Source Port,Destination Port,NAT Source Port,NAT Destination Port,Action,Bytes,Bytes Sent,Bytes Received,Packets,Elapsed Time (sec),pkts_sent,pkts_received
1091,37965,0,0,deny,62,62,0,1,0,1,0
64607,443,37548,443,allow,3182,1568,1614,8,120,4,4
64693,26467,0,0,deny,62,62,0,1,0,1,0
53943,445,0,0,drop,70,70,0,1,0,1,0
52405,53,59064,53,allow,168,78,90,2,30,1,1
53115,40693,57479,40693,allow,70,70,0,1,5,1,0
56400,53,12520,53,allow,819,102,717,2,30,1,1
55714,443,18718,443,allow,11626,4173,7453,25,121,12,13
65373,53,50644,53,allow,197,102,95,2,31,1,1
53844,22114,0,0,deny,66,66,0,1,0,1,0
55584,445,0,0,drop,70,70,0,1,0,1,0
56386,53,13942,53,allow,170,87,83,2,31,1,1
80,44459,0,0,deny,66,66,0,1,0,1,0
57201,53,57201,53,allow,220,90,130,2,30,1,1
55765,53,10201,53,allow,770,101,669,2,30,1,1
62438,37807,0,0,deny,66,66,0,1,0,1,0
50269,80,46714,80,allow,1606,823,783,12,121,7,5
59891,53,0,0,allow,248,75,173,2,30,1,1
59868,443,32881,443,allow,502,250,252,9,26,5,4
57260,51221,0,0,deny,66,66,0,1,0,1,0
50557,445,0,0,drop,70,70,0,1,0,1,0
32911,443,37831,443,allow,970703,43045,927658,1244,141,563,681
49838,445,0,0,drop,70,70,0,1,0,1,0
38126,3389,38126,3389,reset-both,293,223,70,4,1,3,1
36394,443,29956,443,allow,8714,1606,7108,24,34,12,12
64020,53,34722,53,allow,196,102,94,2,30,1,1
5588,5588,0,0,allow,3354,1792,1562,46,195,23,23
55759,53,49971,53,allow,177,94,83,2,30,1,1
64640,445,0,0,drop,70,70,0,1,0,1,0
56629,53,58033,53,allow,182,93,89,2,30,1,1
56926,80,46037,80,allow,214,140,74,4,25,3,1
53070,53,0,0,allow,168,74,94,2,29,1,1
57007,80,33678,80,allow,214,140,74,4,31,3,1
50219,53,44100,53,allow,751,95,656,2,31,1,1
56267,445,0,0,drop,70,70,0,1,0,1,0
56667,53,46013,53,allow,168,86,82,2,30,1,1
49512,80,18348,80,allow,2225,1649,576,10,38,6,4
49832,445,0,0,drop,70,70,0,1,0,1,0
63949,53,30252,53,allow,195,102,93,2,31,1,1
64144,53,47875,53,allow,193,102,91,2,30,1,1
60022,443,54871,443,allow,4962,2551,2411,19,144,10,9
51015,80,51015,80,allow,1905,1456,449,10,20,6,4
56953,80,31471,80,allow,37311,3340,33971,52,65,26,26
39484,80,6764,80,allow,1403,651,752,10,16,6,4
2432,11392,0,0,deny,62,62,0,1,0,1,0
64228,53,55912,53,allow,266,110,156,2,30,1,1
51684,80,23150,80,allow,1515,481,1034,11,15,6,5
58119,445,0,0,drop,66,66,0,1,0,1,0
45109,443,1117,443,allow,11156,3899,7257,31,234,17,14
53197,445,0,0,drop,70,70,0,1,0,1,0
49547,53,49951,53,allow,193,102,91,2,30,1,1
45713,53,45713,53,allow,217,87,130,2,30,1,1
56878,53,29099,53,allow,94,94,0,1,30,1,0
60379,34301,5453,34301,allow,320,140,180,6,7,3,3
50281,53,8038,53,allow,195,102,93,2,30,1,1
13294,64147,0,0,deny,145,145,0,1,0,1,0
60555,445,0,0,drop,70,70,0,1,0,1,0
5223,32965,0,0,deny,167,167,0,1,0,1,0
51525,35440,0,0,deny,66,66,0,1,0,1,0
55271,53,61756,53,allow,751,95,656,2,31,1,1
49485,53,58732,53,allow,752,93,659,2,31,1,1
32768,22,0,0,deny,60,60,0,1,0,1,0
64329,53,38742,53,allow,479,111,368,4,50,2,2
56971,53,24481,53,allow,195,102,93,2,30,1,1
59745,53635,0,0,deny,66,66,0,1,0,1,0
2049,32480,0,0,deny,66,66,0,1,0,1,0
64235,445,0,0,drop,66,66,0,1,0,1,0
49817,445,0,0,drop,70,70,0,1,0,1,0
49646,53,18495,53,allow,199,102,97,2,30,1,1
64330,53,63113,53,allow,200,94,106,2,29,1,1
57412,445,0,0,drop,66,66,0,1,0,1,0
62055,445,0,0,drop,70,70,0,1,0,1,0
28830,37965,0,0,deny,62,62,0,1,0,1,0
49958,36829,0,0,deny,66,66,0,1,0,1,0
55103,445,0,0,drop,70,70,0,1,0,1,0
55377,53,7280,53,allow,164,78,86,2,30,1,1
59866,443,32010,443,allow,6135,843,5292,20,26,10,10
58638,5900,0,0,deny,62,62,0,1,0,1,0
61147,445,0,0,drop,70,70,0,1,0,1,0
54458,64147,0,0,deny,62,62,0,1,0,1,0
55921,53,32858,53,allow,177,94,83,2,30,1,1
56612,443,14658,443,allow,4378,1140,3238,14,26,9,5
58837,3389,58837,3389,allow,4429,2581,1848,21,33,11,10
53186,443,23298,443,allow,10332,2735,7597,36,21,17,19
49504,443,29645,443,allow,26816,2982,23834,50,270,23,27
36821,443,10604,443,allow,5948,1553,4395,16,15,10,6
52111,44847,0,0,deny,62,62,0,1,0,1,0
51928,52520,20049,52520,allow,258,70,188,4,8,2,2
63820,27441,36322,27441,allow,66,66,0,2,7,2,0
55796,53,34450,53,allow,214,94,120,2,30,1,1
65516,53,26663,53,allow,290,94,196,4,40,2,2
59816,443,30172,443,allow,622,310,312,11,29,6,5
56542,53,53986,53,allow,183,94,89,2,29,1,1
60854,42873,0,0,deny,66,66,0,1,0,1,0
60037,445,0,0,drop,70,70,0,1,0,1,0
49901,443,33276,443,allow,5583,1567,4016,16,85,9,7
52404,445,0,0,drop,66,66,0,1,0,1,0
55995,53,32542,53,allow,329,118,211,2,30,1,1
62844,445,0,0,drop,70,70,0,1,0,1,0
48817,32897,48817,32897,allow,152,152,0,1,1200,1,0
27505,25174,0,0,deny,62,62,0,1,0,1,0
33525,53,64644,53,allow,179,86,93,2,30,1,1
65403,53,24512,53,allow,249,102,147,2,30,1,1
56102,53,33083,53,allow,199,94,105,2,30,1,1
56360,445,0,0,drop,66,66,0,1,0,1,0
55958,53,25725,53,allow,209,102,107,2,30,1,1
62693,445,0,0,drop,70,70,0,1,0,1,0
22404,443,22404,443,allow,5576,2436,3140,21,26,12,9
56038,53,33876,53,allow,177,94,83,2,30,1,1
57226,53,39140,53,allow,178,94,84,2,31,1,1
38087,443,27935,443,allow,6147,910,5237,18,100,10,8
61740,445,0,0,drop,70,70,0,1,0,1,0
38066,443,48945,443,allow,328599,275779,52820,868,342,483,385
57346,53,32731,53,allow,210,110,100,2,30,1,1
443,46080,0,0,deny,66,66,0,1,0,1,0
55714,53,64632,53,allow,173,94,79,2,30,1,1
58139,445,0,0,drop,70,70,0,1,0,1,0
46899,443,58934,443,allow,9085,2222,6863,39,125,19,20
56821,53,11694,53,allow,235,94,141,2,30,1,1
64725,445,0,0,drop,70,70,0,1,0,1,0
51486,445,0,0,drop,70,70,0,1,0,1,0
55069,443,55069,443,allow,4517,1610,2907,19,27,11,8
63545,25174,0,0,deny,66,66,0,1,0,1,0
57220,445,0,0,drop,70,70,0,1,0,1,0
49113,50584,0,0,deny,66,66,0,1,0,1,0
52741,443,63085,443,allow,85011,4398,80613,113,26,52,61
49531,53,34898,53,allow,183,94,89,2,30,1,1
51689,4765,24946,4765,allow,66,66,0,1,5,1,0
22916,25174,0,0,deny,62,62,0,1,0,1,0
3478,61463,0,0,deny,164,164,0,1,0,1,0
50584,6881,59238,6881,allow,901,166,735,2,1200,1,1
52159,16297,42997,16297,allow,70,70,0,1,5,1,0
443,31367,0,0,deny,74,74,0,1,0,1,0
17750,6881,6103,6881,allow,149,149,0,1,1200,1,0
50536,445,0,0,drop,70,70,0,1,0,1,0
46585,443,60959,443,allow,9439,3223,6216,27,137,13,14
57166,53,28476,53,allow,177,94,83,2,30,1,1
54343,50584,0,0,deny,66,66,0,1,0,1,0
32137,44512,0,0,deny,62,62,0,1,0,1,0
65031,53,34987,53,allow,184,94,90,2,30,1,1
40054,62413,0,0,deny,62,62,0,1,0,1,0
52442,445,0,0,drop,70,70,0,1,0,1,0
9687,35440,0,0,deny,66,66,0,1,0,1,0
26406,37965,0,0,deny,66,66,0,1,0,1,0
49514,39127,0,0,deny,162,162,0,1,0,1,0
35212,443,26645,443,allow,4477,2350,2127,16,135,8,8
57005,53,24332,53,allow,762,98,664,2,30,1,1
54304,445,0,0,drop,66,66,0,1,0,1,0
54148,445,0,0,drop,70,70,0,1,0,1,0
54957,53,54042,53,allow,197,102,95,2,35,1,1
6882,51505,0,0,deny,66,66,0,1,0,1,0
49565,53,54064,53,allow,768,193,575,6,40,3,3
51954,57470,0,0,deny,66,66,0,1,0,1,0
2075,19473,0,0,deny,66,66,0,1,0,1,0
52024,47600,56931,47600,allow,70,70,0,2,8,2,0
59210,50584,0,0,deny,66,66,0,1,0,1,0
49512,443,49512,443,allow,217225,47956,169269,284,64,149,135
53878,443,30400,443,allow,499,425,74,4,1,3,1
51789,40800,21058,40800,allow,70,70,0,2,8,2,0
54776,445,0,0,drop,70,70,0,1,0,1,0
54705,443,23468,443,allow,5411,851,4560,17,15,8,9
40026,443,36114,443,allow,6058,1749,4309,22,200,13,9
58375,445,0,0,drop,70,70,0,1,0,1,0
1500,10387,0,0,deny,157,157,0,1,0,1,0
52321,26467,0,0,deny,62,62,0,1,0,1,0
56816,80,41001,80,allow,420340,15216,405124,441,376,163,278
53736,37168,63835,37168,allow,70,70,0,1,4,1,0
49485,11392,0,0,deny,66,66,0,1,0,1,0
57604,445,0,0,drop,70,70,0,1,0,1,0
49165,53,19244,53,allow,379,94,285,2,30,1,1
443,51160,0,0,deny,102,102,0,1,0,1,0
60379,443,13895,443,allow,9593,3182,6411,19,23,8,11
55027,445,0,0,drop,70,70,0,1,0,1,0
50674,35440,0,0,deny,62,62,0,1,0,1,0
42686,53,42686,53,allow,262,106,156,2,32,1,1
48913,443,1076,443,allow,6922,1618,5304,23,35,12,11
49634,443,7107,443,allow,1575,988,587,13,35,7,6
56100,57470,0,0,deny,62,62,0,1,0,1,0
443,63128,0,0,deny,1514,1514,0,1,0,1,0
6889,8970,0,0,reset-both,143,143,0,1,0,1,0
56311,53,2296,53,allow,311,94,217,2,30,1,1
31871,53,40960,53,allow,209,86,123,2,29,1,1
50226,80,13987,80,allow,1746,780,966,19,102,7,12
49278,80,1561,80,allow,254,128,126,5,16,3,2
49438,443,47897,443,allow,135574,9426,126148,201,183,102,99
49687,53,9331,53,allow,184,102,82,2,30,1,1
56227,53,8068,53,allow,188,96,92,2,30,1,1
49885,53,57862,53,allow,786,110,676,2,30,1,1
52216,8848,22408,8848,allow,136,136,0,3,11,3,0
65234,53,47492,53,allow,193,102,91,2,31,1,1
59867,443,26148,443,allow,6197,843,5354,21,27,10,11
53126,443,10677,443,allow,6668,2026,4642,15,120,8,7
42128,80,52556,80,allow,1139,506,633,10,15,6,4
56686,443,39990,443,allow,7941,1952,5989,20,16,11,9
443,62451,0,0,deny,199,199,0,1,0,1,0
52965,443,44159,443,allow,86041,4656,81385,102,113,34,68
5637,23,0,0,deny,60,60,0,1,0,1,0
56388,53,28613,53,allow,186,95,91,3,46,2,1
49961,53,9720,53,allow,327,126,201,2,30,1,1
56489,53,9715,53,allow,172,88,84,2,31,1,1
59029,445,0,0,drop,70,70,0,1,0,1,0
58244,445,0,0,drop,70,70,0,1,0,1,0
55581,53,26872,53,allow,167,86,81,2,30,1,1
52225,31985,35881,31985,allow,66,66,0,1,5,1,0
55941,53,54126,53,allow,184,94,90,2,30,1,1
63988,50584,0,0,deny,66,66,0,1,0,1,0
50573,445,0,0,drop,70,70,0,1,0,1,0
57268,443,29567,443,allow,11546,3604,7942,38,120,20,18
62558,20170,0,0,deny,145,145,0,1,0,1,0
56082,53,27828,53,allow,182,94,88,2,30,1,1
55599,80,22870,80,allow,1165,473,692,10,14,5,5
0,0,0,0,deny,70,70,0,1,0,1,0
57341,53,25205,53,allow,184,94,90,2,30,1,1
62295,445,0,0,drop,66,66,0,1,0,1,0
63364,445,0,0,drop,70,70,0,1,0,1,0
50621,80,31852,80,allow,11975,10368,1607,27,52,16,11
65326,445,0,0,drop,66,66,0,1,0,1,0
59455,53,0,0,allow,221,81,140,2,31,1,1
55772,445,0,0,drop,70,70,0,1,0,1,0
65240,53,39958,53,allow,199,94,105,2,30,1,1
39690,443,65323,443,allow,5806,3167,2639,29,221,16,13
55727,53,48303,53,allow,177,94,83,2,30,1,1
58638,5900,0,0,deny,62,62,0,1,0,1,0
56981,443,53338,443,allow,7238,2601,4637,20,22,10,10
60003,445,0,0,drop,70,70,0,1,0,1,0
49229,6921,0,0,deny,145,145,0,1,0,1,0
65233,23117,0,0,deny,62,62,0,1,0,1,0
53268,80,36603,80,allow,2960,1928,1032,13,75,8,5
51501,993,18732,993,allow,12667,4060,8607,87,32,39,48
60104,30188,0,0,deny,66,66,0,1,0,1,0
16905,57866,0,0,deny,66,66,0,1,0,1,0
61066,53,0,0,allow,283,78,205,2,29,1,1
60069,443,38195,443,allow,3045,1340,1705,16,141,8,8
443,11266,0,0,deny,124,124,0,1,0,1,0
44528,5900,0,0,deny,60,60,0,1,0,1,0
47453,6881,0,0,deny,146,146,0,1,0,1,0
443,48120,0,0,deny,97,97,0,1,0,1,0
57311,443,59894,443,allow,134,60,74,3,6,2,1
63824,445,0,0,drop,70,70,0,1,0,1,0
57573,443,57573,443,allow,775362,32338,743024,683,180,169,514
57595,445,0,0,drop,70,70,0,1,0,1,0
51745,2572,13644,2572,allow,70,70,0,2,8,2,0
58652,445,0,0,drop,70,70,0,1,0,1,0
56762,53,10015,53,allow,168,86,82,2,29,1,1
37542,53,41860,53,allow,240,76,164,2,30,1,1
49655,53,32746,53,allow,209,110,99,2,30,1,1
9092,26672,0,0,deny,60,60,0,1,0,1,0
57737,53,57737,53,allow,374,240,134,3,32,2,1
61153,445,0,0,drop,66,66,0,1,0,1,0
28649,43890,0,0,deny,66,66,0,1,0,1,0
9482,443,2770,443,allow,5657,487,5170,14,15,7,7
49001,22114,0,0,deny,62,62,0,1,0,1,0
54264,445,0,0,drop,66,66,0,1,0,1,0
57959,21247,0,0,deny,66,66,0,1,0,1,0
50629,443,56409,443,allow,70,70,0,1,5,1,0
58562,57587,0,0,deny,66,66,0,1,0,1,0
51406,443,19359,443,allow,5360,3775,1585,22,35,13,9
55646,53,23408,53,allow,182,93,89,2,31,1,1
55933,53,55116,53,allow,330,92,238,4,43,2,2
59476,445,0,0,drop,70,70,0,1,0,1,0
54904,445,0,0,drop,70,70,0,1,0,1,0
11816,53,11816,53,allow,240,98,142,2,30,1,1
54280,3398,0,0,deny,60,60,0,1,0,1,0
64485,53,38773,53,allow,182,93,89,2,30,1,1
39588,25174,0,0,deny,66,66,0,1,0,1,0
53928,15503,0,0,deny,62,62,0,1,0,1,0
61669,445,0,0,drop,70,70,0,1,0,1,0
62940,445,0,0,drop,70,70,0,1,0,1,0
58671,445,0,0,drop,70,70,0,1,0,1,0
3478,61463,0,0,deny,164,164,0,1,0,1,0
55067,53,40121,53,allow,178,94,84,2,30,1,1
41486,443,65300,443,allow,204,70,134,4,26,2,2
50367,445,0,0,drop,66,66,0,1,0,1,0
52875,443,52875,443,allow,3133,814,2319,13,136,6,7
49454,53,42230,53,allow,248,118,130,2,30,1,1
51745,57470,0,0,deny,62,62,0,1,0,1,0
56677,53,20003,53,allow,200,102,98,2,31,1,1
50393,53,2809,53,allow,759,94,665,2,29,1,1
43260,41615,0,0,deny,145,145,0,1,0,1,0
21606,80,0,0,deny,60,60,0,1,0,1,0
65484,53,32858,53,allow,195,102,93,2,30,1,1
56746,80,35139,80,allow,876072,26350,849722,935,27,335,600
58638,5900,0,0,deny,62,62,0,1,0,1,0
65321,53,36858,53,allow,167,86,81,2,29,1,1
51338,445,0,0,drop,66,66,0,1,0,1,0
59166,123,2980,123,allow,184,94,90,2,30,1,1
59530,445,0,0,drop,70,70,0,1,0,1,0
50316,80,27928,80,allow,1677,862,815,10,15,5,5
50211,53,50211,53,allow,217,90,127,2,29,1,1
53247,445,0,0,drop,70,70,0,1,0,1,0
49733,443,61095,443,allow,204,70,134,4,26,2,2
51176,445,0,0,drop,70,70,0,1,0,1,0
50037,53,12005,53,allow,195,102,93,2,30,1,1
56629,443,36618,443,allow,22938,14436,8502,43,35,23,20
54217,445,0,0,drop,66,66,0,1,0,1,0
53639,15079,39945,15079,allow,546,306,240,9,15,5,4
49498,53,4790,53,allow,245,102,143,2,30,1,1
41785,443,3150,443,allow,13183,1682,11501,26,78,12,14
52812,25174,0,0,deny,62,62,0,1,0,1,0
51970,18752,54925,18752,allow,70,70,0,2,8,2,0
55229,443,47978,443,allow,3602,1519,2083,18,60,10,8
55062,53,27959,53,allow,194,94,100,2,31,1,1
55427,53,42725,53,allow,442,110,332,4,44,2,2
60319,445,0,0,drop,70,70,0,1,0,1,0
64475,53,56537,53,allow,184,94,90,2,30,1,1
52025,443,47252,443,allow,8034,2692,5342,15,16,8,7
50584,15926,55734,15926,allow,1377,300,1077,6,1200,3,3
39569,443,39569,443,allow,4601,1694,2907,19,28,11,8
52034,48856,21980,48856,allow,70,70,0,2,9,2,0
65175,53,18597,53,allow,269,94,175,2,30,1,1
52103,53733,0,0,deny,62,62,0,1,0,1,0
50477,443,26806,443,allow,55388,4069,51319,94,240,46,48
39337,443,52807,443,allow,4362,1145,3217,17,26,9,8
58877,443,35023,443,allow,183394,7389,176005,219,108,87,132
53869,443,21669,443,allow,499,425,74,4,1,3,1
61152,445,0,0,drop,66,66,0,1,0,1,0
57496,25174,0,0,deny,66,66,0,1,0,1,0
51254,445,0,0,drop,66,66,0,1,0,1,0
49454,445,0,0,drop,66,66,0,1,0,1,0
20389,64147,0,0,deny,66,66,0,1,0,1,0
55865,53,22117,53,allow,184,94,90,2,30,1,1
62926,445,0,0,drop,70,70,0,1,0,1,0
49418,27333,30238,27333,allow,254,78,176,2,30,1,1
56474,80,38347,80,allow,8790,1387,7403,17,134,9,8
56492,53,3429,53,allow,177,94,83,2,30,1,1
63743,445,0,0,drop,70,70,0,1,0,1,0
55806,53,52811,53,allow,200,102,98,2,33,1,1
65350,53,19451,53,allow,75,75,0,1,30,1,0
49570,443,32958,443,allow,6360,2483,3877,20,16,10,10
58147,443,65421,443,allow,8365,2826,5539,27,693,15,12
53119,58118,18768,58118,allow,70,70,0,1,5,1,0
63732,40642,31051,40642,allow,66,66,0,2,7,2,0
36400,51505,0,0,deny,62,62,0,1,0,1,0
52560,445,0,0,drop,70,70,0,1,0,1,0
6754,443,21695,443,allow,13520,2288,11232,43,192,19,24
57316,53,12512,53,allow,177,94,83,2,30,1,1
57431,53,12535,53,allow,994,86,908,2,30,1,1
50518,80,23907,80,allow,2864,1338,1526,17,21,9,8
49314,445,0,0,drop,66,66,0,1,0,1,0
59038,53,59038,53,allow,832,106,726,2,30,1,1
59030,445,0,0,drop,70,70,0,1,0,1,0
64914,53,32177,53,allow,168,86,82,2,31,1,1
56433,53,56287,53,allow,177,94,83,2,30,1,1
62760,445,0,0,drop,66,66,0,1,0,1,0
57436,53,46375,53,allow,183,94,89,2,30,1,1
41235,443,2013,443,allow,1807,1048,759,16,26,8,8
64577,443,50601,443,allow,24686,1935,22751,36,16,17,19
58788,443,39752,443,allow,5166,700,4466,16,15,7,9
53166,53,17813,53,allow,168,78,90,2,30,1,1
61638,445,0,0,drop,70,70,0,1,0,1,0
62949,37965,0,0,deny,62,62,0,1,0,1,0
51170,443,40281,443,allow,9894856,232425,9662431,9829,90,3300,6529
49522,443,49522,443,allow,7647,1693,5954,31,77,16,15
9327,443,1143,443,allow,3616,429,3187,11,15,6,5
63459,445,0,0,drop,70,70,0,1,0,1,0
49557,53,33015,53,allow,211,102,109,2,30,1,1
52165,49740,56721,49740,allow,70,70,0,2,8,2,0
51955,39871,39902,39871,allow,70,70,0,1,5,1,0
43260,41615,0,0,deny,145,145,0,1,0,1,0
50934,443,28821,443,allow,9989,3003,6986,30,46,17,13
53543,445,0,0,deny,70,70,0,1,0,1,0
49469,53,45496,53,allow,177,94,83,2,30,1,1
39251,53,9429,53,allow,198,93,105,2,30,1,1
55335,53,8773,53,allow,754,94,660,2,30,1,1
64082,43786,41878,43786,allow,504,382,122,8,14,6,2
9231,3389,0,0,deny,66,66,0,1,0,1,0
56824,55829,39772,55829,allow,70,70,0,1,5,1,0
61576,445,0,0,drop,66,66,0,1,0,1,0
57470,53250,48963,53250,allow,491,150,341,2,1199,1,1
30960,45727,32973,45727,allow,330,330,0,6,3610,6,0
55091,443,55091,443,allow,21122,2591,18531,36,17,18,18
0,0,0,0,deny,98,98,0,1,0,1,0
64473,7000,64473,7000,allow,3434,1595,1839,17,15,9,8
8976,44847,0,0,deny,66,66,0,1,0,1,0
52170,45144,10407,45144,allow,66,66,0,1,5,1,0
46369,443,62410,443,allow,12157,3583,8574,81,480,34,47
45218,25174,0,0,deny,62,62,0,1,0,1,0
51231,443,6800,443,allow,63550,10766,52784,98,131,43,55
53035,5228,40515,5228,allow,2725,1610,1115,20,3600,10,10
27000,23117,0,0,deny,62,62,0,1,0,1,0
60077,445,0,0,drop,70,70,0,1,0,1,0
52001,80,13411,80,allow,546,300,246,10,25,6,4
55545,53,10302,53,allow,170,87,83,2,30,1,1
64199,445,0,0,drop,70,70,0,1,0,1,0
53625,53,53625,53,allow,643,88,555,2,31,1,1
64053,47783,24062,47783,allow,70,70,0,1,5,1,0
56078,53,48093,53,allow,178,94,84,2,29,1,1
64162,22114,0,0,deny,146,146,0,1,0,1,0
58912,443,7357,443,allow,7941,5160,2781,25,17,13,12
63509,445,0,0,drop,70,70,0,1,0,1,0
57291,53,29680,53,allow,178,94,84,2,30,1,1
60793,40010,33213,40010,allow,316,136,180,6,6,3,3
59507,445,0,0,drop,70,70,0,1,0,1,0
50025,53,41046,53,allow,369,150,219,2,30,1,1
54106,445,0,0,drop,70,70,0,1,0,1,0
55068,53,43226,53,allow,196,102,94,2,31,1,1
50431,80,44826,80,allow,318,192,126,6,27,4,2
41739,53,41739,53,allow,235,90,145,2,32,1,1
56522,443,50354,443,allow,5212,1037,4175,20,115,10,10
65122,443,26133,443,allow,5500,1277,4223,17,180,8,9
42917,52952,0,0,deny,62,62,0,1,0,1,0
63331,51221,0,0,deny,62,62,0,1,0,1,0
55275,445,0,0,drop,70,70,0,1,0,1,0
55580,445,0,0,drop,70,70,0,1,0,1,0
53852,80,48149,80,allow,130,70,60,2,15,1,1
55926,445,0,0,drop,70,70,0,1,0,1,0
53797,443,48154,443,allow,499,425,74,4,0,3,1
64295,26467,0,0,deny,66,66,0,1,0,1,0
55786,53,41972,53,allow,200,102,98,2,29,1,1
49370,53,35451,53,allow,430,85,345,4,54,2,2
49527,53,63553,53,allow,415,98,317,4,51,2,2
57825,13014,0,0,deny,74,74,0,1,0,1,0
50027,445,0,0,drop,70,70,0,1,0,1,0
38822,80,14880,80,allow,810,413,397,7,19,5,2
7532,53,7532,53,allow,228,90,138,2,31,1,1
51602,22114,0,0,deny,66,66,0,1,0,1,0
25009,35440,0,0,deny,66,66,0,1,0,1,0
56751,53,10691,53,allow,177,94,83,2,30,1,1
54211,53,7944,53,allow,339,94,245,2,30,1,1
49819,53,24234,53,allow,94,94,0,1,30,1,0
54649,443,1081,443,allow,355822,186974,168848,1039,1626,433,606
57499,445,0,0,drop,70,70,0,1,0,1,0
55640,54435,47783,54435,allow,70,70,0,2,8,2,0
12183,22114,0,0,deny,62,62,0,1,0,1,0
56077,80,49245,80,allow,2481,529,1952,11,75,6,5
48290,443,64782,443,allow,7920,2731,5189,27,82,15,12
64987,27042,62086,27042,allow,1012,462,550,4,30,2,2
48817,48489,48817,48489,allow,480,149,331,2,1200,1,1
65176,445,0,0,drop,66,66,0,1,0,1,0
54202,445,0,0,drop,66,66,0,1,0,1,0
51113,80,51632,80,allow,1948,1092,856,10,20,7,3
9748,21247,0,0,deny,66,66,0,1,0,1,0
53235,443,53235,443,allow,1270,697,573,15,33,8,7
34203,443,27925,443,allow,33068,2556,30512,48,81,21,27
57251,53,30748,53,allow,780,104,676,2,31,1,1
34914,26467,0,0,deny,62,62,0,1,0,1,0
44402,443,62685,443,allow,196732,11940,184792,257,139,103,154
53096,445,0,0,drop,66,66,0,1,0,1,0
57136,53,53104,53,allow,177,94,83,2,30,1,1
53190,80,50867,80,allow,1873,713,1160,10,15,5,5
56940,80,20270,80,allow,2925,1480,1445,11,30,7,4
56833,23117,0,0,deny,62,62,0,1,0,1,0
53255,443,13217,443,allow,6244,1104,5140,23,65,12,11
60241,445,0,0,drop,66,66,0,1,0,1,0
59696,57470,0,0,deny,62,62,0,1,0,1,0
39735,443,13542,443,allow,280,140,140,5,130,3,2
6333,53,6333,53,allow,216,90,126,2,30,1,1
64318,53,41262,53,allow,499,183,316,6,57,3,3
38926,37965,0,0,deny,62,62,0,1,0,1,0
60462,47821,9617,47821,allow,70,70,0,1,5,1,0
65291,53,53725,53,allow,889,404,485,10,30,5,5
38885,21247,0,0,deny,62,62,0,1,0,1,0
37651,443,4131,443,allow,4162,3001,1161,20,25,12,8
59377,443,61380,443,allow,43483,26315,17168,86,62,54,32
3181,53,3181,53,allow,214,97,117,2,30,1,1
49755,443,49571,443,allow,447301,17016,430285,539,128,196,343
60159,22114,0,0,deny,66,66,0,1,0,1,0
0,0,0,0,deny,60,60,0,1,0,1,0
57201,53,17693,53,allow,195,102,93,2,31,1,1
50279,445,0,0,drop,66,66,0,1,0,1,0
56066,53,44669,53,allow,196,86,110,2,30,1,1
54590,445,0,0,drop,70,70,0,1,0,1,0
55508,53,1825,53,allow,814,110,704,2,30,1,1
22751,53,22751,53,allow,235,90,145,2,32,1,1
46587,57470,0,0,deny,62,62,0,1,0,1,0
34166,443,49916,443,allow,8290,2156,6134,24,81,14,10
65092,53,28213,53,allow,197,102,95,2,29,1,1
5011,53,5011,53,allow,244,98,146,2,32,1,1
53859,34334,7486,34334,allow,492,306,186,8,14,5,3
59477,443,7119,443,allow,14489,12206,2283,25,120,15,10
54528,443,20055,443,allow,6256,1871,4385,20,45,12,8
49514,443,28704,443,allow,28361,1861,26500,49,195,19,30
33259,443,58382,443,allow,4193,2689,1504,23,23,14,9
50726,443,17287,443,allow,6464,2707,3757,39,151,18,21
65014,53,3896,53,allow,186,95,91,2,31,1,1
51903,35904,6046,35904,allow,70,70,0,2,8,2,0
27005,27001,28367,27001,allow,883,126,757,2,30,1,1
6247,51221,0,0,deny,78,78,0,1,0,1,0
59352,37965,0,0,deny,66,66,0,1,0,1,0
64986,53,47302,53,allow,176,90,86,2,31,1,1
56618,445,0,0,drop,70,70,0,1,0,1,0
64877,53,52528,53,allow,94,94,0,1,30,1,0
53497,443,53212,443,allow,17187157,553524,16633633,18453,352,6098,12355
51747,54301,33615,54301,allow,136,136,0,3,14,3,0
10533,23,0,0,deny,60,60,0,1,0,1,0
52217,22114,0,0,deny,66,66,0,1,0,1,0
57282,53,60817,53,allow,198,101,97,2,30,1,1
65496,53,50300,53,allow,183,94,89,2,30,1,1
40967,1433,0,0,deny,60,60,0,1,0,1,0
49343,445,0,0,drop,66,66,0,1,0,1,0
55314,53,61384,53,allow,279,110,169,2,30,1,1
9294,443,62511,443,allow,6356,979,5377,19,27,10,9
56297,53,58728,53,allow,168,86,82,2,30,1,1
12183,22114,0,0,deny,62,62,0,1,0,1,0
9267,80,6787,80,allow,318,192,126,6,27,4,2
65315,53,25931,53,allow,770,101,669,2,30,1,1
56304,53,19681,53,allow,184,94,90,2,30,1,1
56292,445,0,0,drop,70,70,0,1,0,1,0
49257,53,51437,53,allow,199,102,97,2,30,1,1
53878,55950,58060,55950,allow,70,70,0,2,8,2,0
6881,31026,35308,31026,allow,509,150,359,2,1199,1,1
57529,445,0,0,drop,66,66,0,1,0,1,0
48706,23393,0,0,deny,60,60,0,1,0,1,0
49440,53,64789,53,allow,415,88,327,4,52,2,2
52309,80,52309,80,allow,450,246,204,8,29,5,3
50237,53,33615,53,allow,183,94,89,2,30,1,1
49986,445,0,0,drop,70,70,0,1,0,1,0
54990,80,38273,80,allow,9054746,285623,8769123,10474,214,4673,5801
49891,443,42695,443,allow,8211,3683,4528,27,623,14,13
64449,53,34818,53,allow,255,102,153,2,31,1,1
65461,445,0,0,drop,70,70,0,1,0,1,0
58095,80,30247,80,allow,4468,1145,3323,15,16,9,6
54075,445,0,0,drop,66,66,0,1,0,1,0
50272,53,35628,53,allow,210,110,100,2,29,1,1
43791,443,3031,443,allow,6933,1677,5256,22,305,12,10
58537,445,0,0,drop,70,70,0,1,0,1,0
46573,50584,0,0,deny,66,66,0,1,0,1,0
51851,445,0,0,drop,70,70,0,1,0,1,0
39207,80,48256,80,allow,234,234,0,4,12,4,0
53774,51505,0,0,deny,62,62,0,1,0,1,0
65211,53,49175,53,allow,216,102,114,2,30,1,1
54598,37965,0,0,deny,62,62,0,1,0,1,0
56541,53,2371,53,allow,294,142,152,2,30,1,1
54450,445,0,0,drop,70,70,0,1,0,1,0
60162,53436,0,0,deny,66,66,0,1,0,1,0
52038,50584,0,0,deny,66,66,0,1,0,1,0
61345,445,0,0,drop,70,70,0,1,0,1,0
61129,443,47713,443,allow,3854,1233,2621,19,120,9,10
59677,445,0,0,drop,70,70,0,1,0,1,0
59724,64147,0,0,deny,62,62,0,1,0,1,0
52059,445,0,0,drop,70,70,0,1,0,1,0
443,49988,0,0,deny,82,82,0,1,0,1,0
4903,42873,0,0,deny,70,70,0,1,0,1,0
56411,50584,0,0,deny,62,62,0,1,0,1,0
51926,445,0,0,drop,70,70,0,1,0,1,0
56775,53,34626,53,allow,763,101,662,2,30,1,1
64026,80,47805,80,allow,314,192,122,6,15,4,2
56718,443,49535,443,allow,7940,1951,5989,20,15,11,9
50287,445,0,0,drop,66,66,0,1,0,1,0
25296,51505,0,0,deny,66,66,0,1,0,1,0
57985,80,36501,80,allow,3703,2068,1635,17,33,10,7
47866,53,1378,53,allow,199,94,105,2,30,1,1
53588,445,0,0,drop,70,70,0,1,0,1,0
50584,6881,56597,6881,allow,161,161,0,1,1201,1,0
28024,443,28708,443,allow,5516,1388,4128,18,15,9,9
58638,5900,0,0,deny,62,62,0,1,0,1,0
56293,53,25636,53,allow,166,86,80,2,30,1,1
57726,445,0,0,drop,70,70,0,1,0,1,0
50277,443,37349,443,allow,3182,1568,1614,8,120,4,4
64539,53,38642,53,allow,276,126,150,2,30,1,1
50919,445,0,0,drop,66,66,0,1,0,1,0
49941,80,49941,80,allow,493003,23995,469008,578,22,246,332
55972,445,0,0,drop,70,70,0,1,0,1,0
50681,445,0,0,drop,66,66,0,1,0,1,0
57921,445,0,0,drop,70,70,0,1,0,1,0
8229,22114,0,0,deny,62,62,0,1,0,1,0
59191,35440,0,0,deny,62,62,0,1,0,1,0
21017,3389,21017,3389,allow,4085,1916,2169,21,18,12,9
56768,445,0,0,drop,70,70,0,1,0,1,0
58638,5900,0,0,deny,62,62,0,1,0,1,0
2990,64147,0,0,deny,66,66,0,1,0,1,0
50566,443,4143,443,allow,2064,1287,777,16,139,9,7
57018,53,57758,53,allow,177,94,83,2,30,1,1
53453,2767,0,0,deny,66,66,0,1,0,1,0
56002,53,4276,53,allow,771,101,670,2,31,1,1
50052,65010,0,0,deny,60,60,0,1,0,1,0
51558,443,41569,443,allow,254,70,184,5,22,2,3
35957,51185,0,0,deny,60,60,0,1,0,1,0
39531,19473,0,0,deny,62,62,0,1,0,1,0
47342,36237,0,0,deny,66,66,0,1,0,1,0
57440,53,28373,53,allow,199,102,97,2,30,1,1
39336,443,13653,443,allow,4362,1145,3217,17,25,9,8
56719,53,59269,53,allow,185,102,83,2,30,1,1
11061,4229,0,0,deny,145,145,0,1,0,1,0
63194,50265,0,0,deny,66,66,0,1,0,1,0
64930,443,64930,443,allow,4596,1689,2907,19,27,11,8
49598,80,65095,80,allow,400,70,330,6,24,1,5
3478,61463,0,0,deny,1049,1049,0,1,0,1,0
24174,57470,0,0,deny,62,62,0,1,0,1,0
14070,62413,0,0,deny,66,66,0,1,0,1,0
60617,445,0,0,drop,66,66,0,1,0,1,0
51457,445,0,0,drop,70,70,0,1,0,1,0
65367,53,17484,53,allow,271,94,177,2,30,1,1
56036,53,20624,53,allow,762,98,664,2,31,1,1
58638,5900,0,0,deny,62,62,0,1,0,1,0
52018,80,20950,80,allow,1660,791,869,11,32,6,5
55228,445,0,0,drop,66,66,0,1,0,1,0
54321,27015,42449,27015,allow,924,924,0,3,29,3,0
49992,445,0,0,drop,70,70,0,1,0,1,0
55828,445,0,0,drop,70,70,0,1,0,1,0
48757,443,52585,443,allow,6353,1075,5278,18,33,10,8
53133,445,0,0,drop,70,70,0,1,0,1,0
1038,37965,0,0,deny,62,62,0,1,0,1,0
53613,11309,52250,11309,allow,492,306,186,8,16,5,3
14489,25174,0,0,deny,62,62,0,1,0,1,0
56366,51221,0,0,deny,66,66,0,1,0,1,0
58394,53,41554,53,allow,274,94,180,2,30,1,1
45964,2225,0,0,deny,60,60,0,1,0,1,0
49532,53,58267,53,allow,334,92,242,4,49,2,2
54189,22114,0,0,deny,66,66,0,1,0,1,0
10151,10016,24460,10016,allow,460,150,310,2,1200,1,1
50470,61463,0,0,deny,86,86,0,1,0,1,0
58369,53,2783,53,allow,167,78,89,2,30,1,1
54148,445,0,0,drop,70,70,0,1,0,1,0
53852,14099,17770,14099,allow,320,140,180,6,6,3,3
49609,53,45961,53,allow,177,94,83,2,31,1,1
59523,37965,0,0,deny,62,62,0,1,0,1,0
49265,53,7053,53,allow,178,91,87,2,31,1,1
50151,445,0,0,drop,66,66,0,1,0,1,0
61419,443,21446,443,allow,1664127,116770,1547357,2028,401,736,1292
55114,53,53852,53,allow,392,100,292,4,33,2,2
60467,51095,40128,51095,allow,320,140,180,6,7,3,3
27005,27017,8108,27017,allow,1658,126,1532,4,30,2,2
50637,445,0,0,drop,70,70,0,1,0,1,0
57470,31381,16195,31381,allow,792,792,0,13,1200,13,0
53975,445,0,0,drop,70,70,0,1,0,1,0
49418,27015,20028,27015,allow,264,78,186,2,29,1,1
63731,26467,0,0,deny,66,66,0,1,0,1,0
51324,465,51324,465,allow,320,128,192,6,5,3,3
39423,80,38195,80,allow,78,78,0,1,4,1,0
46409,35440,0,0,deny,62,62,0,1,0,1,0
63062,35440,0,0,deny,62,62,0,1,0,1,0
55130,25174,0,0,deny,66,66,0,1,0,1,0
54306,443,48186,443,allow,6376,1576,4800,24,19,13,11
50640,445,0,0,drop,70,70,0,1,0,1,0
56389,53,40774,53,allow,279,93,186,4,32,2,2
64579,37965,0,0,deny,66,66,0,1,0,1,0
56527,445,0,0,drop,70,70,0,1,0,1,0
56500,53,38812,53,allow,164,86,78,2,30,1,1
65071,80,65071,80,allow,296372,11959,284413,311,23,113,198
35136,443,3606,443,allow,25542,17843,7699,58,59,34,24
1070,26467,0,0,deny,62,62,0,1,0,1,0
62003,445,0,0,drop,70,70,0,1,0,1,0
58903,443,20018,443,allow,6033,770,5263,18,15,8,10
37965,48782,19115,48782,allow,132,132,0,3,1199,3,0
33896,57470,0,0,deny,74,74,0,1,0,1,0
38674,80,36626,80,allow,1114,534,580,12,16,7,5
59975,443,17092,443,allow,7875,3100,4775,42,24,22,20
61721,445,0,0,drop,66,66,0,1,0,1,0
27988,40005,15276,40005,allow,148,86,62,2,30,1,1
54811,443,21381,443,allow,3392,2305,1087,22,80,11,11
57401,53,41706,53,allow,174,89,85,2,31,1,1
58791,30188,0,0,deny,146,146,0,1,0,1,0
49160,63307,39518,63307,allow,854,150,704,4,1200,2,2
64942,53,36365,53,allow,284,102,182,4,38,2,2
20741,64147,0,0,deny,62,62,0,1,0,1,0
21133,54322,33050,54322,allow,480,149,331,2,1200,1,1
57470,47099,22688,47099,allow,330,330,0,6,1199,6,0
54261,445,0,0,drop,70,70,0,1,0,1,0
52662,445,0,0,drop,70,70,0,1,0,1,0
62681,445,0,0,drop,66,66,0,1,0,1,0
56183,53,29912,53,allow,179,94,85,2,31,1,1
52021,32202,28754,32202,allow,66,66,0,1,5,1,0
64343,53,64343,53,allow,216,98,118,2,30,1,1
48258,37965,0,0,deny,62,62,0,1,0,1,0
60035,445,0,0,drop,70,70,0,1,0,1,0
60993,445,0,0,drop,70,70,0,1,0,1,0
61978,445,0,0,drop,66,66,0,1,0,1,0
34779,443,25876,443,allow,34914,5279,29635,47,543,18,29
64367,443,64367,443,allow,4347,1440,2907,19,26,11,8
48864,123,32657,123,allow,184,94,90,2,30,1,1
33896,57470,0,0,deny,74,74,0,1,0,1,0
443,10010,0,0,deny,60,60,0,1,0,1,0
52164,443,52164,443,allow,20480,2066,18414,37,17,19,18
59984,443,65136,443,allow,2419,330,2089,12,135,5,7
49466,443,64942,443,allow,4562,2466,2096,20,119,11,9
57303,53,6094,53,allow,177,94,83,2,30,1,1
65361,53,62352,53,allow,211,102,109,2,30,1,1
57521,445,0,0,drop,70,70,0,1,0,1,0
2828,35253,0,0,deny,66,66,0,1,0,1,0
58638,5900,0,0,deny,62,62,0,1,0,1,0
61387,43890,0,0,deny,66,66,0,1,0,1,0
53676,445,0,0,drop,66,66,0,1,0,1,0
45360,443,43206,443,allow,10280,6167,4113,20,15,12,8
51749,1408,5548,1408,allow,66,66,0,1,5,1,0
61664,445,0,0,drop,66,66,0,1,0,1,0
49166,443,48248,443,allow,9022,1416,7606,25,31,11,14
49599,445,0,0,drop,70,70,0,1,0,1,0
51031,445,0,0,drop,70,70,0,1,0,1,0
55193,53,60056,53,allow,170,87,83,2,31,1,1
64092,443,64092,443,allow,5643,2397,3246,26,159,14,12
50056,27018,43222,27018,allow,468,390,78,5,29,4,1
61840,25174,0,0,deny,66,66,0,1,0,1,0
33122,80,28324,80,allow,9055,863,8192,18,45,10,8
62029,36237,0,0,deny,66,66,0,1,0,1,0
55644,53,49999,53,allow,184,94,90,2,30,1,1
55951,53,13243,53,allow,197,102,95,2,31,1,1
49885,443,26423,443,allow,10216,2749,7467,27,86,14,13
49797,25174,0,0,deny,66,66,0,1,0,1,0
63112,445,0,0,drop,66,66,0,1,0,1,0
54913,445,0,0,drop,70,70,0,1,0,1,0
65251,80,48445,80,allow,6352,4052,2300,44,630,23,21
51638,80,60451,80,allow,318,192,126,6,39,4,2
55002,53,54595,53,allow,192,98,94,2,31,1,1
56661,80,6258,80,allow,234,234,0,4,12,4,0
57397,53,3449,53,allow,183,94,89,2,30,1,1
59711,445,0,0,drop,70,70,0,1,0,1,0
57129,445,0,0,drop,70,70,0,1,0,1,0
64513,53,5790,53,allow,336,93,243,4,33,2,2
56260,445,0,0,drop,66,66,0,1,0,1,0
62104,445,0,0,drop,70,70,0,1,0,1,0
27005,33038,15973,33038,allow,892,126,766,2,31,1,1
49373,443,19953,443,allow,1857,1218,639,18,104,11,7
9103,443,27886,443,allow,7876,1511,6365,29,42,14,15
55803,53,42450,53,allow,261,89,172,4,38,2,2
50005,53,45437,53,allow,295,101,194,4,30,2,2
28584,37965,0,0,deny,62,62,0,1,0,1,0
54305,39004,0,0,deny,62,62,0,1,0,1,0
59181,445,0,0,drop,70,70,0,1,0,1,0
53905,443,17585,443,allow,499,425,74,4,0,3,1
36074,80,23733,80,allow,1158,792,366,10,17,6,4
27005,27017,42794,27017,allow,880,126,754,2,30,1,1
63278,443,14519,443,allow,11570,3553,8017,24,134,10,14
44684,443,12133,443,allow,4728,3417,1311,23,35,12,11
51295,443,27138,443,allow,7448,1737,5711,24,201,13,11
33372,3389,33372,3389,allow,4695,2520,2175,22,19,13,9
51676,23718,0,0,deny,62,62,0,1,0,1,0
50074,53,48010,53,allow,168,86,82,2,30,1,1
49418,28002,23648,28002,allow,271,78,193,2,30,1,1
57131,35776,0,0,deny,145,145,0,1,0,1,0
56602,443,27563,443,allow,7942,1953,5989,20,15,11,9
56288,445,0,0,drop,70,70,0,1,0,1,0
56841,443,47510,443,allow,156805,44621,112184,289,215,137,152
9087,53,9087,53,allow,215,80,135,2,33,1,1
17101,25174,0,0,deny,62,62,0,1,0,1,0
19372,443,19372,443,allow,10461,1417,9044,23,16,10,13
51933,53,51933,53,allow,253,106,147,2,30,1,1
56185,53,61715,53,allow,168,86,82,2,30,1,1
56521,53,35277,53,allow,305,86,219,2,30,1,1
51166,31573,0,0,deny,66,66,0,1,0,1,0
65519,443,19659,443,allow,436359,12780,423579,448,16,157,291
65507,53,1633,53,allow,177,94,83,2,30,1,1
53750,443,4212,443,allow,499,425,74,4,0,3,1
49575,53,46030,53,allow,775,102,673,2,29,1,1
24351,57470,0,0,deny,62,62,0,1,0,1,0
55797,53,58319,53,allow,170,87,83,2,31,1,1
49250,445,0,0,drop,66,66,0,1,0,1,0
57470,3800,54639,3800,allow,150,150,0,1,1199,1,0
55463,53,53091,53,allow,216,110,106,2,31,1,1
51130,61689,0,0,deny,66,66,0,1,0,1,0
63599,445,0,0,drop,70,70,0,1,0,1,0
60698,445,0,0,drop,70,70,0,1,0,1,0
55070,53,23784,53,allow,195,102,93,2,31,1,1
1528,53,1528,53,allow,193,90,103,2,30,1,1
51882,15733,3672,15733,allow,70,70,0,1,5,1,0
50245,443,54814,443,allow,6866,1958,4908,21,20,13,8
64725,445,0,0,drop,70,70,0,1,0,1,0
49826,443,35074,443,allow,5635,1599,4036,19,125,11,8
51207,445,0,0,drop,70,70,0,1,0,1,0
49472,80,16724,80,allow,318,192,126,6,28,4,2
46342,53,46342,53,allow,233,90,143,2,32,1,1
6932,80,6932,80,allow,124405,3747,120658,131,38,46,85
50305,443,65523,443,allow,7725,2029,5696,23,136,13,10
61762,443,14583,443,allow,5975,2713,3262,24,125,12,12
55936,53,2278,53,allow,170,87,83,2,30,1,1
1025,35447,0,0,deny,62,62,0,1,0,1,0
55686,44049,11130,44049,allow,504,318,186,8,15,5,3
49522,21247,0,0,deny,66,66,0,1,0,1,0
24212,21247,0,0,deny,146,146,0,1,0,1,0
56752,44847,0,0,deny,66,66,0,1,0,1,0
64741,53,21274,53,allow,198,86,112,2,29,1,1
50379,53,12803,53,allow,197,102,95,2,30,1,1
63497,445,0,0,drop,70,70,0,1,0,1,0
61788,445,0,0,drop,70,70,0,1,0,1,0
62073,443,32648,443,allow,9559,3243,6316,28,46,16,12
58427,53,30619,53,allow,197,94,103,2,30,1,1
49695,53,29724,53,allow,240,102,138,2,30,1,1
49847,23,0,0,deny,60,60,0,1,0,1,0
57884,443,11734,443,allow,7668,2540,5128,22,155,12,10
33461,443,33205,443,allow,8366,3900,4466,19,120,10,9
59945,443,18013,443,allow,10477,3435,7042,34,20,18,16
50307,80,5299,80,allow,2840,1750,1090,13,82,7,6
28973,30188,0,0,deny,66,66,0,1,0,1,0
65152,53,13983,53,allow,167,86,81,2,30,1,1
38053,50584,0,0,deny,62,62,0,1,0,1,0
13287,16933,0,0,deny,62,62,0,1,0,1,0
35691,123,42659,123,allow,184,94,90,2,30,1,1
49248,80,49248,80,allow,163556,12140,151416,207,22,97,110
45941,23386,0,0,deny,60,60,0,1,0,1,0
60492,443,48948,443,allow,81016,8373,72643,122,339,57,65
41636,123,47665,123,allow,184,94,90,2,30,1,1
52924,443,50522,443,allow,21789,7672,14117,78,115,39,39
63033,53,19877,53,allow,304,86,218,2,30,1,1
52460,445,0,0,drop,70,70,0,1,0,1,0
64191,44847,0,0,deny,66,66,0,1,0,1,0
49418,53,32330,53,allow,165,86,79,2,29,1,1
53419,445,0,0,drop,70,70,0,1,0,1,0
32837,443,39597,443,allow,3167,1498,1669,19,315,10,9
63569,445,0,0,drop,70,70,0,1,0,1,0
52515,445,0,0,drop,70,70,0,1,0,1,0
49418,27016,5778,27016,allow,263,78,185,2,29,1,1
56395,53,7674,53,allow,177,94,83,2,30,1,1
64074,34067,2832,34067,allow,312,132,180,6,6,3,3
56621,443,14784,443,allow,1327,918,409,10,26,6,4
50174,445,0,0,drop,66,66,0,1,0,1,0
53011,80,53011,80,allow,349769,6527,343242,368,22,100,268
40685,80,25851,80,allow,1278,774,504,12,360,7,5
57234,21247,0,0,deny,66,66,0,1,0,1,0
64311,53,39516,53,allow,199,102,97,2,30,1,1
55700,443,30597,443,allow,10286,1326,8960,25,1017,8,17
37455,50584,0,0,deny,66,66,0,1,0,1,0
56782,53,53429,53,allow,194,99,95,2,30,1,1
57109,445,0,0,drop,66,66,0,1,0,1,0
49545,53,14394,53,allow,195,102,93,2,29,1,1
64722,53,27260,53,allow,184,94,90,2,30,1,1
53135,14297,49248,14297,allow,70,70,0,1,5,1,0
59277,445,0,0,drop,70,70,0,1,0,1,0
50339,53,28610,53,allow,498,204,294,6,29,3,3
50345,53,41743,53,allow,193,102,91,2,30,1,1
64106,53,22227,53,allow,309,102,207,4,53,2,2
58656,445,0,0,drop,70,70,0,1,0,1,0
50956,25174,0,0,deny,146,146,0,1,0,1,0
62382,445,0,0,drop,70,70,0,1,0,1,0
16221,50584,0,0,deny,146,146,0,1,0,1,0
60980,5900,0,0,deny,60,60,0,1,0,1,0
56832,445,0,0,drop,66,66,0,1,0,1,0
62454,443,55667,443,allow,18884,4117,14767,37,25,16,21
62972,445,0,0,drop,70,70,0,1,0,1,0
56408,443,56408,443,allow,4373,1466,2907,19,28,11,8
51815,443,62038,443,allow,9061,3443,5618,64,121,27,37
55534,53,6633,53,allow,86,86,0,1,30,1,0
60742,443,40207,443,allow,2258,559,1699,22,120,6,16
37584,443,21310,443,allow,499,425,74,4,0,3,1
54573,445,0,0,drop,70,70,0,1,0,1,0
35550,53,45606,53,allow,164,78,86,2,30,1,1
49951,80,39870,80,allow,1706,505,1201,8,14,5,3
59379,443,58325,443,allow,4518,1784,2734,30,23,15,15
56658,53,53602,53,allow,193,102,91,2,30,1,1
52989,443,57788,443,allow,182945,23135,159810,191,111,63,128
55826,53,30050,53,allow,86,86,0,1,31,1,0
38402,443,34859,443,allow,8119,1962,6157,24,360,11,13
49384,53,22527,53,allow,193,102,91,2,29,1,1
58638,5900,58638,5900,allow,62,62,0,1,5,1,0
58638,5900,0,0,deny,62,62,0,1,0,1,0
64305,445,0,0,drop,70,70,0,1,0,1,0
22904,56205,0,0,deny,146,146,0,1,0,1,0
39200,443,57759,443,allow,8918,2361,6557,35,255,18,17
50537,445,0,0,drop,66,66,0,1,0,1,0
53863,443,62778,443,allow,499,425,74,4,1,3,1
60377,65054,58961,65054,allow,624,318,306,10,15,5,5
52555,445,0,0,drop,66,66,0,1,0,1,0
57864,445,0,0,drop,70,70,0,1,0,1,0
27005,27015,28442,27015,allow,881,126,755,2,31,1,1
49727,443,62181,443,allow,1461,761,700,15,130,8,7
62524,445,0,0,drop,70,70,0,1,0,1,0
65011,53,59179,53,allow,168,86,82,2,30,1,1
11136,19910,0,0,deny,62,62,0,1,0,1,0
34354,80,61619,80,allow,350,210,140,6,15,4,2
65293,53,50670,53,allow,94,94,0,1,30,1,0
55380,53,32660,53,allow,289,97,192,4,44,2,2
58760,445,0,0,drop,70,70,0,1,0,1,0
59728,80,65227,80,allow,821011,16040,804971,778,100,238,540
39207,80,25613,80,allow,78,78,0,1,5,1,0
65325,53,33633,53,allow,216,110,106,2,29,1,1
53992,445,0,0,drop,66,66,0,1,0,1,0
51441,443,28224,443,allow,322,66,256,6,16,2,4
61535,445,0,0,drop,66,66,0,1,0,1,0
57470,41813,46944,41813,allow,519,166,353,2,1200,1,1
9521,443,4635,443,allow,7231,1442,5789,21,30,10,11
26180,35440,0,0,deny,66,66,0,1,0,1,0
53447,44847,0,0,deny,62,62,0,1,0,1,0
47201,44847,0,0,deny,66,66,0,1,0,1,0
43356,443,48473,443,allow,79561,11513,68048,183,94,95,88
56979,53,50230,53,allow,209,110,99,2,30,1,1
49699,53,17835,53,allow,266,89,177,4,58,2,2
64544,53,63880,53,allow,199,94,105,2,30,1,1
49001,55108,0,0,deny,160,160,0,1,0,1,0
57060,50584,0,0,deny,62,62,0,1,0,1,0
47166,443,47166,443,allow,4567,1660,2907,19,28,11,8
55235,53,18331,53,allow,178,94,84,2,29,1,1
55678,32468,0,0,deny,66,66,0,1,0,1,0
8023,64147,0,0,deny,146,146,0,1,0,1,0
0,0,0,0,deny,110,110,0,1,0,1,0
1925,53,9734,53,allow,210,78,132,2,30,1,1
50447,80,50342,80,allow,67694,29654,38040,85,37,40,45
58638,5900,0,0,deny,62,62,0,1,0,1,0
64078,54561,14823,54561,allow,70,70,0,1,4,1,0
65206,53,7977,53,allow,167,86,81,2,30,1,1
64579,53,27350,53,allow,178,94,84,2,30,1,1
59772,443,48331,443,allow,181413,11493,169920,167,85,41,126
51354,445,0,0,drop,70,70,0,1,0,1,0
64313,53,9214,53,allow,226,110,116,2,30,1,1
62487,443,47119,443,allow,14840,3978,10862,32,33,15,17
49600,80,7933,80,allow,312,192,120,6,41,4,2
57015,25174,0,0,deny,66,66,0,1,0,1,0
62952,35440,0,0,deny,66,66,0,1,0,1,0
60901,443,60901,443,allow,24367,4634,19733,52,49,26,26
13168,35440,0,0,deny,66,66,0,1,0,1,0
49677,25174,0,0,deny,62,62,0,1,0,1,0
65107,53,20258,53,allow,266,87,179,4,32,2,2
54011,22114,0,0,deny,62,62,0,1,0,1,0
65520,53,2299,53,allow,379,94,285,2,30,1,1
53737,443,15661,443,allow,499,425,74,4,0,3,1
44886,23,0,0,deny,60,60,0,1,0,1,0
55383,53,49153,53,allow,177,94,83,2,29,1,1
56951,53,31350,53,allow,199,102,97,2,30,1,1
50584,6889,50435,6889,allow,1326,300,1026,6,1200,3,3
61288,445,0,0,drop,70,70,0,1,0,1,0
50973,445,0,0,drop,70,70,0,1,0,1,0
7231,53,7231,53,allow,215,80,135,2,33,1,1
55684,80,48603,80,allow,70,70,0,1,5,1,0
6881,6881,0,0,deny,62,62,0,1,0,1,0
7275,13487,0,0,allow,66,66,0,1,91,1,0
6882,41923,41297,41923,allow,492,150,342,2,1200,1,1
58325,53,35330,53,allow,251,79,172,2,30,1,1
54143,7000,54143,7000,allow,770727,19843,750884,802,16,295,507
50600,80,50600,80,allow,4262,3329,933,17,19,9,8
10265,64147,0,0,deny,66,66,0,1,0,1,0
54619,445,0,0,drop,70,70,0,1,0,1,0
56772,53,56028,53,allow,168,86,82,2,30,1,1
27995,22114,0,0,deny,146,146,0,1,0,1,0
53817,443,41947,443,allow,499,425,74,4,0,3,1
40078,44847,0,0,deny,62,62,0,1,0,1,0
56775,53,1038,53,allow,733,85,648,2,30,1,1
50316,25604,0,0,deny,66,66,0,1,0,1,0
52067,445,0,0,drop,70,70,0,1,0,1,0
59822,56205,0,0,deny,66,66,0,1,0,1,0
52147,30265,61743,30265,allow,66,66,0,1,5,1,0
55879,53,40028,53,allow,184,94,90,2,30,1,1
17750,14132,3203,14132,allow,150,150,0,1,1200,1,0
53063,80,2438,80,allow,2725,1228,1497,24,90,13,11
53226,80,34049,80,allow,1054,602,452,10,20,5,5
51604,443,37096,443,allow,7086,2173,4913,20,16,10,10
11599,25174,0,0,deny,146,146,0,1,0,1,0
64837,53,3342,53,allow,190,97,93,2,31,1,1
61818,80,36349,80,allow,4454,591,3863,12,45,6,6
40418,25174,0,0,deny,62,62,0,1,0,1,0
49290,445,0,0,drop,70,70,0,1,0,1,0
55495,53,24897,53,allow,305,94,211,2,30,1,1
65507,53,7082,53,allow,229,102,127,2,30,1,1
46495,4607,0,0,deny,60,60,0,1,0,1,0
50424,55777,0,0,deny,62,62,0,1,0,1,0
64884,53,2199,53,allow,190,97,93,2,31,1,1
55293,445,0,0,drop,66,66,0,1,0,1,0
11582,41599,27860,41599,allow,70,70,0,2,8,2,0
53770,64147,0,0,deny,66,66,0,1,0,1,0
56955,53,1466,53,allow,183,94,89,2,30,1,1
64981,445,0,0,drop,70,70,0,1,0,1,0
63554,44847,0,0,deny,62,62,0,1,0,1,0
49622,53,45379,53,allow,185,102,83,2,30,1,1
56516,445,0,0,drop,66,66,0,1,0,1,0
53536,445,0,0,drop,66,66,0,1,0,1,0
27195,21247,0,0,deny,146,146,0,1,0,1,0
51607,445,0,0,drop,70,70,0,1,0,1,0
37965,51413,62222,51413,allow,158,158,0,1,1200,1,0
63777,80,2556,80,allow,314,192,122,6,15,4,2
6881,6881,48136,6881,allow,238,118,120,2,1200,1,1
50413,80,12074,80,allow,8388,2010,6378,17,23,8,9
42446,123,14987,123,allow,184,94,90,2,30,1,1
65306,443,3584,443,allow,5756,1781,3975,23,136,11,12
51239,443,46781,443,allow,9649,4615,5034,42,16,24,18
65419,26467,0,0,deny,62,62,0,1,0,1,0
51867,53,1821,53,allow,179,86,93,2,30,1,1
50355,43890,0,0,deny,66,66,0,1,0,1,0
53546,17203,56777,17203,allow,320,140,180,6,7,3,3
6881,26296,0,0,deny,143,143,0,1,0,1,0
10011,40005,27073,40005,allow,148,86,62,2,30,1,1
48736,443,16569,443,allow,371295,17988,353307,571,40,233,338
49628,443,14591,443,allow,12843,3808,9035,26,81,13,13
58725,7302,0,0,deny,66,66,0,1,0,1,0
51922,18413,55909,18413,allow,70,70,0,2,8,2,0
8389,80,8389,80,allow,1700,1073,627,15,84,8,7
43208,443,45939,443,allow,4296557,96359,4200198,3781,143,838,2943
50073,443,21032,443,allow,9873,2384,7489,25,242,14,11
59799,443,59799,443,allow,4666,1759,2907,19,28,11,8
50946,44847,0,0,deny,62,62,0,1,0,1,0
50875,53,21370,53,allow,78,78,0,1,30,1,0
53395,445,0,0,drop,70,70,0,1,0,1,0
59845,443,19704,443,allow,14702,1976,12726,28,18,10,18
64715,53,60767,53,allow,315,98,217,4,58,2,2
51202,53,51202,53,allow,221,89,132,2,30,1,1
53003,11392,0,0,deny,66,66,0,1,0,1,0
61911,3855,0,0,deny,146,146,0,1,0,1,0
0,0,0,0,deny,156,156,0,2,0,2,0
64995,53,32224,53,allow,210,110,100,2,30,1,1
38334,53,4428,53,allow,168,78,90,2,31,1,1
57368,7302,0,0,deny,66,66,0,1,0,1,0
39703,443,48474,443,allow,4719,2313,2406,15,132,7,8
65215,445,0,0,drop,66,66,0,1,0,1,0
60362,445,0,0,drop,70,70,0,1,0,1,0
61423,445,0,0,drop,70,70,0,1,0,1,0
56350,53,30997,53,allow,287,102,185,2,30,1,1
49326,445,0,0,drop,70,70,0,1,0,1,0
62499,445,0,0,drop,70,70,0,1,0,1,0
55877,1049,50494,1049,allow,323,150,173,2,1200,1,1
44805,3389,44805,3389,allow,4870,2631,2239,23,19,13,10
51374,30317,0,0,deny,66,66,0,1,0,1,0
52615,445,0,0,drop,66,66,0,1,0,1,0
49553,53,5635,53,allow,614,239,375,6,53,3,3
56550,53,61639,53,allow,183,94,89,2,30,1,1
63236,445,0,0,drop,70,70,0,1,0,1,0
50920,445,0,0,drop,70,70,0,1,0,1,0
54280,3398,0,0,deny,60,60,0,1,0,1,0
55336,53,13699,53,allow,295,101,194,4,31,2,2
37387,443,27821,443,allow,64440,16508,47932,101,142,44,57
56910,53,22546,53,allow,199,102,97,2,29,1,1
58638,5900,0,0,deny,62,62,0,1,0,1,0
0,0,0,0,deny,156,156,0,2,0,2,0
52941,443,58388,443,allow,14630,5941,8689,52,115,26,26
54587,53,0,0,allow,82,82,0,1,30,1,0
52003,44512,0,0,deny,66,66,0,1,0,1,0
64149,53,35596,53,allow,301,108,193,4,50,2,2
56883,53,62227,53,allow,184,94,90,2,30,1,1
55760,443,60909,443,allow,12723734,404530,12319204,13539,134,4494,9045
53431,445,0,0,drop,70,70,0,1,0,1,0
49418,27055,11921,27055,allow,269,78,191,2,30,1,1
52912,443,9289,443,allow,41094,14929,26165,126,116,69,57
65412,445,0,0,drop,70,70,0,1,0,1,0
55019,53,16750,53,allow,299,110,189,4,31,2,2
54880,445,0,0,drop,70,70,0,1,0,1,0
34731,22114,0,0,deny,146,146,0,1,0,1,0
44913,80,22574,80,allow,1270,387,883,16,393,4,12
64128,53,11418,53,allow,186,95,91,2,31,1,1
31710,53,31710,53,allow,233,90,143,2,32,1,1
35811,443,26946,443,allow,13562,3104,10458,38,201,22,16
61390,80,4844,80,allow,13706,1388,12318,26,255,14,12
54533,443,7224,443,allow,2638,330,2308,12,135,5,7
62338,443,61578,443,allow,13396186,148566,13247620,10474,59,1498,8976
56415,445,0,0,drop,70,70,0,1,0,1,0
5180,57866,0,0,deny,62,62,0,1,0,1,0
51166,31573,0,0,deny,66,66,0,1,0,1,0
65209,57866,0,0,deny,66,66,0,1,0,1,0
65205,445,0,0,drop,70,70,0,1,0,1,0
37698,443,12829,443,allow,1781,1062,719,16,275,8,8
51889,445,0,0,drop,66,66,0,1,0,1,0
64114,445,0,0,drop,66,66,0,1,0,1,0
60228,443,13572,443,allow,1058,641,417,10,50,6,4
64215,445,0,0,drop,70,70,0,1,0,1,0
1081,1970,0,0,deny,146,146,0,1,0,1,0
65273,445,0,0,drop,70,70,0,1,0,1,0
56528,445,0,0,drop,70,70,0,1,0,1,0
48144,21247,0,0,deny,66,66,0,1,0,1,0
49920,445,0,0,drop,66,66,0,1,0,1,0
49891,53,30480,53,allow,788,108,680,2,31,1,1
49300,443,31684,443,allow,4364,2129,2235,12,121,6,6
60287,53,47078,53,allow,215,86,129,2,30,1,1
55221,443,65521,443,allow,10435,2860,7575,27,46,15,12
63741,50584,0,0,deny,66,66,0,1,0,1,0
8999,1,0,0,deny,146,146,0,1,0,1,0
54899,445,0,0,drop,70,70,0,1,0,1,0
50628,80,65125,80,allow,4349,647,3702,16,22,7,9
1735,80,1735,80,allow,78576,5218,73358,91,95,36,55
63996,45759,44503,45759,allow,70,70,0,1,5,1,0
35809,443,51066,443,allow,13084,2704,10380,36,201,21,15
57434,50584,0,0,deny,62,62,0,1,0,1,0
55082,25174,0,0,deny,66,66,0,1,0,1,0
44774,22114,0,0,deny,62,62,0,1,0,1,0
50545,443,51366,443,allow,9654,1771,7883,27,186,14,13
65323,27047,12346,27047,allow,1233,924,309,6,31,3,3
55445,53,54858,53,allow,96,96,0,2,31,2,0
48274,15000,32911,15000,allow,130,70,60,2,6,1,1
41756,56205,0,0,deny,62,62,0,1,0,1,0
52048,80,14488,80,allow,41486,20844,20642,64,37,32,32
27005,27016,52967,27016,allow,879,126,753,2,30,1,1
56322,53,24189,53,allow,209,110,99,2,30,1,1
58638,5900,0,0,deny,62,62,0,1,0,1,0
33305,53,29793,53,allow,168,78,90,2,30,1,1
34285,80,34285,80,allow,424,198,226,7,141,4,3
61323,23117,0,0,deny,62,62,0,1,0,1,0
61195,56205,0,0,deny,66,66,0,1,0,1,0
26192,23,0,0,deny,60,60,0,1,0,1,0
53656,31573,0,0,deny,62,62,0,1,0,1,0
58981,50584,0,0,deny,146,146,0,1,0,1,0
64457,445,0,0,drop,66,66,0,1,0,1,0
41431,443,28233,443,allow,1843,996,847,17,275,8,9
64933,53,11327,53,allow,349,94,255,2,30,1,1
50422,50584,0,0,deny,66,66,0,1,0,1,0
61345,21247,0,0,deny,66,66,0,1,0,1,0
58638,5900,0,0,deny,62,62,0,1,0,1,0
53228,443,53228,443,allow,4456,2436,2020,19,24,10,9
55713,25174,0,0,deny,62,62,0,1,0,1,0
50354,56205,0,0,deny,66,66,0,1,0,1,0
54524,445,0,0,drop,66,66,0,1,0,1,0
33171,443,48753,443,allow,6509,973,5536,17,25,10,7
52788,64147,0,0,deny,66,66,0,1,0,1,0
50468,443,35607,443,allow,227265,6450,220815,225,124,63,162
50540,445,0,0,drop,66,66,0,1,0,1,0
54525,445,0,0,drop,70,70,0,1,0,1,0
58006,443,30394,443,allow,9596,1688,7908,26,255,13,13
60003,36829,0,0,deny,66,66,0,1,0,1,0
51964,1103,52197,1103,allow,70,70,0,2,8,2,0
0,0,0,0,deny,156,156,0,2,0,2,0
49706,53,34348,53,allow,258,110,148,2,30,1,1
59193,445,0,0,drop,70,70,0,1,0,1,0
56732,443,47503,443,allow,6205,986,5219,16,48,10,6
57132,53,31918,53,allow,177,94,83,2,30,1,1
57152,53,61515,53,allow,183,94,89,2,29,1,1
57151,39004,0,0,deny,66,66,0,1,0,1,0
38687,443,37401,443,allow,13923,1728,12195,24,16,10,14
61000,15503,0,0,deny,146,146,0,1,0,1,0
61589,21247,0,0,deny,66,66,0,1,0,1,0
49418,27022,63608,27022,allow,229,71,158,2,31,1,1
50750,445,0,0,drop,70,70,0,1,0,1,0
18632,51505,0,0,deny,66,66,0,1,0,1,0
60438,17372,0,0,deny,66,66,0,1,0,1,0
50489,80,24870,80,allow,318,192,126,6,25,4,2
49837,53,47456,53,allow,214,110,104,2,30,1,1
64068,53,47417,53,allow,168,86,82,2,31,1,1
57392,443,57392,443,allow,4729,1822,2907,19,27,11,8
34517,80,7727,80,allow,1056,682,374,10,16,6,4
27005,27018,24466,27018,allow,882,126,756,2,30,1,1
38634,443,16123,443,allow,9096,1676,7420,20,18,10,10
55064,80,48645,80,allow,1646,998,648,13,85,7,6
47040,443,54181,443,allow,10326,4295,6031,29,62,16,13
64124,25174,0,0,deny,146,146,0,1,0,1,0
61184,445,0,0,drop,70,70,0,1,0,1,0
54423,445,0,0,drop,66,66,0,1,0,1,0
64199,50584,0,0,deny,146,146,0,1,0,1,0
59790,44847,0,0,deny,66,66,0,1,0,1,0
51834,35440,0,0,deny,66,66,0,1,0,1,0
15981,23117,0,0,deny,146,146,0,1,0,1,0
65104,445,0,0,drop,70,70,0,1,0,1,0
53718,445,0,0,drop,70,70,0,1,0,1,0
52131,28980,48915,28980,allow,70,70,0,2,8,2,0
35072,53,51638,53,allow,168,78,90,2,30,1,1
57478,445,0,0,drop,70,70,0,1,0,1,0
54280,3398,0,0,deny,60,60,0,1,0,1,0
55759,445,0,0,drop,66,66,0,1,0,1,0
50052,65008,0,0,deny,60,60,0,1,0,1,0
52150,39109,0,0,deny,66,66,0,1,0,1,0
53302,445,0,0,drop,70,70,0,1,0,1,0
54539,80,58817,80,allow,4162,3455,707,14,15,8,6
53948,7370,62549,7370,allow,70,70,0,1,5,1,0
38475,11392,0,0,deny,66,66,0,1,0,1,0
44815,36829,0,0,deny,62,62,0,1,0,1,0
3911,50584,0,0,deny,62,62,0,1,0,1,0
43584,24748,0,0,deny,156,156,0,1,0,1,0
65278,53,45335,53,allow,264,110,154,2,30,1,1
64330,53,10524,53,allow,193,102,91,2,30,1,1
49492,53,41002,53,allow,199,102,97,2,31,1,1
54883,60043,0,0,deny,62,62,0,1,0,1,0
57909,443,27742,443,allow,2653,1558,1095,18,124,10,8
6881,6881,0,0,deny,146,146,0,1,0,1,0
59609,445,0,0,drop,66,66,0,1,0,1,0
51434,445,0,0,drop,70,70,0,1,0,1,0
57428,443,23700,443,allow,6277,1727,4550,16,75,9,7
62642,25174,0,0,deny,66,66,0,1,0,1,0
50006,53,41506,53,allow,994,86,908,2,29,1,1
47053,5228,30906,5228,allow,11647,2439,9208,47,3724,21,26
55452,53,54913,53,allow,184,94,90,2,30,1,1
64334,25174,0,0,deny,66,66,0,1,0,1,0
44293,23,0,0,deny,60,60,0,1,0,1,0
57225,445,0,0,drop,70,70,0,1,0,1,0
13654,50584,0,0,deny,146,146,0,1,0,1,0
443,9986,0,0,deny,66,66,0,1,0,1,0
6881,5903,6718,5903,allow,501,150,351,2,1200,1,1
51221,57254,65381,57254,allow,491,150,341,2,1200,1,1
53280,443,38767,443,allow,4228,1083,3145,15,31,8,7
54977,445,0,0,drop,70,70,0,1,0,1,0
64059,80,17237,80,allow,374,192,182,7,15,4,3
53918,53,0,0,allow,222,82,140,2,30,1,1
55637,27816,50457,27816,allow,316,190,126,5,15,3,2
19875,30170,0,0,deny,145,145,0,1,0,1,0
19875,30170,0,0,deny,145,145,0,1,0,1,0
49612,80,42484,80,allow,1388,562,826,11,315,6,5
19473,6889,63001,6889,allow,480,149,331,2,1200,1,1
50405,80,63982,80,allow,4530,3395,1135,15,32,8,7
53614,443,10121,443,allow,8347,1979,6368,32,19,17,15
49771,53,61386,53,allow,86,86,0,1,30,1,0
63888,57470,0,0,deny,62,62,0,1,0,1,0
20844,64147,0,0,deny,66,66,0,1,0,1,0
57158,445,0,0,drop,66,66,0,1,0,1,0
50439,80,50439,80,allow,96018,5956,90062,107,20,41,66
2938,64147,0,0,deny,62,62,0,1,0,1,0
35558,15503,0,0,deny,66,66,0,1,0,1,0
52288,445,0,0,drop,70,70,0,1,0,1,0
27005,27015,40771,27015,allow,1618,126,1492,4,31,2,2
56225,445,0,0,drop,70,70,0,1,0,1,0
57416,53,8404,53,allow,193,102,91,2,29,1,1
53206,443,65067,443,allow,3656,2345,1311,18,17,9,9
56126,53,32815,53,allow,183,94,89,2,30,1,1
55658,45261,61900,45261,allow,70,70,0,1,5,1,0
49359,64147,0,0,deny,66,66,0,1,0,1,0
49897,443,33898,443,allow,8586,1352,7234,27,34,13,14
51221,63128,42268,63128,allow,480,149,331,2,1201,1,1
64911,53,26816,53,allow,209,110,99,2,31,1,1
65134,445,0,0,drop,70,70,0,1,0,1,0
42732,57470,0,0,deny,62,62,0,1,0,1,0
55830,53,46828,53,allow,183,94,89,2,30,1,1
24040,22114,0,0,deny,62,62,0,1,0,1,0
52870,22197,0,0,deny,66,66,0,1,0,1,0
57863,443,52780,443,allow,1981,1155,826,19,86,10,9
62493,50584,0,0,deny,62,62,0,1,0,1,0
17750,51965,19962,51965,allow,150,150,0,1,1200,1,0
64331,53,48009,53,allow,179,94,85,2,29,1,1
51913,80,58997,80,allow,366,240,126,7,29,5,2
58638,5900,58638,5900,allow,130,66,64,2,4,1,1
56464,53,58795,53,allow,177,94,83,2,30,1,1
13285,29892,0,0,deny,145,145,0,1,0,1,0
51923,443,5090,443,allow,8964,6357,2607,44,163,23,21
59326,80,59326,80,allow,109128,4773,104355,197,16,68,129
37774,443,33221,443,allow,282171,13444,268727,377,201,175,202
57649,6881,0,0,deny,146,146,0,1,0,1,0
49824,53,29358,53,allow,178,94,84,2,31,1,1
64605,53,20190,53,allow,183,94,89,2,31,1,1
42318,53,4117,53,allow,164,78,86,2,30,1,1
13907,57470,0,0,deny,66,66,0,1,0,1,0
51414,22,0,0,deny,60,60,0,1,0,1,0
35849,30188,0,0,deny,62,62,0,1,0,1,0
61655,445,0,0,drop,66,66,0,1,0,1,0
61361,443,55767,443,allow,9604,5021,4583,29,86,15,14
52110,445,0,0,drop,70,70,0,1,0,1,0
50227,57470,0,0,deny,62,62,0,1,0,1,0
18116,37807,0,0,deny,66,66,0,1,0,1,0
9339,443,39172,443,allow,3614,434,3180,11,15,6,5
49593,5228,25502,5228,allow,9720,2717,7003,67,1019,34,33
55040,443,51805,443,allow,36648,3634,33014,51,62,23,28
19983,18242,0,0,reset-both,146,146,0,1,0,1,0
58763,443,45079,443,allow,5108,700,4408,15,15,7,8
52169,443,53007,443,allow,7905,4819,3086,27,139,13,14
41464,443,7904,443,allow,3978,2714,1264,24,83,13,11
65198,445,0,0,drop,66,66,0,1,0,1,0
61268,445,0,0,drop,70,70,0,1,0,1,0
59274,445,0,0,drop,66,66,0,1,0,1,0
59187,445,0,0,drop,70,70,0,1,0,1,0
65501,445,0,0,drop,70,70,0,1,0,1,0
50478,80,37121,80,allow,2869,1173,1696,11,21,6,5
57410,25174,0,0,deny,62,62,0,1,0,1,0
49158,443,4149,443,allow,3655,1807,1848,17,15,9,8
61495,37965,0,0,deny,66,66,0,1,0,1,0
57602,443,32129,443,allow,7527,1788,5739,23,20,13,10
6881,6881,1541,6881,allow,237,118,119,2,1200,1,1
56698,443,46123,443,allow,8058,2038,6020,20,15,11,9
11878,37807,0,0,deny,62,62,0,1,0,1,0
60240,445,0,0,drop,66,66,0,1,0,1,0
50941,443,22406,443,allow,12831,2277,10554,37,145,17,20
63776,445,0,0,drop,70,70,0,1,0,1,0
64059,445,0,0,drop,70,70,0,1,0,1,0
13285,29892,0,0,deny,145,145,0,1,0,1,0
55991,53,2664,53,allow,199,102,97,2,30,1,1
53431,80,15544,80,allow,1638,1324,314,10,15,5,5
50142,443,40604,443,allow,9040,2349,6691,22,64,13,9
16387,35244,0,0,deny,60,60,0,1,0,1,0
55981,80,16434,80,allow,824,469,355,9,360,5,4
50996,445,0,0,drop,66,66,0,1,0,1,0
45099,443,21949,443,allow,94099,5885,88214,140,104,69,71
61804,51505,0,0,deny,66,66,0,1,0,1,0
63849,16632,40129,16632,allow,66,66,0,1,5,1,0
57362,53,9411,53,allow,346,102,244,2,31,1,1
50314,31652,0,0,allow,66,66,0,1,90,1,0
64602,53,49677,53,allow,184,94,90,2,30,1,1
50916,80,44611,80,allow,11456216,116932,11339284,9298,139,1683,7615
50272,443,27135,443,allow,772,432,340,12,18,7,5
55468,53,52823,53,allow,754,94,660,2,31,1,1
65428,53,61145,53,allow,195,102,93,2,30,1,1
52916,443,43880,443,allow,5455,1388,4067,17,15,9,8
50326,46824,0,0,deny,66,66,0,1,0,1,0
64835,53,56147,53,allow,200,102,98,2,31,1,1
37556,16386,44427,16386,allow,432,192,240,8,30,4,4
32299,40034,44134,40034,allow,253,190,63,2,31,1,1
50064,443,49945,443,allow,4118,2209,1909,36,239,21,15
5223,1210,0,0,deny,103,103,0,1,0,1,0
57115,53,1229,53,allow,178,94,84,2,30,1,1
6666,44818,0,0,deny,60,60,0,1,0,1,0
63761,25933,42159,25933,allow,436,254,182,7,15,4,3
50933,80,44380,80,allow,9932735,85391,9847344,7875,123,1237,6638
57470,43576,31912,43576,allow,545,166,379,2,1200,1,1
13868,53,13868,53,allow,215,80,135,2,34,1,1
55688,53,8374,53,allow,184,94,90,2,30,1,1
27996,80,2657,80,allow,2058,589,1469,10,45,6,4
61375,445,0,0,drop,70,70,0,1,0,1,0
65463,445,0,0,drop,66,66,0,1,0,1,0
56272,53,26836,53,allow,186,95,91,2,31,1,1
27005,27017,24115,27017,allow,880,126,754,2,30,1,1
50283,445,0,0,drop,70,70,0,1,0,1,0
50216,443,23002,443,allow,6796,1796,5000,26,257,14,12
44921,53,22635,53,allow,168,78,90,2,30,1,1
49820,53,16935,53,allow,193,102,91,2,29,1,1
64069,443,44966,443,allow,11223,3362,7861,62,280,27,35
60438,53,9919,53,allow,77,77,0,2,31,2,0
37965,24475,30249,24475,allow,480,149,331,2,1200,1,1
55784,53,2771,53,allow,184,94,90,2,30,1,1
64421,53,32983,53,allow,178,94,84,2,29,1,1
57313,443,59852,443,allow,134,60,74,3,5,2,1
38716,443,32682,443,allow,90273,3481,86792,96,15,31,65
57345,445,0,0,drop,70,70,0,1,0,1,0
30861,46783,0,0,deny,62,62,0,1,0,1,0
26900,27017,20527,27017,allow,422,164,258,6,30,3,3
43261,53,43261,53,allow,247,98,149,2,34,1,1
45908,33330,0,0,deny,60,60,0,1,0,1,0
49708,443,54037,443,allow,456387,11878,444509,427,81,121,306
50018,445,0,0,drop,66,66,0,1,0,1,0
55620,53,11702,53,allow,177,94,83,2,29,1,1
52340,64147,0,0,deny,66,66,0,1,0,1,0
57307,443,55707,443,allow,35035,5135,29900,81,216,33,48
56955,80,64782,80,allow,214,140,74,4,30,3,1
57829,445,0,0,drop,70,70,0,1,0,1,0
46981,443,34961,443,allow,2809,1884,925,19,25,11,8
49278,445,0,0,drop,70,70,0,1,0,1,0
49481,7000,49481,7000,allow,3066,1675,1391,16,14,9,7
4483,53,4483,53,allow,213,87,126,2,31,1,1
57281,53,33051,53,allow,178,94,84,2,30,1,1
56858,32330,62382,32330,allow,70,70,0,2,8,2,0
10151,19083,54566,19083,allow,489,149,340,2,1200,1,1
50560,80,54497,80,allow,318,192,126,6,26,4,2
52946,80,56196,80,allow,4085,2870,1215,23,358,14,9
50272,53,9644,53,allow,744,95,649,2,30,1,1
52682,22114,0,0,deny,66,66,0,1,0,1,0
10921,19847,0,0,deny,62,62,0,1,0,1,0
49693,53,49502,53,allow,209,110,99,2,30,1,1
53134,42369,45499,42369,allow,70,70,0,2,8,2,0
60606,445,0,0,drop,70,70,0,1,0,1,0
52533,445,0,0,drop,66,66,0,1,0,1,0
16424,55108,0,0,deny,145,145,0,1,0,1,0
62550,51505,0,0,deny,66,66,0,1,0,1,0
54216,64147,0,0,deny,66,66,0,1,0,1,0
49721,445,0,0,drop,70,70,0,1,0,1,0
49223,443,17029,443,allow,14838,6995,7843,52,244,26,26
59809,445,0,0,drop,66,66,0,1,0,1,0
50598,80,50598,80,allow,10463,6606,3857,36,27,20,16
49291,53,26536,53,allow,277,110,167,2,30,1,1
60055,445,0,0,drop,70,70,0,1,0,1,0
64687,53,9775,53,allow,183,94,89,2,29,1,1
59874,22114,0,0,deny,146,146,0,1,0,1,0
57620,445,0,0,drop,70,70,0,1,0,1,0
49160,38098,52628,38098,allow,676,367,309,6,1200,3,3
51880,8001,36976,8001,allow,86,86,0,1,30,1,0
58725,10387,0,0,deny,145,145,0,1,0,1,0
58888,23718,0,0,deny,66,66,0,1,0,1,0
10013,443,27326,443,allow,10336,4760,5576,37,315,18,19
55138,53,34113,53,allow,165,86,79,2,30,1,1
53746,445,0,0,drop,70,70,0,1,0,1,0
53764,443,56074,443,allow,499,425,74,4,0,3,1
13980,23,0,0,deny,60,60,0,1,0,1,0
58638,5900,0,0,deny,62,62,0,1,0,1,0
52738,443,34014,443,allow,56339,3530,52809,79,26,39,40
52235,443,52235,443,allow,4892,844,4048,19,21,9,10
65189,53,46273,53,allow,328,93,235,4,29,2,2
64022,53,48680,53,allow,197,102,95,2,31,1,1
51793,12210,40752,12210,allow,70,70,0,2,8,2,0
50378,53,37644,53,allow,167,78,89,2,30,1,1
63043,445,0,0,drop,70,70,0,1,0,1,0
50538,80,28093,80,allow,4314,3518,796,15,32,8,7
7100,53,7100,53,allow,644,90,554,2,30,1,1
50695,80,60576,80,allow,58726,30286,28440,246,175,123,123
55974,53,19851,53,allow,762,98,664,2,30,1,1
58855,80,59829,80,allow,1601,902,699,8,387,5,3
57994,443,19602,443,allow,14465,1797,12668,30,170,14,16
64683,445,0,0,drop,66,66,0,1,0,1,0
62728,445,0,0,drop,66,66,0,1,0,1,0
51658,80,20246,80,allow,44842,2446,42396,73,255,34,39
58808,443,58470,443,allow,5167,700,4467,16,15,7,9
49300,443,11217,443,allow,26747,8027,18720,58,92,25,33
59111,443,56216,443,allow,10912,6095,4817,28,17,15,13
57850,445,0,0,drop,70,70,0,1,0,1,0
19875,30170,0,0,deny,145,145,0,1,0,1,0
23383,64147,0,0,deny,62,62,0,1,0,1,0
55194,53,21353,53,allow,195,102,93,2,29,1,1
60482,445,0,0,drop,70,70,0,1,0,1,0
56701,53,54684,53,allow,211,110,101,2,30,1,1
50193,3389,50193,3389,allow,3409,1454,1955,16,16,8,8
65275,53,60428,53,allow,807,94,713,2,30,1,1
56427,443,19838,443,allow,9901,1298,8603,19,79,10,9
59009,445,0,0,drop,70,70,0,1,0,1,0
32491,15503,0,0,deny,66,66,0,1,0,1,0
64771,53,46292,53,allow,793,101,692,2,30,1,1
58679,53,27207,53,allow,298,102,196,2,29,1,1
55081,53,46160,53,allow,209,102,107,2,30,1,1
55786,53,31916,53,allow,102,102,0,1,30,1,0
38662,15000,56543,15000,allow,138,78,60,2,6,1,1
58638,5900,58638,5900,allow,66,66,0,1,4,1,0
60117,50934,0,0,deny,66,66,0,1,0,1,0
57761,30317,0,0,deny,66,66,0,1,0,1,0
52269,445,0,0,drop,70,70,0,1,0,1,0
65168,53,45025,53,allow,749,94,655,2,30,1,1
63024,53,42862,53,allow,569,164,405,2,30,1,1
55313,53,12662,53,allow,168,78,90,2,29,1,1
26900,27017,12136,27017,allow,422,164,258,6,30,3,3
56743,445,0,0,drop,70,70,0,1,0,1,0
53961,13067,4497,13067,allow,70,70,0,1,5,1,0
55228,53,59087,53,allow,212,102,110,2,30,1,1
63983,53,48725,53,allow,447,94,353,4,54,2,2
36788,443,36788,443,allow,4555,1648,2907,19,29,11,8
49949,80,34072,80,allow,16663,923,15740,25,15,11,14
60091,443,19389,443,allow,2531,1288,1243,17,140,9,8
64856,53,10911,53,allow,755,93,662,2,31,1,1
58638,5900,0,0,deny,62,62,0,1,0,1,0
33305,443,50193,443,allow,1067,650,417,10,73,6,4
55274,445,0,0,drop,66,66,0,1,0,1,0
59743,80,42514,80,allow,815748,15896,799852,777,90,244,533
50605,443,56643,443,allow,1766,975,791,15,71,9,6
39461,53,45858,53,allow,168,78,90,2,30,1,1
27005,26259,41193,26259,allow,889,126,763,2,31,1,1
57339,445,0,0,drop,70,70,0,1,0,1,0
51887,445,0,0,drop,66,66,0,1,0,1,0
63229,445,0,0,drop,70,70,0,1,0,1,0
59513,53,30834,53,allow,212,92,120,2,30,1,1
52925,64147,0,0,deny,62,62,0,1,0,1,0
56734,443,60875,443,allow,7889,1900,5989,20,15,11,9
59027,445,0,0,drop,70,70,0,1,0,1,0
65228,53,0,0,deny,88,88,0,1,0,1,0
39414,443,32057,443,allow,4179,1480,2699,18,124,9,9
64036,23718,0,0,deny,66,66,0,1,0,1,0
45908,3383,0,0,deny,60,60,0,1,0,1,0
64957,53,47584,53,allow,192,98,94,2,30,1,1
55549,53,24179,53,allow,209,110,99,2,29,1,1
20706,23718,0,0,deny,66,66,0,1,0,1,0
58638,5900,0,0,deny,62,62,0,1,0,1,0
50535,53,14934,53,allow,210,110,100,2,29,1,1
55018,53,64174,53,allow,312,89,223,4,36,2,2
50710,443,41434,443,allow,6141,1268,4873,22,18,12,10
55654,18251,23263,18251,allow,70,70,0,2,8,2,0
49671,53,34167,53,allow,242,110,132,2,30,1,1
59630,445,0,0,drop,66,66,0,1,0,1,0
2995,26467,0,0,deny,62,62,0,1,0,1,0
53453,443,41566,443,allow,6824,2097,4727,19,15,11,8
49418,27015,24624,27015,allow,78,78,0,1,30,1,0
53374,443,16272,443,allow,4317,1134,3183,16,26,9,7
58009,80,11441,80,allow,495,192,303,6,21,4,2
37694,5228,64819,5228,allow,6930,1665,5265,18,3601,9,9
64671,445,0,0,drop,70,70,0,1,0,1,0
40022,443,32042,443,allow,6073,1628,4445,23,15,12,11
54336,445,0,0,drop,66,66,0,1,0,1,0
61537,445,0,0,drop,66,66,0,1,0,1,0
49941,443,34505,443,allow,8754,2895,5859,26,16,15,11
52077,445,0,0,drop,70,70,0,1,0,1,0
52635,445,0,0,drop,70,70,0,1,0,1,0
63868,60392,39941,60392,allow,66,66,0,2,7,2,0
59543,445,0,0,drop,70,70,0,1,0,1,0
50419,443,44835,443,allow,4590,575,4015,14,28,6,8
64965,53,42321,53,allow,200,94,106,2,31,1,1
54070,445,0,0,drop,66,66,0,1,0,1,0
50151,80,25475,80,allow,1915831,46544,1869287,1569,166,311,1258
42020,80,16578,80,allow,42657,2962,39695,68,38,36,32
55007,53,23960,53,allow,166,86,80,2,29,1,1
56825,53,56167,53,allow,177,94,83,2,30,1,1
50375,443,2479,443,allow,5419,705,4714,16,25,8,8
65479,445,0,0,drop,70,70,0,1,0,1,0
55592,53,16143,53,allow,817,98,719,2,30,1,1
16387,26637,0,0,allow,60,60,0,1,61,1,0
49558,53,61665,53,allow,423,104,319,4,39,2,2
60885,443,21890,443,allow,3855,2679,1176,28,45,15,13
64811,445,0,0,drop,70,70,0,1,0,1,0
61600,56205,0,0,deny,66,66,0,1,0,1,0
49849,53,14013,53,allow,192,98,94,2,31,1,1
6355,25174,0,0,deny,62,62,0,1,0,1,0
30945,53,30945,53,allow,237,91,146,2,32,1,1
50936,445,0,0,drop,66,66,0,1,0,1,0
63744,47106,38855,47106,allow,66,66,0,2,8,2,0
443,4205,0,0,deny,187,187,0,1,0,1,0
54489,53,0,0,allow,418,154,264,4,33,2,2
11552,44847,0,0,deny,62,62,0,1,0,1,0
55979,53,61976,53,allow,275,110,165,2,30,1,1
65004,53,7635,53,allow,261,102,159,2,30,1,1
65143,445,0,0,drop,66,66,0,1,0,1,0
22376,443,22376,443,allow,6620,3193,3427,23,26,13,10
45535,25174,0,0,deny,66,66,0,1,0,1,0
62739,21416,0,0,deny,145,145,0,1,0,1,0
58867,445,0,0,drop,66,66,0,1,0,1,0
53166,80,34843,80,allow,1487,838,649,10,323,6,4
55146,53,27596,53,allow,178,91,87,2,31,1,1
2049,32480,0,0,deny,66,66,0,1,0,1,0
57275,53,13596,53,allow,193,102,91,2,31,1,1
51015,64147,0,0,deny,62,62,0,1,0,1,0
40175,80,8302,80,allow,130,70,60,2,15,1,1
55144,443,5039,443,allow,3522,869,2653,13,121,6,7
50560,443,20442,443,allow,17710,10880,6830,44,271,25,19
62780,35440,0,0,deny,66,66,0,1,0,1,0
51391,443,62057,443,allow,9973,1941,8032,38,121,19,19
51026,37450,0,0,deny,66,66,0,1,0,1,0
52098,29067,36738,29067,allow,70,70,0,2,7,2,0
443,44683,0,0,deny,83,83,0,1,0,1,0
49933,80,49306,80,allow,1130,613,517,11,15,6,5
55408,64147,0,0,deny,66,66,0,1,0,1,0
63423,445,0,0,drop,70,70,0,1,0,1,0
53144,443,6960,443,allow,7121,2564,4557,26,127,15,11
56367,53,38735,53,allow,194,102,92,2,30,1,1
47105,64147,0,0,deny,62,62,0,1,0,1,0
55417,53,15668,53,allow,179,94,85,2,31,1,1
14084,43890,0,0,deny,146,146,0,1,0,1,0
49157,53,49157,53,allow,229,89,140,2,31,1,1
60372,80,60372,80,allow,186272,9792,176480,216,21,93,123
54965,80,28312,80,allow,3419,2046,1373,12,515,7,5
56435,53,21877,53,allow,193,102,91,2,30,1,1
59082,445,0,0,drop,70,70,0,1,0,1,0
51492,80,15284,80,allow,1517,481,1036,11,15,6,5
59833,53,30174,53,allow,377,86,291,2,29,1,1
60007,443,50307,443,allow,2798,1652,1146,15,143,8,7
443,29326,0,0,deny,82,82,0,1,0,1,0
55176,53,15853,53,allow,181,94,87,2,30,1,1
64257,53,61085,53,allow,211,78,133,2,30,1,1
8069,80,8069,80,allow,638,306,332,11,84,6,5
53374,445,0,0,drop,70,70,0,1,0,1,0
50561,80,50561,80,allow,1695,995,700,11,21,6,5
51245,445,0,0,drop,66,66,0,1,0,1,0
61123,80,61123,80,allow,21678,2120,19558,33,20,16,17
50240,445,0,0,drop,70,70,0,1,0,1,0
58961,80,48953,80,allow,5412,4758,654,14,14,8,6
52942,443,55996,443,allow,14696,5947,8749,53,115,26,27
50636,80,12150,80,allow,16521,6496,10025,31,49,16,15
49666,80,7693,80,allow,2356,499,1857,10,125,6,4
48706,23393,0,0,deny,60,60,0,1,0,1,0
56785,28902,1768,28902,allow,70,70,0,2,8,2,0
58168,445,0,0,drop,66,66,0,1,0,1,0
63288,52848,0,0,deny,66,66,0,1,0,1,0
53546,445,0,0,drop,70,70,0,1,0,1,0
56518,53,9121,53,allow,177,94,83,2,30,1,1
54325,27016,47516,27016,allow,924,924,0,3,30,3,0
61218,445,0,0,drop,70,70,0,1,0,1,0
55193,53,2306,53,allow,177,94,83,2,30,1,1
56750,53,18998,53,allow,279,118,161,2,30,1,1
52480,443,40106,443,allow,7103,2432,4671,18,76,10,8
60466,64337,52523,64337,allow,70,70,0,2,8,2,0
49229,53,18433,53,allow,178,94,84,2,31,1,1
56246,53,1913,53,allow,209,110,99,2,30,1,1
64306,53,2693,53,allow,216,110,106,2,30,1,1
57394,53,17167,53,allow,193,102,91,2,31,1,1
49713,53,39823,53,allow,184,94,90,2,30,1,1
51342,445,0,0,drop,70,70,0,1,0,1,0
58989,445,0,0,drop,70,70,0,1,0,1,0
65359,53,37489,53,allow,210,102,108,2,30,1,1
57662,445,0,0,drop,70,70,0,1,0,1,0
56640,443,64695,443,allow,7797,1808,5989,20,14,11,9
59394,445,0,0,drop,70,70,0,1,0,1,0
58313,445,0,0,drop,66,66,0,1,0,1,0
26229,21247,0,0,deny,62,62,0,1,0,1,0
53053,443,10274,443,allow,9303,2569,6734,39,106,20,19
55057,53,28179,53,allow,889,404,485,10,30,5,5
57140,53,49557,53,allow,177,94,83,2,30,1,1
65319,80,8384,80,allow,2284,484,1800,10,133,6,4
30353,53,30353,53,allow,200,90,110,2,30,1,1
55877,53,52511,53,allow,166,86,80,2,30,1,1
57367,53,62826,53,allow,170,87,83,2,30,1,1
50779,445,0,0,drop,70,70,0,1,0,1,0
59828,443,59390,443,allow,7083,2786,4297,24,81,14,10
56526,53,57484,53,allow,210,102,108,2,30,1,1
51110,80,32972,80,allow,23850,1662,22188,36,15,19,17
53567,64147,0,0,deny,62,62,0,1,0,1,0
50399,80,19756,80,allow,318,192,126,6,26,4,2
57584,443,14480,443,allow,8937,3934,5003,18,120,9,9
55829,53,4732,53,allow,208,106,102,2,31,1,1
58638,5900,0,0,deny,62,62,0,1,0,1,0
52097,445,0,0,drop,70,70,0,1,0,1,0
59472,445,0,0,drop,70,70,0,1,0,1,0
58638,5900,0,0,deny,62,62,0,1,0,1,0
51785,33253,14709,33253,allow,70,70,0,2,8,2,0
49162,53,30620,53,allow,401,94,307,4,32,2,2
10947,53,10947,53,allow,197,90,107,2,29,1,1
56939,53,41233,53,allow,322,134,188,2,30,1,1
4748,64147,0,0,deny,62,62,0,1,0,1,0
54598,37965,0,0,deny,66,66,0,1,0,1,0
51689,443,47234,443,allow,8488,2174,6314,23,255,12,11
55821,445,0,0,drop,70,70,0,1,0,1,0
50036,445,0,0,drop,66,66,0,1,0,1,0
40204,40016,4435,40016,allow,148,86,62,2,30,1,1
52472,7302,0,0,deny,66,66,0,1,0,1,0
54879,445,0,0,drop,70,70,0,1,0,1,0
63458,445,0,0,drop,70,70,0,1,0,1,0
51916,24596,6622,24596,allow,70,70,0,2,8,2,0
64420,53,3880,53,allow,194,102,92,2,30,1,1
64171,53,30410,53,allow,94,94,0,1,30,1,0
7285,51221,0,0,deny,66,66,0,1,0,1,0
45941,23386,0,0,deny,60,60,0,1,0,1,0
49862,443,6856,443,allow,17924,7867,10057,45,88,24,21
57160,53,20461,53,allow,255,110,145,2,29,1,1
56490,53,61381,53,allow,744,89,655,2,31,1,1
56747,53,48027,53,allow,226,110,116,2,30,1,1
46862,443,48242,443,allow,6162,925,5237,18,179,10,8
51544,445,0,0,drop,70,70,0,1,0,1,0
28580,64147,0,0,deny,62,62,0,1,0,1,0
55093,53,0,0,allow,318,86,232,2,30,1,1
56737,53,36153,53,allow,817,98,719,2,31,1,1
55373,1,0,0,deny,66,66,0,1,0,1,0
49867,445,0,0,drop,70,70,0,1,0,1,0
64172,53,37844,53,allow,197,102,95,2,33,1,1
49237,53,49518,53,allow,216,110,106,2,30,1,1
52424,445,0,0,drop,66,66,0,1,0,1,0
62361,445,0,0,drop,66,66,0,1,0,1,0
53016,443,53016,443,allow,4787,1880,2907,19,27,11,8
50718,80,3998,80,allow,620,320,300,11,166,6,5
54975,445,0,0,drop,70,70,0,1,0,1,0
0,0,0,0,deny,98,98,0,1,0,1,0
56078,80,65466,80,allow,2458,531,1927,11,75,6,5
52028,80,63717,80,allow,422,240,182,8,24,5,3
36022,443,7743,443,allow,7257,1619,5638,22,275,11,11
63023,443,14505,443,allow,382,164,218,2,30,1,1
53708,23280,6417,23280,allow,1903,968,935,16,16,9,7
58638,5900,0,0,deny,62,62,0,1,0,1,0
51238,445,0,0,drop,70,70,0,1,0,1,0
60008,443,9561,443,allow,7060,1850,5210,35,110,21,14
40481,22114,0,0,deny,66,66,0,1,0,1,0
49841,53,36944,53,allow,227,110,117,2,30,1,1
47892,443,55293,443,allow,172,172,0,2,5,2,0
55338,445,0,0,drop,70,70,0,1,0,1,0
57741,445,0,0,drop,70,70,0,1,0,1,0
60499,445,0,0,drop,70,70,0,1,0,1,0
54280,445,0,0,drop,70,70,0,1,0,1,0
48676,53395,0,0,deny,60,60,0,1,0,1,0
49860,443,20445,443,allow,10754,2778,7976,38,59,19,19
64752,53,55237,53,allow,190,97,93,2,31,1,1
51891,445,0,0,drop,66,66,0,1,0,1,0
52187,38153,15114,38153,allow,70,70,0,2,9,2,0
49429,443,22034,443,allow,990201,31101,959100,1061,192,383,678
8884,443,38785,443,allow,5307,3288,2019,25,397,8,17
61331,445,0,0,drop,70,70,0,1,0,1,0
65139,53,12315,53,allow,210,102,108,2,30,1,1
55691,443,55691,443,allow,165616,8760,156856,199,82,79,120
65238,443,5223,443,allow,26538,8416,18122,54,121,25,29
51159,8090,0,0,deny,60,60,0,1,0,1,0
10652,57470,0,0,deny,66,66,0,1,0,1,0
52223,443,45658,443,allow,6710,4371,2339,33,109,18,15
61365,445,0,0,drop,70,70,0,1,0,1,0
49767,443,22404,443,allow,11883,1419,10464,26,127,11,15
64677,53,46523,53,allow,195,102,93,2,31,1,1
49670,53,59914,53,allow,168,86,82,2,31,1,1
10243,36237,0,0,deny,62,62,0,1,0,1,0
9312,443,24938,443,allow,4618,840,3778,16,26,9,7
18655,50584,0,0,deny,62,62,0,1,0,1,0
47663,443,61725,443,allow,214,140,74,4,15,3,1
53633,445,0,0,drop,70,70,0,1,0,1,0
50153,80,50079,80,allow,41846,1261,40585,45,75,13,32
55605,53,27341,53,allow,195,102,93,2,30,1,1
35078,53,22216,53,allow,198,93,105,2,30,1,1
64110,51617,13818,51617,allow,66,66,0,2,7,2,0
55796,53,55796,53,allow,253,99,154,2,32,1,1
34478,443,59065,443,allow,9107,2253,6854,22,185,11,11
50928,445,0,0,drop,70,70,0,1,0,1,0
34436,443,8261,443,allow,9083,2087,6996,28,18,16,12
53725,57418,1375,57418,allow,70,70,0,2,8,2,0
57470,44224,31554,44224,allow,480,149,331,2,1200,1,1
34152,11119,0,0,deny,148,148,0,1,0,1,0
59530,445,0,0,drop,66,66,0,1,0,1,0
50414,443,29700,443,allow,1346,918,428,10,25,6,4
49288,443,9666,443,allow,7846,2369,5477,23,385,10,13
55329,445,0,0,drop,70,70,0,1,0,1,0
20953,23,0,0,deny,60,60,0,1,0,1,0
58638,5900,58638,5900,allow,126,62,64,2,5,1,1
54760,445,0,0,drop,66,66,0,1,0,1,0
58950,445,0,0,drop,70,70,0,1,0,1,0
55056,53,12643,53,allow,202,103,99,2,31,1,1
63902,445,0,0,drop,70,70,0,1,0,1,0
49737,443,56529,443,allow,5566,1444,4122,17,129,10,7
56501,53,62547,53,allow,711,87,624,2,31,1,1
9095,22114,0,0,deny,62,62,0,1,0,1,0
57293,443,21825,443,allow,5161,2421,2740,14,122,7,7
50265,17555,24395,17555,allow,1488,930,558,21,1200,12,9
65262,53,31670,53,allow,216,110,106,2,30,1,1
46315,443,19188,443,allow,5571,2240,3331,28,87,14,14
44792,80,52125,80,allow,1295,781,514,12,16,6,6
63387,445,0,0,drop,70,70,0,1,0,1,0
54120,445,0,0,drop,66,66,0,1,0,1,0
61630,445,0,0,drop,70,70,0,1,0,1,0
59524,25174,0,0,deny,62,62,0,1,0,1,0
57287,445,0,0,drop,66,66,0,1,0,1,0
59575,445,0,0,drop,70,70,0,1,0,1,0
58504,445,0,0,drop,66,66,0,1,0,1,0
11562,30188,0,0,deny,62,62,0,1,0,1,0
60049,445,0,0,drop,66,66,0,1,0,1,0
3986,17372,0,0,deny,66,66,0,1,0,1,0
54173,23,0,0,deny,60,60,0,1,0,1,0
57887,443,20597,443,allow,6938,1531,5407,23,195,13,10
34734,443,41689,443,allow,7974,2716,5258,50,7261,26,24
59116,443,24457,443,allow,48923,5417,43506,61,122,25,36
57453,445,0,0,drop,70,70,0,1,0,1,0
51221,65427,56298,65427,allow,460,150,310,2,1200,1,1
27005,27015,18996,27015,allow,1618,126,1492,4,30,2,2
64096,53,55413,53,allow,197,94,103,2,29,1,1
54811,445,0,0,drop,70,70,0,1,0,1,0
55735,53,65479,53,allow,184,94,90,2,31,1,1
52928,443,12845,443,allow,56910,3384,53526,85,115,33,52
55955,53,2221,53,allow,814,110,704,2,30,1,1
65228,53,63836,53,allow,267,93,174,4,46,2,2
56937,8200,55532,8200,allow,78,78,0,1,30,1,0
27005,33052,60950,33052,allow,873,126,747,2,31,1,1
59462,445,0,0,drop,70,70,0,1,0,1,0
52310,53,0,0,allow,247,76,171,2,30,1,1
5588,5588,0,0,allow,3354,1792,1562,46,194,23,23
51519,443,51519,443,allow,8680,2323,6357,31,173,13,18
63032,22114,0,0,deny,66,66,0,1,0,1,0
49987,443,39263,443,allow,426,180,246,8,21,4,4
55884,53,23694,53,allow,438,180,258,6,30,3,3
65346,53,45745,53,allow,182,93,89,2,31,1,1
44400,443,34284,443,allow,6576,1937,4639,14,120,7,7
18086,25174,0,0,deny,146,146,0,1,0,1,0
59169,56205,0,0,deny,62,62,0,1,0,1,0
55660,53,60167,53,allow,177,94,83,2,30,1,1
53239,443,57625,443,allow,84664,6099,78565,140,70,56,84
59375,445,0,0,drop,70,70,0,1,0,1,0
57368,53,40892,53,allow,167,86,81,2,30,1,1
60922,445,0,0,drop,70,70,0,1,0,1,0
65380,53,23186,53,allow,180,94,86,2,30,1,1
1048,25174,0,0,deny,62,62,0,1,0,1,0
49881,443,45580,443,allow,5997,978,5019,19,53,10,9
60675,445,0,0,drop,70,70,0,1,0,1,0
50327,445,0,0,drop,70,70,0,1,0,1,0
27005,27272,38443,27272,allow,887,126,761,2,30,1,1
55920,25174,0,0,deny,62,62,0,1,0,1,0
49949,53,8662,53,allow,307,110,197,2,30,1,1
56194,445,0,0,drop,66,66,0,1,0,1,0
10036,44847,0,0,deny,66,66,0,1,0,1,0
22300,51505,0,0,deny,66,66,0,1,0,1,0
53561,443,46196,443,allow,4586,1216,3370,17,28,10,7
55867,53,4524,53,allow,184,94,90,2,31,1,1
42898,25174,0,0,deny,62,62,0,1,0,1,0
53124,443,9153,443,allow,64407,55712,8695,92,364,58,34
56968,80,38598,80,allow,2273,1511,762,7,29,4,3
3456,11392,0,0,deny,62,62,0,1,0,1,0
52038,50584,0,0,deny,66,66,0,1,0,1,0
49505,443,25913,443,allow,6318,2030,4288,25,270,12,13
58114,445,0,0,drop,66,66,0,1,0,1,0
45079,31573,0,0,deny,62,62,0,1,0,1,0
65193,53,19280,53,allow,436,94,342,2,30,1,1
64989,53,11063,53,allow,578,286,292,9,15,5,4
55439,53,53595,53,allow,209,110,99,2,29,1,1
65102,53,65408,53,allow,183,94,89,2,30,1,1
54445,443,28246,443,allow,2782,1778,1004,20,33,10,10
50783,23,0,0,deny,60,60,0,1,0,1,0
56766,443,55432,443,allow,7888,1899,5989,20,15,11,9
64679,53,50625,53,allow,172,88,84,2,31,1,1
64054,53,42745,53,allow,182,93,89,2,31,1,1
56492,53,12334,53,allow,184,94,90,2,29,1,1
53877,443,42282,443,allow,499,425,74,4,1,3,1
49968,53,62146,53,allow,1412,94,1318,4,33,2,2
59680,445,0,0,drop,70,70,0,1,0,1,0
57107,64147,0,0,deny,66,66,0,1,0,1,0
51461,443,45147,443,allow,318,70,248,5,17,1,4
61846,445,0,0,drop,66,66,0,1,0,1,0
21432,53,21432,53,allow,244,98,146,2,32,1,1
61575,445,0,0,drop,66,66,0,1,0,1,0
53355,23117,0,0,deny,62,62,0,1,0,1,0
9849,53,9849,53,allow,219,87,132,2,31,1,1
60715,80,28604,80,allow,198,78,120,4,11,2,2
9476,443,21369,443,allow,3999,905,3094,15,26,8,7
50583,80,64336,80,allow,630930,27504,603426,812,74,381,431
59159,445,0,0,drop,70,70,0,1,0,1,0
53913,443,40081,443,allow,499,425,74,4,0,3,1
39735,53,51086,53,allow,223,78,145,2,30,1,1
59419,443,5544,443,allow,2854,1732,1122,16,15,8,8
61723,443,17384,443,allow,6962,979,5983,19,15,10,9
53730,37096,48081,37096,allow,70,70,0,1,4,1,0
60752,28080,38222,28080,allow,70,70,0,2,8,2,0
49837,53,8590,53,allow,176,90,86,2,30,1,1
63369,445,0,0,drop,66,66,0,1,0,1,0
12162,53,12162,53,allow,233,90,143,2,33,1,1
25565,54864,0,0,deny,60,60,0,1,0,1,0
57817,445,0,0,drop,66,66,0,1,0,1,0
49674,445,0,0,drop,70,70,0,1,0,1,0
36144,443,59381,443,allow,8859,1662,7197,26,75,14,12
51953,37965,0,0,deny,66,66,0,1,0,1,0
1749,64147,0,0,deny,62,62,0,1,0,1,0
51839,80,51839,80,allow,951054,20747,930307,902,26,276,626
56661,443,26302,443,allow,18375,7252,11123,47,40,24,23
55934,53,55732,53,allow,192,98,94,2,31,1,1
56155,53,9599,53,allow,199,102,97,2,30,1,1
55525,53,56574,53,allow,214,110,104,2,30,1,1
57987,56125,0,0,deny,90,90,0,1,0,1,0
55767,443,58129,443,allow,1786,172,1614,7,122,3,4
50999,443,32321,443,allow,3051,1801,1250,18,16,8,10
56969,443,46839,443,allow,6431,1792,4639,22,80,13,9
50494,445,0,0,drop,70,70,0,1,0,1,0
50512,443,55722,443,allow,6945,1842,5103,25,87,14,11
60465,445,0,0,drop,70,70,0,1,0,1,0
50408,53,36344,53,allow,182,93,89,2,31,1,1
60287,80,11423,80,allow,130,70,60,2,15,1,1
19699,48817,0,0,deny,143,143,0,1,0,1,0
62369,445,0,0,drop,70,70,0,1,0,1,0
59404,443,36010,443,allow,11018,5022,5996,84,588,43,41
63145,445,0,0,drop,70,70,0,1,0,1,0
60865,443,14969,443,allow,9934,4897,5037,43,15,25,18
57275,443,62988,443,allow,45483074,398771,45084303,36307,333,3386,32921
42355,443,21738,443,allow,4181,998,3183,14,26,7,7
27005,27015,64415,27015,allow,875,126,749,2,30,1,1
52734,445,0,0,drop,70,70,0,1,0,1,0
50359,80,41698,80,allow,318,192,126,6,28,4,2
52643,36237,0,0,deny,66,66,0,1,0,1,0
55641,53,38684,53,allow,184,94,90,2,30,1,1
64724,53,50975,53,allow,195,102,93,2,31,1,1
58638,5900,0,0,deny,62,62,0,1,0,1,0
6881,7999,34044,7999,allow,238,118,120,2,1199,1,1
49961,80,19985,80,allow,8315,820,7495,18,15,9,9
58734,443,17024,443,allow,8758,3850,4908,26,330,14,12
8168,443,8168,443,allow,10130,4701,5429,34,82,18,16
8082,53,8082,53,allow,237,91,146,2,33,1,1
65432,53,33110,53,allow,448,184,264,6,30,3,3
50113,445,0,0,drop,66,66,0,1,0,1,0
55077,53,32952,53,allow,179,94,85,2,29,1,1
49465,443,16999,443,allow,4555,2472,2083,20,119,11,9
56996,53,30047,53,allow,177,94,83,2,29,1,1
45754,80,60037,80,allow,1282,650,632,9,127,5,4
12550,37807,0,0,deny,62,62,0,1,0,1,0
10445,46824,0,0,deny,62,62,0,1,0,1,0
56751,32300,2097,32300,allow,70,70,0,1,5,1,0
52076,44847,0,0,deny,66,66,0,1,0,1,0
60218,80,20948,80,allow,8268,6054,2214,23,151,14,9
56629,53,53878,53,allow,183,94,89,2,30,1,1
65012,53,58709,53,allow,775,102,673,2,30,1,1
54611,445,0,0,drop,70,70,0,1,0,1,0
38700,53,38476,53,allow,164,78,86,2,30,1,1
39356,443,35388,443,allow,7134,2290,4844,29,80,15,14
52094,22114,0,0,deny,146,146,0,1,0,1,0
64583,445,0,0,drop,70,70,0,1,0,1,0
50307,443,50307,443,allow,4378,1471,2907,19,30,11,8
61465,22114,0,0,deny,62,62,0,1,0,1,0
48728,80,37214,80,allow,3524,2698,826,14,16,8,6
27005,27018,47150,27018,allow,1898,378,1520,6,31,4,2
65479,443,61050,443,allow,92397,4379,88018,102,16,37,65
46860,53,42204,53,allow,447,101,346,4,29,2,2
64166,35440,0,0,deny,66,66,0,1,0,1,0
53580,445,0,0,drop,70,70,0,1,0,1,0
50983,443,64084,443,allow,11897,6250,5647,27,81,14,13
64406,50584,0,0,deny,66,66,0,1,0,1,0
54035,443,14205,443,allow,4454,2001,2453,11,120,6,5
57082,53,1107,53,allow,211,102,109,2,30,1,1
53243,57470,0,0,deny,74,74,0,1,0,1,0
6661,23,0,0,deny,60,60,0,1,0,1,0
56448,53,62354,53,allow,200,102,98,2,29,1,1
54471,445,0,0,drop,70,70,0,1,0,1,0
39672,443,58171,443,allow,6540,5046,1494,19,115,12,7
33328,25174,0,0,deny,62,62,0,1,0,1,0
50619,443,52531,443,allow,10483,1021,9462,30,100,11,19
49769,80,36678,80,allow,254,128,126,5,15,3,2
53874,443,50535,443,allow,499,425,74,4,1,3,1
1815,22114,0,0,deny,66,66,0,1,0,1,0
56222,443,56222,443,allow,4378,1471,2907,19,27,11,8
3478,61463,0,0,deny,409,409,0,1,0,1,0
56494,1,0,0,deny,146,146,0,1,0,1,0
50057,80,26007,80,allow,1570,754,816,10,16,6,4
57189,445,0,0,drop,70,70,0,1,0,1,0
41999,80,10138,80,allow,38137,1920,36217,51,81,24,27
42298,40022,6562,40022,allow,148,86,62,2,30,1,1
49823,53,39316,53,allow,388,102,286,2,30,1,1
63755,17866,46456,17866,allow,2568,1944,624,20,29,13,7
25504,53,50116,53,allow,311,86,225,2,30,1,1
56262,445,0,0,drop,70,70,0,1,0,1,0
55296,23718,0,0,deny,66,66,0,1,0,1,0
59436,22114,0,0,deny,66,66,0,1,0,1,0
64470,445,0,0,drop,66,66,0,1,0,1,0
53283,443,51039,443,allow,3369,1036,2333,11,121,5,6
25565,62778,0,0,deny,60,60,0,1,0,1,0
53351,445,0,0,drop,66,66,0,1,0,1,0
58892,443,12440,443,allow,5167,700,4467,16,15,7,9
52828,51221,0,0,deny,66,66,0,1,0,1,0
443,50238,0,0,deny,99,99,0,1,0,1,0
57147,53,63811,53,allow,166,86,80,2,29,1,1
61412,443,58094,443,allow,4934,771,4163,18,28,8,10
60895,445,0,0,drop,66,66,0,1,0,1,0
50390,443,34358,443,allow,1328,876,452,11,29,6,5
52175,443,52175,443,allow,506908,20303,486605,548,25,204,344
58974,443,58974,443,allow,6792,1521,5271,18,28,11,7
56901,445,0,0,drop,70,70,0,1,0,1,0
55440,445,0,0,drop,70,70,0,1,0,1,0
58800,445,0,0,drop,70,70,0,1,0,1,0
63644,445,0,0,drop,66,66,0,1,0,1,0
53910,443,14287,443,allow,499,425,74,4,0,3,1
50470,61463,0,0,deny,86,86,0,1,0,1,0
54452,443,13624,443,allow,4227,1086,3141,15,28,8,7
57011,49813,0,0,deny,66,66,0,1,0,1,0
49913,53,16997,53,allow,216,110,106,2,31,1,1
57853,64147,0,0,deny,62,62,0,1,0,1,0
49677,64147,0,0,deny,62,62,0,1,0,1,0
56524,53,52908,53,allow,711,87,624,2,31,1,1
63243,53,40178,53,allow,330,228,102,3,33,2,1
56501,53,9977,53,allow,216,94,122,2,31,1,1
65265,55067,0,0,deny,62,62,0,1,0,1,0
43205,22,43205,22,allow,6957,2330,4627,35,27,17,18
1882,43890,0,0,deny,62,62,0,1,0,1,0
55987,445,0,0,drop,66,66,0,1,0,1,0
6666,21,0,0,deny,60,60,0,1,0,1,0
65270,53,38040,53,allow,226,110,116,2,30,1,1
60311,56205,0,0,deny,66,66,0,1,0,1,0
49993,80,30030,80,allow,21812,900,20912,27,26,9,18
56677,53,25915,53,allow,286,103,183,4,48,2,2
63704,445,0,0,drop,70,70,0,1,0,1,0
55249,445,0,0,drop,66,66,0,1,0,1,0
57526,445,0,0,drop,66,66,0,1,0,1,0
65443,53,19494,53,allow,215,102,113,2,30,1,1
49841,443,32376,443,allow,7084,1611,5473,29,71,15,14
53586,443,61806,443,allow,8510,3207,5303,25,324,13,12
56534,443,29507,443,allow,265430,17951,247479,305,105,122,183
56702,443,53688,443,allow,8058,2038,6020,20,15,11,9
54280,3396,0,0,deny,60,60,0,1,0,1,0
56086,445,0,0,drop,70,70,0,1,0,1,0
53825,58968,28988,58968,allow,70,70,0,2,7,2,0
55032,53,18500,53,allow,458,188,270,6,31,3,3
52853,443,21647,443,allow,9582,3906,5676,21,135,10,11
60887,445,0,0,drop,66,66,0,1,0,1,0
58199,445,0,0,drop,66,66,0,1,0,1,0
63196,445,0,0,deny,62,62,0,1,0,1,0
65157,53,24624,53,allow,209,102,107,2,31,1,1
65204,53,50970,53,allow,182,93,89,2,31,1,1
50541,80,22542,80,allow,4296,3281,1015,12,33,7,5
5223,14446,0,0,deny,66,66,0,1,0,1,0
33878,443,33484,443,allow,2279,1637,642,15,25,9,6
39854,443,9295,443,allow,7903,3497,4406,38,72,22,16
27005,28015,54917,28015,allow,888,126,762,2,30,1,1
62551,445,0,0,drop,66,66,0,1,0,1,0
34517,443,44047,443,allow,5996,1967,4029,17,99,10,7
20726,2767,0,0,deny,66,66,0,1,0,1,0
55771,53,25077,53,allow,196,102,94,2,30,1,1
63742,445,0,0,drop,70,70,0,1,0,1,0
40204,40026,38971,40026,allow,148,86,62,2,30,1,1
56439,53,18376,53,allow,198,102,96,2,30,1,1
62948,445,0,0,drop,70,70,0,1,0,1,0
64146,53,31528,53,allow,197,102,95,2,30,1,1
54598,37965,0,0,deny,66,66,0,1,0,1,0
52358,30188,0,0,deny,66,66,0,1,0,1,0
58509,80,60586,80,allow,1666,1130,536,12,16,7,5
63873,61002,7411,61002,allow,5431,3164,2267,32,76,18,14
60079,445,0,0,drop,70,70,0,1,0,1,0
59912,53,38804,53,allow,168,78,90,2,30,1,1
57251,445,0,0,drop,70,70,0,1,0,1,0
6881,6881,0,0,deny,62,62,0,1,0,1,0
54360,445,0,0,drop,70,70,0,1,0,1,0
52879,443,43280,443,allow,286404,12478,273926,379,118,130,249
49633,80,21073,80,allow,318,192,126,6,41,4,2
39548,8696,0,0,deny,60,60,0,1,0,1,0
25296,51505,0,0,deny,66,66,0,1,0,1,0
55421,57470,0,0,deny,74,74,0,1,0,1,0
62579,57866,0,0,deny,62,62,0,1,0,1,0
36306,80,36306,80,allow,1917,1468,449,10,20,6,4
60049,25174,0,0,deny,66,66,0,1,0,1,0
53612,1032,47132,1032,allow,130,70,60,3,5,2,1
59373,22,59373,22,deny,295,126,169,4,1,2,2
49477,53,35970,53,allow,172,88,84,2,30,1,1
47783,50432,0,0,deny,62,62,0,1,0,1,0
50445,80,48799,80,allow,318,192,126,6,27,4,2
33409,53,6047,53,allow,241272,234761,6511,2872,89,2833,39
58361,445,0,0,drop,70,70,0,1,0,1,0
55282,53,18223,53,allow,771,101,670,2,31,1,1
56964,443,49041,443,allow,8085,2164,5921,22,86,12,10
55344,53,18078,53,allow,208,106,102,2,31,1,1
51480,445,0,0,drop,66,66,0,1,0,1,0
55629,42873,0,0,deny,74,74,0,1,0,1,0
51114,445,0,0,drop,70,70,0,1,0,1,0
60461,10138,64431,10138,allow,70,70,0,1,5,1,0
54453,443,34094,443,allow,257837,37453,220384,446,952,175,271
57772,50584,0,0,deny,66,66,0,1,0,1,0
50973,443,10208,443,allow,9525,6135,3390,24,120,13,11
34332,443,1542,443,allow,1717,1153,564,13,26,7,6
55797,53,43104,53,allow,194,102,92,2,30,1,1
12143,56205,0,0,deny,62,62,0,1,0,1,0
58638,5900,0,0,deny,62,62,0,1,0,1,0
57642,80,57642,80,allow,220515,3488,217027,180,31,31,149
56321,445,0,0,drop,66,66,0,1,0,1,0
55286,53,55062,53,allow,188,96,92,2,30,1,1
38000,49152,22175,49152,allow,156,156,0,3,8,3,0
56354,53,25392,53,allow,753,93,660,2,30,1,1
65194,53,62268,53,allow,298,102,196,2,29,1,1
48941,443,53829,443,allow,10085,3487,6598,21,120,9,12
62470,445,0,0,drop,66,66,0,1,0,1,0
7992,64147,0,0,deny,62,62,0,1,0,1,0
52056,50328,41814,50328,allow,70,70,0,1,4,1,0
56986,2310,0,0,deny,159,159,0,1,0,1,0
57641,445,0,0,drop,66,66,0,1,0,1,0
63621,445,0,0,drop,70,70,0,1,0,1,0
44846,53,44846,53,allow,653,349,304,5,30,3,2
6881,61980,0,0,deny,150,150,0,1,0,1,0
50346,445,0,0,drop,70,70,0,1,0,1,0
56096,445,0,0,drop,70,70,0,1,0,1,0
64807,53,32139,53,allow,246,118,128,2,29,1,1
49227,53,48621,53,allow,718,94,624,2,30,1,1
38772,53,26700,53,allow,168,78,90,2,30,1,1
50127,64147,0,0,deny,66,66,0,1,0,1,0
58028,445,0,0,drop,70,70,0,1,0,1,0
56837,53,17666,53,allow,190,97,93,2,31,1,1
49918,53,25518,53,allow,198,102,96,2,31,1,1
52104,51756,27820,51756,allow,70,70,0,2,8,2,0
48817,6881,48817,6881,allow,334,158,176,2,1200,1,1
51504,443,9734,443,allow,6656,769,5887,14,16,9,5
56041,445,0,0,drop,70,70,0,1,0,1,0
46568,443,33630,443,allow,6407,984,5423,21,360,11,10
56419,53,45684,53,allow,199,102,97,2,30,1,1
51007,445,0,0,drop,66,66,0,1,0,1,0
54654,443,37432,443,allow,4869,1016,3853,18,121,9,9
56152,53,5986,53,allow,195,102,93,2,31,1,1
1042,64147,0,0,deny,145,145,0,1,0,1,0
56995,445,0,0,drop,70,70,0,1,0,1,0
62902,32468,0,0,deny,66,66,0,1,0,1,0
57470,52217,58146,52217,allow,1969,730,1239,19,1199,10,9
35154,42707,0,0,deny,62,62,0,1,0,1,0
59414,445,0,0,drop,66,66,0,1,0,1,0
56424,53,14436,53,allow,306,94,212,2,30,1,1
59328,445,0,0,drop,70,70,0,1,0,1,0
9518,1,0,0,deny,100,100,0,1,0,1,0
63979,49547,9568,49547,allow,312,132,180,6,6,3,3
57355,445,0,0,drop,70,70,0,1,0,1,0
65513,445,0,0,drop,66,66,0,1,0,1,0
45652,10214,0,0,deny,62,62,0,1,0,1,0
52494,36237,0,0,deny,62,62,0,1,0,1,0
50683,443,31278,443,allow,12362,1650,10712,33,300,14,19
6817,23,0,0,deny,60,60,0,1,0,1,0
57238,53,18077,53,allow,701,88,613,2,31,1,1
52855,445,0,0,drop,66,66,0,1,0,1,0
64103,50265,0,0,deny,66,66,0,1,0,1,0
65228,53,53617,53,allow,212,86,126,2,30,1,1
57323,53,38814,53,allow,194,102,92,2,31,1,1
65264,53,15709,53,allow,178,94,84,2,29,1,1
65115,53,30947,53,allow,170,87,83,2,31,1,1
53891,1056,54785,1056,allow,260,140,120,5,6,3,2
55206,443,55206,443,allow,18965,2061,16904,35,17,18,17
49294,445,0,0,drop,70,70,0,1,0,1,0
52852,80,35656,80,allow,7572,3232,4340,42,140,23,19
44885,443,34599,443,allow,296,78,218,4,19,1,3
38076,80,55546,80,allow,15538,1307,14231,27,45,15,12
55286,53,17426,53,allow,268,87,181,4,35,2,2
62295,443,30041,443,allow,3538,2015,1523,28,325,14,14
50928,443,1946,443,allow,3347,2025,1322,31,34,18,13
27005,30006,22484,30006,allow,890,126,764,2,31,1,1
9469,80,38587,80,allow,1641,483,1158,10,15,5,5
0,0,0,0,deny,70,70,0,1,0,1,0
0,0,0,0,allow,244,244,0,2,0,2,0
58910,445,0,0,drop,70,70,0,1,0,1,0
58803,443,12977,443,allow,5166,700,4466,16,15,7,9
65108,53,40239,53,allow,215,94,121,2,30,1,1
44119,53,25337,53,allow,168,78,90,2,30,1,1
55410,80,63972,80,allow,1250,472,778,13,46,3,10
2705,37,0,0,deny,60,60,0,1,0,1,0
63464,443,28849,443,allow,3120,976,2144,13,135,6,7
49175,2710,9134,2710,allow,66,66,0,1,5,1,0
52903,443,57569,443,allow,253281,6271,247010,276,117,66,210
22539,53,19206,53,allow,86,86,0,1,30,1,0
50729,445,0,0,drop,70,70,0,1,0,1,0
56790,53,5516,53,allow,747,92,655,2,31,1,1
49160,6889,59737,6889,allow,834,150,684,4,1200,2,2
64798,53,18186,53,allow,177,94,83,2,29,1,1
50241,53,32622,53,allow,184,102,82,2,30,1,1
51195,443,30169,443,allow,291595,261981,29614,587,206,339,248
56216,53,58788,53,allow,177,94,83,2,30,1,1
64257,53,1307,53,allow,168,86,82,2,30,1,1
49621,445,0,0,drop,70,70,0,1,0,1,0
55081,443,63191,443,allow,19866,7188,12678,18,151,7,11
50071,53,62204,53,allow,458,188,270,6,30,3,3
59143,445,0,0,drop,66,66,0,1,0,1,0
63589,44847,0,0,deny,62,62,0,1,0,1,0
64889,53,50666,53,allow,215,102,113,2,30,1,1
64627,445,0,0,drop,70,70,0,1,0,1,0
29509,25174,0,0,deny,62,62,0,1,0,1,0
53660,443,43128,443,allow,350,210,140,6,24,4,2
57052,53,38641,53,allow,177,94,83,2,30,1,1
443,56513,0,0,deny,78,78,0,1,0,1,0
55183,445,0,0,drop,70,70,0,1,0,1,0
65126,445,0,0,drop,70,70,0,1,0,1,0
41545,443,41545,443,allow,4719,1812,2907,19,29,11,8
27969,25174,0,0,deny,66,66,0,1,0,1,0
63587,22114,0,0,deny,146,146,0,1,0,1,0
53721,8999,32848,8999,allow,320,140,180,6,6,3,3
55929,80,55929,80,allow,450,246,204,8,29,5,3
49245,80,49245,80,allow,378,180,198,7,54,4,3
51822,445,0,0,drop,70,70,0,1,0,1,0
36194,443,29201,443,allow,5674,1556,4118,23,271,13,10
56559,443,41687,443,allow,2723,1564,1159,15,17,9,6
49739,443,63017,443,allow,3085,1404,1681,15,15,7,8
52042,53,52042,53,allow,478,292,186,5,30,3,2
53611,58508,47899,58508,allow,320,140,180,6,7,3,3
21998,51221,0,0,deny,62,62,0,1,0,1,0
63285,445,0,0,drop,66,66,0,1,0,1,0
55855,53,55855,53,allow,221,89,132,2,31,1,1
49203,53,46894,53,allow,168,86,82,2,30,1,1
23719,22114,0,0,deny,146,146,0,1,0,1,0
64462,53,49415,53,allow,179,94,85,2,30,1,1
56882,445,0,0,drop,70,70,0,1,0,1,0
61426,64910,0,0,deny,66,66,0,1,0,1,0
23126,35440,0,0,deny,66,66,0,1,0,1,0
63974,445,0,0,drop,70,70,0,1,0,1,0
51832,40607,33466,40607,allow,66,66,0,1,5,1,0
56852,6057,3356,6057,allow,2499,2499,0,22,300,22,0
62432,445,0,0,drop,70,70,0,1,0,1,0
58289,445,0,0,drop,70,70,0,1,0,1,0
56360,443,15487,443,allow,3734,1750,1984,24,203,12,12
62831,445,0,0,drop,70,70,0,1,0,1,0
57123,53,38680,53,allow,811,94,717,2,30,1,1
51580,80,9107,80,allow,1752,786,966,16,17,9,7
58373,445,0,0,drop,66,66,0,1,0,1,0
65132,53,27212,53,allow,167,86,81,2,30,1,1
7109,64147,0,0,deny,66,66,0,1,0,1,0
59066,445,0,0,drop,66,66,0,1,0,1,0
50582,445,0,0,drop,70,70,0,1,0,1,0
49001,40108,0,0,deny,161,161,0,1,0,1,0
50819,443,24202,443,allow,11217,3882,7335,42,164,19,23
52604,445,0,0,drop,70,70,0,1,0,1,0
59572,445,0,0,drop,70,70,0,1,0,1,0
1026,64147,0,0,deny,145,145,0,1,0,1,0
50893,445,0,0,drop,66,66,0,1,0,1,0
56811,445,0,0,drop,70,70,0,1,0,1,0
62089,445,0,0,drop,66,66,0,1,0,1,0
53170,20259,55641,20259,allow,70,70,0,1,5,1,0
62557,445,0,0,drop,70,70,0,1,0,1,0
58638,5900,0,0,deny,62,62,0,1,0,1,0
2707,37,0,0,deny,60,60,0,1,0,1,0
63944,30188,0,0,deny,66,66,0,1,0,1,0
50939,80,16478,80,allow,1375,1038,337,7,137,4,3
52075,443,32298,443,allow,18579,9266,9313,49,198,25,24
57430,53,55125,53,allow,185,102,83,2,29,1,1
49161,53,1492,53,allow,385,102,283,2,30,1,1
51699,37224,26533,37224,allow,66,66,0,1,5,1,0
61683,445,0,0,drop,70,70,0,1,0,1,0
60798,443,60798,443,allow,1092,645,447,10,34,6,4
58872,443,35466,443,allow,5166,700,4466,16,15,7,9
60865,445,0,0,drop,70,70,0,1,0,1,0
64359,53,62943,53,allow,196,102,94,2,30,1,1
49604,53,29008,53,allow,969,86,883,2,30,1,1
47662,80,15716,80,allow,1067,697,370,8,63,5,3
49487,53,45596,53,allow,267,102,165,2,30,1,1
63066,443,9445,443,allow,448,166,282,2,30,1,1
58856,443,29128,443,allow,2881,1766,1115,17,16,9,8
53218,443,1969,443,allow,245772,8639,237133,291,66,103,188
60342,36237,0,0,deny,66,66,0,1,0,1,0
55752,8060,41329,8060,allow,70,70,0,1,4,1,0
1034,26296,0,0,deny,159,159,0,1,0,1,0
23226,53,23226,53,allow,217,82,135,2,33,1,1
33882,80,63489,80,allow,1454,866,588,11,58,7,4
56430,53,37979,53,allow,193,102,91,2,30,1,1
25448,36827,0,0,deny,62,62,0,1,0,1,0
47020,443,34656,443,allow,3545,1817,1728,22,95,11,11
37244,53,37244,53,allow,172,76,96,2,30,1,1
53720,50795,49301,50795,allow,320,140,180,6,7,3,3
60721,443,60721,443,allow,1092,645,447,10,34,6,4
0,0,0,0,allow,480,244,236,4,0,2,2
49805,443,42807,443,allow,2839,1654,1185,15,126,9,6
54931,445,0,0,drop,70,70,0,1,0,1,0
49683,443,27198,443,allow,11301,2219,9082,29,187,14,15
60758,445,0,0,drop,70,70,0,1,0,1,0
3090,1,0,0,deny,66,66,0,1,0,1,0
64864,53,28778,53,allow,275,126,149,2,30,1,1
58029,445,0,0,drop,70,70,0,1,0,1,0
55078,80,14305,80,allow,265275,25834,239441,366,101,182,184
54958,443,14997,443,allow,6578,1571,5007,24,17,13,11
5431,53,5431,53,allow,224,88,136,2,31,1,1
34677,51185,0,0,deny,60,60,0,1,0,1,0
57204,53,65520,53,allow,195,102,93,2,30,1,1
49875,80,61335,80,allow,35824,4558,31266,39,88,13,26
49926,53,46406,53,allow,333,90,243,4,41,2,2
27005,27222,42780,27222,allow,890,126,764,2,30,1,1
49001,40108,0,0,deny,161,161,0,1,0,1,0
56682,443,61779,443,allow,8654,2150,6504,20,15,11,9
64889,26467,0,0,deny,66,66,0,1,0,1,0
64763,53,14685,53,allow,214,110,104,2,30,1,1
60867,443,23930,443,allow,14125,3827,10298,33,45,18,15
15933,64147,0,0,deny,62,62,0,1,0,1,0
52009,443,52009,443,allow,588633,17490,571143,578,51,186,392
49295,445,0,0,drop,70,70,0,1,0,1,0
43473,53,43473,53,allow,220,100,120,2,30,1,1
53398,445,0,0,drop,70,70,0,1,0,1,0
53231,443,53231,443,allow,1402,856,546,12,34,6,6
65515,53,3298,53,allow,210,110,100,2,30,1,1
56704,53,10036,53,allow,194,102,92,2,31,1,1
63929,445,0,0,drop,70,70,0,1,0,1,0
65189,27216,23592,27216,allow,226,71,155,2,31,1,1
65389,26467,0,0,deny,62,62,0,1,0,1,0
61672,445,0,0,drop,70,70,0,1,0,1,0
49647,53,18676,53,allow,361,102,259,2,30,1,1
56926,53,49989,53,allow,747,93,654,2,31,1,1
55444,23,0,0,deny,60,60,0,1,0,1,0
60513,445,0,0,drop,70,70,0,1,0,1,0
19330,25174,0,0,deny,62,62,0,1,0,1,0
65462,53,20337,53,allow,196,102,94,2,33,1,1
39762,443,10128,443,allow,9264,2848,6416,31,100,16,15
9246,80,48818,80,allow,318,192,126,6,26,4,2
56461,53,50926,53,allow,760,96,664,2,31,1,1
65037,53,41367,53,allow,210,110,100,2,29,1,1
52224,37178,41727,37178,allow,136,136,0,3,14,3,0
64428,53,23839,53,allow,621,196,425,6,59,3,3
55732,45682,36442,45682,allow,70,70,0,2,8,2,0
50380,53,4521,53,allow,737,94,643,2,29,1,1
58658,53,27150,53,allow,260,86,174,2,30,1,1
16387,25523,0,0,allow,60,60,0,1,61,1,0
53504,443,31592,443,allow,2291912,60511,2231401,2353,196,863,1490
55714,53,2036,53,allow,165,86,79,2,30,1,1
51262,35440,0,0,deny,66,66,0,1,0,1,0
54120,445,0,0,drop,70,70,0,1,0,1,0
52891,443,27899,443,allow,320255,9207,311048,343,117,107,236
63263,57470,0,0,deny,66,66,0,1,0,1,0
61515,445,0,0,drop,70,70,0,1,0,1,0
57044,53,24810,53,allow,197,102,95,2,30,1,1
49347,80,49347,80,allow,450,246,204,8,141,5,3
59837,80,33837,80,allow,830733,17622,813111,789,66,245,544
55516,445,0,0,drop,70,70,0,1,0,1,0
57228,53,5585,53,allow,198,101,97,2,30,1,1
58743,35894,0,0,deny,62,62,0,1,0,1,0
57505,445,0,0,drop,70,70,0,1,0,1,0
59528,50584,0,0,deny,146,146,0,1,0,1,0
37575,443,28180,443,allow,499,425,74,4,0,3,1
33405,37965,0,0,deny,62,62,0,1,0,1,0
54924,443,37000,443,allow,62,62,0,1,4,1,0
61592,445,0,0,drop,66,66,0,1,0,1,0
33931,50584,0,0,deny,146,146,0,1,0,1,0
43220,443,18756,443,allow,3178535,62767,3115768,2800,83,626,2174
55666,53,45375,53,allow,211,102,109,2,30,1,1
56204,53,16211,53,allow,195,102,93,2,30,1,1
38807,443,38807,443,allow,5741,2532,3209,24,80,14,10
59600,445,0,0,drop,66,66,0,1,0,1,0
16387,44427,0,0,deny,60,60,0,1,0,1,0
65422,26467,0,0,deny,62,62,0,1,0,1,0
16814,53,16814,53,allow,217,87,130,2,30,1,1
49845,53,6637,53,allow,188,96,92,2,31,1,1
54356,80,42803,80,allow,9608,746,8862,19,82,9,10
56094,445,0,0,drop,70,70,0,1,0,1,0
56190,53,16437,53,allow,196,94,102,2,30,1,1
56100,53,20590,53,allow,216,110,106,2,30,1,1
57470,44919,55339,44919,allow,166,166,0,1,1199,1,0
59962,445,0,0,drop,70,70,0,1,0,1,0
52004,55711,12562,55711,allow,70,70,0,2,7,2,0
53589,3389,53589,3389,allow,3407,1518,1889,16,16,9,7
60435,80,6093,80,allow,1155,781,374,10,15,6,4
56462,53,3765,53,allow,168,78,90,2,30,1,1
64535,53,33577,53,allow,734,86,648,2,31,1,1
41032,80,41032,80,allow,11428,2250,9178,22,126,11,11
57331,53,13149,53,allow,1420,95,1325,4,32,2,2
58638,5900,0,0,deny,62,62,0,1,0,1,0
57208,53,43799,53,allow,184,86,98,2,30,1,1
41713,443,59804,443,allow,61983,10061,51922,85,130,35,50
57928,30188,0,0,deny,146,146,0,1,0,1,0
57129,53,59540,53,allow,265,94,171,2,30,1,1
58383,53,25867,53,allow,357,87,270,2,31,1,1
37903,23,0,0,deny,60,60,0,1,0,1,0
56290,53,40983,53,allow,716,95,621,2,31,1,1
53169,443,5040,443,allow,6716,922,5794,20,20,10,10
2506,443,2506,443,allow,35555,4646,30909,59,23,33,26
49419,443,41592,443,allow,318,192,126,6,15,4,2
55133,53,7400,53,allow,711,87,624,2,30,1,1
6338,23117,0,0,deny,66,66,0,1,0,1,0
65279,53,39619,53,allow,183,94,89,2,30,1,1
5631,80,5631,80,allow,16287,756,15531,23,16,9,14
60446,6882,37809,6882,allow,70,70,0,1,5,1,0
34756,8055,0,0,deny,159,159,0,1,0,1,0
1026,64147,0,0,deny,62,62,0,1,0,1,0
63465,56205,0,0,deny,66,66,0,1,0,1,0
49632,445,0,0,drop,70,70,0,1,0,1,0
50912,445,0,0,drop,70,70,0,1,0,1,0
63332,445,0,0,drop,70,70,0,1,0,1,0
51646,80,63912,80,allow,1038219,43977,994242,1734,30,616,1118
8762,53,8762,53,allow,233,91,142,2,31,1,1
57226,51505,0,0,deny,66,66,0,1,0,1,0
56883,53,10133,53,allow,184,94,90,2,30,1,1
56915,445,0,0,drop,70,70,0,1,0,1,0
443,14591,0,0,deny,131,131,0,1,0,1,0
59017,445,0,0,drop,66,66,0,1,0,1,0
63615,445,0,0,drop,66,66,0,1,0,1,0
58602,445,0,0,drop,70,70,0,1,0,1,0
62800,80,25172,80,allow,1437,659,778,11,45,6,5
50002,53,23419,53,allow,183,102,81,2,30,1,1
46116,57470,0,0,deny,74,74,0,1,0,1,0
64255,53,12895,53,allow,200,94,106,2,29,1,1
49754,53,60786,53,allow,180,94,86,2,30,1,1
56611,443,56611,443,allow,4530,1623,2907,19,26,11,8
40215,443,8042,443,allow,6423,1543,4880,21,191,12,9
55777,53,5442,53,allow,733,94,639,2,29,1,1
50036,80,50018,80,allow,1665,923,742,7,32,4,3
56655,53,60599,53,allow,168,86,82,2,31,1,1
54450,445,0,0,drop,66,66,0,1,0,1,0
34466,443,32529,443,allow,1402,910,492,11,360,6,5
53600,8999,29889,8999,allow,492,306,186,8,15,5,3
61677,445,0,0,drop,70,70,0,1,0,1,0
50346,53,56767,53,allow,760,97,663,2,30,1,1
27005,32038,32589,32038,allow,868,126,742,2,31,1,1
35408,56205,0,0,deny,66,66,0,1,0,1,0
62160,445,0,0,drop,66,66,0,1,0,1,0
49459,53,5838,53,allow,199,102,97,2,29,1,1
52586,445,0,0,drop,70,70,0,1,0,1,0
64055,445,0,0,drop,66,66,0,1,0,1,0
64891,53,61433,53,allow,320,97,223,4,34,2,2
65500,443,41851,443,allow,8177,3420,4757,23,124,11,12
51174,443,12417,443,allow,786014,23908,762106,803,47,276,527
35049,80,15791,80,allow,5773,1197,4576,14,32,8,6
56020,53,34140,53,allow,199,102,97,2,29,1,1
56725,53,48111,53,allow,180,94,86,2,31,1,1
50438,19426,0,0,deny,62,62,0,1,0,1,0
55010,443,35131,443,allow,9023,4071,4952,30,35,17,13
50400,53,9416,53,allow,177,94,83,2,30,1,1
61534,445,0,0,drop,70,70,0,1,0,1,0
38885,21247,0,0,deny,62,62,0,1,0,1,0
44884,443,1595,443,allow,309,309,0,1,5,1,0
56458,53,36864,53,allow,192,98,94,2,31,1,1
64568,53,24682,53,allow,388,134,254,2,30,1,1
54415,443,40112,443,allow,7129,4391,2738,32,196,16,16
10396,62609,0,0,deny,148,148,0,1,0,1,0
61983,50432,0,0,deny,66,66,0,1,0,1,0
52815,80,10358,80,allow,1152,712,440,10,15,5,5
65440,53,2075,53,allow,189,102,87,2,30,1,1
6881,6881,0,0,deny,146,146,0,1,0,1,0
57326,443,4725,443,allow,5613,733,4880,16,14,9,7
18739,23,0,0,deny,60,60,0,1,0,1,0
4793,50584,0,0,deny,62,62,0,1,0,1,0
43366,53,27594,53,allow,168,78,90,2,30,1,1
56667,53,19814,53,allow,244,94,150,2,30,1,1
22683,39210,0,0,deny,60,60,0,1,0,1,0
64399,53,19303,53,allow,373,90,283,4,53,2,2
49798,53,23227,53,allow,196,102,94,2,30,1,1
27005,27016,43090,27016,allow,878,126,752,2,30,1,1
49263,53,54586,53,allow,178,94,84,2,30,1,1
52335,445,0,0,drop,70,70,0,1,0,1,0
53394,53,24735,53,allow,86,86,0,1,30,1,0
6881,49001,20436,49001,allow,210,111,99,2,1201,1,1
61608,445,0,0,drop,66,66,0,1,0,1,0
61513,445,0,0,drop,66,66,0,1,0,1,0
49106,53,49106,53,allow,1415,689,726,3,30,2,1
60347,80,6401,80,allow,2018,1704,314,16,15,11,5
56677,53,36331,53,allow,286,103,183,4,48,2,2
49495,53,39798,53,allow,758,102,656,2,31,1,1
8999,15503,0,0,deny,146,146,0,1,0,1,0
26799,6881,0,0,deny,146,146,0,1,0,1,0
57894,80,58107,80,allow,9800,2228,7572,23,24,12,11
50369,50584,0,0,deny,62,62,0,1,0,1,0
64998,27037,52668,27037,allow,3573,2238,1335,16,34,8,8
50431,445,0,0,drop,70,70,0,1,0,1,0
60446,6882,2486,6882,allow,70,70,0,2,8,2,0
50292,443,41099,443,allow,183024,16754,166270,247,28,114,133
54822,445,0,0,drop,70,70,0,1,0,1,0
44919,26467,0,0,deny,62,62,0,1,0,1,0
51866,22114,0,0,deny,66,66,0,1,0,1,0
49520,445,0,0,drop,70,70,0,1,0,1,0
55647,61042,18333,61042,allow,320,140,180,6,7,3,3
50286,53,44602,53,allow,766,102,664,2,30,1,1
49654,53,58880,53,allow,214,110,104,2,31,1,1
65327,445,0,0,drop,70,70,0,1,0,1,0
56608,443,64637,443,allow,8034,2014,6020,20,15,11,9
49193,443,7514,443,allow,3283,665,2618,16,160,7,9
35587,123,5043,123,allow,184,94,90,2,30,1,1
58346,53,2203,53,allow,209,102,107,2,30,1,1
65093,53,16648,53,allow,266,118,148,2,29,1,1
20170,23,0,0,deny,60,60,0,1,0,1,0
56445,53,19322,53,allow,374,94,280,2,30,1,1
38119,53,41188,53,allow,199,94,105,2,30,1,1
58638,5900,0,0,deny,62,62,0,1,0,1,0
49281,445,0,0,drop,66,66,0,1,0,1,0
55657,443,55657,443,allow,30650,11103,19547,66,51,40,26
9412,7302,0,0,deny,66,66,0,1,0,1,0
65014,53,36571,53,allow,193,102,91,2,30,1,1
58638,5900,0,0,deny,62,62,0,1,0,1,0
59456,445,0,0,drop,70,70,0,1,0,1,0
64959,53,50159,53,allow,173,94,79,2,30,1,1
64209,53,40539,53,allow,291,94,197,2,29,1,1
59796,23,0,0,deny,60,60,0,1,0,1,0
49343,443,10308,443,allow,1556,769,787,17,134,9,8
65155,445,0,0,drop,70,70,0,1,0,1,0
54288,445,0,0,drop,70,70,0,1,0,1,0
48826,25174,0,0,deny,66,66,0,1,0,1,0
0,0,0,0,allow,320,320,0,5,0,5,0
49418,27016,19249,27016,allow,240,71,169,2,30,1,1
55478,445,0,0,drop,66,66,0,1,0,1,0
50129,443,27980,443,allow,29436,9695,19741,54,34,30,24
61884,445,0,0,drop,70,70,0,1,0,1,0
56219,22114,0,0,deny,62,62,0,1,0,1,0
41714,443,33432,443,allow,4590,3026,1564,28,80,15,13
59128,443,26405,443,allow,92207,5395,86812,130,88,58,72
64071,53,55557,53,allow,194,102,92,2,31,1,1
49432,445,0,0,drop,70,70,0,1,0,1,0
42632,443,43354,443,allow,4299,1870,2429,17,150,8,9
54987,443,13107,443,allow,7502,2299,5203,37,18,21,16
58638,5900,0,0,deny,62,62,0,1,0,1,0
30114,65151,0,0,deny,60,60,0,1,0,1,0
10018,80,16761,80,allow,1052,612,440,10,15,5,5
43715,443,63901,443,allow,81803,3159,78644,93,20,33,60
56139,53,55354,53,allow,306,94,212,2,30,1,1
49512,53,60222,53,allow,195,102,93,2,31,1,1
64559,53,14656,53,allow,816,102,714,2,29,1,1
64899,53,42372,53,allow,767,102,665,2,29,1,1
35321,443,13287,443,allow,9675,2671,7004,36,262,18,18
56768,445,0,0,drop,66,66,0,1,0,1,0
59494,443,39878,443,allow,448,78,370,6,25,1,5
16979,56205,0,0,deny,62,62,0,1,0,1,0
55864,445,0,0,drop,70,70,0,1,0,1,0
65344,445,0,0,drop,70,70,0,1,0,1,0
49837,53,42825,53,allow,214,110,104,2,30,1,1
42429,22114,0,0,deny,146,146,0,1,0,1,0
64068,53,59683,53,allow,168,86,82,2,30,1,1
51177,445,0,0,drop,70,70,0,1,0,1,0
57094,53,64941,53,allow,192,98,94,2,31,1,1
49869,53,64308,53,allow,209,110,99,2,30,1,1
27452,5222,13129,5222,allow,3751,1007,2744,35,425,11,24
53171,443,32050,443,allow,11080,4277,6803,23,42,10,13
57761,30317,0,0,deny,66,66,0,1,0,1,0
49418,27015,32814,27015,allow,257,78,179,2,30,1,1
16387,22272,0,0,deny,60,60,0,1,0,1,0
56448,53,9031,53,allow,200,102,98,2,30,1,1
36712,53,0,0,allow,139,70,69,2,30,1,1
19858,64147,0,0,deny,62,62,0,1,0,1,0
63584,445,0,0,drop,70,70,0,1,0,1,0
55854,54369,0,0,deny,74,74,0,1,0,1,0
61002,37965,0,0,deny,145,145,0,1,0,1,0
62097,57470,0,0,deny,146,146,0,1,0,1,0
55643,53,52917,53,allow,183,94,89,2,31,1,1
65020,53,24466,53,allow,290,94,196,4,55,2,2
49483,80,60356,80,allow,318,192,126,6,40,4,2
49459,53,35212,53,allow,199,102,97,2,31,1,1
63082,445,0,0,drop,70,70,0,1,0,1,0
43227,443,48195,443,allow,460628,23936,436692,580,124,264,316
36961,443,20198,443,allow,7326,1399,5927,29,280,15,14
55599,53,39999,53,allow,258,94,164,2,29,1,1
63019,445,0,0,drop,66,66,0,1,0,1,0
60381,26312,6064,26312,allow,70,70,0,2,8,2,0
64309,53,55479,53,allow,549,188,361,6,57,3,3
60600,445,0,0,drop,70,70,0,1,0,1,0
49160,46824,0,0,deny,146,146,0,1,0,1,0
61528,445,0,0,drop,70,70,0,1,0,1,0
51238,443,29233,443,allow,8034,2584,5450,39,16,23,16
11136,57587,0,0,deny,145,145,0,1,0,1,0
50518,53,60220,53,allow,802,104,698,2,31,1,1
65495,11392,0,0,deny,66,66,0,1,0,1,0
59210,8168,0,0,deny,66,66,0,1,0,1,0
58638,5900,0,0,deny,62,62,0,1,0,1,0
58638,5900,0,0,deny,62,62,0,1,0,1,0
52682,22114,0,0,deny,66,66,0,1,0,1,0
22773,443,22773,443,allow,6993,960,6033,17,31,10,7
56938,53,31467,53,allow,452,101,351,4,36,2,2
55258,53,4040,53,allow,177,94,83,2,30,1,1
54689,445,0,0,drop,70,70,0,1,0,1,0
33627,36237,0,0,deny,66,66,0,1,0,1,0
52425,443,43475,443,allow,8454,978,7476,20,15,10,10
65114,443,65114,443,allow,4480,1573,2907,19,30,11,8
61457,445,0,0,drop,70,70,0,1,0,1,0
63063,445,0,0,drop,66,66,0,1,0,1,0
33053,53,52435,53,allow,164,78,86,2,31,1,1
56589,53,35173,53,allow,199,102,97,2,30,1,1
60434,445,0,0,drop,70,70,0,1,0,1,0
7372,25773,0,0,reset-both,139,139,0,1,0,1,0
59082,445,0,0,drop,66,66,0,1,0,1,0
52265,445,0,0,drop,66,66,0,1,0,1,0
55354,53,21132,53,allow,214,110,104,2,30,1,1
60746,40010,7294,40010,allow,316,136,180,6,6,3,3
2267,53,32602,53,allow,204,118,86,2,30,1,1
54395,445,0,0,drop,66,66,0,1,0,1,0
51703,3010,58034,3010,allow,70,70,0,1,5,1,0
55220,53,55080,53,allow,758,96,662,2,30,1,1
60138,443,19544,443,allow,2993,1992,1001,16,15,8,8
63838,445,0,0,drop,66,66,0,1,0,1,0
57654,35440,0,0,deny,66,66,0,1,0,1,0
63213,35440,0,0,deny,62,62,0,1,0,1,0
28570,25174,0,0,deny,146,146,0,1,0,1,0
993,3979,0,0,deny,129,129,0,1,0,1,0
52668,51221,0,0,deny,66,66,0,1,0,1,0
64818,53,5282,53,allow,174,89,85,2,30,1,1
49166,445,0,0,drop,70,70,0,1,0,1,0
52170,80,60754,80,allow,362,240,122,7,17,5,2
52361,23718,0,0,deny,66,66,0,1,0,1,0
55273,53,29948,53,allow,167,86,81,2,30,1,1
53460,445,0,0,drop,70,70,0,1,0,1,0
42298,40006,18530,40006,allow,243,180,63,2,31,1,1
51782,10637,37366,10637,allow,70,70,0,2,8,2,0
54280,3398,0,0,deny,60,60,0,1,0,1,0
63260,445,0,0,drop,66,66,0,1,0,1,0
57470,15564,5143,15564,allow,1577,594,983,20,1624,10,10
33328,25174,0,0,deny,146,146,0,1,0,1,0
49867,53,10689,53,allow,177,94,83,2,30,1,1
8282,25916,26002,25916,allow,133,64,69,3,33,2,1
51955,443,64636,443,allow,8390,1525,6865,24,26,11,13
50516,53,53120,53,allow,168,86,82,2,30,1,1
64375,53,1918,53,allow,228,110,118,2,29,1,1
54417,53,12775,53,allow,259,86,173,2,30,1,1
51365,445,0,0,drop,70,70,0,1,0,1,0
52895,443,23981,443,allow,18795,10297,8498,56,118,29,27
39393,22114,0,0,deny,146,146,0,1,0,1,0
51574,445,0,0,drop,66,66,0,1,0,1,0
37026,80,28562,80,allow,2849,1631,1218,9,721,5,4
63095,443,9067,443,allow,571,166,405,2,30,1,1
50686,443,29049,443,allow,6340,1381,4959,19,170,9,10
55888,445,0,0,drop,66,66,0,1,0,1,0
36903,56205,0,0,deny,62,62,0,1,0,1,0
0,0,0,0,allow,400,204,196,4,0,2,2
51725,56205,0,0,deny,62,62,0,1,0,1,0
55907,53,31154,53,allow,184,94,90,2,29,1,1
55618,53,59211,53,allow,255,102,153,2,30,1,1
60207,445,0,0,drop,70,70,0,1,0,1,0
56623,443,54121,443,allow,7982,1962,6020,20,15,11,9
63896,80,57609,80,allow,314,192,122,6,15,4,2
23332,80,23332,80,allow,490,264,226,8,26,5,3
57236,443,10665,443,allow,225524,59002,166522,402,78,192,210
49546,53,27218,53,allow,193,102,91,2,30,1,1
49577,445,0,0,drop,70,70,0,1,0,1,0
52986,443,58135,443,allow,280,140,140,5,130,3,2
58330,443,54762,443,allow,7353,2840,4513,33,107,18,15
44059,443,60027,443,allow,9730,1613,8117,24,170,11,13
45482,80,16084,80,allow,1130,624,506,11,15,5,6
61962,53733,0,0,deny,66,66,0,1,0,1,0
50593,64147,0,0,deny,66,66,0,1,0,1,0
62410,445,0,0,drop,66,66,0,1,0,1,0
55330,53,46578,53,allow,188,96,92,2,30,1,1
57170,3389,57170,3389,allow,3413,1458,1955,16,19,8,8
60380,443,8139,443,allow,70,70,0,2,8,2,0
64840,53,31006,53,allow,186,95,91,2,31,1,1
64359,445,0,0,drop,70,70,0,1,0,1,0
55053,53,47870,53,allow,216,102,114,2,30,1,1
55623,62853,62347,62853,allow,504,318,186,8,15,5,3
57706,64147,0,0,deny,62,62,0,1,0,1,0
55262,53,28090,53,allow,762,98,664,2,31,1,1
55081,445,0,0,drop,70,70,0,1,0,1,0
62149,22114,0,0,deny,66,66,0,1,0,1,0
55358,53,28706,53,allow,183,94,89,2,31,1,1
49695,445,0,0,drop,66,66,0,1,0,1,0
60680,445,0,0,drop,70,70,0,1,0,1,0
55598,445,0,0,drop,66,66,0,1,0,1,0
57598,443,10245,443,allow,12463,6762,5701,28,31,14,14
6666,27017,0,0,deny,60,60,0,1,0,1,0
5588,5588,0,0,allow,3562,1936,1626,48,195,24,24
57731,443,57731,443,allow,5508,2261,3247,22,38,13,9
64997,53,57263,53,allow,166,86,80,2,31,1,1
60184,37965,0,0,deny,66,66,0,1,0,1,0
50864,445,0,0,drop,66,66,0,1,0,1,0
53527,45626,13998,45626,allow,70,70,0,1,5,1,0
57416,53,21354,53,allow,193,102,91,2,30,1,1
64190,445,0,0,drop,66,66,0,1,0,1,0
35949,31573,0,0,deny,146,146,0,1,0,1,0
49715,53,39049,53,allow,807,94,713,2,30,1,1
65251,53,53427,53,allow,199,102,97,2,30,1,1
37395,443,29125,443,allow,16590,1630,14960,33,199,15,18
55810,53,5823,53,allow,183,94,89,2,31,1,1
48676,53395,0,0,deny,60,60,0,1,0,1,0
57601,80,57601,80,allow,25872,4400,21472,41,38,16,25
63344,445,0,0,drop,70,70,0,1,0,1,0
43888,64147,0,0,deny,62,62,0,1,0,1,0
2522,64147,0,0,deny,62,62,0,1,0,1,0
58401,445,0,0,drop,70,70,0,1,0,1,0
58055,56205,0,0,deny,146,146,0,1,0,1,0
64250,53,22733,53,allow,314,102,212,2,29,1,1
61717,445,0,0,drop,70,70,0,1,0,1,0
51963,445,0,0,deny,66,66,0,1,0,1,0
52157,80,19874,80,allow,366,240,126,7,32,5,2
49345,443,62638,443,allow,26156,6762,19394,37,16,16,21
53725,443,12003,443,allow,499,425,74,4,0,3,1
26799,50584,0,0,deny,146,146,0,1,0,1,0
38956,443,38557,443,allow,9096,4245,4851,29,121,14,15
36826,443,2632,443,allow,6040,1612,4428,21,255,12,9
49413,443,21606,443,allow,7849,1104,6745,23,123,12,11
50725,443,41613,443,allow,6593,3522,3071,56,76,33,23
57339,57470,0,0,deny,66,66,0,1,0,1,0
62191,445,0,0,drop,70,70,0,1,0,1,0
57763,52752,0,0,deny,66,66,0,1,0,1,0
57638,80,57638,80,allow,29263,2432,26831,36,31,13,23
49482,22,0,0,deny,60,60,0,1,0,1,0
56920,445,0,0,drop,70,70,0,1,0,1,0
39540,37965,0,0,deny,66,66,0,1,0,1,0
48576,443,26108,443,allow,476,410,66,4,0,3,1
51803,445,0,0,drop,70,70,0,1,0,1,0
53004,445,0,0,drop,66,66,0,1,0,1,0
48080,22,0,0,deny,60,60,0,1,0,1,0
65143,53,8081,53,allow,199,102,97,2,30,1,1
63991,53,7704,53,allow,186,95,91,2,31,1,1
54521,445,0,0,drop,66,66,0,1,0,1,0
51632,445,0,0,drop,70,70,0,1,0,1,0
41848,23,0,0,deny,60,60,0,1,0,1,0
62413,445,0,0,drop,70,70,0,1,0,1,0
64135,53,40678,53,allow,196,102,94,2,30,1,1
50254,44847,0,0,deny,66,66,0,1,0,1,0
6881,45378,0,0,deny,146,146,0,1,0,1,0
50596,53,57766,53,allow,168,86,82,2,30,1,1
56104,53,55768,53,allow,210,110,100,2,30,1,1
65515,53,32592,53,allow,204,104,100,2,31,1,1
64792,53,47254,53,allow,166,86,80,2,30,1,1
52966,80,53251,80,allow,2974,1352,1622,28,113,15,13
49504,443,14991,443,allow,18746,2976,15770,32,32,12,20
51752,445,0,0,drop,66,66,0,1,0,1,0
40547,24051,0,0,deny,74,74,0,1,0,1,0
55705,53,13969,53,allow,281,101,180,4,58,2,2
65515,53,42704,53,allow,210,110,100,2,29,1,1
34155,443,36605,443,allow,154,94,60,2,5,1,1
13528,51221,0,0,deny,62,62,0,1,0,1,0
6881,6881,9262,6881,allow,501,150,351,2,1200,1,1
56962,53,51903,53,allow,170,87,83,2,30,1,1
12929,41864,0,0,deny,145,145,0,1,0,1,0
60911,53,60911,53,allow,216,90,126,2,30,1,1
1955,35974,0,0,deny,60,60,0,1,0,1,0
63055,445,0,0,drop,70,70,0,1,0,1,0
60929,80,45754,80,allow,2235,1055,1180,12,15,7,5
54444,443,57397,443,allow,9802,2594,7208,25,360,10,15
59624,443,22456,443,allow,18261,2059,16202,40,31,20,20
64041,80,63585,80,allow,314,192,122,6,15,4,2
52198,12727,50505,12727,allow,66,66,0,2,10,2,0
55184,53,55740,53,allow,443,92,351,4,31,2,2
43671,37965,0,0,deny,62,62,0,1,0,1,0
50581,445,0,0,drop,70,70,0,1,0,1,0
51393,445,0,0,drop,66,66,0,1,0,1,0
57598,443,59383,443,allow,3323,2398,925,18,21,10,8
55155,53,65476,53,allow,188,96,92,2,31,1,1
25589,23,0,0,deny,60,60,0,1,0,1,0
55542,443,51637,443,allow,58975,3359,55616,78,26,34,44
48452,443,56539,443,allow,9553,2175,7378,33,27,17,16
49476,445,0,0,drop,66,66,0,1,0,1,0
58638,5900,0,0,deny,62,62,0,1,0,1,0
34454,80,32778,80,allow,1638,1324,314,10,14,5,5
49945,445,0,0,drop,70,70,0,1,0,1,0
27005,27016,56355,27016,allow,1646,126,1520,4,31,2,2
65355,443,1822,443,allow,3563945,186679,3377266,4424,723,1877,2547
45964,2225,0,0,deny,60,60,0,1,0,1,0
52112,443,29903,443,allow,59796,4486,55310,92,48,45,47
18653,42707,0,0,deny,66,66,0,1,0,1,0
61616,23,0,0,deny,60,60,0,1,0,1,0
59207,445,0,0,drop,70,70,0,1,0,1,0
29972,50584,0,0,deny,62,62,0,1,0,1,0
9552,22114,0,0,deny,146,146,0,1,0,1,0
49831,30188,0,0,deny,66,66,0,1,0,1,0
27005,27016,63308,27016,allow,887,126,761,2,30,1,1
58638,5900,0,0,deny,62,62,0,1,0,1,0
62424,445,0,0,drop,70,70,0,1,0,1,0
56571,53,42202,53,allow,325,102,223,2,30,1,1
58984,443,13660,443,allow,4874459,114404,4760055,4469,188,1112,3357
39599,443,45420,443,allow,1352,691,661,14,18,8,6
51413,1,0,0,deny,72,72,0,1,0,1,0
57330,53,57913,53,allow,177,94,83,2,30,1,1
5683,44847,0,0,deny,66,66,0,1,0,1,0
10627,23117,0,0,deny,66,66,0,1,0,1,0
53921,18183,42637,18183,allow,826,386,440,12,15,6,6
59607,53,65103,53,allow,209,102,107,2,30,1,1
65102,53,35796,53,allow,183,94,89,2,30,1,1
65500,443,21161,443,allow,91813,4379,87434,101,16,37,64
21502,44847,0,0,deny,66,66,0,1,0,1,0
60778,445,0,0,drop,66,66,0,1,0,1,0
49332,445,0,0,drop,66,66,0,1,0,1,0
65528,53,44314,53,allow,168,86,82,2,30,1,1
44879,443,44879,443,allow,7123,1020,6103,19,151,11,8
55951,30188,0,0,deny,66,66,0,1,0,1,0
59982,443,10585,443,allow,3640,870,2770,13,120,6,7
26601,22114,0,0,deny,66,66,0,1,0,1,0
52138,445,0,0,drop,66,66,0,1,0,1,0
22220,25174,0,0,deny,62,62,0,1,0,1,0
60869,48817,0,0,deny,66,66,0,1,0,1,0
56748,443,11472,443,allow,8007,1987,6020,20,15,11,9
55008,445,0,0,drop,70,70,0,1,0,1,0
53620,443,60649,443,allow,15422,1623,13799,34,18,14,20
56551,53,16307,53,allow,458,188,270,6,30,3,3
52968,445,0,0,drop,66,66,0,1,0,1,0
21133,59392,22505,59392,allow,481,150,331,2,1199,1,1
59165,53,3283,53,allow,186,78,108,2,30,1,1
64556,53,40982,53,allow,195,102,93,2,30,1,1
49891,53,34490,53,allow,166,86,80,2,30,1,1
52969,44847,0,0,deny,66,66,0,1,0,1,0
52045,445,0,0,drop,70,70,0,1,0,1,0
56515,53,8193,53,allow,177,94,83,2,29,1,1
19963,2767,0,0,deny,66,66,0,1,0,1,0
57228,8525,57228,8525,allow,138,78,60,2,5,1,1
45589,53,45589,53,allow,225,106,119,2,30,1,1
57337,64147,0,0,deny,66,66,0,1,0,1,0
49742,53,36313,53,allow,216,110,106,2,30,1,1
64980,53,54616,53,allow,200,102,98,2,30,1,1
58638,5900,0,0,deny,62,62,0,1,0,1,0
29682,44847,0,0,deny,62,62,0,1,0,1,0
64680,22114,0,0,deny,146,146,0,1,0,1,0
64549,445,0,0,drop,66,66,0,1,0,1,0
62824,37807,0,0,deny,66,66,0,1,0,1,0
41914,443,49039,443,allow,466,392,74,4,0,3,1
55715,53,18469,53,allow,168,86,82,2,30,1,1
58600,443,58600,443,allow,4398,1491,2907,19,28,11,8
6881,6881,26676,6881,allow,238,118,120,2,1200,1,1
62360,445,0,0,drop,70,70,0,1,0,1,0
51914,80,46843,80,allow,366,240,126,7,28,5,2
49742,53,40944,53,allow,790,110,680,2,30,1,1
38698,443,50432,443,allow,90261,3545,86716,96,16,32,64
27005,27015,38552,27015,allow,876,126,750,2,31,1,1
63752,445,0,0,drop,70,70,0,1,0,1,0
53983,40500,52248,40500,allow,70,70,0,2,7,2,0
49708,53,46475,53,allow,193,102,91,2,30,1,1
55859,445,0,0,drop,66,66,0,1,0,1,0
15503,14130,48221,14130,allow,480,149,331,2,1200,1,1
57033,445,0,0,drop,66,66,0,1,0,1,0
60505,443,23004,443,allow,1061,727,334,9,26,4,5
63779,26467,0,0,deny,66,66,0,1,0,1,0
48188,443,44045,443,allow,1263,536,727,13,82,6,7
57300,53,9339,53,allow,184,94,90,2,29,1,1
42128,54532,0,0,deny,60,60,0,1,0,1,0
64910,53,52147,53,allow,259,86,173,2,30,1,1
60922,445,0,0,drop,66,66,0,1,0,1,0
56014,53,32746,53,allow,711,87,624,2,30,1,1
51426,80,51426,80,allow,114697,3049,111648,114,26,35,79
62172,445,0,0,drop,66,66,0,1,0,1,0
57417,53,39419,53,allow,199,102,97,2,30,1,1
56952,53,53652,53,allow,487,136,351,4,46,2,2
65428,53,32499,53,allow,190,97,93,2,31,1,1
49342,443,27856,443,allow,6944,2404,4540,21,15,10,11
63810,27064,25460,27064,allow,1778,1386,392,8,31,4,4
60645,35440,0,0,deny,66,66,0,1,0,1,0
54198,445,0,0,drop,66,66,0,1,0,1,0
65109,445,0,0,drop,70,70,0,1,0,1,0
63759,64509,33605,64509,allow,66,66,0,2,7,2,0
49864,53,65077,53,allow,212,102,110,2,30,1,1
52664,445,0,0,drop,66,66,0,1,0,1,0
56417,53,44124,53,allow,752,93,659,2,30,1,1
52471,22114,0,0,deny,66,66,0,1,0,1,0
30960,45705,10345,45705,allow,396,396,0,7,3617,7,0
58638,5900,0,0,deny,62,62,0,1,0,1,0
56394,443,33249,443,allow,12371,1344,11027,30,3944,10,20
50237,445,0,0,drop,70,70,0,1,0,1,0
42040,5228,16525,5228,allow,60,60,0,1,5,1,0
59345,445,0,0,drop,66,66,0,1,0,1,0
43817,443,47281,443,allow,5911,1666,4245,27,18,15,12
64930,53,28381,53,allow,193,102,91,2,31,1,1
56117,53,21155,53,allow,178,94,84,2,30,1,1
52127,44198,39130,44198,allow,70,70,0,2,8,2,0
1067,51221,0,0,deny,62,62,0,1,0,1,0
64087,445,0,0,drop,70,70,0,1,0,1,0
39042,443,16986,443,allow,19733,3606,16127,43,16,22,21
55123,64097,0,0,deny,66,66,0,1,0,1,0
49512,445,0,0,drop,70,70,0,1,0,1,0
58638,5900,0,0,deny,62,62,0,1,0,1,0
56218,43890,0,0,deny,66,66,0,1,0,1,0
61001,445,0,0,drop,66,66,0,1,0,1,0
58638,5900,0,0,deny,62,62,0,1,0,1,0
49639,443,42419,443,allow,21062,2202,18860,34,80,15,19
54721,22114,0,0,deny,66,66,0,1,0,1,0
56151,445,0,0,drop,70,70,0,1,0,1,0
55750,53,13328,53,allow,211,110,101,2,30,1,1
62904,80,35309,80,allow,1515,481,1034,11,16,6,5
65487,445,0,0,drop,66,66,0,1,0,1,0
27005,27018,14110,27018,allow,881,126,755,2,30,1,1
53825,443,49613,443,allow,499,425,74,4,0,3,1
9468,80,22561,80,allow,1835,421,1414,9,15,4,5
55431,443,58607,443,allow,999955,25445,974510,1003,171,325,678
55710,53,65057,53,allow,198,93,105,2,30,1,1
55994,53,19158,53,allow,182,93,89,2,31,1,1
58917,53,38602,53,allow,192,82,110,2,30,1,1
61078,445,0,0,drop,66,66,0,1,0,1,0
13518,25174,0,0,deny,62,62,0,1,0,1,0
64998,27037,18339,27037,allow,3287,2072,1215,12,30,6,6
50354,80,47927,80,allow,306,180,126,6,25,4,2
53950,32057,38888,32057,allow,70,70,0,2,7,2,0
64788,43890,0,0,deny,66,66,0,1,0,1,0
50993,445,0,0,drop,66,66,0,1,0,1,0
51806,443,51806,443,allow,1466,856,610,13,27,6,7
55541,53,53785,53,allow,772,100,672,2,31,1,1
55503,53,56462,53,allow,216,110,106,2,30,1,1
50567,443,16036,443,allow,5866,1781,4085,21,81,12,9
65124,53,4615,53,allow,353,118,235,2,30,1,1
49860,53,48565,53,allow,168,86,82,2,31,1,1
54146,445,0,0,drop,70,70,0,1,0,1,0
62074,443,56208,443,allow,350,210,140,6,15,4,2
49170,445,0,0,drop,70,70,0,1,0,1,0
49696,443,61815,443,allow,42348,4871,37477,71,150,40,31
63059,443,42784,443,allow,5772,3849,1923,27,270,14,13
51652,80,52729,80,allow,32942,2548,30394,58,255,28,30
59053,53,2855,53,allow,227,86,141,2,30,1,1
48838,8080,7294,8080,allow,533,327,206,8,33,5,3
50791,445,0,0,drop,70,70,0,1,0,1,0
57909,445,0,0,drop,70,70,0,1,0,1,0
50631,80,34721,80,allow,14784,7048,7736,31,27,18,13
54578,26467,0,0,deny,66,66,0,1,0,1,0
49934,80,37957,80,allow,1130,613,517,11,15,6,5
62506,445,0,0,drop,66,66,0,1,0,1,0
51242,80,19033,80,allow,3506,2280,1226,24,50,13,11
63652,443,53205,443,allow,51005,2084,48921,61,120,22,39
56712,46824,0,0,deny,62,62,0,1,0,1,0
65135,445,0,0,drop,66,66,0,1,0,1,0
25436,53,25436,53,allow,235,90,145,2,32,1,1
37618,443,28939,443,allow,28034,26485,1549,48,16,29,19
54024,445,0,0,drop,70,70,0,1,0,1,0
58638,5900,0,0,deny,62,62,0,1,0,1,0
60123,445,0,0,drop,70,70,0,1,0,1,0
64332,53,6045,53,allow,167,86,81,2,30,1,1
60997,445,0,0,drop,70,70,0,1,0,1,0
44250,443,49251,443,allow,3374,2106,1268,19,15,10,9
57249,445,0,0,drop,70,70,0,1,0,1,0
51943,55464,52953,55464,allow,70,70,0,1,5,1,0
60169,445,0,0,drop,70,70,0,1,0,1,0
63969,445,0,0,drop,66,66,0,1,0,1,0
11020,62413,0,0,deny,62,62,0,1,0,1,0
31680,53,31680,53,allow,404,259,145,3,32,2,1
63557,445,0,0,drop,70,70,0,1,0,1,0
58440,22114,0,0,deny,146,146,0,1,0,1,0
50436,80,19701,80,allow,314,192,122,6,26,4,2
55489,80,62350,80,allow,180504,12712,167792,229,32,105,124
36438,5223,19564,5223,allow,5243,1898,3345,34,3005,18,16
51425,37450,0,0,deny,62,62,0,1,0,1,0
56187,445,0,0,drop,70,70,0,1,0,1,0
50095,53,10662,53,allow,168,86,82,2,30,1,1
58844,51505,0,0,deny,66,66,0,1,0,1,0
57288,443,58142,443,allow,116807,21042,95765,315,19,161,154
56927,53,35589,53,allow,183,94,89,2,30,1,1
49700,53,14464,53,allow,165,78,87,2,30,1,1
50139,443,27090,443,allow,72523,5814,66709,125,255,61,64
56421,80,51921,80,allow,34300,868,33432,35,104,10,25
29623,37807,0,0,deny,146,146,0,1,0,1,0
19371,53,19371,53,allow,214,82,132,2,31,1,1
13840,37965,0,0,deny,146,146,0,1,0,1,0
49301,53,20768,53,allow,214,102,112,2,30,1,1
56655,53,54773,53,allow,86,86,0,1,29,1,0
53948,445,0,0,drop,70,70,0,1,0,1,0
45590,53,0,0,allow,82,82,0,1,31,1,0
59994,11446,0,0,deny,66,66,0,1,0,1,0
49184,445,0,0,drop,66,66,0,1,0,1,0
27724,53,46943,53,allow,322,84,238,4,29,2,2
27641,39004,0,0,deny,62,62,0,1,0,1,0
59002,53,19057,53,allow,238,94,144,2,30,1,1
58251,36237,0,0,deny,66,66,0,1,0,1,0
64913,53,23262,53,allow,194,102,92,2,29,1,1
23770,50584,0,0,deny,66,66,0,1,0,1,0
49630,53,20567,53,allow,374,126,248,2,30,1,1
55365,53,47603,53,allow,184,94,90,2,31,1,1
52245,445,0,0,drop,70,70,0,1,0,1,0
58499,445,0,0,drop,70,70,0,1,0,1,0
55877,12187,8942,12187,allow,150,150,0,1,1200,1,0
27005,27015,9880,27015,allow,937,126,811,2,30,1,1
61100,80,15206,80,allow,1516,481,1035,11,15,6,5
1059,44847,0,0,deny,62,62,0,1,0,1,0
42110,80,55658,80,allow,1056,682,374,10,15,6,4
64240,50584,0,0,deny,62,62,0,1,0,1,0
49355,443,38735,443,allow,4960,896,4064,14,16,8,6
40942,123,62465,123,allow,184,94,90,2,30,1,1
63594,445,0,0,drop,70,70,0,1,0,1,0
51940,53,28110,53,allow,199,94,105,2,30,1,1
55704,445,0,0,drop,66,66,0,1,0,1,0
64896,53,50820,53,allow,195,94,101,2,30,1,1
51888,42529,42090,42529,allow,316,136,180,6,6,3,3
5588,5588,0,0,allow,3562,1936,1626,48,192,24,24
50027,21247,0,0,deny,66,66,0,1,0,1,0
58962,80,58962,80,allow,22844,1529,21315,39,28,20,19
65398,53,49816,53,allow,214,110,104,2,30,1,1
51162,445,0,0,drop,70,70,0,1,0,1,0
3608,25773,0,0,reset-both,146,146,0,1,0,1,0
59509,64147,0,0,deny,145,145,0,1,0,1,0
27005,27015,62179,27015,allow,889,126,763,2,30,1,1
55679,445,0,0,drop,70,70,0,1,0,1,0
34517,53,34517,53,allow,200,82,118,2,30,1,1
55268,53,2485,53,allow,193,102,91,2,30,1,1
56415,53,51829,53,allow,179,94,85,2,30,1,1
51197,57470,0,0,deny,62,62,0,1,0,1,0
53554,8999,6458,8999,allow,130,70,60,3,6,2,1
64001,13051,4222,13051,allow,70,70,0,1,4,1,0
27773,56205,0,0,deny,62,62,0,1,0,1,0
50354,443,29554,443,allow,1786,172,1614,7,120,3,4
49212,80,10274,80,allow,912,410,502,10,15,5,5
56786,53,65502,53,allow,817,102,715,2,30,1,1
44355,443,45033,443,allow,354,140,214,6,131,3,3
59422,51221,0,0,deny,62,62,0,1,0,1,0
51006,445,0,0,drop,66,66,0,1,0,1,0
27005,27015,31472,27015,allow,888,126,762,2,30,1,1
49418,27015,34023,27015,allow,249,71,178,2,30,1,1
50389,8080,50389,8080,allow,5724,1509,4215,18,55,10,8
56010,53,24880,53,allow,184,94,90,2,30,1,1
56793,53,43867,53,allow,196,102,94,2,30,1,1
49531,53,39343,53,allow,289,94,195,4,31,2,2
58638,5900,0,0,deny,62,62,0,1,0,1,0
46910,443,1706,443,allow,5714,1536,4178,24,21,13,11
50738,445,0,0,drop,66,66,0,1,0,1,0
38573,443,38573,443,allow,5744,2534,3210,24,80,14,10
46162,25174,0,0,deny,62,62,0,1,0,1,0
23650,37807,0,0,deny,66,66,0,1,0,1,0
61827,445,0,0,drop,70,70,0,1,0,1,0
56742,445,0,0,drop,70,70,0,1,0,1,0
58713,445,0,0,drop,70,70,0,1,0,1,0
56260,445,0,0,drop,70,70,0,1,0,1,0
58759,445,0,0,drop,70,70,0,1,0,1,0
53268,443,33392,443,allow,13176,4779,8397,47,17,29,18
27005,27014,60254,27014,allow,879,126,753,2,31,1,1
62684,445,0,0,drop,66,66,0,1,0,1,0
56632,443,17597,443,allow,13148,2310,10838,29,80,16,13
56881,445,0,0,drop,70,70,0,1,0,1,0
56006,23,0,0,deny,60,60,0,1,0,1,0
58079,50584,0,0,deny,62,62,0,1,0,1,0
62599,445,0,0,drop,66,66,0,1,0,1,0
61128,445,0,0,drop,70,70,0,1,0,1,0
443,43775,0,0,deny,97,97,0,1,0,1,0
32770,51505,0,0,deny,62,62,0,1,0,1,0
54134,64147,0,0,deny,66,66,0,1,0,1,0
51287,445,0,0,drop,70,70,0,1,0,1,0
54980,53,25043,53,allow,763,101,662,2,30,1,1
64001,13051,20049,13051,allow,66,66,0,2,7,2,0
58835,17372,0,0,deny,66,66,0,1,0,1,0
53904,1024,57585,1024,allow,70,70,0,2,8,2,0
51961,40373,22472,40373,allow,70,70,0,1,5,1,0
59819,445,0,0,drop,70,70,0,1,0,1,0
51988,53,22023,53,allow,78,78,0,1,30,1,0
49609,53,22044,53,allow,170,87,83,2,30,1,1
55762,53,8136,53,allow,196,86,110,2,29,1,1
49941,445,0,0,drop,70,70,0,1,0,1,0
55641,53,35786,53,allow,184,94,90,2,31,1,1
54088,445,0,0,drop,70,70,0,1,0,1,0
29787,37965,0,0,deny,62,62,0,1,0,1,0
17842,22114,0,0,deny,62,62,0,1,0,1,0
63336,445,0,0,drop,66,66,0,1,0,1,0
6916,9822,0,0,deny,100,100,0,1,0,1,0
47261,443,56817,443,allow,4536,845,3691,16,15,9,7
61312,445,0,0,drop,70,70,0,1,0,1,0
56561,443,57452,443,allow,341343,9074,332269,353,121,122,231
59895,443,59498,443,allow,1537,934,603,14,32,7,7
64940,445,0,0,drop,70,70,0,1,0,1,0
25101,50584,0,0,deny,62,62,0,1,0,1,0
56787,53,40108,53,allow,209,110,99,2,30,1,1
65417,53,49087,53,allow,402,118,284,2,30,1,1
61987,445,0,0,drop,70,70,0,1,0,1,0
55820,53,20613,53,allow,168,86,82,2,30,1,1
55026,445,0,0,drop,70,70,0,1,0,1,0
51071,443,30007,443,allow,13412,5710,7702,50,257,24,26
55412,445,0,0,drop,70,70,0,1,0,1,0
45995,443,45995,443,allow,1494,898,596,12,142,6,6
9226,57470,0,0,deny,66,66,0,1,0,1,0
64024,22114,0,0,deny,66,66,0,1,0,1,0
61000,15503,0,0,deny,146,146,0,1,0,1,0
43374,443,52439,443,allow,10176,2162,8014,25,186,14,11
53036,80,53036,80,allow,2954,720,2234,13,143,6,7
65085,53,45076,53,allow,258,102,156,2,30,1,1
63569,445,0,0,drop,66,66,0,1,0,1,0
49256,53,11555,53,allow,179,94,85,2,30,1,1
65511,53,46791,53,allow,214,102,112,2,30,1,1
12677,53,12677,53,allow,234,93,141,2,30,1,1
26900,27017,11369,27017,allow,422,164,258,6,30,3,3
37696,443,12389,443,allow,32798,2912,29886,58,170,29,29
52925,64147,0,0,deny,62,62,0,1,0,1,0
50140,53,8390,53,allow,177,94,83,2,30,1,1
60470,51413,5081,51413,allow,741,435,306,10,16,5,5
57008,53,37986,53,allow,255,110,145,2,30,1,1
49596,80,27800,80,allow,312,192,120,6,41,4,2
65282,53,57609,53,allow,522,91,431,4,49,2,2
49285,6881,35710,6881,allow,411,225,186,6,16,3,3
50593,445,0,0,drop,66,66,0,1,0,1,0
58638,5900,0,0,deny,62,62,0,1,0,1,0
49272,53,48276,53,allow,168,86,82,2,33,1,1
56827,18318,42346,18318,allow,70,70,0,1,5,1,0
31675,19473,0,0,deny,145,145,0,1,0,1,0
56630,80,55230,80,allow,234,234,0,4,12,4,0
27528,35440,0,0,deny,62,62,0,1,0,1,0
61150,11392,0,0,deny,66,66,0,1,0,1,0
59569,445,0,0,drop,66,66,0,1,0,1,0
49217,53,2129,53,allow,209,110,99,2,31,1,1
59765,445,0,0,drop,70,70,0,1,0,1,0
34572,443,63392,443,allow,52330,13948,38382,131,129,71,60
57419,53,26611,53,allow,196,102,94,2,30,1,1
57615,445,0,0,drop,70,70,0,1,0,1,0
443,61686,0,0,deny,1484,1484,0,1,0,1,0
46455,53,32632,53,allow,168,78,90,2,30,1,1
9261,80,32507,80,allow,378,192,186,7,26,4,3
58638,5900,0,0,deny,62,62,0,1,0,1,0
49135,443,9255,443,allow,2529,1230,1299,17,16,9,8
61383,445,0,0,drop,70,70,0,1,0,1,0
27005,27017,35476,27017,allow,882,126,756,2,31,1,1
60486,8999,41044,8999,allow,70,70,0,1,5,1,0
54989,443,11421,443,allow,34038,16039,17999,79,63,43,36
49771,80,10429,80,allow,254,128,126,5,16,3,2
58393,445,0,0,drop,70,70,0,1,0,1,0
56752,53,15313,53,allow,183,94,89,2,31,1,1
45941,23386,0,0,deny,60,60,0,1,0,1,0
53302,445,0,0,drop,66,66,0,1,0,1,0
49672,80,61052,80,allow,3874260,98179,3776081,4003,1072,1479,2524
57323,53,18058,53,allow,188,96,92,2,31,1,1
56791,11500,39420,11500,allow,70,70,0,2,8,2,0
56615,53,15642,53,allow,177,94,83,2,29,1,1
59777,443,29457,443,allow,966,480,486,17,29,9,8
34932,38608,0,0,deny,62,62,0,1,0,1,0
48839,37807,0,0,deny,62,62,0,1,0,1,0
55661,49671,27582,49671,allow,70,70,0,1,5,1,0
58638,5900,0,0,deny,62,62,0,1,0,1,0
59815,445,0,0,drop,66,66,0,1,0,1,0
56173,445,0,0,drop,70,70,0,1,0,1,0
58128,44847,0,0,deny,146,146,0,1,0,1,0
57223,445,0,0,drop,66,66,0,1,0,1,0
62301,445,0,0,drop,70,70,0,1,0,1,0
63708,445,0,0,drop,70,70,0,1,0,1,0
56689,53,17079,53,allow,264,91,173,4,38,2,2
52781,445,0,0,drop,66,66,0,1,0,1,0
51985,80,32955,80,allow,1479,822,657,11,25,7,4
56307,52700,0,0,deny,66,66,0,1,0,1,0
46028,80,31228,80,allow,1176793,65077,1111716,1528,85,788,740
65116,53,4360,53,allow,214,110,104,2,30,1,1
53635,22383,54338,22383,allow,492,306,186,8,17,5,3
60950,443,63675,443,allow,7431,2753,4678,40,18,21,19
10850,53,10850,53,allow,237,91,146,2,34,1,1
63959,445,0,0,drop,66,66,0,1,0,1,0
58259,445,0,0,drop,70,70,0,1,0,1,0
50226,443,45230,443,allow,7726,4613,3113,21,137,11,10
49593,80,60078,80,allow,7098,5692,1406,17,41,9,8
6247,51221,0,0,deny,62,62,0,1,0,1,0
64084,445,0,0,drop,66,66,0,1,0,1,0
64276,53,63257,53,allow,398,105,293,4,46,2,2
58071,445,0,0,drop,70,70,0,1,0,1,0
46389,27098,0,0,deny,66,66,0,1,0,1,0
56980,53,28670,53,allow,267,87,180,4,38,2,2
56502,443,5913,443,allow,5414,1010,4404,17,33,9,8
55383,445,0,0,drop,70,70,0,1,0,1,0
55615,53,23565,53,allow,772,100,672,2,31,1,1
57470,6882,62846,6882,allow,528,528,0,9,1200,9,0
65189,27202,50060,27202,allow,230,78,152,2,29,1,1
49734,53,20221,53,allow,216,110,106,2,30,1,1
64932,445,0,0,drop,70,70,0,1,0,1,0
51263,443,57364,443,allow,162,102,60,2,5,1,1
49429,53,55360,53,allow,194,102,92,2,30,1,1
0,0,0,0,allow,274,274,0,2,0,2,0
49421,53,13940,53,allow,215,94,121,2,29,1,1
12830,25174,0,0,deny,146,146,0,1,0,1,0
49706,53,30583,53,allow,296,102,194,4,41,2,2
62029,22114,0,0,deny,66,66,0,1,0,1,0
52319,443,62232,443,allow,569666,25343,544323,721,46,320,401
51945,1587,22122,1587,allow,70,70,0,2,8,2,0
64847,445,0,0,drop,70,70,0,1,0,1,0
65068,445,0,0,drop,66,66,0,1,0,1,0
19161,26296,0,0,deny,159,159,0,1,0,1,0
59886,64147,0,0,deny,72,72,0,1,0,1,0
63218,22,63218,22,allow,9001,4087,4914,59,39,27,32
54684,37965,0,0,deny,62,62,0,1,0,1,0
55972,53,29588,53,allow,262,126,136,2,30,1,1
50955,445,0,0,drop,66,66,0,1,0,1,0
50517,80,5050,80,allow,502,256,246,9,25,5,4
49541,443,61178,443,allow,8464,2891,5573,20,30,10,10
56330,445,0,0,drop,70,70,0,1,0,1,0
55931,445,0,0,drop,70,70,0,1,0,1,0
59792,80,59792,80,allow,33435,1694,31741,43,20,18,25
60372,445,0,0,drop,66,66,0,1,0,1,0
64282,445,0,0,drop,70,70,0,1,0,1,0
443,56513,0,0,deny,78,78,0,1,0,1,0
60769,443,35964,443,allow,3758,1691,2067,12,135,6,6
55978,445,0,0,drop,70,70,0,1,0,1,0
28668,8696,0,0,deny,60,60,0,1,0,1,0
65229,53,52095,53,allow,193,102,91,2,30,1,1
60437,30889,62883,30889,allow,1729,1125,604,14,16,8,6
49769,445,0,0,drop,66,66,0,1,0,1,0
48008,443,47118,443,allow,10665,3059,7606,28,17,16,12
49724,443,6596,443,allow,7226,844,6382,19,50,9,10
26758,443,6342,443,allow,20851,15854,4997,36,20,20,16
38725,80,37134,80,allow,130,70,60,2,15,1,1
64110,53,20636,53,allow,215,102,113,2,30,1,1
49365,443,7020,443,allow,442336,371266,71070,1143,762,651,492
55719,8060,30409,8060,allow,70,70,0,2,7,2,0
54979,53,3280,53,allow,97,97,0,1,61,1,0
58311,445,0,0,drop,70,70,0,1,0,1,0
54883,51505,0,0,deny,66,66,0,1,0,1,0
33147,443,60062,443,allow,7639,948,6691,25,395,9,16
51802,21555,33946,21555,allow,316,136,180,6,6,3,3
54420,443,57977,443,allow,5809,1552,4257,19,74,11,8
56703,443,53583,443,allow,8006,1986,6020,20,15,11,9
11337,15503,0,0,deny,62,62,0,1,0,1,0
64748,53,54658,53,allow,212,102,110,2,30,1,1
49705,22,49705,22,allow,1108,66,1042,3,15,2,1
55727,53,2459,53,allow,195,102,93,2,29,1,1
64324,445,0,0,drop,70,70,0,1,0,1,0
48847,443,57026,443,allow,2478246,45190,2433056,2175,27,520,1655
54127,443,25652,443,allow,148422,10568,137854,223,115,114,109
34157,443,57470,443,allow,154,94,60,2,5,1,1
52242,3749,25339,3749,allow,70,70,0,2,7,2,0
65189,27017,19229,27017,allow,239,78,161,2,30,1,1
56381,443,16712,443,allow,7236,2290,4946,18,16,11,7
53413,35440,0,0,deny,146,146,0,1,0,1,0
59606,445,0,0,drop,70,70,0,1,0,1,0
63717,37965,0,0,deny,62,62,0,1,0,1,0
56904,445,0,0,drop,70,70,0,1,0,1,0
49322,443,25281,443,allow,3005,2082,923,18,28,9,9
59278,53,0,0,allow,86,86,0,1,30,1,0
63814,12906,64380,12906,allow,66,66,0,2,7,2,0
57898,445,0,0,drop,70,70,0,1,0,1,0
12645,22114,0,0,deny,146,146,0,1,0,1,0
56629,53,45116,53,allow,183,94,89,2,29,1,1
37549,443,18373,443,allow,203299,6930,196369,231,16,92,139
54468,443,26749,443,allow,2402,1444,958,18,81,10,8
50939,445,0,0,drop,70,70,0,1,0,1,0
14614,25174,0,0,deny,66,66,0,1,0,1,0
63127,55860,37307,55860,allow,316,190,126,5,15,3,2
64346,445,0,0,drop,70,70,0,1,0,1,0
49624,443,29597,443,allow,2899,1813,1086,12,136,7,5
64621,53,62273,53,allow,214,102,112,2,30,1,1
42558,64147,0,0,deny,62,62,0,1,0,1,0
45941,23388,0,0,deny,60,60,0,1,0,1,0
65444,445,0,0,drop,70,70,0,1,0,1,0
50924,445,0,0,drop,66,66,0,1,0,1,0
51516,443,35060,443,allow,1195,634,561,12,21,7,5
49994,443,47759,443,allow,352,292,60,2,5,1,1
50591,22114,0,0,deny,146,146,0,1,0,1,0
49265,53,37179,53,allow,181,94,87,2,30,1,1
26697,37965,0,0,deny,66,66,0,1,0,1,0
50608,80,12728,80,allow,10029,8683,1346,20,36,11,9
51889,44348,37588,44348,allow,70,70,0,1,5,1,0
58457,445,0,0,drop,70,70,0,1,0,1,0
59039,445,0,0,drop,70,70,0,1,0,1,0
42960,443,37505,443,allow,5057,2448,2609,27,544,12,15
41463,20005,0,0,deny,60,60,0,1,0,1,0
50265,443,41315,443,allow,10788,6022,4766,36,144,20,16
55489,53,34902,53,allow,748,106,642,2,31,1,1
50287,443,3897,443,allow,8247,2761,5486,36,99,19,17
49407,53,19099,53,allow,209,102,107,2,30,1,1
57094,53,10369,53,allow,196,102,94,2,30,1,1
59978,443,59552,443,allow,10132,5161,4971,42,15,25,17
64879,53,13290,53,allow,165,86,79,2,30,1,1
50462,443,22628,443,allow,14264,4441,9823,74,386,38,36
34953,443,6409,443,allow,9415,3482,5933,57,16,29,28
37993,49152,8346,49152,allow,156,156,0,3,8,3,0
64862,53,5762,53,allow,211,110,101,2,30,1,1
60209,445,0,0,drop,70,70,0,1,0,1,0
40709,443,9964,443,allow,5565,1382,4183,22,158,11,11
42567,80,40138,80,allow,2161,1178,983,16,17,10,6
57293,25174,0,0,deny,146,146,0,1,0,1,0
42298,40035,3337,40035,allow,207,85,122,4,30,2,2
54280,3385,0,0,deny,60,60,0,1,0,1,0
33305,54532,0,0,deny,60,60,0,1,0,1,0
65242,445,0,0,drop,70,70,0,1,0,1,0
64095,1976,59947,1976,allow,66,66,0,2,8,2,0
28317,35776,0,0,deny,146,146,0,1,0,1,0
18843,25174,0,0,deny,146,146,0,1,0,1,0
50830,445,0,0,drop,70,70,0,1,0,1,0
54978,53,3492,53,allow,198,94,104,2,30,1,1
57019,53,31067,53,allow,193,102,91,2,31,1,1
50439,80,32782,80,allow,318,192,126,6,26,4,2
56342,445,0,0,drop,70,70,0,1,0,1,0
56606,443,12642,443,allow,7914,1925,5989,20,15,11,9
49418,27016,58886,27016,allow,242,78,164,2,30,1,1
46864,443,31788,443,allow,5349,1090,4259,18,31,10,8
49875,445,0,0,drop,70,70,0,1,0,1,0
16630,44847,0,0,deny,62,62,0,1,0,1,0
50277,80,19151,80,allow,12764,7749,5015,28,84,14,14
49907,443,5295,443,allow,6754,2219,4535,21,76,11,10
51791,445,0,0,drop,70,70,0,1,0,1,0
60869,48817,0,0,deny,66,66,0,1,0,1,0
54712,445,0,0,drop,66,66,0,1,0,1,0
50236,25174,0,0,deny,66,66,0,1,0,1,0
54029,445,0,0,drop,66,66,0,1,0,1,0
62645,445,0,0,drop,70,70,0,1,0,1,0
52034,26467,0,0,deny,62,62,0,1,0,1,0
39287,57470,0,0,deny,62,62,0,1,0,1,0
47013,37965,0,0,deny,62,62,0,1,0,1,0
58716,9694,0,0,deny,62,62,0,1,0,1,0
53158,443,62480,443,allow,4940,2342,2598,21,135,10,11
55033,53,44325,53,allow,182,94,88,2,30,1,1
64818,445,0,0,drop,70,70,0,1,0,1,0
56724,53,0,0,allow,86,86,0,1,30,1,0
17735,53,27345,53,allow,223,86,137,2,29,1,1
63236,443,2158,443,allow,4945,2798,2147,27,141,14,13
64616,53,29802,53,allow,184,80,104,2,30,1,1
65262,80,27207,80,allow,8814,4800,4014,52,629,27,25
46627,36237,0,0,deny,62,62,0,1,0,1,0
65174,53,57194,53,allow,214,110,104,2,30,1,1
49855,53,65525,53,allow,177,94,83,2,30,1,1
56119,46824,0,0,deny,62,62,0,1,0,1,0
52177,443,52177,443,allow,38013,6855,31158,58,21,25,33
51575,9694,0,0,deny,66,66,0,1,0,1,0
38171,443,40043,443,allow,1649,980,669,14,28,7,7
49221,80,26224,80,allow,214,140,74,4,15,3,1
52266,53,15275,53,allow,168,78,90,2,30,1,1
49219,443,60965,443,allow,70,70,0,2,4,2,0
52206,445,0,0,drop,70,70,0,1,0,1,0
1027,57866,0,0,deny,62,62,0,1,0,1,0
36192,443,26140,443,allow,4555,859,3696,17,360,9,8
64331,53,61619,53,allow,179,94,85,2,30,1,1
56810,53,31641,53,allow,177,94,83,2,30,1,1
55646,53,3427,53,allow,183,94,89,2,30,1,1
24202,53,24202,53,allow,220,90,130,2,29,1,1
55827,445,0,0,drop,66,66,0,1,0,1,0
59786,25174,0,0,deny,66,66,0,1,0,1,0
2704,37,0,0,deny,60,60,0,1,0,1,0
54033,443,63656,443,allow,190,70,120,4,15,2,2
65074,443,20920,443,allow,7584,7094,490,14,124,7,7
38677,443,26000,443,allow,5306,1619,3687,20,29,12,8
23349,30188,0,0,deny,146,146,0,1,0,1,0
16393,22114,0,0,deny,66,66,0,1,0,1,0
55156,53,61392,53,allow,188,96,92,2,30,1,1
55067,53,28702,53,allow,166,86,80,2,30,1,1
50289,53,1310,53,allow,189,102,87,2,30,1,1
49158,80,49158,80,allow,10922,816,10106,19,18,8,11
65187,53,58684,53,allow,199,102,97,2,31,1,1
31738,51505,0,0,deny,62,62,0,1,0,1,0
54394,445,0,0,drop,66,66,0,1,0,1,0
52828,51221,0,0,deny,66,66,0,1,0,1,0
57431,53,3019,53,allow,181,94,87,2,31,1,1
64054,53,33800,53,allow,183,94,89,2,31,1,1
60761,51221,0,0,deny,62,62,0,1,0,1,0
42094,35440,0,0,deny,146,146,0,1,0,1,0
55350,53,27984,53,allow,177,94,83,2,29,1,1
57750,445,0,0,drop,66,66,0,1,0,1,0
64048,53,63585,53,allow,326,92,234,4,31,2,2
52831,53,52831,53,allow,200,90,110,2,30,1,1
57246,53,53043,53,allow,182,93,89,2,31,1,1
32854,443,34612,443,allow,9695,4412,5283,22,172,13,9
47910,7454,0,0,deny,60,60,0,1,0,1,0
52508,445,0,0,drop,70,70,0,1,0,1,0
44318,51180,0,0,deny,74,74,0,1,0,1,0
62658,445,0,0,drop,70,70,0,1,0,1,0
49650,53,63255,53,allow,322,110,212,4,30,2,2
64353,445,0,0,drop,66,66,0,1,0,1,0
55321,53,43693,53,allow,186,95,91,2,31,1,1
63596,443,27876,443,allow,8104,2201,5903,28,135,15,13
56275,53,15148,53,allow,164,84,80,2,31,1,1
51676,445,0,0,drop,70,70,0,1,0,1,0
65264,445,0,0,drop,66,66,0,1,0,1,0
53762,9587,5160,9587,allow,70,70,0,1,4,1,0
61432,443,52750,443,allow,2959,1819,1140,19,86,10,9
54374,443,44819,443,allow,9131,3499,5632,39,24,21,18
55133,53,55133,53,allow,228,90,138,2,30,1,1
51204,443,55515,443,allow,37173,3712,33461,54,74,24,30
1024,64147,0,0,deny,62,62,0,1,0,1,0
54778,22114,0,0,deny,66,66,0,1,0,1,0
41784,443,54389,443,allow,20365,2035,18330,36,15,17,19
51710,43069,65147,43069,allow,70,70,0,2,8,2,0
64089,20260,49240,20260,allow,66,66,0,2,8,2,0
62055,443,14508,443,allow,11694,4947,6747,34,48,19,15
7275,9524,0,0,deny,66,66,0,1,0,1,0
52649,443,45569,443,allow,6292,1492,4800,22,17,11,11
2717,31573,0,0,deny,66,66,0,1,0,1,0
55653,443,8699,443,allow,7267,2312,4955,16,120,7,9
56026,53,14279,53,allow,189,102,87,2,30,1,1
58787,443,18932,443,allow,5107,700,4407,15,15,7,8
53656,58624,15076,58624,allow,70,70,0,2,8,2,0
58638,5900,0,0,deny,62,62,0,1,0,1,0
52140,80,9768,80,allow,3476,1433,2043,26,418,14,12
50789,445,0,0,drop,70,70,0,1,0,1,0
58585,445,0,0,drop,70,70,0,1,0,1,0
55820,445,0,0,drop,66,66,0,1,0,1,0
65524,445,0,0,drop,66,66,0,1,0,1,0
61257,56448,0,0,deny,146,146,0,1,0,1,0
56580,443,8692,443,allow,20897,11903,8994,52,49,30,22
64677,53,58771,53,allow,183,94,89,2,30,1,1
60311,30627,0,0,deny,66,66,0,1,0,1,0
58839,443,35385,443,allow,8595,2118,6477,40,179,22,18
64449,53,61840,53,allow,197,94,103,2,30,1,1
64679,53,2951,53,allow,178,94,84,2,30,1,1
55726,445,0,0,drop,70,70,0,1,0,1,0
16387,49252,0,0,deny,60,60,0,1,0,1,0
62828,443,62828,443,allow,4604,1697,2907,19,29,11,8
58054,80,39200,80,allow,3561,3028,533,14,31,8,6
52054,443,46268,443,allow,9339,4411,4928,20,135,10,10
65047,445,0,0,drop,66,66,0,1,0,1,0
37558,16386,20045,16386,allow,432,192,240,8,30,4,4
59725,443,1736,443,allow,89790,6036,83754,112,55,41,71
55141,53,56040,53,allow,184,94,90,2,31,1,1
57176,53,65163,53,allow,793,101,692,2,31,1,1
59940,50584,0,0,deny,66,66,0,1,0,1,0
62909,445,0,0,drop,70,70,0,1,0,1,0
54752,31573,0,0,deny,66,66,0,1,0,1,0
60365,443,2645,443,allow,130,70,60,2,15,1,1
54227,445,0,0,drop,70,70,0,1,0,1,0
34914,26467,0,0,deny,62,62,0,1,0,1,0
53887,445,0,0,drop,70,70,0,1,0,1,0
53638,443,51723,443,allow,24895,2856,22039,46,270,22,24
63205,9571,0,0,deny,62,62,0,1,0,1,0
38320,53,38320,53,allow,260,106,154,2,32,1,1
16071,53,16071,53,allow,832,106,726,2,30,1,1
13654,50584,0,0,deny,62,62,0,1,0,1,0
52340,22114,0,0,deny,62,62,0,1,0,1,0
15503,36501,26789,36501,allow,323,150,173,2,1201,1,1
51880,8000,41455,8000,allow,172,94,78,2,29,1,1
28498,36237,0,0,deny,62,62,0,1,0,1,0
65514,445,0,0,drop,70,70,0,1,0,1,0
58901,443,24407,443,allow,17071,1532,15539,17,27,3,14
55833,53,8720,53,allow,177,94,83,2,30,1,1
57769,445,0,0,drop,66,66,0,1,0,1,0
43518,443,43518,443,allow,4691,1784,2907,19,29,11,8
56025,445,0,0,drop,66,66,0,1,0,1,0
49178,80,4471,80,allow,2807,587,2220,13,16,7,6
24504,37965,0,0,deny,62,62,0,1,0,1,0
58597,35440,0,0,deny,62,62,0,1,0,1,0
58131,30228,0,0,deny,146,146,0,1,0,1,0
63113,445,0,0,drop,66,66,0,1,0,1,0
33388,53,33388,53,allow,229,98,131,2,30,1,1
56115,445,0,0,drop,70,70,0,1,0,1,0
50665,443,26812,443,allow,374,192,182,7,28,4,3
48817,38081,48817,38081,allow,863,363,500,4,1200,2,2
59449,445,0,0,drop,70,70,0,1,0,1,0
63717,445,0,0,drop,70,70,0,1,0,1,0
44411,37965,0,0,deny,62,62,0,1,0,1,0
49240,445,0,0,drop,70,70,0,1,0,1,0
49908,56205,0,0,deny,62,62,0,1,0,1,0
50978,80,46474,80,allow,1442,700,742,12,35,6,6
52107,443,6381,443,allow,12091,3135,8956,30,49,16,14
65403,53,40925,53,allow,199,102,97,2,29,1,1
49564,53,7876,53,allow,168,78,90,2,30,1,1
62940,445,0,0,drop,66,66,0,1,0,1,0
58638,5900,0,0,deny,62,62,0,1,0,1,0
52778,445,0,0,drop,70,70,0,1,0,1,0
38002,49152,2185,49152,allow,156,156,0,3,8,3,0
54103,445,0,0,drop,70,70,0,1,0,1,0
64622,36829,0,0,deny,66,66,0,1,0,1,0
49708,445,0,0,drop,70,70,0,1,0,1,0
46389,27098,0,0,deny,66,66,0,1,0,1,0
38279,80,49834,80,allow,122,62,60,2,15,1,1
36562,443,34526,443,allow,3452,1535,1917,18,82,10,8
55979,53,16779,53,allow,184,102,82,2,29,1,1
56557,53,41528,53,allow,214,110,104,2,30,1,1
60377,443,19236,443,allow,10101,2782,7319,22,78,10,12
55931,53,3407,53,allow,168,78,90,2,30,1,1
52218,80,8584,80,allow,2373,614,1759,11,15,6,5
58610,445,0,0,drop,70,70,0,1,0,1,0
63461,443,13278,443,allow,622,310,312,11,59,6,5
59880,443,7834,443,allow,16776,7513,9263,42,47,24,18
62523,445,0,0,drop,70,70,0,1,0,1,0
53074,445,0,0,drop,70,70,0,1,0,1,0
14023,37965,0,0,deny,62,62,0,1,0,1,0
38667,443,44334,443,allow,496852,12216,484636,499,16,167,332
32388,26467,0,0,deny,66,66,0,1,0,1,0
50354,445,0,0,drop,66,66,0,1,0,1,0
52118,80,62172,80,allow,3158,1309,1849,28,418,15,13
50504,53,41149,53,allow,168,86,82,2,30,1,1
27005,27016,39937,27016,allow,914,126,788,2,31,1,1
55867,53,49859,53,allow,178,94,84,2,29,1,1
33852,443,7849,443,allow,3419,2241,1178,16,16,8,8
62045,445,0,0,drop,70,70,0,1,0,1,0
9237,80,59192,80,allow,378,192,186,7,26,4,3
49217,53,12085,53,allow,202,103,99,2,31,1,1
50236,443,50711,443,allow,6661,1489,5172,26,270,13,13
26900,27017,21825,27017,allow,422,164,258,6,31,3,3
64546,53,29110,53,allow,183,94,89,2,30,1,1
1070,26467,0,0,deny,62,62,0,1,0,1,0
34458,80,25271,80,allow,6260,696,5564,17,16,9,8
56268,44847,0,0,deny,66,66,0,1,0,1,0
55453,53,1077,53,allow,730,102,628,2,30,1,1
52026,26467,0,0,deny,60,60,0,1,0,1,0
64671,53,7191,53,allow,294,102,192,2,30,1,1
50082,445,0,0,drop,70,70,0,1,0,1,0
50002,53,25520,53,allow,196,102,94,2,30,1,1
63400,57470,0,0,deny,66,66,0,1,0,1,0
56947,53,11234,53,allow,239,102,137,2,30,1,1
55352,53,47404,53,allow,216,110,106,2,30,1,1
57275,53,15169,53,allow,193,102,91,2,30,1,1
49914,443,22293,443,allow,12190,2075,10115,28,16,14,14
49513,445,0,0,drop,66,66,0,1,0,1,0
51827,48432,31400,48432,allow,160,70,90,2,4,1,1
50210,443,12154,443,allow,6444,1320,5124,31,727,10,21
20608,28189,0,0,deny,60,60,0,1,0,1,0
57470,51413,16094,51413,allow,700,275,425,4,1200,2,2
65201,53,45437,53,allow,334,94,240,2,30,1,1
48984,15000,36697,15000,allow,130,70,60,2,5,1,1
14967,24855,0,0,reset-both,62,62,0,1,0,1,0
12549,50265,0,0,deny,146,146,0,1,0,1,0
46219,53,46219,53,allow,237,91,146,2,33,1,1
53151,445,0,0,drop,66,66,0,1,0,1,0
62092,35440,0,0,deny,66,66,0,1,0,1,0
29486,53,29486,53,allow,825,99,726,2,31,1,1
49218,53,40400,53,allow,195,102,93,2,30,1,1
64944,53,44996,53,allow,749,89,660,2,30,1,1
56919,445,0,0,drop,66,66,0,1,0,1,0
9178,443,33091,443,allow,5731,495,5236,14,15,7,7
60879,443,57510,443,allow,15774,5540,10234,48,48,26,22
25778,53,25778,53,allow,235,90,145,2,33,1,1
49472,53,31228,53,allow,772,102,670,2,30,1,1
51830,32787,47434,32787,allow,70,70,0,2,6,2,0
58993,445,0,0,drop,70,70,0,1,0,1,0
38496,5228,27256,5228,allow,3397,1506,1891,26,640,8,18
49384,53,2964,53,allow,186,95,91,2,30,1,1
53211,22114,0,0,deny,66,66,0,1,0,1,0
20198,17372,0,0,deny,62,62,0,1,0,1,0
22409,55442,0,0,deny,74,74,0,1,0,1,0
55034,443,64856,443,allow,45487,4986,40501,74,47,36,38
64533,53,56786,53,allow,183,102,81,2,29,1,1
52506,445,0,0,drop,70,70,0,1,0,1,0
62029,36237,0,0,deny,62,62,0,1,0,1,0
52189,24190,3693,24190,allow,70,70,0,2,9,2,0
51738,47483,4479,47483,allow,70,70,0,1,5,1,0
14185,48637,0,0,deny,60,60,0,1,0,1,0
42951,443,65078,443,allow,6513,1609,4904,26,303,14,12
48020,53,48020,53,allow,404,259,145,3,33,2,1
58709,443,26417,443,allow,7924,702,7222,17,16,7,10
51927,80,21213,80,allow,1945,1002,943,11,20,7,4
50052,65008,0,0,deny,60,60,0,1,0,1,0
55165,53,51406,53,allow,193,102,91,2,30,1,1
51806,49530,21191,49530,allow,70,70,0,2,8,2,0
43304,443,10226,443,allow,4389,797,3592,15,70,8,7
34225,443,33698,443,allow,256793,17776,239017,327,23,146,181
55100,53,52662,53,allow,438,94,344,2,29,1,1
49197,53,54717,53,allow,214,102,112,2,30,1,1
53610,443,29299,443,allow,3096,962,2134,13,135,6,7
57240,53,16899,53,allow,176,90,86,2,30,1,1
52016,58318,32216,58318,allow,70,70,0,2,9,2,0
52503,50584,0,0,deny,66,66,0,1,0,1,0
49208,6881,3930,6881,allow,70,70,0,2,8,2,0
64898,53,46183,53,allow,209,94,115,2,29,1,1
60470,445,0,0,drop,70,70,0,1,0,1,0
43381,443,3948,443,allow,9551,2173,7378,33,25,17,16
38264,443,28661,443,allow,134,60,74,3,4,2,1
52848,443,15385,443,allow,6218,1239,4979,14,133,7,7
27005,27333,2413,27333,allow,890,126,764,2,30,1,1
55450,53,40253,53,allow,213,102,111,2,30,1,1
62076,443,11320,443,allow,7370,2873,4497,23,47,13,10
60504,445,0,0,drop,70,70,0,1,0,1,0
64840,53,3676,53,allow,193,102,91,2,30,1,1
40634,443,26237,443,allow,4917,1273,3644,17,34,10,7
56813,443,32005,443,allow,8021,2001,6020,20,16,11,9
50422,53,50422,53,allow,194,87,107,2,30,1,1
59485,80,39693,80,allow,882,527,355,10,255,6,4
64656,53,38366,53,allow,718,94,624,2,30,1,1
58097,445,0,0,drop,70,70,0,1,0,1,0
64159,445,0,0,drop,70,70,0,1,0,1,0
55385,445,0,0,drop,70,70,0,1,0,1,0
61896,34021,0,0,allow,66,66,0,1,91,1,0
51520,443,51520,443,allow,53075,3609,49466,74,173,25,49
51412,51505,0,0,deny,66,66,0,1,0,1,0
58638,5900,0,0,deny,62,62,0,1,0,1,0
58959,445,0,0,drop,70,70,0,1,0,1,0
57296,53,27311,53,allow,771,101,670,2,30,1,1
55015,443,8354,443,allow,1786,172,1614,7,120,3,4
64987,53,4145,53,allow,196,102,94,2,30,1,1
56470,28678,7618,28678,allow,1806,1806,0,22,224,22,0
55830,53,38726,53,allow,177,94,83,2,29,1,1
34697,443,10528,443,allow,15997,3015,12982,31,18,16,15
14469,443,14469,443,allow,274,132,142,5,15,3,2
50067,445,0,0,drop,70,70,0,1,0,1,0
50454,445,0,0,drop,70,70,0,1,0,1,0
52636,443,34549,443,allow,1309,670,639,16,166,9,7
63839,445,0,0,drop,66,66,0,1,0,1,0
57315,53,60318,53,allow,748,95,653,2,30,1,1
60066,445,0,0,drop,66,66,0,1,0,1,0
54235,445,0,0,drop,70,70,0,1,0,1,0
62208,37965,0,0,deny,66,66,0,1,0,1,0
63867,64147,0,0,deny,62,62,0,1,0,1,0
28221,37965,0,0,deny,62,62,0,1,0,1,0
65112,53,6227,53,allow,209,110,99,2,31,1,1
64657,53,42843,53,allow,816,102,714,2,30,1,1
53725,57418,10921,57418,allow,70,70,0,1,4,1,0
38411,17372,0,0,deny,62,62,0,1,0,1,0
55859,443,4096,443,allow,399086,26649,372437,488,462,156,332
49619,53,50189,53,allow,789,110,679,2,30,1,1
58638,5900,0,0,deny,62,62,0,1,0,1,0
57470,53380,4441,53380,allow,330,330,0,6,1200,6,0
54573,445,0,0,drop,66,66,0,1,0,1,0
6889,7363,0,0,deny,143,143,0,1,0,1,0
32090,43890,0,0,deny,146,146,0,1,0,1,0
53138,443,56360,443,allow,7141,2507,4634,28,42,13,15
35261,15503,0,0,deny,74,74,0,1,0,1,0
49868,443,19461,443,allow,11578,2375,9203,47,55,22,25
56413,53,30670,53,allow,224,94,130,2,30,1,1
63772,35440,0,0,deny,62,62,0,1,0,1,0
62246,443,21397,443,allow,117314,4775,112539,144,120,51,93
44060,443,59243,443,allow,9734,1614,8120,24,170,11,13
3436,46783,0,0,deny,62,62,0,1,0,1,0
58638,5900,0,0,deny,62,62,0,1,0,1,0
7619,50584,0,0,deny,62,62,0,1,0,1,0
50451,80,13158,80,allow,2673,564,2109,11,125,6,5
59091,445,0,0,drop,70,70,0,1,0,1,0
19054,3389,19054,3389,allow,3564,1850,1714,18,35,10,8
40439,443,42690,443,allow,8126,1627,6499,29,165,16,13
49636,53,23682,53,allow,180,94,86,2,30,1,1
52278,445,0,0,drop,70,70,0,1,0,1,0
58001,443,15727,443,allow,300,180,120,6,28,4,2
57904,443,36166,443,allow,4042,2515,1527,28,169,14,14
57201,53,40982,53,allow,214,110,104,2,29,1,1
6842,42873,0,0,deny,62,62,0,1,0,1,0
49611,80,38044,80,allow,378,192,186,7,41,4,3
60287,445,0,0,drop,66,66,0,1,0,1,0
65223,443,38564,443,allow,5012,4134,878,17,98,10,7
9506,443,29564,443,allow,3614,434,3180,11,15,6,5
64081,59517,43134,59517,allow,504,382,122,8,16,6,2
64505,53,38734,53,allow,373,126,247,2,30,1,1
54810,445,0,0,drop,70,70,0,1,0,1,0
27209,30170,0,0,deny,145,145,0,1,0,1,0
61455,64147,0,0,deny,66,66,0,1,0,1,0
64488,53,18852,53,allow,291,102,189,2,29,1,1
50442,25174,0,0,deny,66,66,0,1,0,1,0
55639,62954,47207,62954,allow,504,318,186,8,15,5,3
54377,56205,0,0,deny,62,62,0,1,0,1,0
56955,53,35942,53,allow,183,94,89,2,30,1,1
64078,54561,7261,54561,allow,66,66,0,2,7,2,0
58199,445,0,0,drop,70,70,0,1,0,1,0
63903,56016,63323,56016,allow,312,132,180,6,6,3,3
26469,26348,0,0,deny,62,62,0,1,0,1,0
31112,50584,0,0,deny,66,66,0,1,0,1,0
56451,995,0,0,deny,60,60,0,1,0,1,0
53815,44847,0,0,deny,66,66,0,1,0,1,0
65042,53,41893,53,allow,182,93,89,2,31,1,1
50116,22,50116,22,allow,60,60,0,1,5,1,0
50929,80,17624,80,allow,9630744,98097,9532647,7804,123,1387,6417
49557,53,50413,53,allow,272,110,162,2,29,1,1
52904,445,0,0,drop,70,70,0,1,0,1,0
55367,53,8311,53,allow,190,97,93,2,31,1,1
55130,53,35650,53,allow,216,110,106,2,30,1,1
50497,445,0,0,drop,66,66,0,1,0,1,0
59008,443,16532,443,allow,10214,2669,7545,30,170,14,16
56652,443,14295,443,allow,1272,876,396,10,25,6,4
59658,443,21276,443,allow,6695,1617,5078,23,200,13,10
60026,445,0,0,drop,70,70,0,1,0,1,0
56765,53,25229,53,allow,194,102,92,2,29,1,1
59775,443,26264,443,allow,5024,2538,2486,23,15,13,10
64709,53,11434,53,allow,821,102,719,2,30,1,1
3981,23117,0,0,deny,66,66,0,1,0,1,0
55842,80,22065,80,allow,1151,711,440,10,15,5,5
47910,7454,0,0,deny,60,60,0,1,0,1,0
65096,37807,0,0,deny,66,66,0,1,0,1,0
33794,53,45704,53,allow,168,78,90,2,29,1,1
62596,445,0,0,drop,70,70,0,1,0,1,0
58638,5900,0,0,deny,62,62,0,1,0,1,0
44714,25174,0,0,deny,146,146,0,1,0,1,0
51889,80,18568,80,allow,15867,8841,7026,29,29,16,13
56250,53,20280,53,allow,802,104,698,2,31,1,1
61020,445,0,0,drop,70,70,0,1,0,1,0
50278,53,34897,53,allow,819,102,717,2,30,1,1
35514,80,18032,80,allow,841,715,126,5,14,3,2
65522,445,0,0,drop,66,66,0,1,0,1,0
57315,445,0,0,drop,70,70,0,1,0,1,0
56425,53,17413,53,allow,760,97,663,2,30,1,1
55706,53,9914,53,allow,202,103,99,2,31,1,1
52131,28980,37358,28980,allow,66,66,0,1,5,1,0
48157,443,51436,443,allow,7209,2331,4878,20,23,11,9
52221,33166,38901,33166,allow,66,66,0,1,5,1,0
45549,80,33456,80,allow,1117,762,355,10,255,6,4
50975,445,0,0,drop,70,70,0,1,0,1,0
55413,53,38303,53,allow,216,110,106,2,29,1,1
50824,443,63186,443,allow,337727,11283,326444,367,208,126,241
54868,445,0,0,drop,70,70,0,1,0,1,0
57433,21247,0,0,deny,66,66,0,1,0,1,0
56830,17793,18491,17793,allow,564,318,246,9,15,5,4
50485,445,0,0,drop,70,70,0,1,0,1,0
64681,35993,0,0,deny,66,66,0,1,0,1,0
59093,53,0,0,allow,215,77,138,2,31,1,1
50556,445,0,0,drop,70,70,0,1,0,1,0
14721,53,14721,53,allow,217,87,130,2,31,1,1
45941,23386,0,0,deny,60,60,0,1,0,1,0
52072,80,26468,80,allow,482,300,182,9,26,6,3
49456,53,22820,53,allow,308,101,207,4,32,2,2
64666,53,52653,53,allow,226,102,124,2,30,1,1
65064,30188,0,0,deny,66,66,0,1,0,1,0
55634,53,37153,53,allow,210,110,100,2,30,1,1
57882,443,30006,443,allow,22342,1787,20555,38,177,16,22
48710,22,48710,22,allow,11002,3445,7557,60,42,26,34
64393,53,49935,53,allow,182,93,89,2,31,1,1
59930,443,17395,443,allow,58431,5847,52584,55,120,10,45
50242,445,0,0,drop,70,70,0,1,0,1,0
51731,39392,29228,39392,allow,66,66,0,1,5,1,0
50688,80,9336,80,allow,27391,3550,23841,36,20,15,21
52202,64241,11975,64241,allow,164,70,94,2,4,1,1
35556,443,19765,443,allow,2988,1649,1339,17,255,9,8
24566,53,24566,53,allow,216,90,126,2,30,1,1
50090,445,0,0,drop,70,70,0,1,0,1,0
33627,36237,0,0,deny,66,66,0,1,0,1,0
52318,17,0,0,deny,60,60,0,1,0,1,0
50636,443,49176,443,allow,7332,1611,5721,17,15,9,8
33892,53,0,0,allow,86,86,0,1,30,1,0
53871,43266,33475,43266,allow,70,70,0,2,7,2,0
0,0,0,0,deny,98,98,0,1,0,1,0
52459,33890,0,0,deny,60,60,0,1,0,1,0
60897,443,29377,443,allow,10706,1679,9027,27,46,15,12
58439,443,16787,443,allow,232,172,60,3,5,2,1
49237,8080,49237,8080,allow,4451,1329,3122,13,53,7,6
34772,15503,0,0,deny,146,146,0,1,0,1,0
64410,53,3799,53,allow,196,102,94,2,35,1,1
56693,53,6310,53,allow,756,95,661,2,31,1,1
61788,445,0,0,drop,70,70,0,1,0,1,0
62394,80,62394,80,allow,29401,10036,19365,49,28,24,25
59828,53,0,0,allow,275,75,200,2,30,1,1
65235,53,39902,53,allow,216,94,122,2,30,1,1
56480,445,0,0,drop,70,70,0,1,0,1,0
33582,44847,0,0,deny,66,66,0,1,0,1,0
49903,53,41942,53,allow,194,94,100,2,30,1,1
50445,443,50834,443,allow,14431,2090,12341,42,142,20,22
51695,37590,12016,37590,allow,70,70,0,1,5,1,0
56105,53,14961,53,allow,372,142,230,2,29,1,1
57158,53,11939,53,allow,969,86,883,2,30,1,1
14717,64147,0,0,deny,66,66,0,1,0,1,0
54343,443,5667,443,allow,7990,2701,5289,30,61,17,13
51194,443,35674,443,allow,1561,768,793,17,185,9,8
57252,53,53751,53,allow,183,94,89,2,30,1,1
43880,80,10125,80,allow,2693,841,1852,13,16,8,5
65204,53,43316,53,allow,183,94,89,2,30,1,1
56683,443,56683,443,allow,4533,1626,2907,19,28,11,8
47424,25174,0,0,deny,66,66,0,1,0,1,0
33247,443,33617,443,allow,7527,2435,5092,16,120,8,8
20336,53,20336,53,allow,233,91,142,2,31,1,1
63422,443,21466,443,allow,10617247,317598,10299649,11317,243,4141,7176
46417,22114,0,0,deny,146,146,0,1,0,1,0
55224,53,48169,53,allow,182,94,88,2,30,1,1
53242,443,3574,443,allow,5993,974,5019,19,70,10,9
63783,445,0,0,drop,70,70,0,1,0,1,0
12346,53,12346,53,allow,216,98,118,2,30,1,1
51099,80,52841,80,allow,3422,1962,1460,33,131,18,15
27005,27015,56171,27015,allow,858,126,732,2,31,1,1
39742,80,38417,80,allow,1569,593,976,10,44,6,4
5588,5588,0,0,allow,3354,1792,1562,46,193,23,23
64213,53,34758,53,allow,342,105,237,4,53,2,2
54339,445,0,0,drop,70,70,0,1,0,1,0
50624,26467,0,0,deny,66,66,0,1,0,1,0
54726,30041,0,0,deny,66,66,0,1,0,1,0
7030,80,7030,80,allow,115811,3862,111949,123,38,44,79
27727,53,27727,53,allow,407,261,146,3,32,2,1
2180,63710,0,0,deny,66,66,0,1,0,1,0
50758,445,0,0,drop,70,70,0,1,0,1,0
57130,445,0,0,drop,70,70,0,1,0,1,0
56035,445,0,0,drop,70,70,0,1,0,1,0
51048,445,0,0,drop,70,70,0,1,0,1,0
51188,64147,0,0,deny,62,62,0,1,0,1,0
33003,28543,0,0,deny,62,62,0,1,0,1,0
51051,443,1978,443,allow,7712,2203,5509,24,516,14,10
58053,445,0,0,drop,70,70,0,1,0,1,0
59951,445,0,0,drop,70,70,0,1,0,1,0
55190,445,0,0,drop,70,70,0,1,0,1,0
55003,445,0,0,drop,70,70,0,1,0,1,0
64997,53,32660,53,allow,771,102,669,2,29,1,1
53486,445,0,0,drop,70,70,0,1,0,1,0
49566,443,36540,443,allow,10225,5069,5156,30,106,17,13
64203,445,0,0,drop,70,70,0,1,0,1,0
35937,25174,0,0,deny,66,66,0,1,0,1,0
61384,80,43597,80,allow,2526,843,1683,12,255,7,5
60420,2924,28301,2924,allow,320,140,180,6,7,3,3
56828,445,0,0,drop,70,70,0,1,0,1,0
65081,26467,0,0,deny,66,66,0,1,0,1,0
49379,53,28766,53,allow,199,102,97,2,30,1,1
56803,53,52529,53,allow,183,94,89,2,30,1,1
58638,5900,0,0,deny,62,62,0,1,0,1,0
50460,53,9714,53,allow,751,95,656,2,30,1,1
55865,53,59326,53,allow,196,102,94,2,29,1,1
55243,53,43461,53,allow,356,118,238,2,30,1,1
65226,445,0,0,drop,70,70,0,1,0,1,0
55693,45341,22935,45341,allow,70,70,0,1,5,1,0
47030,81,0,0,deny,60,60,0,1,0,1,0
49522,445,0,0,drop,66,66,0,1,0,1,0
59857,443,40076,443,allow,2118,1093,1025,22,44,9,13
15333,60043,0,0,deny,62,62,0,1,0,1,0
33215,37965,0,0,deny,62,62,0,1,0,1,0
54540,445,0,0,drop,66,66,0,1,0,1,0
56176,53,42328,53,allow,194,102,92,2,30,1,1
38288,443,40759,443,allow,8627,2906,5721,10,121,4,6
47089,443,11846,443,allow,172,172,0,2,5,2,0
64655,443,35493,443,allow,8903,2857,6046,22,135,10,12
64324,53,5232,53,allow,344,105,239,4,33,2,2
4780,443,25705,443,allow,1191,692,499,12,40,7,5
50575,443,8721,443,allow,149414,8612,140802,208,25,107,101
49443,80,19440,80,allow,3642,1460,2182,23,143,12,11
65337,53,53258,53,allow,460,112,348,4,56,2,2
60222,443,32889,443,allow,12428,5331,7097,47,32,21,26
13840,37965,0,0,deny,146,146,0,1,0,1,0
23277,53733,0,0,deny,66,66,0,1,0,1,0
27005,32039,29138,32039,allow,883,126,757,2,31,1,1
51418,445,0,0,drop,70,70,0,1,0,1,0
54348,443,31489,443,allow,27760,9709,18051,56,45,27,29
13120,25174,0,0,deny,146,146,0,1,0,1,0
52836,36829,0,0,deny,66,66,0,1,0,1,0
58638,5900,0,0,deny,62,62,0,1,0,1,0
49246,53,4565,53,allow,177,94,83,2,30,1,1
33359,30188,0,0,deny,66,66,0,1,0,1,0
40521,28678,47764,28678,allow,1806,1806,0,22,225,22,0
55624,53,14345,53,allow,198,101,97,2,31,1,1
4545,1900,0,0,deny,136,136,0,1,0,1,0
64054,54778,50482,54778,allow,312,132,180,6,6,3,3
37991,49152,57920,49152,allow,156,156,0,3,7,3,0
33775,80,33775,80,allow,424,198,226,7,142,4,3
52113,443,33178,443,allow,17710,1892,15818,37,24,17,20
46492,50584,0,0,deny,62,62,0,1,0,1,0
55932,53,30562,53,allow,209,110,99,2,31,1,1
54996,445,0,0,drop,70,70,0,1,0,1,0
60400,443,24179,443,allow,7073,1556,5517,21,80,11,10
11464,37965,0,0,deny,62,62,0,1,0,1,0
35412,443,65351,443,allow,1251,749,502,11,68,6,5
62960,445,0,0,drop,70,70,0,1,0,1,0
62512,25174,0,0,deny,62,62,0,1,0,1,0
49928,443,19902,443,allow,4904,864,4040,17,28,10,7
62423,443,31493,443,allow,28031,7016,21015,51,45,23,28
49964,53,64934,53,allow,749,94,655,2,30,1,1
63314,57470,0,0,deny,66,66,0,1,0,1,0
4419,23,0,0,deny,60,60,0,1,0,1,0
45409,53,56925,53,allow,307,86,221,2,31,1,1
50720,443,25123,443,allow,6336,1377,4959,19,169,9,10
50584,1283,8544,1283,allow,1617,161,1456,4,1199,2,2
32811,443,18226,443,allow,16652,13777,2875,48,44,27,21
56266,53,53849,53,allow,182,102,80,2,30,1,1
17002,22114,0,0,deny,62,62,0,1,0,1,0
56463,17,0,0,deny,60,60,0,1,0,1,0
51770,80,6696,80,allow,135293,6214,129079,161,24,71,90
62245,445,0,0,drop,70,70,0,1,0,1,0
54314,445,0,0,drop,70,70,0,1,0,1,0
49277,445,0,0,drop,70,70,0,1,0,1,0
58638,5900,0,0,deny,62,62,0,1,0,1,0
49845,443,44493,443,allow,5996,976,5020,19,72,10,9
56143,53,11476,53,allow,214,94,120,2,30,1,1
55397,445,0,0,drop,70,70,0,1,0,1,0
57907,53,57907,53,allow,228,97,131,2,31,1,1
55989,53,12123,53,allow,198,102,96,2,30,1,1
60745,123,31928,123,allow,184,94,90,2,30,1,1
19875,30170,0,0,deny,145,145,0,1,0,1,0
56952,445,0,0,drop,70,70,0,1,0,1,0
57470,6889,19938,6889,allow,546,166,380,2,1200,1,1
65317,51221,0,0,deny,78,78,0,1,0,1,0
58338,3369,0,0,deny,60,60,0,1,0,1,0
34245,443,35232,443,allow,11441,6765,4676,40,792,19,21
55680,445,0,0,drop,66,66,0,1,0,1,0
55286,53,19401,53,allow,268,87,181,4,35,2,2
61510,37965,0,0,deny,66,66,0,1,0,1,0
21892,15503,0,0,deny,62,62,0,1,0,1,0
19875,30170,0,0,deny,145,145,0,1,0,1,0
51387,445,0,0,drop,70,70,0,1,0,1,0
26900,27017,43770,27017,allow,422,164,258,6,30,3,3
51840,445,0,0,drop,66,66,0,1,0,1,0
54021,445,0,0,drop,66,66,0,1,0,1,0
56334,53,34646,53,allow,177,94,83,2,30,1,1
64954,445,0,0,drop,66,66,0,1,0,1,0
55816,445,0,0,drop,70,70,0,1,0,1,0
55684,53,8013,53,allow,214,110,104,2,30,1,1
55406,25174,0,0,deny,62,62,0,1,0,1,0
20057,44847,0,0,deny,62,62,0,1,0,1,0
8889,21251,0,0,deny,60,60,0,1,0,1,0
63928,61494,31292,61494,allow,1691,446,1245,10,15,7,3
56463,443,48725,443,allow,6364,1147,5217,19,24,11,8
49666,53,61369,53,allow,392,124,268,4,35,2,2
49478,53,32475,53,allow,551,114,437,4,37,2,2
51588,80,26710,80,allow,2016,1050,966,21,300,11,10
50037,53,63751,53,allow,195,102,93,2,31,1,1
52629,445,0,0,drop,66,66,0,1,0,1,0
56167,445,0,0,drop,70,70,0,1,0,1,0
49485,443,26234,443,allow,49823,7236,42587,56,29,20,36
46906,25604,0,0,deny,100,100,0,1,0,1,0
2464,50584,0,0,deny,66,66,0,1,0,1,0
56943,44847,0,0,deny,62,62,0,1,0,1,0
55489,53,32012,53,allow,193,102,91,2,30,1,1
52146,445,0,0,drop,66,66,0,1,0,1,0
52518,80,48144,80,allow,3290,2776,514,12,15,7,5
51075,80,51075,80,allow,450,246,204,8,26,5,3
50552,445,0,0,drop,70,70,0,1,0,1,0
42165,443,38543,443,allow,7583,607,6976,18,119,7,11
64899,53,35861,53,allow,198,101,97,2,30,1,1
49298,18593,0,0,deny,145,145,0,1,0,1,0
50637,80,48925,80,allow,1742,589,1153,10,87,6,4
64723,53,38339,53,allow,165,86,79,2,30,1,1
49919,443,15575,443,allow,16012,2097,13915,33,16,15,18
57820,32753,0,0,deny,361,361,0,1,0,1,0
50345,53,44210,53,allow,193,102,91,2,30,1,1
56381,53,14303,53,allow,196,102,94,2,31,1,1
49531,26467,0,0,deny,66,66,0,1,0,1,0
54989,443,3314,443,allow,7745,2583,5162,27,100,15,12
13445,44847,0,0,deny,66,66,0,1,0,1,0
65258,53,4624,53,allow,186,95,91,2,31,1,1
57788,443,31761,443,allow,6400,1327,5073,21,21,13,8
2170,43227,0,0,deny,62,62,0,1,0,1,0
50299,80,31739,80,allow,2316,1206,1110,16,81,9,7
63966,42532,2551,42532,allow,70,70,0,1,4,1,0
56246,53,30677,53,allow,209,110,99,2,30,1,1
53156,443,62340,443,allow,3814,2664,1150,22,28,12,10
61667,80,57155,80,allow,21567,1666,19901,35,46,18,17
5200,6643,0,0,deny,145,145,0,1,0,1,0
49765,53,55989,53,allow,233,102,131,2,30,1,1
51983,443,27301,443,allow,23955,4211,19744,42,46,21,21
56360,53,26019,53,allow,184,102,82,2,30,1,1
56387,25174,0,0,deny,66,66,0,1,0,1,0
59779,443,11374,443,allow,142,142,0,1,5,1,0
28367,23,0,0,deny,60,60,0,1,0,1,0
47166,15000,45851,15000,allow,130,70,60,2,5,1,1
56482,445,0,0,drop,70,70,0,1,0,1,0
10006,64147,0,0,deny,145,145,0,1,0,1,0
60387,445,0,0,drop,70,70,0,1,0,1,0
53616,44166,57712,44166,allow,70,70,0,1,5,1,0
64987,445,0,0,drop,70,70,0,1,0,1,0
3937,36829,0,0,deny,62,62,0,1,0,1,0
52110,445,0,0,drop,70,70,0,1,0,1,0
64785,53,44600,53,allow,281,94,187,2,29,1,1
38795,40032,51125,40032,allow,243,180,63,2,31,1,1
65115,445,0,0,drop,66,66,0,1,0,1,0
53090,59356,0,0,deny,66,66,0,1,0,1,0
57470,31373,26422,31373,allow,1386,1386,0,22,1798,22,0
52031,20301,11089,20301,allow,70,70,0,2,8,2,0
51763,445,0,0,drop,66,66,0,1,0,1,0
61887,445,0,0,drop,70,70,0,1,0,1,0
56526,80,57143,80,allow,1056,682,374,10,15,6,4
54614,37807,0,0,deny,66,66,0,1,0,1,0
64029,445,0,0,drop,70,70,0,1,0,1,0
64810,53,30848,53,allow,257,126,131,2,30,1,1
55704,53,24414,53,allow,170,87,83,2,30,1,1
65459,445,0,0,drop,70,70,0,1,0,1,0
64664,80,64664,80,allow,1921,1472,449,10,20,6,4
59568,445,0,0,drop,70,70,0,1,0,1,0
55530,445,0,0,drop,70,70,0,1,0,1,0
55476,53,58894,53,allow,232,110,122,2,30,1,1
4431,32480,0,0,deny,66,66,0,1,0,1,0
10552,25174,0,0,deny,62,62,0,1,0,1,0
54473,80,28386,80,allow,14035,1381,12654,26,255,14,12
60020,445,0,0,drop,66,66,0,1,0,1,0
62875,445,0,0,drop,70,70,0,1,0,1,0
52094,443,49643,443,allow,3296065,47110,3248955,2746,51,533,2213
32806,7275,35238,7275,allow,130,70,60,2,15,1,1
51921,37744,34923,37744,allow,70,70,0,1,5,1,0
50861,445,0,0,drop,66,66,0,1,0,1,0
50436,53,50436,53,allow,248,106,142,2,30,1,1
52847,53,50629,53,allow,86,86,0,1,30,1,0
33044,443,11890,443,allow,9695,5259,4436,24,35,12,12
51965,48708,39312,48708,allow,70,70,0,2,8,2,0
36172,443,19620,443,allow,6295,1324,4971,22,983,10,12
27005,27015,8429,27015,allow,882,126,756,2,30,1,1
38117,443,59236,443,allow,8598,3880,4718,23,200,13,10
55503,53,54842,53,allow,200,102,98,2,30,1,1
10406,35440,0,0,deny,146,146,0,1,0,1,0
12550,37807,0,0,deny,146,146,0,1,0,1,0
12965,37965,0,0,deny,66,66,0,1,0,1,0
49536,445,0,0,drop,70,70,0,1,0,1,0
52398,443,30861,443,allow,323437,18923,304514,544,252,276,268
49348,443,47501,443,allow,2879984,113967,2766017,3396,129,1423,1973
63138,51452,7117,51452,allow,70,70,0,1,5,1,0
37235,443,30384,443,allow,8877,1380,7497,30,18,15,15
53513,445,0,0,drop,70,70,0,1,0,1,0
7423,22114,0,0,deny,62,62,0,1,0,1,0
62411,445,0,0,drop,66,66,0,1,0,1,0
54133,445,0,0,drop,66,66,0,1,0,1,0
56173,37807,0,0,deny,66,66,0,1,0,1,0
55220,53,13554,53,allow,193,102,91,2,30,1,1
56223,53,26065,53,allow,768,99,669,2,30,1,1
56111,53,56414,53,allow,152,78,74,2,30,1,1
50513,80,33823,80,allow,318,192,126,6,25,4,2
45941,23386,0,0,deny,60,60,0,1,0,1,0
56950,53,63422,53,allow,211,102,109,2,30,1,1
51793,80,57988,80,allow,3960,2330,1630,18,47,11,7
60192,35440,0,0,deny,62,62,0,1,0,1,0
53846,445,0,0,drop,70,70,0,1,0,1,0
64003,38926,33075,38926,allow,66,66,0,2,8,2,0
52616,80,52616,80,allow,3366,2547,819,15,49,8,7
57797,445,0,0,drop,70,70,0,1,0,1,0
9126,80,52469,80,allow,318,192,126,6,30,4,2
49643,80,57400,80,allow,312,192,120,6,41,4,2
61469,445,0,0,drop,66,66,0,1,0,1,0
27005,27015,50537,27015,allow,878,126,752,2,30,1,1
49224,53,33872,53,allow,198,101,97,2,30,1,1
50741,445,0,0,drop,70,70,0,1,0,1,0
49777,53,59395,53,allow,164,84,80,2,31,1,1
54413,445,0,0,drop,66,66,0,1,0,1,0
59696,57470,0,0,deny,62,62,0,1,0,1,0
56731,53,43957,53,allow,173,94,79,2,31,1,1
55674,445,0,0,drop,70,70,0,1,0,1,0
53906,12051,34312,12051,allow,258,70,188,4,9,2,2
43681,443,58156,443,allow,7235,1097,6138,21,27,10,11
10049,5222,44592,5222,allow,6103,3081,3022,63,616,34,29
64087,80,46757,80,allow,314,192,122,6,15,4,2
45682,25604,0,0,deny,62,62,0,1,0,1,0
59984,445,0,0,drop,66,66,0,1,0,1,0
15806,11392,0,0,deny,66,66,0,1,0,1,0
65463,53,50986,53,allow,177,94,83,2,30,1,1
57680,445,0,0,drop,70,70,0,1,0,1,0
53254,443,6395,443,allow,310549,9420,301129,339,65,122,217
61701,44847,0,0,deny,66,66,0,1,0,1,0
55027,53,13864,53,allow,168,86,82,2,30,1,1
62514,37807,0,0,deny,66,66,0,1,0,1,0
63542,3389,63542,3389,allow,3504,1790,1714,17,32,9,8
1025,51221,0,0,deny,62,62,0,1,0,1,0
55484,443,18380,443,allow,782,428,354,12,25,7,5
62292,445,0,0,drop,70,70,0,1,0,1,0
56791,53,55367,53,allow,250,87,163,4,58,2,2
65107,53,21629,53,allow,186,95,91,2,31,1,1
55343,445,0,0,drop,66,66,0,1,0,1,0
1575,53,0,0,allow,254,86,168,2,30,1,1
53163,32834,49682,32834,allow,70,70,0,1,5,1,0
46730,443,28358,443,allow,7648,1671,5977,25,31,13,12
2467,2767,0,0,deny,66,66,0,1,0,1,0
49312,53,2239,53,allow,184,86,98,2,30,1,1
59610,53,54271,53,allow,191,78,113,2,30,1,1
65381,445,0,0,drop,70,70,0,1,0,1,0
0,0,0,0,deny,98,98,0,1,0,1,0
2422,62507,0,0,deny,62,62,0,1,0,1,0
57296,53,48552,53,allow,200,102,98,2,30,1,1
48478,49903,0,0,deny,62,62,0,1,0,1,0
49418,27015,59160,27015,allow,78,78,0,1,30,1,0
60130,443,10266,443,allow,16291,9102,7189,94,508,42,52
53822,80,58040,80,allow,1655,1341,314,10,15,5,5
62883,445,0,0,drop,70,70,0,1,0,1,0
57446,443,49278,443,allow,9642,3343,6299,37,16,17,20
443,20995,0,0,deny,83,83,0,1,0,1,0
59097,445,0,0,drop,70,70,0,1,0,1,0
57005,80,30107,80,allow,214,140,74,4,30,3,1
53646,16561,53092,16561,allow,422,140,282,6,15,3,3
34073,37965,0,0,deny,62,62,0,1,0,1,0
62745,445,0,0,drop,70,70,0,1,0,1,0
33255,53,27087,53,allow,86,86,0,1,30,1,0
45118,15000,63789,15000,allow,130,70,60,2,6,1,1
65518,53,59686,53,allow,211,102,109,2,30,1,1
52277,443,12555,443,allow,13832,4868,8964,91,364,37,54
64357,53,46898,53,allow,182,93,89,2,30,1,1
57762,445,0,0,drop,66,66,0,1,0,1,0
37835,443,55999,443,allow,63724,45783,17941,171,123,85,86
41052,443,41052,443,allow,4596,1689,2907,19,27,11,8
51783,50584,0,0,deny,66,66,0,1,0,1,0
56540,443,45404,443,allow,103117,6206,96911,127,106,54,73
51289,445,0,0,drop,70,70,0,1,0,1,0
56773,445,0,0,drop,66,66,0,1,0,1,0
42298,40005,17939,40005,allow,263,182,81,2,30,1,1
57540,445,0,0,drop,70,70,0,1,0,1,0
62247,445,0,0,drop,70,70,0,1,0,1,0
62140,445,0,0,drop,70,70,0,1,0,1,0
58721,51505,0,0,deny,66,66,0,1,0,1,0
50584,54993,58004,54993,allow,652,300,352,4,1200,3,1
45355,443,7242,443,allow,410,210,200,7,92,4,3
57087,445,0,0,drop,70,70,0,1,0,1,0
53318,80,64678,80,allow,1536,982,554,10,76,6,4
61701,44847,0,0,deny,66,66,0,1,0,1,0
56009,53,7541,53,allow,172,88,84,2,31,1,1
2425,23117,0,0,deny,62,62,0,1,0,1,0
52304,445,0,0,drop,70,70,0,1,0,1,0
50116,22,50116,22,allow,60,60,0,1,5,1,0
53461,443,61462,443,allow,52988,3128,49860,67,48,26,41
51458,445,0,0,drop,70,70,0,1,0,1,0
53540,34134,43313,34134,allow,70,70,0,2,7,2,0
59900,3389,59900,3389,allow,4286,2261,2025,20,18,11,9
48629,63131,0,0,deny,74,74,0,1,0,1,0
55664,445,0,0,drop,70,70,0,1,0,1,0
40959,61903,0,0,deny,145,145,0,1,0,1,0
11056,6881,0,0,deny,146,146,0,1,0,1,0
35106,53,20275,53,allow,271,102,169,2,30,1,1
50713,57470,0,0,deny,62,62,0,1,0,1,0
46286,21247,0,0,deny,62,62,0,1,0,1,0
47132,1433,0,0,deny,60,60,0,1,0,1,0
50606,443,59722,443,allow,1511,849,662,16,94,9,7
58638,5900,0,0,deny,62,62,0,1,0,1,0
51221,45722,40795,45722,allow,481,150,331,2,1200,1,1
65347,445,0,0,drop,70,70,0,1,0,1,0
53885,443,38826,443,allow,499,425,74,4,0,3,1
12951,50584,0,0,deny,66,66,0,1,0,1,0
57072,53,19221,53,allow,195,102,93,2,30,1,1
49651,37965,0,0,deny,74,74,0,1,0,1,0
56183,53,23444,53,allow,179,94,85,2,30,1,1
58890,445,0,0,drop,70,70,0,1,0,1,0
50584,49647,42268,49647,allow,523,161,362,2,1200,1,1
49851,53,2859,53,allow,306,88,218,4,32,2,2
56450,53,17647,53,allow,177,94,83,2,29,1,1
50611,445,0,0,drop,70,70,0,1,0,1,0
64300,445,0,0,drop,70,70,0,1,0,1,0
6416,22114,0,0,deny,66,66,0,1,0,1,0
60165,80,45319,80,allow,1982,692,1290,8,15,5,3
28176,34021,0,0,allow,66,66,0,1,90,1,0
58955,445,0,0,drop,70,70,0,1,0,1,0
47944,50584,0,0,deny,146,146,0,1,0,1,0
49990,53,43468,53,allow,198,102,96,2,30,1,1
65180,53,26372,53,allow,165,86,79,2,30,1,1
60610,443,53274,443,allow,187258,9720,177538,225,211,86,139
55997,445,0,0,drop,66,66,0,1,0,1,0
56942,53,55677,53,allow,177,94,83,2,30,1,1
52970,443,47039,443,allow,19221,5366,13855,88,113,36,52
50381,445,0,0,drop,70,70,0,1,0,1,0
57296,443,59127,443,allow,5613,733,4880,16,15,9,7
50656,445,0,0,drop,70,70,0,1,0,1,0
64967,53,49368,53,allow,184,94,90,2,31,1,1
8282,17435,17967,17435,allow,73,73,0,1,30,1,0
49110,443,4488,443,allow,43476,3775,39701,67,397,28,39
55018,445,0,0,drop,66,66,0,1,0,1,0
49586,445,0,0,drop,66,66,0,1,0,1,0
7347,56205,0,0,deny,66,66,0,1,0,1,0
57354,443,9548,443,allow,28807,2716,26091,54,466,21,33
60880,443,55222,443,allow,25751,2629,23122,49,49,23,26
50663,80,56397,80,allow,1366,865,501,8,15,5,3
49522,53,15202,53,allow,753,96,657,2,31,1,1
52166,26467,0,0,deny,66,66,0,1,0,1,0
47902,443,46766,443,allow,2420,1462,958,18,170,10,8
49762,53,30143,53,allow,819,102,717,2,29,1,1
58739,445,0,0,drop,66,66,0,1,0,1,0
50700,80,27825,80,allow,142,142,0,1,5,1,0
27209,25198,0,0,deny,145,145,0,1,0,1,0
53597,42845,3911,42845,allow,678,492,186,10,18,7,3
14489,25174,0,0,deny,62,62,0,1,0,1,0
35120,26467,0,0,deny,62,62,0,1,0,1,0
56560,53,11515,53,allow,198,102,96,2,31,1,1
56609,53,65200,53,allow,199,102,97,2,30,1,1
56650,80,32144,80,allow,234,234,0,4,12,4,0
65464,443,36070,443,allow,395647,11870,383777,409,16,144,265
28899,37965,0,0,deny,62,62,0,1,0,1,0
49559,443,1739,443,allow,3641,1047,2594,14,120,7,7
58638,5900,0,0,deny,62,62,0,1,0,1,0
53868,52706,53464,52706,allow,70,70,0,1,4,1,0
65257,445,0,0,drop,70,70,0,1,0,1,0
58819,445,0,0,drop,66,66,0,1,0,1,0
56586,53,63496,53,allow,177,94,83,2,31,1,1
41631,123,31654,123,allow,184,94,90,2,30,1,1
58822,443,37574,443,allow,5166,700,4466,16,15,7,9
54223,445,0,0,drop,66,66,0,1,0,1,0
33965,443,25810,443,allow,1409634,52704,1356930,1536,173,533,1003
49312,53,33674,53,allow,306,94,212,2,29,1,1
65495,443,43238,443,allow,418463,12360,406103,430,16,151,279
34454,80,29541,80,allow,2913,633,2280,15,16,8,7
58597,35440,0,0,deny,66,66,0,1,0,1,0
51652,80,59640,80,allow,454,262,192,8,37,5,3
53453,2767,0,0,deny,66,66,0,1,0,1,0
57066,445,0,0,drop,70,70,0,1,0,1,0
52865,443,62658,443,allow,120290,2988,117302,123,132,32,91
52831,3389,52831,3389,allow,4145,1976,2169,22,18,13,9
60599,445,0,0,drop,70,70,0,1,0,1,0
64803,53,24000,53,allow,303,303,0,4,47,4,0
57435,443,34425,443,allow,13536,5529,8007,55,18,24,31
3755,443,3755,443,allow,12079,1344,10735,24,17,10,14
59757,53,47514,53,allow,260,86,174,2,30,1,1
58638,5900,0,0,deny,62,62,0,1,0,1,0
50146,445,0,0,drop,66,66,0,1,0,1,0
56358,53,42887,53,allow,210,110,100,2,33,1,1
52410,443,38111,443,allow,128802,48896,79906,237,24,121,116
53535,1393,2385,1393,allow,70,70,0,2,8,2,0
24037,443,24037,443,allow,3611,2177,1434,24,17,13,11
55067,53,8321,53,allow,172,88,84,2,30,1,1
65109,53,42813,53,allow,229,102,127,2,30,1,1
25961,55783,0,0,deny,66,66,0,1,0,1,0
59733,53,57614,53,allow,384,166,218,2,30,1,1
64190,2767,0,0,deny,62,62,0,1,0,1,0
49268,445,0,0,drop,70,70,0,1,0,1,0
64731,53,48863,53,allow,779,86,693,2,30,1,1
51151,64147,0,0,deny,62,62,0,1,0,1,0
55617,53,11638,53,allow,214,110,104,2,30,1,1
63975,24874,26677,24874,allow,66,66,0,2,7,2,0
60384,80,50302,80,allow,1420,715,705,12,16,7,5
62081,443,56055,443,allow,3044,1694,1350,23,45,13,10
55286,445,0,0,drop,70,70,0,1,0,1,0
1114,37965,0,0,deny,62,62,0,1,0,1,0
61802,23,0,0,deny,60,60,0,1,0,1,0
65343,53,12324,53,allow,194,99,95,2,30,1,1
47325,2323,0,0,deny,60,60,0,1,0,1,0
57435,53,39763,53,allow,184,102,82,2,30,1,1
4138,55777,0,0,deny,66,66,0,1,0,1,0
59592,37965,0,0,deny,62,62,0,1,0,1,0
30111,2323,0,0,deny,60,60,0,1,0,1,0
63900,42641,18797,42641,allow,504,382,122,8,16,6,2
50692,443,32817,443,allow,180,60,120,4,15,2,2
54028,37965,0,0,deny,66,66,0,1,0,1,0
54321,445,0,0,drop,70,70,0,1,0,1,0
65127,53,45861,53,allow,194,102,92,2,30,1,1
47401,80,21233,80,allow,3158,1159,1999,14,16,8,6
51036,80,2227,80,allow,1514,480,1034,11,16,6,5
60022,443,60022,443,allow,18674,1910,16764,32,18,17,15
59745,25174,0,0,deny,146,146,0,1,0,1,0
49480,53,12824,53,allow,184,94,90,2,30,1,1
60464,53,0,0,allow,180,82,98,2,30,1,1
64474,445,0,0,drop,70,70,0,1,0,1,0
62750,445,0,0,drop,70,70,0,1,0,1,0
62292,445,0,0,drop,70,70,0,1,0,1,0
9222,443,6216,443,allow,6676,1097,5579,21,26,11,10
50137,445,0,0,drop,70,70,0,1,0,1,0
65461,53,60419,53,allow,226,94,132,2,30,1,1
54051,28793,0,0,deny,66,66,0,1,0,1,0
49486,7000,49486,7000,allow,3370,1595,1775,16,15,9,7
57018,53,10253,53,allow,177,94,83,2,30,1,1
37554,443,12881,443,allow,13220,4632,8588,32,37,19,13
64308,445,0,0,drop,70,70,0,1,0,1,0
49377,445,0,0,drop,70,70,0,1,0,1,0
51074,80,51074,80,allow,168467,7348,161119,184,8,67,117
57409,53,32069,53,allow,168,86,82,2,31,1,1
49289,53,16244,53,allow,177,94,83,2,30,1,1
49272,53,30273,53,allow,168,86,82,2,31,1,1
57255,445,0,0,drop,70,70,0,1,0,1,0
53173,445,0,0,drop,66,66,0,1,0,1,0
62995,53,59527,53,allow,101,101,0,2,31,2,0
56299,445,0,0,drop,70,70,0,1,0,1,0
59918,445,0,0,drop,70,70,0,1,0,1,0
56805,1,17140,1,allow,70,70,0,1,5,1,0
50105,445,0,0,drop,70,70,0,1,0,1,0
42034,28189,0,0,deny,62,62,0,1,0,1,0
57305,53,52868,53,allow,168,86,82,2,29,1,1
48706,23393,0,0,deny,60,60,0,1,0,1,0
64288,53,54415,53,allow,398,103,295,4,41,2,2
64895,53,23891,53,allow,199,102,97,2,29,1,1
55187,445,0,0,drop,70,70,0,1,0,1,0
49227,2710,25043,2710,allow,70,70,0,1,5,1,0
27309,6881,0,0,deny,146,146,0,1,0,1,0
53794,53,8818,53,allow,260,86,174,2,30,1,1
53221,53,3242,53,allow,165,78,87,2,30,1,1
41421,443,56908,443,allow,168930,11361,157569,252,31,101,151
50333,80,53972,80,allow,442,250,192,8,47,5,3
51834,30309,10825,30309,allow,70,70,0,1,5,1,0
61408,30188,0,0,deny,66,66,0,1,0,1,0
51553,445,0,0,drop,66,66,0,1,0,1,0
26254,56205,0,0,deny,62,62,0,1,0,1,0
45064,25174,0,0,deny,62,62,0,1,0,1,0
11228,23,0,0,deny,60,60,0,1,0,1,0
53346,445,0,0,drop,70,70,0,1,0,1,0
50135,445,0,0,drop,66,66,0,1,0,1,0
443,45788,0,0,deny,332,332,0,1,0,1,0
64155,53,2380,53,allow,183,94,89,2,30,1,1
64828,53,23782,53,allow,372,94,278,2,30,1,1
56013,443,56013,443,allow,4599,1692,2907,19,26,11,8
63848,48560,48756,48560,allow,66,66,0,2,7,2,0
24351,57470,0,0,deny,62,62,0,1,0,1,0
59884,443,34275,443,allow,1401,864,537,12,28,6,6
56381,51505,0,0,deny,146,146,0,1,0,1,0
8283,52443,24980,52443,allow,70,70,0,1,30,1,0
1057,57470,0,0,deny,62,62,0,1,0,1,0
41631,443,38429,443,allow,20180,2917,17263,35,124,14,21
56541,443,2047,443,allow,1560,988,572,13,25,7,6
50313,80,19871,80,allow,3450,1386,2064,15,83,8,7
59792,445,0,0,drop,66,66,0,1,0,1,0
53798,62166,11396,62166,allow,258,70,188,4,7,2,2
49006,443,37569,443,allow,119425284,929428,118495856,93687,498,9675,84012
53310,443,4749,443,allow,2253,1403,850,15,121,9,6
64030,53,64891,53,allow,222,78,144,2,30,1,1
49370,11392,0,0,deny,62,62,0,1,0,1,0
27005,27017,10039,27017,allow,891,126,765,2,30,1,1
55296,23718,0,0,deny,66,66,0,1,0,1,0
30188,63853,28721,63853,allow,502,150,352,2,1200,1,1
55433,443,16673,443,allow,72759,18547,54212,120,137,49,71
50358,80,6074,80,allow,306,180,126,6,25,4,2
49822,445,0,0,drop,70,70,0,1,0,1,0
57245,443,39703,443,allow,170452,9659,160793,224,68,97,127
61039,445,0,0,drop,70,70,0,1,0,1,0
56602,443,24699,443,allow,27035,4207,22828,43,31,21,22
57198,80,57198,80,allow,6738,909,5829,14,20,7,7
54121,25174,0,0,deny,66,66,0,1,0,1,0
21534,42246,0,0,deny,66,66,0,1,0,1,0
64385,445,0,0,drop,70,70,0,1,0,1,0
59979,445,0,0,drop,66,66,0,1,0,1,0
6881,1707,0,0,deny,146,146,0,1,0,1,0
50265,55637,31401,55637,allow,528,528,0,9,1200,9,0
21173,37965,0,0,deny,62,62,0,1,0,1,0
51736,34343,5872,34343,allow,70,70,0,2,8,2,0
15503,61471,17657,61471,allow,490,149,341,2,1200,1,1
21133,51413,43233,51413,allow,460,150,310,2,1200,1,1
49570,445,0,0,drop,66,66,0,1,0,1,0
57880,80,31507,80,allow,13028,3246,9782,29,30,16,13
56968,443,61875,443,allow,5649,2005,3644,21,186,11,10
49769,53,37724,53,allow,780,93,687,2,31,1,1
45633,80,23400,80,allow,1573,702,871,12,45,7,5
65075,445,0,0,drop,70,70,0,1,0,1,0
59911,445,0,0,drop,70,70,0,1,0,1,0
65519,445,0,0,drop,66,66,0,1,0,1,0
55544,445,0,0,drop,70,70,0,1,0,1,0
44847,26356,3716,26356,allow,501,150,351,2,1200,1,1
46405,80,41634,80,allow,1213,755,458,10,15,6,4
57956,445,0,0,drop,70,70,0,1,0,1,0
53629,443,53629,443,allow,4620,1713,2907,19,30,11,8
64605,25174,0,0,deny,66,66,0,1,0,1,0
65477,443,34529,443,allow,409770,12150,397620,421,16,148,273
50726,443,27589,443,allow,12350,2504,9846,41,137,21,20
48252,443,55839,443,allow,60300,47341,12959,192,39,108,84
64088,53,9032,53,allow,434,108,326,4,51,2,2
63655,445,0,0,drop,70,70,0,1,0,1,0
34952,53,65291,53,allow,177,94,83,2,30,1,1
44934,443,47157,443,allow,416,210,206,7,24,4,3
56008,53,22150,53,allow,230,86,144,2,30,1,1
52470,14037,0,0,deny,66,66,0,1,0,1,0
23150,53,23150,53,allow,365,233,132,3,32,2,1
9529,26467,0,0,deny,62,62,0,1,0,1,0
37874,19000,47411,19000,allow,602,174,428,2,31,1,1
60359,443,21791,443,allow,9607,3847,5760,51,134,26,25
57092,53,3743,53,allow,228,102,126,2,30,1,1
58638,5900,0,0,deny,62,62,0,1,0,1,0
60390,56494,64175,56494,allow,70,70,0,2,8,2,0
52718,445,0,0,drop,70,70,0,1,0,1,0
46991,53,46991,53,allow,262,106,156,2,31,1,1
52385,53,0,0,allow,138,69,69,2,30,1,1
65349,53,5493,53,allow,284,94,190,2,29,1,1
443,38956,0,0,deny,82,82,0,1,0,1,0
27005,1403,18731,1403,allow,857,126,731,2,30,1,1
56612,53,36295,53,allow,184,94,90,2,31,1,1
57873,445,0,0,drop,70,70,0,1,0,1,0
49663,53,27941,53,allow,168,86,82,2,31,1,1
65096,53,51459,53,allow,216,94,122,2,30,1,1
57714,445,0,0,drop,66,66,0,1,0,1,0
56909,50584,0,0,deny,66,66,0,1,0,1,0
53563,445,0,0,drop,70,70,0,1,0,1,0
60374,443,9623,443,allow,130,70,60,2,15,1,1
53016,443,45563,443,allow,50403,2032,48371,66,108,21,45
50279,443,22072,443,allow,21204,10998,10206,51,392,27,24
57433,21247,0,0,deny,66,66,0,1,0,1,0
55425,37965,0,0,deny,66,66,0,1,0,1,0
59662,445,0,0,drop,70,70,0,1,0,1,0
48483,443,20913,443,allow,60944,9555,51389,71,362,25,46
60776,4156,29632,4156,allow,66,66,0,1,5,1,0
65130,53,36063,53,allow,266,110,156,2,30,1,1
63966,445,0,0,drop,70,70,0,1,0,1,0
55025,443,11622,443,allow,7599,3113,4486,30,20,17,13
56092,445,0,0,drop,66,66,0,1,0,1,0
51963,445,0,0,drop,70,70,0,1,0,1,0
33107,443,4785,443,allow,3820081,140348,3679733,4457,136,1736,2721
65454,61600,0,0,deny,66,66,0,1,0,1,0
51754,1182,24029,1182,allow,70,70,0,1,5,1,0
60971,443,2878,443,allow,2732,1359,1373,29,193,16,13
27005,27016,51239,27016,allow,888,126,762,2,30,1,1
50584,51413,31327,51413,allow,498,150,348,4,2396,2,2
63195,445,0,0,drop,66,66,0,1,0,1,0
0,0,0,0,allow,2000,1020,980,20,0,10,10
49746,53,23888,53,allow,177,94,83,2,30,1,1
53003,11392,0,0,deny,66,66,0,1,0,1,0
57849,50584,0,0,deny,66,66,0,1,0,1,0
49556,53,62658,53,allow,300,100,200,4,44,2,2
50015,443,26548,443,allow,59858,24345,35513,148,612,78,70
59528,445,0,0,drop,66,66,0,1,0,1,0
50,64147,0,0,deny,62,62,0,1,0,1,0
57018,53,1950,53,allow,170,87,83,2,30,1,1
65040,53,46633,53,allow,180,94,86,2,29,1,1
49908,56205,0,0,deny,62,62,0,1,0,1,0
63966,53,6914,53,allow,214,102,112,2,30,1,1
51709,40705,43195,40705,allow,70,70,0,2,8,2,0
51784,34568,29870,34568,allow,70,70,0,2,8,2,0
64695,53,9580,53,allow,186,95,91,2,31,1,1
59087,445,0,0,drop,70,70,0,1,0,1,0
19698,502,0,0,deny,60,60,0,1,0,1,0
56704,53,2195,53,allow,177,94,83,2,30,1,1
64701,445,0,0,drop,70,70,0,1,0,1,0
55264,53,25192,53,allow,177,94,83,2,30,1,1
49579,80,10648,80,allow,277736,7810,269926,277,65,91,186
50470,61463,0,0,deny,86,86,0,1,0,1,0
57883,443,38550,443,allow,5932,1264,4668,21,155,11,10
58897,23,0,0,deny,60,60,0,1,0,1,0
58646,44847,0,0,deny,66,66,0,1,0,1,0
56621,53,19745,53,allow,177,94,83,2,30,1,1
60037,443,34987,443,allow,376301,13445,362856,452,102,198,254
51427,445,0,0,drop,70,70,0,1,0,1,0
57591,53,13897,53,allow,165,78,87,2,31,1,1
55976,53,37566,53,allow,758,96,662,2,31,1,1
43536,443,9827,443,allow,13710,4975,8735,22,121,9,13
58049,80,61142,80,allow,378,192,186,7,19,4,3
53703,16426,15322,16426,allow,70,70,0,2,7,2,0
55505,53,51745,53,allow,199,102,97,2,31,1,1
60575,80,18847,80,allow,9034,1860,7174,17,16,8,9
65144,53,10538,53,allow,210,110,100,2,30,1,1
22275,51505,0,0,deny,62,62,0,1,0,1,0
50085,80,41165,80,allow,5514,2362,3152,37,469,19,18
29471,57470,0,0,deny,145,145,0,1,0,1,0
62870,445,0,0,drop,66,66,0,1,0,1,0
62338,50011,0,0,deny,66,66,0,1,0,1,0
49253,53,58276,53,allow,199,102,97,2,30,1,1
58297,445,0,0,drop,70,70,0,1,0,1,0
49358,443,2362,443,allow,9482,4710,4772,19,16,11,8
56889,53,27210,53,allow,211,110,101,2,30,1,1
43934,53,43934,53,allow,310,94,216,2,30,1,1
55142,445,0,0,drop,70,70,0,1,0,1,0
22975,23,0,0,deny,60,60,0,1,0,1,0
39852,80,39852,80,allow,576,272,304,9,142,5,4
60141,30188,0,0,deny,66,66,0,1,0,1,0
60292,7129,0,0,deny,62,62,0,1,0,1,0
53841,8999,55229,8999,allow,70,70,0,2,8,2,0
64546,445,0,0,drop,70,70,0,1,0,1,0
41794,41794,0,0,deny,308,308,0,1,0,1,0
26717,25174,0,0,deny,146,146,0,1,0,1,0
57470,58210,46855,58210,allow,2118,858,1260,28,1261,14,14
63572,443,58406,443,allow,125798,40014,85784,276,171,125,151
61460,445,0,0,drop,70,70,0,1,0,1,0
53045,445,0,0,drop,66,66,0,1,0,1,0
60113,22114,0,0,deny,66,66,0,1,0,1,0
41970,23,0,0,deny,60,60,0,1,0,1,0
64511,53,2785,53,allow,305,102,203,2,30,1,1
55912,53,21691,53,allow,184,94,90,2,31,1,1
59813,445,0,0,drop,70,70,0,1,0,1,0
51165,445,0,0,drop,70,70,0,1,0,1,0
58555,443,6848,443,allow,15546,2361,13185,39,123,18,21
59532,445,0,0,drop,66,66,0,1,0,1,0
54698,445,0,0,drop,70,70,0,1,0,1,0
57607,21247,0,0,deny,66,66,0,1,0,1,0
62558,445,0,0,drop,66,66,0,1,0,1,0
54827,443,62409,443,allow,11291,2426,8865,21,121,10,11
45908,33330,0,0,deny,60,60,0,1,0,1,0
51840,34678,2661,34678,allow,70,70,0,2,8,2,0
58849,64147,0,0,deny,62,62,0,1,0,1,0
57470,6881,59936,6881,allow,132,132,0,3,1199,3,0
26835,47993,0,0,deny,62,62,0,1,0,1,0
50309,443,46447,443,allow,5955,1619,4336,23,15,13,10
55715,443,4116,443,allow,1648,114,1534,5,120,2,3
9494,23,0,0,deny,60,60,0,1,0,1,0
56733,53,65238,53,allow,177,94,83,2,30,1,1
50527,445,0,0,drop,70,70,0,1,0,1,0
59937,37965,0,0,deny,66,66,0,1,0,1,0
49566,53,59606,53,allow,200,94,106,2,30,1,1
59052,53,59052,53,allow,235,90,145,2,32,1,1
56377,445,0,0,drop,70,70,0,1,0,1,0
64516,53,21568,53,allow,215,94,121,2,30,1,1
41953,443,3719,443,allow,4129,2865,1264,17,361,9,8
53813,11392,0,0,deny,62,62,0,1,0,1,0
51935,38639,4270,38639,allow,70,70,0,2,8,2,0
57120,53,16635,53,allow,761,100,661,2,30,1,1
53932,445,0,0,drop,70,70,0,1,0,1,0
56799,443,37236,443,allow,7511,2237,5274,17,16,9,8
64524,53,42733,53,allow,184,94,90,2,31,1,1
64369,445,0,0,drop,70,70,0,1,0,1,0
58638,5900,0,0,deny,62,62,0,1,0,1,0
56609,53,42819,53,allow,199,102,97,2,31,1,1
55069,53,50203,53,allow,195,102,93,2,30,1,1
29300,35440,0,0,deny,62,62,0,1,0,1,0
54848,445,0,0,drop,70,70,0,1,0,1,0
39651,443,15343,443,allow,18514,4506,14008,72,105,41,31
60271,445,0,0,drop,70,70,0,1,0,1,0
49981,44847,0,0,deny,62,62,0,1,0,1,0
64957,53,39699,53,allow,196,102,94,2,30,1,1
63387,445,0,0,drop,66,66,0,1,0,1,0
63981,53,13175,53,allow,199,102,97,2,29,1,1
53693,445,0,0,drop,70,70,0,1,0,1,0
63978,63776,58166,63776,allow,70,70,0,1,4,1,0
10003,64147,0,0,deny,62,62,0,1,0,1,0
18102,53,59095,53,allow,223,86,137,2,30,1,1
49514,65504,0,0,deny,162,162,0,1,0,1,0
58638,5900,0,0,deny,62,62,0,1,0,1,0
43484,443,55073,443,allow,130,70,60,2,15,1,1
57064,443,57064,443,allow,4378,1471,2907,19,29,11,8
56603,53,47573,53,allow,168,86,82,2,29,1,1
30654,51221,0,0,deny,72,72,0,1,0,1,0
59697,445,0,0,drop,70,70,0,1,0,1,0
57402,9992,42519,9992,allow,47040,13931,33109,428,129,207,221
53526,45046,24762,45046,allow,552,306,246,9,15,5,4
55081,80,13620,80,allow,1680,697,983,10,52,6,4
53875,445,0,0,drop,70,70,0,1,0,1,0
18754,30188,0,0,deny,66,66,0,1,0,1,0
9223,443,33719,443,allow,4081,443,3638,12,15,6,6
4269,26672,0,0,deny,60,60,0,1,0,1,0
57908,443,7958,443,allow,1648,1017,631,18,124,10,8
55255,53,4437,53,allow,282,94,188,2,29,1,1
49248,35993,0,0,deny,66,66,0,1,0,1,0
443,10120,443,10120,allow,64,64,0,1,5,1,0
50280,53,42526,53,allow,794,102,692,2,30,1,1
47089,22114,0,0,deny,146,146,0,1,0,1,0
38640,443,50053,443,allow,6171,1091,5080,22,82,12,10
59147,51505,0,0,deny,62,62,0,1,0,1,0
54644,443,43384,443,allow,4679,3387,1292,18,304,10,8
53214,80,58168,80,allow,19877,856,19021,22,16,6,16
13684,25174,0,0,deny,62,62,0,1,0,1,0
61387,443,3059,443,allow,12231,6846,5385,38,160,19,19
45169,14037,0,0,deny,74,74,0,1,0,1,0
52097,23279,3582,23279,allow,70,70,0,2,7,2,0
52019,80,54297,80,allow,426,240,186,8,24,5,3
64384,53,2219,53,allow,333,94,239,2,30,1,1
59532,445,0,0,drop,70,70,0,1,0,1,0
63699,445,0,0,drop,66,66,0,1,0,1,0
64966,53,26229,53,allow,376,126,250,2,29,1,1
64288,53,63361,53,allow,229,110,119,2,29,1,1
50250,53,19188,53,allow,172,88,84,2,30,1,1
37551,443,6245,443,allow,9381,2351,7030,26,37,15,11
54033,443,12852,443,allow,5260,2704,2556,13,121,7,6
50077,443,29789,443,allow,8172,1833,6339,25,93,14,11
49157,53,4191,53,allow,184,94,90,2,30,1,1
65424,53,25204,53,allow,204,104,100,2,31,1,1
50362,445,0,0,drop,70,70,0,1,0,1,0
55592,445,0,0,drop,70,70,0,1,0,1,0
49163,445,0,0,drop,70,70,0,1,0,1,0
50276,53,20646,53,allow,94,94,0,1,30,1,0
32071,51221,0,0,deny,66,66,0,1,0,1,0
45964,2225,0,0,deny,60,60,0,1,0,1,0
64841,53,24677,53,allow,165,86,79,2,30,1,1
64055,45105,31145,45105,allow,70,70,0,1,4,1,0
65526,28793,0,0,deny,66,66,0,1,0,1,0
55937,53,29379,53,allow,174,89,85,2,0,1,1
62348,30349,0,0,deny,148,148,0,1,0,1,0
53895,443,16317,443,allow,375374,160846,214528,633,1412,294,339
50352,445,0,0,drop,70,70,0,1,0,1,0
61406,1,0,0,deny,78,78,0,1,0,1,0
38866,443,54319,443,allow,16577,10269,6308,33,17,20,13
52337,445,0,0,drop,70,70,0,1,0,1,0
51652,80,57447,80,allow,141220,4280,136940,159,17,59,100
60502,445,0,0,drop,70,70,0,1,0,1,0
55732,53,41995,53,allow,177,94,83,2,29,1,1
52168,62118,2887,62118,allow,70,70,0,2,8,2,0
55658,45261,40194,45261,allow,70,70,0,2,8,2,0
51661,445,0,0,drop,66,66,0,1,0,1,0
60483,57723,53854,57723,allow,320,140,180,6,6,3,3
30651,53,22880,53,allow,86,86,0,1,30,1,0
62067,443,12137,443,allow,4833,2196,2637,13,120,7,6
49882,443,51154,443,allow,79524,18512,61012,205,50,101,104
64417,445,0,0,drop,66,66,0,1,0,1,0
60070,44847,0,0,deny,66,66,0,1,0,1,0
49497,443,34229,443,allow,185560,47806,137754,421,295,217,204
26900,27017,60597,27017,allow,422,164,258,6,31,3,3
56181,53,2631,53,allow,784,94,690,2,29,1,1
38334,443,30322,443,allow,1864,250,1614,8,121,4,4
50265,53606,10997,53606,allow,528,528,0,9,1200,9,0
56739,42421,49450,42421,allow,2810,1382,1428,12,31,6,6
53522,8765,27669,8765,allow,199,75,124,4,59,2,2
59544,445,0,0,drop,70,70,0,1,0,1,0
35214,8635,35214,8635,allow,138,78,60,2,5,1,1
65420,53,28650,53,allow,166,86,80,2,31,1,1
55773,53,51846,53,allow,102,102,0,1,60,1,0
62996,445,0,0,drop,70,70,0,1,0,1,0
56922,53,40001,53,allow,168,86,82,2,30,1,1
56070,53,26270,53,allow,193,102,91,2,30,1,1
57044,53,13631,53,allow,177,94,83,2,29,1,1
55790,53,7477,53,allow,170,87,83,2,31,1,1
52640,6881,33244,6881,allow,719,413,306,10,14,5,5
9475,443,36657,443,allow,4063,969,3094,16,26,9,7
64030,53,24656,53,allow,338,110,228,2,30,1,1
60460,54233,13899,54233,allow,70,70,0,1,5,1,0
58638,5900,58638,5900,allow,130,66,64,2,5,1,1
60699,445,0,0,drop,66,66,0,1,0,1,0
46830,80,6947,80,allow,1764,751,1013,10,16,6,4
26847,443,30937,443,allow,10585,3919,6666,33,80,16,17
53536,445,0,0,drop,70,70,0,1,0,1,0
54504,445,0,0,drop,66,66,0,1,0,1,0
52910,443,4102,443,allow,179433,12614,166819,217,116,78,139
56334,53,1244,53,allow,177,94,83,2,29,1,1
58424,52700,0,0,deny,66,66,0,1,0,1,0
65186,445,0,0,drop,70,70,0,1,0,1,0
27651,53,46551,53,allow,225,78,147,2,30,1,1
60129,55442,0,0,deny,66,66,0,1,0,1,0
59927,445,0,0,drop,70,70,0,1,0,1,0
48655,53,0,0,allow,82,82,0,2,40,2,0
24127,23,0,0,deny,60,60,0,1,0,1,0
49418,27015,14560,27015,allow,71,71,0,1,30,1,0
65503,445,0,0,drop,66,66,0,1,0,1,0
58420,443,23233,443,allow,17161,1619,15542,18,149,4,14
47640,443,10100,443,allow,1058,571,487,10,38,6,4
57350,53,37868,53,allow,177,94,83,2,30,1,1
60985,443,19268,443,allow,20423,4091,16332,33,122,15,18
65309,53,31055,53,allow,764,102,662,2,30,1,1
49469,53,2393,53,allow,185,102,83,2,30,1,1
57313,53,1093,53,allow,811,94,717,2,30,1,1
59040,24184,0,0,allow,62,62,0,1,60,1,0
56949,443,2703,443,allow,5601,1203,4398,14,59,9,5
54998,53,29340,53,allow,438,89,349,4,60,2,2
65153,53,10346,53,allow,241,118,123,2,30,1,1
56100,53,56100,53,allow,265,111,154,2,30,1,1
50667,443,38450,443,allow,8536,2068,6468,36,18,16,20
6832,51505,0,0,deny,62,62,0,1,0,1,0
40452,1488,40452,1488,allow,156,156,0,3,8,3,0
50023,443,17571,443,allow,70,70,0,2,5,2,0
55545,53,60601,53,allow,177,94,83,2,30,1,1
59965,36237,0,0,deny,66,66,0,1,0,1,0
51980,45478,64521,45478,allow,70,70,0,1,5,1,0
47523,443,49117,443,allow,429929,11379,418550,456,21,174,282
50879,80,6049,80,allow,15453,3281,12172,29,140,16,13
51590,445,0,0,drop,66,66,0,1,0,1,0
30800,25174,0,0,deny,146,146,0,1,0,1,0
63651,445,0,0,drop,70,70,0,1,0,1,0
41744,37965,0,0,deny,62,62,0,1,0,1,0
53667,49160,27701,49160,allow,320,140,180,6,7,3,3
56655,53,60035,53,allow,168,86,82,2,30,1,1
38711,443,23557,443,allow,459089,10521,448568,449,16,141,308
54914,51505,0,0,deny,66,66,0,1,0,1,0
50734,443,16701,443,allow,1726,668,1058,13,2033,4,9
50877,35776,0,0,deny,159,159,0,1,0,1,0
56743,53,62302,53,allow,209,110,99,2,31,1,1
6881,64422,29110,64422,allow,219,111,108,2,1201,1,1
50095,445,0,0,drop,70,70,0,1,0,1,0
49554,443,54292,443,allow,10104,2646,7458,28,186,14,14
56700,53,42094,53,allow,443,182,261,6,30,3,3
60475,445,0,0,drop,70,70,0,1,0,1,0
43231,443,33460,443,allow,56226,4852,51374,71,106,30,41
34176,51505,0,0,deny,62,62,0,1,0,1,0
6828,64322,0,0,deny,60,60,0,1,0,1,0
49036,44847,0,0,deny,146,146,0,1,0,1,0
65072,445,0,0,drop,70,70,0,1,0,1,0
42473,80,36510,80,allow,1737,796,941,12,16,7,5
34485,81,0,0,deny,60,60,0,1,0,1,0
42309,443,23092,443,allow,7295,1469,5826,30,360,9,21
50380,80,4994,80,allow,3190,980,2210,13,30,7,6
57111,53,59340,53,allow,199,94,105,2,30,1,1
18964,443,18964,443,allow,5157,2180,2977,21,16,12,9
52128,80,31768,80,allow,366,240,126,7,26,5,2
51511,445,0,0,drop,70,70,0,1,0,1,0
55306,53,18601,53,allow,177,94,83,2,29,1,1
64517,53,39078,53,allow,194,102,92,2,31,1,1
56937,80,7429,80,allow,2567,1586,981,13,75,8,5
39840,443,35916,443,allow,6097,1540,4557,25,191,13,12
59967,445,0,0,drop,70,70,0,1,0,1,0
58543,445,0,0,drop,70,70,0,1,0,1,0
53207,50265,0,0,deny,66,66,0,1,0,1,0
35001,53,37388,53,allow,78,78,0,1,30,1,0
57284,22114,0,0,deny,66,66,0,1,0,1,0
55674,48870,19113,48870,allow,70,70,0,2,8,2,0
64160,445,0,0,drop,66,66,0,1,0,1,0
31748,56205,0,0,deny,146,146,0,1,0,1,0
50566,443,28525,443,allow,7367,1149,6218,18,27,9,9
48992,80,47525,80,allow,1114,534,580,12,16,7,5
60184,443,60184,443,allow,4574,1667,2907,19,26,11,8
50265,27813,47510,27813,allow,198,198,0,4,1200,4,0
62231,443,62231,443,allow,180730,19869,160861,239,171,103,136
55055,445,0,0,drop,70,70,0,1,0,1,0
51895,17172,22553,17172,allow,70,70,0,1,5,1,0
62298,445,0,0,drop,66,66,0,1,0,1,0
50500,443,60385,443,allow,12556,1134,11422,28,78,13,15
49639,443,59144,443,allow,13604,1980,11624,33,46,18,15
49982,53,19488,53,allow,211,110,101,2,30,1,1
52519,445,0,0,drop,66,66,0,1,0,1,0
60881,443,31300,443,allow,31109,2922,28187,54,52,26,28
49767,445,0,0,drop,66,66,0,1,0,1,0
62408,3478,14278,3478,allow,142,142,0,1,30,1,0
64565,53,49218,53,allow,802,104,698,2,31,1,1
65511,53,22579,53,allow,545,136,409,4,56,2,2
12965,37965,0,0,deny,66,66,0,1,0,1,0
56459,53,5237,53,allow,177,94,83,2,30,1,1
58638,5900,0,0,deny,62,62,0,1,0,1,0
1036,64147,0,0,deny,62,62,0,1,0,1,0
55001,445,0,0,drop,70,70,0,1,0,1,0
54234,80,54234,80,allow,2334,1575,759,11,148,6,5
44491,50584,0,0,deny,146,146,0,1,0,1,0
55757,53,50237,53,allow,177,94,83,2,30,1,1
62911,993,63006,993,allow,8753,4199,4554,76,54,41,35
56752,53,39858,53,allow,701,88,613,2,30,1,1
58638,5900,0,0,deny,62,62,0,1,0,1,0
53111,445,0,0,drop,66,66,0,1,0,1,0
51050,445,0,0,drop,66,66,0,1,0,1,0
57095,53,22428,53,allow,211,110,101,2,30,1,1
57554,445,0,0,drop,66,66,0,1,0,1,0
62828,445,0,0,drop,70,70,0,1,0,1,0
61442,443,19223,443,allow,3403,1891,1512,24,42,13,11
56429,80,57755,80,allow,17188,1559,15629,25,25,10,15
50889,80,11268,80,allow,397616,15684,381932,419,141,157,262
56457,443,49133,443,allow,3654,1144,2510,10,120,5,5
56903,445,0,0,drop,70,70,0,1,0,1,0
63172,445,0,0,drop,70,70,0,1,0,1,0
49511,80,32515,80,allow,1693924,34466,1659458,1627,230,522,1105
42285,57470,0,0,deny,62,62,0,1,0,1,0
9231,3389,0,0,deny,66,66,0,1,0,1,0
58716,445,0,0,drop,70,70,0,1,0,1,0
63153,445,0,0,drop,70,70,0,1,0,1,0
56810,53,59842,53,allow,751,95,656,2,30,1,1
57597,443,32556,443,allow,12528,7238,5290,26,91,15,11
37007,22114,0,0,deny,146,146,0,1,0,1,0
53105,42707,0,0,deny,66,66,0,1,0,1,0
56769,445,0,0,drop,66,66,0,1,0,1,0
2267,53,17239,53,allow,204,118,86,2,31,1,1
52191,443,46265,443,allow,7882,810,7072,21,15,9,12
42041,443,41646,443,allow,2351,1546,805,20,54,11,9
49762,53,15647,53,allow,195,94,101,2,30,1,1
51966,443,65076,443,allow,9249,4498,4751,39,15,22,17
64986,445,0,0,drop,70,70,0,1,0,1,0
53132,445,0,0,drop,66,66,0,1,0,1,0
55399,53,9206,53,allow,180,94,86,2,31,1,1
443,62451,0,0,deny,199,199,0,1,0,1,0
56718,50584,0,0,deny,66,66,0,1,0,1,0
37371,5228,12391,5228,allow,3277,1954,1323,27,3600,14,13
42305,443,8617,443,allow,1262512,53286,1209226,1457,280,548,909
58638,5900,0,0,deny,62,62,0,1,0,1,0
51064,5529,0,0,deny,146,146,0,1,0,1,0
64300,445,0,0,drop,70,70,0,1,0,1,0
56956,443,35896,443,allow,4359,924,3435,15,59,9,6
2267,53,36345,53,allow,468,320,148,5,49,3,2
65116,53,63151,53,allow,214,110,104,2,30,1,1
58638,5900,0,0,deny,62,62,0,1,0,1,0
63447,44847,0,0,deny,66,66,0,1,0,1,0
52695,445,0,0,drop,70,70,0,1,0,1,0
55294,3389,55294,3389,allow,4470,2381,2089,23,19,13,10
51414,443,43551,443,allow,78740,40216,38524,126,42,66,60
1811,35440,0,0,deny,62,62,0,1,0,1,0
56604,445,0,0,drop,70,70,0,1,0,1,0
52016,80,20046,80,allow,8551,5933,2618,18,26,12,6
65098,53,21613,53,allow,740,93,647,2,31,1,1
12457,57866,0,0,deny,66,66,0,1,0,1,0
58376,445,0,0,drop,66,66,0,1,0,1,0
65063,53,22032,53,allow,180,94,86,2,30,1,1
62714,445,0,0,drop,70,70,0,1,0,1,0
52931,443,32527,443,allow,23112,6278,16834,140,115,55,85
50195,53,43781,53,allow,199,102,97,2,30,1,1
64687,53,30992,53,allow,495,109,386,4,53,2,2
63856,6881,31846,6881,allow,66,66,0,1,5,1,0
61016,445,0,0,drop,70,70,0,1,0,1,0
56810,33957,19531,33957,allow,70,70,0,1,5,1,0
55796,53,15761,53,allow,196,102,94,2,31,1,1
52065,80,16889,80,allow,81670,2359,79311,89,621,30,59
4910,2149,0,0,deny,62,62,0,1,0,1,0
58689,123,57350,123,allow,184,94,90,2,30,1,1
51449,443,58167,443,allow,21779,7983,13796,44,97,25,19
57205,445,0,0,drop,66,66,0,1,0,1,0
63084,64147,0,0,deny,62,62,0,1,0,1,0
3564,57470,0,0,deny,62,62,0,1,0,1,0
57470,8999,29205,8999,allow,863,363,500,4,1200,2,2
49942,53,17734,53,allow,741,94,647,2,30,1,1
56152,56205,0,0,deny,62,62,0,1,0,1,0
53866,8999,60577,8999,allow,372,186,186,6,15,3,3
51078,443,51078,443,allow,71902,4007,67895,98,127,40,58
61868,445,0,0,drop,70,70,0,1,0,1,0
53163,32834,24170,32834,allow,70,70,0,2,8,2,0
61305,443,56273,443,allow,5399,2711,2688,13,120,7,6
52563,17235,0,0,deny,74,74,0,1,0,1,0
53814,6725,20985,6725,allow,70,70,0,1,4,1,0
61811,445,0,0,drop,70,70,0,1,0,1,0
9523,443,27776,443,allow,7199,1410,5789,22,33,11,11
52161,19897,63116,19897,allow,70,70,0,2,8,2,0
55050,443,4346,443,allow,7372,2875,4497,23,61,13,10
55046,53,59080,53,allow,300,102,198,4,40,2,2
55988,445,0,0,drop,66,66,0,1,0,1,0
24285,26467,0,0,deny,62,62,0,1,0,1,0
31627,64147,0,0,deny,62,62,0,1,0,1,0
10009,40008,62477,40008,allow,156,94,62,2,30,1,1
13795,2323,0,0,deny,60,60,0,1,0,1,0
57535,445,0,0,drop,70,70,0,1,0,1,0
53075,445,0,0,drop,70,70,0,1,0,1,0
50303,445,0,0,drop,66,66,0,1,0,1,0
42951,44847,0,0,deny,66,66,0,1,0,1,0
55599,53,58938,53,allow,258,118,140,2,30,1,1
59200,53,0,0,allow,82,82,0,1,30,1,0
64600,80,64600,80,allow,98859,6426,92433,136,27,68,68
65426,443,27740,443,allow,14205,1527,12678,13,145,2,11
33948,15503,0,0,deny,146,146,0,1,0,1,0
40967,1433,0,0,deny,60,60,0,1,0,1,0
39596,53,5876,53,allow,168,78,90,2,30,1,1
64817,53,59265,53,allow,199,94,105,2,29,1,1
64686,445,0,0,drop,70,70,0,1,0,1,0
51796,80,13753,80,allow,2188,1282,906,13,47,8,5
51564,50584,0,0,deny,62,62,0,1,0,1,0
62721,56205,0,0,deny,66,66,0,1,0,1,0
51734,445,0,0,drop,70,70,0,1,0,1,0
64991,53,4692,53,allow,779,86,693,2,30,1,1
55547,445,0,0,drop,70,70,0,1,0,1,0
48114,443,5239,443,allow,4515,2193,2322,14,135,7,7
2278,25174,0,0,deny,62,62,0,1,0,1,0
60718,443,23092,443,allow,71105,20647,50458,107,38,53,54
55679,445,0,0,drop,66,66,0,1,0,1,0
51676,23718,0,0,deny,66,66,0,1,0,1,0
43731,443,32992,443,allow,10930,1759,9171,27,28,13,14
37483,443,13150,443,allow,70,70,0,2,5,2,0
52549,445,0,0,drop,70,70,0,1,0,1,0
51655,445,0,0,drop,66,66,0,1,0,1,0
64306,53,34963,53,allow,216,110,106,2,31,1,1
60163,445,0,0,drop,70,70,0,1,0,1,0
58031,443,14165,443,allow,1314,653,661,13,185,7,6
55461,53,48907,53,allow,198,110,88,2,31,1,1
1024,25174,0,0,deny,146,146,0,1,0,1,0
64647,53,58835,53,allow,575,193,382,6,80,3,3
20608,28189,0,0,deny,60,60,0,1,0,1,0
49507,443,13013,443,allow,4151,1015,3136,16,27,8,8
65147,53,20335,53,allow,194,102,92,2,29,1,1
51655,80,54219,80,allow,318,192,126,6,37,4,2
57982,25174,0,0,deny,62,62,0,1,0,1,0
53856,445,0,0,drop,70,70,0,1,0,1,0
51411,443,11555,443,allow,202,70,132,3,11,1,2
34981,80,29727,80,allow,1658,1344,314,10,15,5,5
21733,56205,0,0,deny,66,66,0,1,0,1,0
18173,25174,0,0,deny,62,62,0,1,0,1,0
54162,443,34813,443,allow,2680,1488,1192,19,41,10,9
4083,443,26942,443,allow,2227,1018,1209,17,16,8,9
49652,53,26066,53,allow,229,110,119,2,30,1,1
49767,80,10412,80,allow,70,70,0,1,4,1,0
65489,443,61860,443,allow,92240,4799,87441,107,16,43,64
52479,443,9730,443,allow,11052,4417,6635,19,137,10,9
38644,443,44476,443,allow,8165,1664,6501,30,62,14,16
55560,443,48574,443,allow,7047,1994,5053,20,24,12,8
59977,30188,0,0,deny,66,66,0,1,0,1,0
60878,443,39667,443,allow,31315,6036,25279,65,49,32,33
60743,443,59766,443,allow,7028,2639,4389,23,16,12,11
55730,8060,62180,8060,allow,70,70,0,2,7,2,0
38664,443,19990,443,allow,8195,1780,6415,23,60,12,11
64657,53,3237,53,allow,193,102,91,2,30,1,1
59586,56205,0,0,deny,62,62,0,1,0,1,0
62983,445,0,0,drop,70,70,0,1,0,1,0
55991,53,30604,53,allow,183,94,89,2,30,1,1
57940,24748,0,0,deny,148,148,0,1,0,1,0
60794,445,0,0,drop,66,66,0,1,0,1,0
48362,443,23544,443,allow,8075,1766,6309,22,78,13,9
17262,25174,0,0,deny,62,62,0,1,0,1,0
63708,25174,0,0,deny,66,66,0,1,0,1,0
49169,445,0,0,drop,70,70,0,1,0,1,0
50643,80,56301,80,allow,5660,3544,2116,17,47,10,7
37658,16386,64660,16386,allow,130,70,60,2,29,1,1
51147,443,55855,443,allow,6162,925,5237,18,52,10,8
55856,53,56508,53,allow,265,94,171,2,30,1,1
64374,53,21299,53,allow,194,94,100,2,30,1,1
49317,443,8477,443,allow,1486172,26246,1459926,1245,40,266,979
57621,445,0,0,drop,70,70,0,1,0,1,0
47636,443,43225,443,allow,5921,1018,4903,21,150,11,10
53034,53,25305,53,allow,238,94,144,2,30,1,1
62767,57470,0,0,deny,74,74,0,1,0,1,0
35265,80,15083,80,allow,3524,2698,826,14,16,8,6
59871,445,0,0,drop,66,66,0,1,0,1,0
41937,53,0,0,allow,82,82,0,1,31,1,0
9455,443,43647,443,allow,6096,777,5319,17,25,9,8
62722,443,49389,443,allow,3491257,62261,3428996,3146,155,768,2378
64341,57470,0,0,deny,62,62,0,1,0,1,0
49749,53,60642,53,allow,200,102,98,2,30,1,1
38611,443,14308,443,allow,22215289,662818,21552471,25924,349,8862,17062
56638,80,7412,80,allow,234,234,0,4,11,4,0
26889,50265,0,0,deny,66,66,0,1,0,1,0
55531,53,46307,53,allow,216,110,106,2,30,1,1
58953,443,9937,443,allow,4051,2587,1464,18,16,9,9
55033,443,56054,443,allow,13944,2069,11875,28,30,15,13
49862,53,59363,53,allow,817,102,715,2,30,1,1
39447,443,60525,443,allow,7878,1909,5969,31,28,16,15
63058,443,54083,443,allow,304,86,218,2,30,1,1
56627,53,7670,53,allow,193,102,91,2,31,1,1
52022,52752,0,0,deny,74,74,0,1,0,1,0
57001,53,10240,53,allow,170,87,83,2,31,1,1
64204,53,35802,53,allow,193,102,91,2,30,1,1
65460,53,48122,53,allow,177,94,83,2,30,1,1
63578,5228,10061,5228,allow,8544,2633,5911,51,154,28,23
59897,443,7806,443,allow,1743,934,809,15,32,7,8
30399,44847,0,0,deny,146,146,0,1,0,1,0
62591,7000,62591,7000,allow,3530,2027,1503,16,15,9,7
58711,53,20725,53,allow,277,78,199,2,30,1,1
55286,37965,0,0,deny,66,66,0,1,0,1,0
41908,1433,0,0,deny,60,60,0,1,0,1,0
49418,27015,17910,27015,allow,232,71,161,2,31,1,1
55167,48817,0,0,deny,66,66,0,1,0,1,0
47052,80,21524,80,allow,1217,486,731,8,43,5,3
57324,443,38455,443,allow,5612,733,4879,16,14,9,7
52181,1038,36423,1038,allow,66,66,0,1,5,1,0
41440,5228,57433,5228,allow,8866,2015,6851,29,4793,14,15
60960,443,48167,443,allow,7488,1552,5936,23,46,13,10
54048,25174,0,0,deny,66,66,0,1,0,1,0
27005,33084,40774,33084,allow,906,126,780,2,31,1,1
56846,445,0,0,drop,66,66,0,1,0,1,0
62662,445,0,0,drop,70,70,0,1,0,1,0
35339,443,19701,443,allow,6677,1006,5671,19,27,11,8
53360,445,0,0,drop,70,70,0,1,0,1,0
50208,1688,32119,1688,allow,70,70,0,2,8,2,0
60507,53830,57450,53830,allow,320,140,180,6,6,3,3
37450,443,11367,443,allow,617919,23432,594487,706,39,297,409
29884,25174,0,0,deny,62,62,0,1,0,1,0
65167,443,56897,443,allow,4925,2188,2737,36,360,16,20
27110,22114,0,0,deny,60,60,0,1,0,1,0
33453,64147,0,0,deny,62,62,0,1,0,1,0
51213,445,0,0,drop,70,70,0,1,0,1,0
7273,64147,0,0,deny,66,66,0,1,0,1,0
51986,445,0,0,drop,66,66,0,1,0,1,0
62099,445,0,0,drop,70,70,0,1,0,1,0
11842,35440,0,0,deny,62,62,0,1,0,1,0
39937,443,39937,443,allow,4756,1849,2907,19,27,11,8
52673,80,57831,80,allow,23776,1372,22404,35,112,15,20
46434,443,35412,443,allow,14879,4981,9898,43,121,21,22
55466,53,2778,53,allow,170,87,83,2,30,1,1
50853,50584,0,0,deny,66,66,0,1,0,1,0
56847,53,17178,53,allow,761,100,661,2,31,1,1
55579,53,24866,53,allow,178,94,84,2,29,1,1
35894,17,0,0,deny,60,60,0,1,0,1,0
55035,445,0,0,drop,70,70,0,1,0,1,0
55048,443,61386,443,allow,1600,1089,511,13,151,7,6
54966,53,59029,53,allow,255,88,167,4,32,2,2
56070,445,0,0,drop,70,70,0,1,0,1,0
51056,445,0,0,drop,66,66,0,1,0,1,0
56522,80,49102,80,allow,798,401,397,7,17,5,2
51758,31009,36831,31009,allow,70,70,0,2,8,2,0
52099,445,0,0,drop,66,66,0,1,0,1,0
49257,53,51275,53,allow,166,86,80,2,29,1,1
63563,24096,60999,24096,allow,198,198,0,1,5,1,0
17280,22114,0,0,deny,146,146,0,1,0,1,0
62243,445,0,0,drop,70,70,0,1,0,1,0
50577,80,14735,80,allow,469212,19981,449231,601,134,276,325
64997,445,0,0,drop,70,70,0,1,0,1,0
54280,3398,0,0,deny,60,60,0,1,0,1,0
50297,80,4817,80,allow,145266,14613,130653,165,161,63,102
63008,53,31909,53,allow,183,86,97,2,30,1,1
61399,80,3299,80,allow,5518,527,4991,13,75,6,7
57402,2258,57402,2258,allow,156,156,0,3,8,3,0
65413,445,0,0,drop,70,70,0,1,0,1,0
56672,53,51134,53,allow,177,94,83,2,30,1,1
58349,445,0,0,drop,70,70,0,1,0,1,0
63048,445,0,0,drop,66,66,0,1,0,1,0
32704,46824,0,0,deny,66,66,0,1,0,1,0
26239,25174,0,0,deny,66,66,0,1,0,1,0
63376,445,0,0,drop,70,70,0,1,0,1,0
59487,443,5005,443,allow,8702,580,8122,17,53,5,12
58993,443,55872,443,allow,416,210,206,7,26,4,3
35756,80,35756,80,allow,364170,17670,346500,412,31,170,242
65328,53,18942,53,allow,166,86,80,2,30,1,1
59948,443,41928,443,allow,349197,16542,332655,411,129,150,261
64530,53,46090,53,allow,211,102,109,2,30,1,1
56877,445,0,0,drop,70,70,0,1,0,1,0
37629,443,33990,443,allow,172,172,0,2,5,2,0
45964,2225,0,0,deny,60,60,0,1,0,1,0
61020,445,0,0,drop,70,70,0,1,0,1,0
43457,31573,0,0,deny,146,146,0,1,0,1,0
9055,443,33529,443,allow,6594797,175738,6419059,6398,123,1755,4643
50,64147,0,0,deny,66,66,0,1,0,1,0
52126,443,32440,443,allow,12096,3734,8362,53,102,25,28
47111,80,20951,80,allow,162355,7124,155231,207,27,96,111
49689,443,55526,443,allow,1179,655,524,13,56,7,6
56354,445,0,0,drop,70,70,0,1,0,1,0
46508,80,61419,80,allow,1056,682,374,10,15,6,4
52321,443,49472,443,allow,10320,5152,5168,45,15,25,20
58638,5900,0,0,deny,62,62,0,1,0,1,0
35080,80,13868,80,allow,71843,2833,69010,83,16,36,47
27005,27018,3011,27018,allow,882,126,756,2,30,1,1
40086,22114,0,0,deny,146,146,0,1,0,1,0
61030,443,16792,443,allow,109010,37307,71703,152,895,62,90
59810,443,31870,443,allow,27370,17071,10299,51,30,26,25
40252,443,46211,443,allow,543828,50144,493684,682,172,254,428
34359,80,6984,80,allow,350,210,140,6,14,4,2
42604,443,37985,443,allow,3243,2026,1217,16,15,8,8
55929,445,0,0,drop,70,70,0,1,0,1,0
49460,445,0,0,drop,66,66,0,1,0,1,0
62103,443,43175,443,allow,6345,3495,2850,18,120,9,9
60536,445,0,0,drop,70,70,0,1,0,1,0
60471,19776,4815,19776,allow,70,70,0,1,5,1,0
56758,40000,32207,40000,allow,70,70,0,2,8,2,0
50008,53,33522,53,allow,193,102,91,2,29,1,1
57204,443,59109,443,allow,35981,14676,21305,63,320,31,32
49634,445,0,0,drop,66,66,0,1,0,1,0
61440,445,0,0,drop,70,70,0,1,0,1,0
50542,443,2915,443,allow,6787,1846,4941,24,361,11,13
37965,46008,3180,46008,allow,132,132,0,3,1200,3,0
55675,53,21127,53,allow,198,102,96,2,30,1,1
56256,62413,0,0,deny,66,66,0,1,0,1,0
64561,53,50313,53,allow,209,110,99,2,30,1,1
51908,80,63314,80,allow,4542,2962,1580,13,28,8,5
31619,51221,0,0,deny,62,62,0,1,0,1,0
55660,443,55660,443,allow,51312,5706,45606,77,48,38,39
63899,445,0,0,drop,70,70,0,1,0,1,0
56430,53,61403,53,allow,193,102,91,2,30,1,1
49980,53,10608,53,allow,503,103,400,4,47,2,2
53683,30218,33662,30218,allow,492,306,186,8,15,5,3
64790,443,44733,443,allow,15810,7525,8285,35,97,18,17
39978,443,47110,443,allow,8030,7064,966,22,30,13,9
50124,443,33361,443,allow,24329,7675,16654,47,16,25,22
56809,443,9000,443,allow,7929,1909,6020,20,15,11,9
58123,80,21790,80,allow,3641,1784,1857,19,375,10,9
64788,43890,0,0,deny,62,62,0,1,0,1,0
60358,443,56425,443,allow,17547,2695,14852,30,76,14,16
43329,50584,0,0,deny,146,146,0,1,0,1,0
58672,443,27008,443,allow,4649,2114,2535,11,120,6,5
40603,53,40603,53,allow,240,96,144,2,31,1,1
50360,37965,0,0,deny,62,62,0,1,0,1,0
58638,5900,0,0,deny,62,62,0,1,0,1,0
40146,443,31443,443,allow,280,140,140,5,130,3,2
55161,445,0,0,drop,66,66,0,1,0,1,0
33563,14037,0,0,deny,78,78,0,1,0,1,0
60602,15503,0,0,deny,62,62,0,1,0,1,0
55271,53,16538,53,allow,268,102,166,2,30,1,1
55749,37965,0,0,deny,66,66,0,1,0,1,0
57912,443,57912,443,allow,4559,1652,2907,19,27,11,8
55289,445,0,0,drop,70,70,0,1,0,1,0
40689,443,13371,443,allow,4203,1564,2639,26,470,14,12
64132,445,0,0,drop,66,66,0,1,0,1,0
57203,53,26707,53,allow,199,102,97,2,30,1,1
57355,443,34540,443,allow,16483,8545,7938,40,281,21,19
123,123,26903,123,allow,826,376,450,10,34,5,5
0,0,0,0,allow,320,320,0,5,0,5,0
50387,80,54775,80,allow,8105,3187,4918,18,24,9,9
49364,80,47748,80,allow,2168,1031,1137,8,166,5,3
61141,443,38623,443,allow,383052,17263,365789,396,132,119,277
52640,64147,0,0,deny,62,62,0,1,0,1,0
64960,27021,59267,27021,allow,742,462,280,2,31,1,1
16387,49252,0,0,deny,60,60,0,1,0,1,0
52176,445,0,0,drop,70,70,0,1,0,1,0
9277,443,3010,443,allow,4230,760,3470,14,27,8,6
58639,443,58639,443,allow,4380,1473,2907,19,30,11,8
33973,50265,0,0,deny,62,62,0,1,0,1,0
65111,443,62828,443,allow,3255,1259,1996,13,135,7,6
51927,445,0,0,drop,70,70,0,1,0,1,0
12031,36237,0,0,deny,66,66,0,1,0,1,0
64628,53,28992,53,allow,199,102,97,2,30,1,1
49749,53,61513,53,allow,200,102,98,2,30,1,1
54898,445,0,0,drop,70,70,0,1,0,1,0
64606,53,40619,53,allow,278,118,160,2,30,1,1
60155,23718,0,0,deny,66,66,0,1,0,1,0
65285,445,0,0,drop,70,70,0,1,0,1,0
35657,48637,0,0,deny,145,145,0,1,0,1,0
57444,53,32931,53,allow,177,94,83,2,30,1,1
40204,40017,36316,40017,allow,156,94,62,2,30,1,1
64106,53,59908,53,allow,190,97,93,2,31,1,1
52716,445,0,0,drop,70,70,0,1,0,1,0
5588,5588,0,0,allow,3562,1936,1626,48,195,24,24
10436,37965,0,0,deny,62,62,0,1,0,1,0
8080,37965,0,0,deny,62,62,0,1,0,1,0
42587,443,6188,443,allow,7733,1203,6530,21,15,12,9
14000,14914,0,0,deny,157,157,0,1,0,1,0
56192,53,60489,53,allow,177,94,83,2,31,1,1
51974,80,51357,80,allow,426,240,186,8,25,5,3
54133,445,0,0,drop,70,70,0,1,0,1,0
53194,443,6156,443,allow,1478,918,560,12,44,6,6
49259,53,59958,53,allow,184,102,82,2,30,1,1
38322,443,57596,443,allow,10632,3838,6794,37,256,18,19
49634,80,5183,80,allow,318,192,126,6,42,4,2
49382,53,23586,53,allow,200,102,98,2,30,1,1
53165,443,53165,443,allow,208,66,142,4,148,2,2
57227,445,0,0,drop,70,70,0,1,0,1,0
50313,53,2331,53,allow,744,95,649,2,30,1,1
55264,53,48968,53,allow,177,94,83,2,30,1,1
58591,445,0,0,drop,70,70,0,1,0,1,0
57470,6881,62748,6881,allow,525,166,359,2,1200,1,1
41490,25174,0,0,deny,146,146,0,1,0,1,0
52830,445,0,0,drop,70,70,0,1,0,1,0
63988,53,51956,53,allow,195,102,93,2,30,1,1
64878,26467,0,0,deny,145,145,0,1,0,1,0
20608,28189,0,0,deny,60,60,0,1,0,1,0
59731,445,0,0,drop,66,66,0,1,0,1,0
56562,44847,0,0,deny,66,66,0,1,0,1,0
51956,443,35785,443,allow,5065,1658,3407,21,16,13,8
65366,53,12473,53,allow,199,102,97,2,30,1,1
56511,53,55404,53,allow,200,102,98,2,30,1,1
42023,443,45040,443,allow,42402,3988,38414,82,89,39,43
60010,443,42426,443,allow,4795,2875,1920,19,143,10,9
53250,443,16467,443,allow,70319,5815,64504,146,67,52,94
60995,443,4422,443,allow,1351,846,505,12,19,7,5
1323,64147,0,0,deny,66,66,0,1,0,1,0
49418,27015,25593,27015,allow,258,78,180,2,30,1,1
55545,445,0,0,drop,70,70,0,1,0,1,0
25469,57470,0,0,deny,62,62,0,1,0,1,0
64161,53,62669,53,allow,261,102,159,2,30,1,1
64531,53,41084,53,allow,183,94,89,2,30,1,1
56261,445,0,0,drop,70,70,0,1,0,1,0
35922,443,6231,443,allow,6997,1773,5224,27,17,15,12
26752,64147,0,0,deny,62,62,0,1,0,1,0
46948,443,43691,443,allow,6374,2446,3928,26,217,13,13
51854,80,4415,80,allow,5438,1822,3616,17,38,11,6
18713,40108,0,0,deny,146,146,0,1,0,1,0
38873,443,28510,443,allow,10209,2574,7635,39,917,18,21
55919,53,44823,53,allow,177,94,83,2,30,1,1
63827,445,0,0,drop,70,70,0,1,0,1,0
57987,56125,0,0,deny,90,90,0,1,0,1,0
53453,2767,0,0,deny,62,62,0,1,0,1,0
53713,443,33766,443,allow,9555,4200,5355,25,86,15,10
57071,53,6792,53,allow,166,86,80,2,30,1,1
56765,443,7248,443,allow,7940,1951,5989,20,15,11,9
55377,53,9978,53,allow,228,110,118,2,30,1,1
65260,53,8952,53,allow,199,102,97,2,30,1,1
1024,64147,0,0,deny,62,62,0,1,0,1,0
49984,53,7504,53,allow,178,94,84,2,30,1,1
56112,80,39554,80,allow,8113,1082,7031,19,16,10,9
60929,28678,34471,28678,allow,1806,1806,0,22,224,22,0
0,0,0,0,allow,320,320,0,5,0,5,0
38306,51221,0,0,deny,62,62,0,1,0,1,0
443,64347,0,0,deny,131,131,0,1,0,1,0
64606,53,12951,53,allow,290,102,188,2,30,1,1
60416,37965,0,0,deny,66,66,0,1,0,1,0
65420,53,11720,53,allow,166,86,80,2,30,1,1
57470,58695,5572,58695,allow,726,726,0,12,1200,12,0
52714,443,48732,443,allow,26399,2076,24323,37,319,15,22
50124,445,0,0,drop,70,70,0,1,0,1,0
61273,25174,0,0,deny,146,146,0,1,0,1,0
57613,42707,0,0,deny,66,66,0,1,0,1,0
65070,80,65070,80,allow,145038,9857,135181,162,23,62,100
57235,445,0,0,drop,66,66,0,1,0,1,0
55641,445,0,0,drop,70,70,0,1,0,1,0
29049,23,0,0,deny,60,60,0,1,0,1,0
3341,23117,0,0,deny,62,62,0,1,0,1,0
60452,443,43264,443,allow,5807,2168,3639,17,135,8,9
49334,53,5617,53,allow,300,99,201,4,38,2,2
4581,23,0,0,deny,60,60,0,1,0,1,0
56753,44847,0,0,deny,146,146,0,1,0,1,0
59959,445,0,0,drop,70,70,0,1,0,1,0
9280,443,36215,443,allow,4612,830,3782,16,27,9,7
59518,80,10090,80,allow,14862,1091,13771,26,135,14,12
53512,443,1529,443,allow,1625,1038,587,14,34,8,6
16693,36237,0,0,deny,62,62,0,1,0,1,0
57646,443,57646,443,allow,4492,1585,2907,19,30,11,8
51097,445,0,0,drop,70,70,0,1,0,1,0
53951,8999,2950,8999,allow,70,70,0,2,7,2,0
53381,25174,0,0,deny,62,62,0,1,0,1,0
48409,443,36994,443,allow,5993,1261,4732,18,982,8,10
54998,53,33990,53,allow,179,94,85,2,30,1,1
41236,443,52117,443,allow,1807,1048,759,16,25,8,8
54034,443,22227,443,allow,43491,8521,34970,69,50,34,35
65028,445,0,0,drop,70,70,0,1,0,1,0
64744,3389,64744,3389,allow,3428,1714,1714,16,33,8,8
52765,445,0,0,drop,70,70,0,1,0,1,0
59068,49813,0,0,deny,70,70,0,1,0,1,0
9731,64147,0,0,deny,62,62,0,1,0,1,0
60004,445,0,0,drop,70,70,0,1,0,1,0
56957,443,26018,443,allow,4359,924,3435,15,59,9,6
50231,445,0,0,drop,70,70,0,1,0,1,0
55048,80,23955,80,allow,3084,1646,1438,19,131,10,9
55306,53,23236,53,allow,170,87,83,2,0,1,1
34150,443,7922,443,allow,12564,9272,3292,66,107,31,35
55341,39004,0,0,deny,74,74,0,1,0,1,0
57654,35440,0,0,deny,66,66,0,1,0,1,0
2777,23,2777,23,allow,130,66,64,2,4,1,1
56131,53,29991,53,allow,245,94,151,2,30,1,1
42925,443,37247,443,allow,5617,1559,4058,22,138,13,9
49676,53,4887,53,allow,216,110,106,2,30,1,1
53492,445,0,0,drop,70,70,0,1,0,1,0
52630,1433,0,0,deny,60,60,0,1,0,1,0
58773,445,0,0,drop,70,70,0,1,0,1,0
51235,80,15389,80,allow,3588,2362,1226,24,87,13,11
58717,443,32923,443,allow,280,140,140,5,130,3,2
59723,80,4011,80,allow,613,539,74,7,15,6,1
51910,37965,0,0,deny,62,62,0,1,0,1,0
40207,80,3053,80,allow,1364,860,504,13,32,8,5
45941,23388,0,0,deny,60,60,0,1,0,1,0
25619,25174,0,0,deny,146,146,0,1,0,1,0
63578,35440,0,0,deny,66,66,0,1,0,1,0
10669,49756,0,0,deny,60,60,0,1,0,1,0
52838,53,22296,53,allow,168,78,90,2,30,1,1
52727,445,0,0,drop,66,66,0,1,0,1,0
53100,443,46629,443,allow,8571,1789,6782,20,326,10,10
50360,35440,0,0,deny,66,66,0,1,0,1,0
61637,25174,0,0,deny,66,66,0,1,0,1,0
52282,37965,0,0,deny,66,66,0,1,0,1,0
56281,53,50630,53,allow,170,87,83,2,31,1,1
55759,445,0,0,drop,70,70,0,1,0,1,0
56534,53,14913,53,allow,177,94,83,2,29,1,1
64016,25174,0,0,deny,62,62,0,1,0,1,0
49960,53,57227,53,allow,198,94,104,2,29,1,1
65241,53,18449,53,allow,200,102,98,2,31,1,1
50595,443,32592,443,allow,8981,4625,4356,22,135,11,11
50010,80,40489,80,allow,5058,4299,759,11,27,6,5
65218,53,5567,53,allow,194,102,92,2,31,1,1
17411,43890,0,0,deny,146,146,0,1,0,1,0
48970,80,48970,80,allow,24303,4898,19405,40,28,21,19
48286,443,64439,443,allow,9590,3002,6588,25,96,14,11
53821,53,5224,53,allow,199,94,105,2,30,1,1
59035,445,0,0,drop,70,70,0,1,0,1,0
65134,53,52533,53,allow,812,110,702,2,29,1,1
49418,27015,10652,27015,allow,224,78,146,2,30,1,1
30602,36237,0,0,deny,146,146,0,1,0,1,0
46593,28678,34181,28678,allow,1806,1806,0,22,224,22,0
52143,80,6472,80,allow,366,240,126,7,32,5,2
49489,443,60116,443,allow,1627,884,743,12,27,6,6
64406,50584,0,0,deny,66,66,0,1,0,1,0
49972,53,23300,53,allow,184,94,90,2,30,1,1
55265,53,47317,53,allow,198,101,97,2,31,1,1
64089,53,43918,53,allow,340,96,244,4,35,2,2
63801,445,0,0,drop,70,70,0,1,0,1,0
57596,80,57596,80,allow,64768,3074,61694,72,145,26,46
8999,59353,0,0,deny,146,146,0,1,0,1,0
58507,445,0,0,drop,70,70,0,1,0,1,0
25384,443,25384,443,allow,3072,696,2376,13,16,8,5
59889,443,31832,443,allow,1576,973,603,14,28,7,7
56117,53,10364,53,allow,757,98,659,2,30,1,1
50964,445,0,0,drop,70,70,0,1,0,1,0
49875,53,51820,53,allow,399,86,313,4,49,2,2
49662,80,35388,80,allow,6753,3135,3618,17,41,8,9
62056,443,37684,443,allow,13784,6865,6919,38,47,21,17
51430,25174,0,0,deny,62,62,0,1,0,1,0
42457,5222,64493,5222,allow,35380,2898,32482,63,227,22,41
57208,53,63369,53,allow,182,93,89,2,31,1,1
43092,443,2375,443,allow,7011,2541,4470,19,15,11,8
63516,445,0,0,drop,70,70,0,1,0,1,0
58871,443,24134,443,allow,5106,700,4406,15,15,7,8
36404,80,8914,80,allow,534,460,74,6,15,5,1
47673,443,27427,443,allow,10372,4341,6031,28,319,15,13
41474,443,44338,443,allow,190,70,120,4,15,2,2
63067,445,0,0,drop,66,66,0,1,0,1,0
51614,443,28714,443,allow,3833,867,2966,14,16,9,5
49402,53,17640,53,allow,177,94,83,2,30,1,1
62885,62413,0,0,deny,66,66,0,1,0,1,0
65057,53,53489,53,allow,199,102,97,2,30,1,1
56266,53,14847,53,allow,186,95,91,2,31,1,1
11688,23718,0,0,deny,62,62,0,1,0,1,0
23174,80,23174,80,allow,490,264,226,8,31,5,3
50306,443,42473,443,allow,2474,735,1739,11,120,6,5
63972,53,35839,53,allow,193,102,91,2,30,1,1
49501,53,50847,53,allow,193,102,91,2,31,1,1
62566,35993,0,0,deny,66,66,0,1,0,1,0
52133,15015,35766,15015,allow,66,66,0,1,5,1,0
55941,53,34210,53,allow,184,94,90,2,30,1,1
56596,53,51860,53,allow,199,102,97,2,30,1,1
56589,53,12890,53,allow,199,102,97,2,31,1,1
49360,445,0,0,drop,70,70,0,1,0,1,0
38852,37965,0,0,deny,62,62,0,1,0,1,0
61832,80,61832,80,allow,2221,1482,739,11,149,6,5
57148,443,64280,443,allow,12000,9252,2748,34,273,17,17
57264,53,5808,53,allow,197,102,95,2,29,1,1
56629,53,33066,53,allow,177,94,83,2,30,1,1
58501,44847,0,0,deny,66,66,0,1,0,1,0
53149,47383,18287,47383,allow,694,320,374,10,18,6,4
52643,15941,0,0,deny,66,66,0,1,0,1,0
61135,50265,0,0,deny,62,62,0,1,0,1,0
4328,7302,0,0,deny,66,66,0,1,0,1,0
61586,445,0,0,drop,70,70,0,1,0,1,0
50606,445,0,0,drop,70,70,0,1,0,1,0
53915,443,38797,443,allow,7917,2410,5507,32,26,18,14
30417,51505,0,0,deny,146,146,0,1,0,1,0
50270,445,0,0,drop,70,70,0,1,0,1,0
64105,6363,30786,6363,allow,66,66,0,2,8,2,0
49792,53,55353,53,allow,755,202,553,6,61,3,3
52490,443,51639,443,allow,23518,8884,14634,32,15,15,17
35268,81,0,0,deny,60,60,0,1,0,1,0
50408,445,0,0,drop,70,70,0,1,0,1,0
60308,37965,0,0,deny,66,66,0,1,0,1,0
57437,53,35666,53,allow,193,102,91,2,30,1,1
50970,445,0,0,drop,70,70,0,1,0,1,0
58638,5900,0,0,deny,62,62,0,1,0,1,0
52929,1433,0,0,deny,60,60,0,1,0,1,0
27005,27017,50516,27017,allow,873,126,747,2,30,1,1
15274,19473,0,0,deny,62,62,0,1,0,1,0
55951,30188,0,0,deny,66,66,0,1,0,1,0
50598,443,44338,443,allow,1653,1010,643,16,94,9,7
51666,445,0,0,drop,70,70,0,1,0,1,0
50064,445,0,0,drop,70,70,0,1,0,1,0
62857,445,0,0,drop,70,70,0,1,0,1,0
45908,33330,45908,33330,allow,124,60,64,3,5,2,1
56771,43648,30018,43648,allow,70,70,0,2,8,2,0
24504,37965,0,0,deny,62,62,0,1,0,1,0
64102,445,0,0,drop,66,66,0,1,0,1,0
55985,445,0,0,drop,66,66,0,1,0,1,0
45941,23386,0,0,deny,60,60,0,1,0,1,0
49842,7302,0,0,deny,66,66,0,1,0,1,0
55717,13517,54958,13517,allow,70,70,0,1,5,1,0
32491,15503,0,0,deny,66,66,0,1,0,1,0
60875,50584,0,0,deny,62,62,0,1,0,1,0
53198,443,53198,443,allow,4591,1684,2907,19,28,11,8
58638,5900,0,0,deny,62,62,0,1,0,1,0
56223,53,26337,53,allow,177,94,83,2,30,1,1
55180,445,0,0,drop,70,70,0,1,0,1,0
3478,61463,0,0,deny,665,665,0,1,0,1,0
53794,39607,29958,39607,allow,70,70,0,2,8,2,0
56312,53,52964,53,allow,195,102,93,2,31,1,1
49847,443,53706,443,allow,6117,976,5141,21,72,10,11
22528,25174,0,0,deny,146,146,0,1,0,1,0
49582,53,42965,53,allow,775,103,672,2,30,1,1
36061,4500,28501,4500,allow,12526,5944,6582,24,3599,11,13
53564,63344,20702,63344,allow,1721,971,750,15,16,8,7
55553,37965,0,0,deny,66,66,0,1,0,1,0
56624,53,44653,53,allow,199,102,97,2,30,1,1
64275,53,2712,53,allow,644,198,446,6,48,3,3
57126,53,50266,53,allow,183,94,89,2,30,1,1
56170,443,45296,443,allow,9201,4926,4275,19,120,10,9
55593,53,42641,53,allow,193,102,91,2,29,1,1
42252,33303,0,0,deny,60,60,0,1,0,1,0
7246,59858,0,0,deny,66,66,0,1,0,1,0
59147,25174,0,0,deny,62,62,0,1,0,1,0
37656,443,58778,443,allow,9875,3479,6396,29,46,17,12
56451,53,25472,53,allow,322,102,220,2,30,1,1
63991,53,55633,53,allow,193,102,91,2,29,1,1
55067,445,0,0,drop,70,70,0,1,0,1,0
50313,445,0,0,drop,70,70,0,1,0,1,0
56330,53,41814,53,allow,271,95,176,4,47,2,2
1560,51505,0,0,deny,62,62,0,1,0,1,0
40369,57470,0,0,deny,62,62,0,1,0,1,0
55295,445,0,0,drop,70,70,0,1,0,1,0
61719,445,0,0,drop,66,66,0,1,0,1,0
25758,53,25758,53,allow,198,90,108,2,30,1,1
28009,36237,0,0,deny,62,62,0,1,0,1,0
60189,443,11334,443,allow,10816,1112,9704,22,125,10,12
55259,445,0,0,drop,70,70,0,1,0,1,0
65432,53,2736,53,allow,254,94,160,2,30,1,1
56790,53,40538,53,allow,758,93,665,2,30,1,1
60606,3389,0,0,deny,60,60,0,1,0,1,0
38385,443,54542,443,allow,5304,1112,4192,19,31,10,9
49743,80,24003,80,allow,2981,473,2508,9,16,5,4
64106,445,0,0,drop,66,66,0,1,0,1,0
56728,443,61064,443,allow,5367,725,4642,15,15,8,7
55505,53,4978,53,allow,199,102,97,2,29,1,1
65149,53,43485,53,allow,760,97,663,2,31,1,1
38367,15000,50286,15000,allow,130,70,60,2,5,1,1
49449,445,0,0,drop,70,70,0,1,0,1,0
64426,53,39298,53,allow,669,200,469,6,49,3,3
50518,443,9409,443,allow,7117,1288,5829,22,84,12,10
55838,443,50460,443,allow,11446,4102,7344,32,20,16,16
53155,443,52565,443,allow,3866,2774,1092,21,28,12,9
63165,445,0,0,drop,70,70,0,1,0,1,0
60379,443,42355,443,allow,4162,2121,2041,25,95,14,11
51998,1877,49263,1877,allow,316,136,180,6,6,3,3
58137,445,0,0,drop,70,70,0,1,0,1,0
57316,53,3738,53,allow,177,94,83,2,30,1,1
39430,443,21846,443,allow,506,292,214,8,50,5,3
55238,445,0,0,drop,66,66,0,1,0,1,0
16474,50584,0,0,deny,146,146,0,1,0,1,0
61785,64147,0,0,deny,62,62,0,1,0,1,0
53471,161,0,0,allow,5907,2302,3605,22,30,11,11
50552,80,61160,80,allow,2367,1240,1127,10,16,5,5
443,60496,0,0,deny,320,320,0,1,0,1,0
57181,445,0,0,drop,70,70,0,1,0,1,0
49533,443,49533,443,allow,20402,16563,3839,29,24,17,12
51815,51221,0,0,deny,74,74,0,1,0,1,0
6882,6889,29221,6889,allow,221,111,110,2,1201,1,1
65146,53,35272,53,allow,763,102,661,2,31,1,1
62051,11392,0,0,deny,62,62,0,1,0,1,0
50038,53,46782,53,allow,177,94,83,2,31,1,1
10151,27949,13472,27949,allow,469,149,320,2,1200,1,1
38694,443,56498,443,allow,90289,3481,86808,96,16,31,65
18750,57866,0,0,deny,62,62,0,1,0,1,0
60806,51050,0,0,deny,62,62,0,1,0,1,0
56739,53,42182,53,allow,195,102,93,2,30,1,1
61278,445,0,0,drop,70,70,0,1,0,1,0
52564,445,0,0,drop,70,70,0,1,0,1,0
5588,5588,0,0,allow,3562,1936,1626,48,193,24,24
56056,53,19190,53,allow,184,86,98,2,30,1,1
55325,53,48577,53,allow,198,101,97,2,30,1,1
49189,445,0,0,drop,70,70,0,1,0,1,0
51548,80,33223,80,allow,1654,1340,314,11,15,6,5
57146,53,31700,53,allow,198,101,97,2,31,1,1
53160,25174,0,0,deny,146,146,0,1,0,1,0
61699,445,0,0,drop,70,70,0,1,0,1,0
6712,44818,0,0,deny,66,66,0,1,0,1,0
9588,37965,0,0,deny,66,66,0,1,0,1,0
65266,53,11513,53,allow,754,94,660,2,30,1,1
20083,6881,0,0,deny,62,62,0,1,0,1,0
32381,50584,0,0,deny,66,66,0,1,0,1,0
56119,53,42460,53,allow,198,101,97,2,30,1,1
62953,445,0,0,drop,70,70,0,1,0,1,0
49715,443,43667,443,allow,4418,789,3629,13,54,6,7
51862,22,51862,22,allow,7902,3301,4601,56,40,26,30
64381,53,44937,53,allow,952,291,661,8,68,4,4
49321,53,16825,53,allow,184,94,90,2,31,1,1
49165,53,42494,53,allow,257,126,131,2,30,1,1
57726,37965,0,0,deny,62,62,0,1,0,1,0
51975,11998,3978,11998,allow,70,70,0,2,8,2,0
54168,80,20934,80,allow,1582,1003,579,12,360,6,6
58564,50432,0,0,deny,66,66,0,1,0,1,0
63380,443,31712,443,allow,4704,2139,2565,13,119,7,6
62408,50584,0,0,deny,62,62,0,1,0,1,0
60015,443,28429,443,allow,6340,3788,2552,21,143,10,11
7067,22114,0,0,deny,62,62,0,1,0,1,0
16570,25174,0,0,deny,62,62,0,1,0,1,0
5859,11392,0,0,deny,62,62,0,1,0,1,0
60344,80,63030,80,allow,2005,1094,911,11,87,6,5
61739,445,0,0,drop,70,70,0,1,0,1,0
56876,11392,0,0,deny,66,66,0,1,0,1,0
50232,28356,48349,28356,allow,4728691,2246710,2481981,40252,1121,19716,20536
55230,445,0,0,drop,70,70,0,1,0,1,0
65047,53,53893,53,allow,196,86,110,2,30,1,1
59951,445,0,0,drop,70,70,0,1,0,1,0
52447,443,48925,443,allow,7980,5952,2028,22,99,12,10
49681,443,34762,443,allow,7383,2461,4922,18,135,8,10
56395,53,28310,53,allow,177,94,83,2,30,1,1
56273,53,10176,53,allow,200,102,98,2,30,1,1
55621,28144,20259,28144,allow,70,70,0,2,8,2,0
58638,5900,0,0,deny,62,62,0,1,0,1,0
64406,50584,0,0,deny,62,62,0,1,0,1,0
59155,39004,0,0,deny,74,74,0,1,0,1,0
55836,53,32275,53,allow,178,91,87,2,31,1,1
51979,25174,0,0,deny,66,66,0,1,0,1,0
55318,445,0,0,drop,70,70,0,1,0,1,0
58034,443,61141,443,allow,4553,856,3697,17,362,9,8
64622,53,5676,53,allow,738,86,652,2,30,1,1
45614,123,42191,123,allow,184,94,90,2,30,1,1
53021,445,0,0,drop,70,70,0,1,0,1,0
50137,53,54059,53,allow,183,94,89,2,31,1,1
55654,445,0,0,drop,70,70,0,1,0,1,0
56636,443,56636,443,allow,4620,1713,2907,19,28,11,8
64171,445,0,0,drop,70,70,0,1,0,1,0
56441,53,4935,53,allow,209,110,99,2,29,1,1
3883,50265,0,0,deny,66,66,0,1,0,1,0
61903,445,0,0,drop,66,66,0,1,0,1,0
49159,53,33263,53,allow,733,86,647,2,31,1,1
52870,445,0,0,drop,66,66,0,1,0,1,0
61898,50584,0,0,deny,66,66,0,1,0,1,0
49605,53,37521,53,allow,239,110,129,2,30,1,1
47422,80,55452,80,allow,1614,1300,314,10,18,5,5
61280,26467,0,0,deny,66,66,0,1,0,1,0
50591,445,0,0,drop,66,66,0,1,0,1,0
57127,53,41835,53,allow,195,102,93,2,30,1,1
58638,5900,0,0,deny,62,62,0,1,0,1,0
57094,443,45074,443,allow,8180,2643,5537,19,121,9,10
18472,5278,0,0,deny,145,145,0,1,0,1,0
65280,53,4153,53,allow,164,84,80,2,31,1,1
53205,443,46818,443,allow,3658,2347,1311,18,17,9,9
58305,51180,0,0,deny,66,66,0,1,0,1,0
35052,80,38624,80,allow,350,210,140,6,30,4,2
62041,443,33913,443,allow,29329,6712,22617,54,60,23,31
53664,445,0,0,drop,70,70,0,1,0,1,0
55155,2767,0,0,deny,62,62,0,1,0,1,0
55836,53,17150,53,allow,181,94,87,2,33,1,1
56215,53,26623,53,allow,216,110,106,2,31,1,1
37008,42707,0,0,deny,62,62,0,1,0,1,0
57594,443,55656,443,allow,614577,24675,589902,673,149,228,445
57240,53,57240,53,allow,198,89,109,2,30,1,1
51979,80,28537,80,allow,6083,699,5384,14,46,7,7
52217,36746,31872,36746,allow,316,136,180,6,9,3,3
64831,53,42481,53,allow,216,110,106,2,30,1,1
49555,53,21166,53,allow,199,102,97,2,30,1,1
60384,443,37407,443,allow,39385,3771,35614,67,129,27,40
60735,28080,14759,28080,allow,70,70,0,1,5,1,0
57581,443,57581,443,allow,2512,1465,1047,21,87,10,11
54525,445,0,0,drop,66,66,0,1,0,1,0
49541,53,16544,53,allow,745,215,530,6,51,3,3
33258,443,43741,443,allow,6958,4394,2564,30,28,17,13
52459,5555,0,0,deny,60,60,0,1,0,1,0
63996,53,49603,53,allow,252,102,150,2,30,1,1
63062,445,0,0,drop,70,70,0,1,0,1,0
55047,80,59301,80,allow,306,180,126,6,32,4,2
63963,53,44790,53,allow,212,102,110,2,30,1,1
54167,445,0,0,drop,70,70,0,1,0,1,0
57149,53,34608,53,allow,382,94,288,2,30,1,1
52614,44847,0,0,deny,66,66,0,1,0,1,0
64942,53,24439,53,allow,522,190,332,5,48,3,2
64470,53,40171,53,allow,261,94,167,2,30,1,1
56966,53,65099,53,allow,177,94,83,2,30,1,1
49348,53,2617,53,allow,194,102,92,2,30,1,1
56718,50584,0,0,deny,66,66,0,1,0,1,0
9327,57470,0,0,deny,62,62,0,1,0,1,0
57386,53,39494,53,allow,193,102,91,2,30,1,1
59350,445,0,0,drop,66,66,0,1,0,1,0
44410,443,17016,443,allow,2359,1436,923,18,38,10,8
50910,80,20207,80,allow,14877069,179445,14697624,12450,135,2531,9919
4431,32480,0,0,deny,66,66,0,1,0,1,0
57424,53,35431,53,allow,711,87,624,2,30,1,1
51137,445,0,0,drop,66,66,0,1,0,1,0
49783,53,25868,53,allow,179,94,85,2,30,1,1
53800,445,0,0,drop,70,70,0,1,0,1,0
55102,53,13108,53,allow,195,102,93,2,29,1,1
37264,443,36936,443,allow,3068,1678,1390,17,241,9,8
56362,443,29740,443,allow,12746,7725,5021,39,234,24,15
41176,443,1178,443,allow,31541,25324,6217,49,91,29,20
44849,46478,0,0,deny,74,74,0,1,0,1,0
57990,445,0,0,drop,70,70,0,1,0,1,0
64677,53,6467,53,allow,195,102,93,2,30,1,1
55631,16191,24420,16191,allow,504,318,186,8,16,5,3
51111,445,0,0,drop,70,70,0,1,0,1,0
58638,5900,0,0,deny,62,62,0,1,0,1,0
56259,445,0,0,drop,70,70,0,1,0,1,0
61999,445,0,0,drop,70,70,0,1,0,1,0
65117,53,25899,53,allow,230,94,136,2,30,1,1
56490,445,0,0,drop,70,70,0,1,0,1,0
56343,53,26376,53,allow,194,102,92,2,29,1,1
64013,48970,31452,48970,allow,70,70,0,1,4,1,0
60894,50584,0,0,deny,66,66,0,1,0,1,0
13947,37965,0,0,deny,145,145,0,1,0,1,0
49893,25174,0,0,deny,66,66,0,1,0,1,0
50793,445,0,0,drop,66,66,0,1,0,1,0
50035,445,0,0,drop,66,66,0,1,0,1,0
56542,443,7908,443,allow,3701,1521,2180,19,7,10,9
65209,445,0,0,drop,70,70,0,1,0,1,0
64245,53,44468,53,allow,199,102,97,2,30,1,1
64612,445,0,0,drop,70,70,0,1,0,1,0
49816,443,49816,443,allow,4682,1775,2907,19,28,11,8
50958,445,0,0,drop,70,70,0,1,0,1,0
48996,443,35257,443,allow,128299,119001,9298,178,280,103,75
41693,443,28921,443,allow,27069,3064,24005,44,178,19,25
65334,443,56103,443,allow,3182,1568,1614,8,120,4,4
20,17095,0,0,deny,554,554,0,1,0,1,0
53927,37828,58314,37828,allow,552,306,246,9,16,5,4
33886,52255,0,0,deny,162,162,0,1,0,1,0
55388,53,1153,53,allow,177,94,83,2,30,1,1
53906,12051,58772,12051,allow,164,70,94,2,5,1,1
30188,14038,49780,14038,allow,502,150,352,2,1200,1,1
58842,443,11917,443,allow,8912,1537,7375,27,638,10,17
60792,53,38025,53,allow,168,78,90,2,29,1,1
39186,53,39186,53,allow,371,237,134,3,33,2,1
49635,445,0,0,drop,66,66,0,1,0,1,0
48706,23393,0,0,deny,60,60,0,1,0,1,0
33661,53,33661,53,allow,643,88,555,2,30,1,1
53146,50393,21783,50393,allow,70,70,0,2,8,2,0
63027,35440,0,0,deny,62,62,0,1,0,1,0
57470,50321,52574,50321,allow,1584,1584,0,25,1537,25,0
30960,45740,3924,45740,allow,330,330,0,6,3609,6,0
55361,445,0,0,drop,66,66,0,1,0,1,0
51430,443,37453,443,allow,7318,1585,5733,24,50,14,10
8889,16991,8889,16991,allow,124,60,64,2,31,1,1
52149,80,52149,80,allow,2928,694,2234,13,141,6,7
59969,443,49407,443,allow,6655,1166,5489,21,360,11,10
28007,443,40494,443,allow,31586,15587,15999,213,884,105,108
64838,445,0,0,drop,66,66,0,1,0,1,0
60888,445,0,0,drop,70,70,0,1,0,1,0
55828,53,3503,53,allow,178,91,87,2,30,1,1
60537,80,60537,80,allow,318,120,198,6,25,3,3
56167,53,36482,53,allow,172,88,84,2,31,1,1
62381,445,0,0,drop,66,66,0,1,0,1,0
49453,443,59315,443,allow,8251,2124,6127,21,16,11,10
54924,3478,45480,3478,allow,452,280,172,5,30,3,2
43586,443,62166,443,allow,2328,1429,899,18,33,10,8
52587,443,5455,443,allow,6170,918,5252,18,15,10,8
65412,53,14297,53,allow,305,118,187,2,30,1,1
58570,445,0,0,drop,66,66,0,1,0,1,0
55605,53,59160,53,allow,198,102,96,2,30,1,1
5588,5588,0,0,allow,3354,1792,1562,46,193,23,23
44411,37965,0,0,deny,62,62,0,1,0,1,0
65011,53,37444,53,allow,183,94,89,2,31,1,1
1956,53,1956,53,allow,240,98,142,2,30,1,1
49995,80,2817,80,allow,2669,604,2065,11,16,6,5
55358,53,33999,53,allow,200,94,106,2,29,1,1
51414,22,0,0,deny,60,60,0,1,0,1,0
8592,35993,0,0,deny,66,66,0,1,0,1,0
52180,20121,7972,20121,allow,70,70,0,1,5,1,0
65216,53,8359,53,allow,775,102,673,2,30,1,1
18105,53,18105,53,allow,216,98,118,2,30,1,1
56211,445,0,0,drop,70,70,0,1,0,1,0
11692,25174,0,0,deny,66,66,0,1,0,1,0
49172,445,0,0,drop,66,66,0,1,0,1,0
49936,53,17708,53,allow,168,94,74,2,30,1,1
50721,445,0,0,drop,66,66,0,1,0,1,0
65165,53,54019,53,allow,200,102,98,2,31,1,1
49752,53,13383,53,allow,199,86,113,2,31,1,1
49329,445,0,0,drop,66,66,0,1,0,1,0
56496,53,56369,53,allow,193,102,91,2,30,1,1
49719,443,56556,443,allow,560073,155518,404555,923,110,411,512
64752,53,50636,53,allow,195,102,93,2,30,1,1
50265,443,33031,443,allow,23684,13193,10491,84,63,44,40
32921,443,5993,443,allow,7578,2270,5308,17,123,8,9
55148,445,0,0,drop,70,70,0,1,0,1,0
57389,53,59363,53,allow,186,95,91,2,30,1,1
64288,53,49667,53,allow,183,94,89,2,29,1,1
58941,80,60543,80,allow,1114,534,580,12,15,7,5
43169,443,5370,443,allow,8615,2156,6459,37,315,16,21
40672,443,9807,443,allow,9150,2155,6995,38,295,15,23
55893,53,45153,53,allow,267,94,173,4,56,2,2
26763,443,27928,443,allow,7343,2586,4757,23,20,11,12
51866,443,8681,443,allow,2449,1794,655,17,31,10,7
51882,443,57503,443,allow,366,180,186,7,30,4,3
35939,443,12067,443,allow,9111,2919,6192,27,19,14,13
50545,53,44269,53,allow,765,102,663,2,30,1,1
35941,443,48738,443,allow,190,70,120,4,18,2,2
46676,443,54715,443,allow,16425,3923,12502,37,156,19,18
64695,53,7882,53,allow,275,118,157,2,30,1,1
55688,33958,16437,33958,allow,70,70,0,1,5,1,0
58228,53733,0,0,deny,62,62,0,1,0,1,0
50881,80,50881,80,allow,13503,1052,12451,23,21,10,13
55703,445,0,0,drop,70,70,0,1,0,1,0
54706,445,0,0,drop,66,66,0,1,0,1,0
58638,5900,0,0,deny,62,62,0,1,0,1,0
63340,53,0,0,deny,84,84,0,1,0,1,0
54228,445,0,0,drop,70,70,0,1,0,1,0
55273,53,49246,53,allow,317,85,232,4,60,2,2
28999,37807,0,0,deny,62,62,0,1,0,1,0
65189,27015,60711,27015,allow,278,78,200,2,29,1,1
59597,37965,0,0,deny,66,66,0,1,0,1,0
49972,53,57217,53,allow,216,110,106,2,31,1,1
49921,80,16260,80,allow,1126,609,517,11,15,6,5
57689,445,0,0,drop,70,70,0,1,0,1,0
58229,50584,0,0,deny,66,66,0,1,0,1,0
50334,443,44789,443,allow,8863,1567,7296,24,41,12,12
64567,53,31447,53,allow,186,95,91,2,31,1,1
58357,62413,0,0,deny,62,62,0,1,0,1,0
56796,443,3501,443,allow,5475,1610,3865,19,255,11,8
64562,53,22327,53,allow,371,94,277,2,30,1,1
42298,40008,56571,40008,allow,206,84,122,4,31,2,2
57431,53,32621,53,allow,178,91,87,2,31,1,1
59563,445,0,0,drop,70,70,0,1,0,1,0
50820,443,64516,443,allow,2760048,78471,2681577,2863,250,962,1901
49874,53,61806,53,allow,165,86,79,2,29,1,1
58255,50584,0,0,deny,62,62,0,1,0,1,0
53545,445,0,0,drop,66,66,0,1,0,1,0
53404,443,43178,443,allow,4972,1547,3425,22,149,10,12
58817,443,7616,443,allow,1413,876,537,12,25,6,6
57453,443,43967,443,allow,2233,1347,886,23,135,13,10
35486,443,63942,443,allow,4630,2803,1827,29,80,14,15
1987,26467,0,0,deny,62,62,0,1,0,1,0
27316,443,39777,443,allow,9439,1890,7549,29,67,14,15
55099,445,0,0,drop,66,66,0,1,0,1,0
13334,41615,0,0,deny,145,145,0,1,0,1,0
51815,28665,10000,28665,allow,70,70,0,1,4,1,0
16037,25174,0,0,deny,146,146,0,1,0,1,0
57982,64147,0,0,deny,66,66,0,1,0,1,0
56351,53,4846,53,allow,195,102,93,2,32,1,1
64016,53,54219,53,allow,184,94,90,2,31,1,1
3234,80,3234,80,allow,12425,835,11590,19,17,8,11
61701,15503,0,0,deny,62,62,0,1,0,1,0
58638,5900,0,0,deny,62,62,0,1,0,1,0
37965,8999,40313,8999,allow,491,150,341,2,1199,1,1
45939,443,45939,443,allow,4504,1597,2907,19,27,11,8
63364,57470,0,0,deny,66,66,0,1,0,1,0
53300,445,0,0,drop,66,66,0,1,0,1,0
55466,53,26661,53,allow,177,94,83,2,29,1,1
64748,445,0,0,drop,66,66,0,1,0,1,0
52015,25487,58605,25487,allow,70,70,0,2,8,2,0
56330,53,26400,53,allow,199,102,97,2,30,1,1
55893,53,44273,53,allow,267,94,173,4,55,2,2
51752,445,0,0,drop,70,70,0,1,0,1,0
55596,53,30266,53,allow,194,102,92,2,31,1,1
3688,80,37150,80,allow,7072,1145,5927,20,105,12,8
43390,53,0,0,allow,184,86,98,2,30,1,1
20487,50584,0,0,deny,62,62,0,1,0,1,0
53844,443,56188,443,allow,499,425,74,4,0,3,1
55056,53,20306,53,allow,209,110,99,2,30,1,1
64493,53,42355,53,allow,199,102,97,2,29,1,1
56999,80,32577,80,allow,214,140,74,4,35,3,1
29706,50584,0,0,deny,66,66,0,1,0,1,0
52095,48896,12899,48896,allow,70,70,0,2,8,2,0
57284,53,21102,53,allow,214,110,104,2,31,1,1
52091,11392,0,0,deny,62,62,0,1,0,1,0
50493,80,1565,80,allow,318,192,126,6,25,4,2
53616,44166,16410,44166,allow,70,70,0,2,7,2,0
51107,80,61498,80,allow,366,240,126,7,21,5,2
51896,43357,20029,43357,allow,70,70,0,1,5,1,0
52266,31225,1238,31225,allow,70,70,0,1,5,1,0
60415,40829,35259,40829,allow,70,70,0,2,8,2,0
26629,56079,0,0,deny,62,62,0,1,0,1,0
56719,445,0,0,drop,66,66,0,1,0,1,0
54745,445,0,0,drop,70,70,0,1,0,1,0
56416,53,14432,53,allow,193,102,91,2,30,1,1
64860,445,0,0,drop,70,70,0,1,0,1,0
36497,80,36497,80,allow,7594,863,6731,18,21,8,10
43724,35440,0,0,deny,146,146,0,1,0,1,0
51516,443,51516,443,allow,143921,6996,136925,152,174,42,110
57001,53,43521,53,allow,177,94,83,2,30,1,1
13285,29892,0,0,deny,145,145,0,1,0,1,0
64989,53,29167,53,allow,214,94,120,2,31,1,1
65107,53,56824,53,allow,266,87,179,4,32,2,2
60806,445,0,0,drop,66,66,0,1,0,1,0
52036,52608,61881,52608,allow,70,70,0,2,8,2,0
53791,53,14073,53,allow,102,102,0,2,31,2,0
0,0,0,0,deny,156,156,0,2,0,2,0
17213,22114,0,0,deny,62,62,0,1,0,1,0
30960,45714,65388,45714,allow,330,330,0,6,3609,6,0
45766,35440,0,0,deny,62,62,0,1,0,1,0
50827,445,0,0,drop,70,70,0,1,0,1,0
60368,443,19000,443,allow,10387,2575,7812,26,108,13,13
45980,443,15108,443,allow,9611,2412,7199,44,20,22,22
40030,80,62413,80,allow,1286,403,883,16,393,4,12
53701,445,0,0,drop,70,70,0,1,0,1,0
65277,53,2071,53,allow,775,102,673,2,30,1,1
57416,66,17429,66,allow,70,70,0,2,7,2,0
50820,57470,0,0,deny,66,66,0,1,0,1,0
26332,57470,0,0,deny,62,62,0,1,0,1,0
62783,445,0,0,drop,70,70,0,1,0,1,0
56445,53,50550,53,allow,353,110,243,4,46,2,2
48064,443,60858,443,allow,7358,2661,4697,22,17,11,11
49154,443,24167,443,allow,3163100,158133,3004967,3863,264,1464,2399
63658,445,0,0,drop,70,70,0,1,0,1,0
37565,443,47595,443,allow,8553,3392,5161,25,202,13,12
49823,53,8034,53,allow,209,110,99,2,29,1,1
56548,443,12998,443,allow,4145,1069,3076,14,25,8,6
64568,445,0,0,drop,66,66,0,1,0,1,0
57632,445,0,0,drop,70,70,0,1,0,1,0
49272,53,53692,53,allow,198,102,96,2,30,1,1
50025,53,20225,53,allow,215,94,121,2,30,1,1
53729,40721,59100,40721,allow,70,70,0,2,8,2,0
50608,443,24048,443,allow,4758,2811,1947,22,140,12,10
61661,445,0,0,drop,66,66,0,1,0,1,0
63888,6881,45286,6881,allow,70,70,0,1,5,1,0
49210,53,34070,53,allow,182,93,89,2,31,1,1
49214,80,50752,80,allow,2734,1498,1236,21,262,11,10
49515,53,58908,53,allow,195,102,93,2,29,1,1
52434,445,0,0,drop,70,70,0,1,0,1,0
57159,53,30985,53,allow,292,94,198,2,30,1,1
42955,80,63046,80,allow,72023,4897,67126,97,115,46,51
55422,445,0,0,drop,70,70,0,1,0,1,0
57612,28793,0,0,deny,66,66,0,1,0,1,0
63804,445,0,0,drop,66,66,0,1,0,1,0
51935,445,0,0,drop,70,70,0,1,0,1,0
61299,25174,0,0,deny,146,146,0,1,0,1,0
49603,80,3315,80,allow,378,192,186,7,41,4,3
50474,445,0,0,drop,70,70,0,1,0,1,0
36829,443,57108,443,allow,560,280,280,9,27,5,4
60075,41705,0,0,deny,66,66,0,1,0,1,0
63065,445,0,0,drop,66,66,0,1,0,1,0
50703,80,3596,80,allow,54304,27807,26497,227,175,113,114
2422,62507,0,0,deny,66,66,0,1,0,1,0
56170,53,28854,53,allow,196,100,96,2,30,1,1
63002,22114,0,0,deny,66,66,0,1,0,1,0
28040,64147,0,0,deny,66,66,0,1,0,1,0
50616,53,27498,53,allow,177,94,83,2,30,1,1
33196,443,16510,443,allow,6989,5073,1916,24,111,14,10
64589,445,0,0,drop,70,70,0,1,0,1,0
38914,80,38914,80,allow,2993,1469,1524,13,20,8,5
65462,443,5746,443,allow,92384,4519,87865,105,15,39,66
64027,53,2870,53,allow,360,97,263,4,38,2,2
58338,3375,0,0,deny,60,60,0,1,0,1,0
44724,443,7111,443,allow,4383,2829,1554,27,80,14,13
50140,44847,0,0,deny,62,62,0,1,0,1,0
50511,443,12647,443,allow,6352,1073,5279,22,85,12,10
36661,53,19439,53,allow,164,78,86,2,31,1,1
62388,39004,0,0,deny,62,62,0,1,0,1,0
443,54507,0,0,deny,82,82,0,1,0,1,0
63010,53,14322,53,allow,304,86,218,2,29,1,1
23333,53,23333,53,allow,215,80,135,2,33,1,1
41197,30188,0,0,deny,146,146,0,1,0,1,0
65133,445,0,0,drop,70,70,0,1,0,1,0
0,0,0,0,allow,320,320,0,5,0,5,0
57595,80,57595,80,allow,254,120,134,5,26,3,2
16387,7205,0,0,deny,60,60,0,1,0,1,0
3478,61463,0,0,deny,400,400,0,1,0,1,0
64652,445,0,0,drop,70,70,0,1,0,1,0
55647,53,31412,53,allow,168,86,82,2,29,1,1
64749,445,0,0,drop,66,66,0,1,0,1,0
56477,445,0,0,drop,70,70,0,1,0,1,0
57122,53,5518,53,allow,295,101,194,4,31,2,2
53783,445,0,0,drop,70,70,0,1,0,1,0
41439,443,30443,443,allow,4370,1148,3222,17,26,9,8
55877,55153,7894,55153,allow,481,150,331,2,1200,1,1
55425,37965,0,0,deny,66,66,0,1,0,1,0
123,123,24489,123,allow,184,94,90,2,29,1,1
16270,56205,0,0,deny,62,62,0,1,0,1,0
16057,51050,0,0,deny,66,66,0,1,0,1,0
48890,443,48166,443,allow,79665,4371,75294,110,256,45,65
49270,53,44798,53,allow,216,110,106,2,30,1,1
63504,445,0,0,drop,70,70,0,1,0,1,0
64988,53,6131,53,allow,360,110,250,2,30,1,1
61979,445,0,0,drop,66,66,0,1,0,1,0
56230,445,0,0,drop,70,70,0,1,0,1,0
50427,443,32859,443,allow,783009,84254,698755,776,706,250,526
54942,445,0,0,drop,70,70,0,1,0,1,0
63962,445,0,0,drop,66,66,0,1,0,1,0
49657,443,35292,443,allow,2800,1557,1243,33,53,19,14
57425,53,41826,53,allow,168,86,82,2,30,1,1
10833,23,0,0,deny,60,60,0,1,0,1,0
53275,21247,0,0,deny,62,62,0,1,0,1,0
58924,445,0,0,drop,70,70,0,1,0,1,0
52169,59681,49857,59681,allow,66,66,0,1,5,1,0
65028,53,48786,53,allow,182,93,89,2,31,1,1
55541,53,4475,53,allow,177,94,83,2,30,1,1
49418,22114,0,0,deny,66,66,0,1,0,1,0
58909,443,25795,443,allow,7671,4890,2781,25,17,13,12
52073,443,26285,443,allow,22714,21388,1326,33,30,22,11
80,63761,0,0,deny,66,66,0,1,0,1,0
56624,53,13351,53,allow,198,101,97,2,31,1,1
55553,37965,0,0,deny,66,66,0,1,0,1,0
45941,23386,0,0,deny,60,60,0,1,0,1,0
62348,57470,0,0,deny,109,109,0,1,0,1,0
18657,53,18657,53,allow,295,90,205,2,29,1,1
17579,57470,0,0,deny,62,62,0,1,0,1,0
52612,445,0,0,drop,70,70,0,1,0,1,0
50871,80,63200,80,allow,94083,6192,87891,121,139,57,64
59156,50584,0,0,deny,62,62,0,1,0,1,0
33196,53,25269,53,allow,181,86,95,2,30,1,1
59234,21247,0,0,deny,62,62,0,1,0,1,0
63421,44847,0,0,deny,66,66,0,1,0,1,0
54936,80,14845,80,allow,613,539,74,7,15,6,1
42672,443,42672,443,allow,4378,1471,2907,19,30,11,8
60125,445,0,0,drop,66,66,0,1,0,1,0
58638,5900,0,0,deny,62,62,0,1,0,1,0
43916,21,0,0,deny,60,60,0,1,0,1,0
53176,445,0,0,drop,70,70,0,1,0,1,0
60222,22114,0,0,deny,66,66,0,1,0,1,0
58805,445,0,0,drop,70,70,0,1,0,1,0
50413,445,0,0,drop,70,70,0,1,0,1,0
15899,37807,0,0,deny,62,62,0,1,0,1,0
51750,54567,46467,54567,allow,70,70,0,1,5,1,0
57354,53,55769,53,allow,767,102,665,2,30,1,1
18063,53,18063,53,allow,219,87,132,2,30,1,1
52431,50265,0,0,deny,62,62,0,1,0,1,0
58775,443,62135,443,allow,9017,5865,3152,26,16,14,12
59220,445,0,0,drop,70,70,0,1,0,1,0
45376,80,8854,80,allow,2259,1068,1191,12,31,8,4
56029,53,2806,53,allow,346,94,252,2,30,1,1
44559,443,29969,443,allow,6903,1185,5718,26,255,12,14
36005,22,0,0,deny,60,60,0,1,0,1,0
48186,51050,0,0,deny,62,62,0,1,0,1,0
55736,53,0,0,allow,338,70,268,2,30,1,1
59699,443,10810,443,allow,9015,2221,6794,27,421,13,14
37492,53,45298,53,allow,199,94,105,2,30,1,1
65228,53,0,0,deny,88,88,0,1,0,1,0
55360,80,13495,80,allow,130,70,60,2,15,1,1
54151,443,32501,443,allow,1749,966,783,13,75,8,5
53724,443,54768,443,allow,499,425,74,4,0,3,1
52084,30863,64593,30863,allow,70,70,0,2,7,2,0
57210,445,0,0,drop,70,70,0,1,0,1,0
8999,43109,0,0,deny,146,146,0,1,0,1,0
65446,445,0,0,drop,70,70,0,1,0,1,0
64251,53,54906,53,allow,451,118,333,2,30,1,1
56964,53,61136,53,allow,267,87,180,4,59,2,2
57192,53,44126,53,allow,177,94,83,2,30,1,1
54808,443,25043,443,allow,9657,1944,7713,31,82,15,16
57858,445,0,0,drop,66,66,0,1,0,1,0
64805,445,0,0,drop,66,66,0,1,0,1,0
56446,445,0,0,drop,70,70,0,1,0,1,0
51244,42416,0,0,deny,100,100,0,1,0,1,0
58286,37965,0,0,deny,66,66,0,1,0,1,0
64555,53,59391,53,allow,167,86,81,2,30,1,1
52086,80,55343,80,allow,2703,632,2071,12,22,7,5
63865,48610,16202,48610,allow,66,66,0,2,8,2,0
52208,43890,0,0,deny,62,62,0,1,0,1,0
57011,53,6103,53,allow,770,101,669,2,30,1,1
56805,53,60553,53,allow,178,94,84,2,30,1,1
65424,445,0,0,drop,70,70,0,1,0,1,0
54978,443,60259,443,allow,225539,162879,62660,476,70,262,214
55163,443,13789,443,allow,2329,505,1824,14,124,7,7
60049,443,35659,443,allow,10124,2145,7979,24,156,11,13
50182,445,0,0,drop,66,66,0,1,0,1,0
63261,445,0,0,drop,70,70,0,1,0,1,0
56771,53,2287,53,allow,270,95,175,4,60,2,2
45727,443,38522,443,allow,1625,1038,587,14,29,8,6
61207,445,0,0,drop,70,70,0,1,0,1,0
54657,6881,47052,6881,allow,1682,716,966,12,15,6,6
63357,445,0,0,drop,66,66,0,1,0,1,0
37455,50584,0,0,deny,62,62,0,1,0,1,0
50337,53,56473,53,allow,762,97,665,2,30,1,1
64193,445,0,0,drop,70,70,0,1,0,1,0
49929,443,10803,443,allow,7069,2667,4402,22,28,13,9
53211,22114,0,0,deny,62,62,0,1,0,1,0
64260,53,38791,53,allow,211,78,133,2,30,1,1
65080,53,46581,53,allow,741,94,647,2,30,1,1
56748,35148,18439,35148,allow,66,66,0,1,5,1,0
58638,5900,0,0,deny,62,62,0,1,0,1,0
63704,28291,53778,28291,allow,504,382,122,8,15,6,2
56063,53,65199,53,allow,192,98,94,2,31,1,1
40545,443,53543,443,allow,8691,6945,1746,25,80,14,11
50713,53,50713,53,allow,198,90,108,2,30,1,1
45155,53,0,0,allow,226,86,140,2,29,1,1
59118,445,0,0,drop,70,70,0,1,0,1,0
62421,445,0,0,drop,70,70,0,1,0,1,0
57299,443,9312,443,allow,23282,4482,18800,67,17,35,32
54403,443,27679,443,allow,3486,924,2562,13,122,6,7
50820,443,50820,443,allow,37757,4416,33341,44,32,17,27
62737,443,7478,443,allow,35936,2741,33195,62,15,30,32
55773,53,28630,53,allow,102,102,0,1,60,1,0
50227,57470,0,0,deny,66,66,0,1,0,1,0
14259,53,14259,53,allow,247,98,149,2,33,1,1
58470,445,0,0,drop,70,70,0,1,0,1,0
52122,43073,59163,43073,allow,70,70,0,1,5,1,0
28121,443,57798,443,allow,9075,2662,6413,34,462,16,18
55198,80,49692,80,allow,41822,2038,39784,56,15,27,29
27005,27018,58513,27018,allow,888,126,762,2,30,1,1
56682,445,0,0,drop,70,70,0,1,0,1,0
52328,445,0,0,drop,66,66,0,1,0,1,0
63259,445,0,0,drop,66,66,0,1,0,1,0
51830,42707,0,0,deny,66,66,0,1,0,1,0
49785,53,47696,53,allow,211,110,101,2,30,1,1
53872,445,0,0,drop,70,70,0,1,0,1,0
9171,80,16073,80,allow,318,192,126,6,29,4,2
62597,445,0,0,drop,70,70,0,1,0,1,0
15176,62413,0,0,deny,66,66,0,1,0,1,0
60683,5900,0,0,deny,60,60,0,1,0,1,0
35509,3389,35509,3389,allow,4224,2055,2169,22,21,13,9
55190,443,14814,443,allow,12801,4250,8551,40,118,21,19
57942,443,1661,443,allow,2791,1800,991,26,185,15,11
55155,53,35899,53,allow,194,102,92,2,31,1,1
65525,445,0,0,drop,70,70,0,1,0,1,0
49413,53,49413,53,allow,225,90,135,2,30,1,1
48847,443,1416,443,allow,2523,1483,1040,19,276,10,9
6712,161,0,0,deny,82,82,0,1,0,1,0
56400,35440,0,0,deny,66,66,0,1,0,1,0
55031,53,63225,53,allow,756,95,661,2,31,1,1
36011,25174,0,0,deny,66,66,0,1,0,1,0
55454,53,34563,53,allow,321,105,216,4,40,2,2
27005,27054,8800,27054,allow,921,126,795,2,31,1,1
59274,443,55424,443,allow,8640,2329,6311,19,76,10,9
56862,445,0,0,drop,66,66,0,1,0,1,0
55795,443,23533,443,allow,5283,2688,2595,14,135,7,7
55666,36653,26608,36653,allow,70,70,0,2,8,2,0
53928,15503,0,0,deny,62,62,0,1,0,1,0
60395,6890,41049,6890,allow,70,70,0,2,8,2,0
10701,11392,0,0,deny,62,62,0,1,0,1,0
46919,443,8853,443,allow,7094,1672,5422,21,361,10,11
57090,53,19646,53,allow,198,102,96,2,30,1,1
62144,445,0,0,drop,70,70,0,1,0,1,0
56786,53,1954,53,allow,194,102,92,2,30,1,1
52272,443,52272,443,allow,1615,941,674,15,20,7,8
58638,5900,0,0,deny,62,62,0,1,0,1,0
64673,445,0,0,drop,70,70,0,1,0,1,0
51578,44847,0,0,deny,66,66,0,1,0,1,0
60400,80,41884,80,allow,1704,808,896,10,122,6,4
11136,15503,0,0,deny,62,62,0,1,0,1,0
31974,51505,0,0,deny,66,66,0,1,0,1,0
22767,53,22767,53,allow,226,106,120,2,30,1,1
53691,445,0,0,drop,66,66,0,1,0,1,0
56648,53,6533,53,allow,198,101,97,2,31,1,1
21034,50265,0,0,deny,66,66,0,1,0,1,0
20112,64147,0,0,deny,62,62,0,1,0,1,0
8889,49138,0,0,deny,60,60,0,1,0,1,0
39814,53,58386,53,allow,168,78,90,2,30,1,1
55816,53,14968,53,allow,214,110,104,2,29,1,1
51154,445,0,0,drop,70,70,0,1,0,1,0
47256,37807,0,0,deny,62,62,0,1,0,1,0
55584,34914,32488,34914,allow,504,318,186,8,15,5,3
44032,161,0,0,allow,4491,2143,2348,24,30,12,12
2918,37965,0,0,deny,62,62,0,1,0,1,0
64789,53,40256,53,allow,193,102,91,2,30,1,1
49853,53,4793,53,allow,291,102,189,2,30,1,1
58115,3389,58115,3389,allow,4166,2141,2025,18,17,9,9
43129,15503,0,0,deny,62,62,0,1,0,1,0
61120,445,0,0,drop,70,70,0,1,0,1,0
55877,27906,5770,27906,allow,480,149,331,2,1200,1,1
56755,443,40162,443,allow,8059,2039,6020,20,15,11,9
43837,443,27944,443,allow,70,70,0,1,4,1,0
59191,35440,0,0,deny,66,66,0,1,0,1,0
64776,50584,0,0,deny,62,62,0,1,0,1,0
28792,22,0,0,deny,60,60,0,1,0,1,0
55991,53,41227,53,allow,183,94,89,2,30,1,1
49917,53,47966,53,allow,752,93,659,2,31,1,1
64718,53,58761,53,allow,266,110,156,2,30,1,1
59156,50584,0,0,deny,66,66,0,1,0,1,0
53298,26467,0,0,deny,66,66,0,1,0,1,0
49878,53,34561,53,allow,216,94,122,2,30,1,1
44847,6882,30467,6882,allow,502,150,352,2,1200,1,1
60290,80,20522,80,allow,1366,785,581,11,145,6,5
64813,53,4341,53,allow,180,94,86,2,30,1,1
65195,53,58646,53,allow,249,94,155,2,30,1,1
64265,53,25534,53,allow,550,133,417,4,47,2,2
58203,445,0,0,drop,70,70,0,1,0,1,0
56880,53,27129,53,allow,209,110,99,2,30,1,1
59732,53,64408,53,allow,384,166,218,2,30,1,1
59891,443,64677,443,allow,7718,1947,5771,25,46,14,11
57470,1052,29632,1052,allow,132,132,0,3,1199,3,0
61800,445,0,0,drop,70,70,0,1,0,1,0
11295,40018,13039,40018,allow,156,94,62,2,30,1,1
60403,60092,47131,60092,allow,70,70,0,2,8,2,0
55531,445,0,0,drop,66,66,0,1,0,1,0
65483,443,48950,443,allow,92479,4869,87610,109,16,44,65
56655,443,7969,443,allow,1272,876,396,10,26,6,4
53626,30317,0,0,deny,66,66,0,1,0,1,0
64747,53,25665,53,allow,167,78,89,2,30,1,1
53941,53739,17149,53739,allow,70,70,0,1,4,1,0
49614,80,63774,80,allow,374,192,182,7,41,4,3
48817,30201,48817,30201,allow,469,150,319,2,1200,1,1
21716,443,21716,443,allow,10913,762,10151,17,19,7,10
443,47582,0,0,deny,60,60,0,1,0,1,0
58821,443,62939,443,allow,16200,10803,5397,42,18,24,18
61496,445,0,0,drop,70,70,0,1,0,1,0
50641,80,49164,80,allow,1658,1247,411,8,15,5,3
49659,445,0,0,drop,66,66,0,1,0,1,0
56569,53,62895,53,allow,199,102,97,2,30,1,1
443,64347,0,0,deny,131,131,0,1,0,1,0
53867,445,0,0,drop,70,70,0,1,0,1,0
9731,64147,0,0,deny,62,62,0,1,0,1,0
27005,27018,61540,27018,allow,881,126,755,2,30,1,1
59180,443,21871,443,allow,2592,1486,1106,20,275,10,10
35017,443,23449,443,allow,826,362,464,13,30,6,7
62374,445,0,0,drop,70,70,0,1,0,1,0
57550,50584,0,0,deny,62,62,0,1,0,1,0
57470,51413,27069,51413,allow,807,275,532,4,1200,2,2
56620,443,2901,443,allow,1327,918,409,10,25,6,4
36258,443,41571,443,allow,1128432,47396,1081036,1242,142,458,784
65136,445,0,0,drop,70,70,0,1,0,1,0
49477,53,20665,53,allow,178,94,84,2,30,1,1
61060,53,35678,53,allow,311,94,217,2,30,1,1
49660,53,64845,53,allow,186,95,91,2,30,1,1
51934,36180,0,0,deny,66,66,0,1,0,1,0
63083,25174,0,0,deny,66,66,0,1,0,1,0
55650,53,22960,53,allow,179,94,85,2,31,1,1
6881,6881,43192,6881,allow,150,150,0,1,1200,1,0
24480,35440,0,0,deny,66,66,0,1,0,1,0
60433,445,0,0,drop,66,66,0,1,0,1,0
65515,53,22832,53,allow,338,107,231,4,39,2,2
31281,57470,0,0,deny,145,145,0,1,0,1,0
0,0,0,0,deny,60,60,0,1,0,1,0
55485,445,0,0,drop,70,70,0,1,0,1,0
56339,443,15948,443,allow,8991,1756,7235,28,26,15,13
52711,443,58119,443,allow,15118,3979,11139,34,353,17,17
55113,53,29716,53,allow,196,100,96,2,31,1,1
49929,443,23324,443,allow,7298,2303,4995,22,16,12,10
33074,5900,0,0,deny,60,60,0,1,0,1,0
65064,53,48752,53,allow,821,102,719,2,29,1,1
59493,44847,0,0,deny,66,66,0,1,0,1,0
53140,51221,0,0,deny,74,74,0,1,0,1,0
50972,3544,63114,3544,allow,409,107,302,4,30,2,2
51972,5222,10197,5222,allow,5410,2343,3067,42,53,24,18
20147,53,20147,53,allow,219,87,132,2,30,1,1
61072,53,60652,53,allow,1139,878,261,2,30,1,1
54502,34729,0,0,deny,66,66,0,1,0,1,0
64383,443,47790,443,allow,4017,978,3039,14,53,8,6
54234,53,54234,53,allow,237,91,146,2,33,1,1
57418,53,56760,53,allow,209,102,107,2,30,1,1
49277,80,11702,80,allow,13670,11470,2200,39,231,20,19
49554,53,40462,53,allow,210,110,100,2,31,1,1
17855,53,17855,53,allow,240,98,142,2,30,1,1
28498,36237,0,0,deny,62,62,0,1,0,1,0
49543,53,24051,53,allow,880,189,691,6,75,3,3
64959,27038,6979,27038,allow,996,462,534,4,30,2,2
58701,27030,9286,27030,allow,70,70,0,1,5,1,0
51534,26467,0,0,deny,62,62,0,1,0,1,0
27005,27015,17073,27015,allow,886,126,760,2,30,1,1
55606,445,0,0,drop,70,70,0,1,0,1,0
49676,53,32954,53,allow,197,102,95,2,30,1,1
59720,443,13294,443,allow,3346,1219,2127,15,136,7,8
56509,53,12733,53,allow,1165,94,1071,2,29,1,1
54854,19847,0,0,deny,66,66,0,1,0,1,0
64601,80,64601,80,allow,56887,6820,50067,90,25,49,41
50816,443,50681,443,allow,134,60,74,3,6,2,1
7749,36237,0,0,deny,66,66,0,1,0,1,0
49569,53,48621,53,allow,91,91,0,2,37,2,0
47134,37965,0,0,deny,62,62,0,1,0,1,0
55972,53,38960,53,allow,756,95,661,2,31,1,1
58131,15503,0,0,deny,146,146,0,1,0,1,0
51209,443,1552,443,allow,11983,2674,9309,51,17,29,22
58082,445,0,0,drop,70,70,0,1,0,1,0
52023,41791,61647,41791,allow,70,70,0,2,8,2,0
57500,23,0,0,deny,60,60,0,1,0,1,0
50265,5554,7404,5554,allow,472,150,322,2,1200,1,1
55975,53,44915,53,allow,195,102,93,2,31,1,1
19838,23,0,0,deny,60,60,0,1,0,1,0
58044,443,46397,443,allow,24527,2438,22089,43,329,19,24
52913,2767,0,0,deny,66,66,0,1,0,1,0
62794,445,0,0,drop,66,66,0,1,0,1,0
51413,32480,0,0,deny,72,72,0,1,0,1,0
50331,80,36568,80,allow,1677,862,815,10,15,5,5
58868,443,40093,443,allow,3867,2403,1464,17,15,8,9
13406,22114,0,0,deny,62,62,0,1,0,1,0
52370,443,22287,443,allow,7058,2421,4637,21,17,11,10
64092,445,0,0,drop,66,66,0,1,0,1,0
57303,53,43423,53,allow,177,94,83,2,30,1,1
61833,443,42241,443,allow,3429,784,2645,18,135,8,10
53642,39344,30760,39344,allow,612,306,306,10,15,5,5
53373,64147,0,0,deny,66,66,0,1,0,1,0
33761,25174,0,0,deny,62,62,0,1,0,1,0
123,123,15177,123,allow,184,94,90,2,30,1,1
62663,35253,0,0,deny,66,66,0,1,0,1,0
64472,53,42723,53,allow,183,94,89,2,30,1,1
65179,53,5745,53,allow,184,94,90,2,31,1,1
57136,53,22982,53,allow,209,110,99,2,30,1,1
56869,17637,0,0,deny,66,66,0,1,0,1,0
49575,445,0,0,drop,70,70,0,1,0,1,0
61492,80,29860,80,allow,901,398,503,10,15,5,5
64903,445,0,0,drop,70,70,0,1,0,1,0
47402,443,25875,443,allow,6118,1180,4938,22,16,11,11
49881,445,0,0,drop,70,70,0,1,0,1,0
61701,44847,0,0,deny,66,66,0,1,0,1,0
55429,25174,0,0,deny,66,66,0,1,0,1,0
51221,27048,22916,27048,allow,132,132,0,3,1200,3,0
59166,443,40050,443,allow,130458,7920,122538,199,359,94,105
53865,64000,37089,64000,allow,492,306,186,8,15,5,3
59879,55783,0,0,deny,62,62,0,1,0,1,0
59459,445,0,0,drop,70,70,0,1,0,1,0
56938,53,8399,53,allow,199,102,97,2,29,1,1
49591,53,21458,53,allow,86,86,0,1,29,1,0
51411,443,26944,443,allow,509,329,180,6,8,3,3
65200,53,50135,53,allow,214,110,104,2,30,1,1
55169,53,58327,53,allow,199,102,97,2,30,1,1
43552,443,10231,443,allow,4680,2873,1807,26,53,15,11
56760,443,12877,443,allow,7894,1671,6223,21,185,11,10
54977,445,0,0,drop,66,66,0,1,0,1,0
57954,48817,0,0,deny,78,78,0,1,0,1,0
64365,53,55898,53,allow,196,94,102,2,30,1,1
5588,5588,0,0,allow,3354,1792,1562,46,192,23,23
50337,53,50337,53,allow,260,106,154,2,30,1,1
46410,80,31458,80,allow,1163,705,458,10,15,6,4
56648,443,26064,443,allow,8007,1987,6020,20,15,11,9
62041,445,0,0,drop,70,70,0,1,0,1,0
63181,445,0,0,drop,66,66,0,1,0,1,0
65220,53,55552,53,allow,172,88,84,2,31,1,1
54743,445,0,0,drop,70,70,0,1,0,1,0
34731,22114,0,0,deny,62,62,0,1,0,1,0
54977,53,36032,53,allow,275,93,182,4,31,2,2
53827,5889,21032,5889,allow,70,70,0,2,7,2,0
49717,53,48239,53,allow,444,96,348,4,44,2,2
23873,30188,0,0,deny,66,66,0,1,0,1,0
45238,44847,0,0,deny,62,62,0,1,0,1,0
46604,57866,0,0,deny,62,62,0,1,0,1,0
56720,53,11601,53,allow,177,94,83,2,29,1,1
53521,443,39860,443,allow,710,350,360,12,33,6,6
58779,443,44782,443,allow,5166,700,4466,16,15,7,9
56628,53,54812,53,allow,789,110,679,2,30,1,1
64595,53,56897,53,allow,183,94,89,2,29,1,1
52754,26467,0,0,deny,66,66,0,1,0,1,0
56769,11155,5156,11155,allow,66,66,0,1,5,1,0
27005,27015,8730,27015,allow,913,126,787,2,30,1,1
65258,445,0,0,drop,70,70,0,1,0,1,0
63030,25174,0,0,deny,62,62,0,1,0,1,0
57797,445,0,0,drop,70,70,0,1,0,1,0
64116,53,6578,53,allow,267,94,173,4,59,2,2
59095,57470,0,0,deny,66,66,0,1,0,1,0
58715,64097,0,0,deny,62,62,0,1,0,1,0
59139,445,0,0,drop,70,70,0,1,0,1,0
52636,445,0,0,drop,70,70,0,1,0,1,0
59524,445,0,0,drop,70,70,0,1,0,1,0
64303,53,30875,53,allow,298,87,211,4,34,2,2
19052,7000,19052,7000,allow,2205,815,1390,13,16,7,6
56301,53,2529,53,allow,177,94,83,2,30,1,1
62896,993,16279,993,allow,9831,4069,5762,88,192,40,48
40890,53,0,0,allow,86,86,0,1,30,1,0
56609,53,37814,53,allow,199,102,97,2,30,1,1
27005,27080,21162,27080,allow,926,126,800,2,31,1,1
57256,53,42871,53,allow,771,101,670,2,31,1,1
53680,445,0,0,drop,70,70,0,1,0,1,0
52080,445,0,0,drop,70,70,0,1,0,1,0
59315,35440,0,0,deny,66,66,0,1,0,1,0
56365,443,42336,443,allow,4850,2997,1853,20,234,12,8
34891,53,37025,53,allow,396,257,139,3,30,2,1
59649,443,47146,443,allow,11784,7785,3999,55,120,28,27
57405,443,36790,443,allow,5734,1543,4191,24,26,13,11
49395,445,0,0,drop,70,70,0,1,0,1,0
62149,445,0,0,drop,70,70,0,1,0,1,0
50226,445,0,0,drop,66,66,0,1,0,1,0
31637,17348,0,0,deny,60,60,0,1,0,1,0
60046,443,51072,443,allow,8241,2346,5895,18,136,8,10
52016,80,31831,80,allow,19693,1957,17736,49,32,23,26
60332,53,8836,53,allow,419,111,308,2,31,1,1
51125,80,6897,80,allow,2880,815,2065,12,25,7,5
53670,32016,15273,32016,allow,70,70,0,2,8,2,0
54579,445,0,0,drop,70,70,0,1,0,1,0
53046,445,0,0,drop,66,66,0,1,0,1,0
49275,53,23304,53,allow,212,102,110,2,30,1,1
50663,445,0,0,drop,70,70,0,1,0,1,0
58762,445,0,0,drop,70,70,0,1,0,1,0
49812,53,5502,53,allow,166,86,80,2,30,1,1
24066,25174,0,0,deny,146,146,0,1,0,1,0
51464,443,29786,443,allow,575,326,249,10,15,6,4
24949,47563,0,0,deny,145,145,0,1,0,1,0
55760,443,34599,443,allow,4344,2974,1370,22,94,12,10
51324,11392,0,0,deny,66,66,0,1,0,1,0
63973,53,57018,53,allow,346,98,248,4,31,2,2
64287,445,0,0,drop,70,70,0,1,0,1,0
39802,80,39802,80,allow,424,198,226,7,142,4,3
50584,51413,3341,51413,allow,475,150,325,2,1200,1,1
58121,445,0,0,drop,66,66,0,1,0,1,0
56973,53,9162,53,allow,193,102,91,2,30,1,1
50812,445,0,0,drop,70,70,0,1,0,1,0
37965,51498,7708,51498,allow,158,158,0,1,1199,1,0
37682,5228,19029,5228,allow,5554,755,4799,14,3600,8,6
40226,443,40694,443,allow,13853,4638,9215,42,387,21,21
63943,53,16297,53,allow,258,90,168,4,56,2,2
50478,51505,0,0,deny,66,66,0,1,0,1,0
1847,64147,0,0,deny,66,66,0,1,0,1,0
64605,445,0,0,drop,70,70,0,1,0,1,0
50935,445,0,0,drop,70,70,0,1,0,1,0
50580,80,18240,80,allow,1513,694,819,10,15,5,5
34531,23117,0,0,deny,62,62,0,1,0,1,0
49539,53,54919,53,allow,198,94,104,2,31,1,1
51972,445,0,0,drop,70,70,0,1,0,1,0
64689,53,34039,53,allow,183,94,89,2,30,1,1
55251,53,16099,53,allow,212,110,102,2,30,1,1
49931,443,64224,443,allow,92352,5699,86653,105,134,35,70
55532,80,8734,80,allow,3367,2346,1021,19,39,11,8
41482,23,0,0,deny,60,60,0,1,0,1,0
48817,41706,48817,41706,allow,513,152,361,2,1200,1,1
55733,51505,0,0,deny,66,66,0,1,0,1,0
49180,53,37264,53,allow,314,97,217,4,34,2,2
53530,8999,38471,8999,allow,70,70,0,2,7,2,0
64569,53,30065,53,allow,183,94,89,2,30,1,1
50863,443,18214,443,allow,1501,590,911,12,26,6,6
42412,443,55628,443,allow,204,70,134,4,26,2,2
58915,443,1330,443,allow,6138,3860,2278,20,16,10,10
56816,12523,45890,12523,allow,70,70,0,1,5,1,0
60381,80,60381,80,allow,448865,6437,442428,380,151,67,313
53353,26467,0,0,deny,62,62,0,1,0,1,0
45964,2225,0,0,deny,60,60,0,1,0,1,0
60368,445,0,0,drop,70,70,0,1,0,1,0
55485,445,0,0,drop,66,66,0,1,0,1,0
59739,35253,0,0,deny,62,62,0,1,0,1,0
49747,53,22028,53,allow,278,94,184,2,30,1,1
55086,53,37200,53,allow,328,90,238,4,37,2,2
51998,80,30634,80,allow,52288,7809,44479,105,37,40,65
64129,445,0,0,drop,70,70,0,1,0,1,0
60292,7129,0,0,deny,62,62,0,1,0,1,0
56872,445,0,0,drop,66,66,0,1,0,1,0
60192,35440,0,0,deny,62,62,0,1,0,1,0
62459,445,0,0,drop,70,70,0,1,0,1,0
58958,80,41174,80,allow,6969,6315,654,15,15,9,6
2919,37965,0,0,deny,62,62,0,1,0,1,0
49928,443,36059,443,allow,11646,4774,6872,29,32,18,11
52769,51221,0,0,deny,62,62,0,1,0,1,0
53144,58987,43141,58987,allow,70,70,0,2,8,2,0
53115,40693,38172,40693,allow,70,70,0,2,8,2,0
64251,53,24532,53,allow,177,94,83,2,30,1,1
54963,445,0,0,drop,70,70,0,1,0,1,0
51674,51505,0,0,deny,66,66,0,1,0,1,0
58062,445,0,0,drop,70,70,0,1,0,1,0
49577,57470,0,0,deny,62,62,0,1,0,1,0
65056,53,34239,53,allow,199,102,97,2,29,1,1
56119,46824,0,0,deny,62,62,0,1,0,1,0
54695,445,0,0,drop,70,70,0,1,0,1,0
54140,17372,0,0,deny,66,66,0,1,0,1,0
52116,445,0,0,drop,70,70,0,1,0,1,0
45428,80,14591,80,allow,350,210,140,6,28,4,2
443,9986,0,0,deny,669,669,0,1,0,1,0
49474,7000,49474,7000,allow,2990,1599,1391,15,15,8,7
47063,53,47063,53,allow,221,89,132,2,31,1,1
59119,445,0,0,drop,70,70,0,1,0,1,0
54040,445,0,0,drop,70,70,0,1,0,1,0
56236,80,56236,80,allow,44755,823,43932,45,15,12,33
60827,53,38613,53,allow,224,86,138,2,29,1,1
65179,44847,0,0,deny,66,66,0,1,0,1,0
61298,445,0,0,drop,70,70,0,1,0,1,0
56491,445,0,0,drop,70,70,0,1,0,1,0
9169,80,55933,80,allow,318,192,126,6,29,4,2
47391,443,14660,443,allow,9921,3169,6752,31,20,17,14
65276,53,46929,53,allow,212,102,110,2,30,1,1
30188,33365,39784,33365,allow,42329,18517,23812,241,2378,116,125
60745,40010,27877,40010,allow,316,136,180,6,6,3,3
51322,443,58671,443,allow,6250,1422,4828,20,17,10,10
57692,445,0,0,drop,66,66,0,1,0,1,0
64785,445,0,0,drop,70,70,0,1,0,1,0
55187,53,40713,53,allow,172,94,78,2,30,1,1
64067,445,0,0,drop,70,70,0,1,0,1,0
20012,444,0,0,deny,60,60,0,1,0,1,0
56719,80,46763,80,allow,1462,703,759,8,16,5,3
52334,445,0,0,drop,70,70,0,1,0,1,0
44929,443,17835,443,allow,554,280,274,9,111,5,4
51394,445,0,0,drop,70,70,0,1,0,1,0
17280,22114,0,0,deny,62,62,0,1,0,1,0
55475,443,50971,443,allow,8714,1456,7258,25,32,13,12
56740,443,11618,443,allow,456259,379546,76713,1179,364,656,523
6825,53,6825,53,allow,217,87,130,2,30,1,1
64776,53,33019,53,allow,935,334,601,8,62,4,4
45908,33330,0,0,deny,60,60,0,1,0,1,0
50650,443,2408,443,allow,9741,7503,2238,24,32,14,10
34553,48637,0,0,deny,60,60,0,1,0,1,0
62342,445,0,0,deny,66,66,0,1,0,1,0
5588,5588,0,0,allow,3498,1872,1626,48,201,24,24
51638,445,0,0,drop,70,70,0,1,0,1,0
59273,445,0,0,drop,70,70,0,1,0,1,0
55521,53,16753,53,allow,711,87,624,2,30,1,1
56841,29753,13885,29753,allow,70,70,0,1,5,1,0
16430,31573,0,0,deny,62,62,0,1,0,1,0
63401,445,0,0,drop,70,70,0,1,0,1,0
58631,445,0,0,drop,70,70,0,1,0,1,0
17750,44597,35749,44597,allow,481,150,331,2,1200,1,1
65200,51050,0,0,deny,66,66,0,1,0,1,0
59904,443,14583,443,allow,694,370,324,12,34,7,5
20706,23718,0,0,deny,62,62,0,1,0,1,0
61988,443,61988,443,allow,4338,1431,2907,19,30,11,8
1046,25174,0,0,deny,146,146,0,1,0,1,0
58638,5900,0,0,deny,62,62,0,1,0,1,0
40185,64147,0,0,deny,66,66,0,1,0,1,0
57706,64147,0,0,deny,66,66,0,1,0,1,0
27773,56205,0,0,deny,146,146,0,1,0,1,0
49699,53,40136,53,allow,266,89,177,4,58,2,2
49692,53,33543,53,allow,212,110,102,2,30,1,1
55379,445,0,0,drop,70,70,0,1,0,1,0
64746,53,28024,53,allow,193,102,91,2,31,1,1
60550,50584,0,0,deny,62,62,0,1,0,1,0
64548,445,0,0,drop,70,70,0,1,0,1,0
50850,445,0,0,drop,70,70,0,1,0,1,0
46116,57470,0,0,deny,74,74,0,1,0,1,0
53289,445,0,0,drop,70,70,0,1,0,1,0
63861,37832,64694,37832,allow,70,70,0,1,5,1,0
55155,445,0,0,drop,70,70,0,1,0,1,0
59782,26467,0,0,deny,62,62,0,1,0,1,0
48230,22114,0,0,deny,146,146,0,1,0,1,0
57226,51505,0,0,deny,66,66,0,1,0,1,0
57246,53,49639,53,allow,183,94,89,2,31,1,1
52462,445,0,0,drop,70,70,0,1,0,1,0
55105,53,24892,53,allow,194,94,100,2,30,1,1
50417,80,26233,80,allow,1658,1247,411,8,15,5,3
56524,445,0,0,drop,70,70,0,1,0,1,0
23021,25174,0,0,deny,62,62,0,1,0,1,0
53365,80,32049,80,allow,405,285,120,5,15,3,2
9270,80,20221,80,allow,318,192,126,6,26,4,2
62692,443,51155,443,allow,14518,2409,12109,23,135,10,13
57289,445,0,0,drop,70,70,0,1,0,1,0
49355,53,16925,53,allow,186,95,91,2,0,1,1
58022,8080,0,0,deny,60,60,0,1,0,1,0
65516,53,45586,53,allow,749,94,655,2,31,1,1
34671,443,52492,443,allow,8904,1058,7846,18,31,9,9
56931,443,32343,443,allow,34750,2997,31753,61,95,29,32
36881,56205,0,0,deny,62,62,0,1,0,1,0
55720,445,0,0,drop,70,70,0,1,0,1,0
14924,44847,0,0,deny,66,66,0,1,0,1,0
35221,443,12640,443,allow,146299,21774,124525,246,141,98,148
49226,443,49226,443,allow,118943,24432,94511,156,96,79,77
53212,443,49183,443,allow,4681,2403,2278,19,135,10,9
32609,64097,0,0,deny,66,66,0,1,0,1,0
51617,21247,0,0,deny,66,66,0,1,0,1,0
50012,53,31232,53,allow,209,102,107,2,30,1,1
58952,443,55046,443,allow,5166,700,4466,16,15,7,9
52325,443,28114,443,allow,3188,1601,1587,34,48,18,16
51782,445,0,0,drop,66,66,0,1,0,1,0
43260,41615,0,0,deny,145,145,0,1,0,1,0
56980,445,0,0,drop,70,70,0,1,0,1,0
33858,443,46476,443,allow,12017,2031,9986,38,216,18,20
49041,443,30685,443,allow,5144,847,4297,16,132,9,7
55873,445,0,0,drop,70,70,0,1,0,1,0
58654,445,0,0,drop,70,70,0,1,0,1,0
40335,443,28601,443,allow,4397,2104,2293,29,85,11,18
63867,35993,0,0,deny,66,66,0,1,0,1,0
49172,445,0,0,drop,70,70,0,1,0,1,0
14336,64147,0,0,deny,62,62,0,1,0,1,0
63048,53,53568,53,allow,304,86,218,2,30,1,1
55294,445,0,0,drop,70,70,0,1,0,1,0
28583,22114,0,0,deny,146,146,0,1,0,1,0
52645,6881,55258,6881,allow,841,535,306,10,14,5,5
64115,80,27951,80,allow,2575,635,1940,12,36,7,5
46218,23,0,0,deny,60,60,0,1,0,1,0
55932,53,3248,53,allow,209,110,99,2,30,1,1
35088,443,54099,443,allow,800,452,348,12,94,7,5
56778,35440,0,0,deny,66,66,0,1,0,1,0
51796,48779,32373,48779,allow,70,70,0,1,5,1,0
57284,22114,0,0,deny,66,66,0,1,0,1,0
57122,53,57720,53,allow,199,102,97,2,29,1,1
49419,53,3552,53,allow,343,100,243,4,52,2,2
56178,445,0,0,drop,66,66,0,1,0,1,0
46403,443,21158,443,allow,6035,1758,4277,27,1169,15,12
61830,443,61830,443,allow,88574,15708,72866,114,176,52,62
43868,23,0,0,deny,60,60,0,1,0,1,0
59823,443,6570,443,allow,27406,15466,11940,123,188,62,61
49410,53,62890,53,allow,177,94,83,2,30,1,1
51989,29736,26603,29736,allow,160,70,90,2,5,1,1
60030,443,28456,443,allow,711172,27430,683742,812,104,342,470
63508,62413,0,0,deny,66,66,0,1,0,1,0
53258,443,7093,443,allow,5124,979,4145,19,54,10,9
54014,5228,26717,5228,allow,2493,1541,952,16,3601,8,8
27005,27021,13743,27021,allow,1616,126,1490,4,30,2,2
50824,445,0,0,drop,66,66,0,1,0,1,0
50169,25174,0,0,deny,62,62,0,1,0,1,0
50028,53,16611,53,allow,210,102,108,2,30,1,1
64986,53,27800,53,allow,180,94,86,2,30,1,1
10639,11392,0,0,deny,62,62,0,1,0,1,0
65080,53,41733,53,allow,193,102,91,2,29,1,1
62556,445,0,0,drop,70,70,0,1,0,1,0
57144,53,3454,53,allow,172,88,84,2,31,1,1
56377,80,8742,80,allow,1633,943,690,15,72,8,7
50160,57470,0,0,deny,146,146,0,1,0,1,0
45882,443,31867,443,allow,6617,1852,4765,23,132,13,10
65040,53,11010,53,allow,178,94,84,2,29,1,1
53589,40281,13610,40281,allow,70,70,0,2,7,2,0
56889,53,22522,53,allow,211,110,101,2,30,1,1
64461,53,10856,53,allow,170,87,83,2,30,1,1
48982,15000,10476,15000,allow,130,70,60,2,5,1,1
52412,445,0,0,drop,66,66,0,1,0,1,0
55396,53,1903,53,allow,778,103,675,2,30,1,1
39480,8055,0,0,deny,148,148,0,1,0,1,0
55165,53,3036,53,allow,193,102,91,2,29,1,1
53667,22114,0,0,deny,62,62,0,1,0,1,0
33582,44847,0,0,deny,66,66,0,1,0,1,0
443,59890,0,0,deny,60,60,0,1,0,1,0
44695,53,44695,53,allow,198,89,109,2,30,1,1
56680,161,0,0,allow,15721,6203,9518,50,30,25,25
24073,22114,0,0,deny,62,62,0,1,0,1,0
58124,80,58124,80,allow,125299,3364,121935,129,19,44,85
38537,443,38537,443,allow,4662,1755,2907,19,30,11,8
50177,443,50177,443,allow,5206,1389,3817,22,15,10,12
58483,443,25541,443,allow,3024,709,2315,13,120,6,7
49770,80,9129,80,allow,254,128,126,5,15,3,2
4138,55777,0,0,deny,66,66,0,1,0,1,0
60455,443,23230,443,allow,25055,5440,19615,65,84,35,30
63603,445,0,0,drop,70,70,0,1,0,1,0
55054,443,36646,443,allow,7993,677,7316,16,15,8,8
18113,22114,0,0,deny,146,146,0,1,0,1,0
61950,445,0,0,drop,70,70,0,1,0,1,0
6037,43890,0,0,deny,74,74,0,1,0,1,0
62038,80,20471,80,allow,668,224,444,10,18,4,6
61721,443,43568,443,allow,9676,2327,7349,25,16,15,10
64641,53,15849,53,allow,193,94,99,2,30,1,1
15503,3082,40195,3082,allow,480,149,331,2,1200,1,1
57377,53,26653,53,allow,2235,93,2142,4,30,2,2
35601,80,28025,80,allow,1151,711,440,10,15,5,5
49247,80,49247,80,allow,135755,6750,129005,160,22,68,92
53824,41482,38792,41482,allow,70,70,0,2,8,2,0
55920,53,58162,53,allow,770,102,668,2,30,1,1
54942,53,0,0,allow,631,74,557,2,30,1,1
41246,443,27215,443,allow,234,234,0,4,12,4,0
55625,10480,18268,10480,allow,564,318,246,9,15,5,4
61897,445,0,0,drop,70,70,0,1,0,1,0
58120,445,0,0,drop,70,70,0,1,0,1,0
39208,53,0,0,allow,86,86,0,1,30,1,0
52151,30692,49782,30692,allow,66,66,0,1,5,1,0
45725,443,40804,443,allow,8600,4882,3718,44,225,23,21
40932,443,9497,443,allow,10803,4485,6318,36,345,19,17
27005,27015,4428,27015,allow,884,126,758,2,31,1,1
52048,44059,7624,44059,allow,160,70,90,2,5,1,1
50905,443,13622,443,allow,124,64,60,2,15,1,1
44921,443,18740,443,allow,5440,846,4594,15,15,9,6
10252,11392,0,0,deny,62,62,0,1,0,1,0
60191,443,1843,443,allow,7292,950,6342,19,125,9,10
41945,443,44467,443,allow,12146,2681,9465,63,4156,25,38
39573,443,27028,443,allow,29226,2150,27076,44,30,19,25
50584,62758,61935,62758,allow,161,161,0,2,1199,2,0
56948,53,55604,53,allow,183,94,89,2,29,1,1
53828,51354,7216,51354,allow,70,70,0,2,8,2,0
54961,53,55140,53,allow,375,99,276,4,54,2,2
40687,64147,0,0,deny,62,62,0,1,0,1,0
56746,443,25716,443,allow,8006,1986,6020,20,15,11,9
65036,53,4183,53,allow,199,102,97,2,30,1,1
52185,13269,13389,13269,allow,70,70,0,1,4,1,0
63924,445,0,0,drop,70,70,0,1,0,1,0
47595,33440,0,0,allow,106,106,0,1,61,1,0
50513,445,0,0,drop,70,70,0,1,0,1,0
51617,15000,54264,15000,allow,130,70,60,2,5,1,1
14252,35993,0,0,deny,62,62,0,1,0,1,0
29424,37807,0,0,deny,62,62,0,1,0,1,0
54339,443,11466,443,allow,3149,769,2380,10,120,5,5
64425,53,47922,53,allow,216,94,122,2,30,1,1
49691,53,43996,53,allow,378,127,251,2,30,1,1
53843,445,0,0,drop,70,70,0,1,0,1,0
58638,5900,0,0,deny,62,62,0,1,0,1,0
27046,51505,0,0,deny,66,66,0,1,0,1,0
37876,5900,0,0,deny,60,60,0,1,0,1,0
11136,57587,0,0,deny,62,62,0,1,0,1,0
44912,443,31289,443,allow,414,140,274,7,26,3,4
57127,53,64638,53,allow,193,102,91,2,30,1,1
60406,443,21053,443,allow,8404,1892,6512,23,30,12,11
65152,53,13700,53,allow,177,94,83,2,30,1,1
56212,53,23655,53,allow,184,102,82,2,30,1,1
6882,30499,61301,30499,allow,150,150,0,1,1200,1,0
63035,443,64744,443,allow,1864,250,1614,8,120,4,4
56610,443,5877,443,allow,100002,5891,94111,138,44,60,78
54000,53,0,0,allow,202,86,116,2,30,1,1
53077,443,28917,443,allow,6715,1415,5300,27,84,14,13
26365,22,0,0,deny,60,60,0,1,0,1,0
60410,445,0,0,drop,70,70,0,1,0,1,0
29300,35440,0,0,deny,146,146,0,1,0,1,0
56875,53,43240,53,allow,167,86,81,2,30,1,1
63921,445,0,0,drop,70,70,0,1,0,1,0
41049,443,3441,443,allow,197239,6098,191141,213,170,75,138
59569,445,0,0,drop,70,70,0,1,0,1,0
19718,37965,0,0,deny,66,66,0,1,0,1,0
6881,6889,24381,6889,allow,228,118,110,2,1199,1,1
61840,25174,0,0,deny,66,66,0,1,0,1,0
26900,27017,11967,27017,allow,422,164,258,6,30,3,3
60632,445,0,0,drop,66,66,0,1,0,1,0
54019,445,0,0,drop,70,70,0,1,0,1,0
53722,443,25032,443,allow,499,425,74,4,0,3,1
49889,445,0,0,drop,66,66,0,1,0,1,0
62569,44847,0,0,deny,66,66,0,1,0,1,0
50946,80,36199,80,allow,5870176,83236,5786940,5053,78,1161,3892
64544,445,0,0,drop,70,70,0,1,0,1,0
26882,443,64713,443,allow,10633,2672,7961,31,20,16,15
59846,445,0,0,drop,66,66,0,1,0,1,0
12830,25174,0,0,deny,62,62,0,1,0,1,0
56314,53,50014,53,allow,183,94,89,2,30,1,1
27328,21247,0,0,deny,66,66,0,1,0,1,0
63050,57470,0,0,deny,74,74,0,1,0,1,0
61181,445,0,0,drop,70,70,0,1,0,1,0
37611,443,31494,443,allow,3936,1618,2318,26,146,14,12
3478,61463,0,0,deny,252,252,0,1,0,1,0
54180,445,0,0,drop,70,70,0,1,0,1,0
62497,445,0,0,drop,70,70,0,1,0,1,0
50320,53,19368,53,allow,754,94,660,2,29,1,1
65233,23117,0,0,deny,66,66,0,1,0,1,0
62648,445,0,0,drop,70,70,0,1,0,1,0
26969,29434,0,0,deny,146,146,0,1,0,1,0
56944,35894,0,0,deny,62,62,0,1,0,1,0
42821,53,25927,53,allow,168,78,90,2,30,1,1
45908,33330,0,0,deny,60,60,0,1,0,1,0
34490,443,47026,443,allow,584,370,214,9,26,6,3
64376,445,0,0,drop,66,66,0,1,0,1,0
51505,17372,0,0,deny,62,62,0,1,0,1,0
60177,445,0,0,drop,66,66,0,1,0,1,0
54928,8245,11083,8245,allow,280,214,66,2,30,1,1
57418,443,37526,443,allow,29994,1927,28067,50,20,17,33
42389,42873,0,0,deny,74,74,0,1,0,1,0
57752,445,0,0,drop,70,70,0,1,0,1,0
63703,445,0,0,drop,70,70,0,1,0,1,0
60993,443,45715,443,allow,7201,2107,5094,23,61,13,10
47521,53,9404,53,allow,198,93,105,2,30,1,1
61767,25174,0,0,deny,62,62,0,1,0,1,0
57587,80,57587,80,allow,218150,5323,212827,218,145,69,149
57148,23,0,0,deny,60,60,0,1,0,1,0
54924,3478,47718,3478,allow,312,140,172,4,30,2,2
40495,53,8395,53,allow,168,78,90,2,29,1,1
59818,443,31542,443,allow,1401,864,537,12,29,6,6
55147,445,0,0,drop,70,70,0,1,0,1,0
64428,53,57120,53,allow,190,97,93,2,31,1,1
64455,53,64455,53,allow,257,101,156,2,33,1,1
49319,53,4413,53,allow,199,94,105,2,30,1,1
53772,14132,16590,14132,allow,70,70,0,2,8,2,0
61443,445,0,0,drop,70,70,0,1,0,1,0
50506,10214,0,0,deny,66,66,0,1,0,1,0
64428,53,26819,53,allow,299,97,202,4,44,2,2
49380,53,7490,53,allow,110,110,0,1,30,1,0
63672,22114,0,0,deny,62,62,0,1,0,1,0
54782,445,0,0,drop,70,70,0,1,0,1,0
17916,48817,0,0,deny,148,148,0,1,0,1,0
36314,443,44182,443,allow,6287,1476,4811,25,16,13,12
50265,15402,25420,15402,allow,1450,747,703,16,1200,9,7
59069,445,0,0,drop,70,70,0,1,0,1,0
53328,443,21893,443,allow,4670,2814,1856,33,81,15,18
50584,16526,25996,16526,allow,166,166,0,1,1199,1,0
46980,443,8668,443,allow,7633,5620,2013,31,60,19,12
34154,443,26354,443,allow,45554,1695,43859,50,30,15,35
49881,53,28793,53,allow,395,102,293,2,30,1,1
49341,53,21121,53,allow,392,86,306,2,29,1,1
51505,445,0,0,drop,66,66,0,1,0,1,0
23710,41615,0,0,deny,145,145,0,1,0,1,0
51807,445,0,0,drop,70,70,0,1,0,1,0
33264,53,24560,53,allow,164,78,86,2,30,1,1
61337,443,54439,443,allow,31111,6287,24824,62,247,25,37
57991,53,26816,53,allow,220,78,142,2,30,1,1
56699,80,7390,80,allow,64386,3122,61264,79,64,35,44
57571,443,57571,443,allow,881747,19604,862143,728,175,144,584
56919,53,19863,53,allow,186,95,91,2,31,1,1
65026,53,61151,53,allow,194,102,92,2,29,1,1
56673,53,26407,53,allow,193,102,91,2,30,1,1
6712,123,0,0,deny,90,90,0,1,0,1,0
54260,443,6069,443,allow,5904,1876,4028,18,18,10,8
50198,445,0,0,drop,70,70,0,1,0,1,0
59514,445,0,0,drop,66,66,0,1,0,1,0
57664,53,41830,53,allow,168,78,90,2,30,1,1
60951,53,52563,53,allow,164,78,86,2,29,1,1
56273,53,28560,53,allow,183,94,89,2,30,1,1
57442,445,0,0,drop,70,70,0,1,0,1,0
11136,19910,0,0,deny,62,62,0,1,0,1,0
63670,11648,33474,11648,allow,4501,3174,1327,26,61,16,10
48634,443,39947,443,allow,448,78,370,6,25,1,5
50025,53,33178,53,allow,761,102,659,2,30,1,1
53529,17130,52813,17130,allow,492,306,186,8,15,5,3
56549,443,22340,443,allow,13979,2593,11386,29,114,11,18
60709,445,0,0,drop,70,70,0,1,0,1,0
57208,53,39529,53,allow,183,94,89,2,30,1,1
63150,443,63150,443,allow,6792,1521,5271,18,28,11,7
55333,123,5768,123,allow,184,94,90,2,30,1,1
53108,445,0,0,drop,70,70,0,1,0,1,0
63047,445,0,0,drop,70,70,0,1,0,1,0
51463,53,6551,53,allow,417,86,331,2,31,1,1
27448,5222,60213,5222,allow,8039,1649,6390,41,357,13,28
50958,53,30226,53,allow,264,264,0,4,47,4,0
14613,12446,0,0,deny,66,66,0,1,0,1,0
63260,445,0,0,drop,70,70,0,1,0,1,0
58621,53,5007,53,allow,256,94,162,2,29,1,1
58638,5900,0,0,deny,62,62,0,1,0,1,0
56431,53,28557,53,allow,177,94,83,2,31,1,1
56318,53,47693,53,allow,183,94,89,2,31,1,1
25565,43088,0,0,deny,60,60,0,1,0,1,0
61933,445,0,0,drop,70,70,0,1,0,1,0
61989,445,0,0,drop,70,70,0,1,0,1,0
52914,443,10656,443,allow,70,70,0,1,5,1,0
62696,50584,0,0,deny,66,66,0,1,0,1,0
49702,53,29408,53,allow,771,102,669,2,31,1,1
57007,53,5847,53,allow,183,94,89,2,30,1,1
53922,445,0,0,drop,70,70,0,1,0,1,0
46619,57470,0,0,deny,62,62,0,1,0,1,0
51894,445,0,0,drop,70,70,0,1,0,1,0
21641,51505,0,0,deny,62,62,0,1,0,1,0
51917,26077,25405,26077,allow,70,70,0,1,5,1,0
50409,445,0,0,drop,66,66,0,1,0,1,0
63651,443,19234,443,allow,333668,12291,321377,321,170,72,249
62400,445,0,0,drop,70,70,0,1,0,1,0
49783,445,0,0,drop,66,66,0,1,0,1,0
60568,445,0,0,drop,66,66,0,1,0,1,0
38770,5228,21583,5228,allow,6033,1874,4159,33,4073,11,22
57385,53,56308,53,allow,197,102,95,2,30,1,1
62729,51558,61898,51558,allow,70,70,0,1,4,1,0
54238,445,0,0,drop,70,70,0,1,0,1,0
53702,51413,14183,51413,allow,70,70,0,2,7,2,0
23331,53,23331,53,allow,242,98,144,2,30,1,1
54892,443,40724,443,allow,602278,26008,576270,748,396,317,431
42298,40016,13493,40016,allow,148,86,62,2,30,1,1
55481,445,0,0,drop,66,66,0,1,0,1,0
65060,35440,0,0,deny,66,66,0,1,0,1,0
56458,445,0,0,drop,70,70,0,1,0,1,0
51919,80,35345,80,allow,16004,8270,7734,32,57,17,15
36548,25174,0,0,deny,62,62,0,1,0,1,0
49418,27015,22086,27015,allow,78,78,0,1,30,1,0
32346,53,32346,53,allow,200,90,110,2,30,1,1
49267,53,29003,53,allow,184,94,90,2,30,1,1
37738,443,40273,443,allow,296068,21814,274254,358,206,150,208
64852,53,7184,53,allow,248,102,146,2,29,1,1
7308,50584,0,0,deny,62,62,0,1,0,1,0
61491,445,0,0,drop,66,66,0,1,0,1,0
36776,80,31947,80,allow,16274,9170,7104,34,32,19,15
50659,443,57690,443,allow,7128,2589,4539,25,37,15,10
56727,53,56099,53,allow,168,86,82,3,50,2,1
49171,53,6707,53,allow,199,102,97,2,30,1,1
51877,53,28972,53,allow,254,78,176,2,29,1,1
64029,443,14573,443,allow,252,70,182,3,120,1,2
53775,8999,38559,8999,allow,320,140,180,6,5,3,3
57076,5222,34364,5222,allow,15600,7789,7811,155,169,82,73
55536,445,0,0,drop,70,70,0,1,0,1,0
58791,15503,0,0,deny,66,66,0,1,0,1,0
57445,445,0,0,drop,70,70,0,1,0,1,0
27005,27013,41883,27013,allow,879,126,753,2,30,1,1
50130,53,58704,53,allow,183,94,89,2,29,1,1
46912,53,4234,53,allow,168,78,90,2,30,1,1
54891,80,41573,80,allow,1222,782,440,11,15,6,5
38592,57209,0,0,deny,62,62,0,1,0,1,0
65366,53,59432,53,allow,199,102,97,2,31,1,1
57298,445,0,0,drop,66,66,0,1,0,1,0
53122,443,60812,443,allow,12409,2224,10185,36,26,19,17
50520,443,34844,443,allow,9942,1211,8731,26,77,14,12
65513,53,51212,53,allow,216,102,114,2,30,1,1
36682,443,16201,443,allow,4590,3104,1486,25,95,14,11
51980,80,2288,80,allow,366,240,126,7,25,5,2
52409,443,39608,443,allow,1369,708,661,14,24,8,6
50570,80,64078,80,allow,318,192,126,6,26,4,2
42441,123,34753,123,allow,184,94,90,2,30,1,1
62002,445,0,0,drop,70,70,0,1,0,1,0
65140,53,5924,53,allow,774,101,673,2,31,1,1
16052,25174,0,0,deny,146,146,0,1,0,1,0
53747,21698,30276,21698,allow,320,140,180,6,7,3,3
62042,445,0,0,drop,66,66,0,1,0,1,0
62232,445,0,0,drop,70,70,0,1,0,1,0
51446,53,21490,53,allow,168,78,90,2,30,1,1
57271,53,1300,53,allow,228,102,126,2,30,1,1
64403,53,23409,53,allow,193,102,91,2,30,1,1
64674,53,50248,53,allow,183,94,89,2,29,1,1
4773,53,4773,53,allow,197,90,107,2,30,1,1
64883,53,45539,53,allow,292,94,198,4,57,2,2
39953,80,18059,80,allow,1035,564,471,10,15,5,5
52870,22197,0,0,deny,62,62,0,1,0,1,0
38688,443,23677,443,allow,90166,3481,86685,96,16,31,65
56872,21247,0,0,deny,74,74,0,1,0,1,0
50743,445,0,0,drop,70,70,0,1,0,1,0
45405,161,0,0,allow,5858,2302,3556,22,30,11,11
55489,53,35095,53,allow,177,94,83,2,30,1,1
50811,443,33324,443,allow,2719275,48822,2670453,2459,127,689,1770
50878,23,0,0,deny,60,60,0,1,0,1,0
64808,27098,0,0,deny,66,66,0,1,0,1,0
50453,445,0,0,drop,66,66,0,1,0,1,0
55087,443,24413,443,allow,101356,10743,90613,178,31,90,88
13235,44847,0,0,deny,66,66,0,1,0,1,0
33062,17,0,0,deny,60,60,0,1,0,1,0
65341,53,20700,53,allow,200,102,98,2,30,1,1
49509,443,14742,443,allow,17660,7465,10195,44,201,23,21
55428,445,0,0,drop,70,70,0,1,0,1,0
64310,53,12682,53,allow,404,102,302,2,30,1,1
44612,25174,0,0,deny,66,66,0,1,0,1,0
61295,443,30551,443,allow,134322,10347,123975,220,304,77,143
45239,443,9489,443,allow,11147,3412,7735,36,458,20,16
53821,443,22487,443,allow,499,425,74,4,0,3,1
49529,445,0,0,drop,70,70,0,1,0,1,0
62339,25174,0,0,deny,66,66,0,1,0,1,0
51374,30317,0,0,deny,66,66,0,1,0,1,0
55156,445,0,0,drop,70,70,0,1,0,1,0
35915,80,21762,80,allow,1283,644,639,9,146,5,4
64870,53,51566,53,allow,200,102,98,2,30,1,1
443,58101,0,0,deny,60,60,0,1,0,1,0
59227,445,0,0,drop,70,70,0,1,0,1,0
59416,445,0,0,drop,70,70,0,1,0,1,0
59057,445,0,0,drop,70,70,0,1,0,1,0
60419,33709,17912,33709,allow,504,318,186,8,16,5,3
61477,443,48304,443,allow,30516,3311,27205,49,47,25,24
49875,53,45365,53,allow,445,94,351,2,30,1,1
56375,53,7555,53,allow,216,110,106,2,31,1,1
49692,53,65365,53,allow,212,110,102,2,30,1,1
10333,22114,0,0,deny,146,146,0,1,0,1,0
56778,35440,0,0,deny,66,66,0,1,0,1,0
53138,445,0,0,drop,70,70,0,1,0,1,0
65283,445,0,0,drop,70,70,0,1,0,1,0
6881,6881,0,0,deny,146,146,0,1,0,1,0
27005,26258,3792,26258,allow,886,126,760,2,31,1,1
60337,30188,0,0,deny,66,66,0,1,0,1,0
64374,53,45440,53,allow,239,102,137,2,30,1,1
64573,53,51074,53,allow,184,94,90,2,30,1,1
50143,35253,0,0,deny,62,62,0,1,0,1,0
53197,25174,0,0,deny,66,66,0,1,0,1,0
6889,45850,0,0,reset-both,143,143,0,1,0,1,0
49627,445,0,0,drop,70,70,0,1,0,1,0
65283,53,18469,53,allow,732,89,643,2,30,1,1
53574,443,38690,443,allow,117116,5692,111424,153,18,56,97
19987,53,54747,53,allow,208,86,122,2,30,1,1
52404,443,21006,443,allow,132575,6675,125900,206,94,91,115
10265,64147,0,0,deny,62,62,0,1,0,1,0
54277,445,0,0,drop,70,70,0,1,0,1,0
58638,5900,0,0,deny,62,62,0,1,0,1,0
5223,14446,0,0,deny,167,167,0,1,0,1,0
3478,61463,0,0,deny,180,180,0,1,0,1,0
55525,53,3773,53,allow,214,110,104,2,30,1,1
63083,25174,0,0,deny,62,62,0,1,0,1,0
55624,53,27462,53,allow,701,88,613,2,30,1,1
55021,443,43787,443,allow,6724,3642,3082,18,133,10,8
63044,443,58831,443,allow,512,166,346,2,30,1,1
52098,445,0,0,drop,70,70,0,1,0,1,0
65344,53,8855,53,allow,180,94,86,2,35,1,1
52626,44847,0,0,deny,62,62,0,1,0,1,0
63325,445,0,0,drop,66,66,0,1,0,1,0
16387,22272,0,0,deny,60,60,0,1,0,1,0
50265,41198,60886,41198,allow,330,330,0,6,1200,6,0
64314,53,49422,53,allow,319,126,193,2,30,1,1
64380,53,22158,53,allow,193,102,91,2,29,1,1
58101,445,0,0,drop,66,66,0,1,0,1,0
65314,53,60905,53,allow,402,118,284,2,30,1,1
55698,53,13157,53,allow,742,88,654,2,31,1,1
58182,445,0,0,drop,70,70,0,1,0,1,0
50108,53,40711,53,allow,179,94,85,2,30,1,1
54990,53,62190,53,allow,166,86,80,2,29,1,1
58836,443,33212,443,allow,383990,15580,368410,490,212,192,298
64537,53,37078,53,allow,168,86,82,2,30,1,1
57154,445,0,0,drop,70,70,0,1,0,1,0
56385,53,22600,53,allow,249,85,164,4,55,2,2
64976,53,22301,53,allow,186,95,91,2,31,1,1
56247,53,34021,53,allow,751,95,656,2,30,1,1
59853,445,0,0,drop,66,66,0,1,0,1,0
5617,64147,0,0,deny,62,62,0,1,0,1,0
22981,15503,0,0,deny,62,62,0,1,0,1,0
58001,445,0,0,drop,70,70,0,1,0,1,0
52003,44512,0,0,deny,66,66,0,1,0,1,0
61203,445,0,0,drop,70,70,0,1,0,1,0
57900,443,44556,443,allow,1798,1159,639,17,170,10,7
1934,53,51604,53,allow,210,78,132,2,30,1,1
49264,443,65214,443,allow,2424,258,2166,9,120,4,5
55095,53,40942,53,allow,194,102,92,2,30,1,1
56201,445,0,0,drop,70,70,0,1,0,1,0
56323,445,0,0,drop,66,66,0,1,0,1,0
50733,445,0,0,drop,66,66,0,1,0,1,0
55056,53,38233,53,allow,177,94,83,2,29,1,1
27005,52013,16949,52013,allow,901,126,775,2,30,1,1
56101,57470,0,0,deny,66,66,0,1,0,1,0
2467,2767,0,0,deny,62,62,0,1,0,1,0
58676,443,61726,443,allow,6144,939,5205,18,70,9,9
55546,53,22275,53,allow,1417,96,1321,4,30,2,2
52145,36670,58227,36670,allow,316,136,180,6,6,3,3
57470,47191,13630,47191,allow,528,528,0,9,1200,9,0
38113,443,46610,443,allow,2849678,105912,2743766,3255,124,1284,1971
51220,443,53814,443,allow,7647,1917,5730,22,80,13,9
45020,443,16879,443,allow,2293,1592,701,16,21,8,8
47180,443,38596,443,allow,6007,1727,4280,27,1128,15,12
53799,445,0,0,drop,70,70,0,1,0,1,0
55364,53,21776,53,allow,168,86,82,2,31,1,1
39548,8696,0,0,deny,60,60,0,1,0,1,0
49340,53,43709,53,allow,94,94,0,1,30,1,0
59943,443,41706,443,allow,2979,914,2065,10,120,5,5
46507,443,10914,443,allow,7068,2016,5052,32,18,17,15
58155,445,0,0,drop,70,70,0,1,0,1,0
60453,22114,0,0,deny,146,146,0,1,0,1,0
53571,19636,6508,19636,allow,70,70,0,1,4,1,0
4009,53,4009,53,allow,231,88,143,2,33,1,1
49995,53,4642,53,allow,99,99,0,1,30,1,0
64683,53,6623,53,allow,168,78,90,2,30,1,1
56659,443,25934,443,allow,1579,988,591,13,24,7,6
53912,26467,0,0,deny,66,66,0,1,0,1,0
46351,53,46351,53,allow,262,106,156,2,31,1,1
55310,53,54071,53,allow,180,94,86,2,30,1,1
64755,445,0,0,drop,70,70,0,1,0,1,0
9457,443,13669,443,allow,5316,488,4828,14,15,7,7
11076,53,11076,53,allow,832,106,726,2,30,1,1
56710,53,57885,53,allow,177,94,83,2,30,1,1
61939,443,12700,443,allow,3698,1049,2649,13,135,6,7
52824,443,36459,443,allow,7118,2239,4879,22,15,12,10
53356,445,0,0,drop,70,70,0,1,0,1,0
65373,53,2835,53,allow,197,102,95,2,30,1,1
49987,445,0,0,drop,70,70,0,1,0,1,0
61154,445,0,0,drop,66,66,0,1,0,1,0
56166,53,15271,53,allow,193,102,91,2,30,1,1
62345,445,0,0,drop,66,66,0,1,0,1,0
43055,80,43055,80,allow,1246,533,713,10,20,5,5
55131,53,48118,53,allow,744,95,649,2,30,1,1
49183,53,55748,53,allow,177,94,83,2,30,1,1
49345,80,49345,80,allow,450,246,204,8,142,5,3
45558,443,51093,443,allow,6450,1003,5447,21,360,11,10
58880,443,32825,443,allow,1413,876,537,12,11,6,6
61550,5529,0,0,deny,145,145,0,1,0,1,0
60226,445,0,0,drop,66,66,0,1,0,1,0
49235,53,43539,53,allow,164,78,86,2,29,1,1
56707,443,1984,443,allow,5928,1558,4370,22,20,13,9
55385,53,61909,53,allow,710,89,621,2,0,1,1
50757,80,50757,80,allow,514,246,268,9,42,5,4
49889,53,17299,53,allow,194,99,95,2,30,1,1
53966,57470,0,0,deny,62,62,0,1,0,1,0
50198,443,55477,443,allow,29124,1724,27400,41,160,16,25
53273,445,0,0,drop,70,70,0,1,0,1,0
55154,53,39546,53,allow,184,94,90,2,30,1,1
35336,443,36436,443,allow,6821,1076,5745,21,27,12,9
56456,445,0,0,drop,70,70,0,1,0,1,0
56358,53,16023,53,allow,104,104,0,1,30,1,0
51587,445,0,0,drop,70,70,0,1,0,1,0
42298,40024,27133,40024,allow,207,85,122,4,29,2,2
61543,445,0,0,drop,70,70,0,1,0,1,0
56289,25174,0,0,deny,66,66,0,1,0,1,0
56000,53,42944,53,allow,177,94,83,2,30,1,1
50085,80,7079,80,allow,3326,684,2642,12,15,7,5
4447,35440,0,0,deny,66,66,0,1,0,1,0
50327,1433,0,0,deny,60,60,0,1,0,1,0
50770,443,41782,443,allow,6350,1369,4981,18,151,9,9
56723,53,3556,53,allow,198,94,104,2,30,1,1
50197,445,0,0,drop,70,70,0,1,0,1,0
55072,53,28531,53,allow,177,94,83,2,30,1,1
52358,30188,0,0,deny,66,66,0,1,0,1,0
64076,53,25451,53,allow,255,102,153,2,30,1,1
56822,39352,35185,39352,allow,70,70,0,1,5,1,0
53237,445,0,0,drop,70,70,0,1,0,1,0
14869,44847,0,0,deny,62,62,0,1,0,1,0
58638,5900,0,0,deny,62,62,0,1,0,1,0
49200,38001,36048,38001,allow,70,70,0,2,8,2,0
64273,53,36287,53,allow,239,94,145,2,30,1,1
60671,445,0,0,drop,70,70,0,1,0,1,0
57204,53,62909,53,allow,195,102,93,2,31,1,1
45461,25174,0,0,deny,62,62,0,1,0,1,0
51667,21391,14607,21391,allow,1345,679,666,9,30,5,4
50827,443,7368,443,allow,388366,15919,372447,435,219,158,277
11988,48817,0,0,deny,66,66,0,1,0,1,0
60260,22114,0,0,deny,66,66,0,1,0,1,0
51511,445,0,0,drop,66,66,0,1,0,1,0
57030,445,0,0,drop,66,66,0,1,0,1,0
59339,80,59339,80,allow,107838,4143,103695,178,15,59,119
55932,53,42862,53,allow,193,102,91,2,30,1,1
56207,53,7940,53,allow,761,100,661,2,31,1,1
51717,63436,58721,63436,allow,66,66,0,1,5,1,0
49759,53,16085,53,allow,216,110,106,2,29,1,1
40808,53,41572,53,allow,168,78,90,2,29,1,1
53558,445,0,0,drop,66,66,0,1,0,1,0
49775,80,20586,80,allow,1302,849,453,10,126,6,4
62364,445,0,0,drop,70,70,0,1,0,1,0
60894,445,0,0,drop,66,66,0,1,0,1,0
52868,80,24153,80,allow,54968,1915,53053,71,125,24,47
1594,44847,0,0,deny,62,62,0,1,0,1,0
54993,445,0,0,drop,70,70,0,1,0,1,0
40204,40010,8959,40010,allow,148,86,62,2,29,1,1
12596,53,12596,53,allow,197,90,107,2,30,1,1
15018,37965,0,0,deny,62,62,0,1,0,1,0
35374,443,7317,443,allow,1558,971,587,14,123,8,6
55871,53,54072,53,allow,189,102,87,2,30,1,1
6882,27032,16689,27032,allow,1200,1200,0,9,1201,9,0
61470,443,10942,443,allow,12420,4900,7520,47,88,24,23
1025,35447,0,0,deny,62,62,0,1,0,1,0
51607,53,31669,53,allow,284,86,198,2,30,1,1
48706,23393,0,0,deny,60,60,0,1,0,1,0
30303,30303,0,0,deny,181,181,0,1,0,1,0
56730,443,7897,443,allow,347884,9284,338600,360,31,125,235
52210,443,33908,443,allow,6294,1716,4578,27,23,16,11
55101,53,3206,53,allow,711,87,624,2,30,1,1
64966,27051,35392,27051,allow,736,462,274,2,30,1,1
52123,1433,0,0,deny,60,60,0,1,0,1,0
54624,445,0,0,drop,70,70,0,1,0,1,0
47342,20541,0,0,deny,66,66,0,1,0,1,0
34415,443,34473,443,allow,6397,1590,4807,23,315,12,11
56649,53,31076,53,allow,168,94,74,2,30,1,1
1046,48817,0,0,deny,62,62,0,1,0,1,0
61559,53,9585,53,allow,376,86,290,2,29,1,1
59096,57866,0,0,deny,62,62,0,1,0,1,0
51914,5222,1180,5222,allow,5141,2331,2810,41,144,24,17
50919,443,47767,443,allow,6412,1370,5042,19,129,9,10
64398,53,23095,53,allow,181,86,95,2,29,1,1
42298,40014,17083,40014,allow,216,94,122,4,29,2,2
51462,445,0,0,drop,70,70,0,1,0,1,0
37567,443,40594,443,allow,149229,139639,9590,226,256,124,102
7360,14914,0,0,deny,157,157,0,1,0,1,0
60095,443,60308,443,allow,2357,1467,890,15,140,8,7
64334,53,61866,53,allow,311,94,217,2,30,1,1
29805,53,29805,53,allow,226,89,137,2,30,1,1
47632,25174,0,0,deny,62,62,0,1,0,1,0
49831,30188,0,0,deny,62,62,0,1,0,1,0
36561,2767,0,0,deny,62,62,0,1,0,1,0
57176,445,0,0,drop,66,66,0,1,0,1,0
37151,80,11771,80,allow,130,70,60,2,15,1,1
59486,50584,0,0,deny,62,62,0,1,0,1,0
65276,445,0,0,drop,70,70,0,1,0,1,0
1024,57470,0,0,deny,62,62,0,1,0,1,0
52198,12727,17212,12727,allow,70,70,0,1,5,1,0
50789,445,0,0,drop,66,66,0,1,0,1,0
55650,53,4298,53,allow,179,94,85,2,29,1,1
55237,53,13670,53,allow,259,87,172,4,56,2,2
59214,445,0,0,drop,70,70,0,1,0,1,0
52169,80,44471,80,allow,362,240,122,7,17,5,2
56580,443,55118,443,allow,2343,1296,1047,17,196,10,7
55937,445,0,0,drop,66,66,0,1,0,1,0
59336,445,0,0,drop,66,66,0,1,0,1,0
56131,53,25151,53,allow,245,94,151,2,30,1,1
54225,53,12389,53,allow,274,78,196,2,30,1,1
49177,53,27104,53,allow,184,94,90,2,30,1,1
59245,445,0,0,drop,70,70,0,1,0,1,0
53753,445,0,0,drop,66,66,0,1,0,1,0
32132,25174,0,0,deny,66,66,0,1,0,1,0
64727,443,24002,443,allow,18620,15824,2796,31,129,18,13
1024,57470,0,0,deny,72,72,0,1,0,1,0
50644,5222,32859,5222,allow,11661,4442,7219,87,71,41,46
59733,445,0,0,drop,66,66,0,1,0,1,0
52647,445,0,0,drop,66,66,0,1,0,1,0
53543,44847,0,0,deny,62,62,0,1,0,1,0
63486,445,0,0,drop,70,70,0,1,0,1,0
54553,53,37407,53,allow,102,102,0,1,30,1,0
19747,37965,0,0,deny,62,62,0,1,0,1,0
61455,443,28409,443,allow,8947,1130,7817,28,124,13,15
32864,53,32864,53,allow,404,259,145,3,32,2,1
62415,53,11045,53,allow,86,86,0,2,31,2,0
61953,443,64547,443,allow,15246,5574,9672,60,391,27,33
58638,5900,0,0,deny,62,62,0,1,0,1,0
56892,53,51389,53,allow,199,102,97,2,31,1,1
9377,56205,0,0,deny,66,66,0,1,0,1,0
62787,51221,0,0,deny,66,66,0,1,0,1,0
50694,80,5032,80,allow,54760,27837,26923,229,175,114,115
48681,80,45826,80,allow,918,461,457,9,15,6,3
64473,53,45476,53,allow,184,94,90,2,30,1,1
51132,80,62444,80,allow,426,240,186,8,21,5,3
56148,37965,0,0,deny,66,66,0,1,0,1,0
62874,445,0,0,drop,70,70,0,1,0,1,0
48706,23393,0,0,deny,60,60,0,1,0,1,0
51185,37965,0,0,deny,62,62,0,1,0,1,0
17750,7579,37146,7579,allow,490,149,341,2,1200,1,1
53872,443,4533,443,allow,11541,4181,7360,62,283,27,35
64413,53,4808,53,allow,209,102,107,2,30,1,1
49340,443,62697,443,allow,7492336,235716,7256620,8119,428,3022,5097
52760,445,0,0,drop,70,70,0,1,0,1,0
64450,53,63147,53,allow,196,94,102,2,31,1,1
59697,80,58873,80,allow,5326946,116544,5210402,5175,111,1695,3480
45121,15000,17487,15000,allow,130,70,60,2,5,1,1
49700,443,6522,443,allow,39240,3804,35436,72,133,38,34
51774,29434,0,0,deny,146,146,0,1,0,1,0
58638,5900,0,0,deny,62,62,0,1,0,1,0
63836,14791,9109,14791,allow,66,66,0,2,7,2,0
56598,443,16755,443,allow,8630,2126,6504,20,15,11,9
64122,53,46704,53,allow,255,102,153,2,30,1,1
54649,445,0,0,drop,70,70,0,1,0,1,0
53959,445,0,0,drop,66,66,0,1,0,1,0
3407,57866,0,0,deny,66,66,0,1,0,1,0
52936,445,0,0,drop,66,66,0,1,0,1,0
54365,443,56544,443,allow,3970,1726,2244,13,134,6,7
57643,28189,0,0,deny,60,60,0,1,0,1,0
52663,445,0,0,drop,70,70,0,1,0,1,0
55089,80,46073,80,allow,1558,452,1106,11,15,6,5
49817,53,12075,53,allow,167,86,81,2,30,1,1
12260,51505,0,0,deny,62,62,0,1,0,1,0
31235,22114,0,0,deny,62,62,0,1,0,1,0
52212,51343,7428,51343,allow,70,70,0,1,5,1,0
4232,50584,0,0,deny,66,66,0,1,0,1,0
61350,445,0,0,drop,70,70,0,1,0,1,0
56260,53,39887,53,allow,170,87,83,2,31,1,1
58972,57866,0,0,deny,62,62,0,1,0,1,0
64837,53,23710,53,allow,196,94,102,2,30,1,1
58909,445,0,0,drop,70,70,0,1,0,1,0
11136,15503,0,0,deny,145,145,0,1,0,1,0
63793,53,63793,53,allow,237,91,146,2,33,1,1
64810,53,65205,53,allow,272,93,179,4,32,2,2
49396,443,4932,443,allow,1394,733,661,14,80,8,6
64011,53,63004,53,allow,228,110,118,2,29,1,1
62936,445,0,0,drop,70,70,0,1,0,1,0
64835,53,59630,53,allow,179,94,85,2,30,1,1
55820,53,6966,53,allow,168,86,82,2,31,1,1
64463,53,17671,53,allow,183,94,89,2,30,1,1
59734,5900,0,0,deny,60,60,0,1,0,1,0
27313,53,27313,53,allow,194,87,107,2,31,1,1
58014,443,11079,443,allow,5528,3392,2136,31,80,16,15
53585,43611,54963,43611,allow,612,306,306,10,15,5,5
60367,443,5802,443,allow,12979,6398,6581,39,115,22,17
6666,401,0,0,deny,60,60,0,1,0,1,0
46025,80,38311,80,allow,5037,1911,3126,18,86,10,8
60261,53,9176,53,allow,233,81,152,2,31,1,1
58638,5900,0,0,deny,62,62,0,1,0,1,0
48729,443,23852,443,allow,8504354,221135,8283219,8447,196,2721,5726
56927,53,57010,53,allow,749,94,655,2,31,1,1
54099,445,0,0,drop,70,70,0,1,0,1,0
60908,445,0,0,drop,70,70,0,1,0,1,0
55837,53,32132,53,allow,195,102,93,2,30,1,1
28897,35440,0,0,deny,62,62,0,1,0,1,0
37603,443,61350,443,allow,573,425,148,5,1,3,2
49846,80,53092,80,allow,2644,1918,726,11,89,7,4
61662,445,0,0,drop,70,70,0,1,0,1,0
48632,443,58774,443,allow,12433,4515,7918,32,136,17,15
45410,1,0,0,deny,62,62,0,1,0,1,0
50523,445,0,0,drop,70,70,0,1,0,1,0
6889,65473,0,0,deny,143,143,0,1,0,1,0
23415,11392,0,0,deny,66,66,0,1,0,1,0
56688,443,37544,443,allow,32780,6864,25916,142,345,57,85
55399,53,7515,53,allow,176,90,86,2,31,1,1
44847,46972,13667,46972,allow,150,150,0,1,1200,1,0
55979,53,33606,53,allow,193,102,91,2,30,1,1
56504,53,9210,53,allow,195,94,101,2,30,1,1
51628,445,0,0,drop,66,66,0,1,0,1,0
49785,445,0,0,drop,66,66,0,1,0,1,0
53247,445,0,0,drop,70,70,0,1,0,1,0
39036,443,62520,443,allow,1768,541,1227,11,20,7,4
38815,53,38815,53,allow,230,99,131,2,30,1,1
51470,445,0,0,drop,70,70,0,1,0,1,0
56186,53,56186,53,allow,233,98,135,2,30,1,1
52651,53,52651,53,allow,414,268,146,3,31,2,1
40611,9571,0,0,deny,72,72,0,1,0,1,0
63740,445,0,0,drop,70,70,0,1,0,1,0
43514,443,45895,443,allow,9643,2462,7181,26,146,11,15
1030,44847,0,0,deny,146,146,0,1,0,1,0
38144,443,38144,443,allow,14849,2263,12586,29,90,17,12
51812,445,0,0,drop,66,66,0,1,0,1,0
56142,53,19071,53,allow,194,102,92,2,29,1,1
57583,443,57583,443,allow,2512,1466,1046,21,87,10,11
34416,443,50099,443,allow,6396,1589,4807,23,315,12,11
19875,30170,0,0,deny,145,145,0,1,0,1,0
57093,26467,0,0,deny,66,66,0,1,0,1,0
53389,23,0,0,deny,60,60,0,1,0,1,0
26900,27017,49129,27017,allow,422,164,258,6,30,3,3
28136,443,42266,443,allow,8805,3429,5376,33,475,16,17
39039,443,4727,443,allow,572,292,280,9,32,5,4
55014,443,4277,443,allow,4962,1352,3610,19,135,9,10
59106,443,57756,443,allow,7398,2209,5189,23,35,11,12
55257,53,9976,53,allow,749,89,660,2,30,1,1
51856,445,0,0,drop,70,70,0,1,0,1,0
51829,46209,37314,46209,allow,70,70,0,2,6,2,0
43130,443,2379,443,allow,207714,9731,197983,267,193,120,147
26406,37965,0,0,deny,66,66,0,1,0,1,0
56364,53,33489,53,allow,308,94,214,2,30,1,1
58286,37965,0,0,deny,66,66,0,1,0,1,0
63266,445,0,0,drop,70,70,0,1,0,1,0
54326,7000,54326,7000,allow,2958,1567,1391,15,15,8,7
51766,443,63491,443,allow,5462,1305,4157,22,121,10,12
55774,8060,26633,8060,allow,70,70,0,2,8,2,0
49752,50584,0,0,deny,62,62,0,1,0,1,0
16387,3655,0,0,deny,60,60,0,1,0,1,0
30303,30303,0,0,deny,181,181,0,1,0,1,0
51609,445,0,0,drop,70,70,0,1,0,1,0
40474,23117,0,0,deny,62,62,0,1,0,1,0
53542,9192,0,0,deny,148,148,0,1,0,1,0
61489,443,14014,443,allow,7299,4561,2738,32,193,16,16
65209,53,6472,53,allow,164,84,80,2,31,1,1
64382,44847,0,0,deny,66,66,0,1,0,1,0
51118,80,35500,80,allow,366,240,126,7,21,5,2
51775,57887,60310,57887,allow,70,70,0,2,8,2,0
29697,51221,0,0,deny,62,62,0,1,0,1,0
50078,445,0,0,drop,70,70,0,1,0,1,0
49414,53,16481,53,allow,770,102,668,2,31,1,1
61411,80,31645,80,allow,145440,11034,134406,292,158,135,157
57287,443,20277,443,allow,8960,2778,6182,31,20,16,15
52559,443,18708,443,allow,4479,2526,1953,10,120,6,4
64217,53,31853,53,allow,193,102,91,2,29,1,1
61730,25320,0,0,deny,66,66,0,1,0,1,0
50358,80,31825,80,allow,318,192,126,6,28,4,2
56583,445,0,0,drop,66,66,0,1,0,1,0
49627,53,55437,53,allow,760,97,663,2,30,1,1
58230,64147,0,0,deny,66,66,0,1,0,1,0
60805,20010,5973,20010,allow,70,70,0,1,5,1,0
44847,15315,12919,15315,allow,150,150,0,1,1200,1,0
60383,445,0,0,drop,66,66,0,1,0,1,0
58036,443,9162,443,allow,12752,5123,7629,39,90,18,21
51211,443,40776,443,allow,7638,2405,5233,44,17,25,19
62579,57866,0,0,deny,66,66,0,1,0,1,0
53678,443,40421,443,allow,6697,1606,5091,23,24,13,10
50137,53,58176,53,allow,183,94,89,2,29,1,1
53880,443,53880,443,allow,4686,1779,2907,19,30,11,8
38690,443,51124,443,allow,1107678,21465,1086213,1058,16,312,746
53805,34155,22730,34155,allow,70,70,0,1,4,1,0
50052,65008,0,0,deny,60,60,0,1,0,1,0
53112,445,0,0,drop,66,66,0,1,0,1,0
27005,33084,13746,33084,allow,906,126,780,2,30,1,1
53923,443,32187,443,allow,499,425,74,4,0,3,1
58638,5900,0,0,deny,62,62,0,1,0,1,0
58764,53,65299,53,allow,268,94,174,2,30,1,1
56761,53,40671,53,allow,788,108,680,2,30,1,1
42053,443,49116,443,allow,2351,1546,805,20,40,11,9
52060,443,18866,443,allow,40726,3421,37305,52,121,20,32
55310,50584,0,0,deny,66,66,0,1,0,1,0
56912,443,18350,443,allow,7618,2859,4759,26,17,14,12
56078,445,0,0,drop,70,70,0,1,0,1,0
15176,62413,0,0,deny,62,62,0,1,0,1,0
51425,37450,0,0,deny,66,66,0,1,0,1,0
39809,23,0,0,deny,60,60,0,1,0,1,0
53550,445,0,0,drop,70,70,0,1,0,1,0
50435,80,14382,80,allow,672,70,602,11,392,2,9
55313,53,17189,53,allow,198,94,104,2,29,1,1
49689,22114,0,0,deny,62,62,0,1,0,1,0
3559,30188,0,0,deny,66,66,0,1,0,1,0
62525,7080,62525,7080,allow,2960,432,2528,11,15,6,5
54528,53,37583,53,allow,197,94,103,2,30,1,1
55820,53,22468,53,allow,184,94,90,2,29,1,1
50223,445,0,0,drop,70,70,0,1,0,1,0
64904,53,63887,53,allow,199,102,97,2,30,1,1
65439,53,5065,53,allow,198,94,104,2,30,1,1
49206,443,6191,443,allow,15982,9199,6783,95,160,40,55
55429,443,25959,443,allow,6292,4834,1458,18,129,11,7
50166,53,40117,53,allow,211,78,133,2,30,1,1
50102,445,0,0,drop,66,66,0,1,0,1,0
46567,443,46567,443,allow,4398,1491,2907,19,29,11,8
46415,53,46415,53,allow,211,80,131,2,30,1,1
64192,53,23253,53,allow,308,110,198,2,29,1,1
56664,443,31995,443,allow,7561,2483,5078,26,20,13,13
52119,49239,52121,49239,allow,160,70,90,2,5,1,1
49418,27400,52679,27400,allow,78,78,0,1,30,1,0
49267,443,42451,443,allow,19851,15702,4149,63,109,34,29
51644,80,3834,80,allow,499,192,307,6,38,4,2
34732,53,8209,53,allow,86,86,0,1,30,1,0
52537,443,37723,443,allow,132577,21019,111558,348,236,142,206
54698,445,0,0,drop,66,66,0,1,0,1,0
54650,445,0,0,drop,70,70,0,1,0,1,0
50650,80,8138,80,allow,129929,6216,123713,164,21,74,90
51948,443,29548,443,allow,4876,2559,2317,32,56,18,14
45335,443,8948,443,allow,2814,1454,1360,23,28,12,11
60776,445,0,0,drop,70,70,0,1,0,1,0
53827,5889,39241,5889,allow,70,70,0,1,4,1,0
16013,35253,0,0,deny,66,66,0,1,0,1,0
59226,53,59226,53,allow,194,87,107,2,30,1,1
58638,5900,0,0,deny,62,62,0,1,0,1,0
49422,445,0,0,drop,70,70,0,1,0,1,0
54405,53,0,0,allow,174,79,95,2,30,1,1
55272,53,17246,53,allow,285,103,182,4,50,2,2
63794,445,0,0,drop,70,70,0,1,0,1,0
56505,445,0,0,drop,66,66,0,1,0,1,0
62821,445,0,0,drop,70,70,0,1,0,1,0
58638,5900,0,0,deny,62,62,0,1,0,1,0
49508,53,17731,53,allow,199,102,97,2,30,1,1
49748,53,20050,53,allow,763,102,661,2,30,1,1
52277,445,0,0,drop,66,66,0,1,0,1,0
55126,53,24901,53,allow,186,95,91,2,31,1,1
51758,31009,29940,31009,allow,70,70,0,1,5,1,0
50539,80,55226,80,allow,5912,3532,2380,15,31,8,7
30966,44847,0,0,deny,146,146,0,1,0,1,0
55382,53,48828,53,allow,199,102,97,2,30,1,1
34112,44847,0,0,deny,62,62,0,1,0,1,0
0,0,0,0,allow,198,128,70,3,0,2,1
17579,57470,0,0,deny,62,62,0,1,0,1,0
40772,15503,0,0,deny,74,74,0,1,0,1,0
51788,80,12159,80,allow,35407,1784,33623,46,20,20,26
53209,80,42720,80,allow,1452,484,968,8,15,5,3
443,1785,0,0,deny,97,97,0,1,0,1,0
64853,53,20952,53,allow,199,102,97,2,31,1,1
63814,81,0,0,deny,60,60,0,1,0,1,0
61434,443,24839,443,allow,8005,830,7175,19,27,9,10
56578,64147,0,0,deny,66,66,0,1,0,1,0
50539,445,0,0,drop,66,66,0,1,0,1,0
58678,445,0,0,drop,70,70,0,1,0,1,0
64967,445,0,0,drop,66,66,0,1,0,1,0
10844,53,10844,53,allow,222,90,132,2,30,1,1
58260,445,0,0,drop,70,70,0,1,0,1,0
56645,445,0,0,drop,70,70,0,1,0,1,0
65274,53,37017,53,allow,295,101,194,4,31,2,2
56301,53,31707,53,allow,177,94,83,2,29,1,1
53579,59332,37605,59332,allow,70,70,0,2,8,2,0
60023,443,8218,443,allow,9660,4678,4982,30,144,15,15
65133,53,1707,53,allow,339,100,239,4,51,2,2
56543,53,0,0,allow,82,82,0,1,31,1,0
51195,123,46436,123,allow,184,94,90,2,30,1,1
49369,53,65002,53,allow,168,86,82,2,30,1,1
54294,445,0,0,drop,66,66,0,1,0,1,0
61013,445,0,0,drop,70,70,0,1,0,1,0
31132,53,31132,53,allow,227,89,138,2,30,1,1
49677,64147,0,0,deny,62,62,0,1,0,1,0
64258,53,3209,53,allow,260,86,174,2,30,1,1
54880,445,0,0,drop,70,70,0,1,0,1,0
51221,27417,45430,27417,allow,481,150,331,2,1200,1,1
53687,19010,53687,19010,allow,64,64,0,1,31,1,0
25457,25604,0,0,deny,62,62,0,1,0,1,0
64353,445,0,0,drop,70,70,0,1,0,1,0
43487,443,46134,443,allow,10015,3476,6539,30,28,19,11
5151,50584,0,0,deny,62,62,0,1,0,1,0
55245,53,36514,53,allow,209,110,99,2,30,1,1
49714,80,42166,80,allow,2096,1011,1085,11,130,6,5
62408,3478,35393,3478,allow,3548,1868,1680,57,87,29,28
50971,445,0,0,drop,70,70,0,1,0,1,0
58117,445,0,0,drop,70,70,0,1,0,1,0
40819,30975,0,0,deny,157,157,0,1,0,1,0
53429,445,0,0,drop,66,66,0,1,0,1,0
27005,27017,59484,27017,allow,882,126,756,2,30,1,1
51690,80,52942,80,allow,21064,2772,18292,38,175,18,20
56675,80,35224,80,allow,156,156,0,3,8,3,0
64902,53,39715,53,allow,231,110,121,2,30,1,1
56202,15503,0,0,deny,146,146,0,1,0,1,0
64340,53,64340,53,allow,847,110,737,2,30,1,1
38977,53,0,0,allow,82,82,0,2,40,2,0
60706,443,17990,443,allow,4974,836,4138,16,40,8,8
65248,53,43627,53,allow,212,110,102,2,29,1,1
50553,445,0,0,drop,66,66,0,1,0,1,0
60254,445,0,0,drop,70,70,0,1,0,1,0
50822,50584,0,0,deny,66,66,0,1,0,1,0
57987,56125,0,0,deny,90,90,0,1,0,1,0
61980,53,64563,53,allow,374,104,270,4,50,2,2
49192,53,8580,53,allow,212,102,110,2,30,1,1
64576,53,14840,53,allow,194,102,92,2,31,1,1
55462,53,13103,53,allow,188,96,92,2,30,1,1
33356,80,44491,80,allow,1658,1344,314,10,15,5,5
30046,15503,0,0,deny,62,62,0,1,0,1,0
25565,51337,0,0,deny,60,60,0,1,0,1,0
4650,53,4650,53,allow,300,90,210,2,29,1,1
65333,445,0,0,drop,70,70,0,1,0,1,0
53418,445,0,0,drop,70,70,0,1,0,1,0
55684,445,0,0,drop,70,70,0,1,0,1,0
63835,30794,25747,30794,allow,66,66,0,1,5,1,0
28429,23,0,0,deny,60,60,0,1,0,1,0
64276,53,39382,53,allow,197,102,95,2,29,1,1
56643,443,24007,443,allow,1560,988,572,13,21,7,6
48756,443,37837,443,allow,6353,1075,5278,18,33,10,8
37900,53,2466,53,allow,78,78,0,1,30,1,0
53375,445,0,0,drop,70,70,0,1,0,1,0
50691,443,45100,443,allow,152,86,66,2,6,1,1
55955,53,56880,53,allow,184,94,90,2,30,1,1
62618,445,0,0,drop,66,66,0,1,0,1,0
56993,53,49057,53,allow,168,86,82,2,30,1,1
64430,53,41812,53,allow,493,91,402,4,31,2,2
64800,80,8529,80,allow,508,256,252,9,75,5,4
49182,445,0,0,drop,70,70,0,1,0,1,0
50481,445,0,0,drop,66,66,0,1,0,1,0
32171,50265,0,0,deny,145,145,0,1,0,1,0
55580,53,25974,53,allow,190,97,93,2,30,1,1
64908,445,0,0,drop,70,70,0,1,0,1,0
65376,53,60931,53,allow,184,94,90,2,30,1,1
16403,16385,49252,16385,allow,548,248,300,10,30,5,5
58638,5900,0,0,deny,62,62,0,1,0,1,0
65159,37965,0,0,deny,74,74,0,1,0,1,0
64773,445,0,0,drop,70,70,0,1,0,1,0
1790,48817,0,0,deny,62,62,0,1,0,1,0
5588,5588,0,0,allow,3354,1792,1562,46,192,23,23
62230,445,0,0,drop,66,66,0,1,0,1,0
23537,35253,0,0,deny,62,62,0,1,0,1,0
64904,53,1451,53,allow,211,102,109,2,30,1,1
65047,53,45819,53,allow,206,91,115,2,30,1,1
56368,443,23641,443,allow,3734,1750,1984,24,203,12,12
42101,443,25094,443,allow,4904,1934,2970,17,135,8,9
17781,50265,0,0,deny,62,62,0,1,0,1,0
55898,445,0,0,drop,66,66,0,1,0,1,0
59042,445,0,0,drop,66,66,0,1,0,1,0
49510,443,40862,443,allow,9571,3757,5814,48,221,26,22
64137,53,61015,53,allow,216,102,114,2,30,1,1
53321,80,20263,80,allow,3483,2072,1411,21,214,17,4
57409,445,0,0,drop,70,70,0,1,0,1,0
55848,53,45545,53,allow,184,102,82,2,30,1,1
11006,23117,0,0,deny,146,146,0,1,0,1,0
52095,48896,29371,48896,allow,66,66,0,1,5,1,0
51914,445,0,0,drop,70,70,0,1,0,1,0
63773,445,0,0,drop,70,70,0,1,0,1,0
0,0,0,0,allow,480,244,236,4,0,2,2
56075,53,1883,53,allow,215,102,113,2,30,1,1
51959,445,0,0,drop,66,66,0,1,0,1,0
6355,25174,0,0,deny,62,62,0,1,0,1,0
8403,46824,0,0,deny,62,62,0,1,0,1,0
58992,445,0,0,drop,70,70,0,1,0,1,0
44976,53,45616,53,allow,86,86,0,1,30,1,0
60000,443,63999,443,allow,1641,730,911,14,18,8,6
65099,445,0,0,drop,70,70,0,1,0,1,0
57089,443,54231,443,allow,5574,999,4575,21,256,11,10
27988,40027,31364,40027,allow,148,86,62,2,30,1,1
63041,53,42776,53,allow,448,166,282,2,30,1,1
53475,3389,0,0,deny,62,62,0,1,0,1,0
0,0,0,0,allow,320,320,0,5,0,5,0
56864,53,8861,53,allow,200,102,98,2,30,1,1
37627,443,10583,443,allow,70,70,0,2,5,2,0
65309,53,6020,53,allow,227,110,117,2,30,1,1
22587,30188,0,0,deny,62,62,0,1,0,1,0
53146,50393,43018,50393,allow,70,70,0,1,5,1,0
56131,445,0,0,drop,70,70,0,1,0,1,0
33539,443,27903,443,allow,3244,2042,1202,17,16,9,8
63692,42635,61565,42635,allow,562,380,182,8,15,5,3
60058,11392,0,0,deny,66,66,0,1,0,1,0
56260,53,19443,53,allow,177,94,83,2,30,1,1
50416,445,0,0,drop,66,66,0,1,0,1,0
34733,80,35506,80,allow,1056,682,374,10,15,6,4
45908,33330,0,0,deny,60,60,0,1,0,1,0
56555,443,29813,443,allow,6308,829,5479,18,15,9,9
51940,26399,39116,26399,allow,70,70,0,2,8,2,0
15561,53,15561,53,allow,199,90,109,2,30,1,1
11228,25174,0,0,deny,66,66,0,1,0,1,0
49836,443,16827,443,allow,6611,2169,4442,20,123,12,8
35440,443,40080,443,allow,7419,2136,5283,23,255,11,12
43495,5223,54062,5223,allow,139,139,0,2,6,2,0
1790,48817,0,0,deny,66,66,0,1,0,1,0
34809,57470,0,0,deny,66,66,0,1,0,1,0
13235,44847,0,0,deny,62,62,0,1,0,1,0
41230,443,13536,443,allow,78,78,0,1,5,1,0
53808,443,50826,443,allow,10785,2147,8638,22,30,10,12
58264,44847,0,0,deny,66,66,0,1,0,1,0
49695,445,0,0,drop,70,70,0,1,0,1,0
50477,443,6875,443,allow,25979,7217,18762,36,15,19,17
50146,445,0,0,drop,70,70,0,1,0,1,0
55551,53,64054,53,allow,180,94,86,2,29,1,1
60328,80,20117,80,allow,2006,1095,911,11,61,6,5
56274,53,38501,53,allow,177,94,83,2,30,1,1
49558,53,61450,53,allow,184,94,90,2,29,1,1
1078,30975,0,0,deny,143,143,0,1,0,1,0
56472,53,36068,53,allow,167,86,81,2,31,1,1
45042,443,17332,443,allow,8445,2120,6325,27,107,15,12
18545,23,0,0,deny,60,60,0,1,0,1,0
59287,445,0,0,drop,70,70,0,1,0,1,0
50340,53,17641,53,allow,189,102,87,2,31,1,1
60443,443,1656,443,allow,10961,4286,6675,53,320,21,32
80,9918,0,0,deny,60,60,0,1,0,1,0
61550,5529,0,0,deny,145,145,0,1,0,1,0
56418,53,62864,53,allow,182,93,89,2,30,1,1
49582,80,49496,80,allow,25980,10637,15343,40,42,17,23
65107,53,31681,53,allow,193,102,91,2,31,1,1
64778,445,0,0,drop,66,66,0,1,0,1,0
62106,445,0,0,drop,66,66,0,1,0,1,0
53968,445,0,0,drop,66,66,0,1,0,1,0
20961,35440,0,0,deny,62,62,0,1,0,1,0
51439,443,28008,443,allow,10119,1855,8264,26,28,15,11
39050,443,47247,443,allow,26692,5527,21165,54,31,28,26
64678,445,0,0,drop,66,66,0,1,0,1,0
54136,443,42387,443,allow,1053,566,487,10,16,6,4
39338,443,49574,443,allow,7624,1384,6240,23,17,12,11
60533,445,0,0,drop,70,70,0,1,0,1,0
49216,63752,46385,63752,allow,70,70,0,2,8,2,0
57659,80,4317,80,allow,742,140,602,12,409,3,9
36628,80,65040,80,allow,78,78,0,1,5,1,0
49173,27402,64212,27402,allow,70,70,0,1,5,1,0
58577,445,0,0,drop,70,70,0,1,0,1,0
26802,50584,0,0,deny,146,146,0,1,0,1,0
56876,443,56876,443,allow,18542,1778,16764,30,17,15,15
64824,53,60323,53,allow,94,94,0,1,30,1,0
55386,37965,0,0,deny,66,66,0,1,0,1,0
57176,445,0,0,drop,70,70,0,1,0,1,0
50022,53,26770,53,allow,179,94,85,2,31,1,1
12694,12446,0,0,deny,62,62,0,1,0,1,0
7342,22114,0,0,deny,62,62,0,1,0,1,0
50903,445,0,0,drop,66,66,0,1,0,1,0
49862,53,52956,53,allow,715,94,621,2,31,1,1
6666,990,0,0,deny,60,60,0,1,0,1,0
58638,5900,0,0,deny,62,62,0,1,0,1,0
51608,443,59688,443,allow,4646,2347,2299,17,34,9,8
62911,36237,0,0,deny,66,66,0,1,0,1,0
50884,80,30103,80,allow,238059,13790,224269,276,141,113,163
50214,53,15199,53,allow,718,94,624,2,29,1,1
54897,445,0,0,drop,70,70,0,1,0,1,0
55516,5228,12835,5228,allow,2769,1694,1075,20,3600,10,10
51348,25174,0,0,deny,66,66,0,1,0,1,0
59905,443,62793,443,allow,21212,14546,6666,43,362,24,19
31609,25174,0,0,deny,62,62,0,1,0,1,0
64638,53,19660,53,allow,397,102,295,2,30,1,1
53537,53,1672,53,allow,391,102,289,2,29,1,1
57005,53,13005,53,allow,199,94,105,2,30,1,1
57470,46501,13184,46501,allow,132,132,0,3,1199,3,0
49177,53,24852,53,allow,184,94,90,2,30,1,1
60676,57866,0,0,deny,66,66,0,1,0,1,0
33150,53,60040,53,allow,816,228,588,8,30,4,4
47827,67,0,0,deny,60,60,0,1,0,1,0
28668,8696,0,0,deny,60,60,0,1,0,1,0
55877,6380,28997,6380,allow,149,149,0,2,1200,2,0
58326,80,34084,80,allow,804,449,355,9,256,5,4
44816,80,47339,80,allow,130,70,60,2,15,1,1
53141,8595,16874,8595,allow,70,70,0,1,5,1,0
54943,445,0,0,drop,70,70,0,1,0,1,0
33932,443,50545,443,allow,54451,2603,51848,70,16,30,40
64467,53,16595,53,allow,184,94,90,2,31,1,1
53447,44847,0,0,deny,66,66,0,1,0,1,0
56109,445,0,0,drop,70,70,0,1,0,1,0
60780,28080,29726,28080,allow,70,70,0,2,8,2,0
57287,53,44650,53,allow,752,93,659,2,30,1,1
53890,443,45559,443,allow,499,425,74,4,0,3,1
28897,35440,0,0,deny,66,66,0,1,0,1,0
59628,445,0,0,drop,70,70,0,1,0,1,0
58638,5900,0,0,deny,62,62,0,1,0,1,0
55791,445,0,0,drop,66,66,0,1,0,1,0
52161,443,17095,443,allow,1461,924,537,13,31,7,6
34417,53,11898,53,allow,168,78,90,2,30,1,1
55646,445,0,0,drop,70,70,0,1,0,1,0
53964,443,1978,443,allow,152,78,74,2,5,1,1
55431,445,0,0,drop,70,70,0,1,0,1,0
51222,445,0,0,drop,70,70,0,1,0,1,0
52203,80,56885,80,allow,432,246,186,7,40,4,3
62173,445,0,0,drop,66,66,0,1,0,1,0
58110,23,0,0,deny,60,60,0,1,0,1,0
60187,443,13141,443,allow,9875,1112,8763,21,125,10,11
56828,53,33245,53,allow,211,102,109,2,30,1,1
56525,443,34500,443,allow,5022,973,4049,17,60,9,8
33340,443,55389,443,allow,3598,1118,2480,14,120,7,7
45259,53,45259,53,allow,176,78,98,2,30,1,1
39945,80,32105,80,allow,1948,728,1220,11,150,6,5
9467,443,18809,443,allow,5960,438,5522,16,15,6,10
65371,443,38245,443,allow,34653,2523,32130,65,83,26,39
56180,53,32734,53,allow,200,102,98,2,31,1,1
49269,445,0,0,drop,66,66,0,1,0,1,0
49746,53,24579,53,allow,479,88,391,4,58,2,2
64614,53,3783,53,allow,168,86,82,2,30,1,1
52679,445,0,0,drop,70,70,0,1,0,1,0
62233,445,0,0,drop,66,66,0,1,0,1,0
53862,443,35996,443,allow,499,425,74,4,1,3,1
27005,27025,48292,27025,allow,1774,252,1522,5,31,3,2
64595,64147,0,0,deny,62,62,0,1,0,1,0
56186,445,0,0,drop,70,70,0,1,0,1,0
51334,443,42102,443,allow,8407,2034,6373,19,121,8,11
38586,3855,0,0,deny,145,145,0,1,0,1,0
57583,443,11570,443,allow,6150,4180,1970,21,95,13,8
52185,445,0,0,drop,70,70,0,1,0,1,0
64797,53,38007,53,allow,183,94,89,2,30,1,1
64581,53,7849,53,allow,514,88,426,4,42,2,2
55427,53,31506,53,allow,200,102,98,2,30,1,1
42608,1,0,0,deny,62,62,0,1,0,1,0
65084,53,19424,53,allow,215,102,113,2,29,1,1
57377,53,64833,53,allow,1165,94,1071,2,30,1,1
50651,445,0,0,drop,70,70,0,1,0,1,0
5228,3434,0,0,deny,345,345,0,1,0,1,0
55392,53,63211,53,allow,418,94,324,2,30,1,1
36749,443,54855,443,allow,487330,18074,469256,508,122,148,360
45314,80,7495,80,allow,72376,2899,69477,79,16,29,50
62066,443,55561,443,allow,11816,3175,8641,32,46,16,16
65127,443,61568,443,allow,648,648,0,7,15,7,0
37840,53,37840,53,allow,216,90,126,2,30,1,1
56180,53,48216,53,allow,757,98,659,2,31,1,1
11337,15503,0,0,deny,62,62,0,1,0,1,0
56803,52421,20663,52421,allow,164,70,94,2,5,1,1
53890,23310,52916,23310,allow,70,70,0,2,8,2,0
50218,53,36162,53,allow,165,86,79,2,31,1,1
52010,445,0,0,drop,70,70,0,1,0,1,0
58703,445,0,0,drop,70,70,0,1,0,1,0
54351,23,0,0,deny,60,60,0,1,0,1,0
50757,64147,0,0,deny,62,62,0,1,0,1,0
50774,445,0,0,drop,70,70,0,1,0,1,0
60560,445,0,0,drop,70,70,0,1,0,1,0
49850,443,7446,443,allow,147320,5771,141549,184,72,73,111
50669,80,58976,80,allow,1485,806,679,13,15,7,6
64959,53,59416,53,allow,202,103,99,2,31,1,1
49295,53,60068,53,allow,172,94,78,2,30,1,1
16768,53,24708,53,allow,199,94,105,2,30,1,1
52164,42271,32377,42271,allow,70,70,0,1,5,1,0
56614,443,7546,443,allow,20451,1899,18552,33,17,14,19
63217,443,63217,443,allow,11907,1406,10501,25,22,11,14
16092,50265,0,0,deny,62,62,0,1,0,1,0
59663,37965,0,0,deny,66,66,0,1,0,1,0
20961,35440,0,0,deny,62,62,0,1,0,1,0
53500,443,28730,443,allow,3036,975,2061,14,136,7,7
55868,53,41641,53,allow,177,94,83,2,29,1,1
51881,17997,36769,17997,allow,414,136,278,6,16,3,3
52853,443,45061,443,allow,130,70,60,2,15,1,1
49730,53,24529,53,allow,211,110,101,2,30,1,1
443,34920,0,0,deny,60,60,0,1,0,1,0
3559,30188,0,0,deny,66,66,0,1,0,1,0
55889,53,50897,53,allow,199,102,97,2,29,1,1
53985,30188,0,0,deny,62,62,0,1,0,1,0
51422,80,51422,80,allow,9962,3379,6583,26,26,13,13
58638,5900,0,0,deny,62,62,0,1,0,1,0
61769,445,0,0,drop,70,70,0,1,0,1,0
50674,445,0,0,drop,70,70,0,1,0,1,0
52563,17235,0,0,deny,74,74,0,1,0,1,0
6881,6881,0,0,deny,62,62,0,1,0,1,0
57426,66,14765,66,allow,70,70,0,2,8,2,0
64665,445,0,0,drop,70,70,0,1,0,1,0
65221,53,41318,53,allow,199,102,97,2,30,1,1
58972,443,21151,443,allow,5979,3487,2492,21,168,10,11
57768,7635,57768,7635,allow,138,78,60,2,6,1,1
58305,443,38970,443,allow,11659,1027,10632,25,29,11,14
56840,20413,10874,20413,allow,70,70,0,2,8,2,0
39839,22114,0,0,deny,62,62,0,1,0,1,0
49554,53,46723,53,allow,541,201,340,6,64,3,3
56927,64147,0,0,deny,145,145,0,1,0,1,0
80,37649,0,0,deny,60,60,0,1,0,1,0
35132,53,35132,53,allow,469,165,304,4,31,2,2
45551,80,20742,80,allow,694,350,344,11,27,6,5
22714,30188,0,0,deny,146,146,0,1,0,1,0
58638,5900,0,0,deny,62,62,0,1,0,1,0
49430,53,28668,53,allow,332,99,233,4,45,2,2
51595,443,19980,443,allow,632,158,474,2,30,1,1
38901,53,60941,53,allow,168,78,90,2,30,1,1
54678,445,0,0,drop,70,70,0,1,0,1,0
56186,57470,0,0,deny,62,62,0,1,0,1,0
63527,50584,0,0,deny,66,66,0,1,0,1,0
65357,53,40859,53,allow,194,102,92,2,29,1,1
30188,31063,61312,31063,allow,502,150,352,2,1200,1,1
49591,53,31886,53,allow,198,94,104,2,30,1,1
49949,53,18474,53,allow,193,102,91,2,30,1,1
54882,445,0,0,drop,70,70,0,1,0,1,0
64799,445,0,0,drop,70,70,0,1,0,1,0
45908,3383,0,0,deny,60,60,0,1,0,1,0
57424,53,63565,53,allow,197,102,95,2,30,1,1
49590,53,5842,53,allow,458,188,270,6,30,3,3
59861,445,0,0,drop,70,70,0,1,0,1,0
27005,27015,8192,27015,allow,912,126,786,2,31,1,1
57614,443,56701,443,allow,25824,14215,11609,65,757,32,33
49274,53,43421,53,allow,212,102,110,2,29,1,1
46093,32661,0,0,deny,74,74,0,1,0,1,0
52997,443,53080,443,allow,17380,7747,9633,52,121,23,29
50584,18066,56366,18066,allow,1705,536,1169,5,1200,4,1
56303,445,0,0,drop,70,70,0,1,0,1,0
64593,53,56394,53,allow,94,94,0,1,30,1,0
49382,53,52485,53,allow,200,102,98,2,31,1,1
55192,53,17598,53,allow,178,94,84,2,30,1,1
51950,80,61236,80,allow,3648,1775,1873,13,26,7,6
50584,20824,62214,20824,allow,324,150,174,2,1200,1,1
10627,23117,0,0,deny,62,62,0,1,0,1,0
49730,53,34301,53,allow,539,100,439,4,54,2,2
55041,53,58764,53,allow,234,94,140,2,30,1,1
50484,445,0,0,drop,70,70,0,1,0,1,0
51490,30228,0,0,deny,100,100,0,1,0,1,0
50235,445,0,0,drop,70,70,0,1,0,1,0
62859,35440,0,0,deny,66,66,0,1,0,1,0
36146,443,42647,443,allow,2514,1249,1265,19,76,9,10
49418,27015,34985,27015,allow,239,71,168,2,31,1,1
19787,53,19787,53,allow,414,268,146,3,32,2,1
14420,80,14420,80,allow,4591,3155,1436,22,45,13,9
2543,25174,0,0,deny,62,62,0,1,0,1,0
52247,445,0,0,drop,70,70,0,1,0,1,0
64106,53,27158,53,allow,195,102,93,2,31,1,1
64617,445,0,0,drop,70,70,0,1,0,1,0
52618,445,0,0,drop,66,66,0,1,0,1,0
55272,53,40097,53,allow,599,198,401,6,50,3,3
46975,443,49913,443,allow,70,70,0,1,5,1,0
47705,443,21979,443,allow,25643,2181,23462,44,363,18,26
54420,445,0,0,drop,66,66,0,1,0,1,0
60786,25174,0,0,deny,66,66,0,1,0,1,0
64097,445,0,0,drop,66,66,0,1,0,1,0
50218,445,0,0,drop,70,70,0,1,0,1,0
49282,53,14515,53,allow,178,94,84,2,30,1,1
22784,9571,0,0,deny,62,62,0,1,0,1,0
45673,30188,0,0,deny,146,146,0,1,0,1,0
50061,80,3362,80,allow,405,285,120,5,15,3,2
65189,53,45878,53,allow,180,94,86,2,30,1,1
56952,53,29584,53,allow,193,102,91,2,30,1,1
23846,22114,0,0,deny,146,146,0,1,0,1,0
56424,53,11596,53,allow,170,87,83,2,31,1,1
55420,53,27651,53,allow,177,94,83,2,29,1,1
58226,52848,0,0,deny,62,62,0,1,0,1,0
26528,51221,0,0,deny,78,78,0,1,0,1,0
49989,53,64218,53,allow,755,94,661,2,29,1,1
6881,6881,56925,6881,allow,238,118,120,2,1200,1,1
53860,33791,1451,33791,allow,492,306,186,8,16,5,3
50052,65008,0,0,deny,60,60,0,1,0,1,0
64847,22114,0,0,deny,66,66,0,1,0,1,0
63588,443,6782,443,allow,11301,2292,9009,37,165,20,17
26385,53,26385,53,allow,235,90,145,2,33,1,1
54227,443,59982,443,allow,499,425,74,4,0,3,1
40480,30317,0,0,deny,146,146,0,1,0,1,0
443,39711,0,0,deny,74,74,0,1,0,1,0
59662,445,0,0,drop,66,66,0,1,0,1,0
56046,53,40264,53,allow,193,102,91,2,30,1,1
64475,53,57543,53,allow,314,99,215,4,39,2,2
63645,445,0,0,drop,66,66,0,1,0,1,0
43657,50011,0,0,deny,62,62,0,1,0,1,0
6546,37965,0,0,deny,62,62,0,1,0,1,0
55476,445,0,0,drop,66,66,0,1,0,1,0
52965,445,0,0,drop,66,66,0,1,0,1,0
53253,443,34431,443,allow,36393,27741,8652,147,210,76,71
48016,57470,0,0,deny,62,62,0,1,0,1,0
55656,31165,21172,31165,allow,70,70,0,2,8,2,0
55688,445,0,0,drop,70,70,0,1,0,1,0
53815,445,0,0,drop,70,70,0,1,0,1,0
53563,35440,0,0,deny,62,62,0,1,0,1,0
50629,53,6662,53,allow,756,94,662,2,30,1,1
50784,50584,0,0,deny,146,146,0,1,0,1,0
49628,53,16334,53,allow,168,86,82,2,31,1,1
55707,53,50329,53,allow,177,94,83,2,29,1,1
64449,53,62626,53,allow,249,94,155,2,30,1,1
57508,443,43486,443,allow,6749,2649,4100,19,142,9,10
49978,53,38632,53,allow,195,102,93,2,29,1,1
64666,445,0,0,drop,70,70,0,1,0,1,0
64833,53,29927,53,allow,167,86,81,2,30,1,1
50770,445,0,0,drop,70,70,0,1,0,1,0
55413,37965,0,0,deny,62,62,0,1,0,1,0
3175,60038,0,0,allow,66,66,0,1,91,1,0
42661,80,47037,80,allow,78310,9243,69067,109,93,57,52
59136,50584,0,0,deny,62,62,0,1,0,1,0
57018,53,23896,53,allow,177,94,83,2,31,1,1
55709,30217,33191,30217,allow,70,70,0,2,8,2,0
62304,445,0,0,drop,66,66,0,1,0,1,0
58638,5900,0,0,deny,62,62,0,1,0,1,0
49344,53,20668,53,allow,458,188,270,6,29,3,3
57700,53,7203,53,allow,308,118,190,2,29,1,1
49619,443,17429,443,allow,46202,8086,38116,131,243,69,62
39550,80,36745,80,allow,1598,731,867,17,362,8,9
49724,443,21055,443,allow,4139,511,3628,12,15,6,6
64678,53,7690,53,allow,758,93,665,2,31,1,1
53541,59939,18832,59939,allow,70,70,0,1,5,1,0
59285,445,0,0,drop,70,70,0,1,0,1,0
64701,53,64701,53,allow,265,111,154,2,30,1,1
57985,26467,0,0,deny,62,62,0,1,0,1,0
49418,32056,18212,32056,allow,245,78,167,2,30,1,1
58638,5900,0,0,deny,62,62,0,1,0,1,0
9518,3855,0,0,deny,100,100,0,1,0,1,0
49582,445,0,0,drop,66,66,0,1,0,1,0
54280,3398,0,0,deny,60,60,0,1,0,1,0
48706,23394,0,0,deny,60,60,0,1,0,1,0
6975,29028,0,0,deny,139,139,0,1,0,1,0
55975,53,28209,53,allow,195,102,93,2,30,1,1
55021,443,61578,443,allow,8042,2104,5938,27,26,15,12
50977,56205,0,0,deny,66,66,0,1,0,1,0
59112,53,0,0,allow,296,76,220,2,30,1,1
27005,27216,53096,27216,allow,883,126,757,2,31,1,1
56656,443,38705,443,allow,8006,1986,6020,20,15,11,9
54827,445,0,0,drop,66,66,0,1,0,1,0
60376,58302,44068,58302,allow,624,318,306,10,15,5,5
27328,443,23617,443,allow,3751,1007,2744,35,473,11,24
42204,443,21062,443,allow,6197,942,5255,19,361,10,9
6931,55108,0,0,deny,139,139,0,1,0,1,0
52990,445,0,0,drop,70,70,0,1,0,1,0
60527,445,0,0,drop,70,70,0,1,0,1,0
55317,53,30681,53,allow,216,102,114,2,30,1,1
57867,27019,59183,27019,allow,802,472,330,8,30,5,3
56627,445,0,0,drop,66,66,0,1,0,1,0
49891,53,31414,53,allow,243,94,149,2,30,1,1
51429,22114,0,0,deny,66,66,0,1,0,1,0
63950,53,19633,53,allow,200,102,98,2,30,1,1
55707,53,31512,53,allow,177,94,83,2,30,1,1
60731,80,1160,80,allow,5911,4727,1184,20,16,11,9
50940,445,0,0,drop,70,70,0,1,0,1,0
51222,35440,0,0,deny,66,66,0,1,0,1,0
51691,80,8687,80,allow,19384,2720,16664,36,174,18,18
40865,8100,52976,8100,allow,78,78,0,1,5,1,0
10128,443,36900,443,allow,22677,11756,10921,45,315,26,19
49853,443,20017,443,allow,11534,2076,9458,43,60,21,22
52758,53,52758,53,allow,197,90,107,2,30,1,1
56372,53,7936,53,allow,172,94,78,2,30,1,1
49153,53,53527,53,allow,280,94,186,2,30,1,1
54141,445,0,0,drop,66,66,0,1,0,1,0
64025,53,10807,53,allow,199,94,105,2,30,1,1
65112,53,26607,53,allow,209,110,99,2,30,1,1
60355,445,0,0,drop,70,70,0,1,0,1,0
51939,445,0,0,drop,70,70,0,1,0,1,0
51221,51413,55208,51413,allow,460,150,310,2,1201,1,1
54519,445,0,0,drop,66,66,0,1,0,1,0
49999,53,61068,53,allow,181,94,87,2,30,1,1
57581,445,0,0,drop,70,70,0,1,0,1,0
54283,445,0,0,drop,70,70,0,1,0,1,0
51735,50794,12843,50794,allow,70,70,0,1,5,1,0
9393,51505,0,0,deny,66,66,0,1,0,1,0
51721,35426,42015,35426,allow,70,70,0,2,8,2,0
443,35556,443,35556,allow,70,70,0,1,4,1,0
58638,5900,0,0,deny,62,62,0,1,0,1,0
49951,53,52674,53,allow,525,110,415,2,30,1,1
49651,445,0,0,drop,70,70,0,1,0,1,0
49242,53,1581,53,allow,167,86,81,2,29,1,1
43916,21,0,0,deny,60,60,0,1,0,1,0
64586,53,19634,53,allow,252,94,158,2,31,1,1
38770,443,52968,443,allow,140155,6367,133788,173,145,62,111
38888,22,38888,22,allow,5130,2103,3027,28,25,16,12
62617,445,0,0,drop,66,66,0,1,0,1,0
49551,445,0,0,drop,70,70,0,1,0,1,0
49767,445,0,0,drop,70,70,0,1,0,1,0
45184,80,27181,80,allow,1718,1404,314,11,15,6,5
57955,44847,0,0,deny,62,62,0,1,0,1,0
55047,53,41022,53,allow,308,94,214,2,29,1,1
57144,53,1605,53,allow,178,94,84,2,29,1,1
56630,443,6016,443,allow,7941,1952,5989,20,15,11,9
50405,445,0,0,drop,66,66,0,1,0,1,0
63529,445,0,0,drop,70,70,0,1,0,1,0
61626,443,21665,443,allow,5663,3258,2405,19,120,9,10
57577,80,57577,80,allow,172548,4355,168193,172,148,53,119
57400,443,4312,443,allow,10169,1957,8212,26,136,11,15
53548,23310,59949,23310,allow,70,70,0,1,4,1,0
49919,80,15298,80,allow,992,524,468,10,125,6,4
39983,80,39983,80,allow,6416,997,5419,17,30,8,9
45394,443,62065,443,allow,1314,653,661,13,185,7,6
65528,62413,0,0,deny,62,62,0,1,0,1,0
47518,53,47518,53,allow,414,268,146,3,32,2,1
46550,443,47907,443,allow,3322,1760,1562,19,255,10,9
52834,445,0,0,drop,70,70,0,1,0,1,0
51826,58925,42484,58925,allow,70,70,0,2,9,2,0
49767,53,43872,53,allow,200,102,98,2,31,1,1
56883,53,20999,53,allow,184,94,90,2,30,1,1
443,15564,0,0,deny,85,85,0,1,0,1,0
61398,80,61398,80,allow,1917,1468,449,10,19,6,4
53173,445,0,0,drop,70,70,0,1,0,1,0
56611,53,54936,53,allow,170,87,83,2,31,1,1
60978,445,0,0,drop,70,70,0,1,0,1,0
27005,33086,32717,33086,allow,877,126,751,2,31,1,1
49469,53,17330,53,allow,718,94,624,2,30,1,1
56568,53,49055,53,allow,206,105,101,2,30,1,1
56405,62413,0,0,deny,66,66,0,1,0,1,0
55940,445,0,0,drop,70,70,0,1,0,1,0
37319,443,50657,443,allow,70,70,0,1,5,1,0
42917,52952,0,0,deny,62,62,0,1,0,1,0
30960,45754,34064,45754,allow,396,396,0,7,3615,7,0
57734,445,0,0,drop,70,70,0,1,0,1,0
51880,8000,15502,8000,allow,750,360,390,10,60,5,5
53469,36237,0,0,deny,66,66,0,1,0,1,0
58574,21247,0,0,deny,66,66,0,1,0,1,0
50821,443,29846,443,allow,7619,3064,4555,14,121,6,8
0,0,0,0,allow,244,244,0,2,0,2,0
52660,443,21035,443,allow,5042,2002,3040,14,119,7,7
9687,57470,0,0,deny,78,78,0,1,0,1,0
42642,443,27903,443,allow,6826,1804,5022,21,137,11,10
56809,53,56809,53,allow,404,259,145,3,33,2,1
53803,443,59546,443,allow,499,425,74,4,0,3,1
55877,39578,13811,39578,allow,150,150,0,1,1200,1,0
6943,14984,0,0,deny,100,100,0,1,0,1,0
47089,15000,57898,15000,allow,138,78,60,2,5,1,1
64371,443,25379,443,allow,5925,3462,2463,13,120,7,6
57177,53,5547,53,allow,174,89,85,2,31,1,1
51572,443,51572,443,allow,1724,916,808,17,128,7,10
45997,443,45997,443,allow,1494,898,596,12,142,6,6
55710,445,0,0,drop,70,70,0,1,0,1,0
52197,445,0,0,drop,66,66,0,1,0,1,0
56174,445,0,0,drop,70,70,0,1,0,1,0
63518,445,0,0,drop,70,70,0,1,0,1,0
5955,55160,0,0,deny,74,74,0,1,0,1,0
59404,443,10904,443,allow,2962,1844,1118,16,15,8,8
57444,53,54223,53,allow,177,94,83,2,30,1,1
27005,27015,43696,27015,allow,876,126,750,2,30,1,1
26501,80,26501,80,allow,93644,8868,84776,131,31,64,67
60280,445,0,0,drop,70,70,0,1,0,1,0
56592,53,38145,53,allow,200,102,98,2,30,1,1
54742,37965,0,0,deny,66,66,0,1,0,1,0
51453,64147,0,0,deny,66,66,0,1,0,1,0
51409,443,17023,443,allow,1442,721,721,15,122,8,7
65324,53,6556,53,allow,749,94,655,2,30,1,1
57284,53,19677,53,allow,214,110,104,2,30,1,1
58925,25174,0,0,deny,66,66,0,1,0,1,0
57945,443,56695,443,allow,3522,1763,1759,31,32,16,15
62865,443,23097,443,allow,21313,7245,14068,48,128,22,26
56109,53,49882,53,allow,177,94,83,2,29,1,1
3181,53567,0,0,deny,66,66,0,1,0,1,0
39312,443,51370,443,allow,10148,2203,7945,37,120,19,18
55349,445,0,0,drop,70,70,0,1,0,1,0
53204,445,0,0,drop,70,70,0,1,0,1,0
58638,5900,0,0,deny,62,62,0,1,0,1,0
58638,5900,0,0,deny,62,62,0,1,0,1,0
50180,445,0,0,drop,70,70,0,1,0,1,0
56747,443,56747,443,allow,33901,9598,24303,56,61,32,24
51968,80,1754,80,allow,366,240,126,7,25,5,2
41520,53,0,0,allow,82,82,0,1,30,1,0
49236,53,40534,53,allow,723,102,621,2,30,1,1
43461,35440,0,0,deny,62,62,0,1,0,1,0
55569,443,40443,443,allow,8867,3511,5356,20,120,9,11
57470,6881,26091,6881,allow,330,330,0,6,1201,6,0
49631,53,6299,53,allow,198,102,96,2,33,1,1
50662,443,50298,443,allow,4190,1882,2308,17,19,10,7
65266,53,39575,53,allow,216,110,106,2,30,1,1
51846,445,0,0,drop,70,70,0,1,0,1,0
62045,445,0,0,drop,70,70,0,1,0,1,0
61404,52700,0,0,deny,72,72,0,1,0,1,0
59581,53,59581,53,allow,823,98,725,2,29,1,1
58602,445,0,0,drop,70,70,0,1,0,1,0
50496,443,2792,443,allow,751676,8792,742884,617,16,123,494
2991,23,0,0,deny,60,60,0,1,0,1,0
26642,57470,0,0,deny,62,62,0,1,0,1,0
58769,443,51640,443,allow,3923,2459,1464,17,17,8,9
59617,445,0,0,drop,70,70,0,1,0,1,0
51715,443,60037,443,allow,4887,2346,2541,16,120,8,8
58526,445,0,0,drop,70,70,0,1,0,1,0
65329,445,0,0,drop,70,70,0,1,0,1,0
50379,80,42640,80,allow,1083,653,430,8,16,5,3
56947,445,0,0,drop,66,66,0,1,0,1,0
55315,53,15960,53,allow,196,102,94,2,30,1,1
51412,51505,0,0,deny,66,66,0,1,0,1,0
54371,443,51699,443,allow,6120,1305,4815,20,983,10,10
54669,80,16041,80,allow,1148,599,549,14,318,7,7
64885,53,14280,53,allow,261,102,159,2,29,1,1
30599,46824,0,0,deny,66,66,0,1,0,1,0
56041,53,6902,53,allow,185,102,83,2,30,1,1
42294,443,1257,443,allow,10384,4353,6031,29,251,16,13
61492,445,0,0,drop,70,70,0,1,0,1,0
56215,53,29779,53,allow,165,86,79,2,30,1,1
11677,44847,0,0,deny,146,146,0,1,0,1,0
58866,53,56575,53,allow,355,118,237,2,29,1,1
60369,443,60379,443,allow,7939,955,6984,22,107,11,11
61259,445,0,0,drop,66,66,0,1,0,1,0
52112,22114,0,0,deny,66,66,0,1,0,1,0
52996,443,47538,443,allow,22513,15188,7325,69,517,31,38
58870,443,34912,443,allow,21207,14062,7145,50,19,28,22
47595,33439,0,0,allow,106,106,0,1,60,1,0
2780,23117,0,0,deny,66,66,0,1,0,1,0
55598,53,46757,53,allow,186,102,84,2,30,1,1
50496,443,27297,443,allow,90570,3437,87133,103,90,34,69
55732,53,56337,53,allow,280,126,154,2,30,1,1
25054,36827,0,0,deny,66,66,0,1,0,1,0
41518,443,53815,443,allow,25342,17809,7533,56,80,28,28
37655,443,5274,443,allow,17842,11204,6638,43,174,24,19
57982,64147,0,0,deny,66,66,0,1,0,1,0
15313,34068,0,0,deny,146,146,0,1,0,1,0
50759,53,62224,53,allow,578,286,292,9,16,5,4
50367,53,53044,53,allow,821,102,719,2,30,1,1
35408,56205,0,0,deny,66,66,0,1,0,1,0
49449,53,37523,53,allow,216,110,106,2,29,1,1
36804,25174,0,0,deny,66,66,0,1,0,1,0
55835,53,39257,53,allow,180,94,86,2,30,1,1
38009,443,41561,443,allow,130,70,60,3,5,2,1
64079,53,36707,53,allow,232,94,138,2,30,1,1
52658,80,12733,80,allow,214,140,74,4,15,3,1
55933,53,42992,53,allow,182,94,88,2,30,1,1
52959,80,37640,80,allow,122572,3630,118942,128,358,46,82
52136,443,52136,443,allow,298081,63335,234746,337,323,145,192
49492,53,11177,53,allow,198,101,97,2,31,1,1
53674,31724,6450,31724,allow,70,70,0,1,4,1,0
61419,445,0,0,drop,70,70,0,1,0,1,0
53869,17089,2091,17089,allow,70,70,0,2,7,2,0
56432,53,38041,53,allow,195,102,93,2,30,1,1
16522,26467,0,0,deny,66,66,0,1,0,1,0
43700,30188,0,0,deny,62,62,0,1,0,1,0
64158,445,0,0,drop,70,70,0,1,0,1,0
64569,53,2461,53,allow,214,102,112,2,31,1,1
50106,30317,0,0,deny,66,66,0,1,0,1,0
57470,53377,9260,53377,allow,594,594,0,10,1199,10,0
65466,53,32995,53,allow,200,102,98,2,30,1,1
58638,5900,58638,5900,allow,66,66,0,1,4,1,0
1025,50584,0,0,deny,146,146,0,1,0,1,0
50728,443,61192,443,allow,34661,17810,16851,89,119,40,49
37916,443,12180,443,allow,6202,872,5330,19,361,9,10
51505,443,27614,443,allow,1210,450,760,17,54,5,12
55588,53,33689,53,allow,168,86,82,2,31,1,1
42291,53,6078,53,allow,168,78,90,2,30,1,1
56428,445,0,0,drop,70,70,0,1,0,1,0
64647,53,15086,53,allow,718,94,624,2,30,1,1
53632,58037,54997,58037,allow,70,70,0,1,5,1,0
61495,37965,0,0,deny,66,66,0,1,0,1,0
52430,22114,0,0,deny,62,62,0,1,0,1,0
17213,22114,0,0,deny,146,146,0,1,0,1,0
47088,15000,21651,15000,allow,138,78,60,2,6,1,1
54302,53,4566,53,allow,168,78,90,2,30,1,1
55705,53,50083,53,allow,209,110,99,2,30,1,1
60399,443,57774,443,allow,8061,1926,6135,24,361,11,13
10126,57470,0,0,deny,62,62,0,1,0,1,0
29979,53,29979,53,allow,215,80,135,2,33,1,1
56126,445,0,0,drop,70,70,0,1,0,1,0
58638,5900,0,0,deny,62,62,0,1,0,1,0
55377,53,33641,53,allow,195,102,93,2,30,1,1
51949,5484,40071,5484,allow,70,70,0,1,5,1,0
49277,53,15554,53,allow,199,102,97,2,31,1,1
56333,53,9058,53,allow,822,102,720,2,29,1,1
50634,80,58631,80,allow,25670,13514,12156,46,36,21,25
60372,53,60372,53,allow,222,90,132,2,30,1,1
59177,53,0,0,allow,426,152,274,4,30,2,2
61127,445,0,0,drop,70,70,0,1,0,1,0
58034,445,0,0,drop,70,70,0,1,0,1,0
64520,53,48129,53,allow,198,102,96,2,30,1,1
55464,53,12452,53,allow,214,110,104,2,30,1,1
58857,443,61452,443,allow,674,130,544,11,129,3,8
21294,57470,0,0,deny,62,62,0,1,0,1,0
49639,445,0,0,drop,66,66,0,1,0,1,0
56936,80,5916,80,allow,1490,886,604,10,75,6,4
51617,21247,0,0,deny,66,66,0,1,0,1,0
52258,58792,14441,58792,allow,316,136,180,6,8,3,3
60501,40829,11084,40829,allow,70,70,0,2,8,2,0
60292,8630,2625,8630,allow,324,250,74,5,3605,4,1
65189,27214,42310,27214,allow,231,78,153,2,29,1,1
46031,443,52828,443,allow,12395,2182,10213,21,122,10,11
52123,46261,33776,46261,allow,70,70,0,1,4,1,0
64159,445,0,0,drop,70,70,0,1,0,1,0
64314,53,48605,53,allow,264,110,154,2,30,1,1
60251,445,0,0,drop,70,70,0,1,0,1,0
50600,443,20473,443,allow,5035,3194,1841,23,96,12,11
2904,44847,0,0,deny,78,78,0,1,0,1,0
56968,445,0,0,drop,70,70,0,1,0,1,0
55461,443,1970,443,allow,6314,4856,1458,18,120,11,7
32549,37807,0,0,deny,146,146,0,1,0,1,0
35515,53,6694,53,allow,199,94,105,2,29,1,1
9447,443,13084,443,allow,5691,503,5188,14,15,7,7
43747,22114,0,0,deny,66,66,0,1,0,1,0
47311,443,49307,443,allow,3398,2096,1302,19,16,10,9
52447,43890,0,0,deny,66,66,0,1,0,1,0
63034,443,51705,443,allow,37694,8319,29375,85,153,36,49
59323,53,1369,53,allow,260,86,174,2,30,1,1
57001,445,0,0,drop,70,70,0,1,0,1,0
56552,443,10361,443,allow,9518,3057,6461,21,43,12,9
59982,445,0,0,drop,66,66,0,1,0,1,0
56135,53,30728,53,allow,258,118,140,2,30,1,1
51174,445,0,0,drop,70,70,0,1,0,1,0
56788,53,36118,53,allow,198,101,97,2,30,1,1
62651,445,0,0,drop,70,70,0,1,0,1,0
52183,13503,62699,13503,allow,70,70,0,2,8,2,0
56743,53,16205,53,allow,202,103,99,2,30,1,1
55375,44847,0,0,deny,62,62,0,1,0,1,0
46410,443,3591,443,allow,4568,2057,2511,17,62,9,8
50589,53,3456,53,allow,177,94,83,2,30,1,1
49865,443,26140,443,allow,5708,1025,4683,16,35,9,7
55935,445,0,0,drop,66,66,0,1,0,1,0
55411,53,35188,53,allow,200,94,106,2,30,1,1
38999,443,34634,443,allow,12742,1983,10759,47,123,14,33
16092,50265,0,0,deny,62,62,0,1,0,1,0
44847,20009,63949,20009,allow,502,150,352,2,1200,1,1
53922,42285,39226,42285,allow,70,70,0,2,8,2,0
60731,443,42232,443,allow,12669,5297,7372,31,188,18,13
56702,445,0,0,drop,70,70,0,1,0,1,0
50280,57470,0,0,deny,78,78,0,1,0,1,0
52077,53,26834,53,allow,199,94,105,2,30,1,1
65383,443,27965,443,allow,839325,38439,800886,1027,94,451,576
59583,445,0,0,drop,70,70,0,1,0,1,0
49554,80,58941,80,allow,1515,481,1034,11,15,6,5
22075,53,22075,53,allow,404,259,145,3,33,2,1
26698,57470,0,0,deny,62,62,0,1,0,1,0
61495,37965,0,0,deny,66,66,0,1,0,1,0
53262,443,5546,443,allow,242149,7606,234543,260,150,92,168
62115,57470,0,0,deny,66,66,0,1,0,1,0
49418,27021,53913,27021,allow,232,71,161,2,30,1,1
50643,443,60929,443,allow,1512,844,668,16,64,9,7
56648,445,0,0,drop,70,70,0,1,0,1,0
18963,80,18963,80,allow,1501,652,849,9,15,5,4
57767,445,0,0,drop,70,70,0,1,0,1,0
56052,53,55355,53,allow,1392,85,1307,4,12,2,2
60401,80,25195,80,allow,190,64,126,4,103,2,2
64627,53,26278,53,allow,168,86,82,2,30,1,1
60966,443,26414,443,allow,60331,12765,47566,119,105,57,62
54530,445,0,0,drop,70,70,0,1,0,1,0
43129,20220,0,0,deny,62,62,0,1,0,1,0
49670,53,58566,53,allow,168,86,82,2,29,1,1
1749,64147,0,0,deny,66,66,0,1,0,1,0
56472,53,0,0,allow,371,77,294,2,30,1,1
52989,53,36046,53,allow,406,94,312,2,30,1,1
52995,445,0,0,drop,70,70,0,1,0,1,0
59697,445,0,0,drop,66,66,0,1,0,1,0
60150,445,0,0,drop,70,70,0,1,0,1,0
27005,27015,32826,27015,allow,880,126,754,2,30,1,1
57236,53733,0,0,deny,66,66,0,1,0,1,0
58453,50584,0,0,deny,66,66,0,1,0,1,0
55829,53,11417,53,allow,212,110,102,2,29,1,1
53665,80,59537,80,allow,4417,3685,732,16,15,10,6
58724,443,33462,443,allow,10179,4285,5894,60,272,31,29
50424,53,64071,53,allow,195,102,93,2,29,1,1
27005,27015,65078,27015,allow,878,126,752,2,30,1,1
49340,53,57846,53,allow,387,134,253,2,30,1,1
50498,53,36030,53,allow,751,94,657,2,29,1,1
58638,5900,0,0,deny,62,62,0,1,0,1,0
64589,53,29733,53,allow,742,88,654,2,30,1,1
64716,53,1067,53,allow,195,102,93,2,30,1,1
64608,53,62804,53,allow,212,110,102,2,30,1,1
49854,443,20438,443,allow,5578,2780,2798,14,120,7,7
57232,443,17235,443,allow,51152,3321,47831,81,100,38,43
56710,53,13287,53,allow,195,102,93,2,30,1,1
15641,26467,0,0,deny,62,62,0,1,0,1,0
49071,443,20590,443,allow,130,70,60,3,5,2,1
65452,445,0,0,drop,70,70,0,1,0,1,0
58391,443,1299,443,allow,347192,61325,285867,643,191,297,346
40474,23117,0,0,deny,146,146,0,1,0,1,0
61385,80,34601,80,allow,30257,2427,27830,45,255,22,23
55037,443,21745,443,allow,2639,258,2381,9,120,4,5
36499,443,51972,443,allow,1159756,1123031,36725,1206,26,753,453
53244,443,63773,443,allow,57649,2489,55160,66,69,23,43
0,0,0,0,allow,134,64,70,2,0,1,1
52775,123,25733,123,allow,184,94,90,2,30,1,1
52870,443,27625,443,allow,113894,15573,98321,182,119,67,115
3478,61463,0,0,deny,921,921,0,1,0,1,0
50288,53,0,0,allow,82,82,0,1,30,1,0
64670,53,60367,53,allow,193,102,91,2,30,1,1
56464,53,12026,53,allow,177,94,83,2,30,1,1
65159,37965,0,0,deny,74,74,0,1,0,1,0
49855,53,54307,53,allow,212,102,110,2,30,1,1
64295,445,0,0,drop,66,66,0,1,0,1,0
63173,36237,0,0,deny,66,66,0,1,0,1,0
56376,53,65133,53,allow,198,102,96,2,30,1,1
47700,51505,0,0,deny,66,66,0,1,0,1,0
52938,443,4484,443,allow,14896,6021,8875,56,115,27,29
7274,64147,0,0,deny,62,62,0,1,0,1,0
65072,80,65072,80,allow,250600,11390,239210,268,23,98,170
48817,16156,48817,16156,allow,513,152,361,2,1200,1,1
7041,37965,0,0,deny,66,66,0,1,0,1,0
62348,65348,0,0,deny,145,145,0,1,0,1,0
32970,443,36092,443,allow,8910,2660,6250,24,18,13,11
30443,44847,0,0,deny,62,62,0,1,0,1,0
58190,53,48181,53,allow,648,86,562,4,51,2,2
56958,53,59654,53,allow,816,102,714,2,30,1,1
59314,443,58564,443,allow,16862,7584,9278,97,8912,60,37
6881,34746,2559,34746,allow,484,150,334,2,1200,1,1
58638,5900,0,0,deny,62,62,0,1,0,1,0
53607,51631,46867,51631,allow,70,70,0,1,4,1,0
59347,57470,0,0,deny,66,66,0,1,0,1,0
64592,53,65035,53,allow,209,110,99,2,31,1,1
49418,52013,42400,52013,allow,278,78,200,2,31,1,1
61323,23117,0,0,deny,62,62,0,1,0,1,0
52216,80,58055,80,allow,15824,805,15019,25,18,9,16
55694,53,17874,53,allow,274,85,189,4,35,2,2
64185,445,0,0,drop,70,70,0,1,0,1,0
63276,445,0,0,drop,70,70,0,1,0,1,0
55317,53,22104,53,allow,94,94,0,1,30,1,0
57023,53,46258,53,allow,179,94,85,2,29,1,1
60779,445,0,0,drop,70,70,0,1,0,1,0
54216,445,0,0,drop,70,70,0,1,0,1,0
61689,443,8639,443,allow,8036,3293,4743,32,48,18,14
57068,445,0,0,drop,70,70,0,1,0,1,0
52346,445,0,0,drop,70,70,0,1,0,1,0
13414,23,0,0,deny,60,60,0,1,0,1,0
50418,443,31085,443,allow,4507,744,3763,17,29,7,10
62282,445,0,0,drop,70,70,0,1,0,1,0
55095,53,54084,53,allow,783,96,687,2,30,1,1
38608,443,19892,443,allow,17473899,604274,16869625,22165,408,7731,14434
57021,443,20461,443,allow,227559,47160,180399,379,143,187,192
58753,443,18417,443,allow,10379,2361,8018,27,20,16,11
64406,53,8536,53,allow,102,102,0,2,31,2,0
58930,60038,0,0,allow,66,66,0,1,91,1,0
64444,445,0,0,drop,70,70,0,1,0,1,0
0,0,0,0,deny,182,182,0,1,0,1,0
55462,53,36387,53,allow,579,88,491,4,35,2,2
59549,50584,0,0,deny,66,66,0,1,0,1,0
59730,443,46246,443,allow,303,85,218,2,30,1,1
52731,445,0,0,drop,70,70,0,1,0,1,0
64037,53,2722,53,allow,215,94,121,2,29,1,1
56603,53,59539,53,allow,168,86,82,2,31,1,1
4567,80,4567,80,allow,23456,1005,22451,32,16,13,19
57440,443,35509,443,allow,8200,2465,5735,30,18,14,16
56586,53,39065,53,allow,177,94,83,2,30,1,1
56755,31774,8678,31774,allow,378,192,186,7,15,4,3
61026,445,0,0,drop,66,66,0,1,0,1,0
62892,445,0,0,drop,70,70,0,1,0,1,0
56805,53,62222,53,allow,815,95,720,2,31,1,1
58129,445,0,0,drop,70,70,0,1,0,1,0
61336,61689,0,0,deny,66,66,0,1,0,1,0
40204,40031,4239,40031,allow,140,78,62,2,29,1,1
54009,445,0,0,drop,70,70,0,1,0,1,0
62170,443,62170,443,allow,28026,5723,22303,62,20,32,30
57360,18375,0,0,deny,66,66,0,1,0,1,0
63876,5968,28223,5968,allow,66,66,0,2,8,2,0
58638,5900,0,0,deny,62,62,0,1,0,1,0
55467,53,17631,53,allow,193,102,91,2,29,1,1
49749,80,64733,80,allow,230959,4381,226578,217,91,60,157
56765,53,64406,53,allow,194,102,92,2,29,1,1
37666,48817,0,0,deny,146,146,0,1,0,1,0
51663,445,0,0,drop,70,70,0,1,0,1,0
50638,443,50638,443,allow,4544,1637,2907,19,26,11,8
14397,37965,0,0,deny,62,62,0,1,0,1,0
6881,6881,29502,6881,allow,231,111,120,2,1200,1,1
53449,445,0,0,drop,66,66,0,1,0,1,0
49687,53,16473,53,allow,197,102,95,2,29,1,1
54205,445,0,0,drop,70,70,0,1,0,1,0
56540,53,53541,53,allow,735,88,647,2,30,1,1
49943,53,23345,53,allow,596,90,506,4,59,2,2
50970,443,47824,443,allow,469,403,66,4,0,3,1
56152,53,61194,53,allow,190,97,93,2,31,1,1
64854,53,60425,53,allow,178,94,84,2,30,1,1
57251,443,64913,443,allow,54515,20774,33741,167,36,88,79
49988,53,19025,53,allow,214,102,112,2,30,1,1
56112,53,18781,53,allow,199,102,97,2,30,1,1
59422,445,0,0,drop,70,70,0,1,0,1,0
64221,53,19919,53,allow,262,102,160,2,30,1,1
60092,51505,0,0,deny,62,62,0,1,0,1,0
49700,80,32872,80,allow,56411,2447,53964,58,130,19,39
1026,64147,0,0,deny,145,145,0,1,0,1,0
51216,22,51216,22,allow,5806,2153,3653,33,24,18,15
19068,37965,0,0,deny,62,62,0,1,0,1,0
64509,445,0,0,drop,70,70,0,1,0,1,0
56377,53,45673,53,allow,793,101,692,2,31,1,1
63852,35440,0,0,deny,66,66,0,1,0,1,0
53163,445,0,0,drop,66,66,0,1,0,1,0
54529,445,0,0,drop,70,70,0,1,0,1,0
56749,443,28025,443,allow,8058,2038,6020,20,15,11,9
51810,445,0,0,drop,70,70,0,1,0,1,0
5588,5588,0,0,allow,3562,1936,1626,48,191,24,24
49216,445,0,0,drop,66,66,0,1,0,1,0
64714,53,41976,53,allow,212,102,110,2,30,1,1
47134,37965,0,0,deny,62,62,0,1,0,1,0
57411,53,7355,53,allow,196,102,94,2,30,1,1
49701,53,55177,53,allow,197,102,95,2,30,1,1
64619,53,62516,53,allow,229,94,135,2,30,1,1
56528,64147,0,0,deny,62,62,0,1,0,1,0
18173,25174,0,0,deny,66,66,0,1,0,1,0
54011,22114,0,0,deny,62,62,0,1,0,1,0
6890,27520,0,0,deny,146,146,0,1,0,1,0
58143,57866,0,0,deny,66,66,0,1,0,1,0
56004,53,34719,53,allow,177,94,83,2,30,1,1
35051,53,35051,53,allow,194,87,107,2,31,1,1
50414,445,0,0,drop,66,66,0,1,0,1,0
57441,53,33174,53,allow,177,94,83,2,30,1,1
53815,443,57260,443,allow,499,425,74,4,0,3,1
60405,64722,47645,64722,allow,70,70,0,2,8,2,0
27005,27015,31409,27015,allow,891,126,765,2,31,1,1
56411,53,48736,53,allow,184,94,90,2,31,1,1
54250,443,54030,443,allow,499,425,74,4,0,3,1
55029,443,11495,443,allow,7682,3198,4484,27,17,16,11
56100,53,62385,53,allow,211,102,109,2,30,1,1
40204,40031,12730,40031,allow,245,182,63,2,30,1,1
9243,80,7873,80,allow,318,192,126,6,26,4,2
27005,27241,34573,27241,allow,885,126,759,2,30,1,1
65024,53,56492,53,allow,174,89,85,2,31,1,1
46332,443,57498,443,allow,3132,1697,1435,17,15,10,7
51698,445,0,0,drop,66,66,0,1,0,1,0
49958,445,0,0,drop,70,70,0,1,0,1,0
49960,445,0,0,drop,70,70,0,1,0,1,0
60261,25174,0,0,deny,66,66,0,1,0,1,0
45964,3111,0,0,deny,60,60,0,1,0,1,0
42959,443,5921,443,allow,795,795,0,2,154,2,0
55266,445,0,0,drop,70,70,0,1,0,1,0
50073,445,0,0,drop,70,70,0,1,0,1,0
58775,445,0,0,drop,66,66,0,1,0,1,0
56152,53,29649,53,allow,195,102,93,2,30,1,1
57842,445,0,0,drop,66,66,0,1,0,1,0
64884,53,27376,53,allow,195,102,93,2,31,1,1
55046,53,35740,53,allow,198,102,96,2,30,1,1
61454,443,53913,443,allow,8673,1722,6951,30,125,18,12
49942,80,49942,80,allow,323714,18296,305418,384,22,165,219
51609,443,37311,443,allow,4598,2312,2286,17,34,9,8
63417,445,0,0,drop,70,70,0,1,0,1,0
14352,8055,0,0,deny,148,148,0,1,0,1,0
60839,445,0,0,drop,66,66,0,1,0,1,0
51784,8245,58196,8245,allow,280,214,66,2,31,1,1
50614,445,0,0,drop,66,66,0,1,0,1,0
60891,443,59680,443,allow,4895,3822,1073,24,49,13,11
64138,445,0,0,deny,70,70,0,1,0,1,0
64984,53,54223,53,allow,177,94,83,2,30,1,1
50483,80,35746,80,allow,374,192,182,7,25,4,3
49713,53,37729,53,allow,177,94,83,2,30,1,1
56697,53,16898,53,allow,198,102,96,2,29,1,1
55518,445,0,0,drop,70,70,0,1,0,1,0
54683,445,0,0,drop,70,70,0,1,0,1,0
49709,443,24927,443,allow,523518,15431,508087,466,210,109,357
41820,80,9493,80,allow,1056,362,694,10,49,6,4
61315,445,0,0,drop,70,70,0,1,0,1,0
53228,443,43258,443,allow,5026,973,4053,19,59,10,9
55098,53,22759,53,allow,474,200,274,6,44,3,3
9141,80,1670,80,allow,378,192,186,7,29,4,3
54366,443,39148,443,allow,17629,5828,11801,39,41,20,19
64582,53,29517,53,allow,209,110,99,2,30,1,1
37540,443,32914,443,allow,6749,2315,4434,24,46,14,10
56468,53,49469,53,allow,209,110,99,2,30,1,1
49733,443,55919,443,allow,7673,1637,6036,31,23,16,15
51076,25174,0,0,deny,146,146,0,1,0,1,0
55713,25174,0,0,deny,62,62,0,1,0,1,0
63140,30685,55473,30685,allow,70,70,0,2,8,2,0
56795,53,50687,53,allow,177,94,83,2,29,1,1
53770,64147,0,0,deny,66,66,0,1,0,1,0
58883,443,6061,443,allow,5476,3102,2374,42,132,23,19
64716,53,37975,53,allow,190,97,93,2,31,1,1
65093,445,0,0,drop,66,66,0,1,0,1,0
27005,27015,15962,27015,allow,906,126,780,2,30,1,1
33043,443,36029,443,allow,1788,968,820,20,15,11,9
2791,7302,0,0,deny,62,62,0,1,0,1,0
56385,445,0,0,drop,66,66,0,1,0,1,0
42767,443,1762,443,allow,8995,2498,6497,40,256,19,21
51834,35440,0,0,deny,66,66,0,1,0,1,0
46378,443,41415,443,allow,10675,4478,6197,25,16,13,12
54684,37965,0,0,deny,62,62,0,1,0,1,0
41620,53,41620,53,allow,257,101,156,2,32,1,1
51948,17372,0,0,deny,62,62,0,1,0,1,0
49168,57470,0,0,deny,66,66,0,1,0,1,0
54601,26467,0,0,deny,66,66,0,1,0,1,0
23122,26296,0,0,deny,159,159,0,1,0,1,0
60778,445,0,0,drop,70,70,0,1,0,1,0
2691,64147,0,0,deny,62,62,0,1,0,1,0
54319,445,0,0,drop,70,70,0,1,0,1,0
64758,445,0,0,drop,70,70,0,1,0,1,0
43750,443,22954,443,allow,248384,70243,178141,544,588,246,298
6486,64147,0,0,deny,62,62,0,1,0,1,0
64191,53,1179,53,allow,212,102,110,2,30,1,1
59276,445,0,0,drop,66,66,0,1,0,1,0
55824,53,12441,53,allow,196,102,94,2,30,1,1
50630,445,0,0,drop,70,70,0,1,0,1,0
51967,443,12004,443,allow,21063,13499,7564,47,68,25,22
55343,53,13186,53,allow,770,101,669,2,31,1,1
61859,445,0,0,drop,70,70,0,1,0,1,0
56215,445,0,0,drop,70,70,0,1,0,1,0
57331,53,47400,53,allow,178,94,84,2,31,1,1
21365,23718,0,0,deny,62,62,0,1,0,1,0
54550,53,0,0,allow,188,86,102,2,29,1,1
52180,20121,52199,20121,allow,70,70,0,2,7,2,0
58895,443,55555,443,allow,148,82,66,2,10,1,1
53835,62413,0,0,deny,62,62,0,1,0,1,0
57231,53,57692,53,allow,168,86,82,2,32,1,1
3559,51050,0,0,deny,146,146,0,1,0,1,0
49348,53,64482,53,allow,214,94,120,2,31,1,1
57470,49160,27757,49160,allow,402,132,270,6,1209,3,3
61637,25174,0,0,deny,66,66,0,1,0,1,0
57470,61803,17706,61803,allow,792,792,0,13,1200,13,0
58916,443,3751,443,allow,6376,4098,2278,20,16,10,10
48509,443,53083,443,allow,4922,950,3972,17,34,10,7
57987,56125,0,0,deny,90,90,0,1,0,1,0
56344,53,18094,53,allow,167,86,81,2,30,1,1
49385,53,9929,53,allow,843,285,558,8,56,4,4
60263,445,0,0,drop,70,70,0,1,0,1,0
62468,445,0,0,drop,70,70,0,1,0,1,0
52136,42939,1692,42939,allow,70,70,0,1,5,1,0
36400,51505,0,0,deny,62,62,0,1,0,1,0
3764,9694,0,0,deny,66,66,0,1,0,1,0
54693,445,0,0,drop,70,70,0,1,0,1,0
59390,445,0,0,drop,70,70,0,1,0,1,0
58836,44847,0,0,deny,74,74,0,1,0,1,0
57040,53,36140,53,allow,179,94,85,2,31,1,1
54061,443,17849,443,allow,126027,103934,22093,380,239,237,143
64113,53,6414,53,allow,216,102,114,2,30,1,1
36933,23117,0,0,deny,66,66,0,1,0,1,0
52907,445,0,0,drop,66,66,0,1,0,1,0
55554,22114,0,0,deny,62,62,0,1,0,1,0
50167,53,41841,53,allow,260,86,174,2,30,1,1
55790,53,54535,53,allow,177,94,83,2,30,1,1
48966,53,48747,53,allow,168,78,90,2,30,1,1
54905,445,0,0,drop,70,70,0,1,0,1,0
1143,25198,0,0,deny,148,148,0,1,0,1,0
11937,35440,0,0,deny,146,146,0,1,0,1,0
42076,443,12944,443,allow,4295,2123,2172,11,121,6,5
56703,53,61350,53,allow,198,101,97,2,31,1,1
49257,445,0,0,drop,70,70,0,1,0,1,0
49591,5228,57295,5228,allow,18548,2772,15776,41,3957,17,24
59957,445,0,0,drop,70,70,0,1,0,1,0
63970,53,19074,53,allow,228,110,118,2,30,1,1
65343,53,9995,53,allow,197,102,95,2,30,1,1
46726,53,27470,53,allow,168,78,90,2,30,1,1
56429,443,9683,443,allow,355939,9284,346655,365,121,125,240
60548,445,0,0,drop,66,66,0,1,0,1,0
38086,53,54095,53,allow,199,94,105,2,30,1,1
58638,5900,0,0,deny,62,62,0,1,0,1,0
50021,53,58776,53,allow,963,391,572,10,83,5,5
3818,37965,0,0,deny,66,66,0,1,0,1,0
44408,57470,0,0,deny,62,62,0,1,0,1,0
57860,445,0,0,drop,66,66,0,1,0,1,0
57606,443,30554,443,allow,2614,1689,925,18,22,10,8
62320,445,0,0,drop,70,70,0,1,0,1,0
63171,445,0,0,drop,70,70,0,1,0,1,0
63945,53,11861,53,allow,216,110,106,2,31,1,1
64135,53,50232,53,allow,192,98,94,2,31,1,1
49734,23,0,0,deny,60,60,0,1,0,1,0
56744,53,44320,53,allow,740,93,647,2,31,1,1
55019,443,52718,443,allow,6484,1915,4569,26,131,14,12
7968,53,7968,53,allow,407,261,146,3,32,2,1
56654,443,1981,443,allow,8007,1987,6020,20,15,11,9
63474,48817,0,0,deny,62,62,0,1,0,1,0
51534,443,19846,443,allow,262,70,192,5,21,2,3
59808,53,0,0,allow,86,86,0,1,30,1,0
56577,445,0,0,drop,66,66,0,1,0,1,0
15239,53,15239,53,allow,229,89,140,2,30,1,1
41249,50584,0,0,deny,66,66,0,1,0,1,0
59701,44847,0,0,deny,62,62,0,1,0,1,0
65482,53,40607,53,allow,174,89,85,2,31,1,1
64615,53,40640,53,allow,198,94,104,2,30,1,1
57100,53,41347,53,allow,192,90,102,2,31,1,1
63581,445,0,0,drop,70,70,0,1,0,1,0
13027,64147,0,0,deny,62,62,0,1,0,1,0
19698,502,0,0,deny,60,60,0,1,0,1,0
0,0,0,0,deny,98,98,0,1,0,1,0
60740,443,50087,443,allow,12605,5558,7047,42,101,18,24
60146,53,47250,53,allow,218,78,140,2,30,1,1
49758,443,14307,443,allow,17412,6917,10495,38,63,20,18
64872,53,35777,53,allow,164,84,80,2,30,1,1
53179,80,43162,80,allow,1628,828,800,10,25,6,4
0,0,0,0,allow,480,244,236,4,0,2,2
60195,80,59592,80,allow,70,70,0,1,5,1,0
6712,161,0,0,deny,82,82,0,1,0,1,0
39992,443,33603,443,allow,3470,1045,2425,13,121,6,7
5223,44091,0,0,deny,167,167,0,1,0,1,0
26729,57470,0,0,deny,66,66,0,1,0,1,0
49308,53,30302,53,allow,195,102,93,2,31,1,1
54737,50584,0,0,deny,66,66,0,1,0,1,0
64841,53,21377,53,allow,173,94,79,2,30,1,1
55950,443,51183,443,allow,6490,1789,4701,30,95,16,14
53575,53,50120,53,allow,198,93,105,2,30,1,1
50265,21544,58613,21544,allow,390,266,124,6,1200,4,2
55487,53,60324,53,allow,199,102,97,2,31,1,1
61496,443,4674,443,allow,27232,3841,23391,42,38,17,25
49878,53,52467,53,allow,262,126,136,2,30,1,1
56928,53,56928,53,allow,823,98,725,2,30,1,1
49531,26467,0,0,deny,66,66,0,1,0,1,0
61419,57470,0,0,deny,66,66,0,1,0,1,0
56726,443,29318,443,allow,7941,1952,5989,20,15,11,9
32955,80,30230,80,allow,14961,937,14024,25,16,11,14
55269,53,51344,53,allow,193,102,91,2,30,1,1
43185,443,5462,443,allow,6951,1333,5618,26,271,14,12
14715,56205,0,0,deny,62,62,0,1,0,1,0
32474,48817,0,0,deny,148,148,0,1,0,1,0
59668,50584,0,0,deny,66,66,0,1,0,1,0
443,45788,0,0,deny,332,332,0,1,0,1,0
57083,53,27580,53,allow,198,102,96,2,30,1,1
56589,53,29602,53,allow,199,102,97,2,30,1,1
49440,53,37784,53,allow,210,102,108,2,29,1,1
35965,443,35465,443,allow,14940,9434,5506,30,105,17,13
3802,55777,0,0,deny,66,66,0,1,0,1,0
61387,43890,0,0,deny,62,62,0,1,0,1,0
63431,443,3951,443,allow,3182,1568,1614,8,120,4,4
50993,445,0,0,drop,66,66,0,1,0,1,0
22168,25174,0,0,deny,146,146,0,1,0,1,0
51085,56205,0,0,deny,66,66,0,1,0,1,0
52053,34411,40436,34411,allow,70,70,0,1,4,1,0
60495,6882,55669,6882,allow,70,70,0,2,8,2,0
49996,53,34015,53,allow,210,102,108,2,30,1,1
55681,31948,3131,31948,allow,70,70,0,2,8,2,0
48144,443,29490,443,allow,16198,9822,6376,54,35,28,26
55933,445,0,0,drop,70,70,0,1,0,1,0
49624,53,37843,53,allow,216,94,122,2,30,1,1
6881,6881,60771,6881,allow,150,150,0,1,1200,1,0
59993,443,5215,443,allow,6452,2146,4306,30,125,14,16
56095,445,0,0,drop,70,70,0,1,0,1,0
52469,445,0,0,drop,66,66,0,1,0,1,0
49846,445,0,0,drop,70,70,0,1,0,1,0
60295,80,60202,80,allow,8876,1061,7815,18,144,9,9
52573,445,0,0,drop,70,70,0,1,0,1,0
51828,445,0,0,drop,66,66,0,1,0,1,0
62591,445,0,0,drop,70,70,0,1,0,1,0
24037,53415,0,0,deny,76,76,0,1,0,1,0
61956,445,0,0,drop,70,70,0,1,0,1,0
58305,445,0,0,drop,70,70,0,1,0,1,0
58765,443,24675,443,allow,26158,17265,8893,57,19,31,26
6666,6001,0,0,deny,60,60,0,1,0,1,0
49746,53,11363,53,allow,236,94,142,2,29,1,1
34616,443,64459,443,allow,9265,4429,4836,23,18,14,9
63096,44847,0,0,deny,66,66,0,1,0,1,0
50690,443,9122,443,allow,152,86,66,2,4,1,1
48867,443,13159,443,allow,6107,2079,4028,19,68,11,8
32381,50584,0,0,deny,66,66,0,1,0,1,0
44075,80,12675,80,allow,3560,1256,2304,22,86,10,12
50427,445,0,0,drop,70,70,0,1,0,1,0
51497,443,45992,443,allow,4945,1060,3885,21,15,12,9
51218,445,0,0,drop,70,70,0,1,0,1,0
0,0,0,0,deny,94,94,0,1,0,1,0
59505,53733,0,0,deny,66,66,0,1,0,1,0
50549,43890,0,0,deny,66,66,0,1,0,1,0
50328,53,20316,53,allow,783,96,687,2,30,1,1
52061,80,7969,80,allow,366,240,126,7,25,5,2
56803,53,49854,53,allow,195,102,93,2,29,1,1
6881,6881,0,0,deny,62,62,0,1,0,1,0
55600,22,0,0,deny,60,60,0,1,0,1,0
63873,44847,0,0,deny,62,62,0,1,0,1,0
20371,35440,0,0,deny,62,62,0,1,0,1,0
39880,80,44153,80,allow,1779,793,986,17,58,6,11
37602,443,57970,443,allow,573,425,148,5,0,3,2
7978,50584,0,0,deny,66,66,0,1,0,1,0
59855,445,0,0,drop,66,66,0,1,0,1,0
64332,53,56016,53,allow,195,102,93,2,30,1,1
53002,443,30088,443,allow,16537,4585,11952,46,96,24,22
45846,443,37447,443,allow,4819,829,3990,15,40,8,7
36407,443,52772,443,allow,1149,709,440,13,38,8,5
51182,445,0,0,drop,66,66,0,1,0,1,0
55853,53,55965,53,allow,197,102,95,2,30,1,1
64406,25174,0,0,deny,62,62,0,1,0,1,0
60867,443,29499,443,allow,3072,2174,898,14,317,8,6
50008,53,2633,53,allow,232,94,138,2,29,1,1
51620,56205,0,0,deny,66,66,0,1,0,1,0
60579,25174,0,0,deny,62,62,0,1,0,1,0
49167,80,49167,80,allow,1915,1466,449,10,20,6,4
23197,44847,0,0,deny,62,62,0,1,0,1,0
52248,9323,44483,9323,allow,210,70,140,4,8,2,2
52957,53,50377,53,allow,168,78,90,2,29,1,1
10151,27715,29644,27715,allow,460,150,310,2,1200,1,1
3478,61463,0,0,deny,343,343,0,1,0,1,0
48841,51221,0,0,deny,62,62,0,1,0,1,0
64093,64828,53558,64828,allow,70,70,0,1,4,1,0
40165,443,53877,443,allow,232,172,60,3,5,2,1
49620,53,16282,53,allow,198,110,88,2,29,1,1
57272,443,35317,443,allow,6445,2145,4300,29,33,17,12
51304,443,20155,443,allow,7134,3081,4053,24,121,11,13
63467,37807,0,0,deny,62,62,0,1,0,1,0
50529,44847,0,0,deny,66,66,0,1,0,1,0
26800,22,0,0,deny,60,60,0,1,0,1,0
56014,443,56014,443,allow,4334,1427,2907,19,30,11,8
11030,37965,0,0,deny,62,62,0,1,0,1,0
55013,443,19104,443,allow,7531,1773,5758,30,32,17,13
52467,443,14984,443,allow,5343,1102,4241,22,152,11,11
63108,445,0,0,drop,70,70,0,1,0,1,0
32860,53,58856,53,allow,168,78,90,2,30,1,1
44048,443,44048,443,allow,4401,1494,2907,19,29,11,8
45822,443,11470,443,allow,4201,2089,2112,11,120,6,5
52321,443,52321,443,allow,6727,762,5965,15,25,8,7
56717,443,27833,443,allow,8006,1986,6020,20,15,11,9
24041,55783,0,0,deny,62,62,0,1,0,1,0
14333,51050,0,0,deny,62,62,0,1,0,1,0
62845,445,0,0,drop,70,70,0,1,0,1,0
65025,53,29192,53,allow,786,110,676,2,29,1,1
49411,53,16636,53,allow,190,97,93,2,31,1,1
63016,53,49407,53,allow,243,94,149,2,30,1,1
33115,443,15120,443,allow,75816,2178,73638,72,16,20,52
58638,5900,0,0,deny,62,62,0,1,0,1,0
55142,26467,0,0,deny,62,62,0,1,0,1,0
54654,445,0,0,drop,70,70,0,1,0,1,0
50850,445,0,0,drop,66,66,0,1,0,1,0
15959,56205,0,0,deny,62,62,0,1,0,1,0
56676,445,0,0,drop,70,70,0,1,0,1,0
65448,53,6069,53,allow,264,110,154,2,30,1,1
43677,443,7474,443,allow,7698,2373,5325,21,159,12,9
56825,53,3164,53,allow,177,94,83,2,30,1,1
58686,445,0,0,drop,70,70,0,1,0,1,0
58638,5900,0,0,deny,62,62,0,1,0,1,0
59408,443,57336,443,allow,2914,1780,1134,16,15,8,8
44929,443,44929,443,allow,5469,2222,3247,22,38,13,9
56005,53,41493,53,allow,403,142,261,2,30,1,1
61315,53,20800,53,allow,8616,4944,3672,22,87,11,11
5223,1210,0,0,deny,103,103,0,1,0,1,0
41473,443,44182,443,allow,4987881,144889,4842992,5257,85,1888,3369
49754,53,54663,53,allow,176,90,86,2,31,1,1
58564,445,0,0,drop,66,66,0,1,0,1,0
53208,18375,0,0,deny,62,62,0,1,0,1,0
55890,53,50894,53,allow,186,95,91,2,31,1,1
49699,53,49094,53,allow,209,110,99,2,30,1,1
54447,443,59840,443,allow,9818,2008,7810,23,317,12,11
62396,445,0,0,drop,70,70,0,1,0,1,0
57257,53,11711,53,allow,764,99,665,2,30,1,1
55887,53,54286,53,allow,166,86,80,2,31,1,1
55016,1113,36871,1113,allow,6723,1881,4842,25,16,15,10
56926,445,0,0,drop,70,70,0,1,0,1,0
56273,53,61553,53,allow,194,99,95,2,30,1,1
49624,445,0,0,drop,70,70,0,1,0,1,0
49333,445,0,0,drop,66,66,0,1,0,1,0
53162,445,0,0,drop,70,70,0,1,0,1,0
35717,443,25554,443,allow,8290,2954,5336,24,361,13,11
64567,53,8117,53,allow,193,102,91,2,29,1,1
3478,61463,0,0,deny,1188,1188,0,1,0,1,0
49573,443,10413,443,allow,1326,876,450,11,55,6,5
55674,48870,28202,48870,allow,70,70,0,1,5,1,0
55990,53,28837,53,allow,183,94,89,2,30,1,1
58943,443,29236,443,allow,6611,4273,2338,22,17,11,11
50396,62413,0,0,deny,66,66,0,1,0,1,0
49418,27025,2656,27025,allow,250,78,172,2,30,1,1
62348,50584,0,0,deny,62,62,0,1,0,1,0
26425,22114,0,0,deny,62,62,0,1,0,1,0
65187,53,19736,53,allow,392,86,306,2,30,1,1
42030,25,0,0,deny,74,74,0,1,0,1,0
50994,35974,0,0,deny,60,60,0,1,0,1,0
57995,445,0,0,drop,70,70,0,1,0,1,0
27005,27015,45773,27015,allow,899,126,773,2,30,1,1
44847,6881,11410,6881,allow,502,150,352,2,1200,1,1
9108,443,64667,443,allow,5510,901,4609,15,26,8,7
60024,445,0,0,drop,70,70,0,1,0,1,0
5729,22114,0,0,deny,62,62,0,1,0,1,0
62729,445,0,0,drop,66,66,0,1,0,1,0
57330,53,61035,53,allow,177,94,83,2,30,1,1
67,68,0,0,deny,346,346,0,1,0,1,0
63813,53455,26592,53455,allow,66,66,0,2,7,2,0
62872,50584,0,0,deny,66,66,0,1,0,1,0
49308,53,35422,53,allow,320,97,223,4,50,2,2
52808,445,0,0,drop,66,66,0,1,0,1,0
57874,26467,0,0,deny,62,62,0,1,0,1,0
13589,22114,0,0,deny,146,146,0,1,0,1,0
61701,445,0,0,drop,70,70,0,1,0,1,0
63403,445,0,0,drop,70,70,0,1,0,1,0
51214,443,63195,443,allow,7924,3247,4677,32,71,19,13
56052,53,22562,53,allow,177,94,83,2,30,1,1
52042,38074,53103,38074,allow,70,70,0,2,8,2,0
65507,443,3045,443,allow,453047,13340,439707,469,16,165,304
45344,53,14086,53,allow,538,328,210,3,29,2,1
50610,445,0,0,drop,66,66,0,1,0,1,0
64877,37450,0,0,deny,66,66,0,1,0,1,0
60048,445,0,0,drop,70,70,0,1,0,1,0
56704,53,33003,53,allow,711,87,624,2,30,1,1
40729,123,44305,123,allow,184,94,90,2,30,1,1
65221,445,0,0,drop,70,70,0,1,0,1,0
62953,445,0,0,drop,66,66,0,1,0,1,0
6881,6881,0,0,deny,146,146,0,1,0,1,0
13160,7905,0,0,deny,62,62,0,1,0,1,0
48817,7294,48817,7294,allow,479,152,327,2,1200,1,1
49369,445,0,0,drop,70,70,0,1,0,1,0
64710,53,1727,53,allow,195,102,93,2,29,1,1
39941,2767,0,0,deny,62,62,0,1,0,1,0
50920,443,1716,443,allow,24070,16123,7947,82,6308,42,40
54819,443,59534,443,allow,3429,1188,2241,13,134,6,7
55104,443,37071,443,allow,10470,3626,6844,20,131,9,11
58889,443,6054,443,allow,7871,5455,2416,24,18,13,11
26451,80,26451,80,allow,642,338,304,10,32,6,4
54458,64147,0,0,deny,62,62,0,1,0,1,0
60029,443,40871,443,allow,1057,590,467,11,142,6,5
63533,445,0,0,drop,70,70,0,1,0,1,0
63149,445,0,0,drop,66,66,0,1,0,1,0
37522,22114,0,0,deny,62,62,0,1,0,1,0
27005,27237,41184,27237,allow,891,126,765,2,30,1,1
61441,443,10709,443,allow,7832,1143,6689,19,31,9,10
58530,445,0,0,drop,66,66,0,1,0,1,0
65253,53,35458,53,allow,321,150,171,2,30,1,1
48706,23393,0,0,deny,60,60,0,1,0,1,0
50312,80,40765,80,allow,2699,1007,1692,14,64,7,7
12605,57470,0,0,deny,62,62,0,1,0,1,0
14445,443,55284,443,allow,2589,1443,1146,18,15,8,10
52933,80,52933,80,allow,98765,5293,93472,131,199,48,83
64912,53,33217,53,allow,183,94,89,2,31,1,1
55751,53,8390,53,allow,216,94,122,2,30,1,1
44512,443,54023,443,allow,1101393,30310,1071083,1137,109,381,756
50280,57470,0,0,deny,78,78,0,1,0,1,0
48681,11392,0,0,deny,62,62,0,1,0,1,0
49474,443,32026,443,allow,10315,2018,8297,24,158,12,12
3667,56205,0,0,deny,62,62,0,1,0,1,0
49762,53,23081,53,allow,760,97,663,2,30,1,1
55014,53,9068,53,allow,716,95,621,2,31,1,1
57470,35667,24783,35667,allow,132,132,0,3,1200,3,0
51701,24343,49961,24343,allow,70,70,0,1,5,1,0
31950,22114,0,0,deny,62,62,0,1,0,1,0
65048,53,15306,53,allow,297,96,201,4,42,2,2
55582,53,11114,53,allow,778,103,675,2,31,1,1
58327,445,0,0,drop,70,70,0,1,0,1,0
51243,445,0,0,drop,70,70,0,1,0,1,0
2332,35440,0,0,deny,66,66,0,1,0,1,0
57810,445,0,0,drop,66,66,0,1,0,1,0
52234,64624,43132,64624,allow,136,136,0,3,14,3,0
41410,30188,0,0,deny,146,146,0,1,0,1,0
55058,53,37390,53,allow,216,110,106,2,30,1,1
55534,53,10719,53,allow,168,86,82,2,29,1,1
56888,445,0,0,drop,66,66,0,1,0,1,0
30084,21247,0,0,deny,146,146,0,1,0,1,0
54389,445,0,0,drop,70,70,0,1,0,1,0
50403,445,0,0,drop,66,66,0,1,0,1,0
64939,445,0,0,drop,66,66,0,1,0,1,0
51685,80,11134,80,allow,1516,481,1035,11,15,6,5
49254,53,31955,53,allow,814,110,704,2,30,1,1
52022,445,0,0,drop,66,66,0,1,0,1,0
52625,445,0,0,drop,70,70,0,1,0,1,0
50491,443,45806,443,allow,1304,878,426,12,78,7,5
61967,445,0,0,drop,70,70,0,1,0,1,0
62322,80,60035,80,allow,384,384,0,7,34,7,0
50581,445,0,0,drop,70,70,0,1,0,1,0
58077,36653,28921,36653,allow,268,128,140,5,10,3,2
0,0,0,0,deny,98,98,0,1,0,1,0
56211,445,0,0,drop,66,66,0,1,0,1,0
56728,53,8699,53,allow,166,86,80,2,31,1,1
65429,53,14191,53,allow,200,94,106,2,30,1,1
53028,80,62533,80,allow,70,70,0,1,5,1,0
35589,25174,0,0,deny,66,66,0,1,0,1,0
64091,80,64091,80,allow,2244,1505,739,11,146,6,5
49305,53,20734,53,allow,571,181,390,6,73,3,3
53043,445,0,0,drop,66,66,0,1,0,1,0
18086,25174,0,0,deny,62,62,0,1,0,1,0
25565,13556,0,0,deny,60,60,0,1,0,1,0
59436,22114,0,0,deny,66,66,0,1,0,1,0
56134,53,59241,53,allow,183,94,89,2,29,1,1
60786,51505,0,0,deny,66,66,0,1,0,1,0
56671,80,31736,80,allow,234,234,0,4,12,4,0
45908,33330,0,0,deny,60,60,0,1,0,1,0
54559,445,0,0,drop,70,70,0,1,0,1,0
50450,80,35672,80,allow,2781,563,2218,11,125,6,5
53354,445,0,0,drop,70,70,0,1,0,1,0
65008,445,0,0,drop,70,70,0,1,0,1,0
46260,80,59881,80,allow,3459,1620,1839,16,186,10,6
49766,80,16081,80,allow,254,128,126,5,15,3,2
64030,24096,24415,24096,allow,442,320,122,7,17,5,2
63595,51050,0,0,deny,66,66,0,1,0,1,0
10834,50584,0,0,deny,62,62,0,1,0,1,0
49197,30188,0,0,deny,62,62,0,1,0,1,0
51807,10920,47874,10920,allow,70,70,0,2,8,2,0
51244,1,0,0,deny,100,100,0,1,0,1,0
56897,7003,14885,7003,allow,1098,672,426,14,734,8,6
55411,53,33954,53,allow,183,94,89,2,30,1,1
35760,11392,0,0,deny,146,146,0,1,0,1,0
38320,51505,0,0,deny,66,66,0,1,0,1,0
43969,7000,43969,7000,allow,3370,1595,1775,16,15,9,7
55163,53,9459,53,allow,197,102,95,2,30,1,1
1024,50265,0,0,deny,62,62,0,1,0,1,0
52086,27156,8001,27156,allow,136,136,0,3,14,3,0
55169,53,40051,53,allow,199,102,97,2,30,1,1
35100,11392,0,0,deny,62,62,0,1,0,1,0
0,0,0,0,deny,98,98,0,1,0,1,0
42969,8146,0,0,deny,62,62,0,1,0,1,0
55229,53,8520,53,allow,173,94,79,2,30,1,1
53618,445,0,0,drop,70,70,0,1,0,1,0
53278,443,21560,443,allow,38395,6930,31465,56,30,27,29
56544,53,62437,53,allow,760,97,663,2,31,1,1
55260,53,54111,53,allow,183,94,89,2,30,1,1
58934,443,63790,443,allow,5167,700,4467,16,15,7,9
7928,80,7928,80,allow,25909,3016,22893,40,83,15,25
40086,22114,0,0,deny,62,62,0,1,0,1,0
50491,443,32943,443,allow,28729,1634,27095,40,120,16,24
59977,445,0,0,drop,70,70,0,1,0,1,0
37384,443,22279,443,allow,416,210,206,7,29,4,3
38758,23,0,0,deny,60,60,0,1,0,1,0
55435,25174,0,0,deny,146,146,0,1,0,1,0
62418,445,0,0,drop,66,66,0,1,0,1,0
24812,44847,0,0,deny,146,146,0,1,0,1,0
49348,53,28507,53,allow,312,96,216,4,35,2,2
46964,80,54750,80,allow,1687,951,736,10,93,6,4
59352,37965,0,0,deny,66,66,0,1,0,1,0
52213,445,0,0,drop,66,66,0,1,0,1,0
54866,37965,0,0,deny,62,62,0,1,0,1,0
30960,45744,39744,45744,allow,330,330,0,6,3609,6,0
56388,443,22343,443,allow,11093,2322,8771,40,17,23,17
61030,21247,0,0,deny,66,66,0,1,0,1,0
57394,53,16872,53,allow,186,95,91,2,31,1,1
50323,445,0,0,drop,70,70,0,1,0,1,0
64095,53,19951,53,allow,170,87,83,2,30,1,1
59602,445,0,0,drop,70,70,0,1,0,1,0
50984,443,27569,443,allow,8023,3352,4671,19,80,11,8
52927,443,29135,443,allow,5582,1388,4194,19,15,9,10
57263,443,6071,443,allow,7748,3859,3889,20,148,10,10
59888,443,25489,443,allow,4350,2061,2289,18,47,10,8
19008,31652,0,0,allow,74,74,0,1,91,1,0
51969,443,9113,443,allow,15609,5649,9960,58,76,31,27
62027,445,0,0,drop,70,70,0,1,0,1,0
55261,53,55428,53,allow,165,86,79,2,29,1,1
42282,443,42282,443,allow,2052,1187,865,21,76,11,10
64707,445,0,0,drop,70,70,0,1,0,1,0
44725,443,58969,443,allow,7998,1347,6651,49,1647,10,39
61720,445,0,0,drop,66,66,0,1,0,1,0
53367,445,0,0,drop,66,66,0,1,0,1,0
53546,46824,0,0,deny,66,66,0,1,0,1,0
38961,443,38961,443,allow,4425,1518,2907,19,29,11,8
64122,53,11077,53,allow,214,110,104,2,30,1,1
59077,445,0,0,drop,70,70,0,1,0,1,0
61399,445,0,0,drop,70,70,0,1,0,1,0
56643,53,25715,53,allow,195,102,93,2,31,1,1
52842,445,0,0,drop,70,70,0,1,0,1,0
50021,445,0,0,drop,66,66,0,1,0,1,0
52206,443,46301,443,allow,6278,682,5596,17,20,8,9
52118,445,0,0,drop,70,70,0,1,0,1,0
64320,53,48665,53,allow,199,102,97,2,30,1,1
50014,445,0,0,drop,70,70,0,1,0,1,0
63160,445,0,0,drop,70,70,0,1,0,1,0
56444,53,36861,53,allow,730,102,628,2,29,1,1
61624,445,0,0,drop,70,70,0,1,0,1,0
1773,11392,0,0,deny,62,62,0,1,0,1,0
57026,445,0,0,drop,70,70,0,1,0,1,0
59987,445,0,0,drop,70,70,0,1,0,1,0
55191,445,0,0,drop,70,70,0,1,0,1,0
64695,53,52435,53,allow,193,102,91,2,30,1,1
57617,53,32772,53,allow,164,78,86,2,30,1,1
54954,445,0,0,drop,70,70,0,1,0,1,0
48833,443,62502,443,allow,1348406,28891,1319515,1247,31,340,907
64357,53,56985,53,allow,183,94,89,2,30,1,1
49518,53,34801,53,allow,213,102,111,2,30,1,1
50046,443,28953,443,allow,12134,6888,5246,27,37,15,12
56113,53,45666,53,allow,211,102,109,2,30,1,1
58454,443,58454,443,allow,4593,1616,2977,19,76,10,9
59512,445,0,0,drop,66,66,0,1,0,1,0
55286,37965,0,0,deny,66,66,0,1,0,1,0
7364,50584,0,0,deny,66,66,0,1,0,1,0
0,0,0,0,deny,98,98,0,1,0,1,0
31404,52955,0,0,deny,100,100,0,1,0,1,0
57673,53,25100,53,allow,273,94,179,2,30,1,1
57928,30188,0,0,deny,62,62,0,1,0,1,0
57784,445,0,0,drop,66,66,0,1,0,1,0
51149,443,26017,443,allow,5092,2574,2518,14,135,7,7
61622,80,61622,80,allow,48702,2799,45903,74,110,38,36
56361,443,32525,443,allow,3775,1791,1984,24,203,12,12
53200,443,25558,443,allow,1462,965,497,13,18,7,6
58638,5900,0,0,deny,62,62,0,1,0,1,0
17873,23117,0,0,deny,66,66,0,1,0,1,0
60628,445,0,0,drop,70,70,0,1,0,1,0
57281,53,55108,53,allow,178,94,84,2,30,1,1
57259,53,43312,53,allow,199,102,97,2,31,1,1
56980,53,33611,53,allow,526,188,338,6,48,3,3
58553,445,0,0,drop,66,66,0,1,0,1,0
8979,443,54799,443,allow,62149740,2002795,60146945,62894,211,19380,43514
13062,52752,0,0,deny,66,66,0,1,0,1,0
59998,53,31845,53,allow,481,110,371,2,31,1,1
57548,445,0,0,drop,70,70,0,1,0,1,0
55045,445,0,0,drop,70,70,0,1,0,1,0
55246,443,12271,443,allow,6144,1810,4334,18,45,11,7
49904,53,21659,53,allow,749,94,655,2,30,1,1
50998,443,9197,443,allow,6765,1108,5657,17,18,10,7
56724,53,15012,53,allow,749,89,660,2,31,1,1
36836,443,63140,443,allow,7195,1791,5404,18,99,11,7
54964,445,0,0,drop,66,66,0,1,0,1,0
50661,445,0,0,drop,70,70,0,1,0,1,0
24301,6881,0,0,deny,146,146,0,1,0,1,0
59626,22114,0,0,deny,62,62,0,1,0,1,0
59060,50584,0,0,deny,62,62,0,1,0,1,0
55106,445,0,0,drop,70,70,0,1,0,1,0
55294,53,48651,53,allow,295,101,194,4,30,2,2
64157,53,49752,53,allow,370,126,244,2,30,1,1
58382,50584,0,0,deny,146,146,0,1,0,1,0
64327,53,41348,53,allow,210,110,100,2,31,1,1
57082,53,0,0,allow,82,82,0,1,30,1,0
54521,443,4685,443,allow,1574197,46737,1527460,1590,34,557,1033
54141,445,0,0,drop,70,70,0,1,0,1,0
52558,443,32057,443,allow,3530,1002,2528,12,120,6,6
57297,443,9892,443,allow,5614,733,4881,16,15,9,7
49616,445,0,0,drop,70,70,0,1,0,1,0
55293,445,0,0,drop,70,70,0,1,0,1,0
50017,53,55318,53,allow,190,97,93,2,31,1,1
64154,53,43771,53,allow,194,102,92,2,30,1,1
50262,443,64245,443,allow,11220,726,10494,18,75,8,10
56322,53,2088,53,allow,209,110,99,2,30,1,1
56831,10434,25973,10434,allow,70,70,0,1,5,1,0
49526,53,60849,53,allow,402,118,284,2,30,1,1
51945,1587,2517,1587,allow,66,66,0,1,5,1,0
58719,443,6983,443,allow,18880,7831,11049,37,18,19,18
58638,5900,0,0,deny,62,62,0,1,0,1,0
53608,39004,0,0,deny,66,66,0,1,0,1,0
58638,5900,0,0,deny,62,62,0,1,0,1,0
59564,57470,0,0,deny,66,66,0,1,0,1,0
13285,29892,0,0,deny,145,145,0,1,0,1,0
49445,80,19716,80,allow,1586,808,778,13,45,7,6
65246,53,34223,53,allow,182,93,89,2,31,1,1
63962,53,21344,53,allow,185,93,92,3,58,2,1
58799,30188,0,0,deny,62,62,0,1,0,1,0
51132,445,0,0,drop,66,66,0,1,0,1,0
54716,443,54716,443,allow,4728,1821,2907,19,29,11,8
59784,443,16677,443,allow,6698,1606,5092,23,19,13,10
56498,53,6287,53,allow,199,102,97,2,30,1,1
46824,53,42441,53,allow,326,78,248,2,30,1,1
58638,5900,0,0,deny,62,62,0,1,0,1,0
51010,445,0,0,drop,70,70,0,1,0,1,0
64693,445,0,0,drop,70,70,0,1,0,1,0
49433,53,27774,53,allow,173,94,79,2,30,1,1
25565,2216,0,0,deny,60,60,0,1,0,1,0
60517,53,55123,53,allow,215,94,121,2,29,1,1
57838,445,0,0,drop,70,70,0,1,0,1,0
50842,445,0,0,drop,70,70,0,1,0,1,0
33421,443,28800,443,allow,9917,3184,6733,30,91,12,18
65248,445,0,0,drop,66,66,0,1,0,1,0
35623,443,1828,443,allow,9685,2504,7181,26,153,11,15
27153,992,0,0,deny,60,60,0,1,0,1,0
62139,445,0,0,drop,70,70,0,1,0,1,0
54555,25174,0,0,deny,62,62,0,1,0,1,0
59923,53,7241,53,allow,197,78,119,2,30,1,1
64644,53,30010,53,allow,364,89,275,4,33,2,2
49001,65473,0,0,deny,174,174,0,1,0,1,0
57122,53,4958,53,allow,199,102,97,2,29,1,1
52091,4789,12478,4789,allow,70,70,0,2,7,2,0
55010,445,0,0,drop,70,70,0,1,0,1,0
50550,5228,24310,5228,allow,2661,1518,1143,18,3600,9,9
42298,40022,48973,40022,allow,730,548,182,4,30,2,2
57913,443,45296,443,allow,9578079,276384,9301695,9817,153,2984,6833
49848,53,60109,53,allow,260,102,158,2,30,1,1
62029,22114,0,0,deny,66,66,0,1,0,1,0
65307,445,0,0,drop,70,70,0,1,0,1,0
49380,443,11402,443,allow,2382775,72482,2310293,2485,252,843,1642
63979,445,0,0,drop,66,66,0,1,0,1,0
59937,443,12788,443,allow,70,70,0,1,5,1,0
56495,53,29192,53,allow,198,101,97,2,30,1,1
61282,445,0,0,drop,66,66,0,1,0,1,0
56538,443,26463,443,allow,8490,2953,5537,27,569,15,12
49273,53,17508,53,allow,342,110,232,2,30,1,1
50553,445,0,0,drop,66,66,0,1,0,1,0
60466,445,0,0,drop,70,70,0,1,0,1,0
60325,80,16267,80,allow,3697,2062,1635,16,61,9,7
53209,445,0,0,drop,70,70,0,1,0,1,0
65386,445,0,0,drop,66,66,0,1,0,1,0
60721,22114,0,0,deny,62,62,0,1,0,1,0
52885,80,48034,80,allow,5688,2508,3180,36,118,19,17
42119,36237,0,0,deny,66,66,0,1,0,1,0
48839,37807,0,0,deny,146,146,0,1,0,1,0
53318,445,0,0,drop,70,70,0,1,0,1,0
65229,53,55495,53,allow,186,95,91,2,30,1,1
62550,51505,0,0,deny,66,66,0,1,0,1,0
50504,443,62477,443,allow,6051,1149,4902,16,25,9,7
52230,50265,0,0,deny,62,62,0,1,0,1,0
63832,6969,23907,6969,allow,66,66,0,2,8,2,0
61681,23,0,0,deny,60,60,0,1,0,1,0
51769,17,0,0,deny,60,60,0,1,0,1,0
48817,64245,48817,64245,allow,481,150,331,2,1200,1,1
52087,80,10358,80,allow,2757,648,2109,12,23,7,5
34784,53,61391,53,allow,168,78,90,2,30,1,1
63742,26305,40966,26305,allow,70,70,0,1,4,1,0
56669,80,21282,80,allow,234,234,0,4,12,4,0
47674,443,2134,443,allow,7576,2983,4593,33,42,18,15
65303,53,22620,53,allow,760,96,664,2,31,1,1
55072,53,31850,53,allow,168,86,82,2,31,1,1
47264,80,26226,80,allow,1737,796,941,12,16,7,5
1930,80,62505,80,allow,214,140,74,4,15,3,1
56663,53,41717,53,allow,181,94,87,2,33,1,1
50028,53,64249,53,allow,256,102,154,2,30,1,1
56637,53,33997,53,allow,199,102,97,2,31,1,1
56662,443,9856,443,allow,8007,1987,6020,20,15,11,9
59526,445,0,0,drop,70,70,0,1,0,1,0
58568,53,2690,53,allow,294,86,208,2,30,1,1
60423,52001,49584,52001,allow,260,140,120,5,9,3,2
51129,80,6520,80,allow,2794,2075,719,15,30,9,6
11907,57470,0,0,deny,66,66,0,1,0,1,0
55326,445,0,0,drop,70,70,0,1,0,1,0
64784,53,28832,53,allow,195,102,93,2,29,1,1
49777,53,45833,53,allow,166,86,80,2,31,1,1
51955,39871,23023,39871,allow,70,70,0,2,8,2,0
54560,53,54560,53,allow,832,106,726,2,30,1,1
51626,445,0,0,drop,70,70,0,1,0,1,0
65216,53,59898,53,allow,244,94,150,2,30,1,1
50908,445,0,0,drop,70,70,0,1,0,1,0
56689,445,0,0,drop,66,66,0,1,0,1,0
61435,445,0,0,drop,66,66,0,1,0,1,0
49547,445,0,0,drop,70,70,0,1,0,1,0
56812,53,46886,53,allow,767,102,665,2,30,1,1
3478,61463,0,0,deny,455,455,0,1,0,1,0
19579,23,0,0,deny,60,60,0,1,0,1,0
57470,64050,27080,64050,allow,1660,677,983,20,1600,10,10
5379,37965,0,0,deny,66,66,0,1,0,1,0
50113,51505,0,0,deny,66,66,0,1,0,1,0
43537,2323,0,0,deny,60,60,0,1,0,1,0
58638,5900,0,0,deny,62,62,0,1,0,1,0
54973,53,16224,53,allow,181,94,87,2,31,1,1
58885,445,0,0,drop,66,66,0,1,0,1,0
1183,53,1183,53,allow,213,79,134,2,33,1,1
64145,53,5953,53,allow,504,105,399,4,35,2,2
59364,44847,0,0,deny,66,66,0,1,0,1,0
64031,25933,32039,25933,allow,436,254,182,7,14,4,3
56739,53,65216,53,allow,195,102,93,2,30,1,1
61168,443,61168,443,allow,4599,1692,2907,19,29,11,8
60263,443,35248,443,allow,5889,2893,2996,45,149,24,21
37168,443,59171,443,allow,17716,5150,12566,48,21,25,23
17306,25174,0,0,deny,66,66,0,1,0,1,0
56439,53,20721,53,allow,177,94,83,2,29,1,1
19944,22114,0,0,deny,62,62,0,1,0,1,0
59683,443,22150,443,allow,13310,4422,8888,47,136,27,20
65103,445,0,0,drop,70,70,0,1,0,1,0
56127,35440,0,0,deny,62,62,0,1,0,1,0
51582,48817,0,0,deny,66,66,0,1,0,1,0
49945,53,14331,53,allow,281,97,184,4,56,2,2
50196,53,48778,53,allow,756,95,661,2,31,1,1
36536,53,36536,53,allow,414,268,146,3,32,2,1
30654,51221,0,0,deny,72,72,0,1,0,1,0
63771,7426,20150,7426,allow,70,70,0,1,5,1,0
49569,80,41314,80,allow,454,262,192,8,44,5,3
65269,53,18855,53,allow,226,102,124,2,30,1,1
49452,53,60984,53,allow,244,110,134,2,30,1,1
48640,47993,0,0,deny,145,145,0,1,0,1,0
57476,445,0,0,drop,66,66,0,1,0,1,0
63399,445,0,0,drop,70,70,0,1,0,1,0
42664,80,62788,80,allow,63654,7979,55675,90,91,49,41
53670,32016,15201,32016,allow,70,70,0,1,4,1,0
63843,445,0,0,drop,70,70,0,1,0,1,0
53373,64147,0,0,deny,66,66,0,1,0,1,0
53337,1433,0,0,deny,60,60,0,1,0,1,0
27005,27111,16900,27111,allow,913,126,787,2,31,1,1
52529,80,44880,80,allow,1056,682,374,10,15,6,4
33362,50584,0,0,deny,146,146,0,1,0,1,0
64228,445,0,0,drop,70,70,0,1,0,1,0
52334,443,32129,443,allow,96091,8340,87751,159,205,75,84
58120,25174,0,0,deny,66,66,0,1,0,1,0
23079,9694,0,0,deny,62,62,0,1,0,1,0
64087,443,64087,443,allow,150808,48110,102698,173,173,82,91
64810,53,55417,53,allow,272,93,179,4,33,2,2
57030,53,42325,53,allow,283,101,182,4,37,2,2
63925,37965,0,0,deny,62,62,0,1,0,1,0
54814,445,0,0,drop,70,70,0,1,0,1,0
37419,443,55901,443,allow,558,210,348,9,28,4,5
52378,445,0,0,drop,70,70,0,1,0,1,0
56836,445,0,0,drop,70,70,0,1,0,1,0
63937,53,56505,53,allow,182,93,89,2,30,1,1
25565,20455,0,0,deny,60,60,0,1,0,1,0
58614,443,16756,443,allow,12164,4840,7324,29,198,16,13
49308,443,39770,443,allow,4256,2975,1281,23,47,12,11
55319,445,0,0,drop,70,70,0,1,0,1,0
56404,445,0,0,drop,66,66,0,1,0,1,0
55422,445,0,0,drop,66,66,0,1,0,1,0
52749,443,45343,443,allow,148418,107579,40839,315,6090,107,208
54484,445,0,0,drop,66,66,0,1,0,1,0
50646,445,0,0,drop,70,70,0,1,0,1,0
53713,80,58765,80,allow,5778,661,5117,17,75,8,9
63823,445,0,0,drop,66,66,0,1,0,1,0
62617,443,37156,443,allow,3931,678,3253,15,140,6,9
50120,443,54666,443,allow,29503,9695,19808,55,34,30,25
65516,53,20089,53,allow,506,204,302,6,57,3,3
62153,35440,0,0,deny,66,66,0,1,0,1,0
50148,80,57004,80,allow,9058,868,8190,18,46,10,8
54754,50432,0,0,deny,66,66,0,1,0,1,0
62758,443,37429,443,allow,22187,14208,7979,52,130,25,27
54539,445,0,0,drop,66,66,0,1,0,1,0
51544,4545,51544,4545,allow,156,156,0,3,8,3,0
39661,23,0,0,deny,60,60,0,1,0,1,0
49176,443,46832,443,allow,2802,1902,900,22,1118,12,10
50910,445,0,0,drop,70,70,0,1,0,1,0
49973,53,45350,53,allow,309,110,199,2,30,1,1
55470,53,6327,53,allow,197,102,95,2,30,1,1
25565,34677,0,0,deny,60,60,0,1,0,1,0
54888,443,50282,443,allow,1775,169,1606,7,122,3,4
45402,443,57057,443,allow,7710,3375,4335,32,131,18,14
11295,40033,3453,40033,allow,213,89,124,4,32,2,2
34565,53,14106,53,allow,168,78,90,2,30,1,1
58638,5900,58638,5900,allow,66,66,0,1,5,1,0
55593,53,62454,53,allow,193,102,91,2,30,1,1
49977,57470,0,0,deny,62,62,0,1,0,1,0
58143,443,15049,443,allow,17812,8128,9684,55,343,27,28
58777,443,42281,443,allow,2577,1550,1027,15,16,7,8
59366,53,31679,53,allow,242,78,164,2,30,1,1
50282,443,64648,443,allow,15775,3795,11980,48,18,32,16
55733,53,30284,53,allow,177,94,83,2,30,1,1
58046,80,28676,80,allow,2306,1112,1194,23,76,12,11
57665,52700,0,0,deny,66,66,0,1,0,1,0
58638,5900,0,0,deny,62,62,0,1,0,1,0
56526,443,61934,443,allow,7563,3697,3866,19,15,10,9
54300,22114,0,0,deny,66,66,0,1,0,1,0
45363,23,0,0,deny,60,60,0,1,0,1,0
51136,80,1499,80,allow,366,240,126,7,21,5,2
59001,445,0,0,drop,70,70,0,1,0,1,0
49788,53,17656,53,allow,198,102,96,2,32,1,1
6881,10385,61159,10385,allow,118,118,0,1,1199,1,0
49606,445,0,0,drop,66,66,0,1,0,1,0
57220,26467,0,0,deny,66,66,0,1,0,1,0
56682,53,9242,53,allow,196,86,110,2,30,1,1
65219,53,52496,53,allow,197,102,95,2,31,1,1
39689,443,12729,443,allow,7259,3893,3366,34,236,18,16
38941,443,59649,443,allow,13623,2693,10930,22,123,10,12
58311,445,0,0,drop,70,70,0,1,0,1,0
38581,22114,0,0,deny,62,62,0,1,0,1,0
64180,445,0,0,drop,70,70,0,1,0,1,0
19845,30024,0,0,deny,62,62,0,1,0,1,0
50184,443,37537,443,allow,6349,1071,5278,18,42,10,8
38957,443,58777,443,allow,7457,1333,6124,18,200,10,8
57226,443,27047,443,allow,7924,2027,5897,23,22,14,9
55049,443,41973,443,allow,5587,3950,1637,26,55,15,11
16262,80,16262,80,allow,14671,951,13720,23,16,10,13
46479,443,13902,443,allow,5241,2026,3215,50,6660,18,32
52418,46314,0,0,deny,66,66,0,1,0,1,0
9128,80,3849,80,allow,318,192,126,6,30,4,2
39569,443,5001,443,allow,1784075,46752,1737323,1812,47,606,1206
56763,27734,6083,27734,allow,70,70,0,1,5,1,0
50487,3389,50487,3389,allow,6312,2620,3692,25,24,12,13
55520,445,0,0,drop,70,70,0,1,0,1,0
49989,53,19506,53,allow,301,85,216,4,53,2,2
39233,53,39233,53,allow,235,90,145,2,33,1,1
51571,443,51571,443,allow,1724,916,808,17,128,7,10
56163,53,27486,53,allow,188,96,92,2,31,1,1
57108,445,0,0,drop,70,70,0,1,0,1,0
51957,445,0,0,drop,70,70,0,1,0,1,0
51709,53,0,0,allow,201,94,107,2,29,1,1
65275,53,12888,53,allow,370,126,244,2,30,1,1
50873,80,11525,80,allow,173653,9305,164348,189,141,73,116
50995,445,0,0,drop,66,66,0,1,0,1,0
50181,443,54274,443,allow,8113,2063,6050,23,255,11,12
56632,443,5495,443,allow,7941,1952,5989,20,15,11,9
55809,445,0,0,drop,66,66,0,1,0,1,0
50602,443,61178,443,allow,3901,1858,2043,19,23,11,8
46734,50265,0,0,deny,74,74,0,1,0,1,0
51221,57274,16024,57274,allow,528,528,0,9,1201,9,0
50581,53,15550,53,allow,185,102,83,2,30,1,1
49962,53,19275,53,allow,184,94,90,2,31,1,1
60889,445,0,0,drop,70,70,0,1,0,1,0
55694,62954,52341,62954,allow,504,318,186,8,15,5,3
41429,50584,0,0,deny,66,66,0,1,0,1,0
20724,19750,0,0,deny,78,78,0,1,0,1,0
49242,443,58883,443,allow,638,70,568,10,203,2,8
63305,62413,0,0,deny,62,62,0,1,0,1,0
58266,445,0,0,drop,70,70,0,1,0,1,0
53269,443,51596,443,allow,5766,1925,3841,22,17,14,8
64525,443,3519,443,allow,5981,1902,4079,14,120,7,7
63940,3389,63940,3389,allow,3347,1458,1889,15,17,8,7
51221,19072,17591,19072,allow,330,330,0,6,1200,6,0
50405,443,58184,443,allow,612,280,332,10,26,5,5
27005,27015,8409,27015,allow,897,126,771,2,30,1,1
41399,443,26251,443,allow,8512,2563,5949,27,24,15,12
51782,10637,45950,10637,allow,66,66,0,1,5,1,0
50046,445,0,0,drop,70,70,0,1,0,1,0
59186,445,0,0,drop,70,70,0,1,0,1,0
58756,445,0,0,drop,66,66,0,1,0,1,0
3341,23117,0,0,deny,66,66,0,1,0,1,0
8889,34659,0,0,deny,60,60,0,1,0,1,0
55689,443,55689,443,allow,177498,9805,167693,244,80,119,125
43482,443,29764,443,allow,2316,1280,1036,20,278,11,9
55401,53,24581,53,allow,168,86,82,2,30,1,1
41447,64147,0,0,deny,62,62,0,1,0,1,0
49558,445,0,0,drop,66,66,0,1,0,1,0
49847,53,33024,53,allow,448,184,264,6,29,3,3
40840,21247,0,0,deny,62,62,0,1,0,1,0
64944,443,63703,443,allow,48856,4158,44698,65,120,26,39
27005,27015,38392,27015,allow,878,126,752,2,30,1,1
51823,445,0,0,drop,70,70,0,1,0,1,0
58143,445,0,0,drop,66,66,0,1,0,1,0
7246,59858,0,0,deny,66,66,0,1,0,1,0
63116,22114,0,0,deny,146,146,0,1,0,1,0
63951,53,11656,53,allow,193,102,91,2,30,1,1
54884,445,0,0,drop,70,70,0,1,0,1,0
64339,18375,0,0,deny,62,62,0,1,0,1,0
57676,445,0,0,drop,66,66,0,1,0,1,0
50689,445,0,0,drop,70,70,0,1,0,1,0
45317,53,22055,53,allow,86,86,0,1,30,1,0
13917,18033,0,0,deny,62,62,0,1,0,1,0
53886,443,35805,443,allow,6074,1579,4495,18,125,11,7
38099,11392,0,0,deny,62,62,0,1,0,1,0
52414,80,51546,80,allow,9534,746,8788,18,49,9,9
44353,443,12767,443,allow,15234,2503,12731,45,135,20,25
16387,35308,0,0,deny,60,60,0,1,0,1,0
52672,22114,0,0,deny,146,146,0,1,0,1,0
43661,443,21697,443,allow,11255,7612,3643,36,248,19,17
56516,445,0,0,drop,70,70,0,1,0,1,0
49981,44847,0,0,deny,62,62,0,1,0,1,0
63731,26467,0,0,deny,66,66,0,1,0,1,0
57869,443,47551,443,allow,11947,2436,9511,19,121,9,10
49183,53,29082,53,allow,451,91,360,4,36,2,2
56046,445,0,0,drop,66,66,0,1,0,1,0
59153,35440,0,0,deny,66,66,0,1,0,1,0
59527,445,0,0,drop,66,66,0,1,0,1,0
1935,53,17873,53,allow,260,86,174,2,30,1,1
61550,5529,0,0,deny,145,145,0,1,0,1,0
54953,53,34688,53,allow,263,94,169,2,30,1,1
65059,53,30320,53,allow,168,86,82,2,31,1,1
54073,443,61123,443,allow,90387,4941,85446,123,170,54,69
60047,80,39100,80,allow,2634,1780,854,14,142,8,6
60872,443,60963,443,allow,10306,3254,7052,32,47,18,14
3978,35440,0,0,deny,62,62,0,1,0,1,0
43705,443,47459,443,allow,8060,2001,6059,24,19,14,10
35617,443,43217,443,allow,2981,1719,1262,17,79,10,7
34083,22,0,0,deny,60,60,0,1,0,1,0
23197,44847,0,0,deny,146,146,0,1,0,1,0
38562,443,38562,443,allow,4611,1704,2907,19,28,11,8
35900,443,35900,443,allow,5661,2414,3247,22,39,13,9
15641,26467,0,0,deny,62,62,0,1,0,1,0
52266,50038,0,0,deny,66,66,0,1,0,1,0
55609,39869,9261,39869,allow,70,70,0,2,8,2,0
41541,25174,0,0,deny,66,66,0,1,0,1,0
50325,445,0,0,drop,70,70,0,1,0,1,0
60481,445,0,0,drop,70,70,0,1,0,1,0
49895,80,46026,80,allow,2781,1400,1381,11,87,6,5
56845,53,40181,53,allow,730,102,628,2,30,1,1
53875,43611,35716,43611,allow,70,70,0,2,8,2,0
55169,53,64266,53,allow,775,103,672,2,30,1,1
51371,445,0,0,drop,66,66,0,1,0,1,0
55374,25,55374,25,allow,130,66,64,2,5,1,1
56170,53,19497,53,allow,198,102,96,2,30,1,1
52459,3399,0,0,deny,60,60,0,1,0,1,0
49892,443,33274,443,allow,5737,1602,4135,23,86,13,10
27528,35440,0,0,deny,66,66,0,1,0,1,0
1369,48817,0,0,deny,145,145,0,1,0,1,0
56786,443,44559,443,allow,9096,4394,4702,26,256,15,11
56367,443,45911,443,allow,3674,1750,1924,23,203,12,11
59701,443,37154,443,allow,6155,1819,4336,18,181,8,10
56845,53,56845,53,allow,825,99,726,2,30,1,1
58774,445,0,0,drop,70,70,0,1,0,1,0
65028,53,13338,53,allow,763,102,661,2,30,1,1
65529,35440,0,0,deny,62,62,0,1,0,1,0
53595,445,0,0,drop,70,70,0,1,0,1,0
62319,445,0,0,drop,70,70,0,1,0,1,0
6842,42873,0,0,deny,66,66,0,1,0,1,0
60162,53436,0,0,deny,66,66,0,1,0,1,0
49973,445,0,0,drop,66,66,0,1,0,1,0
49307,443,35042,443,allow,245382,6838,238544,214,31,44,170
42783,443,65446,443,allow,13510,5888,7622,65,86,33,32
55454,445,0,0,drop,70,70,0,1,0,1,0
54688,445,0,0,drop,70,70,0,1,0,1,0
53606,54476,23615,54476,allow,320,140,180,6,6,3,3
64899,53,5067,53,allow,199,102,97,2,31,1,1
36812,53,60347,53,allow,168,78,90,2,31,1,1
50222,445,0,0,drop,66,66,0,1,0,1,0
60312,57470,0,0,deny,74,74,0,1,0,1,0
56854,17067,53674,17067,allow,70,70,0,2,8,2,0
55485,53,64726,53,allow,212,102,110,2,30,1,1
27005,27017,49070,27017,allow,883,126,757,2,30,1,1
55009,445,0,0,drop,70,70,0,1,0,1,0
55325,53,12048,53,allow,762,101,661,2,30,1,1
45042,48817,0,0,deny,109,109,0,1,0,1,0
57413,445,0,0,drop,66,66,0,1,0,1,0
64102,445,0,0,drop,70,70,0,1,0,1,0
49863,8100,50615,8100,allow,234,234,0,4,11,4,0
55216,443,23383,443,allow,8058,5498,2560,20,120,11,9
45286,62413,0,0,deny,146,146,0,1,0,1,0
51101,80,9411,80,allow,366,240,126,7,20,5,2
55867,53,60176,53,allow,178,94,84,2,31,1,1
44133,53,62526,53,allow,164,78,86,2,30,1,1
35430,443,18104,443,allow,6267,1810,4457,25,18,14,11
65479,53,45836,53,allow,728,102,626,2,29,1,1
11859,64147,0,0,deny,62,62,0,1,0,1,0
65000,27019,62331,27019,allow,728,462,266,2,30,1,1
53161,51221,0,0,deny,66,66,0,1,0,1,0
51248,445,0,0,drop,70,70,0,1,0,1,0
58638,5900,0,0,deny,62,62,0,1,0,1,0
51934,36180,0,0,deny,62,62,0,1,0,1,0
57470,39608,19893,39608,allow,330,330,0,6,1199,6,0
6881,6881,0,0,deny,146,146,0,1,0,1,0
65445,53,5000,53,allow,718,94,624,2,30,1,1
40301,8696,0,0,deny,60,60,0,1,0,1,0
63856,6881,6366,6881,allow,66,66,0,2,8,2,0
56636,43890,0,0,deny,66,66,0,1,0,1,0
38386,80,38386,80,allow,6261,833,5428,15,20,8,7
41321,443,40754,443,allow,6989232,188564,6800668,7110,288,2412,4698
53918,445,0,0,drop,70,70,0,1,0,1,0
26922,443,5779,443,allow,7647,2890,4757,23,20,11,12
57264,53,53973,53,allow,197,102,95,2,30,1,1
57369,1433,0,0,deny,60,60,0,1,0,1,0
51754,445,0,0,drop,70,70,0,1,0,1,0
52544,445,0,0,drop,70,70,0,1,0,1,0
58638,5900,0,0,deny,62,62,0,1,0,1,0
56490,443,32124,443,allow,163763,5320,158443,178,120,60,118
56707,443,22633,443,allow,8005,1985,6020,20,15,11,9
56048,53,3715,53,allow,296,110,186,2,30,1,1
49760,53,59419,53,allow,183,94,89,2,30,1,1
64518,445,0,0,deny,70,70,0,1,0,1,0
14446,443,21708,443,allow,2616,1470,1146,18,16,8,10
58082,443,14473,443,allow,45314943,1391230,43923713,47149,303,15196,31953
64942,445,0,0,drop,70,70,0,1,0,1,0
55024,445,0,0,drop,70,70,0,1,0,1,0
50652,443,65076,443,allow,2477,1505,972,15,20,9,6
65472,53,43093,53,allow,209,110,99,2,30,1,1
49924,445,0,0,drop,66,66,0,1,0,1,0
54787,445,0,0,drop,70,70,0,1,0,1,0
49978,53,13448,53,allow,190,97,93,2,30,1,1
1687,25174,0,0,deny,146,146,0,1,0,1,0
53549,40826,14418,40826,allow,492,306,186,8,14,5,3
56614,443,40071,443,allow,8034,2014,6020,20,15,11,9
52330,445,0,0,drop,70,70,0,1,0,1,0
33305,54532,0,0,deny,60,60,0,1,0,1,0
51567,443,51567,443,allow,1654,916,738,16,126,7,9
49999,445,0,0,drop,66,66,0,1,0,1,0
23807,44847,0,0,deny,66,66,0,1,0,1,0
6889,24748,0,0,deny,143,143,0,1,0,1,0
54816,53,4342,53,allow,168,78,90,2,30,1,1
55577,53,15503,53,allow,199,102,97,2,31,1,1
34936,30188,0,0,deny,66,66,0,1,0,1,0
53120,49860,25192,49860,allow,70,70,0,1,5,1,0
52342,445,0,0,drop,66,66,0,1,0,1,0
64724,53,10875,53,allow,190,97,93,2,31,1,1
59201,51221,0,0,deny,62,62,0,1,0,1,0
51108,80,16411,80,allow,2794,2075,719,15,30,9,6
53855,443,61273,443,allow,134631,7253,127378,176,171,79,97
49791,443,35792,443,allow,20149,14507,5642,40,355,24,16
49513,443,49513,443,allow,140969,40311,100658,180,68,92,88
64756,53,35378,53,allow,195,102,93,2,30,1,1
57470,60560,62247,60560,allow,527,166,361,2,1200,1,1
57825,445,0,0,drop,70,70,0,1,0,1,0
53758,445,0,0,drop,70,70,0,1,0,1,0
60890,443,16222,443,allow,5089,4217,872,23,47,13,10
62595,445,0,0,drop,70,70,0,1,0,1,0
3478,61463,0,0,deny,1188,1188,0,1,0,1,0
57741,445,0,0,drop,70,70,0,1,0,1,0
65438,53,17432,53,allow,332,94,238,2,29,1,1
53201,445,0,0,drop,66,66,0,1,0,1,0
58946,443,24412,443,allow,3990,2586,1404,17,16,9,8
1660,8696,0,0,deny,62,62,0,1,0,1,0
57262,53,58338,53,allow,180,94,86,2,30,1,1
57470,19641,64041,19641,allow,132,132,0,3,1199,3,0
61408,30188,0,0,deny,62,62,0,1,0,1,0
55610,53,9648,53,allow,265,91,174,4,36,2,2
55393,44512,0,0,deny,66,66,0,1,0,1,0
52328,445,0,0,drop,70,70,0,1,0,1,0
54653,445,0,0,drop,66,66,0,1,0,1,0
55388,53,11740,53,allow,292,87,205,4,42,2,2
5575,8889,0,0,deny,495,495,0,1,0,1,0
42732,57470,0,0,deny,62,62,0,1,0,1,0
51618,15000,8356,15000,allow,130,70,60,2,5,1,1
53730,445,0,0,drop,70,70,0,1,0,1,0
37556,16385,7205,16385,allow,432,192,240,8,30,4,4
55342,53,5897,53,allow,323,110,213,2,30,1,1
33022,443,32074,443,allow,162,102,60,2,5,1,1
51221,15886,64989,15886,allow,481,150,331,2,1200,1,1
50547,22197,0,0,deny,66,66,0,1,0,1,0
58847,443,24312,443,allow,3143,1064,2079,18,82,8,10
49418,31000,20791,31000,allow,78,78,0,1,30,1,0
60403,60092,40292,60092,allow,70,70,0,1,5,1,0
52150,445,0,0,drop,66,66,0,1,0,1,0
32296,443,32296,443,allow,5421,2444,2977,20,15,11,9
56460,445,0,0,drop,70,70,0,1,0,1,0
56596,53,43071,53,allow,194,102,92,2,30,1,1
44205,443,40929,443,allow,13019,4593,8426,71,350,34,37
32132,25174,0,0,deny,66,66,0,1,0,1,0
7184,15503,0,0,deny,66,66,0,1,0,1,0
37658,16385,25619,16385,allow,130,70,60,2,30,1,1
56653,22114,0,0,deny,66,66,0,1,0,1,0
57499,80,57499,80,allow,343853,13570,330283,445,3,223,222
49650,53,21786,53,allow,216,110,106,2,30,1,1
7811,44847,0,0,deny,62,62,0,1,0,1,0
49698,445,0,0,drop,66,66,0,1,0,1,0
64590,443,12398,443,allow,24686,1935,22751,36,17,17,19
40204,40034,20615,40034,allow,164,102,62,2,30,1,1
53240,443,55808,443,allow,14932,1671,13261,31,69,15,16
57669,64147,0,0,deny,66,66,0,1,0,1,0
54670,445,0,0,drop,66,66,0,1,0,1,0
49846,53,37794,53,allow,763,101,662,2,31,1,1
49719,53,33096,53,allow,209,110,99,2,30,1,1
62597,53,18771,53,allow,102,102,0,1,30,1,0
56755,53,13799,53,allow,184,94,90,2,29,1,1
58638,5900,0,0,deny,62,62,0,1,0,1,0
61702,80,48411,80,allow,1553,953,600,14,47,8,6
9532,56205,0,0,deny,146,146,0,1,0,1,0
64439,445,0,0,drop,70,70,0,1,0,1,0
50265,50262,19967,50262,allow,3758,2456,1302,52,2355,31,21
50759,53,50759,53,allow,225,106,119,2,30,1,1
59800,443,57363,443,allow,94202,5247,88955,115,37,41,74
58849,64147,0,0,deny,66,66,0,1,0,1,0
56319,445,0,0,drop,66,66,0,1,0,1,0
61703,80,42538,80,allow,1494,954,540,13,51,8,5
53728,443,11260,443,allow,499,425,74,4,0,3,1
53647,80,49783,80,allow,1962,1287,675,13,27,7,6
4748,64147,0,0,deny,66,66,0,1,0,1,0
63587,22114,0,0,deny,62,62,0,1,0,1,0
64283,37965,0,0,deny,74,74,0,1,0,1,0
57434,445,0,0,drop,70,70,0,1,0,1,0
0,0,0,0,allow,134,64,70,2,0,1,1
50610,443,21425,443,allow,9469,1273,8196,29,93,15,14
49561,53,53882,53,allow,211,102,109,2,30,1,1
49987,53,51873,53,allow,253,86,167,2,30,1,1
53721,443,43069,443,allow,70,70,0,2,7,2,0
33070,80,34842,80,allow,3483,1578,1905,17,186,10,7
5223,14446,0,0,deny,66,66,0,1,0,1,0
65089,53,20611,53,allow,199,102,97,2,30,1,1
59498,445,0,0,drop,70,70,0,1,0,1,0
27005,50001,15883,50001,allow,1656,126,1530,4,31,2,2
49759,53,4425,53,allow,381,110,271,4,32,2,2
56967,35440,0,0,deny,66,66,0,1,0,1,0
49068,443,40796,443,allow,8664,2567,6097,20,120,10,10
38295,443,36563,443,allow,5247,3662,1585,21,310,11,10
49410,53,29049,53,allow,177,94,83,2,31,1,1
52253,443,52253,443,allow,429263,14390,414873,449,24,159,290
56677,53,31185,53,allow,767,102,665,2,31,1,1
52907,445,0,0,drop,70,70,0,1,0,1,0
34914,25604,0,0,deny,145,145,0,1,0,1,0
55602,53,61633,53,allow,711,87,624,2,30,1,1
49690,443,64449,443,allow,9107,2174,6933,29,187,14,15
49418,27022,21779,27022,allow,71,71,0,1,30,1,0
56691,443,56691,443,allow,4378,1471,2907,19,29,11,8
51495,443,20935,443,allow,55465,11462,44003,89,31,43,46
55826,42771,0,0,deny,66,66,0,1,0,1,0
61647,445,0,0,drop,66,66,0,1,0,1,0
53640,25174,0,0,deny,66,66,0,1,0,1,0
0,0,0,0,allow,156,156,0,2,0,2,0
58453,50584,0,0,deny,66,66,0,1,0,1,0
61976,445,0,0,drop,70,70,0,1,0,1,0
53129,443,62080,443,allow,51742,10734,41008,85,44,33,52
42686,443,38351,443,allow,190,70,120,4,15,2,2
51419,445,0,0,drop,70,70,0,1,0,1,0
25536,50584,0,0,deny,146,146,0,1,0,1,0
54366,445,0,0,drop,70,70,0,1,0,1,0
50972,3544,39467,3544,allow,258,107,151,2,30,1,1
34158,53,34158,53,allow,217,87,130,2,30,1,1
53916,23505,33630,23505,allow,70,70,0,2,7,2,0
58638,5900,0,0,deny,62,62,0,1,0,1,0
50611,445,0,0,drop,66,66,0,1,0,1,0
62518,445,0,0,drop,66,66,0,1,0,1,0
55048,53,48265,53,allow,215,94,121,2,29,1,1
1377,44847,0,0,deny,146,146,0,1,0,1,0
63997,445,0,0,drop,70,70,0,1,0,1,0
40074,443,9837,443,allow,412322,17503,394819,466,140,167,299
49610,53,9285,53,allow,168,78,90,2,30,1,1
51751,80,4770,80,allow,1854,1360,494,12,15,7,5
55095,445,0,0,drop,66,66,0,1,0,1,0
58638,5900,0,0,deny,62,62,0,1,0,1,0
17177,64147,0,0,deny,62,62,0,1,0,1,0
53627,1099,28999,1099,allow,320,140,180,6,7,3,3
27005,32025,26233,32025,allow,887,126,761,2,30,1,1
38629,443,15765,443,allow,9198,2279,6919,18,18,9,9
51353,445,0,0,drop,70,70,0,1,0,1,0
61265,445,0,0,drop,70,70,0,1,0,1,0
443,22238,0,0,deny,112,112,0,1,0,1,0
42510,53,42510,53,allow,237,91,146,2,32,1,1
64567,53,13390,53,allow,193,102,91,2,30,1,1
55417,53,14562,53,allow,199,102,97,2,30,1,1
64172,445,0,0,drop,70,70,0,1,0,1,0
64531,53,46731,53,allow,182,93,89,2,30,1,1
65216,53,15859,53,allow,994,86,908,2,30,1,1
5223,1210,0,0,deny,103,103,0,1,0,1,0
55503,53,44075,53,allow,216,110,106,2,30,1,1
52012,63475,43517,63475,allow,316,136,180,6,7,3,3
15733,3389,15733,3389,allow,3910,1805,2105,20,19,12,8
63615,23,0,0,deny,60,60,0,1,0,1,0
54580,445,0,0,drop,66,66,0,1,0,1,0
16387,7205,0,0,deny,60,60,0,1,0,1,0
49710,53,37323,53,allow,179,94,85,2,30,1,1
57664,80,57664,80,allow,1917,1468,449,10,19,6,4
63934,53,27798,53,allow,347,103,244,4,46,2,2
60566,445,0,0,drop,66,66,0,1,0,1,0
50016,80,57935,80,allow,827,687,140,6,32,4,2
58975,80,4684,80,allow,214,140,74,4,15,3,1
59213,25174,0,0,deny,66,66,0,1,0,1,0
51892,443,20369,443,allow,5671,1556,4115,23,274,13,10
54445,445,0,0,drop,66,66,0,1,0,1,0
51743,64147,0,0,deny,62,62,0,1,0,1,0
3093,62413,0,0,deny,62,62,0,1,0,1,0
50408,443,29487,443,allow,5638,4258,1380,19,34,11,8
64566,53,50358,53,allow,347,107,240,4,42,2,2
62194,50584,0,0,deny,62,62,0,1,0,1,0
34464,443,64076,443,allow,1402,910,492,11,360,6,5
10916,44847,0,0,deny,62,62,0,1,0,1,0
30500,26296,0,0,deny,159,159,0,1,0,1,0
443,35385,0,0,deny,161,161,0,1,0,1,0
46939,443,46939,443,allow,4657,1750,2907,19,28,11,8
56543,445,0,0,drop,70,70,0,1,0,1,0
50594,80,12498,80,allow,1635,824,811,10,15,5,5
49966,445,0,0,drop,70,70,0,1,0,1,0
49578,53,60840,53,allow,212,102,110,2,29,1,1
45254,443,27475,443,allow,8328,2592,5736,35,34,18,17
51910,443,52422,443,allow,29367,10171,19196,66,184,32,34
58664,53,14984,53,allow,192,90,102,2,30,1,1
51772,59814,12241,59814,allow,70,70,0,2,8,2,0
55374,445,0,0,drop,70,70,0,1,0,1,0
54976,2273,0,0,deny,60,60,0,1,0,1,0
60850,445,0,0,drop,70,70,0,1,0,1,0
54346,443,54346,443,allow,4651,1744,2907,19,27,11,8
37648,443,15216,443,allow,9618,7387,2231,30,26,18,12
53943,40534,14905,40534,allow,320,140,180,6,5,3,3
56422,445,0,0,drop,70,70,0,1,0,1,0
49001,40108,0,0,deny,161,161,0,1,0,1,0
52310,80,52310,80,allow,450,246,204,8,29,5,3
58801,445,0,0,drop,70,70,0,1,0,1,0
62111,443,62044,443,allow,3262,256,3006,9,121,4,5
41816,443,14209,443,allow,88503,3914,84589,114,80,44,70
60943,443,53022,443,allow,4960,896,4064,14,18,8,6
48676,53389,0,0,deny,60,60,0,1,0,1,0
42153,443,25509,443,allow,12306,2097,10209,31,360,15,16
58638,5900,0,0,deny,62,62,0,1,0,1,0
52891,445,0,0,drop,70,70,0,1,0,1,0
58209,53,58209,53,allow,645,90,555,2,30,1,1
56433,53,24075,53,allow,210,110,100,2,30,1,1
65315,53,47241,53,allow,767,102,665,2,31,1,1
51578,44847,0,0,deny,66,66,0,1,0,1,0
1629,64147,0,0,deny,146,146,0,1,0,1,0
64486,445,0,0,drop,70,70,0,1,0,1,0
52044,44847,0,0,deny,146,146,0,1,0,1,0
59747,445,0,0,drop,70,70,0,1,0,1,0
51564,443,53413,443,allow,2888,1566,1322,17,18,9,8
52973,57470,0,0,deny,74,74,0,1,0,1,0
58611,53,0,0,allow,172,78,94,2,30,1,1
49836,53,26222,53,allow,889,404,485,10,29,5,5
18203,23,0,0,deny,60,60,0,1,0,1,0
58003,80,63884,80,allow,14987,10571,4416,40,75,20,20
62341,26467,0,0,deny,66,66,0,1,0,1,0
57707,53,34372,53,allow,70,70,0,1,30,1,0
49288,80,52653,80,allow,1056,682,374,10,15,6,4
34079,80,3796,80,allow,5053,4178,875,17,15,9,8
61917,445,0,0,drop,70,70,0,1,0,1,0
27641,39004,0,0,deny,62,62,0,1,0,1,0
49244,80,49244,80,allow,661753,15722,646031,683,17,235,448
6778,50584,0,0,deny,66,66,0,1,0,1,0
60535,80,60535,80,allow,318,120,198,6,25,3,3
56771,53,26360,53,allow,193,102,91,2,31,1,1
62723,443,17496,443,allow,126815,114702,12113,243,86,139,104
60433,6881,42209,6881,allow,70,70,0,2,8,2,0
50663,443,57930,443,allow,7732,3046,4686,22,26,12,10
8194,21247,0,0,deny,146,146,0,1,0,1,0
55594,42459,54770,42459,allow,1253,716,537,12,23,7,5
38545,443,54573,443,allow,4961,2148,2813,30,90,13,17
57470,36670,48397,36670,allow,3570,1126,2444,28,1465,16,12
56375,53,48204,53,allow,177,94,83,2,30,1,1
54276,39004,0,0,deny,66,66,0,1,0,1,0
54995,53,9641,53,allow,199,102,97,2,30,1,1
37271,443,4038,443,allow,51402,5964,45438,86,153,32,54
10448,14914,0,0,deny,143,143,0,1,0,1,0
51737,445,0,0,drop,66,66,0,1,0,1,0
48852,443,7799,443,allow,38886,2134,36752,55,16,24,31
56000,53,26233,53,allow,177,94,83,2,30,1,1
18754,30188,0,0,deny,66,66,0,1,0,1,0
57252,53,26443,53,allow,229,102,127,2,30,1,1
52412,443,22141,443,allow,11565,5557,6008,52,16,27,25
52332,443,60314,443,allow,15746,4302,11444,17,122,5,12
55648,80,53307,80,allow,70,70,0,2,8,2,0
56703,53,54677,53,allow,183,94,89,2,30,1,1
61091,443,61091,443,allow,18924,5378,13546,33,18,19,14
55834,53,38945,53,allow,184,94,90,2,31,1,1
59882,445,0,0,drop,70,70,0,1,0,1,0
53026,443,50319,443,allow,14051,6332,7719,43,92,21,22
61662,445,0,0,drop,70,70,0,1,0,1,0
56835,53,43767,53,allow,213,102,111,2,30,1,1
27889,32480,0,0,deny,100,100,0,1,0,1,0
0,0,0,0,deny,82,82,0,1,0,1,0
34073,37965,0,0,deny,62,62,0,1,0,1,0
64928,53,11072,53,allow,762,98,664,2,30,1,1
63835,30794,60469,30794,allow,66,66,0,2,8,2,0
26869,53,19844,53,allow,290,110,180,2,30,1,1
56245,53,14605,53,allow,200,102,98,2,30,1,1
50318,53,54870,53,allow,94,94,0,1,30,1,0
64417,53,4241,53,allow,184,94,90,2,30,1,1
65388,55783,0,0,deny,66,66,0,1,0,1,0
57909,80,57909,80,allow,2648,921,1727,12,20,7,5
2182,53,2182,53,allow,643,88,555,2,30,1,1
1523,22,0,0,deny,60,60,0,1,0,1,0
50915,443,63177,443,allow,9599,3465,6134,20,16,11,9
15959,56205,0,0,deny,66,66,0,1,0,1,0
53110,8830,57205,8830,allow,70,70,0,1,5,1,0
52146,18174,63624,18174,allow,70,70,0,1,5,1,0
3576,8305,0,0,deny,145,145,0,1,0,1,0
59124,443,18887,443,allow,9612,1720,7892,32,130,15,17
53822,25174,0,0,deny,66,66,0,1,0,1,0
38058,443,33797,443,allow,22970,12439,10531,61,98,32,29
51682,445,0,0,drop,66,66,0,1,0,1,0
65049,53,34852,53,allow,199,102,97,2,30,1,1
55746,53,61389,53,allow,216,110,106,2,31,1,1
64684,53,48311,53,allow,184,94,90,2,30,1,1
42366,57470,0,0,deny,66,66,0,1,0,1,0
49323,53,50782,53,allow,210,110,100,2,29,1,1
53831,443,39132,443,allow,499,425,74,4,0,3,1
58774,443,43846,443,allow,5167,700,4467,16,15,7,9
49196,53,15790,53,allow,181,94,87,2,33,1,1
63893,443,26379,443,allow,3071,804,2267,15,135,7,8
50583,80,63777,80,allow,2226,1077,1149,13,79,7,6
58638,5900,58638,5900,allow,130,66,64,2,5,1,1
60375,80,60375,80,allow,172473,8713,163760,205,33,91,114
58638,5900,0,0,deny,62,62,0,1,0,1,0
61461,443,61461,443,allow,19070,4830,14240,33,18,18,15
62489,445,0,0,drop,66,66,0,1,0,1,0
55090,53,17815,53,allow,196,102,94,2,30,1,1
49447,445,0,0,drop,70,70,0,1,0,1,0
53240,445,0,0,drop,66,66,0,1,0,1,0
49835,53,27246,53,allow,214,94,120,2,30,1,1
64762,53,32990,53,allow,188,96,92,2,30,1,1
16387,35583,0,0,deny,60,60,0,1,0,1,0
64537,53,63183,53,allow,718,94,624,2,30,1,1
64554,53,27674,53,allow,199,102,97,2,30,1,1
53900,443,15989,443,allow,499,425,74,4,0,3,1
54553,53,62342,53,allow,202,202,0,3,46,3,0
51202,445,0,0,drop,70,70,0,1,0,1,0
49461,53,60884,53,allow,314,102,212,2,30,1,1
38468,53,0,0,allow,82,82,0,2,40,2,0
63002,22114,0,0,deny,66,66,0,1,0,1,0
55408,64147,0,0,deny,66,66,0,1,0,1,0
9836,22114,0,0,deny,62,62,0,1,0,1,0
63568,445,0,0,drop,66,66,0,1,0,1,0
53043,51050,0,0,deny,62,62,0,1,0,1,0
7308,50584,0,0,deny,66,66,0,1,0,1,0
37965,6881,16163,6881,allow,452,248,204,4,1199,2,2
50265,11035,48783,11035,allow,132,132,0,3,1200,3,0
41911,443,53613,443,allow,9499,3786,5713,31,315,16,15
51730,33399,18349,33399,allow,66,66,0,1,5,1,0
58554,443,5045,443,allow,8626,2156,6470,24,81,14,10
52459,33890,0,0,deny,60,60,0,1,0,1,0
62973,51505,0,0,deny,62,62,0,1,0,1,0
57701,445,0,0,drop,70,70,0,1,0,1,0
55713,47783,26233,47783,allow,70,70,0,1,5,1,0
52695,443,43213,443,allow,34402,2328,32074,55,153,23,32
38287,443,17803,443,allow,424,210,214,7,131,4,3
50903,80,4352,80,allow,8600,1437,7163,18,144,10,8
49127,53,16761,53,allow,199,94,105,2,29,1,1
54527,443,27649,443,allow,13132,7107,6025,45,174,23,22
55513,53,52238,53,allow,184,94,90,2,29,1,1
49636,44847,0,0,deny,62,62,0,1,0,1,0
53791,16881,62073,16881,allow,70,70,0,2,8,2,0
56716,443,64304,443,allow,8058,2038,6020,20,15,11,9
56856,47715,25916,47715,allow,66,66,0,1,5,1,0
21903,443,21903,443,allow,29203,1859,27344,37,18,14,23
53661,34967,21536,34967,allow,70,70,0,2,8,2,0
35616,21247,0,0,deny,146,146,0,1,0,1,0
51963,22114,0,0,deny,62,62,0,1,0,1,0
1024,44847,0,0,deny,62,62,0,1,0,1,0
1059,44847,0,0,deny,62,62,0,1,0,1,0
49897,443,63900,443,allow,113036,13164,99872,191,144,89,102
57906,443,49224,443,allow,9316,3279,6037,39,186,20,19
19875,30170,0,0,deny,145,145,0,1,0,1,0
57752,445,0,0,drop,66,66,0,1,0,1,0
57396,53,17014,53,allow,212,102,110,2,30,1,1
56161,62413,0,0,deny,66,66,0,1,0,1,0
50698,443,13372,443,allow,24575,6565,18010,86,275,32,54
37965,22343,64266,22343,allow,1307,594,713,17,1657,10,7
50376,53,65518,53,allow,164,84,80,2,31,1,1
35466,443,44428,443,allow,7409,1702,5707,23,20,13,10
60097,53,60097,53,allow,193,90,103,2,30,1,1
36515,80,38433,80,allow,51571,48786,2785,74,19,38,36
64844,53,45693,53,allow,733,86,647,2,29,1,1
35555,53,35555,53,allow,194,87,107,2,30,1,1
54761,5228,49627,5228,allow,12683,1205,11478,27,182,8,19
60540,445,0,0,drop,70,70,0,1,0,1,0
49266,53,8623,53,allow,86,86,0,1,30,1,0
49346,443,65391,443,allow,7292,950,6342,19,75,9,10
49160,57470,0,0,deny,146,146,0,1,0,1,0
54265,445,0,0,drop,70,70,0,1,0,1,0
52867,445,0,0,drop,70,70,0,1,0,1,0
2099,53,2099,53,allow,217,82,135,2,33,1,1
65087,53,12187,53,allow,413,170,243,6,30,3,3
39795,5900,0,0,deny,60,60,0,1,0,1,0
36498,80,36498,80,allow,161054,3432,157622,140,158,24,116
57235,53,3428,53,allow,212,102,110,2,30,1,1
57307,53,15696,53,allow,177,94,83,2,30,1,1
34897,50584,0,0,deny,62,62,0,1,0,1,0
59447,445,0,0,drop,70,70,0,1,0,1,0
52064,80,33091,80,allow,692,300,392,9,25,6,3
27065,53,10980,53,allow,822,466,356,3,30,2,1
46452,53,46452,53,allow,247,98,149,2,32,1,1
52222,11516,7975,11516,allow,70,70,0,1,5,1,0
49563,443,54610,443,allow,6462,2102,4360,18,180,8,10
58638,5900,0,0,deny,62,62,0,1,0,1,0
20706,37965,0,0,deny,62,62,0,1,0,1,0
46704,80,21758,80,allow,1193,451,742,10,15,6,4
58876,57470,0,0,deny,66,66,0,1,0,1,0
49696,443,49696,443,allow,4871,1623,3248,18,137,8,10
64879,445,0,0,drop,66,66,0,1,0,1,0
63797,47784,45642,47784,allow,66,66,0,1,5,1,0
46965,443,48357,443,allow,1786,172,1614,7,120,3,4
49433,53,41471,53,allow,165,86,79,2,30,1,1
50563,53,11644,53,allow,718,94,624,2,30,1,1
59115,445,0,0,drop,70,70,0,1,0,1,0
60838,445,0,0,drop,70,70,0,1,0,1,0
13160,53,13160,53,allow,198,89,109,2,31,1,1
55188,443,45668,443,allow,6649,1556,5093,23,24,13,10
50626,80,27963,80,allow,1366,865,501,8,15,5,3
56727,443,57540,443,allow,7889,1900,5989,20,14,11,9
58894,443,4103,443,allow,152,86,66,2,4,1,1
30920,64147,0,0,deny,62,62,0,1,0,1,0
50618,80,9879,80,allow,25890,3442,22448,33,21,13,20
57590,443,26107,443,allow,2614,1689,925,18,19,10,8
29300,35440,0,0,deny,62,62,0,1,0,1,0
50048,80,54605,80,allow,2140,1030,1110,22,149,8,14
27005,30015,42725,30015,allow,1700,126,1574,4,31,2,2
22541,64147,0,0,deny,62,62,0,1,0,1,0
52363,123,30662,123,allow,184,94,90,2,30,1,1
64286,53,59300,53,allow,274,94,180,2,30,1,1
51878,445,0,0,drop,66,66,0,1,0,1,0
62838,44847,0,0,deny,66,66,0,1,0,1,0
57073,53,17930,53,allow,197,102,95,2,35,1,1
63672,22114,0,0,deny,66,66,0,1,0,1,0
17750,60780,57502,60780,allow,481,150,331,2,1200,1,1
9552,57470,0,0,deny,66,66,0,1,0,1,0
56166,53,15904,53,allow,186,95,91,2,30,1,1
50132,443,60688,443,allow,8162,1364,6798,22,16,11,11
64111,1830,17922,1830,allow,66,66,0,2,8,2,0
64096,1127,15786,1127,allow,312,132,180,6,6,3,3
40127,53,0,0,allow,82,82,0,1,31,1,0
37566,443,61835,443,allow,1386,924,462,12,30,7,5
61550,5529,0,0,deny,145,145,0,1,0,1,0
55651,53,17505,53,allow,199,102,97,2,30,1,1
58854,443,61370,443,allow,19134,6811,12323,39,83,18,21
55019,443,26461,443,allow,6866,1983,4883,23,330,11,12
57729,445,0,0,drop,66,66,0,1,0,1,0
52657,445,0,0,drop,70,70,0,1,0,1,0
39921,80,15019,80,allow,1151,711,440,10,15,5,5
2427,25174,0,0,deny,62,62,0,1,0,1,0
22571,51505,0,0,deny,66,66,0,1,0,1,0
65505,53,15527,53,allow,166,86,80,2,31,1,1
64922,53,63289,53,allow,431,95,336,4,55,2,2
52584,445,0,0,drop,70,70,0,1,0,1,0
25565,55690,0,0,deny,60,60,0,1,0,1,0
52478,443,48158,443,allow,9844,3089,6755,21,133,10,11
37622,443,52437,443,allow,12542,2527,10015,31,48,18,13
56581,445,0,0,drop,66,66,0,1,0,1,0
53771,64351,48425,64351,allow,70,70,0,1,5,1,0
56003,445,0,0,drop,70,70,0,1,0,1,0
55525,53,5634,53,allow,214,110,104,2,30,1,1
57470,65534,12773,65534,allow,773,271,502,4,1200,2,2
55114,443,11994,443,allow,14680,6119,8561,35,152,16,19
64358,445,0,0,drop,70,70,0,1,0,1,0
50686,443,4744,443,allow,1199,618,581,13,29,6,7
55680,23711,23434,23711,allow,70,70,0,2,8,2,0
47831,53,0,0,allow,86,86,0,1,30,1,0
62888,993,63963,993,allow,8786,4118,4668,80,200,41,39
49918,53,41805,53,allow,198,102,96,2,30,1,1
63425,443,8137,443,allow,22815,20019,2796,55,81,31,24
65530,53,49940,53,allow,96,96,0,1,30,1,0
50903,80,42549,80,allow,13644327,154437,13489890,11257,134,2201,9056
37568,443,50535,443,allow,214,140,74,4,15,3,1
43028,443,42197,443,allow,6748,1643,5105,26,138,14,12
55830,53,13004,53,allow,177,94,83,2,30,1,1
50291,53,32259,53,allow,86,86,0,1,30,1,0
9203,443,1918,443,allow,318,192,126,6,17,4,2
56204,53,61458,53,allow,168,86,82,2,30,1,1
53756,50584,0,0,deny,66,66,0,1,0,1,0
51693,22114,0,0,deny,62,62,0,1,0,1,0
59100,445,0,0,drop,70,70,0,1,0,1,0
6014,37965,0,0,deny,66,66,0,1,0,1,0
34932,38608,0,0,deny,62,62,0,1,0,1,0
46695,443,28304,443,allow,12787534,288179,12499355,12299,64,4036,8263
13743,33720,0,0,deny,159,159,0,1,0,1,0
55567,53,51894,53,allow,184,80,104,2,0,1,1
38644,443,1255,443,allow,2622,1399,1223,18,28,10,8
51807,10920,61477,10920,allow,70,70,0,1,5,1,0
50851,80,30396,80,allow,1123758,19319,1104439,1037,133,278,759
36717,51505,0,0,deny,146,146,0,1,0,1,0
52182,443,4685,443,allow,237151,13019,224132,251,42,90,161
1030,44847,0,0,deny,62,62,0,1,0,1,0
51629,443,13664,443,allow,19743,2133,17610,32,187,11,21
51996,80,49659,80,allow,6518746,206365,6312381,6886,22,2687,4199
35927,443,23260,443,allow,9102,1205,7897,25,14,14,11
30729,22114,0,0,deny,62,62,0,1,0,1,0
51411,443,6428,443,allow,5550,1177,4373,24,80,13,11
58638,5900,0,0,deny,62,62,0,1,0,1,0
53895,36849,56387,36849,allow,70,70,0,2,7,2,0
26183,22114,0,0,deny,62,62,0,1,0,1,0
55262,443,33483,443,allow,28633618,753499,27880119,30116,102,8846,21270
35785,80,12900,80,allow,1594,1280,314,10,15,5,5
59383,445,0,0,drop,66,66,0,1,0,1,0
58638,5900,0,0,deny,62,62,0,1,0,1,0
64324,37807,0,0,deny,62,62,0,1,0,1,0
42237,36237,0,0,deny,66,66,0,1,0,1,0
50156,445,0,0,drop,70,70,0,1,0,1,0
60438,17148,35885,17148,allow,70,70,0,1,5,1,0
30114,65151,0,0,deny,60,60,0,1,0,1,0
63465,443,3023,443,allow,3942,1406,2536,18,135,8,10
16358,50584,0,0,deny,146,146,0,1,0,1,0
56941,443,11257,443,allow,8304,2968,5336,24,362,13,11
54889,53,54889,53,allow,832,106,726,2,30,1,1
58638,5900,0,0,deny,62,62,0,1,0,1,0
64063,37832,48121,37832,allow,66,66,0,2,7,2,0
58676,445,0,0,drop,66,66,0,1,0,1,0
9185,80,20640,80,allow,17855,1067,16788,26,35,11,15
55967,53,9494,53,allow,701,88,613,2,30,1,1
123,123,46819,123,allow,184,94,90,2,29,1,1
63310,445,0,0,drop,70,70,0,1,0,1,0
58562,53,31864,53,allow,215,102,113,2,30,1,1
22199,443,22199,443,allow,79787,12741,67046,117,31,65,52
53791,16881,2744,16881,allow,70,70,0,1,5,1,0
55398,445,0,0,drop,70,70,0,1,0,1,0
123,123,49338,123,allow,184,94,90,2,30,1,1
56280,53,50135,53,allow,1335,87,1248,4,59,2,2
52177,21079,54277,21079,allow,316,136,180,6,5,3,3
65240,53,20571,53,allow,453,186,267,6,30,3,3
39244,36829,0,0,deny,62,62,0,1,0,1,0
55731,445,0,0,drop,70,70,0,1,0,1,0
49790,53,41551,53,allow,195,102,93,2,29,1,1
50020,53,1594,53,allow,210,102,108,2,30,1,1
52606,53,0,0,allow,223,91,132,2,30,1,1
54196,11392,0,0,deny,66,66,0,1,0,1,0
52661,445,0,0,drop,66,66,0,1,0,1,0
53715,443,59918,443,allow,70,70,0,1,5,1,0
63899,62015,4677,62015,allow,66,66,0,2,8,2,0
27147,22114,0,0,deny,62,62,0,1,0,1,0
56940,5900,0,0,deny,60,60,0,1,0,1,0
57655,56205,0,0,deny,66,66,0,1,0,1,0
49577,53,36536,53,allow,242,94,148,2,30,1,1
56885,445,0,0,drop,66,66,0,1,0,1,0
58850,443,33361,443,allow,9035,5883,3152,26,17,14,12
37834,45129,0,0,deny,145,145,0,1,0,1,0
3436,46783,0,0,deny,145,145,0,1,0,1,0
60498,445,0,0,drop,70,70,0,1,0,1,0
50584,6889,7914,6889,allow,1326,300,1026,6,1200,3,3
48300,443,42844,443,allow,7762,2247,5515,21,31,11,10
54434,445,0,0,drop,70,70,0,1,0,1,0
63910,44847,0,0,deny,66,66,0,1,0,1,0
55490,443,55467,443,allow,3080,1018,2062,10,120,5,5
55627,53,60150,53,allow,193,102,91,2,30,1,1
54034,445,0,0,drop,70,70,0,1,0,1,0
56754,53,42272,53,allow,209,110,99,2,30,1,1
57539,44847,0,0,deny,62,62,0,1,0,1,0
54418,445,0,0,drop,70,70,0,1,0,1,0
3996,57470,0,0,deny,62,62,0,1,0,1,0
65218,53,11039,53,allow,188,96,92,2,30,1,1
65503,443,44158,443,allow,429890,12640,417250,442,16,155,287
58642,445,0,0,drop,66,66,0,1,0,1,0
16403,16385,35308,16385,allow,308,128,180,6,30,3,3
50017,53,60474,53,allow,195,102,93,2,30,1,1
64956,53,26166,53,allow,196,102,94,2,30,1,1
64729,80,64729,80,allow,40906,1105,39801,45,142,13,32
49171,443,1136,443,allow,15437,8368,7069,40,361,19,21
43347,443,49384,443,allow,9118,1699,7419,24,131,14,10
50421,443,23778,443,allow,562,222,340,9,26,4,5
49466,53,52804,53,allow,184,94,90,2,29,1,1
56765,53,6433,53,allow,194,102,92,2,30,1,1
60089,53,50988,53,allow,297,83,214,2,30,1,1
50394,443,24134,443,allow,60424,4482,55942,101,686,39,62
56219,53,32903,53,allow,762,101,661,2,31,1,1
56558,443,56558,443,allow,4656,1749,2907,19,27,11,8
63766,80,33525,80,allow,314,192,122,6,15,4,2
61820,445,0,0,drop,70,70,0,1,0,1,0
55454,443,35001,443,allow,1784,247,1537,7,120,4,3
50765,22114,0,0,deny,66,66,0,1,0,1,0
58638,5900,0,0,deny,62,62,0,1,0,1,0
57110,445,0,0,drop,70,70,0,1,0,1,0
63060,445,0,0,drop,70,70,0,1,0,1,0
60877,443,6098,443,allow,8536,2392,6144,29,45,17,12
56177,53,3037,53,allow,807,94,713,2,31,1,1
49162,53,33526,53,allow,183,94,89,2,30,1,1
49737,443,13001,443,allow,37094,22774,14320,125,27,72,53
60239,23,0,0,deny,60,60,0,1,0,1,0
35894,53,14493,53,allow,198,93,105,2,30,1,1
50784,52952,0,0,deny,66,66,0,1,0,1,0
58727,445,0,0,drop,70,70,0,1,0,1,0
49418,27018,53537,27018,allow,256,78,178,2,30,1,1
42963,443,15595,443,allow,7681,4711,2970,36,28,17,19
50438,53,55322,53,allow,199,102,97,2,31,1,1
50181,64147,0,0,deny,66,66,0,1,0,1,0
11488,22114,0,0,deny,62,62,0,1,0,1,0
34674,41864,0,0,deny,145,145,0,1,0,1,0
31136,50584,0,0,deny,146,146,0,1,0,1,0
50936,445,0,0,drop,70,70,0,1,0,1,0
53283,445,0,0,drop,70,70,0,1,0,1,0
52644,57209,0,0,deny,66,66,0,1,0,1,0
40911,443,37854,443,allow,11095,2599,8496,45,257,22,23
62343,445,0,0,drop,70,70,0,1,0,1,0
56071,53,60998,53,allow,193,102,91,2,29,1,1
56792,42155,44462,42155,allow,70,70,0,1,5,1,0
60942,445,0,0,drop,70,70,0,1,0,1,0
55165,53,33843,53,allow,186,95,91,2,31,1,1
56771,53,26482,53,allow,166,86,80,2,30,1,1
55828,53,62076,53,allow,181,94,87,2,29,1,1
60742,20010,63644,20010,allow,70,70,0,2,8,2,0
52050,445,0,0,drop,66,66,0,1,0,1,0
61948,53,63047,53,allow,205,86,119,2,30,1,1
61085,37965,0,0,deny,62,62,0,1,0,1,0
59564,57470,0,0,deny,66,66,0,1,0,1,0
58778,443,47598,443,allow,5168,700,4468,16,15,7,9
55866,53,10182,53,allow,257,94,163,2,30,1,1
53226,445,0,0,drop,70,70,0,1,0,1,0
41073,53,41073,53,allow,197,90,107,2,30,1,1
48817,25636,48817,25636,allow,481,150,331,2,1200,1,1
53771,37965,0,0,deny,66,66,0,1,0,1,0
35647,3389,35647,3389,allow,4575,2400,2175,20,18,11,9
44246,80,45320,80,allow,5584,2543,3041,20,27,11,9
50296,53,13683,53,allow,183,94,89,2,30,1,1
9160,443,28992,443,allow,5727,491,5236,14,15,7,7
53469,36237,0,0,deny,62,62,0,1,0,1,0
56144,445,0,0,drop,70,70,0,1,0,1,0
42982,443,14998,443,allow,7467,1522,5945,26,16,14,12
53906,443,56748,443,allow,499,425,74,4,0,3,1
61741,443,4502,443,allow,68851,3430,65421,93,121,35,58
57959,21247,0,0,deny,66,66,0,1,0,1,0
58481,445,0,0,drop,70,70,0,1,0,1,0
3478,61463,0,0,deny,68,68,0,1,0,1,0
56226,53,49033,53,allow,200,102,98,2,30,1,1
17008,35440,0,0,deny,62,62,0,1,0,1,0
59777,443,22920,443,allow,19311,2432,16879,55,417,24,31
35849,30188,0,0,deny,146,146,0,1,0,1,0
63571,443,39273,443,allow,1882441,60775,1821666,2129,129,795,1334
49845,53,42421,53,allow,168,86,82,2,30,1,1
50604,80,50604,80,allow,1707,1007,700,11,21,6,5
47788,30170,0,0,deny,146,146,0,1,0,1,0
55417,53,30758,53,allow,196,100,96,2,30,1,1
65018,53,20967,53,allow,310,102,208,2,30,1,1
53142,443,26091,443,allow,4962,887,4075,15,28,9,6
53759,445,0,0,drop,70,70,0,1,0,1,0
55200,53,19804,53,allow,202,103,99,2,31,1,1
54887,445,0,0,drop,66,66,0,1,0,1,0
59052,53,10639,53,allow,504,110,394,2,30,1,1
59972,25174,0,0,deny,62,62,0,1,0,1,0
16618,52952,0,0,deny,146,146,0,1,0,1,0
61651,123,29529,123,allow,184,94,90,2,30,1,1
52933,443,12830,443,allow,3517,993,2524,12,120,6,6
64052,445,0,0,drop,66,66,0,1,0,1,0
49664,443,7925,443,allow,134,60,74,3,6,2,1
57131,35776,0,0,deny,145,145,0,1,0,1,0
49393,30188,0,0,deny,66,66,0,1,0,1,0
64493,53,56892,53,allow,280,97,183,4,58,2,2
64950,53,11191,53,allow,326,88,238,4,52,2,2
51859,7700,19893,7700,allow,8425,6015,2410,73,34,37,36
37592,443,51917,443,allow,9000,2566,6434,29,47,17,12
50224,443,62141,443,allow,9530,2104,7426,18,121,9,9
52246,52840,54967,52840,allow,258,70,188,4,9,2,2
53513,56205,0,0,deny,62,62,0,1,0,1,0
5223,34403,0,0,deny,220,220,0,1,0,1,0
50988,443,14910,443,allow,6938,2686,4252,25,27,12,13
52603,445,0,0,drop,66,66,0,1,0,1,0
59699,55783,0,0,deny,62,62,0,1,0,1,0
51898,80,53700,80,allow,366,240,126,7,28,5,2
56924,53,57471,53,allow,177,94,83,2,30,1,1
52017,26175,18735,26175,allow,70,70,0,2,9,2,0
5955,55160,0,0,deny,74,74,0,1,0,1,0
57989,445,0,0,drop,66,66,0,1,0,1,0
63176,445,0,0,drop,70,70,0,1,0,1,0
65122,53,25897,53,allow,410,110,300,2,30,1,1
52231,50934,0,0,deny,62,62,0,1,0,1,0
38663,443,44632,443,allow,16002,4305,11697,60,138,29,31
49418,27016,30888,27016,allow,255,78,177,2,30,1,1
56050,53,45848,53,allow,172,88,84,2,30,1,1
55949,443,10704,443,allow,21852,2269,19583,48,95,23,25
27110,22114,0,0,deny,62,62,0,1,0,1,0
53114,32975,63232,32975,allow,70,70,0,1,5,1,0
56296,53,43298,53,allow,216,110,106,2,30,1,1
49614,53,48437,53,allow,258,110,148,2,30,1,1
19662,22114,0,0,deny,62,62,0,1,0,1,0
50995,53,51013,53,allow,168,78,90,2,30,1,1
58257,445,0,0,drop,70,70,0,1,0,1,0
52454,445,0,0,drop,70,70,0,1,0,1,0
30046,15503,0,0,deny,62,62,0,1,0,1,0
49577,53,58264,53,allow,389,134,255,2,29,1,1
64159,445,0,0,drop,66,66,0,1,0,1,0
65356,53,49410,53,allow,199,102,97,2,30,1,1
55130,25174,0,0,deny,66,66,0,1,0,1,0
31609,26296,0,0,deny,148,148,0,1,0,1,0
59803,22114,0,0,deny,62,62,0,1,0,1,0
60775,443,60775,443,allow,4652,1745,2907,19,29,11,8
56079,53,34259,53,allow,740,93,647,2,31,1,1
55534,53,27868,53,allow,168,86,82,2,29,1,1
56062,53,2393,53,allow,192,98,94,2,31,1,1
52219,37398,8768,37398,allow,316,136,180,6,8,3,3
40802,443,39888,443,allow,3321,1297,2024,13,32,7,6
65095,53,43220,53,allow,718,94,624,2,30,1,1
56137,53,13627,53,allow,198,101,97,2,30,1,1
56717,53,9802,53,allow,711,87,624,2,30,1,1
60435,445,0,0,drop,66,66,0,1,0,1,0
23531,31573,0,0,deny,146,146,0,1,0,1,0
43584,24748,0,0,deny,156,156,0,1,0,1,0
12471,31573,0,0,deny,62,62,0,1,0,1,0
62015,445,0,0,drop,70,70,0,1,0,1,0
51493,80,21444,80,allow,9524,736,8788,18,131,9,9
50905,80,47395,80,allow,11749346,149441,11599905,10089,147,2116,7973
62717,443,23146,443,allow,3129,782,2347,17,134,8,9
3914,37965,0,0,deny,62,62,0,1,0,1,0
30599,46824,0,0,deny,66,66,0,1,0,1,0
64567,53,64760,53,allow,193,102,91,2,30,1,1
49383,445,0,0,drop,66,66,0,1,0,1,0
59543,443,39979,443,allow,7358,2661,4697,22,17,11,11
56574,53,4025,53,allow,198,94,104,2,30,1,1
61768,445,0,0,drop,66,66,0,1,0,1,0
12527,50584,0,0,deny,62,62,0,1,0,1,0
65360,53,6269,53,allow,763,102,661,2,30,1,1
41836,23,0,0,deny,60,60,0,1,0,1,0
53380,445,0,0,deny,70,70,0,1,0,1,0
28385,26467,0,0,deny,66,66,0,1,0,1,0
51244,21162,0,0,deny,100,100,0,1,0,1,0
53771,64351,44787,64351,allow,70,70,0,2,8,2,0
59477,36829,0,0,deny,66,66,0,1,0,1,0
54429,53,0,0,allow,195,70,125,2,30,1,1
57009,53,8536,53,allow,177,94,83,2,30,1,1
50370,445,0,0,drop,70,70,0,1,0,1,0
56415,53,33684,53,allow,199,102,97,2,29,1,1
58759,445,0,0,drop,66,66,0,1,0,1,0
53833,445,0,0,drop,66,66,0,1,0,1,0
59856,445,0,0,drop,70,70,0,1,0,1,0
55590,443,56220,443,allow,7906,1569,6337,20,150,9,11
50412,80,11804,80,allow,22200,11865,10335,38,86,24,14
49772,80,38817,80,allow,70,70,0,1,5,1,0
56356,2710,17176,2710,allow,1222,747,475,10,23,5,5
49179,80,7093,80,allow,2807,587,2220,13,16,7,6
57340,53,3053,53,allow,747,92,655,2,31,1,1
50542,443,1665,443,allow,5779,1472,4307,22,78,12,10
58638,5900,0,0,deny,62,62,0,1,0,1,0
17070,48817,0,0,deny,140,140,0,1,0,1,0
61229,445,0,0,drop,70,70,0,1,0,1,0
56979,80,46084,80,allow,214,140,74,4,35,3,1
29577,64147,0,0,deny,62,62,0,1,0,1,0
58120,25174,0,0,deny,66,66,0,1,0,1,0
50319,443,50669,443,allow,9933,2306,7627,27,82,13,14
58193,445,0,0,drop,66,66,0,1,0,1,0
21133,8535,17822,8535,allow,490,149,341,2,1200,1,1
61779,445,0,0,drop,70,70,0,1,0,1,0
56113,445,0,0,drop,66,66,0,1,0,1,0
50931,443,19777,443,allow,4178,2310,1868,39,30,23,16
55647,53,47322,53,allow,711,87,624,2,30,1,1
50772,35440,0,0,deny,66,66,0,1,0,1,0
11643,81,0,0,deny,60,60,0,1,0,1,0
55492,53,7520,53,allow,216,110,106,2,29,1,1
61024,445,0,0,drop,66,66,0,1,0,1,0
49861,445,0,0,drop,70,70,0,1,0,1,0
60425,80,53766,80,allow,186,64,122,4,28,2,2
56682,443,39754,443,allow,8735,1819,6916,23,22,14,9
55752,443,54224,443,allow,11823,4029,7794,25,143,12,13
55427,445,0,0,drop,66,66,0,1,0,1,0
53789,47191,44143,47191,allow,70,70,0,2,8,2,0
56275,443,61048,443,allow,513682,20015,493667,523,226,126,397
61696,445,0,0,drop,70,70,0,1,0,1,0
56711,445,0,0,drop,66,66,0,1,0,1,0
1040,37965,0,0,deny,62,62,0,1,0,1,0
36339,50584,0,0,deny,62,62,0,1,0,1,0
6882,43825,33329,43825,allow,200,111,89,2,1200,1,1
55253,53,63534,53,allow,754,94,660,2,31,1,1
56064,53,20414,53,allow,710,89,621,2,30,1,1
56433,53,27409,53,allow,170,87,83,2,31,1,1
63701,46824,0,0,deny,66,66,0,1,0,1,0
56242,445,0,0,drop,70,70,0,1,0,1,0
65299,445,0,0,drop,70,70,0,1,0,1,0
48817,57013,48817,57013,allow,158,158,0,1,1200,1,0
42986,25174,0,0,deny,66,66,0,1,0,1,0
55314,445,0,0,drop,70,70,0,1,0,1,0
50223,445,0,0,drop,66,66,0,1,0,1,0
58758,443,49380,443,allow,4889,1079,3810,15,25,8,7
19594,23117,0,0,deny,66,66,0,1,0,1,0
56941,53,56687,53,allow,193,102,91,2,30,1,1
60381,443,9520,443,allow,24271,17315,6956,53,107,34,19
50295,443,29927,443,allow,18401,4536,13865,48,27,24,24
64742,53,40488,53,allow,194,94,100,2,31,1,1
49863,8100,2379,8100,allow,78,78,0,1,4,1,0
61681,443,6029,443,allow,5922,1917,4005,24,18,14,10
53714,443,14989,443,allow,9842,4572,5270,22,76,12,10
16857,53,16857,53,allow,832,106,726,2,30,1,1
62233,445,0,0,drop,70,70,0,1,0,1,0
49764,53,33834,53,allow,198,101,97,2,31,1,1
51893,445,0,0,drop,66,66,0,1,0,1,0
33832,55108,0,0,deny,148,148,0,1,0,1,0
58997,443,10081,443,allow,70,70,0,1,4,1,0
50143,35253,0,0,deny,66,66,0,1,0,1,0
64649,53,32892,53,allow,807,94,713,2,30,1,1
13235,44847,0,0,deny,66,66,0,1,0,1,0
52295,53,54282,53,allow,322,102,220,2,30,1,1
25457,25604,0,0,deny,145,145,0,1,0,1,0
58638,5900,0,0,deny,62,62,0,1,0,1,0
53318,22114,0,0,deny,66,66,0,1,0,1,0
40299,443,53474,443,allow,9574,2600,6974,29,136,16,13
65385,53,41370,53,allow,259,110,149,2,30,1,1
55594,53,43491,53,allow,167,86,81,2,30,1,1
51201,445,0,0,drop,66,66,0,1,0,1,0
56937,8200,52360,8200,allow,78,78,0,1,30,1,0
64554,53,25900,53,allow,198,101,97,2,31,1,1
56198,445,0,0,drop,66,66,0,1,0,1,0
59995,445,0,0,drop,70,70,0,1,0,1,0
53031,443,7092,443,allow,16055,5856,10199,97,92,42,55
55757,53,48609,53,allow,177,94,83,2,30,1,1
60001,445,0,0,drop,66,66,0,1,0,1,0
64980,53,62800,53,allow,180,94,86,2,30,1,1
52165,49740,12957,49740,allow,70,70,0,1,5,1,0
55294,53,55276,53,allow,199,102,97,2,30,1,1
39061,22114,0,0,deny,146,146,0,1,0,1,0
65460,53,50952,53,allow,215,102,113,2,29,1,1
52144,15208,25879,15208,allow,70,70,0,2,8,2,0
54320,27016,28839,27016,allow,924,924,0,3,30,3,0
10082,64147,0,0,deny,62,62,0,1,0,1,0
55141,53,55990,53,allow,184,94,90,2,30,1,1
64974,53,23445,53,allow,506,108,398,4,36,2,2
47682,64147,0,0,deny,66,66,0,1,0,1,0
61510,37965,0,0,deny,66,66,0,1,0,1,0
47276,443,53172,443,allow,190,70,120,4,15,2,2
60411,80,48309,80,allow,1589,941,648,11,121,6,5
55570,44847,0,0,deny,66,66,0,1,0,1,0
60775,445,0,0,drop,70,70,0,1,0,1,0
60516,445,0,0,drop,70,70,0,1,0,1,0
11385,48543,0,0,deny,145,145,0,1,0,1,0
57038,53,63930,53,allow,194,102,92,2,33,1,1
42454,443,47292,443,allow,3513,795,2718,11,120,5,6
65061,53,60210,53,allow,733,204,529,6,40,3,3
52236,25174,0,0,deny,62,62,0,1,0,1,0
37249,25174,0,0,deny,146,146,0,1,0,1,0
57134,53,24003,53,allow,195,102,93,2,29,1,1
28236,53,28236,53,allow,235,90,145,2,32,1,1
65422,53,10168,53,allow,753,96,657,2,30,1,1
60011,443,19677,443,allow,8413,3768,4645,25,143,12,13
56715,53,50292,53,allow,807,94,713,2,30,1,1
50036,445,0,0,drop,70,70,0,1,0,1,0
64791,53,16107,53,allow,184,94,90,2,29,1,1
13285,29892,0,0,deny,145,145,0,1,0,1,0
52329,443,52329,443,allow,4453,1546,2907,21,86,11,10
55988,53,26621,53,allow,353,94,259,2,30,1,1
57395,53,64683,53,allow,262,88,174,4,58,2,2
56422,53,18940,53,allow,199,102,97,2,30,1,1
54280,3385,0,0,deny,60,60,0,1,0,1,0
61800,3389,61800,3389,allow,3429,1474,1955,16,16,8,8
5283,56205,0,0,deny,146,146,0,1,0,1,0
52061,35717,37968,35717,allow,70,70,0,1,5,1,0
52861,443,16498,443,allow,3633587,34615,3598972,2964,137,514,2450
40521,23117,0,0,deny,62,62,0,1,0,1,0
56708,443,9469,443,allow,6155,919,5236,18,55,10,8
64277,30188,0,0,deny,62,62,0,1,0,1,0
53513,51354,18257,51354,allow,70,70,0,1,4,1,0
49698,53,38054,53,allow,184,102,82,2,30,1,1
56202,15503,0,0,deny,146,146,0,1,0,1,0
52884,443,37471,443,allow,4466,1914,2552,32,116,18,14
52866,445,0,0,drop,70,70,0,1,0,1,0
57226,53,4215,53,allow,88,88,0,1,30,1,0
7210,22114,0,0,deny,66,66,0,1,0,1,0
15227,26467,0,0,deny,66,66,0,1,0,1,0
49242,80,49242,80,allow,378,180,198,7,53,4,3
64546,53,11850,53,allow,183,94,89,2,29,1,1
64237,53,55167,53,allow,199,86,113,2,30,1,1
50378,53,26291,53,allow,199,102,97,2,29,1,1
45964,55559,0,0,deny,60,60,0,1,0,1,0
50732,27029,64378,27029,allow,269,78,191,2,30,1,1
49913,53,15271,53,allow,177,94,83,2,30,1,1
56450,53,45835,53,allow,184,102,82,2,29,1,1
54137,443,45668,443,allow,10046,1394,8652,22,75,13,9
60115,445,0,0,drop,70,70,0,1,0,1,0
53714,6882,41499,6882,allow,70,70,0,1,4,1,0
58426,445,0,0,drop,70,70,0,1,0,1,0
50588,80,47890,80,allow,9116,7610,1506,22,78,12,10
58638,5900,58638,5900,allow,156,62,94,2,10,1,1
52887,445,0,0,drop,70,70,0,1,0,1,0
34548,443,60764,443,allow,11549,3378,8171,33,196,16,17
51287,26467,0,0,deny,66,66,0,1,0,1,0
62678,57470,0,0,deny,62,62,0,1,0,1,0
52475,443,47203,443,allow,14713,3210,11503,24,135,9,15
60338,443,20283,443,allow,3648,2251,1397,28,89,16,12
62938,445,0,0,drop,70,70,0,1,0,1,0
50265,45599,34078,45599,allow,330,330,0,6,1200,6,0
58638,5900,0,0,deny,62,62,0,1,0,1,0
6712,5060,0,0,deny,410,410,0,1,0,1,0
57169,445,0,0,drop,66,66,0,1,0,1,0
56281,445,0,0,drop,66,66,0,1,0,1,0
50331,445,0,0,drop,70,70,0,1,0,1,0
59848,443,53182,443,allow,2431,1164,1267,27,46,11,16
62456,443,40302,443,allow,8678,3253,5425,22,25,11,11
23310,22114,0,0,deny,62,62,0,1,0,1,0
63148,445,0,0,drop,70,70,0,1,0,1,0
47279,443,50478,443,allow,7948,1520,6428,21,16,13,8
50339,25174,0,0,deny,146,146,0,1,0,1,0
51494,443,60286,443,allow,8140,5384,2756,15,122,8,7
39714,443,60107,443,allow,922046,41258,880788,1106,218,498,608
65450,53,49502,53,allow,336,110,226,2,30,1,1
51444,443,39755,443,allow,3283,951,2332,13,135,6,7
52680,445,0,0,drop,70,70,0,1,0,1,0
60875,56205,0,0,deny,66,66,0,1,0,1,0
34129,11045,0,0,deny,62,62,0,1,0,1,0
37965,28596,25273,28596,allow,479,150,329,2,1199,1,1
58638,5900,0,0,deny,62,62,0,1,0,1,0
58118,445,0,0,drop,70,70,0,1,0,1,0
61614,445,0,0,drop,70,70,0,1,0,1,0
60308,37965,0,0,deny,66,66,0,1,0,1,0
65167,445,0,0,drop,70,70,0,1,0,1,0
55597,7485,34248,7485,allow,70,70,0,1,5,1,0
61340,445,0,0,drop,66,66,0,1,0,1,0
57732,445,0,0,drop,70,70,0,1,0,1,0
49428,445,0,0,drop,66,66,0,1,0,1,0
53733,40599,57099,40599,allow,70,70,0,2,7,2,0
63563,24096,6074,24096,allow,70,70,0,1,5,1,0
64849,53,44145,53,allow,216,102,114,2,29,1,1
63136,25174,0,0,deny,66,66,0,1,0,1,0
60761,445,0,0,drop,70,70,0,1,0,1,0
27005,27017,7414,27017,allow,882,126,756,2,30,1,1
55209,445,0,0,drop,70,70,0,1,0,1,0
60991,445,0,0,drop,70,70,0,1,0,1,0
50078,443,50829,443,allow,7418,2721,4697,23,17,12,11
49889,443,5001,443,allow,214782,13389,201393,277,50,98,179
49169,445,0,0,drop,70,70,0,1,0,1,0
58759,445,0,0,drop,70,70,0,1,0,1,0
52277,445,0,0,drop,70,70,0,1,0,1,0
59812,443,39961,443,allow,6412,1530,4882,24,255,11,13
53938,445,0,0,drop,70,70,0,1,0,1,0
57546,445,0,0,drop,66,66,0,1,0,1,0
7655,23,0,0,deny,60,60,0,1,0,1,0
41561,23,0,0,deny,60,60,0,1,0,1,0
45891,443,41811,443,allow,5718,1527,4191,24,22,13,11
47454,443,6613,443,allow,21782,2823,18959,42,16,20,22
64980,53,5647,53,allow,200,102,98,2,31,1,1
57275,53,14863,53,allow,177,94,83,2,30,1,1
9731,64147,0,0,deny,62,62,0,1,0,1,0
64357,53,36127,53,allow,183,94,89,2,30,1,1
56770,26467,0,0,deny,62,62,0,1,0,1,0
52155,445,0,0,drop,70,70,0,1,0,1,0
52282,37965,0,0,deny,66,66,0,1,0,1,0
55847,443,25138,443,allow,8443,1430,7013,17,141,8,9
22530,25174,0,0,deny,146,146,0,1,0,1,0
65239,443,50519,443,allow,5780,2572,3208,23,120,11,12
63573,445,0,0,drop,70,70,0,1,0,1,0
50027,80,48247,80,allow,3648,2069,1579,16,85,9,7
44482,443,27809,443,allow,16517,3254,13263,37,271,18,19
56104,53,51847,53,allow,210,110,100,2,31,1,1
63690,445,0,0,drop,70,70,0,1,0,1,0
55621,28144,63708,28144,allow,70,70,0,1,5,1,0
48063,80,21248,80,allow,1638,1324,314,10,15,5,5
52830,22114,0,0,deny,62,62,0,1,0,1,0
35347,20238,0,0,deny,66,66,0,1,0,1,0
61202,35894,0,0,deny,66,66,0,1,0,1,0
45525,53,45525,53,allow,469,165,304,4,30,2,2
46441,443,33380,443,allow,416,210,206,7,28,4,3
58638,5900,0,0,deny,62,62,0,1,0,1,0
63137,445,0,0,drop,70,70,0,1,0,1,0
25973,26467,0,0,deny,66,66,0,1,0,1,0
47453,443,47453,443,allow,4475,1568,2907,19,28,11,8
49861,53,49122,53,allow,196,100,96,2,31,1,1
30188,64511,50224,64511,allow,854,150,704,4,1200,2,2
7975,53,7975,53,allow,237,91,146,2,33,1,1
63927,50265,0,0,deny,62,62,0,1,0,1,0
27988,40040,49340,40040,allow,148,86,62,2,30,1,1
49380,53,58826,53,allow,199,102,97,2,31,1,1
60173,443,14780,443,allow,7909,3501,4408,19,181,9,10
65168,53,17811,53,allow,185,102,83,2,30,1,1
60145,445,0,0,drop,70,70,0,1,0,1,0
50862,445,0,0,drop,70,70,0,1,0,1,0
56797,445,0,0,drop,70,70,0,1,0,1,0
53906,37965,0,0,deny,62,62,0,1,0,1,0
1024,21247,0,0,deny,62,62,0,1,0,1,0
60389,445,0,0,drop,70,70,0,1,0,1,0
27005,1108,19358,1108,allow,873,126,747,2,30,1,1
53139,445,0,0,drop,70,70,0,1,0,1,0
37635,443,29591,443,allow,4266,1768,2498,18,121,8,10
12465,9823,0,0,deny,146,146,0,1,0,1,0
55117,443,14752,443,allow,1350,689,661,14,18,8,6
50447,443,44649,443,allow,12362,3372,8990,34,143,18,16
55858,80,7371,80,allow,104399,8436,95963,122,21,49,73
46663,53,46663,53,allow,209,83,126,2,30,1,1
55072,53,50967,53,allow,177,94,83,2,31,1,1
42185,443,3806,443,allow,15233,9395,5838,33,338,16,17
19944,22114,0,0,deny,66,66,0,1,0,1,0
49410,443,22106,443,allow,87590,6597,80993,129,125,48,81
64982,53,35426,53,allow,195,102,93,2,30,1,1
49309,443,31644,443,allow,4250,2969,1281,23,47,12,11
59534,445,0,0,drop,70,70,0,1,0,1,0
44207,44847,0,0,deny,62,62,0,1,0,1,0
65179,53,56146,53,allow,184,94,90,2,30,1,1
53813,443,59809,443,allow,499,425,74,4,0,3,1
55672,45682,1314,45682,allow,70,70,0,1,5,1,0
50223,53,61828,53,allow,173,94,79,2,30,1,1
11402,11119,0,0,deny,145,145,0,1,0,1,0
61855,445,0,0,drop,70,70,0,1,0,1,0
62731,443,62731,443,allow,9938,3644,6294,31,18,18,13
55318,53,46114,53,allow,711,87,624,2,31,1,1
38768,443,45644,443,allow,7380,3474,3906,18,16,10,8
57239,53,5025,53,allow,193,102,91,2,30,1,1
44923,23,0,0,deny,60,60,0,1,0,1,0
61463,445,0,0,drop,66,66,0,1,0,1,0
62493,50584,0,0,deny,62,62,0,1,0,1,0
50394,443,25886,443,allow,7584,1848,5736,19,29,10,9
62658,445,0,0,drop,70,70,0,1,0,1,0
53161,445,0,0,drop,66,66,0,1,0,1,0
65501,26467,0,0,deny,66,66,0,1,0,1,0
53779,37965,0,0,deny,66,66,0,1,0,1,0
65005,445,0,0,drop,66,66,0,1,0,1,0
52125,53,31811,53,allow,205,86,119,2,29,1,1
33822,57470,0,0,deny,66,66,0,1,0,1,0
60721,22114,0,0,deny,66,66,0,1,0,1,0
51868,443,55642,443,allow,4375,1230,3145,16,30,8,8
47564,5900,0,0,deny,60,60,0,1,0,1,0
57599,80,57599,80,allow,60244,2829,57415,65,144,22,43
49202,31719,26471,31719,allow,70,70,0,1,5,1,0
45116,80,45116,80,allow,24787,1571,23216,40,21,20,20
32710,22114,0,0,deny,62,62,0,1,0,1,0
63095,445,0,0,drop,70,70,0,1,0,1,0
49621,53,9845,53,allow,183,94,89,2,29,1,1
60538,80,60538,80,allow,318,120,198,6,26,3,3
6882,3800,7427,3800,allow,150,150,0,2,1201,2,0
60931,445,0,0,drop,70,70,0,1,0,1,0
18172,23,0,0,deny,60,60,0,1,0,1,0
56484,80,16261,80,allow,97842,4441,93401,109,135,41,68
13408,44847,0,0,deny,66,66,0,1,0,1,0
65315,53,36625,53,allow,94,94,0,1,30,1,0
57915,445,0,0,drop,70,70,0,1,0,1,0
56770,443,57005,443,allow,124,64,60,2,16,1,1
65392,443,55705,443,allow,5939,772,5167,17,27,9,8
50370,80,12726,80,allow,318,192,126,6,28,4,2
22409,55442,0,0,deny,74,74,0,1,0,1,0
63178,445,0,0,drop,66,66,0,1,0,1,0
53332,80,59740,80,allow,9094,5469,3625,22,166,12,10
62792,53,0,0,deny,88,88,0,1,0,1,0
49156,53,59173,53,allow,195,102,93,2,30,1,1
57698,64147,0,0,deny,62,62,0,1,0,1,0
23127,53,23127,53,allow,233,91,142,2,30,1,1
41420,443,4151,443,allow,4858,855,4003,16,64,9,7
55764,53,63898,53,allow,250,94,156,2,30,1,1
53234,48817,0,0,deny,148,148,0,1,0,1,0
5938,6987,0,0,allow,60,60,0,1,90,1,0
45035,80,33169,80,allow,3720,1663,2057,17,186,10,7
53188,443,8819,443,allow,7878,3197,4681,22,18,11,11
49245,445,0,0,drop,70,70,0,1,0,1,0
59216,445,0,0,drop,66,66,0,1,0,1,0
36476,5228,61709,5228,allow,21282,7311,13971,96,1216,47,49
64537,53,43379,53,allow,251,102,149,2,30,1,1
55045,53,21912,53,allow,261,102,159,2,30,1,1
55005,53,64586,53,allow,211,102,109,2,30,1,1
55030,53,38017,53,allow,185,102,83,2,30,1,1
64483,53,39103,53,allow,168,86,82,2,29,1,1
55370,443,38504,443,allow,3055,953,2102,23,50,10,13
49386,53,12060,53,allow,332,102,230,2,30,1,1
60017,443,51690,443,allow,134,60,74,3,10,2,1
46640,9002,0,0,deny,60,60,0,1,0,1,0
59233,445,0,0,drop,70,70,0,1,0,1,0
59018,22114,0,0,deny,62,62,0,1,0,1,0
64266,53,49573,53,allow,168,86,82,2,31,1,1
49035,443,36911,443,allow,4299,2327,1972,23,315,11,12
52521,80,12951,80,allow,3676,3228,448,11,15,7,4
49296,53,40688,53,allow,322,98,224,4,32,2,2
55525,443,64786,443,allow,5200,2825,2375,18,155,9,9
48731,443,18575,443,allow,5959,1709,4250,27,1211,15,12
39487,80,41504,80,allow,1403,651,752,10,15,6,4
50985,80,32837,80,allow,5823,1570,4253,17,20,10,7
62487,445,0,0,drop,70,70,0,1,0,1,0
57303,445,0,0,drop,70,70,0,1,0,1,0
33057,80,61093,80,allow,1151,711,440,10,15,5,5
61362,443,33042,443,allow,8167,2671,5496,22,69,11,11
0,0,0,0,allow,600,306,294,6,0,3,3
49505,445,0,0,drop,70,70,0,1,0,1,0
49516,53,31257,53,allow,183,94,89,2,29,1,1
51191,26467,0,0,deny,66,66,0,1,0,1,0
65513,445,0,0,drop,70,70,0,1,0,1,0
9434,443,11212,443,allow,5693,499,5194,14,15,7,7
58286,20,58286,20,allow,100132,17467,82665,325,619,168,157
27005,27015,22346,27015,allow,869,126,743,2,30,1,1
55417,445,0,0,drop,66,66,0,1,0,1,0
55431,53,52036,53,allow,196,102,94,2,29,1,1
64034,17935,14010,17935,allow,66,66,0,2,8,2,0
60513,443,14543,443,allow,9456,1987,7469,28,30,15,13
55657,53,52636,53,allow,822,102,720,2,30,1,1
42465,443,2367,443,allow,4885,895,3990,16,29,9,7
58072,445,0,0,drop,66,66,0,1,0,1,0
63407,445,0,0,drop,70,70,0,1,0,1,0
4110,35440,0,0,deny,66,66,0,1,0,1,0
55603,32520,10079,32520,allow,5982,1890,4092,30,75,15,15
50972,443,8971,443,allow,469,403,66,4,0,3,1
14437,443,4301,443,allow,2589,1443,1146,18,16,8,10
49264,80,49264,80,allow,698,366,332,12,44,7,5
58926,25174,0,0,deny,146,146,0,1,0,1,0
54803,445,0,0,drop,70,70,0,1,0,1,0
65045,443,13703,443,allow,4305,2217,2088,11,120,5,6
35123,443,15419,443,allow,17656,4044,13612,30,122,13,17
57248,443,46396,443,allow,4113,1387,2726,15,36,8,7
56543,443,26469,443,allow,245527,10641,234886,322,405,136,186
46641,443,43427,443,allow,8471,3278,5193,21,120,11,10
65526,53,9344,53,allow,199,102,97,2,30,1,1
53624,53,53624,53,allow,832,106,726,2,29,1,1
15760,53,32222,53,allow,497,83,414,4,30,2,2
52139,38259,26811,38259,allow,70,70,0,1,4,1,0
37941,443,61204,443,allow,69429,16478,52951,156,182,83,73
57475,445,0,0,drop,70,70,0,1,0,1,0
41641,443,28317,443,allow,13106,6413,6693,24,121,12,12
12530,35440,0,0,deny,66,66,0,1,0,1,0
54149,445,0,0,drop,66,66,0,1,0,1,0
59368,53,55998,53,allow,241,118,123,2,29,1,1
55413,37965,0,0,deny,66,66,0,1,0,1,0
51086,80,8200,80,allow,6365,3093,3272,36,130,19,17
61431,443,56520,443,allow,352310,324883,27427,389,300,270,119
57603,80,12542,80,allow,886,886,0,1,120,1,0
51902,445,0,0,drop,66,66,0,1,0,1,0
25108,53,24919,53,allow,222,78,144,2,30,1,1
59977,53,61405,53,allow,168,78,90,2,30,1,1
62060,443,7381,443,allow,12169,4985,7184,34,52,19,15
6069,45680,0,0,deny,159,159,0,1,0,1,0
55732,53,40584,53,allow,194,102,92,2,31,1,1
27005,27018,56521,27018,allow,1672,126,1546,4,30,2,2
12951,50584,0,0,deny,66,66,0,1,0,1,0
65447,53,45832,53,allow,756,95,661,2,31,1,1
44680,80,65456,80,allow,1658,922,736,10,17,6,4
42927,443,28678,443,allow,6921,1769,5152,22,24,13,9
52375,80,50220,80,allow,234,234,0,4,12,4,0
41974,443,41974,443,allow,214163,29159,185004,242,20,108,134
51638,80,49602,80,allow,19232,1830,17402,35,49,19,16
51760,36558,34247,36558,allow,70,70,0,1,5,1,0
62922,993,33264,993,allow,9484,4222,5262,86,45,40,46
35579,443,65088,443,allow,13136,3596,9540,40,26,21,19
45682,47993,0,0,deny,62,62,0,1,0,1,0
65398,53,27490,53,allow,214,110,104,2,30,1,1
60303,445,0,0,drop,66,66,0,1,0,1,0
64876,445,0,0,drop,66,66,0,1,0,1,0
57070,443,3388,443,allow,18227,6731,11496,63,18,34,29
56963,53,26493,53,allow,210,110,100,2,30,1,1
60307,445,0,0,drop,66,66,0,1,0,1,0
39626,443,37265,443,allow,5518,1323,4195,25,271,14,11
49370,11392,0,0,deny,66,66,0,1,0,1,0
50304,443,23238,443,allow,3565,1947,1618,19,15,9,10
19841,50584,0,0,deny,62,62,0,1,0,1,0
57073,57470,0,0,deny,62,62,0,1,0,1,0
58053,80,60672,80,allow,3751,3009,742,14,31,8,6
9233,443,25219,443,allow,5955,728,5227,17,15,8,9
12605,57470,0,0,deny,62,62,0,1,0,1,0
50340,80,53882,80,allow,8924,872,8052,19,41,9,10
56535,53,61823,53,allow,200,94,106,2,30,1,1
33671,443,8770,443,allow,12536,1564,10972,30,809,13,17
57340,3333,57340,3333,allow,24544,10921,13623,171,1095,89,82
57513,443,18231,443,allow,4346,1212,3134,13,120,6,7
62180,445,0,0,drop,70,70,0,1,0,1,0
64183,445,0,0,drop,70,70,0,1,0,1,0
63001,445,0,0,drop,66,66,0,1,0,1,0
54986,53,53684,53,allow,164,78,86,2,30,1,1
52493,443,57807,443,allow,32907,8900,24007,38,16,16,22
58651,445,0,0,drop,70,70,0,1,0,1,0
51246,445,0,0,drop,70,70,0,1,0,1,0
65131,53,44924,53,allow,168,86,82,2,30,1,1
51794,53911,31763,53911,allow,70,70,0,2,8,2,0
49808,445,0,0,drop,70,70,0,1,0,1,0
49401,53,41126,53,allow,258,102,156,2,30,1,1
58891,443,55777,443,allow,7641,5165,2476,25,18,13,12
49579,443,1881,443,allow,6629,827,5802,19,53,9,10
11136,17500,0,0,deny,62,62,0,1,0,1,0
62015,445,0,0,drop,70,70,0,1,0,1,0
57259,53,43490,53,allow,167,86,81,2,29,1,1
50016,53,35137,53,allow,275,94,181,2,29,1,1
53242,37965,0,0,deny,66,66,0,1,0,1,0
64976,53,40742,53,allow,193,102,91,2,31,1,1
59064,445,0,0,drop,66,66,0,1,0,1,0
42319,443,8708,443,allow,6664,1570,5094,23,18,13,10
50265,27034,40304,27034,allow,480,149,331,2,1200,1,1
55475,80,10225,80,allow,350,210,140,6,27,4,2
50418,80,62798,80,allow,12920,6875,6045,25,27,13,12
51530,445,0,0,drop,66,66,0,1,0,1,0
61192,445,0,0,drop,70,70,0,1,0,1,0
34417,50265,0,0,deny,145,145,0,1,0,1,0
49193,80,37184,80,allow,6158,654,5504,15,16,8,7
52741,445,0,0,drop,70,70,0,1,0,1,0
55113,53,62810,53,allow,198,102,96,2,33,1,1
35343,80,43757,80,allow,953,538,415,11,318,6,5
56766,53,15187,53,allow,210,110,100,2,30,1,1
50031,44847,0,0,deny,74,74,0,1,0,1,0
49665,53,15025,53,allow,168,86,82,2,29,1,1
64559,53,8772,53,allow,198,102,96,2,30,1,1
51295,445,0,0,drop,66,66,0,1,0,1,0
57677,57470,0,0,deny,62,62,0,1,0,1,0
26921,37965,0,0,deny,62,62,0,1,0,1,0
19473,28109,14230,28109,allow,468,149,319,2,1200,1,1
50191,53,52829,53,allow,182,102,80,2,30,1,1
60713,443,57689,443,allow,6287,1742,4545,17,19,10,7
58638,5900,0,0,deny,62,62,0,1,0,1,0
6881,63963,28408,63963,allow,207,118,89,2,1200,1,1
52245,445,0,0,drop,66,66,0,1,0,1,0
51413,48637,0,0,deny,72,72,0,1,0,1,0
49529,21247,0,0,deny,62,62,0,1,0,1,0
53726,443,39961,443,allow,499,425,74,4,0,3,1
64302,53,55170,53,allow,258,94,164,2,31,1,1
50116,22,50116,22,allow,146,60,86,2,9,1,1
59924,443,2445,443,allow,682,310,372,12,68,6,6
443,50755,0,0,deny,102,102,0,1,0,1,0
49905,443,56801,443,allow,4712,908,3804,18,77,9,9
55605,27274,9607,27274,allow,130,70,60,2,4,1,1
51428,445,0,0,drop,70,70,0,1,0,1,0
53815,44847,0,0,deny,62,62,0,1,0,1,0
56713,25174,0,0,deny,62,62,0,1,0,1,0
41895,443,48920,443,allow,282,60,222,5,14,2,3
39771,80,39771,80,allow,17982,4308,13674,30,20,15,15
53914,44209,7956,44209,allow,1729,985,744,16,16,9,7
14252,35993,0,0,deny,66,66,0,1,0,1,0
13285,29892,0,0,deny,145,145,0,1,0,1,0
49953,53,38496,53,allow,757,98,659,2,31,1,1
65173,53,61112,53,allow,508,186,322,6,51,3,3
55347,443,1685,443,allow,116686,21822,94864,224,186,112,112
65213,53,54852,53,allow,298,94,204,2,30,1,1
32299,40015,58130,40015,allow,148,86,62,2,30,1,1
52811,44847,0,0,deny,66,66,0,1,0,1,0
63467,445,0,0,drop,66,66,0,1,0,1,0
53488,445,0,0,drop,70,70,0,1,0,1,0
49243,53,10757,53,allow,452,118,334,2,30,1,1
59420,443,62141,443,allow,2854,1732,1122,16,15,8,8
9687,57470,0,0,deny,78,78,0,1,0,1,0
60297,25604,0,0,deny,62,62,0,1,0,1,0
18224,23,0,0,deny,60,60,0,1,0,1,0
12909,47807,0,0,deny,148,148,0,1,0,1,0
27005,30004,43558,30004,allow,1646,126,1520,4,30,2,2
61360,445,0,0,drop,70,70,0,1,0,1,0
61865,35440,0,0,deny,66,66,0,1,0,1,0
49663,53,41171,53,allow,184,102,82,2,30,1,1
48271,15000,29989,15000,allow,130,70,60,2,5,1,1
50428,445,0,0,drop,70,70,0,1,0,1,0
50934,443,50934,443,allow,5661,2414,3247,22,37,13,9
60781,40010,23139,40010,allow,316,136,180,6,5,3,3
37661,53,37661,53,allow,237,91,146,2,32,1,1
50225,445,0,0,drop,66,66,0,1,0,1,0
56687,443,42301,443,allow,7889,1900,5989,20,15,11,9
49533,53,65286,53,allow,771,101,670,2,30,1,1
49730,445,0,0,drop,70,70,0,1,0,1,0
49994,26467,0,0,deny,62,62,0,1,0,1,0
52744,25174,0,0,deny,66,66,0,1,0,1,0
54684,37965,0,0,deny,62,62,0,1,0,1,0
51270,443,53083,443,allow,190,70,120,4,15,2,2
59570,443,28825,443,allow,24203,14278,9925,168,320,74,94
42810,443,64537,443,allow,9265,2134,7131,24,123,12,12
54908,53,0,0,allow,174,79,95,2,30,1,1
49418,30050,47158,30050,allow,78,78,0,1,30,1,0
55998,15503,0,0,deny,146,146,0,1,0,1,0
34134,30188,0,0,deny,62,62,0,1,0,1,0
49506,53,52835,53,allow,200,102,98,2,31,1,1
30188,14991,3855,14991,allow,501,150,351,2,1200,1,1
0,0,0,0,deny,210,210,0,3,0,3,0
56569,53,42369,53,allow,183,94,89,2,30,1,1
27005,33111,35417,33111,allow,895,126,769,2,31,1,1
53861,53065,56189,53065,allow,70,70,0,1,5,1,0
56586,443,35077,443,allow,7110,2183,4927,22,16,12,10
52787,443,54390,443,allow,1550,834,716,19,141,10,9
57570,443,57570,443,allow,175212,28668,146544,186,180,69,117
49395,445,0,0,drop,66,66,0,1,0,1,0
41502,443,22197,443,allow,1053,566,487,10,48,6,4
49248,445,0,0,drop,70,70,0,1,0,1,0
64204,53,3889,53,allow,186,95,91,2,31,1,1
56276,443,23651,443,allow,154,94,60,2,4,1,1
62769,25174,0,0,deny,146,146,0,1,0,1,0
64538,53,37074,53,allow,194,102,92,2,30,1,1
49963,53,15871,53,allow,279,96,183,4,58,2,2
55686,443,35273,443,allow,319563,13365,306198,344,123,119,225
55413,53,32368,53,allow,216,110,106,2,31,1,1
55877,64536,41597,64536,allow,469,150,319,2,1200,1,1
64850,53,27196,53,allow,167,86,81,2,30,1,1
56532,53,29846,53,allow,291,88,203,4,50,2,2
60582,53,13685,53,allow,180,86,94,2,30,1,1
65312,53,47796,53,allow,180,92,88,2,30,1,1
64884,53,55819,53,allow,195,102,93,2,31,1,1
36810,80,28528,80,allow,18460,3166,15294,34,32,18,16
40845,64147,0,0,deny,62,62,0,1,0,1,0
40840,21247,0,0,deny,62,62,0,1,0,1,0
49719,445,0,0,drop,70,70,0,1,0,1,0
54196,443,33780,443,allow,499,425,74,4,0,3,1
58010,445,0,0,drop,70,70,0,1,0,1,0
6882,25021,51756,25021,allow,509,150,359,2,1200,1,1
55125,53,32465,53,allow,177,94,83,2,31,1,1
50453,445,0,0,drop,66,66,0,1,0,1,0
24965,53,24965,53,allow,247,98,149,2,32,1,1
58016,80,61881,80,allow,378,192,186,7,21,4,3
51003,445,0,0,drop,70,70,0,1,0,1,0
43916,21,0,0,deny,60,60,0,1,0,1,0
50815,445,0,0,drop,70,70,0,1,0,1,0
42731,23,0,0,deny,60,60,0,1,0,1,0
56760,53,60380,53,allow,760,96,664,2,31,1,1
55022,53,30402,53,allow,772,103,669,2,30,1,1
50719,445,0,0,drop,70,70,0,1,0,1,0
49242,22114,0,0,deny,62,62,0,1,0,1,0
60025,445,0,0,drop,70,70,0,1,0,1,0
49825,445,0,0,drop,66,66,0,1,0,1,0
53177,443,2633,443,allow,6512167,186944,6325223,6347,1216,2089,4258
61307,445,0,0,drop,70,70,0,1,0,1,0
26900,27017,30659,27017,allow,168,82,86,2,30,1,1
49709,80,19787,80,allow,1702,1388,314,10,15,5,5
59990,445,0,0,drop,70,70,0,1,0,1,0
40358,53,40358,53,allow,414,268,146,3,32,2,1
65350,53,62383,53,allow,168,86,82,2,30,1,1
55392,53,38891,53,allow,190,97,93,2,31,1,1
34286,53,18958,53,allow,199,94,105,2,30,1,1
52727,443,14385,443,allow,1369,708,661,14,45,8,6
63855,29799,24538,29799,allow,66,66,0,2,8,2,0
3549,64147,0,0,deny,62,62,0,1,0,1,0
13654,50584,0,0,deny,62,62,0,1,0,1,0
49785,443,35177,443,allow,7757,1949,5808,22,126,12,10
64266,53,53096,53,allow,1026,383,643,10,84,5,5
62769,25174,0,0,deny,62,62,0,1,0,1,0
65492,53,44506,53,allow,822,102,720,2,30,1,1
40549,443,43115,443,allow,1352,691,661,14,42,8,6
58969,443,56637,443,allow,2768,1593,1175,22,21,11,11
39639,80,40156,80,allow,1143,401,742,9,360,5,4
61000,57587,0,0,deny,146,146,0,1,0,1,0
47894,443,29583,443,allow,295475,14093,281382,413,469,162,251
46860,15000,54542,15000,allow,130,70,60,2,6,1,1
17146,57470,0,0,deny,62,62,0,1,0,1,0
39556,443,12327,443,allow,7469,2547,4922,18,135,8,10
4515,37807,0,0,deny,62,62,0,1,0,1,0
56217,5900,0,0,deny,60,60,0,1,0,1,0
55024,53,56157,53,allow,168,86,82,2,31,1,1
64188,53,11006,53,allow,299,98,201,4,57,2,2
55337,443,55337,443,allow,7710,3932,3778,23,18,14,9
6881,12676,29408,12676,allow,509,150,359,2,1199,1,1
51691,5543,12224,5543,allow,70,70,0,1,5,1,0
39375,443,57783,443,allow,36154,9709,26445,60,161,27,33
27005,27015,11957,27015,allow,901,126,775,2,30,1,1
64053,445,0,0,drop,70,70,0,1,0,1,0
53628,445,0,0,drop,66,66,0,1,0,1,0
60934,80,21512,80,allow,1212,774,438,11,81,7,4
55634,53,46753,53,allow,308,102,206,2,30,1,1
46349,51505,0,0,deny,74,74,0,1,0,1,0
58638,5900,0,0,deny,62,62,0,1,0,1,0
54067,443,60829,443,allow,113020,6140,106880,149,202,66,83
55260,445,0,0,drop,70,70,0,1,0,1,0
49228,53,30182,53,allow,193,102,91,2,30,1,1
1048,25174,0,0,deny,62,62,0,1,0,1,0
42298,40016,35583,40016,allow,157,94,63,2,30,1,1
64639,3389,64639,3389,allow,3409,1454,1955,16,16,8,8
65019,53,42326,53,allow,190,97,93,2,31,1,1
49293,53,18352,53,allow,294,88,206,4,57,2,2
37453,443,30746,443,allow,8891,1846,7045,27,147,14,13
53858,443,59816,443,allow,499,425,74,4,1,3,1
56434,445,0,0,drop,66,66,0,1,0,1,0
44962,8802,46440,8802,allow,4014,2342,1672,42,386,21,21
38976,46824,0,0,deny,62,62,0,1,0,1,0
56670,443,55495,443,allow,8308,3589,4719,25,19,15,10
55176,53,23619,53,allow,195,102,93,2,30,1,1
49396,445,0,0,drop,70,70,0,1,0,1,0
53324,44847,0,0,deny,66,66,0,1,0,1,0
11592,80,11592,80,allow,6967,765,6202,15,16,7,8
61364,443,17656,443,allow,7653,1226,6427,24,18,14,10
33924,80,28051,80,allow,1139,609,530,10,61,6,4
57625,445,0,0,drop,66,66,0,1,0,1,0
15274,81,0,0,deny,60,60,0,1,0,1,0
51903,443,13827,443,allow,1612,1089,523,12,15,7,5
57860,445,0,0,drop,70,70,0,1,0,1,0
2323,23117,0,0,deny,62,62,0,1,0,1,0
50295,445,0,0,drop,66,66,0,1,0,1,0
55193,53,10853,53,allow,177,94,83,2,29,1,1
33202,80,39571,80,allow,1114,534,580,12,15,7,5
3911,50584,0,0,deny,62,62,0,1,0,1,0
49262,445,0,0,drop,70,70,0,1,0,1,0
64603,53,49089,53,allow,269,110,159,2,30,1,1
57128,445,0,0,drop,70,70,0,1,0,1,0
51001,445,0,0,drop,70,70,0,1,0,1,0
34997,22,0,0,deny,60,60,0,1,0,1,0
57309,53,6657,53,allow,197,102,95,2,29,1,1
5180,57866,0,0,deny,66,66,0,1,0,1,0
52428,80,60172,80,allow,2516,1929,587,15,16,9,6
61313,445,0,0,drop,70,70,0,1,0,1,0
33705,80,63150,80,allow,1288,496,792,8,43,5,3
55377,53,45027,53,allow,195,102,93,2,30,1,1
54007,50265,0,0,deny,66,66,0,1,0,1,0
57069,445,0,0,drop,70,70,0,1,0,1,0
55690,443,36462,443,allow,914,444,470,14,29,7,7
52147,443,32446,443,allow,27251,9966,17285,70,73,35,35
55847,445,0,0,drop,70,70,0,1,0,1,0
52892,443,14885,443,allow,130,70,60,2,14,1,1
60480,57470,0,0,deny,62,62,0,1,0,1,0
57106,33000,6001,33000,allow,223,223,0,1,30,1,0
7877,22114,0,0,deny,62,62,0,1,0,1,0
64580,445,0,0,drop,70,70,0,1,0,1,0
49289,53,50733,53,allow,322,118,204,2,30,1,1
1025,51221,0,0,deny,62,62,0,1,0,1,0
54201,443,42354,443,allow,6500,1064,5436,22,255,12,10
56035,53,29824,53,allow,337,94,243,2,30,1,1
1038,37965,0,0,deny,62,62,0,1,0,1,0
49713,53,16907,53,allow,184,94,90,2,30,1,1
49835,53,35014,53,allow,168,86,82,2,30,1,1
51984,54606,27351,54606,allow,70,70,0,1,5,1,0
56395,53,34668,53,allow,199,102,97,2,29,1,1
56148,445,0,0,drop,66,66,0,1,0,1,0
57320,443,20383,443,allow,5989,926,5063,19,14,10,9
63463,53,56932,53,allow,199,86,113,2,29,1,1
21133,17068,30422,17068,allow,481,150,331,2,1199,1,1
6712,161,0,0,deny,82,82,0,1,0,1,0
45726,443,49906,443,allow,3068,1678,1390,17,242,9,8
52461,443,54450,443,allow,16541,4900,11641,62,131,26,36
49725,443,45081,443,allow,7162,780,6382,18,50,8,10
52703,443,1986,443,allow,7843,2397,5446,23,256,12,11
45964,2225,0,0,deny,60,60,0,1,0,1,0
10010,80,10501,80,allow,2166,600,1566,10,45,6,4
64735,53,3296,53,allow,730,102,628,2,30,1,1
61784,49903,0,0,deny,66,66,0,1,0,1,0
50903,445,0,0,drop,70,70,0,1,0,1,0
49316,53,24928,53,allow,184,94,90,2,31,1,1
51415,443,38416,443,allow,9284,2172,7112,39,83,19,20
53936,5915,64456,5915,allow,70,70,0,2,7,2,0
55957,53,33865,53,allow,178,94,84,2,30,1,1
55807,80,52839,80,allow,73021,1232,71789,66,80,14,52
51756,53,33754,53,allow,168,78,90,2,30,1,1
64888,60038,0,0,allow,66,66,0,1,91,1,0
65377,53,64134,53,allow,404,95,309,4,49,2,2
57470,1028,19810,1028,allow,350,163,187,2,1200,1,1
31176,53,31176,53,allow,414,268,146,3,32,2,1
27005,31010,2449,31010,allow,1626,126,1500,4,31,2,2
51840,443,42990,443,allow,246,120,126,5,32,3,2
123,123,8140,123,allow,184,94,90,2,30,1,1
59754,53,11671,53,allow,260,86,174,2,30,1,1
55776,53,11984,53,allow,271,93,178,4,32,2,2
1534,54369,0,0,deny,66,66,0,1,0,1,0
51716,57137,62764,57137,allow,70,70,0,2,8,2,0
55900,53,13889,53,allow,194,102,92,2,30,1,1
50057,53,37422,53,allow,177,94,83,2,30,1,1
52781,57470,0,0,deny,66,66,0,1,0,1,0
51951,80,50498,80,allow,366,240,126,7,28,5,2
63065,53,14429,53,allow,448,166,282,2,30,1,1
45055,443,37161,443,allow,1392,731,661,14,80,8,6
61237,445,0,0,drop,70,70,0,1,0,1,0
46270,7700,51894,7700,allow,1440,956,484,15,35,8,7
42555,443,40081,443,allow,14262,5874,8388,31,138,15,16
14567,37965,0,0,deny,62,62,0,1,0,1,0
49805,6881,0,0,deny,62,62,0,1,0,1,0
51742,20110,30208,20110,allow,136,136,0,3,14,3,0
6122,23,0,0,deny,60,60,0,1,0,1,0
56703,53,34394,53,allow,199,102,97,2,31,1,1
2531,30188,0,0,deny,66,66,0,1,0,1,0
50802,445,0,0,drop,66,66,0,1,0,1,0
64097,443,64097,443,allow,13511,6811,6700,43,159,23,20
59956,25,59956,25,allow,1867,743,1124,24,16,11,13
64706,53,5159,53,allow,179,94,85,2,30,1,1
64180,445,0,0,drop,70,70,0,1,0,1,0
52368,445,0,0,drop,70,70,0,1,0,1,0
57470,6881,57710,6881,allow,453,251,202,4,1200,2,2
56375,53,4600,53,allow,184,102,82,2,30,1,1
45682,37965,0,0,deny,145,145,0,1,0,1,0
53252,443,27483,443,allow,31843,2847,28996,50,323,20,30
1827,64147,0,0,deny,66,66,0,1,0,1,0
55816,53,60578,53,allow,214,110,104,2,31,1,1
56925,445,0,0,drop,66,66,0,1,0,1,0
43475,443,10490,443,allow,5578,1646,3932,23,16,13,10
49730,53,34658,53,allow,194,102,92,2,30,1,1
61491,443,56385,443,allow,5628,1716,3912,26,109,16,10
49243,80,49243,80,allow,378,180,198,7,53,4,3
52643,36237,0,0,deny,66,66,0,1,0,1,0
33405,37965,0,0,deny,62,62,0,1,0,1,0
60789,40010,35327,40010,allow,316,136,180,6,6,3,3
55238,21247,0,0,deny,62,62,0,1,0,1,0
42558,64147,0,0,deny,62,62,0,1,0,1,0
42034,28189,0,0,deny,62,62,0,1,0,1,0
53500,443,53500,443,allow,960,539,421,9,35,5,4
52240,52893,59916,52893,allow,70,70,0,2,6,2,0
38701,443,23957,443,allow,1065134,19929,1045205,1009,16,288,721
11136,15503,0,0,deny,145,145,0,1,0,1,0
64613,53,15938,53,allow,179,94,85,2,30,1,1
49282,53,56718,53,allow,178,94,84,2,30,1,1
65401,445,0,0,drop,66,66,0,1,0,1,0
58374,445,0,0,drop,70,70,0,1,0,1,0
55439,37965,0,0,deny,66,66,0,1,0,1,0
52201,44054,12966,44054,allow,66,66,0,2,9,2,0
53879,443,22578,443,allow,499,425,74,4,1,3,1
52267,445,0,0,drop,66,66,0,1,0,1,0
50140,53,17472,53,allow,209,110,99,2,30,1,1
56111,53,53180,53,allow,174,89,85,2,31,1,1
57783,445,0,0,drop,70,70,0,1,0,1,0
53442,443,20405,443,allow,10500,2835,7665,34,114,14,20
55264,53,35896,53,allow,170,87,83,2,30,1,1
56394,443,3047,443,allow,5019,946,4073,19,34,9,10
50584,38578,41911,38578,allow,1377,300,1077,6,1200,3,3
50021,445,0,0,drop,70,70,0,1,0,1,0
55658,445,0,0,drop,70,70,0,1,0,1,0
8449,80,8449,80,allow,48320,1685,46635,57,126,22,35
53156,57780,14557,57780,allow,320,140,180,6,7,3,3
64104,53,1753,53,allow,855,311,544,8,79,4,4
57363,53,6725,53,allow,172,88,84,2,31,1,1
56837,53,14391,53,allow,195,102,93,2,33,1,1
64382,53,40543,53,allow,278,102,176,2,30,1,1
27005,32065,5075,32065,allow,877,126,751,2,31,1,1
49384,53,48199,53,allow,193,102,91,2,31,1,1
64903,51050,0,0,deny,62,62,0,1,0,1,0
56100,445,0,0,drop,70,70,0,1,0,1,0
65531,53,43079,53,allow,186,95,91,2,31,1,1
64441,445,0,0,drop,66,66,0,1,0,1,0
51143,443,51143,443,allow,33565,5938,27627,60,128,24,36
59801,445,0,0,drop,70,70,0,1,0,1,0
53894,443,56603,443,allow,499,425,74,4,0,3,1
48817,6889,48817,6889,allow,480,149,331,2,1200,1,1
64054,53,41905,53,allow,1299,387,912,10,103,5,5
50265,57799,36521,57799,allow,1450,747,703,16,1200,9,7
64124,53,26589,53,allow,182,93,89,2,31,1,1
65460,53,23650,53,allow,184,94,90,2,30,1,1
60076,445,0,0,drop,70,70,0,1,0,1,0
48810,443,34983,443,allow,6478,2684,3794,18,122,8,10
50574,80,53098,80,allow,2734,1250,1484,16,15,10,6
64530,445,0,0,drop,70,70,0,1,0,1,0
15875,50584,0,0,deny,62,62,0,1,0,1,0
56598,445,0,0,drop,70,70,0,1,0,1,0
55300,53,49492,53,allow,308,94,214,2,30,1,1
49450,53,29878,53,allow,758,102,656,2,30,1,1
49001,48983,0,0,deny,161,161,0,1,0,1,0
60978,443,39156,443,allow,1004246,35992,968254,1127,90,451,676
13262,53,13262,53,allow,208,94,114,2,31,1,1
57936,445,0,0,drop,70,70,0,1,0,1,0
56596,53,26887,53,allow,198,101,97,2,30,1,1
55878,53,24199,53,allow,260,102,158,2,29,1,1
48697,5222,62184,5222,allow,8355,4135,4220,79,616,41,38
50316,37965,0,0,deny,66,66,0,1,0,1,0
64823,53,51719,53,allow,199,102,97,2,30,1,1
57402,445,0,0,drop,66,66,0,1,0,1,0
41815,5228,54746,5228,allow,7701,2155,5546,30,611,17,13
42166,443,46667,443,allow,162,102,60,2,5,1,1
57356,53,19968,53,allow,199,102,97,2,30,1,1
64410,53,32197,53,allow,286,98,188,4,40,2,2
43078,80,13694,80,allow,1052,612,440,10,15,5,5
54048,25174,0,0,deny,62,62,0,1,0,1,0
64298,53,48284,53,allow,311,118,193,2,30,1,1
54287,443,13671,443,allow,122,62,60,2,15,1,1
57550,445,0,0,drop,70,70,0,1,0,1,0
49858,53,41757,53,allow,177,94,83,2,30,1,1
59001,443,42456,443,allow,9860,5309,4551,25,131,14,11
55044,53,52145,53,allow,196,102,94,2,29,1,1
51998,445,0,0,drop,70,70,0,1,0,1,0
49814,53,29277,53,allow,181,94,87,2,30,1,1
58638,5900,0,0,deny,62,62,0,1,0,1,0
63993,17866,56109,17866,allow,4607,2045,2562,24,45,14,10
53198,53,24028,53,allow,365,86,279,2,30,1,1
57426,443,14949,443,allow,832,268,564,14,37,5,9
30629,46783,0,0,deny,145,145,0,1,0,1,0
64968,445,0,0,drop,70,70,0,1,0,1,0
56560,53,21034,53,allow,198,102,96,2,31,1,1
49615,443,24939,443,allow,48705,7643,41062,146,256,77,69
33434,5228,15468,5228,allow,12979,2808,10171,46,648,21,25
55123,64097,0,0,deny,66,66,0,1,0,1,0
50393,443,64712,443,allow,1125,595,530,12,29,6,6
59733,443,53510,443,allow,7165,2077,5088,22,105,12,10
17344,62413,0,0,deny,62,62,0,1,0,1,0
44977,443,32272,443,allow,4848,1030,3818,16,26,9,7
57038,53,13307,53,allow,735,88,647,2,30,1,1
56911,53,31733,53,allow,177,94,83,2,30,1,1
49789,53,65450,53,allow,177,94,83,2,30,1,1
58074,11392,0,0,deny,62,62,0,1,0,1,0
56795,53,22826,53,allow,177,94,83,2,30,1,1
2267,53,10348,53,allow,204,118,86,2,30,1,1
51430,445,0,0,drop,70,70,0,1,0,1,0
52455,443,34682,443,allow,7356,1014,6342,20,75,10,10
58961,445,0,0,drop,70,70,0,1,0,1,0
49502,443,21667,443,allow,26402,2904,23498,56,270,29,27
51748,15177,40687,15177,allow,70,70,0,2,9,2,0
49686,445,0,0,drop,70,70,0,1,0,1,0
24486,53,24486,53,allow,414,268,146,3,31,2,1
49539,80,49460,80,allow,378,192,186,7,42,4,3
58638,5900,0,0,deny,62,62,0,1,0,1,0
54002,445,0,0,drop,70,70,0,1,0,1,0
50453,445,0,0,drop,70,70,0,1,0,1,0
64990,53,21080,53,allow,323,94,229,2,30,1,1
4581,23,0,0,deny,60,60,0,1,0,1,0
46337,443,56368,443,allow,10379011,159069,10219942,8727,252,1321,7406
54506,443,29033,443,allow,89702,83941,5761,91,181,66,25
53097,445,0,0,drop,70,70,0,1,0,1,0
993,16279,0,0,deny,129,129,0,1,0,1,0
55840,53,36401,53,allow,199,94,105,2,30,1,1
56157,50584,0,0,deny,66,66,0,1,0,1,0
26962,26467,0,0,deny,66,66,0,1,0,1,0
22150,6881,0,0,deny,62,62,0,1,0,1,0
49412,443,12912,443,allow,9266,2595,6671,35,123,18,17
54930,445,0,0,drop,70,70,0,1,0,1,0
25469,57470,0,0,deny,62,62,0,1,0,1,0
28234,36653,45143,36653,allow,64,64,0,1,10,1,0
29988,44847,0,0,deny,66,66,0,1,0,1,0
59727,3389,59727,3389,allow,8409,1841,6568,27,20,11,16
27005,27015,34659,27015,allow,899,126,773,2,30,1,1
47096,443,23148,443,allow,6211,1753,4458,43,215,15,28
42922,80,41285,80,allow,234,234,0,4,12,4,0
56385,53,62602,53,allow,402,142,260,2,30,1,1
57413,443,19121,443,allow,16749,7614,9135,74,17,34,40
49510,443,46546,443,allow,1012,495,517,10,26,4,6
50106,31573,0,0,deny,66,66,0,1,0,1,0
42135,443,55299,443,allow,6531,1249,5282,24,286,13,11
55088,53,2549,53,allow,186,95,91,2,31,1,1
58303,22114,0,0,deny,62,62,0,1,0,1,0
57284,445,0,0,drop,70,70,0,1,0,1,0
65132,445,0,0,drop,70,70,0,1,0,1,0
45767,80,42626,80,allow,2768,1722,1046,17,20,8,9
49771,53,57877,53,allow,177,94,83,2,29,1,1
64796,53,3205,53,allow,184,94,90,2,31,1,1
49521,53,26950,53,allow,182,93,89,2,30,1,1
34233,993,0,0,deny,60,60,0,1,0,1,0
52273,80,52273,80,allow,156876,7015,149861,158,28,49,109
38699,443,63342,443,allow,759586,14873,744713,719,16,209,510
62377,443,62377,443,allow,4378,1471,2907,19,27,11,8
58841,445,0,0,drop,70,70,0,1,0,1,0
56960,53,26282,53,allow,196,102,94,2,30,1,1
49195,8108,53972,8108,allow,70,70,0,1,5,1,0
53446,443,53446,443,allow,960,539,421,9,30,5,4
58638,5900,0,0,deny,62,62,0,1,0,1,0
56552,53,3851,53,allow,195,102,93,2,31,1,1
65106,53,10929,53,allow,193,102,91,2,30,1,1
55233,445,0,0,drop,66,66,0,1,0,1,0
63915,23225,23322,23225,allow,564,382,182,9,15,6,3
57333,53,41487,53,allow,258,110,148,2,31,1,1
56711,53,61949,53,allow,209,110,99,2,31,1,1
5195,64147,0,0,deny,66,66,0,1,0,1,0
56614,25174,0,0,deny,66,66,0,1,0,1,0
57470,26944,61791,26944,allow,480,149,331,2,1200,1,1
55940,53,33630,53,allow,742,88,654,2,30,1,1
50187,53,34456,53,allow,168,78,90,2,30,1,1
50336,53,11367,53,allow,240,76,164,2,30,1,1
56599,53,21288,53,allow,258,110,148,2,30,1,1
33830,443,43990,443,allow,448,78,370,6,25,1,5
50484,443,37149,443,allow,30475,26737,3738,62,26,35,27
51922,80,2848,80,allow,52962,3994,48968,71,27,32,39
59879,443,12932,443,allow,302,120,182,6,32,3,3
60768,445,0,0,drop,66,66,0,1,0,1,0
14697,8000,59482,8000,allow,212,150,62,2,30,1,1
45641,443,12763,443,allow,99276,88410,10866,143,333,78,65
64244,53,1570,53,allow,199,102,97,2,31,1,1
65526,28793,0,0,deny,66,66,0,1,0,1,0
49880,445,0,0,drop,70,70,0,1,0,1,0
62388,39004,0,0,deny,62,62,0,1,0,1,0
60525,443,60525,443,allow,1088,641,447,10,26,6,4
30114,65151,0,0,deny,60,60,0,1,0,1,0
51212,445,0,0,drop,66,66,0,1,0,1,0
64463,53,25750,53,allow,183,94,89,2,31,1,1
49923,443,47836,443,allow,7759,2264,5495,19,120,9,10
56519,53,20744,53,allow,167,86,81,2,29,1,1
32707,11392,0,0,deny,62,62,0,1,0,1,0
57134,445,0,0,drop,70,70,0,1,0,1,0
55489,53,26827,53,allow,193,102,91,2,30,1,1
57454,443,10249,443,allow,4881,1817,3064,30,135,16,14
50723,445,0,0,drop,66,66,0,1,0,1,0
51471,445,0,0,drop,70,70,0,1,0,1,0
56619,443,13998,443,allow,6895,2273,4622,21,17,12,9
50525,445,0,0,drop,66,66,0,1,0,1,0
36229,62413,0,0,deny,62,62,0,1,0,1,0
55800,53,32257,53,allow,177,94,83,2,30,1,1
46509,53,4834,53,allow,168,78,90,2,30,1,1
1024,37450,0,0,deny,62,62,0,1,0,1,0
2437,23117,0,0,deny,62,62,0,1,0,1,0
65315,53,23256,53,allow,178,94,84,2,30,1,1
56396,53,60964,53,allow,183,94,89,2,30,1,1
51291,25174,0,0,deny,62,62,0,1,0,1,0
63616,443,48346,443,allow,1296,612,684,18,120,9,9
48817,21939,48817,21939,allow,513,152,361,2,1200,1,1
41431,443,64563,443,allow,190,70,120,4,15,2,2
56275,53,46209,53,allow,166,86,80,2,30,1,1
5223,32965,0,0,deny,220,220,0,1,0,1,0
58638,5900,58638,5900,allow,62,62,0,1,5,1,0
16762,61689,0,0,deny,62,62,0,1,0,1,0
53513,443,7067,443,allow,1625,1038,587,14,34,8,6
49046,5222,3706,5222,allow,6910,3381,3529,50,323,26,24
41612,80,44236,80,allow,2016,552,1464,8,16,5,3
54910,445,0,0,drop,66,66,0,1,0,1,0
36390,443,36390,443,allow,4563,1656,2907,19,28,11,8
58638,5900,0,0,deny,62,62,0,1,0,1,0
57252,443,17744,443,allow,12683,4753,7930,59,36,33,26
58574,445,0,0,drop,70,70,0,1,0,1,0
52459,33890,0,0,deny,60,60,0,1,0,1,0
60649,445,0,0,drop,66,66,0,1,0,1,0
26332,57470,0,0,deny,62,62,0,1,0,1,0
8999,32480,0,0,deny,146,146,0,1,0,1,0
58736,445,0,0,drop,70,70,0,1,0,1,0
44389,53,44389,53,allow,235,90,145,2,32,1,1
55727,43736,19578,43736,allow,70,70,0,1,5,1,0
55071,53,51447,53,allow,177,94,83,2,30,1,1
47595,33434,0,0,allow,106,106,0,1,60,1,0
60727,445,0,0,drop,70,70,0,1,0,1,0
57470,18531,64727,18531,allow,166,166,0,1,1200,1,0
65354,53,35359,53,allow,272,94,178,2,31,1,1
59899,443,64399,443,allow,1401,864,537,12,30,6,6
49654,53,58330,53,allow,184,94,90,2,31,1,1
61701,15503,0,0,deny,66,66,0,1,0,1,0
1091,37965,0,0,deny,62,62,0,1,0,1,0
64289,53,64357,53,allow,199,102,97,2,30,1,1
49785,53,52317,53,allow,211,110,101,2,30,1,1
62941,445,0,0,drop,66,66,0,1,0,1,0
59744,445,0,0,drop,66,66,0,1,0,1,0
58245,445,0,0,drop,70,70,0,1,0,1,0
64628,53,1942,53,allow,199,102,97,2,30,1,1
56614,80,65163,80,allow,234,234,0,4,11,4,0
49684,80,60336,80,allow,13889,4084,9805,27,16,13,14
55773,53,34274,53,allow,199,102,97,2,30,1,1
48972,443,48972,443,allow,4657,1750,2907,19,31,11,8
58381,57470,0,0,deny,66,66,0,1,0,1,0
65202,445,0,0,drop,70,70,0,1,0,1,0
58835,445,0,0,drop,70,70,0,1,0,1,0
64306,64147,0,0,deny,66,66,0,1,0,1,0
59699,55783,0,0,deny,62,62,0,1,0,1,0
41763,443,59315,443,allow,9797,1934,7863,21,15,12,9
7222,57470,0,0,deny,62,62,0,1,0,1,0
49481,53,49481,53,allow,222,101,121,2,31,1,1
54260,445,0,0,drop,70,70,0,1,0,1,0
42071,443,52227,443,allow,9366,5830,3536,23,121,12,11
53212,443,62292,443,allow,81114,4708,76406,108,66,39,69
51085,56205,0,0,deny,66,66,0,1,0,1,0
50584,50901,9302,50901,allow,166,166,0,1,1199,1,0
49393,30188,0,0,deny,66,66,0,1,0,1,0
50708,445,0,0,drop,66,66,0,1,0,1,0
50287,53,45385,53,allow,177,94,83,2,30,1,1
36445,443,53718,443,allow,78,78,0,1,5,1,0
30960,45679,3682,45679,allow,396,396,0,7,3615,7,0
60186,445,0,0,drop,70,70,0,1,0,1,0
55862,53,15902,53,allow,177,94,83,2,30,1,1
49511,57470,0,0,deny,66,66,0,1,0,1,0
64009,53,32252,53,allow,209,110,99,2,30,1,1
49863,443,31339,443,allow,6057,1038,5019,20,56,11,9
53301,445,0,0,drop,66,66,0,1,0,1,0
50584,445,0,0,drop,70,70,0,1,0,1,0
33664,80,55691,80,allow,70,70,0,1,5,1,0
27005,1102,43095,1102,allow,867,126,741,2,30,1,1
49361,53,25462,53,allow,184,94,90,2,30,1,1
46093,32661,0,0,deny,74,74,0,1,0,1,0
56355,53,52899,53,allow,184,94,90,2,31,1,1
53608,39004,0,0,deny,66,66,0,1,0,1,0
53835,62413,0,0,deny,62,62,0,1,0,1,0
62039,443,46235,443,allow,356,60,296,6,18,2,4
65430,80,47649,80,allow,306,180,126,6,29,4,2
57172,3389,57172,3389,allow,3347,1458,1889,15,18,8,7
27988,40037,18791,40037,allow,568,78,490,2,29,1,1
49196,445,0,0,drop,66,66,0,1,0,1,0
28331,53,28331,53,allow,213,87,126,2,30,1,1
64543,50265,0,0,deny,66,66,0,1,0,1,0
56283,53,17978,53,allow,315,102,213,2,30,1,1
49230,445,0,0,drop,66,66,0,1,0,1,0
51120,587,51120,587,allow,320,128,192,6,6,3,3
60628,445,0,0,drop,70,70,0,1,0,1,0
56500,53,41129,53,allow,199,102,97,2,30,1,1
56037,53,8318,53,allow,246,102,144,2,30,1,1
53145,27067,38874,27067,allow,1231702,397859,833843,10382,185,4780,5602
49394,443,62275,443,allow,1392,731,661,14,80,8,6
50151,53,38506,53,allow,177,94,83,2,30,1,1
56041,53,5205,53,allow,183,94,89,2,30,1,1
64598,53,46493,53,allow,342,142,200,2,30,1,1
27005,27015,60376,27015,allow,878,126,752,2,30,1,1
56389,53,50951,53,allow,279,93,186,4,32,2,2
65448,445,0,0,drop,66,66,0,1,0,1,0
42898,443,46834,443,allow,4999,2845,2154,41,87,22,19
56703,53,62070,53,allow,183,94,89,2,31,1,1
65192,445,0,0,drop,66,66,0,1,0,1,0
61481,443,1524,443,allow,23229,1880,21349,46,80,21,25
65483,53,14095,53,allow,701,88,613,2,31,1,1
49872,53,36268,53,allow,331,126,205,2,30,1,1
49966,53,5626,53,allow,168,78,90,2,30,1,1
53381,25174,0,0,deny,66,66,0,1,0,1,0
56586,53,23269,53,allow,170,87,83,2,30,1,1
50302,443,11942,443,allow,11313,2617,8696,27,47,15,12
52850,443,36065,443,allow,5743,1339,4404,18,180,8,10
27005,27019,51161,27019,allow,1698,126,1572,4,31,2,2
45511,443,41466,443,allow,130,70,60,2,15,1,1
54687,445,0,0,drop,66,66,0,1,0,1,0
63601,443,6476,443,allow,26835,2611,24224,36,121,14,22
50450,53,9173,53,allow,209,110,99,2,30,1,1
33215,37965,0,0,deny,62,62,0,1,0,1,0
56799,443,31346,443,allow,6496,1340,5156,31,506,10,21
46707,443,23817,443,allow,9723,1780,7943,35,120,17,18
3478,61463,0,0,deny,179,179,0,1,0,1,0
37435,53,37435,53,allow,414,268,146,3,32,2,1
57576,445,0,0,drop,70,70,0,1,0,1,0
53354,80,22791,80,allow,2722,1530,1192,12,316,7,5
65248,53,8659,53,allow,197,94,103,2,30,1,1
55851,53,15581,53,allow,749,94,655,2,30,1,1
56069,445,0,0,drop,66,66,0,1,0,1,0
8536,37965,0,0,deny,62,62,0,1,0,1,0
59247,53,59247,53,allow,825,99,726,2,31,1,1
50584,1070,63097,1070,allow,161,161,0,2,1200,2,0
55001,80,28763,80,allow,9249354,297929,8951425,10789,208,4872,5917
53923,25267,60857,25267,allow,1724,1157,567,14,17,9,5
49196,25174,0,0,deny,62,62,0,1,0,1,0
18218,30349,0,0,deny,148,148,0,1,0,1,0
53924,45212,17906,45212,allow,70,70,0,1,5,1,0
51746,17867,44740,17867,allow,136,136,0,3,14,3,0
51716,44847,0,0,deny,62,62,0,1,0,1,0
56214,53,47362,53,allow,200,102,98,2,30,1,1
49331,443,20933,443,allow,4889,763,4126,18,30,8,10
64090,53,12119,53,allow,227,102,125,2,30,1,1
64733,445,0,0,drop,66,66,0,1,0,1,0
51062,445,0,0,drop,66,66,0,1,0,1,0
11651,64147,0,0,deny,145,145,0,1,0,1,0
54436,445,0,0,drop,70,70,0,1,0,1,0
51945,445,0,0,drop,70,70,0,1,0,1,0
38285,443,16953,443,allow,6872,1815,5057,22,318,13,9
57029,53,54997,53,allow,413,170,243,6,30,3,3
49631,443,7469,443,allow,11772,5416,6356,25,49,15,10
63459,443,62292,443,allow,7782,1280,6502,22,79,10,12
58143,57866,0,0,deny,66,66,0,1,0,1,0
35869,80,16584,80,allow,2604,1690,914,20,610,11,9
34169,443,8049,443,allow,6507,1060,5447,22,255,12,10
53754,445,0,0,drop,66,66,0,1,0,1,0
33995,443,61498,443,allow,6419,995,5424,21,361,11,10
31675,19473,0,0,deny,62,62,0,1,0,1,0
9748,21247,0,0,deny,66,66,0,1,0,1,0
61976,445,0,0,drop,66,66,0,1,0,1,0
56003,445,0,0,drop,66,66,0,1,0,1,0
56848,19556,62974,19556,allow,70,70,0,2,8,2,0
12794,35440,0,0,deny,146,146,0,1,0,1,0
36488,443,36488,443,allow,8448,2150,6298,39,98,21,18
57430,80,9392,80,allow,4509,2976,1533,13,15,6,7
0,0,0,0,allow,480,244,236,4,0,2,2
55569,443,6204,443,allow,8049,1560,6489,19,151,9,10
61387,43890,0,0,deny,66,66,0,1,0,1,0
47342,36237,0,0,deny,66,66,0,1,0,1,0
31235,22114,0,0,deny,146,146,0,1,0,1,0
49708,53,49250,53,allow,193,102,91,2,30,1,1
64288,443,27448,443,allow,252,70,182,3,120,1,2
44293,443,16772,443,allow,5880,2280,3600,31,76,14,17
56604,17372,0,0,deny,66,66,0,1,0,1,0
50512,24748,0,0,deny,145,145,0,1,0,1,0
52859,445,0,0,drop,66,66,0,1,0,1,0
56528,64147,0,0,deny,62,62,0,1,0,1,0
59136,50584,0,0,deny,66,66,0,1,0,1,0
65059,445,0,0,drop,70,70,0,1,0,1,0
54071,50265,0,0,deny,66,66,0,1,0,1,0
10436,37965,0,0,deny,62,62,0,1,0,1,0
42166,443,20816,443,allow,5309,3110,2199,36,81,18,18
55379,53,3403,53,allow,358,102,256,2,30,1,1
27005,27015,32670,27015,allow,912,126,786,2,31,1,1
51808,46390,6189,46390,allow,70,70,0,2,8,2,0
49205,445,0,0,drop,70,70,0,1,0,1,0
64092,14447,29856,14447,allow,66,66,0,1,5,1,0
49316,445,0,0,drop,70,70,0,1,0,1,0
49628,443,15510,443,allow,5600,1187,4413,24,80,13,11
44334,26467,0,0,deny,62,62,0,1,0,1,0
0,0,0,0,allow,600,306,294,6,0,3,3
33241,443,5641,443,allow,37452,28136,9316,56,15,33,23
62772,445,0,0,drop,66,66,0,1,0,1,0
49315,53,15991,53,allow,94,94,0,1,30,1,0
56676,53,50057,53,allow,178,94,84,2,30,1,1
49399,80,18487,80,allow,4382,2084,2298,18,66,10,8
63691,53,63691,53,allow,198,90,108,2,30,1,1
61818,445,0,0,drop,70,70,0,1,0,1,0
61455,445,0,0,drop,70,70,0,1,0,1,0
3382,53,3382,53,allow,220,100,120,2,31,1,1
50136,443,32292,443,allow,23193,8487,14706,57,55,28,29
60475,443,46189,443,allow,5888,1175,4713,19,43,11,8
56980,53,43925,53,allow,701,88,613,2,30,1,1
44538,50584,0,0,deny,62,62,0,1,0,1,0
36956,443,8939,443,allow,9273,2731,6542,31,403,10,21
55390,443,55390,443,allow,164571,13257,151314,206,19,95,111
57470,24409,44348,24409,allow,870,330,540,12,1501,6,6
52806,445,0,0,drop,70,70,0,1,0,1,0
54826,56205,0,0,deny,66,66,0,1,0,1,0
9555,80,9555,80,allow,6893,704,6189,14,15,6,8
50706,443,45520,443,allow,13948,10445,3503,25,121,14,11
65180,53,32141,53,allow,198,101,97,2,31,1,1
60193,443,30919,443,allow,677029,102078,574951,1152,455,559,593
55234,53,22160,53,allow,177,94,83,2,30,1,1
58966,30188,0,0,deny,66,66,0,1,0,1,0
36068,80,51482,80,allow,41269,2915,38354,62,33,32,30
49682,53,35686,53,allow,341,110,231,2,29,1,1
53128,443,20598,443,allow,14603,4208,10395,39,48,20,19
51418,443,51418,443,allow,4742,1835,2907,19,30,11,8
55245,443,43023,443,allow,7725129,126824,7598305,6259,607,740,5519
31994,53,31994,53,allow,244,98,146,2,33,1,1
58427,5223,31205,5223,allow,13841,6601,7240,42,622,19,23
56273,53,51229,53,allow,197,102,95,2,33,1,1
57470,48622,44893,48622,allow,166,166,0,1,1200,1,0
60762,445,0,0,drop,70,70,0,1,0,1,0
58742,443,35475,443,allow,5166,700,4466,16,15,7,9
57035,53,11215,53,allow,1414,95,1319,4,41,2,2
36656,64147,0,0,deny,62,62,0,1,0,1,0
58558,53,58236,53,allow,268,86,182,2,30,1,1
59883,17637,0,0,deny,66,66,0,1,0,1,0
53490,62413,0,0,deny,66,66,0,1,0,1,0
61961,445,0,0,drop,66,66,0,1,0,1,0
60259,443,51277,443,allow,3285,2009,1276,26,150,16,10
64668,53,24152,53,allow,211,102,109,2,30,1,1
58396,80,29243,80,allow,1088,599,489,13,315,7,6
65289,25174,0,0,deny,66,66,0,1,0,1,0
58392,445,0,0,drop,70,70,0,1,0,1,0
59646,5223,55530,5223,allow,70,70,0,1,5,1,0
6881,58293,28909,58293,allow,228,118,110,2,1200,1,1
63846,445,0,0,drop,66,66,0,1,0,1,0
58132,80,58132,80,allow,348,132,216,6,15,3,3
57331,53,38724,53,allow,166,86,80,2,30,1,1
64087,50265,0,0,deny,145,145,0,1,0,1,0
63960,53,41492,53,allow,172,88,84,2,31,1,1
51961,80,32070,80,allow,26804,11349,15455,45,26,25,20
54268,445,0,0,drop,66,66,0,1,0,1,0
62764,445,0,0,drop,70,70,0,1,0,1,0
54894,9571,0,0,deny,66,66,0,1,0,1,0
55113,53,22722,53,allow,177,94,83,2,30,1,1
61528,443,29665,443,allow,138544,7073,131471,165,144,59,106
60441,64337,31545,64337,allow,70,70,0,2,8,2,0
51638,443,56586,443,allow,8176,2082,6094,26,360,12,14
60367,443,45021,443,allow,4847,963,3884,22,63,11,11
55927,80,55927,80,allow,450,246,204,8,29,5,3
65472,445,0,0,drop,70,70,0,1,0,1,0
51244,57099,0,0,deny,100,100,0,1,0,1,0
59928,53,57258,53,allow,320,94,226,2,29,1,1
58143,57866,0,0,deny,66,66,0,1,0,1,0
55470,53,60625,53,allow,310,94,216,2,30,1,1
55763,443,52551,443,allow,48162,46496,1666,59,136,39,20
0,0,0,0,deny,98,98,0,1,0,1,0
49555,53,60187,53,allow,578,286,292,9,15,5,4
41762,443,13178,443,allow,2306249,52358,2253891,2041,239,447,1594
49690,50265,0,0,deny,66,66,0,1,0,1,0
50168,445,0,0,drop,66,66,0,1,0,1,0
56636,80,30803,80,allow,234,234,0,4,12,4,0
62332,53,0,0,allow,633,75,558,2,29,1,1
49218,53,62258,53,allow,190,97,93,2,31,1,1
55202,445,0,0,drop,70,70,0,1,0,1,0
65300,53,18303,53,allow,195,102,93,2,31,1,1
62273,50584,0,0,deny,66,66,0,1,0,1,0
52600,445,0,0,drop,70,70,0,1,0,1,0
56880,53,23570,53,allow,202,103,99,2,31,1,1
56789,443,8502,443,allow,7877,1888,5989,20,15,11,9
2886,35440,0,0,deny,66,66,0,1,0,1,0
50584,54157,4800,54157,allow,1377,300,1077,6,1200,3,3
14717,64147,0,0,deny,66,66,0,1,0,1,0
80,13987,0,0,deny,66,66,0,1,0,1,0
63542,15503,0,0,deny,66,66,0,1,0,1,0
63812,445,0,0,drop,70,70,0,1,0,1,0
59546,445,0,0,drop,70,70,0,1,0,1,0
61766,443,43724,443,allow,4326,2217,2109,14,120,7,7
56246,53,33774,53,allow,209,110,99,2,30,1,1
63780,28124,24113,28124,allow,4536,2883,1653,27,94,15,12
62768,445,0,0,drop,70,70,0,1,0,1,0
38140,443,44966,443,allow,82608,3591,79017,101,15,39,62
57094,53,18443,53,allow,196,102,94,2,31,1,1
43584,24748,0,0,deny,156,156,0,1,0,1,0
58638,5900,0,0,deny,62,62,0,1,0,1,0
52184,22114,0,0,deny,66,66,0,1,0,1,0
45374,443,48527,443,allow,88469,3492,84977,104,396,35,69
26079,53,52153,53,allow,226,78,148,2,29,1,1
55857,53,56112,53,allow,199,102,97,2,31,1,1
57282,445,0,0,drop,70,70,0,1,0,1,0
52236,25174,0,0,deny,66,66,0,1,0,1,0
54998,53,23774,53,allow,198,102,96,2,29,1,1
19747,37965,0,0,deny,62,62,0,1,0,1,0
27005,33059,8397,33059,allow,900,126,774,2,31,1,1
51822,445,0,0,drop,70,70,0,1,0,1,0
42075,36237,0,0,deny,62,62,0,1,0,1,0
11585,56205,0,0,deny,66,66,0,1,0,1,0
56979,53,36485,53,allow,176,90,86,2,31,1,1
28124,37965,0,0,deny,145,145,0,1,0,1,0
56680,8100,35918,8100,allow,78,78,0,1,5,1,0
63951,55255,6079,55255,allow,1277,856,421,9,15,6,3
56653,443,38474,443,allow,8059,2039,6020,20,15,11,9
53979,26308,39677,26308,allow,70,70,0,2,7,2,0
58018,445,0,0,drop,66,66,0,1,0,1,0
50377,53,41134,53,allow,214,110,104,2,30,1,1
46544,443,31614,443,allow,332590,15084,317506,341,139,89,252
49431,53,43013,53,allow,194,102,92,2,30,1,1
61827,443,61827,443,allow,56634,10853,45781,76,175,34,42
63220,445,0,0,drop,70,70,0,1,0,1,0
56526,53,41730,53,allow,168,94,74,2,30,1,1
9253,443,42267,443,allow,6135,770,5365,17,26,9,8
5683,44847,0,0,deny,66,66,0,1,0,1,0
49825,53,18724,53,allow,168,86,82,2,29,1,1
33404,443,64550,443,allow,4152,2734,1418,24,40,14,10
64403,445,0,0,drop,66,66,0,1,0,1,0
3376,35440,0,0,deny,66,66,0,1,0,1,0
54548,7000,54548,7000,allow,4487,2090,2397,15,15,8,7
50672,445,0,0,deny,70,70,0,1,0,1,0
43532,80,43879,80,allow,1449,364,1085,13,15,6,7
52285,995,52285,995,allow,146,82,64,2,5,1,1
35036,26296,0,0,deny,159,159,0,1,0,1,0
51607,53,46424,53,allow,322,102,220,2,29,1,1
64900,53,36772,53,allow,314,102,212,2,29,1,1
16119,57470,0,0,deny,145,145,0,1,0,1,0
7246,59858,0,0,deny,66,66,0,1,0,1,0
62269,445,0,0,drop,66,66,0,1,0,1,0
51929,80,26646,80,allow,1213,821,392,8,15,6,2
57269,53,43829,53,allow,183,94,89,2,30,1,1
51242,445,0,0,drop,70,70,0,1,0,1,0
26879,37965,0,0,deny,62,62,0,1,0,1,0
49433,445,0,0,drop,70,70,0,1,0,1,0
52101,445,0,0,drop,70,70,0,1,0,1,0
62840,445,0,0,drop,70,70,0,1,0,1,0
52986,445,0,0,drop,66,66,0,1,0,1,0
52817,443,5709,443,allow,2658,1126,1532,25,120,12,13
443,62732,0,0,deny,332,332,0,1,0,1,0
60465,445,0,0,drop,70,70,0,1,0,1,0
54101,80,21675,80,allow,78,78,0,1,5,1,0
26717,25174,0,0,deny,62,62,0,1,0,1,0
49403,53,28281,53,allow,228,102,126,2,29,1,1
64566,443,6952,443,allow,8573,2039,6534,25,31,14,11
10089,80,55892,80,allow,130,70,60,2,15,1,1
52931,80,27397,80,allow,78,78,0,1,4,1,0
42685,51180,0,0,deny,62,62,0,1,0,1,0
57010,445,0,0,drop,70,70,0,1,0,1,0
57114,35440,0,0,deny,146,146,0,1,0,1,0
52848,445,0,0,drop,70,70,0,1,0,1,0
49662,443,55920,443,allow,9534,4029,5505,22,59,12,10
56741,53,9430,53,allow,814,110,704,2,30,1,1
65221,53,47234,53,allow,199,102,97,2,30,1,1
4545,1900,0,0,deny,136,136,0,1,0,1,0
53676,3678,29317,3678,allow,70,70,0,2,7,2,0
39920,22114,0,0,deny,146,146,0,1,0,1,0
60514,39004,0,0,deny,66,66,0,1,0,1,0
49167,443,26021,443,allow,8271,1357,6914,26,17,12,14
49418,27017,46358,27017,allow,252,71,181,2,30,1,1
52167,61948,12539,61948,allow,70,70,0,2,8,2,0
54523,445,0,0,drop,66,66,0,1,0,1,0
61462,445,0,0,drop,66,66,0,1,0,1,0
49418,27017,55350,27017,allow,275,71,204,2,31,1,1
55358,53,38932,53,allow,183,94,89,2,29,1,1
58638,5900,0,0,deny,62,62,0,1,0,1,0
51106,445,0,0,drop,66,66,0,1,0,1,0
36158,443,34202,443,allow,9808,3005,6803,36,255,19,17
56441,80,54346,80,allow,17008,1379,15629,22,25,7,15
64750,53,14070,53,allow,276,102,174,2,30,1,1
52195,50930,54222,50930,allow,70,70,0,1,5,1,0
63342,445,0,0,drop,70,70,0,1,0,1,0
35217,443,22630,443,allow,4113,2625,1488,25,79,13,12
54094,445,0,0,drop,70,70,0,1,0,1,0
65211,445,0,0,drop,70,70,0,1,0,1,0
58638,5900,0,0,deny,62,62,0,1,0,1,0
38085,443,21750,443,allow,234,234,0,4,12,4,0
59309,445,0,0,drop,70,70,0,1,0,1,0
58265,445,0,0,drop,70,70,0,1,0,1,0
49606,53,26399,53,allow,231,110,121,2,31,1,1
60892,443,56728,443,allow,22772,8095,14677,46,54,24,22
61738,2767,0,0,deny,62,62,0,1,0,1,0
62466,53,62466,53,allow,194,87,107,2,30,1,1
58638,5900,0,0,deny,62,62,0,1,0,1,0
56387,25174,0,0,deny,66,66,0,1,0,1,0
50557,53,32584,53,allow,758,93,665,2,31,1,1
52009,443,21173,443,allow,10339,2028,8311,28,46,16,12
49797,445,0,0,drop,66,66,0,1,0,1,0
53010,80,53010,80,allow,210304,4398,205906,225,21,65,160
57370,6969,42648,6969,allow,70,70,0,1,5,1,0
5859,11392,0,0,deny,66,66,0,1,0,1,0
54583,445,0,0,drop,70,70,0,1,0,1,0
55065,443,23726,443,allow,13236,4421,8815,28,61,16,12
52411,443,20618,443,allow,9428,3770,5658,54,24,28,26
48905,80,43588,80,allow,1868,1374,494,12,15,7,5
49312,53,34351,53,allow,767,102,665,2,31,1,1
59352,37965,0,0,deny,66,66,0,1,0,1,0
50824,80,46115,80,allow,36051,11695,24356,109,265,55,54
49234,445,0,0,drop,70,70,0,1,0,1,0
51910,80,31121,80,allow,4994,3658,1336,11,26,6,5
50344,80,51584,80,allow,3132,730,2402,13,42,7,6
28064,36237,0,0,deny,62,62,0,1,0,1,0
49203,445,0,0,drop,66,66,0,1,0,1,0
56239,80,56239,80,allow,101707,1824,99883,96,15,26,70
49556,53,59272,53,allow,300,100,200,4,44,2,2
52029,52093,64487,52093,allow,70,70,0,1,5,1,0
49271,53,54358,53,allow,186,102,84,2,30,1,1
49539,53,25645,53,allow,177,94,83,2,30,1,1
54411,445,0,0,drop,70,70,0,1,0,1,0
56656,443,8282,443,allow,7743,3072,4671,18,125,10,8
64497,53,35440,53,allow,232,110,122,2,29,1,1
64509,9571,0,0,deny,62,62,0,1,0,1,0
55926,53,35022,53,allow,184,94,90,2,30,1,1
56512,53,8579,53,allow,166,86,80,2,29,1,1
0,0,0,0,deny,70,70,0,1,0,1,0
62327,443,62327,443,allow,1210,637,573,14,51,7,7
45941,23386,0,0,deny,60,60,0,1,0,1,0
64697,37965,0,0,deny,66,66,0,1,0,1,0
49797,25174,0,0,deny,66,66,0,1,0,1,0
63999,53,50492,53,allow,193,102,91,2,29,1,1
64172,445,0,0,drop,66,66,0,1,0,1,0
6881,6881,0,0,deny,146,146,0,1,0,1,0
60665,443,60665,443,allow,5715,1432,4283,19,15,9,10
50887,80,30027,80,allow,256649,11414,245235,280,141,111,169
51230,80,8702,80,allow,1594,1280,314,10,15,5,5
53718,443,33767,443,allow,318,192,126,6,16,4,2
56083,445,0,0,drop,70,70,0,1,0,1,0
63075,445,0,0,drop,70,70,0,1,0,1,0
64070,53,32128,53,allow,243,94,149,2,31,1,1
51859,35365,47948,35365,allow,70,70,0,2,7,2,0
62945,445,0,0,drop,70,70,0,1,0,1,0
64791,443,54264,443,allow,8580,5765,2815,46,82,22,24
23916,53,23916,53,allow,224,88,136,2,30,1,1
54345,445,0,0,drop,66,66,0,1,0,1,0
50286,445,0,0,drop,66,66,0,1,0,1,0
52095,56079,0,0,deny,66,66,0,1,0,1,0
61277,445,0,0,drop,70,70,0,1,0,1,0
50914,51505,0,0,deny,66,66,0,1,0,1,0
52496,445,0,0,drop,70,70,0,1,0,1,0
42608,1,0,0,deny,62,62,0,1,0,1,0
62892,993,17111,993,allow,9588,4811,4777,85,193,49,36
53766,51505,0,0,deny,66,66,0,1,0,1,0
56948,445,0,0,drop,66,66,0,1,0,1,0
11136,19910,0,0,deny,62,62,0,1,0,1,0
34391,443,18031,443,allow,80160,3527,76633,98,76,38,60
52496,443,9919,443,allow,9500,4662,4838,20,16,11,9
50716,50584,0,0,deny,74,74,0,1,0,1,0
50270,443,45158,443,allow,9998,2237,7761,38,121,21,17
54617,445,0,0,drop,70,70,0,1,0,1,0
50178,53,43275,53,allow,172,88,84,2,31,1,1
57326,53,9216,53,allow,180,94,86,2,35,1,1
49837,445,0,0,drop,70,70,0,1,0,1,0
55772,53,9529,53,allow,782,105,677,2,30,1,1
63134,445,0,0,drop,70,70,0,1,0,1,0
46328,443,26248,443,allow,446664,48034,398630,698,223,326,372
64049,1029,38472,1029,allow,66,66,0,2,7,2,0
56727,53,55377,53,allow,250,86,164,4,52,2,2
38770,443,2311,443,allow,7431,3525,3906,18,15,10,8
50332,80,19945,80,allow,2862,1465,1397,11,47,6,5
49248,53,8891,53,allow,211,102,109,2,30,1,1
61919,445,0,0,drop,70,70,0,1,0,1,0
55600,443,16865,443,allow,11891,2141,9750,40,231,19,21
7561,43890,0,0,deny,62,62,0,1,0,1,0
13168,35440,0,0,deny,66,66,0,1,0,1,0
49175,443,3024,443,allow,4429,2593,1836,34,1126,18,16
57477,445,0,0,drop,66,66,0,1,0,1,0
33908,48983,0,0,deny,145,145,0,1,0,1,0
36013,53,23635,53,allow,86,86,0,1,30,1,0
57647,53,15724,53,allow,265,78,187,2,30,1,1
50604,80,39550,80,allow,1658,1247,411,8,15,5,3
39536,80,4904,80,allow,2749,1732,1017,21,361,12,9
57470,49294,38558,49294,allow,132,132,0,3,1199,3,0
54352,443,38196,443,allow,12594,5098,7496,32,34,17,15
51390,53,51390,53,allow,398,255,143,3,31,2,1
59753,443,43725,443,allow,303,85,218,2,30,1,1
49169,443,62824,443,allow,11168,3827,7341,42,16,20,22
39396,443,4891,443,allow,7531,2720,4811,24,331,13,11
56157,50584,0,0,deny,62,62,0,1,0,1,0
64981,27068,50495,27068,allow,1680,1386,294,7,30,4,3
58026,445,0,0,drop,66,66,0,1,0,1,0
50614,443,33140,443,allow,3499,1732,1767,15,16,9,6
50914,51505,0,0,deny,66,66,0,1,0,1,0
36313,443,38446,443,allow,55608,48375,7233,140,95,81,59
59319,445,0,0,drop,70,70,0,1,0,1,0
58930,443,53896,443,allow,70,70,0,1,5,1,0
52614,44847,0,0,deny,66,66,0,1,0,1,0
49420,80,13977,80,allow,1985,657,1328,11,21,6,5
50912,80,58684,80,allow,9578491,119422,9459069,8079,137,1689,6390
64506,53,36287,53,allow,184,86,98,2,30,1,1
55253,445,0,0,drop,70,70,0,1,0,1,0
2049,23,0,0,deny,60,60,0,1,0,1,0
25151,58833,0,0,deny,62,62,0,1,0,1,0
33027,161,0,0,allow,15505,6180,9325,50,30,25,25
59638,445,0,0,drop,70,70,0,1,0,1,0
12128,37965,0,0,deny,62,62,0,1,0,1,0
56861,33412,8103,33412,allow,70,70,0,1,5,1,0
50372,445,0,0,drop,70,70,0,1,0,1,0
54962,53,32571,53,allow,188,96,92,2,30,1,1
50209,1688,49264,1688,allow,70,70,0,2,8,2,0
13825,443,28678,443,allow,8844,949,7895,19,75,9,10
50865,445,0,0,drop,70,70,0,1,0,1,0
64883,53,2709,53,allow,184,94,90,2,30,1,1
53553,443,31063,443,allow,3708,1988,1720,20,255,10,10
65116,53,63214,53,allow,200,94,106,2,30,1,1
49713,53,34138,53,allow,198,94,104,2,30,1,1
56656,53,3129,53,allow,255,88,167,4,53,2,2
47461,50584,0,0,deny,62,62,0,1,0,1,0
50789,445,0,0,drop,70,70,0,1,0,1,0
6897,48817,0,0,deny,139,139,0,1,0,1,0
57177,53,17706,53,allow,179,94,85,2,31,1,1
55286,53,22334,53,allow,194,102,92,2,31,1,1
49652,445,0,0,drop,66,66,0,1,0,1,0
49610,53,38769,53,allow,754,94,660,2,30,1,1
54701,445,0,0,drop,66,66,0,1,0,1,0
1024,6881,0,0,deny,146,146,0,1,0,1,0
41064,80,41064,80,allow,2118,1493,625,9,82,6,3
47765,443,53985,443,allow,8035,2176,5859,25,331,12,13
64947,53,61833,53,allow,275,96,179,4,41,2,2
52945,445,0,0,drop,70,70,0,1,0,1,0
55815,443,3642,443,allow,8602,1050,7552,16,120,7,9
49160,3800,35343,3800,allow,854,150,704,4,1200,2,2
34499,443,29656,443,allow,19518,11774,7744,46,168,26,20
62452,21247,0,0,deny,62,62,0,1,0,1,0
49206,53,61280,53,allow,174,89,85,2,31,1,1
62743,445,0,0,drop,70,70,0,1,0,1,0
54959,53,17105,53,allow,206,105,101,2,31,1,1
52991,53,52991,53,allow,235,90,145,2,32,1,1
51718,445,0,0,drop,70,70,0,1,0,1,0
51872,48108,5295,48108,allow,70,70,0,2,8,2,0
62642,25174,0,0,deny,62,62,0,1,0,1,0
62616,445,0,0,drop,70,70,0,1,0,1,0
64642,445,0,0,drop,70,70,0,1,0,1,0
58307,443,36806,443,allow,934,506,428,14,29,8,6
61458,443,40730,443,allow,3505,2042,1463,27,82,15,12
65234,53,55204,53,allow,248,110,138,2,29,1,1
50347,445,0,0,drop,70,70,0,1,0,1,0
61477,57470,0,0,deny,62,62,0,1,0,1,0
49369,443,29095,443,allow,7165,1099,6066,16,15,9,7
55840,53,28820,53,allow,177,94,83,2,30,1,1
48360,3389,48360,3389,allow,4085,1916,2169,21,19,12,9
50043,443,32430,443,allow,6551,2085,4466,25,85,14,11
59604,443,43036,443,allow,4507,1525,2982,24,147,13,11
53406,50584,0,0,deny,66,66,0,1,0,1,0
65449,445,0,0,drop,66,66,0,1,0,1,0
58092,445,0,0,drop,70,70,0,1,0,1,0
53117,37529,25510,37529,allow,70,70,0,2,8,2,0
61202,35894,0,0,deny,66,66,0,1,0,1,0
65346,53,64945,53,allow,183,94,89,2,30,1,1
52437,443,30974,443,allow,384,384,0,7,33,7,0
59034,445,0,0,drop,70,70,0,1,0,1,0
57092,445,0,0,drop,66,66,0,1,0,1,0
53892,445,0,0,drop,70,70,0,1,0,1,0
65355,53,61445,53,allow,741,94,647,2,30,1,1
8464,3389,8464,3389,allow,3910,1805,2105,20,18,12,8
56760,53,34251,53,allow,216,102,114,2,30,1,1
51876,35624,28526,35624,allow,70,70,0,2,8,2,0
55498,53,32880,53,allow,177,94,83,2,31,1,1
51222,35440,0,0,deny,66,66,0,1,0,1,0
31362,23,31362,23,allow,60,60,0,1,5,1,0
64670,53,38301,53,allow,186,95,91,2,31,1,1
63346,53,0,0,deny,75,75,0,1,0,1,0
54140,445,0,0,drop,66,66,0,1,0,1,0
51842,27665,45700,27665,allow,66,66,0,1,5,1,0
64964,53,59512,53,allow,197,102,95,2,31,1,1
64214,53,1437,53,allow,337,106,231,4,43,2,2
65493,445,0,0,drop,70,70,0,1,0,1,0
55461,443,39176,443,allow,2341,540,1801,9,121,5,4
58638,5900,0,0,deny,62,62,0,1,0,1,0
52970,445,0,0,drop,70,70,0,1,0,1,0
55395,445,0,0,drop,70,70,0,1,0,1,0
60586,445,0,0,drop,70,70,0,1,0,1,0
56274,445,0,0,drop,66,66,0,1,0,1,0
59586,57470,0,0,deny,66,66,0,1,0,1,0
56730,53,28651,53,allow,177,94,83,2,30,1,1
49661,443,62284,443,allow,6950,2484,4466,20,53,11,9
56360,53,64885,53,allow,711,87,624,2,30,1,1
39616,443,20055,443,allow,60,60,0,2,5,2,0
52682,443,30711,443,allow,5406,922,4484,19,360,10,9
49901,53,54026,53,allow,776,102,674,2,30,1,1
54530,445,0,0,drop,70,70,0,1,0,1,0
55078,445,0,0,drop,70,70,0,1,0,1,0
61507,445,0,0,drop,70,70,0,1,0,1,0
38082,443,14308,443,allow,284,164,120,4,15,2,2
53748,445,0,0,drop,70,70,0,1,0,1,0
63973,445,0,0,drop,70,70,0,1,0,1,0
49945,53,3434,53,allow,281,97,184,4,57,2,2
53911,1025,45349,1025,allow,130,70,60,3,6,2,1
50488,22114,0,0,deny,66,66,0,1,0,1,0
56227,53,28291,53,allow,179,94,85,2,30,1,1
56336,53,34970,53,allow,178,94,84,2,29,1,1
55349,53,40115,53,allow,701,88,613,2,31,1,1
56125,53,56568,53,allow,311,118,193,2,30,1,1
58074,11392,0,0,deny,66,66,0,1,0,1,0
58638,5900,0,0,deny,62,62,0,1,0,1,0
57342,80,40590,80,allow,1056,682,374,10,15,6,4
65514,53,6429,53,allow,212,108,104,2,31,1,1
53016,80,9240,80,allow,4419,271,4148,13,28,3,10
53627,445,0,0,drop,66,66,0,1,0,1,0
39568,443,60001,443,allow,4477,2605,1872,22,248,12,10
55649,445,0,0,drop,70,70,0,1,0,1,0
57562,445,0,0,drop,70,70,0,1,0,1,0
51059,445,0,0,drop,66,66,0,1,0,1,0
54160,53,34866,53,allow,199,94,105,2,29,1,1
42298,40007,10253,40007,allow,273,73,200,4,29,2,2
49715,53,2852,53,allow,734,94,640,2,30,1,1
27641,39004,0,0,deny,62,62,0,1,0,1,0
49913,443,65032,443,allow,976,589,387,10,76,6,4
47910,7454,0,0,deny,60,60,0,1,0,1,0
55300,445,0,0,drop,66,66,0,1,0,1,0
52047,42805,9664,42805,allow,164,70,94,3,7,2,1
59900,443,59900,443,allow,5980,1122,4858,18,58,9,9
51742,30317,0,0,deny,66,66,0,1,0,1,0
3068,36237,0,0,deny,62,62,0,1,0,1,0
52862,80,51424,80,allow,3150,1478,1672,32,131,17,15
63819,445,0,0,drop,70,70,0,1,0,1,0
64540,53,44077,53,allow,352,107,245,4,37,2,2
58038,80,30379,80,allow,5029,2608,2421,15,25,9,6
56090,53,62587,53,allow,195,94,101,2,30,1,1
64034,53,21913,53,allow,188,96,92,2,31,1,1
51576,443,46569,443,allow,400,70,330,6,25,1,5
62014,35440,0,0,deny,66,66,0,1,0,1,0
28237,443,25955,443,allow,7876,1540,6336,21,124,10,11
62747,445,0,0,drop,70,70,0,1,0,1,0
52024,25174,0,0,deny,66,66,0,1,0,1,0
49835,443,51050,443,allow,8754,2616,6138,34,96,19,15
63853,10659,14752,10659,allow,66,66,0,2,8,2,0
34246,53,34246,53,allow,217,87,130,2,31,1,1
58638,5900,0,0,deny,62,62,0,1,0,1,0
55283,445,0,0,drop,70,70,0,1,0,1,0
41886,53,43611,53,allow,168,78,90,2,30,1,1
2876,35440,0,0,deny,62,62,0,1,0,1,0
51813,445,0,0,drop,70,70,0,1,0,1,0
35864,44847,0,0,deny,78,78,0,1,0,1,0
56440,56205,0,0,deny,62,62,0,1,0,1,0
61090,445,0,0,drop,70,70,0,1,0,1,0
57408,53,13747,53,allow,195,102,93,2,33,1,1
65428,53,31541,53,allow,195,102,93,2,31,1,1
56548,53,18583,53,allow,199,102,97,2,30,1,1
59487,80,24242,80,allow,350,210,140,6,26,4,2
49359,53,57768,53,allow,102,102,0,1,60,1,0
56772,53,46490,53,allow,185,102,83,2,31,1,1
64482,53,15277,53,allow,196,102,94,2,30,1,1
63924,53,40615,53,allow,214,102,112,2,30,1,1
55560,53,7666,53,allow,166,86,80,2,30,1,1
49620,53,32011,53,allow,198,110,88,2,30,1,1
54804,445,0,0,drop,66,66,0,1,0,1,0
49628,35440,0,0,deny,66,66,0,1,0,1,0
55879,53,59038,53,allow,184,94,90,2,30,1,1
50005,53,15477,53,allow,199,102,97,2,30,1,1
52472,51221,0,0,deny,74,74,0,1,0,1,0
50376,53,40722,53,allow,196,102,94,2,30,1,1
49476,53,2698,53,allow,200,94,106,2,30,1,1
33543,44847,0,0,deny,62,62,0,1,0,1,0
56362,53,16824,53,allow,195,102,93,2,30,1,1
59587,25174,0,0,deny,62,62,0,1,0,1,0
64705,445,0,0,drop,66,66,0,1,0,1,0
54875,445,0,0,drop,70,70,0,1,0,1,0
36053,443,36053,443,allow,79562,17054,62508,111,109,54,57
61902,22114,0,0,deny,66,66,0,1,0,1,0
65386,445,0,0,drop,70,70,0,1,0,1,0
55656,31165,38946,31165,allow,70,70,0,1,5,1,0
57929,445,0,0,drop,66,66,0,1,0,1,0
16013,35253,0,0,deny,66,66,0,1,0,1,0
56734,443,56734,443,allow,373876,52153,321723,424,87,185,239
28122,443,63914,443,allow,7808,2487,5321,34,446,16,18
56987,53,64863,53,allow,196,102,94,2,30,1,1
1100,27540,17868,27540,allow,132,70,62,2,30,1,1
37555,16385,34137,16385,allow,130,70,60,2,30,1,1
58361,443,12659,443,allow,7297,2046,5251,22,29,13,9
56589,53,43560,53,allow,166,86,80,2,31,1,1
5222,7493,0,0,deny,66,66,0,1,0,1,0
3478,61463,0,0,deny,328,328,0,1,0,1,0
42981,44847,0,0,deny,146,146,0,1,0,1,0
49580,53,43364,53,allow,782,110,672,2,30,1,1
63582,445,0,0,drop,66,66,0,1,0,1,0
55943,53,30420,53,allow,448,184,264,6,29,3,3
61241,22114,0,0,deny,66,66,0,1,0,1,0
57433,21247,0,0,deny,66,66,0,1,0,1,0
64748,53,3750,53,allow,168,94,74,2,29,1,1
57393,48983,0,0,deny,146,146,0,1,0,1,0
63895,43729,7105,43729,allow,70,70,0,1,4,1,0
43916,21,0,0,deny,60,60,0,1,0,1,0
49671,443,7194,443,allow,1485,940,545,13,57,7,6
55364,53,26181,53,allow,168,86,82,2,31,1,1
49353,53,9997,53,allow,237,94,143,2,30,1,1
59563,30188,0,0,deny,66,66,0,1,0,1,0
51723,10622,28735,10622,allow,70,70,0,1,5,1,0
50840,57470,0,0,deny,66,66,0,1,0,1,0
36500,3142,36500,3142,allow,138,78,60,2,6,1,1
56039,445,0,0,drop,70,70,0,1,0,1,0
50556,80,38454,80,allow,378,192,186,7,26,4,3
0,0,0,0,deny,156,156,0,2,0,2,0
55462,53,19938,53,allow,214,110,104,2,29,1,1
62057,445,0,0,drop,66,66,0,1,0,1,0
59829,445,0,0,drop,70,70,0,1,0,1,0
65280,53,36660,53,allow,213,102,111,2,30,1,1
40799,443,51690,443,allow,21024,14637,6387,46,271,26,20
53101,443,37557,443,allow,8071,1789,6282,20,326,10,10
57131,35776,0,0,deny,145,145,0,1,0,1,0
49197,445,0,0,drop,70,70,0,1,0,1,0
57616,80,57616,80,allow,266789,7684,259105,234,25,54,180
62737,64147,0,0,deny,66,66,0,1,0,1,0
50405,53,20541,53,allow,200,102,98,2,29,1,1
56326,56205,0,0,deny,66,66,0,1,0,1,0
50583,53,45479,53,allow,196,102,94,2,30,1,1
64957,53,41435,53,allow,506,131,375,4,41,2,2
53298,26467,0,0,deny,62,62,0,1,0,1,0
55887,53,55333,53,allow,212,94,118,2,30,1,1
64252,53,63103,53,allow,350,94,256,2,29,1,1
38808,443,46954,443,allow,25120,1874,23246,39,171,17,22
59394,443,52019,443,allow,5993,1987,4006,17,26,9,8
30303,22530,0,0,deny,169,169,0,1,0,1,0
0,0,0,0,deny,98,98,0,1,0,1,0
60539,80,60539,80,allow,318,120,198,6,26,3,3
49367,51505,0,0,deny,62,62,0,1,0,1,0
50586,443,6357,443,allow,2756,1594,1162,20,27,11,9
58896,443,22104,443,allow,5168,700,4468,16,15,7,9
55815,445,0,0,drop,70,70,0,1,0,1,0
60045,445,0,0,drop,66,66,0,1,0,1,0
58807,445,0,0,drop,66,66,0,1,0,1,0
60520,445,0,0,drop,66,66,0,1,0,1,0
54631,44847,0,0,deny,74,74,0,1,0,1,0
24961,53,24961,53,allow,215,80,135,2,33,1,1
27005,27017,65015,27017,allow,880,126,754,2,30,1,1
21173,37965,0,0,deny,62,62,0,1,0,1,0
55674,445,0,0,drop,66,66,0,1,0,1,0
50908,445,0,0,drop,70,70,0,1,0,1,0
36930,22,36930,22,deny,293,126,167,4,0,2,2
5729,22114,0,0,deny,66,66,0,1,0,1,0
55803,53,28022,53,allow,174,89,85,3,36,2,1
60636,445,0,0,drop,66,66,0,1,0,1,0
59278,445,0,0,drop,70,70,0,1,0,1,0
37780,443,37780,443,allow,4294,695,3599,15,20,8,7
59084,445,0,0,drop,70,70,0,1,0,1,0
63667,57470,0,0,deny,145,145,0,1,0,1,0
65318,445,0,0,drop,70,70,0,1,0,1,0
65318,53,16200,53,allow,395,102,293,2,30,1,1
46295,443,11323,443,allow,9938,1398,8540,9,128,1,8
51665,443,64553,443,allow,8783,4321,4462,39,94,19,20
55803,53,62058,53,allow,179,94,85,2,30,1,1
63640,57866,0,0,deny,66,66,0,1,0,1,0
56611,53,17951,53,allow,177,94,83,2,29,1,1
55884,53,55884,53,allow,197,90,107,2,30,1,1
61504,443,15507,443,allow,16708,2331,14377,31,21,14,17
55951,53,2710,53,allow,780,104,676,2,31,1,1
17750,12550,53024,12550,allow,491,150,341,2,1200,1,1
63152,445,0,0,drop,70,70,0,1,0,1,0
58638,5900,0,0,deny,62,62,0,1,0,1,0
58806,443,62353,443,allow,10442,6793,3649,30,17,16,14
54328,445,0,0,drop,66,66,0,1,0,1,0
56552,53,34046,53,allow,195,102,93,2,30,1,1
64052,53,64052,53,allow,198,90,108,2,30,1,1
34354,443,64555,443,allow,3603,562,3041,10,15,6,4
55494,53,4891,53,allow,255,102,153,2,30,1,1
51880,51880,39901,51880,allow,582,270,312,8,32,4,4
61132,445,0,0,drop,66,66,0,1,0,1,0
51764,33432,19826,33432,allow,70,70,0,2,8,2,0
7891,25174,0,0,deny,66,66,0,1,0,1,0
57021,445,0,0,drop,70,70,0,1,0,1,0
53229,443,53229,443,allow,1402,856,546,12,34,6,6
58638,5900,0,0,deny,62,62,0,1,0,1,0
56261,53,47864,53,allow,184,94,90,2,31,1,1
45434,443,37816,443,allow,74123,16210,57913,106,57,52,54
55721,53,4903,53,allow,212,94,118,2,30,1,1
58120,25174,0,0,deny,62,62,0,1,0,1,0
53172,56013,23634,56013,allow,70,70,0,1,5,1,0
56288,53,34669,53,allow,183,94,89,2,30,1,1
36660,443,25642,443,allow,25051,3368,21683,50,313,26,24
57349,445,0,0,drop,66,66,0,1,0,1,0
60747,40010,30374,40010,allow,316,136,180,6,6,3,3
62821,445,0,0,drop,66,66,0,1,0,1,0
61932,25174,0,0,deny,66,66,0,1,0,1,0
64539,53,18826,53,allow,177,94,83,2,29,1,1
4232,50584,0,0,deny,66,66,0,1,0,1,0
64494,53,62617,53,allow,402,118,284,2,30,1,1
51852,80,36581,80,allow,182,60,122,4,29,2,2
51324,11392,0,0,deny,66,66,0,1,0,1,0
9412,7302,0,0,deny,66,66,0,1,0,1,0
51369,445,0,0,drop,66,66,0,1,0,1,0
44285,25174,0,0,deny,146,146,0,1,0,1,0
54675,445,0,0,drop,70,70,0,1,0,1,0
64032,12343,46737,12343,allow,630,508,122,9,15,7,2
64444,53,35858,53,allow,183,94,89,2,29,1,1
7060,53,45870,53,allow,197,94,103,2,30,1,1
57398,53,47898,53,allow,232,110,122,2,30,1,1
65460,53,30831,53,allow,197,102,95,2,30,1,1
58638,5900,0,0,deny,62,62,0,1,0,1,0
34530,80,15851,80,allow,1056,682,374,10,15,6,4
50712,80,10227,80,allow,708,384,324,12,195,7,5
64246,445,0,0,drop,66,66,0,1,0,1,0
64122,443,27502,443,allow,5121090,119252,5001838,5000,55,1680,3320
52174,443,52174,443,allow,55503,7279,48224,79,22,32,47
34146,51221,0,0,deny,62,62,0,1,0,1,0
12232,18593,0,0,deny,139,139,0,1,0,1,0
56854,445,0,0,drop,70,70,0,1,0,1,0
1090,26296,0,0,deny,159,159,0,1,0,1,0
52227,64147,0,0,deny,66,66,0,1,0,1,0
52512,80,4200,80,allow,10889,1117,9772,22,16,12,10
64144,445,0,0,drop,70,70,0,1,0,1,0
49576,80,6202,80,allow,174140,4942,169198,166,65,47,119
59060,50584,0,0,deny,66,66,0,1,0,1,0
42252,33303,0,0,deny,60,60,0,1,0,1,0
49708,53,64935,53,allow,178,94,84,2,30,1,1
60355,445,0,0,drop,66,66,0,1,0,1,0
53140,64128,33195,64128,allow,698,320,378,10,17,6,4
53693,26515,57249,26515,allow,70,70,0,1,4,1,0
34964,80,34964,80,allow,2889,1482,1407,10,15,6,4
58638,5900,0,0,deny,62,62,0,1,0,1,0
55690,53,21416,53,allow,183,94,89,2,29,1,1
36400,443,31590,443,allow,53365,28404,24961,565,753,302,263
45404,80,36835,80,allow,574,500,74,6,15,5,1
53592,23578,9676,23578,allow,70,70,0,1,4,1,0
56955,53,43873,53,allow,183,94,89,2,30,1,1
50275,443,24781,443,allow,708,362,346,11,18,6,5
50266,443,41683,443,allow,49981,15486,34495,269,138,136,133
53993,6881,30701,6881,allow,70,70,0,2,8,2,0
64491,53,54856,53,allow,244,94,150,2,30,1,1
64154,53,29072,53,allow,188,96,92,2,30,1,1
51424,30188,0,0,deny,66,66,0,1,0,1,0
49996,53,62453,53,allow,183,94,89,2,30,1,1
51913,443,46255,443,allow,13337,10008,3329,47,185,23,24
60822,443,12029,443,allow,7839,2697,5142,21,137,10,11
56266,53,13342,53,allow,193,102,91,2,31,1,1
55311,53,61632,53,allow,298,101,197,4,31,2,2
58386,445,0,0,drop,70,70,0,1,0,1,0
65123,53,24943,53,allow,307,110,197,2,29,1,1
14567,37965,0,0,deny,62,62,0,1,0,1,0
55311,44847,0,0,deny,62,62,0,1,0,1,0
9287,443,31377,443,allow,5539,1486,4053,21,23,11,10
14084,43890,0,0,deny,62,62,0,1,0,1,0
62728,445,0,0,drop,70,70,0,1,0,1,0
1091,37965,0,0,deny,62,62,0,1,0,1,0
52575,22114,0,0,deny,62,62,0,1,0,1,0
32996,443,27619,443,allow,160,69,91,2,120,1,1
22350,25174,0,0,deny,62,62,0,1,0,1,0
31384,56205,0,0,deny,62,62,0,1,0,1,0
80,61486,0,0,deny,66,66,0,1,0,1,0
65405,445,0,0,drop,70,70,0,1,0,1,0
50199,443,58943,443,allow,8641,2459,6182,22,16,12,10
51245,443,54725,443,allow,9847,4746,5101,43,16,24,19
55404,443,49426,443,allow,70,70,0,1,5,1,0
56125,53,57582,53,allow,168,86,82,2,30,1,1
64714,53,5629,53,allow,250,86,164,4,36,2,2
42228,51050,0,0,deny,66,66,0,1,0,1,0
58476,443,24063,443,allow,25370,5607,19763,40,138,18,22
53153,17639,25846,17639,allow,698,320,378,10,18,6,4
53220,80,25607,80,allow,17976,840,17136,21,16,6,15
63895,44847,0,0,deny,62,62,0,1,0,1,0
43611,1879,0,0,deny,145,145,0,1,0,1,0
57384,443,63051,443,allow,546,280,266,9,28,5,4
26085,51221,0,0,deny,72,72,0,1,0,1,0
25360,51505,0,0,deny,66,66,0,1,0,1,0
19096,64147,0,0,deny,62,62,0,1,0,1,0
58638,5900,0,0,deny,62,62,0,1,0,1,0
50532,443,27098,443,allow,7416,1777,5639,23,74,12,11
40202,5222,32011,5222,allow,5958,2420,3538,40,25,20,20
50391,80,6997,80,allow,300,180,120,6,26,4,2
60407,443,49458,443,allow,8328,1611,6717,25,121,14,11
56672,53,28150,53,allow,199,102,97,2,30,1,1
56033,53,58148,53,allow,213,102,111,2,31,1,1
57470,54154,42196,54154,allow,480,149,331,2,1200,1,1
49447,443,42024,443,allow,790501,27378,763123,858,86,322,536
39380,46783,0,0,deny,146,146,0,1,0,1,0
58638,5900,0,0,deny,62,62,0,1,0,1,0
53585,445,0,0,drop,66,66,0,1,0,1,0
55312,64147,0,0,deny,62,62,0,1,0,1,0
64942,53,20482,53,allow,215,94,121,2,30,1,1
55080,80,25795,80,allow,2305712,80795,2224917,2771,52,1293,1478
28795,37965,0,0,deny,62,62,0,1,0,1,0
56468,80,52689,80,allow,214,140,74,4,26,3,1
51836,443,36494,443,allow,4927,986,3941,21,31,12,9
59833,53,25424,53,allow,195,94,101,2,30,1,1
50250,53,63565,53,allow,178,94,84,2,31,1,1
58906,445,0,0,drop,70,70,0,1,0,1,0
52062,60388,61139,60388,allow,70,70,0,2,8,2,0
63995,53,52864,53,allow,212,94,118,2,30,1,1
51976,443,51253,443,allow,14912,9611,5301,36,57,21,15
59343,53,0,0,allow,627,72,555,2,30,1,1
20864,51221,0,0,deny,62,62,0,1,0,1,0
49797,53,51758,53,allow,718,94,624,2,30,1,1
46734,53,39721,53,allow,168,78,90,2,30,1,1
63588,445,0,0,drop,66,66,0,1,0,1,0
49826,53,41958,53,allow,279,95,184,4,59,2,2
51449,443,58007,443,allow,9602,3315,6287,25,37,15,10
51985,80,53937,80,allow,14233438,253696,13979742,12752,54,3515,9237
50608,445,0,0,drop,66,66,0,1,0,1,0
53930,443,55523,443,allow,33489,2768,30721,44,121,17,27
27005,27016,18981,27016,allow,884,126,758,2,30,1,1
55362,53,23060,53,allow,374,97,277,4,32,2,2
56869,17637,0,0,deny,66,66,0,1,0,1,0
56332,443,3765,443,allow,6028,1958,4070,34,124,14,20
59486,445,0,0,drop,66,66,0,1,0,1,0
53182,443,48630,443,allow,6094,1073,5021,19,15,10,9
60487,1134,43276,1134,allow,70,70,0,2,8,2,0
58646,445,0,0,drop,70,70,0,1,0,1,0
39716,53,15462,53,allow,86,86,0,1,30,1,0
46275,64147,0,0,deny,62,62,0,1,0,1,0
54310,80,7871,80,allow,552,280,272,9,30,5,4
42252,33306,0,0,deny,60,60,0,1,0,1,0
49899,443,6307,443,allow,1820,1101,719,18,72,10,8
54545,49344,0,0,deny,66,66,0,1,0,1,0
65436,53,49533,53,allow,286,90,196,4,55,2,2
57503,445,0,0,drop,66,66,0,1,0,1,0
51164,443,28609,443,allow,5040,2743,2297,34,185,18,16
55538,53,15605,53,allow,168,86,82,2,30,1,1
50826,443,44270,443,allow,820870,30523,790347,918,218,337,581
55924,80,55924,80,allow,450,246,204,8,28,5,3
56186,53,1999,53,allow,196,100,96,2,31,1,1
56436,445,0,0,drop,66,66,0,1,0,1,0
55699,21063,52402,21063,allow,70,70,0,1,5,1,0
5588,5588,0,0,allow,3354,1792,1562,46,195,23,23
60777,445,0,0,drop,66,66,0,1,0,1,0
38135,443,62915,443,allow,2568507,98538,2469969,2956,65,1228,1728
52470,443,33189,443,allow,7915,1213,6702,23,50,12,11
27005,32066,15067,32066,allow,881,126,755,2,31,1,1
60766,445,0,0,drop,70,70,0,1,0,1,0
53233,51221,0,0,deny,66,66,0,1,0,1,0
57442,66,49848,66,allow,70,70,0,2,8,2,0
55232,443,11743,443,allow,9619,2504,7115,28,46,15,13
48706,23393,0,0,deny,60,60,0,1,0,1,0
1024,37450,0,0,deny,62,62,0,1,0,1,0
56964,53,57920,53,allow,179,94,85,2,30,1,1
60126,445,0,0,drop,70,70,0,1,0,1,0
54955,7302,0,0,deny,62,62,0,1,0,1,0
51217,443,21771,443,allow,126,60,66,3,5,2,1
49246,53,17908,53,allow,177,94,83,2,30,1,1
1972,57470,0,0,deny,78,78,0,1,0,1,0
56388,53,30178,53,allow,165,86,79,2,30,1,1
59724,53,63001,53,allow,304,86,218,2,30,1,1
49471,80,33120,80,allow,10175,1359,8816,18,78,7,11
52061,35717,8703,35717,allow,70,70,0,2,8,2,0
65147,445,0,0,drop,66,66,0,1,0,1,0
57781,445,0,0,drop,70,70,0,1,0,1,0
49506,53,26702,53,allow,200,102,98,2,31,1,1
52152,80,10469,80,allow,366,240,126,7,32,5,2
9494,23,0,0,deny,60,60,0,1,0,1,0
3074,64147,0,0,deny,62,62,0,1,0,1,0
64758,53,44548,53,allow,311,102,209,2,30,1,1
49158,443,27828,443,allow,14490,4227,10263,35,36,19,16
63744,47106,28036,47106,allow,70,70,0,1,4,1,0
56391,53,63935,53,allow,758,93,665,2,31,1,1
29126,7000,29126,7000,allow,4124,2423,1701,20,16,11,9
7916,23,0,0,deny,60,60,0,1,0,1,0
60163,26467,0,0,deny,66,66,0,1,0,1,0
50652,445,0,0,drop,66,66,0,1,0,1,0
62068,64147,0,0,deny,66,66,0,1,0,1,0
60700,445,0,0,drop,70,70,0,1,0,1,0
38905,53,58412,53,allow,86,86,0,1,30,1,0
35657,48637,0,0,deny,62,62,0,1,0,1,0
55700,53,12317,53,allow,337,110,227,2,30,1,1
53738,25760,39657,25760,allow,2031,1019,1012,11,16,6,5
54959,53,14757,53,allow,211,110,101,2,30,1,1
56144,53,34369,53,allow,177,94,83,2,30,1,1
58638,5900,0,0,deny,62,62,0,1,0,1,0
52218,445,0,0,drop,70,70,0,1,0,1,0
49835,53,10267,53,allow,199,94,105,2,31,1,1
55817,36829,0,0,deny,66,66,0,1,0,1,0
54150,443,60800,443,allow,230997,10675,220322,291,75,122,169
40620,443,2727,443,allow,7049,1412,5637,24,16,14,10
49867,53,28958,53,allow,232,110,122,2,30,1,1
54314,445,0,0,drop,66,66,0,1,0,1,0
65187,53,35953,53,allow,199,102,97,2,29,1,1
36483,80,36483,80,allow,1015966,37923,978043,1167,205,468,699
49910,443,39120,443,allow,4712,908,3804,18,75,9,9
42804,80,7713,80,allow,1115,534,581,12,15,7,5
46640,8880,0,0,deny,60,60,0,1,0,1,0
49701,53,61542,53,allow,197,102,95,2,30,1,1
58910,445,0,0,drop,70,70,0,1,0,1,0
53214,443,52186,443,allow,526,156,370,8,14,3,5
30729,22114,0,0,deny,66,66,0,1,0,1,0
49164,25174,0,0,deny,62,62,0,1,0,1,0
42119,443,42119,443,allow,9299,1697,7602,21,146,12,9
59459,37807,0,0,deny,66,66,0,1,0,1,0
64420,53,18764,53,allow,386,102,284,2,30,1,1
55509,53,37936,53,allow,215,102,113,2,30,1,1
55421,53,33025,53,allow,200,102,98,2,29,1,1
58638,5900,0,0,deny,62,62,0,1,0,1,0
63930,443,21272,443,allow,2940,669,2271,13,122,6,7
44063,443,1759,443,allow,7762,2601,5161,18,137,8,10
47814,51505,0,0,deny,66,66,0,1,0,1,0
53680,443,32656,443,allow,7035,2364,4671,18,75,10,8
45754,80,23823,80,allow,47137,10210,36927,80,477,38,42
21187,53,21187,53,allow,208,94,114,2,30,1,1
49862,445,0,0,drop,66,66,0,1,0,1,0
64677,53,11788,53,allow,334,93,241,4,50,2,2
11228,25174,0,0,deny,66,66,0,1,0,1,0
55154,53,45659,53,allow,184,94,90,2,30,1,1
37992,49152,18454,49152,allow,156,156,0,3,7,3,0
56285,53,7225,53,allow,751,95,656,2,31,1,1
2636,7302,0,0,deny,66,66,0,1,0,1,0
61109,445,0,0,drop,70,70,0,1,0,1,0
60795,40010,57308,40010,allow,316,136,180,6,6,3,3
65225,443,9124,443,allow,3350,2037,1313,25,95,14,11
60409,80,41783,80,allow,10970,7709,3261,24,29,13,11
56425,445,0,0,drop,70,70,0,1,0,1,0
60526,443,60526,443,allow,1462,863,599,15,37,9,6
57794,53,57794,53,allow,825,99,726,2,30,1,1
64651,53,19265,53,allow,196,94,102,2,30,1,1
41625,15000,38798,15000,allow,130,70,60,2,5,1,1
53737,445,0,0,drop,66,66,0,1,0,1,0
60203,53,37285,53,allow,328,86,242,2,30,1,1
64205,53,47320,53,allow,178,94,84,2,31,1,1
36236,443,36236,443,allow,4625,1718,2907,19,31,11,8
34209,80,4661,80,allow,1280,586,694,10,14,5,5
55346,445,0,0,drop,66,66,0,1,0,1,0
63765,51221,0,0,deny,62,62,0,1,0,1,0
54078,445,0,0,drop,70,70,0,1,0,1,0
58835,443,12321,443,allow,9823,2600,7223,46,195,23,23
55963,445,0,0,drop,66,66,0,1,0,1,0
26085,51221,0,0,deny,72,72,0,1,0,1,0
52148,29104,16660,29104,allow,70,70,0,1,5,1,0
57470,33159,38691,33159,allow,594,594,0,10,1199,10,0
55724,45682,40719,45682,allow,70,70,0,2,8,2,0
50624,80,47844,80,allow,12701,9788,2913,29,52,16,13
5357,32468,0,0,deny,62,62,0,1,0,1,0
63710,445,0,0,drop,70,70,0,1,0,1,0
31745,2323,0,0,deny,60,60,0,1,0,1,0
49324,64147,0,0,deny,66,66,0,1,0,1,0
58638,5900,0,0,deny,62,62,0,1,0,1,0
56600,445,0,0,drop,70,70,0,1,0,1,0
46856,25174,0,0,deny,62,62,0,1,0,1,0
49547,53,33121,53,allow,193,102,91,2,29,1,1
58638,5900,58638,5900,allow,62,62,0,1,5,1,0
52062,80,7748,80,allow,366,240,126,7,26,5,2
55748,445,0,0,drop,70,70,0,1,0,1,0
55540,53,5728,53,allow,757,98,659,2,31,1,1
50054,445,0,0,drop,70,70,0,1,0,1,0
50145,445,0,0,drop,70,70,0,1,0,1,0
49584,445,0,0,drop,70,70,0,1,0,1,0
63901,445,0,0,drop,66,66,0,1,0,1,0
54943,445,0,0,drop,70,70,0,1,0,1,0
51125,445,0,0,drop,66,66,0,1,0,1,0
47213,443,42653,443,allow,8166,2498,5668,16,120,8,8
18113,22114,0,0,deny,62,62,0,1,0,1,0
42568,443,34410,443,allow,8049,2043,6006,23,360,11,12
60879,445,0,0,drop,66,66,0,1,0,1,0
54104,445,0,0,drop,70,70,0,1,0,1,0
64532,445,0,0,drop,66,66,0,1,0,1,0
55511,445,0,0,drop,70,70,0,1,0,1,0
53760,45682,20604,45682,allow,70,70,0,1,4,1,0
57470,45340,41159,45340,allow,527,166,361,2,1200,1,1
59996,443,60855,443,allow,1641,730,911,14,18,8,6
64241,445,0,0,drop,70,70,0,1,0,1,0
50246,445,0,0,drop,70,70,0,1,0,1,0
55246,445,0,0,drop,66,66,0,1,0,1,0
50457,443,62733,443,allow,3091,1708,1383,15,21,9,6
51852,445,0,0,drop,70,70,0,1,0,1,0
49300,443,63188,443,allow,6101,848,5253,17,21,9,8
49393,30188,0,0,deny,62,62,0,1,0,1,0
65279,53,28048,53,allow,183,94,89,2,31,1,1
10036,80,8198,80,allow,2058,589,1469,10,46,6,4
53373,443,1651,443,allow,8557,1755,6802,28,35,14,14
53202,445,0,0,drop,70,70,0,1,0,1,0
55380,53,60904,53,allow,289,97,192,4,45,2,2
42252,33306,0,0,deny,60,60,0,1,0,1,0
33893,80,46490,80,allow,1376,788,588,10,23,6,4
46409,80,19897,80,allow,4674,767,3907,17,15,9,8
64878,53,35842,53,allow,511,92,419,4,45,2,2
40151,443,46330,443,allow,80789,5008,75781,92,128,33,59
51121,443,8150,443,allow,5553,2844,2709,21,30,11,10
59435,37807,0,0,deny,66,66,0,1,0,1,0
64428,445,0,0,drop,70,70,0,1,0,1,0
2864,25174,0,0,deny,66,66,0,1,0,1,0
58638,5900,0,0,deny,62,62,0,1,0,1,0
57143,445,0,0,drop,66,66,0,1,0,1,0
19697,26296,0,0,deny,159,159,0,1,0,1,0
27005,27018,46285,27018,allow,895,126,769,2,30,1,1
50268,443,33459,443,allow,35251,25181,10070,121,123,63,58
46751,53,46751,53,allow,220,90,130,2,30,1,1
6882,46440,39998,46440,allow,324,150,174,2,1200,1,1
49787,53,35169,53,allow,193,102,91,2,30,1,1
11988,48817,0,0,deny,66,66,0,1,0,1,0
59352,53,59352,53,allow,283,114,169,2,31,1,1
40125,443,1221,443,allow,7000,1799,5201,20,256,12,8
48978,25174,0,0,deny,62,62,0,1,0,1,0
57436,53,11754,53,allow,728,102,626,2,29,1,1
17226,35440,0,0,deny,62,62,0,1,0,1,0
55199,53,60419,53,allow,223,78,145,2,30,1,1
51691,445,0,0,drop,70,70,0,1,0,1,0
46556,443,5923,443,allow,9316,1720,7596,25,16,13,12
35141,53,35141,53,allow,288,83,205,2,31,1,1
63583,37965,0,0,deny,66,66,0,1,0,1,0
42298,40019,18664,40019,allow,597,79,518,2,31,1,1
57691,445,0,0,drop,70,70,0,1,0,1,0
63878,50829,35363,50829,allow,70,70,0,1,5,1,0
58832,445,0,0,drop,70,70,0,1,0,1,0
50584,80,65205,80,allow,1883,995,888,11,47,6,5
61804,51505,0,0,deny,66,66,0,1,0,1,0
58429,53,0,0,allow,1254,160,1094,4,49,2,2
59782,26467,0,0,deny,62,62,0,1,0,1,0
38683,17,0,0,deny,60,60,0,1,0,1,0
58737,443,61229,443,allow,16417,13221,3196,50,74,31,19
53353,26467,0,0,deny,62,62,0,1,0,1,0
56788,53,30869,53,allow,199,102,97,2,30,1,1
16387,51369,0,0,deny,60,60,0,1,0,1,0
33814,443,5866,443,allow,8601,2870,5731,40,225,22,18
65437,53,50016,53,allow,190,97,93,2,30,1,1
53256,443,59014,443,allow,29039,3057,25982,46,323,19,27
18204,55160,0,0,deny,146,146,0,1,0,1,0
64612,53,64612,53,allow,213,87,126,2,30,1,1
27691,53,27691,53,allow,235,90,145,2,32,1,1
45941,23388,0,0,deny,60,60,0,1,0,1,0
64680,53,32256,53,allow,768,99,669,2,30,1,1
5405,53,5405,53,allow,645,90,555,2,30,1,1
51325,443,32371,443,allow,2959,793,2166,10,120,5,5
50774,443,8773,443,allow,6074,4349,1725,22,361,11,11
53111,80,26592,80,allow,45904,3904,42000,65,16,33,32
60934,445,0,0,drop,66,66,0,1,0,1,0
56818,60043,0,0,deny,66,66,0,1,0,1,0
49912,53,4964,53,allow,733,94,639,2,29,1,1
56006,53,14148,53,allow,200,102,98,2,30,1,1
55498,53,62567,53,allow,177,94,83,2,30,1,1
56782,49135,53247,49135,allow,70,70,0,1,5,1,0
48575,123,43562,123,allow,184,94,90,2,30,1,1
64958,53,33266,53,allow,395,102,293,2,30,1,1
59488,443,37367,443,allow,6100,580,5520,17,53,5,12
53415,445,0,0,drop,66,66,0,1,0,1,0
7275,9524,0,0,deny,66,66,0,1,0,1,0
50265,49893,64996,49893,allow,480,149,331,2,1200,1,1
34527,443,29221,443,allow,480624,56231,424393,860,196,427,433
62757,123,11526,123,allow,184,94,90,2,30,1,1
59651,445,0,0,drop,70,70,0,1,0,1,0
65484,53,10578,53,allow,195,86,109,2,30,1,1
51640,80,25604,80,allow,2895,1428,1467,12,38,7,5
65229,53,45181,53,allow,195,102,93,2,31,1,1
64237,51505,0,0,deny,66,66,0,1,0,1,0
53343,445,0,0,drop,70,70,0,1,0,1,0
64483,53,37576,53,allow,300,90,210,4,30,2,2
43817,53,43817,53,allow,203,82,121,2,30,1,1
52732,445,0,0,drop,66,66,0,1,0,1,0
49591,53,7823,53,allow,402,118,284,2,30,1,1
35180,443,55162,443,allow,13838,1370,12468,26,34,13,13
35120,26467,0,0,deny,62,62,0,1,0,1,0
55564,80,32717,80,allow,944,529,415,11,315,6,5
52683,445,0,0,drop,66,66,0,1,0,1,0
38733,443,51557,443,allow,7655,2018,5637,31,93,16,15
57410,37965,0,0,deny,66,66,0,1,0,1,0
59890,443,21509,443,allow,9801,2337,7464,25,47,13,12
50679,443,24042,443,allow,14172,2714,11458,32,637,13,19
54779,445,0,0,drop,66,66,0,1,0,1,0
53687,445,0,0,drop,70,70,0,1,0,1,0
50681,445,0,0,drop,70,70,0,1,0,1,0
57799,445,0,0,drop,66,66,0,1,0,1,0
57323,443,4968,443,allow,5613,733,4880,16,14,9,7
8380,80,8380,80,allow,25613,1592,24021,32,22,9,23
50318,53,63172,53,allow,732,89,643,2,30,1,1
37462,53,30454,53,allow,207,86,121,2,30,1,1
18771,35440,0,0,deny,62,62,0,1,0,1,0
50522,443,6531,443,allow,1579,988,591,13,45,7,6
1162,57470,0,0,deny,62,62,0,1,0,1,0
57589,53,7858,53,allow,165,78,87,2,30,1,1
62766,445,0,0,drop,70,70,0,1,0,1,0
61041,53,61041,53,allow,214,90,124,2,29,1,1
58509,443,26840,443,allow,13973721,436876,13536845,14039,1629,4929,9110
30598,46824,0,0,deny,62,62,0,1,0,1,0
1725,80,3568,80,allow,254,128,126,5,16,3,2
14397,37965,0,0,deny,62,62,0,1,0,1,0
53832,53,28034,53,allow,211,78,133,2,29,1,1
61918,445,0,0,drop,66,66,0,1,0,1,0
57470,18560,34437,18560,allow,150,150,0,1,1199,1,0
49229,53,43907,53,allow,178,94,84,2,30,1,1
64885,53,4392,53,allow,166,86,80,2,29,1,1
57033,53,60387,53,allow,754,94,660,2,31,1,1
6889,47807,0,0,deny,143,143,0,1,0,1,0
50533,445,0,0,drop,66,66,0,1,0,1,0
56023,445,0,0,drop,70,70,0,1,0,1,0
55127,53,39994,53,allow,253,87,166,4,43,2,2
55457,53,65037,53,allow,372,126,246,2,29,1,1
65366,53,11375,53,allow,199,102,97,2,30,1,1
58851,443,28195,443,allow,344,130,214,6,77,3,3
59658,445,0,0,drop,66,66,0,1,0,1,0
52123,1433,0,0,deny,60,60,0,1,0,1,0
50972,80,5146,80,allow,1095399,7129,1088270,832,37,106,726
63956,38211,0,0,deny,62,62,0,1,0,1,0
43111,443,29874,443,allow,3117,1867,1250,19,15,9,10
57311,53,54078,53,allow,211,102,109,2,30,1,1
16382,17500,0,0,deny,62,62,0,1,0,1,0
52743,15503,0,0,deny,66,66,0,1,0,1,0
50102,53,50102,53,allow,216,90,126,2,29,1,1
3875,25174,0,0,deny,62,62,0,1,0,1,0
58638,5900,0,0,deny,62,62,0,1,0,1,0
53556,1024,47936,1024,allow,70,70,0,1,4,1,0
25187,31573,0,0,deny,62,62,0,1,0,1,0
63925,37965,0,0,deny,66,66,0,1,0,1,0
43104,26467,0,0,deny,62,62,0,1,0,1,0
52252,46314,0,0,deny,62,62,0,1,0,1,0
27005,27016,17194,27016,allow,878,126,752,2,30,1,1
52199,35549,6211,35549,allow,70,70,0,1,5,1,0
37707,53,28750,53,allow,168,78,90,2,30,1,1
56624,53,20436,53,allow,819,102,717,2,30,1,1
61563,37807,0,0,deny,66,66,0,1,0,1,0
51871,23801,64442,23801,allow,316,136,180,6,6,3,3
51991,445,0,0,drop,70,70,0,1,0,1,0
59436,22114,0,0,deny,62,62,0,1,0,1,0
65475,443,62261,443,allow,429726,12570,417156,440,16,154,286
44847,51572,8318,51572,allow,509,150,359,2,1200,1,1
48303,53,44805,53,allow,198,93,105,2,31,1,1
56390,445,0,0,drop,70,70,0,1,0,1,0
64144,53,27291,53,allow,193,102,91,2,31,1,1
50296,53,43204,53,allow,183,94,89,2,29,1,1
64615,53,10268,53,allow,195,102,93,2,30,1,1
37837,37965,0,0,deny,62,62,0,1,0,1,0
53249,443,22744,443,allow,12082,5745,6337,32,61,16,16
14409,7363,0,0,deny,145,145,0,1,0,1,0
57354,53,4539,53,allow,177,94,83,2,30,1,1
49820,53,40891,53,allow,211,102,109,2,30,1,1
52172,7353,52329,7353,allow,70,70,0,2,7,2,0
61788,20000,0,0,deny,60,60,0,1,0,1,0
59851,445,0,0,drop,66,66,0,1,0,1,0
36209,443,44738,443,allow,656609,25419,631190,752,62,322,430
51095,445,0,0,drop,66,66,0,1,0,1,0
49521,53,40316,53,allow,183,94,89,2,30,1,1
36291,53,42350,53,allow,199,94,105,2,31,1,1
53999,445,0,0,drop,70,70,0,1,0,1,0
64017,53,64345,53,allow,325,103,222,4,45,2,2
53503,445,0,0,drop,70,70,0,1,0,1,0
39064,443,7055,443,allow,11356,4341,7015,33,128,16,17
58638,5900,0,0,deny,62,62,0,1,0,1,0
63127,445,0,0,drop,66,66,0,1,0,1,0
50460,443,12819,443,allow,1346,918,428,10,31,6,4
44847,31105,50353,31105,allow,324,150,174,2,1200,1,1
55369,53,62193,53,allow,376,94,282,2,30,1,1
64677,53,13173,53,allow,195,102,93,2,31,1,1
52992,443,3497,443,allow,97763,8230,89533,131,150,49,82
25497,44847,0,0,deny,62,62,0,1,0,1,0
59849,443,38799,443,allow,8368,1360,7008,19,18,7,12
55072,445,0,0,drop,70,70,0,1,0,1,0
64940,445,0,0,drop,66,66,0,1,0,1,0
55161,37807,0,0,deny,66,66,0,1,0,1,0
60423,443,61729,443,allow,6849,1103,5746,23,120,12,11
45424,23,0,0,deny,60,60,0,1,0,1,0
60445,20555,38160,20555,allow,70,70,0,1,5,1,0
54316,445,0,0,drop,70,70,0,1,0,1,0
55879,53,24811,53,allow,749,94,655,2,30,1,1
50530,445,0,0,drop,66,66,0,1,0,1,0
60281,80,39760,80,allow,1151,711,440,10,16,5,5
51948,37965,0,0,deny,62,62,0,1,0,1,0
51741,48440,47763,48440,allow,136,136,0,3,14,3,0
59794,443,46382,443,allow,408,78,330,6,25,1,5
49672,53,36807,53,allow,718,94,624,2,30,1,1
51685,57470,0,0,deny,62,62,0,1,0,1,0
58246,445,0,0,drop,70,70,0,1,0,1,0
59225,57587,0,0,deny,66,66,0,1,0,1,0
56067,53,20488,53,allow,189,102,87,2,30,1,1
60248,46776,0,0,deny,66,66,0,1,0,1,0
9340,443,64311,443,allow,3835,501,3334,14,15,7,7
58263,5223,22492,5223,allow,3721,1173,2548,18,20,11,7
60811,443,53507,443,allow,740,222,518,11,3631,4,7
50803,445,0,0,drop,70,70,0,1,0,1,0
63532,445,0,0,drop,70,70,0,1,0,1,0
61273,443,55960,443,allow,19675,8597,11078,137,480,68,69
2681,48817,0,0,deny,146,146,0,1,0,1,0
64146,53,50563,53,allow,308,99,209,4,39,2,2
41168,443,17875,443,allow,8949,1938,7011,21,17,12,9
50998,443,19722,443,allow,3482,1985,1497,21,17,10,11
55075,53,41245,53,allow,181,94,87,2,33,1,1
52498,445,0,0,drop,66,66,0,1,0,1,0
40985,443,29028,443,allow,3166,2097,1069,24,46,12,12
2402,7000,2402,7000,allow,1236,676,560,13,22,7,6
7844,22114,0,0,deny,66,66,0,1,0,1,0
61363,445,0,0,drop,66,66,0,1,0,1,0
56850,64932,41419,64932,allow,70,70,0,1,5,1,0
55979,445,0,0,drop,70,70,0,1,0,1,0
64316,53,5577,53,allow,184,94,90,2,30,1,1
18725,35440,0,0,deny,62,62,0,1,0,1,0
38476,161,0,0,allow,3304,1560,1744,18,30,9,9
38119,443,46487,443,allow,1820,1101,719,18,16,10,8
60284,80,50056,80,allow,1430,754,676,11,146,6,5
30598,37965,0,0,deny,62,62,0,1,0,1,0
51413,10387,0,0,deny,139,139,0,1,0,1,0
13864,30718,0,0,deny,60,60,0,1,0,1,0
65317,51221,0,0,deny,78,78,0,1,0,1,0
51581,22114,0,0,deny,66,66,0,1,0,1,0
54353,443,50678,443,allow,9976,3230,6746,22,56,13,9
49637,445,0,0,drop,66,66,0,1,0,1,0
53609,445,0,0,drop,70,70,0,1,0,1,0
52951,445,0,0,drop,70,70,0,1,0,1,0
55699,443,1921,443,allow,4170,1901,2269,14,120,7,7
56756,53,60834,53,allow,167,86,81,2,30,1,1
55658,445,0,0,drop,66,66,0,1,0,1,0
50470,80,36047,80,allow,8593,2011,6582,17,23,8,9
60022,443,9132,443,allow,6906,1458,5448,24,16,14,10
49270,80,7008,80,allow,254,128,126,5,15,3,2
55846,53,27827,53,allow,198,102,96,2,30,1,1
45783,22114,0,0,deny,62,62,0,1,0,1,0
60029,445,0,0,drop,66,66,0,1,0,1,0
55808,53,26919,53,allow,179,94,85,2,30,1,1
50977,56205,0,0,deny,66,66,0,1,0,1,0
58638,5900,0,0,deny,62,62,0,1,0,1,0
12457,57866,0,0,deny,62,62,0,1,0,1,0
51414,445,0,0,drop,70,70,0,1,0,1,0
57132,53,11896,53,allow,216,110,106,2,31,1,1
51931,443,20564,443,allow,2328,1677,651,17,23,9,8
64776,80,31533,80,allow,4502,1072,3430,15,98,7,8
46334,443,50617,443,allow,9759,2304,7455,28,138,14,14
56102,443,1329,443,allow,8577,3450,5127,23,30,13,10
18517,31652,0,0,reset-both,62,62,0,1,0,1,0
52427,445,0,0,drop,66,66,0,1,0,1,0
51667,25826,2987,25826,allow,9440,9440,0,11,30,11,0
1025,64147,0,0,deny,62,62,0,1,0,1,0
61550,445,0,0,drop,70,70,0,1,0,1,0
49418,49000,14471,49000,allow,270,78,192,2,30,1,1
57553,443,21487,443,allow,7075,2575,4500,21,30,12,9
49528,443,34727,443,allow,5968,985,4983,17,28,8,9
57240,53,32655,53,allow,180,94,86,2,29,1,1
55974,80,55609,80,allow,613,539,74,7,15,6,1
37390,80,53231,80,allow,78,78,0,1,5,1,0
49976,5900,0,0,deny,60,60,0,1,0,1,0
52831,445,0,0,drop,70,70,0,1,0,1,0
49700,445,0,0,drop,70,70,0,1,0,1,0
59587,25174,0,0,deny,146,146,0,1,0,1,0
53602,12395,26422,12395,allow,70,70,0,2,7,2,0
62825,445,0,0,drop,70,70,0,1,0,1,0
58638,5900,0,0,deny,62,62,0,1,0,1,0
61367,445,0,0,drop,70,70,0,1,0,1,0
60418,39537,32602,39537,allow,70,70,0,2,8,2,0
53693,26515,52761,26515,allow,70,70,0,2,7,2,0
64469,445,0,0,drop,70,70,0,1,0,1,0
33270,80,23251,80,allow,1614,1300,314,10,15,5,5
48713,80,47813,80,allow,1767,751,1016,10,15,6,4
61413,443,10754,443,allow,4933,771,4162,18,28,8,10
50041,443,57357,443,allow,1097,654,443,12,86,7,5
55631,443,48681,443,allow,17521,3850,13671,30,121,13,17
55220,53,9691,53,allow,186,95,91,2,31,1,1
10319,42707,0,0,deny,62,62,0,1,0,1,0
57074,53,2955,53,allow,195,102,93,2,30,1,1
52332,445,0,0,drop,70,70,0,1,0,1,0
57420,445,0,0,drop,70,70,0,1,0,1,0
55168,53,23617,53,allow,816,97,719,2,31,1,1
38634,443,59310,443,allow,9741,4687,5054,36,165,21,15
53433,445,0,0,drop,66,66,0,1,0,1,0
57094,53,61596,53,allow,196,102,94,2,30,1,1
54761,443,53919,443,allow,103367,3730,99637,117,170,42,75
60849,80,64699,80,allow,9729,876,8853,21,45,11,10
55720,53,40889,53,allow,774,101,673,2,31,1,1
50465,445,0,0,drop,66,66,0,1,0,1,0
60988,443,42425,443,allow,8019,3298,4721,30,40,17,13
52711,37965,0,0,deny,62,62,0,1,0,1,0
55105,53,18912,53,allow,747,93,654,2,31,1,1
30179,57470,0,0,deny,60,60,0,1,0,1,0
57114,35440,0,0,deny,62,62,0,1,0,1,0
5686,80,5686,80,allow,326,186,140,6,29,4,2
64721,53,29674,53,allow,214,110,104,2,30,1,1
59255,445,0,0,drop,70,70,0,1,0,1,0
55806,80,55806,80,allow,424,198,226,7,142,4,3
57292,53,58837,53,allow,395,102,293,2,30,1,1
50007,80,25590,80,allow,2089,1161,928,10,86,6,4
15503,11731,3627,11731,allow,1188,1188,0,19,2298,19,0
53519,64147,0,0,deny,66,66,0,1,0,1,0
55786,53,65115,53,allow,186,95,91,2,31,1,1
59478,443,44670,443,allow,9310,2994,6316,25,122,11,14
62599,445,0,0,drop,70,70,0,1,0,1,0
48737,443,47925,443,allow,5220,2290,2930,15,121,7,8
58922,57470,0,0,deny,66,66,0,1,0,1,0
52896,80,13613,80,allow,3020,1414,1606,30,118,16,14
42252,33303,0,0,deny,60,60,0,1,0,1,0
65474,53,42125,53,allow,197,94,103,2,29,1,1
45941,23386,0,0,deny,60,60,0,1,0,1,0
56994,80,47420,80,allow,214,140,74,4,35,3,1
52083,26607,11051,26607,allow,70,70,0,2,7,2,0
59874,22114,0,0,deny,66,66,0,1,0,1,0
64034,445,0,0,drop,70,70,0,1,0,1,0
53933,20801,58007,20801,allow,70,70,0,2,7,2,0
55718,27025,19303,27025,allow,1778,1386,392,8,30,4,4
54438,62413,0,0,deny,66,66,0,1,0,1,0
65063,53,62698,53,allow,176,90,86,2,31,1,1
56988,53,25747,53,allow,216,110,106,2,30,1,1
27005,27015,25382,27015,allow,937,126,811,2,30,1,1
49378,445,0,0,drop,66,66,0,1,0,1,0
49485,7080,49485,7080,allow,2960,432,2528,11,15,6,5
52827,445,0,0,drop,70,70,0,1,0,1,0
61509,445,0,0,drop,70,70,0,1,0,1,0
50709,445,0,0,drop,70,70,0,1,0,1,0
40547,24051,0,0,deny,74,74,0,1,0,1,0
52802,443,30052,443,allow,4202,1924,2278,27,80,13,14
56896,445,0,0,drop,66,66,0,1,0,1,0
57862,445,0,0,drop,70,70,0,1,0,1,0
11491,53,11491,53,allow,247,98,149,2,32,1,1
64572,53,23687,53,allow,561,104,457,4,57,2,2
55555,445,0,0,drop,70,70,0,1,0,1,0
21459,23,0,0,deny,60,60,0,1,0,1,0
54839,445,0,0,drop,70,70,0,1,0,1,0
63228,445,0,0,drop,70,70,0,1,0,1,0
12841,37965,0,0,deny,62,62,0,1,0,1,0
51800,63796,15243,63796,allow,70,70,0,1,5,1,0
60791,443,31785,443,allow,15013,10159,4854,34,46,19,15
64306,64147,0,0,deny,66,66,0,1,0,1,0
50732,445,0,0,drop,66,66,0,1,0,1,0
49638,443,58989,443,allow,5776,1079,4697,15,52,8,7
55972,53,36064,53,allow,193,102,91,2,30,1,1
4782,443,2792,443,allow,1191,692,499,12,39,7,5
53018,443,37160,443,allow,6352,1552,4800,23,17,12,11
51966,80,49895,80,allow,366,240,126,7,25,5,2
51421,445,0,0,drop,70,70,0,1,0,1,0
53020,80,53020,80,allow,134273,4066,130207,163,22,59,104
44794,443,36304,443,allow,11158,3338,7820,27,16,16,11
1609,53,1609,53,allow,197,90,107,2,30,1,1
49274,445,0,0,drop,66,66,0,1,0,1,0
51912,443,41941,443,allow,186,70,116,2,120,1,1
54455,445,0,0,drop,66,66,0,1,0,1,0
28470,80,28470,80,allow,355544,12402,343142,378,26,134,244
14696,42707,0,0,deny,62,62,0,1,0,1,0
46383,443,46383,443,allow,4661,1754,2907,19,30,11,8
63920,443,64654,443,allow,3192,633,2559,17,135,7,10
51244,57587,0,0,deny,100,100,0,1,0,1,0
57801,445,0,0,drop,70,70,0,1,0,1,0
59371,161,59371,161,allow,2085,880,1205,10,31,5,5
36792,80,39617,80,allow,152694,8416,144278,200,32,101,99
37660,443,48083,443,allow,3354,2353,1001,18,45,11,7
2074,32480,0,0,deny,146,146,0,1,0,1,0
19473,41049,5316,41049,allow,149,149,0,1,1200,1,0
56431,53,52567,53,allow,323,110,213,2,30,1,1
55071,53,59621,53,allow,177,94,83,2,30,1,1
56477,80,20829,80,allow,95037,3407,91630,103,135,38,65
32132,25174,0,0,deny,62,62,0,1,0,1,0
57987,3478,50170,3478,allow,312,140,172,4,30,2,2
61104,445,0,0,drop,70,70,0,1,0,1,0
55907,445,0,0,drop,70,70,0,1,0,1,0
65436,53,8668,53,allow,234,94,140,2,29,1,1
50714,80,62410,80,allow,708,384,324,12,195,7,5
55100,445,0,0,drop,70,70,0,1,0,1,0
55004,443,32429,443,allow,1334906,33112,1301794,1315,35,446,869
36811,80,46728,80,allow,1475,837,638,10,15,5,5
51113,445,0,0,drop,66,66,0,1,0,1,0
58608,62413,0,0,deny,66,66,0,1,0,1,0
55520,53,33643,53,allow,188,96,92,2,31,1,1
3478,61463,0,0,deny,1162,1162,0,1,0,1,0
58537,445,0,0,drop,66,66,0,1,0,1,0
60983,443,50042,443,allow,7458,2832,4626,26,16,15,11
49160,16919,59131,16919,allow,868,150,718,4,1200,2,2
57999,80,9823,80,allow,5434,3724,1710,26,76,14,12
55663,19994,24256,19994,allow,70,70,0,1,5,1,0
3478,61463,0,0,deny,164,164,0,1,0,1,0
49782,80,45830,80,allow,130,70,60,2,15,1,1
64380,53,30464,53,allow,196,102,94,2,32,1,1
63101,445,0,0,drop,66,66,0,1,0,1,0
56959,80,53934,80,allow,15752,5736,10016,28,30,14,14
39114,443,44592,443,allow,1238821,42695,1196126,1389,72,535,854
56103,21247,0,0,deny,66,66,0,1,0,1,0
49322,443,12551,443,allow,166663,77974,88689,368,2310,123,245
57636,445,0,0,drop,70,70,0,1,0,1,0
6881,6881,40959,6881,allow,238,118,120,2,1200,1,1
43218,443,21139,443,allow,7375,2087,5288,24,255,12,12
49650,445,0,0,drop,70,70,0,1,0,1,0
49409,443,26346,443,allow,6574,2176,4398,28,124,14,14
50919,443,16242,443,allow,5962,1621,4341,16,75,9,7
59325,445,0,0,drop,66,66,0,1,0,1,0
42880,443,28151,443,allow,134,60,74,3,4,2,1
53724,53,53724,53,allow,268,114,154,2,29,1,1
55445,53,39762,53,allow,192,192,0,3,46,3,0
61701,80,22637,80,allow,1495,954,541,13,47,8,5
51202,443,46664,443,allow,7702,2410,5292,26,34,13,13
61085,445,0,0,drop,70,70,0,1,0,1,0
56484,443,15925,443,allow,2948,782,2166,10,121,5,5
58225,445,0,0,drop,70,70,0,1,0,1,0
37592,36829,0,0,deny,146,146,0,1,0,1,0
56785,53,32079,53,allow,193,102,91,2,30,1,1
53468,443,36235,443,allow,3153,2232,921,15,15,8,7
61456,443,24877,443,allow,9577,1475,8102,30,124,14,16
63368,445,0,0,drop,70,70,0,1,0,1,0
60075,41705,0,0,deny,62,62,0,1,0,1,0
59763,443,10249,443,allow,24828,8387,16441,80,111,44,36
56719,443,65516,443,allow,7888,1899,5989,20,15,11,9
62170,53,16163,53,allow,234,94,140,2,29,1,1
63384,445,0,0,drop,66,66,0,1,0,1,0
49704,80,54649,80,allow,2058,589,1469,10,44,6,4
54618,5900,0,0,deny,60,60,0,1,0,1,0
53876,53380,47868,53380,allow,70,70,0,1,5,1,0
36732,443,61155,443,allow,7449,2359,5090,15,120,7,8
50516,53,48548,53,allow,772,100,672,2,31,1,1
59397,445,0,0,drop,70,70,0,1,0,1,0
51487,443,18707,443,allow,10453,3977,6476,27,54,15,12
64636,3389,64636,3389,allow,3424,1710,1714,16,32,8,8
49453,445,0,0,drop,70,70,0,1,0,1,0
53330,443,1024,443,allow,5454,1157,4297,15,22,9,6
54134,64147,0,0,deny,66,66,0,1,0,1,0
49860,80,9156,80,allow,6892,2154,4738,22,89,12,10
53958,80,17834,80,allow,23134,15926,7208,53,541,32,21
16168,23,0,0,deny,60,60,0,1,0,1,0
51383,445,0,0,drop,66,66,0,1,0,1,0
1025,40108,0,0,deny,146,146,0,1,0,1,0
5826,26467,0,0,deny,62,62,0,1,0,1,0
52857,445,0,0,drop,66,66,0,1,0,1,0
55421,53,47278,53,allow,200,102,98,2,30,1,1
52133,443,32677,443,allow,7601,1919,5682,24,76,13,11
50470,61463,0,0,deny,86,86,0,1,0,1,0
49386,64147,0,0,deny,62,62,0,1,0,1,0
43326,443,42679,443,allow,10063,2126,7937,36,120,18,18
15347,55108,0,0,deny,148,148,0,1,0,1,0
0,0,0,0,allow,124,64,60,2,0,1,1
51459,443,47605,443,allow,379,259,120,4,16,2,2
27005,27015,21869,27015,allow,877,126,751,2,29,1,1
33954,53,7602,53,allow,168,78,90,2,29,1,1
51637,80,27014,80,allow,378,192,186,7,39,4,3
58781,443,48906,443,allow,6673,4335,2338,22,16,11,11
57319,53,4407,53,allow,189,102,87,2,30,1,1
57269,53,5905,53,allow,183,94,89,2,30,1,1
11775,25174,0,0,deny,62,62,0,1,0,1,0
39717,5228,64597,5228,allow,7587,2099,5488,26,3602,14,12
54984,53,62420,53,allow,994,86,908,2,30,1,1
59897,445,0,0,drop,70,70,0,1,0,1,0
60899,445,0,0,drop,70,70,0,1,0,1,0
49765,53,55763,53,allow,188,96,92,2,31,1,1
47812,443,45871,443,allow,25864,15150,10714,105,217,54,51
64806,53,2007,53,allow,273,94,179,2,30,1,1
49999,53,62191,53,allow,316,91,225,4,46,2,2
0,0,0,0,allow,320,320,0,5,0,5,0
26799,50584,0,0,deny,62,62,0,1,0,1,0
59494,443,29596,443,allow,338,278,60,2,5,1,1
63873,44847,0,0,deny,66,66,0,1,0,1,0
56582,53,45398,53,allow,196,102,94,2,33,1,1
12128,37965,0,0,deny,62,62,0,1,0,1,0
54995,443,62942,443,allow,23418,2454,20964,56,197,26,30
59660,445,0,0,drop,70,70,0,1,0,1,0
54746,445,0,0,drop,70,70,0,1,0,1,0
13581,51505,0,0,deny,66,66,0,1,0,1,0
53129,80,16654,80,allow,5318,685,4633,14,15,7,7
44649,443,58778,443,allow,7013,1092,5921,21,31,12,9
62079,30188,0,0,deny,66,66,0,1,0,1,0
60786,51505,0,0,deny,66,66,0,1,0,1,0
50637,44847,0,0,deny,66,66,0,1,0,1,0
33941,37807,0,0,deny,146,146,0,1,0,1,0
60173,445,0,0,drop,70,70,0,1,0,1,0
37426,443,35217,443,allow,7477,3305,4172,21,400,12,9
55726,32463,19971,32463,allow,70,70,0,1,5,1,0
49650,53,11402,53,allow,216,110,106,2,30,1,1
42971,3478,43871,3478,allow,452,280,172,5,31,3,2
64969,445,0,0,drop,70,70,0,1,0,1,0
56609,3389,56609,3389,allow,3327,1438,1889,15,16,8,7
4607,6004,0,0,deny,70,70,0,1,0,1,0
53945,445,0,0,drop,70,70,0,1,0,1,0
48798,443,34647,443,allow,55560,11338,44222,90,23,41,49
50034,53,9396,53,allow,174,89,85,2,30,1,1
49670,445,0,0,drop,66,66,0,1,0,1,0
58734,443,48413,443,allow,1413,876,537,12,26,6,6
55835,62413,0,0,deny,62,62,0,1,0,1,0
57805,445,0,0,drop,66,66,0,1,0,1,0
65319,53,54613,53,allow,200,94,106,2,30,1,1
56127,445,0,0,drop,66,66,0,1,0,1,0
35775,443,51834,443,allow,6665,3913,2752,33,98,19,14
61590,445,0,0,drop,70,70,0,1,0,1,0
54559,445,0,0,drop,70,70,0,1,0,1,0
61544,53,18551,53,allow,325,86,239,2,30,1,1
58729,443,41982,443,allow,5167,700,4467,16,15,7,9
56131,37807,0,0,deny,66,66,0,1,0,1,0
58215,443,23391,443,allow,7337,1630,5707,23,256,12,11
443,21255,0,0,deny,66,66,0,1,0,1,0
64592,53,28124,53,allow,197,94,103,2,30,1,1
53584,62974,25990,62974,allow,70,70,0,2,8,2,0
59308,443,6790,443,allow,12169,4963,7206,60,262,31,29
42238,25174,0,0,deny,66,66,0,1,0,1,0
61679,445,0,0,drop,70,70,0,1,0,1,0
56101,57470,0,0,deny,66,66,0,1,0,1,0
47992,5228,27773,5228,allow,2988,2036,952,16,3601,8,8
61195,56205,0,0,deny,66,66,0,1,0,1,0
48444,53,53992,53,allow,164,78,86,2,30,1,1
62724,53,2730,53,allow,195,78,117,2,29,1,1
38121,443,50120,443,allow,1515436,54168,1461268,1689,16,687,1002
54287,443,51264,443,allow,8603,853,7750,27,92,9,18
52210,51505,0,0,deny,62,62,0,1,0,1,0
62202,445,0,0,drop,70,70,0,1,0,1,0
27005,27015,11588,27015,allow,1019,252,767,4,32,3,1
56487,53,61282,53,allow,194,102,92,2,31,1,1
50622,443,10440,443,allow,9215,1795,7420,32,140,16,16
56461,445,0,0,drop,66,66,0,1,0,1,0
54993,53,53914,53,allow,751,95,656,2,31,1,1
39455,80,39455,80,allow,14349,1038,13311,26,20,13,13
55554,22114,0,0,deny,62,62,0,1,0,1,0
64628,53,57301,53,allow,198,101,97,2,31,1,1
61306,445,0,0,drop,70,70,0,1,0,1,0
63954,60430,37652,60430,allow,70,70,0,1,4,1,0
61256,445,0,0,drop,66,66,0,1,0,1,0
65285,44847,0,0,deny,62,62,0,1,0,1,0
59763,445,0,0,drop,70,70,0,1,0,1,0
60936,443,12668,443,allow,1864,250,1614,8,120,4,4
52720,445,0,0,drop,70,70,0,1,0,1,0
64636,53,42647,53,allow,727,223,504,6,70,3,3
60908,443,62015,443,allow,10043,4993,5050,45,15,27,18
19882,22114,0,0,deny,62,62,0,1,0,1,0
49681,443,29652,443,allow,7074,2016,5058,26,187,13,13
11382,43890,0,0,deny,62,62,0,1,0,1,0
56250,36237,0,0,deny,66,66,0,1,0,1,0
43382,53,39674,53,allow,86,86,0,1,30,1,0
55493,80,50792,80,allow,133558,8265,125293,186,31,93,93
14112,443,14112,443,allow,25629,5823,19806,44,179,25,19
10427,32480,0,0,deny,66,66,0,1,0,1,0
55157,7302,0,0,deny,66,66,0,1,0,1,0
37697,443,26341,443,allow,2071929,56793,2015136,2088,179,685,1403
49492,80,50602,80,allow,1680,1210,470,9,15,5,4
49503,443,38675,443,allow,1363701,35511,1328190,1382,271,476,906
33059,58962,0,0,deny,774,774,0,1,0,1,0
60941,25174,0,0,deny,62,62,0,1,0,1,0
57672,445,0,0,drop,66,66,0,1,0,1,0
49675,7000,49675,7000,allow,3132,815,2317,14,15,7,7
58638,5900,0,0,deny,62,62,0,1,0,1,0
61355,445,0,0,drop,66,66,0,1,0,1,0
55171,53,9139,53,allow,199,102,97,2,29,1,1
57151,445,0,0,drop,66,66,0,1,0,1,0
42895,443,18411,443,allow,600,156,444,8,25,2,6
22114,4789,50813,4789,allow,70,70,0,1,30,1,0
49670,53,37029,53,allow,168,86,82,2,30,1,1
52033,50584,0,0,deny,66,66,0,1,0,1,0
55391,53,35560,53,allow,210,110,100,2,31,1,1
58638,5900,58638,5900,allow,160,66,94,2,9,1,1
64780,443,53095,443,allow,70785,3306,67479,99,80,34,65
3766,25174,0,0,deny,62,62,0,1,0,1,0
56781,17548,14113,17548,allow,70,70,0,1,5,1,0
51996,41888,55881,41888,allow,70,70,0,2,7,2,0
65403,53,26978,53,allow,178,94,84,2,30,1,1
51184,445,0,0,drop,70,70,0,1,0,1,0
55839,443,48499,443,allow,13469,2007,11462,44,256,19,25
48219,55442,0,0,deny,66,66,0,1,0,1,0
56019,53,13898,53,allow,194,102,92,2,30,1,1
14059,21247,0,0,deny,62,62,0,1,0,1,0
58740,443,9858,443,allow,5228,700,4528,17,14,7,10
45359,443,22644,443,allow,10480,4949,5531,22,15,12,10
44732,80,44732,80,allow,369759,9557,360202,388,22,137,251
64712,53,1546,53,allow,177,94,83,2,30,1,1
37587,443,9282,443,allow,6912,1841,5071,33,27,17,16
39063,5900,0,0,deny,60,60,0,1,0,1,0
56986,53,31308,53,allow,177,94,83,2,29,1,1
27005,27021,33565,27021,allow,879,126,753,2,30,1,1
60948,445,0,0,drop,66,66,0,1,0,1,0
10151,51413,40673,51413,allow,460,150,310,2,1200,1,1
55659,443,55659,443,allow,25716,7632,18084,52,48,31,21
63836,445,0,0,drop,70,70,0,1,0,1,0
65232,53,42020,53,allow,311,94,217,2,30,1,1
53705,30600,18470,30600,allow,492,306,186,8,15,5,3
0,0,0,0,allow,200,102,98,2,0,1,1
35195,443,7133,443,allow,153,93,60,2,5,1,1
61030,21247,0,0,deny,62,62,0,1,0,1,0
55341,445,0,0,drop,66,66,0,1,0,1,0
53265,443,57484,443,allow,4995,1414,3581,21,15,12,9
39715,443,41417,443,allow,65276,4554,60722,82,217,34,48
52663,443,53022,443,allow,4416,1702,2714,19,126,9,10
58638,5900,0,0,deny,62,62,0,1,0,1,0
57555,35440,0,0,deny,66,66,0,1,0,1,0
55596,445,0,0,drop,70,70,0,1,0,1,0
57035,53,5245,53,allow,199,102,97,2,30,1,1
26531,37965,0,0,deny,62,62,0,1,0,1,0
57322,53,53567,53,allow,196,102,94,2,29,1,1
49496,53,27238,53,allow,194,102,92,2,30,1,1
60386,80,35408,80,allow,214,140,74,4,15,3,1
58834,445,0,0,drop,70,70,0,1,0,1,0
52929,43890,0,0,deny,62,62,0,1,0,1,0
56005,64147,0,0,deny,62,62,0,1,0,1,0
64949,44847,0,0,deny,62,62,0,1,0,1,0
36628,80,54402,80,allow,78,78,0,2,8,2,0
19875,30170,0,0,deny,145,145,0,1,0,1,0
14082,50584,0,0,deny,66,66,0,1,0,1,0
50207,53,12070,53,allow,189,102,87,2,31,1,1
59236,17,0,0,deny,60,60,0,1,0,1,0
53907,443,41234,443,allow,499,425,74,4,0,3,1
51754,18375,0,0,deny,66,66,0,1,0,1,0
57131,26296,0,0,deny,145,145,0,1,0,1,0
50086,53,16389,53,allow,193,102,91,2,30,1,1
47682,64147,0,0,deny,66,66,0,1,0,1,0
5195,64147,0,0,deny,66,66,0,1,0,1,0
64744,445,0,0,drop,70,70,0,1,0,1,0
53919,443,62398,443,allow,499,425,74,4,0,3,1
57911,443,43527,443,allow,9662,4079,5583,66,194,30,36
65317,51221,0,0,deny,78,78,0,1,0,1,0
5588,5588,0,0,allow,3354,1792,1562,46,194,23,23
51630,80,41968,80,allow,7679,5325,2354,15,29,8,7
56843,443,16451,443,allow,54661,36820,17841,266,201,128,138
14997,57470,0,0,deny,72,72,0,1,0,1,0
50675,445,0,0,drop,66,66,0,1,0,1,0
993,58185,0,0,deny,129,129,0,1,0,1,0
56256,445,0,0,drop,66,66,0,1,0,1,0
59429,445,0,0,drop,66,66,0,1,0,1,0
35549,443,45483,443,allow,9032,2244,6788,36,255,17,19
53575,445,0,0,drop,66,66,0,1,0,1,0
50014,445,0,0,drop,70,70,0,1,0,1,0
33260,443,40517,443,allow,4051,2618,1433,21,23,13,8
50161,53,38218,53,allow,165,86,79,2,30,1,1
56919,53,40423,53,allow,177,94,83,2,29,1,1
64216,53,16244,53,allow,183,94,89,2,30,1,1
56855,443,28597,443,allow,8114,2511,5603,19,135,9,10
443,41237,0,0,deny,89,89,0,1,0,1,0
41321,443,41856,443,allow,9168,1596,7572,22,186,11,11
50531,80,35066,80,allow,21782,2162,19620,28,20,11,17
56732,10271,46976,10271,allow,3090,1706,1384,16,30,10,6
52717,53,4391,53,allow,277,94,183,2,30,1,1
57257,445,0,0,drop,70,70,0,1,0,1,0
10002,40012,52638,40012,allow,261,198,63,2,29,1,1
64292,445,0,0,drop,70,70,0,1,0,1,0
443,15564,0,0,deny,85,85,0,1,0,1,0
52593,445,0,0,drop,70,70,0,1,0,1,0
55463,445,0,0,drop,70,70,0,1,0,1,0
49418,27015,16562,27015,allow,269,71,198,2,31,1,1
62237,445,0,0,drop,66,66,0,1,0,1,0
51842,443,3576,443,allow,1503,984,519,13,31,8,5
53975,443,21855,443,allow,2845,1694,1151,18,125,10,8
44154,22114,0,0,deny,62,62,0,1,0,1,0
2697,28189,0,0,deny,60,60,0,1,0,1,0
52575,445,0,0,drop,70,70,0,1,0,1,0
53920,34914,18938,34914,allow,1781,1103,678,15,17,9,6
49154,80,61897,80,allow,2438,565,1873,10,75,6,4
51837,37965,0,0,deny,66,66,0,1,0,1,0
33801,62413,0,0,deny,66,66,0,1,0,1,0
49364,53,30235,53,allow,183,94,89,2,30,1,1
44908,443,9126,443,allow,2931,1940,991,19,25,10,9
56628,80,40894,80,allow,234,234,0,4,11,4,0
16057,51050,0,0,deny,66,66,0,1,0,1,0
54538,80,35235,80,allow,4162,3455,707,14,15,8,6
50401,443,36442,443,allow,1124,594,530,12,26,6,6
64882,53,49587,53,allow,279,126,153,2,30,1,1
42137,443,46635,443,allow,9173,2080,7093,22,18,13,9
5588,5588,0,0,allow,3354,1792,1562,46,193,23,23
56480,80,24972,80,allow,289731,8487,281244,294,136,104,190
65204,445,0,0,drop,70,70,0,1,0,1,0
49937,53,46761,53,allow,718,94,624,2,30,1,1
50123,443,58250,443,allow,15011,5619,9392,50,35,26,24
64017,80,54075,80,allow,314,192,122,6,15,4,2
60075,445,0,0,drop,70,70,0,1,0,1,0
57734,445,0,0,drop,70,70,0,1,0,1,0
53147,26330,24592,26330,allow,70,70,0,1,5,1,0
47119,5228,18356,5228,allow,3630,2427,1203,21,3601,11,10
19245,64147,0,0,deny,62,62,0,1,0,1,0
12348,50265,0,0,deny,62,62,0,1,0,1,0
50277,445,0,0,drop,66,66,0,1,0,1,0
49739,53,37326,53,allow,757,102,655,2,30,1,1
56720,53,7909,53,allow,177,94,83,2,30,1,1
51547,445,0,0,drop,70,70,0,1,0,1,0
59181,445,0,0,drop,70,70,0,1,0,1,0
62409,445,0,0,drop,66,66,0,1,0,1,0
57552,445,0,0,drop,70,70,0,1,0,1,0
55378,445,0,0,drop,66,66,0,1,0,1,0
64753,53,63867,53,allow,94,94,0,1,30,1,0
27783,57470,0,0,deny,62,62,0,1,0,1,0
65307,53,63090,53,allow,184,94,90,2,30,1,1
65246,53,4675,53,allow,182,93,89,2,31,1,1
55324,445,0,0,drop,70,70,0,1,0,1,0
49917,53,46665,53,allow,168,78,90,2,29,1,1
46128,443,47204,443,allow,9814,2331,7483,38,255,19,19
57470,58753,38248,58753,allow,166,166,0,1,1199,1,0
49837,53,9778,53,allow,167,86,81,2,30,1,1
43056,443,9640,443,allow,31297,21354,9943,55,363,28,27
45964,3111,0,0,deny,60,60,0,1,0,1,0
31845,55777,0,0,deny,62,62,0,1,0,1,0
15629,53,15629,53,allow,209,77,132,2,32,1,1
49352,443,43143,443,allow,2118582,46411,2072171,2066,90,617,1449
49849,80,56031,80,allow,9581,2352,7229,14,89,7,7
57717,445,0,0,drop,66,66,0,1,0,1,0
51838,29448,59159,29448,allow,70,70,0,1,5,1,0
65460,53,42143,53,allow,194,99,95,2,31,1,1
55807,80,55807,80,allow,424,198,226,7,142,4,3
64445,53,20808,53,allow,269,94,175,2,30,1,1
62581,445,0,0,drop,70,70,0,1,0,1,0
64330,53,5975,53,allow,193,102,91,2,30,1,1
17481,53,17481,53,allow,198,90,108,2,30,1,1
49988,443,49988,443,allow,2123,1050,1073,23,120,11,12
59892,443,22013,443,allow,1813,1004,809,16,28,8,8
55255,445,0,0,drop,70,70,0,1,0,1,0
34441,53,34441,53,allow,314,98,216,2,30,1,1
57676,64147,0,0,deny,74,74,0,1,0,1,0
27005,37569,49792,37569,allow,892,126,766,2,30,1,1
59750,53,24886,53,allow,304,86,218,2,29,1,1
64231,445,0,0,drop,70,70,0,1,0,1,0
62152,56205,0,0,deny,66,66,0,1,0,1,0
50354,56205,0,0,deny,66,66,0,1,0,1,0
61550,5529,0,0,deny,145,145,0,1,0,1,0
60602,15503,0,0,deny,66,66,0,1,0,1,0
25091,64147,0,0,deny,66,66,0,1,0,1,0
54816,35440,0,0,deny,62,62,0,1,0,1,0
59222,445,0,0,drop,66,66,0,1,0,1,0
9197,80,56702,80,allow,1701,883,818,14,26,7,7
57009,53,48433,53,allow,177,94,83,2,30,1,1
35609,443,52136,443,allow,9225,2759,6466,27,100,16,11
49735,443,18914,443,allow,1143,672,471,12,129,7,5
65166,445,0,0,drop,70,70,0,1,0,1,0
62725,51221,0,0,deny,66,66,0,1,0,1,0
56326,56205,0,0,deny,66,66,0,1,0,1,0
65361,53,33877,53,allow,760,97,663,2,30,1,1
61071,1053,14234,1053,allow,1139,878,261,2,30,1,1
53621,445,0,0,drop,70,70,0,1,0,1,0
54404,445,0,0,drop,70,70,0,1,0,1,0
37965,48477,53954,48477,allow,7097,4720,2377,89,3163,55,34
54168,445,0,0,drop,70,70,0,1,0,1,0
52276,80,52276,80,allow,222010,7236,214774,216,28,66,150
55955,53,59392,53,allow,164,86,78,2,30,1,1
20108,64147,0,0,deny,66,66,0,1,0,1,0
1238,51505,0,0,deny,62,62,0,1,0,1,0
50441,80,50441,80,allow,79227,5480,73747,89,19,32,57
58638,5900,0,0,deny,62,62,0,1,0,1,0
65166,62413,0,0,deny,62,62,0,1,0,1,0
57588,445,0,0,drop,66,66,0,1,0,1,0
36080,26467,0,0,deny,62,62,0,1,0,1,0
43879,443,28850,443,allow,71822,4809,67013,112,241,54,58
65219,53,25255,53,allow,229,102,127,2,29,1,1
51987,445,0,0,drop,70,70,0,1,0,1,0
53724,64923,33470,64923,allow,70,70,0,2,8,2,0
62226,443,62226,443,allow,130836,22940,107896,161,170,72,89
62413,6881,56796,6881,allow,311,311,0,3,1200,3,0
20108,64147,0,0,deny,62,62,0,1,0,1,0
51977,445,0,0,drop,66,66,0,1,0,1,0
55671,53,32686,53,allow,98,98,0,1,30,1,0
56952,443,36539,443,allow,5601,1203,4398,14,60,9,5
59974,443,8585,443,allow,7820,1344,6476,24,16,13,11
58849,443,31441,443,allow,1366,631,735,14,81,7,7
68,67,0,0,deny,594,594,0,1,0,1,0
59878,443,30562,443,allow,3864,2812,1052,17,112,8,9
53242,443,60207,443,allow,42135,4098,38037,64,323,25,39
26900,27017,34324,27017,allow,422,164,258,6,30,3,3
40866,8434,40866,8434,allow,156,156,0,3,8,3,0
64787,53,4166,53,allow,174,89,85,2,31,1,1
49177,54532,0,0,deny,60,60,0,1,0,1,0
27005,50003,20006,50003,allow,887,126,761,2,31,1,1
56730,53,53565,53,allow,210,110,100,2,30,1,1
58576,445,0,0,drop,70,70,0,1,0,1,0
49701,443,3982,443,allow,28497,1646,26851,31,138,9,22
60875,56205,0,0,deny,66,66,0,1,0,1,0
51328,30228,0,0,deny,109,109,0,1,0,1,0
49270,53,43465,53,allow,216,110,106,2,30,1,1
52867,53,61685,53,allow,184,86,98,2,30,1,1
52051,29868,57987,29868,allow,70,70,0,1,4,1,0
64580,53,58796,53,allow,200,94,106,2,30,1,1
1024,6881,0,0,deny,146,146,0,1,0,1,0
56406,22114,0,0,deny,62,62,0,1,0,1,0
2876,35440,0,0,deny,62,62,0,1,0,1,0
443,14591,0,0,deny,131,131,0,1,0,1,0
55932,53,10932,53,allow,193,102,91,2,29,1,1
52903,445,0,0,drop,70,70,0,1,0,1,0
58638,5900,0,0,deny,62,62,0,1,0,1,0
59511,445,0,0,drop,70,70,0,1,0,1,0
3478,61463,0,0,deny,1044,1044,0,1,0,1,0
64320,53,39088,53,allow,197,94,103,2,29,1,1
64257,53,4953,53,allow,261,94,167,2,30,1,1
54749,443,23422,443,allow,273283,194709,78574,1567,3312,746,821
50432,445,0,0,drop,66,66,0,1,0,1,0
43891,8497,0,0,deny,148,148,0,1,0,1,0
49532,53,4849,53,allow,190,97,93,2,31,1,1
57234,21247,0,0,deny,66,66,0,1,0,1,0
45754,443,17919,443,allow,1625,1038,587,14,25,8,6
55003,445,0,0,drop,70,70,0,1,0,1,0
57282,443,46130,443,allow,11721,2230,9491,39,31,22,17
65471,53,50193,53,allow,498,204,294,6,31,3,3
60502,61473,62296,61473,allow,1628,1037,591,14,16,8,6
61912,17546,0,0,deny,66,66,0,1,0,1,0
39839,22114,0,0,deny,62,62,0,1,0,1,0
52754,26467,0,0,deny,62,62,0,1,0,1,0
41348,5555,0,0,deny,60,60,0,1,0,1,0
52447,43890,0,0,deny,66,66,0,1,0,1,0
52248,443,56929,443,allow,190,70,120,4,15,2,2
56707,445,0,0,drop,70,70,0,1,0,1,0
52399,445,0,0,drop,70,70,0,1,0,1,0
57375,53,63119,53,allow,198,102,96,2,30,1,1
49418,27014,49598,27014,allow,235,71,164,2,31,1,1
61430,80,6930,80,allow,214,140,74,4,41,3,1
55672,445,0,0,drop,70,70,0,1,0,1,0
41738,53,43971,53,allow,168,78,90,2,30,1,1
31683,35440,0,0,deny,146,146,0,1,0,1,0
56633,53,46953,53,allow,342,99,243,4,32,2,2
49885,445,0,0,drop,70,70,0,1,0,1,0
49171,53,3246,53,allow,199,102,97,2,30,1,1
61464,445,0,0,drop,70,70,0,1,0,1,0
49177,54532,0,0,deny,60,60,0,1,0,1,0
32053,443,32053,443,allow,28195,6044,22151,58,17,30,28
50374,443,56948,443,allow,5359,705,4654,15,25,8,7
44258,443,15237,443,allow,14478,1815,12663,30,170,14,16
50786,445,0,0,drop,70,70,0,1,0,1,0
49332,443,12336,443,allow,4425,1910,2515,36,3656,12,24
18592,44612,0,0,deny,62,62,0,1,0,1,0
56313,53,27206,53,allow,198,102,96,2,30,1,1
61711,35440,0,0,deny,66,66,0,1,0,1,0
32927,443,31722,443,allow,867883,29498,838385,922,58,328,594
49160,16767,65061,16767,allow,854,150,704,4,1200,2,2
60046,445,0,0,drop,66,66,0,1,0,1,0
56288,53,45590,53,allow,200,102,98,2,31,1,1
53277,445,0,0,drop,70,70,0,1,0,1,0
64990,55442,0,0,deny,66,66,0,1,0,1,0
18415,37965,0,0,deny,62,62,0,1,0,1,0
50116,22,50116,22,allow,66,66,0,1,5,1,0
65082,53,4469,53,allow,718,94,624,2,29,1,1
30960,45683,56128,45683,allow,330,330,0,6,3609,6,0
55734,53,29847,53,allow,733,94,639,2,30,1,1
55077,53,42307,53,allow,179,94,85,2,30,1,1
59374,445,0,0,drop,70,70,0,1,0,1,0
15111,53,15111,53,allow,210,98,112,2,29,1,1
1865,25174,0,0,deny,146,146,0,1,0,1,0
55631,445,0,0,drop,66,66,0,1,0,1,0
61764,57470,0,0,deny,146,146,0,1,0,1,0
47483,53,19312,53,allow,164,78,86,2,30,1,1
15581,46713,0,0,deny,66,66,0,1,0,1,0
56788,53,32214,53,allow,199,102,97,2,30,1,1
52123,46261,34015,46261,allow,70,70,0,2,7,2,0
65006,53,44331,53,allow,763,102,661,2,30,1,1
54973,445,0,0,drop,70,70,0,1,0,1,0
55428,443,63993,443,allow,74784,4781,70003,122,171,55,67
58110,53,0,0,allow,178,79,99,2,30,1,1
35063,443,32697,443,allow,7105,1924,5181,20,25,10,10
55704,53,62671,53,allow,193,102,91,2,30,1,1
16647,53,16647,53,allow,233,91,142,2,30,1,1
49245,53,34102,53,allow,376,126,250,2,29,1,1
61771,445,0,0,drop,70,70,0,1,0,1,0
54994,53,25626,53,allow,209,110,99,2,31,1,1
65300,53,17594,53,allow,329,88,241,4,50,2,2
56663,53,34654,53,allow,178,91,87,2,31,1,1
60487,445,0,0,drop,66,66,0,1,0,1,0
35849,30188,0,0,deny,62,62,0,1,0,1,0
443,56858,0,0,deny,85,85,0,1,0,1,0
51521,443,51521,443,allow,138679,4142,134537,141,173,33,108
49418,27013,52057,27013,allow,230,71,159,2,31,1,1
53771,37965,0,0,deny,66,66,0,1,0,1,0
50730,445,0,0,drop,70,70,0,1,0,1,0
65187,27126,30981,27126,allow,268,78,190,2,30,1,1
57470,51413,47712,51413,allow,543,166,377,2,1199,1,1
53536,443,47086,443,allow,7901,3483,4418,24,30,13,11
993,54748,0,0,deny,66,66,0,1,0,1,0
56697,53,34605,53,allow,198,102,96,2,30,1,1
44368,443,44368,443,allow,7123,1020,6103,19,151,11,8
46275,64147,0,0,deny,62,62,0,1,0,1,0
49805,445,0,0,drop,70,70,0,1,0,1,0
49516,53,27772,53,allow,182,93,89,2,31,1,1
55896,53,31620,53,allow,168,86,82,2,30,1,1
58638,5900,0,0,deny,62,62,0,1,0,1,0
50209,53,40978,53,allow,86,86,0,1,30,1,0
61465,22114,0,0,deny,62,62,0,1,0,1,0
1114,37965,0,0,deny,62,62,0,1,0,1,0
60500,445,0,0,drop,66,66,0,1,0,1,0
13062,52274,0,0,deny,66,66,0,1,0,1,0
30188,23453,55935,23453,allow,502,150,352,2,1200,1,1
49911,445,0,0,drop,70,70,0,1,0,1,0
55698,45710,57579,45710,allow,70,70,0,1,5,1,0
38167,443,36158,443,allow,6150,914,5236,18,16,10,8
56638,445,0,0,drop,66,66,0,1,0,1,0
44509,80,44509,80,allow,84030,4287,79743,107,145,47,60
56337,443,18375,443,allow,9683,2173,7510,35,26,17,18
52071,445,0,0,drop,66,66,0,1,0,1,0
52715,443,38027,443,allow,164840,5975,158865,179,122,61,118
62375,445,0,0,drop,70,70,0,1,0,1,0
64071,445,0,0,drop,70,70,0,1,0,1,0
37566,443,23464,443,allow,499,425,74,4,0,3,1
56369,53,59110,53,allow,193,102,91,2,31,1,1
28032,443,27743,443,allow,6756,2587,4169,19,16,10,9
33877,443,16562,443,allow,9449,3441,6008,27,41,17,10
41653,21247,0,0,deny,62,62,0,1,0,1,0
1024,64147,0,0,deny,62,62,0,1,0,1,0
56345,443,39296,443,allow,39990,1989,38001,50,147,17,33
54373,53,8646,53,allow,200,86,114,2,30,1,1
65315,53,25956,53,allow,172,88,84,2,30,1,1
50856,445,0,0,drop,66,66,0,1,0,1,0
49893,445,0,0,drop,66,66,0,1,0,1,0
18415,37965,0,0,deny,62,62,0,1,0,1,0
58638,5900,0,0,deny,62,62,0,1,0,1,0
42128,54532,0,0,deny,60,60,0,1,0,1,0
57528,53,37207,53,allow,585,192,393,6,54,3,3
6881,6881,0,0,deny,62,62,0,1,0,1,0
45230,443,23452,443,allow,33924,26047,7877,73,403,33,40
64634,53,6012,53,allow,211,102,109,2,29,1,1
54600,445,0,0,drop,66,66,0,1,0,1,0
58638,5900,0,0,deny,62,62,0,1,0,1,0
60341,445,0,0,drop,70,70,0,1,0,1,0
55267,53,26990,53,allow,214,102,112,2,29,1,1
55614,29731,2636,29731,allow,70,70,0,2,8,2,0
27005,27018,40028,27018,allow,891,126,765,2,31,1,1
49471,445,0,0,drop,70,70,0,1,0,1,0
64219,53,14756,53,allow,403,94,309,4,38,2,2
56938,8000,45584,8000,allow,110,110,0,1,30,1,0
53551,445,0,0,drop,70,70,0,1,0,1,0
49763,53,30741,53,allow,258,110,148,2,30,1,1
53630,64745,62898,64745,allow,70,70,0,2,7,2,0
55289,53,47764,53,allow,446,94,352,4,44,2,2
60300,80,12014,80,allow,1343,846,497,11,145,6,5
50995,445,0,0,drop,70,70,0,1,0,1,0
55820,53,12238,53,allow,184,94,90,2,30,1,1
52455,445,0,0,drop,66,66,0,1,0,1,0
63731,26467,0,0,deny,62,62,0,1,0,1,0
55058,80,17892,80,allow,48751,3044,45707,57,60,23,34
64587,43890,0,0,deny,66,66,0,1,0,1,0
60361,57470,0,0,deny,66,66,0,1,0,1,0
65218,443,1874,443,allow,2767,681,2086,10,120,5,5
43841,443,59699,443,allow,6516,3085,3431,33,80,17,16
55311,53,15716,53,allow,298,101,197,4,31,2,2
60405,5900,0,0,deny,60,60,0,1,0,1,0
54071,53,10458,53,allow,207,86,121,2,30,1,1
64722,53,58551,53,allow,214,110,104,2,30,1,1
53218,56205,0,0,deny,66,66,0,1,0,1,0
57897,443,36818,443,allow,1865,1226,639,18,176,11,7
55163,445,0,0,drop,70,70,0,1,0,1,0
20586,25174,0,0,deny,62,62,0,1,0,1,0
63758,57825,49491,57825,allow,312,132,180,6,6,3,3
14422,443,38791,443,allow,1857,1218,639,18,95,11,7
59846,443,17762,443,allow,23856,3218,20638,40,18,16,24
65512,53,38019,53,allow,265,102,163,2,30,1,1
51956,445,0,0,drop,66,66,0,1,0,1,0
50573,443,20479,443,allow,6575,1995,4580,26,100,13,13
60981,445,0,0,drop,70,70,0,1,0,1,0
37837,37965,0,0,deny,62,62,0,1,0,1,0
23296,23,0,0,deny,60,60,0,1,0,1,0
60880,443,53335,443,allow,12278,1931,10347,32,56,18,14
62757,445,0,0,drop,70,70,0,1,0,1,0
16994,57866,0,0,deny,146,146,0,1,0,1,0
58034,443,56445,443,allow,4132,2158,1974,35,255,17,18
64438,53,9645,53,allow,184,94,90,2,29,1,1
45941,23386,0,0,deny,60,60,0,1,0,1,0
55836,53,41454,53,allow,181,94,87,2,33,1,1
59728,445,0,0,drop,66,66,0,1,0,1,0
51110,80,59490,80,allow,1524,1028,496,10,20,7,3
53873,52055,19487,52055,allow,70,70,0,1,4,1,0
63954,53,6162,53,allow,289,102,187,2,30,1,1
49418,27018,24351,27018,allow,240,78,162,2,30,1,1
64903,53,16364,53,allow,210,110,100,2,30,1,1
49484,445,0,0,drop,66,66,0,1,0,1,0
64665,53,55262,53,allow,181,94,87,2,31,1,1
65495,53,9784,53,allow,202,103,99,2,31,1,1
59675,80,26404,80,allow,3437462,77916,3359546,3384,134,1140,2244
55325,53,11184,53,allow,210,110,100,2,31,1,1
33165,443,61975,443,allow,7442,1260,6182,19,15,10,9
50030,53,18076,53,allow,209,110,99,2,30,1,1
52124,443,40698,443,allow,78269,5330,72939,127,313,57,70
49909,443,16969,443,allow,6754,2219,4535,21,75,11,10
52047,42805,53752,42805,allow,70,70,0,1,4,1,0
60102,445,0,0,drop,70,70,0,1,0,1,0
25878,25174,0,0,deny,66,66,0,1,0,1,0
63130,55860,38620,55860,allow,1426,964,462,7,15,4,3
59974,443,38243,443,allow,354,140,214,6,130,3,3
443,23220,0,0,deny,100,100,0,1,0,1,0
59417,443,49153,443,allow,2898,1700,1198,16,15,8,8
58035,80,30742,80,allow,100364,4917,95447,133,241,67,66
56834,53,6671,53,allow,178,94,84,2,31,1,1
64596,53,15356,53,allow,215,86,129,2,30,1,1
63319,53,8378,53,allow,315,102,213,2,31,1,1
2850,64147,0,0,deny,66,66,0,1,0,1,0
6666,6001,0,0,deny,60,60,0,1,0,1,0
59316,443,4398,443,allow,17547,11857,5690,34,159,20,14
11136,15503,0,0,deny,62,62,0,1,0,1,0
56112,53,3199,53,allow,198,101,97,2,31,1,1
1038,37965,0,0,deny,62,62,0,1,0,1,0
64296,53,31060,53,allow,215,94,121,2,29,1,1
55700,26957,2984,26957,allow,70,70,0,1,5,1,0
14263,22114,0,0,deny,62,62,0,1,0,1,0
56295,443,26147,443,allow,8550,1880,6670,22,376,12,10
64074,53,30034,53,allow,209,110,99,2,29,1,1
51769,51505,0,0,deny,62,62,0,1,0,1,0
55390,53,32407,53,allow,778,103,675,2,31,1,1
34873,80,34873,80,allow,2148,918,1230,10,20,6,4
57324,445,0,0,drop,70,70,0,1,0,1,0
52772,445,0,0,drop,70,70,0,1,0,1,0
53338,53,53532,53,allow,168,78,90,2,30,1,1
62303,445,0,0,drop,66,66,0,1,0,1,0
58229,50584,0,0,deny,66,66,0,1,0,1,0
64255,53,54651,53,allow,211,102,109,2,30,1,1
54838,445,0,0,drop,66,66,0,1,0,1,0
61736,50584,0,0,deny,66,66,0,1,0,1,0
44546,32468,0,0,deny,146,146,0,1,0,1,0
36906,50584,0,0,deny,62,62,0,1,0,1,0
9264,80,28949,80,allow,318,192,126,6,26,4,2
9528,44847,0,0,deny,62,62,0,1,0,1,0
64719,53,8538,53,allow,381,98,283,4,51,2,2
64630,53,37942,53,allow,350,94,256,2,30,1,1
34936,30188,0,0,deny,66,66,0,1,0,1,0
58638,5900,0,0,deny,62,62,0,1,0,1,0
28306,25604,0,0,deny,62,62,0,1,0,1,0
51104,80,56002,80,allow,1524,1028,496,10,21,7,3
54276,37628,0,0,deny,66,66,0,1,0,1,0
49811,53,10574,53,allow,763,102,661,2,29,1,1
60135,445,0,0,drop,70,70,0,1,0,1,0
60085,445,0,0,drop,70,70,0,1,0,1,0
50501,123,36469,123,allow,184,94,90,2,30,1,1
52036,445,0,0,drop,70,70,0,1,0,1,0
65315,53,35548,53,allow,178,94,84,2,29,1,1
51490,50432,0,0,deny,100,100,0,1,0,1,0
16477,37807,0,0,deny,66,66,0,1,0,1,0
12477,80,12477,80,allow,6835,961,5874,17,27,9,8
54153,443,43773,443,allow,5008,2097,2911,13,121,6,7
6546,37965,0,0,deny,62,62,0,1,0,1,0
57163,53,45195,53,allow,209,110,99,2,30,1,1
64245,445,0,0,drop,70,70,0,1,0,1,0
62101,445,0,0,drop,70,70,0,1,0,1,0
62670,445,0,0,drop,66,66,0,1,0,1,0
35738,80,42244,80,allow,1151,711,440,10,16,5,5
50613,53,60735,53,allow,814,110,704,2,30,1,1
64502,53,21170,53,allow,199,102,97,2,30,1,1
27922,25174,0,0,deny,62,62,0,1,0,1,0
59023,64097,0,0,deny,62,62,0,1,0,1,0
50971,44847,0,0,deny,62,62,0,1,0,1,0
65123,53,3182,53,allow,193,102,91,2,29,1,1
63203,445,0,0,drop,66,66,0,1,0,1,0
54276,39004,0,0,deny,62,62,0,1,0,1,0
2049,32480,0,0,deny,62,62,0,1,0,1,0
64858,53,5118,53,allow,819,102,717,2,30,1,1
62207,445,0,0,drop,70,70,0,1,0,1,0
57828,445,0,0,drop,70,70,0,1,0,1,0
36361,80,36361,80,allow,514,246,268,9,76,5,4
59711,445,0,0,drop,70,70,0,1,0,1,0
57093,445,0,0,drop,66,66,0,1,0,1,0
49742,80,32579,80,allow,103346,1476,101870,87,17,16,71
55043,53,56883,53,allow,167,86,81,2,29,1,1
49518,53,34385,53,allow,299,90,209,4,49,2,2
53730,443,15340,443,allow,499,425,74,4,0,3,1
52040,80,45485,80,allow,4185,3462,723,14,16,7,7
44847,17977,12872,17977,allow,502,150,352,2,1200,1,1
33570,443,59571,443,allow,81954,13611,68343,174,34,79,95
26900,27017,61520,27017,allow,422,164,258,6,31,3,3
49275,53,35482,53,allow,195,102,93,2,31,1,1
55097,53,14648,53,allow,177,94,83,2,29,1,1
35373,443,52870,443,allow,255313,6947,248366,253,123,74,179
51234,443,8944,443,allow,31736,1463,30273,43,32,14,29
28998,53,28998,53,allow,220,90,130,2,30,1,1
26821,57866,0,0,deny,62,62,0,1,0,1,0
58936,80,60272,80,allow,10003,5095,4908,21,76,12,9
62400,35993,0,0,deny,62,62,0,1,0,1,0
64763,445,0,0,drop,66,66,0,1,0,1,0
35610,37965,0,0,deny,62,62,0,1,0,1,0
56328,36237,0,0,deny,66,66,0,1,0,1,0
64602,53,19507,53,allow,184,94,90,2,30,1,1
37260,21247,0,0,deny,66,66,0,1,0,1,0
51038,445,0,0,drop,66,66,0,1,0,1,0
65530,53,49295,53,allow,381,88,293,4,31,2,2
53901,443,43794,443,allow,499,425,74,4,0,3,1
34531,443,54332,443,allow,135231,5033,130198,149,216,55,94
55868,445,0,0,drop,70,70,0,1,0,1,0
55198,445,0,0,drop,70,70,0,1,0,1,0
59326,445,0,0,drop,70,70,0,1,0,1,0
47918,123,27276,123,allow,184,94,90,2,30,1,1
56736,443,32910,443,allow,7890,1901,5989,20,15,11,9
58638,5900,0,0,deny,62,62,0,1,0,1,0
56946,80,58825,80,allow,214,140,74,4,30,3,1
2267,53,49774,53,allow,826,826,0,8,44,8,0
57024,445,0,0,drop,70,70,0,1,0,1,0
57063,53,34748,53,allow,177,94,83,2,30,1,1
63060,53,7236,53,allow,304,86,218,2,30,1,1
55624,80,56586,80,allow,70,70,0,1,5,1,0
65398,7129,0,0,deny,66,66,0,1,0,1,0
60266,445,0,0,drop,70,70,0,1,0,1,0
56736,53,58809,53,allow,283,94,189,4,41,2,2
56714,443,11426,443,allow,579769,15036,564733,578,61,199,379
55056,53,32343,53,allow,177,94,83,2,31,1,1
51544,50584,0,0,deny,62,62,0,1,0,1,0
50290,53,2460,53,allow,211,110,101,2,30,1,1
12465,11392,0,0,deny,62,62,0,1,0,1,0
65125,445,0,0,drop,70,70,0,1,0,1,0
49780,80,65003,80,allow,1429,931,498,10,126,6,4
44891,23,0,0,deny,60,60,0,1,0,1,0
60954,443,45270,443,allow,62583,3743,58840,88,32,40,48
56982,53,26329,53,allow,193,94,99,2,30,1,1
59489,445,0,0,drop,70,70,0,1,0,1,0
51465,443,37534,443,allow,318,70,248,5,17,1,4
49235,80,47953,80,allow,1783342,58977,1724365,1613,162,445,1168
56312,53,29568,53,allow,195,102,93,2,29,1,1
62103,445,0,0,drop,70,70,0,1,0,1,0
64013,57470,0,0,deny,74,74,0,1,0,1,0
6889,48817,0,0,deny,143,143,0,1,0,1,0
52103,80,61932,80,allow,68083,5515,62568,90,38,40,50
59032,25174,0,0,deny,66,66,0,1,0,1,0
53791,443,9232,443,allow,499,425,74,4,0,3,1
53730,37965,0,0,deny,66,66,0,1,0,1,0
58369,53,5499,53,allow,174,81,93,2,30,1,1
49656,443,43316,443,allow,19544,4428,15116,79,119,39,40
55001,443,43698,443,allow,8182,3793,4389,27,37,16,11
33040,443,3946,443,allow,118,118,0,1,30,1,0
7954,53,7954,53,allow,226,90,136,2,29,1,1
54768,25,54768,25,allow,194,66,128,3,15,1,2
53204,443,30061,443,allow,3655,2344,1311,18,17,9,9
56844,445,0,0,drop,70,70,0,1,0,1,0
60079,445,0,0,drop,70,70,0,1,0,1,0
51696,445,0,0,drop,70,70,0,1,0,1,0
49418,30006,39633,30006,allow,244,71,173,2,30,1,1
65382,53,48645,53,allow,301,108,193,4,55,2,2
60267,445,0,0,drop,70,70,0,1,0,1,0
55452,53,61292,53,allow,184,94,90,2,30,1,1
23461,34021,0,0,reset-both,62,62,0,1,0,1,0
62359,445,0,0,drop,66,66,0,1,0,1,0
50264,445,0,0,drop,70,70,0,1,0,1,0
60524,64147,0,0,deny,66,66,0,1,0,1,0
57251,37965,0,0,deny,62,62,0,1,0,1,0
50392,445,0,0,drop,70,70,0,1,0,1,0
51164,64147,0,0,deny,66,66,0,1,0,1,0
56376,80,29400,80,allow,1635,945,690,15,72,8,7
62257,2767,0,0,deny,66,66,0,1,0,1,0
61002,37965,0,0,deny,145,145,0,1,0,1,0
53598,40326,59380,40326,allow,70,70,0,1,4,1,0
62431,445,0,0,drop,70,70,0,1,0,1,0
50937,445,0,0,drop,70,70,0,1,0,1,0
56819,53,59960,53,allow,202,103,99,2,31,1,1
57577,443,53525,443,allow,4752,2561,2191,32,256,16,16
50629,80,50629,80,allow,6210,2976,3234,16,20,9,7
5588,5588,0,0,allow,3498,1872,1626,48,205,24,24
56601,443,39654,443,allow,8978,3243,5735,22,45,13,9
50319,53,7677,53,allow,814,110,704,2,30,1,1
64424,53,30245,53,allow,211,102,109,2,30,1,1
49671,53,37210,53,allow,182,93,89,2,31,1,1
5228,3434,0,0,deny,345,345,0,1,0,1,0
55376,445,0,0,drop,70,70,0,1,0,1,0
38101,443,38674,443,allow,190,70,120,4,15,2,2
60043,445,0,0,drop,70,70,0,1,0,1,0
55606,445,0,0,drop,66,66,0,1,0,1,0
27005,27015,65390,27015,allow,891,126,765,2,31,1,1
55744,445,0,0,drop,70,70,0,1,0,1,0
39851,443,44930,443,allow,9355,3422,5933,56,16,28,28
58718,80,58718,80,allow,106571,3881,102690,128,16,56,72
55360,443,39812,443,allow,6379,1762,4617,27,27,14,13
60073,80,45095,80,allow,10676,6719,3957,23,141,12,11
50388,53,36843,53,allow,177,94,83,2,30,1,1
65276,53,64809,53,allow,195,86,109,2,30,1,1
6587,22114,0,0,deny,146,146,0,1,0,1,0
56424,53,24013,53,allow,711,87,624,2,0,1,1
64024,22114,0,0,deny,66,66,0,1,0,1,0
49333,443,8337,443,allow,50226,4284,45942,76,75,31,45
46831,53,55820,53,allow,391,102,289,2,30,1,1
62051,11392,0,0,deny,66,66,0,1,0,1,0
54361,445,0,0,drop,70,70,0,1,0,1,0
1660,8696,0,0,deny,62,62,0,1,0,1,0
38961,443,19720,443,allow,67063,17409,49654,94,274,48,46
53204,445,0,0,drop,70,70,0,1,0,1,0
55677,445,0,0,drop,70,70,0,1,0,1,0
64619,53,54626,53,allow,174,89,85,2,31,1,1
58638,5900,0,0,deny,62,62,0,1,0,1,0
49522,53,16817,53,allow,688,185,503,6,45,3,3
62197,445,0,0,drop,70,70,0,1,0,1,0
64583,53,25231,53,allow,174,89,85,2,30,1,1
33305,54532,0,0,deny,60,60,0,1,0,1,0
53589,445,0,0,drop,70,70,0,1,0,1,0
65452,53,19191,53,allow,196,102,94,2,30,1,1
51443,445,0,0,drop,66,66,0,1,0,1,0
27005,27019,20474,27019,allow,2024,504,1520,7,33,5,2
49407,53,35774,53,allow,774,101,673,2,30,1,1
65008,445,0,0,drop,66,66,0,1,0,1,0
64592,53,31524,53,allow,209,110,99,2,30,1,1
64364,53,34718,53,allow,323,110,213,2,30,1,1
49194,65100,3468,65100,allow,624,318,306,10,15,5,5
55112,53,21380,53,allow,245,94,151,2,30,1,1
64539,53,12093,53,allow,177,94,83,2,30,1,1
55939,53,43027,53,allow,193,102,91,2,30,1,1
60802,445,0,0,drop,70,70,0,1,0,1,0
37965,63728,43778,63728,allow,1294,594,700,20,1781,10,10
58755,53,43262,53,allow,277,102,175,2,30,1,1
3996,57470,0,0,deny,62,62,0,1,0,1,0
61682,80,36902,80,allow,1804,884,920,12,49,6,6
64733,35440,0,0,deny,62,62,0,1,0,1,0
60426,80,65008,80,allow,4515,3889,626,11,27,6,5
55513,53,1888,53,allow,184,94,90,2,30,1,1
64976,53,53844,53,allow,193,102,91,2,29,1,1
65121,443,49060,443,allow,11416,4745,6671,45,256,22,23
53559,445,0,0,drop,70,70,0,1,0,1,0
64482,64147,0,0,deny,62,62,0,1,0,1,0
59847,443,26253,443,allow,11950,1590,10360,33,90,16,17
59049,53,37929,53,allow,199,94,105,2,30,1,1
10669,49756,0,0,deny,60,60,0,1,0,1,0
26573,44847,0,0,deny,66,66,0,1,0,1,0
54243,445,0,0,drop,70,70,0,1,0,1,0
52705,80,52705,80,allow,7237,2578,4659,19,16,9,10
51502,443,28500,443,allow,10204,5034,5170,45,16,25,20
64579,53,56844,53,allow,178,94,84,2,30,1,1
49406,445,0,0,drop,70,70,0,1,0,1,0
57092,53,22566,53,allow,756,95,661,2,31,1,1
53145,44634,28253,44634,allow,70,70,0,2,8,2,0
51052,53,0,0,allow,82,82,0,1,30,1,0
51581,17546,0,0,deny,66,66,0,1,0,1,0
64056,51266,3673,51266,allow,66,66,0,1,5,1,0
56418,41615,0,0,deny,143,143,0,1,0,1,0
56523,443,55087,443,allow,8130,2093,6037,17,120,9,8
33846,443,41735,443,allow,7760,2646,5114,24,16,13,11
56380,36829,0,0,deny,66,66,0,1,0,1,0
49418,57470,0,0,deny,66,66,0,1,0,1,0
49253,53,0,0,allow,218,78,140,2,30,1,1
48272,15000,32471,15000,allow,130,70,60,2,5,1,1
57275,443,6369,443,allow,22074,3005,19069,58,31,31,27
58860,53,53609,53,allow,209,102,107,2,29,1,1
43093,443,25301,443,allow,7028,2558,4470,19,16,11,8
56883,445,0,0,drop,66,66,0,1,0,1,0
60251,445,0,0,drop,66,66,0,1,0,1,0
9204,443,60040,443,allow,5399,368,5031,18,31,5,13
50594,25174,0,0,deny,66,66,0,1,0,1,0
56842,24233,12414,24233,allow,70,70,0,2,8,2,0
35499,443,34865,443,allow,2270,1303,967,20,102,11,9
45912,443,22419,443,allow,4306,1107,3199,17,30,9,8
9402,53,9402,53,allow,237,91,146,2,32,1,1
56633,53,19316,53,allow,197,102,95,2,30,1,1
49888,53,58972,53,allow,363,97,266,4,34,2,2
27005,27015,9469,27015,allow,887,126,761,2,30,1,1
34809,57470,0,0,deny,66,66,0,1,0,1,0
48230,57866,0,0,deny,146,146,0,1,0,1,0
55690,53,37274,53,allow,183,94,89,2,30,1,1
28370,35440,0,0,deny,66,66,0,1,0,1,0
65141,445,0,0,drop,70,70,0,1,0,1,0
56161,53,4993,53,allow,817,102,715,2,30,1,1
49226,53,3367,53,allow,194,102,92,2,30,1,1
35519,80,60080,80,allow,841,715,126,5,15,3,2
53934,48339,61953,48339,allow,320,140,180,6,6,3,3
55654,443,49899,443,allow,186406,10415,175991,218,123,79,139
63675,445,0,0,drop,66,66,0,1,0,1,0
53050,445,0,0,drop,70,70,0,1,0,1,0
60488,27615,38598,27615,allow,70,70,0,1,5,1,0
56995,53,58865,53,allow,168,86,82,2,31,1,1
53759,40826,3442,40826,allow,492,306,186,8,15,5,3
55690,54233,5574,54233,allow,320,140,180,6,6,3,3
65450,445,0,0,drop,66,66,0,1,0,1,0
27005,33086,33799,33086,allow,877,126,751,2,30,1,1
51317,443,51634,443,allow,59889,7472,52417,83,145,32,51
57470,40870,29859,40870,allow,535,163,372,2,1200,1,1
1319,443,12846,443,allow,448,256,192,8,25,5,3
62486,443,21615,443,allow,10390,7057,3333,27,33,15,12
44992,80,44992,80,allow,2091,1642,449,10,20,6,4
56101,53,64581,53,allow,194,102,92,2,30,1,1
60788,40010,33720,40010,allow,316,136,180,6,5,3,3
36262,443,11222,443,allow,678861,22499,656362,749,19,290,459
49008,53,13913,53,allow,168,78,90,2,29,1,1
55831,53,4843,53,allow,183,94,89,2,30,1,1
56562,53,4746,53,allow,183,94,89,2,29,1,1
58228,53733,0,0,deny,66,66,0,1,0,1,0
55082,445,0,0,drop,66,66,0,1,0,1,0
25889,11446,0,0,deny,62,62,0,1,0,1,0
64473,53,39348,53,allow,184,94,90,2,31,1,1
55036,445,0,0,drop,66,66,0,1,0,1,0
65413,445,0,0,drop,70,70,0,1,0,1,0
55826,42771,0,0,deny,66,66,0,1,0,1,0
49743,445,0,0,drop,70,70,0,1,0,1,0
50153,445,0,0,drop,66,66,0,1,0,1,0
54464,56205,0,0,deny,66,66,0,1,0,1,0
57923,443,34874,443,allow,13736,1702,12034,26,15,12,14
65400,36237,0,0,deny,66,66,0,1,0,1,0
50407,53,51161,53,allow,749,89,660,2,31,1,1
49687,53,13204,53,allow,197,102,95,2,31,1,1
56467,53,49050,53,allow,578,286,292,9,15,5,4
50278,443,50420,443,allow,36958,2966,33992,48,120,18,30
53227,443,53227,443,allow,4107,2486,1621,20,24,10,10
49724,53,47705,53,allow,183,94,89,2,30,1,1
14397,37965,0,0,deny,62,62,0,1,0,1,0
49195,8108,11315,8108,allow,70,70,0,2,8,2,0
55244,53,5418,53,allow,186,102,84,2,29,1,1
443,64347,0,0,deny,131,131,0,1,0,1,0
49781,53,31272,53,allow,194,102,92,2,29,1,1
58473,445,0,0,drop,70,70,0,1,0,1,0
36983,80,48738,80,allow,1143,401,742,9,360,5,4
37191,48817,0,0,deny,159,159,0,1,0,1,0
26048,21,0,0,deny,60,60,0,1,0,1,0
53689,42719,50216,42719,allow,70,70,0,1,4,1,0
50278,443,46463,443,allow,6466,2862,3604,21,163,11,10
56673,53,38951,53,allow,183,94,89,2,30,1,1
27005,32039,29232,32039,allow,883,126,757,2,31,1,1
50925,445,0,0,drop,66,66,0,1,0,1,0
49310,53,42489,53,allow,816,102,714,2,30,1,1
63676,445,0,0,drop,70,70,0,1,0,1,0
34897,50584,0,0,deny,62,62,0,1,0,1,0
5753,65473,0,0,deny,146,146,0,1,0,1,0
54779,50584,0,0,deny,66,66,0,1,0,1,0
64038,445,0,0,drop,66,66,0,1,0,1,0
53366,53,53366,53,allow,237,98,139,2,30,1,1
64931,53,5623,53,allow,179,94,85,2,30,1,1
63419,53,63419,53,allow,216,90,126,2,30,1,1
50691,80,62082,80,allow,4237,3610,627,15,31,8,7
57349,445,0,0,drop,70,70,0,1,0,1,0
52432,50265,0,0,deny,66,66,0,1,0,1,0
65139,53,54576,53,allow,443,182,261,6,30,3,3
43563,80,9467,80,allow,10597,2910,7687,24,47,14,10
3803,51505,0,0,deny,62,62,0,1,0,1,0
52133,445,0,0,drop,70,70,0,1,0,1,0
59230,445,0,0,drop,70,70,0,1,0,1,0
33856,443,15583,443,allow,7298,2661,4637,21,21,11,10
56102,53,3387,53,allow,757,98,659,2,0,1,1
52160,445,0,0,drop,70,70,0,1,0,1,0
65425,80,38267,80,allow,366,180,186,7,29,4,3
55463,53,39462,53,allow,816,102,714,2,29,1,1
37420,443,37420,443,allow,4624,1717,2907,19,27,11,8
30584,53,30584,53,allow,241,98,143,2,30,1,1
64749,53,21766,53,allow,227,110,117,2,30,1,1
35654,80,35654,80,allow,7040,5744,1296,16,158,9,7
56492,53,62080,53,allow,184,94,90,2,30,1,1
55580,53,57711,53,allow,195,102,93,2,31,1,1
55157,7302,0,0,deny,66,66,0,1,0,1,0
62637,42873,0,0,deny,66,66,0,1,0,1,0
39716,443,56404,443,allow,131171,10346,120825,183,150,93,90
58363,443,44841,443,allow,46992,4773,42219,89,160,36,53
49334,53,14859,53,allow,184,94,90,2,30,1,1
58751,9571,0,0,deny,62,62,0,1,0,1,0
60609,445,0,0,drop,70,70,0,1,0,1,0
50642,53,60676,53,allow,173,94,79,2,30,1,1
49364,53,25963,53,allow,307,307,0,4,61,4,0
50784,52952,0,0,deny,66,66,0,1,0,1,0
56528,443,48835,443,allow,158084,6138,151946,173,95,64,109
60300,445,0,0,drop,70,70,0,1,0,1,0
26944,443,13934,443,allow,6861,2224,4637,19,19,9,10
1356,57470,0,0,deny,72,72,0,1,0,1,0
62506,443,7984,443,allow,1326,876,450,11,32,6,5
63935,445,0,0,drop,66,66,0,1,0,1,0
63717,445,0,0,drop,66,66,0,1,0,1,0
61468,443,50536,443,allow,6265,1185,5080,24,89,14,10
53685,53,0,0,allow,547,97,450,4,40,2,2
64387,53,16161,53,allow,359,99,260,4,54,2,2
64546,57470,0,0,deny,66,66,0,1,0,1,0
57558,443,4202,443,allow,42986,7555,35431,69,125,29,40
51376,445,0,0,drop,70,70,0,1,0,1,0
56624,443,34630,443,allow,7940,1951,5989,20,16,11,9
64662,445,0,0,drop,66,66,0,1,0,1,0
23980,53,23980,53,allow,220,100,120,2,31,1,1
56634,443,30287,443,allow,8654,2150,6504,20,15,11,9
9708,53,0,0,allow,304,94,210,2,30,1,1
45373,443,33904,443,allow,33357,26315,7042,65,273,38,27
33896,57470,0,0,deny,74,74,0,1,0,1,0
51940,445,0,0,drop,66,66,0,1,0,1,0
64775,443,64775,443,allow,4559,1652,2907,19,27,11,8
55273,53,48247,53,allow,197,94,103,2,30,1,1
62620,445,0,0,drop,66,66,0,1,0,1,0
45119,443,36541,443,allow,5082,969,4113,18,30,10,8
59861,445,0,0,drop,70,70,0,1,0,1,0
50265,49083,4910,49083,allow,132,132,0,3,1200,3,0
39888,443,38398,443,allow,1964,1171,793,20,25,11,9
26900,27017,64702,27017,allow,422,164,258,6,30,3,3
52333,445,0,0,drop,70,70,0,1,0,1,0
60473,8765,52424,8765,allow,1370,750,620,21,329,11,10
51348,25174,0,0,deny,66,66,0,1,0,1,0
53979,443,21511,443,allow,3566,871,2695,11,120,5,6
53914,443,31627,443,allow,499,425,74,4,0,3,1
32679,37965,0,0,deny,62,62,0,1,0,1,0
61917,445,0,0,drop,66,66,0,1,0,1,0
55830,443,44368,443,allow,62,62,0,1,5,1,0
27366,5222,55342,5222,allow,3833,1007,2826,27,68,11,16
52647,443,40426,443,allow,46502,33690,12812,93,234,55,38
56880,53,14600,53,allow,216,102,114,2,30,1,1
60185,445,0,0,drop,70,70,0,1,0,1,0
6881,6889,7381,6889,allow,228,118,110,2,1200,1,1
54972,80,43170,80,allow,1074,691,383,12,66,7,5
1024,64147,0,0,deny,62,62,0,1,0,1,0
60364,445,0,0,drop,66,66,0,1,0,1,0
61613,445,0,0,drop,66,66,0,1,0,1,0
60297,25604,0,0,deny,62,62,0,1,0,1,0
38851,443,9016,443,allow,5993,2348,3645,15,120,8,7
55358,445,0,0,drop,70,70,0,1,0,1,0
25565,28739,0,0,deny,60,60,0,1,0,1,0
49969,53,54536,53,allow,356,105,251,4,49,2,2
58638,5900,0,0,deny,62,62,0,1,0,1,0
27005,27016,42013,27016,allow,893,126,767,2,31,1,1
55417,53,40418,53,allow,179,94,85,2,30,1,1
27005,27017,53290,27017,allow,881,126,755,2,31,1,1
51313,64147,0,0,deny,66,66,0,1,0,1,0
56418,53,28996,53,allow,183,94,89,2,31,1,1
41907,53,41907,53,allow,233,90,143,2,33,1,1
36776,443,7923,443,allow,2866,1674,1192,14,15,8,6
27005,27020,4875,27020,allow,898,126,772,2,30,1,1
61483,443,51261,443,allow,107901,5004,102897,127,46,53,74
11136,15503,0,0,deny,62,62,0,1,0,1,0
63916,445,0,0,drop,70,70,0,1,0,1,0
62064,443,63626,443,allow,11582,2503,9079,33,47,17,16
55485,53,55524,53,allow,720,94,626,2,29,1,1
64380,53,44055,53,allow,98,98,0,1,30,1,0
63750,63343,38388,63343,allow,66,66,0,2,8,2,0
54121,25174,0,0,deny,62,62,0,1,0,1,0
57470,64738,24802,64738,allow,1577,594,983,20,1582,10,10
6824,26467,0,0,deny,62,62,0,1,0,1,0
49855,53,31460,53,allow,170,87,83,2,30,1,1
62571,445,0,0,drop,70,70,0,1,0,1,0
59966,443,53241,443,allow,7165,1312,5853,22,16,12,10
56710,53,52813,53,allow,177,94,83,2,30,1,1
57514,53,51498,53,allow,168,78,90,2,30,1,1
56575,445,0,0,drop,70,70,0,1,0,1,0
52151,30692,2893,30692,allow,70,70,0,2,8,2,0
49913,443,1275,443,allow,4275,2222,2053,24,15,14,10
44285,25174,0,0,deny,62,62,0,1,0,1,0
50792,443,51398,443,allow,144115,19017,125098,229,400,112,117
35092,22,0,0,deny,60,60,0,1,0,1,0
50296,445,0,0,drop,66,66,0,1,0,1,0
44690,443,54599,443,allow,1648,813,835,17,185,9,8
37600,443,40571,443,allow,19917,8751,11166,51,56,32,19
49663,53,65385,53,allow,195,102,93,2,30,1,1
62916,993,58185,993,allow,8832,3647,5185,77,41,35,42
56624,443,23164,443,allow,8536,3817,4719,25,20,15,10
57074,53,22735,53,allow,195,102,93,2,30,1,1
58365,5900,0,0,deny,60,60,0,1,0,1,0
49841,445,0,0,drop,66,66,0,1,0,1,0
12549,50265,0,0,deny,146,146,0,1,0,1,0
43634,80,30485,80,allow,1151,711,440,10,15,5,5
53160,443,52369,443,allow,2738,1904,834,18,28,10,8
1734,80,1734,80,allow,318813,10418,308395,314,95,102,212
54658,6881,23302,6881,allow,705,583,122,6,26,4,2
50974,11392,0,0,deny,66,66,0,1,0,1,0
49708,53,14475,53,allow,185,102,83,2,30,1,1
53481,443,12218,443,allow,5913,4482,1431,30,30,20,10
56540,445,0,0,drop,66,66,0,1,0,1,0
49598,80,32079,80,allow,372,192,180,7,41,4,3
47230,443,43067,443,allow,9930,3002,6928,34,120,17,17
49602,80,16412,80,allow,378,192,186,7,41,4,3
51314,445,0,0,drop,66,66,0,1,0,1,0
60380,443,36908,443,allow,24243,17180,7063,52,97,33,19
56913,53,30099,53,allow,772,103,669,2,31,1,1
57676,64147,0,0,deny,74,74,0,1,0,1,0
49249,445,0,0,drop,70,70,0,1,0,1,0
58638,5900,58638,5900,allow,126,62,64,2,5,1,1
42298,40022,27294,40022,allow,156,94,62,2,30,1,1
64124,443,56676,443,allow,1411,852,559,13,25,7,6
50527,80,17326,80,allow,261781,16421,245360,330,156,137,193
61474,445,0,0,drop,70,70,0,1,0,1,0
63915,445,0,0,drop,70,70,0,1,0,1,0
50969,80,54293,80,allow,921711,12229,909482,780,37,172,608
59728,53,43809,53,allow,304,86,218,2,30,1,1
62885,62413,0,0,deny,62,62,0,1,0,1,0
59710,445,0,0,drop,66,66,0,1,0,1,0
23560,53,25867,53,allow,219,86,133,2,30,1,1
52152,58114,40189,58114,allow,70,70,0,2,8,2,0
1066,16464,0,0,deny,60,60,0,1,0,1,0
50234,53,13512,53,allow,242,78,164,2,30,1,1
58453,50584,0,0,deny,66,66,0,1,0,1,0
57982,445,0,0,drop,70,70,0,1,0,1,0
65367,53,6408,53,allow,251,94,157,2,30,1,1
7889,48817,0,0,deny,146,146,0,1,0,1,0
65442,53,27260,53,allow,760,97,663,2,31,1,1
64588,53,37209,53,allow,186,95,91,2,31,1,1
49993,443,14877,443,allow,14857,1138,13719,26,17,10,16
56381,53,54551,53,allow,196,102,94,2,30,1,1
46641,8100,2386,8100,allow,78,78,0,1,4,1,0
49891,53,46766,53,allow,199,102,97,2,30,1,1
52537,445,0,0,drop,66,66,0,1,0,1,0
49594,53,49594,53,allow,199,90,109,2,30,1,1
58225,443,29188,443,allow,2484,330,2154,12,135,5,7
53683,443,41886,443,allow,9880,1687,8193,23,15,12,11
58331,443,26953,443,allow,31515,26798,4717,91,82,49,42
50728,27029,42888,27029,allow,269,78,191,2,31,1,1
49240,53,28241,53,allow,198,101,97,2,30,1,1
51706,25174,0,0,deny,66,66,0,1,0,1,0
49439,443,14852,443,allow,9495,2281,7214,22,78,11,11
58932,80,50607,80,allow,2424,529,1895,11,75,6,5
11136,19910,0,0,deny,62,62,0,1,0,1,0
57470,6881,5972,6881,allow,755,275,480,4,1200,2,2
49234,53,23533,53,allow,206,97,109,2,30,1,1
51635,50265,0,0,deny,66,66,0,1,0,1,0
64589,53,62557,53,allow,814,110,704,2,29,1,1
64417,53,46438,53,allow,184,94,90,2,31,1,1
26900,27017,41644,27017,allow,422,164,258,6,30,3,3
60887,445,0,0,drop,70,70,0,1,0,1,0
60219,80,48945,80,allow,1987,1593,394,10,151,6,4
64133,53,49082,53,allow,225,110,115,2,30,1,1
54605,445,0,0,drop,66,66,0,1,0,1,0
52115,443,22081,443,allow,11551,3870,7681,29,37,16,13
56015,53,39973,53,allow,195,102,93,2,30,1,1
3764,9694,0,0,deny,66,66,0,1,0,1,0
49184,53,41219,53,allow,199,94,105,2,30,1,1
41332,80,41332,80,allow,230861,5063,225798,227,18,74,153
55478,53,54641,53,allow,177,94,83,2,30,1,1
64934,445,0,0,drop,66,66,0,1,0,1,0
56586,53,6320,53,allow,170,87,83,2,30,1,1
49593,445,0,0,drop,70,70,0,1,0,1,0
10914,35974,0,0,deny,60,60,0,1,0,1,0
55375,445,0,0,drop,70,70,0,1,0,1,0
32974,37965,0,0,deny,66,66,0,1,0,1,0
64011,443,26030,443,allow,4196,1407,2789,19,135,9,10
47903,443,31427,443,allow,9323,2192,7131,25,25,13,12
57243,53,28936,53,allow,168,78,90,2,30,1,1
5831,22114,0,0,deny,62,62,0,1,0,1,0
62469,445,0,0,drop,70,70,0,1,0,1,0
55559,53,6941,53,allow,182,94,88,2,29,1,1
63719,445,0,0,drop,70,70,0,1,0,1,0
33638,443,11926,443,allow,1784,1010,774,16,185,9,7
64986,53,51778,53,allow,734,94,640,2,29,1,1
53199,30188,0,0,deny,66,66,0,1,0,1,0
56590,25174,0,0,deny,66,66,0,1,0,1,0
53590,8999,22601,8999,allow,1207,605,602,10,25,5,5
50584,51651,64737,51651,allow,166,166,0,1,1200,1,0
63574,445,0,0,drop,70,70,0,1,0,1,0
50294,80,24616,80,allow,1515,481,1034,11,15,6,5
38862,443,38862,443,allow,23553,2583,20970,46,103,19,27
53194,443,63620,443,allow,1462,965,497,13,18,7,6
53911,443,51915,443,allow,499,425,74,4,0,3,1
61428,443,21919,443,allow,7276,1763,5513,22,77,12,10
56236,443,26673,443,allow,9597,2488,7109,32,287,16,16
41322,443,26107,443,allow,6332,944,5388,19,66,10,9
55082,25174,0,0,deny,66,66,0,1,0,1,0
39119,44847,0,0,deny,62,62,0,1,0,1,0
62071,22114,0,0,deny,62,62,0,1,0,1,0
60006,443,38577,443,allow,185169,75281,109888,426,111,209,217
3578,51505,0,0,deny,62,62,0,1,0,1,0
51746,25174,0,0,deny,66,66,0,1,0,1,0
65419,26467,0,0,deny,62,62,0,1,0,1,0
51692,993,54748,993,allow,11462,4282,7180,61,37,28,33
55185,53,27754,53,allow,758,93,665,2,30,1,1
18061,25174,0,0,deny,62,62,0,1,0,1,0
59877,80,9809,80,allow,1306,557,749,10,25,6,4
50119,443,44388,443,allow,10557,2063,8494,40,144,22,18
57307,53,57558,53,allow,170,87,83,2,31,1,1
56195,445,0,0,drop,66,66,0,1,0,1,0
55578,445,0,0,drop,70,70,0,1,0,1,0
57048,445,0,0,drop,70,70,0,1,0,1,0
1880,57470,0,0,deny,146,146,0,1,0,1,0
53144,445,0,0,drop,70,70,0,1,0,1,0
16660,55783,0,0,deny,62,62,0,1,0,1,0
52987,445,0,0,drop,70,70,0,1,0,1,0
64380,53,5955,53,allow,193,102,91,2,30,1,1
63956,44512,0,0,deny,145,145,0,1,0,1,0
56574,443,27778,443,allow,75732,15030,60702,137,138,56,81
55690,53,57021,53,allow,183,94,89,2,30,1,1
2267,53,3037,53,allow,826,826,0,8,44,8,0
17232,22114,0,0,deny,62,62,0,1,0,1,0
56816,53,22918,53,allow,233,94,139,2,30,1,1
63988,53,39055,53,allow,190,97,93,2,30,1,1
50584,6881,63450,6881,allow,1320,300,1020,6,1200,3,3
64850,53,42650,53,allow,192,98,94,2,31,1,1
54315,445,0,0,drop,66,66,0,1,0,1,0
61700,443,65174,443,allow,12613,2946,9667,38,50,18,20
63390,445,0,0,drop,70,70,0,1,0,1,0
51918,27015,0,0,deny,67,67,0,1,0,1,0
53823,25291,38093,25291,allow,320,140,180,6,6,3,3
45394,80,27437,80,allow,4886,1260,3626,17,17,10,7
63980,445,0,0,drop,70,70,0,1,0,1,0
52526,30188,0,0,deny,66,66,0,1,0,1,0
49402,53,15984,53,allow,185,102,83,2,31,1,1
57990,445,0,0,drop,66,66,0,1,0,1,0
60032,445,0,0,drop,66,66,0,1,0,1,0
59735,443,11235,443,allow,512,166,346,2,29,1,1
64934,53,9879,53,allow,216,94,122,2,30,1,1
58547,53,0,0,allow,86,86,0,1,29,1,0
443,60082,0,0,deny,74,74,0,1,0,1,0
25031,25174,0,0,deny,62,62,0,1,0,1,0
49642,53,3732,53,allow,302,110,192,2,30,1,1
63643,445,0,0,drop,66,66,0,1,0,1,0
36943,10387,0,0,deny,159,159,0,1,0,1,0
58075,445,0,0,drop,70,70,0,1,0,1,0
55078,443,55078,443,allow,4401,1494,2907,19,30,11,8
50369,50584,0,0,deny,66,66,0,1,0,1,0
56456,443,10392,443,allow,3528,1162,2366,10,120,5,5
54443,445,0,0,drop,66,66,0,1,0,1,0
55027,445,0,0,drop,70,70,0,1,0,1,0
20508,57470,0,0,deny,62,62,0,1,0,1,0
49940,53,29743,53,allow,197,94,103,2,29,1,1
51120,445,0,0,drop,66,66,0,1,0,1,0
65489,445,0,0,drop,70,70,0,1,0,1,0
44855,58414,0,0,deny,62,62,0,1,0,1,0
44847,43154,42931,43154,allow,150,150,0,1,1200,1,0
54145,443,52108,443,allow,118,118,0,1,120,1,0
2267,53,35610,53,allow,204,118,86,2,30,1,1
54982,53,58418,53,allow,282,96,186,4,47,2,2
30578,55783,0,0,deny,145,145,0,1,0,1,0
56066,53,20182,53,allow,212,110,102,2,30,1,1
50708,22114,0,0,deny,62,62,0,1,0,1,0
56472,53,44784,53,allow,177,94,83,2,30,1,1
52788,443,17904,443,allow,21915,3929,17986,40,31,23,17
49534,53,53329,53,allow,168,86,82,2,30,1,1
46849,36237,0,0,deny,66,66,0,1,0,1,0
61830,445,0,0,drop,70,70,0,1,0,1,0
56213,26467,0,0,deny,66,66,0,1,0,1,0
49363,53,19246,53,allow,212,110,102,2,29,1,1
36908,26467,0,0,deny,62,62,0,1,0,1,0
39453,15503,0,0,deny,74,74,0,1,0,1,0
61419,443,15902,443,allow,6661,862,5799,18,28,9,9
55260,53,35785,53,allow,183,94,89,2,30,1,1
63925,18912,65425,18912,allow,66,66,0,2,8,2,0
41650,443,33832,443,allow,6356,1857,4499,48,229,20,28
49838,53,31499,53,allow,183,94,89,2,31,1,1
443,62732,0,0,deny,332,332,0,1,0,1,0
39477,443,24151,443,allow,3655,2308,1347,18,15,10,8
64357,445,0,0,drop,70,70,0,1,0,1,0
58638,5900,0,0,deny,62,62,0,1,0,1,0
45964,2225,0,0,deny,60,60,0,1,0,1,0
51862,27758,53526,27758,allow,70,70,0,1,5,1,0
52887,37807,0,0,deny,66,66,0,1,0,1,0
52445,445,0,0,drop,70,70,0,1,0,1,0
58638,5900,0,0,deny,62,62,0,1,0,1,0
13462,35440,0,0,deny,66,66,0,1,0,1,0
54377,56205,0,0,deny,66,66,0,1,0,1,0
26124,56205,0,0,deny,146,146,0,1,0,1,0
50572,80,10361,80,allow,318,192,126,6,26,4,2
50507,445,0,0,drop,70,70,0,1,0,1,0
12821,37965,0,0,deny,66,66,0,1,0,1,0
51494,445,0,0,drop,66,66,0,1,0,1,0
56514,443,14098,443,allow,5084,969,4115,18,32,10,8
56617,53,16257,53,allow,286,94,192,2,30,1,1
17750,55265,61135,55265,allow,481,150,331,2,1200,1,1
55468,445,0,0,drop,70,70,0,1,0,1,0
50680,445,0,0,drop,66,66,0,1,0,1,0
57312,53,15531,53,allow,212,110,102,2,30,1,1
38450,443,40244,443,allow,9299,2445,6854,25,81,14,11
56334,53,41390,53,allow,767,102,665,2,31,1,1
63860,445,0,0,drop,70,70,0,1,0,1,0
60631,445,0,0,drop,70,70,0,1,0,1,0
56701,53,21171,53,allow,211,110,101,2,30,1,1
47150,9339,62687,9339,allow,179194,19657,159537,415,149,202,213
59146,445,0,0,drop,70,70,0,1,0,1,0
54550,445,0,0,drop,70,70,0,1,0,1,0
56510,443,37047,443,allow,8742,2483,6259,41,114,22,19
50018,3389,50018,3389,allow,3413,1458,1955,16,18,8,8
52488,443,19422,443,allow,7165,1099,6066,16,18,9,7
65438,443,60459,443,allow,572,320,252,10,28,6,4
55159,53,20403,53,allow,200,102,98,2,29,1,1
58638,5900,0,0,deny,62,62,0,1,0,1,0
61366,445,0,0,drop,70,70,0,1,0,1,0
57231,53,46027,53,allow,168,86,82,2,30,1,1
55991,53,53761,53,allow,182,93,89,2,30,1,1
34814,53,64232,53,allow,168,78,90,2,30,1,1
56410,443,52137,443,allow,16167,1392,14775,25,105,12,13
53754,53,53754,53,allow,257,114,143,2,30,1,1
53671,60416,42593,60416,allow,70,70,0,2,7,2,0
55630,53,24833,53,allow,197,102,95,2,30,1,1
54419,445,0,0,drop,70,70,0,1,0,1,0
57370,445,0,0,drop,70,70,0,1,0,1,0
60441,5900,0,0,deny,60,60,0,1,0,1,0
65451,53,43825,53,allow,172,88,84,2,31,1,1
64969,53,18068,53,allow,329,118,211,2,30,1,1
48817,14888,48817,14888,allow,481,150,331,2,1200,1,1
58146,445,0,0,drop,66,66,0,1,0,1,0
56374,53,38425,53,allow,770,102,668,2,31,1,1
56477,53,13759,53,allow,199,102,97,2,30,1,1
65285,50584,0,0,deny,66,66,0,1,0,1,0
57161,53,62554,53,allow,196,94,102,2,30,1,1
53637,443,7341,443,allow,8473,1099,7374,20,119,9,11
49433,53,38840,53,allow,167,86,81,2,30,1,1
3478,61463,0,0,deny,1275,1275,0,1,0,1,0
65388,80,37790,80,allow,1498,392,1106,10,16,5,5
22350,25174,0,0,deny,66,66,0,1,0,1,0
54934,445,0,0,drop,70,70,0,1,0,1,0
49383,53,63729,53,allow,226,110,116,2,30,1,1
13120,25174,0,0,deny,62,62,0,1,0,1,0
36108,8245,12106,8245,allow,280,214,66,2,29,1,1
24009,53,46041,53,allow,223,86,137,2,29,1,1
63864,44139,1189,44139,allow,66,66,0,2,7,2,0
51100,445,0,0,drop,70,70,0,1,0,1,0
50822,443,34134,443,allow,89322,8569,80753,102,316,31,71
64813,53,27372,53,allow,176,90,86,2,30,1,1
58496,53,58496,53,allow,204,92,112,2,30,1,1
56907,53,38903,53,allow,293,102,191,2,29,1,1
64016,53,54267,53,allow,183,94,89,2,30,1,1
53202,443,37949,443,allow,6043,1568,4475,11,120,4,7
59161,445,0,0,drop,70,70,0,1,0,1,0
55464,22114,0,0,deny,146,146,0,1,0,1,0
13285,29892,0,0,deny,145,145,0,1,0,1,0
63867,43618,62706,43618,allow,66,66,0,2,7,2,0
33992,53,33992,53,allow,462,158,304,4,30,2,2
57424,53,59355,53,allow,197,102,95,2,29,1,1
54944,445,0,0,drop,70,70,0,1,0,1,0
47910,7461,0,0,deny,60,60,0,1,0,1,0
56840,20413,2836,20413,allow,66,66,0,1,5,1,0
28809,50584,0,0,deny,66,66,0,1,0,1,0
49608,80,59432,80,allow,145752,3240,142512,128,61,23,105
50986,445,0,0,drop,70,70,0,1,0,1,0
56554,445,0,0,drop,70,70,0,1,0,1,0
50638,443,62460,443,allow,14401,2712,11689,52,19,23,29
2267,53,46205,53,allow,204,118,86,2,31,1,1
27005,12345,54236,12345,allow,898,126,772,2,30,1,1
56439,53,38034,53,allow,196,100,96,2,31,1,1
55245,53,25152,53,allow,193,102,91,2,30,1,1
61017,64147,0,0,deny,66,66,0,1,0,1,0
50288,445,0,0,drop,66,66,0,1,0,1,0
50514,443,24194,443,allow,11554,3028,8526,34,86,19,15
37095,443,45405,443,allow,1835,1190,645,17,26,10,7
49230,443,49230,443,allow,123041,10988,112053,185,67,86,99
52315,443,14653,443,allow,24304,2974,21330,57,34,31,26
55887,53,42850,53,allow,164,84,80,2,31,1,1
65323,53,20486,53,allow,193,102,91,2,30,1,1
55995,53,15590,53,allow,182,94,88,2,29,1,1
50426,445,0,0,drop,66,66,0,1,0,1,0
45374,80,46773,80,allow,806,463,343,9,15,6,3
49603,53,64849,53,allow,733,94,639,2,30,1,1
51895,445,0,0,drop,70,70,0,1,0,1,0
6890,11204,0,0,deny,146,146,0,1,0,1,0
60195,443,54821,443,allow,8894,1633,7261,18,15,9,9
55304,53,64050,53,allow,711,87,624,2,30,1,1
51320,37965,0,0,deny,62,62,0,1,0,1,0
64086,443,64086,443,allow,79107,10743,68364,96,172,42,54
14656,36237,0,0,deny,66,66,0,1,0,1,0
58029,443,3427,443,allow,1312,651,661,13,185,7,6
40521,23117,0,0,deny,66,66,0,1,0,1,0
1284,50584,0,0,deny,66,66,0,1,0,1,0
64024,57470,0,0,deny,66,66,0,1,0,1,0
50116,22,50116,22,allow,184,120,64,4,10,3,1
63787,18318,40020,18318,allow,66,66,0,2,8,2,0
56239,53,14198,53,allow,180,94,86,2,30,1,1
65303,53,28109,53,allow,94,94,0,1,29,1,0
63345,53,0,0,deny,75,75,0,1,0,1,0
50490,445,0,0,drop,66,66,0,1,0,1,0
56934,53,42274,53,allow,216,110,106,2,31,1,1
44236,80,40314,80,allow,2982,2565,417,12,15,7,5
62124,445,0,0,drop,70,70,0,1,0,1,0
64216,53,11505,53,allow,182,93,89,2,30,1,1
60398,46776,0,0,deny,74,74,0,1,0,1,0
60987,445,0,0,drop,70,70,0,1,0,1,0
60705,443,45671,443,allow,24145,5933,18212,55,549,27,28
43499,443,52568,443,allow,9685,2330,7355,23,15,12,11
64605,25174,0,0,deny,62,62,0,1,0,1,0
58638,5900,0,0,deny,62,62,0,1,0,1,0
64004,48339,32132,48339,allow,70,70,0,1,4,1,0
56951,53,9479,53,allow,199,102,97,2,30,1,1
54460,445,0,0,drop,66,66,0,1,0,1,0
22036,44847,0,0,deny,146,146,0,1,0,1,0
53164,443,44686,443,allow,38442,16213,22229,67,46,30,37
44099,443,28525,443,allow,6235,1562,4673,21,191,12,9
59789,443,5705,443,allow,6695,2021,4674,23,45,11,12
65497,53,55657,53,allow,197,102,95,2,29,1,1
50121,53,5203,53,allow,152,78,74,2,30,1,1
45119,443,35597,443,allow,2227,1018,1209,17,16,8,9
60400,56243,28136,56243,allow,70,70,0,2,8,2,0
49621,443,55607,443,allow,46983,4167,42816,66,44,28,38
52732,80,5693,80,allow,23509,14666,8843,70,553,38,32
6712,161,0,0,deny,82,82,0,1,0,1,0
50197,64147,0,0,deny,62,62,0,1,0,1,0
53744,10030,43880,10030,allow,320,140,180,6,5,3,3
59935,445,0,0,drop,70,70,0,1,0,1,0
45632,443,51632,443,allow,55844,3452,52392,85,255,38,47
55216,445,0,0,drop,70,70,0,1,0,1,0
56272,443,56272,443,allow,4550,1643,2907,19,28,11,8
60479,25174,0,0,deny,66,66,0,1,0,1,0
61357,64147,0,0,deny,62,62,0,1,0,1,0
34932,38608,0,0,deny,62,62,0,1,0,1,0
49488,53,28678,53,allow,194,102,92,2,31,1,1
56249,445,0,0,drop,70,70,0,1,0,1,0
56333,53,17825,53,allow,199,102,97,2,30,1,1
46461,53,27823,53,allow,199,94,105,2,30,1,1
49820,53,29495,53,allow,193,102,91,2,31,1,1
62458,53,43371,53,allow,429,102,327,2,31,1,1
56143,53,50780,53,allow,177,94,83,2,30,1,1
42231,57470,0,0,deny,78,78,0,1,0,1,0
51633,80,4651,80,allow,502,256,246,9,39,5,4
993,54634,0,0,allow,66,66,0,1,90,1,0
36714,80,19257,80,allow,1792,703,1089,12,16,7,5
58667,445,0,0,drop,70,70,0,1,0,1,0
51443,443,36286,443,allow,70,70,0,1,5,1,0
57968,53,57968,53,allow,371,237,134,3,32,2,1
61593,445,0,0,drop,66,66,0,1,0,1,0
49851,80,9497,80,allow,11936,2198,9738,22,88,9,13
52192,443,41129,443,allow,13948,1150,12798,29,15,14,15
54762,53,0,0,allow,86,86,0,1,30,1,0
49686,44847,0,0,deny,66,66,0,1,0,1,0
9997,53,9997,53,allow,235,90,145,2,32,1,1
55866,53,0,0,allow,86,86,0,1,30,1,0
64992,53,39214,53,allow,177,94,83,2,29,1,1
53555,445,0,0,drop,66,66,0,1,0,1,0
63996,443,19057,443,allow,122293139,3727246,118565893,125460,331,39649,85811
24838,39828,0,0,deny,60,60,0,1,0,1,0
58221,445,0,0,drop,70,70,0,1,0,1,0
57470,10154,49581,10154,allow,924,924,0,15,1200,15,0
53246,443,34451,443,allow,30174,2792,27382,47,323,19,28
52215,80,59875,80,allow,1009,506,503,10,16,5,5
56752,443,37907,443,allow,8007,1987,6020,20,15,11,9
57514,445,0,0,drop,70,70,0,1,0,1,0
64112,53,32226,53,allow,281,94,187,2,30,1,1
2267,53,18938,53,allow,204,118,86,2,30,1,1
58249,443,38085,443,allow,4192,2267,1925,12,120,6,6
55033,53,37383,53,allow,182,94,88,2,31,1,1
5826,26467,0,0,deny,62,62,0,1,0,1,0
38281,37807,0,0,deny,62,62,0,1,0,1,0
23131,25174,0,0,deny,62,62,0,1,0,1,0
63064,443,24318,443,allow,12008,2367,9641,32,151,18,14
61227,445,0,0,drop,70,70,0,1,0,1,0
49820,445,0,0,drop,70,70,0,1,0,1,0
55231,443,25575,443,allow,10684454,328574,10355880,11599,77,3693,7906
60382,445,0,0,drop,70,70,0,1,0,1,0
55043,57470,0,0,deny,78,78,0,1,0,1,0
55705,53,14171,53,allow,209,110,99,2,30,1,1
50554,443,37415,443,allow,7343,1707,5636,26,134,14,12
65251,53,48559,53,allow,198,101,97,2,30,1,1
5462,21247,0,0,deny,66,66,0,1,0,1,0
63049,443,56063,443,allow,384,166,218,2,30,1,1
53724,64923,63918,64923,allow,70,70,0,1,5,1,0
53330,443,46161,443,allow,3701,1232,2469,13,136,6,7
49948,53,31894,53,allow,755,102,653,2,30,1,1
34979,80,8756,80,allow,1150,465,685,14,268,5,9
49364,53,61056,53,allow,779,86,693,2,30,1,1
44334,26467,0,0,deny,62,62,0,1,0,1,0
55945,53,49702,53,allow,177,94,83,2,31,1,1
53372,445,0,0,drop,66,66,0,1,0,1,0
49234,53,56023,53,allow,177,94,83,2,30,1,1
50888,445,0,0,drop,70,70,0,1,0,1,0
51192,15503,0,0,deny,66,66,0,1,0,1,0
63027,445,0,0,drop,66,66,0,1,0,1,0
24624,443,24624,443,allow,5198,2221,2977,19,16,10,9
50644,443,24533,443,allow,1514,852,662,16,86,9,7
58712,80,8787,80,allow,4176,3453,723,14,15,7,7
34014,80,56105,80,allow,1951,731,1220,11,150,6,5
58638,5900,0,0,deny,62,62,0,1,0,1,0
30598,46824,0,0,deny,62,62,0,1,0,1,0
50323,80,57798,80,allow,2074,793,1281,11,48,6,5
50174,445,0,0,drop,70,70,0,1,0,1,0
2090,50265,0,0,deny,145,145,0,1,0,1,0
52092,80,65314,80,allow,3163,716,2447,12,28,7,5
49240,443,49240,443,allow,8448,3368,5080,25,48,15,10
49451,443,61379,443,allow,12802,1977,10825,32,25,14,18
58163,20005,0,0,deny,60,60,0,1,0,1,0
63307,445,0,0,drop,70,70,0,1,0,1,0
56951,53,25007,53,allow,198,101,97,2,31,1,1
58702,80,13752,80,allow,2424,529,1895,11,75,6,5
55439,53,11568,53,allow,177,94,83,2,30,1,1
58873,443,46096,443,allow,5166,700,4466,16,15,7,9
51554,443,48017,443,allow,4263,671,3592,14,75,8,6
8999,48817,0,0,deny,146,146,0,1,0,1,0
54699,53,18510,53,allow,236,86,150,2,30,1,1
56066,53,13837,53,allow,184,102,82,2,30,1,1
2083,7000,2083,7000,allow,3374,1535,1839,16,15,8,8
60152,26467,0,0,deny,62,62,0,1,0,1,0
54800,443,18015,443,allow,18814,10011,8803,42,129,21,21
61273,445,0,0,drop,70,70,0,1,0,1,0
65154,53,12899,53,allow,196,94,102,2,30,1,1
64926,53,21011,53,allow,166,86,80,2,31,1,1
49861,80,57112,80,allow,4892,1157,3735,16,89,8,8
50335,445,0,0,drop,66,66,0,1,0,1,0
55605,27274,38364,27274,allow,130,70,60,3,5,2,1
60416,445,0,0,drop,66,66,0,1,0,1,0
59582,53,61781,53,allow,256,102,154,2,29,1,1
59874,445,0,0,drop,66,66,0,1,0,1,0
59043,35440,0,0,deny,66,66,0,1,0,1,0
56427,53,42294,53,allow,166,86,80,2,30,1,1
54519,443,53980,443,allow,8413,2503,5910,23,16,13,10
50084,26672,0,0,deny,62,62,0,1,0,1,0
57172,53,10868,53,allow,196,102,94,2,31,1,1
64719,53,59437,53,allow,192,98,94,2,30,1,1
52344,445,0,0,drop,66,66,0,1,0,1,0
62512,25174,0,0,deny,146,146,0,1,0,1,0
7048,25174,0,0,deny,66,66,0,1,0,1,0
49399,53,15486,53,allow,775,102,673,2,30,1,1
65487,443,51445,443,allow,3641,886,2755,13,136,6,7
6881,6881,37501,6881,allow,259,150,109,2,1200,1,1
58344,53,58344,53,allow,847,110,737,2,30,1,1
38104,443,51062,443,allow,8884,4067,4817,24,19,11,13
52816,445,0,0,drop,66,66,0,1,0,1,0
53812,443,40871,443,allow,2966,801,2165,13,135,6,7
52184,22114,0,0,deny,66,66,0,1,0,1,0
56343,53,46504,53,allow,177,94,83,2,30,1,1
50478,51505,0,0,deny,62,62,0,1,0,1,0
50622,445,0,0,drop,66,66,0,1,0,1,0
65194,53,43835,53,allow,181,94,87,2,29,1,1
50744,443,22315,443,allow,6854,1380,5474,18,161,9,9
49364,53,17404,53,allow,307,307,0,4,60,4,0
53952,26973,12520,26973,allow,70,70,0,2,8,2,0
44121,23,0,0,deny,60,60,0,1,0,1,0
64304,53,40913,53,allow,1054,293,761,8,94,4,4
58928,443,59647,443,allow,6548,4210,2338,23,18,12,11
50989,445,0,0,drop,66,66,0,1,0,1,0
62579,57866,0,0,deny,66,66,0,1,0,1,0
64332,53,24629,53,allow,374,96,278,4,55,2,2
49201,443,23062,443,allow,13738,6378,7360,70,981,33,37
49448,443,34233,443,allow,1574,921,653,14,15,7,7
61803,445,0,0,drop,66,66,0,1,0,1,0
49297,443,47840,443,allow,5341,3636,1705,30,76,16,14
63442,445,0,0,drop,66,66,0,1,0,1,0
58929,445,0,0,drop,70,70,0,1,0,1,0
64716,53,5161,53,allow,718,94,624,2,30,1,1
54914,445,0,0,drop,70,70,0,1,0,1,0
56846,26665,12553,26665,allow,70,70,0,2,8,2,0
24144,57470,0,0,deny,62,62,0,1,0,1,0
56470,53,54674,53,allow,198,102,96,2,31,1,1
55323,53,20826,53,allow,178,94,84,2,30,1,1
58481,37838,0,0,deny,146,146,0,1,0,1,0
56343,443,34805,443,allow,350,210,140,6,27,4,2
55025,53,22515,53,allow,183,94,89,2,30,1,1
50347,53,8937,53,allow,756,95,661,2,30,1,1
56339,445,0,0,drop,70,70,0,1,0,1,0
65231,53,23789,53,allow,200,102,98,2,31,1,1
53709,445,0,0,drop,70,70,0,1,0,1,0
57002,53,38861,53,allow,731,85,646,2,30,1,1
51994,25509,12796,25509,allow,66,66,0,1,5,1,0
27005,27015,51372,27015,allow,884,126,758,2,30,1,1
52793,443,27629,443,allow,1942,1281,661,22,228,16,6
53300,443,53300,443,allow,4406,1499,2907,19,30,11,8
56819,443,59951,443,allow,79878,10479,69399,138,120,68,70
52609,18081,52609,18081,allow,66,66,0,1,5,1,0
58338,3369,0,0,deny,60,60,0,1,0,1,0
55077,53,49404,53,allow,394,94,300,2,30,1,1
56134,53,5515,53,allow,183,94,89,2,29,1,1
49879,80,2147,80,allow,2087,1215,872,8,88,5,3
65507,53,47508,53,allow,167,86,81,2,30,1,1
51733,445,0,0,drop,70,70,0,1,0,1,0
62111,35440,0,0,deny,66,66,0,1,0,1,0
58638,5900,0,0,deny,62,62,0,1,0,1,0
60395,443,53609,443,allow,10672,1729,8943,24,81,12,12
55293,445,0,0,drop,70,70,0,1,0,1,0
24608,53,24608,53,allow,209,77,132,2,33,1,1
57470,6881,64620,6881,allow,577,251,326,4,1200,2,2
64685,53,12212,53,allow,534,193,341,6,78,3,3
58177,445,0,0,drop,70,70,0,1,0,1,0
13285,29892,0,0,deny,145,145,0,1,0,1,0
51993,55279,27826,55279,allow,316,136,180,6,7,3,3
53230,445,0,0,drop,70,70,0,1,0,1,0
55966,57866,0,0,deny,62,62,0,1,0,1,0
59262,80,59262,80,allow,94514,14468,80046,152,15,41,111
61187,443,13311,443,allow,4862,1820,3042,14,120,7,7
50732,445,0,0,drop,70,70,0,1,0,1,0
55924,53,5985,53,allow,711,87,624,2,31,1,1
59789,443,29818,443,allow,103556,8767,94789,144,48,75,69
49418,30007,64637,30007,allow,242,71,171,2,30,1,1
50374,443,25596,443,allow,4749,859,3890,18,30,9,9
49534,80,31376,80,allow,1702,611,1091,8,30,4,4
8485,80,8485,80,allow,572,240,332,10,84,5,5
60633,445,0,0,drop,70,70,0,1,0,1,0
64051,53,14293,53,allow,430,172,258,6,60,3,3
40936,5900,0,0,deny,60,60,0,1,0,1,0
53960,61038,13704,61038,allow,552,306,246,9,14,5,4
51926,80,62359,80,allow,36720,3404,33316,51,25,22,29
56075,443,56807,443,allow,5640,3241,2399,22,120,11,11
50562,53,50562,53,allow,216,82,134,2,32,1,1
65304,53,31926,53,allow,195,102,93,2,29,1,1
52604,25174,0,0,deny,66,66,0,1,0,1,0
50232,443,24591,443,allow,7292,950,6342,19,75,9,10
51414,22,0,0,deny,60,60,0,1,0,1,0
55457,53,12461,53,allow,177,94,83,2,30,1,1
64615,445,0,0,drop,70,70,0,1,0,1,0
57261,445,0,0,drop,70,70,0,1,0,1,0
65513,53,15039,53,allow,195,102,93,2,31,1,1
50660,445,0,0,drop,66,66,0,1,0,1,0
49977,57470,0,0,deny,62,62,0,1,0,1,0
53139,50285,41730,50285,allow,320,140,180,6,6,3,3
62009,443,59530,443,allow,5017,1969,3048,14,136,7,7
50552,445,0,0,drop,66,66,0,1,0,1,0
53877,445,0,0,drop,66,66,0,1,0,1,0
62414,50584,0,0,deny,66,66,0,1,0,1,0
59617,443,31345,443,allow,5682,1565,4117,23,66,13,10
64116,53,59887,53,allow,177,94,83,2,31,1,1
46842,25174,0,0,deny,146,146,0,1,0,1,0
54347,443,29019,443,allow,9976,3230,6746,22,58,13,9
50862,443,25283,443,allow,1501,590,911,12,26,6,6
47091,15000,23609,15000,allow,138,78,60,2,6,1,1
56597,53,51184,53,allow,711,87,624,2,30,1,1
5881,53,5881,53,allow,231,90,141,2,31,1,1
52190,443,60064,443,allow,570322,21029,549293,569,46,181,388
46258,80,9234,80,allow,3711,1806,1905,17,186,10,7
21542,57470,0,0,deny,74,74,0,1,0,1,0
45941,23388,0,0,deny,60,60,0,1,0,1,0
57363,445,0,0,drop,70,70,0,1,0,1,0
65048,53,54954,53,allow,754,94,660,2,31,1,1
50975,80,19286,80,allow,24781,3304,21477,43,21,24,19
10169,80,10169,80,allow,450,246,204,8,24,5,3
54621,26296,0,0,deny,145,145,0,1,0,1,0
49418,27017,12752,27017,allow,283,71,212,2,31,1,1
56568,53,45144,53,allow,211,110,101,2,30,1,1
51410,443,1294,443,allow,619870,220857,399013,1045,123,531,514
49878,443,52783,443,allow,5997,978,5019,19,53,10,9
56994,445,0,0,drop,66,66,0,1,0,1,0
49817,443,20632,443,allow,4504,839,3665,16,125,8,8
44855,58414,0,0,deny,146,146,0,1,0,1,0
55001,445,0,0,drop,70,70,0,1,0,1,0
53448,445,0,0,drop,66,66,0,1,0,1,0
49511,443,49511,443,allow,150713,27113,123600,199,82,104,95
53661,445,0,0,drop,70,70,0,1,0,1,0
57019,53,54333,53,allow,193,102,91,2,30,1,1
56575,53,50705,53,allow,732,89,643,2,31,1,1
36803,53,44440,53,allow,243,86,157,2,30,1,1
53466,443,35377,443,allow,7866,2625,5241,25,120,11,14
45941,23386,0,0,deny,60,60,0,1,0,1,0
57636,80,57636,80,allow,147506,3521,143985,125,32,23,102
57470,31112,14070,31112,allow,132,132,0,3,1199,3,0
42298,40026,9867,40026,allow,212,90,122,4,30,2,2
55125,53,57418,53,allow,170,87,83,2,31,1,1
7978,50584,0,0,deny,66,66,0,1,0,1,0
51768,61765,18579,61765,allow,70,70,0,2,8,2,0
57711,445,0,0,drop,70,70,0,1,0,1,0
56962,53,40705,53,allow,177,94,83,2,31,1,1
49611,53,24146,53,allow,177,94,83,2,30,1,1
58638,5900,0,0,deny,62,62,0,1,0,1,0
9687,57470,0,0,deny,78,78,0,1,0,1,0
44774,22114,0,0,deny,62,62,0,1,0,1,0
40159,443,53282,443,allow,5360,4048,1312,22,265,11,11
22205,443,22205,443,allow,10793,2049,8744,23,30,14,9
62819,56205,0,0,deny,62,62,0,1,0,1,0
56334,53,19616,53,allow,177,94,83,2,30,1,1
34193,17,0,0,deny,60,60,0,1,0,1,0
52537,57866,0,0,deny,62,62,0,1,0,1,0
1025,46232,0,0,deny,145,145,0,1,0,1,0
53844,445,0,0,drop,70,70,0,1,0,1,0
54903,445,0,0,drop,70,70,0,1,0,1,0
23844,26467,0,0,deny,62,62,0,1,0,1,0
48368,443,5888,443,allow,9157,3805,5352,39,100,18,21
50711,80,56692,80,allow,708,384,324,12,195,7,5
49175,53,11847,53,allow,193,102,91,2,29,1,1
56453,37965,0,0,deny,66,66,0,1,0,1,0
9836,22114,0,0,deny,66,66,0,1,0,1,0
27005,27240,14670,27240,allow,868,126,742,2,31,1,1
56206,53,48081,53,allow,711,87,624,2,30,1,1
56624,443,46421,443,allow,12807,129,12678,13,147,2,11
65488,53,4906,53,allow,232,110,122,2,29,1,1
49772,80,25587,80,allow,1155,781,374,10,15,6,4
25328,23,0,0,deny,60,60,0,1,0,1,0
55610,23383,23402,23383,allow,70,70,0,2,8,2,0
55810,445,0,0,drop,66,66,0,1,0,1,0
53721,62413,0,0,deny,146,146,0,1,0,1,0
64276,26467,0,0,deny,66,66,0,1,0,1,0
61233,443,12202,443,allow,1775,169,1606,7,120,3,4
63980,53,48933,53,allow,225,102,123,2,30,1,1
60735,445,0,0,drop,70,70,0,1,0,1,0
1043,48817,0,0,deny,136,136,0,1,0,1,0
58638,5900,0,0,deny,62,62,0,1,0,1,0
27005,27017,51500,27017,allow,901,126,775,2,30,1,1
50996,443,8675,443,allow,3536,2039,1497,22,18,11,11
55966,35440,0,0,deny,66,66,0,1,0,1,0
55554,22114,0,0,deny,146,146,0,1,0,1,0
53629,445,0,0,drop,70,70,0,1,0,1,0
53437,6057,38097,6057,allow,245,245,0,2,30,2,0
53164,445,0,0,drop,66,66,0,1,0,1,0
51831,26270,32908,26270,allow,70,70,0,2,6,2,0
443,64347,0,0,deny,131,131,0,1,0,1,0
63859,80,37247,80,allow,314,192,122,6,15,4,2
37887,22114,0,0,deny,66,66,0,1,0,1,0
55066,80,57629,80,allow,2554,1742,812,15,77,8,7
55776,53,11095,53,allow,272,110,162,2,29,1,1
50711,80,19117,80,allow,1658,1247,411,8,15,5,3
60785,40010,47744,40010,allow,316,136,180,6,5,3,3
63981,53,63404,53,allow,198,101,97,2,30,1,1
52528,445,0,0,drop,66,66,0,1,0,1,0
40919,443,40161,443,allow,12243,6818,5425,30,314,16,14
51983,30472,23592,30472,allow,70,70,0,2,8,2,0
64407,53,18646,53,allow,232,110,122,2,29,1,1
61864,80,52616,80,allow,9747,537,9210,14,16,6,8
56455,445,0,0,drop,66,66,0,1,0,1,0
53773,443,19967,443,allow,499,425,74,4,0,3,1
57131,7774,0,0,deny,145,145,0,1,0,1,0
3478,61463,0,0,deny,1109,1109,0,1,0,1,0
51875,443,48033,443,allow,1852,1103,749,16,31,9,7
52280,445,0,0,drop,66,66,0,1,0,1,0
43578,15503,0,0,deny,74,74,0,1,0,1,0
57601,445,0,0,drop,70,70,0,1,0,1,0
47013,44512,0,0,deny,62,62,0,1,0,1,0
52802,56205,0,0,deny,62,62,0,1,0,1,0
63077,53,21461,53,allow,304,86,218,2,30,1,1
52261,48208,15422,48208,allow,70,70,0,2,8,2,0
62281,445,0,0,drop,66,66,0,1,0,1,0
61639,37965,0,0,deny,66,66,0,1,0,1,0
50387,8080,50387,8080,allow,7241,3224,4017,23,61,14,9
52035,80,61330,80,allow,4185,3462,723,14,15,7,7
45941,23386,0,0,deny,60,60,0,1,0,1,0
57411,53,32246,53,allow,196,102,94,2,29,1,1
62885,443,65198,443,allow,8097,2684,5413,22,248,12,10
55872,445,0,0,drop,70,70,0,1,0,1,0
49210,53,33969,53,allow,410,93,317,4,30,2,2
50551,80,50551,80,allow,4780,1925,2855,16,22,8,8
50265,33734,14802,33734,allow,132,132,0,3,1200,3,0
49697,53,43942,53,allow,195,94,101,2,30,1,1
52643,6881,27552,6881,allow,719,413,306,10,14,5,5
52696,21247,0,0,deny,66,66,0,1,0,1,0
49688,443,44354,443,allow,318,192,126,6,53,4,2
52604,25174,0,0,deny,66,66,0,1,0,1,0
54775,445,0,0,drop,66,66,0,1,0,1,0
65063,53,59913,53,allow,340,94,246,2,30,1,1
49607,25174,0,0,deny,66,66,0,1,0,1,0
64005,53,33305,53,allow,226,102,124,2,30,1,1
37653,5223,42431,5223,allow,142,142,0,1,5,1,0
52644,57209,0,0,deny,62,62,0,1,0,1,0
34493,443,37498,443,allow,11771,2624,9147,50,20,25,25
49908,445,0,0,drop,66,66,0,1,0,1,0
49776,443,33796,443,allow,214,140,74,4,15,3,1
26921,26467,0,0,deny,62,62,0,1,0,1,0
47063,15503,0,0,deny,146,146,0,1,0,1,0
29176,7000,29176,7000,allow,4731,2270,2461,18,15,10,8
57066,443,13444,443,allow,556770,88286,468484,777,202,314,463
51915,35068,4331,35068,allow,316,136,180,6,6,3,3
50386,8080,50386,8080,allow,5533,2632,2901,20,46,12,8
54954,443,24434,443,allow,469752,21060,448692,589,64,265,324
65516,53,4200,53,allow,290,94,196,4,41,2,2
60617,64147,0,0,deny,62,62,0,1,0,1,0
59473,445,0,0,drop,70,70,0,1,0,1,0
56562,53,42626,53,allow,183,94,89,2,30,1,1
52214,27480,12479,27480,allow,70,70,0,2,6,2,0
49313,53,30091,53,allow,199,102,97,2,30,1,1
64256,53,5483,53,allow,334,94,240,2,31,1,1
56755,53,37076,53,allow,184,94,90,2,31,1,1
26900,27017,54890,27017,allow,758,328,430,10,30,5,5
62234,445,0,0,drop,66,66,0,1,0,1,0
62509,445,0,0,drop,70,70,0,1,0,1,0
56906,50584,0,0,deny,146,146,0,1,0,1,0
49418,27016,3773,27016,allow,242,78,164,2,30,1,1
50819,443,23164,443,allow,1663508,63528,1599980,1853,251,692,1161
44414,23718,0,0,deny,66,66,0,1,0,1,0
61078,123,41282,123,allow,184,94,90,2,30,1,1
49418,27015,11506,27015,allow,248,78,170,2,30,1,1
49890,443,15513,443,allow,5597,1462,4135,21,86,11,10
56809,53,37625,53,allow,167,86,81,2,30,1,1
59374,51505,0,0,deny,62,62,0,1,0,1,0
50193,53,18428,53,allow,770,101,669,2,30,1,1
58913,443,48481,443,allow,5264,3357,1907,21,17,11,10
64627,53,53750,53,allow,305,101,204,4,44,2,2
65513,53,25094,53,allow,178,94,84,2,30,1,1
51069,80,24367,80,allow,254,128,126,5,15,3,2
49448,53,38995,53,allow,195,94,101,2,30,1,1
56996,80,27965,80,allow,214,140,74,4,35,3,1
58771,80,60976,80,allow,3312,1569,1743,12,135,7,5
41576,443,2351,443,allow,2227,1018,1209,17,15,8,9
55634,53,60487,53,allow,204,104,100,2,31,1,1
50873,443,51953,443,allow,350,210,140,6,26,4,2
5685,35440,0,0,deny,66,66,0,1,0,1,0
62760,445,0,0,drop,70,70,0,1,0,1,0
13021,25174,0,0,deny,146,146,0,1,0,1,0
16630,44847,0,0,deny,146,146,0,1,0,1,0
54473,37807,0,0,deny,66,66,0,1,0,1,0
49515,80,17973,80,allow,5101,2867,2234,15,38,8,7
65101,53,61768,53,allow,402,118,284,2,30,1,1
61321,445,0,0,drop,66,66,0,1,0,1,0
49766,445,0,0,drop,70,70,0,1,0,1,0
49628,53,48622,53,allow,168,86,82,2,31,1,1
55600,22,0,0,deny,60,60,0,1,0,1,0
32892,23,0,0,deny,60,60,0,1,0,1,0
52204,445,0,0,drop,70,70,0,1,0,1,0
45531,53,30846,53,allow,168,78,90,2,30,1,1
49601,53,30079,53,allow,88,88,0,1,31,1,0
58638,5900,0,0,deny,62,62,0,1,0,1,0
56966,35440,0,0,deny,66,66,0,1,0,1,0
54954,445,0,0,drop,66,66,0,1,0,1,0
51788,35787,52462,35787,allow,70,70,0,2,8,2,0
59168,445,0,0,drop,70,70,0,1,0,1,0
34220,80,10366,80,allow,672,300,372,12,30,6,6
51119,445,0,0,drop,66,66,0,1,0,1,0
51388,443,47694,443,allow,4209,1570,2639,14,136,7,7
49440,443,59866,443,allow,5141,896,4245,17,69,8,9
45908,3383,0,0,deny,60,60,0,1,0,1,0
55427,53,28517,53,allow,772,103,669,2,30,1,1
22683,39210,0,0,deny,60,60,0,1,0,1,0
57414,443,40284,443,allow,103144,2997,100147,114,16,36,78
50827,80,8180,80,allow,35970,11674,24296,108,265,55,53
38576,443,38576,443,allow,225915,9896,216019,283,80,128,155
56961,80,26352,80,allow,5885,3796,2089,16,30,10,6
53692,16624,3177,16624,allow,320,140,180,6,6,3,3
50499,80,43182,80,allow,318,192,126,6,25,4,2
53457,443,28376,443,allow,26693,2059,24634,42,30,18,24
56668,80,5597,80,allow,234,234,0,4,12,4,0
55351,445,0,0,drop,66,66,0,1,0,1,0
1646,23,0,0,deny,60,60,0,1,0,1,0
36588,5223,46105,5223,allow,4336,1518,2818,23,3005,14,9
57396,443,49419,443,allow,362,302,60,2,5,1,1
65386,53,46279,53,allow,168,86,82,2,29,1,1
55330,53,4334,53,allow,216,102,114,2,30,1,1
51479,25174,0,0,deny,66,66,0,1,0,1,0
59447,445,0,0,drop,70,70,0,1,0,1,0
55159,53,57486,53,allow,168,86,82,2,30,1,1
59920,445,0,0,drop,66,66,0,1,0,1,0
1171,18375,0,0,deny,146,146,0,1,0,1,0
54721,22114,0,0,deny,62,62,0,1,0,1,0
57834,445,0,0,drop,70,70,0,1,0,1,0
62149,22114,0,0,deny,66,66,0,1,0,1,0
64908,53,50995,53,allow,304,94,210,2,30,1,1
55986,26467,0,0,deny,66,66,0,1,0,1,0
46839,51050,0,0,deny,146,146,0,1,0,1,0
1431,30041,0,0,deny,62,62,0,1,0,1,0
51031,445,0,0,drop,70,70,0,1,0,1,0
54769,50584,0,0,deny,62,62,0,1,0,1,0
49486,53,33759,53,allow,170,87,83,2,31,1,1
58638,5900,0,0,deny,62,62,0,1,0,1,0
61891,445,0,0,drop,70,70,0,1,0,1,0
51332,445,0,0,drop,70,70,0,1,0,1,0
57257,53,41032,53,allow,173,94,79,2,29,1,1
58495,443,34760,443,allow,1638,829,809,18,43,10,8
49864,443,13446,443,allow,5930,910,5020,18,56,9,9
64599,445,0,0,drop,66,66,0,1,0,1,0
55808,53,53764,53,allow,730,102,628,2,30,1,1
65166,62413,0,0,deny,66,66,0,1,0,1,0
60750,42707,0,0,deny,66,66,0,1,0,1,0
61973,53,11068,53,allow,222,94,128,2,30,1,1
65126,53,60546,53,allow,718,94,624,2,30,1,1
57397,53,42342,53,allow,256,93,163,2,31,1,1
65131,53,4831,53,allow,168,86,82,2,30,1,1
52975,445,0,0,drop,70,70,0,1,0,1,0
49871,445,0,0,drop,70,70,0,1,0,1,0
10754,28793,0,0,deny,62,62,0,1,0,1,0
55653,53,52726,53,allow,94,94,0,1,29,1,0
62610,445,0,0,drop,70,70,0,1,0,1,0
12700,57470,0,0,deny,145,145,0,1,0,1,0
64999,53,11642,53,allow,757,98,659,2,31,1,1
65487,53,2041,53,allow,210,110,100,2,29,1,1
59364,44847,0,0,deny,62,62,0,1,0,1,0
54922,445,0,0,drop,66,66,0,1,0,1,0
53864,53,0,0,allow,181,86,95,2,30,1,1
57038,53,31637,53,allow,194,102,92,2,30,1,1
56960,53,21026,53,allow,196,102,94,2,31,1,1
55080,53,11951,53,allow,173,94,79,2,29,1,1
55495,53,27673,53,allow,210,110,100,2,30,1,1
123,123,13425,123,allow,184,94,90,2,29,1,1
55542,53,5716,53,allow,170,87,83,2,30,1,1
60224,445,0,0,drop,66,66,0,1,0,1,0
50438,3389,50438,3389,allow,3429,1474,1955,16,16,8,8
50767,57470,0,0,deny,66,66,0,1,0,1,0
46771,80,6345,80,allow,2066,1369,697,13,84,7,6
50490,80,51282,80,allow,318,192,126,6,25,4,2
54633,36237,0,0,deny,66,66,0,1,0,1,0
55706,53,61735,53,allow,209,110,99,2,30,1,1
443,50238,0,0,deny,331,331,0,1,0,1,0
51880,8001,32545,8001,allow,86,86,0,1,30,1,0
50564,445,0,0,drop,70,70,0,1,0,1,0
56704,80,26438,80,allow,1146417,29701,1116716,1218,54,422,796
30129,37965,0,0,deny,72,72,0,1,0,1,0
60603,445,0,0,drop,66,66,0,1,0,1,0
28679,3389,28679,3389,allow,3910,1805,2105,20,19,12,8
50607,443,39884,443,allow,25263,2606,22657,41,90,19,22
43639,443,43639,443,allow,4683,1776,2907,19,29,11,8
57216,445,0,0,drop,70,70,0,1,0,1,0
57302,443,55784,443,allow,5614,733,4881,16,15,9,7
53743,23915,28798,23915,allow,70,70,0,2,8,2,0
27005,27017,7063,27017,allow,877,126,751,3,31,2,1
49806,53,63116,53,allow,242,118,124,2,30,1,1
47013,44512,0,0,deny,62,62,0,1,0,1,0
52658,445,0,0,drop,70,70,0,1,0,1,0
52045,16853,9076,16853,allow,66,66,0,1,5,1,0
55404,445,0,0,drop,70,70,0,1,0,1,0
52220,22,52220,22,allow,8248,3445,4803,57,38,26,31
54995,445,0,0,drop,70,70,0,1,0,1,0
50630,53,12018,53,allow,209,110,99,2,29,1,1
55469,445,0,0,drop,70,70,0,1,0,1,0
10669,49756,0,0,deny,60,60,0,1,0,1,0
60376,443,40016,443,allow,6608,1843,4765,44,120,23,21
55525,53,23543,53,allow,212,108,104,2,31,1,1
55334,53,17897,53,allow,199,102,97,2,31,1,1
59431,443,29795,443,allow,12756,3596,9160,31,299,16,15
24931,25174,0,0,deny,146,146,0,1,0,1,0
63848,445,0,0,drop,70,70,0,1,0,1,0
41322,443,7553,443,allow,153,93,60,2,5,1,1
50224,445,0,0,drop,70,70,0,1,0,1,0
65332,56205,0,0,deny,66,66,0,1,0,1,0
49628,35440,0,0,deny,66,66,0,1,0,1,0
57455,123,24910,123,allow,184,94,90,2,29,1,1
64904,53,60868,53,allow,198,101,97,2,31,1,1
49261,80,5363,80,allow,3802643,113349,3689294,3463,206,982,2481
59604,445,0,0,drop,70,70,0,1,0,1,0
65099,53,22746,53,allow,199,102,97,2,31,1,1
59068,57470,0,0,deny,74,74,0,1,0,1,0
59781,443,23445,443,allow,546,180,366,10,28,4,6
40970,80,47105,80,allow,1052,612,440,10,15,5,5
63253,445,0,0,drop,70,70,0,1,0,1,0
64737,53,51522,53,allow,757,98,659,2,0,1,1
52216,445,0,0,drop,70,70,0,1,0,1,0
64100,445,0,0,drop,70,70,0,1,0,1,0
64257,53,50451,53,allow,168,86,82,2,31,1,1
31539,37965,0,0,deny,62,62,0,1,0,1,0
58638,5900,0,0,deny,62,62,0,1,0,1,0
49418,27015,47844,27015,allow,214,71,143,2,30,1,1
51880,443,34522,443,allow,4358,1056,3302,16,30,9,7
50116,22,50116,22,allow,152,66,86,2,9,1,1
61784,49903,0,0,deny,66,66,0,1,0,1,0
1025,50584,0,0,deny,62,62,0,1,0,1,0
58638,5900,0,0,deny,62,62,0,1,0,1,0
56262,53,49362,53,allow,701,88,613,2,30,1,1
56920,53,48525,53,allow,184,78,106,2,30,1,1
64214,445,0,0,drop,66,66,0,1,0,1,0
55479,53,23646,53,allow,184,94,90,2,31,1,1
42777,443,6253,443,allow,4353,687,3666,14,25,8,6
64873,53,26833,53,allow,380,110,270,2,30,1,1
54906,445,0,0,drop,66,66,0,1,0,1,0
65446,53,11171,53,allow,168,86,82,2,30,1,1
57479,56205,0,0,deny,66,66,0,1,0,1,0
22783,64147,0,0,deny,62,62,0,1,0,1,0
46587,57470,0,0,deny,66,66,0,1,0,1,0
40418,25174,0,0,deny,66,66,0,1,0,1,0
57269,445,0,0,drop,70,70,0,1,0,1,0
31683,35440,0,0,deny,62,62,0,1,0,1,0
34317,53,53292,53,allow,168,78,90,2,29,1,1
10416,64147,0,0,deny,62,62,0,1,0,1,0
56560,53,48488,53,allow,198,102,96,2,30,1,1
38406,80,52487,80,allow,52105,1615,50490,61,18,24,37
64327,53,64327,53,allow,243,100,143,2,30,1,1
29178,35440,0,0,deny,62,62,0,1,0,1,0
49583,445,0,0,drop,66,66,0,1,0,1,0
51830,443,51830,443,allow,17899,5015,12884,33,36,14,19
50699,445,0,0,drop,70,70,0,1,0,1,0
9265,37965,0,0,deny,62,62,0,1,0,1,0
62150,23718,0,0,deny,66,66,0,1,0,1,0
51417,445,0,0,drop,70,70,0,1,0,1,0
50079,443,27272,443,allow,20880,7976,12904,41,47,22,19
63684,445,0,0,drop,70,70,0,1,0,1,0
54118,6004,0,0,deny,66,66,0,1,0,1,0
64242,53,3579,53,allow,180,94,86,2,30,1,1
56138,53,23162,53,allow,177,94,83,2,30,1,1
64694,445,0,0,drop,70,70,0,1,0,1,0
2890,443,2890,443,allow,6915,882,6033,16,134,9,7
65481,443,11803,443,allow,138507,5990,132517,156,16,60,96
55069,53,13593,53,allow,195,102,93,2,31,1,1
43101,443,55812,443,allow,20846,11163,9683,55,318,30,25
50990,443,22704,443,allow,6090,2628,3462,21,24,11,10
49834,443,52390,443,allow,8332,3418,4914,31,95,17,14
49447,443,57996,443,allow,11281,5398,5883,21,125,11,10
44719,80,51210,80,allow,1998,1422,576,10,15,6,4
61128,80,61128,80,allow,1382,855,527,11,20,6,5
64146,53,19064,53,allow,212,102,110,2,29,1,1
64739,53,17167,53,allow,178,94,84,2,30,1,1
55421,445,0,0,drop,70,70,0,1,0,1,0
53097,443,17057,443,allow,7013,1718,5295,18,326,9,9
49914,445,0,0,drop,66,66,0,1,0,1,0
44864,443,47449,443,allow,8779,1861,6918,34,120,17,17
52929,43890,0,0,deny,66,66,0,1,0,1,0
57701,445,0,0,drop,70,70,0,1,0,1,0
51829,36134,0,0,deny,66,66,0,1,0,1,0
9327,57470,0,0,deny,62,62,0,1,0,1,0
62184,445,0,0,drop,66,66,0,1,0,1,0
58905,443,1469,443,allow,6370,706,5664,19,16,7,12
51584,443,13301,443,allow,12641,5741,6900,26,362,12,14
58874,443,39745,443,allow,21478,2212,19266,47,86,19,28
26900,27017,28688,27017,allow,422,164,258,6,30,3,3
55271,445,0,0,drop,66,66,0,1,0,1,0
50350,445,0,0,drop,66,66,0,1,0,1,0
51506,443,39609,443,allow,4869,699,4170,14,15,8,6
56898,445,0,0,drop,70,70,0,1,0,1,0
54935,445,0,0,drop,66,66,0,1,0,1,0
50442,80,50442,80,allow,52791,4087,48704,66,24,26,40
63952,50734,54501,50734,allow,66,66,0,2,8,2,0
49565,443,37074,443,allow,378,192,186,7,14,4,3
54540,443,17427,443,allow,6680,3784,2896,18,135,9,9
57418,53,27035,53,allow,758,96,662,2,31,1,1
58228,53733,0,0,deny,66,66,0,1,0,1,0
56901,53,23977,53,allow,710,89,621,2,31,1,1
64064,29856,32936,29856,allow,66,66,0,1,5,1,0
47783,50432,0,0,deny,62,62,0,1,0,1,0
63455,445,0,0,drop,70,70,0,1,0,1,0
11907,57470,0,0,deny,66,66,0,1,0,1,0
61711,35440,0,0,deny,62,62,0,1,0,1,0
49845,80,64041,80,allow,31466,852,30614,32,89,9,23
58008,80,56721,80,allow,2549,1595,954,21,75,11,10
51510,443,23309,443,allow,1047,560,487,10,16,6,4
62929,445,0,0,drop,66,66,0,1,0,1,0
443,35385,0,0,deny,97,97,0,1,0,1,0
11136,19910,0,0,deny,62,62,0,1,0,1,0
49668,443,64842,443,allow,1288,754,534,13,50,5,8
4961,62741,0,0,deny,66,66,0,1,0,1,0
49396,53,60623,53,allow,216,102,114,2,30,1,1
65315,445,0,0,drop,70,70,0,1,0,1,0
58638,5900,58638,5900,allow,126,62,64,2,5,1,1
63190,445,0,0,drop,70,70,0,1,0,1,0
37568,443,13649,443,allow,1702,861,841,19,110,10,9
49418,33032,30338,33032,allow,78,78,0,1,30,1,0
53548,445,0,0,drop,66,66,0,1,0,1,0
60261,25174,0,0,deny,66,66,0,1,0,1,0
39004,443,10788,443,allow,38459,27564,10895,97,189,49,48
52149,445,0,0,drop,66,66,0,1,0,1,0
51614,15000,49065,15000,allow,130,70,60,2,5,1,1
62857,445,0,0,drop,66,66,0,1,0,1,0
51349,80,65226,80,allow,1056,682,374,10,15,6,4
53821,7788,40501,7788,allow,70,70,0,1,5,1,0
62539,445,0,0,drop,66,66,0,1,0,1,0
51508,4545,51508,4545,allow,156,156,0,3,8,3,0
52151,445,0,0,drop,70,70,0,1,0,1,0
65179,53,52575,53,allow,184,94,90,2,30,1,1
59965,36237,0,0,deny,66,66,0,1,0,1,0
56775,53,64956,53,allow,177,94,83,2,29,1,1
59248,445,0,0,drop,70,70,0,1,0,1,0
57091,445,0,0,drop,66,66,0,1,0,1,0
65454,61600,0,0,deny,66,66,0,1,0,1,0
55619,53,44719,53,allow,183,94,89,2,29,1,1
57586,443,39129,443,allow,3724,1963,1761,24,95,13,11
49568,80,26293,80,allow,1515,481,1034,11,15,6,5
443,18177,0,0,deny,66,66,0,1,0,1,0
55199,445,0,0,drop,70,70,0,1,0,1,0
59959,80,18461,80,allow,1052,612,440,10,16,5,5
62249,443,58132,443,allow,9251,6353,2898,25,120,13,12
55210,53,63664,53,allow,969,86,883,2,30,1,1
49115,443,63602,443,allow,361013,18864,342149,392,296,110,282
53732,22704,15296,22704,allow,70,70,0,1,5,1,0
51472,80,52276,80,allow,1410,797,613,10,302,6,4
60239,53,53135,53,allow,219,102,117,2,30,1,1
45060,37965,0,0,deny,62,62,0,1,0,1,0
57605,443,60913,443,allow,2614,1689,925,18,20,10,8
1054,57470,0,0,deny,62,62,0,1,0,1,0
36712,53,0,0,allow,138,69,69,2,30,1,1
56628,443,49515,443,allow,7941,1952,5989,20,15,11,9
62362,445,0,0,drop,70,70,0,1,0,1,0
36278,7000,36278,7000,allow,3578,1967,1611,16,16,8,8
56690,443,7139,443,allow,7914,1925,5989,20,15,11,9
53579,42707,0,0,deny,66,66,0,1,0,1,0
55172,443,53179,443,allow,25605,3359,22246,47,82,26,21
64872,445,0,0,drop,70,70,0,1,0,1,0
41611,80,9523,80,allow,1860,712,1148,8,15,5,3
62920,993,31712,993,allow,7974,4175,3799,65,32,40,25
59421,445,0,0,drop,70,70,0,1,0,1,0
65434,445,0,0,drop,66,66,0,1,0,1,0
64085,445,0,0,drop,66,66,0,1,0,1,0
64379,53,61307,53,allow,333,94,239,2,30,1,1
49646,443,27491,443,allow,12279,4202,8077,33,43,16,17
65060,53,36666,53,allow,761,100,661,2,30,1,1
9333,443,63777,443,allow,5200,499,4701,13,15,7,6
48320,80,28314,80,allow,12110,3853,8257,35,1075,13,22
53167,22083,1777,22083,allow,70,70,0,2,8,2,0
60294,80,59530,80,allow,1463,865,598,11,144,6,5
10145,21247,0,0,deny,62,62,0,1,0,1,0
58638,5900,0,0,deny,62,62,0,1,0,1,0
64892,53,1067,53,allow,751,95,656,2,30,1,1
56672,80,18882,80,allow,234,234,0,4,11,4,0
9453,443,40885,443,allow,5693,499,5194,14,15,7,7
62802,445,0,0,drop,66,66,0,1,0,1,0
56373,53,9472,53,allow,200,102,98,2,30,1,1
49997,53,52835,53,allow,418,75,343,2,31,1,1
45564,443,3708,443,allow,69614,5520,64094,100,21,52,48
56627,53,14624,53,allow,193,102,91,2,30,1,1
57409,53,41368,53,allow,232,94,138,2,30,1,1
52989,51505,0,0,deny,66,66,0,1,0,1,0
49354,443,37956,443,allow,22643,7456,15187,32,15,17,15
50265,58840,23141,58840,allow,132,132,0,3,1200,3,0
59170,445,0,0,drop,70,70,0,1,0,1,0
55064,445,0,0,drop,70,70,0,1,0,1,0
59981,443,57380,443,allow,180817,9921,170896,241,21,116,125
51785,33253,63010,33253,allow,70,70,0,1,5,1,0
56756,53,22443,53,allow,711,87,624,2,30,1,1
64534,53,35373,53,allow,214,110,104,2,30,1,1
59728,5900,0,0,deny,60,60,0,1,0,1,0
49472,53,42476,53,allow,210,110,100,2,31,1,1
50172,443,42288,443,allow,152228,30166,122062,215,153,92,123
27005,27015,49303,27015,allow,868,126,742,2,30,1,1
50348,443,42997,443,allow,1385,868,517,12,30,6,6
49321,445,0,0,drop,70,70,0,1,0,1,0
64745,53,11106,53,allow,196,94,102,2,31,1,1
35240,443,35240,443,allow,24155,3115,21040,55,98,27,28
61093,445,0,0,drop,70,70,0,1,0,1,0
64124,53,35184,53,allow,183,94,89,2,30,1,1
56661,53,53473,53,allow,297,102,195,4,34,2,2
64664,53,7997,53,allow,168,86,82,2,32,1,1
47910,7454,0,0,deny,60,60,0,1,0,1,0
20682,57470,0,0,deny,62,62,0,1,0,1,0
56603,53,28698,53,allow,179,94,85,2,30,1,1
26900,27017,60170,27017,allow,422,164,258,6,30,3,3
57424,53,20131,53,allow,170,87,83,2,31,1,1
51605,443,55829,443,allow,8095,3030,5065,27,95,14,13
53906,17372,0,0,deny,145,145,0,1,0,1,0
3478,61463,0,0,deny,1148,1148,0,1,0,1,0
49848,53,31476,53,allow,167,86,81,2,30,1,1
58434,445,0,0,drop,70,70,0,1,0,1,0
49201,53,51989,53,allow,200,102,98,2,30,1,1
6882,64287,36114,64287,allow,228,118,110,2,1200,1,1
26900,27017,63924,27017,allow,422,164,258,6,30,3,3
50652,445,0,0,drop,70,70,0,1,0,1,0
53774,443,4137,443,allow,499,425,74,4,0,3,1
64953,445,0,0,drop,70,70,0,1,0,1,0
61845,445,0,0,drop,70,70,0,1,0,1,0
49267,53,55947,53,allow,184,94,90,2,30,1,1
49729,443,33717,443,allow,8322,2585,5737,23,16,12,11
50547,443,55787,443,allow,5895,1068,4827,22,149,12,10
60710,53,32625,53,allow,211,78,133,2,30,1,1
49996,53,6579,53,allow,183,94,89,2,30,1,1
55986,26467,0,0,deny,66,66,0,1,0,1,0
64530,53,18888,53,allow,261,87,174,4,45,2,2
49907,53,44048,53,allow,198,101,97,2,31,1,1
61929,445,0,0,drop,70,70,0,1,0,1,0
62742,445,0,0,drop,66,66,0,1,0,1,0
59836,443,19606,443,allow,1587,924,663,15,27,7,8
2278,25174,0,0,deny,62,62,0,1,0,1,0
56444,445,0,0,drop,70,70,0,1,0,1,0
61216,445,0,0,drop,70,70,0,1,0,1,0
443,18177,0,0,deny,66,66,0,1,0,1,0
53565,58695,4400,58695,allow,70,70,0,1,5,1,0
57045,53,16294,53,allow,177,94,83,2,30,1,1
22,44840,22,44840,allow,1427,1170,257,8,15,4,4
51728,44847,0,0,deny,66,66,0,1,0,1,0
55337,53,8346,53,allow,294,106,188,4,56,2,2
56649,443,38913,443,allow,8060,2040,6020,20,15,11,9
6666,2222,0,0,deny,60,60,0,1,0,1,0
56406,22114,0,0,deny,62,62,0,1,0,1,0
54167,50584,0,0,deny,62,62,0,1,0,1,0
54446,445,0,0,drop,70,70,0,1,0,1,0
50764,445,0,0,drop,66,66,0,1,0,1,0
60498,443,60498,443,allow,8233,948,7285,18,30,10,8
27005,27015,15191,27015,allow,889,126,763,2,30,1,1
49932,53,49932,53,allow,404,259,145,3,32,2,1
50434,445,0,0,drop,70,70,0,1,0,1,0
64951,53,60545,53,allow,230,102,128,2,30,1,1
1860,25174,0,0,deny,66,66,0,1,0,1,0
55735,53,42351,53,allow,199,102,97,2,30,1,1
46370,443,36990,443,allow,11035,8438,2597,39,95,23,16
65499,445,0,0,drop,66,66,0,1,0,1,0
10754,28793,0,0,deny,66,66,0,1,0,1,0
53716,443,47470,443,allow,70,70,0,2,8,2,0
27309,6881,0,0,deny,62,62,0,1,0,1,0
55544,445,0,0,drop,66,66,0,1,0,1,0
43260,41615,0,0,deny,145,145,0,1,0,1,0
49421,5228,11226,5228,allow,8399,1901,6498,39,1562,16,23
49432,53,25699,53,allow,309,94,215,4,32,2,2
49973,80,59362,80,allow,1352,364,988,13,15,6,7
57432,53,35465,53,allow,193,102,91,2,29,1,1
55582,445,0,0,drop,70,70,0,1,0,1,0
50957,445,0,0,drop,70,70,0,1,0,1,0
61113,27045,31501,27045,allow,1680,1386,294,7,30,4,3
63988,43365,3645,43365,allow,624,382,242,10,15,6,4
22263,30188,0,0,deny,66,66,0,1,0,1,0
56225,53,8973,53,allow,194,102,92,2,29,1,1
65252,53,49878,53,allow,249,102,147,2,30,1,1
65194,53,28428,53,allow,196,94,102,2,29,1,1
60136,56205,0,0,deny,66,66,0,1,0,1,0
55118,445,0,0,drop,70,70,0,1,0,1,0
57864,445,0,0,drop,66,66,0,1,0,1,0
58922,445,0,0,drop,70,70,0,1,0,1,0
56336,445,0,0,drop,70,70,0,1,0,1,0
44721,443,28122,443,allow,24317,1518,22799,38,218,16,22
49765,443,44439,443,allow,17982,2337,15645,34,127,16,18
65352,53,23820,53,allow,416,102,314,2,30,1,1
58008,445,0,0,drop,70,70,0,1,0,1,0
50466,445,0,0,drop,70,70,0,1,0,1,0
49522,21247,0,0,deny,62,62,0,1,0,1,0
55262,445,0,0,drop,70,70,0,1,0,1,0
27005,27016,10139,27016,allow,887,126,761,2,30,1,1
9687,57470,0,0,deny,78,78,0,1,0,1,0
58638,5900,0,0,deny,62,62,0,1,0,1,0
52415,443,32301,443,allow,2007,1152,855,14,15,8,6
47871,443,47202,443,allow,70,70,0,1,5,1,0
63919,80,26463,80,allow,314,192,122,6,15,4,2
54488,443,26044,443,allow,4967,2482,2485,26,271,13,13
62004,445,0,0,drop,70,70,0,1,0,1,0
27005,27016,3846,27016,allow,889,126,763,2,30,1,1
49667,53,34670,53,allow,183,94,89,2,29,1,1
50475,80,50475,80,allow,26023,3118,22905,38,24,18,20
54826,56205,0,0,deny,62,62,0,1,0,1,0
58103,10197,0,0,deny,66,66,0,1,0,1,0
65117,53,5041,53,allow,196,100,96,2,31,1,1
55768,443,42706,443,allow,5263,2534,2729,16,120,8,8
54046,445,0,0,drop,70,70,0,1,0,1,0
49712,53,62216,53,allow,178,94,84,2,30,1,1
65244,53,26357,53,allow,177,94,83,2,31,1,1
42758,123,49346,123,allow,184,94,90,2,30,1,1
5588,5588,0,0,allow,3354,1792,1562,46,194,23,23
50109,53,52643,53,allow,198,110,88,2,31,1,1
28441,23,28441,23,allow,152,66,86,2,7,1,1
36851,53,31171,53,allow,86,86,0,1,30,1,0
52913,2767,0,0,deny,66,66,0,1,0,1,0
56718,80,40668,80,allow,1462,703,759,8,15,5,3
50169,445,0,0,drop,70,70,0,1,0,1,0
56112,53,63106,53,allow,199,102,97,2,30,1,1
56982,80,33665,80,allow,3817,829,2988,11,16,7,4
35353,443,50088,443,allow,1864,250,1614,8,120,4,4
53247,443,23976,443,allow,10542,1216,9326,26,44,10,16
50689,443,50217,443,allow,152,86,66,2,4,1,1
52917,445,0,0,drop,66,66,0,1,0,1,0
64449,30188,0,0,deny,62,62,0,1,0,1,0
58764,445,0,0,drop,70,70,0,1,0,1,0
27005,27017,62934,27017,allow,1658,126,1532,4,30,2,2
48013,53,0,0,allow,82,82,0,1,30,1,0
29787,37965,0,0,deny,62,62,0,1,0,1,0
55561,53,57871,53,allow,313,102,211,2,30,1,1
48817,6889,48817,6889,allow,158,158,0,1,1200,1,0
31675,19473,0,0,deny,62,62,0,1,0,1,0
55348,53,14185,53,allow,332,94,238,2,29,1,1
53761,443,39818,443,allow,499,425,74,4,0,3,1
41298,51050,0,0,deny,62,62,0,1,0,1,0
51422,443,51422,443,allow,4399,1492,2907,19,27,11,8
55990,445,0,0,drop,70,70,0,1,0,1,0
49224,53,6029,53,allow,170,87,83,2,31,1,1
26900,27017,46101,27017,allow,422,164,258,6,30,3,3
49750,445,0,0,drop,70,70,0,1,0,1,0
53246,443,31450,443,allow,6066,1046,5020,20,69,11,9
53912,8999,51602,8999,allow,1869,1009,860,15,18,9,6
51938,11218,50761,11218,allow,70,70,0,2,8,2,0
50061,443,34942,443,allow,4819,2004,2815,22,80,11,11
48753,80,48753,80,allow,19937,2162,17775,36,24,19,17
51192,15503,0,0,deny,66,66,0,1,0,1,0
58791,15503,0,0,deny,66,66,0,1,0,1,0
51875,25072,31017,25072,allow,70,70,0,2,7,2,0
47910,7454,0,0,deny,60,60,0,1,0,1,0
55822,445,0,0,drop,70,70,0,1,0,1,0
61955,445,0,0,drop,70,70,0,1,0,1,0
50927,44847,0,0,deny,62,62,0,1,0,1,0
62071,22114,0,0,deny,62,62,0,1,0,1,0
59886,445,0,0,drop,70,70,0,1,0,1,0
49246,80,49246,80,allow,378,180,198,7,53,4,3
55050,443,45507,443,allow,1480,1029,451,11,151,6,5
33453,64147,0,0,deny,62,62,0,1,0,1,0
65019,445,0,0,drop,66,66,0,1,0,1,0
55938,53,49190,53,allow,780,93,687,2,30,1,1
30782,36237,0,0,deny,146,146,0,1,0,1,0
60228,445,0,0,drop,66,66,0,1,0,1,0
53833,26467,0,0,deny,66,66,0,1,0,1,0
31956,53,16501,53,allow,268,94,174,2,30,1,1
53213,443,51742,443,allow,8451,2320,6131,25,104,13,12
64359,53,13819,53,allow,230,102,128,2,30,1,1
63927,53,2248,53,allow,374,101,273,4,33,2,2
65451,53,6208,53,allow,188,96,92,2,31,1,1
36621,443,53395,443,allow,2239099,75601,2163498,2512,71,983,1529
52107,53,0,0,allow,210,77,133,2,29,1,1
51675,53,24941,53,allow,168,78,90,2,29,1,1
51778,60565,25061,60565,allow,70,70,0,2,8,2,0
55416,445,0,0,drop,70,70,0,1,0,1,0
61163,443,25794,443,allow,8637,5348,3289,37,738,15,22
49439,445,0,0,drop,66,66,0,1,0,1,0
38008,443,10885,443,allow,11784,6760,5024,50,247,30,20
52755,445,0,0,drop,66,66,0,1,0,1,0
55129,53,28774,53,allow,754,94,660,2,31,1,1
42231,57470,0,0,deny,78,78,0,1,0,1,0
50602,443,33341,443,allow,572966,109738,463228,1277,624,639,638
55088,53,51001,53,allow,177,94,83,2,29,1,1
28229,51505,0,0,deny,146,146,0,1,0,1,0
63088,445,0,0,drop,70,70,0,1,0,1,0
50392,80,28117,80,allow,306,180,126,6,26,4,2
57035,53,3817,53,allow,199,102,97,2,30,1,1
65487,53,64939,53,allow,184,94,90,2,31,1,1
59770,443,37125,443,allow,7316,1933,5383,27,16,15,12
51609,445,0,0,drop,70,70,0,1,0,1,0
37965,51413,49792,51413,allow,789,152,637,4,1199,2,2
33611,443,49502,443,allow,9490,1158,8332,24,256,13,11
42796,22114,0,0,deny,146,146,0,1,0,1,0
51503,443,42971,443,allow,9239,4472,4767,37,39,21,16
51879,443,43940,443,allow,4418,1116,3302,17,30,10,7
56647,80,55289,80,allow,234,234,0,4,12,4,0
13281,51050,0,0,deny,62,62,0,1,0,1,0
22683,39210,0,0,deny,60,60,0,1,0,1,0
57839,53,57631,53,allow,231,231,0,4,47,4,0
61636,25735,61636,25735,allow,3828,1516,2312,29,5271,18,11
52531,445,0,0,drop,66,66,0,1,0,1,0
55324,445,0,0,drop,70,70,0,1,0,1,0
58757,5222,20717,5222,allow,3815,2065,1750,37,309,19,18
50575,443,24477,443,allow,5197,3181,2016,50,261,26,24
27005,27016,42584,27016,allow,1010,252,758,4,33,3,1
51481,53,20508,53,allow,168,78,90,2,30,1,1
56620,53,51991,53,allow,322,110,212,4,30,2,2
60113,22114,0,0,deny,66,66,0,1,0,1,0
64323,53,38959,53,allow,190,97,93,2,31,1,1
26900,27017,59839,27017,allow,422,164,258,6,30,3,3
54144,443,45159,443,allow,5736,1990,3746,25,16,14,11
60350,51505,0,0,deny,66,66,0,1,0,1,0
61138,445,0,0,drop,66,66,0,1,0,1,0
39105,443,21624,443,allow,2853588,73973,2779615,2907,129,994,1913
54340,443,58977,443,allow,79305,3202,76103,98,347,32,66
65258,53,31384,53,allow,193,102,91,2,31,1,1
58808,445,0,0,drop,66,66,0,1,0,1,0
58688,53,58261,53,allow,184,78,106,2,30,1,1
39017,443,58610,443,allow,5176,861,4315,16,26,9,7
37965,48167,49022,48167,allow,490,149,341,3,1199,2,1
57946,445,0,0,drop,70,70,0,1,0,1,0
34999,25864,0,0,deny,74,74,0,1,0,1,0
64987,445,0,0,drop,66,66,0,1,0,1,0
49662,53,37093,53,allow,268,93,175,4,59,2,2
54614,443,21022,443,allow,36109,16793,19316,62,19,32,30
56377,51505,0,0,deny,66,66,0,1,0,1,0
50130,53,36317,53,allow,179,94,85,2,30,1,1
56387,53,8885,53,allow,757,98,659,2,31,1,1
46987,443,48389,443,allow,3847,2650,1197,22,32,13,9
49333,25174,0,0,deny,62,62,0,1,0,1,0
40803,443,57775,443,allow,1093,662,431,10,46,6,4
55877,1135,9849,1135,allow,489,149,340,2,1200,1,1
12143,56205,0,0,deny,66,66,0,1,0,1,0
57942,445,0,0,drop,66,66,0,1,0,1,0
56582,445,0,0,drop,66,66,0,1,0,1,0
41234,443,28858,443,allow,1741,1048,693,15,25,8,7
61147,22114,0,0,deny,62,62,0,1,0,1,0
57273,445,0,0,drop,66,66,0,1,0,1,0
51114,25174,0,0,deny,66,66,0,1,0,1,0
61339,443,59710,443,allow,31648,6288,25360,62,247,25,37
57344,53,65328,53,allow,177,94,83,2,30,1,1
27005,1102,9620,1102,allow,867,126,741,2,30,1,1
57762,25174,0,0,deny,62,62,0,1,0,1,0
57322,53,27268,53,allow,192,98,94,2,31,1,1
58638,5900,0,0,deny,62,62,0,1,0,1,0
42558,64147,0,0,deny,62,62,0,1,0,1,0
54588,445,0,0,drop,66,66,0,1,0,1,0
58999,443,40792,443,allow,9569,2606,6963,22,135,11,11
56965,445,0,0,drop,66,66,0,1,0,1,0
57331,53,50054,53,allow,178,94,84,2,30,1,1
64980,53,27979,53,allow,199,102,97,2,29,1,1
3478,61463,0,0,deny,164,164,0,1,0,1,0
55462,53,41879,53,allow,194,102,92,2,33,1,1
123,123,13833,123,allow,184,94,90,2,30,1,1
48600,23718,0,0,deny,66,66,0,1,0,1,0
63059,445,0,0,drop,70,70,0,1,0,1,0
1638,25174,0,0,deny,146,146,0,1,0,1,0
443,28417,0,0,deny,82,82,0,1,0,1,0
49907,53,54297,53,allow,199,102,97,2,29,1,1
27005,27015,3826,27015,allow,876,126,750,2,31,1,1
49656,53,53430,53,allow,193,102,91,2,30,1,1
52439,35894,0,0,deny,74,74,0,1,0,1,0
55072,53,38583,53,allow,86,86,0,1,30,1,0
52604,25174,0,0,deny,62,62,0,1,0,1,0
53858,6889,25438,6889,allow,372,186,186,6,16,3,3
45454,80,45454,80,allow,42171,1901,40270,57,16,26,31
62387,445,0,0,drop,70,70,0,1,0,1,0
52078,15518,32282,15518,allow,70,70,0,1,4,1,0
23589,53,23589,53,allow,220,90,130,2,30,1,1
55417,53,42244,53,allow,179,94,85,2,30,1,1
123,123,58588,123,allow,184,94,90,2,30,1,1
56747,80,7383,80,allow,194,128,66,4,25,3,1
56779,53,27714,53,allow,165,86,79,2,30,1,1
19933,35440,0,0,deny,62,62,0,1,0,1,0
57165,34101,0,0,deny,66,66,0,1,0,1,0
58638,5900,0,0,deny,62,62,0,1,0,1,0
46409,35440,0,0,deny,66,66,0,1,0,1,0
54996,443,52291,443,allow,8637,2889,5748,40,41,23,17
47744,80,34323,80,allow,1571,877,694,11,180,6,5
52243,445,0,0,drop,66,66,0,1,0,1,0
57736,443,25293,443,allow,3345,823,2522,12,120,6,6
56975,445,0,0,drop,70,70,0,1,0,1,0
51966,25174,0,0,deny,146,146,0,1,0,1,0
56876,11392,0,0,deny,66,66,0,1,0,1,0
27005,33076,50946,33076,allow,889,126,763,2,31,1,1
63941,53,42926,53,allow,253,102,151,2,30,1,1
31235,22114,0,0,deny,62,62,0,1,0,1,0
49361,53,49782,53,allow,166,86,80,2,30,1,1
52001,12514,64945,12514,allow,70,70,0,2,7,2,0
63852,25174,0,0,deny,146,146,0,1,0,1,0
28809,50584,0,0,deny,62,62,0,1,0,1,0
55425,37965,0,0,deny,66,66,0,1,0,1,0
45941,23386,0,0,deny,60,60,0,1,0,1,0
56500,53,23471,53,allow,199,102,97,2,30,1,1
59712,445,0,0,drop,66,66,0,1,0,1,0
63709,445,0,0,drop,70,70,0,1,0,1,0
4817,11392,0,0,deny,146,146,0,1,0,1,0
52514,445,0,0,drop,70,70,0,1,0,1,0
61944,445,0,0,drop,70,70,0,1,0,1,0
56474,18375,0,0,deny,62,62,0,1,0,1,0
65526,28793,0,0,deny,62,62,0,1,0,1,0
64164,53,32232,53,allow,229,102,127,2,30,1,1
56809,53,8718,53,allow,232,94,138,2,30,1,1
49754,35440,0,0,deny,146,146,0,1,0,1,0
34911,443,4016,443,allow,414843,13933,400910,459,136,160,299
65466,443,13984,443,allow,478996,13760,465236,490,16,171,319
61550,5529,0,0,deny,145,145,0,1,0,1,0
52141,445,0,0,drop,66,66,0,1,0,1,0
55379,443,27244,443,allow,13679,7277,6402,35,262,15,20
58638,5900,0,0,deny,62,62,0,1,0,1,0
33380,48817,0,0,deny,146,146,0,1,0,1,0
49380,445,0,0,drop,70,70,0,1,0,1,0
49705,80,59166,80,allow,132198,5466,126732,140,109,45,95
49282,6881,35216,6881,allow,709,523,186,6,16,3,3
5239,6064,8462,6064,allow,217199,128,217071,316,37,3,313
58638,5900,0,0,deny,62,62,0,1,0,1,0
54192,443,18650,443,allow,17821,7006,10815,95,448,48,47
59390,53,43106,53,allow,184,86,98,2,31,1,1
63139,12311,7837,12311,allow,70,70,0,2,8,2,0
64104,445,0,0,drop,70,70,0,1,0,1,0
61790,445,0,0,drop,70,70,0,1,0,1,0
54858,443,53726,443,allow,5252,3392,1860,22,316,12,10
45118,39004,0,0,deny,74,74,0,1,0,1,0
27005,33051,7331,33051,allow,887,126,761,2,31,1,1
56736,443,56736,443,allow,120441,7846,112595,167,61,76,91
55532,80,33980,80,allow,12971,971,12000,22,15,12,10
55218,53,56966,53,allow,402,142,260,2,30,1,1
49710,445,0,0,drop,66,66,0,1,0,1,0
58511,50584,0,0,deny,62,62,0,1,0,1,0
55230,443,46201,443,allow,42376115,1180708,41195407,45399,148,13976,31423
54399,445,0,0,drop,70,70,0,1,0,1,0
49521,443,49521,443,allow,25081,3001,22080,55,75,29,26
57362,53,47817,53,allow,183,86,97,2,30,1,1
56746,443,56746,443,allow,68504,9909,58595,93,62,46,47
64668,53,32390,53,allow,772,103,669,2,31,1,1
56661,53,21967,53,allow,288,93,195,4,32,2,2
58733,445,0,0,drop,70,70,0,1,0,1,0
56151,53,18710,53,allow,194,102,92,2,30,1,1
58823,443,42336,443,allow,25195,16739,8456,60,20,35,25
1936,80,29393,80,allow,214,140,74,4,15,3,1
38702,443,49260,443,allow,1117339,17881,1099458,1006,16,256,750
64565,443,57848,443,allow,24984,2042,22942,41,33,19,22
49320,445,0,0,drop,70,70,0,1,0,1,0
52431,50265,0,0,deny,62,62,0,1,0,1,0
49713,53,41539,53,allow,233,94,139,2,30,1,1
55710,63545,52051,63545,allow,504,318,186,8,15,5,3
56805,53,35322,53,allow,172,88,84,2,30,1,1
30114,65151,0,0,deny,60,60,0,1,0,1,0
54163,443,60868,443,allow,2430,1416,1014,18,34,9,9
9446,443,50836,443,allow,8672,1863,6809,22,46,11,11
55098,53,33176,53,allow,474,200,274,6,44,3,3
55127,53,18845,53,allow,253,87,166,4,44,2,2
50131,443,16533,443,allow,12716,2575,10141,55,141,27,28
60479,445,0,0,drop,70,70,0,1,0,1,0
40512,57470,0,0,deny,74,74,0,1,0,1,0
50659,445,0,0,drop,70,70,0,1,0,1,0
42228,51050,0,0,deny,66,66,0,1,0,1,0
59795,443,6313,443,allow,120014,7352,112662,155,37,64,91
64683,53,44457,53,allow,370,126,244,2,30,1,1
41052,80,7228,80,allow,1056,682,374,10,15,6,4
43523,53,26419,53,allow,168,78,90,2,30,1,1
33814,22114,0,0,deny,62,62,0,1,0,1,0
61711,80,55600,80,allow,4448,2223,2225,18,49,10,8
60951,445,0,0,drop,66,66,0,1,0,1,0
56744,31151,15345,31151,allow,1703,524,1179,9,30,5,4
64318,53,45436,53,allow,183,94,89,2,30,1,1
55765,443,54125,443,allow,4660,1915,2745,23,120,12,11
50482,443,21793,443,allow,2520,1267,1253,17,83,9,8
62716,23,0,0,deny,60,60,0,1,0,1,0
20724,19750,0,0,deny,78,78,0,1,0,1,0
20586,25174,0,0,deny,62,62,0,1,0,1,0
65279,53,57423,53,allow,183,94,89,2,30,1,1
19204,56448,0,0,deny,78,78,0,1,0,1,0
2837,25174,0,0,deny,62,62,0,1,0,1,0
45566,443,9859,443,allow,570475,25559,544916,712,32,341,371
56624,53,36589,53,allow,177,94,83,2,31,1,1
53692,44512,0,0,deny,66,66,0,1,0,1,0
10312,23117,0,0,deny,62,62,0,1,0,1,0
56735,53283,31023,53283,allow,4188,1648,2540,17,19,9,8
43747,22114,0,0,deny,62,62,0,1,0,1,0
51980,80,55042,80,allow,4247,699,3548,13,46,7,6
53253,443,36100,443,allow,8662,1469,7193,28,66,15,13
53124,52917,26989,52917,allow,70,70,0,1,5,1,0
53811,445,0,0,drop,66,66,0,1,0,1,0
38700,443,59895,443,allow,4478,1133,3345,13,27,8,5
64819,445,0,0,drop,66,66,0,1,0,1,0
34658,443,51529,443,allow,3521,516,3005,12,15,6,6
49225,8080,49225,8080,allow,43790,20134,23656,73,400,45,28
55058,53,31545,53,allow,216,110,106,2,30,1,1
1264,26296,0,0,deny,143,143,0,1,0,1,0
29080,50265,0,0,deny,62,62,0,1,0,1,0
40737,443,35009,443,allow,44004,3909,40095,80,135,38,42
38707,443,59526,443,allow,774099,15769,758330,743,16,223,520
23658,18375,0,0,deny,62,62,0,1,0,1,0
49756,53,23691,53,allow,264,89,175,4,48,2,2
64747,53,39095,53,allow,216,94,122,2,29,1,1
61230,22114,0,0,deny,66,66,0,1,0,1,0
50631,23,0,0,deny,60,60,0,1,0,1,0
9707,3389,9707,3389,allow,3441,1552,1889,17,21,10,7
65033,53,12694,53,allow,214,94,120,2,30,1,1
55346,53,15239,53,allow,199,94,105,2,30,1,1
32806,7275,9524,7275,allow,1564,560,1004,23,38,9,14
1024,6881,0,0,deny,62,62,0,1,0,1,0
50584,55727,63781,55727,allow,2268,1050,1218,15,5442,8,7
59060,443,38409,443,allow,16775,1879,14896,36,16,17,19
64391,53,9777,53,allow,209,102,107,2,29,1,1
41813,8080,0,0,deny,60,60,0,1,0,1,0
59790,445,0,0,drop,70,70,0,1,0,1,0
50706,445,0,0,drop,70,70,0,1,0,1,0
57066,53,53308,53,allow,778,103,675,2,30,1,1
64746,445,0,0,drop,70,70,0,1,0,1,0
57038,53,16760,53,allow,188,96,92,2,30,1,1
48087,16069,0,0,deny,62,62,0,1,0,1,0
63713,445,0,0,drop,66,66,0,1,0,1,0
37611,53,57023,53,allow,199,94,105,2,30,1,1
64103,445,0,0,drop,70,70,0,1,0,1,0
56948,53,61880,53,allow,183,94,89,2,30,1,1
60601,53,19741,53,allow,451,86,365,2,30,1,1
3001,28680,0,0,deny,148,148,0,1,0,1,0
3303,80,51748,80,allow,2338,1419,919,10,15,5,5
36765,80,13699,80,allow,2272,1679,593,10,34,6,4
10738,50584,0,0,deny,62,62,0,1,0,1,0
49537,53,59309,53,allow,269,96,173,4,59,2,2
60181,445,0,0,drop,66,66,0,1,0,1,0
55300,445,0,0,drop,70,70,0,1,0,1,0
64000,445,0,0,drop,70,70,0,1,0,1,0
51221,50861,60298,50861,allow,490,149,341,2,1200,1,1
51980,45478,12123,45478,allow,70,70,0,2,7,2,0
37588,443,34121,443,allow,499,425,74,4,0,3,1
11295,53,11295,53,allow,197,90,107,2,30,1,1
45952,22114,0,0,deny,62,62,0,1,0,1,0
53198,443,2334,443,allow,1462,965,497,13,18,7,6
63595,51050,0,0,deny,62,62,0,1,0,1,0
42342,443,63705,443,allow,494,198,296,8,17,4,4
50222,443,19718,443,allow,9582,2201,7381,28,99,14,14
30707,30317,0,0,deny,62,62,0,1,0,1,0
51522,443,43510,443,allow,190,70,120,4,15,2,2
49418,27017,22257,27017,allow,271,78,193,2,31,1,1
56754,53,26868,53,allow,182,93,89,2,31,1,1
26978,443,38800,443,allow,7547,2728,4819,26,20,13,13
51609,37807,0,0,deny,66,66,0,1,0,1,0
61430,37965,0,0,deny,66,66,0,1,0,1,0
56852,49677,39171,49677,allow,130,70,60,2,5,1,1
45461,25174,0,0,deny,62,62,0,1,0,1,0
56573,445,0,0,drop,70,70,0,1,0,1,0
56183,445,0,0,drop,70,70,0,1,0,1,0
56638,64147,0,0,deny,62,62,0,1,0,1,0
64905,53,16169,53,allow,245,94,151,2,30,1,1
56809,53,37761,53,allow,178,94,84,2,30,1,1
58858,15503,0,0,deny,66,66,0,1,0,1,0
1987,26467,0,0,deny,62,62,0,1,0,1,0
64326,445,0,0,drop,70,70,0,1,0,1,0
19068,37965,0,0,deny,62,62,0,1,0,1,0
56629,80,58427,80,allow,234,234,0,4,12,4,0
54228,443,39518,443,allow,499,425,74,4,0,3,1
58851,443,38942,443,allow,5166,700,4466,16,15,7,9
56995,53,18611,53,allow,168,86,82,2,30,1,1
48513,44847,0,0,deny,62,62,0,1,0,1,0
53490,445,0,0,drop,70,70,0,1,0,1,0
58392,53,58392,53,allow,404,259,145,3,33,2,1
52544,443,52544,443,allow,4487,1580,2907,19,26,11,8
57470,17984,5691,17984,allow,402,132,270,6,1209,3,3
56694,53,57041,53,allow,196,102,94,2,30,1,1
51446,445,0,0,drop,66,66,0,1,0,1,0
65225,53,20120,53,allow,822,102,720,2,30,1,1
57281,445,0,0,drop,66,66,0,1,0,1,0
35232,36602,0,0,deny,74,74,0,1,0,1,0
49633,53,21391,53,allow,168,86,82,2,30,1,1
39508,53,12625,53,allow,78,78,0,1,30,1,0
10026,443,31835,443,allow,3409,1599,1810,24,80,12,12
1074,25174,0,0,deny,146,146,0,1,0,1,0
39624,53,30103,53,allow,168,78,90,2,30,1,1
55649,53,62328,53,allow,216,110,106,2,30,1,1
58826,445,0,0,drop,70,70,0,1,0,1,0
53746,36237,0,0,deny,66,66,0,1,0,1,0
55841,53,16397,53,allow,458,188,270,6,31,3,3
38142,53,38142,53,allow,404,259,145,3,32,2,1
65228,53,0,0,deny,88,88,0,1,0,1,0
65127,443,37615,443,allow,146,64,82,3,9,2,1
65212,53,36121,53,allow,230,102,128,2,30,1,1
58687,12883,0,0,deny,143,143,0,1,0,1,0
21133,51413,27138,51413,allow,460,150,310,2,1199,1,1
35078,443,18726,443,allow,78,78,0,1,5,1,0
63334,445,0,0,drop,70,70,0,1,0,1,0
57115,53,47701,53,allow,172,88,84,2,30,1,1
18574,56205,0,0,deny,62,62,0,1,0,1,0
5222,32859,0,0,deny,66,66,0,1,0,1,0
53419,28189,0,0,deny,60,60,0,1,0,1,0
60175,445,0,0,drop,70,70,0,1,0,1,0
55618,56205,0,0,deny,66,66,0,1,0,1,0
38269,80,33887,80,allow,190,70,120,4,14,2,2
51208,443,14745,443,allow,3477,1216,2261,16,136,8,8
56806,443,15010,443,allow,8072,2052,6020,20,15,11,9
9265,80,10244,80,allow,318,192,126,6,26,4,2
50543,445,0,0,drop,70,70,0,1,0,1,0
64763,53,29524,53,allow,728,96,632,2,30,1,1
58646,445,0,0,drop,70,70,0,1,0,1,0
11337,25773,0,0,reset-both,159,159,0,1,0,1,0
16387,8455,0,0,deny,60,60,0,1,0,1,0
56180,53,37696,53,allow,200,102,98,2,30,1,1
61019,445,0,0,drop,66,66,0,1,0,1,0
41093,53,34774,53,allow,78,78,0,1,30,1,0
6546,37965,0,0,deny,62,62,0,1,0,1,0
55075,53,54293,53,allow,181,94,87,2,33,1,1
55762,53,29389,53,allow,249,94,155,2,29,1,1
54489,445,0,0,drop,70,70,0,1,0,1,0
52100,54130,1109,54130,allow,70,70,0,1,4,1,0
9517,23,9517,23,allow,66,66,0,1,5,1,0
49701,53,61488,53,allow,197,102,95,2,30,1,1
21993,25174,0,0,deny,62,62,0,1,0,1,0
52208,43890,0,0,deny,66,66,0,1,0,1,0
9161,443,17981,443,allow,5658,501,5157,14,15,7,7
65293,53,30071,53,allow,349,110,239,2,30,1,1
59618,46824,0,0,deny,66,66,0,1,0,1,0
65036,53,28927,53,allow,214,110,104,2,30,1,1
9524,443,1427,443,allow,1313,876,437,11,26,6,5
65440,53,38806,53,allow,240,86,154,2,29,1,1
49233,53,6991,53,allow,819,102,717,2,29,1,1
62887,445,0,0,drop,70,70,0,1,0,1,0
33292,50584,0,0,deny,66,66,0,1,0,1,0
60461,443,30128,443,allow,18515,2899,15616,32,148,15,17
58638,5900,0,0,deny,62,62,0,1,0,1,0
59400,445,0,0,drop,66,66,0,1,0,1,0
56887,53,57938,53,allow,170,87,83,2,30,1,1
56380,36829,0,0,deny,66,66,0,1,0,1,0
55808,53,45901,53,allow,738,86,652,2,31,1,1
39062,443,32900,443,allow,11360,8326,3034,36,22,19,17
46129,443,13770,443,allow,6255,1125,5130,26,413,9,17
43199,5228,42030,5228,allow,10588,2455,8133,46,5724,19,27
61050,445,0,0,drop,66,66,0,1,0,1,0
65244,445,0,0,drop,66,66,0,1,0,1,0
11236,53,11236,53,allow,197,90,107,2,30,1,1
1156,53,45394,53,allow,278,86,192,2,29,1,1
51932,443,23132,443,allow,3207,2430,777,21,26,11,10
49417,38558,0,0,deny,66,66,0,1,0,1,0
60619,445,0,0,drop,70,70,0,1,0,1,0
55102,80,41246,80,allow,46215,1615,44600,57,18,24,33
50668,443,5052,443,allow,2881,642,2239,13,135,6,7
49749,443,9817,443,allow,438048,86860,351188,491,420,213,278
13285,29892,0,0,deny,145,145,0,1,0,1,0
53116,445,0,0,drop,70,70,0,1,0,1,0
54968,53,43880,53,allow,198,101,97,2,30,1,1
65201,445,0,0,drop,70,70,0,1,0,1,0
4296,53,43153,53,allow,217,86,131,2,30,1,1
65357,445,0,0,drop,70,70,0,1,0,1,0
37708,443,23854,443,allow,8604,2228,6376,36,739,19,17
55706,443,29687,443,allow,5259,1203,4056,19,41,10,9
50632,80,1606,80,allow,1559,1107,452,9,22,5,4
49252,445,0,0,drop,66,66,0,1,0,1,0
62406,445,0,0,drop,70,70,0,1,0,1,0
52935,443,46702,443,allow,1769338,65258,1704080,1935,1200,735,1200
58754,443,12477,443,allow,7674,4959,2715,24,16,13,11
64865,53,41424,53,allow,423,102,321,2,30,1,1
64320,53,61236,53,allow,199,102,97,2,30,1,1
53298,445,0,0,drop,66,66,0,1,0,1,0
64033,29834,16078,29834,allow,70,70,0,1,5,1,0
55084,53,9496,53,allow,177,94,83,2,31,1,1
37578,443,38222,443,allow,499,425,74,4,0,3,1
65263,53,53101,53,allow,232,110,122,2,30,1,1
42630,53,12099,53,allow,168,78,90,2,30,1,1
65487,53,21256,53,allow,184,94,90,2,30,1,1
50284,80,36535,80,allow,8269,1423,6846,20,75,10,10
10151,60419,62503,60419,allow,479,150,329,2,1200,1,1
65081,26467,0,0,deny,66,66,0,1,0,1,0
49891,53,62229,53,allow,822,102,720,2,30,1,1
45871,443,58048,443,allow,275011,235921,39090,651,350,363,288
58468,57587,0,0,deny,66,66,0,1,0,1,0
54221,57470,0,0,deny,66,66,0,1,0,1,0
56006,53,56453,53,allow,200,102,98,2,30,1,1
56639,48817,0,0,deny,66,66,0,1,0,1,0
50253,53,23205,53,allow,167,86,81,2,31,1,1
64489,445,0,0,drop,70,70,0,1,0,1,0
64811,51221,0,0,deny,62,62,0,1,0,1,0
53579,42707,0,0,deny,66,66,0,1,0,1,0
63944,30188,0,0,deny,66,66,0,1,0,1,0
41914,123,34175,123,allow,184,94,90,2,30,1,1
56350,445,0,0,drop,66,66,0,1,0,1,0
45289,80,45289,80,allow,144717,5580,139137,180,20,81,99
64050,53,59472,53,allow,389,94,295,2,30,1,1
36367,443,61564,443,allow,1209,709,500,14,26,8,6
55113,53,62631,53,allow,177,94,83,2,30,1,1
55418,53,39604,53,allow,168,86,82,2,31,1,1
49994,443,12654,443,allow,378,82,296,5,17,1,4
53145,445,0,0,drop,70,70,0,1,0,1,0
58118,445,0,0,drop,66,66,0,1,0,1,0
45964,2228,0,0,deny,60,60,0,1,0,1,0
55865,53,59187,53,allow,192,98,94,2,31,1,1
50719,443,22608,443,allow,17803069,497380,17305689,17583,219,5899,11684
60186,445,0,0,drop,70,70,0,1,0,1,0
51329,445,0,0,drop,70,70,0,1,0,1,0
57348,25174,0,0,deny,62,62,0,1,0,1,0
5938,47512,0,0,allow,60,60,0,1,90,1,0
54752,445,0,0,drop,70,70,0,1,0,1,0
59341,53,56377,53,allow,187,78,109,2,30,1,1
30307,51505,0,0,deny,62,62,0,1,0,1,0
56937,53,62951,53,allow,181,94,87,2,30,1,1
27386,53,27386,53,allow,194,87,107,2,31,1,1
60245,25174,0,0,deny,62,62,0,1,0,1,0
64898,53,12662,53,allow,487,201,286,6,42,3,3
56597,53,9477,53,allow,197,197,0,3,60,3,0
56119,53,10048,53,allow,199,102,97,2,33,1,1
56694,53,47429,53,allow,196,102,94,2,29,1,1
49814,53,14666,53,allow,189,102,87,2,30,1,1
64614,53,60972,53,allow,168,86,82,2,31,1,1
58638,5900,0,0,deny,62,62,0,1,0,1,0
54569,445,0,0,drop,70,70,0,1,0,1,0
65237,53,38520,53,allow,733,86,647,2,30,1,1
56801,443,16437,443,allow,8022,2002,6020,20,15,11,9
65355,53,22974,53,allow,321,102,219,2,30,1,1
63399,445,0,0,drop,70,70,0,1,0,1,0
58253,445,0,0,drop,70,70,0,1,0,1,0
57150,53,64897,53,allow,177,94,83,2,30,1,1
56733,445,0,0,drop,70,70,0,1,0,1,0
53704,15000,63052,15000,allow,70,70,0,1,4,1,0
58096,443,10840,443,allow,7252,1150,6102,22,199,11,11
50820,53,0,0,allow,371,77,294,2,30,1,1
57143,53,50787,53,allow,184,94,90,2,30,1,1
64937,53,12503,53,allow,210,110,100,2,30,1,1
52837,445,0,0,drop,66,66,0,1,0,1,0
51815,445,0,0,drop,70,70,0,1,0,1,0
52802,80,4743,80,allow,1465,729,736,12,16,7,5
11458,2767,0,0,deny,66,66,0,1,0,1,0
49689,445,0,0,drop,70,70,0,1,0,1,0
56421,53,57015,53,allow,177,94,83,2,30,1,1
56369,53,3077,53,allow,193,102,91,2,31,1,1
59834,80,63639,80,allow,943291,17238,926053,869,72,249,620
50006,53,55896,53,allow,378,94,284,2,30,1,1
45918,443,28786,443,allow,12351,7584,4767,38,48,22,16
45238,44847,0,0,deny,66,66,0,1,0,1,0
58923,443,63838,443,allow,5167,700,4467,16,14,7,9
64900,53,55374,53,allow,778,103,675,2,30,1,1
3783,40740,0,0,deny,160,160,0,1,0,1,0
55595,445,0,0,drop,70,70,0,1,0,1,0
49281,443,26289,443,allow,7655,2377,5278,20,135,11,9
40226,53,63320,53,allow,258,78,180,4,30,2,2
36685,35440,0,0,deny,62,62,0,1,0,1,0
60921,443,34285,443,allow,9869,2448,7421,61,1253,24,37
55367,53,40346,53,allow,195,102,93,2,30,1,1
50127,445,0,0,drop,66,66,0,1,0,1,0
49182,21247,0,0,deny,66,66,0,1,0,1,0
48252,443,35978,443,allow,283034,39462,243572,536,224,257,279
45937,443,35765,443,allow,4592,697,3895,14,25,8,6
52978,445,0,0,drop,70,70,0,1,0,1,0
57322,53,63683,53,allow,196,102,94,2,31,1,1
54302,445,0,0,drop,70,70,0,1,0,1,0
56748,53,37401,53,allow,184,94,90,2,30,1,1
56450,53,8472,53,allow,168,86,82,2,30,1,1
20706,23718,0,0,deny,66,66,0,1,0,1,0
65504,53,33205,53,allow,193,102,91,2,30,1,1
36946,123,44700,123,allow,184,94,90,2,30,1,1
50353,443,35772,443,allow,7397,1784,5613,27,306,13,14
52720,35894,0,0,deny,62,62,0,1,0,1,0
64755,445,0,0,drop,70,70,0,1,0,1,0
58557,443,4317,443,allow,114852,43911,70941,248,69,132,116
42298,40039,40294,40039,allow,211,89,122,4,30,2,2
2267,53,54801,53,allow,204,118,86,2,30,1,1
56315,123,48493,123,allow,184,94,90,2,30,1,1
57107,64147,0,0,deny,66,66,0,1,0,1,0
52009,445,0,0,drop,66,66,0,1,0,1,0
51781,43909,49326,43909,allow,66,66,0,1,5,1,0
55704,13343,3338,13343,allow,564,318,246,9,15,5,4
41577,53,15196,53,allow,168,78,90,2,30,1,1
55171,53,44438,53,allow,199,102,97,2,30,1,1
42344,48637,0,0,deny,60,60,0,1,0,1,0
50392,443,55310,443,allow,1125,595,530,12,29,6,6
49271,53,62549,53,allow,178,94,84,2,30,1,1
52925,64147,0,0,deny,62,62,0,1,0,1,0
22587,30188,0,0,deny,66,66,0,1,0,1,0
59660,445,0,0,drop,66,66,0,1,0,1,0
62473,445,0,0,drop,66,66,0,1,0,1,0
40392,443,64453,443,allow,8105,2278,5827,27,196,15,12
55655,445,0,0,drop,70,70,0,1,0,1,0
55235,53,63921,53,allow,178,94,84,2,30,1,1
40521,23117,0,0,deny,66,66,0,1,0,1,0
50211,445,0,0,drop,70,70,0,1,0,1,0
58655,445,0,0,drop,66,66,0,1,0,1,0
44577,443,43261,443,allow,30773,9123,21650,90,104,48,42
49377,443,17002,443,allow,11627,4670,6957,37,155,16,21
50374,443,61017,443,allow,8485,1804,6681,30,316,14,16
57314,53,61726,53,allow,190,97,93,2,31,1,1
61978,445,0,0,drop,70,70,0,1,0,1,0
64587,43890,0,0,deny,66,66,0,1,0,1,0
13281,51050,0,0,deny,66,66,0,1,0,1,0
58736,445,0,0,drop,70,70,0,1,0,1,0
13718,23,0,0,deny,60,60,0,1,0,1,0
1025,51221,0,0,deny,62,62,0,1,0,1,0
64907,53,21503,53,allow,247,86,161,3,31,2,1
52174,43106,42661,43106,allow,258,70,188,4,9,2,2
51358,445,0,0,drop,70,70,0,1,0,1,0
60913,80,45601,80,allow,613,539,74,7,15,6,1
50384,445,0,0,drop,70,70,0,1,0,1,0
35350,443,47252,443,allow,13168,2505,10663,21,121,9,12
40527,443,2355,443,allow,21750,1903,19847,39,154,20,19
63547,37965,0,0,deny,66,66,0,1,0,1,0
27005,33056,59284,33056,allow,885,126,759,2,31,1,1
59422,51221,0,0,deny,66,66,0,1,0,1,0
41278,443,28567,443,allow,7238,2601,4637,20,17,10,10
55981,53,55529,53,allow,168,78,90,2,30,1,1
42433,443,64701,443,allow,6381,3801,2580,19,135,10,9
58636,445,0,0,drop,70,70,0,1,0,1,0
55550,445,0,0,drop,70,70,0,1,0,1,0
64548,445,0,0,drop,70,70,0,1,0,1,0
53893,11344,38662,11344,allow,70,70,0,1,5,1,0
62315,445,0,0,drop,70,70,0,1,0,1,0
11450,57470,0,0,deny,66,66,0,1,0,1,0
58359,64147,0,0,deny,72,72,0,1,0,1,0
48706,23393,0,0,deny,60,60,0,1,0,1,0
8239,37965,0,0,deny,146,146,0,1,0,1,0
57368,7302,0,0,deny,66,66,0,1,0,1,0
60478,443,17919,443,allow,5045,2009,3036,14,120,7,7
64261,53,48738,53,allow,295,110,185,2,30,1,1
39058,443,63912,443,allow,8028,5439,2589,32,27,16,16
51787,35661,9669,35661,allow,70,70,0,1,5,1,0
51749,445,0,0,drop,66,66,0,1,0,1,0
54661,445,0,0,drop,70,70,0,1,0,1,0
37563,443,52126,443,allow,499,425,74,4,0,3,1
55325,53,5383,53,allow,199,102,97,2,30,1,1
57633,50584,0,0,deny,62,62,0,1,0,1,0
56176,53,54476,53,allow,177,94,83,2,30,1,1
38632,443,3130,443,allow,9606,1228,8378,20,115,9,11
54984,443,11572,443,allow,68519,3801,64718,93,31,40,53
17101,25174,0,0,deny,66,66,0,1,0,1,0
44246,5228,57956,5228,allow,19678,4762,14916,98,9851,54,44
58638,5900,0,0,deny,62,62,0,1,0,1,0
37028,51505,0,0,deny,62,62,0,1,0,1,0
38645,51221,0,0,deny,62,62,0,1,0,1,0
58700,445,0,0,drop,66,66,0,1,0,1,0
61147,22114,0,0,deny,66,66,0,1,0,1,0
59415,443,30552,443,allow,2854,1700,1154,16,16,8,8
63855,29799,41914,29799,allow,66,66,0,1,5,1,0
49177,54532,0,0,deny,60,60,0,1,0,1,0
54028,37965,0,0,deny,66,66,0,1,0,1,0
51547,445,0,0,drop,70,70,0,1,0,1,0
52827,25174,0,0,deny,62,62,0,1,0,1,0
64566,53,26350,53,allow,194,102,92,2,29,1,1
65465,445,0,0,drop,70,70,0,1,0,1,0
53165,443,14639,443,allow,7434,1695,5739,23,27,12,11
2697,28189,0,0,deny,60,60,0,1,0,1,0
60991,443,12084,443,allow,15561,8186,7375,44,47,26,18
47262,443,28246,443,allow,4609,763,3846,14,14,8,6
56757,445,0,0,drop,66,66,0,1,0,1,0
49570,53,16357,53,allow,196,94,102,2,29,1,1
44482,443,20797,443,allow,7464,1869,5595,29,409,11,18
55020,443,26568,443,allow,7239,2934,4305,26,16,15,11
56494,53,64995,53,allow,793,101,692,2,31,1,1
49337,53,44481,53,allow,199,102,97,2,30,1,1
61643,445,0,0,drop,70,70,0,1,0,1,0
60354,443,37287,443,allow,10223,3933,6290,49,115,22,27
49418,52013,5997,52013,allow,257,71,186,2,30,1,1
56979,53,3476,53,allow,180,94,86,2,30,1,1
53760,80,45731,80,allow,1667,619,1048,10,45,6,4
55656,53,37585,53,allow,214,110,104,2,30,1,1
62029,445,0,0,drop,66,66,0,1,0,1,0
50222,445,0,0,drop,70,70,0,1,0,1,0
64252,53,2109,53,allow,199,102,97,2,29,1,1
51465,80,10875,80,allow,913,410,503,10,15,5,5
55466,445,0,0,drop,70,70,0,1,0,1,0
64937,53,42639,53,allow,204,104,100,2,31,1,1
65307,53,33704,53,allow,365,94,271,4,58,2,2
56582,37965,0,0,deny,66,66,0,1,0,1,0
57334,53,43556,53,allow,210,110,100,2,30,1,1
50148,80,44851,80,allow,17314,6865,10449,50,79,24,26
50160,445,0,0,drop,70,70,0,1,0,1,0
53011,445,0,0,drop,70,70,0,1,0,1,0
55728,445,0,0,drop,66,66,0,1,0,1,0
63727,61557,39781,61557,allow,312,132,180,6,6,3,3
59489,53,5531,53,allow,168,78,90,2,30,1,1
56205,53,15763,53,allow,240,110,130,2,30,1,1
60417,55100,62868,55100,allow,164,70,94,2,5,1,1
4788,53,4788,53,allow,825,99,726,2,0,1,1
42288,443,48757,443,allow,16985,7850,9135,39,121,19,20
44739,443,37697,443,allow,6220,1790,4430,19,120,10,9
50411,445,0,0,drop,66,66,0,1,0,1,0
56987,53,21347,53,allow,196,102,94,2,30,1,1
63389,3389,63389,3389,reset-both,293,223,70,4,0,3,1
53577,35894,0,0,deny,66,66,0,1,0,1,0
49503,443,13223,443,allow,9678,4552,5126,22,76,12,10
44913,443,18458,443,allow,414,140,274,7,27,3,4
65189,27015,44891,27015,allow,255,78,177,2,30,1,1
9158,443,59645,443,allow,5727,491,5236,14,15,7,7
61461,443,31107,443,allow,9073,2899,6174,36,94,19,17
55736,53,0,0,allow,623,70,553,2,30,1,1
49722,53,48716,53,allow,200,102,98,2,30,1,1
59792,80,7891,80,allow,1453540,37280,1416260,1552,96,507,1045
52233,80,14705,80,allow,1674,708,966,18,392,6,12
55179,53,47200,53,allow,178,94,84,2,30,1,1
63969,445,0,0,drop,70,70,0,1,0,1,0
29159,39004,0,0,deny,62,62,0,1,0,1,0
64369,53,59649,53,allow,240,110,130,2,30,1,1
58638,5900,0,0,deny,62,62,0,1,0,1,0
16387,20045,0,0,deny,60,60,0,1,0,1,0
62697,445,0,0,drop,70,70,0,1,0,1,0
55176,53,60647,53,allow,195,102,93,2,30,1,1
56785,443,49634,443,allow,7905,1916,5989,20,15,11,9
36629,23117,0,0,deny,62,62,0,1,0,1,0
59296,445,0,0,drop,70,70,0,1,0,1,0
56117,445,0,0,drop,66,66,0,1,0,1,0
50052,65008,0,0,deny,60,60,0,1,0,1,0
64722,53,18980,53,allow,384,94,290,4,42,2,2
49408,443,47633,443,allow,4728,2928,1800,28,95,15,13
64881,445,0,0,drop,66,66,0,1,0,1,0
9444,443,26906,443,allow,7353,1570,5783,22,39,11,11
7844,22114,0,0,deny,66,66,0,1,0,1,0
51950,445,0,0,drop,70,70,0,1,0,1,0
56512,443,45161,443,allow,155750,151462,4288,169,215,112,57
65387,443,41173,443,allow,2289,1583,706,14,18,8,6
9696,16010,0,0,deny,60,60,0,1,0,1,0
49489,443,58403,443,allow,3170,977,2193,13,135,6,7
58705,445,0,0,drop,70,70,0,1,0,1,0
59782,26467,0,0,deny,62,62,0,1,0,1,0
51124,445,0,0,drop,66,66,0,1,0,1,0
49263,53,17752,53,allow,178,94,84,2,30,1,1
62408,3478,24308,3478,allow,140,140,0,1,30,1,0
53342,443,18889,443,allow,82909,70964,11945,139,283,71,68
51922,18413,51851,18413,allow,70,70,0,1,5,1,0
57310,445,0,0,drop,66,66,0,1,0,1,0
65085,445,0,0,drop,66,66,0,1,0,1,0
21054,53,21054,53,allow,216,98,118,2,30,1,1
5588,5588,0,0,allow,3498,1872,1626,48,197,24,24
48155,443,36559,443,allow,7395,1514,5881,26,225,11,15
26480,64147,0,0,deny,62,62,0,1,0,1,0
44847,6881,59803,6881,allow,484,150,334,2,1200,1,1
51341,445,0,0,drop,66,66,0,1,0,1,0
60248,30188,0,0,deny,66,66,0,1,0,1,0
41672,53,20887,53,allow,240,76,164,2,30,1,1
56373,53,59936,53,allow,200,102,98,2,30,1,1
11967,57470,0,0,deny,62,62,0,1,0,1,0
55901,53,32764,53,allow,226,110,116,2,30,1,1
23843,26467,0,0,deny,62,62,0,1,0,1,0
54398,445,0,0,drop,70,70,0,1,0,1,0
54229,443,56153,443,allow,499,425,74,4,0,3,1
50592,445,0,0,drop,66,66,0,1,0,1,0
39311,443,39728,443,allow,12825,8114,4711,63,269,25,38
53092,443,57966,443,allow,8071,1789,6282,20,326,10,10
62026,445,0,0,drop,70,70,0,1,0,1,0
62089,8604,0,0,deny,62,62,0,1,0,1,0
47281,443,8413,443,allow,190,70,120,4,15,2,2
3027,53,3027,53,allow,199,90,109,2,30,1,1
29011,32468,0,0,deny,66,66,0,1,0,1,0
61407,443,5972,443,allow,6248,829,5419,17,29,9,8
55439,445,0,0,drop,70,70,0,1,0,1,0
49989,445,0,0,drop,70,70,0,1,0,1,0
57803,445,0,0,drop,66,66,0,1,0,1,0
60022,10387,0,0,deny,159,159,0,1,0,1,0
61110,445,0,0,drop,66,66,0,1,0,1,0
60223,445,0,0,drop,70,70,0,1,0,1,0
52508,53,51671,53,allow,168,78,90,2,30,1,1
49163,22114,0,0,deny,146,146,0,1,0,1,0
55286,53,38062,53,allow,194,102,92,2,29,1,1
57973,445,0,0,drop,66,66,0,1,0,1,0
26900,27017,15992,27017,allow,422,164,258,6,30,3,3
57470,80,24424,80,allow,230,82,148,4,1199,2,2
36907,53,36907,53,allow,237,91,146,2,33,1,1
14618,6881,0,0,deny,66,66,0,1,0,1,0
57470,64919,63117,64919,allow,594,594,0,10,1199,10,0
56861,445,0,0,drop,70,70,0,1,0,1,0
53833,26467,0,0,deny,62,62,0,1,0,1,0
35163,30188,0,0,deny,66,66,0,1,0,1,0
49175,53,18016,53,allow,193,102,91,2,30,1,1
49968,445,0,0,drop,70,70,0,1,0,1,0
49901,53,35015,53,allow,186,95,91,2,31,1,1
24972,27262,0,0,deny,60,60,0,1,0,1,0
21133,27613,37990,27613,allow,481,150,331,2,1199,1,1
62625,37965,0,0,deny,62,62,0,1,0,1,0
27348,80,31901,80,allow,1550,850,700,10,18,5,5
60945,443,60187,443,allow,1373,712,661,14,18,8,6
54602,445,0,0,drop,70,70,0,1,0,1,0
57385,445,0,0,drop,70,70,0,1,0,1,0
55370,445,0,0,drop,70,70,0,1,0,1,0
54442,445,0,0,drop,70,70,0,1,0,1,0
50724,443,48529,443,allow,12515,5891,6624,42,166,22,20
6943,21162,0,0,deny,100,100,0,1,0,1,0
60180,31573,0,0,deny,62,62,0,1,0,1,0
49323,53,45688,53,allow,192,98,94,2,30,1,1
12458,161,0,0,deny,85,85,0,1,0,1,0
46760,50584,0,0,deny,146,146,0,1,0,1,0
65495,11392,0,0,deny,62,62,0,1,0,1,0
51710,43069,28929,43069,allow,70,70,0,1,5,1,0
55944,53,48983,53,allow,762,98,664,2,30,1,1
58724,43890,0,0,deny,66,66,0,1,0,1,0
12232,41864,0,0,deny,139,139,0,1,0,1,0
59912,443,31539,443,allow,7763,1354,6409,25,82,13,12
37176,80,24453,80,allow,941,526,415,11,315,6,5
64477,3478,36622,3478,allow,189,79,110,2,301,1,1
9087,37965,0,0,deny,62,62,0,1,0,1,0
40140,53,40140,53,allow,404,259,145,3,32,2,1
57334,53,19722,53,allow,210,110,100,2,30,1,1
2440,37807,0,0,deny,66,66,0,1,0,1,0
54770,445,0,0,drop,70,70,0,1,0,1,0
50688,5222,59884,5222,allow,402,342,60,2,15,1,1
59541,445,0,0,drop,70,70,0,1,0,1,0
49703,443,4967,443,allow,421435,16499,404936,388,210,95,293
56169,53,29884,53,allow,749,94,655,2,30,1,1
60786,80,13349,80,allow,1638,1324,314,10,15,5,5
27005,27016,57447,27016,allow,885,126,759,2,30,1,1
38576,443,42458,443,allow,10853,8227,2626,30,360,15,15
55577,53,45509,53,allow,198,101,97,2,31,1,1
51422,3027,51422,3027,allow,156,156,0,3,8,3,0
38383,51221,0,0,deny,66,66,0,1,0,1,0
65254,445,0,0,drop,70,70,0,1,0,1,0
57262,443,38202,443,allow,43771,18333,25438,105,126,49,56
11825,38338,0,0,deny,86,86,0,1,0,1,0
4594,35993,0,0,deny,62,62,0,1,0,1,0
63012,53,5232,53,allow,304,86,218,2,30,1,1
41340,80,50400,80,allow,2426,1540,886,14,23,8,6
5894,44847,0,0,deny,66,66,0,1,0,1,0
50574,445,0,0,drop,70,70,0,1,0,1,0
54709,445,0,0,drop,66,66,0,1,0,1,0
64617,53,10590,53,allow,301,102,199,2,30,1,1
28192,50584,0,0,deny,66,66,0,1,0,1,0
50586,80,50586,80,allow,5320,3428,1892,22,21,12,10
50396,445,0,0,drop,70,70,0,1,0,1,0
61459,445,0,0,drop,70,70,0,1,0,1,0
9017,6881,0,0,deny,66,66,0,1,0,1,0
63404,445,0,0,drop,70,70,0,1,0,1,0
52010,53,28769,53,allow,218,85,133,2,30,1,1
49156,53,13189,53,allow,199,94,105,2,29,1,1
39059,443,37868,443,allow,3221,1299,1922,15,19,9,6
57504,44847,0,0,deny,66,66,0,1,0,1,0
34613,80,39992,80,allow,1013,504,509,10,17,6,4
51909,443,57663,443,allow,8801,2032,6769,28,361,14,14
6881,6881,0,0,deny,62,62,0,1,0,1,0
46014,443,8499,443,allow,13661,2246,11415,28,256,14,14
56506,53,3362,53,allow,184,94,90,2,30,1,1
64685,53,19809,53,allow,535,100,435,4,36,2,2
61292,445,0,0,drop,70,70,0,1,0,1,0
49945,53,22837,53,allow,821,102,719,2,30,1,1
56634,443,43198,443,allow,8865,1819,7046,24,30,14,10
56502,53,50256,53,allow,726,85,641,2,31,1,1
55849,53,21168,53,allow,190,97,93,2,31,1,1
51426,445,0,0,drop,66,66,0,1,0,1,0
54025,53,41690,53,allow,578,286,292,9,0,5,4
61589,443,61589,443,allow,4672,1765,2907,19,28,11,8
48817,51413,48817,51413,allow,460,150,310,2,1200,1,1
50477,80,50477,80,allow,20873,1203,19670,30,21,13,17
56357,53,62096,53,allow,168,86,82,2,30,1,1
64914,53,27750,53,allow,168,86,82,2,30,1,1
26601,22114,0,0,deny,62,62,0,1,0,1,0
61843,445,0,0,drop,70,70,0,1,0,1,0
65412,53,28937,53,allow,782,105,677,2,31,1,1
40244,443,63008,443,allow,21525,15159,6366,43,315,25,18
58638,5900,0,0,deny,62,62,0,1,0,1,0
63598,64147,0,0,deny,66,66,0,1,0,1,0
50866,443,31244,443,allow,9517,1897,7620,21,130,11,10
36042,53,8305,53,allow,168,78,90,2,30,1,1
3981,23117,0,0,deny,66,66,0,1,0,1,0
52160,1,0,0,deny,145,145,0,1,0,1,0
56127,53,6171,53,allow,167,86,81,2,30,1,1
53868,53,38630,53,allow,164,78,86,2,30,1,1
55215,443,18070,443,allow,3717,2233,1484,34,80,20,14
51147,443,61160,443,allow,7124,2457,4667,23,120,10,13
65136,53,36348,53,allow,438,180,258,6,30,3,3
57669,445,0,0,drop,70,70,0,1,0,1,0
9227,443,31374,443,allow,5146,960,4186,17,25,9,8
65245,53,10432,53,allow,479,98,381,4,57,2,2
50838,445,0,0,drop,70,70,0,1,0,1,0
58638,5900,0,0,deny,62,62,0,1,0,1,0
64029,445,0,0,drop,70,70,0,1,0,1,0
13684,25174,0,0,deny,62,62,0,1,0,1,0
39677,443,47798,443,allow,7123,1331,5792,22,81,11,11
49865,443,25068,443,allow,6177,1038,5139,22,56,11,11
60740,80,7735,80,allow,254,128,126,5,16,3,2
40155,25174,0,0,deny,66,66,0,1,0,1,0
65318,53,63246,53,allow,294,94,200,4,51,2,2
61645,445,0,0,drop,66,66,0,1,0,1,0
51602,22114,0,0,deny,66,66,0,1,0,1,0
54990,53,35409,53,allow,168,86,82,2,31,1,1
61832,445,0,0,drop,66,66,0,1,0,1,0
37580,443,41939,443,allow,24810,10597,14213,51,123,22,29
50265,42805,33244,42805,allow,480,149,331,2,1200,1,1
41811,443,11732,443,allow,28899,3134,25765,66,271,32,34
58982,5222,15289,5222,allow,16545,8556,7989,69,69,30,39
62687,445,0,0,drop,66,66,0,1,0,1,0
52033,445,0,0,drop,70,70,0,1,0,1,0
50289,80,7131,80,allow,7166,1086,6080,18,87,9,9
50982,445,0,0,drop,66,66,0,1,0,1,0
58183,445,0,0,drop,66,66,0,1,0,1,0
59355,51505,0,0,deny,66,66,0,1,0,1,0
56741,443,24400,443,allow,9868,2027,7841,24,20,12,12
55879,53,32478,53,allow,200,94,106,2,30,1,1
56893,53,37100,53,allow,170,87,83,2,31,1,1
53749,53572,44841,53572,allow,492,306,186,8,15,5,3
1620,53567,0,0,deny,66,66,0,1,0,1,0
63325,445,0,0,drop,70,70,0,1,0,1,0
56622,53,20942,53,allow,174,89,85,2,31,1,1
37694,80,28033,80,allow,1190,591,599,8,15,5,3
57058,53,2739,53,allow,167,86,81,2,31,1,1
58593,57470,0,0,deny,62,62,0,1,0,1,0
48424,53,48424,53,allow,220,90,130,2,30,1,1
53085,443,17021,443,allow,16024,3168,12856,56,76,31,25
49975,445,0,0,drop,70,70,0,1,0,1,0
2082,7000,2082,7000,allow,3022,1567,1455,16,15,8,8
51183,445,0,0,drop,70,70,0,1,0,1,0
65172,53,25157,53,allow,306,110,196,2,30,1,1
51451,80,37614,80,allow,214,140,74,4,15,3,1
26937,23,0,0,deny,60,60,0,1,0,1,0
49379,53,52143,53,allow,260,102,158,2,30,1,1
63003,445,0,0,drop,66,66,0,1,0,1,0
57345,443,32367,443,allow,55537,4477,51060,81,22,38,43
65262,445,0,0,drop,66,66,0,1,0,1,0
54907,445,0,0,drop,70,70,0,1,0,1,0
63278,445,0,0,drop,70,70,0,1,0,1,0
56448,53,7304,53,allow,200,102,98,2,30,1,1
49364,53,20144,53,allow,183,94,89,2,30,1,1
57294,53,58964,53,allow,387,134,253,2,30,1,1
53784,16671,31656,16671,allow,70,70,0,1,4,1,0
50014,443,7099,443,allow,5644,3210,2434,22,86,13,9
64626,53,31838,53,allow,326,102,224,2,30,1,1
51835,443,47905,443,allow,546,300,246,10,31,6,4
54518,25174,0,0,deny,62,62,0,1,0,1,0
65410,443,49825,443,allow,2494,1643,851,17,25,9,8
50535,445,0,0,drop,70,70,0,1,0,1,0
51981,445,0,0,drop,70,70,0,1,0,1,0
58956,53,19380,53,allow,213,89,124,2,30,1,1
63174,445,0,0,drop,70,70,0,1,0,1,0
55563,53,47239,53,allow,194,102,92,2,31,1,1
5223,32965,0,0,deny,66,66,0,1,0,1,0
38508,443,38508,443,allow,279067,22871,256196,327,90,145,182
58055,80,49869,80,allow,254,128,126,5,15,3,2
80,7597,0,0,deny,66,66,0,1,0,1,0
40705,443,7502,443,allow,5721,3240,2481,35,147,14,21
39871,53,52816,53,allow,198,93,105,2,31,1,1
59749,445,0,0,drop,70,70,0,1,0,1,0
52031,20301,50759,20301,allow,66,66,0,1,5,1,0
63927,50265,0,0,deny,62,62,0,1,0,1,0
64950,53,65250,53,allow,193,102,91,2,30,1,1
64592,53,58811,53,allow,209,110,99,2,30,1,1
49800,53,2151,53,allow,183,94,89,2,31,1,1
36017,53,46700,53,allow,198,93,105,2,31,1,1
52951,80,38288,80,allow,6266,4430,1836,22,358,13,9
57468,2258,57468,2258,allow,156,156,0,3,8,3,0
64137,53,55466,53,allow,228,94,134,2,30,1,1
49415,443,33045,443,allow,29561,4857,24704,44,44,15,29
50604,53,2592,53,allow,752,93,659,2,31,1,1
57772,445,0,0,drop,70,70,0,1,0,1,0
55877,47528,12404,47528,allow,491,150,341,2,1200,1,1
58638,5900,0,0,deny,62,62,0,1,0,1,0
49437,53,49111,53,allow,498,204,294,6,30,3,3
63822,14382,38807,14382,allow,70,70,0,1,4,1,0
63779,445,0,0,drop,66,66,0,1,0,1,0
64554,53,41182,53,allow,199,102,97,2,30,1,1
56415,53,13196,53,allow,199,102,97,2,29,1,1
27464,53,27464,53,allow,233,90,143,2,32,1,1
62461,445,0,0,drop,70,70,0,1,0,1,0
26263,8168,0,0,deny,66,66,0,1,0,1,0
59276,445,0,0,drop,70,70,0,1,0,1,0
64847,22114,0,0,deny,66,66,0,1,0,1,0
51848,445,0,0,drop,66,66,0,1,0,1,0
52075,80,29185,80,allow,422,240,182,8,25,5,3
47037,80,10159,80,allow,613,539,74,7,15,6,1
2267,53,18224,53,allow,204,118,86,2,31,1,1
49418,29999,18255,29999,allow,239,78,161,2,30,1,1
36302,25174,0,0,deny,146,146,0,1,0,1,0
55782,53,3411,53,allow,238,87,151,2,30,1,1
37965,15509,12475,15509,allow,481,150,331,2,1199,1,1
40428,53,46586,53,allow,168,78,90,2,30,1,1
6881,6881,0,0,deny,146,146,0,1,0,1,0
57476,445,0,0,drop,70,70,0,1,0,1,0
7347,56205,0,0,deny,62,62,0,1,0,1,0
56532,53,37108,53,allow,164,86,78,2,30,1,1
62227,443,62227,443,allow,197342,62255,135087,232,170,110,122
65166,62413,0,0,deny,66,66,0,1,0,1,0
44815,36829,0,0,deny,62,62,0,1,0,1,0
49444,443,41469,443,allow,2293735,61874,2231861,2321,87,764,1557
44674,80,41945,80,allow,1298,624,674,12,16,5,7
49366,445,0,0,drop,70,70,0,1,0,1,0
64759,445,0,0,drop,70,70,0,1,0,1,0
50473,80,50473,80,allow,78355,11395,66960,122,27,62,60
51662,443,4972,443,allow,7532,3051,4481,13,121,6,7
63963,50584,0,0,deny,66,66,0,1,0,1,0
6703,21247,0,0,deny,62,62,0,1,0,1,0
41315,11392,0,0,deny,146,146,0,1,0,1,0
48079,43227,0,0,deny,66,66,0,1,0,1,0
53120,80,53120,80,allow,26927,1133,25794,36,15,16,20
62077,443,1621,443,allow,17761,7207,10554,44,46,25,19
49744,445,0,0,drop,70,70,0,1,0,1,0
64809,53,47769,53,allow,312,78,234,2,30,1,1
49357,80,5006,80,allow,3014,1052,1962,14,97,9,5
64605,53,57757,53,allow,183,94,89,2,29,1,1
62084,445,0,0,drop,70,70,0,1,0,1,0
55261,53,40486,53,allow,716,95,621,2,31,1,1
49351,53,13338,53,allow,166,86,80,2,30,1,1
65417,44847,0,0,deny,66,66,0,1,0,1,0
58086,445,0,0,drop,70,70,0,1,0,1,0
51852,445,0,0,drop,70,70,0,1,0,1,0
58398,44847,0,0,deny,66,66,0,1,0,1,0
57617,80,57617,80,allow,542818,11392,531426,466,25,106,360
55987,53,22591,53,allow,733,85,648,2,0,1,1
60409,443,2686,443,allow,7925,1878,6047,26,66,12,14
53447,443,53447,443,allow,960,539,421,9,30,5,4
56561,53,31365,53,allow,216,110,106,2,31,1,1
64421,53,34149,53,allow,178,94,84,2,30,1,1
53105,61310,38041,61310,allow,70,70,0,1,5,1,0
52055,445,0,0,drop,70,70,0,1,0,1,0
52770,445,0,0,drop,70,70,0,1,0,1,0
56323,57470,0,0,deny,74,74,0,1,0,1,0
27005,27013,28763,27013,allow,1628,126,1502,4,31,2,2
56245,53,47709,53,allow,200,102,98,2,30,1,1
50211,51050,0,0,deny,62,62,0,1,0,1,0
59888,443,28259,443,allow,1401,864,537,12,28,6,6
51830,42707,0,0,deny,66,66,0,1,0,1,0
17676,23,0,0,deny,60,60,0,1,0,1,0
55211,53,32834,53,allow,183,94,89,2,30,1,1
38234,443,15725,443,allow,9807,2542,7265,47,19,24,23
59732,443,44274,443,allow,34866,3347,31519,55,54,22,33
54693,443,58435,443,allow,5220,922,4298,17,100,10,7
9448,443,19728,443,allow,5691,503,5188,14,15,7,7
60312,80,47441,80,allow,2390,532,1858,11,75,6,5
52200,445,0,0,drop,70,70,0,1,0,1,0
64036,53,10774,53,allow,182,93,89,2,31,1,1
49752,53,61999,53,allow,182,94,88,2,30,1,1
55743,53,6640,53,allow,748,106,642,2,31,1,1
60260,445,0,0,drop,66,66,0,1,0,1,0
64964,27035,57797,27035,allow,996,462,534,4,31,2,2
64243,53,38194,53,allow,257,102,155,2,30,1,1
64620,53,50964,53,allow,166,86,80,2,30,1,1
6886,55839,0,0,deny,139,139,0,1,0,1,0
2427,25174,0,0,deny,62,62,0,1,0,1,0
57006,53,13462,53,allow,196,102,94,2,29,1,1
5912,22114,0,0,deny,62,62,0,1,0,1,0
55586,445,0,0,drop,70,70,0,1,0,1,0
27005,27015,43819,27015,allow,868,126,742,2,30,1,1
58638,5900,0,0,deny,62,62,0,1,0,1,0
62440,443,45155,443,allow,28183,7016,21167,51,45,23,28
60691,445,0,0,drop,66,66,0,1,0,1,0
63538,80,37199,80,allow,578,518,60,2,5,1,1
56572,443,48876,443,allow,10325,2594,7731,28,27,16,12
53723,443,52693,443,allow,70,70,0,2,8,2,0
60587,445,0,0,drop,70,70,0,1,0,1,0
56156,445,0,0,drop,70,70,0,1,0,1,0
59705,445,0,0,drop,70,70,0,1,0,1,0
58672,43890,0,0,deny,66,66,0,1,0,1,0
64222,53,1206,53,allow,264,94,170,2,30,1,1
27005,27022,21223,27022,allow,890,126,764,2,31,1,1
55767,445,0,0,drop,70,70,0,1,0,1,0
50095,50584,0,0,deny,66,66,0,1,0,1,0
61545,445,0,0,drop,70,70,0,1,0,1,0
50129,445,0,0,drop,70,70,0,1,0,1,0
40657,443,5933,443,allow,9869,2395,7474,36,129,20,16
51330,445,0,0,drop,66,66,0,1,0,1,0
30960,45738,57653,45738,allow,396,396,0,7,3615,7,0
65266,53,53450,53,allow,233,102,131,2,29,1,1
64239,445,0,0,drop,66,66,0,1,0,1,0
62693,443,62693,443,allow,4788,1881,2907,19,31,11,8
62330,445,0,0,drop,70,70,0,1,0,1,0
25602,64147,0,0,deny,62,62,0,1,0,1,0
36679,443,65477,443,allow,466,392,74,4,0,3,1
63878,445,0,0,drop,70,70,0,1,0,1,0
50611,80,6797,80,allow,2933,1237,1696,12,20,7,5
55032,62413,0,0,deny,62,62,0,1,0,1,0
56703,53,19999,53,allow,199,102,97,2,30,1,1
59855,445,0,0,drop,70,70,0,1,0,1,0
33836,443,3806,443,allow,18875,13913,4962,116,788,60,56
51983,30472,5988,30472,allow,70,70,0,1,5,1,0
52373,445,0,0,drop,70,70,0,1,0,1,0
42811,443,38598,443,allow,2766,1907,859,17,25,10,7
59940,50584,0,0,deny,66,66,0,1,0,1,0
24931,25174,0,0,deny,62,62,0,1,0,1,0
49346,53,23031,53,allow,228,110,118,2,30,1,1
57093,53,32863,53,allow,711,87,624,2,30,1,1
52100,443,42530,443,allow,14433889,278906,14154983,13633,66,4079,9554
55896,53,65305,53,allow,184,94,90,2,30,1,1
36406,443,50079,443,allow,1149,709,440,13,38,8,5
55704,53,57746,53,allow,193,102,91,2,30,1,1
57364,53,57364,53,allow,213,79,134,2,32,1,1
50355,443,60927,443,allow,4137,2232,1905,13,132,8,5
55430,445,0,0,drop,70,70,0,1,0,1,0
55633,445,0,0,drop,70,70,0,1,0,1,0
55582,53,57520,53,allow,177,94,83,2,30,1,1
60064,445,0,0,drop,70,70,0,1,0,1,0
49202,53,22068,53,allow,498,204,294,6,29,3,3
15113,25174,0,0,deny,62,62,0,1,0,1,0
57131,35776,0,0,deny,145,145,0,1,0,1,0
58614,53,27966,53,allow,168,78,90,2,30,1,1
50561,445,0,0,drop,66,66,0,1,0,1,0
50738,445,0,0,drop,70,70,0,1,0,1,0
51102,80,31602,80,allow,2794,2075,719,15,30,9,6
65039,53,3857,53,allow,302,102,200,2,30,1,1
64160,445,0,0,drop,70,70,0,1,0,1,0
58131,445,0,0,drop,70,70,0,1,0,1,0
61673,443,61673,443,allow,76863,6096,70767,103,17,49,54
49590,57470,0,0,deny,78,78,0,1,0,1,0
50486,443,8859,443,allow,5791,3692,2099,21,78,13,8
64752,53,29277,53,allow,195,102,93,2,30,1,1
40369,57470,0,0,deny,62,62,0,1,0,1,0
64574,53,64558,53,allow,388,95,293,4,32,2,2
65080,53,11923,53,allow,209,110,99,2,30,1,1
34914,53,34914,53,allow,825,99,726,2,30,1,1
56741,443,30975,443,allow,8059,2039,6020,20,15,11,9
52472,445,0,0,drop,70,70,0,1,0,1,0
51837,37965,0,0,deny,66,66,0,1,0,1,0
65495,53,27520,53,allow,209,110,99,2,30,1,1
56939,53,41325,53,allow,216,110,106,2,31,1,1
49944,53,39307,53,allow,196,102,94,2,31,1,1
33774,443,40240,443,allow,9551,2173,7378,33,27,17,16
37522,22114,0,0,deny,62,62,0,1,0,1,0
52027,443,40345,443,allow,8698,1393,7305,22,16,12,10
33227,53,32032,53,allow,177,86,91,2,30,1,1
55172,445,0,0,drop,70,70,0,1,0,1,0
65453,53,23093,53,allow,311,94,217,2,30,1,1
65079,53,34794,53,allow,272,94,178,2,30,1,1
56221,445,0,0,drop,66,66,0,1,0,1,0
58612,443,21355,443,allow,154,94,60,2,5,1,1
55102,445,0,0,drop,70,70,0,1,0,1,0
55547,445,0,0,drop,70,70,0,1,0,1,0
60184,443,52371,443,allow,26293,7740,18553,55,121,26,29
64710,53,31226,53,allow,190,97,93,2,30,1,1
56491,443,52771,443,allow,6066,1016,5050,20,26,11,9
56395,443,48597,443,allow,77506,2940,74566,100,80,38,62
39437,80,3186,80,allow,2088,472,1616,15,155,3,12
49351,53,56042,53,allow,166,86,80,2,29,1,1
53322,445,0,0,drop,70,70,0,1,0,1,0
65176,53,36351,53,allow,193,102,91,2,31,1,1
63083,53,63784,53,allow,303,85,218,2,30,1,1
40082,2222,0,0,deny,60,60,0,1,0,1,0
58873,53,50618,53,allow,168,78,90,2,30,1,1
49631,443,48718,443,allow,8558,1006,7552,16,121,7,9
54220,445,0,0,drop,70,70,0,1,0,1,0
9748,21247,0,0,deny,66,66,0,1,0,1,0
61530,445,0,0,drop,66,66,0,1,0,1,0
56724,443,37476,443,allow,7941,1952,5989,20,15,11,9
37710,443,47259,443,allow,13986,9199,4787,59,94,24,35
64180,53,4267,53,allow,180,94,86,2,30,1,1
56711,53,25495,53,allow,209,110,99,2,30,1,1
55347,443,36174,443,allow,3811,2320,1491,33,735,18,15
54691,443,33638,443,allow,4851,1269,3582,21,148,9,12
62392,15503,0,0,deny,146,146,0,1,0,1,0
53567,64147,0,0,deny,66,66,0,1,0,1,0
3891,53,3891,53,allow,235,90,145,2,32,1,1
44808,443,1785,443,allow,22366,9583,12783,50,37,25,25
57025,53,16250,53,allow,168,86,82,2,30,1,1
52354,445,0,0,drop,70,70,0,1,0,1,0
44258,25,0,0,deny,74,74,0,1,0,1,0
54997,26467,0,0,deny,62,62,0,1,0,1,0
43271,50584,0,0,deny,146,146,0,1,0,1,0
3512,23,0,0,deny,60,60,0,1,0,1,0
51221,31285,26575,31285,allow,2274,924,1350,30,3293,15,15
53116,32014,29630,32014,allow,698,320,378,10,17,6,4
49948,53,31917,53,allow,177,94,83,2,30,1,1
60569,445,0,0,drop,66,66,0,1,0,1,0
60104,30188,0,0,deny,66,66,0,1,0,1,0
24127,56205,0,0,deny,66,66,0,1,0,1,0
55912,53,4881,53,allow,199,102,97,2,31,1,1
53071,25174,0,0,deny,66,66,0,1,0,1,0
49418,30010,58880,30010,allow,238,71,167,2,30,1,1
50050,443,8381,443,allow,7912,3269,4643,23,95,12,11
59282,443,30587,443,allow,5413,968,4445,20,15,11,9
48079,43227,0,0,deny,62,62,0,1,0,1,0
51446,57587,0,0,deny,100,100,0,1,0,1,0
52918,445,0,0,drop,70,70,0,1,0,1,0
37343,21247,0,0,deny,62,62,0,1,0,1,0
34902,443,35566,443,allow,70,70,0,1,5,1,0
56683,443,65170,443,allow,268,120,148,5,11,3,2
51229,445,0,0,drop,70,70,0,1,0,1,0
53944,23280,32203,23280,allow,1740,834,906,16,16,10,6
45608,443,58506,443,allow,8487,2231,6256,26,350,12,14
64284,445,0,0,drop,70,70,0,1,0,1,0
37785,80,22917,80,allow,2293,1576,717,12,15,6,6
65490,443,45608,443,allow,405489,12010,393479,416,16,146,270
50228,53,36486,53,allow,173,94,79,2,30,1,1
6126,25174,0,0,deny,62,62,0,1,0,1,0
35821,80,40158,80,allow,34712,2489,32223,52,19,27,25
61591,80,1732,80,allow,124,64,60,2,16,1,1
59370,445,0,0,drop,70,70,0,1,0,1,0
64675,445,0,0,drop,66,66,0,1,0,1,0
57470,54058,20688,54058,allow,150,150,0,1,1199,1,0
57025,445,0,0,drop,66,66,0,1,0,1,0
53480,445,0,0,drop,66,66,0,1,0,1,0
62483,445,0,0,drop,70,70,0,1,0,1,0
59254,445,0,0,drop,66,66,0,1,0,1,0
37538,37965,0,0,deny,66,66,0,1,0,1,0
49296,53,53194,53,allow,193,102,91,2,31,1,1
52651,445,0,0,drop,70,70,0,1,0,1,0
56643,53,22354,53,allow,190,97,93,2,31,1,1
49299,443,14634,443,allow,6681,1950,4731,24,45,14,10
7099,51505,0,0,deny,62,62,0,1,0,1,0
49250,53,20588,53,allow,731,85,646,2,30,1,1
50265,49754,28018,49754,allow,402,132,270,6,1209,3,3
56138,53,1894,53,allow,783,96,687,2,31,1,1
63063,443,23701,443,allow,303,85,218,2,30,1,1
49758,53,63769,53,allow,243,102,141,2,30,1,1
58879,443,4460,443,allow,5168,700,4468,16,15,7,9
65324,53,23853,53,allow,748,94,654,2,30,1,1
10874,25174,0,0,deny,62,62,0,1,0,1,0
53667,80,16085,80,allow,5090,4357,733,17,15,11,6
50559,53,13725,53,allow,216,110,106,2,29,1,1
50876,80,52453,80,allow,121344,7345,113999,144,141,61,83
55756,53,23922,53,allow,311,94,217,2,30,1,1
56782,53,51399,53,allow,197,94,103,2,30,1,1
55504,53,20782,53,allow,199,94,105,2,30,1,1
57683,53,53315,53,allow,243,94,149,2,30,1,1
42650,3389,42650,3389,allow,4930,2691,2239,24,19,14,10
49513,53,20128,53,allow,391,102,289,4,31,2,2
37533,443,8271,443,allow,5516,1774,3742,21,46,13,8
62250,23117,0,0,deny,66,66,0,1,0,1,0
3792,52700,0,0,deny,62,62,0,1,0,1,0
52056,80,60936,80,allow,3641,846,2795,18,44,7,11
48992,443,21581,443,allow,5952,1328,4624,19,76,11,8
61065,445,0,0,drop,66,66,0,1,0,1,0
26420,25174,0,0,deny,66,66,0,1,0,1,0
55008,21247,0,0,deny,62,62,0,1,0,1,0
60380,445,0,0,drop,70,70,0,1,0,1,0
55704,53,8827,53,allow,177,94,83,2,31,1,1
35414,53,44913,53,allow,168,78,90,2,30,1,1
57582,80,30299,80,allow,370,222,148,6,48,4,2
45908,443,37140,443,allow,507235,15454,491781,534,136,188,346
58638,5900,0,0,deny,62,62,0,1,0,1,0
1912,48817,0,0,deny,62,62,0,1,0,1,0
55855,445,0,0,drop,70,70,0,1,0,1,0
63046,445,0,0,drop,70,70,0,1,0,1,0
1827,64147,0,0,deny,66,66,0,1,0,1,0
51759,445,0,0,drop,66,66,0,1,0,1,0
61333,445,0,0,drop,70,70,0,1,0,1,0
56571,53,44608,53,allow,211,102,109,2,30,1,1
38565,51505,0,0,deny,62,62,0,1,0,1,0
43862,443,61828,443,allow,6600,1174,5426,23,62,13,10
56323,53,5698,53,allow,152,78,74,2,30,1,1
1972,57470,0,0,deny,78,78,0,1,0,1,0
51311,445,0,0,drop,66,66,0,1,0,1,0
52607,445,0,0,drop,70,70,0,1,0,1,0
51880,8001,48278,8001,allow,86,86,0,1,29,1,0
55806,53,43969,53,allow,200,102,98,2,32,1,1
49825,53,42990,53,allow,168,86,82,2,30,1,1
55603,443,55603,443,allow,4684,1777,2907,19,12,11,8
58927,443,34485,443,allow,5168,700,4468,16,15,7,9
65221,53,62850,53,allow,199,102,97,2,30,1,1
31011,53,31011,53,allow,197,76,121,2,30,1,1
36586,80,45063,80,allow,1114,534,580,12,15,7,5
50367,445,0,0,drop,70,70,0,1,0,1,0
58057,443,19504,443,allow,6821,1076,5745,21,38,12,9
54539,443,59530,443,allow,4867,1208,3659,16,23,10,6
50700,80,7007,80,allow,142,142,0,1,5,1,0
60779,80,5237,80,allow,1248,516,732,9,15,4,5
64276,53,2363,53,allow,354,102,252,2,30,1,1
57655,56205,0,0,deny,62,62,0,1,0,1,0
49359,53,18838,53,allow,216,110,106,2,30,1,1
6881,6881,44839,6881,allow,238,118,120,2,1200,1,1
57096,445,0,0,drop,66,66,0,1,0,1,0
55106,53,41822,53,allow,177,94,83,2,30,1,1
60561,445,0,0,drop,66,66,0,1,0,1,0
64747,445,0,0,drop,70,70,0,1,0,1,0
64559,53,43720,53,allow,168,86,82,2,30,1,1
55677,445,0,0,drop,70,70,0,1,0,1,0
63975,445,0,0,drop,70,70,0,1,0,1,0
5588,5588,0,0,allow,3354,1792,1562,46,196,23,23
55406,25174,0,0,deny,66,66,0,1,0,1,0
55311,53,38927,53,allow,298,101,197,4,31,2,2
19412,53,19412,53,allow,229,98,131,2,30,1,1
40786,53,0,0,allow,82,82,0,1,30,1,0
10063,443,38761,443,allow,822903,35544,787359,1068,153,463,605
55083,53,1182,53,allow,216,110,106,2,30,1,1
55636,80,55636,80,allow,1916,1467,449,10,19,6,4
49772,80,38136,80,allow,70,70,0,2,8,2,0
50316,25604,0,0,deny,66,66,0,1,0,1,0
9505,443,9745,443,allow,3613,433,3180,11,16,6,5
58986,445,0,0,drop,70,70,0,1,0,1,0
50771,445,0,0,drop,70,70,0,1,0,1,0
50467,80,50467,80,allow,886702,38812,847890,1134,23,558,576
25209,53,25209,53,allow,240,98,142,2,30,1,1
53746,53,62050,53,allow,164,78,86,2,31,1,1
55066,53,27707,53,allow,180,94,86,2,30,1,1
60431,52867,31778,52867,allow,70,70,0,2,8,2,0
64145,445,0,0,drop,66,66,0,1,0,1,0
59785,443,14021,443,allow,1077274,41232,1036042,1152,49,455,697
13462,35440,0,0,deny,62,62,0,1,0,1,0
54110,445,0,0,drop,70,70,0,1,0,1,0
50936,80,62610,80,allow,10423067,111935,10311132,8558,119,1601,6957
61053,44847,0,0,deny,66,66,0,1,0,1,0
52374,445,0,0,drop,70,70,0,1,0,1,0
53977,443,23449,443,allow,3330,1694,1636,15,30,8,7
50010,445,0,0,drop,70,70,0,1,0,1,0
50875,80,60669,80,allow,141059,7791,133268,168,140,72,96
53987,57470,0,0,deny,66,66,0,1,0,1,0
56039,50584,0,0,deny,62,62,0,1,0,1,0
54898,36237,0,0,deny,66,66,0,1,0,1,0
50987,10086,44124,10086,allow,217,157,60,2,5,1,1
45196,443,61474,443,allow,6357,1546,4811,26,17,14,12
65224,53,29187,53,allow,232,110,122,2,30,1,1
61766,44847,0,0,deny,66,66,0,1,0,1,0
59272,445,0,0,drop,66,66,0,1,0,1,0
51909,6881,0,0,deny,66,66,0,1,0,1,0
50579,80,48781,80,allow,265114,13651,251463,346,76,161,185
63755,445,0,0,drop,66,66,0,1,0,1,0
56735,443,32808,443,allow,7942,1953,5989,20,15,11,9
54485,80,18876,80,allow,130,70,60,2,15,1,1
44907,5900,44907,5900,allow,130,66,64,2,4,1,1
51993,25174,0,0,deny,66,66,0,1,0,1,0
51652,445,0,0,drop,70,70,0,1,0,1,0
56265,53,56216,53,allow,213,94,119,2,30,1,1
55445,53,56296,53,allow,711,87,624,2,30,1,1
64260,53,40725,53,allow,230,86,144,2,30,1,1
6980,48543,0,0,deny,139,139,0,1,0,1,0
57225,53,63764,53,allow,177,94,83,2,30,1,1
53590,445,0,0,drop,70,70,0,1,0,1,0
56858,32330,59933,32330,allow,66,66,0,1,5,1,0
40876,443,14567,443,allow,6450,1003,5447,21,360,11,10
56246,445,0,0,drop,70,70,0,1,0,1,0
53667,56205,0,0,deny,62,62,0,1,0,1,0
60613,443,54092,443,allow,154465,11473,142992,244,212,101,143
65047,53,60656,53,allow,184,102,82,2,30,1,1
60948,443,3715,443,allow,1373,712,661,14,18,8,6
39684,80,40129,80,allow,680,70,610,11,392,2,9
35263,443,2697,443,allow,22457,12680,9777,65,20,34,31
37555,16384,61049,16384,allow,130,70,60,2,30,1,1
56863,80,39475,80,allow,13608,783,12825,21,45,9,12
64016,53,52366,53,allow,184,94,90,2,30,1,1
53064,445,0,0,drop,66,66,0,1,0,1,0
63542,15503,0,0,deny,62,62,0,1,0,1,0
53381,25174,0,0,deny,66,66,0,1,0,1,0
54833,443,54833,443,allow,306802,26705,280097,395,21,190,205
56430,443,45343,443,allow,10956,4863,6093,47,82,22,25
26884,37965,0,0,deny,66,66,0,1,0,1,0
45309,443,7993,443,allow,3094,2048,1046,18,16,9,9
56993,80,53078,80,allow,214,140,74,4,35,3,1
65518,5710,0,0,deny,62,62,0,1,0,1,0
65262,53,47231,53,allow,216,110,106,2,30,1,1
57100,53,28423,53,allow,180,94,86,2,31,1,1
61000,15503,0,0,deny,146,146,0,1,0,1,0
60212,445,0,0,drop,70,70,0,1,0,1,0
65291,53,24701,53,allow,195,102,93,2,30,1,1
6999,11119,0,0,deny,143,143,0,1,0,1,0
54382,53,54382,53,allow,414,268,146,3,33,2,1
39426,443,8694,443,allow,903603,21528,882075,858,57,234,624
50265,56845,47720,56845,allow,480,149,331,2,1200,1,1
53736,445,0,0,drop,66,66,0,1,0,1,0
9184,80,49214,80,allow,2066,651,1415,11,35,6,5
10669,49756,0,0,deny,60,60,0,1,0,1,0
56474,53,60230,53,allow,209,110,99,2,29,1,1
65498,53,26410,53,allow,209,110,99,2,30,1,1
57604,32480,0,0,deny,62,62,0,1,0,1,0
57001,53,50963,53,allow,210,110,100,2,30,1,1
41388,1433,0,0,deny,60,60,0,1,0,1,0
52270,443,52270,443,allow,1615,941,674,15,20,7,8
49673,443,32250,443,allow,6404,829,5575,18,57,9,9
34351,443,4638,443,allow,402051,17714,384337,520,83,228,292
45832,51050,0,0,deny,66,66,0,1,0,1,0
59661,443,56024,443,allow,9055,2404,6651,24,126,13,11
34430,53,54160,53,allow,199,94,105,2,30,1,1
51788,35787,25759,35787,allow,70,70,0,1,4,1,0
443,4205,0,0,deny,320,320,0,1,0,1,0
64559,53,24538,53,allow,182,94,88,2,30,1,1
42298,40028,40095,40028,allow,563,86,477,2,30,1,1
64385,53,21883,53,allow,307,105,202,4,47,2,2
57143,53,42791,53,allow,184,94,90,2,30,1,1
39011,80,17481,80,allow,1114,534,580,12,15,7,5
55056,56205,0,0,deny,62,62,0,1,0,1,0
56409,443,57180,443,allow,25302,1733,23569,35,121,16,19
60063,443,64614,443,allow,432803,9264,423539,427,141,135,292
56562,53,48636,53,allow,182,93,89,2,31,1,1
62236,445,0,0,drop,66,66,0,1,0,1,0
55043,57470,0,0,deny,78,78,0,1,0,1,0
6882,51505,0,0,deny,66,66,0,1,0,1,0
49332,53,39051,53,allow,740,93,647,2,31,1,1
65176,53,35365,53,allow,182,93,89,2,30,1,1
25889,11446,0,0,deny,66,66,0,1,0,1,0
58890,53,0,0,allow,180,82,98,2,31,1,1
11951,45026,0,0,deny,60,60,0,1,0,1,0
55577,53,26571,53,allow,199,102,97,2,30,1,1
27005,1301,24545,1301,allow,860,126,734,2,30,1,1
20457,51185,0,0,deny,72,72,0,1,0,1,0
19270,56448,0,0,deny,78,78,0,1,0,1,0
58550,445,0,0,drop,66,66,0,1,0,1,0
51571,445,0,0,drop,70,70,0,1,0,1,0
56436,80,34544,80,allow,17067,1439,15628,23,25,8,15
62920,445,0,0,drop,70,70,0,1,0,1,0
64874,445,0,0,drop,70,70,0,1,0,1,0
56922,53,63628,53,allow,168,86,82,2,31,1,1
50569,80,5164,80,allow,318,192,126,6,26,4,2
50524,443,21568,443,allow,1389,868,521,12,25,6,6
52555,443,31121,443,allow,4362,1826,2536,18,134,8,10
6666,2001,0,0,deny,60,60,0,1,0,1,0
63043,445,0,0,drop,70,70,0,1,0,1,0
27005,27018,12355,27018,allow,879,126,753,2,30,1,1
27005,37579,44292,37579,allow,886,126,760,2,30,1,1
52459,33890,0,0,deny,60,60,0,1,0,1,0
3478,61463,0,0,deny,804,804,0,1,0,1,0
56772,53,47377,53,allow,168,86,82,2,30,1,1
40312,55442,0,0,deny,62,62,0,1,0,1,0
50263,445,0,0,drop,70,70,0,1,0,1,0
9461,443,60064,443,allow,2581,1602,979,17,20,9,8
58010,445,0,0,drop,70,70,0,1,0,1,0
55090,53,34414,53,allow,196,102,94,2,29,1,1
56911,53,22477,53,allow,211,78,133,2,30,1,1
51674,445,0,0,drop,70,70,0,1,0,1,0
63474,48817,0,0,deny,66,66,0,1,0,1,0
58911,443,49541,443,allow,23915,4341,19574,37,120,15,22
55736,445,0,0,drop,70,70,0,1,0,1,0
41477,50584,0,0,deny,66,66,0,1,0,1,0
55317,445,0,0,drop,70,70,0,1,0,1,0
61078,57470,0,0,deny,145,145,0,1,0,1,0
55633,53,59677,53,allow,195,102,93,2,30,1,1
37604,443,53490,443,allow,8493,2314,6179,33,16,18,15
60571,26467,0,0,deny,62,62,0,1,0,1,0
57394,53,39709,53,allow,193,102,91,2,31,1,1
39065,443,4463,443,allow,3589,1251,2338,15,20,9,6
62452,21247,0,0,deny,66,66,0,1,0,1,0
59477,36829,0,0,deny,62,62,0,1,0,1,0
64681,53,5691,53,allow,86,86,0,1,60,1,0
50460,443,50460,443,allow,1159,668,491,11,31,6,5
51017,80,29159,80,allow,2654,796,1858,12,18,7,5
55365,53,41996,53,allow,184,94,90,2,31,1,1
63830,445,0,0,drop,70,70,0,1,0,1,0
37096,443,33249,443,allow,1753,1108,645,16,26,9,7
36656,64147,0,0,deny,62,62,0,1,0,1,0
49615,53,57263,53,allow,199,102,97,2,30,1,1
58638,5900,0,0,deny,62,62,0,1,0,1,0
50966,443,34957,443,allow,6350,1072,5278,18,40,10,8
57290,443,45371,443,allow,2693,1361,1332,17,19,10,7
64582,443,48743,443,allow,24686,1935,22751,36,19,17,19
49667,443,61228,443,allow,334,140,194,6,25,3,3
64524,53,20476,53,allow,274,94,180,4,33,2,2
51959,443,18601,443,allow,20648,4726,15922,40,48,19,21
58785,53,58785,53,allow,216,90,126,2,30,1,1
3478,61463,0,0,deny,1305,1305,0,1,0,1,0
64945,53,44242,53,allow,243,94,149,2,30,1,1
56897,11446,0,0,deny,66,66,0,1,0,1,0
49347,53,23678,53,allow,342,91,251,4,54,2,2
40301,8696,0,0,deny,60,60,0,1,0,1,0
58787,23,0,0,deny,60,60,0,1,0,1,0
16425,15503,0,0,deny,62,62,0,1,0,1,0
36604,443,8659,443,allow,6506,1532,4974,28,16,14,14
52980,445,0,0,drop,70,70,0,1,0,1,0
58638,5900,0,0,deny,62,62,0,1,0,1,0
52098,443,38562,443,allow,3015,2037,978,15,15,9,6
51161,445,0,0,drop,70,70,0,1,0,1,0
56844,443,48471,443,allow,10878,4815,6063,60,196,31,29
56127,37965,0,0,deny,66,66,0,1,0,1,0
31227,53,31227,53,allow,407,261,146,3,32,2,1
49731,443,14153,443,allow,13155,3815,9340,29,24,13,16
64240,50584,0,0,deny,66,66,0,1,0,1,0
53252,445,0,0,drop,66,66,0,1,0,1,0
51887,445,0,0,drop,70,70,0,1,0,1,0
56919,53,23059,53,allow,423,95,328,4,34,2,2
22783,64147,0,0,deny,66,66,0,1,0,1,0
55048,53,59185,53,allow,780,104,676,2,30,1,1
51996,35440,0,0,deny,66,66,0,1,0,1,0
64526,53,11461,53,allow,377,94,283,2,30,1,1
55849,53,3530,53,allow,889,404,485,10,30,5,5
37008,42707,0,0,deny,62,62,0,1,0,1,0
56799,80,63768,80,allow,1514,481,1033,11,15,6,5
27005,27015,61856,27015,allow,888,126,762,2,30,1,1
443,28553,0,0,deny,74,74,0,1,0,1,0
64284,53,35627,53,allow,306,94,212,2,29,1,1
56320,53,39261,53,allow,182,93,89,2,31,1,1
54351,53,59901,53,allow,168,78,90,2,29,1,1
44774,22114,0,0,deny,146,146,0,1,0,1,0
56742,443,47140,443,allow,8007,1987,6020,20,15,11,9
58283,443,44449,443,allow,42792,12402,30390,98,370,45,53
60378,443,38205,443,allow,130,70,60,2,15,1,1
41296,80,53379,80,allow,1056,682,374,10,15,6,4
34360,25174,0,0,deny,62,62,0,1,0,1,0
49383,445,0,0,drop,70,70,0,1,0,1,0
50022,53,4784,53,allow,198,110,88,2,29,1,1
50374,445,0,0,drop,66,66,0,1,0,1,0
46215,443,63410,443,allow,4182,2874,1308,17,361,9,8
56319,445,0,0,drop,70,70,0,1,0,1,0
64929,53,46254,53,allow,168,86,82,2,31,1,1
56713,25174,0,0,deny,146,146,0,1,0,1,0
9155,443,45491,443,allow,5734,498,5236,14,15,7,7
55352,53,6913,53,allow,216,110,106,2,31,1,1
52804,443,52702,443,allow,70,70,0,2,154,2,0
49477,53,9524,53,allow,271,88,183,4,59,2,2
53782,445,0,0,drop,66,66,0,1,0,1,0
55733,53,46336,53,allow,177,94,83,2,29,1,1
58638,5900,0,0,deny,62,62,0,1,0,1,0
49457,445,0,0,drop,66,66,0,1,0,1,0
44411,37965,0,0,deny,62,62,0,1,0,1,0
55255,37965,0,0,deny,146,146,0,1,0,1,0
64622,36829,0,0,deny,62,62,0,1,0,1,0
35543,443,52290,443,allow,7298,2601,4697,21,26,10,11
58782,53,58782,53,allow,310,94,216,2,30,1,1
50402,80,18324,80,allow,5981,3589,2392,15,32,8,7
55776,53,13718,53,allow,182,93,89,3,33,2,1
64433,53,29795,53,allow,214,102,112,2,30,1,1
53255,445,0,0,drop,70,70,0,1,0,1,0
60401,445,0,0,drop,70,70,0,1,0,1,0
65224,445,0,0,drop,66,66,0,1,0,1,0
58902,445,0,0,drop,70,70,0,1,0,1,0
57247,445,0,0,drop,66,66,0,1,0,1,0
50065,445,0,0,drop,70,70,0,1,0,1,0
58638,5900,0,0,deny,62,62,0,1,0,1,0
55619,445,0,0,drop,70,70,0,1,0,1,0
37352,80,54268,80,allow,1115,562,553,13,362,6,7
60449,445,0,0,drop,70,70,0,1,0,1,0
57346,445,0,0,drop,70,70,0,1,0,1,0
0,0,0,0,deny,98,98,0,1,0,1,0
64814,53,63374,53,allow,212,102,110,2,30,1,1
63411,445,0,0,drop,70,70,0,1,0,1,0
55928,80,55928,80,allow,17982,2112,15870,35,28,18,17
60765,445,0,0,drop,66,66,0,1,0,1,0
44884,443,49689,443,allow,296,78,218,4,19,1,3
13907,57470,0,0,deny,66,66,0,1,0,1,0
55800,445,0,0,drop,70,70,0,1,0,1,0
49497,445,0,0,drop,70,70,0,1,0,1,0
50178,53,59652,53,allow,178,94,84,2,29,1,1
62020,64147,0,0,deny,145,145,0,1,0,1,0
35945,8080,16769,8080,allow,170,110,60,2,5,1,1
21892,15503,0,0,deny,62,62,0,1,0,1,0
443,23220,0,0,deny,100,100,0,1,0,1,0
35978,443,55185,443,allow,2959,793,2166,10,120,5,5
50315,445,0,0,drop,66,66,0,1,0,1,0
47783,50432,0,0,deny,62,62,0,1,0,1,0
65359,53,55689,53,allow,193,102,91,2,30,1,1
60374,443,14239,443,allow,15475,7059,8416,33,97,18,15
61924,80,25773,80,allow,2170,472,1698,10,125,6,4
32071,51221,0,0,deny,66,66,0,1,0,1,0
52795,443,61686,443,allow,7203,2188,5015,23,186,11,12
42167,443,27521,443,allow,4117,1026,3091,15,31,9,6
57319,53,46855,53,allow,353,94,259,2,30,1,1
63071,445,0,0,drop,70,70,0,1,0,1,0
51615,25174,0,0,deny,62,62,0,1,0,1,0
47652,51505,0,0,deny,62,62,0,1,0,1,0
56646,445,0,0,drop,70,70,0,1,0,1,0
42658,443,41427,443,allow,10170,2072,8098,37,255,19,18
58638,5900,0,0,deny,62,62,0,1,0,1,0
53323,35253,0,0,deny,62,62,0,1,0,1,0
51174,80,58764,80,allow,1658,1344,314,10,15,5,5
49131,443,28166,443,allow,6150,914,5236,18,97,10,8
59597,445,0,0,drop,66,66,0,1,0,1,0
53017,80,53017,80,allow,184725,5028,179697,217,25,75,142
56868,53,63238,53,allow,752,93,659,2,30,1,1
50584,51413,16088,51413,allow,475,150,325,2,1200,1,1
9335,443,4512,443,allow,674,128,546,12,45,3,9
49418,33058,55897,33058,allow,244,78,166,2,30,1,1
54676,443,17245,443,allow,5747,1892,3855,19,17,11,8
50293,445,0,0,drop,70,70,0,1,0,1,0
59965,36237,0,0,deny,66,66,0,1,0,1,0
54826,443,54826,443,allow,158092,23051,135041,216,21,110,106
443,18411,0,0,deny,74,74,0,1,0,1,0
46093,443,55794,443,allow,14746,3097,11649,34,19,19,15
45052,80,23641,80,allow,1539,553,986,10,14,6,4
45941,23386,0,0,deny,60,60,0,1,0,1,0
51604,443,33369,443,allow,19611,6865,12746,46,37,24,22
48882,443,39008,443,allow,8105,1902,6203,24,26,14,10
52213,56682,55020,56682,allow,66,66,0,1,5,1,0
1024,62609,0,0,deny,148,148,0,1,0,1,0
52875,443,25381,443,allow,89335,4699,84636,107,118,32,75
49632,53,14328,53,allow,199,102,97,2,30,1,1
52059,80,19994,80,allow,426,240,186,8,25,5,3
58227,445,0,0,drop,66,66,0,1,0,1,0
54470,443,54470,443,allow,101021,6173,94848,142,18,65,77
50736,445,0,0,drop,66,66,0,1,0,1,0
53808,443,30751,443,allow,499,425,74,4,0,3,1
53059,445,0,0,drop,70,70,0,1,0,1,0
43194,32480,0,0,deny,145,145,0,1,0,1,0
51375,445,0,0,drop,66,66,0,1,0,1,0
64072,445,0,0,drop,66,66,0,1,0,1,0
49486,53,16915,53,allow,177,94,83,2,30,1,1
55070,53,47871,53,allow,195,102,93,2,31,1,1
50499,53,23624,53,allow,718,94,624,2,30,1,1
50590,53,53774,53,allow,889,404,485,10,30,5,5
57338,443,31270,443,allow,222159,52803,169356,361,26,173,188
58528,445,0,0,drop,66,66,0,1,0,1,0
55053,443,38835,443,allow,23234,3906,19328,40,61,19,21
49949,443,7206,443,allow,4712,908,3804,18,89,9,9
57011,49813,0,0,deny,66,66,0,1,0,1,0
36025,443,36025,443,allow,4585,1678,2907,19,29,11,8
59101,53,46129,53,allow,195,94,101,2,30,1,1
51002,443,58115,443,allow,3536,2198,1338,18,332,9,9
64104,53,45169,53,allow,288,101,187,4,28,2,2
36908,26467,0,0,deny,62,62,0,1,0,1,0
56562,443,49879,443,allow,8821,3228,5593,25,60,15,10
56367,53,52598,53,allow,188,96,92,2,31,1,1
51620,56205,0,0,deny,62,62,0,1,0,1,0
37855,443,39398,443,allow,25928,15100,10828,59,39,37,22
7288,25174,0,0,deny,66,66,0,1,0,1,0
43666,443,10694,443,allow,13212,9431,3781,41,238,21,20
55101,53,52227,53,allow,197,102,95,2,31,1,1
60766,28080,64298,28080,allow,70,70,0,2,8,2,0
40189,443,26952,443,allow,7221,2940,4281,30,23,16,14
54730,445,0,0,drop,66,66,0,1,0,1,0
25961,55783,0,0,deny,66,66,0,1,0,1,0
62341,445,0,0,drop,70,70,0,1,0,1,0
65208,445,0,0,drop,70,70,0,1,0,1,0
54687,445,0,0,drop,70,70,0,1,0,1,0
7905,22114,0,0,deny,62,62,0,1,0,1,0
54810,80,61461,80,allow,6098,1916,4182,31,357,16,15
4738,53,4738,53,allow,213,87,126,2,30,1,1
48817,63838,48817,63838,allow,513,152,361,2,1200,1,1
50358,443,36799,443,allow,1786,172,1614,7,121,3,4
51580,53,9399,53,allow,199,94,105,2,30,1,1
26835,47993,0,0,deny,62,62,0,1,0,1,0
56824,3389,56824,3389,allow,3910,1805,2105,20,18,12,8
49593,53,57101,53,allow,212,94,118,2,29,1,1
62048,445,0,0,drop,66,66,0,1,0,1,0
40603,443,49368,443,allow,9462,6402,3060,32,394,11,21
52858,443,52858,443,allow,313243,267937,45306,456,5925,210,246
63057,53,17577,53,allow,304,86,218,2,30,1,1
65313,445,0,0,drop,70,70,0,1,0,1,0
62913,993,11946,993,allow,9122,4055,5067,84,67,39,45
45344,443,7513,443,allow,2593,1394,1199,20,13,11,9
60113,22114,0,0,deny,66,66,0,1,0,1,0
51899,47537,54934,47537,allow,70,70,0,2,8,2,0
59101,445,0,0,drop,66,66,0,1,0,1,0
65246,445,0,0,drop,66,66,0,1,0,1,0
49784,445,0,0,drop,66,66,0,1,0,1,0
49916,443,14101,443,allow,2970,1793,1177,20,15,12,8
52128,37807,0,0,deny,66,66,0,1,0,1,0
63999,10552,13138,10552,allow,66,66,0,2,8,2,0
56941,53,32595,53,allow,212,102,110,2,30,1,1
58638,5900,0,0,deny,62,62,0,1,0,1,0
49948,53,19107,53,allow,380,110,270,2,30,1,1
46398,443,65303,443,allow,12982,7168,5814,50,165,23,27
54437,443,40534,443,allow,716056,89267,626789,952,300,368,584
63873,44847,0,0,deny,66,66,0,1,0,1,0
47207,443,60906,443,allow,11085,2554,8531,48,19,24,24
46837,57470,0,0,deny,62,62,0,1,0,1,0
49483,53,5607,53,allow,273,94,179,2,30,1,1
58306,443,35402,443,allow,5995,3536,2459,31,20,17,14
15499,22114,0,0,deny,62,62,0,1,0,1,0
63495,50584,0,0,deny,66,66,0,1,0,1,0
50052,65008,0,0,deny,60,60,0,1,0,1,0
24480,35440,0,0,deny,62,62,0,1,0,1,0
49418,30002,50815,30002,allow,242,71,171,2,30,1,1
54438,443,22711,443,allow,8198,1975,6223,24,361,11,13
52025,445,0,0,drop,66,66,0,1,0,1,0
58719,445,0,0,drop,70,70,0,1,0,1,0
10949,22114,0,0,deny,146,146,0,1,0,1,0
40571,26467,0,0,deny,62,62,0,1,0,1,0
50245,44847,0,0,deny,66,66,0,1,0,1,0
3478,61463,0,0,deny,780,780,0,1,0,1,0
57511,123,47594,123,allow,184,94,90,2,29,1,1
56536,443,9088,443,allow,8866,2743,6123,23,139,11,12
49213,53,44755,53,allow,211,102,109,2,30,1,1
59035,445,0,0,drop,66,66,0,1,0,1,0
65348,53,36995,53,allow,170,87,83,2,30,1,1
54496,445,0,0,drop,70,70,0,1,0,1,0
49324,443,52610,443,allow,6147,943,5204,17,16,9,8
63194,50265,0,0,deny,62,62,0,1,0,1,0
54119,445,0,0,drop,66,66,0,1,0,1,0
443,60040,0,0,deny,60,60,0,1,0,1,0
53290,443,5427,443,allow,494,288,206,8,26,5,3
52032,55505,56842,55505,allow,70,70,0,2,8,2,0
53735,443,34476,443,allow,499,425,74,4,0,3,1
49759,53,30943,53,allow,216,110,106,2,31,1,1
41576,443,6870,443,allow,5954,1607,4347,27,215,14,13
3406,17372,0,0,deny,66,66,0,1,0,1,0
49771,53,28192,53,allow,177,94,83,2,29,1,1
63400,57470,0,0,deny,66,66,0,1,0,1,0
65016,53,63384,53,allow,215,94,121,2,29,1,1
38663,15000,54810,15000,allow,138,78,60,2,5,1,1
55970,53,19238,53,allow,760,97,663,2,31,1,1
54022,445,0,0,drop,70,70,0,1,0,1,0
63086,53,16338,53,allow,512,166,346,2,30,1,1
39198,443,37054,443,allow,6328,850,5478,26,289,9,17
9459,443,54316,443,allow,5695,505,5190,14,15,7,7
49332,53,50877,53,allow,281,98,183,4,57,2,2
37989,49152,16381,49152,allow,156,156,0,3,8,3,0
58468,37965,0,0,deny,66,66,0,1,0,1,0
55591,53,22310,53,allow,195,102,93,2,30,1,1
65038,53,25509,53,allow,165,86,79,2,30,1,1
50465,80,35475,80,allow,8499,2011,6488,17,21,8,9
65149,443,54688,443,allow,2963,1304,1659,28,120,14,14
8999,15503,0,0,deny,146,146,0,1,0,1,0
43608,53,16507,53,allow,199,94,105,2,30,1,1
51827,56205,0,0,deny,66,66,0,1,0,1,0
61341,445,0,0,drop,66,66,0,1,0,1,0
35185,3389,35185,3389,allow,3424,1710,1714,16,33,8,8
41365,443,33138,443,allow,27475,5634,21841,76,145,35,41
50563,445,0,0,drop,70,70,0,1,0,1,0
49841,80,51896,80,allow,3126,469,2657,9,75,5,4
5588,5588,0,0,allow,3562,1936,1626,48,194,24,24
58486,57470,0,0,deny,66,66,0,1,0,1,0
65414,53,34166,53,allow,197,102,95,2,30,1,1
48279,8080,0,0,allow,368,156,212,5,13,3,2
62485,445,0,0,drop,70,70,0,1,0,1,0
65189,27268,56111,27268,allow,232,78,154,2,29,1,1
2717,31573,0,0,deny,62,62,0,1,0,1,0
53229,443,57933,443,allow,91414,11700,79714,174,59,65,109
63984,53,63454,53,allow,264,110,154,2,30,1,1
65376,443,34209,443,allow,55500,40540,14960,137,131,72,65
41247,80,52056,80,allow,234,234,0,4,12,4,0
60949,445,0,0,drop,66,66,0,1,0,1,0
56626,53,22670,53,allow,710,89,621,2,31,1,1
63515,445,0,0,drop,66,66,0,1,0,1,0
64622,445,0,0,drop,66,66,0,1,0,1,0
56531,53,17376,53,allow,309,94,215,2,30,1,1
42881,443,29777,443,allow,134,60,74,3,4,2,1
50734,80,51242,80,allow,1114,534,580,12,16,7,5
65486,53,11134,53,allow,760,97,663,2,30,1,1
64633,53,20577,53,allow,255,102,153,2,30,1,1
49671,80,23759,80,allow,2122,1018,1104,13,41,7,6
57351,53,35105,53,allow,184,94,90,2,30,1,1
49266,443,52610,443,allow,183,70,113,2,120,1,1
55392,445,0,0,drop,70,70,0,1,0,1,0
52064,80,62647,80,allow,65658,3155,62503,76,621,26,50
52902,443,33545,443,allow,13263,7381,5882,51,118,26,25
16905,57866,0,0,deny,66,66,0,1,0,1,0
59031,25174,0,0,deny,62,62,0,1,0,1,0
55625,53,6982,53,allow,94,94,0,1,30,1,0
56423,80,12556,80,allow,33937,628,33309,31,104,6,25
58253,25174,0,0,deny,146,146,0,1,0,1,0
49506,443,13324,443,allow,6002,1965,4037,23,270,11,12
49335,443,62056,443,allow,125790,4516,121274,118,55,28,90
53043,443,3283,443,allow,11020,3760,7260,56,92,25,31
56639,443,28147,443,allow,7849,1860,5989,20,16,11,9
50822,80,16918,80,allow,550,476,74,6,15,5,1
0,0,0,0,allow,320,320,0,5,0,5,0
54526,443,1853,443,allow,33625519,489773,33135746,29877,243,6803,23074
49319,53,62578,53,allow,199,102,97,2,30,1,1
47461,50584,0,0,deny,62,62,0,1,0,1,0
50169,25174,0,0,deny,62,62,0,1,0,1,0
51965,443,54764,443,allow,12738,5385,7353,37,67,21,16
35955,5228,64424,5228,allow,6776,1542,5234,21,3600,12,9
33871,34476,0,0,deny,137,137,0,1,0,1,0
52768,445,0,0,drop,70,70,0,1,0,1,0
6676,63836,0,0,deny,145,145,0,1,0,1,0
58682,80,4123,80,allow,1345,726,619,16,362,8,8
43625,53,13195,53,allow,86,86,0,1,30,1,0
24504,37965,0,0,deny,62,62,0,1,0,1,0
38886,53,39118,53,allow,223,78,145,2,30,1,1
64850,53,16958,53,allow,196,102,94,2,30,1,1
58638,5900,0,0,deny,62,62,0,1,0,1,0
64318,53,59823,53,allow,182,93,89,2,31,1,1
55221,445,0,0,drop,66,66,0,1,0,1,0
9510,443,20445,443,allow,3615,435,3180,11,15,6,5
47164,15000,48096,15000,allow,130,70,60,2,5,1,1
9407,443,42706,443,allow,5697,503,5194,14,15,7,7
55015,53,27863,53,allow,733,94,639,2,30,1,1
64751,53,33597,53,allow,178,94,84,2,30,1,1
57067,53,18004,53,allow,183,94,89,2,29,1,1
10007,443,53248,443,allow,3811,1846,1965,20,330,9,11
51244,445,0,0,drop,70,70,0,1,0,1,0
48345,443,50795,443,allow,940826,59470,881356,1101,190,412,689
58638,5900,0,0,deny,62,62,0,1,0,1,0
53957,35440,0,0,deny,146,146,0,1,0,1,0
52135,445,0,0,drop,66,66,0,1,0,1,0
53620,445,0,0,drop,70,70,0,1,0,1,0
49236,8080,49236,8080,allow,4458,1336,3122,13,53,7,6
23006,48817,0,0,deny,62,62,0,1,0,1,0
63566,443,27176,443,allow,2537,1268,1269,23,186,12,11
49936,53,59450,53,allow,216,110,106,2,31,1,1
14042,22114,0,0,deny,62,62,0,1,0,1,0
55127,445,0,0,drop,70,70,0,1,0,1,0
65131,53,31647,53,allow,168,86,82,2,30,1,1
21133,6889,63864,6889,allow,481,150,331,2,1199,1,1
54262,53,54262,53,allow,216,82,134,2,33,1,1
1594,44847,0,0,deny,62,62,0,1,0,1,0
53697,6224,21795,6224,allow,70,70,0,2,8,2,0
65307,53,59322,53,allow,184,94,90,2,29,1,1
49416,80,5310,80,allow,318,192,126,6,28,4,2
55372,53,7739,53,allow,448,184,264,6,30,3,3
64384,53,46498,53,allow,350,94,256,2,30,1,1
33183,23,0,0,deny,60,60,0,1,0,1,0
65143,53,18193,53,allow,184,94,90,2,30,1,1
57344,53,11119,53,allow,969,86,883,2,30,1,1
49396,80,45610,80,allow,13738839,196158,13542681,11272,248,2231,9041
64059,30188,0,0,deny,62,62,0,1,0,1,0
56826,31310,8679,31310,allow,70,70,0,1,5,1,0
21750,39004,0,0,deny,66,66,0,1,0,1,0
58326,445,0,0,drop,66,66,0,1,0,1,0
54121,443,54121,443,allow,184574,24037,160537,209,84,87,122
6666,3389,0,0,deny,60,60,0,1,0,1,0
36368,80,28918,80,allow,78,78,0,2,8,2,0
49881,80,7229,80,allow,1965,1450,515,7,87,5,2
49295,53,60133,53,allow,194,102,92,2,32,1,1
33044,443,19147,443,allow,268582,23654,244928,341,190,128,213
54905,445,0,0,drop,66,66,0,1,0,1,0
55600,53,6191,53,allow,209,110,99,2,29,1,1
49659,53,53164,53,allow,730,102,628,2,30,1,1
61295,445,0,0,drop,70,70,0,1,0,1,0
63867,35993,0,0,deny,66,66,0,1,0,1,0
57042,445,0,0,drop,70,70,0,1,0,1,0
21534,42246,0,0,deny,66,66,0,1,0,1,0
55056,56205,0,0,deny,66,66,0,1,0,1,0
62054,443,20146,443,allow,10596,3874,6722,30,62,17,13
47400,80,8007,80,allow,9083,1822,7261,20,257,5,15
63067,53,20594,53,allow,384,166,218,2,30,1,1
50259,445,0,0,drop,70,70,0,1,0,1,0
56217,53,65360,53,allow,711,87,624,2,30,1,1
58890,80,50368,80,allow,23867,3316,20551,38,135,20,18
49290,53,62128,53,allow,184,94,90,2,30,1,1
59745,25174,0,0,deny,62,62,0,1,0,1,0
27502,50584,0,0,deny,62,62,0,1,0,1,0
51915,443,2041,443,allow,362,180,182,7,28,4,3
51437,80,35977,80,allow,1703,538,1165,8,177,5,3
13095,80,13095,80,allow,32613,1160,31453,38,16,13,25
54302,445,0,0,drop,70,70,0,1,0,1,0
11404,64147,0,0,deny,62,62,0,1,0,1,0
59320,443,31815,443,allow,4573,2614,1959,25,80,13,12
49798,53,8655,53,allow,196,102,94,2,30,1,1
64243,53,51060,53,allow,258,102,156,2,30,1,1
80,5101,0,0,deny,78,78,0,1,0,1,0
65359,53,51803,53,allow,731,91,640,2,30,1,1
55386,445,0,0,drop,70,70,0,1,0,1,0
58638,5900,0,0,deny,62,62,0,1,0,1,0
51026,37450,0,0,deny,62,62,0,1,0,1,0
39890,443,25429,443,allow,18127,8010,10117,41,116,24,17
65386,443,29589,443,allow,5405,4034,1371,25,43,10,15
51981,38274,61701,38274,allow,206,136,70,4,13,3,1
53810,8999,16528,8999,allow,320,140,180,6,5,3,3
3381,44847,0,0,deny,78,78,0,1,0,1,0
34066,36829,0,0,deny,146,146,0,1,0,1,0
55392,53,19876,53,allow,195,102,93,2,31,1,1
51414,22,0,0,deny,60,60,0,1,0,1,0
50266,443,54511,443,allow,21634,11226,10408,54,402,35,19
64580,53,3526,53,allow,180,94,86,2,30,1,1
62623,443,47203,443,allow,5311,1546,3765,15,122,7,8
2941,7000,2941,7000,allow,3398,947,2451,18,27,9,9
64588,53,47202,53,allow,165,86,79,2,30,1,1
53970,1024,11868,1024,allow,260,140,120,5,6,3,2
55147,53,40257,53,allow,776,102,674,2,30,1,1
35498,80,39354,80,allow,1270,387,883,16,392,4,12
51999,445,0,0,drop,70,70,0,1,0,1,0
53787,1,62839,1,allow,320,140,180,6,6,3,3
65510,53,46580,53,allow,229,102,127,2,30,1,1
49982,53,52781,53,allow,206,105,101,2,31,1,1
22835,51221,0,0,deny,62,62,0,1,0,1,0
61898,445,0,0,drop,70,70,0,1,0,1,0
58638,5900,0,0,deny,62,62,0,1,0,1,0
56294,53,56294,53,allow,229,89,140,2,31,1,1
54854,443,6189,443,allow,32544,28348,4196,63,332,31,32
52127,443,33029,443,allow,18360,1198,17162,27,25,9,18
57511,445,0,0,drop,70,70,0,1,0,1,0
58973,57470,0,0,deny,66,66,0,1,0,1,0
57396,53,20662,53,allow,807,94,713,2,30,1,1
51937,38056,49622,38056,allow,66,66,0,1,5,1,0
55211,445,0,0,drop,70,70,0,1,0,1,0
64801,445,0,0,drop,70,70,0,1,0,1,0
50406,443,46416,443,allow,6470,897,5573,24,55,9,15
45202,23,0,0,deny,60,60,0,1,0,1,0
27005,27019,52593,27019,allow,1007,252,755,4,32,3,1
47910,7454,0,0,deny,60,60,0,1,0,1,0
54262,445,0,0,drop,70,70,0,1,0,1,0
45964,14444,0,0,deny,60,60,0,1,0,1,0
21133,18719,1173,18719,allow,150,150,0,1,1200,1,0
56426,53,37263,53,allow,184,94,90,2,31,1,1
53821,7788,19069,7788,allow,70,70,0,2,8,2,0
36835,443,45000,443,allow,9115,1269,7846,21,31,12,9
32961,80,43846,80,allow,480,258,222,8,12,5,3
7871,3389,7871,3389,allow,4166,2141,2025,18,18,9,9
58741,443,39394,443,allow,5168,700,4468,16,15,7,9
60375,32277,60465,32277,allow,70,70,0,1,5,1,0
50991,445,0,0,drop,66,66,0,1,0,1,0
24144,57470,0,0,deny,62,62,0,1,0,1,0
26528,51221,0,0,deny,78,78,0,1,0,1,0
50690,445,0,0,drop,70,70,0,1,0,1,0
55595,443,57179,443,allow,448,166,282,2,30,1,1
51967,80,56439,80,allow,426,240,186,8,25,5,3
64941,445,0,0,drop,66,66,0,1,0,1,0
33563,14037,0,0,deny,78,78,0,1,0,1,0
51825,443,16261,443,allow,4943,936,4007,21,32,11,10
49879,445,0,0,drop,70,70,0,1,0,1,0
59679,37807,0,0,deny,66,66,0,1,0,1,0
59803,22114,0,0,deny,146,146,0,1,0,1,0
49161,53,58186,53,allow,168,86,82,2,30,1,1
64956,53,25279,53,allow,192,98,94,2,30,1,1
11295,40018,57800,40018,allow,213,89,124,4,31,2,2
51444,443,44166,443,allow,7658,1309,6349,24,75,13,11
57204,443,62645,443,allow,340,140,200,6,25,3,3
40030,443,25382,443,allow,2651,1331,1320,18,17,10,8
59011,445,0,0,drop,66,66,0,1,0,1,0
46349,51505,0,0,deny,70,70,0,1,0,1,0
56842,24233,45791,24233,allow,70,70,0,1,5,1,0
57027,445,0,0,drop,66,66,0,1,0,1,0
58435,64631,0,0,deny,74,74,0,1,0,1,0
43184,80,44137,80,allow,1972,1464,508,15,16,7,8
47348,23,0,0,deny,60,60,0,1,0,1,0
51648,80,61615,80,allow,3227,2425,802,9,31,5,4
46982,443,35062,443,allow,3847,2650,1197,22,35,13,9
50,38211,0,0,deny,66,66,0,1,0,1,0
51342,53,21697,53,allow,199,94,105,2,30,1,1
50470,53,11331,53,allow,770,102,668,2,30,1,1
56001,445,0,0,drop,70,70,0,1,0,1,0
32945,80,47829,80,allow,234,234,0,4,12,4,0
56511,53,50821,53,allow,200,102,98,2,30,1,1
25009,35440,0,0,deny,66,66,0,1,0,1,0
49215,52611,6615,52611,allow,70,70,0,1,5,1,0
57344,53,21861,53,allow,177,94,83,2,30,1,1
50972,3544,16024,3544,allow,258,107,151,2,30,1,1
50793,443,16791,443,allow,9721,3096,6625,30,122,13,17
27005,27015,24846,27015,allow,878,126,752,2,30,1,1
5222,21212,0,0,deny,66,66,0,1,0,1,0
55219,53,51728,53,allow,181,94,87,2,32,1,1
50081,57470,0,0,deny,66,66,0,1,0,1,0
60222,22114,0,0,deny,62,62,0,1,0,1,0
53147,37965,0,0,deny,62,62,0,1,0,1,0
61723,445,0,0,drop,66,66,0,1,0,1,0
62341,445,0,0,drop,70,70,0,1,0,1,0
37614,80,61486,80,allow,1399,406,993,15,43,5,10
50282,445,0,0,drop,70,70,0,1,0,1,0
27005,27018,55202,27018,allow,881,126,755,2,30,1,1
49365,445,0,0,drop,70,70,0,1,0,1,0
64327,53,33651,53,allow,204,104,100,2,31,1,1
62392,15503,0,0,deny,146,146,0,1,0,1,0
65077,53,33139,53,allow,734,86,648,2,30,1,1
49176,443,60169,443,allow,533295,14310,518985,552,18,201,351
64788,53,23511,53,allow,168,86,82,2,30,1,1
59599,62413,0,0,deny,146,146,0,1,0,1,0
49203,53,46082,53,allow,168,86,82,2,31,1,1
55471,53,27819,53,allow,256,93,163,2,30,1,1
58638,5900,0,0,deny,62,62,0,1,0,1,0
31172,22114,0,0,deny,146,146,0,1,0,1,0
48095,53,40439,53,allow,199,94,105,2,30,1,1
48173,443,63016,443,allow,4342,2152,2190,19,255,10,9
56964,53,13707,53,allow,267,87,180,4,57,2,2
63139,12311,39911,12311,allow,70,70,0,1,5,1,0
57168,53,20859,53,allow,760,96,664,2,30,1,1
29145,8168,0,0,deny,62,62,0,1,0,1,0
58003,1433,0,0,deny,60,60,0,1,0,1,0
45847,443,35477,443,allow,1134,490,644,18,42,8,10
49856,80,12008,80,allow,13992,1645,12347,23,89,10,13
60394,53,18080,53,allow,330,94,236,2,30,1,1
50574,443,9752,443,allow,9191,2003,7188,25,100,13,12
57473,23,0,0,deny,60,60,0,1,0,1,0
443,51550,0,0,deny,100,100,0,1,0,1,0
57606,443,40796,443,allow,11986,3075,8911,60,4981,31,29
52594,445,0,0,drop,70,70,0,1,0,1,0
14103,35440,0,0,deny,62,62,0,1,0,1,0
63002,445,0,0,drop,66,66,0,1,0,1,0
61652,445,0,0,drop,70,70,0,1,0,1,0
52907,443,48453,443,allow,9303,3133,6170,26,22,13,13
64137,53,46613,53,allow,276,126,150,2,30,1,1
65386,53,22726,53,allow,184,102,82,2,29,1,1
53404,445,0,0,drop,70,70,0,1,0,1,0
55675,445,0,0,drop,66,66,0,1,0,1,0
64082,53,17005,53,allow,356,97,259,4,58,2,2
49606,80,25049,80,allow,454,262,192,8,41,5,3
59671,445,0,0,drop,70,70,0,1,0,1,0
52229,54711,46262,54711,allow,136,136,0,3,14,3,0
53665,29135,50493,29135,allow,70,70,0,2,8,2,0
11964,53,13321,53,allow,268,94,174,2,30,1,1
49325,443,64992,443,allow,6141,949,5192,17,21,9,8
57389,53,16174,53,allow,193,102,91,2,31,1,1
49418,30003,43016,30003,allow,71,71,0,1,30,1,0
62917,993,58803,993,allow,9056,4223,4833,82,35,42,40
57407,53,20489,53,allow,755,94,661,2,31,1,1
49777,53,28087,53,allow,216,110,106,2,30,1,1
443,50238,0,0,deny,286,286,0,1,0,1,0
56727,445,0,0,drop,70,70,0,1,0,1,0
56837,445,0,0,drop,66,66,0,1,0,1,0
16965,3389,16965,3389,allow,4085,1916,2169,21,18,12,9
61400,64147,0,0,deny,66,66,0,1,0,1,0
52137,1026,43020,1026,allow,196,136,60,4,8,3,1
59997,445,0,0,drop,66,66,0,1,0,1,0
49582,443,23714,443,allow,29241,2457,26784,48,171,24,24
53534,443,20648,443,allow,7639,1831,5808,29,76,15,14
57601,443,61546,443,allow,2614,1689,925,18,20,10,8
52088,53,34492,53,allow,168,78,90,2,30,1,1
52263,445,0,0,drop,70,70,0,1,0,1,0
38363,15000,1161,15000,allow,130,70,60,2,6,1,1
49532,80,7798,80,allow,4577,3951,626,11,25,6,5
50151,53,24855,53,allow,177,94,83,2,30,1,1
5180,80,5180,80,allow,33443,797,32646,33,16,9,24
53108,445,0,0,drop,66,66,0,1,0,1,0
41151,80,58286,80,allow,1711,786,925,12,16,7,5
5588,5588,0,0,allow,3354,1792,1562,46,193,23,23
60761,53,45233,53,allow,198,86,112,2,29,1,1
58753,445,0,0,drop,66,66,0,1,0,1,0
55717,13517,61965,13517,allow,70,70,0,2,8,2,0
53477,443,34084,443,allow,21476,1330,20146,32,137,12,20
57290,445,0,0,drop,70,70,0,1,0,1,0
48985,15000,20199,15000,allow,130,70,60,2,5,1,1
64381,445,0,0,drop,70,70,0,1,0,1,0
49662,53,40322,53,allow,268,93,175,4,58,2,2
54726,30041,0,0,deny,62,62,0,1,0,1,0
57152,53,57152,53,allow,241,98,143,2,30,1,1
49567,53,36957,53,allow,184,102,82,2,29,1,1
11826,53,11826,53,allow,237,91,146,2,33,1,1
63912,18318,13803,18318,allow,1295,926,369,13,17,9,4
65216,35440,0,0,deny,66,66,0,1,0,1,0
58868,443,25875,443,allow,1826093,48237,1777856,1873,71,599,1274
64956,53,40414,53,allow,402,118,284,2,29,1,1
49856,443,10855,443,allow,5512,978,4534,20,60,10,10
54910,32480,0,0,deny,66,66,0,1,0,1,0
57590,53,59223,53,allow,260,86,174,2,30,1,1
49593,53,25320,53,allow,253,102,151,2,30,1,1
1730,37965,0,0,deny,145,145,0,1,0,1,0
52495,443,27354,443,allow,787462,10645,776817,653,131,87,566
55157,53,58441,53,allow,711,87,624,2,30,1,1
65486,53,8619,53,allow,193,102,91,2,30,1,1
58178,443,51468,443,allow,8000,1760,6240,32,43,16,16
60361,57470,0,0,deny,66,66,0,1,0,1,0
51690,993,38356,993,allow,15022,5202,9820,113,36,53,60
55270,443,14179,443,allow,6098,778,5320,17,15,8,9
52518,35440,0,0,deny,66,66,0,1,0,1,0
58638,5900,0,0,deny,62,62,0,1,0,1,0
59366,35440,0,0,deny,66,66,0,1,0,1,0
35670,443,58907,443,allow,295458,11828,283630,339,185,137,202
49341,53,19411,53,allow,199,102,97,2,29,1,1
61758,445,0,0,drop,70,70,0,1,0,1,0
5938,37145,0,0,allow,60,60,0,1,90,1,0
50249,445,0,0,drop,70,70,0,1,0,1,0
58815,443,6132,443,allow,11773,7687,4086,31,17,16,15
57027,53,37270,53,allow,177,94,83,2,30,1,1
64045,445,0,0,drop,70,70,0,1,0,1,0
21604,50201,0,0,deny,62,62,0,1,0,1,0
55089,53,1796,53,allow,199,102,97,2,30,1,1
59940,50584,0,0,deny,62,62,0,1,0,1,0
26180,53,26180,53,allow,245,98,147,2,30,1,1
38852,443,38852,443,allow,4747,1840,2907,19,28,11,8
64368,445,0,0,drop,70,70,0,1,0,1,0
56961,53,64914,53,allow,757,102,655,2,30,1,1
49426,57470,0,0,deny,66,66,0,1,0,1,0
58829,445,0,0,drop,66,66,0,1,0,1,0
55641,53,43709,53,allow,70,70,0,1,30,1,0
57140,445,0,0,drop,66,66,0,1,0,1,0
52127,445,0,0,drop,66,66,0,1,0,1,0
49298,443,58144,443,allow,3949,2535,1414,24,75,12,12
64892,445,0,0,drop,66,66,0,1,0,1,0
57838,53,1470,53,allow,70,70,0,1,29,1,0
56336,53,18502,53,allow,192,98,94,2,30,1,1
28015,443,63063,443,allow,6435,1089,5346,18,75,9,9
54137,445,0,0,drop,70,70,0,1,0,1,0
49481,53,5935,53,allow,232,102,130,2,30,1,1
58276,43890,0,0,deny,66,66,0,1,0,1,0
27005,27017,35539,27017,allow,873,126,747,2,31,1,1
50378,53,48801,53,allow,184,94,90,2,30,1,1
1027,64147,0,0,deny,62,62,0,1,0,1,0
53628,50514,36687,50514,allow,70,70,0,1,4,1,0
65491,53,31323,53,allow,193,102,91,2,33,1,1
48012,443,51500,443,allow,1429,1295,134,10,29,8,2
54210,64097,0,0,deny,66,66,0,1,0,1,0
55739,53,43741,53,allow,215,102,113,2,30,1,1
61040,443,61040,443,allow,4886,1530,3356,17,17,10,7
52146,443,52659,443,allow,774806,25835,748971,772,52,253,519
55538,53,6885,53,allow,168,86,82,2,30,1,1
32051,37965,0,0,deny,62,62,0,1,0,1,0
54429,445,0,0,drop,70,70,0,1,0,1,0
1462,41599,48660,41599,allow,70,70,0,2,8,2,0
52564,15503,0,0,deny,74,74,0,1,0,1,0
49163,443,41945,443,allow,2529,1230,1299,17,16,9,8
50635,80,60349,80,allow,3722,1504,2218,13,20,7,6
58169,443,39268,443,allow,30845,9943,20902,172,133,73,99
55715,34309,29460,34309,allow,260,140,120,5,8,3,2
64490,445,0,0,drop,70,70,0,1,0,1,0
58080,443,57943,443,allow,646,358,288,10,133,6,4
36535,443,64497,443,allow,6805,1662,5143,25,17,13,12
50622,445,0,0,drop,70,70,0,1,0,1,0
27888,53,27888,53,allow,240,96,144,2,31,1,1
50482,445,0,0,drop,70,70,0,1,0,1,0
23349,30188,0,0,deny,62,62,0,1,0,1,0
58899,443,33038,443,allow,3690,2585,1105,17,16,9,8
55286,53,26564,53,allow,268,87,181,4,35,2,2
443,44683,0,0,deny,83,83,0,1,0,1,0
57220,26467,0,0,deny,62,62,0,1,0,1,0
11317,53563,0,0,reset-both,143,143,0,1,0,1,0
13963,50584,0,0,deny,66,66,0,1,0,1,0
56783,53,42766,53,allow,199,102,97,2,30,1,1
50563,445,0,0,drop,70,70,0,1,0,1,0
34456,80,16801,80,allow,2913,633,2280,15,16,8,7
64652,53,53769,53,allow,198,94,104,2,30,1,1
58743,443,24933,443,allow,14819,3993,10826,80,330,36,44
60415,53,0,0,allow,82,82,0,1,30,1,0
44847,30066,30079,30066,allow,150,150,0,1,1200,1,0
49311,445,0,0,drop,70,70,0,1,0,1,0
28549,53,28549,53,allow,194,87,107,2,30,1,1
52744,53,32462,53,allow,218,81,137,2,31,1,1
45470,443,49980,443,allow,1636,827,809,18,43,10,8
65115,53,24765,53,allow,186,95,91,2,30,1,1
43357,443,61952,443,allow,146374,13143,133231,238,131,116,122
49554,53,50726,53,allow,210,110,100,2,30,1,1
49332,443,44143,443,allow,142684,5997,136687,134,48,31,103
8889,63001,0,0,deny,60,60,0,1,0,1,0
57397,53,25863,53,allow,182,93,89,2,31,1,1
49632,443,26348,443,allow,3618,961,2657,13,121,6,7
2919,57866,0,0,deny,62,62,0,1,0,1,0
55292,53,33154,53,allow,211,102,109,2,31,1,1
11136,15503,0,0,deny,62,62,0,1,0,1,0
64548,445,0,0,drop,66,66,0,1,0,1,0
49614,53,6383,53,allow,183,94,89,2,30,1,1
52917,445,0,0,drop,70,70,0,1,0,1,0
9450,443,24290,443,allow,5691,503,5188,14,15,7,7
50840,445,0,0,drop,70,70,0,1,0,1,0
56246,445,0,0,drop,66,66,0,1,0,1,0
53038,445,0,0,drop,66,66,0,1,0,1,0
27300,6881,0,0,deny,66,66,0,1,0,1,0
42337,443,16716,443,allow,4181,998,3183,14,26,7,7
2064,22114,0,0,deny,62,62,0,1,0,1,0
49680,53,31932,53,allow,749,94,655,2,30,1,1
52230,50265,0,0,deny,66,66,0,1,0,1,0
40742,2967,0,0,deny,62,62,0,1,0,1,0
39110,50584,0,0,deny,62,62,0,1,0,1,0
55938,53,44450,53,allow,209,110,99,2,30,1,1
48346,80,10787,80,allow,1878,1444,434,14,15,7,7
14350,56205,0,0,deny,62,62,0,1,0,1,0
59402,53,59402,53,allow,216,90,126,2,29,1,1
48436,443,64004,443,allow,9744,1958,7786,25,18,13,12
54816,445,0,0,drop,70,70,0,1,0,1,0
49762,53,13712,53,allow,335,142,193,2,30,1,1
12614,22,0,0,deny,60,60,0,1,0,1,0
54373,443,3920,443,allow,16029,6377,9652,46,37,24,22
17643,50584,0,0,deny,62,62,0,1,0,1,0
17415,25174,0,0,deny,62,62,0,1,0,1,0
49595,80,13926,80,allow,1285,772,513,11,53,6,5
57175,445,0,0,drop,70,70,0,1,0,1,0
62299,53,62299,53,allow,259,108,151,2,31,1,1
53950,445,0,0,drop,70,70,0,1,0,1,0
33324,42873,0,0,deny,62,62,0,1,0,1,0
58552,445,0,0,drop,66,66,0,1,0,1,0
53979,80,42117,80,allow,64091,62467,1624,61,16,48,13
62971,44847,0,0,deny,62,62,0,1,0,1,0
55217,443,42611,443,allow,8690,4119,4571,26,31,14,12
56843,53,63293,53,allow,177,94,83,2,30,1,1
56082,53,15374,53,allow,271,88,183,4,37,2,2
52033,50584,0,0,deny,66,66,0,1,0,1,0
6881,6881,6157,6881,allow,253,118,135,2,1200,1,1
51862,27758,32851,27758,allow,70,70,0,2,7,2,0
60241,445,0,0,drop,70,70,0,1,0,1,0
65117,53,1871,53,allow,198,102,96,2,30,1,1
41037,80,6510,80,allow,613,539,74,7,15,6,1
43597,443,44647,443,allow,47048,9293,37755,63,412,28,35
48817,27003,48817,27003,allow,839,296,543,4,1200,2,2
65177,53,43720,53,allow,258,110,148,2,30,1,1
18623,1,0,0,deny,66,66,0,1,0,1,0
39684,443,56331,443,allow,5150,853,4297,16,34,9,7
58638,5900,0,0,deny,62,62,0,1,0,1,0
27735,53,27735,53,allow,235,90,145,2,32,1,1
65389,445,0,0,drop,66,66,0,1,0,1,0
52749,64147,0,0,deny,66,66,0,1,0,1,0
53737,445,0,0,drop,70,70,0,1,0,1,0
56866,53,52471,53,allow,194,102,92,2,30,1,1
57367,443,24702,443,allow,7498,2799,4699,24,17,13,11
65452,53,12771,53,allow,819,102,717,2,30,1,1
58582,50584,0,0,deny,62,62,0,1,0,1,0
57743,445,0,0,drop,70,70,0,1,0,1,0
57137,53,2649,53,allow,279,96,183,4,31,2,2
48187,443,22685,443,allow,1515,568,947,14,82,6,8
1024,48817,0,0,deny,148,148,0,1,0,1,0
34430,80,5069,80,allow,2913,633,2280,15,15,8,7
54936,445,0,0,drop,70,70,0,1,0,1,0
34348,22114,0,0,deny,146,146,0,1,0,1,0
63586,445,0,0,drop,66,66,0,1,0,1,0
36629,23117,0,0,deny,62,62,0,1,0,1,0
64063,53,31532,53,allow,339,110,229,2,29,1,1
55692,53,4863,53,allow,198,102,96,2,29,1,1
8889,64500,0,0,deny,60,60,0,1,0,1,0
65514,443,30386,443,allow,92638,4519,88119,105,15,39,66
54935,443,10103,443,allow,10198,3881,6317,46,146,26,20
51023,443,24793,443,allow,26189,8238,17951,72,18,39,33
51429,443,6993,443,allow,8804,1597,7207,25,50,14,11
56555,53,42493,53,allow,348,94,254,2,30,1,1
55614,445,0,0,drop,70,70,0,1,0,1,0
64069,53,35417,53,allow,183,86,97,2,29,1,1
56668,53,12015,53,allow,199,94,105,2,30,1,1
36448,80,28179,80,allow,1325,336,989,10,15,5,5
64451,53,26294,53,allow,363,92,271,4,31,2,2
52326,443,20319,443,allow,4939,2553,2386,51,72,28,23
55678,53,29354,53,allow,270,88,182,4,53,2,2
32648,55108,0,0,deny,145,145,0,1,0,1,0
58483,445,0,0,drop,66,66,0,1,0,1,0
63886,445,0,0,drop,66,66,0,1,0,1,0
51615,15000,33004,15000,allow,130,70,60,2,5,1,1
51948,37965,0,0,deny,62,62,0,1,0,1,0
52074,57947,10118,57947,allow,70,70,0,2,8,2,0
64719,445,0,0,drop,70,70,0,1,0,1,0
57470,6881,28610,6881,allow,396,396,0,7,1200,7,0
10265,64147,0,0,deny,66,66,0,1,0,1,0
54631,443,8589,443,allow,130,70,60,3,5,2,1
61682,445,0,0,drop,70,70,0,1,0,1,0
55075,8080,0,0,deny,60,60,0,1,0,1,0
61029,445,0,0,drop,70,70,0,1,0,1,0
60011,443,4713,443,allow,11061,2230,8831,40,109,23,17
60840,53,50587,53,allow,255,86,169,2,31,1,1
64750,53,24687,53,allow,193,102,91,2,29,1,1
56704,445,0,0,drop,66,66,0,1,0,1,0
49306,443,46343,443,allow,83411,4586,78825,94,47,30,64
59889,445,0,0,drop,66,66,0,1,0,1,0
50135,50584,0,0,deny,62,62,0,1,0,1,0
64426,53,47787,53,allow,289,101,188,4,50,2,2
56724,445,0,0,drop,70,70,0,1,0,1,0
49907,53,32516,53,allow,199,102,97,2,30,1,1
56092,53,34391,53,allow,177,94,83,2,30,1,1
58638,5900,0,0,deny,62,62,0,1,0,1,0
37558,16384,22272,16384,allow,556,256,300,10,30,5,5
64421,445,0,0,drop,66,66,0,1,0,1,0
51817,443,24496,443,allow,2811130,115323,2695807,3382,206,1445,1937
53015,64147,0,0,deny,62,62,0,1,0,1,0
57662,445,0,0,drop,66,66,0,1,0,1,0
53915,443,3997,443,allow,499,425,74,4,0,3,1
46512,63836,0,0,deny,148,148,0,1,0,1,0
57371,53,9888,53,allow,755,93,662,2,31,1,1
46683,443,34091,443,allow,416,210,206,7,28,4,3
54938,445,0,0,drop,70,70,0,1,0,1,0
55241,443,32846,443,allow,8080,2630,5450,24,45,12,12
63300,445,0,0,drop,70,70,0,1,0,1,0
55563,53,42353,53,allow,177,94,83,2,30,1,1
55771,53,45760,53,allow,283,98,185,4,51,2,2
64595,53,55733,53,allow,167,86,81,2,30,1,1
64542,53,47604,53,allow,234,94,140,2,29,1,1
27005,27017,4986,27017,allow,881,126,755,2,30,1,1
52745,25174,0,0,deny,66,66,0,1,0,1,0
5588,5588,0,0,allow,3354,1792,1562,46,193,23,23
53260,443,48140,443,allow,4885,983,3902,21,53,10,11
59985,443,35984,443,allow,55132,17147,37985,126,150,55,71
0,0,0,0,allow,320,320,0,5,0,5,0
49837,53,44716,53,allow,734,86,648,2,30,1,1
3428,22,0,0,deny,60,60,0,1,0,1,0
50372,443,12434,443,allow,456,390,66,4,0,3,1
65488,443,64323,443,allow,92286,4799,87487,107,16,43,64
56668,53,31919,53,allow,198,101,97,2,31,1,1
57983,443,38369,443,allow,7966,3102,4864,18,75,10,8
23843,26467,0,0,deny,62,62,0,1,0,1,0
4427,50584,0,0,deny,62,62,0,1,0,1,0
49317,53,16697,53,allow,166,86,80,2,31,1,1
59965,80,33685,80,allow,1638,1324,314,10,15,5,5
49632,53,30803,53,allow,198,101,97,2,30,1,1
5222,64493,0,0,deny,1514,1514,0,1,0,1,0
56590,25174,0,0,deny,66,66,0,1,0,1,0
23293,443,23293,443,allow,50236,37417,12819,67,19,41,26
63428,445,0,0,drop,70,70,0,1,0,1,0
60489,445,0,0,drop,70,70,0,1,0,1,0
37319,80,37445,80,allow,1056,682,374,10,15,6,4
64743,445,0,0,drop,70,70,0,1,0,1,0
48706,23393,0,0,deny,60,60,0,1,0,1,0
59350,445,0,0,drop,70,70,0,1,0,1,0
64907,53,65054,53,allow,168,86,82,2,29,1,1
1873,37965,0,0,deny,62,62,0,1,0,1,0
48555,53,5829,53,allow,215,86,129,2,30,1,1
56762,443,61918,443,allow,8005,1985,6020,20,15,11,9
58638,5900,0,0,deny,62,62,0,1,0,1,0
58868,443,58939,443,allow,239435,36478,202957,319,111,133,186
65312,53,52827,53,allow,182,94,88,2,30,1,1
60062,53,61702,53,allow,168,78,90,2,30,1,1
65258,443,17337,443,allow,6043,1568,4475,11,120,4,7
62139,53,5155,53,allow,291,78,213,2,30,1,1
53539,44847,0,0,deny,66,66,0,1,0,1,0
56106,53,18399,53,allow,193,102,91,2,30,1,1
48817,42099,48817,42099,allow,479,152,327,2,1200,1,1
49247,80,49247,80,allow,378,180,198,7,53,4,3
53580,443,57283,443,allow,4669,2251,2418,14,137,7,7
65231,53,37315,53,allow,200,102,98,2,31,1,1
38143,443,25496,443,allow,84884,5896,78988,128,36,66,62
53246,445,0,0,drop,70,70,0,1,0,1,0
51120,445,0,0,drop,70,70,0,1,0,1,0
56931,445,0,0,drop,70,70,0,1,0,1,0
50699,445,0,0,drop,66,66,0,1,0,1,0
52924,443,13021,443,allow,5583,1390,4193,19,15,9,10
50943,445,0,0,drop,70,70,0,1,0,1,0
61216,12250,0,0,deny,148,148,0,1,0,1,0
65501,53,16521,53,allow,443,182,261,6,29,3,3
63062,11392,0,0,deny,66,66,0,1,0,1,0
57000,80,51268,80,allow,214,140,74,4,35,3,1
42298,40027,29472,40027,allow,144,82,62,2,30,1,1
62737,64147,0,0,deny,66,66,0,1,0,1,0
37851,443,37851,443,allow,4691,1784,2907,19,27,11,8
65089,53,28362,53,allow,199,102,97,2,30,1,1
53562,8999,49942,8999,allow,320,140,180,6,6,3,3
49647,443,38723,443,allow,11011,4522,6489,35,43,17,18
37977,443,37977,443,allow,5763,2553,3210,24,80,14,10
54586,445,0,0,drop,70,70,0,1,0,1,0
56956,53,13948,53,allow,183,94,89,2,30,1,1
6881,35156,27681,35156,allow,509,150,359,2,1199,1,1
49793,53,56349,53,allow,271,102,169,2,30,1,1
64609,53,19942,53,allow,168,86,82,2,30,1,1
59030,443,52271,443,allow,10079,2210,7869,36,120,19,17
46261,80,62301,80,allow,3578,1673,1905,16,186,9,7
34028,443,55750,443,allow,7804,2108,5696,24,32,14,10
44947,443,36944,443,allow,6359,4441,1918,33,80,17,16
55206,22114,0,0,deny,66,66,0,1,0,1,0
50474,80,43879,80,allow,19357,10244,9113,36,27,19,17
52193,33027,51097,33027,allow,70,70,0,1,5,1,0
64627,53,17603,53,allow,198,101,97,2,30,1,1
12087,59033,0,0,deny,148,148,0,1,0,1,0
49384,445,0,0,drop,70,70,0,1,0,1,0
61642,445,0,0,drop,70,70,0,1,0,1,0
56569,53,52915,53,allow,94,94,0,1,30,1,0
64927,445,0,0,drop,70,70,0,1,0,1,0
64921,445,0,0,drop,70,70,0,1,0,1,0
43303,443,47473,443,allow,6448,1982,4466,22,16,11,11
6224,37965,0,0,deny,62,62,0,1,0,1,0
61611,445,0,0,drop,70,70,0,1,0,1,0
56924,53,50260,53,allow,170,87,83,2,31,1,1
34980,443,26995,443,allow,8211,2165,6046,25,361,13,12
59157,445,0,0,drop,70,70,0,1,0,1,0
21844,50584,0,0,deny,146,146,0,1,0,1,0
21993,25174,0,0,deny,146,146,0,1,0,1,0
56431,53,36582,53,allow,778,103,675,2,31,1,1
51736,34343,51970,34343,allow,70,70,0,1,5,1,0
47075,80,40568,80,allow,1614,1300,314,10,15,5,5
50394,25174,0,0,deny,62,62,0,1,0,1,0
55010,53,9213,53,allow,195,102,93,2,31,1,1
49913,445,0,0,drop,70,70,0,1,0,1,0
56761,445,0,0,drop,66,66,0,1,0,1,0
54526,44847,0,0,deny,66,66,0,1,0,1,0
60826,445,0,0,drop,66,66,0,1,0,1,0
1484,22114,0,0,deny,146,146,0,1,0,1,0
65440,80,8468,80,allow,366,180,186,7,28,4,3
56188,445,0,0,drop,70,70,0,1,0,1,0
443,31353,0,0,deny,97,97,0,1,0,1,0
56503,53,8942,53,allow,916,86,830,2,31,1,1
27005,33055,20199,33055,allow,888,126,762,2,31,1,1
45064,25174,0,0,deny,62,62,0,1,0,1,0
42252,33306,0,0,deny,60,60,0,1,0,1,0
38093,11392,0,0,deny,62,62,0,1,0,1,0
16387,63752,0,0,deny,60,60,0,1,0,1,0
20864,51221,0,0,deny,62,62,0,1,0,1,0
62590,7000,62590,7000,allow,2163,676,1487,14,15,7,7
13508,15503,0,0,deny,66,66,0,1,0,1,0
62900,993,6178,993,allow,12900,4980,7920,91,117,51,40
13285,29892,0,0,deny,145,145,0,1,0,1,0
65284,445,0,0,drop,70,70,0,1,0,1,0
49549,443,60727,443,allow,5903,1270,4633,14,17,8,6
51135,80,18450,80,allow,254,128,126,5,15,3,2
53785,33324,40281,33324,allow,70,70,0,2,7,2,0
54322,443,16940,443,allow,14649,11393,3256,49,99,22,27
49205,53,38111,53,allow,188,96,92,2,31,1,1
56050,53,44342,53,allow,178,94,84,2,30,1,1
50584,8999,10076,8999,allow,161,161,0,1,1200,1,0
51443,443,11818,443,allow,4773,2454,2319,14,135,7,7
49333,25174,0,0,deny,146,146,0,1,0,1,0
55273,53,2212,53,allow,168,78,90,2,30,1,1
58344,445,0,0,drop,66,66,0,1,0,1,0
8933,56205,0,0,deny,62,62,0,1,0,1,0
50998,445,0,0,drop,70,70,0,1,0,1,0
53466,445,0,0,drop,70,70,0,1,0,1,0
60499,51413,3005,51413,allow,70,70,0,2,8,2,0
60373,80,60373,80,allow,116680,5773,110907,126,21,46,80
49331,53,38875,53,allow,200,94,106,2,29,1,1
54370,445,0,0,drop,70,70,0,1,0,1,0
56203,53,18895,53,allow,283,102,181,2,29,1,1
35596,5228,54963,5228,allow,3235,1448,1787,26,811,8,18
55254,53,12306,53,allow,195,102,93,2,30,1,1
36685,443,19672,443,allow,10753,1585,9168,24,120,10,14
52238,48996,43886,48996,allow,70,70,0,1,5,1,0
59876,44847,0,0,deny,66,66,0,1,0,1,0
55387,445,0,0,drop,70,70,0,1,0,1,0
45472,443,53386,443,allow,1568,759,809,17,43,9,8
49274,445,0,0,drop,70,70,0,1,0,1,0
58862,443,26650,443,allow,5167,700,4467,16,15,7,9
49710,53,33849,53,allow,183,102,81,2,30,1,1
57919,443,32808,443,allow,21293,7315,13978,85,188,37,48
48706,23393,0,0,deny,60,60,0,1,0,1,0
13090,36237,0,0,deny,66,66,0,1,0,1,0
52267,55982,31620,55982,allow,70,70,0,2,6,2,0
10061,443,5696,443,allow,4984,892,4092,18,185,9,9
51262,35440,0,0,deny,62,62,0,1,0,1,0
56907,53,30481,53,allow,186,95,91,2,30,1,1
49741,53,12587,53,allow,211,102,109,2,30,1,1
64592,53,37714,53,allow,202,103,99,2,31,1,1
52097,443,1702,443,allow,11181,7329,3852,39,53,20,19
60894,50584,0,0,deny,62,62,0,1,0,1,0
42934,443,24809,443,allow,232,172,60,3,5,2,1
35094,53,9610,53,allow,371,94,277,2,30,1,1
55649,5228,61882,5228,allow,5378,2359,3019,35,3786,16,19
55877,56036,49566,56036,allow,469,150,319,2,1200,1,1
56427,53,25251,53,allow,178,94,84,2,29,1,1
26900,27017,43852,27017,allow,422,164,258,6,29,3,3
49594,445,0,0,drop,70,70,0,1,0,1,0
22419,1433,22419,1433,allow,146,60,86,2,9,1,1
80,37649,0,0,deny,60,60,0,1,0,1,0
51970,18752,15573,18752,allow,70,70,0,1,5,1,0
51982,56306,48759,56306,allow,70,70,0,2,8,2,0
50321,48817,0,0,deny,143,143,0,1,0,1,0
63867,64147,0,0,deny,62,62,0,1,0,1,0
55803,445,0,0,drop,70,70,0,1,0,1,0
60514,39004,0,0,deny,66,66,0,1,0,1,0
59406,445,0,0,drop,70,70,0,1,0,1,0
44388,63874,0,0,deny,62,62,0,1,0,1,0
58076,21247,0,0,deny,66,66,0,1,0,1,0
65339,53,32222,53,allow,193,102,91,2,29,1,1
52108,80,27420,80,allow,182,60,122,4,25,2,2
57045,53,2181,53,allow,177,94,83,2,30,1,1
56204,53,48094,53,allow,195,102,93,2,30,1,1
62721,445,0,0,drop,70,70,0,1,0,1,0
55175,80,55175,80,allow,7452,1052,6400,20,22,11,9
55158,445,0,0,drop,66,66,0,1,0,1,0
50535,22,50535,22,allow,6292,2375,3917,35,20,19,16
57011,49813,0,0,deny,62,62,0,1,0,1,0
53837,15000,29903,15000,allow,130,70,60,2,6,1,1
55448,445,0,0,drop,70,70,0,1,0,1,0
63942,445,0,0,drop,70,70,0,1,0,1,0
46778,53,46778,53,allow,214,82,132,2,30,1,1
39823,36237,0,0,deny,66,66,0,1,0,1,0
55966,35440,0,0,deny,62,62,0,1,0,1,0
57596,445,0,0,drop,70,70,0,1,0,1,0
60365,443,29839,443,allow,13649,6567,7082,29,127,14,15
49160,6881,22368,6881,allow,490,150,340,2,1200,1,1
50598,445,0,0,drop,70,70,0,1,0,1,0
51480,445,0,0,drop,70,70,0,1,0,1,0
55900,445,0,0,drop,70,70,0,1,0,1,0
53227,443,46822,443,allow,5430,687,4743,15,73,6,9
65285,53,31109,53,allow,294,102,192,2,30,1,1
56690,445,0,0,drop,66,66,0,1,0,1,0
51459,443,53569,443,allow,202,70,132,3,11,1,2
59900,445,0,0,drop,66,66,0,1,0,1,0
45118,39004,0,0,deny,74,74,0,1,0,1,0
56536,445,0,0,drop,66,66,0,1,0,1,0
49667,80,7772,80,allow,27534,4859,22675,34,41,14,20
61524,445,0,0,drop,70,70,0,1,0,1,0
1027,57866,0,0,deny,62,62,0,1,0,1,0
59982,80,63868,80,allow,207418,4580,202838,194,143,50,144
56829,53,48980,53,allow,199,102,97,2,30,1,1
49369,53,21699,53,allow,168,86,82,2,30,1,1
64876,53,58020,53,allow,737,94,643,2,30,1,1
51210,50584,0,0,deny,146,146,0,1,0,1,0
9483,80,46807,80,allow,1579,421,1158,9,15,4,5
57365,38303,0,0,deny,62,62,0,1,0,1,0
46331,53,26643,53,allow,199,94,105,2,30,1,1
36339,50584,0,0,deny,62,62,0,1,0,1,0
49761,53,10383,53,allow,182,93,89,2,31,1,1
33841,443,9860,443,allow,12521,6232,6289,43,80,22,21
53160,25174,0,0,deny,62,62,0,1,0,1,0
55614,53,42097,53,allow,309,110,199,2,30,1,1
52993,443,64908,443,allow,16229,3316,12913,23,125,9,14
47910,7461,0,0,deny,60,60,0,1,0,1,0
65000,445,0,0,drop,66,66,0,1,0,1,0
55030,445,0,0,drop,66,66,0,1,0,1,0
50007,53,59429,53,allow,216,110,106,2,30,1,1
49808,443,22176,443,allow,1101,654,447,12,126,7,5
52001,80,32528,80,allow,7578,4652,2926,49,323,30,19
50730,445,0,0,drop,66,66,0,1,0,1,0
46456,443,58612,443,allow,4921,2134,2787,21,95,10,11
59693,443,23790,443,allow,1867,250,1617,8,120,4,4
49726,443,20489,443,allow,5393,1263,4130,21,18,11,10
50472,443,48641,443,allow,251744,9600,242144,302,23,129,173
49501,445,0,0,drop,70,70,0,1,0,1,0
49280,53,8666,53,allow,167,86,81,2,30,1,1
50582,53,45109,53,allow,216,110,106,2,30,1,1
49228,443,49228,443,allow,32952,11546,21406,60,71,36,24
64695,53,11927,53,allow,193,102,91,2,30,1,1
61798,35440,0,0,deny,66,66,0,1,0,1,0
57068,445,0,0,drop,70,70,0,1,0,1,0
52780,37965,0,0,deny,66,66,0,1,0,1,0
49901,7000,49901,7000,allow,3310,1535,1775,15,15,8,7
51434,443,45613,443,allow,12291742,358717,11933025,12485,181,3846,8639
57812,7635,57812,7635,allow,138,78,60,3,6,2,1
53408,445,0,0,drop,70,70,0,1,0,1,0
60372,445,0,0,drop,70,70,0,1,0,1,0
15056,2222,0,0,deny,60,60,0,1,0,1,0
21133,43408,64774,43408,allow,480,149,331,2,1200,1,1
37995,49152,51662,49152,allow,156,156,0,3,8,3,0
46827,443,46276,443,allow,8277,1368,6909,31,120,14,17
44587,443,26672,443,allow,16341,3306,13035,42,17,24,18
1024,50265,0,0,deny,62,62,0,1,0,1,0
54084,445,0,0,drop,70,70,0,1,0,1,0
65229,53,65530,53,allow,443,182,261,6,30,3,3
50175,53,51711,53,allow,819,102,717,2,30,1,1
37902,123,60994,123,allow,184,94,90,2,30,1,1
53520,37553,29607,37553,allow,70,70,0,1,4,1,0
58638,5900,0,0,deny,62,62,0,1,0,1,0
49256,445,0,0,drop,66,66,0,1,0,1,0
53132,29384,28228,29384,allow,70,70,0,2,8,2,0
40547,24051,0,0,deny,74,74,0,1,0,1,0
50651,25174,0,0,deny,62,62,0,1,0,1,0
59508,65348,0,0,deny,148,148,0,1,0,1,0
50602,445,0,0,drop,66,66,0,1,0,1,0
65291,53,57485,53,allow,195,102,93,2,29,1,1
52186,57609,20882,57609,allow,70,70,0,2,9,2,0
56695,53,7335,53,allow,183,94,89,2,30,1,1
60474,8999,37889,8999,allow,70,70,0,2,8,2,0
37320,443,60186,443,allow,70,70,0,1,5,1,0
55868,53,39236,53,allow,458,188,270,6,29,3,3
25602,64147,0,0,deny,62,62,0,1,0,1,0
18423,51505,0,0,deny,66,66,0,1,0,1,0
53352,445,0,0,drop,70,70,0,1,0,1,0
49644,30188,0,0,deny,66,66,0,1,0,1,0
54828,445,0,0,drop,70,70,0,1,0,1,0
49944,53,20178,53,allow,192,98,94,2,31,1,1
40290,53,7159,53,allow,168,78,90,2,30,1,1
64853,53,57521,53,allow,814,110,704,2,29,1,1
49848,443,28970,443,allow,33314,1722,31592,40,88,14,26
9472,443,45589,443,allow,5699,505,5194,14,15,7,7
55913,53,2700,53,allow,177,94,83,2,30,1,1
40356,9192,0,0,deny,145,145,0,1,0,1,0
56774,39553,19722,39553,allow,66,66,0,1,5,1,0
53246,443,15204,443,allow,134,60,74,3,11,2,1
55080,53,13972,53,allow,165,86,79,2,29,1,1
59917,445,0,0,drop,66,66,0,1,0,1,0
57656,445,0,0,drop,66,66,0,1,0,1,0
19096,64147,0,0,deny,62,62,0,1,0,1,0
14336,64147,0,0,deny,62,62,0,1,0,1,0
56071,53,32735,53,allow,193,102,91,2,31,1,1
51696,14370,13279,14370,allow,70,70,0,1,5,1,0
56380,53,5120,53,allow,177,94,83,2,30,1,1
52533,53,8262,53,allow,242,78,164,2,30,1,1
6889,25975,0,0,deny,143,143,0,1,0,1,0
49826,53,43562,53,allow,466,192,274,6,83,3,3
57319,443,43757,443,allow,134,60,74,3,5,2,1
55600,22,0,0,deny,60,60,0,1,0,1,0
58624,445,0,0,drop,70,70,0,1,0,1,0
16721,22114,0,0,deny,146,146,0,1,0,1,0
49635,53,16265,53,allow,458,188,270,6,30,3,3
57387,53,39674,53,allow,178,94,84,2,30,1,1
53624,7370,56004,7370,allow,70,70,0,1,5,1,0
1040,37965,0,0,deny,62,62,0,1,0,1,0
18655,50584,0,0,deny,62,62,0,1,0,1,0
23131,25174,0,0,deny,146,146,0,1,0,1,0
30188,59035,2297,59035,allow,1794,750,1044,12,4220,6,6
52537,37965,0,0,deny,66,66,0,1,0,1,0
56443,53,9982,53,allow,168,86,82,2,31,1,1
20892,53,20892,53,allow,825,99,726,2,30,1,1
52459,33890,0,0,deny,60,60,0,1,0,1,0
29136,31652,0,0,reset-both,145,145,0,1,0,1,0
58976,43890,0,0,deny,62,62,0,1,0,1,0
65228,53,0,0,deny,88,88,0,1,0,1,0
55967,445,0,0,drop,70,70,0,1,0,1,0
61361,445,0,0,drop,70,70,0,1,0,1,0
33830,443,20220,443,allow,130,70,60,2,15,1,1
56062,53,55511,53,allow,196,102,94,2,30,1,1
55757,53,56073,53,allow,177,94,83,2,29,1,1
56968,445,0,0,drop,66,66,0,1,0,1,0
54387,5228,7370,5228,allow,7019,1592,5427,25,3600,14,11
61488,443,29110,443,allow,7036,2247,4789,39,141,19,20
33651,36237,0,0,deny,146,146,0,1,0,1,0
17009,53733,0,0,deny,66,66,0,1,0,1,0
50734,37965,0,0,deny,62,62,0,1,0,1,0
60196,53,0,0,deny,88,88,0,1,0,1,0
59078,445,0,0,drop,66,66,0,1,0,1,0
64897,2323,0,0,deny,60,60,0,1,0,1,0
56288,53,26260,53,allow,200,102,98,2,31,1,1
37965,51719,40903,51719,allow,481,150,331,2,1199,1,1
51413,443,55199,443,allow,695,575,120,4,6,2,2
42731,443,42301,443,allow,6131,1399,4732,20,983,10,10
55368,443,50740,443,allow,8551,2955,5596,28,423,15,13
51407,443,57078,443,allow,202,70,132,3,11,1,2
20954,53,64122,53,allow,223,78,145,2,30,1,1
58906,80,61612,80,allow,742,350,392,12,28,6,6
49348,80,49348,80,allow,450,246,204,8,142,5,3
48817,6884,48817,6884,allow,479,277,202,4,1200,2,2
9098,443,52183,443,allow,6177,969,5208,17,26,9,8
49201,445,0,0,drop,66,66,0,1,0,1,0
52095,56079,0,0,deny,66,66,0,1,0,1,0
59810,445,0,0,drop,70,70,0,1,0,1,0
64531,445,0,0,drop,66,66,0,1,0,1,0
59312,443,40068,443,allow,233778,8502,225276,276,34,109,167
22904,56205,0,0,deny,62,62,0,1,0,1,0
37569,443,55677,443,allow,120566,15345,105221,173,125,72,101
21542,57470,0,0,deny,74,74,0,1,0,1,0
34768,443,44621,443,allow,21905,3249,18656,38,271,18,20
49237,53,49766,53,allow,735,88,647,2,31,1,1
443,41545,0,0,deny,60,60,0,1,0,1,0
49381,53,1330,53,allow,209,110,99,2,30,1,1
55715,53,57381,53,allow,168,86,82,2,30,1,1
45275,443,51304,443,allow,9908271,123308,9784963,8531,359,1708,6823
7176,53,7176,53,allow,233,91,142,2,31,1,1
55597,53,45448,53,allow,168,86,82,2,30,1,1
37646,443,54992,443,allow,11821,3643,8178,30,45,17,13
4760,44847,0,0,deny,62,62,0,1,0,1,0
64886,53,44785,53,allow,199,102,97,2,29,1,1
28580,64147,0,0,deny,62,62,0,1,0,1,0
57336,445,0,0,drop,70,70,0,1,0,1,0
63288,52848,0,0,deny,66,66,0,1,0,1,0
65066,53,65066,53,allow,240,98,142,2,30,1,1
11859,64147,0,0,deny,62,62,0,1,0,1,0
49293,22,0,0,deny,60,60,0,1,0,1,0
62643,445,0,0,drop,66,66,0,1,0,1,0
2078,7000,2078,7000,allow,3006,1615,1391,15,15,8,7
52137,445,0,0,drop,70,70,0,1,0,1,0
59192,25174,0,0,deny,66,66,0,1,0,1,0
56447,53,39784,53,allow,403,110,293,2,30,1,1
54845,445,0,0,drop,66,66,0,1,0,1,0
53459,445,0,0,drop,70,70,0,1,0,1,0
51606,443,26654,443,allow,2895,2046,849,14,134,8,6
11897,443,11897,443,allow,1452,817,635,16,29,9,7
49540,53,16812,53,allow,279,94,185,2,30,1,1
46653,443,4259,443,allow,4037,1058,2979,12,120,6,6
48292,80,5673,80,allow,14038,3554,10484,45,1142,16,29
49257,53,2534,53,allow,198,101,97,2,30,1,1
46763,443,11187,443,allow,11876848,256539,11620309,11266,74,3584,7682
30794,37965,0,0,deny,62,62,0,1,0,1,0
58113,445,0,0,drop,70,70,0,1,0,1,0
49711,445,0,0,drop,66,66,0,1,0,1,0
49861,53,27236,53,allow,198,102,96,2,31,1,1
64118,445,0,0,drop,66,66,0,1,0,1,0
9460,80,52623,80,allow,1641,483,1158,10,15,5,5
51021,445,0,0,drop,70,70,0,1,0,1,0
13062,52752,0,0,deny,66,66,0,1,0,1,0
53974,26108,3464,26108,allow,70,70,0,2,8,2,0
50962,5900,0,0,deny,60,60,0,1,0,1,0
49319,53,39564,53,allow,199,102,97,2,29,1,1
49359,53,28261,53,allow,718,94,624,2,30,1,1
56922,53,43765,53,allow,86,86,0,1,30,1,0
55097,445,0,0,drop,66,66,0,1,0,1,0
55640,53,37187,53,allow,797,208,589,6,67,3,3
56627,53,42658,53,allow,186,95,91,2,31,1,1
59635,7275,39827,7275,allow,448,78,370,6,25,1,5
5223,7851,0,0,deny,66,66,0,1,0,1,0
65371,53,39965,53,allow,198,101,97,2,31,1,1
31613,23,0,0,deny,60,60,0,1,0,1,0
64095,53,40106,53,allow,177,94,83,2,30,1,1
51896,445,0,0,drop,66,66,0,1,0,1,0
8889,33873,8889,33873,allow,124,60,64,2,30,1,1
65011,53,20412,53,allow,183,94,89,2,29,1,1
55689,37965,0,0,deny,66,66,0,1,0,1,0
49649,445,0,0,drop,66,66,0,1,0,1,0
58771,53,46484,53,allow,168,78,90,2,30,1,1
53879,43702,31911,43702,allow,320,140,180,6,6,3,3
57470,6881,51127,6881,allow,594,594,0,10,1200,10,0
8734,56205,0,0,deny,66,66,0,1,0,1,0
57095,53,44244,53,allow,170,87,83,2,30,1,1
49952,445,0,0,drop,66,66,0,1,0,1,0
58638,5900,0,0,deny,62,62,0,1,0,1,0
56338,443,8628,443,allow,11148,3099,8049,26,24,15,11
21522,80,0,0,deny,60,60,0,1,0,1,0
5223,1210,0,0,deny,66,66,0,1,0,1,0
63480,445,0,0,drop,70,70,0,1,0,1,0
51894,80,51074,80,allow,7434,3830,3604,17,26,9,8
47814,51505,0,0,deny,66,66,0,1,0,1,0
15296,37965,0,0,deny,66,66,0,1,0,1,0
64811,53,63660,53,allow,446,93,353,4,55,2,2
61596,445,0,0,drop,66,66,0,1,0,1,0
45132,443,57235,443,allow,5398,3277,2121,30,80,16,14
443,49988,0,0,deny,82,82,0,1,0,1,0
46212,443,60547,443,allow,9753,1572,8181,22,362,11,11
35644,67,0,0,deny,60,60,0,1,0,1,0
49846,445,0,0,drop,66,66,0,1,0,1,0
56874,67,0,0,deny,60,60,0,1,0,1,0
56811,53,1928,53,allow,762,97,665,2,30,1,1
53751,445,0,0,drop,70,70,0,1,0,1,0
53465,57470,0,0,deny,62,62,0,1,0,1,0
55423,53,61643,53,allow,711,87,624,2,31,1,1
65200,53,5141,53,allow,214,110,104,2,30,1,1
25772,7302,0,0,deny,62,62,0,1,0,1,0
58638,5900,0,0,deny,62,62,0,1,0,1,0
58844,443,8325,443,allow,5167,700,4467,16,15,7,9
56674,443,44964,443,allow,237,177,60,3,5,2,1
52994,445,0,0,drop,70,70,0,1,0,1,0
54754,50432,0,0,deny,66,66,0,1,0,1,0
6721,37965,0,0,deny,66,66,0,1,0,1,0
56695,53,2838,53,allow,183,94,89,2,30,1,1
56072,53,61103,53,allow,199,102,97,2,30,1,1
49842,80,44778,80,allow,70094,1629,68465,63,89,16,47
51765,80,50481,80,allow,5569,3270,2299,21,74,13,8
61518,22,61518,22,allow,7306,2583,4723,36,25,19,17
6666,16010,0,0,deny,60,60,0,1,0,1,0
80,53945,0,0,deny,60,60,0,1,0,1,0
58616,80,39662,80,allow,1056,682,374,10,15,6,4
50442,37807,0,0,deny,66,66,0,1,0,1,0
62030,53,0,0,allow,229,85,144,2,31,1,1
50294,53,23372,53,allow,178,94,84,2,30,1,1
36936,53,30039,53,allow,78,78,0,1,30,1,0
49465,445,0,0,drop,70,70,0,1,0,1,0
16522,26467,0,0,deny,62,62,0,1,0,1,0
51923,22114,0,0,deny,146,146,0,1,0,1,0
20746,53,43830,53,allow,191,86,105,2,30,1,1
51920,32678,45180,32678,allow,70,70,0,2,8,2,0
59773,53,11146,53,allow,218,78,140,2,31,1,1
64930,53,29648,53,allow,193,102,91,2,29,1,1
61983,50432,0,0,deny,62,62,0,1,0,1,0
55964,445,0,0,drop,70,70,0,1,0,1,0
55923,53,53051,53,allow,177,94,83,2,30,1,1
60231,443,26634,443,allow,1868,1229,639,18,151,11,7
45813,5222,28803,5222,allow,5723,3023,2700,58,548,32,26
51974,80,47213,80,allow,38272,2881,35391,54,54,26,28
53789,53,48550,53,allow,168,78,90,2,30,1,1
49241,445,0,0,drop,70,70,0,1,0,1,0
64497,445,0,0,drop,70,70,0,1,0,1,0
42107,443,39392,443,allow,13704,2379,11325,47,279,22,25
65294,53,43260,53,allow,173,94,79,2,30,1,1
4300,37838,0,0,deny,146,146,0,1,0,1,0
57994,443,31591,443,allow,10027,2130,7897,27,27,16,11
56965,80,39996,80,allow,526,304,222,8,30,5,3
65481,53,60374,53,allow,168,86,82,2,30,1,1
40977,21247,0,0,deny,66,66,0,1,0,1,0
55456,53,57964,53,allow,711,87,624,2,30,1,1
61550,5529,0,0,deny,145,145,0,1,0,1,0
42157,443,25655,443,allow,4819,2903,1916,29,81,15,14
50602,53,48380,53,allow,761,100,661,2,30,1,1
65323,445,0,0,drop,66,66,0,1,0,1,0
65245,53,21925,53,allow,184,102,82,2,30,1,1
58638,5900,0,0,deny,62,62,0,1,0,1,0
59481,445,0,0,drop,66,66,0,1,0,1,0
46557,57866,0,0,deny,62,62,0,1,0,1,0
27005,27015,28770,27015,allow,879,126,753,2,29,1,1
57395,53,57395,53,allow,208,82,126,2,30,1,1
11488,22114,0,0,deny,66,66,0,1,0,1,0
52676,53733,0,0,deny,66,66,0,1,0,1,0
52308,80,52308,80,allow,14704,1558,13146,25,29,11,14
52078,80,58261,80,allow,366,240,126,7,25,5,2
35291,44847,0,0,deny,66,66,0,1,0,1,0
68,67,0,0,deny,346,346,0,1,0,1,0
49439,53,11369,53,allow,197,102,95,2,30,1,1
64365,53,32131,53,allow,234,94,140,2,30,1,1
60479,25174,0,0,deny,62,62,0,1,0,1,0
52190,29765,59554,29765,allow,70,70,0,1,4,1,0
56917,443,25330,443,allow,14033,1591,12442,26,132,10,16
6881,51184,15075,51184,allow,324,150,174,2,1203,1,1
50489,443,43121,443,allow,8389,1077,7312,24,140,12,12
52176,17572,9912,17572,allow,70,70,0,1,5,1,0
443,14591,0,0,deny,131,131,0,1,0,1,0
64593,53,46361,53,allow,258,102,156,2,30,1,1
57470,32348,51610,32348,allow,527,166,361,2,1199,1,1
60389,443,56749,443,allow,8166,1734,6432,23,81,12,11
64714,53,3550,53,allow,168,86,82,2,31,1,1
63877,51413,26586,51413,allow,564,382,182,9,18,6,3
47090,15000,28011,15000,allow,138,78,60,2,5,1,1
21034,50265,0,0,deny,66,66,0,1,0,1,0
63888,25174,0,0,deny,66,66,0,1,0,1,0
55089,53,56950,53,allow,199,102,97,2,30,1,1
49760,80,15959,80,allow,2113,1181,932,10,127,6,4
53784,16671,49140,16671,allow,70,70,0,2,7,2,0
48304,443,22064,443,allow,6606,2153,4453,22,95,13,9
41056,443,45681,443,allow,8185,1381,6804,22,831,11,11
32675,53,58212,53,allow,218,78,140,2,30,1,1
23406,443,23406,443,allow,5368,1609,3759,21,75,12,9
34430,443,8333,443,allow,1701,1048,653,15,38,8,7
51725,32787,39792,32787,allow,70,70,0,2,8,2,0
58638,5900,0,0,deny,62,62,0,1,0,1,0
20939,60461,0,0,deny,60,60,0,1,0,1,0
37602,53,37602,53,allow,260,106,154,2,32,1,1
50714,443,52657,443,allow,9477,1950,7527,31,181,14,17
39381,53,0,0,allow,82,82,0,1,31,1,0
51694,80,56366,80,allow,1307,649,658,8,75,5,3
56658,53,26187,53,allow,193,102,91,2,30,1,1
63076,445,0,0,drop,70,70,0,1,0,1,0
58638,5900,0,0,deny,62,62,0,1,0,1,0
49730,445,0,0,drop,70,70,0,1,0,1,0
56050,53,60245,53,allow,178,94,84,2,30,1,1
58329,62413,0,0,deny,62,62,0,1,0,1,0
39392,80,20430,80,allow,1325,442,883,16,414,4,12
20741,64147,0,0,deny,62,62,0,1,0,1,0
29623,37807,0,0,deny,62,62,0,1,0,1,0
58339,445,0,0,drop,70,70,0,1,0,1,0
59134,80,59134,80,allow,104133,2163,101970,103,15,32,71
65063,53,52560,53,allow,180,94,86,2,30,1,1
62273,50584,0,0,deny,62,62,0,1,0,1,0
65189,27016,36079,27016,allow,78,78,0,1,29,1,0
54011,445,0,0,drop,66,66,0,1,0,1,0
52040,2524,8539,2524,allow,70,70,0,2,7,2,0
60215,80,6497,80,allow,21073,15881,5192,47,151,30,17
58638,5900,0,0,deny,62,62,0,1,0,1,0
50809,445,0,0,drop,66,66,0,1,0,1,0
58692,53,28574,53,allow,199,94,105,2,30,1,1
34306,37965,0,0,deny,62,62,0,1,0,1,0
54144,445,0,0,drop,70,70,0,1,0,1,0
49234,80,29641,80,allow,1103248,36317,1066931,1001,162,276,725
51658,80,26955,80,allow,39464,2150,37314,81,20,26,55
55066,445,0,0,drop,70,70,0,1,0,1,0
50325,80,28914,80,allow,19438,12019,7419,53,312,30,23
53325,443,60728,443,allow,6988,1214,5774,29,315,13,16
41916,443,13885,443,allow,8634,3251,5383,24,17,14,10
5830,22114,0,0,deny,66,66,0,1,0,1,0
53807,445,0,0,drop,70,70,0,1,0,1,0
50535,80,30581,80,allow,62768,25796,36972,75,34,33,42
60324,445,0,0,drop,70,70,0,1,0,1,0
50672,443,34507,443,allow,6202,1828,4374,25,18,12,13
53042,443,14232,443,allow,5452,1545,3907,22,16,13,9
50018,53,44491,53,allow,270,102,168,2,30,1,1
49339,443,48962,443,allow,3191,2313,878,17,42,10,7
37865,123,17478,123,allow,184,94,90,2,30,1,1
54865,443,54865,443,allow,125282,21435,103847,162,20,80,82
49450,443,32537,443,allow,9704,2335,7369,20,26,10,10
55809,53,62877,53,allow,731,85,646,2,31,1,1
55691,445,0,0,drop,66,66,0,1,0,1,0
52213,56682,21348,56682,allow,70,70,0,2,6,2,0
52473,445,0,0,drop,66,66,0,1,0,1,0
50265,13826,10952,13826,allow,330,330,0,6,1200,6,0
55688,443,55688,443,allow,115875,6637,109238,158,80,71,87
56943,80,45580,80,allow,2817,2024,793,12,75,7,5
16403,16384,56995,16384,allow,556,256,300,10,31,5,5
63888,25174,0,0,deny,62,62,0,1,0,1,0
62197,22114,0,0,deny,62,62,0,1,0,1,0
57761,445,0,0,drop,70,70,0,1,0,1,0
27078,25174,0,0,deny,146,146,0,1,0,1,0
63529,445,0,0,drop,70,70,0,1,0,1,0
52164,42271,30250,42271,allow,70,70,0,2,8,2,0
64095,1976,59706,1976,allow,70,70,0,1,5,1,0
49001,48817,0,0,deny,160,160,0,1,0,1,0
58634,445,0,0,drop,70,70,0,1,0,1,0
57432,53,52576,53,allow,186,95,91,2,31,1,1
50622,53,57483,53,allow,185,102,83,2,30,1,1
10103,443,54343,443,allow,6334,910,5424,20,360,10,10
55269,53,35707,53,allow,193,102,91,2,31,1,1
53940,53,37682,53,allow,70,70,0,1,30,1,0
55411,53,47570,53,allow,183,94,89,2,30,1,1
55201,22114,0,0,deny,62,62,0,1,0,1,0
53741,43800,30138,43800,allow,70,70,0,1,5,1,0
42231,57470,0,0,deny,78,78,0,1,0,1,0
39524,10104,0,0,deny,137,137,0,1,0,1,0
64491,445,0,0,drop,66,66,0,1,0,1,0
50642,53,37858,53,allow,775,102,673,2,30,1,1
57810,445,0,0,drop,70,70,0,1,0,1,0
38602,80,59364,80,allow,2586,832,1754,14,16,7,7
57389,53,9146,53,allow,193,102,91,2,31,1,1
5841,22114,0,0,deny,62,62,0,1,0,1,0
53275,443,20326,443,allow,364,142,222,6,10,3,3
65318,53,17829,53,allow,184,94,90,2,31,1,1
52273,445,0,0,drop,70,70,0,1,0,1,0
56497,53,5207,53,allow,214,110,104,2,30,1,1
57276,445,0,0,drop,70,70,0,1,0,1,0
60925,445,0,0,drop,70,70,0,1,0,1,0
10218,2323,0,0,deny,60,60,0,1,0,1,0
51909,33509,44942,33509,allow,70,70,0,2,8,2,0
30960,45723,17261,45723,allow,330,330,0,6,3608,6,0
60350,51505,0,0,deny,66,66,0,1,0,1,0
59900,3389,59900,3389,allow,3489,1534,1955,17,18,9,8
53807,28630,53835,28630,allow,70,70,0,2,8,2,0
57362,53,3531,53,allow,177,94,83,2,30,1,1
54389,28543,0,0,deny,66,66,0,1,0,1,0
5538,23,0,0,deny,60,60,0,1,0,1,0
50976,80,37762,80,allow,3030,1372,1658,13,21,8,5
58638,5900,0,0,deny,62,62,0,1,0,1,0
49449,80,5830,80,allow,1948,912,1036,13,56,7,6
65416,53,16237,53,allow,213,102,111,2,30,1,1
55526,445,0,0,drop,70,70,0,1,0,1,0
36535,443,34984,443,allow,3319,2176,1143,21,15,11,10
57429,443,7406,443,allow,15017,8283,6734,47,18,24,23
51792,22318,43615,22318,allow,316,136,180,6,5,3,3
62331,445,0,0,drop,66,66,0,1,0,1,0
10128,23718,0,0,deny,146,146,0,1,0,1,0
49209,53,59782,53,allow,199,102,97,2,30,1,1
55559,53,16251,53,allow,182,94,88,2,30,1,1
1666,53,1666,53,allow,217,90,127,2,30,1,1
58885,443,57111,443,allow,5167,700,4467,16,15,7,9
55388,53,28391,53,allow,177,94,83,2,30,1,1
56362,443,16235,443,allow,3734,1750,1984,24,203,12,12
64942,53,4876,53,allow,284,102,182,4,37,2,2
49294,53,7678,53,allow,287,94,193,2,30,1,1
50674,80,2786,80,allow,3325,598,2727,12,15,6,6
52340,64147,0,0,deny,66,66,0,1,0,1,0
59639,445,0,0,drop,70,70,0,1,0,1,0
63953,445,0,0,drop,66,66,0,1,0,1,0
56352,445,0,0,drop,70,70,0,1,0,1,0
56814,53,30689,53,allow,816,102,714,2,30,1,1
63843,53603,44636,53603,allow,312,132,180,6,6,3,3
55720,51610,62012,51610,allow,70,70,0,2,8,2,0
52204,445,0,0,drop,70,70,0,1,0,1,0
54016,42707,0,0,deny,66,66,0,1,0,1,0
49516,53,60499,53,allow,183,94,89,2,29,1,1
57176,53,50437,53,allow,178,94,84,2,29,1,1
60428,25174,0,0,deny,66,66,0,1,0,1,0
56738,53,23984,53,allow,264,87,177,4,37,2,2
57434,50584,0,0,deny,62,62,0,1,0,1,0
55587,43890,0,0,deny,62,62,0,1,0,1,0
50968,443,5698,443,allow,7532,3051,4481,13,120,6,7
53277,80,34172,80,allow,4374,1724,2650,16,150,9,7
65424,53,5090,53,allow,210,110,100,2,31,1,1
53817,443,11999,443,allow,7443,2043,5400,34,255,17,17
55869,53,49767,53,allow,196,102,94,2,30,1,1
62937,445,0,0,drop,66,66,0,1,0,1,0
6881,13234,11039,13234,allow,324,150,174,2,1201,1,1
57370,53,22264,53,allow,347,110,237,2,30,1,1
59634,445,0,0,drop,70,70,0,1,0,1,0
49788,1433,0,0,deny,60,60,0,1,0,1,0
57367,53,32502,53,allow,177,94,83,2,30,1,1
6882,8999,49067,8999,allow,238,118,120,2,1200,1,1
58638,5900,0,0,deny,62,62,0,1,0,1,0
64093,443,64093,443,allow,5663,2416,3247,26,159,14,12
62443,445,0,0,drop,70,70,0,1,0,1,0
64975,445,0,0,deny,66,66,0,1,0,1,0
46266,53,15636,53,allow,308,118,190,2,30,1,1
30960,45703,22089,45703,allow,330,330,0,6,3609,6,0
56835,35894,0,0,deny,66,66,0,1,0,1,0
55630,43736,8013,43736,allow,70,70,0,1,5,1,0
0,0,0,0,allow,156,156,0,2,0,2,0
64698,53,15508,53,allow,763,102,661,2,30,1,1
27005,32036,10706,32036,allow,876,126,750,2,30,1,1
64551,53,2637,53,allow,354,94,260,2,30,1,1
54539,443,15655,443,allow,4552,2230,2322,14,134,7,7
10354,81,0,0,deny,60,60,0,1,0,1,0
9095,22114,0,0,deny,62,62,0,1,0,1,0
64936,53,3056,53,allow,193,102,91,2,30,1,1
35866,80,8550,80,allow,1114,534,580,12,15,7,5
6247,51221,0,0,deny,78,78,0,1,0,1,0
16490,25174,0,0,deny,66,66,0,1,0,1,0
49461,445,0,0,drop,66,66,0,1,0,1,0
53553,2297,50955,2297,allow,70,70,0,1,4,1,0
58770,53,51678,53,allow,168,78,90,2,31,1,1
60399,80,36861,80,allow,1168,815,353,10,122,6,4
123,123,49669,123,allow,184,94,90,2,29,1,1
49913,53,61333,53,allow,177,94,83,2,29,1,1
49931,25174,0,0,deny,66,66,0,1,0,1,0
65167,53,26450,53,allow,212,102,110,2,29,1,1
42607,443,22766,443,allow,167,107,60,2,5,1,1
38291,443,42711,443,allow,6737,1006,5731,20,162,11,9
59659,445,0,0,drop,70,70,0,1,0,1,0
63493,445,0,0,drop,70,70,0,1,0,1,0
59756,445,0,0,drop,70,70,0,1,0,1,0
65516,53,26116,53,allow,202,103,99,2,31,1,1
56431,53,39797,53,allow,177,94,83,2,30,1,1
41892,443,2330,443,allow,2594,1280,1314,17,17,9,8
65152,53,60141,53,allow,177,94,83,2,30,1,1
55989,443,55989,443,allow,4378,1471,2907,19,29,11,8
58638,5900,0,0,deny,62,62,0,1,0,1,0
56601,53,16656,53,allow,239,94,145,2,31,1,1
61148,445,0,0,drop,70,70,0,1,0,1,0
56567,53,21156,53,allow,194,102,92,2,30,1,1
0,0,0,0,allow,152,78,74,2,0,1,1
45397,443,38399,443,allow,970804,44459,926345,1113,200,446,667
50460,53,61853,53,allow,753,96,657,2,31,1,1
11136,19910,0,0,deny,62,62,0,1,0,1,0
56986,445,0,0,drop,70,70,0,1,0,1,0
32007,1212,0,0,deny,145,145,0,1,0,1,0
56449,443,10507,443,allow,3182,1568,1614,8,120,4,4
49706,80,39061,80,allow,118813,4128,114685,122,108,38,84
49577,80,46203,80,allow,147113,4021,143092,144,65,41,103
39324,64147,0,0,deny,62,62,0,1,0,1,0
28436,22114,0,0,deny,146,146,0,1,0,1,0
40103,443,5740,443,allow,416,210,206,7,34,4,3
58280,443,25550,443,allow,1786,172,1614,7,121,3,4
57396,53,7718,53,allow,184,94,90,2,30,1,1
8040,44847,0,0,deny,66,66,0,1,0,1,0
22683,39210,0,0,deny,60,60,0,1,0,1,0
58633,445,0,0,drop,66,66,0,1,0,1,0
64946,53,64946,53,allow,233,90,143,2,33,1,1
50208,1688,43148,1688,allow,70,70,0,1,5,1,0
49580,443,38727,443,allow,442,262,180,8,42,5,3
57410,53,64082,53,allow,711,87,624,2,30,1,1
64037,445,0,0,drop,66,66,0,1,0,1,0
60970,20541,0,0,deny,66,66,0,1,0,1,0
58445,17500,0,0,deny,66,66,0,1,0,1,0
60546,53,37684,53,allow,199,94,105,2,30,1,1
56226,53,8376,53,allow,284,96,188,4,31,2,2
41098,80,34310,80,allow,1937,1193,744,12,16,7,5
58941,445,0,0,drop,70,70,0,1,0,1,0
64850,445,0,0,drop,70,70,0,1,0,1,0
63128,445,0,0,drop,66,66,0,1,0,1,0
443,54507,0,0,deny,82,82,0,1,0,1,0
64086,53,31835,53,allow,241,94,147,2,29,1,1
45780,443,35080,443,allow,7847,1591,6256,23,186,13,10
65372,53,52621,53,allow,330,91,239,4,44,2,2
53218,56205,0,0,deny,66,66,0,1,0,1,0
30304,26467,0,0,deny,62,62,0,1,0,1,0
49183,53,43011,53,allow,592,198,394,6,78,3,3
15005,32480,0,0,deny,145,145,0,1,0,1,0
57470,42329,52817,42329,allow,1782,1782,0,28,1559,28,0
52886,80,7195,80,allow,5688,2508,3180,36,118,19,17
64831,53,30238,53,allow,216,110,106,2,31,1,1
57487,443,7890,443,allow,17065,11570,5495,76,218,39,37
58792,443,15545,443,allow,9278,6126,3152,27,16,15,12
56514,445,0,0,drop,70,70,0,1,0,1,0
27005,27015,13852,27015,allow,881,126,755,2,30,1,1
2487,53,2487,53,allow,235,90,145,2,33,1,1
27005,27015,49152,27015,allow,919,126,793,2,30,1,1
55131,445,0,0,drop,70,70,0,1,0,1,0
49334,53,23056,53,allow,184,94,90,2,31,1,1
58638,5900,0,0,deny,62,62,0,1,0,1,0
55573,445,0,0,drop,70,70,0,1,0,1,0
60851,445,0,0,drop,66,66,0,1,0,1,0
51221,10476,15636,10476,allow,528,528,0,9,1201,9,0
15442,22114,0,0,deny,66,66,0,1,0,1,0
64263,445,0,0,drop,66,66,0,1,0,1,0
53103,8497,0,0,deny,148,148,0,1,0,1,0
49369,53,21146,53,allow,183,94,89,2,30,1,1
65401,445,0,0,drop,70,70,0,1,0,1,0
49174,53,31879,53,allow,199,102,97,2,33,1,1
27005,27015,43397,27015,allow,884,126,758,2,30,1,1
50808,445,0,0,drop,70,70,0,1,0,1,0
65117,445,0,0,drop,66,66,0,1,0,1,0
52456,445,0,0,drop,66,66,0,1,0,1,0
51157,445,0,0,drop,70,70,0,1,0,1,0
53244,445,0,0,drop,70,70,0,1,0,1,0
56655,53,28955,53,allow,168,86,82,2,29,1,1
10034,53,10034,53,allow,215,98,117,2,29,1,1
1660,8696,0,0,deny,62,62,0,1,0,1,0
61222,445,0,0,drop,70,70,0,1,0,1,0
65062,53,47695,53,allow,229,110,119,2,30,1,1
65315,53,36671,53,allow,300,99,201,4,30,2,2
49568,443,30225,443,allow,6408,2531,3877,21,16,11,10
55489,53,54406,53,allow,186,95,91,2,31,1,1
49670,53,15548,53,allow,168,86,82,2,31,1,1
62388,39004,0,0,deny,62,62,0,1,0,1,0
58064,445,0,0,drop,70,70,0,1,0,1,0
53650,37096,53395,37096,allow,70,70,0,2,8,2,0
53168,80,46007,80,allow,1501,958,543,10,323,6,4
56924,53,30417,53,allow,216,110,106,2,31,1,1
50403,8080,50403,8080,allow,2203,575,1628,10,15,6,4
7288,25174,0,0,deny,66,66,0,1,0,1,0
55431,53,2541,53,allow,196,102,94,2,31,1,1
60387,80,36861,80,allow,214,140,74,4,15,3,1
50682,80,30834,80,allow,5036,4332,704,11,25,6,5
45964,2225,0,0,deny,60,60,0,1,0,1,0
55069,44847,0,0,deny,62,62,0,1,0,1,0
46641,8100,13057,8100,allow,78,78,0,1,4,1,0
55373,1,0,0,deny,66,66,0,1,0,1,0
50458,445,0,0,drop,70,70,0,1,0,1,0
56740,53,17032,53,allow,716,95,621,2,30,1,1
64281,53,45768,53,allow,214,110,104,2,31,1,1
10738,50584,0,0,deny,62,62,0,1,0,1,0
60860,443,28548,443,allow,11687,2565,9122,46,66,25,21
49687,53,60160,53,allow,197,102,95,2,31,1,1
55107,53,60503,53,allow,816,102,714,2,30,1,1
51995,50031,39289,50031,allow,70,70,0,2,8,2,0
52642,445,0,0,drop,70,70,0,1,0,1,0
53183,445,0,0,drop,66,66,0,1,0,1,0
62625,37965,0,0,deny,66,66,0,1,0,1,0
50116,22,50116,22,allow,184,120,64,4,10,3,1
58638,5900,0,0,deny,62,62,0,1,0,1,0
40308,67,0,0,deny,60,60,0,1,0,1,0
55782,53,37884,53,allow,728,96,632,2,30,1,1
26449,80,26449,80,allow,642,338,304,10,33,6,4
55963,53,19959,53,allow,316,94,222,2,30,1,1
42813,443,40546,443,allow,1241645,28525,1213120,1200,65,328,872
53178,26467,0,0,deny,62,62,0,1,0,1,0
51943,445,0,0,drop,66,66,0,1,0,1,0
6881,40783,51733,40783,allow,509,150,359,2,1199,1,1
2077,53,2077,53,allow,212,98,114,2,30,1,1
57770,445,0,0,drop,70,70,0,1,0,1,0
52914,445,0,0,drop,70,70,0,1,0,1,0
27005,27019,64712,27019,allow,1624,126,1498,4,31,2,2
61505,443,24914,443,allow,4820,863,3957,18,31,10,8
64905,53,22894,53,allow,458,188,270,6,29,3,3
55065,80,56775,80,allow,306,180,126,6,28,4,2
50351,445,0,0,drop,70,70,0,1,0,1,0
51608,445,0,0,drop,66,66,0,1,0,1,0
50509,443,29330,443,allow,9535,1246,8289,29,77,15,14
48909,5228,27859,5228,allow,11007,2491,8516,44,4411,18,26
55752,53,65323,53,allow,177,94,83,2,30,1,1
56748,80,11482,80,allow,946,531,415,11,296,6,5
56754,53,1275,53,allow,751,95,656,2,30,1,1
64586,53,2228,53,allow,173,94,79,2,30,1,1
56880,53,8683,53,allow,209,110,99,2,31,1,1
60329,7000,60329,7000,allow,3959,1738,2221,15,15,8,7
64480,53,30625,53,allow,276,126,150,2,30,1,1
15875,50584,0,0,deny,62,62,0,1,0,1,0
59072,445,0,0,drop,70,70,0,1,0,1,0
56041,53,27459,53,allow,174,89,85,2,31,1,1
60133,1,0,0,deny,66,66,0,1,0,1,0
65183,27126,22289,27126,allow,268,78,190,2,30,1,1
20388,53,20388,53,allow,203,82,121,2,30,1,1
39691,443,19471,443,allow,6219,4130,2089,29,221,16,13
54184,445,0,0,drop,66,66,0,1,0,1,0
65410,53,40006,53,allow,229,110,119,2,31,1,1
57470,51413,34257,51413,allow,508,163,345,2,1200,1,1
38771,443,39867,443,allow,7407,3501,3906,18,15,10,8
53786,445,0,0,drop,70,70,0,1,0,1,0
57917,44847,0,0,deny,66,66,0,1,0,1,0
26698,25174,0,0,deny,66,66,0,1,0,1,0
37082,443,41934,443,allow,2419,1461,958,18,170,10,8
18876,44847,0,0,deny,66,66,0,1,0,1,0
53563,35440,0,0,deny,66,66,0,1,0,1,0
3478,61463,0,0,deny,1094,1094,0,1,0,1,0
53839,443,31646,443,allow,499,425,74,4,0,3,1
49160,6889,25152,6889,allow,834,150,684,4,1200,2,2
56355,53,13355,53,allow,184,94,90,2,30,1,1
56424,53,8677,53,allow,177,94,83,2,29,1,1
60407,443,16001,443,allow,7298,1737,5561,21,79,11,10
55551,53,53923,53,allow,180,94,86,2,30,1,1
58638,5900,0,0,deny,62,62,0,1,0,1,0
52629,53,0,0,allow,232,77,155,2,33,1,1
56676,53,9987,53,allow,178,94,84,2,30,1,1
38697,443,5230,443,allow,90001,3161,86840,91,15,26,65
52759,445,0,0,drop,70,70,0,1,0,1,0
49487,445,0,0,drop,70,70,0,1,0,1,0
64053,47783,54848,47783,allow,66,66,0,2,7,2,0
63929,48477,13540,48477,allow,70,70,0,1,5,1,0
51310,445,0,0,drop,66,66,0,1,0,1,0
58625,445,0,0,drop,66,66,0,1,0,1,0
64175,56502,0,0,deny,66,66,0,1,0,1,0
61675,443,61675,443,allow,8512,2483,6029,21,18,12,9
46232,53,46232,53,allow,194,87,107,2,30,1,1
57228,53,47428,53,allow,199,102,97,2,30,1,1
59168,39004,0,0,deny,62,62,0,1,0,1,0
59921,445,0,0,drop,66,66,0,1,0,1,0
59424,445,0,0,drop,70,70,0,1,0,1,0
58508,443,23694,443,allow,3386,1894,1492,20,25,10,10
60196,53,0,0,deny,88,88,0,1,0,1,0
50424,53,47336,53,allow,195,102,93,2,30,1,1
3524,25174,0,0,deny,66,66,0,1,0,1,0
45020,443,48024,443,allow,10427,2928,7499,34,106,16,18
64191,53,5419,53,allow,197,94,103,2,30,1,1
49256,53,34162,53,allow,174,89,85,2,31,1,1
58638,5900,0,0,deny,62,62,0,1,0,1,0
56020,53,46192,53,allow,199,102,97,2,30,1,1
53083,445,0,0,drop,70,70,0,1,0,1,0
53782,42855,41001,42855,allow,70,70,0,2,8,2,0
56504,53,24881,53,allow,198,102,96,2,32,1,1
56762,53,10998,53,allow,168,86,82,2,30,1,1
57059,445,0,0,drop,70,70,0,1,0,1,0
57432,443,39026,443,allow,2714,336,2378,10,120,5,5
51667,80,5248,80,allow,20457,4742,15715,37,139,20,17
1940,53,23603,53,allow,210,78,132,2,30,1,1
53100,443,19603,443,allow,472,406,66,4,0,3,1
40408,1488,40408,1488,allow,156,156,0,3,8,3,0
63959,15922,28893,15922,allow,2136,1536,600,18,22,12,6
58101,46314,0,0,deny,72,72,0,1,0,1,0
51076,80,51076,80,allow,8170,844,7326,17,42,7,10
65114,53,42555,53,allow,380,86,294,2,30,1,1
50973,445,0,0,drop,70,70,0,1,0,1,0
5938,47968,0,0,allow,60,60,0,1,91,1,0
26053,33720,0,0,deny,160,160,0,1,0,1,0
50089,445,0,0,drop,70,70,0,1,0,1,0
51569,445,0,0,drop,66,66,0,1,0,1,0
54256,123,0,0,deny,234,234,0,1,0,1,0
61051,445,0,0,drop,70,70,0,1,0,1,0
55547,53,56945,53,allow,738,86,652,2,30,1,1
50479,445,0,0,drop,66,66,0,1,0,1,0
57322,53,59513,53,allow,196,102,94,2,30,1,1
51308,445,0,0,drop,66,66,0,1,0,1,0
58040,445,0,0,drop,66,66,0,1,0,1,0
52212,80,6091,80,allow,366,246,120,6,34,4,2
2697,28189,0,0,deny,60,60,0,1,0,1,0
9296,443,44194,443,allow,3792,488,3304,14,16,7,7
52462,445,0,0,drop,70,70,0,1,0,1,0
51716,57137,20087,57137,allow,70,70,0,1,5,1,0
54339,23117,0,0,deny,66,66,0,1,0,1,0
53472,17,0,0,deny,60,60,0,1,0,1,0
57357,53,10860,53,allow,231,94,137,2,30,1,1
44401,53,44401,53,allow,197,90,107,2,30,1,1
65235,53,33492,53,allow,209,110,99,2,31,1,1
58026,80,26240,80,allow,454,262,192,8,21,5,3
58638,5900,0,0,deny,62,62,0,1,0,1,0
64416,53,56387,53,allow,291,110,181,2,30,1,1
50109,53,61948,53,allow,768,99,669,2,30,1,1
8971,80,8971,80,allow,326,186,140,6,29,4,2
12503,25174,0,0,deny,146,146,0,1,0,1,0
28413,64147,0,0,deny,66,66,0,1,0,1,0
55100,53,26652,53,allow,178,94,84,2,31,1,1
53678,31592,2735,31592,allow,70,70,0,2,8,2,0
49261,53,20112,53,allow,453,186,267,6,30,3,3
59186,445,0,0,drop,70,70,0,1,0,1,0
38700,443,53165,443,allow,40207,7892,32315,59,152,23,36
60336,443,57486,443,allow,6613,4394,2219,50,122,29,21
52005,443,38700,443,allow,4802,866,3936,19,26,10,9
53907,445,0,0,drop,66,66,0,1,0,1,0
60131,445,0,0,drop,70,70,0,1,0,1,0
56997,123,16433,123,allow,184,94,90,2,30,1,1
51581,22114,0,0,deny,66,66,0,1,0,1,0
52318,443,6808,443,allow,9453,2797,6656,46,32,25,21
37597,50584,0,0,deny,66,66,0,1,0,1,0
55460,445,0,0,drop,70,70,0,1,0,1,0
56618,443,57435,443,allow,8034,2014,6020,20,15,11,9
50810,445,0,0,drop,70,70,0,1,0,1,0
64772,64147,0,0,deny,62,62,0,1,0,1,0
33569,443,28286,443,allow,9032,2162,6870,34,34,18,16
45346,443,29212,443,allow,2438,1442,996,21,20,12,9
54464,56205,0,0,deny,66,66,0,1,0,1,0
57163,443,53866,443,allow,4694,2454,2240,14,135,7,7
52669,443,6202,443,allow,18814,2623,16191,54,25,26,28
21268,62609,0,0,deny,146,146,0,1,0,1,0
64559,445,0,0,drop,70,70,0,1,0,1,0
33201,443,28063,443,allow,21805,2081,19724,38,34,19,19
57246,53,9725,53,allow,183,94,89,2,30,1,1
59929,445,0,0,drop,70,70,0,1,0,1,0
65170,53,60576,53,allow,771,102,669,2,30,1,1
49540,80,39259,80,allow,374,192,182,7,42,4,3
60217,445,0,0,drop,70,70,0,1,0,1,0
64172,53,61363,53,allow,361,99,262,4,54,2,2
7067,22114,0,0,deny,146,146,0,1,0,1,0
39192,80,42667,80,allow,62592,60966,1626,63,16,47,16
65110,445,0,0,drop,70,70,0,1,0,1,0
65379,22114,0,0,deny,62,62,0,1,0,1,0
53686,8999,26730,8999,allow,70,70,0,1,4,1,0
61520,23718,0,0,deny,66,66,0,1,0,1,0
53660,443,7808,443,allow,9028,3897,5131,24,83,15,9
50046,22114,0,0,deny,66,66,0,1,0,1,0
65189,28215,62292,28215,allow,259,78,181,2,29,1,1
56380,36829,0,0,deny,66,66,0,1,0,1,0
59956,443,50575,443,allow,2162,1113,1049,18,16,10,8
55635,445,0,0,drop,70,70,0,1,0,1,0
51425,53,0,0,allow,194,87,107,2,30,1,1
52130,1035,4806,1035,allow,70,70,0,2,8,2,0
55216,53,56986,53,allow,179,94,85,2,30,1,1
33324,42873,0,0,deny,62,62,0,1,0,1,0
38626,443,25389,443,allow,97751,9140,88611,115,82,39,76
50458,80,53639,80,allow,1426,865,561,9,15,5,4
52724,445,0,0,drop,66,66,0,1,0,1,0
20345,57470,0,0,deny,146,146,0,1,0,1,0
52643,15941,0,0,deny,66,66,0,1,0,1,0
55930,445,0,0,drop,70,70,0,1,0,1,0
37575,443,11902,443,allow,11095,3227,7868,30,47,17,13
61694,443,25571,443,allow,8696,3245,5451,36,47,16,20
56468,53,8242,53,allow,176,90,86,2,30,1,1
35864,44847,0,0,deny,78,78,0,1,0,1,0
65374,443,10199,443,allow,629017,29841,599176,758,162,331,427
63280,445,0,0,drop,70,70,0,1,0,1,0
44799,443,2515,443,allow,3467,2186,1281,16,15,9,7
56560,53,4551,53,allow,199,102,97,2,30,1,1
63888,57470,0,0,deny,62,62,0,1,0,1,0
60984,445,0,0,drop,70,70,0,1,0,1,0
36789,80,36658,80,allow,129896,7448,122448,172,32,87,85
63969,57635,11400,57635,allow,504,382,122,8,17,6,2
52175,445,0,0,drop,70,70,0,1,0,1,0
40098,443,58425,443,allow,4564,3204,1360,19,348,10,9
50593,443,49390,443,allow,6292,1492,4800,22,16,11,11
49477,7000,49477,7000,allow,5910,4455,1455,19,15,11,8
58387,445,0,0,drop,66,66,0,1,0,1,0
55278,445,0,0,drop,70,70,0,1,0,1,0
61490,443,7323,443,allow,4561,1129,3432,22,109,13,9
50867,445,0,0,drop,66,66,0,1,0,1,0
44822,11848,0,0,reset-both,148,148,0,1,0,1,0
36551,23,0,0,deny,60,60,0,1,0,1,0
43422,80,45475,80,allow,3863,875,2988,12,16,8,4
56113,53,19299,53,allow,817,102,715,2,30,1,1
64169,53,10688,53,allow,202,103,99,2,30,1,1
49573,443,25314,443,allow,1820,1101,719,18,16,10,8
64357,53,38839,53,allow,469,103,366,4,43,2,2
62687,445,0,0,drop,70,70,0,1,0,1,0
52314,443,46456,443,allow,3448,1612,1836,31,36,17,14
35356,53,0,0,allow,82,82,0,1,30,1,0
47884,443,47884,443,allow,4672,1765,2907,18,28,10,8
50769,443,26960,443,allow,6882,1377,5505,19,151,9,10
50098,445,0,0,drop,70,70,0,1,0,1,0
50759,443,24454,443,allow,19782,3596,16186,38,256,21,17
56658,53,11385,53,allow,186,95,91,2,31,1,1
52321,26467,0,0,deny,62,62,0,1,0,1,0
34215,443,33625,443,allow,5341,1386,3955,19,649,11,8
57173,445,0,0,drop,66,66,0,1,0,1,0
61280,26467,0,0,deny,62,62,0,1,0,1,0
52189,24190,59596,24190,allow,70,70,0,1,5,1,0
60786,445,0,0,drop,70,70,0,1,0,1,0
5751,64147,0,0,deny,66,66,0,1,0,1,0
53785,33324,8660,33324,allow,70,70,0,1,4,1,0
1441,51221,0,0,deny,62,62,0,1,0,1,0
64290,53,55058,53,allow,192,98,94,2,31,1,1
54858,51505,0,0,deny,66,66,0,1,0,1,0
64927,53,2368,53,allow,315,110,205,2,30,1,1
65336,53,14965,53,allow,732,89,643,2,31,1,1
61508,443,13468,443,allow,215490,8471,207019,194,45,45,149
53234,445,0,0,drop,70,70,0,1,0,1,0
60292,7129,0,0,deny,62,62,0,1,0,1,0
59881,443,61673,443,allow,302,120,182,6,31,3,3
54240,443,62221,443,allow,499,425,74,4,0,3,1
50552,443,41023,443,allow,8311,3156,5155,29,17,16,13
50335,80,17897,80,allow,3855,828,3027,11,15,5,6
49001,40108,0,0,deny,161,161,0,1,0,1,0
51968,43622,30970,43622,allow,70,70,0,1,4,1,0
62167,445,0,0,drop,70,70,0,1,0,1,0
65297,53,52505,53,allow,241,118,123,2,30,1,1
52120,42751,45034,42751,allow,70,70,0,1,5,1,0
51163,445,0,0,drop,70,70,0,1,0,1,0
58638,5900,0,0,deny,62,62,0,1,0,1,0
49418,33086,18224,33086,allow,237,78,159,2,30,1,1
65324,445,0,0,drop,70,70,0,1,0,1,0
61422,80,46677,80,allow,214,140,74,4,41,3,1
50081,443,6983,443,allow,18754,5240,13514,31,16,15,16
40885,23,0,0,deny,60,60,0,1,0,1,0
52650,44847,0,0,deny,66,66,0,1,0,1,0
50090,50265,0,0,deny,62,62,0,1,0,1,0
52829,80,23872,80,allow,2078,726,1352,10,15,5,5
36731,80,36731,80,allow,514,246,268,9,75,5,4
49837,443,55049,443,allow,4685,2421,2264,10,119,5,5
49646,445,0,0,drop,70,70,0,1,0,1,0
57210,8525,57210,8525,allow,138,78,60,2,5,1,1
39047,443,36034,443,allow,10831,1381,9450,22,19,12,10
54606,445,0,0,drop,70,70,0,1,0,1,0
6355,25174,0,0,deny,146,146,0,1,0,1,0
50551,80,44425,80,allow,374,192,182,7,26,4,3
44795,443,55624,443,allow,9608,1958,7650,21,15,11,10
59949,80,40471,80,allow,730296,15564,714732,723,57,218,505
51508,443,54920,443,allow,98292,24468,73824,179,52,81,98
50474,443,49167,443,allow,17449456,390704,17058752,16816,383,4917,11899
33720,995,0,0,deny,60,60,0,1,0,1,0
50734,37965,0,0,deny,62,62,0,1,0,1,0
52014,20524,7082,20524,allow,70,70,0,1,5,1,0
20624,53,20624,53,allow,229,89,140,2,31,1,1
57325,37965,0,0,deny,62,62,0,1,0,1,0
26900,27017,41768,27017,allow,422,164,258,6,30,3,3
16319,44847,0,0,deny,62,62,0,1,0,1,0
57140,445,0,0,drop,70,70,0,1,0,1,0
33884,53,0,0,allow,86,86,0,1,30,1,0
50994,445,0,0,drop,66,66,0,1,0,1,0
25237,57470,0,0,deny,62,62,0,1,0,1,0
47605,443,46505,443,allow,12572,3471,9101,34,363,14,20
60691,445,0,0,drop,70,70,0,1,0,1,0
49646,53,41795,53,allow,209,102,107,2,30,1,1
14447,25174,0,0,deny,62,62,0,1,0,1,0
56625,53,55820,53,allow,193,102,91,2,30,1,1
50078,443,13152,443,allow,12035,9784,2251,41,92,22,19
50995,443,19177,443,allow,3115,1849,1266,18,16,8,10
25009,35440,0,0,deny,62,62,0,1,0,1,0
55070,445,0,0,drop,66,66,0,1,0,1,0
37607,443,8291,443,allow,499,425,74,4,0,3,1
57669,443,51063,443,allow,12569,8228,4341,28,256,16,12
55467,445,0,0,drop,70,70,0,1,0,1,0
56825,445,0,0,drop,70,70,0,1,0,1,0
57470,16414,19962,16414,allow,726,726,0,12,1200,12,0
52236,445,0,0,drop,66,66,0,1,0,1,0
55570,44847,0,0,deny,62,62,0,1,0,1,0
17046,53,17046,53,allow,220,90,130,2,30,1,1
1912,48817,0,0,deny,62,62,0,1,0,1,0
60756,445,0,0,drop,70,70,0,1,0,1,0
55247,443,30780,443,allow,9656,3460,6196,22,46,12,10
46414,80,41611,80,allow,1155,781,374,10,15,6,4
12242,51221,0,0,deny,62,62,0,1,0,1,0
15180,26467,0,0,deny,62,62,0,1,0,1,0
65048,53,7806,53,allow,194,102,92,2,30,1,1
64080,11801,41031,11801,allow,66,66,0,1,5,1,0
37002,443,19218,443,allow,6646,2747,3899,20,134,10,10
65499,53,38166,53,allow,166,86,80,2,29,1,1
50367,37965,0,0,deny,66,66,0,1,0,1,0
56980,53,33367,53,allow,267,87,180,4,38,2,2
45435,443,1325,443,allow,8034,400,7634,14,193,2,12
53023,445,0,0,drop,70,70,0,1,0,1,0
39277,443,14513,443,allow,6891,1421,5470,20,127,12,8
51863,445,0,0,drop,70,70,0,1,0,1,0
5912,22114,0,0,deny,62,62,0,1,0,1,0
60514,39004,0,0,deny,62,62,0,1,0,1,0
46286,443,2203,443,allow,1053,566,487,10,41,6,4
56292,53,41121,53,allow,194,99,95,2,30,1,1
19125,80,19125,80,allow,12650,889,11761,20,16,9,11
55788,53,26476,53,allow,231,110,121,2,30,1,1
50455,445,0,0,drop,70,70,0,1,0,1,0
55643,53,39402,53,allow,182,93,89,2,0,1,1
7364,50584,0,0,deny,66,66,0,1,0,1,0
64825,53,49543,53,allow,184,94,90,2,31,1,1
56225,53,55911,53,allow,183,94,89,2,31,1,1
53895,443,14973,443,allow,390740,13639,377101,441,132,152,289
50964,445,0,0,drop,70,70,0,1,0,1,0
39040,443,45031,443,allow,25034,7042,17992,58,21,29,29
51969,37558,33450,37558,allow,70,70,0,1,4,1,0
50466,80,50466,80,allow,78335,7114,71221,114,22,60,54
55012,64147,0,0,deny,62,62,0,1,0,1,0
52323,445,0,0,drop,70,70,0,1,0,1,0
3980,63710,0,0,deny,66,66,0,1,0,1,0
49223,2710,26016,2710,allow,3492,3432,60,12,36,11,1
58086,445,0,0,drop,70,70,0,1,0,1,0
56518,53,3673,53,allow,177,94,83,2,31,1,1
9144,80,51086,80,allow,378,192,186,7,30,4,3
8999,55783,0,0,deny,146,146,0,1,0,1,0
57071,53,59373,53,allow,166,86,80,2,30,1,1
65189,27015,1984,27015,allow,260,78,182,2,30,1,1
55730,445,0,0,drop,66,66,0,1,0,1,0
52170,443,36243,443,allow,7228,1589,5639,22,362,11,11
60531,80,48244,80,allow,2122,1559,563,13,16,7,6
52049,52557,35035,52557,allow,70,70,0,2,8,2,0
16387,56995,0,0,deny,60,60,0,1,0,1,0
53976,443,52741,443,allow,1591,1004,587,15,125,8,7
24041,55783,0,0,deny,62,62,0,1,0,1,0
52176,443,52176,443,allow,126525,6370,120155,147,22,56,91
56314,53,22045,53,allow,183,94,89,2,30,1,1
52190,443,16680,443,allow,7942,870,7072,22,15,10,12
44208,26467,0,0,deny,62,62,0,1,0,1,0
56390,445,0,0,drop,70,70,0,1,0,1,0
56803,53,10846,53,allow,195,102,93,2,30,1,1
53505,445,0,0,drop,70,70,0,1,0,1,0
63953,445,0,0,drop,70,70,0,1,0,1,0
36679,41864,0,0,deny,148,148,0,1,0,1,0
50615,53,31516,53,allow,785,110,675,2,30,1,1
39325,443,37130,443,allow,1396,735,661,14,80,8,6
56869,445,0,0,drop,70,70,0,1,0,1,0
52186,57609,42161,57609,allow,66,66,0,1,5,1,0
57519,445,0,0,drop,70,70,0,1,0,1,0
55306,53,39881,53,allow,177,94,83,2,30,1,1
52930,443,54761,443,allow,21194,5779,15415,118,115,47,71
53854,445,0,0,drop,70,70,0,1,0,1,0
57299,445,0,0,drop,70,70,0,1,0,1,0
56646,53,30377,53,allow,177,94,83,2,30,1,1
58455,445,0,0,drop,66,66,0,1,0,1,0
42625,443,18977,443,allow,218298,5904,212394,220,120,63,157
12986,64147,0,0,deny,62,62,0,1,0,1,0
6872,23,0,0,deny,60,60,0,1,0,1,0
57181,53,16955,53,allow,753,96,657,2,31,1,1
56605,443,61768,443,allow,7863,1874,5989,20,15,11,9
56327,53,21642,53,allow,178,94,84,2,29,1,1
56569,53,65375,53,allow,91,91,0,1,31,1,0
52043,43578,45799,43578,allow,316,136,180,6,6,3,3
49546,53,2512,53,allow,357,106,251,4,36,2,2
45941,23386,0,0,deny,60,60,0,1,0,1,0
54666,36237,0,0,deny,66,66,0,1,0,1,0
52690,445,0,0,drop,66,66,0,1,0,1,0
53439,445,0,0,drop,66,66,0,1,0,1,0
64438,53,4120,53,allow,184,94,90,2,30,1,1
44443,80,37663,80,allow,1114,534,580,12,16,7,5
54074,445,0,0,drop,66,66,0,1,0,1,0
56801,21916,14491,21916,allow,316,136,180,6,7,3,3
53894,2944,38557,2944,allow,70,70,0,1,5,1,0
32299,40015,23096,40015,allow,188,70,118,2,31,1,1
52712,80,52712,80,allow,2012,1423,589,12,48,6,6
60486,445,0,0,drop,66,66,0,1,0,1,0
50425,445,0,0,drop,66,66,0,1,0,1,0
53278,443,20618,443,allow,12634,1635,10999,26,322,11,15
65273,53,64303,53,allow,226,102,124,2,30,1,1
65477,53,60369,53,allow,182,93,89,2,31,1,1
21526,53,21526,53,allow,230,90,140,2,30,1,1
62747,445,0,0,drop,66,66,0,1,0,1,0
62440,445,0,0,drop,66,66,0,1,0,1,0
63803,41439,24865,41439,allow,66,66,0,1,5,1,0
56230,5228,8322,5228,allow,2564,1546,1018,18,3600,9,9
53442,443,36564,443,allow,28728581,857403,27871178,29322,132,8944,20378
51403,445,0,0,drop,66,66,0,1,0,1,0
52556,443,21958,443,allow,5696,2392,3304,23,135,10,13
62245,445,0,0,drop,66,66,0,1,0,1,0
49207,58751,6797,58751,allow,70,70,0,2,8,2,0
50739,443,62875,443,allow,6335,1376,4959,19,165,9,10
57548,445,0,0,drop,70,70,0,1,0,1,0
12226,37965,0,0,deny,62,62,0,1,0,1,0
52817,445,0,0,drop,70,70,0,1,0,1,0
52982,25174,0,0,deny,146,146,0,1,0,1,0
52699,25174,0,0,deny,62,62,0,1,0,1,0
52097,80,35130,80,allow,1621,896,725,11,19,7,4
13968,29376,0,0,reset-both,62,62,0,1,0,1,0
58424,443,34481,443,allow,6020,2493,3527,29,80,14,15
55545,53,22001,53,allow,177,94,83,2,30,1,1
60327,80,34206,80,allow,2125,1159,966,13,61,7,6
64180,53,33989,53,allow,296,91,205,4,55,2,2
55002,53,11641,53,allow,196,102,94,2,31,1,1
65207,443,12429,443,allow,8188,2769,5419,22,611,12,10
58638,5900,0,0,deny,62,62,0,1,0,1,0
58659,53,58909,53,allow,167,78,89,2,30,1,1
57633,445,0,0,drop,70,70,0,1,0,1,0
52846,80,43511,80,allow,3626,1778,1848,36,143,19,17
53641,16605,38186,16605,allow,70,70,0,2,7,2,0
53004,445,0,0,drop,70,70,0,1,0,1,0
59597,37965,0,0,deny,66,66,0,1,0,1,0
65385,445,0,0,drop,70,70,0,1,0,1,0
42298,40023,18178,40023,allow,1531,729,802,10,31,5,5
49622,445,0,0,drop,70,70,0,1,0,1,0
64195,53,9148,53,allow,270,110,160,2,29,1,1
14696,42707,0,0,deny,62,62,0,1,0,1,0
51705,22114,0,0,deny,66,66,0,1,0,1,0
60909,443,5719,443,allow,5150,3651,1499,34,46,18,16
50391,443,17235,443,allow,5968,985,4983,17,29,8,9
55240,443,28397,443,allow,6902,1936,4966,22,45,11,11
57654,35440,0,0,deny,66,66,0,1,0,1,0
64903,51050,0,0,deny,66,66,0,1,0,1,0
56522,443,44815,443,allow,43823,7381,36442,84,38,42,42
64833,53,14951,53,allow,166,85,81,2,31,1,1
60764,445,0,0,drop,66,66,0,1,0,1,0
42640,11119,0,0,deny,148,148,0,1,0,1,0
50474,445,0,0,drop,66,66,0,1,0,1,0
30016,36237,0,0,deny,62,62,0,1,0,1,0
55942,53,15569,53,allow,197,102,95,2,30,1,1
54922,445,0,0,drop,70,70,0,1,0,1,0
443,20995,0,0,deny,83,83,0,1,0,1,0
50091,53,37575,53,allow,183,94,89,2,30,1,1
51940,80,62105,80,allow,278312,9722,268590,323,61,135,188
63995,15396,7460,15396,allow,66,66,0,2,7,2,0
64237,53,49326,53,allow,227,110,117,2,31,1,1
18173,25174,0,0,deny,66,66,0,1,0,1,0
49894,1433,0,0,deny,60,60,0,1,0,1,0
55809,443,47324,443,allow,62,62,0,1,4,1,0
50684,80,37949,80,allow,66772,4924,61848,110,19,60,50
54376,445,0,0,drop,70,70,0,1,0,1,0
64709,53,54232,53,allow,338,110,228,2,29,1,1
56655,53,57319,53,allow,209,110,99,2,29,1,1
56115,53,39416,53,allow,278,96,182,4,53,2,2
35422,443,43455,443,allow,154,94,60,2,5,1,1
53513,56205,0,0,deny,62,62,0,1,0,1,0
26793,3389,26793,3389,reset-both,293,223,70,4,1,3,1
49845,443,22803,443,allow,10396,4585,5811,38,54,21,17
64930,53,11667,53,allow,317,96,221,4,32,2,2
50014,80,33183,80,allow,810,670,140,6,34,4,2
56310,445,0,0,drop,70,70,0,1,0,1,0
54373,26467,0,0,deny,62,62,0,1,0,1,0
53625,64147,0,0,deny,66,66,0,1,0,1,0
443,14591,0,0,deny,85,85,0,1,0,1,0
27402,37628,0,0,deny,62,62,0,1,0,1,0
49227,53,40527,53,allow,340,89,251,4,44,2,2
49811,53,32866,53,allow,308,110,198,2,29,1,1
55181,53,51083,53,allow,815,95,720,2,31,1,1
58355,445,0,0,drop,66,66,0,1,0,1,0
59858,443,47016,443,allow,2069,1044,1025,22,44,9,13
53035,445,0,0,drop,66,66,0,1,0,1,0
51870,40490,51955,40490,allow,70,70,0,1,5,1,0
52898,445,0,0,drop,70,70,0,1,0,1,0
50,64147,0,0,deny,66,66,0,1,0,1,0
57473,445,0,0,drop,70,70,0,1,0,1,0
62348,50584,0,0,deny,66,66,0,1,0,1,0
27005,27015,19285,27015,allow,892,126,766,2,30,1,1
32137,44512,0,0,deny,62,62,0,1,0,1,0
51735,50794,43847,50794,allow,70,70,0,2,8,2,0
64863,445,0,0,drop,66,66,0,1,0,1,0
56505,443,54192,443,allow,78426,3219,75207,98,96,37,61
52853,80,51325,80,allow,7502,3168,4334,41,140,22,19
39648,443,15824,443,allow,5663,4227,1436,27,47,16,11
50485,80,52438,80,allow,318,192,126,6,26,4,2
47424,25174,0,0,deny,62,62,0,1,0,1,0
64744,445,0,0,drop,66,66,0,1,0,1,0
37965,17336,18530,17336,allow,481,150,331,2,1199,1,1
48527,7302,0,0,deny,146,146,0,1,0,1,0
49873,443,58284,443,allow,14476,2843,11633,45,55,22,23
57338,80,37762,80,allow,1420,715,705,12,16,7,5
54976,10387,0,0,deny,159,159,0,1,0,1,0
56731,443,49373,443,allow,7907,1918,5989,20,15,11,9
51221,51413,17316,51413,allow,460,150,310,2,1200,1,1
49611,53,14406,53,allow,184,94,90,2,30,1,1
45941,23386,0,0,deny,60,60,0,1,0,1,0
55077,53,19465,53,allow,277,90,187,4,32,2,2
56688,443,28124,443,allow,19185,2445,16740,40,25,20,20
16387,49252,0,0,deny,60,60,0,1,0,1,0
61591,22114,0,0,deny,146,146,0,1,0,1,0
51978,57496,25018,57496,allow,70,70,0,2,8,2,0
56997,53,24700,53,allow,337,107,230,4,34,2,2
56687,443,11163,443,allow,21086,2515,18571,42,25,21,21
49249,443,43033,443,allow,35406,17785,17621,79,141,40,39
57470,24907,9136,24907,allow,1386,1386,0,22,1544,22,0
65287,36829,0,0,deny,146,146,0,1,0,1,0
62507,445,0,0,drop,70,70,0,1,0,1,0
45060,37965,0,0,deny,62,62,0,1,0,1,0
58731,443,5711,443,allow,2383,1460,923,18,201,10,8
64420,53,48861,53,allow,294,95,199,4,42,2,2
55596,53,61686,53,allow,170,87,83,2,30,1,1
64065,445,0,0,drop,70,70,0,1,0,1,0
50084,26672,0,0,deny,62,62,0,1,0,1,0
57393,445,0,0,drop,70,70,0,1,0,1,0
55250,53,30475,53,allow,416,102,314,2,30,1,1
19790,35440,0,0,deny,146,146,0,1,0,1,0
57925,445,0,0,drop,70,70,0,1,0,1,0
53950,32057,54034,32057,allow,70,70,0,1,4,1,0
55159,53,25315,53,allow,199,102,97,2,29,1,1
50238,445,0,0,drop,70,70,0,1,0,1,0
50286,443,3120,443,allow,8773,1538,7235,25,15,14,11
52829,443,52829,443,allow,4613,1706,2907,19,30,11,8
53594,27639,27513,27639,allow,552,306,246,9,15,5,4
50135,50584,0,0,deny,146,146,0,1,0,1,0
62197,443,16977,443,allow,3937,1210,2727,18,134,8,10
52486,443,26318,443,allow,57366,41661,15705,111,440,66,45
55229,53,33453,53,allow,173,94,79,2,30,1,1
9327,57470,0,0,deny,62,62,0,1,0,1,0
65260,53,63253,53,allow,184,94,90,2,30,1,1
58638,5900,0,0,deny,62,62,0,1,0,1,0
443,50238,0,0,deny,331,331,0,1,0,1,0
49654,80,62671,80,allow,1506,914,592,9,16,5,4
56009,53,4440,53,allow,232,94,138,2,30,1,1
11404,64147,0,0,deny,62,62,0,1,0,1,0
55579,58420,44629,58420,allow,70,70,0,1,5,1,0
59523,37965,0,0,deny,62,62,0,1,0,1,0
53023,445,0,0,drop,66,66,0,1,0,1,0
64429,53,41917,53,allow,217,94,123,2,30,1,1
59763,25604,0,0,deny,66,66,0,1,0,1,0
443,42788,0,0,deny,74,74,0,1,0,1,0
58174,445,0,0,drop,66,66,0,1,0,1,0
57188,53,28885,53,allow,193,102,91,2,29,1,1
6666,5984,0,0,deny,60,60,0,1,0,1,0
50035,53,20021,53,allow,308,102,206,2,29,1,1
3504,23,0,0,deny,60,60,0,1,0,1,0
59647,47993,0,0,deny,66,66,0,1,0,1,0
59748,443,39145,443,allow,8789,1592,7197,25,75,13,12
61223,37965,0,0,deny,66,66,0,1,0,1,0
51919,10298,22024,10298,allow,70,70,0,2,8,2,0
27005,27015,63716,27015,allow,889,126,763,2,30,1,1
51015,64147,0,0,deny,62,62,0,1,0,1,0
61960,445,0,0,drop,66,66,0,1,0,1,0
2572,17546,0,0,deny,62,62,0,1,0,1,0
51270,48061,22070,48061,allow,70,70,0,1,5,1,0
63580,445,0,0,drop,70,70,0,1,0,1,0
50438,445,0,0,drop,70,70,0,1,0,1,0
6572,23,0,0,deny,60,60,0,1,0,1,0
49284,53,21270,53,allow,177,94,83,2,30,1,1
56388,53,28849,53,allow,193,102,91,2,29,1,1
49939,80,14388,80,allow,1130,613,517,11,15,6,5
0,0,0,0,deny,60,60,0,1,0,1,0
48676,53393,0,0,deny,60,60,0,1,0,1,0
56864,445,0,0,drop,70,70,0,1,0,1,0
16387,64660,0,0,deny,60,60,0,1,0,1,0
55246,31573,0,0,deny,66,66,0,1,0,1,0
46883,443,30067,443,allow,40443,5300,35143,88,134,38,50
49997,53,41448,53,allow,284,94,190,2,29,1,1
45964,9666,0,0,deny,60,60,0,1,0,1,0
63938,26204,59342,26204,allow,70,70,0,1,4,1,0
54383,445,0,0,drop,70,70,0,1,0,1,0
5588,5588,0,0,allow,3562,1936,1626,48,193,24,24
33525,53,23050,53,allow,168,78,90,2,31,1,1
137,137,40295,137,allow,114,114,0,2,32,2,0
57251,37965,0,0,deny,62,62,0,1,0,1,0
60047,443,20320,443,allow,229060,38515,190545,283,135,113,170
64744,53,61506,53,allow,770,102,668,2,29,1,1
43578,15503,0,0,deny,74,74,0,1,0,1,0
58035,80,7543,80,allow,4168,2906,1262,11,15,6,5
57252,53,46137,53,allow,182,93,89,2,31,1,1
57467,445,0,0,drop,70,70,0,1,0,1,0
57513,445,0,0,drop,66,66,0,1,0,1,0
28176,35440,0,0,deny,146,146,0,1,0,1,0
57386,53,23091,53,allow,193,102,91,2,29,1,1
56030,445,0,0,drop,70,70,0,1,0,1,0
56222,53,43289,53,allow,168,78,90,2,30,1,1
28275,80,28275,80,allow,303421,10894,292527,324,26,116,208
51570,445,0,0,drop,66,66,0,1,0,1,0
49756,80,38066,80,allow,20926,3231,17695,37,51,17,20
62787,51221,0,0,deny,66,66,0,1,0,1,0
53625,64147,0,0,deny,62,62,0,1,0,1,0
44290,53,27070,53,allow,240,76,164,2,31,1,1
37479,53,37479,53,allow,214,82,132,2,30,1,1
55103,53,23177,53,allow,392,92,300,4,55,2,2
6666,16010,0,0,deny,60,60,0,1,0,1,0
57809,53,57809,53,allow,213,79,134,2,33,1,1
49168,57470,0,0,deny,66,66,0,1,0,1,0
62926,445,0,0,drop,66,66,0,1,0,1,0
50523,53,7142,53,allow,168,86,82,2,31,1,1
63257,445,0,0,drop,66,66,0,1,0,1,0
3978,35440,0,0,deny,62,62,0,1,0,1,0
51975,80,44833,80,allow,426,240,186,8,25,5,3
9520,32480,0,0,deny,62,62,0,1,0,1,0
59931,80,27664,80,allow,1272,786,486,8,31,5,3
60133,1,0,0,deny,66,66,0,1,0,1,0
56696,443,27730,443,allow,3140,1782,1358,18,17,10,8
61787,445,0,0,drop,70,70,0,1,0,1,0
53306,443,56801,443,allow,11114,3066,8048,41,119,22,19
55046,53,11757,53,allow,198,102,96,2,29,1,1
33990,443,59264,443,allow,11404,1948,9456,30,81,15,15
2252,443,2252,443,allow,11489,1827,9662,25,23,15,10
51972,13604,16172,13604,allow,258,70,188,4,8,2,2
43584,24748,0,0,deny,156,156,0,1,0,1,0
50200,44847,0,0,deny,74,74,0,1,0,1,0
49738,443,60730,443,allow,5572,1446,4126,17,129,10,7
30960,45713,7044,45713,allow,330,330,0,6,3610,6,0
55063,80,20796,80,allow,2776,1333,1443,12,37,7,5
58782,445,0,0,drop,70,70,0,1,0,1,0
56145,445,0,0,drop,70,70,0,1,0,1,0
61205,445,0,0,drop,66,66,0,1,0,1,0
58193,23,0,0,deny,60,60,0,1,0,1,0
54869,35440,0,0,deny,146,146,0,1,0,1,0
62133,445,0,0,drop,70,70,0,1,0,1,0
56578,53,41828,53,allow,219,86,133,2,31,1,1
51818,37965,0,0,deny,66,66,0,1,0,1,0
56664,80,50394,80,allow,234,234,0,4,11,4,0
50584,42504,10356,42504,allow,161,161,0,2,1199,2,0
51570,443,51570,443,allow,11204,3773,7431,29,132,12,17
56635,80,4559,80,allow,234,234,0,4,12,4,0
50857,26467,0,0,deny,66,66,0,1,0,1,0
54031,443,8430,443,allow,350,210,140,6,25,4,2
40893,123,36091,123,allow,184,94,90,2,31,1,1
51810,33776,19037,33776,allow,70,70,0,2,8,2,0
57470,52339,38751,52339,allow,594,594,0,10,1199,10,0
56581,443,17747,443,allow,4884,1015,3869,17,25,9,8
57470,51413,18747,51413,allow,604,275,329,4,1199,2,2
11136,19910,0,0,deny,62,62,0,1,0,1,0
64417,53,10923,53,allow,231,102,129,2,30,1,1
63554,44847,0,0,deny,66,66,0,1,0,1,0
28832,36237,0,0,deny,62,62,0,1,0,1,0
64752,53,43912,53,allow,210,94,116,2,30,1,1
32704,25174,0,0,deny,62,62,0,1,0,1,0
50986,443,50781,443,allow,67798,17043,50755,202,146,110,92
45964,2225,0,0,deny,60,60,0,1,0,1,0
55946,53,3113,53,allow,762,98,664,2,31,1,1
42745,50011,0,0,deny,62,62,0,1,0,1,0
64915,53,25917,53,allow,98,98,0,1,31,1,0
57470,6881,6226,6881,allow,453,251,202,4,1200,2,2
63067,443,13404,443,allow,2570995,60656,2510339,2538,34,844,1694
60786,25174,0,0,deny,66,66,0,1,0,1,0
58935,445,0,0,drop,66,66,0,1,0,1,0
64002,2880,14112,2880,allow,66,66,0,1,5,1,0
50248,443,36330,443,allow,8882,3013,5869,29,137,14,15
48233,443,29829,443,allow,9759,3896,5863,28,230,15,13
5938,19141,0,0,allow,60,60,0,1,91,1,0
6881,55981,51460,55981,allow,228,118,110,2,1200,1,1
58129,80,58129,80,allow,23462,3780,19682,49,47,24,25
57153,445,0,0,drop,70,70,0,1,0,1,0
17750,6992,50842,6992,allow,150,150,0,1,1200,1,0
55203,443,52613,443,allow,12947,4309,8638,29,152,15,14
33886,39127,0,0,deny,162,162,0,1,0,1,0
58688,53,58688,53,allow,235,92,143,2,30,1,1
51797,80,10283,80,allow,9897,4338,5559,27,58,16,11
56754,443,15698,443,allow,8006,1986,6020,20,16,11,9
49331,53,5900,53,allow,182,94,88,2,31,1,1
52373,445,0,0,drop,70,70,0,1,0,1,0
49266,53,6643,53,allow,199,102,97,2,29,1,1
64222,445,0,0,drop,70,70,0,1,0,1,0
55523,445,0,0,drop,70,70,0,1,0,1,0
45409,80,10508,80,allow,1155,781,374,10,15,6,4
52060,29868,29510,29868,allow,70,70,0,1,5,1,0
15450,53,15450,53,allow,216,82,134,2,33,1,1
56914,53,35890,53,allow,100,100,0,2,35,2,0
50975,445,0,0,drop,66,66,0,1,0,1,0
3377,50584,0,0,deny,62,62,0,1,0,1,0
58461,445,0,0,drop,70,70,0,1,0,1,0
43136,443,64659,443,allow,9329,2900,6429,27,135,15,12
59326,57470,0,0,deny,74,74,0,1,0,1,0
50610,80,53401,80,allow,3726,1504,2222,13,21,7,6
61085,37965,0,0,deny,62,62,0,1,0,1,0
58638,5900,0,0,deny,62,62,0,1,0,1,0
56660,80,51147,80,allow,234,234,0,4,12,4,0
55223,53,31444,53,allow,168,86,82,2,30,1,1
60329,443,10695,443,allow,2859,1499,1360,20,315,10,10
44847,6881,3314,6881,allow,501,150,351,2,1200,1,1
48335,25174,0,0,deny,146,146,0,1,0,1,0
63004,445,0,0,drop,70,70,0,1,0,1,0
58396,22114,0,0,deny,66,66,0,1,0,1,0
59626,22114,0,0,deny,66,66,0,1,0,1,0
51805,15298,11456,15298,allow,70,70,0,2,8,2,0
58801,445,0,0,drop,70,70,0,1,0,1,0
57283,53,20762,53,allow,185,102,83,2,29,1,1
59273,445,0,0,drop,70,70,0,1,0,1,0
50895,443,61149,443,allow,130,70,60,3,5,2,1
56646,48817,0,0,deny,62,62,0,1,0,1,0
39473,443,25041,443,allow,11226,3340,7886,28,16,16,12
64609,53,8196,53,allow,404,95,309,4,43,2,2
60883,64147,0,0,deny,74,74,0,1,0,1,0
64877,53,58345,53,allow,182,93,89,2,30,1,1
8413,8413,11663,8413,allow,66,66,0,1,30,1,0
50482,443,33515,443,allow,6904692,144860,6759832,6483,140,1783,4700
56860,49991,48987,49991,allow,70,70,0,1,5,1,0
42128,54532,0,0,deny,60,60,0,1,0,1,0
60823,25174,0,0,deny,66,66,0,1,0,1,0
0,0,0,0,allow,134,64,70,2,0,1,1
55072,53,52370,53,allow,168,86,82,2,30,1,1
53122,80,53122,80,allow,19237,829,18408,29,15,13,16
57655,445,0,0,drop,66,66,0,1,0,1,0
4760,44847,0,0,deny,62,62,0,1,0,1,0
27005,33035,34801,33035,allow,864,126,738,2,31,1,1
51236,445,0,0,drop,66,66,0,1,0,1,0
55104,53,12993,53,allow,733,85,648,2,31,1,1
15755,53,15755,53,allow,241,95,146,2,31,1,1
45899,53,19119,53,allow,168,78,90,2,30,1,1
55115,53,46461,53,allow,313,110,203,4,35,2,2
49573,53,10183,53,allow,770,102,668,2,30,1,1
55655,53,48004,53,allow,304,110,194,4,35,2,2
28385,50584,0,0,deny,62,62,0,1,0,1,0
45964,55559,0,0,deny,60,60,0,1,0,1,0
60298,443,32921,443,allow,9565,3317,6248,25,144,14,11
43332,81,0,0,deny,60,60,0,1,0,1,0
56876,11392,0,0,deny,66,66,0,1,0,1,0
53695,443,14454,443,allow,4045,439,3606,11,15,5,6
56332,53,1947,53,allow,209,110,99,2,31,1,1
63410,445,0,0,drop,70,70,0,1,0,1,0
51558,37965,0,0,deny,72,72,0,1,0,1,0
443,10010,0,0,deny,60,60,0,1,0,1,0
54552,64147,0,0,deny,62,62,0,1,0,1,0
51777,445,0,0,drop,70,70,0,1,0,1,0
60204,2767,0,0,deny,62,62,0,1,0,1,0
45057,443,6642,443,allow,7536,1915,5621,31,20,17,14
50866,445,0,0,drop,70,70,0,1,0,1,0
61676,445,0,0,drop,66,66,0,1,0,1,0
47141,50584,0,0,deny,62,62,0,1,0,1,0
55953,445,0,0,drop,70,70,0,1,0,1,0
53028,80,12775,80,allow,3470,1464,2006,21,190,10,11
56955,53,15071,53,allow,183,94,89,2,30,1,1
19617,39004,0,0,deny,62,62,0,1,0,1,0
16524,22114,0,0,deny,62,62,0,1,0,1,0
54817,47993,0,0,deny,66,66,0,1,0,1,0
52064,22114,0,0,deny,66,66,0,1,0,1,0
50532,445,0,0,drop,66,66,0,1,0,1,0
54953,443,55555,443,allow,9996,2043,7953,42,271,20,22
47637,443,16997,443,allow,280,140,140,5,151,3,2
50580,80,50580,80,allow,18727,8262,10465,44,18,23,21
23873,30188,0,0,deny,62,62,0,1,0,1,0
56858,445,0,0,drop,70,70,0,1,0,1,0
64582,445,0,0,drop,70,70,0,1,0,1,0
53189,80,57818,80,allow,1873,713,1160,10,15,5,5
65106,53,60145,53,allow,438,180,258,6,30,3,3
54828,445,0,0,drop,70,70,0,1,0,1,0
62065,443,18237,443,allow,21959,8954,13005,65,63,33,32
55179,53,42268,53,allow,172,88,84,2,31,1,1
7934,443,7934,443,allow,6593,3073,3520,27,82,14,13
26900,27017,57110,27017,allow,422,164,258,6,30,3,3
64585,53,51194,53,allow,210,110,100,2,30,1,1
56422,53,35593,53,allow,716,95,621,2,30,1,1
47063,15503,0,0,deny,62,62,0,1,0,1,0
58695,445,0,0,drop,70,70,0,1,0,1,0
60106,443,61992,443,allow,7243,4797,2446,42,136,23,19
27005,27016,32182,27016,allow,1648,126,1522,4,30,2,2
46190,80,10092,80,allow,5443,2529,2914,14,515,8,6
49890,443,37248,443,allow,9545,2433,7112,24,142,10,14
25061,53,25061,53,allow,214,82,132,2,32,1,1
64290,445,0,0,drop,66,66,0,1,0,1,0
51442,443,50943,443,allow,15321,3760,11561,56,170,23,33
55312,64147,0,0,deny,66,66,0,1,0,1,0
49825,53,24008,53,allow,814,110,704,2,29,1,1
52938,64097,0,0,deny,66,66,0,1,0,1,0
50755,80,64278,80,allow,1783,1346,437,7,15,5,2
47531,8080,0,0,allow,184,78,106,3,10,2,1
49655,53,33441,53,allow,209,110,99,2,30,1,1
3478,61463,0,0,deny,1248,1248,0,1,0,1,0
55791,445,0,0,drop,70,70,0,1,0,1,0
60294,30188,0,0,deny,66,66,0,1,0,1,0
56966,35440,0,0,deny,66,66,0,1,0,1,0
54001,445,0,0,drop,70,70,0,1,0,1,0
2346,25174,0,0,deny,66,66,0,1,0,1,0
62796,37807,0,0,deny,66,66,0,1,0,1,0
55759,53,57416,53,allow,170,87,83,2,30,1,1
58726,443,45284,443,allow,39202,21598,17604,72,20,39,33
65370,53,10592,53,allow,193,102,91,2,30,1,1
55364,53,1221,53,allow,168,86,82,2,31,1,1
50693,80,37544,80,allow,56849,29352,27497,239,175,120,119
11136,57587,0,0,deny,62,62,0,1,0,1,0
51610,445,0,0,drop,70,70,0,1,0,1,0
49339,80,8376,80,allow,1467,361,1106,10,15,5,5
54867,445,0,0,drop,70,70,0,1,0,1,0
52090,64823,30736,64823,allow,634,568,66,8,29,7,1
27005,27091,19292,27091,allow,883,126,757,2,31,1,1
55431,53,1200,53,allow,196,102,94,2,31,1,1
45562,5228,50425,5228,allow,29298,3627,25671,67,5346,25,42
49634,53,7065,53,allow,257,102,155,2,30,1,1
39718,443,30883,443,allow,10457,3150,7307,25,217,13,12
50078,53,19314,53,allow,185,102,83,2,29,1,1
42600,443,64399,443,allow,3137,1986,1151,15,15,8,7
65194,53,9315,53,allow,265,91,174,4,36,2,2
59750,445,0,0,drop,70,70,0,1,0,1,0
38631,443,46548,443,allow,6231,1151,5080,23,109,13,10
45964,55559,0,0,deny,60,60,0,1,0,1,0
50328,22114,0,0,deny,66,66,0,1,0,1,0
52869,445,0,0,drop,70,70,0,1,0,1,0
56704,53,2427,53,allow,318,94,224,2,30,1,1
64983,53,54706,53,allow,181,94,87,2,30,1,1
10348,25604,0,0,deny,66,66,0,1,0,1,0
56440,80,38855,80,allow,17008,1379,15629,22,25,7,15
55180,53,29558,53,allow,209,110,99,2,30,1,1
56960,80,32758,80,allow,6363,3790,2573,16,30,10,6
42986,25174,0,0,deny,66,66,0,1,0,1,0
38871,80,51643,80,allow,2057,1263,794,10,15,6,4
49576,445,0,0,drop,70,70,0,1,0,1,0
56941,53,56569,53,allow,193,102,91,2,30,1,1
53652,443,55573,443,allow,11041,3217,7824,26,24,15,11
59883,445,0,0,drop,70,70,0,1,0,1,0
49677,25174,0,0,deny,66,66,0,1,0,1,0
56765,443,20044,443,allow,12038195,322404,11715791,12026,153,3435,8591
13514,53,13514,53,allow,244,98,146,2,32,1,1
53621,445,0,0,drop,66,66,0,1,0,1,0
49369,53,12483,53,allow,168,86,82,2,31,1,1
3478,61463,0,0,deny,1188,1188,0,1,0,1,0
56810,53,20653,53,allow,438,180,258,6,30,3,3
50313,53,50313,53,allow,202,91,111,2,30,1,1
49935,445,0,0,drop,70,70,0,1,0,1,0
56418,53,6346,53,allow,183,94,89,2,29,1,1
63756,445,0,0,drop,66,66,0,1,0,1,0
54166,25174,0,0,deny,66,66,0,1,0,1,0
50670,445,0,0,drop,66,66,0,1,0,1,0
56968,53,34326,53,allow,762,97,665,2,30,1,1
53522,24116,50290,24116,allow,70,70,0,1,4,1,0
59001,80,22174,80,allow,1266,383,883,16,393,4,12
49221,36069,51500,36069,allow,1941,1009,932,10,16,6,4
56888,443,59232,443,allow,10384,2236,8148,28,186,15,13
55070,53,15674,53,allow,195,94,101,2,30,1,1
61389,80,44525,80,allow,17407,1529,15878,30,255,16,14
26805,443,46763,443,allow,7697,2940,4757,25,18,13,12
7744,32480,0,0,deny,62,62,0,1,0,1,0
9687,57470,0,0,deny,78,78,0,1,0,1,0
61711,445,0,0,drop,70,70,0,1,0,1,0
9775,30188,0,0,deny,62,62,0,1,0,1,0
6929,35440,0,0,deny,66,66,0,1,0,1,0
57307,53,5441,53,allow,177,94,83,2,30,1,1
57054,445,0,0,drop,66,66,0,1,0,1,0
54669,445,0,0,drop,70,70,0,1,0,1,0
49611,53,60181,53,allow,170,87,83,2,31,1,1
55030,80,10323,80,allow,2954,671,2283,12,15,7,5
38557,443,3043,443,allow,70,70,0,1,5,1,0
54918,445,0,0,drop,70,70,0,1,0,1,0
52818,445,0,0,drop,70,70,0,1,0,1,0
64139,445,0,0,drop,70,70,0,1,0,1,0
36727,443,3578,443,allow,27009,7414,19595,46,122,21,25
57240,53,1415,53,allow,180,94,86,2,30,1,1
49290,53,15607,53,allow,760,97,663,2,31,1,1
34134,30188,0,0,deny,62,62,0,1,0,1,0
54788,445,0,0,drop,70,70,0,1,0,1,0
49920,443,45165,443,allow,8888,2265,6623,18,15,9,9
65239,53,65239,53,allow,231,90,141,2,30,1,1
54976,2273,0,0,deny,60,60,0,1,0,1,0
8907,443,50464,443,allow,7594,1457,6137,26,404,10,16
55638,53,61828,53,allow,184,86,98,2,30,1,1
27005,27015,28808,27015,allow,873,126,747,2,30,1,1
43708,53,62627,53,allow,168,78,90,2,30,1,1
54276,39004,0,0,deny,66,66,0,1,0,1,0
11350,3389,11350,3389,allow,3850,1745,2105,19,18,11,8
17750,58572,62694,58572,allow,150,150,0,1,1200,1,0
47904,443,37875,443,allow,2766,1907,859,17,24,10,7
63817,445,0,0,drop,70,70,0,1,0,1,0
56358,443,56358,443,allow,4674,1767,2907,19,29,11,8
56578,25174,0,0,deny,66,66,0,1,0,1,0
61097,445,0,0,drop,70,70,0,1,0,1,0
35666,22114,0,0,deny,62,62,0,1,0,1,0
49677,64147,0,0,deny,62,62,0,1,0,1,0
64093,445,0,0,drop,70,70,0,1,0,1,0
64460,53,62568,53,allow,192,98,94,2,31,1,1
49653,445,0,0,drop,70,70,0,1,0,1,0
51908,443,56072,443,allow,8481,1976,6505,23,25,13,10
56120,53,44279,53,allow,177,94,83,2,30,1,1
64585,80,64585,80,allow,405673,21057,384616,519,26,252,267
56450,53,31149,53,allow,177,94,83,2,30,1,1
56067,53,11884,53,allow,189,102,87,2,31,1,1
63838,80,51652,80,allow,314,192,122,6,15,4,2
36541,443,3197,443,allow,4322,797,3525,14,64,8,6
62678,445,0,0,drop,70,70,0,1,0,1,0
55787,445,0,0,drop,70,70,0,1,0,1,0
51774,16930,9118,16930,allow,70,70,0,1,5,1,0
48676,53395,48676,53395,allow,124,60,64,3,5,2,1
49826,445,0,0,drop,70,70,0,1,0,1,0
61563,37807,0,0,deny,62,62,0,1,0,1,0
63589,445,0,0,drop,70,70,0,1,0,1,0
51490,445,0,0,drop,66,66,0,1,0,1,0
11136,17500,0,0,deny,62,62,0,1,0,1,0
45313,64147,0,0,deny,62,62,0,1,0,1,0
57204,53,58516,53,allow,183,94,89,2,30,1,1
43578,15503,0,0,deny,74,74,0,1,0,1,0
65482,53,62841,53,allow,374,91,283,4,33,2,2
50052,65008,0,0,deny,60,60,0,1,0,1,0
53982,24226,50334,24226,allow,70,70,0,2,7,2,0
6666,138,0,0,deny,60,60,0,1,0,1,0
63043,53,52366,53,allow,448,166,282,2,30,1,1
5588,5588,0,0,allow,3498,1872,1626,48,195,24,24
56068,53,2215,53,allow,752,93,659,2,30,1,1
30046,15503,0,0,deny,62,62,0,1,0,1,0
53644,445,0,0,drop,70,70,0,1,0,1,0
60431,445,0,0,drop,70,70,0,1,0,1,0
64538,443,60340,443,allow,4658,1652,3006,10,121,5,5
59872,443,27152,443,allow,6239,800,5439,18,32,8,10
62011,57354,0,0,deny,159,159,0,1,0,1,0
15523,53,15523,53,allow,227,88,139,2,30,1,1
38555,443,24882,443,allow,40928,36006,4922,59,16,34,25
49390,1433,0,0,deny,60,60,0,1,0,1,0
51414,22,0,0,deny,60,60,0,1,0,1,0
55943,53,5113,53,allow,1415,94,1321,4,31,2,2
44116,123,64380,123,allow,184,94,90,2,30,1,1
38260,443,50232,443,allow,7173,1419,5754,32,383,11,21
56569,53,35579,53,allow,199,102,97,2,30,1,1
25448,23,25448,23,allow,66,66,0,1,5,1,0
60508,55998,14688,55998,allow,70,70,0,2,8,2,0
39460,23117,0,0,deny,66,66,0,1,0,1,0
0,0,0,0,allow,320,320,0,5,0,5,0
56332,53,36197,53,allow,193,102,91,2,31,1,1
56884,53,27069,53,allow,177,94,83,2,30,1,1
64041,53,24835,53,allow,200,102,98,2,29,1,1
57196,53,50893,53,allow,182,93,89,2,30,1,1
52782,445,0,0,drop,70,70,0,1,0,1,0
64356,445,0,0,drop,66,66,0,1,0,1,0
46972,443,1778,443,allow,45264,4281,40983,59,120,24,35
57947,443,8723,443,allow,2791,1800,991,26,185,15,11
5588,5588,0,0,allow,3562,1936,1626,48,195,24,24
52042,53,52042,53,allow,81,81,0,1,30,1,0
56679,53,5371,53,allow,216,102,114,2,30,1,1
58638,5900,0,0,deny,62,62,0,1,0,1,0
63988,53,50282,53,allow,559,193,366,6,67,3,3
55762,445,0,0,drop,70,70,0,1,0,1,0
49690,53,62022,53,allow,322,110,212,4,30,2,2
58638,5900,58638,5900,allow,66,66,0,1,4,1,0
50990,23884,0,0,deny,66,66,0,1,0,1,0
64767,51221,0,0,deny,62,62,0,1,0,1,0
62614,445,0,0,drop,66,66,0,1,0,1,0
61022,445,0,0,drop,66,66,0,1,0,1,0
52738,445,0,0,drop,70,70,0,1,0,1,0
55936,53,1988,53,allow,177,94,83,2,29,1,1
60527,35440,0,0,deny,66,66,0,1,0,1,0
56637,443,17039,443,allow,8865,1819,7046,24,30,14,10
54930,443,22759,443,allow,2349,258,2091,10,120,4,6
65307,53,36094,53,allow,811,94,717,2,29,1,1
56272,53,59359,53,allow,167,86,81,2,31,1,1
52847,445,0,0,drop,70,70,0,1,0,1,0
50612,445,0,0,drop,66,66,0,1,0,1,0
52841,445,0,0,drop,70,70,0,1,0,1,0
49485,80,52074,80,allow,1155,781,374,10,15,6,4
64527,53,58780,53,allow,228,102,126,2,30,1,1
51802,443,19479,443,allow,4426,1518,2908,12,120,6,6
49194,443,50497,443,allow,159850,5338,154512,179,200,64,115
53446,445,0,0,drop,70,70,0,1,0,1,0
26531,25174,0,0,deny,62,62,0,1,0,1,0
35217,443,21700,443,allow,2388,1628,760,18,294,11,7
56829,53,52849,53,allow,185,102,83,2,30,1,1
63036,53,45835,53,allow,304,86,218,2,29,1,1
65092,53,51583,53,allow,263,94,169,2,30,1,1
59076,25174,0,0,deny,62,62,0,1,0,1,0
51116,80,26188,80,allow,14873,8100,6773,36,32,19,17
50191,445,0,0,drop,70,70,0,1,0,1,0
49883,53,18157,53,allow,170,87,83,2,30,1,1
63959,53,54075,53,allow,246,102,144,2,31,1,1
52143,37807,0,0,deny,62,62,0,1,0,1,0
49293,80,54518,80,allow,75982,15645,60337,88,158,31,57
62944,445,0,0,drop,66,66,0,1,0,1,0
55088,445,0,0,drop,70,70,0,1,0,1,0
49265,53,25625,53,allow,211,102,109,2,30,1,1
56643,445,0,0,drop,66,66,0,1,0,1,0
53799,443,27170,443,allow,499,425,74,4,0,3,1
5588,5588,0,0,allow,3354,1792,1562,46,192,23,23
49972,53,25100,53,allow,328,110,218,4,57,2,2
49790,53,24988,53,allow,190,97,93,2,30,1,1
51139,80,1947,80,allow,124,64,60,2,15,1,1
55056,445,0,0,drop,70,70,0,1,0,1,0
64438,23,0,0,deny,60,60,0,1,0,1,0
52251,80,52251,80,allow,1838,1319,519,11,48,6,5
56568,53,11893,53,allow,306,306,0,4,47,4,0
58638,5900,0,0,deny,62,62,0,1,0,1,0
42316,443,23676,443,allow,6397,2103,4294,17,26,9,8
57416,53,15222,53,allow,193,102,91,2,30,1,1
55036,443,33915,443,allow,36364,9639,26725,62,53,31,31
49282,53,46163,53,allow,172,88,84,2,31,1,1
50039,53,19771,53,allow,261,110,151,2,30,1,1
35637,443,59473,443,allow,5611,1559,4052,22,648,13,9
50529,80,9935,80,allow,12874,6770,6104,26,28,13,13
50893,80,33062,80,allow,149442,8423,141019,177,140,76,101
51768,445,0,0,drop,66,66,0,1,0,1,0
49418,26169,6616,26169,allow,78,78,0,1,30,1,0
65251,53,19717,53,allow,819,102,717,2,30,1,1
56413,51221,0,0,deny,62,62,0,1,0,1,0
45007,22114,0,0,deny,146,146,0,1,0,1,0
53906,17372,0,0,deny,62,62,0,1,0,1,0
17750,25326,52113,25326,allow,491,150,341,2,1200,1,1
57664,445,0,0,drop,70,70,0,1,0,1,0
57040,53,51890,53,allow,236,94,142,2,30,1,1
60474,53,36065,53,allow,195,94,101,2,30,1,1
25602,64147,0,0,deny,62,62,0,1,0,1,0
53745,18569,18242,18569,allow,70,70,0,1,5,1,0
60353,80,51111,80,allow,1679,1269,410,8,15,5,3
64312,53,41455,53,allow,225,110,115,2,30,1,1
56365,53,6321,53,allow,199,102,97,2,30,1,1
55106,53,52896,53,allow,184,94,90,2,31,1,1
34808,22114,0,0,deny,66,66,0,1,0,1,0
48223,5222,8848,5222,allow,14939,1037,13902,35,579,11,24
57709,445,0,0,drop,70,70,0,1,0,1,0
46518,44847,0,0,deny,62,62,0,1,0,1,0
53018,80,53018,80,allow,182677,4908,177769,213,25,73,140
10532,26672,0,0,deny,60,60,0,1,0,1,0
32768,53,4546,53,allow,86,86,0,1,30,1,0
56813,53,41752,53,allow,753,96,657,2,31,1,1
58638,5900,0,0,deny,62,62,0,1,0,1,0
33941,37807,0,0,deny,62,62,0,1,0,1,0
65024,53,10602,53,allow,196,94,102,2,30,1,1
41279,443,39948,443,allow,8119,1411,6708,20,200,11,9
49636,53,12225,53,allow,180,94,86,2,30,1,1
34273,36829,0,0,deny,146,146,0,1,0,1,0
27005,27055,64070,27055,allow,915,126,789,2,31,1,1
60168,35440,0,0,deny,66,66,0,1,0,1,0
60451,17432,27417,17432,allow,504,318,186,8,17,5,3
45941,23386,0,0,deny,60,60,0,1,0,1,0
23658,18375,0,0,deny,62,62,0,1,0,1,0
64640,53,17711,53,allow,249,94,155,2,30,1,1
13178,37965,0,0,deny,62,62,0,1,0,1,0
59453,445,0,0,drop,70,70,0,1,0,1,0
33502,5529,0,0,deny,143,143,0,1,0,1,0
53599,445,0,0,drop,70,70,0,1,0,1,0
49681,80,35209,80,allow,4584,3642,942,15,15,8,7
11136,19910,0,0,deny,62,62,0,1,0,1,0
63589,44847,0,0,deny,66,66,0,1,0,1,0
12262,22114,0,0,deny,146,146,0,1,0,1,0
47365,10387,0,0,deny,159,159,0,1,0,1,0
65063,53,50094,53,allow,180,94,86,2,30,1,1
51506,443,52823,443,allow,584947,21842,563105,678,36,286,392
49848,445,0,0,drop,70,70,0,1,0,1,0
30129,37965,0,0,deny,72,72,0,1,0,1,0
60554,445,0,0,drop,70,70,0,1,0,1,0
50110,53,49491,53,allow,172,88,84,2,31,1,1
47444,443,24955,443,allow,13920,5009,8911,34,30,18,16
55423,53,51640,53,allow,177,94,83,2,30,1,1
54979,53,11444,53,allow,183,94,89,2,30,1,1
49838,445,0,0,drop,66,66,0,1,0,1,0
55520,443,13062,443,allow,272841,13586,259255,353,176,164,189
64813,7000,64813,7000,allow,1300,676,624,14,15,7,7
51772,80,5918,80,allow,93693,4469,89224,115,24,53,62
55553,37965,0,0,deny,66,66,0,1,0,1,0
18907,53,18907,53,allow,237,91,146,2,32,1,1
58162,445,0,0,drop,70,70,0,1,0,1,0
55471,445,0,0,drop,70,70,0,1,0,1,0
55689,37965,0,0,deny,66,66,0,1,0,1,0
54647,445,0,0,drop,70,70,0,1,0,1,0
60388,445,0,0,drop,66,66,0,1,0,1,0
52633,30188,0,0,deny,66,66,0,1,0,1,0
35203,443,62498,443,allow,232,172,60,3,5,2,1
50388,53,14304,53,allow,177,94,83,2,29,1,1
53710,443,55386,443,allow,499,425,74,4,0,3,1
57287,445,0,0,drop,70,70,0,1,0,1,0
43348,443,43348,443,allow,46356,1595,44761,52,17,15,37
5588,5588,0,0,allow,3354,1792,1562,46,195,23,23
65206,53,13449,53,allow,330,118,212,2,30,1,1
58864,443,26989,443,allow,312852,8845,304007,317,45,99,218
52088,35605,27322,35605,allow,70,70,0,1,5,1,0
57555,35440,0,0,deny,62,62,0,1,0,1,0
58126,443,22478,443,allow,3179,954,2225,10,120,5,5
17344,62413,0,0,deny,66,66,0,1,0,1,0
57929,53,0,0,allow,294,86,208,2,30,1,1
46478,64147,0,0,deny,62,62,0,1,0,1,0
54191,445,0,0,drop,66,66,0,1,0,1,0
50584,21094,39450,21094,allow,1356,300,1056,6,1200,3,3
51628,443,16414,443,allow,8084,2509,5575,36,195,19,17
61135,50265,0,0,deny,62,62,0,1,0,1,0
58899,445,0,0,drop,70,70,0,1,0,1,0
58638,5900,0,0,deny,62,62,0,1,0,1,0
56760,48386,9485,48386,allow,268,70,198,4,19,1,3
64421,53,53236,53,allow,398,88,310,4,54,2,2
51164,443,40341,443,allow,7569,2113,5456,26,361,14,12
55641,61762,32816,61762,allow,70,70,0,2,8,2,0
51012,445,0,0,drop,70,70,0,1,0,1,0
55479,53,40449,53,allow,184,94,90,2,31,1,1
59227,11392,0,0,deny,62,62,0,1,0,1,0
55395,53,45676,53,allow,767,102,665,2,31,1,1
64980,53,1256,53,allow,199,102,97,2,31,1,1
6882,51508,23505,51508,allow,238,118,120,2,1200,1,1
61770,445,0,0,drop,66,66,0,1,0,1,0
56759,445,0,0,drop,66,66,0,1,0,1,0
65069,445,0,0,drop,66,66,0,1,0,1,0
34028,443,47575,443,allow,7804,1583,6221,26,981,13,13
5223,14446,0,0,deny,220,220,0,1,0,1,0
64551,445,0,0,drop,66,66,0,1,0,1,0
50170,445,0,0,drop,70,70,0,1,0,1,0
49260,53,27595,53,allow,177,86,91,2,29,1,1
5223,14446,0,0,deny,119,119,0,1,0,1,0
56938,53,56411,53,allow,199,102,97,2,31,1,1
49415,53,54397,53,allow,188,96,92,2,31,1,1
57403,53,33479,53,allow,764,99,665,2,31,1,1
49616,80,21429,80,allow,314,192,122,6,42,4,2
57578,443,34885,443,allow,13999,3478,10521,33,134,15,18
65292,445,0,0,drop,66,66,0,1,0,1,0
51616,443,56570,443,allow,62241,4598,57643,82,170,35,47
52270,445,0,0,drop,70,70,0,1,0,1,0
57290,53,54259,53,allow,178,94,84,2,30,1,1
49356,53,31614,53,allow,209,102,107,2,30,1,1
14692,443,14692,443,allow,95958,6670,89288,139,80,68,71
63062,11392,0,0,deny,66,66,0,1,0,1,0
50022,53,3051,53,allow,179,94,85,2,30,1,1
60485,13314,55482,13314,allow,70,70,0,1,5,1,0
64911,53,45523,53,allow,209,110,99,2,30,1,1
6036,51505,0,0,deny,66,66,0,1,0,1,0
33556,25174,0,0,deny,146,146,0,1,0,1,0
49883,53,42017,53,allow,177,94,83,2,30,1,1
49915,35440,0,0,deny,62,62,0,1,0,1,0
52791,25174,0,0,deny,66,66,0,1,0,1,0
56234,445,0,0,drop,70,70,0,1,0,1,0
35546,443,6886,443,allow,5198,973,4225,16,17,10,6
48676,53399,0,0,deny,60,60,0,1,0,1,0
56232,445,0,0,drop,70,70,0,1,0,1,0
49378,53,26888,53,allow,210,94,116,2,30,1,1
57470,51413,33371,51413,allow,460,150,310,2,1199,1,1
11816,50584,0,0,deny,62,62,0,1,0,1,0
55688,53,25850,53,allow,184,94,90,2,31,1,1
58593,57470,0,0,deny,62,62,0,1,0,1,0
50779,443,64325,443,allow,3247,1630,1617,8,120,4,4
64315,53,11433,53,allow,322,102,220,2,30,1,1
56228,53,46587,53,allow,711,87,624,2,30,1,1
1972,57470,0,0,deny,78,78,0,1,0,1,0
1024,64147,0,0,deny,62,62,0,1,0,1,0
53201,28513,16417,28513,allow,862,562,300,13,145,8,5
59592,37965,0,0,deny,62,62,0,1,0,1,0
52459,33890,0,0,deny,60,60,0,1,0,1,0
54332,445,0,0,drop,66,66,0,1,0,1,0
39323,443,25500,443,allow,1394,733,661,14,81,8,6
46865,80,11797,80,allow,662,600,62,12,495,11,1
49404,53,39531,53,allow,253,102,151,2,30,1,1
53916,23505,16942,23505,allow,70,70,0,1,5,1,0
29363,443,29363,443,allow,29861,6027,23834,65,37,34,31
32820,443,45406,443,allow,11455,5836,5619,40,317,20,20
53586,44515,38182,44515,allow,678,432,246,10,15,6,4
57589,443,3632,443,allow,2614,1689,925,18,23,10,8
51966,25174,0,0,deny,62,62,0,1,0,1,0
64673,6881,0,0,deny,66,66,0,1,0,1,0
62765,445,0,0,drop,70,70,0,1,0,1,0
1560,51505,0,0,deny,62,62,0,1,0,1,0
63088,443,45061,443,allow,512,166,346,2,30,1,1
26698,57470,0,0,deny,62,62,0,1,0,1,0
53006,443,3727,443,allow,2651,1504,1147,24,68,13,11
58664,64147,0,0,deny,66,66,0,1,0,1,0
50694,443,18706,443,allow,3097,1708,1389,15,19,9,6
38731,443,59272,443,allow,13181,5856,7325,23,135,11,12
50791,53,50791,53,allow,231,90,141,2,30,1,1
50804,1,0,0,deny,62,62,0,1,0,1,0
3478,61463,0,0,deny,822,822,0,1,0,1,0
8168,80,8168,80,allow,282487,10736,271751,315,52,124,191
56512,445,0,0,drop,66,66,0,1,0,1,0
51890,31122,40957,31122,allow,70,70,0,2,8,2,0
50974,11392,0,0,deny,66,66,0,1,0,1,0
26799,6881,0,0,deny,62,62,0,1,0,1,0
61406,445,0,0,drop,70,70,0,1,0,1,0
993,18732,0,0,deny,129,129,0,1,0,1,0
61012,445,0,0,drop,70,70,0,1,0,1,0
57557,64147,0,0,deny,62,62,0,1,0,1,0
64585,443,46353,443,allow,24686,1935,22751,36,18,17,19
49860,53,13520,53,allow,550,129,421,4,57,2,2
34244,80,38249,80,allow,656,398,258,11,39,7,4
5588,5588,0,0,allow,3354,1792,1562,46,193,23,23
55627,53,32877,53,allow,179,94,85,2,30,1,1
44823,53,0,0,allow,82,82,0,1,30,1,0
25497,44847,0,0,deny,62,62,0,1,0,1,0
60734,445,0,0,drop,70,70,0,1,0,1,0
53750,25174,0,0,deny,66,66,0,1,0,1,0
58638,5900,0,0,deny,62,62,0,1,0,1,0
64373,53,26971,53,allow,554,96,458,4,60,2,2
58745,30188,0,0,deny,66,66,0,1,0,1,0
62499,443,53888,443,allow,1332,876,456,11,26,6,5
58022,1471,0,0,deny,60,60,0,1,0,1,0
62309,445,0,0,drop,66,66,0,1,0,1,0
49972,53,21304,53,allow,184,94,90,2,30,1,1
60265,443,40784,443,allow,11048,3161,7887,26,24,15,11
1024,44847,0,0,deny,62,62,0,1,0,1,0
22,15260,22,15260,allow,130,70,60,2,15,1,1
63750,445,0,0,drop,70,70,0,1,0,1,0
63593,22114,0,0,deny,62,62,0,1,0,1,0
34357,443,37129,443,allow,17372,10352,7020,91,422,52,39
65189,27015,36838,27015,allow,257,78,179,2,30,1,1
55608,17425,43686,17425,allow,320,140,180,6,7,3,3
51963,21638,62624,21638,allow,70,70,0,2,8,2,0
50265,13302,54682,13302,allow,2118,858,1260,28,1267,14,14
61417,80,18297,80,allow,214,140,74,4,55,3,1
57069,53,3710,53,allow,177,94,83,2,30,1,1
10151,11809,51182,11809,allow,481,150,331,2,1200,1,1
26713,64147,0,0,deny,62,62,0,1,0,1,0
49849,53,18692,53,allow,173,94,79,2,30,1,1
3597,11392,0,0,deny,62,62,0,1,0,1,0
27005,27050,14571,27050,allow,1684,126,1558,4,31,2,2
58058,53,63439,53,allow,168,78,90,2,29,1,1
38528,443,36554,443,allow,13608,3518,10090,48,217,24,24
38834,53,64506,53,allow,168,78,90,2,30,1,1
50145,53,7031,53,allow,184,94,90,2,30,1,1
49515,53,61596,53,allow,195,102,93,2,31,1,1
64979,27050,52278,27050,allow,735,462,273,2,30,1,1
33822,57470,0,0,deny,66,66,0,1,0,1,0
50222,445,0,0,drop,70,70,0,1,0,1,0
53709,443,33210,443,allow,7356,1014,6342,20,75,10,10
56459,53,48405,53,allow,177,94,83,2,30,1,1
6881,51413,34368,51413,allow,207,118,89,2,1199,1,1
30960,45750,9630,45750,allow,66,66,0,1,3600,1,0
51108,53,64155,53,allow,168,78,90,2,30,1,1
22571,51505,0,0,deny,66,66,0,1,0,1,0
50947,445,0,0,drop,66,66,0,1,0,1,0
55770,445,0,0,drop,70,70,0,1,0,1,0
60311,56205,0,0,deny,62,62,0,1,0,1,0
56546,443,13186,443,allow,19236,2292,16944,45,55,23,22
43757,3389,43757,3389,allow,3910,1805,2105,20,18,12,8
64751,443,49226,443,allow,507753,8795,498958,463,195,122,341
57438,53,17355,53,allow,782,105,677,2,30,1,1
55621,53,47829,53,allow,453,186,267,6,30,3,3
45144,25174,0,0,deny,62,62,0,1,0,1,0
58022,8010,0,0,deny,60,60,0,1,0,1,0
443,50238,0,0,deny,331,331,0,1,0,1,0
56020,53,24675,53,allow,168,86,82,2,31,1,1
57172,17,0,0,deny,60,60,0,1,0,1,0
56100,53,57045,53,allow,216,110,106,2,31,1,1
55066,53,62750,53,allow,180,94,86,2,30,1,1
31404,36778,0,0,deny,100,100,0,1,0,1,0
64029,53,34743,53,allow,180,94,86,2,30,1,1
49418,27018,13297,27018,allow,259,78,181,2,30,1,1
60722,445,0,0,drop,66,66,0,1,0,1,0
63550,80,63550,80,allow,1232,481,751,10,15,5,5
49480,443,58193,443,allow,1160,638,522,13,113,7,6
52104,51756,50928,51756,allow,66,66,0,1,5,1,0
51849,21091,51027,21091,allow,316,136,180,6,7,3,3
55612,36239,64723,36239,allow,320,140,180,6,5,3,3
56961,445,0,0,drop,70,70,0,1,0,1,0
1176,64147,0,0,deny,62,62,0,1,0,1,0
58129,26467,0,0,deny,62,62,0,1,0,1,0
64104,22114,0,0,deny,66,66,0,1,0,1,0
51917,26077,8998,26077,allow,70,70,0,2,8,2,0
58700,443,30626,443,allow,8124,1079,7045,16,26,8,8
57280,445,0,0,drop,66,66,0,1,0,1,0
51972,80,30646,80,allow,426,240,186,8,26,5,3
64279,53,29219,53,allow,177,94,83,2,29,1,1
64240,53,21453,53,allow,256,110,146,2,30,1,1
55479,53,3977,53,allow,789,110,679,2,30,1,1
49892,443,65121,443,allow,1820,1101,719,18,73,10,8
15819,3389,0,0,deny,60,60,0,1,0,1,0
65139,53,18725,53,allow,216,110,106,2,29,1,1
49869,53,53726,53,allow,202,103,99,2,31,1,1
57298,443,20012,443,allow,8313,2850,5463,42,15,24,18
45973,80,60960,80,allow,1114,534,580,12,16,7,5
55921,43890,0,0,deny,62,62,0,1,0,1,0
46495,4607,0,0,deny,60,60,0,1,0,1,0
51732,445,0,0,drop,70,70,0,1,0,1,0
58976,43890,0,0,deny,66,66,0,1,0,1,0
50913,443,27670,443,allow,5057,851,4206,15,16,9,6
49556,53,40428,53,allow,300,100,200,4,44,2,2
50589,53,14237,53,allow,786,110,676,2,30,1,1
7487,443,7487,443,allow,4265,1184,3081,18,16,9,9
56773,28093,43311,28093,allow,70,70,0,1,5,1,0
27005,27035,11763,27035,allow,891,126,765,2,31,1,1
54197,445,0,0,drop,66,66,0,1,0,1,0
53698,8120,50996,8120,allow,70,70,0,2,8,2,0
53707,443,35476,443,allow,350,210,140,6,25,4,2
57689,445,0,0,drop,66,66,0,1,0,1,0
54202,53,3615,53,allow,578,286,292,9,16,5,4
51034,445,0,0,drop,70,70,0,1,0,1,0
42241,11392,0,0,deny,66,66,0,1,0,1,0
63963,53,56258,53,allow,262,86,176,4,46,2,2
57063,53,16093,53,allow,186,95,91,2,31,1,1
53288,443,63225,443,allow,4448,1654,2794,13,121,6,7
63157,445,0,0,drop,70,70,0,1,0,1,0
51414,22,0,0,deny,60,60,0,1,0,1,0
53986,54070,21018,54070,allow,70,70,0,2,7,2,0
56569,445,0,0,drop,70,70,0,1,0,1,0
47638,53,47638,53,allow,212,98,114,2,30,1,1
60018,64147,0,0,deny,62,62,0,1,0,1,0
64411,443,21450,443,allow,23357,2589,20768,33,120,13,20
49592,80,33337,80,allow,4173,2324,1849,14,42,8,6
34636,23,0,0,deny,60,60,0,1,0,1,0
65229,53,50271,53,allow,195,102,93,2,30,1,1
50097,445,0,0,drop,70,70,0,1,0,1,0
50742,445,0,0,drop,70,70,0,1,0,1,0
56384,445,0,0,drop,66,66,0,1,0,1,0
57132,53,39108,53,allow,216,110,106,2,30,1,1
52207,80,29595,80,allow,372,246,126,6,27,4,2
52166,80,3955,80,allow,2110,1066,1044,12,15,7,5
60021,445,0,0,drop,70,70,0,1,0,1,0
60943,445,0,0,drop,70,70,0,1,0,1,0
54397,443,59448,443,allow,1786,172,1614,7,120,3,4
53900,45682,23799,45682,allow,492,306,186,8,15,5,3
55082,445,0,0,drop,70,70,0,1,0,1,0
62872,50584,0,0,deny,66,66,0,1,0,1,0
3730,17372,0,0,deny,62,62,0,1,0,1,0
50395,445,0,0,drop,66,66,0,1,0,1,0
56040,445,0,0,drop,70,70,0,1,0,1,0
54402,445,0,0,drop,70,70,0,1,0,1,0
54179,445,0,0,drop,70,70,0,1,0,1,0
65319,445,0,0,drop,66,66,0,1,0,1,0
58638,5900,0,0,deny,62,62,0,1,0,1,0
57099,445,0,0,drop,70,70,0,1,0,1,0
55167,445,0,0,drop,70,70,0,1,0,1,0
47040,25174,0,0,deny,62,62,0,1,0,1,0
51818,37965,0,0,deny,66,66,0,1,0,1,0
52777,445,0,0,drop,66,66,0,1,0,1,0
5222,48709,0,0,deny,66,66,0,1,0,1,0
57745,15000,1994,15000,allow,130,70,60,2,5,1,1
62566,35993,0,0,deny,66,66,0,1,0,1,0
40787,57470,0,0,deny,62,62,0,1,0,1,0
57118,80,7804,80,allow,2404,568,1836,10,75,6,4
49480,53,47457,53,allow,184,94,90,2,30,1,1
57464,53,0,0,allow,86,86,0,1,30,1,0
43671,37965,0,0,deny,62,62,0,1,0,1,0
49177,53,53466,53,allow,735,88,647,2,30,1,1
45964,3111,0,0,deny,60,60,0,1,0,1,0
57592,80,57592,80,allow,3118,689,2429,13,144,6,7
20844,64147,0,0,deny,66,66,0,1,0,1,0
56711,443,22373,443,allow,1207531,28695,1178836,1184,45,400,784
61278,56205,0,0,deny,62,62,0,1,0,1,0
63261,445,0,0,drop,66,66,0,1,0,1,0
53748,51413,38549,51413,allow,70,70,0,2,7,2,0
52667,80,1897,80,allow,1272,633,639,9,150,5,4
45941,23388,0,0,deny,60,60,0,1,0,1,0
60324,445,0,0,drop,66,66,0,1,0,1,0
62817,445,0,0,drop,66,66,0,1,0,1,0
64982,50584,0,0,deny,146,146,0,1,0,1,0
45682,47993,0,0,deny,62,62,0,1,0,1,0
56356,443,29331,443,allow,3734,1750,1984,24,203,12,12
49184,443,9767,443,allow,493152,13222,479930,509,19,184,325
55310,53,16833,53,allow,180,94,86,2,30,1,1
51209,443,64337,443,allow,84768,21103,63665,136,133,58,78
17925,26467,0,0,deny,66,66,0,1,0,1,0
65336,53,13952,53,allow,782,105,677,2,31,1,1
59822,56205,0,0,deny,62,62,0,1,0,1,0
15333,60043,0,0,deny,62,62,0,1,0,1,0
48817,32794,48817,32794,allow,152,152,0,1,1200,1,0
65234,53,58797,53,allow,193,102,91,2,31,1,1
50584,40926,15001,40926,allow,166,166,0,1,1199,1,0
54455,445,0,0,drop,70,70,0,1,0,1,0
64173,445,0,0,drop,70,70,0,1,0,1,0
52251,445,0,0,drop,70,70,0,1,0,1,0
27005,32066,2938,32066,allow,881,126,755,2,31,1,1
62815,445,0,0,drop,70,70,0,1,0,1,0
53869,56205,0,0,deny,62,62,0,1,0,1,0
61416,443,34403,443,allow,6437,1994,4443,22,87,12,10
63960,53,31296,53,allow,178,94,84,2,30,1,1
49889,80,51133,80,allow,1376,946,430,8,87,5,3
49322,445,0,0,drop,70,70,0,1,0,1,0
36893,67,0,0,deny,60,60,0,1,0,1,0
58638,5900,0,0,deny,62,62,0,1,0,1,0
42488,53,42488,53,allow,235,90,145,2,32,1,1
58638,5900,58638,5900,allow,66,66,0,1,4,1,0
64890,51180,0,0,deny,66,66,0,1,0,1,0
9318,443,40235,443,allow,3649,424,3225,12,15,6,6
64790,53,49419,53,allow,182,93,89,2,31,1,1
55554,445,0,0,drop,70,70,0,1,0,1,0
52047,80,55413,80,allow,27784,13980,13804,44,35,22,22
53172,445,0,0,drop,66,66,0,1,0,1,0
56793,56205,0,0,deny,66,66,0,1,0,1,0
30599,46824,0,0,deny,66,66,0,1,0,1,0
37965,39108,36972,39108,allow,1056,1056,0,17,1550,17,0
54506,80,60844,80,allow,254,128,126,5,15,3,2
57002,445,0,0,drop,66,66,0,1,0,1,0
55661,53,42015,53,allow,213,102,111,2,30,1,1
64023,53,29476,53,allow,179,94,85,2,30,1,1
27005,27018,42247,27018,allow,881,126,755,2,30,1,1
51634,443,38565,443,allow,3174,346,2828,12,121,5,7
52914,37965,0,0,deny,66,66,0,1,0,1,0
27773,56205,0,0,deny,62,62,0,1,0,1,0
55877,54210,39473,54210,allow,490,149,341,2,1200,1,1
49962,53,48309,53,allow,184,94,90,2,30,1,1
40033,80,40033,80,allow,424,198,226,7,142,4,3
49979,53,49459,53,allow,197,94,103,2,30,1,1
54440,26467,0,0,deny,66,66,0,1,0,1,0
0,0,0,0,allow,124,64,60,2,0,1,1
55841,53,44587,53,allow,265,86,179,4,58,2,2
55872,53,6785,53,allow,196,102,94,2,30,1,1
62005,445,0,0,drop,70,70,0,1,0,1,0
54663,443,5282,443,allow,18311,11567,6744,43,363,21,22
27679,37965,0,0,deny,62,62,0,1,0,1,0
51739,62163,32244,62163,allow,70,70,0,1,5,1,0
55729,53,3509,53,allow,199,102,97,2,30,1,1
41547,80,41547,80,allow,120443,1965,118478,108,20,21,87
64533,53,56074,53,allow,183,102,81,2,29,1,1
51433,80,51433,80,allow,12796,1635,11161,21,15,8,13
50179,445,0,0,drop,70,70,0,1,0,1,0
64179,53,19210,53,allow,212,102,110,2,30,1,1
38633,51221,0,0,deny,66,66,0,1,0,1,0
49719,443,9783,443,allow,40332,2476,37856,57,130,26,31
49918,80,19931,80,allow,751,455,296,8,125,5,3
30906,53,30906,53,allow,227,89,138,2,30,1,1
63982,25174,0,0,deny,66,66,0,1,0,1,0
51640,445,0,0,drop,66,66,0,1,0,1,0
6712,5060,0,0,deny,410,410,0,1,0,1,0
61848,445,0,0,drop,70,70,0,1,0,1,0
44062,443,52650,443,allow,8998,1684,7314,24,170,12,12
57331,53,59568,53,allow,172,88,84,2,30,1,1
55609,53,45313,53,allow,172,88,84,2,30,1,1
55087,445,0,0,drop,66,66,0,1,0,1,0
57421,445,0,0,drop,70,70,0,1,0,1,0
59883,17637,0,0,deny,66,66,0,1,0,1,0
0,0,0,0,allow,244,244,0,2,0,2,0
9226,57470,0,0,deny,66,66,0,1,0,1,0
59892,445,0,0,drop,70,70,0,1,0,1,0
51702,33451,34580,33451,allow,70,70,0,1,5,1,0
50324,80,23988,80,allow,1083,653,430,8,15,5,3
49877,443,32997,443,allow,37364,16799,20565,189,53,87,102
50694,80,52061,80,allow,3481,1576,1905,17,187,10,7
53109,41661,38343,41661,allow,320,140,180,6,8,3,3
31845,55777,0,0,deny,62,62,0,1,0,1,0
52471,443,64710,443,allow,8398,1552,6846,27,50,14,13
57870,443,40542,443,allow,1373,734,639,17,125,10,7
64615,53,13915,53,allow,386,134,252,2,30,1,1
55344,53,59156,53,allow,212,110,102,2,30,1,1
51850,80,53740,80,allow,2188,1421,767,11,61,7,4
31978,57470,0,0,deny,60,60,0,1,0,1,0
64307,53,12624,53,allow,463,90,373,4,34,2,2
55965,53,49770,53,allow,184,94,90,2,30,1,1
55445,445,0,0,drop,66,66,0,1,0,1,0
58638,5900,0,0,deny,62,62,0,1,0,1,0
54985,53,45907,53,allow,177,94,83,2,30,1,1
30114,65151,0,0,deny,60,60,0,1,0,1,0
65040,53,10817,53,allow,180,94,86,2,31,1,1
35753,80,35753,80,allow,158890,11318,147572,182,30,74,108
50293,53,25447,53,allow,740,93,647,2,31,1,1
62177,445,0,0,drop,70,70,0,1,0,1,0
55044,445,0,0,drop,70,70,0,1,0,1,0
49589,445,0,0,drop,66,66,0,1,0,1,0
51798,445,0,0,drop,70,70,0,1,0,1,0
49717,57470,0,0,deny,62,62,0,1,0,1,0
56752,44847,0,0,deny,66,66,0,1,0,1,0
49898,443,53027,443,allow,44110,4769,39341,90,108,46,44
61185,54532,0,0,deny,62,62,0,1,0,1,0
62799,445,0,0,drop,70,70,0,1,0,1,0
7226,50584,0,0,deny,146,146,0,1,0,1,0
49432,53,61997,53,allow,312,94,218,2,30,1,1
53375,443,59892,443,allow,4317,1134,3183,16,26,9,7
33453,64147,0,0,deny,62,62,0,1,0,1,0
49810,53,13654,53,allow,244,94,150,2,30,1,1
53560,443,34440,443,allow,10823,1626,9197,27,28,15,12
49494,443,9142,443,allow,4168,1018,3150,16,27,8,8
26900,27017,38373,27017,allow,422,164,258,6,30,3,3
41815,50265,0,0,deny,146,146,0,1,0,1,0
49527,53,30173,53,allow,165,86,79,2,30,1,1
7539,30317,0,0,deny,62,62,0,1,0,1,0
64451,445,0,0,deny,70,70,0,1,0,1,0
56681,443,64351,443,allow,19154,11130,8024,40,102,24,16
58149,445,0,0,drop,70,70,0,1,0,1,0
52389,445,0,0,drop,70,70,0,1,0,1,0
49254,53,34045,53,allow,214,102,112,2,30,1,1
36414,80,15964,80,allow,5046,4132,914,31,15,16,15
49727,443,37710,443,allow,5037,1135,3902,16,18,9,7
58702,445,0,0,drop,66,66,0,1,0,1,0
64702,53,11324,53,allow,760,97,663,2,31,1,1
53292,445,0,0,drop,70,70,0,1,0,1,0
65048,53,24505,53,allow,396,84,312,4,54,2,2
51763,34121,50527,34121,allow,70,70,0,1,5,1,0
53838,36829,0,0,deny,62,62,0,1,0,1,0
60745,445,0,0,drop,66,66,0,1,0,1,0
64831,53,59275,53,allow,216,110,106,2,30,1,1
15451,25174,0,0,deny,146,146,0,1,0,1,0
64316,53,46275,53,allow,184,94,90,2,31,1,1
65333,53,15875,53,allow,197,94,103,2,29,1,1
26953,30317,0,0,deny,62,62,0,1,0,1,0
24931,25174,0,0,deny,62,62,0,1,0,1,0
45941,23386,0,0,deny,60,60,0,1,0,1,0
54457,445,0,0,drop,70,70,0,1,0,1,0
30960,45694,42221,45694,allow,330,330,0,6,3610,6,0
31859,33909,0,0,deny,66,66,0,1,0,1,0
56478,53,64286,53,allow,200,102,98,2,30,1,1
53884,445,0,0,drop,70,70,0,1,0,1,0
64020,53,46952,53,allow,302,118,184,2,29,1,1
58677,28678,3047,28678,allow,1806,1806,0,22,225,22,0
57937,445,0,0,drop,66,66,0,1,0,1,0
60678,445,0,0,drop,66,66,0,1,0,1,0
55110,53,57772,53,allow,770,102,668,2,30,1,1
59275,445,0,0,drop,66,66,0,1,0,1,0
51134,445,0,0,drop,66,66,0,1,0,1,0
65012,32468,0,0,deny,66,66,0,1,0,1,0
10035,443,49026,443,allow,7915,1634,6281,25,315,11,14
43274,443,35686,443,allow,6645,1668,4977,21,31,12,9
46532,17372,0,0,deny,145,145,0,1,0,1,0
49869,53,29655,53,allow,209,110,99,2,30,1,1
64870,65473,0,0,deny,148,148,0,1,0,1,0
29022,23,0,0,deny,60,60,0,1,0,1,0
51573,445,0,0,drop,66,66,0,1,0,1,0
6916,52700,0,0,deny,100,100,0,1,0,1,0
56273,53,58204,53,allow,197,102,95,2,30,1,1
52976,31573,0,0,deny,62,62,0,1,0,1,0
50324,445,0,0,drop,70,70,0,1,0,1,0
49357,53,3200,53,allow,211,102,109,2,30,1,1
62944,445,0,0,drop,70,70,0,1,0,1,0
51840,80,51840,80,allow,525257,17273,507984,531,26,183,348
60605,53,5384,53,allow,275,86,189,2,30,1,1
57224,53,20310,53,allow,532,198,334,6,50,3,3
60007,443,8441,443,allow,7040,1933,5107,32,110,19,13
64768,53,30874,53,allow,78,78,0,1,30,1,0
55660,53,31252,53,allow,177,94,83,2,30,1,1
38647,443,59827,443,allow,2634,1411,1223,18,28,10,8
59326,57470,0,0,deny,74,74,0,1,0,1,0
49262,80,49262,80,allow,515211,10976,504235,506,49,169,337
52386,445,0,0,drop,70,70,0,1,0,1,0
9134,80,9239,80,allow,318,192,126,6,29,4,2
57326,53,16719,53,allow,180,94,86,2,35,1,1
0,0,0,0,deny,98,98,0,1,0,1,0
51920,30188,0,0,deny,66,66,0,1,0,1,0
49564,53,13171,53,allow,193,102,91,2,29,1,1
50171,445,0,0,drop,66,66,0,1,0,1,0
52185,13269,32926,13269,allow,70,70,0,2,7,2,0
57379,445,0,0,drop,70,70,0,1,0,1,0
56945,53,62206,53,allow,180,94,86,2,30,1,1
49961,443,64983,443,allow,16890,7125,9765,33,98,19,14
62316,445,0,0,drop,66,66,0,1,0,1,0
7881,48817,0,0,deny,133,133,0,1,0,1,0
50559,80,62420,80,allow,318,192,126,6,26,4,2
49265,53,28768,53,allow,181,94,87,2,29,1,1
50897,80,4903,80,allow,13981183,155668,13825515,11482,136,2194,9288
55743,53,57939,53,allow,165,86,79,2,30,1,1
3766,25174,0,0,deny,146,146,0,1,0,1,0
58638,5900,0,0,deny,62,62,0,1,0,1,0
60401,30046,40405,30046,allow,70,70,0,1,5,1,0
49871,445,0,0,drop,66,66,0,1,0,1,0
64185,53,32210,53,allow,403,110,293,2,31,1,1
40990,10387,0,0,deny,148,148,0,1,0,1,0
64125,53,18557,53,allow,199,102,97,2,30,1,1
58638,5900,0,0,deny,62,62,0,1,0,1,0
62684,445,0,0,drop,70,70,0,1,0,1,0
51325,443,47264,443,allow,2019,1219,800,15,17,8,7
53972,59089,19075,59089,allow,70,70,0,1,4,1,0
45896,443,32975,443,allow,1160457,45088,1115369,1320,315,518,802
63982,25174,0,0,deny,66,66,0,1,0,1,0
47963,443,46762,443,allow,8903,3095,5808,31,121,16,15
65118,445,0,0,drop,70,70,0,1,0,1,0
53159,445,0,0,drop,66,66,0,1,0,1,0
52196,445,0,0,drop,70,70,0,1,0,1,0
49396,53,32920,53,allow,177,94,83,2,29,1,1
64116,53,59357,53,allow,87,87,0,1,31,1,0
26553,57470,0,0,deny,66,66,0,1,0,1,0
64144,445,0,0,drop,66,66,0,1,0,1,0
62810,445,0,0,drop,66,66,0,1,0,1,0
59920,445,0,0,drop,70,70,0,1,0,1,0
9059,443,42849,443,allow,19816,13030,6786,80,159,40,40
63710,54740,50464,54740,allow,70,70,0,1,4,1,0
49371,445,0,0,drop,70,70,0,1,0,1,0
55246,31573,0,0,deny,62,62,0,1,0,1,0
5588,5588,0,0,allow,3354,1792,1562,46,193,23,23
34239,80,12111,80,allow,1056,682,374,10,15,6,4
20741,64147,0,0,deny,62,62,0,1,0,1,0
53572,443,49621,443,allow,5935,342,5593,12,120,5,7
59051,445,0,0,drop,66,66,0,1,0,1,0
61275,445,0,0,drop,70,70,0,1,0,1,0
48817,51417,48817,51417,allow,485,158,327,2,1200,1,1
53559,58968,7595,58968,allow,70,70,0,2,7,2,0
50861,445,0,0,drop,70,70,0,1,0,1,0
57239,53,63537,53,allow,186,95,91,2,31,1,1
53833,53,46684,53,allow,211,78,133,2,30,1,1
55432,443,59316,443,allow,256189,15094,241095,316,122,120,196
45964,2666,0,0,deny,60,60,0,1,0,1,0
60684,53,9516,53,allow,199,94,105,2,30,1,1
49152,53,49230,53,allow,211,110,101,2,31,1,1
64823,53,48646,53,allow,210,102,108,2,30,1,1
54614,37807,0,0,deny,62,62,0,1,0,1,0
53759,42873,0,0,deny,74,74,0,1,0,1,0
54022,443,12904,443,allow,7653,1188,6465,21,16,12,9
57262,53,44073,53,allow,176,90,86,2,30,1,1
40590,443,36504,443,allow,2965,1650,1315,24,275,12,12
49994,26467,0,0,deny,66,66,0,1,0,1,0
61372,445,0,0,drop,70,70,0,1,0,1,0
59865,445,0,0,drop,66,66,0,1,0,1,0
56455,53,54287,53,allow,183,94,89,2,31,1,1
51480,445,0,0,drop,70,70,0,1,0,1,0
55733,51505,0,0,deny,66,66,0,1,0,1,0
31130,30188,0,0,deny,66,66,0,1,0,1,0
44594,64147,0,0,deny,66,66,0,1,0,1,0
63811,443,59225,443,allow,25707,7559,18148,53,121,24,29
61337,445,0,0,drop,66,66,0,1,0,1,0
32968,43890,0,0,deny,146,146,0,1,0,1,0
51399,443,28295,443,allow,642,582,60,2,5,1,1
53711,443,24841,443,allow,499,425,74,4,0,3,1
56604,3389,56604,3389,allow,3424,1710,1714,16,31,8,8
51401,443,31981,443,allow,6537,3702,2835,34,170,17,17
53974,443,28676,443,allow,3330,1694,1636,15,30,8,7
49550,80,26667,80,allow,3531,1965,1566,14,29,8,6
58638,5900,0,0,deny,62,62,0,1,0,1,0
58638,5900,0,0,deny,62,62,0,1,0,1,0
55606,21802,21715,21802,allow,320,140,180,6,5,3,3
25651,48817,0,0,deny,140,140,0,1,0,1,0
40231,443,30990,443,allow,10401,3375,7026,33,22,17,16
63943,53,24441,53,allow,509,176,333,6,56,3,3
55724,445,0,0,drop,70,70,0,1,0,1,0
64177,44847,0,0,deny,66,66,0,1,0,1,0
49369,53,36980,53,allow,183,94,89,2,30,1,1
49214,443,63008,443,allow,7177,2666,4511,20,15,11,9
56351,445,0,0,drop,70,70,0,1,0,1,0
58294,443,58294,443,allow,7356,1014,6342,20,76,10,10
24127,56205,0,0,deny,66,66,0,1,0,1,0
45295,443,2561,443,allow,6864,1633,5231,20,315,10,10
59677,443,25449,443,allow,13551,5488,8063,33,95,16,17
56105,445,0,0,drop,70,70,0,1,0,1,0
1903,43890,0,0,deny,66,66,0,1,0,1,0
22541,64147,0,0,deny,66,66,0,1,0,1,0
27005,1306,35061,1306,allow,858,126,732,2,29,1,1
58863,443,30901,443,allow,4546411,95150,4451261,4312,109,1197,3115
55205,53,56363,53,allow,167,86,81,2,30,1,1
58785,443,2616,443,allow,37165,2164,35001,58,29,28,30
56395,53,26847,53,allow,177,94,83,2,29,1,1
40107,53,34833,53,allow,168,78,90,2,30,1,1
65003,57470,0,0,deny,78,78,0,1,0,1,0
50967,445,0,0,drop,70,70,0,1,0,1,0
52657,53,48551,53,allow,302,210,92,3,30,2,1
12060,37965,0,0,deny,66,66,0,1,0,1,0
9449,443,11942,443,allow,5693,499,5194,14,15,7,7
41107,53,24186,53,allow,168,78,90,2,30,1,1
53762,53,52593,53,allow,168,78,90,2,30,1,1
53912,443,35610,443,allow,1346,918,428,10,33,6,4
60423,35440,0,0,deny,146,146,0,1,0,1,0
36103,443,46915,443,allow,130,70,60,2,15,1,1
11295,40033,39520,40033,allow,213,89,124,4,49,2,2
55664,53,23659,53,allow,177,94,83,2,30,1,1
56975,53,38883,53,allow,197,102,95,2,29,1,1
35790,443,59845,443,allow,6777,1527,5250,24,201,13,11
50822,50584,0,0,deny,62,62,0,1,0,1,0
65428,80,59063,80,allow,366,180,186,7,29,4,3
57031,53,9800,53,allow,170,87,83,2,31,1,1
60123,443,13855,443,allow,6485,1957,4528,22,16,11,11
9188,443,11737,443,allow,5955,728,5227,17,15,8,9
2745,53,2745,53,allow,244,98,146,2,32,1,1
49722,53,53892,53,allow,873,280,593,8,80,4,4
51756,41471,58464,41471,allow,70,70,0,1,5,1,0
50396,445,0,0,drop,70,70,0,1,0,1,0
59789,445,0,0,drop,70,70,0,1,0,1,0
11478,51221,0,0,deny,66,66,0,1,0,1,0
443,9986,0,0,deny,669,669,0,1,0,1,0
62208,37965,0,0,deny,66,66,0,1,0,1,0
54883,51505,0,0,deny,66,66,0,1,0,1,0
55497,53,48989,53,allow,168,86,82,2,30,1,1
64134,445,0,0,drop,70,70,0,1,0,1,0
49162,53,60010,53,allow,182,93,89,2,31,1,1
7810,25174,0,0,deny,62,62,0,1,0,1,0
50292,62413,0,0,deny,62,62,0,1,0,1,0
51671,443,38152,443,allow,1143,703,440,13,38,8,5
62117,445,0,0,drop,70,70,0,1,0,1,0
58000,17,58000,17,allow,66,66,0,1,30,1,0
56667,53,25410,53,allow,250,86,164,4,29,2,2
61148,445,0,0,drop,66,66,0,1,0,1,0
49443,443,17566,443,allow,70988,47020,23968,152,652,79,73
58638,5900,0,0,deny,62,62,0,1,0,1,0
53510,58706,37396,58706,allow,492,306,186,8,16,5,3
2886,35440,0,0,deny,66,66,0,1,0,1,0
51157,443,53993,443,allow,5378,1423,3955,19,22,11,8
1114,37965,0,0,deny,62,62,0,1,0,1,0
4111,25174,0,0,deny,62,62,0,1,0,1,0
54990,53,8264,53,allow,168,86,82,2,31,1,1
55979,53,24460,53,allow,168,86,82,2,30,1,1
10000,10214,0,0,deny,62,62,0,1,0,1,0
54129,445,0,0,drop,70,70,0,1,0,1,0
40072,80,29014,80,allow,1298,370,928,12,15,6,6
39359,443,36397,443,allow,46113,6913,39200,86,34,41,45
58863,443,23250,443,allow,3873,2469,1404,17,16,9,8
49717,666,0,0,deny,60,60,0,1,0,1,0
62846,445,0,0,drop,70,70,0,1,0,1,0
64862,53,32776,53,allow,206,105,101,2,30,1,1
54423,21247,0,0,deny,66,66,0,1,0,1,0
33845,53,0,0,allow,82,82,0,1,30,1,0
19875,30170,0,0,deny,145,145,0,1,0,1,0
65445,80,60875,80,allow,1279,714,565,11,19,6,5
56205,51505,0,0,deny,66,66,0,1,0,1,0
28754,50584,0,0,deny,66,66,0,1,0,1,0
62682,445,0,0,drop,66,66,0,1,0,1,0
51881,443,23769,443,allow,4418,1116,3302,17,30,10,7
45350,443,10693,443,allow,918,358,560,14,40,6,8
59246,445,0,0,drop,70,70,0,1,0,1,0
64989,53,9165,53,allow,183,102,81,2,30,1,1
55626,53,3780,53,allow,319,126,193,2,29,1,1
52030,43068,29971,43068,allow,66,66,0,1,5,1,0
64678,53,43744,53,allow,289,102,187,2,30,1,1
28999,37807,0,0,deny,146,146,0,1,0,1,0
40302,443,5180,443,allow,7586,3785,3801,20,30,11,9
63808,40608,41042,40608,allow,504,382,122,8,15,6,2
56917,53,8537,53,allow,424,104,320,4,30,2,2
58005,80,36908,80,allow,14927,10571,4356,39,75,20,19
62956,445,0,0,drop,66,66,0,1,0,1,0
50201,80,38325,80,allow,5015,2123,2892,25,96,14,11
57387,445,0,0,drop,70,70,0,1,0,1,0
56933,80,47498,80,allow,486,280,206,8,26,5,3
57798,445,0,0,drop,70,70,0,1,0,1,0
58638,5900,0,0,deny,62,62,0,1,0,1,0
49860,53,46004,53,allow,212,102,110,2,30,1,1
55712,53,64759,53,allow,164,86,78,2,30,1,1
55009,53,51311,53,allow,241,78,163,2,30,1,1
55043,57470,0,0,deny,78,78,0,1,0,1,0
65454,53,35372,53,allow,218,86,132,2,31,1,1
53788,53,27955,53,allow,213,78,135,2,30,1,1
64706,53,6789,53,allow,179,94,85,2,30,1,1
10088,443,42389,443,allow,7243,1860,5383,26,330,14,12
19204,57866,0,0,deny,62,62,0,1,0,1,0
45816,443,14384,443,allow,21950,3632,18318,46,140,20,26
52569,80,52569,80,allow,93783,3885,89898,105,167,37,68
60885,445,0,0,drop,70,70,0,1,0,1,0
46792,443,1807,443,allow,7298,2661,4637,21,18,11,10
26900,27017,60227,27017,allow,422,164,258,6,30,3,3
50444,443,13843,443,allow,5593,996,4597,22,127,11,11
16948,990,0,0,deny,60,60,0,1,0,1,0
56282,3389,56282,3389,allow,3425,1470,1955,16,16,8,8
5729,22114,0,0,deny,66,66,0,1,0,1,0
57022,445,0,0,drop,70,70,0,1,0,1,0
49418,33056,16028,33056,allow,237,78,159,2,30,1,1
52837,35440,0,0,deny,66,66,0,1,0,1,0
55912,445,0,0,drop,70,70,0,1,0,1,0
58135,445,0,0,drop,70,70,0,1,0,1,0
64439,53,35218,53,allow,199,102,97,2,31,1,1
55056,53,8605,53,allow,170,87,83,2,30,1,1
47513,23,0,0,deny,60,60,0,1,0,1,0
33457,27015,0,0,deny,67,67,0,1,0,1,0
54144,7000,54144,7000,allow,3018,1627,1391,16,15,9,7
64275,53,47758,53,allow,192,90,102,2,31,1,1
25457,25604,0,0,deny,62,62,0,1,0,1,0
50668,58833,0,0,deny,62,62,0,1,0,1,0
58888,445,0,0,drop,70,70,0,1,0,1,0
57339,53,43284,53,allow,184,80,104,2,30,1,1
52029,445,0,0,drop,66,66,0,1,0,1,0
53079,443,11081,443,allow,8233,5537,2696,40,84,21,19
52040,2524,48292,2524,allow,70,70,0,1,5,1,0
22390,19473,0,0,deny,66,66,0,1,0,1,0
53769,8999,60336,8999,allow,70,70,0,1,5,1,0
30365,45991,0,0,deny,60,60,0,1,0,1,0
63368,445,0,0,drop,66,66,0,1,0,1,0
49364,443,26461,443,allow,8376,2198,6178,25,81,14,11
25565,27942,0,0,deny,60,60,0,1,0,1,0
55190,445,0,0,drop,70,70,0,1,0,1,0
55517,443,55517,443,allow,274414,45529,228885,359,170,186,173
63834,445,0,0,drop,70,70,0,1,0,1,0
14360,64147,0,0,deny,62,62,0,1,0,1,0
51755,445,0,0,drop,66,66,0,1,0,1,0
57714,53,57714,53,allow,233,90,143,2,32,1,1
60732,443,1345,443,allow,193520,11019,182501,280,276,140,140
50544,53,6922,53,allow,193,102,91,2,30,1,1
51405,80,23596,80,allow,1510,481,1029,11,20,6,5
54859,443,24991,443,allow,6677,1006,5671,19,26,11,8
48818,443,11974,443,allow,4167,1669,2498,23,15,12,11
10165,80,10165,80,allow,6714,929,5785,17,33,8,9
53723,443,51817,443,allow,70,70,0,1,5,1,0
50470,61463,0,0,deny,86,86,0,1,0,1,0
49117,443,48924,443,allow,9551,2173,7378,33,27,17,16
64935,53,42263,53,allow,313,94,219,2,29,1,1
19570,50584,0,0,deny,62,62,0,1,0,1,0
57470,45561,33811,45561,allow,792,792,0,13,1201,13,0
64617,53,32317,53,allow,756,95,661,2,30,1,1
27018,61508,0,0,deny,753,753,0,1,0,1,0
64803,53,18696,53,allow,403,142,261,2,31,1,1
57340,443,31175,443,allow,1169,616,553,12,16,7,5
55535,80,6697,80,allow,18450,1862,16588,29,17,15,14
47664,3389,47664,3389,allow,4575,2400,2175,20,19,11,9
37555,16385,63752,16385,allow,556,256,300,10,30,5,5
56794,46824,0,0,deny,66,66,0,1,0,1,0
54155,64147,0,0,deny,66,66,0,1,0,1,0
63913,445,0,0,drop,70,70,0,1,0,1,0
55165,445,0,0,drop,70,70,0,1,0,1,0
52095,443,5865,443,allow,3023,2045,978,15,15,9,6
57058,53,29046,53,allow,167,86,81,2,30,1,1
52184,57262,17429,57262,allow,66,66,0,1,5,1,0
49305,57470,0,0,deny,66,66,0,1,0,1,0
37887,22114,0,0,deny,66,66,0,1,0,1,0
55957,53,35891,53,allow,178,94,84,2,29,1,1
48706,23393,0,0,deny,60,60,0,1,0,1,0
49691,443,33512,443,allow,1183,659,524,13,56,7,6
64587,53,36595,53,allow,167,86,81,2,31,1,1
56989,80,28425,80,allow,526,304,222,8,35,5,3
62262,445,0,0,drop,66,66,0,1,0,1,0
8889,2917,0,0,deny,60,60,0,1,0,1,0
62781,445,0,0,drop,66,66,0,1,0,1,0
45567,443,10380,443,allow,1473,988,485,12,25,7,5
49538,53,56684,53,allow,258,102,156,2,30,1,1
50236,443,15469,443,allow,5858,791,5067,19,22,10,9
60542,53,46573,53,allow,260,86,174,2,30,1,1
37635,443,24027,443,allow,9406,2044,7362,27,21,16,11
11826,53,11826,53,allow,216,98,118,2,30,1,1
49206,12242,47287,12242,allow,70,70,0,1,5,1,0
58844,51505,0,0,deny,66,66,0,1,0,1,0
60341,80,24741,80,allow,2005,1094,911,11,87,6,5
57432,66,6875,66,allow,70,70,0,2,8,2,0
63980,4804,28040,4804,allow,66,66,0,2,8,2,0
1399,53,11703,53,allow,256,94,162,2,30,1,1
33080,53,44512,53,allow,86,86,0,1,29,1,0
19698,502,0,0,deny,60,60,0,1,0,1,0
56766,41605,18996,41605,allow,1639,460,1179,8,30,4,4
61190,21247,0,0,deny,62,62,0,1,0,1,0
49200,445,0,0,drop,66,66,0,1,0,1,0
28124,8497,0,0,deny,148,148,0,1,0,1,0
52830,443,59305,443,allow,12577,3687,8890,63,415,30,33
50935,80,3414,80,allow,8167195,108448,8058747,7107,121,1531,5576
58887,80,17469,80,allow,1493,765,728,10,90,6,4
65361,53,22669,53,allow,249,94,155,2,30,1,1
41462,2323,0,0,deny,60,60,0,1,0,1,0
49183,53,53469,53,allow,194,102,92,2,30,1,1
57825,13014,0,0,deny,74,74,0,1,0,1,0
49350,80,49350,80,allow,450,246,204,8,142,5,3
62238,443,62238,443,allow,58141,3051,55090,78,78,29,49
61501,445,0,0,drop,70,70,0,1,0,1,0
80,9918,0,0,deny,60,60,0,1,0,1,0
50625,445,0,0,drop,70,70,0,1,0,1,0
49660,443,16842,443,allow,3721,1477,2244,15,121,8,7
58811,443,3266,443,allow,10704,7055,3649,29,17,15,14
65404,36237,0,0,deny,62,62,0,1,0,1,0
24560,25174,0,0,deny,146,146,0,1,0,1,0
54896,445,0,0,drop,70,70,0,1,0,1,0
50346,445,0,0,drop,70,70,0,1,0,1,0
60195,80,26973,80,allow,3059,1869,1190,17,105,13,4
49653,445,0,0,drop,66,66,0,1,0,1,0
32967,443,43142,443,allow,5327,963,4364,19,15,11,8
65349,445,0,0,drop,70,70,0,1,0,1,0
52957,443,8095,443,allow,38149,4388,33761,68,113,26,42
57470,51413,13214,51413,allow,490,163,327,2,1200,1,1
7891,25174,0,0,deny,66,66,0,1,0,1,0
54998,53,2972,53,allow,196,100,96,2,31,1,1
56985,53,39491,53,allow,165,86,79,2,30,1,1
59402,445,0,0,drop,70,70,0,1,0,1,0
51979,55803,3042,55803,allow,70,70,0,1,4,1,0
56690,53,19054,53,allow,802,104,698,2,30,1,1
56942,53,26338,53,allow,170,87,83,2,31,1,1
62952,38741,48558,38741,allow,18963,9580,9383,211,348,109,102
49948,53,30662,53,allow,214,94,120,2,30,1,1
17532,23,0,0,deny,60,60,0,1,0,1,0
53975,443,8391,443,allow,9782,1996,7786,30,31,14,16
56206,53,31271,53,allow,211,102,109,2,30,1,1
123,123,41547,123,allow,184,94,90,2,30,1,1
55766,443,53751,443,allow,1864,250,1614,8,120,4,4
53896,48027,30657,48027,allow,70,70,0,1,5,1,0
39543,7276,23316,7276,allow,1142,558,584,16,16,8,8
64330,53,32772,53,allow,186,95,91,2,31,1,1
50705,21,33829,21,allow,2222,983,1239,27,18,13,14
47652,443,53871,443,allow,1058,571,487,10,24,6,4
52859,53,16412,53,allow,164,78,86,2,30,1,1
33861,443,34883,443,allow,8084,2638,5446,26,20,14,12
57594,443,61887,443,allow,291,171,120,4,15,2,2
34165,443,24288,443,allow,14923,1978,12945,32,49,17,15
51090,80,46921,80,allow,10434,1041,9393,20,45,11,9
49431,53,38249,53,allow,767,102,665,2,30,1,1
49516,53,32390,53,allow,183,94,89,2,31,1,1
54201,445,0,0,drop,70,70,0,1,0,1,0
45908,33330,0,0,deny,60,60,0,1,0,1,0
60097,22114,0,0,deny,66,66,0,1,0,1,0
56269,53,56636,53,allow,326,126,200,2,30,1,1
3478,61463,0,0,deny,857,857,0,1,0,1,0
57266,445,0,0,drop,70,70,0,1,0,1,0
62424,37965,0,0,deny,66,66,0,1,0,1,0
63036,445,0,0,drop,70,70,0,1,0,1,0
65076,53,51472,53,allow,215,94,121,2,29,1,1
56462,37965,0,0,deny,62,62,0,1,0,1,0
12232,41864,0,0,deny,139,139,0,1,0,1,0
64898,53,30399,53,allow,167,86,81,2,29,1,1
17750,39318,52655,39318,allow,481,150,331,2,1200,1,1
60116,443,14734,443,allow,9454,2307,7147,40,19,17,23
1262,23,0,0,deny,60,60,0,1,0,1,0
57240,443,57240,443,allow,4623,1716,2907,19,26,11,8
61460,80,11498,80,allow,1507,1184,323,11,79,7,4
52925,5555,0,0,deny,60,60,0,1,0,1,0
56559,53,15416,53,allow,731,85,646,2,30,1,1
55707,53,50594,53,allow,177,94,83,2,30,1,1
59454,445,0,0,drop,70,70,0,1,0,1,0
50069,445,0,0,drop,70,70,0,1,0,1,0
52344,445,0,0,drop,70,70,0,1,0,1,0
55540,443,32830,443,allow,10458,5272,5186,24,76,13,11
65277,53,48607,53,allow,199,102,97,2,30,1,1
55681,53,52185,53,allow,711,87,624,2,30,1,1
57330,53,31519,53,allow,228,94,134,2,30,1,1
59275,445,0,0,drop,70,70,0,1,0,1,0
64001,445,0,0,drop,70,70,0,1,0,1,0
60635,445,0,0,drop,70,70,0,1,0,1,0
42034,28189,0,0,deny,62,62,0,1,0,1,0
52010,80,6411,80,allow,1327,822,505,11,21,7,4
46495,4607,0,0,deny,60,60,0,1,0,1,0
51864,445,0,0,drop,70,70,0,1,0,1,0
56539,443,14998,443,allow,52465,2787,49678,66,80,26,40
49178,2710,54926,2710,allow,70,70,0,2,7,2,0
49418,27016,46428,27016,allow,249,71,178,2,30,1,1
64701,53,54317,53,allow,195,94,101,2,30,1,1
51134,3389,51134,3389,allow,4213,2429,1784,18,32,9,9
55337,53,28465,53,allow,196,100,96,2,30,1,1
53176,445,0,0,drop,66,66,0,1,0,1,0
57470,22796,55699,22796,allow,2224,1852,372,33,1565,27,6
53819,445,0,0,drop,66,66,0,1,0,1,0
64857,445,0,0,drop,70,70,0,1,0,1,0
50737,445,0,0,drop,70,70,0,1,0,1,0
51528,445,0,0,drop,70,70,0,1,0,1,0
443,20087,0,0,deny,83,83,0,1,0,1,0
65329,53,20205,53,allow,278,102,176,2,29,1,1
34574,443,39427,443,allow,130,70,60,2,15,1,1
56462,445,0,0,drop,70,70,0,1,0,1,0
49861,445,0,0,drop,70,70,0,1,0,1,0
49355,53,27262,53,allow,193,102,91,2,30,1,1
63318,445,0,0,drop,70,70,0,1,0,1,0
55377,53,47893,53,allow,190,97,93,2,31,1,1
57948,443,32601,443,allow,5914,1514,4400,23,15,12,11
56086,443,31892,443,allow,6817,3598,3219,32,143,15,17
22530,25174,0,0,deny,62,62,0,1,0,1,0
50003,443,32664,443,allow,13812,3042,10770,29,16,15,14
48436,53,48436,53,allow,216,82,134,2,32,1,1
56626,443,50553,443,allow,8240,3521,4719,25,18,15,10
56478,53,62940,53,allow,200,102,98,2,30,1,1
49967,53,25573,53,allow,445,95,350,4,50,2,2
41164,443,60993,443,allow,8949,1938,7011,21,17,12,9
55146,53,47576,53,allow,277,110,167,2,30,1,1
56425,53,0,0,allow,82,82,0,1,30,1,0
62480,443,56428,443,allow,1326,876,450,11,26,6,5
59942,80,31955,80,allow,2241,1549,692,9,15,5,4
49777,445,0,0,drop,70,70,0,1,0,1,0
56632,53,56632,53,allow,235,90,145,2,33,1,1
56734,445,0,0,drop,66,66,0,1,0,1,0
63085,53,50123,53,allow,448,166,282,2,30,1,1
56196,53,38043,53,allow,214,110,104,2,30,1,1
64595,53,56793,53,allow,182,93,89,2,30,1,1
64519,53,15868,53,allow,518,185,333,6,60,3,3
58862,443,37549,443,allow,1068717,27931,1040786,1093,45,351,742
64854,53,54158,53,allow,260,102,158,2,30,1,1
52590,445,0,0,drop,70,70,0,1,0,1,0
65145,53,64400,53,allow,338,110,228,2,30,1,1
64034,17935,37819,17935,allow,66,66,0,1,5,1,0
2946,25174,0,0,deny,62,62,0,1,0,1,0
53294,445,0,0,drop,70,70,0,1,0,1,0
55988,443,19724,443,allow,14754,7879,6875,37,231,20,17
49614,53,48973,53,allow,183,94,89,2,29,1,1
64022,60918,37297,60918,allow,66,66,0,2,7,2,0
49748,445,0,0,drop,70,70,0,1,0,1,0
60908,445,0,0,drop,66,66,0,1,0,1,0
48273,15000,43622,15000,allow,130,70,60,2,5,1,1
27005,1103,52058,1103,allow,822,126,696,2,29,1,1
49622,50584,0,0,deny,62,62,0,1,0,1,0
61146,443,19937,443,allow,8580941,269463,8311478,9202,122,3016,6186
2076,7000,2076,7000,allow,5194,3739,1455,18,15,10,8
45726,443,40256,443,allow,130,70,60,3,6,2,1
6712,5632,0,0,deny,60,60,0,1,0,1,0
47377,443,54637,443,allow,2725,1153,1572,19,208,8,11
52785,443,33714,443,allow,5806,1059,4747,16,63,8,8
80,9918,0,0,deny,60,60,0,1,0,1,0
56635,445,0,0,drop,70,70,0,1,0,1,0
21133,24035,37028,24035,allow,481,150,331,2,1200,1,1
57044,53,35114,53,allow,197,102,95,2,30,1,1
37619,443,7866,443,allow,6169,4980,1189,28,16,15,13
50391,445,0,0,drop,70,70,0,1,0,1,0
49501,53,44593,53,allow,186,95,91,2,31,1,1
53716,443,47571,443,allow,499,425,74,4,0,3,1
30188,13384,3738,13384,allow,501,150,351,2,1200,1,1
49888,53,17695,53,allow,198,102,96,2,29,1,1
56876,53,26048,53,allow,283,110,173,2,29,1,1
65036,53,55693,53,allow,199,102,97,2,29,1,1
65476,443,36901,443,allow,93073,4939,88134,111,16,45,66
49531,53,21298,53,allow,740,93,647,2,31,1,1
61497,443,26455,443,allow,15302,2355,12947,30,32,14,16
63503,42707,0,0,deny,66,66,0,1,0,1,0
55829,53,27683,53,allow,177,94,83,2,29,1,1
55276,53,37772,53,allow,215,94,121,2,30,1,1
56941,445,0,0,drop,70,70,0,1,0,1,0
49680,443,50049,443,allow,63100,10145,52955,87,147,37,50
50584,8999,18180,8999,allow,1356,300,1056,6,1200,3,3
58142,445,0,0,drop,70,70,0,1,0,1,0
55326,53,8434,53,allow,170,87,83,2,30,1,1
51233,445,0,0,drop,70,70,0,1,0,1,0
61748,445,0,0,drop,70,70,0,1,0,1,0
64858,53,1882,53,allow,227,102,125,2,30,1,1
4910,2149,0,0,deny,66,66,0,1,0,1,0
64034,53,38664,53,allow,194,102,92,2,29,1,1
51806,443,40388,443,allow,3182,1568,1614,8,121,4,4
57572,443,57572,443,allow,181333,21870,159463,187,175,65,122
65518,53,19504,53,allow,701,88,613,2,30,1,1
60898,443,32262,443,allow,10104,1643,8461,28,46,15,13
1025,25174,0,0,deny,62,62,0,1,0,1,0
56288,53,47353,53,allow,200,102,98,2,30,1,1
62328,443,62328,443,allow,1210,637,573,14,51,7,7
39390,15503,0,0,deny,74,74,0,1,0,1,0
50017,53,65009,53,allow,741,94,647,2,30,1,1
55533,80,6176,80,allow,3386,2365,1021,19,39,11,8
56387,443,8980,443,allow,9569,2225,7344,28,15,15,13
50544,443,24381,443,allow,8592,1152,7440,25,150,13,12
33912,25174,0,0,deny,62,62,0,1,0,1,0
50667,80,4915,80,allow,3778,2082,1696,12,21,7,5
51972,13604,43742,13604,allow,160,70,90,2,5,1,1
2864,25174,0,0,deny,66,66,0,1,0,1,0
56368,445,0,0,drop,70,70,0,1,0,1,0
54617,64147,0,0,deny,62,62,0,1,0,1,0
60965,445,0,0,drop,70,70,0,1,0,1,0
59537,80,26442,80,allow,3892,1824,2068,21,187,12,9
52557,44847,0,0,deny,66,66,0,1,0,1,0
53395,445,0,0,drop,66,66,0,1,0,1,0
3591,53,3591,53,allow,235,90,145,2,32,1,1
54315,445,0,0,drop,70,70,0,1,0,1,0
54377,445,0,0,drop,66,66,0,1,0,1,0
34597,80,9526,80,allow,1540,553,987,10,15,6,4
57917,44847,0,0,deny,62,62,0,1,0,1,0
17009,53733,0,0,deny,66,66,0,1,0,1,0
0,0,0,0,allow,707,707,0,2,0,2,0
53121,8986,41857,8986,allow,70,70,0,2,8,2,0
58825,443,1318,443,allow,6357,4318,2039,22,16,11,11
53800,445,0,0,drop,66,66,0,1,0,1,0
49671,53,50695,53,allow,335,117,218,4,36,2,2
36000,443,6421,443,allow,68705,5084,63621,93,172,36,57
43632,80,17222,80,allow,2000,710,1290,8,15,5,3
22542,30188,0,0,deny,146,146,0,1,0,1,0
54030,443,52354,443,allow,249900,26024,223876,450,167,183,267
63385,445,0,0,drop,66,66,0,1,0,1,0
52016,58318,42027,58318,allow,66,66,0,1,5,1,0
61196,53,61196,53,allow,213,79,134,2,32,1,1
47135,53,52086,53,allow,199,94,105,2,30,1,1
56214,53,47113,53,allow,200,102,98,2,33,1,1
64603,34021,0,0,allow,66,66,0,1,90,1,0
50572,443,24489,443,allow,5867,1782,4085,21,80,12,9
57335,53,58927,53,allow,177,94,83,2,30,1,1
443,36576,0,0,deny,60,60,0,1,0,1,0
49966,80,31375,80,allow,1210,788,422,9,33,5,4
49167,19750,0,0,deny,66,66,0,1,0,1,0
56701,445,0,0,drop,70,70,0,1,0,1,0
51631,443,52849,443,allow,36602,1919,34683,58,80,19,39
50106,53,61175,53,allow,209,110,99,2,30,1,1
34553,48637,0,0,deny,60,60,0,1,0,1,0
10886,51505,0,0,deny,62,62,0,1,0,1,0
58982,443,29770,443,allow,6400453,202937,6197516,6806,226,2259,4547
48817,51414,48817,51414,allow,150,150,0,1,1200,1,0
27076,80,27076,80,allow,6337,947,5390,15,17,8,7
56410,445,0,0,drop,66,66,0,1,0,1,0
64618,445,0,0,drop,66,66,0,1,0,1,0
49483,7000,49483,7000,allow,755531,16955,738576,785,16,265,520
63673,445,0,0,drop,70,70,0,1,0,1,0
20706,37965,0,0,deny,62,62,0,1,0,1,0
57893,445,0,0,drop,70,70,0,1,0,1,0
56344,53,2417,53,allow,199,102,97,2,30,1,1
49749,445,0,0,drop,70,70,0,1,0,1,0
60797,445,0,0,drop,70,70,0,1,0,1,0
65382,445,0,0,drop,70,70,0,1,0,1,0
58661,443,49876,443,allow,2956,790,2166,10,120,5,5
56038,53,24286,53,allow,177,94,83,2,30,1,1
57470,6881,47770,6881,allow,330,330,0,6,1200,6,0
34752,3389,34752,3389,allow,3910,1805,2105,20,18,12,8
49697,53,7185,53,allow,195,94,101,2,30,1,1
55076,53,43465,53,allow,183,94,89,2,30,1,1
58638,5900,0,0,deny,62,62,0,1,0,1,0
49742,53,51185,53,allow,216,110,106,2,30,1,1
49354,53,16501,53,allow,196,102,94,2,30,1,1
123,123,14772,123,allow,184,94,90,2,29,1,1
26324,30188,0,0,deny,62,62,0,1,0,1,0
57604,32480,0,0,deny,62,62,0,1,0,1,0
58373,443,64061,443,allow,78832,12408,66424,109,162,46,63
31738,51505,0,0,deny,62,62,0,1,0,1,0
51986,80,28001,80,allow,1420,888,532,11,49,7,4
58840,443,27383,443,allow,5108,700,4408,15,15,7,8
55883,53,20281,53,allow,189,102,87,2,30,1,1
63205,9571,0,0,deny,66,66,0,1,0,1,0
39661,7275,31233,7275,allow,8822,1485,7337,26,15,13,13
53473,445,0,0,drop,70,70,0,1,0,1,0
50491,80,59883,80,allow,318,192,126,6,25,4,2
53514,8999,20953,8999,allow,70,70,0,1,5,1,0
57378,53,5726,53,allow,350,94,256,2,30,1,1
55805,80,55805,80,allow,424,198,226,7,141,4,3
65275,53,14086,53,allow,168,86,82,2,31,1,1
60045,80,49980,80,allow,1455,965,490,10,142,6,4
61508,445,0,0,drop,70,70,0,1,0,1,0
59998,445,0,0,drop,70,70,0,1,0,1,0
38637,443,8499,443,allow,12339,2392,9947,36,287,15,21
57546,25174,0,0,deny,66,66,0,1,0,1,0
64617,445,0,0,drop,70,70,0,1,0,1,0
49699,53,32857,53,allow,266,89,177,4,58,2,2
64657,53,35491,53,allow,370,96,274,4,39,2,2
27005,27018,4129,27018,allow,881,126,755,2,30,1,1
58638,5900,0,0,deny,62,62,0,1,0,1,0
63968,53,62729,53,allow,200,102,98,2,30,1,1
42630,443,10044,443,allow,6039,1327,4712,19,121,11,8
58638,5900,0,0,deny,62,62,0,1,0,1,0
6881,6882,26617,6882,allow,231,111,120,2,1200,1,1
61463,443,9374,443,allow,11355,3474,7881,45,93,22,23
56040,445,0,0,drop,70,70,0,1,0,1,0
44577,53,21603,53,allow,199,94,105,2,30,1,1
64723,53,45766,53,allow,329,118,211,2,30,1,1
0,0,0,0,allow,244,244,0,2,0,2,0
50913,445,0,0,drop,70,70,0,1,0,1,0
11859,64147,0,0,deny,62,62,0,1,0,1,0
64741,53,19831,53,allow,420,110,310,2,30,1,1
55117,445,0,0,drop,70,70,0,1,0,1,0
59523,445,0,0,drop,70,70,0,1,0,1,0
40479,35993,0,0,deny,62,62,0,1,0,1,0
57903,445,0,0,drop,70,70,0,1,0,1,0
49253,53,20812,53,allow,198,101,97,2,30,1,1
59125,445,0,0,drop,70,70,0,1,0,1,0
49608,53,36244,53,allow,177,94,83,2,31,1,1
26843,53,26843,53,allow,209,77,132,2,33,1,1
52199,35549,28334,35549,allow,66,66,0,2,10,2,0
49418,27016,64137,27016,allow,270,78,192,2,30,1,1
62935,445,0,0,drop,66,66,0,1,0,1,0
52037,80,5136,80,allow,366,240,126,7,25,5,2
58997,443,39971,443,allow,3576,2319,1257,21,23,11,10
51535,64147,0,0,deny,62,62,0,1,0,1,0
54092,445,0,0,drop,70,70,0,1,0,1,0
45554,443,45554,443,allow,4617,1710,2907,19,26,11,8
50440,80,41548,80,allow,318,192,126,6,26,4,2
55337,53,41001,53,allow,198,102,96,2,29,1,1
63923,59177,7249,59177,allow,66,66,0,2,7,2,0
49238,445,0,0,drop,70,70,0,1,0,1,0
50352,80,51125,80,allow,2537,783,1754,13,25,7,6
55083,53,43737,53,allow,751,95,656,2,30,1,1
58638,5900,0,0,deny,62,62,0,1,0,1,0
24560,25174,0,0,deny,62,62,0,1,0,1,0
53060,445,0,0,drop,70,70,0,1,0,1,0
51457,443,49898,443,allow,642,582,60,2,15,1,1
49521,53,30278,53,allow,183,94,89,2,30,1,1
57318,443,57308,443,allow,10504,1787,8717,27,364,12,15
49978,53,55753,53,allow,195,102,93,2,30,1,1
53839,15000,61295,15000,allow,130,70,60,2,5,1,1
55912,53,46949,53,allow,184,94,90,2,30,1,1
35216,123,45101,123,allow,184,94,90,2,30,1,1
44098,1433,0,0,deny,60,60,0,1,0,1,0
52274,80,52274,80,allow,852970,14195,838775,769,28,207,562
54909,445,0,0,drop,66,66,0,1,0,1,0
63282,445,0,0,drop,70,70,0,1,0,1,0
41101,443,39031,443,allow,7067,2430,4637,18,17,8,10
54598,53,30660,53,allow,168,78,90,2,30,1,1
49716,443,56032,443,allow,4653,785,3868,14,52,6,8
42861,443,12903,443,allow,2337,1394,943,17,275,9,8
55841,53,22596,53,allow,265,86,179,4,59,2,2
50324,53,1643,53,allow,754,94,660,2,31,1,1
56529,445,0,0,drop,66,66,0,1,0,1,0
56148,37965,0,0,deny,66,66,0,1,0,1,0
62497,443,15059,443,allow,10393,7059,3334,27,26,15,12
27005,27015,15666,27015,allow,876,126,750,2,30,1,1
51699,445,0,0,drop,66,66,0,1,0,1,0
52056,50328,8366,50328,allow,70,70,0,1,5,1,0
65317,51221,0,0,deny,78,78,0,1,0,1,0
56018,53,52062,53,allow,762,97,665,2,30,1,1
49418,27015,20912,27015,allow,302,78,224,2,30,1,1
27233,53,27233,53,allow,213,87,126,2,31,1,1
49499,445,0,0,drop,70,70,0,1,0,1,0
57093,26467,0,0,deny,66,66,0,1,0,1,0
57212,53,19775,53,allow,780,104,676,2,31,1,1
54024,443,29413,443,allow,7653,1188,6465,21,16,12,9
64467,53,41082,53,allow,548,194,354,6,63,3,3
51385,161,51385,161,allow,2315,979,1336,10,30,5,5
62387,80,62387,80,allow,548903,4452,544451,440,20,58,382
54472,80,34355,80,allow,13695,1377,12318,26,255,14,12
64340,445,0,0,drop,66,66,0,1,0,1,0
43681,443,22567,443,allow,40598,5313,35285,83,97,43,40
37571,53,19977,53,allow,164,78,86,2,30,1,1
443,62451,0,0,deny,199,199,0,1,0,1,0
12632,25174,0,0,deny,146,146,0,1,0,1,0
40481,22114,0,0,deny,66,66,0,1,0,1,0
56623,80,56144,80,allow,234,234,0,4,12,4,0
52107,53,0,0,allow,621,77,544,2,29,1,1
56705,53,36648,53,allow,711,87,624,2,30,1,1
39839,67,0,0,deny,60,60,0,1,0,1,0
49478,80,36631,80,allow,28629,4862,23767,33,39,13,20
54636,26467,0,0,deny,62,62,0,1,0,1,0
55698,45710,26352,45710,allow,70,70,0,2,8,2,0
53847,443,28382,443,allow,499,425,74,4,0,3,1
64068,445,0,0,drop,70,70,0,1,0,1,0
53209,8081,13912,8081,allow,5349,1928,3421,17,114,10,7
55524,46232,0,0,deny,62,62,0,1,0,1,0
52118,443,25040,443,allow,22072,2166,19906,44,49,22,22
50513,443,44199,443,allow,9766,1810,7956,30,86,16,14
54973,53,20292,53,allow,181,94,87,2,30,1,1
64175,56502,0,0,deny,66,66,0,1,0,1,0
46271,7700,56460,7700,allow,1440,956,484,15,36,8,7
60014,445,0,0,drop,70,70,0,1,0,1,0
60292,7129,0,0,deny,62,62,0,1,0,1,0
49202,445,0,0,drop,66,66,0,1,0,1,0
36262,53,36262,53,allow,216,90,126,2,30,1,1
51919,10298,57387,10298,allow,70,70,0,1,5,1,0
51035,445,0,0,drop,66,66,0,1,0,1,0
56595,445,0,0,drop,66,66,0,1,0,1,0
51977,18504,24364,18504,allow,70,70,0,2,8,2,0
56989,53,25786,53,allow,168,94,74,2,30,1,1
64733,53,63976,53,allow,889,404,485,10,30,5,5
65005,53,27346,53,allow,776,102,674,2,30,1,1
16948,990,0,0,deny,60,60,0,1,0,1,0
59404,53,59404,53,allow,237,91,146,2,32,1,1
58239,445,0,0,drop,70,70,0,1,0,1,0
58900,37807,0,0,deny,66,66,0,1,0,1,0
50951,445,0,0,drop,70,70,0,1,0,1,0
62971,44847,0,0,deny,66,66,0,1,0,1,0
10976,22,10976,22,allow,9240,3413,5827,59,37,26,33
64912,53,47656,53,allow,183,94,89,2,30,1,1
52128,445,0,0,drop,70,70,0,1,0,1,0
55549,53,55549,53,allow,228,90,138,2,30,1,1
58972,80,64079,80,allow,943,513,430,9,14,6,3
57207,53,55086,53,allow,195,102,93,2,30,1,1
55942,53,36132,53,allow,197,102,95,2,30,1,1
60152,26467,0,0,deny,62,62,0,1,0,1,0
49686,44847,0,0,deny,66,66,0,1,0,1,0
53061,445,0,0,drop,70,70,0,1,0,1,0
49272,445,0,0,drop,66,66,0,1,0,1,0
45099,123,62953,123,allow,184,94,90,2,30,1,1
57406,53,60835,53,allow,188,96,92,2,30,1,1
20270,3478,6426,3478,allow,443,294,149,2,300,1,1
50038,53,0,0,allow,275,85,190,2,31,1,1
57134,53,41374,53,allow,195,102,93,2,30,1,1
64022,53,2782,53,allow,197,102,95,2,30,1,1
51679,445,0,0,drop,70,70,0,1,0,1,0
58145,445,0,0,drop,70,70,0,1,0,1,0
49996,445,0,0,drop,70,70,0,1,0,1,0
62012,445,0,0,drop,70,70,0,1,0,1,0
53559,445,0,0,drop,66,66,0,1,0,1,0
60048,443,33885,443,allow,12254,3186,9068,27,171,13,14
52164,443,1593,443,allow,161883,8848,153035,177,54,64,113
57033,443,35994,443,allow,1092898,42451,1050447,1213,155,423,790
63585,445,0,0,drop,66,66,0,1,0,1,0
3964,51505,0,0,deny,62,62,0,1,0,1,0
49456,445,0,0,drop,66,66,0,1,0,1,0
8916,443,25420,443,allow,7685,1016,6669,29,413,11,18
64150,22114,0,0,deny,66,66,0,1,0,1,0
61536,445,0,0,drop,66,66,0,1,0,1,0
52430,35440,0,0,deny,62,62,0,1,0,1,0
64089,20260,49392,20260,allow,66,66,0,1,5,1,0
65000,445,0,0,drop,70,70,0,1,0,1,0
56448,53,33079,53,allow,200,102,98,2,30,1,1
1537,22114,0,0,deny,62,62,0,1,0,1,0
58904,445,0,0,drop,66,66,0,1,0,1,0
49292,53,63112,53,allow,323,94,229,2,31,1,1
49384,53,17338,53,allow,181,94,87,2,31,1,1
60723,445,0,0,drop,70,70,0,1,0,1,0
58459,445,0,0,drop,70,70,0,1,0,1,0
10115,52700,0,0,deny,62,62,0,1,0,1,0
53267,443,33925,443,allow,6156,2009,4147,26,18,14,12
51814,445,0,0,drop,66,66,0,1,0,1,0
65234,53,35438,53,allow,193,102,91,2,30,1,1
61642,445,0,0,drop,66,66,0,1,0,1,0
64588,53,5541,53,allow,264,102,162,2,30,1,1
27005,27016,36126,27016,allow,883,126,757,2,30,1,1
56462,37965,0,0,deny,66,66,0,1,0,1,0
62018,445,0,0,drop,70,70,0,1,0,1,0
12031,36237,0,0,deny,66,66,0,1,0,1,0
61081,445,0,0,drop,66,66,0,1,0,1,0
65304,53,52702,53,allow,194,86,108,2,29,1,1
42602,443,64444,443,allow,2378,1126,1252,14,982,7,7
45726,64147,0,0,deny,62,62,0,1,0,1,0
57343,53,32639,53,allow,181,94,87,2,31,1,1
58338,3369,0,0,deny,60,60,0,1,0,1,0
59932,443,1750,443,allow,333535,35190,298345,555,285,257,298
55456,443,5231,443,allow,7409,2302,5107,19,135,9,10
35749,18375,0,0,deny,146,146,0,1,0,1,0
59282,51050,0,0,deny,66,66,0,1,0,1,0
50514,445,0,0,drop,70,70,0,1,0,1,0
58638,5900,0,0,deny,62,62,0,1,0,1,0
52960,80,43936,80,allow,82011,2937,79074,91,358,34,57
63683,445,0,0,drop,66,66,0,1,0,1,0
45461,25174,0,0,deny,146,146,0,1,0,1,0
62732,443,28854,443,allow,50000,36438,13562,98,336,61,37
3478,61463,0,0,deny,1188,1188,0,1,0,1,0
43676,80,45378,80,allow,696,378,318,12,35,7,5
55642,26872,53975,26872,allow,70,70,0,2,8,2,0
57570,443,58853,443,allow,6226,4213,2013,30,79,18,12
65225,53,58694,53,allow,199,102,97,2,30,1,1
63934,53,38044,53,allow,209,110,99,2,30,1,1
50548,443,50022,443,allow,9277,2865,6412,31,200,18,13
55097,53,3886,53,allow,324,102,222,4,42,2,2
57925,443,19196,443,allow,43126,33414,9712,214,220,108,106
53828,2323,0,0,deny,60,60,0,1,0,1,0
45017,443,13860,443,allow,11771,2624,9147,50,20,25,25
50458,53,16491,53,allow,458,188,270,6,30,3,3
53702,445,0,0,drop,66,66,0,1,0,1,0
10914,35974,0,0,deny,60,60,0,1,0,1,0
49477,53,25866,53,allow,183,86,97,2,30,1,1
53447,445,0,0,drop,66,66,0,1,0,1,0
6881,6881,13981,6881,allow,150,150,0,1,1200,1,0
58638,5900,0,0,deny,62,62,0,1,0,1,0
57470,44822,45311,44822,allow,132,132,0,3,1200,3,0
45169,443,45169,443,allow,282,140,142,5,152,3,2
64975,27033,50776,27033,allow,734,462,272,2,30,1,1
50394,445,0,0,drop,70,70,0,1,0,1,0
65085,445,0,0,drop,70,70,0,1,0,1,0
38168,443,45970,443,allow,6136,1404,4732,20,979,10,10
49329,443,27397,443,allow,460,394,66,4,0,3,1
64002,15503,0,0,deny,146,146,0,1,0,1,0
39318,443,24928,443,allow,6933,2226,4707,33,140,18,15
49593,53,21447,53,allow,762,98,664,2,31,1,1
12605,57470,0,0,deny,62,62,0,1,0,1,0
53403,443,55979,443,allow,38342,14090,24252,83,159,40,43
53017,443,37363,443,allow,15038,4142,10896,48,108,24,24
55759,53,54947,53,allow,756,95,661,2,30,1,1
51009,445,0,0,drop,66,66,0,1,0,1,0
60416,37965,0,0,deny,66,66,0,1,0,1,0
59343,445,0,0,drop,66,66,0,1,0,1,0
60370,445,0,0,drop,66,66,0,1,0,1,0
41317,443,52322,443,allow,4555,2276,2279,27,244,9,18
55851,53,42151,53,allow,277,110,167,2,30,1,1
51824,53021,25345,53021,allow,66,66,0,2,8,2,0
63734,28221,59198,28221,allow,66,66,0,2,7,2,0
30960,45676,24387,45676,allow,396,396,0,7,3616,7,0
56629,25174,0,0,deny,66,66,0,1,0,1,0
49269,53,5251,53,allow,198,110,88,2,29,1,1
54816,35440,0,0,deny,62,62,0,1,0,1,0
52066,60118,49058,60118,allow,70,70,0,1,5,1,0
55840,53,9224,53,allow,170,87,83,2,30,1,1
57150,53,60378,53,allow,177,94,83,2,29,1,1
42532,22114,0,0,deny,62,62,0,1,0,1,0
50657,445,0,0,drop,70,70,0,1,0,1,0
60752,28080,10717,28080,allow,70,70,0,1,5,1,0
51221,1338,12971,1338,allow,132,132,0,3,1200,3,0
50442,80,8641,80,allow,378,192,186,7,19,4,3
52801,443,38731,443,allow,8308,3201,5107,36,1401,19,17
49650,53,42506,53,allow,248,110,138,2,30,1,1
56639,53,47791,53,allow,168,86,82,2,32,1,1
58876,443,42159,443,allow,19357,12948,6409,47,18,26,21
40885,443,32340,443,allow,4014,1592,2422,17,147,9,8
41783,443,41782,443,allow,23344,2097,21247,39,15,18,21
49424,53,36639,53,allow,210,102,108,2,30,1,1
55727,53,2697,53,allow,195,102,93,2,31,1,1
65085,22114,0,0,deny,66,66,0,1,0,1,0
44849,46478,0,0,deny,74,74,0,1,0,1,0
56111,53,5335,53,allow,179,94,85,2,30,1,1
53085,445,0,0,drop,70,70,0,1,0,1,0
55567,53,55567,53,allow,216,90,126,2,30,1,1
44068,443,30325,443,allow,3947,1744,2203,16,361,8,8
64106,53,52132,53,allow,195,102,93,2,29,1,1
49722,53,50235,53,allow,168,78,90,2,30,1,1
49959,80,5453,80,allow,9763,749,9014,17,15,8,9
58919,443,29317,443,allow,5166,700,4466,16,15,7,9
56361,445,0,0,drop,70,70,0,1,0,1,0
49449,53,15422,53,allow,216,110,106,2,30,1,1
50928,445,0,0,drop,66,66,0,1,0,1,0
50605,80,50605,80,allow,2909,1798,1111,14,23,8,6
55102,53,40717,53,allow,190,97,93,2,30,1,1
4431,32480,0,0,deny,66,66,0,1,0,1,0
49907,53,22787,53,allow,199,102,97,2,30,1,1
63832,25174,0,0,deny,62,62,0,1,0,1,0
40847,25174,0,0,deny,146,146,0,1,0,1,0
65250,53,12810,53,allow,900,110,790,2,30,1,1
49981,53,18517,53,allow,200,94,106,2,30,1,1
64046,18318,32519,18318,allow,3197,1526,1671,19,26,12,7
59782,53,21953,53,allow,168,78,90,2,30,1,1
46770,443,32021,443,allow,90614,3825,86789,108,214,42,66
55012,53,50167,53,allow,275,110,165,2,30,1,1
63804,445,0,0,drop,70,70,0,1,0,1,0
57470,22468,25297,22468,allow,726,726,0,12,1200,12,0
64307,53,35303,53,allow,241,94,147,2,30,1,1
50584,18047,33742,18047,allow,851,369,482,5,1200,3,2
56684,53,5087,53,allow,194,94,100,2,30,1,1
34135,443,33569,443,allow,9932,1987,7945,22,16,12,10
54452,445,0,0,drop,66,66,0,1,0,1,0
51764,443,27947,443,allow,5660,3864,1796,27,95,14,13
56155,53,9723,53,allow,199,102,97,2,30,1,1
47037,1,0,0,deny,62,62,0,1,0,1,0
49886,443,58788,443,allow,77867,2411,75456,82,87,27,55
62536,445,0,0,drop,66,66,0,1,0,1,0
53209,443,56508,443,allow,11086,2564,8522,42,186,21,21
49820,53,12064,53,allow,186,95,91,2,31,1,1
50283,80,41911,80,allow,5689,1015,4674,16,45,8,8
53156,445,0,0,drop,70,70,0,1,0,1,0
2422,62507,0,0,deny,66,66,0,1,0,1,0
41541,25174,0,0,deny,66,66,0,1,0,1,0
57260,51221,0,0,deny,66,66,0,1,0,1,0
48344,443,64214,443,allow,2588313,95154,2493159,2645,190,811,1834
34301,21247,0,0,deny,146,146,0,1,0,1,0
51712,443,2406,443,allow,66148,6145,60003,116,80,60,56
50917,445,0,0,drop,66,66,0,1,0,1,0
36883,80,30047,80,allow,114410,3755,110655,128,38,47,81
65449,53,42820,53,allow,723,102,621,2,30,1,1
49624,80,29847,80,allow,3314,1478,1836,16,41,9,7
41197,30188,0,0,deny,62,62,0,1,0,1,0
5213,44847,0,0,deny,66,66,0,1,0,1,0
51882,15733,38796,15733,allow,70,70,0,2,8,2,0
49518,443,56139,443,allow,7834,1758,6076,26,171,13,13
43345,443,34624,443,allow,7767,1069,6698,23,3971,7,16
64880,445,0,0,drop,70,70,0,1,0,1,0
63129,445,0,0,drop,70,70,0,1,0,1,0
32722,25174,0,0,deny,62,62,0,1,0,1,0
38163,53,38163,53,allow,216,89,127,2,30,1,1
58956,445,0,0,drop,66,66,0,1,0,1,0
58638,5900,0,0,deny,62,62,0,1,0,1,0
49983,53,2734,53,allow,211,110,101,2,30,1,1
56963,53,37570,53,allow,199,102,97,2,29,1,1
55049,443,10286,443,allow,12851,3808,9043,30,61,16,14
50,64147,0,0,deny,66,66,0,1,0,1,0
63925,18912,12626,18912,allow,70,70,0,1,4,1,0
65064,53,64961,53,allow,197,94,103,2,30,1,1
9552,57470,0,0,deny,62,62,0,1,0,1,0
38643,443,16669,443,allow,2540,1317,1223,17,28,9,8
64943,53,17729,53,allow,341,110,231,2,29,1,1
50369,443,20659,443,allow,8048,1189,6859,19,25,10,9
53928,47287,32055,47287,allow,612,306,306,10,14,5,5
55376,53,64673,53,allow,198,101,97,2,31,1,1
33886,52255,0,0,deny,162,162,0,1,0,1,0
50316,80,40877,80,allow,2062,872,1190,13,83,7,6
65322,443,20624,443,allow,8429792,268889,8160903,8985,135,2983,6002
59834,445,0,0,drop,70,70,0,1,0,1,0
36099,443,35934,443,allow,5901,1324,4577,25,50,14,11
28584,37965,0,0,deny,62,62,0,1,0,1,0
65239,53,57855,53,allow,489,185,304,6,73,3,3
60213,445,0,0,drop,70,70,0,1,0,1,0
55531,80,42208,80,allow,3277,2255,1022,18,39,10,8
49847,445,0,0,drop,70,70,0,1,0,1,0
17232,22114,0,0,deny,62,62,0,1,0,1,0
59654,445,0,0,drop,70,70,0,1,0,1,0
55248,445,0,0,drop,70,70,0,1,0,1,0
6666,21,0,0,deny,60,60,0,1,0,1,0
63580,443,12197,443,allow,5759,1721,4038,20,78,11,9
58731,445,0,0,drop,70,70,0,1,0,1,0
49563,53,8253,53,allow,200,102,98,2,30,1,1
6666,2222,0,0,deny,60,60,0,1,0,1,0
52625,25174,0,0,deny,62,62,0,1,0,1,0
57684,445,0,0,drop,66,66,0,1,0,1,0
48471,443,48471,443,allow,4381,1474,2907,19,26,11,8
51026,445,0,0,drop,70,70,0,1,0,1,0
59791,445,0,0,drop,66,66,0,1,0,1,0
62186,445,0,0,drop,66,66,0,1,0,1,0
56963,80,25455,80,allow,6974,3906,3068,19,30,11,8
34200,443,26443,443,allow,7341,2121,5220,18,135,8,10
64915,53,41416,53,allow,177,94,83,2,31,1,1
13588,15503,0,0,deny,62,62,0,1,0,1,0
63984,15847,44273,15847,allow,1344,819,525,14,15,8,6
54011,44847,0,0,deny,66,66,0,1,0,1,0
55097,53,65390,53,allow,170,87,83,2,31,1,1
46986,443,11457,443,allow,2809,1884,925,19,27,11,8
55553,53,13806,53,allow,199,94,105,2,29,1,1
51841,445,0,0,drop,70,70,0,1,0,1,0
64808,53,34038,53,allow,239,94,145,2,30,1,1
51717,445,0,0,drop,70,70,0,1,0,1,0
56658,53,34980,53,allow,458,188,270,6,30,3,3
62029,36237,0,0,deny,66,66,0,1,0,1,0
53913,28402,62039,28402,allow,70,70,0,2,7,2,0
63696,445,0,0,drop,70,70,0,1,0,1,0
52119,443,11235,443,allow,10583,3353,7230,32,83,16,16
56296,53,37666,53,allow,216,110,106,2,30,1,1
9199,80,13955,80,allow,60838,1648,59190,68,27,25,43
55418,53,32806,53,allow,168,86,82,2,30,1,1
57235,443,36461,443,allow,8954,3404,5550,34,46,19,15
43185,50584,0,0,deny,146,146,0,1,0,1,0
47856,443,54908,443,allow,7816,2371,5445,34,255,18,16
62982,445,0,0,drop,70,70,0,1,0,1,0
61907,445,0,0,drop,70,70,0,1,0,1,0
51404,445,0,0,drop,70,70,0,1,0,1,0
51442,443,61245,443,allow,4591,3237,1354,18,271,10,8
53337,445,0,0,drop,70,70,0,1,0,1,0
50740,445,0,0,drop,70,70,0,1,0,1,0
42108,23,0,0,deny,60,60,0,1,0,1,0
46367,36237,0,0,deny,66,66,0,1,0,1,0
58638,5900,0,0,deny,62,62,0,1,0,1,0
13943,22,0,0,deny,60,60,0,1,0,1,0
55529,44847,0,0,deny,66,66,0,1,0,1,0
49367,443,60799,443,allow,22639,7456,15183,32,16,17,15
56745,443,12454,443,allow,8058,2038,6020,20,15,11,9
54478,445,0,0,drop,70,70,0,1,0,1,0
58638,5900,0,0,deny,62,62,0,1,0,1,0
62108,443,7391,443,allow,9652,2914,6738,22,124,11,11
1026,30188,0,0,deny,62,62,0,1,0,1,0
50434,80,31890,80,allow,318,192,126,6,26,4,2
61016,443,27858,443,allow,56191,3435,52756,81,271,37,44
65216,35440,0,0,deny,66,66,0,1,0,1,0
35888,443,35888,443,allow,4481,1574,2907,19,26,11,8
9064,443,8179,443,allow,11738,6980,4758,34,81,19,15
62459,445,0,0,drop,66,66,0,1,0,1,0
45964,3111,0,0,deny,60,60,0,1,0,1,0
65078,445,0,0,drop,66,66,0,1,0,1,0
60433,6881,35052,6881,allow,70,70,0,1,5,1,0
64559,53,32115,53,allow,193,102,91,2,29,1,1
46211,443,8239,443,allow,9805,1642,8163,24,362,12,12
54872,53,11458,53,allow,578,286,292,9,15,5,4
59411,37965,0,0,deny,62,62,0,1,0,1,0
443,6793,0,0,allow,169,169,0,2,90,2,0
64827,445,0,0,drop,70,70,0,1,0,1,0
10002,80,8568,80,allow,3759,741,3018,15,45,8,7
43676,443,26633,443,allow,5903,1367,4536,18,16,10,8
44554,5900,0,0,deny,60,60,0,1,0,1,0
64626,50584,0,0,deny,62,62,0,1,0,1,0
56586,53,50469,53,allow,177,94,83,2,29,1,1
65159,53,25271,53,allow,286,103,183,4,52,2,2
1024,35894,0,0,deny,62,62,0,1,0,1,0
52111,44847,0,0,deny,66,66,0,1,0,1,0
65289,53,7871,53,allow,179,94,85,2,31,1,1
16454,25174,0,0,deny,66,66,0,1,0,1,0
56560,53,34693,53,allow,196,100,96,2,31,1,1
50265,35344,29716,35344,allow,1386,1386,0,22,2342,22,0
56511,445,0,0,drop,70,70,0,1,0,1,0
57442,66,38674,66,allow,70,70,0,1,5,1,0
49858,443,3076,443,allow,16232,3319,12913,23,124,9,14
61983,50432,0,0,deny,66,66,0,1,0,1,0
53109,445,0,0,drop,66,66,0,1,0,1,0
57802,80,24943,80,allow,2762,2628,134,8,17,6,2
56663,80,6268,80,allow,234,234,0,4,12,4,0
56646,48817,0,0,deny,62,62,0,1,0,1,0
57335,53,28128,53,allow,185,102,83,2,30,1,1
55868,53,29665,53,allow,198,110,88,2,29,1,1
50276,445,0,0,drop,66,66,0,1,0,1,0
58085,57470,0,0,deny,62,62,0,1,0,1,0
55084,53,64405,53,allow,177,94,83,2,29,1,1
52029,445,0,0,drop,70,70,0,1,0,1,0
49597,53,32706,53,allow,168,86,82,2,31,1,1
55115,443,23390,443,allow,1348,687,661,14,18,8,6
49502,53,58398,53,allow,193,102,91,2,30,1,1
54455,443,48160,443,allow,282,148,134,5,27,3,2
64066,23718,0,0,deny,66,66,0,1,0,1,0
49393,445,0,0,drop,70,70,0,1,0,1,0
61336,445,0,0,drop,70,70,0,1,0,1,0
55310,53,40255,53,allow,168,78,90,2,29,1,1
55487,53,40739,53,allow,199,102,97,2,30,1,1
42894,443,60082,443,allow,448,78,370,6,25,1,5
56296,53,27962,53,allow,216,110,106,2,30,1,1
57173,53,12903,53,allow,216,110,106,2,31,1,1
55601,445,0,0,drop,70,70,0,1,0,1,0
56256,80,30485,80,allow,25043,1750,23293,44,30,23,21
8592,35993,0,0,deny,62,62,0,1,0,1,0
54201,443,55731,443,allow,499,425,74,4,0,3,1
45908,33330,0,0,deny,60,60,0,1,0,1,0
26758,50584,0,0,deny,62,62,0,1,0,1,0
36756,443,3567,443,allow,6112,1553,4559,18,16,10,8
51616,15000,27735,15000,allow,130,70,60,2,6,1,1
26254,56205,0,0,deny,66,66,0,1,0,1,0
58954,443,36028,443,allow,5166,700,4466,16,15,7,9
55305,53,21908,53,allow,94,94,0,1,30,1,0
61764,445,0,0,drop,70,70,0,1,0,1,0
50493,443,55037,443,allow,8164,1206,6958,24,139,12,12
50056,27018,50062,27018,allow,546,390,156,6,30,4,2
25348,23,0,0,deny,60,60,0,1,0,1,0
57345,445,0,0,drop,66,66,0,1,0,1,0
62827,1,0,0,deny,66,66,0,1,0,1,0
57299,53,60240,53,allow,338,110,228,2,30,1,1
63888,57470,0,0,deny,62,62,0,1,0,1,0
57177,53,13049,53,allow,179,94,85,2,30,1,1
46046,443,33761,443,allow,11019,4673,6346,32,423,17,15
57467,443,57467,443,allow,4373,1466,2907,19,27,11,8
55151,445,0,0,drop,70,70,0,1,0,1,0
60000,443,1189,443,allow,34450,1943,32507,47,144,16,31
56377,51505,0,0,deny,66,66,0,1,0,1,0
52258,445,0,0,drop,70,70,0,1,0,1,0
46576,23718,0,0,deny,66,66,0,1,0,1,0
49268,53,9594,53,allow,200,94,106,2,30,1,1
60018,443,30525,443,allow,8127,1796,6331,21,79,12,9
57385,53,7964,53,allow,197,102,95,2,30,1,1
56640,443,54047,443,allow,8735,1819,6916,23,30,14,9
49654,53,46255,53,allow,775,102,673,2,30,1,1
56388,443,41257,443,allow,15485,8351,7134,71,130,40,31
63089,445,0,0,drop,70,70,0,1,0,1,0
58350,445,0,0,drop,70,70,0,1,0,1,0
63140,30685,24929,30685,allow,70,70,0,1,5,1,0
9323,443,4707,443,allow,26959,1764,25195,42,48,18,24
64252,53,36702,53,allow,198,101,97,2,31,1,1
52050,31648,38816,31648,allow,70,70,0,1,5,1,0
56246,53,10681,53,allow,816,97,719,2,31,1,1
53123,59228,32782,59228,allow,70,70,0,2,8,2,0
54716,445,0,0,drop,66,66,0,1,0,1,0
49686,443,60868,443,allow,8475,1661,6814,32,76,14,18
26810,5033,0,0,deny,145,145,0,1,0,1,0
3377,50584,0,0,deny,66,66,0,1,0,1,0
55340,53,11264,53,allow,184,94,90,2,30,1,1
26755,443,24399,443,allow,7283,2586,4697,22,19,11,11
53376,22114,0,0,deny,62,62,0,1,0,1,0
10005,40022,7541,40022,allow,151,89,62,2,30,1,1
60198,445,0,0,drop,70,70,0,1,0,1,0
55934,53,48489,53,allow,196,102,94,2,30,1,1
59923,53,59923,53,allow,365,233,132,3,33,2,1
50303,445,0,0,drop,66,66,0,1,0,1,0
61150,445,0,0,drop,66,66,0,1,0,1,0
35168,443,20668,443,allow,7447,2133,5314,27,348,14,13
37893,53,0,0,allow,86,86,0,1,30,1,0
49202,80,38617,80,allow,3223,605,2618,13,15,7,6
64592,443,64064,443,allow,24682,1935,22747,36,17,17,19
49412,443,56019,443,allow,46271,6834,39437,63,47,19,44
53595,28976,64230,28976,allow,492,306,186,8,15,5,3
50784,50584,0,0,deny,62,62,0,1,0,1,0
60657,445,0,0,drop,70,70,0,1,0,1,0
37988,49152,27635,49152,allow,156,156,0,3,7,3,0
36369,51505,0,0,deny,62,62,0,1,0,1,0
46438,53,32231,53,allow,222,78,144,2,30,1,1
63455,445,0,0,drop,66,66,0,1,0,1,0
45313,64147,0,0,deny,62,62,0,1,0,1,0
16518,64147,0,0,deny,145,145,0,1,0,1,0
56487,53,12533,53,allow,188,96,92,2,30,1,1
58638,5900,0,0,deny,62,62,0,1,0,1,0
60794,20010,2485,20010,allow,70,70,0,1,5,1,0
63455,445,0,0,drop,70,70,0,1,0,1,0
59673,445,0,0,drop,70,70,0,1,0,1,0
61920,53,61920,53,allow,298,114,184,2,30,1,1
56422,80,3635,80,allow,35833,938,34895,37,104,11,26
63143,16884,9026,16884,allow,618,318,300,10,16,5,5
53563,35440,0,0,deny,66,66,0,1,0,1,0
42382,443,39819,443,allow,4844,1099,3745,18,25,10,8
52925,443,23150,443,allow,5582,1388,4194,19,15,9,10
60441,443,36416,443,allow,3211,1964,1247,25,263,13,12
64619,53,25912,53,allow,179,94,85,2,31,1,1
54441,445,0,0,drop,70,70,0,1,0,1,0
61069,445,0,0,drop,70,70,0,1,0,1,0
63962,10115,25745,10115,allow,66,66,0,1,5,1,0
34692,80,34692,80,allow,3530,2851,679,13,20,8,5
34366,443,43232,443,allow,1053,566,487,10,16,6,4
63239,445,0,0,drop,70,70,0,1,0,1,0
58504,57470,0,0,deny,62,62,0,1,0,1,0
25523,35974,0,0,deny,62,62,0,1,0,1,0
14185,48637,0,0,deny,60,60,0,1,0,1,0
51522,445,0,0,drop,70,70,0,1,0,1,0
35722,123,29832,123,allow,94,94,0,1,30,1,0
60041,443,53446,443,allow,1015,572,443,11,142,6,5
60322,443,12700,443,allow,1743,1164,579,16,25,10,6
57842,53,57842,53,allow,225,87,138,2,30,1,1
52881,443,3297,443,allow,130,70,60,2,15,1,1
25363,23,0,0,deny,60,60,0,1,0,1,0
11136,19910,0,0,deny,62,62,0,1,0,1,0
59985,57470,0,0,deny,66,66,0,1,0,1,0
52066,80,29968,80,allow,692,300,392,9,26,6,3
49654,445,0,0,drop,66,66,0,1,0,1,0
58638,5900,0,0,deny,62,62,0,1,0,1,0
27005,50019,8990,50019,allow,877,126,751,2,31,1,1
50633,80,7997,80,allow,1717,1247,470,9,15,5,4
41959,443,65186,443,allow,5838,1840,3998,20,80,12,8
44358,443,57886,443,allow,502,288,214,8,131,5,3
56887,53,51812,53,allow,177,94,83,2,30,1,1
61974,445,0,0,drop,66,66,0,1,0,1,0
54066,443,63244,443,allow,307208,13249,293959,367,202,153,214
55580,53,20402,53,allow,195,102,93,2,30,1,1
50916,445,0,0,drop,70,70,0,1,0,1,0
56837,443,38721,443,allow,2349,258,2091,10,120,4,6
49245,53,3951,53,allow,190,97,93,2,31,1,1
56370,445,0,0,drop,70,70,0,1,0,1,0
55026,53,51536,53,allow,164,86,78,2,30,1,1
64738,53,34025,53,allow,402,118,284,2,30,1,1
55445,53,8991,53,allow,102,102,0,1,30,1,0
49549,443,14886,443,allow,19491,14463,5028,50,224,26,24
58665,445,0,0,drop,66,66,0,1,0,1,0
49544,80,16588,80,allow,10192,3818,6374,20,16,9,11
60299,445,0,0,drop,70,70,0,1,0,1,0
60319,23,0,0,deny,60,60,0,1,0,1,0
52226,445,0,0,drop,70,70,0,1,0,1,0
51781,445,0,0,deny,70,70,0,1,0,1,0
48631,443,20403,443,allow,42910,5005,37905,72,136,36,36
57306,53,57306,53,allow,220,90,130,2,30,1,1
49182,53,3761,53,allow,199,102,97,2,29,1,1
54071,445,0,0,drop,70,70,0,1,0,1,0
52439,445,0,0,drop,70,70,0,1,0,1,0
53275,21247,0,0,deny,66,66,0,1,0,1,0
57554,443,18344,443,allow,7323,2654,4669,23,30,13,10
62864,443,56821,443,allow,86513,10300,76213,131,137,54,77
5588,5588,0,0,allow,3354,1792,1562,46,196,23,23
56607,443,33013,443,allow,21604,12969,8635,49,112,28,21
62346,80,27241,80,allow,2328,580,1748,12,16,6,6
52064,43273,5722,43273,allow,70,70,0,2,7,2,0
50852,445,0,0,drop,70,70,0,1,0,1,0
49918,53,55343,53,allow,396,88,308,4,59,2,2
54111,62609,0,0,deny,148,148,0,1,0,1,0
61566,44847,0,0,deny,66,66,0,1,0,1,0
60301,445,0,0,drop,70,70,0,1,0,1,0
63964,445,0,0,drop,70,70,0,1,0,1,0
53862,445,0,0,drop,66,66,0,1,0,1,0
53979,26308,29256,26308,allow,70,70,0,1,4,1,0
57750,37965,0,0,deny,62,62,0,1,0,1,0
51221,57073,10928,57073,allow,481,150,331,2,1200,1,1
56489,443,54085,443,allow,75930,4291,71639,90,120,32,58
53864,24874,8342,24874,allow,320,140,180,6,6,3,3
50602,80,38980,80,allow,1658,1247,411,8,15,5,3
55410,53,27764,53,allow,711,87,624,2,30,1,1
36084,80,36084,80,allow,514,246,268,9,76,5,4
56496,445,0,0,drop,70,70,0,1,0,1,0
60369,445,0,0,drop,66,66,0,1,0,1,0
53582,40872,7897,40872,allow,492,306,186,8,16,5,3
49418,27015,33472,27015,allow,71,71,0,1,30,1,0
49418,57470,0,0,deny,62,62,0,1,0,1,0
49865,443,1213,443,allow,8535,1936,6599,22,87,12,10
62019,445,0,0,drop,70,70,0,1,0,1,0
52882,445,0,0,drop,70,70,0,1,0,1,0
51676,443,25301,443,allow,90135,76061,14074,251,247,132,119
54015,445,0,0,drop,70,70,0,1,0,1,0
52144,15208,55499,15208,allow,70,70,0,1,5,1,0
55990,53,40258,53,allow,182,93,89,2,30,1,1
47595,33435,0,0,allow,106,106,0,1,60,1,0
63642,445,0,0,drop,66,66,0,1,0,1,0
52599,445,0,0,drop,66,66,0,1,0,1,0
52240,52893,2825,52893,allow,66,66,0,1,5,1,0
49312,445,0,0,drop,66,66,0,1,0,1,0
50938,445,0,0,drop,66,66,0,1,0,1,0
61055,445,0,0,drop,70,70,0,1,0,1,0
59063,445,0,0,drop,66,66,0,1,0,1,0
51417,445,0,0,drop,70,70,0,1,0,1,0
443,60496,0,0,deny,60,60,0,1,0,1,0
54849,445,0,0,drop,70,70,0,1,0,1,0
56955,53,57810,53,allow,182,93,89,2,31,1,1
57342,53,37406,53,allow,166,85,81,2,31,1,1
58376,445,0,0,drop,70,70,0,1,0,1,0
60797,28080,22385,28080,allow,70,70,0,2,8,2,0
27005,27017,58319,27017,allow,883,126,757,2,30,1,1
57723,445,0,0,drop,70,70,0,1,0,1,0
49161,53,58630,53,allow,184,102,82,2,30,1,1
51738,7000,51738,7000,allow,3550,1983,1567,15,16,8,7
57131,443,18384,443,allow,6489,1065,5424,22,255,12,10
49516,53,40491,53,allow,183,94,89,2,30,1,1
65031,53,49062,53,allow,184,94,90,2,31,1,1
56562,44847,0,0,deny,62,62,0,1,0,1,0
51585,443,25112,443,allow,2840,330,2510,12,135,5,7
53129,38413,48065,38413,allow,70,70,0,2,8,2,0
64381,53,4400,53,allow,168,86,82,2,32,1,1
59509,64147,0,0,deny,62,62,0,1,0,1,0
48557,37965,0,0,deny,62,62,0,1,0,1,0
64535,53,14565,53,allow,763,101,662,2,30,1,1
61661,445,0,0,drop,70,70,0,1,0,1,0
49706,53,34052,53,allow,296,102,194,4,41,2,2
64113,445,0,0,drop,70,70,0,1,0,1,0
65229,53,65354,53,allow,190,97,93,2,31,1,1
6882,24271,34047,24271,allow,228,118,110,2,1200,1,1
4328,7302,0,0,deny,66,66,0,1,0,1,0
50919,445,0,0,drop,70,70,0,1,0,1,0
55281,53,41810,53,allow,236,94,142,2,30,1,1
51090,445,0,0,drop,70,70,0,1,0,1,0
59968,445,0,0,drop,70,70,0,1,0,1,0
3478,61463,0,0,deny,942,942,0,1,0,1,0
58338,3363,0,0,deny,60,60,0,1,0,1,0
35460,35440,0,0,deny,62,62,0,1,0,1,0
55367,53,11900,53,allow,195,102,93,2,30,1,1
34162,443,17948,443,allow,4897,850,4047,15,15,9,6
54657,445,0,0,drop,70,70,0,1,0,1,0
60527,35440,0,0,deny,66,66,0,1,0,1,0
27005,30002,50231,30002,allow,1780,252,1528,5,44,3,2
32551,51221,0,0,deny,62,62,0,1,0,1,0
54924,3478,2909,3478,allow,312,140,172,4,30,2,2
59977,30188,0,0,deny,66,66,0,1,0,1,0
55479,53,50336,53,allow,184,94,90,2,31,1,1
65311,53,5309,53,allow,198,94,104,2,30,1,1
58080,3389,58080,3389,allow,3564,1850,1714,18,32,10,8
19858,64147,0,0,deny,62,62,0,1,0,1,0
43479,443,6073,443,allow,6990,2019,4971,29,20,16,13
57808,53,57808,53,allow,222,90,132,2,30,1,1
60374,57470,0,0,deny,62,62,0,1,0,1,0
53732,22704,63994,22704,allow,70,70,0,2,8,2,0
58603,445,0,0,drop,70,70,0,1,0,1,0
57356,53,56372,53,allow,815,95,720,2,30,1,1
49598,445,0,0,drop,66,66,0,1,0,1,0
49487,53,26714,53,allow,183,94,89,2,31,1,1
58226,52848,0,0,deny,62,62,0,1,0,1,0
50265,43178,20188,43178,allow,481,150,331,2,1200,1,1
54752,31573,0,0,deny,66,66,0,1,0,1,0
62965,445,0,0,drop,70,70,0,1,0,1,0
26900,27017,8503,27017,allow,422,164,258,6,29,3,3
34234,993,0,0,deny,60,60,0,1,0,1,0
53688,17106,13403,17106,allow,70,70,0,1,4,1,0
5610,37965,0,0,deny,66,66,0,1,0,1,0
59834,445,0,0,drop,70,70,0,1,0,1,0
61017,445,0,0,drop,66,66,0,1,0,1,0
26805,443,51812,443,allow,7343,2586,4757,23,20,11,12
0,0,0,0,allow,480,244,236,4,0,2,2
49238,53,61405,53,allow,274,94,180,2,30,1,1
49905,443,37995,443,allow,798502,33164,765338,927,103,379,548
46851,53,12035,53,allow,168,78,90,2,30,1,1
28020,443,11039,443,allow,5576,1388,4188,19,15,9,10
58638,5900,58638,5900,allow,130,66,64,2,5,1,1
62108,445,0,0,drop,66,66,0,1,0,1,0
58680,445,0,0,drop,66,66,0,1,0,1,0
49986,53,35150,53,allow,209,94,115,2,30,1,1
64335,443,56064,443,allow,230615,48569,182046,379,176,157,222
63599,443,32617,443,allow,10050,1802,8248,30,39,16,14
52705,42873,0,0,deny,66,66,0,1,0,1,0
57325,37965,0,0,deny,62,62,0,1,0,1,0
55353,53,1525,53,allow,168,86,82,2,30,1,1
36003,123,29238,123,allow,184,94,90,2,30,1,1
59283,80,59283,80,allow,72354,14398,57956,123,15,40,83
3399,25174,0,0,deny,66,66,0,1,0,1,0
55810,53,12633,53,allow,182,93,89,2,30,1,1
41167,443,51918,443,allow,8869,1938,6931,21,17,12,9
59787,443,59787,443,allow,5525,2278,3247,22,40,13,9
53808,56215,4312,56215,allow,70,70,0,1,4,1,0
55222,445,0,0,drop,66,66,0,1,0,1,0
12663,62413,0,0,deny,66,66,0,1,0,1,0
51598,56079,0,0,deny,66,66,0,1,0,1,0
53991,445,0,0,drop,66,66,0,1,0,1,0
52435,53,3973,53,allow,216,78,138,2,29,1,1
57183,53,6659,53,allow,178,94,84,2,31,1,1
58587,445,0,0,drop,70,70,0,1,0,1,0
49418,27019,26998,27019,allow,242,78,164,2,30,1,1
58638,5900,0,0,deny,62,62,0,1,0,1,0
57849,50584,0,0,deny,66,66,0,1,0,1,0
49418,27015,54748,27015,allow,78,78,0,1,29,1,0
58638,5900,0,0,deny,62,62,0,1,0,1,0
31627,64147,0,0,deny,62,62,0,1,0,1,0
58840,445,0,0,drop,70,70,0,1,0,1,0
46879,37807,0,0,deny,146,146,0,1,0,1,0
65277,53,55975,53,allow,167,86,81,2,30,1,1
43230,80,43230,80,allow,6776,692,6084,16,20,8,8
18623,1,0,0,deny,66,66,0,1,0,1,0
56969,53,53086,53,allow,196,94,102,2,29,1,1
52642,6881,49230,6881,allow,1106,800,306,10,14,5,5
47632,25174,0,0,deny,62,62,0,1,0,1,0
64512,53,2401,53,allow,524,91,433,4,34,2,2
58964,80,7375,80,allow,5541,4758,783,16,16,8,8
64824,36829,0,0,deny,62,62,0,1,0,1,0
54262,443,59350,443,allow,11356,5509,5847,84,544,44,40
60975,443,27000,443,allow,333131,17461,315670,435,72,211,224
53211,445,0,0,drop,70,70,0,1,0,1,0
50458,53,25707,53,allow,177,94,83,2,30,1,1
34885,443,20315,443,allow,80828,20592,60236,124,180,54,70
55907,445,0,0,drop,70,70,0,1,0,1,0
37902,23718,0,0,deny,62,62,0,1,0,1,0
46779,5228,25730,5228,allow,3775,2029,1746,30,3637,13,17
63928,53,2140,53,allow,376,126,250,2,30,1,1
53886,49618,46889,49618,allow,492,306,186,8,16,5,3
50552,80,50552,80,allow,2887,1776,1111,14,22,8,6
65071,445,0,0,drop,66,66,0,1,0,1,0
56481,53,4723,53,allow,193,102,91,2,30,1,1
50583,80,50583,80,allow,17375,11554,5821,52,27,32,20
34166,50584,0,0,deny,146,146,0,1,0,1,0
58638,5900,0,0,deny,62,62,0,1,0,1,0
40834,50584,0,0,deny,62,62,0,1,0,1,0
63786,35440,0,0,deny,66,66,0,1,0,1,0
64882,43890,0,0,deny,66,66,0,1,0,1,0
1230,3389,1230,3389,allow,3910,1805,2105,20,19,12,8
51702,445,0,0,drop,66,66,0,1,0,1,0
30580,50265,0,0,deny,62,62,0,1,0,1,0
40216,50265,0,0,deny,62,62,0,1,0,1,0
53703,16426,38652,16426,allow,70,70,0,1,4,1,0
35149,53,35149,53,allow,235,90,145,2,32,1,1
59093,445,0,0,drop,70,70,0,1,0,1,0
65224,443,29038,443,allow,18887,8273,10614,42,62,22,20
50626,43890,0,0,deny,62,62,0,1,0,1,0
44890,443,50264,443,allow,232,172,60,3,4,2,1
64987,53,27930,53,allow,198,102,96,2,29,1,1
443,20087,0,0,deny,83,83,0,1,0,1,0
49398,53,12765,53,allow,226,86,140,2,31,1,1
55966,53,62624,53,allow,747,92,655,2,30,1,1
43099,5900,0,0,deny,60,60,0,1,0,1,0
58632,445,0,0,drop,66,66,0,1,0,1,0
64958,53,14759,53,allow,197,102,95,2,30,1,1
53571,19636,50196,19636,allow,70,70,0,2,7,2,0
53766,445,0,0,drop,70,70,0,1,0,1,0
56246,80,56246,80,allow,101654,1739,99915,95,15,25,70
57000,53,24193,53,allow,194,102,92,2,30,1,1
21954,53,21954,53,allow,220,90,130,2,30,1,1
49785,53,63638,53,allow,211,110,101,2,30,1,1
62874,445,0,0,drop,66,66,0,1,0,1,0
57472,44847,0,0,deny,66,66,0,1,0,1,0
