Source Port,Destination Port,NAT Source Port,NAT Destination Port,Action,Bytes,Bytes Sent,Bytes Received,Packets,Elapsed Time (sec),pkts_sent,pkts_received
56782,53,33216,53,allow,197,102,95,2,33,1,1
60989,445,0,0,drop,66,66,0,1,0,1,0
49242,443,58883,443,allow,638,70,568,10,203,2,8
0,0,0,0,deny,98,98,0,1,0,1,0
52472,445,0,0,drop,66,66,0,1,0,1,0
0,0,0,0,allow,480,244,236,4,0,2,2
63205,9571,0,0,deny,62,62,0,1,0,1,0
37757,53,12221,53,allow,86,86,0,1,30,1,0
51363,445,0,0,drop,70,70,0,1,0,1,0
27000,23117,0,0,deny,62,62,0,1,0,1,0
49382,53,52583,53,allow,200,102,98,2,31,1,1
55583,14822,28217,14822,allow,70,70,0,1,5,1,0
3802,55777,0,0,deny,66,66,0,1,0,1,0
57173,53,39121,53,allow,168,78,90,2,30,1,1
55951,53,63735,53,allow,197,102,95,2,31,1,1
59454,445,0,0,drop,66,66,0,1,0,1,0
6057,51221,0,0,deny,78,78,0,1,0,1,0
55350,53,27984,53,allow,177,94,83,2,29,1,1
35011,37965,0,0,deny,62,62,0,1,0,1,0
63084,443,51859,443,allow,571,166,405,2,30,1,1
51423,445,0,0,drop,70,70,0,1,0,1,0
53119,58118,18768,58118,allow,70,70,0,1,5,1,0
50265,45682,46008,45682,allow,402,132,270,6,1209,3,3
55019,53,16040,53,allow,299,110,189,4,32,2,2
64579,37965,0,0,deny,66,66,0,1,0,1,0
40369,57470,0,0,deny,62,62,0,1,0,1,0
50520,443,34844,443,allow,9942,1211,8731,26,77,14,12
26722,11446,0,0,deny,66,66,0,1,0,1,0
54325,7000,54325,7000,allow,755529,16895,738634,785,16,264,521
47272,443,40986,443,allow,6318,1025,5293,17,35,9,8
64915,443,15491,443,allow,4659604,120303,4539301,4651,74,1586,3065
54889,443,57896,443,allow,5541,3309,2232,19,61,11,8
52508,445,0,0,drop,66,66,0,1,0,1,0
50373,443,36496,443,allow,4695,859,3836,17,30,9,8
64266,53,14538,53,allow,255,102,153,2,30,1,1
59535,445,0,0,drop,66,66,0,1,0,1,0
56103,443,24314,443,allow,22293,16437,5856,51,30,27,24
56803,53,52529,53,allow,183,94,89,2,30,1,1
49507,443,28948,443,allow,9536,2399,7137,32,270,17,15
49529,445,0,0,drop,70,70,0,1,0,1,0
57127,53,59492,53,allow,186,95,91,2,31,1,1
62089,8604,0,0,deny,66,66,0,1,0,1,0
56328,36237,0,0,deny,62,62,0,1,0,1,0
60833,443,43148,443,allow,1157,817,340,10,26,5,5
59298,443,18109,443,allow,20971,2840,18131,52,89,24,28
49319,53,4413,53,allow,199,94,105,2,30,1,1
61185,54532,0,0,deny,62,62,0,1,0,1,0
63864,23,0,0,deny,60,60,0,1,0,1,0
64723,53,23544,53,allow,677,198,479,6,68,3,3
52777,445,0,0,drop,66,66,0,1,0,1,0
50181,443,22681,443,allow,6350,1071,5279,18,42,10,8
60602,15503,0,0,deny,66,66,0,1,0,1,0
65363,53,30865,53,allow,178,91,87,2,31,1,1
57231,53,57692,53,allow,168,86,82,2,32,1,1
50109,53,52643,53,allow,198,110,88,2,31,1,1
58638,5900,0,0,deny,62,62,0,1,0,1,0
58821,445,0,0,drop,70,70,0,1,0,1,0
59526,445,0,0,drop,70,70,0,1,0,1,0
32871,53,29403,53,allow,199,94,105,2,30,1,1
26496,80,26496,80,allow,160989,10162,150827,189,31,81,108
443,39999,0,0,deny,74,74,0,1,0,1,0
49206,80,5739,80,allow,57497,913,56584,52,75,11,41
64135,53,50232,53,allow,192,98,94,2,31,1,1
63060,445,0,0,drop,70,70,0,1,0,1,0
43345,51505,0,0,deny,146,146,0,1,0,1,0
42732,57470,0,0,deny,62,62,0,1,0,1,0
21993,25174,0,0,deny,62,62,0,1,0,1,0
64634,445,0,0,drop,70,70,0,1,0,1,0
60936,443,12668,443,allow,1864,250,1614,8,120,4,4
53156,35993,0,0,deny,66,66,0,1,0,1,0
50089,445,0,0,drop,70,70,0,1,0,1,0
56975,53,65042,53,allow,197,102,95,2,31,1,1
30188,15370,58525,15370,allow,10190,4774,5416,64,1490,32,32
6881,6881,9262,6881,allow,501,150,351,2,1200,1,1
50298,53,38554,53,allow,164,86,78,2,30,1,1
47632,25174,0,0,deny,62,62,0,1,0,1,0
56623,53,18777,53,allow,771,101,670,2,30,1,1
64105,53,29112,53,allow,300,102,198,2,30,1,1
49421,53,13940,53,allow,215,94,121,2,29,1,1
49462,53,10345,53,allow,86,86,0,1,30,1,0
60661,445,0,0,drop,70,70,0,1,0,1,0
63961,53,35480,53,allow,184,86,98,2,30,1,1
65340,53,10565,53,allow,226,102,124,2,30,1,1
9524,443,1427,443,allow,1313,876,437,11,26,6,5
56821,53,60054,53,allow,199,102,97,2,30,1,1
26713,64147,0,0,deny,62,62,0,1,0,1,0
53515,39608,40902,39608,allow,70,70,0,1,4,1,0
51982,56306,48759,56306,allow,70,70,0,2,8,2,0
58077,36653,53473,36653,allow,204,64,140,4,11,2,2
56024,53,53250,53,allow,711,87,624,2,30,1,1
58638,5900,0,0,deny,62,62,0,1,0,1,0
43676,443,26633,443,allow,5903,1367,4536,18,16,10,8
49724,53,34584,53,allow,210,102,108,2,30,1,1
51954,57470,0,0,deny,66,66,0,1,0,1,0
52426,443,50838,443,allow,782,428,354,12,28,7,5
44855,58414,0,0,deny,62,62,0,1,0,1,0
59421,445,0,0,drop,70,70,0,1,0,1,0
52198,445,0,0,drop,70,70,0,1,0,1,0
25457,25604,0,0,deny,145,145,0,1,0,1,0
19394,44847,0,0,deny,66,66,0,1,0,1,0
51571,445,0,0,drop,70,70,0,1,0,1,0
50446,445,0,0,drop,70,70,0,1,0,1,0
51243,445,0,0,drop,66,66,0,1,0,1,0
49631,443,48718,443,allow,8558,1006,7552,16,121,7,9
57159,445,0,0,drop,70,70,0,1,0,1,0
27005,27015,16145,27015,allow,879,126,753,2,29,1,1
59872,443,27152,443,allow,6239,800,5439,18,32,8,10
64369,445,0,0,drop,66,66,0,1,0,1,0
59403,443,13461,443,allow,2866,1684,1182,16,15,8,8
27005,27013,41883,27013,allow,879,126,753,2,30,1,1
56939,53,41233,53,allow,322,134,188,2,30,1,1
59119,445,0,0,drop,70,70,0,1,0,1,0
53320,443,39301,443,allow,30796,3050,27746,60,30,32,28
60213,445,0,0,drop,70,70,0,1,0,1,0
49359,53,8497,53,allow,216,110,106,2,30,1,1
58330,443,54762,443,allow,7353,2840,4513,33,107,18,15
57620,445,0,0,drop,70,70,0,1,0,1,0
10014,443,17937,443,allow,3876,2012,1864,21,315,10,11
64242,53,44715,53,allow,176,90,86,2,31,1,1
56025,53,63426,53,allow,761,100,661,2,30,1,1
61738,2767,0,0,deny,66,66,0,1,0,1,0
61764,57470,0,0,deny,146,146,0,1,0,1,0
65516,445,0,0,drop,70,70,0,1,0,1,0
56927,53,28530,53,allow,183,94,89,2,29,1,1
36924,53,36924,53,allow,257,106,151,2,30,1,1
65450,53,49502,53,allow,336,110,226,2,30,1,1
23274,50584,0,0,deny,146,146,0,1,0,1,0
33643,443,12343,443,allow,163835,28514,135321,310,153,162,148
49648,7275,24792,7275,allow,8962,1625,7337,28,16,15,13
50527,445,0,0,drop,70,70,0,1,0,1,0
49514,52255,0,0,deny,162,162,0,1,0,1,0
54139,53,64934,53,allow,168,78,90,2,31,1,1
65364,53,50447,53,allow,226,110,116,2,29,1,1
65184,53,13116,53,allow,166,86,80,2,30,1,1
64753,53,63867,53,allow,94,94,0,1,30,1,0
57331,53,13149,53,allow,1420,95,1325,4,32,2,2
39359,443,36397,443,allow,46113,6913,39200,86,34,41,45
13088,80,11600,80,allow,4079,3203,876,12,97,8,4
33582,44847,0,0,deny,66,66,0,1,0,1,0
54240,443,62221,443,allow,499,425,74,4,0,3,1
57117,80,29144,80,allow,1049,679,370,8,16,5,3
53469,445,0,0,drop,70,70,0,1,0,1,0
57161,53,1657,53,allow,711,87,624,2,30,1,1
58638,5900,58638,5900,allow,62,62,0,1,5,1,0
56351,53,13734,53,allow,306,99,207,2,31,1,1
50786,445,0,0,drop,66,66,0,1,0,1,0
53561,443,46196,443,allow,4586,1216,3370,17,28,10,7
52266,445,0,0,drop,70,70,0,1,0,1,0
56765,53,52447,53,allow,194,102,92,2,30,1,1
26528,51221,0,0,deny,78,78,0,1,0,1,0
53746,445,0,0,drop,70,70,0,1,0,1,0
55878,7302,0,0,deny,66,66,0,1,0,1,0
33416,23,0,0,deny,60,60,0,1,0,1,0
55128,445,0,0,drop,70,70,0,1,0,1,0
55538,53,15605,53,allow,168,86,82,2,30,1,1
65449,53,65266,53,allow,507,193,314,6,57,3,3
6881,5903,6718,5903,allow,501,150,351,2,1200,1,1
59979,443,21635,443,allow,30171,25514,4657,77,37,42,35
53567,64147,0,0,deny,62,62,0,1,0,1,0
4760,44847,0,0,deny,62,62,0,1,0,1,0
24174,57470,0,0,deny,62,62,0,1,0,1,0
42294,443,1257,443,allow,10384,4353,6031,29,251,16,13
63708,29685,60492,29685,allow,66,66,0,1,5,1,0
50610,80,53401,80,allow,3726,1504,2222,13,21,7,6
53017,445,0,0,drop,70,70,0,1,0,1,0
37663,443,39550,443,allow,8493,2314,6179,33,15,18,15
58782,445,0,0,drop,70,70,0,1,0,1,0
60329,7000,60329,7000,allow,3959,1738,2221,15,15,8,7
56395,53,54170,53,allow,199,102,97,2,29,1,1
51824,53021,41842,53021,allow,70,70,0,1,5,1,0
37603,443,12094,443,allow,8493,2314,6179,33,15,18,15
34765,5222,48630,5222,allow,10109,3480,6629,72,615,38,34
51811,443,43399,443,allow,4007,2063,1944,12,122,6,6
57431,15503,0,0,deny,66,66,0,1,0,1,0
6889,41615,0,0,deny,143,143,0,1,0,1,0
49209,53,59782,53,allow,199,102,97,2,30,1,1
50360,80,16489,80,allow,318,192,126,6,28,4,2
54891,443,48520,443,allow,10035,2160,7875,35,120,18,17
40967,1433,0,0,deny,60,60,0,1,0,1,0
50589,53,14237,53,allow,786,110,676,2,30,1,1
8080,37965,0,0,deny,62,62,0,1,0,1,0
56494,30228,0,0,deny,146,146,0,1,0,1,0
58796,443,44743,443,allow,14463,9503,4960,34,17,17,17
49752,53,1168,53,allow,182,94,88,2,30,1,1
50277,443,65171,443,allow,268,120,148,5,11,3,2
44923,23,0,0,deny,60,60,0,1,0,1,0
65398,7129,0,0,deny,66,66,0,1,0,1,0
49582,80,49496,80,allow,25980,10637,15343,40,42,17,23
50593,443,49390,443,allow,6292,1492,4800,22,16,11,11
57572,443,57572,443,allow,181333,21870,159463,187,175,65,122
55211,53,32834,53,allow,183,94,89,2,30,1,1
55102,53,6205,53,allow,195,102,93,2,30,1,1
55028,443,3475,443,allow,1403116,30089,1373027,1321,32,404,917
1029,44847,0,0,deny,62,62,0,1,0,1,0
44546,53,44546,53,allow,204,92,112,2,30,1,1
54280,3396,0,0,deny,60,60,0,1,0,1,0
57853,64147,0,0,deny,62,62,0,1,0,1,0
60557,445,0,0,drop,70,70,0,1,0,1,0
50050,53,12626,53,allow,253,87,166,4,51,2,2
65239,53,27517,53,allow,199,102,97,2,30,1,1
56803,443,62661,443,allow,8020,2000,6020,20,15,11,9
62745,445,0,0,drop,66,66,0,1,0,1,0
53257,37450,0,0,deny,66,66,0,1,0,1,0
55840,53,25093,53,allow,711,87,624,2,30,1,1
55030,445,0,0,drop,66,66,0,1,0,1,0
22939,443,22939,443,allow,6993,960,6033,17,31,10,7
64908,53,50064,53,allow,812,110,702,2,30,1,1
49242,53,51879,53,allow,183,94,89,2,30,1,1
50303,445,0,0,drop,66,66,0,1,0,1,0
60427,61137,3652,61137,allow,70,70,0,2,8,2,0
27443,23,0,0,deny,60,60,0,1,0,1,0
51105,50584,0,0,deny,62,62,0,1,0,1,0
52605,445,0,0,drop,70,70,0,1,0,1,0
52164,445,0,0,drop,70,70,0,1,0,1,0
55669,53,4616,53,allow,784,94,690,2,30,1,1
5588,5588,0,0,allow,3354,1792,1562,46,192,23,23
60246,445,0,0,drop,70,70,0,1,0,1,0
55867,53,49859,53,allow,178,94,84,2,29,1,1
443,49988,0,0,deny,82,82,0,1,0,1,0
55296,23718,0,0,deny,66,66,0,1,0,1,0
61704,445,0,0,drop,66,66,0,1,0,1,0
46989,80,46989,80,allow,82082,3212,78870,90,155,27,63
33822,57470,0,0,deny,66,66,0,1,0,1,0
51467,443,43898,443,allow,186117,12962,173155,249,143,83,166
64721,53,29674,53,allow,214,110,104,2,30,1,1
48676,53398,0,0,deny,60,60,0,1,0,1,0
64299,53,64359,53,allow,166,86,80,2,30,1,1
64422,53,42337,53,allow,176,90,86,2,30,1,1
49912,53,25675,53,allow,246,102,144,2,30,1,1
51966,18716,18361,18716,allow,66,66,0,1,5,1,0
49071,443,20590,443,allow,130,70,60,3,5,2,1
443,64347,0,0,deny,100,100,0,1,0,1,0
14397,37965,0,0,deny,62,62,0,1,0,1,0
64530,53,5563,53,allow,264,110,154,2,30,1,1
60972,443,43346,443,allow,10208,5093,5115,46,15,27,19
39292,80,43537,80,allow,1655,1341,314,10,16,5,5
55081,53,46160,53,allow,209,102,107,2,30,1,1
38544,161,0,0,allow,8977,3570,5407,30,31,15,15
54849,445,0,0,drop,66,66,0,1,0,1,0
7811,44847,0,0,deny,62,62,0,1,0,1,0
65012,2767,0,0,deny,62,62,0,1,0,1,0
62211,445,0,0,drop,70,70,0,1,0,1,0
65239,53,28035,53,allow,757,102,655,2,29,1,1
55435,443,60769,443,allow,684908,25994,658914,762,141,263,499
40333,80,15004,80,allow,1049,975,74,6,15,5,1
26849,443,35279,443,allow,20979,15982,4997,38,36,22,16
52928,443,44110,443,allow,5584,1390,4194,19,15,9,10
49461,445,0,0,drop,66,66,0,1,0,1,0
51412,51505,0,0,deny,66,66,0,1,0,1,0
38642,443,33643,443,allow,1468,893,575,15,62,8,7
61770,445,0,0,drop,70,70,0,1,0,1,0
47771,25174,0,0,deny,62,62,0,1,0,1,0
57599,80,57241,80,allow,1526,972,554,10,75,6,4
64922,53,63289,53,allow,431,95,336,4,55,2,2
54862,19000,22196,19000,allow,476,216,260,2,30,1,1
50161,53,40110,53,allow,173,94,79,2,30,1,1
49964,64147,0,0,deny,66,66,0,1,0,1,0
56487,53,25181,53,allow,788,108,680,2,31,1,1
61719,445,0,0,drop,70,70,0,1,0,1,0
50974,80,21113,80,allow,1095989,7833,1088156,841,37,117,724
54593,51505,0,0,deny,66,66,0,1,0,1,0
49267,53,29003,53,allow,184,94,90,2,30,1,1
21432,53,21432,53,allow,244,98,146,2,32,1,1
49800,53,33373,53,allow,183,94,89,2,29,1,1
49589,80,33481,80,allow,314,128,186,6,26,3,3
51163,443,48007,443,allow,9466,2602,6864,41,185,20,21
40072,80,29014,80,allow,1298,370,928,12,15,6,6
64255,53,54651,53,allow,211,102,109,2,30,1,1
42034,28189,0,0,deny,62,62,0,1,0,1,0
51511,445,0,0,drop,66,66,0,1,0,1,0
58654,53,55637,53,allow,168,78,90,2,30,1,1
65122,53,25897,53,allow,410,110,300,2,30,1,1
40159,443,53282,443,allow,5360,4048,1312,22,265,11,11
64665,445,0,0,drop,70,70,0,1,0,1,0
63873,44847,0,0,deny,66,66,0,1,0,1,0
56390,445,0,0,drop,70,70,0,1,0,1,0
55866,53,45530,53,allow,732,89,643,2,30,1,1
53921,18183,42637,18183,allow,826,386,440,12,15,6,6
9512,443,14359,443,allow,3614,434,3180,11,1,6,5
54004,445,0,0,drop,70,70,0,1,0,1,0
19473,28109,14230,28109,allow,468,149,319,2,1200,1,1
59210,50584,0,0,deny,66,66,0,1,0,1,0
42922,80,41285,80,allow,234,234,0,4,12,4,0
55337,53,58173,53,allow,198,102,96,2,30,1,1
63078,53,5697,53,allow,304,86,218,2,30,1,1
63084,53,54059,53,allow,86,86,0,1,30,1,0
26810,5033,0,0,deny,145,145,0,1,0,1,0
45964,3111,0,0,deny,60,60,0,1,0,1,0
48444,53,53992,53,allow,164,78,86,2,30,1,1
45767,50584,0,0,deny,146,146,0,1,0,1,0
52717,445,0,0,drop,70,70,0,1,0,1,0
44155,443,5461,443,allow,5157,917,4240,20,360,10,10
49935,53,46528,53,allow,177,94,83,2,30,1,1
35047,80,8306,80,allow,7891,2035,5856,17,32,10,7
26131,56205,0,0,deny,62,62,0,1,0,1,0
60407,443,48240,443,allow,308771,8699,300072,322,30,112,210
65507,53,53628,53,allow,199,102,97,2,30,1,1
52624,445,0,0,drop,70,70,0,1,0,1,0
11859,64147,0,0,deny,62,62,0,1,0,1,0
58638,5900,0,0,deny,62,62,0,1,0,1,0
57736,445,0,0,drop,66,66,0,1,0,1,0
55526,53,26801,53,allow,749,94,655,2,30,1,1
56415,53,58262,53,allow,174,89,85,2,31,1,1
27997,80,36977,80,allow,3683,591,3092,11,45,6,5
64865,53,49871,53,allow,305,97,208,4,53,2,2
61318,445,0,0,drop,66,66,0,1,0,1,0
56126,53,5534,53,allow,177,94,83,2,30,1,1
59478,445,0,0,drop,70,70,0,1,0,1,0
55205,53,36429,53,allow,166,85,81,2,31,1,1
48186,51050,0,0,deny,62,62,0,1,0,1,0
50550,53,58594,53,allow,168,78,90,2,30,1,1
43818,80,62769,80,allow,2005,715,1290,8,15,5,3
48388,44847,0,0,deny,146,146,0,1,0,1,0
49472,53,42476,53,allow,210,110,100,2,31,1,1
61477,57470,0,0,deny,62,62,0,1,0,1,0
29195,51505,0,0,deny,146,146,0,1,0,1,0
58238,23,0,0,deny,60,60,0,1,0,1,0
45941,23386,0,0,deny,60,60,0,1,0,1,0
55803,53,62058,53,allow,179,94,85,2,30,1,1
44358,443,57886,443,allow,502,288,214,8,131,5,3
61790,445,0,0,drop,66,66,0,1,0,1,0
56218,43890,0,0,deny,62,62,0,1,0,1,0
9294,443,62511,443,allow,6356,979,5377,19,27,10,9
29647,53,29647,53,allow,197,76,121,2,30,1,1
54552,64147,0,0,deny,62,62,0,1,0,1,0
51726,18475,34444,18475,allow,316,136,180,6,7,3,3
37965,20926,65479,20926,allow,481,150,331,2,1199,1,1
27005,27020,19187,27020,allow,890,126,764,2,30,1,1
55106,443,7279,443,allow,3411,887,2524,12,120,6,6
55828,445,0,0,drop,70,70,0,1,0,1,0
5588,5588,0,0,allow,3562,1936,1626,48,193,24,24
56569,443,12304,443,allow,340595,9013,331582,345,80,119,226
60992,443,15020,443,allow,3465,2532,933,20,47,12,8
63344,53,0,0,deny,73,73,0,1,0,1,0
64723,443,61032,443,allow,7978900,79979,7898921,6464,210,644,5820
65112,53,30397,53,allow,202,103,99,2,31,1,1
57170,53,13134,53,allow,298,102,196,4,36,2,2
49163,22114,0,0,deny,146,146,0,1,0,1,0
53231,443,26059,443,allow,11825,4129,7696,39,40,21,18
53145,445,0,0,drop,70,70,0,1,0,1,0
59509,64147,0,0,deny,145,145,0,1,0,1,0
61230,22114,0,0,deny,66,66,0,1,0,1,0
15320,30188,0,0,deny,146,146,0,1,0,1,0
56292,445,0,0,drop,70,70,0,1,0,1,0
56621,50584,0,0,deny,62,62,0,1,0,1,0
62499,443,53888,443,allow,1332,876,456,11,26,6,5
60732,443,1345,443,allow,193520,11019,182501,280,276,140,140
50358,80,6074,80,allow,306,180,126,6,25,4,2
53169,44707,23330,44707,allow,1078,518,560,16,21,9,7
53726,26083,31165,26083,allow,70,70,0,1,5,1,0
51041,445,0,0,drop,70,70,0,1,0,1,0
16270,56205,0,0,deny,62,62,0,1,0,1,0
55750,53,13328,53,allow,211,110,101,2,30,1,1
58638,5900,0,0,deny,62,62,0,1,0,1,0
41613,80,21847,80,allow,6003,691,5312,13,16,7,6
37483,443,13150,443,allow,70,70,0,2,5,2,0
6889,48817,0,0,deny,143,143,0,1,0,1,0
65520,443,22541,443,allow,438102,12780,425322,449,15,157,292
51961,40373,19759,40373,allow,70,70,0,2,8,2,0
59465,445,0,0,drop,66,66,0,1,0,1,0
56422,80,3635,80,allow,35833,938,34895,37,104,11,26
64762,53,37992,53,allow,194,102,92,2,30,1,1
63807,38976,18542,38976,allow,66,66,0,2,8,2,0
3803,51505,0,0,deny,66,66,0,1,0,1,0
54873,445,0,0,drop,70,70,0,1,0,1,0
32768,53,4546,53,allow,86,86,0,1,30,1,0
57339,50584,0,0,deny,62,62,0,1,0,1,0
64024,22114,0,0,deny,66,66,0,1,0,1,0
63742,445,0,0,drop,70,70,0,1,0,1,0
53838,36829,0,0,deny,66,66,0,1,0,1,0
58861,445,0,0,drop,70,70,0,1,0,1,0
50129,443,27980,443,allow,29436,9695,19741,54,34,30,24
33359,443,23934,443,allow,9818,2036,7782,28,31,12,16
62793,445,0,0,drop,70,70,0,1,0,1,0
6338,23117,0,0,deny,66,66,0,1,0,1,0
50236,443,50711,443,allow,6661,1489,5172,26,270,13,13
56499,80,63072,80,allow,277848,13775,264073,301,63,118,183
51966,25174,0,0,deny,62,62,0,1,0,1,0
64071,445,0,0,drop,70,70,0,1,0,1,0
28429,23,0,0,deny,60,60,0,1,0,1,0
65147,53,20335,53,allow,194,102,92,2,29,1,1
54573,445,0,0,drop,70,70,0,1,0,1,0
65218,53,49451,53,allow,193,102,91,2,30,1,1
26900,27017,37191,27017,allow,422,164,258,6,30,3,3
63839,445,0,0,drop,66,66,0,1,0,1,0
44313,53,51644,53,allow,199,94,105,2,30,1,1
57860,23,0,0,deny,60,60,0,1,0,1,0
38714,443,54689,443,allow,90043,3609,86434,97,15,33,64
26900,27017,44727,27017,allow,422,164,258,6,30,3,3
54069,445,0,0,drop,66,66,0,1,0,1,0
58967,443,57759,443,allow,9225,1878,7347,28,21,14,14
38057,443,24418,443,allow,9486,2668,6818,26,81,14,12
49127,53,16761,53,allow,199,94,105,2,29,1,1
56612,53,15256,53,allow,274,87,187,4,30,2,2
53589,40281,44450,40281,allow,70,70,0,1,4,1,0
27005,32078,22538,32078,allow,871,126,745,2,30,1,1
36339,50584,0,0,deny,146,146,0,1,0,1,0
51320,44847,0,0,deny,62,62,0,1,0,1,0
57819,443,40837,443,allow,6161,925,5236,18,28,10,8
51167,443,46694,443,allow,13777,1743,12034,26,31,12,14
52312,443,50036,443,allow,1574859,55851,1519008,1758,185,656,1102
58135,445,0,0,drop,70,70,0,1,0,1,0
52121,443,41012,443,allow,199757,7497,192260,216,45,80,136
49410,53,7557,53,allow,178,94,84,2,30,1,1
49723,443,17483,443,allow,11181,3795,7386,50,20,23,27
64953,445,0,0,drop,70,70,0,1,0,1,0
61918,445,0,0,drop,70,70,0,1,0,1,0
9532,56205,0,0,deny,146,146,0,1,0,1,0
57092,53,56689,53,allow,445,86,359,2,30,1,1
443,34599,0,0,deny,60,60,0,1,0,1,0
52025,443,47252,443,allow,8034,2692,5342,15,16,8,7
57430,53,16018,53,allow,200,102,98,2,29,1,1
65075,53,1890,53,allow,278,100,178,4,31,2,2
50821,443,29846,443,allow,7619,3064,4555,14,121,6,8
50466,53,34951,53,allow,199,102,97,2,30,1,1
49558,53,61450,53,allow,184,94,90,2,29,1,1
57836,443,52669,443,allow,15844,1691,14153,18,138,5,13
50009,80,24998,80,allow,186,64,122,4,29,2,2
52042,38074,53103,38074,allow,70,70,0,2,8,2,0
50803,445,0,0,drop,66,66,0,1,0,1,0
53318,80,64678,80,allow,1536,982,554,10,76,6,4
53753,445,0,0,drop,66,66,0,1,0,1,0
65347,53,20093,53,allow,352,94,258,2,30,1,1
55489,53,32876,53,allow,193,102,91,2,29,1,1
56575,53,50705,53,allow,732,89,643,2,31,1,1
56576,445,0,0,drop,66,66,0,1,0,1,0
50116,22,50116,22,allow,60,60,0,1,5,1,0
55503,53,55222,53,allow,200,102,98,2,30,1,1
28040,64147,0,0,deny,66,66,0,1,0,1,0
55340,53,32896,53,allow,184,94,90,2,31,1,1
46861,15000,42443,15000,allow,130,70,60,2,5,1,1
26623,22114,0,0,deny,146,146,0,1,0,1,0
35609,443,52136,443,allow,9225,2759,6466,27,100,16,11
63231,443,12369,443,allow,7124,3843,3281,42,126,20,22
58224,445,0,0,drop,70,70,0,1,0,1,0
51796,48779,32373,48779,allow,70,70,0,1,5,1,0
57917,44847,0,0,deny,66,66,0,1,0,1,0
56152,53,29649,53,allow,195,102,93,2,30,1,1
58305,18375,0,0,deny,66,66,0,1,0,1,0
59433,53,26803,53,allow,218,78,140,2,29,1,1
51834,30309,10825,30309,allow,70,70,0,1,5,1,0
58638,5900,0,0,deny,62,62,0,1,0,1,0
53323,35253,0,0,deny,66,66,0,1,0,1,0
50975,53,27923,53,allow,199,94,105,2,30,1,1
49629,26467,0,0,deny,66,66,0,1,0,1,0
27889,32480,0,0,deny,100,100,0,1,0,1,0
58365,5900,0,0,deny,60,60,0,1,0,1,0
49577,443,34979,443,allow,6947,833,6114,20,53,9,11
52976,31573,0,0,deny,66,66,0,1,0,1,0
52085,80,49733,80,allow,360,240,120,7,25,5,2
7105,25174,0,0,deny,66,66,0,1,0,1,0
63984,15847,44273,15847,allow,1344,819,525,14,15,8,6
49993,53,3383,53,allow,211,102,109,2,30,1,1
64063,53,31532,53,allow,339,110,229,2,29,1,1
56637,443,26633,443,allow,7907,1918,5989,20,15,11,9
64485,53,6047,53,allow,183,94,89,2,30,1,1
59961,445,0,0,drop,70,70,0,1,0,1,0
65117,445,0,0,drop,66,66,0,1,0,1,0
60365,443,2645,443,allow,130,70,60,2,15,1,1
49626,53,57027,53,allow,226,110,116,2,30,1,1
57356,53,19968,53,allow,199,102,97,2,30,1,1
35441,5222,17710,5222,allow,10854,4776,6078,80,119,41,39
60060,443,7904,443,allow,4648,1505,3143,17,141,9,8
42522,443,26969,443,allow,7352,1592,5760,25,16,15,10
58074,11392,0,0,deny,66,66,0,1,0,1,0
56504,53,9210,53,allow,195,94,101,2,30,1,1
39077,443,60900,443,allow,24631,1902,22729,37,215,17,20
65189,27212,4653,27212,allow,254,78,176,2,29,1,1
56779,53,7300,53,allow,757,98,659,2,30,1,1
26900,27017,41644,27017,allow,422,164,258,6,30,3,3
53985,26515,51989,26515,allow,70,70,0,2,7,2,0
49808,53,25125,53,allow,268,102,166,2,29,1,1
47598,443,10751,443,allow,22048,16451,5597,47,18,21,26
62236,445,0,0,drop,66,66,0,1,0,1,0
51464,443,62248,443,allow,7269,1978,5291,28,39,14,14
62875,445,0,0,drop,66,66,0,1,0,1,0
36717,443,50144,443,allow,232,172,60,3,5,2,1
46362,35440,0,0,deny,66,66,0,1,0,1,0
53158,17234,26675,17234,allow,70,70,0,2,8,2,0
64782,53,40065,53,allow,758,93,665,2,31,1,1
58430,445,0,0,drop,70,70,0,1,0,1,0
3424,53,3424,53,allow,216,88,128,2,30,1,1
55530,80,60637,80,allow,3334,2314,1020,19,39,11,8
48458,53,36064,53,allow,289,86,203,2,29,1,1
45732,443,54582,443,allow,6558,2131,4427,26,262,10,16
55580,445,0,0,drop,70,70,0,1,0,1,0
57035,53,5245,53,allow,199,102,97,2,30,1,1
59199,53,18550,53,allow,228,94,134,2,30,1,1
40512,57470,0,0,deny,74,74,0,1,0,1,0
54165,443,54165,443,allow,147750,13521,134229,182,92,84,98
60947,443,46012,443,allow,1373,712,661,14,18,8,6
63542,445,0,0,drop,70,70,0,1,0,1,0
43215,443,60115,443,allow,9781,3108,6673,28,15,15,13
40787,57470,0,0,deny,62,62,0,1,0,1,0
55525,53,56574,53,allow,214,110,104,2,30,1,1
49561,53,39252,53,allow,754,94,660,2,30,1,1
58654,445,0,0,drop,70,70,0,1,0,1,0
54044,53,15773,53,allow,224,86,138,2,29,1,1
61528,445,0,0,drop,66,66,0,1,0,1,0
51849,21091,51027,21091,allow,316,136,180,6,7,3,3
55625,443,33412,443,allow,96323,4044,92279,113,139,44,69
54076,445,0,0,drop,70,70,0,1,0,1,0
18246,64097,0,0,deny,66,66,0,1,0,1,0
58338,3353,0,0,deny,60,60,0,1,0,1,0
51956,443,35785,443,allow,5065,1658,3407,21,16,13,8
25565,55690,0,0,deny,60,60,0,1,0,1,0
62015,445,0,0,drop,70,70,0,1,0,1,0
60055,53,0,0,allow,82,82,0,1,30,1,0
65025,57866,0,0,deny,62,62,0,1,0,1,0
61755,445,0,0,drop,70,70,0,1,0,1,0
65264,53,15709,53,allow,178,94,84,2,29,1,1
45941,23386,0,0,deny,60,60,0,1,0,1,0
4545,1900,0,0,deny,136,136,0,1,0,1,0
56925,53,26704,53,allow,275,110,165,2,29,1,1
56415,445,0,0,drop,70,70,0,1,0,1,0
50627,443,54044,443,allow,5427,3497,1930,23,141,13,10
50541,53,14016,53,allow,458,188,270,6,30,3,3
50107,53,50107,53,allow,216,89,127,2,30,1,1
52892,443,14885,443,allow,130,70,60,2,14,1,1
53224,443,28053,443,allow,6001,982,5019,19,65,10,9
55896,53,50702,53,allow,184,94,90,2,31,1,1
53161,443,60488,443,allow,9458,4646,4812,26,25,14,12
49861,445,0,0,drop,70,70,0,1,0,1,0
6247,51221,0,0,deny,78,78,0,1,0,1,0
53228,443,43258,443,allow,5026,973,4053,19,59,10,9
5751,64147,0,0,deny,66,66,0,1,0,1,0
48020,7484,0,0,deny,60,60,0,1,0,1,0
47551,443,47551,443,allow,4743,1836,2907,19,29,11,8
26921,37965,0,0,deny,62,62,0,1,0,1,0
62380,445,0,0,drop,70,70,0,1,0,1,0
53580,445,0,0,drop,70,70,0,1,0,1,0
65506,443,5450,443,allow,92243,4519,87724,105,16,39,66
55429,53,62139,53,allow,182,102,80,2,30,1,1
26755,443,24399,443,allow,7283,2586,4697,22,19,11,11
55260,53,35785,53,allow,183,94,89,2,30,1,1
50466,445,0,0,drop,66,66,0,1,0,1,0
37759,53,22729,53,allow,164,78,86,2,30,1,1
42361,23,0,0,deny,60,60,0,1,0,1,0
64137,53,61015,53,allow,216,102,114,2,30,1,1
30188,41184,4045,41184,allow,509,150,359,2,1200,1,1
58402,53,52417,53,allow,578,286,292,9,15,5,4
63944,30188,0,0,deny,66,66,0,1,0,1,0
50027,80,48247,80,allow,3648,2069,1579,16,85,9,7
4323,64147,0,0,deny,62,62,0,1,0,1,0
65398,7129,0,0,deny,62,62,0,1,0,1,0
53317,445,0,0,drop,70,70,0,1,0,1,0
65350,53,48988,53,allow,168,86,82,2,30,1,1
61465,80,64777,80,allow,17320,9430,7890,67,93,35,32
52604,25174,0,0,deny,66,66,0,1,0,1,0
37900,53,2466,53,allow,78,78,0,1,30,1,0
54986,53,11167,53,allow,212,108,104,2,31,1,1
1024,25174,0,0,deny,62,62,0,1,0,1,0
53721,443,9349,443,allow,499,425,74,4,0,3,1
56550,53,53287,53,allow,166,86,80,2,29,1,1
443,10010,0,0,deny,60,60,0,1,0,1,0
56578,25174,0,0,deny,66,66,0,1,0,1,0
31035,23,0,0,deny,60,60,0,1,0,1,0
51798,445,0,0,drop,70,70,0,1,0,1,0
56143,53,31546,53,allow,748,106,642,2,31,1,1
62819,445,0,0,drop,70,70,0,1,0,1,0
56480,445,0,0,drop,70,70,0,1,0,1,0
57027,53,37270,53,allow,177,94,83,2,30,1,1
62470,445,0,0,drop,66,66,0,1,0,1,0
58932,53,21682,53,allow,168,78,90,2,31,1,1
25602,64147,0,0,deny,62,62,0,1,0,1,0
50418,53,14403,53,allow,177,94,83,2,30,1,1
59661,443,56024,443,allow,9055,2404,6651,24,126,13,11
56862,443,9641,443,allow,7819,1662,6157,20,76,11,9
42749,53,42749,53,allow,847,110,737,2,30,1,1
64071,53,55557,53,allow,194,102,92,2,31,1,1
51533,44847,0,0,deny,66,66,0,1,0,1,0
51810,445,0,0,drop,70,70,0,1,0,1,0
57622,7000,57622,7000,allow,2343,856,1487,17,16,10,7
53513,56205,0,0,deny,62,62,0,1,0,1,0
63037,443,11934,443,allow,303,85,218,2,31,1,1
43584,24748,0,0,deny,156,156,0,1,0,1,0
55199,445,0,0,drop,66,66,0,1,0,1,0
58011,445,0,0,drop,70,70,0,1,0,1,0
51414,22,0,0,deny,60,60,0,1,0,1,0
53809,443,5069,443,allow,499,425,74,4,0,3,1
57201,53,40982,53,allow,214,110,104,2,29,1,1
60465,445,0,0,drop,70,70,0,1,0,1,0
57732,445,0,0,drop,70,70,0,1,0,1,0
45238,44847,0,0,deny,62,62,0,1,0,1,0
39312,443,51370,443,allow,10148,2203,7945,37,120,19,18
54324,445,0,0,drop,66,66,0,1,0,1,0
57382,53,8955,53,allow,184,94,90,2,31,1,1
57694,445,0,0,drop,70,70,0,1,0,1,0
60632,53,3971,53,allow,179,86,93,2,29,1,1
32381,50584,0,0,deny,66,66,0,1,0,1,0
45964,3111,0,0,deny,60,60,0,1,0,1,0
61404,445,0,0,drop,70,70,0,1,0,1,0
24471,32167,0,0,deny,60,60,0,1,0,1,0
13528,51221,0,0,deny,62,62,0,1,0,1,0
48992,443,21581,443,allow,5952,1328,4624,19,76,11,8
443,43775,0,0,deny,97,97,0,1,0,1,0
55654,18251,23263,18251,allow,70,70,0,2,8,2,0
58773,445,0,0,drop,70,70,0,1,0,1,0
49205,29020,24277,29020,allow,316,136,180,6,7,3,3
14777,25174,0,0,deny,62,62,0,1,0,1,0
80,61486,0,0,deny,66,66,0,1,0,1,0
6889,8055,0,0,deny,143,143,0,1,0,1,0
50022,53,3051,53,allow,179,94,85,2,30,1,1
16052,25174,0,0,deny,146,146,0,1,0,1,0
53259,443,54002,443,allow,6250,1774,4476,27,17,14,13
49593,80,60078,80,allow,7098,5692,1406,17,41,9,8
38363,5900,0,0,deny,60,60,0,1,0,1,0
18745,64147,0,0,deny,62,62,0,1,0,1,0
53111,50809,43690,50809,allow,70,70,0,1,4,1,0
35889,443,19640,443,allow,6982,1728,5254,23,27,13,10
50079,443,27272,443,allow,20880,7976,12904,41,47,22,19
49904,445,0,0,drop,70,70,0,1,0,1,0
53815,44847,0,0,deny,62,62,0,1,0,1,0
50414,80,48434,80,allow,1657,1246,411,8,15,5,3
56936,53,1448,53,allow,244,94,150,2,30,1,1
62912,53,42026,53,allow,214,76,138,2,30,1,1
53006,443,46019,443,allow,17711,5894,11817,47,96,24,23
51837,37610,19513,37610,allow,316,136,180,6,5,3,3
42117,443,44867,443,allow,9999,4008,5991,33,345,18,15
59715,3389,59715,3389,allow,3331,1442,1889,15,17,8,7
36209,443,44738,443,allow,656609,25419,631190,752,62,322,430
443,42788,0,0,deny,74,74,0,1,0,1,0
41027,80,63019,80,allow,540,540,0,10,186,10,0
53987,16571,20059,16571,allow,70,70,0,1,5,1,0
49160,40527,18392,40527,allow,854,150,704,4,1201,2,2
2422,50584,0,0,deny,66,66,0,1,0,1,0
53722,443,25032,443,allow,499,425,74,4,0,3,1
50265,16082,44635,16082,allow,858,858,0,14,1200,14,0
25565,50263,0,0,deny,60,60,0,1,0,1,0
50091,53,50600,53,allow,164,86,78,2,30,1,1
62487,445,0,0,drop,66,66,0,1,0,1,0
51115,445,0,0,drop,70,70,0,1,0,1,0
49562,80,14517,80,allow,318,192,126,6,45,4,2
63564,445,0,0,drop,66,66,0,1,0,1,0
64276,53,2055,53,allow,436,89,347,4,42,2,2
55141,445,0,0,drop,70,70,0,1,0,1,0
2697,28189,0,0,deny,60,60,0,1,0,1,0
56852,53,36624,53,allow,762,101,661,2,31,1,1
50347,445,0,0,drop,70,70,0,1,0,1,0
62765,16933,0,0,deny,66,66,0,1,0,1,0
7891,25174,0,0,deny,66,66,0,1,0,1,0
53971,18810,62225,18810,allow,70,70,0,2,8,2,0
53922,42285,1496,42285,allow,70,70,0,1,4,1,0
30960,45762,15257,45762,allow,330,330,0,6,3609,6,0
30960,45737,31575,45737,allow,330,330,0,6,3609,6,0
56086,53,3627,53,allow,172,94,78,2,30,1,1
64659,53,14647,53,allow,464,99,365,4,39,2,2
3818,37965,0,0,deny,66,66,0,1,0,1,0
58638,5900,0,0,deny,62,62,0,1,0,1,0
55859,53,59697,53,allow,210,110,100,2,30,1,1
63848,64147,0,0,deny,66,66,0,1,0,1,0
1462,41599,5098,41599,allow,70,70,0,1,5,1,0
49692,53,19952,53,allow,208,106,102,2,30,1,1
56667,53,46013,53,allow,168,86,82,2,30,1,1
25778,53,25778,53,allow,235,90,145,2,33,1,1
49556,53,62658,53,allow,300,100,200,4,44,2,2
17750,50321,45531,50321,allow,491,150,341,2,1200,1,1
58001,80,18559,80,allow,20532,14664,5868,47,75,24,23
63385,25174,0,0,deny,66,66,0,1,0,1,0
59414,445,0,0,drop,66,66,0,1,0,1,0
56523,445,0,0,drop,66,66,0,1,0,1,0
8282,17435,17967,17435,allow,73,73,0,1,30,1,0
53496,3389,53496,3389,allow,3624,1910,1714,19,33,11,8
35063,443,32697,443,allow,7105,1924,5181,20,25,10,10
24174,57470,0,0,deny,62,62,0,1,0,1,0
53119,445,0,0,drop,70,70,0,1,0,1,0
36936,53,30039,53,allow,78,78,0,1,30,1,0
65209,53,36498,53,allow,166,86,80,2,30,1,1
37604,443,53490,443,allow,8493,2314,6179,33,16,18,15
65220,53,61957,53,allow,811,94,717,2,30,1,1
51788,443,22272,443,allow,3679,1712,1967,14,135,7,7
63538,445,0,0,drop,70,70,0,1,0,1,0
65307,53,2186,53,allow,184,94,90,2,31,1,1
63016,53,49407,53,allow,243,94,149,2,30,1,1
50768,445,0,0,drop,70,70,0,1,0,1,0
54632,445,0,0,drop,66,66,0,1,0,1,0
51902,55933,35723,55933,allow,316,136,180,6,5,3,3
59822,56205,0,0,deny,66,66,0,1,0,1,0
53115,443,63976,443,allow,9616,6956,2660,39,47,21,18
56567,445,0,0,drop,70,70,0,1,0,1,0
65040,53,33364,53,allow,178,94,84,2,30,1,1
64531,53,41084,53,allow,183,94,89,2,30,1,1
56904,80,52022,80,allow,25125,2681,22444,36,318,19,17
58080,3389,58080,3389,allow,3564,1850,1714,18,32,10,8
56620,443,7502,443,allow,8033,2013,6020,20,16,11,9
46415,443,41654,443,allow,9307,2265,7042,31,325,13,18
46670,51505,0,0,deny,62,62,0,1,0,1,0
24874,55108,0,0,deny,145,145,0,1,0,1,0
50665,443,2947,443,allow,2626,1638,988,19,83,11,8
16387,45121,0,0,deny,60,60,0,1,0,1,0
65516,53,4200,53,allow,290,94,196,4,41,2,2
49699,53,53158,53,allow,209,110,99,2,30,1,1
53109,80,20052,80,allow,8176,1443,6733,20,15,10,10
57637,445,0,0,drop,70,70,0,1,0,1,0
40598,23,0,0,deny,60,60,0,1,0,1,0
52111,44847,0,0,deny,66,66,0,1,0,1,0
50876,445,0,0,drop,70,70,0,1,0,1,0
63758,57825,49491,57825,allow,312,132,180,6,6,3,3
50821,445,0,0,drop,70,70,0,1,0,1,0
59662,445,0,0,drop,66,66,0,1,0,1,0
7151,37965,0,0,deny,66,66,0,1,0,1,0
64986,53,36194,53,allow,182,93,89,2,31,1,1
50253,53,23205,53,allow,167,86,81,2,31,1,1
55790,445,0,0,drop,66,66,0,1,0,1,0
27005,1305,52487,1305,allow,855,126,729,2,30,1,1
46860,53,42204,53,allow,447,101,346,4,29,2,2
50440,80,41548,80,allow,318,192,126,6,26,4,2
59864,443,10819,443,allow,6066,833,5233,19,26,10,9
49885,445,0,0,drop,70,70,0,1,0,1,0
51924,28016,53313,28016,allow,70,70,0,1,5,1,0
56646,48817,0,0,deny,62,62,0,1,0,1,0
54432,53,45895,53,allow,168,78,90,2,30,1,1
55276,53,37772,53,allow,215,94,121,2,30,1,1
52227,64147,0,0,deny,62,62,0,1,0,1,0
57289,31573,0,0,deny,66,66,0,1,0,1,0
63465,56205,0,0,deny,66,66,0,1,0,1,0
49534,445,0,0,drop,70,70,0,1,0,1,0
52228,445,0,0,drop,70,70,0,1,0,1,0
55926,445,0,0,drop,70,70,0,1,0,1,0
65534,53,65534,53,allow,414,268,146,3,31,2,1
34720,443,52073,443,allow,6453,2318,4135,32,84,16,16
55848,53,34320,53,allow,168,86,82,2,30,1,1
34484,53,27104,53,allow,86,86,0,1,30,1,0
56676,37965,0,0,deny,62,62,0,1,0,1,0
54365,64147,0,0,deny,62,62,0,1,0,1,0
52280,44847,0,0,deny,66,66,0,1,0,1,0
26301,22114,0,0,deny,146,146,0,1,0,1,0
63400,57470,0,0,deny,66,66,0,1,0,1,0
59146,445,0,0,drop,70,70,0,1,0,1,0
65350,53,48602,53,allow,168,86,82,2,31,1,1
45862,443,6882,443,allow,234,234,0,4,11,4,0
64219,53,14756,53,allow,403,94,309,4,38,2,2
63527,445,0,0,drop,70,70,0,1,0,1,0
65422,445,0,0,drop,70,70,0,1,0,1,0
37902,123,60994,123,allow,184,94,90,2,30,1,1
57136,53,36933,53,allow,209,110,99,2,31,1,1
55155,53,65476,53,allow,188,96,92,2,31,1,1
61241,22114,0,0,deny,66,66,0,1,0,1,0
55207,443,50638,443,allow,1803,1029,774,16,185,9,7
46046,443,33761,443,allow,11019,4673,6346,32,423,17,15
54516,53,54516,53,allow,235,90,145,2,33,1,1
5588,5588,0,0,allow,3498,1872,1626,48,195,24,24
27005,27019,23362,27019,allow,873,126,747,2,31,1,1
52658,64147,0,0,deny,145,145,0,1,0,1,0
50660,445,0,0,drop,66,66,0,1,0,1,0
56066,445,0,0,drop,66,66,0,1,0,1,0
64535,37965,0,0,deny,62,62,0,1,0,1,0
51170,443,40281,443,allow,9894856,232425,9662431,9829,90,3300,6529
65442,445,0,0,drop,70,70,0,1,0,1,0
54051,28793,0,0,deny,66,66,0,1,0,1,0
34732,53,8209,53,allow,86,86,0,1,30,1,0
55934,53,51844,53,allow,731,85,646,2,30,1,1
26651,25174,0,0,deny,62,62,0,1,0,1,0
49508,53,61449,53,allow,370,102,268,2,30,1,1
52933,80,52933,80,allow,98765,5293,93472,131,199,48,83
27144,25174,0,0,deny,66,66,0,1,0,1,0
55032,62413,0,0,deny,62,62,0,1,0,1,0
57109,53,37634,53,allow,168,86,82,2,31,1,1
51544,44847,0,0,deny,146,146,0,1,0,1,0
56656,443,24919,443,allow,1342,918,424,10,25,6,4
48344,443,10226,443,allow,68467,4750,63717,100,276,48,52
37965,1,53190,1,allow,330,330,0,6,1199,6,0
56582,445,0,0,drop,66,66,0,1,0,1,0
65012,32468,0,0,deny,62,62,0,1,0,1,0
42166,443,46667,443,allow,162,102,60,2,5,1,1
63305,62413,0,0,deny,66,66,0,1,0,1,0
58638,5900,0,0,deny,62,62,0,1,0,1,0
49160,51413,36529,51413,allow,800,150,650,4,1200,2,2
63358,445,0,0,drop,70,70,0,1,0,1,0
64116,53,59357,53,allow,87,87,0,1,31,1,0
61916,445,0,0,drop,70,70,0,1,0,1,0
51544,445,0,0,drop,70,70,0,1,0,1,0
53375,445,0,0,drop,70,70,0,1,0,1,0
55902,53,8610,53,allow,181,94,87,2,31,1,1
53227,64097,0,0,deny,66,66,0,1,0,1,0
50375,50584,0,0,deny,62,62,0,1,0,1,0
51911,14543,57115,14543,allow,70,70,0,2,8,2,0
58153,445,0,0,drop,70,70,0,1,0,1,0
54717,445,0,0,drop,70,70,0,1,0,1,0
56472,53,0,0,allow,371,77,294,2,30,1,1
50051,53,51528,53,allow,766,102,664,2,30,1,1
33171,443,48753,443,allow,6509,973,5536,17,25,10,7
49619,53,1376,53,allow,184,86,98,2,30,1,1
61113,27045,20306,27045,allow,1778,1386,392,8,30,4,4
59767,445,0,0,drop,70,70,0,1,0,1,0
49491,445,0,0,drop,70,70,0,1,0,1,0
49212,80,1671,80,allow,1013,566,447,8,134,5,3
51745,2572,13644,2572,allow,70,70,0,2,8,2,0
59677,443,25449,443,allow,13551,5488,8063,33,95,16,17
50411,80,65137,80,allow,1657,1246,411,8,15,5,3
6247,51221,0,0,deny,78,78,0,1,0,1,0
58269,445,0,0,drop,70,70,0,1,0,1,0
57470,32517,51554,32517,allow,166,166,0,1,1199,1,0
14692,25174,0,0,deny,146,146,0,1,0,1,0
48885,53,48885,53,allow,215,80,135,2,32,1,1
51940,53,28110,53,allow,199,94,105,2,30,1,1
56301,443,56301,443,allow,4378,1471,2907,19,30,11,8
59018,22114,0,0,deny,62,62,0,1,0,1,0
55204,53,55204,53,allow,239,98,141,2,30,1,1
53011,80,53011,80,allow,349769,6527,343242,368,22,100,268
50330,445,0,0,drop,70,70,0,1,0,1,0
51967,443,38807,443,allow,10684,3167,7517,43,34,24,19
50191,445,0,0,drop,70,70,0,1,0,1,0
56474,18375,0,0,deny,62,62,0,1,0,1,0
57672,445,0,0,drop,66,66,0,1,0,1,0
34809,57470,0,0,deny,66,66,0,1,0,1,0
49516,35894,0,0,deny,145,145,0,1,0,1,0
5588,5588,0,0,allow,3354,1792,1562,46,194,23,23
65503,53,13139,53,allow,177,94,83,2,30,1,1
51263,443,3091,443,allow,8247,2116,6131,23,360,11,12
53917,35885,37941,35885,allow,70,70,0,1,4,1,0
55565,64147,0,0,deny,62,62,0,1,0,1,0
55216,445,0,0,drop,70,70,0,1,0,1,0
55841,53,22596,53,allow,265,86,179,4,59,2,2
52170,443,36243,443,allow,7228,1589,5639,22,362,11,11
49312,445,0,0,drop,66,66,0,1,0,1,0
53365,445,0,0,drop,70,70,0,1,0,1,0
53824,41482,38792,41482,allow,70,70,0,2,8,2,0
49418,27017,12250,27017,allow,239,78,161,2,30,1,1
60065,80,60065,80,allow,246733,5745,240988,246,144,80,166
51689,53,34111,53,allow,198,86,112,2,30,1,1
56327,44512,0,0,deny,66,66,0,1,0,1,0
58638,5900,0,0,deny,62,62,0,1,0,1,0
64374,53,21599,53,allow,211,94,117,2,30,1,1
49684,53,21165,53,allow,305,94,211,2,29,1,1
58934,443,63790,443,allow,5167,700,4467,16,15,7,9
20400,64147,0,0,deny,145,145,0,1,0,1,0
63991,53,7605,53,allow,193,102,91,2,30,1,1
55452,53,54913,53,allow,184,94,90,2,30,1,1
50582,80,62835,80,allow,53959,2683,51276,69,16,30,39
57339,53,43284,53,allow,184,80,104,2,30,1,1
56581,25174,0,0,deny,146,146,0,1,0,1,0
50938,80,32549,80,allow,10272889,104948,10167941,8416,121,1525,6891
62892,443,62892,443,allow,4377,1470,2907,19,30,11,8
37179,443,24898,443,allow,7440,3165,4275,31,358,17,14
55269,53,51344,53,allow,193,102,91,2,30,1,1
64986,27049,14066,27049,allow,1764,924,840,6,31,3,3
3691,80,6351,80,allow,6826,1214,5612,20,105,12,8
56720,53,20064,53,allow,177,94,83,2,30,1,1
50405,443,58184,443,allow,612,280,332,10,26,5,5
63362,445,0,0,drop,70,70,0,1,0,1,0
64338,53,13922,53,allow,298,102,196,4,43,2,2
34932,38608,0,0,deny,62,62,0,1,0,1,0
64937,53,3891,53,allow,360,118,242,2,30,1,1
56715,445,0,0,drop,70,70,0,1,0,1,0
60883,64147,0,0,deny,74,74,0,1,0,1,0
49209,53,27106,53,allow,199,102,97,2,31,1,1
52570,80,52570,80,allow,3886,696,3190,13,142,6,7
55687,53,59046,53,allow,186,95,91,2,31,1,1
43701,3389,43701,3389,allow,3910,1805,2105,20,19,12,8
443,38956,0,0,deny,82,82,0,1,0,1,0
53721,62413,0,0,deny,62,62,0,1,0,1,0
64828,53,23782,53,allow,372,94,278,2,30,1,1
64988,27052,9710,27052,allow,735,462,273,2,31,1,1
40571,26467,0,0,deny,62,62,0,1,0,1,0
64279,23718,0,0,deny,62,62,0,1,0,1,0
57019,53,12115,53,allow,186,95,91,2,30,1,1
39416,443,22181,443,allow,621104,12188,608916,575,78,149,426
49418,27016,45260,27016,allow,255,78,177,2,30,1,1
60187,443,13141,443,allow,9875,1112,8763,21,125,10,11
49342,53,10156,53,allow,443,182,261,6,30,3,3
50511,443,12647,443,allow,6352,1073,5279,22,85,12,10
52714,443,48732,443,allow,26399,2076,24323,37,319,15,22
5588,5588,0,0,allow,3354,1792,1562,46,194,23,23
43156,53,17212,53,allow,168,78,90,2,29,1,1
443,1785,0,0,deny,97,97,0,1,0,1,0
58081,3389,58081,3389,allow,3549,1594,1955,18,16,10,8
58383,53,25867,53,allow,357,87,270,2,31,1,1
56840,20413,2836,20413,allow,66,66,0,1,5,1,0
53940,445,0,0,drop,66,66,0,1,0,1,0
51969,80,41756,80,allow,7304882,206543,7098339,7398,37,2677,4721
54968,53,43253,53,allow,199,102,97,2,30,1,1
50137,1433,0,0,deny,60,60,0,1,0,1,0
52644,57209,0,0,deny,66,66,0,1,0,1,0
56495,80,7502,80,allow,32396,2695,29701,46,135,22,24
56020,445,0,0,drop,66,66,0,1,0,1,0
55624,53,14345,53,allow,198,101,97,2,31,1,1
56998,80,16426,80,allow,214,140,74,4,35,3,1
55180,53,4513,53,allow,209,110,99,2,30,1,1
52509,445,0,0,drop,70,70,0,1,0,1,0
49862,53,51904,53,allow,194,102,92,2,30,1,1
56922,29434,0,0,deny,107,107,0,1,0,1,0
53944,23280,32203,23280,allow,1740,834,906,16,16,10,6
19874,3389,19874,3389,allow,4145,1976,2169,22,18,13,9
9068,443,2083,443,allow,5045,2005,3040,14,119,7,7
57066,53,53308,53,allow,778,103,675,2,30,1,1
54033,443,63656,443,allow,190,70,120,4,15,2,2
50871,443,47245,443,allow,9241,2001,7240,24,28,14,10
26528,51221,0,0,deny,78,78,0,1,0,1,0
9518,1,0,0,deny,100,100,0,1,0,1,0
3352,50584,0,0,deny,66,66,0,1,0,1,0
55349,445,0,0,drop,70,70,0,1,0,1,0
34465,443,9083,443,allow,1402,910,492,11,360,6,5
50137,53,54059,53,allow,183,94,89,2,31,1,1
64940,26467,0,0,deny,62,62,0,1,0,1,0
50063,53,53923,53,allow,173,94,79,2,30,1,1
49850,53,46784,53,allow,166,86,80,2,30,1,1
44207,44847,0,0,deny,66,66,0,1,0,1,0
63190,445,0,0,drop,70,70,0,1,0,1,0
14433,443,47619,443,allow,2589,1443,1146,18,15,8,10
993,3979,0,0,deny,129,129,0,1,0,1,0
57194,53,31354,53,allow,2198,193,2005,6,90,3,3
50122,443,28442,443,allow,130,70,60,2,15,1,1
64772,64147,0,0,deny,62,62,0,1,0,1,0
65370,53,10592,53,allow,193,102,91,2,30,1,1
35849,30188,0,0,deny,62,62,0,1,0,1,0
33948,15503,0,0,deny,146,146,0,1,0,1,0
52837,35440,0,0,deny,66,66,0,1,0,1,0
51431,445,0,0,drop,70,70,0,1,0,1,0
44883,53,44883,53,allow,216,90,126,2,29,1,1
55163,53,20116,53,allow,197,102,95,2,31,1,1
50309,80,22924,80,allow,2481,723,1758,12,57,6,6
60527,445,0,0,drop,70,70,0,1,0,1,0
50319,53,7471,53,allow,194,102,92,2,30,1,1
28624,23,0,0,deny,60,60,0,1,0,1,0
55373,445,0,0,drop,70,70,0,1,0,1,0
21844,50584,0,0,deny,146,146,0,1,0,1,0
57394,53,16872,53,allow,186,95,91,2,31,1,1
0,0,0,0,allow,244,244,0,2,0,2,0
64069,443,44966,443,allow,11223,3362,7861,62,280,27,35
50559,53,4402,53,allow,216,110,106,2,31,1,1
51946,9407,60623,9407,allow,70,70,0,1,4,1,0
58642,445,0,0,drop,66,66,0,1,0,1,0
52241,51717,30281,51717,allow,70,70,0,2,5,2,0
51558,37965,0,0,deny,72,72,0,1,0,1,0
59885,443,10109,443,allow,1401,864,537,12,28,6,6
40600,53,40600,53,allow,228,90,138,2,30,1,1
47040,443,54181,443,allow,10326,4295,6031,29,62,16,13
52334,445,0,0,drop,70,70,0,1,0,1,0
29159,39004,0,0,deny,62,62,0,1,0,1,0
57788,445,0,0,drop,70,70,0,1,0,1,0
37680,443,37680,443,allow,4592,1685,2907,19,29,11,8
64505,445,0,0,drop,66,66,0,1,0,1,0
62014,35440,0,0,deny,66,66,0,1,0,1,0
59324,53,10357,53,allow,211,78,133,2,30,1,1
57258,445,0,0,drop,66,66,0,1,0,1,0
52599,53,38138,53,allow,338,94,244,2,29,1,1
55715,443,4116,443,allow,1648,114,1534,5,120,2,3
1866,51505,0,0,deny,66,66,0,1,0,1,0
31112,50584,0,0,deny,62,62,0,1,0,1,0
29076,53,29076,53,allow,231,90,141,2,31,1,1
57634,445,0,0,drop,66,66,0,1,0,1,0
55420,53,27651,53,allow,177,94,83,2,29,1,1
50562,37965,0,0,deny,66,66,0,1,0,1,0
56944,35894,0,0,deny,62,62,0,1,0,1,0
41891,443,2286,443,allow,235626,4546,231080,232,339,53,179
8282,40200,5762,40200,allow,133,64,69,3,30,2,1
50564,445,0,0,drop,66,66,0,1,0,1,0
6666,50070,0,0,deny,60,60,0,1,0,1,0
64376,53,21911,53,allow,210,94,116,2,30,1,1
17415,25174,0,0,deny,62,62,0,1,0,1,0
51479,25174,0,0,deny,66,66,0,1,0,1,0
53287,445,0,0,drop,66,66,0,1,0,1,0
50143,35253,0,0,deny,66,66,0,1,0,1,0
58279,445,0,0,drop,70,70,0,1,0,1,0
38288,443,40759,443,allow,8627,2906,5721,10,121,4,6
55467,53,65023,53,allow,198,94,104,2,30,1,1
55951,53,16889,53,allow,194,99,95,2,31,1,1
27005,27015,38522,27015,allow,878,126,752,2,30,1,1
51815,28665,41311,28665,allow,70,70,0,2,7,2,0
54728,445,0,0,drop,66,66,0,1,0,1,0
49657,443,29231,443,allow,9039,2175,6864,32,20,17,15
49177,443,60972,443,allow,654956,17062,637894,673,18,244,429
33045,443,23219,443,allow,4446,1298,3148,15,34,8,7
50613,80,37228,80,allow,21942,2323,19619,28,21,11,17
55789,445,0,0,drop,66,66,0,1,0,1,0
64048,53,43444,53,allow,202,103,99,2,31,1,1
52895,445,0,0,drop,66,66,0,1,0,1,0
51931,19416,65025,19416,allow,70,70,0,2,8,2,0
51914,20777,59494,20777,allow,256,136,120,5,8,3,2
53330,443,1024,443,allow,5454,1157,4297,15,22,9,6
49615,445,0,0,drop,66,66,0,1,0,1,0
37469,53,51680,53,allow,168,78,90,2,30,1,1
21133,26205,8150,26205,allow,480,149,331,2,1200,1,1
63709,445,0,0,drop,70,70,0,1,0,1,0
65441,445,0,0,drop,70,70,0,1,0,1,0
61670,57470,0,0,deny,74,74,0,1,0,1,0
52346,5222,7493,5222,allow,3983,1663,2320,40,151,19,21
61178,53,58018,53,allow,290,86,204,2,30,1,1
52085,445,0,0,drop,66,66,0,1,0,1,0
55046,53,27327,53,allow,300,102,198,4,39,2,2
57206,443,4994,443,allow,1798,1223,575,13,28,8,5
49395,445,0,0,drop,70,70,0,1,0,1,0
123,123,34455,123,allow,184,94,90,2,30,1,1
48817,6881,48817,6881,allow,506,152,354,2,1200,1,1
61507,445,0,0,drop,70,70,0,1,0,1,0
64158,53,28086,53,allow,211,102,109,2,30,1,1
3667,56205,0,0,deny,146,146,0,1,0,1,0
56755,445,0,0,drop,66,66,0,1,0,1,0
52334,443,32129,443,allow,96091,8340,87751,159,205,75,84
51988,32239,13198,32239,allow,66,66,0,1,5,1,0
51387,445,0,0,drop,70,70,0,1,0,1,0
61189,443,61189,443,allow,1092,645,447,10,34,6,4
50802,445,0,0,drop,70,70,0,1,0,1,0
58638,5900,0,0,deny,62,62,0,1,0,1,0
59213,445,0,0,drop,70,70,0,1,0,1,0
52220,65128,1362,65128,allow,70,70,0,1,5,1,0
56532,53,65053,53,allow,164,86,78,2,29,1,1
61828,443,61828,443,allow,317388,25904,291484,338,200,128,210
58311,443,32362,443,allow,6128,1394,4734,24,146,10,14
64609,53,57916,53,allow,146,75,71,2,31,1,1
49181,2710,53031,2710,allow,70,70,0,2,8,2,0
65093,445,0,0,drop,66,66,0,1,0,1,0
49323,53,9705,53,allow,210,110,100,2,30,1,1
14263,22114,0,0,deny,62,62,0,1,0,1,0
59718,445,0,0,drop,70,70,0,1,0,1,0
51615,25174,0,0,deny,66,66,0,1,0,1,0
55900,53,53468,53,allow,194,102,92,2,30,1,1
53726,443,39961,443,allow,499,425,74,4,0,3,1
65330,53,59699,53,allow,766,102,664,2,29,1,1
50447,53,27142,53,allow,765,102,663,2,30,1,1
49395,445,0,0,drop,66,66,0,1,0,1,0
52854,445,0,0,drop,66,66,0,1,0,1,0
49777,445,0,0,drop,66,66,0,1,0,1,0
34677,51185,0,0,deny,60,60,0,1,0,1,0
61993,445,0,0,drop,66,66,0,1,0,1,0
2394,43890,0,0,deny,62,62,0,1,0,1,0
56776,445,0,0,drop,66,66,0,1,0,1,0
63469,445,0,0,drop,70,70,0,1,0,1,0
2522,64147,0,0,deny,62,62,0,1,0,1,0
50694,443,18706,443,allow,3097,1708,1389,15,19,9,6
37965,50321,10306,50321,allow,158,158,0,1,1199,1,0
39850,53,3565,53,allow,199,94,105,2,29,1,1
50518,445,0,0,drop,66,66,0,1,0,1,0
12909,47807,0,0,deny,148,148,0,1,0,1,0
49230,53,1845,53,allow,168,86,82,2,31,1,1
49992,445,0,0,drop,70,70,0,1,0,1,0
55856,445,0,0,drop,66,66,0,1,0,1,0
49459,443,10186,443,allow,10166,3392,6774,35,133,18,17
57382,53,15348,53,allow,969,86,883,2,30,1,1
65063,53,50094,53,allow,180,94,86,2,30,1,1
9302,443,20327,443,allow,4216,771,3445,16,26,9,7
51886,35965,10726,35965,allow,70,70,0,2,8,2,0
59739,35253,0,0,deny,62,62,0,1,0,1,0
49369,445,0,0,drop,70,70,0,1,0,1,0
50671,445,0,0,drop,66,66,0,1,0,1,0
11136,19910,0,0,deny,62,62,0,1,0,1,0
49534,53,11716,53,allow,193,102,91,2,31,1,1
43851,53,43851,53,allow,227,90,137,2,30,1,1
39198,443,37054,443,allow,6328,850,5478,26,289,9,17
40175,53,40175,53,allow,235,90,145,2,32,1,1
62930,21247,0,0,deny,66,66,0,1,0,1,0
54914,51505,0,0,deny,62,62,0,1,0,1,0
52361,23718,0,0,deny,66,66,0,1,0,1,0
2432,11392,0,0,deny,62,62,0,1,0,1,0
56173,445,0,0,drop,70,70,0,1,0,1,0
65031,53,9401,53,allow,184,94,90,2,30,1,1
51488,445,0,0,drop,70,70,0,1,0,1,0
49988,443,12921,443,allow,214,82,132,4,5,2,2
49621,53,6731,53,allow,501,188,313,6,33,3,3
64872,53,23783,53,allow,323,94,229,2,30,1,1
52870,22197,0,0,deny,66,66,0,1,0,1,0
19473,6889,17971,6889,allow,481,150,331,2,1200,1,1
40802,443,39888,443,allow,3321,1297,2024,13,32,7,6
52146,445,0,0,drop,70,70,0,1,0,1,0
54198,443,37713,443,allow,499,425,74,4,0,3,1
2062,35440,0,0,deny,66,66,0,1,0,1,0
37653,5223,43344,5223,allow,142,142,0,1,5,1,0
54688,443,54688,443,allow,149676,25300,124376,220,110,122,98
57331,53,50054,53,allow,178,94,84,2,30,1,1
50603,443,37566,443,allow,2928,1448,1480,17,20,10,7
49439,445,0,0,drop,66,66,0,1,0,1,0
53772,14132,42222,14132,allow,70,70,0,1,5,1,0
54224,53,18536,53,allow,199,94,105,2,30,1,1
50609,443,29620,443,allow,1738,1061,677,18,94,10,8
49921,53,27368,53,allow,214,110,104,2,30,1,1
39796,443,27327,443,allow,7425,2276,5149,24,16,12,12
64880,53,46886,53,allow,164,84,80,2,30,1,1
57131,7774,0,0,deny,145,145,0,1,0,1,0
59399,53,32458,53,allow,232,94,138,2,30,1,1
53227,64097,0,0,deny,62,62,0,1,0,1,0
55258,443,6481,443,allow,1786,172,1614,7,120,3,4
56183,53,23444,53,allow,179,94,85,2,30,1,1
51102,443,49198,443,allow,3402,1258,2144,13,135,6,7
62189,64147,0,0,deny,62,62,0,1,0,1,0
50177,443,50177,443,allow,5206,1389,3817,22,15,10,12
49969,445,0,0,drop,66,66,0,1,0,1,0
64892,53,1067,53,allow,751,95,656,2,30,1,1
60808,40010,35600,40010,allow,316,136,180,6,6,3,3
61441,445,0,0,drop,70,70,0,1,0,1,0
49621,53,9845,53,allow,183,94,89,2,29,1,1
33410,80,44582,80,allow,1570,754,816,10,15,6,4
54871,445,0,0,drop,70,70,0,1,0,1,0
40039,80,57862,80,allow,1155,781,374,10,15,6,4
54033,445,0,0,drop,70,70,0,1,0,1,0
62684,445,0,0,drop,70,70,0,1,0,1,0
52385,53,0,0,allow,139,70,69,2,30,1,1
58189,445,0,0,drop,70,70,0,1,0,1,0
62263,445,0,0,drop,70,70,0,1,0,1,0
49845,445,0,0,drop,66,66,0,1,0,1,0
44411,37965,0,0,deny,62,62,0,1,0,1,0
54555,25174,0,0,deny,66,66,0,1,0,1,0
63978,63776,58166,63776,allow,70,70,0,1,4,1,0
55156,53,61392,53,allow,188,96,92,2,30,1,1
55705,53,57706,53,allow,202,103,99,2,31,1,1
43604,53,41746,53,allow,168,78,90,2,30,1,1
49480,7000,49480,7000,allow,3050,1659,1391,16,15,9,7
55340,53,17205,53,allow,184,94,90,2,30,1,1
55044,443,65434,443,allow,14427,4574,9853,34,61,18,16
0,0,0,0,deny,156,156,0,2,0,2,0
20495,53,20495,53,allow,217,90,127,2,30,1,1
60877,443,6098,443,allow,8536,2392,6144,29,45,17,12
25504,53,50116,53,allow,311,86,225,2,30,1,1
35073,443,44227,443,allow,6201,1790,4411,24,330,13,11
55704,445,0,0,drop,66,66,0,1,0,1,0
52589,445,0,0,drop,70,70,0,1,0,1,0
64807,445,0,0,drop,66,66,0,1,0,1,0
20378,53,20378,53,allow,235,90,145,2,32,1,1
46409,35440,0,0,deny,66,66,0,1,0,1,0
38676,443,23921,443,allow,101056,3737,97319,107,15,35,72
3478,61463,0,0,deny,822,822,0,1,0,1,0
60484,52001,52870,52001,allow,320,140,180,6,8,3,3
26900,27017,21825,27017,allow,422,164,258,6,31,3,3
50336,53,11367,53,allow,240,76,164,2,30,1,1
60579,25174,0,0,deny,66,66,0,1,0,1,0
50109,445,0,0,drop,70,70,0,1,0,1,0
64695,53,9580,53,allow,186,95,91,2,31,1,1
57691,445,0,0,drop,70,70,0,1,0,1,0
56474,18375,0,0,deny,62,62,0,1,0,1,0
64580,53,58796,53,allow,200,94,106,2,30,1,1
56805,53,61616,53,allow,178,94,84,2,31,1,1
57097,443,3043,443,allow,3578432,133577,3444855,4291,426,1634,2657
18011,44847,0,0,deny,66,66,0,1,0,1,0
57593,28678,11489,28678,allow,1806,1806,0,22,225,22,0
53856,443,18832,443,allow,495,421,74,4,0,3,1
55258,53,4040,53,allow,177,94,83,2,30,1,1
54016,42707,0,0,deny,66,66,0,1,0,1,0
64813,7000,64813,7000,allow,1300,676,624,14,15,7,7
52313,445,0,0,drop,70,70,0,1,0,1,0
57905,445,0,0,drop,70,70,0,1,0,1,0
52957,80,46330,80,allow,156378,5406,150972,165,383,60,105
63796,60557,4607,60557,allow,70,70,0,1,5,1,0
55997,53,30863,53,allow,716,95,621,2,30,1,1
57318,443,48526,443,allow,5612,733,4879,16,15,9,7
64827,445,0,0,drop,70,70,0,1,0,1,0
56945,443,12296,443,allow,7818,2136,5682,31,322,14,17
56782,443,26053,443,allow,7956,1967,5989,20,15,11,9
59993,80,25071,80,allow,1883,1263,620,11,83,6,5
49611,53,47629,53,allow,184,94,90,2,29,1,1
56848,19556,15601,19556,allow,66,66,0,1,5,1,0
59095,57470,0,0,deny,66,66,0,1,0,1,0
52078,15518,47758,15518,allow,70,70,0,2,7,2,0
443,10010,0,0,deny,60,60,0,1,0,1,0
58457,445,0,0,drop,70,70,0,1,0,1,0
56456,1433,0,0,deny,60,60,0,1,0,1,0
65278,53,33473,53,allow,403,91,312,4,34,2,2
40781,443,52827,443,allow,448,78,370,7,20,2,5
15235,36237,0,0,deny,62,62,0,1,0,1,0
1025,35447,0,0,deny,62,62,0,1,0,1,0
65193,445,0,0,drop,66,66,0,1,0,1,0
55211,445,0,0,drop,70,70,0,1,0,1,0
64744,53,61506,53,allow,770,102,668,2,29,1,1
56908,445,0,0,drop,70,70,0,1,0,1,0
61016,445,0,0,drop,70,70,0,1,0,1,0
49418,27017,9977,27017,allow,260,78,182,2,31,1,1
54198,445,0,0,drop,66,66,0,1,0,1,0
57152,445,0,0,drop,66,66,0,1,0,1,0
49650,53,42506,53,allow,248,110,138,2,30,1,1
65188,445,0,0,drop,70,70,0,1,0,1,0
443,49988,0,0,deny,82,82,0,1,0,1,0
52938,64097,0,0,deny,66,66,0,1,0,1,0
59543,445,0,0,drop,66,66,0,1,0,1,0
64169,53,31527,53,allow,209,110,99,2,30,1,1
57577,443,27380,443,allow,39421,4980,34441,57,144,23,34
56986,53,24262,53,allow,170,87,83,2,30,1,1
53246,443,34451,443,allow,30174,2792,27382,47,323,19,28
64375,53,1918,53,allow,228,110,118,2,29,1,1
49762,53,16917,53,allow,184,94,90,2,30,1,1
57066,443,13444,443,allow,556770,88286,468484,777,202,314,463
62913,445,0,0,drop,70,70,0,1,0,1,0
57578,443,34885,443,allow,13999,3478,10521,33,134,15,18
32381,50584,0,0,deny,66,66,0,1,0,1,0
49539,53,50465,53,allow,177,94,83,2,30,1,1
51996,41888,46821,41888,allow,70,70,0,1,4,1,0
54104,80,15819,80,allow,214,140,74,4,15,3,1
55869,53,8327,53,allow,196,102,94,2,31,1,1
26658,25174,0,0,deny,62,62,0,1,0,1,0
51398,443,32490,443,allow,322,262,60,2,5,1,1
56633,53,46953,53,allow,342,99,243,4,32,2,2
6126,25174,0,0,deny,66,66,0,1,0,1,0
44258,25,0,0,deny,74,74,0,1,0,1,0
53629,51413,13341,51413,allow,70,70,0,2,7,2,0
55374,445,0,0,drop,66,66,0,1,0,1,0
49629,53,32885,53,allow,742,88,654,2,30,1,1
60782,3389,60782,3389,allow,3504,1790,1714,17,33,9,8
64798,53,14494,53,allow,178,94,84,2,30,1,1
24534,50584,0,0,deny,146,146,0,1,0,1,0
10262,11392,0,0,deny,62,62,0,1,0,1,0
55745,445,0,0,drop,66,66,0,1,0,1,0
8486,56205,0,0,deny,66,66,0,1,0,1,0
11344,42873,0,0,deny,62,62,0,1,0,1,0
49699,53,7442,53,allow,266,89,177,4,58,2,2
53814,6725,2877,6725,allow,70,70,0,2,7,2,0
49632,445,0,0,drop,70,70,0,1,0,1,0
65028,445,0,0,drop,70,70,0,1,0,1,0
59530,445,0,0,drop,70,70,0,1,0,1,0
62698,445,0,0,drop,66,66,0,1,0,1,0
62251,445,0,0,drop,70,70,0,1,0,1,0
57982,445,0,0,drop,70,70,0,1,0,1,0
57130,443,51431,443,allow,10724,3758,6966,38,403,13,25
49432,5228,59843,5228,allow,10635,3087,7548,41,3661,22,19
56751,445,0,0,drop,70,70,0,1,0,1,0
55758,445,0,0,drop,70,70,0,1,0,1,0
57129,445,0,0,drop,70,70,0,1,0,1,0
59476,23,0,0,deny,60,60,0,1,0,1,0
38059,443,31779,443,allow,25214,14000,11214,66,99,34,32
49717,57470,0,0,deny,62,62,0,1,0,1,0
57098,80,38453,80,allow,819,530,289,8,40,5,3
49523,80,32458,80,allow,1399,826,573,11,38,6,5
51012,445,0,0,drop,70,70,0,1,0,1,0
49938,57470,0,0,deny,66,66,0,1,0,1,0
58131,30228,0,0,deny,146,146,0,1,0,1,0
65073,53,50486,53,allow,195,102,93,2,29,1,1
57288,443,58142,443,allow,116807,21042,95765,315,19,161,154
43552,443,10231,443,allow,4680,2873,1807,26,53,15,11
57550,50584,0,0,deny,62,62,0,1,0,1,0
56695,443,5124,443,allow,8006,1986,6020,20,15,11,9
56737,445,0,0,drop,70,70,0,1,0,1,0
6666,138,0,0,deny,60,60,0,1,0,1,0
47504,53,47504,53,allow,174,77,97,2,30,1,1
52278,445,0,0,drop,70,70,0,1,0,1,0
39570,443,62469,443,allow,70,70,0,1,5,1,0
59178,53,27947,53,allow,260,86,174,2,30,1,1
49168,53,10918,53,allow,192,98,94,2,31,1,1
30782,36237,0,0,deny,62,62,0,1,0,1,0
49321,53,46028,53,allow,184,94,90,2,30,1,1
9312,443,24938,443,allow,4618,840,3778,16,26,9,7
63871,445,0,0,drop,70,70,0,1,0,1,0
12951,50584,0,0,deny,66,66,0,1,0,1,0
61281,445,0,0,drop,66,66,0,1,0,1,0
65460,53,50952,53,allow,215,102,113,2,29,1,1
46774,51050,0,0,deny,62,62,0,1,0,1,0
65446,53,26325,53,allow,210,110,100,2,30,1,1
50553,445,0,0,drop,66,66,0,1,0,1,0
56693,443,47203,443,allow,7862,1873,5989,20,16,11,9
60745,445,0,0,drop,70,70,0,1,0,1,0
56586,53,32780,53,allow,177,94,83,2,31,1,1
5588,5588,0,0,allow,3498,1872,1626,48,201,24,24
36601,443,32906,443,allow,16455,11185,5270,37,271,22,15
59666,53,55387,53,allow,497,118,379,2,30,1,1
30188,36914,20864,36914,allow,2668,1950,718,16,7827,14,2
57834,445,0,0,drop,70,70,0,1,0,1,0
16223,443,54966,443,allow,7461,1034,6427,21,16,11,10
14693,64147,0,0,deny,66,66,0,1,0,1,0
51015,64147,0,0,deny,62,62,0,1,0,1,0
19610,55839,0,0,deny,137,137,0,1,0,1,0
65355,443,1822,443,allow,3563945,186679,3377266,4424,723,1877,2547
443,9986,0,0,deny,297,297,0,1,0,1,0
64775,445,0,0,drop,70,70,0,1,0,1,0
64017,445,0,0,drop,66,66,0,1,0,1,0
60375,445,0,0,drop,66,66,0,1,0,1,0
49220,53,32308,53,allow,755,94,661,2,30,1,1
50737,445,0,0,drop,70,70,0,1,0,1,0
9520,32480,0,0,deny,62,62,0,1,0,1,0
56613,445,0,0,drop,70,70,0,1,0,1,0
57373,443,61209,443,allow,5620,927,4693,17,15,10,7
48219,55442,0,0,deny,66,66,0,1,0,1,0
26900,27017,28688,27017,allow,422,164,258,6,30,3,3
57949,445,0,0,drop,66,66,0,1,0,1,0
6881,6881,62439,6881,allow,502,150,352,2,1200,1,1
56744,31151,15345,31151,allow,1703,524,1179,9,30,5,4
46516,80,0,0,deny,60,60,0,1,0,1,0
62512,25174,0,0,deny,62,62,0,1,0,1,0
61589,445,0,0,drop,66,66,0,1,0,1,0
63520,445,0,0,drop,66,66,0,1,0,1,0
56390,53,2004,53,allow,701,88,613,2,30,1,1
53705,443,11151,443,allow,499,425,74,4,0,3,1
64224,53,56405,53,allow,280,94,186,2,30,1,1
55464,53,12452,53,allow,214,110,104,2,30,1,1
56397,53,29734,53,allow,174,89,85,2,31,1,1
58420,445,0,0,drop,66,66,0,1,0,1,0
58528,445,0,0,drop,66,66,0,1,0,1,0
61601,445,0,0,drop,70,70,0,1,0,1,0
6881,31026,35308,31026,allow,509,150,359,2,1199,1,1
57479,56205,0,0,deny,66,66,0,1,0,1,0
56997,53,32024,53,allow,273,102,171,2,30,1,1
56985,53,45052,53,allow,711,87,624,2,31,1,1
58638,5900,0,0,deny,62,62,0,1,0,1,0
65107,53,53716,53,allow,193,102,91,2,30,1,1
53048,445,0,0,drop,70,70,0,1,0,1,0
47149,443,19883,443,allow,5995,1092,4903,22,72,12,10
62902,32468,0,0,deny,66,66,0,1,0,1,0
65276,53,46929,53,allow,212,102,110,2,30,1,1
49178,2710,54926,2710,allow,70,70,0,2,7,2,0
60367,443,45021,443,allow,4847,963,3884,22,63,11,11
57882,445,0,0,drop,70,70,0,1,0,1,0
43835,443,28215,443,allow,11422,2361,9061,26,505,10,16
38334,22,38334,22,allow,9022,3349,5673,57,43,26,31
49706,443,36455,443,allow,32941,1850,31091,46,131,19,27
53798,53,26638,53,allow,224,86,138,2,30,1,1
53701,8999,10439,8999,allow,1328,960,368,10,32,5,5
58327,445,0,0,drop,66,66,0,1,0,1,0
55797,53,58319,53,allow,170,87,83,2,31,1,1
49418,27016,40313,27016,allow,71,71,0,1,30,1,0
52521,445,0,0,drop,66,66,0,1,0,1,0
56365,443,26003,443,allow,3734,1750,1984,24,203,12,12
27005,27015,24846,27015,allow,878,126,752,2,30,1,1
59258,80,59258,80,allow,107904,4143,103761,179,15,59,120
51760,50584,0,0,deny,66,66,0,1,0,1,0
37182,80,39276,80,allow,1638,1324,314,10,16,5,5
52418,46314,0,0,deny,66,66,0,1,0,1,0
50160,57470,0,0,deny,146,146,0,1,0,1,0
49931,443,45441,443,allow,3278,1835,1443,22,16,13,9
55176,53,23799,53,allow,181,94,87,2,30,1,1
56786,443,13825,443,allow,5698,906,4792,19,27,11,8
43725,443,24670,443,allow,82838,3838,79000,104,31,42,62
44032,161,0,0,allow,4491,2143,2348,24,30,12,12
10216,80,10216,80,allow,7548,1586,5962,18,21,8,10
23415,11392,0,0,deny,66,66,0,1,0,1,0
8999,49001,0,0,deny,146,146,0,1,0,1,0
49965,53,21038,53,allow,285,110,175,2,30,1,1
50104,445,0,0,drop,70,70,0,1,0,1,0
53939,445,0,0,drop,66,66,0,1,0,1,0
58127,445,0,0,drop,70,70,0,1,0,1,0
55335,445,0,0,drop,70,70,0,1,0,1,0
53688,445,0,0,drop,70,70,0,1,0,1,0
3478,61463,0,0,deny,933,933,0,1,0,1,0
64559,53,63710,53,allow,198,102,96,2,30,1,1
62892,445,0,0,drop,70,70,0,1,0,1,0
58638,5900,0,0,deny,62,62,0,1,0,1,0
23197,44847,0,0,deny,146,146,0,1,0,1,0
50502,445,0,0,drop,70,70,0,1,0,1,0
48817,57013,48817,57013,allow,158,158,0,1,1200,1,0
54610,445,0,0,drop,70,70,0,1,0,1,0
56907,53,38903,53,allow,293,102,191,2,29,1,1
58638,5900,0,0,deny,62,62,0,1,0,1,0
56148,37965,0,0,deny,66,66,0,1,0,1,0
27005,27017,40278,27017,allow,891,126,765,2,30,1,1
64041,53,28808,53,allow,380,92,288,4,37,2,2
63886,445,0,0,drop,66,66,0,1,0,1,0
3766,25174,0,0,deny,62,62,0,1,0,1,0
45289,80,45289,80,allow,144717,5580,139137,180,20,81,99
49930,53,51940,53,allow,258,110,148,2,30,1,1
45941,23388,0,0,deny,60,60,0,1,0,1,0
60085,445,0,0,drop,66,66,0,1,0,1,0
51385,443,10522,443,allow,8388,760,7628,20,145,6,14
57470,6881,22501,6881,allow,353,166,187,2,1199,1,1
49513,53,63183,53,allow,200,102,98,2,29,1,1
60875,56205,0,0,deny,66,66,0,1,0,1,0
64853,445,0,0,drop,70,70,0,1,0,1,0
65015,22114,0,0,deny,62,62,0,1,0,1,0
50758,445,0,0,drop,70,70,0,1,0,1,0
51320,445,0,0,drop,70,70,0,1,0,1,0
52601,445,0,0,drop,66,66,0,1,0,1,0
60245,25174,0,0,deny,62,62,0,1,0,1,0
55744,445,0,0,drop,66,66,0,1,0,1,0
20,17095,0,0,deny,554,554,0,1,0,1,0
65142,53,52775,53,allow,167,86,81,2,29,1,1
43093,443,25301,443,allow,7028,2558,4470,19,16,11,8
57470,44667,49855,44667,allow,480,149,331,2,1200,1,1
58318,15503,0,0,deny,66,66,0,1,0,1,0
64974,53,23445,53,allow,506,108,398,4,36,2,2
62049,443,63135,443,allow,9526,1375,8151,24,125,12,12
52975,445,0,0,drop,70,70,0,1,0,1,0
64964,53,38711,53,allow,197,102,95,2,30,1,1
59041,445,0,0,drop,70,70,0,1,0,1,0
63884,53,63884,53,allow,400,257,143,3,33,2,1
64273,53,36287,53,allow,239,94,145,2,30,1,1
34680,9595,34680,9595,allow,152,66,86,2,10,1,1
55231,445,0,0,drop,70,70,0,1,0,1,0
51865,61689,0,0,deny,66,66,0,1,0,1,0
50910,445,0,0,drop,66,66,0,1,0,1,0
52096,445,0,0,drop,70,70,0,1,0,1,0
57406,53,60835,53,allow,188,96,92,2,30,1,1
57540,445,0,0,drop,70,70,0,1,0,1,0
58638,5900,0,0,deny,62,62,0,1,0,1,0
42532,22114,0,0,deny,62,62,0,1,0,1,0
52582,445,0,0,drop,66,66,0,1,0,1,0
40368,123,25473,123,allow,184,94,90,2,30,1,1
33965,443,25810,443,allow,1409634,52704,1356930,1536,173,533,1003
57033,53,53118,53,allow,216,110,106,2,30,1,1
56934,53,21277,53,allow,216,110,106,2,31,1,1
50640,443,7427,443,allow,1533,950,583,14,85,8,6
60854,443,16841,443,allow,10447,2417,8030,26,16,15,11
63173,36237,0,0,deny,66,66,0,1,0,1,0
65278,53,45335,53,allow,264,110,154,2,30,1,1
56212,53,23655,53,allow,184,102,82,2,30,1,1
36486,80,36486,80,allow,15249,1015,14234,24,29,9,15
61073,445,0,0,drop,70,70,0,1,0,1,0
49805,6881,0,0,deny,66,66,0,1,0,1,0
50616,53,45129,53,allow,177,94,83,2,30,1,1
48180,143,0,0,deny,60,60,0,1,0,1,0
62956,443,13888,443,allow,829275,26662,802613,884,129,295,589
41748,443,37689,443,allow,4570,792,3778,15,15,8,7
56941,53,56569,53,allow,193,102,91,2,30,1,1
51736,34343,51970,34343,allow,70,70,0,1,5,1,0
51522,443,43510,443,allow,190,70,120,4,15,2,2
55048,80,23955,80,allow,3084,1646,1438,19,131,10,9
48258,37965,0,0,deny,62,62,0,1,0,1,0
50584,20824,62214,20824,allow,324,150,174,2,1200,1,1
64209,53,25156,53,allow,277,94,183,2,30,1,1
51411,443,3217,443,allow,1444,723,721,15,121,8,7
46286,21247,0,0,deny,146,146,0,1,0,1,0
34932,38608,0,0,deny,62,62,0,1,0,1,0
65128,443,26680,443,allow,3055,1759,1296,22,126,12,10
60875,50584,0,0,deny,66,66,0,1,0,1,0
52272,443,52272,443,allow,1615,941,674,15,20,7,8
64128,53,31311,53,allow,193,102,91,2,31,1,1
40785,443,32724,443,allow,646,292,354,10,41,5,5
49479,80,63239,80,allow,9192,4788,4404,30,126,17,13
50672,445,0,0,drop,66,66,0,1,0,1,0
55021,443,61578,443,allow,8042,2104,5938,27,26,15,12
52430,35440,0,0,deny,146,146,0,1,0,1,0
56497,53,16693,53,allow,177,94,83,2,30,1,1
59106,443,57756,443,allow,7398,2209,5189,23,35,11,12
60787,445,0,0,drop,70,70,0,1,0,1,0
34086,25174,0,0,deny,66,66,0,1,0,1,0
59974,443,38243,443,allow,354,140,214,6,130,3,3
53239,445,0,0,drop,66,66,0,1,0,1,0
64079,20233,52835,20233,allow,70,70,0,1,4,1,0
49444,53,42796,53,allow,401,88,313,4,38,2,2
47515,5900,0,0,deny,60,60,0,1,0,1,0
80,18811,0,0,deny,60,60,0,1,0,1,0
54060,445,0,0,drop,70,70,0,1,0,1,0
64942,53,4876,53,allow,284,102,182,4,37,2,2
65510,53,46580,53,allow,229,102,127,2,30,1,1
54811,443,21381,443,allow,3392,2305,1087,22,80,11,11
62315,445,0,0,drop,70,70,0,1,0,1,0
37048,53,15129,53,allow,168,78,90,2,29,1,1
54259,443,22869,443,allow,7508,2864,4644,18,75,11,7
28479,53,28479,53,allow,235,90,145,2,33,1,1
51495,443,20935,443,allow,55465,11462,44003,89,31,43,46
59127,445,0,0,drop,66,66,0,1,0,1,0
1114,46824,0,0,deny,62,62,0,1,0,1,0
61152,445,0,0,drop,66,66,0,1,0,1,0
63514,445,0,0,drop,66,66,0,1,0,1,0
53150,43918,23563,43918,allow,320,140,180,6,6,3,3
51930,80,17993,80,allow,1669,865,804,13,76,8,5
55268,53,2485,53,allow,193,102,91,2,30,1,1
57356,53,60821,53,allow,198,101,97,2,30,1,1
31974,51505,0,0,deny,66,66,0,1,0,1,0
65047,53,60656,53,allow,184,102,82,2,30,1,1
38290,443,29490,443,allow,6978,1169,5809,22,163,12,10
56526,53,57484,53,allow,210,102,108,2,30,1,1
50426,443,9963,443,allow,5713,1079,4634,15,26,8,7
54442,445,0,0,drop,70,70,0,1,0,1,0
51773,23728,42323,23728,allow,70,70,0,2,8,2,0
49757,53,31813,53,allow,177,94,83,2,31,1,1
58027,80,53632,80,allow,1225,711,514,11,15,5,6
55067,443,38448,443,allow,3136,2025,1111,19,26,10,9
57683,53,53315,53,allow,243,94,149,2,30,1,1
56488,80,17378,80,allow,64702,3709,60993,76,135,30,46
16522,26467,0,0,deny,62,62,0,1,0,1,0
49934,53,41301,53,allow,752,93,659,2,30,1,1
64729,80,64729,80,allow,40906,1105,39801,45,142,13,32
53738,443,58635,443,allow,499,425,74,4,0,3,1
65427,443,32092,443,allow,14205,1527,12678,13,147,2,11
56014,443,56014,443,allow,4334,1427,2907,19,30,11,8
52237,16801,7817,16801,allow,70,70,0,1,5,1,0
48015,443,45822,443,allow,19394,2961,16433,51,196,24,27
56811,44008,31634,44008,allow,3034,1547,1487,12,16,7,5
51787,80,42388,80,allow,26626,1555,25071,36,20,16,20
49313,53,6801,53,allow,295,101,194,4,31,2,2
61700,53,61700,53,allow,221,90,131,2,30,1,1
51648,80,61615,80,allow,3227,2425,802,9,31,5,4
50328,22114,0,0,deny,66,66,0,1,0,1,0
56754,53,65237,53,allow,183,94,89,2,30,1,1
52790,445,0,0,drop,70,70,0,1,0,1,0
58638,5900,0,0,deny,62,62,0,1,0,1,0
64219,53,37826,53,allow,264,102,162,2,30,1,1
50347,443,6764,443,allow,1385,868,517,12,30,6,6
65521,445,0,0,drop,66,66,0,1,0,1,0
55971,445,0,0,drop,70,70,0,1,0,1,0
43095,443,34288,443,allow,6513,2043,4470,20,17,12,8
57262,53,12912,53,allow,180,94,86,2,30,1,1
64880,9694,0,0,deny,66,66,0,1,0,1,0
56777,443,21273,443,allow,8654,2150,6504,20,16,11,9
53734,443,22403,443,allow,499,425,74,4,0,3,1
53647,80,49783,80,allow,1962,1287,675,13,27,7,6
50671,445,0,0,drop,66,66,0,1,0,1,0
65064,30188,0,0,deny,66,66,0,1,0,1,0
3764,9694,0,0,deny,66,66,0,1,0,1,0
65024,53,8030,53,allow,295,101,194,4,33,2,2
59507,445,0,0,drop,70,70,0,1,0,1,0
35356,53,0,0,allow,82,82,0,1,30,1,0
56018,443,53493,443,allow,162,102,60,2,5,1,1
57258,53,16585,53,allow,177,94,83,2,30,1,1
49001,40108,0,0,deny,161,161,0,1,0,1,0
59796,23,0,0,deny,60,60,0,1,0,1,0
27490,53,27490,53,allow,214,82,132,2,33,1,1
53971,445,0,0,drop,70,70,0,1,0,1,0
59985,445,0,0,drop,66,66,0,1,0,1,0
53907,445,0,0,drop,66,66,0,1,0,1,0
56563,443,19548,443,allow,4528,884,3644,15,26,9,6
49197,53,13288,53,allow,777,87,690,2,30,1,1
11688,23718,0,0,deny,146,146,0,1,0,1,0
50626,80,27963,80,allow,1366,865,501,8,15,5,3
60802,445,0,0,drop,70,70,0,1,0,1,0
50298,37965,0,0,deny,66,66,0,1,0,1,0
64587,43890,0,0,deny,66,66,0,1,0,1,0
57388,53,31918,53,allow,266,86,180,2,30,1,1
56679,51505,0,0,deny,146,146,0,1,0,1,0
54969,53,12796,53,allow,199,102,97,2,29,1,1
65096,37807,0,0,deny,62,62,0,1,0,1,0
56364,445,0,0,drop,70,70,0,1,0,1,0
56500,53,54568,53,allow,164,86,78,2,30,1,1
53470,22114,0,0,deny,66,66,0,1,0,1,0
10145,21247,0,0,deny,62,62,0,1,0,1,0
35338,443,9775,443,allow,7504,2762,4742,35,61,17,18
59556,443,25166,443,allow,3888,1169,2719,13,136,6,7
37538,37965,0,0,deny,66,66,0,1,0,1,0
57834,443,16694,443,allow,6214,1733,4481,13,121,6,7
52860,9694,0,0,deny,62,62,0,1,0,1,0
63873,61002,7411,61002,allow,5431,3164,2267,32,76,18,14
49272,53,44204,53,allow,198,102,96,2,30,1,1
59422,445,0,0,drop,70,70,0,1,0,1,0
55745,445,0,0,drop,70,70,0,1,0,1,0
63059,445,0,0,drop,70,70,0,1,0,1,0
60166,53,7820,53,allow,258,94,164,2,30,1,1
40811,80,13530,80,allow,31286,2032,29254,50,30,26,24
46295,443,11323,443,allow,9938,1398,8540,9,128,1,8
36834,443,25361,443,allow,7251,5852,1399,34,75,18,16
49255,44847,0,0,deny,66,66,0,1,0,1,0
57236,53,14592,53,allow,748,95,653,2,30,1,1
64602,53,26542,53,allow,185,102,83,2,30,1,1
48070,53,48070,53,allow,197,90,107,2,30,1,1
57470,1,59410,1,allow,132,132,0,3,1199,3,0
51688,123,9497,123,allow,184,94,90,2,29,1,1
59287,445,0,0,drop,70,70,0,1,0,1,0
55890,53,46214,53,allow,711,87,624,2,30,1,1
56934,53,16279,53,allow,216,110,106,2,29,1,1
58638,5900,0,0,deny,62,62,0,1,0,1,0
50223,445,0,0,drop,66,66,0,1,0,1,0
50584,6889,8974,6889,allow,166,166,0,1,1200,1,0
25543,22114,0,0,deny,62,62,0,1,0,1,0
55071,53,33464,53,allow,177,94,83,2,31,1,1
62054,443,20146,443,allow,10596,3874,6722,30,62,17,13
6881,6881,40959,6881,allow,238,118,120,2,1200,1,1
58638,5900,0,0,deny,62,62,0,1,0,1,0
65036,53,55693,53,allow,199,102,97,2,29,1,1
53848,36237,0,0,deny,62,62,0,1,0,1,0
52518,80,48144,80,allow,3290,2776,514,12,15,7,5
63827,445,0,0,drop,70,70,0,1,0,1,0
41298,51050,0,0,deny,62,62,0,1,0,1,0
48676,53395,0,0,deny,60,60,0,1,0,1,0
55655,53,55322,53,allow,304,110,194,4,34,2,2
63227,443,37596,443,allow,1373,734,639,17,125,10,7
64986,53,34295,53,allow,183,94,89,2,30,1,1
56667,443,7226,443,allow,8057,2037,6020,20,16,11,9
64940,26467,0,0,deny,62,62,0,1,0,1,0
26900,27017,15992,27017,allow,422,164,258,6,30,3,3
65196,53,4463,53,allow,177,94,83,2,30,1,1
64376,445,0,0,drop,66,66,0,1,0,1,0
54833,443,54833,443,allow,306802,26705,280097,395,21,190,205
53993,6881,30701,6881,allow,70,70,0,2,8,2,0
49452,443,53461,443,allow,13184,2507,10677,27,64,14,13
2437,23117,0,0,deny,62,62,0,1,0,1,0
58767,53,1096,53,allow,168,78,90,2,29,1,1
52170,45144,16828,45144,allow,70,70,0,2,8,2,0
48114,443,5239,443,allow,4515,2193,2322,14,135,7,7
60335,445,0,0,drop,70,70,0,1,0,1,0
49208,53,22620,53,allow,578,286,292,9,15,5,4
61286,443,41653,443,allow,248071,7320,240751,269,268,89,180
6881,6881,48403,6881,allow,502,150,352,2,1200,1,1
46116,57470,0,0,deny,74,74,0,1,0,1,0
60297,53,6955,53,allow,227,86,141,2,30,1,1
49217,53,36290,53,allow,209,110,99,2,30,1,1
49160,50321,21626,50321,allow,150,150,0,2,1200,2,0
52161,19897,63116,19897,allow,70,70,0,2,8,2,0
56750,443,39492,443,allow,8006,1986,6020,20,15,11,9
57546,445,0,0,drop,66,66,0,1,0,1,0
9264,80,28949,80,allow,318,192,126,6,26,4,2
56785,443,49634,443,allow,7905,1916,5989,20,15,11,9
58833,443,6455,443,allow,5167,700,4467,16,14,7,9
57162,53,0,0,allow,198,91,107,2,30,1,1
64384,445,0,0,drop,70,70,0,1,0,1,0
57313,53,1093,53,allow,811,94,717,2,30,1,1
6881,35894,0,0,deny,62,62,0,1,0,1,0
56841,29753,13885,29753,allow,70,70,0,1,5,1,0
50826,80,48832,80,allow,35970,11674,24296,108,265,55,53
55694,53,54062,53,allow,166,85,81,2,31,1,1
54046,445,0,0,drop,70,70,0,1,0,1,0
60804,40010,37467,40010,allow,316,136,180,6,5,3,3
55538,53,48787,53,allow,195,102,93,2,30,1,1
52730,445,0,0,drop,66,66,0,1,0,1,0
60903,443,60903,443,allow,13557,3307,10250,43,47,25,18
55591,53,22310,53,allow,195,102,93,2,30,1,1
6881,6881,0,0,deny,62,62,0,1,0,1,0
51110,80,32972,80,allow,23850,1662,22188,36,15,19,17
50,38211,0,0,deny,66,66,0,1,0,1,0
52069,53446,32796,53446,allow,70,70,0,1,5,1,0
34246,53,34246,53,allow,217,87,130,2,31,1,1
56688,53,20462,53,allow,196,102,94,2,30,1,1
45964,2777,0,0,deny,60,60,0,1,0,1,0
65168,53,7392,53,allow,185,102,83,2,31,1,1
65430,53,43606,53,allow,305,94,211,2,29,1,1
35112,8635,35112,8635,allow,138,78,60,2,5,1,1
2049,32480,0,0,deny,66,66,0,1,0,1,0
31404,46232,0,0,deny,100,100,0,1,0,1,0
65211,53,54701,53,allow,183,94,89,2,30,1,1
54963,53,30866,53,allow,210,110,100,2,30,1,1
44710,25174,0,0,deny,62,62,0,1,0,1,0
51657,445,0,0,drop,70,70,0,1,0,1,0
50395,445,0,0,drop,70,70,0,1,0,1,0
52050,31648,17402,31648,allow,70,70,0,2,8,2,0
64420,53,14172,53,allow,188,96,92,2,30,1,1
55051,53,44193,53,allow,167,86,81,2,31,1,1
50929,445,0,0,drop,66,66,0,1,0,1,0
10265,64147,0,0,deny,66,66,0,1,0,1,0
443,46080,0,0,deny,66,66,0,1,0,1,0
49246,443,11384,443,allow,29705,9203,20502,41,18,21,20
51984,445,0,0,drop,70,70,0,1,0,1,0
64380,53,29472,53,allow,186,95,91,2,31,1,1
62229,445,0,0,drop,66,66,0,1,0,1,0
38857,443,38857,443,allow,115031,5628,109403,143,104,55,88
50614,443,33140,443,allow,3499,1732,1767,15,16,9,6
55406,25174,0,0,deny,66,66,0,1,0,1,0
41008,53,32302,53,allow,168,78,90,2,29,1,1
54839,445,0,0,drop,70,70,0,1,0,1,0
14924,44847,0,0,deny,66,66,0,1,0,1,0
51021,445,0,0,drop,70,70,0,1,0,1,0
57067,53,11101,53,allow,252,102,150,2,30,1,1
61020,445,0,0,drop,66,66,0,1,0,1,0
43645,39004,0,0,deny,145,145,0,1,0,1,0
50573,22114,0,0,deny,62,62,0,1,0,1,0
57662,445,0,0,drop,66,66,0,1,0,1,0
61981,443,61981,443,allow,4533,1626,2907,19,29,11,8
55559,445,0,0,drop,70,70,0,1,0,1,0
59874,443,18993,443,allow,1066,545,521,11,28,5,6
53236,443,53236,443,allow,1210,637,573,14,34,7,7
55072,53,57853,53,allow,701,88,613,2,30,1,1
53625,39198,33493,39198,allow,552,306,246,9,16,5,4
2064,22114,0,0,deny,62,62,0,1,0,1,0
57287,443,20277,443,allow,8960,2778,6182,31,20,16,15
58352,445,0,0,drop,70,70,0,1,0,1,0
52405,53,59064,53,allow,168,78,90,2,30,1,1
50477,80,50477,80,allow,20873,1203,19670,30,21,13,17
58348,445,0,0,drop,70,70,0,1,0,1,0
56739,443,22996,443,allow,795,795,0,2,169,2,0
61473,445,0,0,drop,70,70,0,1,0,1,0
48676,53398,0,0,deny,60,60,0,1,0,1,0
49174,50584,0,0,deny,146,146,0,1,0,1,0
61218,445,0,0,drop,70,70,0,1,0,1,0
35052,443,8505,443,allow,4652,3109,1543,25,95,14,11
50584,53,43253,53,allow,174,89,85,2,31,1,1
64530,445,0,0,drop,70,70,0,1,0,1,0
56494,15503,0,0,deny,146,146,0,1,0,1,0
31066,57470,0,0,deny,74,74,0,1,0,1,0
17018,53,17018,53,allow,217,87,130,2,30,1,1
52183,443,15080,443,allow,69339,4124,65215,96,22,45,51
51829,36134,0,0,deny,66,66,0,1,0,1,0
52989,53,36046,53,allow,406,94,312,2,30,1,1
6889,34962,0,0,deny,143,143,0,1,0,1,0
13840,37965,0,0,deny,146,146,0,1,0,1,0
54865,443,54865,443,allow,125282,21435,103847,162,20,80,82
49917,443,56620,443,allow,5899,732,5167,16,41,8,8
31609,25174,0,0,deny,146,146,0,1,0,1,0
50125,445,0,0,drop,70,70,0,1,0,1,0
64000,445,0,0,drop,70,70,0,1,0,1,0
52559,445,0,0,drop,70,70,0,1,0,1,0
60508,445,0,0,drop,66,66,0,1,0,1,0
5643,53,5643,53,allow,237,91,146,2,33,1,1
57031,53,13224,53,allow,711,87,624,2,30,1,1
50169,445,0,0,drop,70,70,0,1,0,1,0
7160,34317,0,0,deny,146,146,0,1,0,1,0
11136,19910,0,0,deny,62,62,0,1,0,1,0
59759,445,0,0,drop,70,70,0,1,0,1,0
123,123,13833,123,allow,184,94,90,2,30,1,1
30960,45670,41313,45670,allow,462,462,0,8,3632,8,0
6356,26467,0,0,deny,62,62,0,1,0,1,0
56830,53,25316,53,allow,195,102,93,2,29,1,1
55097,53,65390,53,allow,170,87,83,2,31,1,1
55797,53,21762,53,allow,177,94,83,2,30,1,1
50912,445,0,0,drop,70,70,0,1,0,1,0
53777,445,0,0,drop,70,70,0,1,0,1,0
52248,443,56929,443,allow,190,70,120,4,15,2,2
63780,445,0,0,drop,70,70,0,1,0,1,0
45908,33330,0,0,deny,60,60,0,1,0,1,0
53254,443,47275,443,allow,9949,4623,5326,45,150,23,22
51367,445,0,0,drop,70,70,0,1,0,1,0
63769,47661,30265,47661,allow,66,66,0,2,7,2,0
52027,49743,54736,49743,allow,70,70,0,2,7,2,0
64815,53,23371,53,allow,755,94,661,2,30,1,1
64499,445,0,0,drop,70,70,0,1,0,1,0
51413,443,55199,443,allow,695,575,120,4,6,2,2
55243,53,43461,53,allow,356,118,238,2,30,1,1
52142,80,50942,80,allow,246,120,126,5,32,3,2
52276,445,0,0,drop,66,66,0,1,0,1,0
54956,53,14576,53,allow,194,102,92,2,31,1,1
64915,53,19337,53,allow,177,94,83,2,29,1,1
65018,53,21026,53,allow,168,94,74,2,31,1,1
59502,445,0,0,drop,70,70,0,1,0,1,0
52888,443,11223,443,allow,12876,2739,10137,44,118,21,23
54710,445,0,0,drop,66,66,0,1,0,1,0
60436,445,0,0,drop,66,66,0,1,0,1,0
50875,445,0,0,drop,70,70,0,1,0,1,0
53151,29500,62396,29500,allow,514,274,240,8,143,4,4
40603,443,49368,443,allow,9462,6402,3060,32,394,11,21
49418,27015,15763,27015,allow,248,78,170,2,30,1,1
53645,62348,1333,62348,allow,2395,1145,1250,13,16,6,7
38113,443,46610,443,allow,2849678,105912,2743766,3255,124,1284,1971
57863,445,0,0,drop,66,66,0,1,0,1,0
49702,53,29408,53,allow,771,102,669,2,31,1,1
50655,26467,0,0,deny,66,66,0,1,0,1,0
62791,443,22999,443,allow,17411,8921,8490,98,291,41,57
59635,445,0,0,drop,70,70,0,1,0,1,0
56713,25174,0,0,deny,62,62,0,1,0,1,0
55679,1024,62004,1024,allow,70,70,0,1,5,1,0
13406,22114,0,0,deny,62,62,0,1,0,1,0
26462,80,26462,80,allow,490,264,226,8,32,5,3
40763,443,27693,443,allow,15679,4305,11374,32,43,17,15
65270,3855,0,0,deny,78,78,0,1,0,1,0
30794,37965,0,0,deny,62,62,0,1,0,1,0
46201,443,55008,443,allow,16666,4851,11815,58,150,27,31
54909,445,0,0,drop,70,70,0,1,0,1,0
55555,53,4576,53,allow,194,102,92,2,31,1,1
33443,443,53620,443,allow,14402,2801,11601,28,205,11,17
53164,443,44686,443,allow,38442,16213,22229,67,46,30,37
65006,26467,0,0,deny,62,62,0,1,0,1,0
64340,53,64340,53,allow,237,91,146,2,33,1,1
61630,445,0,0,drop,66,66,0,1,0,1,0
60424,6881,10732,6881,allow,320,140,180,6,7,3,3
58396,22114,0,0,deny,66,66,0,1,0,1,0
50369,443,20659,443,allow,8048,1189,6859,19,25,10,9
51948,37965,0,0,deny,62,62,0,1,0,1,0
47213,443,42653,443,allow,8166,2498,5668,16,120,8,8
50991,445,0,0,drop,70,70,0,1,0,1,0
15513,25174,0,0,deny,62,62,0,1,0,1,0
56690,445,0,0,drop,66,66,0,1,0,1,0
50444,53,27303,53,allow,256,93,163,2,31,1,1
64858,445,0,0,drop,66,66,0,1,0,1,0
53439,445,0,0,drop,66,66,0,1,0,1,0
52661,445,0,0,drop,66,66,0,1,0,1,0
65317,51221,0,0,deny,78,78,0,1,0,1,0
64017,53,3169,53,allow,209,110,99,2,30,1,1
6881,6881,14545,6881,allow,492,150,342,2,1200,1,1
49468,443,51693,443,allow,6940,1302,5638,20,119,10,10
60473,443,60473,443,allow,18018,4407,13611,36,100,19,17
49826,53,26730,53,allow,650,286,364,8,84,4,4
50550,443,42250,443,allow,8123,1809,6314,22,71,12,10
65049,445,0,0,drop,66,66,0,1,0,1,0
50224,445,0,0,drop,66,66,0,1,0,1,0
55452,445,0,0,drop,70,70,0,1,0,1,0
49225,53,32550,53,allow,295,101,194,4,49,2,2
55697,14795,5674,14795,allow,564,318,246,9,15,5,4
53753,46790,44362,46790,allow,492,306,186,8,15,5,3
55951,53,13243,53,allow,197,102,95,2,31,1,1
52074,57947,9698,57947,allow,70,70,0,1,5,1,0
37027,443,52306,443,allow,90706,5324,85382,128,262,66,62
64722,53,7575,53,allow,184,94,90,2,30,1,1
18655,50584,0,0,deny,146,146,0,1,0,1,0
1026,64147,0,0,deny,62,62,0,1,0,1,0
53118,445,0,0,drop,70,70,0,1,0,1,0
57550,50584,0,0,deny,66,66,0,1,0,1,0
56845,53,65473,53,allow,233,102,131,2,30,1,1
64379,53,61307,53,allow,333,94,239,2,30,1,1
51560,445,0,0,drop,70,70,0,1,0,1,0
49418,27019,26998,27019,allow,242,78,164,2,30,1,1
49534,80,31376,80,allow,1702,611,1091,8,30,4,4
64029,53,34743,53,allow,180,94,86,2,30,1,1
52266,31225,1238,31225,allow,70,70,0,1,5,1,0
51587,445,0,0,drop,70,70,0,1,0,1,0
51562,445,0,0,drop,70,70,0,1,0,1,0
57470,6881,57710,6881,allow,453,251,202,4,1200,2,2
42298,40001,45646,40001,allow,156,94,62,2,30,1,1
27005,27015,6059,27015,allow,881,126,755,2,30,1,1
58895,445,0,0,drop,66,66,0,1,0,1,0
57284,22114,0,0,deny,66,66,0,1,0,1,0
16857,53,16857,53,allow,832,106,726,2,30,1,1
44538,50584,0,0,deny,146,146,0,1,0,1,0
50268,443,33459,443,allow,35251,25181,10070,121,123,63,58
3564,57470,0,0,deny,62,62,0,1,0,1,0
50406,443,46416,443,allow,6470,897,5573,24,55,9,15
47342,20541,0,0,deny,66,66,0,1,0,1,0
27328,21247,0,0,deny,66,66,0,1,0,1,0
56489,53,43327,53,allow,212,110,102,2,30,1,1
34286,53,18958,53,allow,199,94,105,2,30,1,1
63717,445,0,0,drop,66,66,0,1,0,1,0
50358,445,0,0,drop,70,70,0,1,0,1,0
49418,27013,52000,27013,allow,241,78,163,2,30,1,1
59241,62413,0,0,deny,66,66,0,1,0,1,0
52715,443,11256,443,allow,26901,2286,24615,46,319,18,28
60295,53,27114,53,allow,224,94,130,2,30,1,1
49937,443,1883,443,allow,240,240,0,5,338,5,0
56820,53,40391,53,allow,193,102,91,2,30,1,1
59563,56205,0,0,deny,66,66,0,1,0,1,0
55818,53,21143,53,allow,775,103,672,2,31,1,1
60769,443,3938,443,allow,7639,2051,5588,33,120,17,16
52147,443,32446,443,allow,27251,9966,17285,70,73,35,35
50498,53,36030,53,allow,751,94,657,2,29,1,1
52889,445,0,0,drop,70,70,0,1,0,1,0
60295,445,0,0,drop,70,70,0,1,0,1,0
56994,53,32105,53,allow,177,94,83,2,30,1,1
58726,443,45284,443,allow,39202,21598,17604,72,20,39,33
51953,443,6688,443,allow,7571,3372,4199,33,88,17,16
39587,22114,0,0,deny,62,62,0,1,0,1,0
62937,445,0,0,drop,66,66,0,1,0,1,0
62452,21247,0,0,deny,66,66,0,1,0,1,0
57839,445,0,0,drop,70,70,0,1,0,1,0
57585,51221,0,0,deny,62,62,0,1,0,1,0
64139,53,9779,53,allow,498,93,405,4,47,2,2
64331,445,0,0,drop,70,70,0,1,0,1,0
64721,53,18309,53,allow,214,110,104,2,30,1,1
64338,53,55215,53,allow,292,102,190,2,29,1,1
38926,37965,0,0,deny,62,62,0,1,0,1,0
44847,20101,53137,20101,allow,150,150,0,1,1200,1,0
57140,445,0,0,drop,66,66,0,1,0,1,0
48272,15000,32471,15000,allow,130,70,60,2,5,1,1
65395,53,34335,53,allow,754,94,660,2,30,1,1
51946,80,42668,80,allow,1716,952,764,13,69,8,5
49967,53,55984,53,allow,303,100,203,4,40,2,2
56216,50584,0,0,deny,62,62,0,1,0,1,0
49994,26467,0,0,deny,66,66,0,1,0,1,0
46844,34567,0,0,deny,60,60,0,1,0,1,0
59734,445,0,0,drop,66,66,0,1,0,1,0
63580,443,12197,443,allow,5759,1721,4038,20,78,11,9
55965,445,0,0,drop,66,66,0,1,0,1,0
9105,443,49589,443,allow,4077,438,3639,12,15,6,6
36079,53,36079,53,allow,235,90,145,2,32,1,1
58706,445,0,0,drop,70,70,0,1,0,1,0
51164,64147,0,0,deny,66,66,0,1,0,1,0
64785,445,0,0,drop,70,70,0,1,0,1,0
64410,445,0,0,drop,70,70,0,1,0,1,0
34932,38608,0,0,deny,62,62,0,1,0,1,0
40340,53,40340,53,allow,217,90,127,2,30,1,1
63744,47106,28036,47106,allow,70,70,0,1,4,1,0
12694,12446,0,0,deny,145,145,0,1,0,1,0
58309,445,0,0,drop,66,66,0,1,0,1,0
9153,443,27123,443,allow,6059,773,5286,17,29,9,8
49391,445,0,0,drop,70,70,0,1,0,1,0
52420,445,0,0,drop,66,66,0,1,0,1,0
56104,53,14895,53,allow,204,104,100,2,30,1,1
49752,50584,0,0,deny,62,62,0,1,0,1,0
50463,80,63271,80,allow,214,140,74,4,15,3,1
50253,445,0,0,drop,70,70,0,1,0,1,0
49567,53,30320,53,allow,195,94,101,2,30,1,1
50575,53,21343,53,allow,184,94,90,2,30,1,1
7360,14914,0,0,deny,157,157,0,1,0,1,0
64114,443,8780,443,allow,1411,852,559,13,24,7,6
52022,52752,0,0,deny,74,74,0,1,0,1,0
52265,445,0,0,drop,66,66,0,1,0,1,0
61291,53,61291,53,allow,261,106,155,2,29,1,1
63931,16528,26745,16528,allow,376,254,122,6,17,4,2
52292,80,52292,80,allow,1914,1302,612,11,14,5,6
58338,3362,0,0,deny,60,60,0,1,0,1,0
51909,6881,0,0,deny,66,66,0,1,0,1,0
53601,30160,44927,30160,allow,70,70,0,2,8,2,0
53173,445,0,0,drop,70,70,0,1,0,1,0
80,53945,0,0,deny,60,60,0,1,0,1,0
59144,445,0,0,drop,70,70,0,1,0,1,0
59283,80,59283,80,allow,72354,14398,57956,123,15,40,83
27005,27015,33669,27015,allow,876,126,750,2,30,1,1
15806,11392,0,0,deny,66,66,0,1,0,1,0
49416,80,5310,80,allow,318,192,126,6,28,4,2
55065,80,56775,80,allow,306,180,126,6,28,4,2
52148,29104,12286,29104,allow,70,70,0,2,8,2,0
51172,44847,0,0,deny,66,66,0,1,0,1,0
63291,445,0,0,drop,70,70,0,1,0,1,0
49346,445,0,0,drop,70,70,0,1,0,1,0
57441,57470,0,0,deny,66,66,0,1,0,1,0
56705,53,36648,53,allow,711,87,624,2,30,1,1
59044,53,47816,53,allow,78,78,0,1,30,1,0
57131,35776,0,0,deny,145,145,0,1,0,1,0
52838,37965,0,0,deny,66,66,0,1,0,1,0
40791,443,54664,443,allow,7236,2069,5167,25,25,12,13
64559,53,60231,53,allow,258,110,148,2,29,1,1
51499,443,54241,443,allow,1610,1073,537,14,15,8,6
52040,445,0,0,drop,66,66,0,1,0,1,0
443,48346,0,0,deny,81,81,0,1,0,1,0
49247,53,56867,53,allow,478,196,282,6,63,3,3
56734,445,0,0,drop,66,66,0,1,0,1,0
50453,445,0,0,drop,70,70,0,1,0,1,0
53727,53,60009,53,allow,172,72,100,2,30,1,1
50791,53,50791,53,allow,231,90,141,2,30,1,1
54278,445,0,0,drop,66,66,0,1,0,1,0
53906,44512,0,0,deny,62,62,0,1,0,1,0
65014,53,36571,53,allow,193,102,91,2,30,1,1
55968,445,0,0,drop,70,70,0,1,0,1,0
6037,43890,0,0,deny,74,74,0,1,0,1,0
27005,27016,57447,27016,allow,885,126,759,2,30,1,1
45186,443,63714,443,allow,5959,169,5790,10,121,3,7
56486,445,0,0,drop,70,70,0,1,0,1,0
27005,27016,9043,27016,allow,881,126,755,2,30,1,1
56762,25080,40998,25080,allow,70,70,0,1,5,1,0
61085,37965,0,0,deny,62,62,0,1,0,1,0
56679,443,4543,443,allow,7941,1952,5989,20,15,11,9
51568,445,0,0,drop,66,66,0,1,0,1,0
53827,445,0,0,drop,70,70,0,1,0,1,0
56200,53,31034,53,allow,211,110,101,2,31,1,1
62704,445,0,0,drop,70,70,0,1,0,1,0
64746,53,28024,53,allow,193,102,91,2,31,1,1
48906,53,48906,53,allow,217,87,130,2,30,1,1
12616,23,0,0,deny,60,60,0,1,0,1,0
65477,53,50858,53,allow,209,110,99,2,30,1,1
60956,443,57163,443,allow,13342,9687,3655,53,17,28,25
49869,445,0,0,drop,70,70,0,1,0,1,0
50027,21247,0,0,deny,66,66,0,1,0,1,0
60232,443,3016,443,allow,1868,1229,639,18,151,11,7
57222,53,51448,53,allow,177,94,83,2,30,1,1
60374,17432,21315,17432,allow,564,318,246,9,18,5,4
59758,443,28743,443,allow,384,166,218,2,29,1,1
3225,64147,0,0,deny,62,62,0,1,0,1,0
49418,27019,20347,27019,allow,71,71,0,1,30,1,0
64697,53,42927,53,allow,198,101,97,2,31,1,1
58398,44847,0,0,deny,66,66,0,1,0,1,0
43770,53,60550,53,allow,199,94,105,2,30,1,1
63305,445,0,0,drop,70,70,0,1,0,1,0
57943,1433,0,0,deny,60,60,0,1,0,1,0
27005,27016,11653,27016,allow,876,126,750,3,31,2,1
59143,445,0,0,drop,70,70,0,1,0,1,0
56062,445,0,0,drop,66,66,0,1,0,1,0
65327,53,49765,53,allow,822,102,720,2,29,1,1
56865,445,0,0,drop,66,66,0,1,0,1,0
58959,80,58892,80,allow,5481,4758,723,15,15,8,7
27844,52700,0,0,deny,74,74,0,1,0,1,0
64872,445,0,0,drop,70,70,0,1,0,1,0
57343,53,10133,53,allow,214,86,128,2,29,1,1
55176,53,23619,53,allow,195,102,93,2,30,1,1
13375,53,13375,53,allow,213,82,131,2,30,1,1
54018,443,16505,443,allow,13330,3836,9494,53,255,29,24
50798,445,0,0,drop,66,66,0,1,0,1,0
64143,53,33110,53,allow,179,94,85,2,30,1,1
54779,50584,0,0,deny,62,62,0,1,0,1,0
46280,5900,0,0,deny,60,60,0,1,0,1,0
27005,1402,23160,1402,allow,870,126,744,2,29,1,1
51955,39871,23023,39871,allow,70,70,0,2,8,2,0
58785,445,0,0,drop,70,70,0,1,0,1,0
65317,80,47905,80,allow,1014,507,507,8,133,5,3
55650,53,22960,53,allow,179,94,85,2,31,1,1
44455,443,5697,443,allow,6972,1375,5597,20,31,10,10
42485,443,17248,443,allow,130,70,60,3,5,2,1
64935,53,65195,53,allow,193,102,91,2,30,1,1
65487,53,41710,53,allow,210,110,100,2,29,1,1
45335,443,8948,443,allow,2814,1454,1360,23,28,12,11
26451,80,26451,80,allow,642,338,304,10,32,6,4
51816,27721,15774,27721,allow,70,70,0,1,5,1,0
35163,30188,0,0,deny,62,62,0,1,0,1,0
58120,53,58120,53,allow,825,99,726,2,30,1,1
56586,53,17774,53,allow,177,94,83,2,29,1,1
55070,53,15674,53,allow,195,94,101,2,30,1,1
65376,53,47204,53,allow,184,94,90,2,29,1,1
17534,50584,0,0,deny,146,146,0,1,0,1,0
61085,37965,0,0,deny,62,62,0,1,0,1,0
9297,443,46735,443,allow,4216,771,3445,16,26,9,7
52054,50513,53866,50513,allow,66,66,0,1,5,1,0
63759,64509,61744,64509,allow,70,70,0,1,4,1,0
49766,53,54774,53,allow,234,102,132,2,30,1,1
6881,6881,0,0,deny,146,146,0,1,0,1,0
49647,80,48193,80,allow,318,192,126,6,42,4,2
64933,53,1484,53,allow,738,86,652,2,31,1,1
49498,53,63118,53,allow,734,94,640,2,29,1,1
49559,53,6355,53,allow,164,84,80,2,31,1,1
64998,53,50318,53,allow,214,94,120,2,30,1,1
62315,445,0,0,drop,66,66,0,1,0,1,0
56072,53,60907,53,allow,198,101,97,2,31,1,1
55376,53,1208,53,allow,199,102,97,2,30,1,1
64463,53,25750,53,allow,183,94,89,2,31,1,1
25961,55783,0,0,deny,66,66,0,1,0,1,0
50209,53,40978,53,allow,86,86,0,1,30,1,0
50740,445,0,0,drop,70,70,0,1,0,1,0
31235,22114,0,0,deny,62,62,0,1,0,1,0
43568,443,63608,443,allow,9445,6593,2852,43,96,25,18
49418,27015,37886,27015,allow,219,71,148,2,31,1,1
56611,53,45220,53,allow,177,94,83,2,30,1,1
59326,57470,0,0,deny,74,74,0,1,0,1,0
60218,80,20948,80,allow,8268,6054,2214,23,151,14,9
37965,6881,16163,6881,allow,452,248,204,4,1199,2,2
50084,26672,0,0,deny,62,62,0,1,0,1,0
37185,443,49991,443,allow,14035,8420,5615,31,256,18,13
51918,27015,0,0,deny,67,67,0,1,0,1,0
52866,445,0,0,drop,70,70,0,1,0,1,0
53436,443,59367,443,allow,7941,2678,5263,25,122,12,13
15922,44847,0,0,deny,66,66,0,1,0,1,0
58638,5900,0,0,deny,62,62,0,1,0,1,0
64653,53,37901,53,allow,755,93,662,2,31,1,1
65336,53,9283,53,allow,200,102,98,2,29,1,1
36448,80,28179,80,allow,1325,336,989,10,15,5,5
52364,445,0,0,drop,66,66,0,1,0,1,0
57591,443,27521,443,allow,2614,1689,925,18,20,10,8
60802,40010,3447,40010,allow,316,136,180,6,6,3,3
55939,53,47586,53,allow,177,94,83,2,29,1,1
63865,48610,9039,48610,allow,66,66,0,1,5,1,0
63460,445,0,0,drop,70,70,0,1,0,1,0
7099,51505,0,0,deny,62,62,0,1,0,1,0
53163,32834,24170,32834,allow,70,70,0,2,8,2,0
64618,53,13340,53,allow,410,102,308,2,29,1,1
49811,53,32866,53,allow,308,110,198,2,29,1,1
37965,4546,34269,4546,allow,3957,2324,1633,51,1720,29,22
56901,53,16725,53,allow,264,94,170,2,31,1,1
63807,38976,41497,38976,allow,66,66,0,1,5,1,0
59728,445,0,0,drop,66,66,0,1,0,1,0
55339,445,0,0,drop,66,66,0,1,0,1,0
50946,80,36199,80,allow,5870176,83236,5786940,5053,78,1161,3892
57169,53,49234,53,allow,177,94,83,2,30,1,1
58796,443,14867,443,allow,7402,2429,4973,40,139,22,18
63844,445,0,0,drop,66,66,0,1,0,1,0
59044,445,0,0,drop,70,70,0,1,0,1,0
56223,53,58545,53,allow,185,102,83,2,31,1,1
52925,3389,0,0,deny,60,60,0,1,0,1,0
50544,445,0,0,drop,70,70,0,1,0,1,0
1030,64147,0,0,deny,62,62,0,1,0,1,0
10010,80,10501,80,allow,2166,600,1566,10,45,6,4
27844,52700,0,0,deny,74,74,0,1,0,1,0
54884,445,0,0,drop,70,70,0,1,0,1,0
53233,51221,0,0,deny,66,66,0,1,0,1,0
50937,445,0,0,drop,70,70,0,1,0,1,0
61811,445,0,0,drop,70,70,0,1,0,1,0
34257,7275,41230,7275,allow,2845,419,2426,12,15,7,5
57129,53,59540,53,allow,265,94,171,2,30,1,1
17004,64147,0,0,deny,66,66,0,1,0,1,0
59510,445,0,0,drop,70,70,0,1,0,1,0
65294,53,7465,53,allow,184,102,82,2,30,1,1
60300,445,0,0,drop,70,70,0,1,0,1,0
55821,53,40795,53,allow,196,102,94,2,30,1,1
58017,53,58017,53,allow,832,106,726,2,30,1,1
55524,53,55524,53,allow,197,90,107,2,29,1,1
52359,443,35892,443,allow,13972,2550,11422,29,954,11,18
53923,443,32187,443,allow,499,425,74,4,0,3,1
13943,22,0,0,deny,60,60,0,1,0,1,0
17009,53733,0,0,deny,62,62,0,1,0,1,0
63906,445,0,0,drop,70,70,0,1,0,1,0
53536,445,0,0,drop,66,66,0,1,0,1,0
60838,445,0,0,drop,70,70,0,1,0,1,0
58542,445,0,0,drop,70,70,0,1,0,1,0
62429,445,0,0,drop,70,70,0,1,0,1,0
44368,443,44368,443,allow,7123,1020,6103,19,151,11,8
46746,443,17806,443,allow,9506,4029,5477,30,330,17,13
55914,53,21562,53,allow,212,102,110,2,30,1,1
49503,80,52162,80,allow,121857,7431,114426,166,486,38,128
49335,80,26214,80,allow,1193,703,490,8,18,5,3
61712,80,5502,80,allow,1864,1024,840,10,16,6,4
65241,53,47217,53,allow,198,102,96,2,29,1,1
50402,445,0,0,drop,66,66,0,1,0,1,0
29512,30188,0,0,deny,62,62,0,1,0,1,0
5588,5588,0,0,allow,3354,1792,1562,46,194,23,23
55642,26872,27323,26872,allow,70,70,0,1,5,1,0
64545,445,0,0,drop,70,70,0,1,0,1,0
4545,1900,0,0,deny,136,136,0,1,0,1,0
9824,53,59579,53,allow,179,86,93,2,29,1,1
59335,80,59335,80,allow,107776,4213,103563,177,16,60,117
55495,53,27718,53,allow,210,110,100,2,31,1,1
50563,443,65476,443,allow,1313,876,437,11,26,6,5
59420,443,62141,443,allow,2854,1732,1122,16,15,8,8
55098,53,38857,53,allow,474,200,274,6,43,3,3
56704,53,33003,53,allow,711,87,624,2,30,1,1
57149,53,45353,53,allow,222,86,136,2,30,1,1
51919,443,36228,443,allow,17595,8241,9354,80,106,43,37
65204,53,50970,53,allow,182,93,89,2,31,1,1
42298,40031,17629,40031,allow,148,86,62,2,30,1,1
49865,443,25068,443,allow,6177,1038,5139,22,56,11,11
53685,38978,44279,38978,allow,70,70,0,2,8,2,0
52066,60118,49058,60118,allow,70,70,0,1,5,1,0
62692,445,0,0,drop,70,70,0,1,0,1,0
53238,443,11082,443,allow,27650,12347,15303,47,53,24,23
723,3389,0,0,deny,74,74,0,1,0,1,0
65263,445,0,0,drop,66,66,0,1,0,1,0
57427,53,45535,53,allow,363,94,269,2,30,1,1
57987,445,0,0,drop,70,70,0,1,0,1,0
61917,445,0,0,drop,70,70,0,1,0,1,0
56418,80,22380,80,allow,39249,938,38311,40,104,11,29
55417,445,0,0,drop,66,66,0,1,0,1,0
56632,53,56632,53,allow,235,90,145,2,33,1,1
55014,80,6896,80,allow,1573,1145,428,13,32,8,5
49623,443,29272,443,allow,36302,2869,33433,67,180,32,35
57470,50321,52574,50321,allow,1584,1584,0,25,1537,25,0
49628,53,48622,53,allow,168,86,82,2,31,1,1
64114,64126,30827,64126,allow,66,66,0,2,8,2,0
18545,23,0,0,deny,60,60,0,1,0,1,0
65474,443,34045,443,allow,355358,10960,344398,369,16,131,238
60332,53,8836,53,allow,419,111,308,2,31,1,1
15641,26467,0,0,deny,62,62,0,1,0,1,0
49196,25174,0,0,deny,66,66,0,1,0,1,0
54449,443,54449,443,allow,7974,2926,5048,25,17,15,10
62893,445,0,0,drop,70,70,0,1,0,1,0
50010,445,0,0,drop,70,70,0,1,0,1,0
49432,53,21540,53,allow,199,94,105,2,30,1,1
45473,53,13745,53,allow,168,78,90,2,31,1,1
54063,80,60737,80,allow,2545,515,2030,12,17,6,6
52439,35894,0,0,deny,74,74,0,1,0,1,0
51180,445,0,0,drop,70,70,0,1,0,1,0
50576,53,22318,53,allow,765,102,663,2,29,1,1
49940,445,0,0,drop,66,66,0,1,0,1,0
50293,443,30749,443,allow,6697,1606,5091,23,36,13,10
25222,37965,0,0,deny,62,62,0,1,0,1,0
48817,13259,48817,13259,allow,460,150,310,2,1200,1,1
27005,27015,3826,27015,allow,876,126,750,2,31,1,1
3478,61463,0,0,deny,1097,1097,0,1,0,1,0
63387,445,0,0,drop,66,66,0,1,0,1,0
58681,443,24073,443,allow,22576,10533,12043,61,200,35,26
49449,445,0,0,drop,70,70,0,1,0,1,0
49355,53,27262,53,allow,193,102,91,2,30,1,1
43861,123,6210,123,allow,184,94,90,2,29,1,1
49681,53,1706,53,allow,170,87,83,2,30,1,1
42465,57470,0,0,deny,60,60,0,1,0,1,0
10089,80,55892,80,allow,130,70,60,2,15,1,1
49488,443,58643,443,allow,90030,13137,76893,92,47,29,63
21133,43408,64774,43408,allow,480,149,331,2,1200,1,1
58638,5900,0,0,deny,62,62,0,1,0,1,0
25532,35440,0,0,deny,146,146,0,1,0,1,0
53734,22051,14778,22051,allow,70,70,0,1,5,1,0
65343,53,9995,53,allow,197,102,95,2,30,1,1
56560,53,48488,53,allow,198,102,96,2,30,1,1
51854,13923,55002,13923,allow,136,136,0,3,13,3,0
60171,445,0,0,drop,70,70,0,1,0,1,0
3478,61463,0,0,deny,1148,1148,0,1,0,1,0
37616,443,9088,443,allow,702409,17257,685152,698,32,233,465
55454,53,12071,53,allow,209,110,99,2,31,1,1
59840,80,40850,80,allow,469946,11862,458084,482,68,173,309
64950,53,65250,53,allow,193,102,91,2,30,1,1
53897,443,53988,443,allow,499,425,74,4,0,3,1
56560,53,11515,53,allow,198,102,96,2,31,1,1
65115,445,0,0,drop,66,66,0,1,0,1,0
59611,56205,0,0,deny,66,66,0,1,0,1,0
19617,39004,0,0,deny,145,145,0,1,0,1,0
58770,443,24221,443,allow,6033,770,5263,18,15,8,10
55421,57470,0,0,deny,74,74,0,1,0,1,0
21133,51413,27138,51413,allow,460,150,310,2,1199,1,1
1091,37965,0,0,deny,62,62,0,1,0,1,0
10059,443,58839,443,allow,70553,6471,64082,141,182,69,72
55392,53,38891,53,allow,190,97,93,2,31,1,1
27454,53,27454,53,allow,244,98,146,2,32,1,1
38087,443,27935,443,allow,6147,910,5237,18,100,10,8
64105,445,0,0,drop,66,66,0,1,0,1,0
60425,15503,0,0,deny,145,145,0,1,0,1,0
34873,80,34873,80,allow,2148,918,1230,10,20,6,4
57413,445,0,0,drop,66,66,0,1,0,1,0
58638,5900,0,0,deny,62,62,0,1,0,1,0
50793,445,0,0,drop,66,66,0,1,0,1,0
49340,53,43709,53,allow,94,94,0,1,30,1,0
50265,55243,25034,55243,allow,481,150,331,2,1200,1,1
60142,445,0,0,drop,70,70,0,1,0,1,0
35775,443,51834,443,allow,6665,3913,2752,33,98,19,14
63456,37965,0,0,deny,62,62,0,1,0,1,0
46658,53,46658,53,allow,216,98,118,2,30,1,1
56560,53,37508,53,allow,172,94,78,2,29,1,1
58638,5900,0,0,deny,62,62,0,1,0,1,0
63473,443,25564,443,allow,4490,1234,3256,20,122,9,11
42252,33303,0,0,deny,60,60,0,1,0,1,0
64813,16385,22226,16385,allow,432,192,240,8,30,4,4
49243,53,10757,53,allow,452,118,334,2,30,1,1
49396,53,24683,53,allow,170,87,83,2,30,1,1
56157,445,0,0,drop,70,70,0,1,0,1,0
54961,53,50012,53,allow,211,102,109,2,29,1,1
49001,40108,0,0,deny,161,161,0,1,0,1,0
49162,53,39735,53,allow,183,94,89,2,29,1,1
45908,33330,0,0,deny,60,60,0,1,0,1,0
57054,445,0,0,drop,66,66,0,1,0,1,0
49418,30002,50815,30002,allow,242,71,171,2,30,1,1
57311,443,59894,443,allow,134,60,74,3,6,2,1
51812,443,55280,443,allow,10741,7368,3373,32,135,16,16
57233,50934,0,0,deny,66,66,0,1,0,1,0
57146,53,5349,53,allow,199,102,97,2,29,1,1
49189,445,0,0,drop,70,70,0,1,0,1,0
50305,80,32825,80,allow,5500,2829,2671,19,34,10,9
51890,80,53517,80,allow,7097,3553,3544,15,31,8,7
49272,53,7753,53,allow,196,100,96,2,30,1,1
62340,445,0,0,drop,70,70,0,1,0,1,0
64306,53,29347,53,allow,216,110,106,2,31,1,1
59693,445,0,0,drop,70,70,0,1,0,1,0
64797,80,54604,80,allow,378,192,186,7,71,4,3
40498,443,31302,443,allow,9807,2542,7265,47,19,24,23
6881,6881,7756,6881,allow,501,150,351,2,1200,1,1
57394,53,63615,53,allow,193,102,91,2,30,1,1
61259,445,0,0,drop,66,66,0,1,0,1,0
62620,3389,62620,3389,allow,4410,2321,2089,22,18,12,10
56333,53,63639,53,allow,202,103,99,2,31,1,1
61409,443,48164,443,allow,7839,1726,6113,21,77,11,10
56127,37965,0,0,deny,66,66,0,1,0,1,0
50341,37965,0,0,deny,66,66,0,1,0,1,0
50079,23,0,0,deny,60,60,0,1,0,1,0
60920,53,22139,53,allow,268,86,182,2,30,1,1
58631,445,0,0,drop,66,66,0,1,0,1,0
57282,53,23204,53,allow,199,102,97,2,29,1,1
49848,53,60109,53,allow,260,102,158,2,30,1,1
8560,50584,0,0,deny,62,62,0,1,0,1,0
34642,53,34642,53,allow,220,90,130,2,30,1,1
53211,80,10536,80,allow,194,128,66,4,51,3,1
13285,29892,0,0,deny,145,145,0,1,0,1,0
41787,443,37748,443,allow,34237,22442,11795,86,131,41,45
36229,62413,0,0,deny,62,62,0,1,0,1,0
44846,53,44846,53,allow,653,349,304,5,30,3,2
50011,53,36525,53,allow,94,94,0,1,30,1,0
34553,48637,0,0,deny,60,60,0,1,0,1,0
56262,53,49362,53,allow,701,88,613,2,30,1,1
57203,53,26707,53,allow,199,102,97,2,30,1,1
55084,445,0,0,drop,70,70,0,1,0,1,0
61129,443,47713,443,allow,3854,1233,2621,19,120,9,10
57896,7635,57896,7635,allow,138,78,60,2,5,1,1
55237,53,14253,53,allow,193,102,91,2,30,1,1
64685,53,31549,53,allow,199,102,97,2,30,1,1
17561,52700,0,0,deny,62,62,0,1,0,1,0
63328,445,0,0,drop,70,70,0,1,0,1,0
52741,445,0,0,drop,70,70,0,1,0,1,0
34995,443,34995,443,allow,1542,489,1053,8,20,5,3
49260,53,27595,53,allow,177,86,91,2,29,1,1
63737,80,37849,80,allow,314,192,122,6,15,4,2
50507,443,55208,443,allow,7171,1729,5442,24,78,13,11
56724,443,37476,443,allow,7941,1952,5989,20,15,11,9
55301,443,54571,443,allow,9881,1486,8395,22,200,12,10
50519,443,63602,443,allow,16215,1368,14847,36,77,12,24
39941,2767,0,0,deny,62,62,0,1,0,1,0
50113,51505,0,0,deny,66,66,0,1,0,1,0
61659,445,0,0,drop,70,70,0,1,0,1,0
58638,5900,58638,5900,allow,66,66,0,1,4,1,0
42298,40022,6562,40022,allow,148,86,62,2,30,1,1
63079,445,0,0,drop,66,66,0,1,0,1,0
51584,445,0,0,drop,70,70,0,1,0,1,0
56125,53,44434,53,allow,168,86,82,2,29,1,1
4447,35440,0,0,deny,66,66,0,1,0,1,0
56769,11155,9985,11155,allow,70,70,0,2,8,2,0
64971,53,0,0,allow,229,85,144,2,31,1,1
51663,445,0,0,drop,70,70,0,1,0,1,0
52146,18174,42084,18174,allow,70,70,0,2,7,2,0
49242,80,49242,80,allow,378,180,198,7,53,4,3
57301,443,1829,443,allow,5614,733,4881,16,15,9,7
56226,53,55576,53,allow,512,187,325,6,58,3,3
2777,23,2777,23,allow,130,66,64,2,4,1,1
64980,53,40885,53,allow,274,88,186,4,35,2,2
65220,53,8622,53,allow,178,94,84,2,29,1,1
65489,53,22228,53,allow,242,102,140,2,30,1,1
27005,27019,28419,27019,allow,880,126,754,2,30,1,1
55116,445,0,0,drop,66,66,0,1,0,1,0
52016,80,20046,80,allow,8551,5933,2618,18,26,12,6
53523,5362,54435,5362,allow,320,140,180,6,6,3,3
51547,443,7780,443,allow,202,70,132,3,11,1,2
65367,443,29972,443,allow,5666,4417,1249,23,86,12,11
60338,443,20283,443,allow,3648,2251,1397,28,89,16,12
65357,445,0,0,drop,70,70,0,1,0,1,0
49838,443,6189,443,allow,8555,1821,6734,24,123,13,11
56626,443,26601,443,allow,7941,1952,5989,20,15,11,9
50299,445,0,0,drop,70,70,0,1,0,1,0
54680,443,15778,443,allow,1786,172,1614,7,120,3,4
49670,443,18797,443,allow,16957,6203,10754,30,52,14,16
62338,50011,0,0,deny,66,66,0,1,0,1,0
58250,35440,0,0,deny,66,66,0,1,0,1,0
52375,80,50220,80,allow,234,234,0,4,12,4,0
49522,21247,0,0,deny,66,66,0,1,0,1,0
55482,53,16639,53,allow,822,102,720,2,30,1,1
55854,445,0,0,drop,66,66,0,1,0,1,0
60411,58131,27448,58131,allow,70,70,0,1,5,1,0
63274,445,0,0,drop,70,70,0,1,0,1,0
56404,445,0,0,drop,66,66,0,1,0,1,0
49650,53,14821,53,allow,821,102,719,2,29,1,1
65276,445,0,0,drop,70,70,0,1,0,1,0
58638,5900,0,0,deny,62,62,0,1,0,1,0
58981,50584,0,0,deny,146,146,0,1,0,1,0
50019,80,29484,80,allow,814,674,140,6,28,4,2
50332,53,12740,53,allow,193,102,91,2,29,1,1
59165,53,3627,53,allow,320,94,226,2,30,1,1
50992,445,0,0,drop,70,70,0,1,0,1,0
51755,445,0,0,drop,70,70,0,1,0,1,0
50287,53,47633,53,allow,177,94,83,2,30,1,1
61995,445,0,0,drop,70,70,0,1,0,1,0
54631,443,58856,443,allow,8367,3945,4422,81,616,42,39
2609,35993,0,0,deny,146,146,0,1,0,1,0
55049,53,52659,53,allow,733,86,647,2,31,1,1
49812,445,0,0,drop,70,70,0,1,0,1,0
33941,37807,0,0,deny,62,62,0,1,0,1,0
45941,23386,0,0,deny,60,60,0,1,0,1,0
50584,6882,59204,6882,allow,371,311,60,4,1199,3,1
65496,53,1852,53,allow,198,94,104,2,31,1,1
42252,33306,0,0,deny,60,60,0,1,0,1,0
30443,44847,0,0,deny,62,62,0,1,0,1,0
56107,53,50537,53,allow,817,102,715,2,30,1,1
64702,53,11324,53,allow,760,97,663,2,31,1,1
52110,35411,30183,35411,allow,66,66,0,1,5,1,0
1736,80,1736,80,allow,101959,5508,96451,111,95,41,70
52071,80,35794,80,allow,362,240,122,7,25,5,2
53732,22704,15296,22704,allow,70,70,0,1,5,1,0
27005,27017,49070,27017,allow,883,126,757,2,30,1,1
53632,445,0,0,drop,70,70,0,1,0,1,0
58638,5900,0,0,deny,62,62,0,1,0,1,0
49718,53,42238,53,allow,807,94,713,2,30,1,1
18246,64097,0,0,deny,66,66,0,1,0,1,0
60397,43129,42698,43129,allow,70,70,0,1,5,1,0
37075,80,46978,80,allow,1678,1364,314,10,15,5,5
58331,445,0,0,drop,70,70,0,1,0,1,0
57470,59216,60669,59216,allow,594,594,0,10,1200,10,0
34146,51221,0,0,deny,62,62,0,1,0,1,0
55167,48817,0,0,deny,66,66,0,1,0,1,0
10006,64147,0,0,deny,62,62,0,1,0,1,0
50722,80,21337,80,allow,3235,555,2680,13,20,6,7
64600,80,64600,80,allow,98859,6426,92433,136,27,68,68
49759,53,4425,53,allow,381,110,271,4,32,2,2
59008,51221,0,0,deny,66,66,0,1,0,1,0
64878,26467,0,0,deny,62,62,0,1,0,1,0
61137,40740,0,0,deny,145,145,0,1,0,1,0
65007,53,7048,53,allow,165,86,79,2,30,1,1
49996,53,6579,53,allow,183,94,89,2,30,1,1
56289,53,51620,53,allow,749,89,660,2,30,1,1
65265,445,0,0,drop,70,70,0,1,0,1,0
49558,443,48351,443,allow,12704,3459,9245,50,1336,18,32
51581,17546,0,0,deny,62,62,0,1,0,1,0
60409,44739,64818,44739,allow,70,70,0,1,5,1,0
58278,443,51446,443,allow,7349712,213635,7136077,7600,192,2303,5297
57545,35440,0,0,deny,66,66,0,1,0,1,0
53182,443,48630,443,allow,6094,1073,5021,19,15,10,9
64297,53,33648,53,allow,199,94,105,2,30,1,1
61505,443,24914,443,allow,4820,863,3957,18,31,10,8
58751,51221,0,0,deny,62,62,0,1,0,1,0
56924,53,61139,53,allow,216,110,106,2,30,1,1
41832,5222,27749,5222,allow,3823,1878,1945,39,309,22,17
4431,32480,0,0,deny,66,66,0,1,0,1,0
55922,53,5571,53,allow,807,94,713,2,29,1,1
49722,53,50235,53,allow,168,78,90,2,30,1,1
49875,445,0,0,drop,70,70,0,1,0,1,0
49622,445,0,0,drop,66,66,0,1,0,1,0
52337,445,0,0,drop,70,70,0,1,0,1,0
49972,53,21304,53,allow,184,94,90,2,30,1,1
64780,53,55734,53,allow,186,95,91,2,31,1,1
52042,53,52042,53,allow,81,81,0,1,30,1,0
37075,48817,0,0,deny,62,62,0,1,0,1,0
22528,25174,0,0,deny,62,62,0,1,0,1,0
59789,443,29818,443,allow,103556,8767,94789,144,48,75,69
57127,53,17390,53,allow,193,102,91,2,31,1,1
6247,51221,0,0,deny,78,78,0,1,0,1,0
39674,443,32592,443,allow,2828,1800,1028,27,184,15,12
0,0,0,0,allow,480,244,236,4,0,2,2
50317,80,30399,80,allow,5438,2832,2606,18,56,10,8
62014,35440,0,0,deny,66,66,0,1,0,1,0
58638,5900,0,0,deny,62,62,0,1,0,1,0
38135,80,24108,80,allow,111328,4904,106424,145,240,66,79
9518,443,46388,443,allow,3613,433,3180,11,16,6,5
63996,45759,44503,45759,allow,70,70,0,1,5,1,0
48111,443,2939,443,allow,214,140,74,4,15,3,1
43568,80,8531,80,allow,2277,1521,756,16,16,10,6
61451,17500,0,0,deny,66,66,0,1,0,1,0
52934,443,64385,443,allow,5584,1390,4194,19,14,9,10
27005,27015,4886,27015,allow,876,126,750,2,30,1,1
64388,445,0,0,drop,70,70,0,1,0,1,0
62792,53,0,0,deny,88,88,0,1,0,1,0
58638,5900,0,0,deny,62,62,0,1,0,1,0
51849,80,48623,80,allow,366,240,126,7,31,5,2
54912,443,54912,443,allow,4401,1494,2907,19,27,11,8
35122,80,19351,80,allow,130,70,60,2,15,1,1
58638,5900,0,0,deny,62,62,0,1,0,1,0
48837,53,7815,53,allow,198,93,105,2,30,1,1
17750,18866,37630,18866,allow,150,150,0,1,1200,1,0
65201,53,5294,53,allow,216,110,106,2,30,1,1
64086,53,31835,53,allow,241,94,147,2,29,1,1
58638,5900,0,0,deny,62,62,0,1,0,1,0
37694,80,28033,80,allow,1190,591,599,8,15,5,3
45941,23387,0,0,deny,60,60,0,1,0,1,0
55082,445,0,0,drop,66,66,0,1,0,1,0
56231,445,0,0,drop,66,66,0,1,0,1,0
55621,28144,20259,28144,allow,70,70,0,2,8,2,0
56645,445,0,0,drop,66,66,0,1,0,1,0
65382,53,24981,53,allow,301,108,193,4,54,2,2
4111,25174,0,0,deny,62,62,0,1,0,1,0
7871,3389,7871,3389,allow,4166,2141,2025,18,18,9,9
55498,445,0,0,drop,66,66,0,1,0,1,0
24988,53,24988,53,allow,214,82,132,2,33,1,1
59607,53,65103,53,allow,209,102,107,2,30,1,1
6666,990,0,0,deny,60,60,0,1,0,1,0
63868,445,0,0,drop,70,70,0,1,0,1,0
56677,443,37200,443,allow,6313,2068,4245,21,20,12,9
57051,53,10858,53,allow,354,90,264,4,50,2,2
54043,36237,0,0,deny,66,66,0,1,0,1,0
53772,53,7783,53,allow,70,70,0,1,30,1,0
35497,443,49704,443,allow,162,102,60,2,4,1,1
51831,26270,32908,26270,allow,70,70,0,2,6,2,0
57490,80,59652,80,allow,1614,1300,314,10,15,5,5
36579,30188,0,0,deny,66,66,0,1,0,1,0
55773,53,34274,53,allow,199,102,97,2,30,1,1
54828,443,16065,443,allow,572,572,0,5,11,5,0
56951,443,25621,443,allow,4679,2071,2608,14,135,7,7
57729,19750,0,0,deny,66,66,0,1,0,1,0
57192,53,44126,53,allow,177,94,83,2,30,1,1
37588,443,34121,443,allow,499,425,74,4,0,3,1
47963,443,46762,443,allow,8903,3095,5808,31,121,16,15
51684,80,23150,80,allow,1515,481,1034,11,15,6,5
13168,35440,0,0,deny,66,66,0,1,0,1,0
60229,443,63895,443,allow,19536,7593,11943,76,151,37,39
57604,445,0,0,drop,70,70,0,1,0,1,0
55631,16191,24420,16191,allow,504,318,186,8,16,5,3
56733,80,32206,80,allow,214,140,74,4,25,3,1
56415,53,6839,53,allow,198,101,97,2,30,1,1
39718,443,30883,443,allow,10457,3150,7307,25,217,13,12
31281,30188,0,0,deny,62,62,0,1,0,1,0
61445,443,34767,443,allow,97211,3043,94168,109,121,37,72
36146,443,34524,443,allow,1147,660,487,11,17,7,4
52022,52752,0,0,deny,74,74,0,1,0,1,0
55028,443,55949,443,allow,6015,3964,2051,32,361,18,14
63236,445,0,0,drop,70,70,0,1,0,1,0
49925,80,18933,80,allow,12290,10150,2140,37,256,19,18
58638,5900,0,0,deny,62,62,0,1,0,1,0
40204,40017,36316,40017,allow,156,94,62,2,30,1,1
64636,53,38894,53,allow,182,102,80,2,30,1,1
59468,445,0,0,drop,70,70,0,1,0,1,0
42602,443,64444,443,allow,2378,1126,1252,14,982,7,7
55840,443,56226,443,allow,9374,2150,7224,42,255,19,23
123,123,48945,123,allow,184,94,90,2,29,1,1
50584,6889,50435,6889,allow,1326,300,1026,6,1200,3,3
60571,26467,0,0,deny,62,62,0,1,0,1,0
56519,53,28431,53,allow,167,86,81,2,30,1,1
50820,57470,0,0,deny,62,62,0,1,0,1,0
1057,57470,0,0,deny,62,62,0,1,0,1,0
58638,5900,0,0,deny,62,62,0,1,0,1,0
61017,445,0,0,drop,70,70,0,1,0,1,0
0,0,0,0,deny,70,70,0,1,0,1,0
35267,80,35004,80,allow,613,539,74,7,15,6,1
57114,35440,0,0,deny,62,62,0,1,0,1,0
39810,48817,0,0,deny,148,148,0,1,0,1,0
49482,80,49482,80,allow,2444,1148,1296,14,48,7,7
34262,23,0,0,deny,60,60,0,1,0,1,0
56124,445,0,0,drop,70,70,0,1,0,1,0
3478,45401,0,0,deny,109,109,0,1,0,1,0
53512,443,1529,443,allow,1625,1038,587,14,34,8,6
38763,30188,0,0,deny,146,146,0,1,0,1,0
55221,445,0,0,drop,66,66,0,1,0,1,0
58574,445,0,0,drop,66,66,0,1,0,1,0
65513,445,0,0,drop,66,66,0,1,0,1,0
1030,35776,0,0,deny,139,139,0,1,0,1,0
51950,80,41291,80,allow,1268,645,623,12,45,7,5
50233,80,29881,80,allow,2388,1066,1322,16,135,8,8
56600,443,42581,443,allow,13773,6668,7105,31,105,19,12
9338,443,8556,443,allow,4462,500,3962,13,15,7,6
60752,28080,38222,28080,allow,70,70,0,2,8,2,0
59988,443,59988,443,allow,8589,2809,5780,30,16,15,15
45337,443,2595,443,allow,2312,1382,930,19,24,11,8
64588,53,47202,53,allow,165,86,79,2,30,1,1
55481,53,35011,53,allow,758,96,662,2,30,1,1
64988,53,16723,53,allow,196,94,102,2,30,1,1
57670,445,0,0,drop,66,66,0,1,0,1,0
53579,42707,0,0,deny,66,66,0,1,0,1,0
55760,53,12734,53,allow,182,94,88,2,30,1,1
49302,445,0,0,drop,70,70,0,1,0,1,0
57760,80,57760,80,allow,2934,1497,1437,10,16,6,4
63888,57470,0,0,deny,62,62,0,1,0,1,0
41694,26296,0,0,deny,145,145,0,1,0,1,0
16387,49252,0,0,deny,60,60,0,1,0,1,0
52075,445,0,0,drop,70,70,0,1,0,1,0
59225,57587,0,0,deny,66,66,0,1,0,1,0
11880,36829,0,0,deny,146,146,0,1,0,1,0
45624,443,55280,443,allow,6697,1606,5091,23,17,13,10
50244,80,52530,80,allow,136475,59298,77177,166,53,78,88
43784,443,17789,443,allow,10458,1688,8770,30,15,17,13
57470,32177,25835,32177,allow,480,149,331,2,1200,1,1
23157,53,23157,53,allow,228,90,138,2,30,1,1
53143,50584,0,0,deny,66,66,0,1,0,1,0
57270,53,64569,53,allow,200,102,98,2,30,1,1
50897,80,4903,80,allow,13981183,155668,13825515,11482,136,2194,9288
55427,53,31506,53,allow,200,102,98,2,30,1,1
63785,55255,57684,55255,allow,3706,2125,1581,18,33,10,8
50273,443,63017,443,allow,13363,4645,8718,54,241,32,22
55642,26872,53975,26872,allow,70,70,0,2,8,2,0
49214,58485,20411,58485,allow,70,70,0,1,5,1,0
50354,56205,0,0,deny,66,66,0,1,0,1,0
63156,445,0,0,drop,66,66,0,1,0,1,0
51717,445,0,0,drop,70,70,0,1,0,1,0
49321,443,15064,443,allow,3005,2082,923,18,28,9,9
51893,63924,1367,63924,allow,70,70,0,1,5,1,0
2876,35440,0,0,deny,62,62,0,1,0,1,0
50418,445,0,0,drop,66,66,0,1,0,1,0
65454,61600,0,0,deny,66,66,0,1,0,1,0
57375,53,3463,53,allow,198,102,96,2,30,1,1
58087,445,0,0,drop,70,70,0,1,0,1,0
33069,80,38685,80,allow,1899,1172,727,17,284,10,7
58638,5900,0,0,deny,62,62,0,1,0,1,0
57244,445,0,0,drop,70,70,0,1,0,1,0
54917,60043,0,0,deny,66,66,0,1,0,1,0
56292,443,36478,443,allow,10839,2145,8694,32,140,14,18
64428,53,26819,53,allow,299,97,202,4,44,2,2
51505,443,27614,443,allow,1210,450,760,17,54,5,12
993,54634,0,0,allow,66,66,0,1,90,1,0
26050,22448,0,0,allow,62,62,0,1,60,1,0
57913,443,41913,443,allow,1853,1214,639,18,142,11,7
58638,5900,0,0,deny,62,62,0,1,0,1,0
49650,80,5839,80,allow,318,192,126,6,41,4,2
51108,80,61739,80,allow,6504,3994,2510,26,47,14,12
60731,443,42232,443,allow,12669,5297,7372,31,188,18,13
59164,445,0,0,drop,70,70,0,1,0,1,0
60894,50584,0,0,deny,66,66,0,1,0,1,0
55676,445,0,0,drop,70,70,0,1,0,1,0
34083,443,2580,443,allow,7510,2040,5470,24,210,13,11
51582,48817,0,0,deny,66,66,0,1,0,1,0
53532,445,0,0,drop,70,70,0,1,0,1,0
58056,445,0,0,drop,66,66,0,1,0,1,0
80,53945,0,0,deny,60,60,0,1,0,1,0
64121,53,21027,53,allow,365,102,263,2,31,1,1
59341,53,56377,53,allow,187,78,109,2,30,1,1
46919,443,8853,443,allow,7094,1672,5422,21,361,10,11
5938,19141,0,0,allow,60,60,0,1,91,1,0
58168,445,0,0,drop,70,70,0,1,0,1,0
54936,80,14845,80,allow,613,539,74,7,15,6,1
61798,35440,0,0,deny,66,66,0,1,0,1,0
56950,443,1900,443,allow,4391,2171,2220,14,135,7,7
64985,53,36411,53,allow,192,98,94,2,30,1,1
0,0,0,0,deny,156,156,0,2,0,2,0
54142,7000,54142,7000,allow,4067,1750,2317,16,16,9,7
64305,445,0,0,drop,70,70,0,1,0,1,0
42316,443,23676,443,allow,6397,2103,4294,17,26,9,8
30920,64147,0,0,deny,62,62,0,1,0,1,0
55583,445,0,0,drop,66,66,0,1,0,1,0
56624,53,20436,53,allow,819,102,717,2,30,1,1
52541,53,60922,53,allow,242,78,164,2,29,1,1
63348,445,0,0,drop,70,70,0,1,0,1,0
65506,53,20953,53,allow,197,102,95,2,30,1,1
56552,445,0,0,drop,70,70,0,1,0,1,0
57183,53,32090,53,allow,178,94,84,2,30,1,1
27005,27016,41130,27016,allow,1622,126,1496,4,31,2,2
60424,445,0,0,drop,70,70,0,1,0,1,0
48817,14888,48817,14888,allow,481,150,331,2,1200,1,1
65220,53,55029,53,allow,178,94,84,2,30,1,1
54887,443,54887,443,allow,5573,2326,3247,22,40,13,9
37569,443,62678,443,allow,214,140,74,4,15,3,1
27407,36237,0,0,deny,146,146,0,1,0,1,0
49255,44847,0,0,deny,66,66,0,1,0,1,0
50258,443,57201,443,allow,7975,1974,6001,31,210,15,16
65463,443,25060,443,allow,92752,4519,88233,105,15,39,66
48301,25174,0,0,deny,66,66,0,1,0,1,0
50948,80,50948,80,allow,520,246,274,9,25,5,4
55610,23383,23402,23383,allow,70,70,0,2,8,2,0
62530,445,0,0,drop,70,70,0,1,0,1,0
38807,443,38807,443,allow,5741,2532,3209,24,80,14,10
64917,53,19019,53,allow,718,94,624,2,30,1,1
13963,50584,0,0,deny,66,66,0,1,0,1,0
55687,53,45230,53,allow,193,102,91,2,29,1,1
443,62732,0,0,deny,60,60,0,1,0,1,0
58101,53,12737,53,allow,83,83,0,2,31,2,0
49730,53,34301,53,allow,539,100,439,4,54,2,2
56456,445,0,0,drop,70,70,0,1,0,1,0
49713,80,27859,80,allow,5029,1986,3043,16,130,8,8
64678,53,21797,53,allow,229,110,119,2,30,1,1
58549,445,0,0,drop,70,70,0,1,0,1,0
43815,50584,0,0,deny,62,62,0,1,0,1,0
56755,53,37076,53,allow,184,94,90,2,31,1,1
45287,53,10390,53,allow,198,93,105,2,30,1,1
15605,50265,0,0,deny,62,62,0,1,0,1,0
65131,53,31647,53,allow,168,86,82,2,30,1,1
50553,3389,50553,3389,allow,3327,1438,1889,15,17,8,7
56217,53,61344,53,allow,183,94,89,2,31,1,1
50552,80,61160,80,allow,2367,1240,1127,10,16,5,5
55511,443,12800,443,allow,10499,2421,8078,28,15,14,14
55054,445,0,0,drop,66,66,0,1,0,1,0
58303,22114,0,0,deny,62,62,0,1,0,1,0
54545,49344,0,0,deny,66,66,0,1,0,1,0
58638,5900,0,0,deny,62,62,0,1,0,1,0
48335,25174,0,0,deny,62,62,0,1,0,1,0
54754,50432,0,0,deny,66,66,0,1,0,1,0
57664,80,57664,80,allow,1917,1468,449,10,19,6,4
55498,53,32880,53,allow,177,94,83,2,31,1,1
49526,53,6376,53,allow,272,97,175,4,58,2,2
60357,445,0,0,drop,66,66,0,1,0,1,0
62232,80,62232,80,allow,2158,1419,739,11,150,6,5
64128,53,11418,53,allow,186,95,91,2,31,1,1
60270,443,24845,443,allow,6155,1709,4446,29,1710,15,14
52168,62118,28732,62118,allow,70,70,0,1,5,1,0
64475,53,56537,53,allow,184,94,90,2,30,1,1
50651,25174,0,0,deny,62,62,0,1,0,1,0
48368,443,5888,443,allow,9157,3805,5352,39,100,18,21
49508,53,13388,53,allow,199,102,97,2,30,1,1
63695,445,0,0,drop,66,66,0,1,0,1,0
62136,445,0,0,drop,70,70,0,1,0,1,0
53792,1,64543,1,allow,70,70,0,1,4,1,0
58638,5900,0,0,deny,62,62,0,1,0,1,0
27005,27019,51161,27019,allow,1698,126,1572,4,31,2,2
15503,37512,24044,37512,allow,528,528,0,9,1199,9,0
56958,80,27013,80,allow,9535,3968,5567,21,30,12,9
18157,53,35666,53,allow,215,94,121,2,30,1,1
64914,53,27750,53,allow,168,86,82,2,30,1,1
51496,443,41580,443,allow,1177,624,553,12,16,7,5
58273,445,0,0,drop,70,70,0,1,0,1,0
7226,50584,0,0,deny,62,62,0,1,0,1,0
51028,445,0,0,drop,70,70,0,1,0,1,0
34897,50584,0,0,deny,62,62,0,1,0,1,0
58409,53,57147,53,allow,307,86,221,2,30,1,1
1487,35440,0,0,deny,146,146,0,1,0,1,0
63763,17368,8449,17368,allow,66,66,0,1,5,1,0
50908,443,7886,443,allow,124,64,60,2,15,1,1
49914,445,0,0,drop,66,66,0,1,0,1,0
50964,445,0,0,drop,70,70,0,1,0,1,0
56358,443,56358,443,allow,4674,1767,2907,19,29,11,8
52310,80,52310,80,allow,450,246,204,8,29,5,3
56756,53,14084,53,allow,167,86,81,2,30,1,1
52930,445,0,0,drop,70,70,0,1,0,1,0
38104,443,51062,443,allow,8884,4067,4817,24,19,11,13
49506,443,13324,443,allow,6002,1965,4037,23,270,11,12
54343,50584,0,0,deny,66,66,0,1,0,1,0
56884,53,35715,53,allow,199,102,97,2,30,1,1
58171,80,42934,80,allow,1651,550,1101,13,15,7,6
41335,53,41335,53,allow,825,99,726,2,30,1,1
59099,445,0,0,drop,70,70,0,1,0,1,0
16721,22114,0,0,deny,146,146,0,1,0,1,0
64559,53,29849,53,allow,198,110,88,2,30,1,1
56662,80,65360,80,allow,234,234,0,4,12,4,0
59832,445,0,0,drop,70,70,0,1,0,1,0
50070,445,0,0,drop,70,70,0,1,0,1,0
49805,53,26905,53,allow,296,102,194,2,30,1,1
59214,445,0,0,drop,66,66,0,1,0,1,0
50060,80,8335,80,allow,2425,529,1896,11,75,6,5
64001,13051,4222,13051,allow,70,70,0,1,4,1,0
58955,57470,0,0,deny,74,74,0,1,0,1,0
39932,80,45032,80,allow,3472,2124,1348,14,21,8,6
57072,53,9949,53,allow,195,102,93,2,30,1,1
49305,445,0,0,drop,70,70,0,1,0,1,0
49191,53,32868,53,allow,186,95,91,2,31,1,1
52191,445,0,0,drop,70,70,0,1,0,1,0
35989,443,62539,443,allow,2840032,64781,2775251,2709,292,769,1940
50282,37965,0,0,deny,66,66,0,1,0,1,0
56827,18318,42346,18318,allow,70,70,0,1,5,1,0
56275,53,54180,53,allow,177,94,83,2,30,1,1
55711,53,26039,53,allow,177,94,83,2,29,1,1
56575,443,16584,443,allow,14284,5729,8555,31,61,19,12
49655,443,10531,443,allow,31956,13344,18612,64,65,36,28
56586,53,50469,53,allow,177,94,83,2,29,1,1
54909,445,0,0,drop,66,66,0,1,0,1,0
43460,80,58949,80,allow,23394,1667,21727,38,18,20,18
61202,445,0,0,drop,70,70,0,1,0,1,0
50332,80,19945,80,allow,2862,1465,1397,11,47,6,5
55113,53,62631,53,allow,177,94,83,2,30,1,1
56137,53,37448,53,allow,199,102,97,2,30,1,1
64332,53,40499,53,allow,167,86,81,2,30,1,1
53743,443,64755,443,allow,495,421,74,4,1,3,1
47050,53,14793,53,allow,199,94,105,2,30,1,1
11478,51221,0,0,deny,66,66,0,1,0,1,0
55773,53,49268,53,allow,97,97,0,1,60,1,0
47173,35440,0,0,deny,62,62,0,1,0,1,0
64649,53,56977,53,allow,184,94,90,2,30,1,1
57539,44847,0,0,deny,62,62,0,1,0,1,0
48736,443,16569,443,allow,371295,17988,353307,571,40,233,338
51239,443,46781,443,allow,9649,4615,5034,42,16,24,18
63037,445,0,0,drop,70,70,0,1,0,1,0
65073,53,40365,53,allow,293,102,191,2,30,1,1
60435,35440,0,0,deny,62,62,0,1,0,1,0
54536,80,14992,80,allow,4096,3455,641,13,15,8,5
36419,50584,0,0,deny,146,146,0,1,0,1,0
49158,443,27828,443,allow,14490,4227,10263,35,36,19,16
58338,3362,0,0,deny,60,60,0,1,0,1,0
49977,53,38356,53,allow,209,110,99,2,30,1,1
60850,445,0,0,drop,70,70,0,1,0,1,0
53142,445,0,0,drop,70,70,0,1,0,1,0
26900,27017,43770,27017,allow,422,164,258,6,30,3,3
54343,50584,0,0,deny,66,66,0,1,0,1,0
50584,19051,19819,19051,allow,300,300,0,3,1200,3,0
60614,445,0,0,drop,70,70,0,1,0,1,0
49418,27015,52335,27015,allow,295,78,217,2,30,1,1
55022,53,15240,53,allow,195,102,93,2,30,1,1
54011,44847,0,0,deny,66,66,0,1,0,1,0
50089,445,0,0,drop,70,70,0,1,0,1,0
64022,53,20960,53,allow,194,99,95,2,1,1,1
49963,53,58470,53,allow,564,191,373,6,62,3,3
61522,64147,0,0,deny,66,66,0,1,0,1,0
51513,443,63128,443,allow,10839,705,10134,14,46,4,10
55563,53,47239,53,allow,194,102,92,2,31,1,1
65196,53,56319,53,allow,172,94,78,2,29,1,1
49400,80,14888,80,allow,40119,2475,37644,49,84,16,33
64936,53,3056,53,allow,193,102,91,2,30,1,1
50444,443,31610,443,allow,47752,21819,25933,119,704,59,60
47994,443,47994,443,allow,4485,1578,2907,19,28,11,8
55342,443,55342,443,allow,5593,2346,3247,22,39,13,9
56911,53,22477,53,allow,211,78,133,2,30,1,1
54429,53,0,0,allow,195,70,125,2,30,1,1
54437,80,15743,80,allow,95298,61941,33357,182,929,95,87
62683,445,0,0,drop,66,66,0,1,0,1,0
23936,35440,0,0,deny,62,62,0,1,0,1,0
65085,22114,0,0,deny,66,66,0,1,0,1,0
16092,50265,0,0,deny,62,62,0,1,0,1,0
50818,445,0,0,drop,66,66,0,1,0,1,0
56831,10434,25973,10434,allow,70,70,0,1,5,1,0
5774,37965,0,0,deny,66,66,0,1,0,1,0
31683,35440,0,0,deny,62,62,0,1,0,1,0
16071,53,16071,53,allow,832,106,726,2,30,1,1
40703,5900,0,0,deny,60,60,0,1,0,1,0
44158,443,51060,443,allow,232,172,60,3,5,2,1
443,32698,0,0,deny,89,89,0,1,0,1,0
56252,53,46494,53,allow,531,90,441,4,41,2,2
65512,53,38019,53,allow,265,102,163,2,30,1,1
52536,445,0,0,drop,66,66,0,1,0,1,0
52886,80,7195,80,allow,5688,2508,3180,36,118,19,17
64459,53,56371,53,allow,251,94,157,2,29,1,1
65084,53,19424,53,allow,215,102,113,2,29,1,1
65491,53,6276,53,allow,889,404,485,10,30,5,5
58053,445,0,0,drop,66,66,0,1,0,1,0
56889,53,27210,53,allow,211,110,101,2,30,1,1
42658,443,41427,443,allow,10170,2072,8098,37,255,19,18
65491,53,33767,53,allow,193,102,91,2,31,1,1
49528,53,36226,53,allow,177,94,83,2,29,1,1
60731,445,0,0,drop,66,66,0,1,0,1,0
59203,445,0,0,drop,70,70,0,1,0,1,0
9231,3389,0,0,deny,66,66,0,1,0,1,0
60681,445,0,0,drop,70,70,0,1,0,1,0
57281,443,25432,443,allow,212477,8324,204153,232,122,79,153
58248,53,0,0,allow,633,83,550,2,30,1,1
50061,443,9312,443,allow,7199,2528,4671,18,76,10,8
60191,80,55591,80,allow,2589,1231,1358,9,28,5,4
43089,443,26098,443,allow,9737,6695,3042,45,81,24,21
9529,26467,0,0,deny,62,62,0,1,0,1,0
52934,26467,0,0,deny,66,66,0,1,0,1,0
27005,27111,30399,27111,allow,893,126,767,2,30,1,1
56389,445,0,0,drop,70,70,0,1,0,1,0
49422,53,49422,53,allow,247,98,149,2,32,1,1
50488,80,56611,80,allow,318,192,126,6,25,4,2
42632,443,43354,443,allow,4299,1870,2429,17,150,8,9
37851,443,26132,443,allow,14283,12630,1653,29,126,17,12
55647,53,13562,53,allow,168,86,82,2,31,1,1
1848,53,1848,53,allow,832,106,726,2,29,1,1
49900,4500,63369,4500,allow,78,78,0,1,5,1,0
56991,445,0,0,drop,70,70,0,1,0,1,0
49927,445,0,0,drop,70,70,0,1,0,1,0
54976,10387,0,0,deny,159,159,0,1,0,1,0
54162,445,0,0,drop,70,70,0,1,0,1,0
45472,8168,0,0,deny,62,62,0,1,0,1,0
49605,53,30084,53,allow,756,95,661,2,30,1,1
63013,445,0,0,drop,70,70,0,1,0,1,0
64219,445,0,0,drop,70,70,0,1,0,1,0
64586,50584,0,0,deny,146,146,0,1,0,1,0
63989,445,0,0,drop,66,66,0,1,0,1,0
60851,443,17568,443,allow,36974,3935,33039,56,61,27,29
64576,53,33878,53,allow,188,96,92,2,31,1,1
53160,25174,0,0,deny,62,62,0,1,0,1,0
16403,16385,45121,16385,allow,182,62,120,4,30,2,2
63939,445,0,0,drop,70,70,0,1,0,1,0
60480,57470,0,0,deny,62,62,0,1,0,1,0
58851,443,62485,443,allow,15848,13507,2341,37,32,19,18
57007,445,0,0,drop,70,70,0,1,0,1,0
25565,44521,0,0,deny,60,60,0,1,0,1,0
62632,35440,0,0,deny,66,66,0,1,0,1,0
60152,26467,0,0,deny,62,62,0,1,0,1,0
56707,443,58509,443,allow,40263,17490,22773,75,403,35,40
54167,53,54167,53,allow,242,98,144,2,30,1,1
57201,53,46716,53,allow,214,110,104,2,30,1,1
50356,53,7944,53,allow,176,90,86,2,31,1,1
55760,53,35277,53,allow,182,94,88,2,31,1,1
64821,53,30415,53,allow,775,102,673,2,30,1,1
55419,445,0,0,drop,70,70,0,1,0,1,0
15635,41182,0,0,deny,66,66,0,1,0,1,0
65342,53,40557,53,allow,183,94,89,2,30,1,1
53555,57861,41718,57861,allow,492,306,186,8,15,5,3
53364,445,0,0,drop,70,70,0,1,0,1,0
50919,445,0,0,drop,70,70,0,1,0,1,0
50077,80,42513,80,allow,804,380,424,9,15,5,4
54640,445,0,0,drop,70,70,0,1,0,1,0
54998,80,32299,80,allow,2814,2440,374,13,16,7,6
49042,443,19321,443,allow,5792,1764,4028,24,31,14,10
61520,23718,0,0,deny,66,66,0,1,0,1,0
6881,8305,0,0,deny,143,143,0,1,0,1,0
54062,31573,0,0,deny,66,66,0,1,0,1,0
50604,443,49840,443,allow,7470,2479,4991,20,135,9,11
15503,6881,43362,6881,allow,2310,2310,0,36,3136,36,0
20864,51221,0,0,deny,62,62,0,1,0,1,0
30114,65151,0,0,deny,60,60,0,1,0,1,0
55816,445,0,0,drop,70,70,0,1,0,1,0
54542,25604,0,0,deny,66,66,0,1,0,1,0
44516,443,57254,443,allow,4709,2451,2258,18,304,8,10
49795,443,22996,443,allow,7243,777,6466,17,126,8,9
55951,53,4112,53,allow,197,102,95,2,30,1,1
53728,19442,57763,19442,allow,320,140,180,6,7,3,3
52336,64097,0,0,deny,66,66,0,1,0,1,0
58442,445,0,0,drop,66,66,0,1,0,1,0
54168,445,0,0,drop,70,70,0,1,0,1,0
50265,12656,39117,12656,allow,402,132,270,6,1209,3,3
49331,53,5900,53,allow,182,94,88,2,31,1,1
1790,48817,0,0,deny,62,62,0,1,0,1,0
56234,445,0,0,drop,70,70,0,1,0,1,0
1262,23,0,0,deny,60,60,0,1,0,1,0
54721,22114,0,0,deny,66,66,0,1,0,1,0
55887,53,54286,53,allow,166,86,80,2,31,1,1
54320,445,0,0,drop,66,66,0,1,0,1,0
49202,445,0,0,drop,66,66,0,1,0,1,0
20254,53,7951,53,allow,223,78,145,2,29,1,1
62107,445,0,0,drop,66,66,0,1,0,1,0
27005,1202,59034,1202,allow,865,126,739,2,30,1,1
40603,53,40603,53,allow,240,96,144,2,31,1,1
54962,53,47568,53,allow,241,102,139,2,31,1,1
26758,50584,0,0,deny,66,66,0,1,0,1,0
62995,53,21772,53,allow,102,102,0,1,30,1,0
60152,26467,0,0,deny,62,62,0,1,0,1,0
54429,443,55314,443,allow,9970,3706,6264,44,272,21,23
12663,62413,0,0,deny,66,66,0,1,0,1,0
60573,445,0,0,drop,70,70,0,1,0,1,0
50531,80,18243,80,allow,1704,799,905,11,83,6,5
47729,443,6419,443,allow,15600,2166,13434,32,205,16,16
55782,53,37884,53,allow,728,96,632,2,30,1,1
49237,443,19934,443,allow,8293,4179,4114,22,128,11,11
60337,443,11026,443,allow,1862,1223,639,18,89,11,7
65264,53,51558,53,allow,198,94,104,2,29,1,1
49490,443,58298,443,allow,1627,884,743,12,27,6,6
35608,443,36107,443,allow,8530,2685,5845,25,100,15,10
55559,53,6941,53,allow,182,94,88,2,29,1,1
5379,37965,0,0,deny,62,62,0,1,0,1,0
5894,44847,0,0,deny,66,66,0,1,0,1,0
46674,53,59897,53,allow,168,78,90,2,30,1,1
50412,80,26565,80,allow,1524,341,1183,11,36,4,7
65067,445,0,0,drop,66,66,0,1,0,1,0
52933,443,12830,443,allow,3517,993,2524,12,120,6,6
52146,18174,63624,18174,allow,70,70,0,1,5,1,0
49663,443,36491,443,allow,4271,1075,3196,16,25,8,8
5637,37965,0,0,deny,62,62,0,1,0,1,0
51504,443,9734,443,allow,6656,769,5887,14,16,9,5
49967,53,25573,53,allow,445,95,350,4,50,2,2
26900,27017,8503,27017,allow,422,164,258,6,29,3,3
40990,10387,0,0,deny,148,148,0,1,0,1,0
57045,53,5353,53,allow,177,94,83,2,29,1,1
64029,443,14573,443,allow,252,70,182,3,120,1,2
0,0,0,0,deny,156,156,0,2,0,2,0
61637,25174,0,0,deny,66,66,0,1,0,1,0
65350,53,62383,53,allow,168,86,82,2,30,1,1
50156,445,0,0,drop,70,70,0,1,0,1,0
35194,57470,0,0,deny,74,74,0,1,0,1,0
65221,53,28071,53,allow,196,86,110,2,30,1,1
34822,31573,0,0,deny,62,62,0,1,0,1,0
53223,53,33950,53,allow,165,78,87,2,30,1,1
60093,445,0,0,drop,70,70,0,1,0,1,0
50970,80,27517,80,allow,1123476,15099,1108377,963,39,223,740
56784,23140,27615,23140,allow,70,70,0,1,5,1,0
61838,53,61838,53,allow,216,90,126,2,30,1,1
64119,53,14375,53,allow,259,102,157,2,30,1,1
50265,23,0,0,deny,60,60,0,1,0,1,0
64192,445,0,0,drop,66,66,0,1,0,1,0
60173,443,14780,443,allow,7909,3501,4408,19,181,9,10
55673,54815,52506,54815,allow,316,190,126,5,15,3,2
57013,53,60365,53,allow,172,88,84,2,30,1,1
54954,443,24434,443,allow,469752,21060,448692,589,64,265,324
53379,445,0,0,drop,70,70,0,1,0,1,0
23293,443,23293,443,allow,50236,37417,12819,67,19,41,26
55003,445,0,0,drop,70,70,0,1,0,1,0
62704,443,4818,443,allow,6805,3445,3360,31,121,15,16
50130,53,57806,53,allow,174,89,85,2,30,1,1
55410,80,63972,80,allow,1250,472,778,13,46,3,10
58369,443,52510,443,allow,12779517,343310,12436207,12837,162,4589,8248
50057,53,32757,53,allow,718,94,624,2,30,1,1
55828,53,14283,53,allow,177,94,83,2,30,1,1
56369,53,59110,53,allow,193,102,91,2,31,1,1
55560,53,36102,53,allow,166,86,80,2,30,1,1
55670,31056,27603,31056,allow,70,70,0,1,5,1,0
47054,443,53511,443,allow,6803,2164,4639,14,121,7,7
58860,53,53609,53,allow,209,102,107,2,29,1,1
64166,35440,0,0,deny,66,66,0,1,0,1,0
55034,443,55034,443,allow,154907,10748,144159,217,20,101,116
63964,53,52901,53,allow,196,94,102,2,30,1,1
44784,443,49876,443,allow,12834,7868,4966,60,463,38,22
52215,16937,53036,16937,allow,136,136,0,3,12,3,0
45472,8168,0,0,deny,62,62,0,1,0,1,0
52492,37965,0,0,deny,66,66,0,1,0,1,0
64685,53,47486,53,allow,785,110,675,2,30,1,1
50340,53,17641,53,allow,189,102,87,2,31,1,1
36926,53,54098,53,allow,164,78,86,2,30,1,1
65465,53,18720,53,allow,293,102,191,2,29,1,1
54394,445,0,0,drop,66,66,0,1,0,1,0
54440,26467,0,0,deny,66,66,0,1,0,1,0
53121,8986,30082,8986,allow,70,70,0,1,5,1,0
54624,445,0,0,drop,70,70,0,1,0,1,0
50106,30317,0,0,deny,66,66,0,1,0,1,0
65315,53,22076,53,allow,216,110,106,2,30,1,1
65313,53,20235,53,allow,802,288,514,8,75,4,4
60187,53,13355,53,allow,168,78,90,2,30,1,1
63260,445,0,0,drop,66,66,0,1,0,1,0
59276,443,40586,443,allow,16232,3319,12913,23,125,9,14
61537,445,0,0,drop,66,66,0,1,0,1,0
55620,30188,0,0,deny,66,66,0,1,0,1,0
56438,445,0,0,drop,70,70,0,1,0,1,0
55032,53,18500,53,allow,458,188,270,6,31,3,3
25101,50584,0,0,deny,62,62,0,1,0,1,0
52925,64147,0,0,deny,62,62,0,1,0,1,0
57269,53,63044,53,allow,183,94,89,2,30,1,1
36403,443,54491,443,allow,1149,709,440,13,39,8,5
50589,53,50328,53,allow,733,85,648,2,30,1,1
54321,27015,6955,27015,allow,924,924,0,3,30,3,0
49836,53,62893,53,allow,168,78,90,2,30,1,1
43494,443,46566,443,allow,670,382,288,10,133,6,4
38634,443,59310,443,allow,9741,4687,5054,36,165,21,15
3478,61463,0,0,deny,252,252,0,1,0,1,0
49939,53,36312,53,allow,384,103,281,4,50,2,2
51272,12210,19987,12210,allow,70,70,0,2,8,2,0
51413,57470,0,0,deny,72,72,0,1,0,1,0
57370,443,5735,443,allow,7211,823,6388,16,15,10,6
56170,53,52947,53,allow,198,102,96,2,31,1,1
64295,26467,0,0,deny,66,66,0,1,0,1,0
62902,32468,0,0,deny,66,66,0,1,0,1,0
65477,53,46159,53,allow,209,110,99,2,30,1,1
50321,443,43498,443,allow,8156,1586,6570,24,82,11,13
9157,443,57140,443,allow,5734,498,5236,14,15,7,7
51873,19311,22096,19311,allow,70,70,0,1,5,1,0
50586,443,6357,443,allow,2756,1594,1162,20,27,11,9
63765,51221,0,0,deny,62,62,0,1,0,1,0
65102,53,35796,53,allow,183,94,89,2,30,1,1
61830,443,61830,443,allow,88574,15708,72866,114,176,52,62
65413,53,65505,53,allow,266,110,156,2,30,1,1
55680,53,52561,53,allow,749,94,655,2,31,1,1
56806,443,47180,443,allow,403093,31796,371297,497,151,185,312
65472,443,58915,443,allow,460338,13340,446998,472,16,165,307
56938,53,8399,53,allow,199,102,97,2,29,1,1
54238,443,21116,443,allow,499,425,74,4,0,3,1
59840,445,0,0,drop,66,66,0,1,0,1,0
52916,445,0,0,drop,66,66,0,1,0,1,0
41931,443,53560,443,allow,8579,2273,6306,17,136,8,9
54449,443,31656,443,allow,128477,6347,122130,155,276,56,99
57470,29500,37295,29500,allow,2772,2772,0,43,2311,43,0
6416,22114,0,0,deny,66,66,0,1,0,1,0
55877,22374,2922,22374,allow,150,150,0,1,1200,1,0
23021,25174,0,0,deny,66,66,0,1,0,1,0
55593,53,39878,53,allow,288,288,0,4,47,4,0
49826,443,35074,443,allow,5635,1599,4036,19,125,11,8
56790,443,12015,443,allow,8073,2053,6020,20,16,11,9
53959,39097,20337,39097,allow,1450,761,689,14,15,8,6
53727,443,53687,443,allow,499,425,74,4,0,3,1
56340,53,44693,53,allow,198,102,96,2,30,1,1
41632,443,56228,443,allow,8507,4462,4045,27,141,14,13
16387,7205,0,0,deny,60,60,0,1,0,1,0
5683,44847,0,0,deny,66,66,0,1,0,1,0
57948,443,51203,443,allow,6885,3239,3646,53,190,24,29
54566,445,0,0,drop,70,70,0,1,0,1,0
57432,443,39026,443,allow,2714,336,2378,10,120,5,5
57258,53,32914,53,allow,198,102,96,2,30,1,1
49370,53,35451,53,allow,430,85,345,4,54,2,2
37965,48782,19115,48782,allow,132,132,0,3,1199,3,0
32424,50584,0,0,deny,146,146,0,1,0,1,0
59756,53,64652,53,allow,571,166,405,2,29,1,1
49514,52255,0,0,deny,162,162,0,1,0,1,0
57293,443,65420,443,allow,7057,2815,4242,37,18,21,16
33305,54532,0,0,deny,60,60,0,1,0,1,0
34114,443,15852,443,allow,6206,1695,4511,25,16,13,12
17306,25174,0,0,deny,66,66,0,1,0,1,0
27343,55839,0,0,deny,137,137,0,1,0,1,0
55585,445,0,0,drop,70,70,0,1,0,1,0
56261,53,47864,53,allow,184,94,90,2,31,1,1
49568,443,30225,443,allow,6408,2531,3877,21,16,11,10
56360,53,64885,53,allow,711,87,624,2,30,1,1
62540,29892,0,0,deny,145,145,0,1,0,1,0
55373,1,0,0,deny,66,66,0,1,0,1,0
64883,53,13274,53,allow,184,94,90,2,31,1,1
58176,5223,41893,5223,allow,15152,5747,9405,46,56,20,26
61488,445,0,0,drop,70,70,0,1,0,1,0
49891,445,0,0,drop,66,66,0,1,0,1,0
49359,445,0,0,drop,66,66,0,1,0,1,0
64784,53,13638,53,allow,226,102,124,2,30,1,1
49580,53,60391,53,allow,196,102,94,2,30,1,1
51981,80,47640,80,allow,48165,2605,45560,63,15,31,32
49853,443,20017,443,allow,11534,2076,9458,43,60,21,22
61761,445,0,0,drop,70,70,0,1,0,1,0
50692,443,11802,443,allow,152,86,66,2,5,1,1
56758,53,14411,53,allow,165,86,79,2,30,1,1
45608,443,58506,443,allow,8487,2231,6256,26,350,12,14
55330,53,28011,53,allow,194,102,92,2,29,1,1
6881,48947,47849,48947,allow,228,118,110,2,1199,1,1
3478,61463,0,0,deny,233,233,0,1,0,1,0
56662,443,9856,443,allow,8007,1987,6020,20,15,11,9
49547,443,61463,443,allow,7817,1780,6037,26,172,13,13
49828,443,20161,443,allow,5927,1644,4283,18,16,10,8
50657,445,0,0,drop,70,70,0,1,0,1,0
50807,443,17833,443,allow,9328,1709,7619,18,139,8,10
56980,53,42285,53,allow,267,87,180,4,38,2,2
63864,44139,53899,44139,allow,70,70,0,1,5,1,0
59896,443,22952,443,allow,1537,934,603,14,32,7,7
53212,445,0,0,drop,70,70,0,1,0,1,0
54868,1433,0,0,deny,60,60,0,1,0,1,0
57204,53,35848,53,allow,183,94,89,2,30,1,1
57770,445,0,0,drop,70,70,0,1,0,1,0
45682,37965,0,0,deny,145,145,0,1,0,1,0
56747,445,0,0,drop,70,70,0,1,0,1,0
53911,443,51915,443,allow,499,425,74,4,0,3,1
13441,57470,0,0,deny,62,62,0,1,0,1,0
5223,44091,0,0,deny,167,167,0,1,0,1,0
41545,443,41545,443,allow,4719,1812,2907,19,29,11,8
17171,22114,0,0,deny,66,66,0,1,0,1,0
64670,53,24174,53,allow,193,102,91,2,30,1,1
57044,53,54820,53,allow,177,94,83,2,31,1,1
13021,25174,0,0,deny,62,62,0,1,0,1,0
45355,443,7242,443,allow,410,210,200,7,92,4,3
63030,25174,0,0,deny,62,62,0,1,0,1,0
57126,53,6801,53,allow,183,94,89,2,31,1,1
61845,11392,0,0,deny,66,66,0,1,0,1,0
32976,37965,0,0,deny,66,66,0,1,0,1,0
56636,43890,0,0,deny,66,66,0,1,0,1,0
53271,443,21027,443,allow,1544,1073,471,13,15,8,5
58678,445,0,0,drop,70,70,0,1,0,1,0
50609,80,26280,80,allow,4163,2891,1272,17,17,9,8
60587,445,0,0,drop,70,70,0,1,0,1,0
64889,26467,0,0,deny,66,66,0,1,0,1,0
55185,53,27754,53,allow,758,93,665,2,30,1,1
57470,56250,44821,56250,allow,330,330,0,6,1199,6,0
53215,445,0,0,drop,70,70,0,1,0,1,0
58587,445,0,0,drop,70,70,0,1,0,1,0
49909,443,16969,443,allow,6754,2219,4535,21,75,11,10
53207,50265,0,0,deny,66,66,0,1,0,1,0
65273,53,64303,53,allow,226,102,124,2,30,1,1
33193,50584,0,0,deny,62,62,0,1,0,1,0
65036,53,40667,53,allow,214,110,104,2,30,1,1
53543,51819,43192,51819,allow,70,70,0,2,7,2,0
29291,40108,0,0,deny,150,150,0,1,0,1,0
42167,443,27521,443,allow,4117,1026,3091,15,31,9,6
62693,443,62693,443,allow,4788,1881,2907,19,31,11,8
49997,445,0,0,drop,70,70,0,1,0,1,0
57578,51221,0,0,deny,62,62,0,1,0,1,0
54711,443,57738,443,allow,7169,2405,4764,18,135,10,8
64369,53,59649,53,allow,240,110,130,2,30,1,1
42917,53,23421,53,allow,168,78,90,2,30,1,1
49681,80,35209,80,allow,4584,3642,942,15,15,8,7
52989,51505,0,0,deny,66,66,0,1,0,1,0
27005,30006,10243,30006,allow,888,126,762,3,31,2,1
49913,53,48535,53,allow,493,94,399,4,40,2,2
60045,443,35524,443,allow,17161,1619,15542,18,151,4,14
49971,443,5852,443,allow,62,62,0,1,120,1,0
51085,56205,0,0,deny,66,66,0,1,0,1,0
62153,35440,0,0,deny,66,66,0,1,0,1,0
52658,445,0,0,drop,70,70,0,1,0,1,0
49943,80,49943,80,allow,254742,14106,240636,305,22,131,174
52462,445,0,0,drop,70,70,0,1,0,1,0
49791,445,0,0,drop,70,70,0,1,0,1,0
19068,37965,0,0,deny,62,62,0,1,0,1,0
51837,37965,0,0,deny,66,66,0,1,0,1,0
59378,50584,0,0,deny,62,62,0,1,0,1,0
41173,443,28924,443,allow,11771,2624,9147,50,19,25,25
37672,443,48728,443,allow,3338,2337,1001,18,45,11,7
49568,443,58538,443,allow,7180,4959,2221,34,81,18,16
57270,53,35020,53,allow,211,102,109,2,30,1,1
61212,445,0,0,drop,66,66,0,1,0,1,0
56655,53,60035,53,allow,168,86,82,2,30,1,1
35060,80,35060,80,allow,1918,1469,449,10,20,6,4
49370,443,17640,443,allow,350,210,140,6,16,4,2
57720,445,0,0,drop,70,70,0,1,0,1,0
53493,445,0,0,drop,70,70,0,1,0,1,0
64428,53,57120,53,allow,190,97,93,2,31,1,1
42298,40003,32102,40003,allow,206,84,122,4,30,2,2
59486,50584,0,0,deny,62,62,0,1,0,1,0
56775,53,64956,53,allow,177,94,83,2,29,1,1
61563,37807,0,0,deny,62,62,0,1,0,1,0
443,46569,0,0,deny,66,66,0,1,0,1,0
34731,22114,0,0,deny,62,62,0,1,0,1,0
55168,53,23617,53,allow,816,97,719,2,31,1,1
50310,80,45251,80,allow,2958,1116,1842,15,83,8,7
30188,55886,45541,55886,allow,502,150,352,2,1200,1,1
61413,443,10754,443,allow,4933,771,4162,18,28,8,10
10669,49756,0,0,deny,60,60,0,1,0,1,0
57899,443,40248,443,allow,6115,1035,5080,21,170,11,10
59189,443,26773,443,allow,9050,4611,4439,37,222,20,17
61140,443,36707,443,allow,10803,2906,7897,20,135,10,10
54984,80,56260,80,allow,2487,680,1807,9,17,6,3
55929,53,16714,53,allow,760,97,663,2,30,1,1
52109,60841,37568,60841,allow,258,70,188,4,8,2,2
6546,37965,0,0,deny,62,62,0,1,0,1,0
50265,25490,26928,25490,allow,1766,1332,434,22,1200,15,7
50607,80,15942,80,allow,1657,1247,410,8,14,5,3
60761,40010,63900,40010,allow,316,136,180,6,6,3,3
5938,37145,0,0,allow,60,60,0,1,90,1,0
51446,17500,0,0,deny,100,100,0,1,0,1,0
59459,37807,0,0,deny,66,66,0,1,0,1,0
45052,443,37093,443,allow,131573,4926,126647,152,152,55,97
55663,19994,24256,19994,allow,70,70,0,1,5,1,0
25739,64147,0,0,deny,62,62,0,1,0,1,0
40500,53,40500,53,allow,203,82,121,2,30,1,1
56708,443,38081,443,allow,9634,3110,6524,26,138,11,15
33498,5529,0,0,deny,145,145,0,1,0,1,0
58797,443,26512,443,allow,3311,1069,2242,13,135,6,7
61183,445,0,0,drop,70,70,0,1,0,1,0
56266,53,65060,53,allow,193,102,91,2,30,1,1
65024,53,56492,53,allow,174,89,85,2,31,1,1
36368,80,58408,80,allow,78,78,0,1,5,1,0
56353,445,0,0,drop,66,66,0,1,0,1,0
59734,445,0,0,drop,70,70,0,1,0,1,0
53750,443,4212,443,allow,499,425,74,4,0,3,1
54912,64147,0,0,deny,66,66,0,1,0,1,0
50116,22,50116,22,allow,184,120,64,4,10,3,1
49540,50584,0,0,deny,66,66,0,1,0,1,0
58713,445,0,0,drop,70,70,0,1,0,1,0
55017,443,32512,443,allow,7627,2734,4893,26,16,15,11
53880,445,0,0,drop,66,66,0,1,0,1,0
40527,443,2355,443,allow,21750,1903,19847,39,154,20,19
51101,445,0,0,drop,66,66,0,1,0,1,0
36649,53,5716,53,allow,198,93,105,2,30,1,1
55820,53,19644,53,allow,194,102,92,2,30,1,1
61912,445,0,0,drop,66,66,0,1,0,1,0
59782,26467,0,0,deny,62,62,0,1,0,1,0
55548,443,42567,443,allow,12205,2036,10169,33,138,18,15
58638,5900,0,0,deny,62,62,0,1,0,1,0
51986,445,0,0,drop,66,66,0,1,0,1,0
34553,48637,0,0,deny,60,60,0,1,0,1,0
49277,80,11702,80,allow,13670,11470,2200,39,231,20,19
60336,5222,43827,5222,allow,32653,15160,17493,307,506,160,147
5223,21557,0,0,deny,91,91,0,1,0,1,0
65244,53,54645,53,allow,177,94,83,2,30,1,1
56221,53,31091,53,allow,177,94,83,2,29,1,1
55644,53,49999,53,allow,184,94,90,2,30,1,1
3169,22114,0,0,deny,66,66,0,1,0,1,0
63983,445,0,0,drop,70,70,0,1,0,1,0
45316,80,11125,80,allow,3044854,64416,2980438,2968,19,997,1971
64037,445,0,0,drop,66,66,0,1,0,1,0
63204,445,0,0,drop,70,70,0,1,0,1,0
53022,25174,0,0,deny,66,66,0,1,0,1,0
61422,443,38584,443,allow,8360,1781,6579,23,77,12,11
54420,445,0,0,drop,66,66,0,1,0,1,0
59845,44847,0,0,deny,66,66,0,1,0,1,0
57470,22796,55699,22796,allow,2224,1852,372,33,1565,27,6
15899,37807,0,0,deny,62,62,0,1,0,1,0
53111,445,0,0,drop,66,66,0,1,0,1,0
50782,445,0,0,drop,66,66,0,1,0,1,0
64394,443,20424,443,allow,3182,1568,1614,8,120,4,4
24208,53,24208,53,allow,231,88,143,2,32,1,1
34490,443,47026,443,allow,584,370,214,9,26,6,3
58666,53,17306,53,allow,167,78,89,2,29,1,1
10072,25174,0,0,deny,62,62,0,1,0,1,0
56948,445,0,0,drop,66,66,0,1,0,1,0
47886,80,46758,80,allow,1767,751,1016,10,15,6,4
40403,53,40667,53,allow,199,94,105,2,30,1,1
61614,445,0,0,drop,70,70,0,1,0,1,0
54713,445,0,0,drop,70,70,0,1,0,1,0
64011,445,0,0,drop,70,70,0,1,0,1,0
55141,53,48144,53,allow,744,89,655,2,30,1,1
57177,53,20677,53,allow,179,94,85,2,29,1,1
56134,53,19695,53,allow,167,86,81,2,30,1,1
27005,32038,39933,32038,allow,868,126,742,2,30,1,1
54343,443,5667,443,allow,7990,2701,5289,30,61,17,13
32299,40014,29367,40014,allow,280,182,98,2,30,1,1
55770,53,28096,53,allow,167,86,81,2,29,1,1
49550,445,0,0,drop,70,70,0,1,0,1,0
55766,36237,0,0,deny,62,62,0,1,0,1,0
49858,443,16431,443,allow,2027955,75406,1952549,2104,60,564,1540
49715,443,43667,443,allow,4418,789,3629,13,54,6,7
44815,443,9189,443,allow,7570,1955,5615,24,1179,12,12
64833,53,41021,53,allow,167,86,81,2,31,1,1
65218,53,25461,53,allow,833,290,543,8,88,4,4
56005,64147,0,0,deny,62,62,0,1,0,1,0
40356,9192,0,0,deny,145,145,0,1,0,1,0
65462,53,17722,53,allow,102,102,0,1,30,1,0
65420,53,11720,53,allow,166,86,80,2,30,1,1
50217,445,0,0,drop,70,70,0,1,0,1,0
33281,53,7345,53,allow,86,86,0,1,30,1,0
62157,445,0,0,drop,70,70,0,1,0,1,0
54206,25174,0,0,deny,62,62,0,1,0,1,0
53835,62413,0,0,deny,62,62,0,1,0,1,0
65140,53,64543,53,allow,198,101,97,2,30,1,1
35041,80,18613,80,allow,3515,1137,2378,12,30,7,5
64763,53,53321,53,allow,214,110,104,2,30,1,1
59663,37965,0,0,deny,62,62,0,1,0,1,0
53995,25174,0,0,deny,66,66,0,1,0,1,0
64517,53,18639,53,allow,194,102,92,2,31,1,1
60004,443,3185,443,allow,134,60,74,3,4,2,1
56653,22114,0,0,deny,66,66,0,1,0,1,0
49460,53,64925,53,allow,458,188,270,6,30,3,3
55130,25174,0,0,deny,66,66,0,1,0,1,0
49418,27015,38880,27015,allow,78,78,0,1,30,1,0
49923,80,28185,80,allow,1126,609,517,11,15,6,5
64331,53,12876,53,allow,174,89,85,2,31,1,1
58213,37807,0,0,deny,66,66,0,1,0,1,0
65165,445,0,0,drop,66,66,0,1,0,1,0
46410,443,3591,443,allow,4568,2057,2511,17,62,9,8
57334,53,19722,53,allow,210,110,100,2,30,1,1
56563,53,53188,53,allow,292,126,166,2,30,1,1
56792,445,0,0,drop,70,70,0,1,0,1,0
49317,53,28300,53,allow,194,102,92,2,29,1,1
64161,53,62669,53,allow,261,102,159,2,30,1,1
61761,44847,0,0,deny,66,66,0,1,0,1,0
56919,443,47014,443,allow,54568,32686,21882,69,161,40,29
54854,19847,0,0,deny,66,66,0,1,0,1,0
37991,443,14336,443,allow,8365,3018,5347,31,271,15,16
10914,35974,0,0,deny,60,60,0,1,0,1,0
57010,53,46777,53,allow,199,102,97,2,30,1,1
57470,34617,39417,34617,allow,481,150,331,2,1199,1,1
56312,53,62526,53,allow,195,102,93,2,30,1,1
50126,443,34426,443,allow,15032,5689,9343,51,35,27,24
56392,445,0,0,drop,66,66,0,1,0,1,0
57340,53,3053,53,allow,747,92,655,2,31,1,1
30181,61689,0,0,deny,62,62,0,1,0,1,0
63554,44847,0,0,deny,66,66,0,1,0,1,0
51831,445,0,0,drop,66,66,0,1,0,1,0
60734,445,0,0,drop,70,70,0,1,0,1,0
53583,15354,45877,15354,allow,70,70,0,1,4,1,0
65219,53,25255,53,allow,229,102,127,2,29,1,1
56831,445,0,0,drop,70,70,0,1,0,1,0
33941,37807,0,0,deny,146,146,0,1,0,1,0
5195,64147,0,0,deny,66,66,0,1,0,1,0
61550,5529,0,0,deny,145,145,0,1,0,1,0
57910,80,25307,80,allow,6453,1210,5243,14,24,8,6
27005,33058,40872,33058,allow,884,126,758,2,31,1,1
58936,445,0,0,drop,66,66,0,1,0,1,0
57988,445,0,0,drop,66,66,0,1,0,1,0
55912,53,61558,53,allow,184,94,90,2,30,1,1
60583,443,60583,443,allow,1315,786,529,12,36,7,5
56171,53,61869,53,allow,756,95,661,2,30,1,1
55232,53,34536,53,allow,177,94,83,2,29,1,1
61804,51505,0,0,deny,66,66,0,1,0,1,0
49395,445,0,0,drop,70,70,0,1,0,1,0
27005,32063,51455,32063,allow,889,126,763,3,31,2,1
33432,5900,0,0,deny,60,60,0,1,0,1,0
62586,445,0,0,drop,70,70,0,1,0,1,0
65265,53,37973,53,allow,821,102,719,2,30,1,1
55877,445,0,0,drop,66,66,0,1,0,1,0
58356,445,0,0,drop,66,66,0,1,0,1,0
53123,59228,59037,59228,allow,70,70,0,1,4,1,0
34281,52862,0,0,deny,145,145,0,1,0,1,0
52192,443,41129,443,allow,13948,1150,12798,29,15,14,15
56516,445,0,0,drop,70,70,0,1,0,1,0
64346,51505,0,0,deny,66,66,0,1,0,1,0
60786,51505,0,0,deny,66,66,0,1,0,1,0
60014,443,21323,443,allow,10021,3035,6986,30,46,17,13
1574,50584,0,0,deny,62,62,0,1,0,1,0
3667,56205,0,0,deny,62,62,0,1,0,1,0
50052,65008,0,0,deny,60,60,0,1,0,1,0
58287,445,0,0,drop,70,70,0,1,0,1,0
59514,445,0,0,drop,66,66,0,1,0,1,0
56026,53,37730,53,allow,181,94,87,2,31,1,1
62103,445,0,0,drop,70,70,0,1,0,1,0
58890,445,0,0,drop,66,66,0,1,0,1,0
59449,445,0,0,drop,70,70,0,1,0,1,0
55008,53,19602,53,allow,215,102,113,2,30,1,1
58638,5900,0,0,deny,62,62,0,1,0,1,0
65279,53,56734,53,allow,182,93,89,2,31,1,1
50126,23117,0,0,deny,66,66,0,1,0,1,0
63964,445,0,0,drop,70,70,0,1,0,1,0
63582,445,0,0,drop,70,70,0,1,0,1,0
56816,11392,0,0,deny,66,66,0,1,0,1,0
57400,443,4312,443,allow,10169,1957,8212,26,136,11,15
63062,445,0,0,drop,70,70,0,1,0,1,0
56676,443,53618,443,allow,7889,1900,5989,20,15,11,9
56987,443,32142,443,allow,3800,1324,2476,14,136,7,7
56889,53,49457,53,allow,211,110,101,2,30,1,1
65425,53,4149,53,allow,402,142,260,2,30,1,1
8194,21247,0,0,deny,62,62,0,1,0,1,0
38264,443,28661,443,allow,134,60,74,3,4,2,1
14417,443,14417,443,allow,15556,2973,12583,41,80,22,19
44855,58414,0,0,deny,62,62,0,1,0,1,0
41575,443,49577,443,allow,24256,1841,22415,41,131,18,23
54157,445,0,0,drop,70,70,0,1,0,1,0
51778,60565,33068,60565,allow,70,70,0,1,5,1,0
0,0,0,0,allow,480,244,236,4,0,2,2
65477,53,48091,53,allow,183,94,89,2,30,1,1
51863,22038,12301,22038,allow,70,70,0,1,5,1,0
58901,443,21819,443,allow,5168,700,4468,16,15,7,9
53006,80,12227,80,allow,1988,742,1246,10,334,6,4
56709,53,55050,53,allow,211,102,109,2,30,1,1
50052,65008,0,0,deny,60,60,0,1,0,1,0
64887,445,0,0,drop,66,66,0,1,0,1,0
65496,53,16227,53,allow,194,102,92,2,29,1,1
51705,22114,0,0,deny,66,66,0,1,0,1,0
35163,30188,0,0,deny,66,66,0,1,0,1,0
62797,445,0,0,drop,70,70,0,1,0,1,0
50938,443,19392,443,allow,37198,29093,8105,64,17,34,30
50200,53,14002,53,allow,758,102,656,2,30,1,1
7844,22114,0,0,deny,66,66,0,1,0,1,0
56343,53,54537,53,allow,177,94,83,2,30,1,1
24062,51505,0,0,deny,146,146,0,1,0,1,0
64583,53,3855,53,allow,179,94,85,2,29,1,1
27005,4444,11098,4444,allow,881,126,755,2,30,1,1
49609,53,44822,53,allow,754,94,660,2,30,1,1
63323,54369,0,0,deny,78,78,0,1,0,1,0
0,0,0,0,deny,60,60,0,1,0,1,0
57396,53,20662,53,allow,807,94,713,2,30,1,1
53690,42301,12821,42301,allow,1821,1088,733,17,15,9,8
54965,445,0,0,drop,66,66,0,1,0,1,0
59834,80,63639,80,allow,943291,17238,926053,869,72,249,620
55325,53,50233,53,allow,210,110,100,2,30,1,1
55618,53,36676,53,allow,199,94,105,2,30,1,1
56198,53,50578,53,allow,184,102,82,2,30,1,1
51951,443,35308,443,allow,3854,1151,2703,20,135,10,10
38860,443,38860,443,allow,15584,2721,12863,44,103,21,23
53911,443,57422,443,allow,1346,918,428,10,33,6,4
35058,23,0,0,deny,60,60,0,1,0,1,0
41167,443,51918,443,allow,8869,1938,6931,21,17,12,9
37780,443,20085,443,allow,1403708,31893,1371815,1301,162,292,1009
57309,53,4070,53,allow,197,102,95,2,30,1,1
64268,53,45536,53,allow,334,103,231,4,54,2,2
17750,6881,6103,6881,allow,149,149,0,1,1200,1,0
45908,33330,0,0,deny,60,60,0,1,0,1,0
49805,6881,0,0,deny,66,66,0,1,0,1,0
59669,80,64457,80,allow,2026957,42480,1984477,1975,80,655,1320
56100,53,56100,53,allow,265,111,154,2,30,1,1
14183,26467,0,0,deny,62,62,0,1,0,1,0
47140,443,13289,443,allow,7669,3355,4314,33,38,19,14
42798,26467,0,0,deny,62,62,0,1,0,1,0
55498,53,62567,53,allow,177,94,83,2,30,1,1
49823,53,25346,53,allow,502,103,399,4,51,2,2
6037,43890,0,0,deny,70,70,0,1,0,1,0
62105,445,0,0,drop,70,70,0,1,0,1,0
50584,54321,2526,54321,allow,1275,300,975,6,1200,3,3
58914,445,0,0,drop,70,70,0,1,0,1,0
13911,57470,0,0,deny,60,60,0,1,0,1,0
65213,53,57292,53,allow,198,94,104,2,30,1,1
60901,443,60901,443,allow,24367,4634,19733,52,49,26,26
55732,53,41995,53,allow,177,94,83,2,29,1,1
10151,55149,20876,55149,allow,481,150,331,2,1200,1,1
54319,53,54319,53,allow,253,99,154,2,32,1,1
5588,5588,0,0,allow,3562,1936,1626,48,195,24,24
50022,53,39220,53,allow,174,89,85,2,30,1,1
30188,14432,60719,14432,allow,868,150,718,4,1200,2,2
54989,443,11421,443,allow,34038,16039,17999,79,63,43,36
64653,53,13693,53,allow,241,94,147,2,30,1,1
47694,443,24366,443,allow,23751,3197,20554,42,170,19,23
55036,53,3360,53,allow,177,94,83,2,30,1,1
50422,50584,0,0,deny,62,62,0,1,0,1,0
57702,53,57702,53,allow,398,255,143,3,32,2,1
44847,9912,37796,9912,allow,502,150,352,2,1200,1,1
54511,53,42780,53,allow,304,86,218,2,30,1,1
50265,49893,64996,49893,allow,480,149,331,2,1200,1,1
35353,443,50088,443,allow,1864,250,1614,8,120,4,4
63929,48477,13540,48477,allow,70,70,0,1,5,1,0
14036,48817,0,0,deny,66,66,0,1,0,1,0
50740,445,0,0,drop,66,66,0,1,0,1,0
64992,53,56297,53,allow,177,94,83,2,30,1,1
42429,22114,0,0,deny,62,62,0,1,0,1,0
65184,27126,4649,27126,allow,268,78,190,2,29,1,1
54648,443,56134,443,allow,9215,3253,5962,51,22,25,26
51241,443,60698,443,allow,8083,2502,5581,40,16,22,18
59728,5900,0,0,deny,60,60,0,1,0,1,0
15113,25174,0,0,deny,62,62,0,1,0,1,0
64469,53,32950,53,allow,342,97,245,4,42,2,2
49270,53,41673,53,allow,735,88,647,2,30,1,1
55271,53,16538,53,allow,268,102,166,2,30,1,1
65081,26467,0,0,deny,66,66,0,1,0,1,0
123,123,49338,123,allow,184,94,90,2,30,1,1
45973,80,60960,80,allow,1114,534,580,12,16,7,5
52830,22114,0,0,deny,146,146,0,1,0,1,0
56986,53,63697,53,allow,177,94,83,2,30,1,1
58453,50584,0,0,deny,66,66,0,1,0,1,0
55349,445,0,0,drop,66,66,0,1,0,1,0
51880,8000,24485,8000,allow,582,270,312,8,32,4,4
50988,443,14910,443,allow,6938,2686,4252,25,27,12,13
34539,80,34539,80,allow,22098,1602,20496,24,57,6,18
65208,53,46888,53,allow,637,178,459,6,70,3,3
20682,57470,0,0,deny,62,62,0,1,0,1,0
64347,53,53125,53,allow,193,102,91,2,29,1,1
49712,443,1489,443,allow,11365,1278,10087,23,131,10,13
57043,445,0,0,drop,70,70,0,1,0,1,0
55655,445,0,0,drop,70,70,0,1,0,1,0
49972,53,23300,53,allow,184,94,90,2,30,1,1
60372,445,0,0,drop,70,70,0,1,0,1,0
59638,445,0,0,drop,70,70,0,1,0,1,0
61635,37965,0,0,deny,66,66,0,1,0,1,0
61076,445,0,0,drop,70,70,0,1,0,1,0
41813,8080,0,0,deny,60,60,0,1,0,1,0
55966,57866,0,0,deny,62,62,0,1,0,1,0
64646,445,0,0,drop,70,70,0,1,0,1,0
53161,51221,0,0,deny,66,66,0,1,0,1,0
50998,445,0,0,drop,70,70,0,1,0,1,0
57470,46487,30671,46487,allow,527,166,361,2,1200,1,1
27005,27054,8800,27054,allow,921,126,795,2,31,1,1
59220,445,0,0,drop,70,70,0,1,0,1,0
60097,22114,0,0,deny,62,62,0,1,0,1,0
55712,53,64759,53,allow,164,86,78,2,30,1,1
55817,36829,0,0,deny,66,66,0,1,0,1,0
52147,445,0,0,drop,70,70,0,1,0,1,0
53730,37096,48081,37096,allow,70,70,0,1,4,1,0
3478,61463,0,0,deny,901,901,0,1,0,1,0
57013,53,50114,53,allow,178,94,84,2,29,1,1
58008,80,56721,80,allow,2549,1595,954,21,75,11,10
56619,443,13998,443,allow,6895,2273,4622,21,17,12,9
56703,53,19999,53,allow,199,102,97,2,30,1,1
64012,40642,36772,40642,allow,66,66,0,2,8,2,0
60864,5223,16379,5223,allow,194,134,60,2,5,1,1
60677,445,0,0,drop,66,66,0,1,0,1,0
62893,993,15179,993,allow,8883,4621,4262,76,191,47,29
56909,443,38825,443,allow,31860,21778,10082,84,190,42,42
65246,53,4675,53,allow,182,93,89,2,31,1,1
55246,445,0,0,drop,66,66,0,1,0,1,0
65136,445,0,0,drop,66,66,0,1,0,1,0
63813,445,0,0,drop,70,70,0,1,0,1,0
53886,445,0,0,drop,70,70,0,1,0,1,0
22924,25174,0,0,deny,62,62,0,1,0,1,0
43225,443,17321,443,allow,3831584,85342,3746242,3246,110,597,2649
52460,445,0,0,drop,70,70,0,1,0,1,0
52282,37965,0,0,deny,66,66,0,1,0,1,0
55776,53,52683,53,allow,216,110,106,2,30,1,1
50389,443,61820,443,allow,306,180,126,6,26,4,2
45549,443,52830,443,allow,7951,1449,6502,22,125,12,10
52587,443,5455,443,allow,6170,918,5252,18,15,10,8
50644,80,26132,80,allow,314,192,122,6,25,4,2
16037,25174,0,0,deny,146,146,0,1,0,1,0
59942,80,31955,80,allow,2241,1549,692,9,15,5,4
57397,53,25863,53,allow,182,93,89,2,31,1,1
64837,53,3342,53,allow,190,97,93,2,31,1,1
63030,25174,0,0,deny,146,146,0,1,0,1,0
49936,53,59450,53,allow,216,110,106,2,31,1,1
18745,64147,0,0,deny,66,66,0,1,0,1,0
53716,443,47571,443,allow,499,425,74,4,0,3,1
39617,50584,0,0,deny,146,146,0,1,0,1,0
49195,8108,11315,8108,allow,70,70,0,2,8,2,0
57499,80,58855,80,allow,30979,1798,29181,46,14,23,23
58900,37807,0,0,deny,62,62,0,1,0,1,0
26758,50584,0,0,deny,62,62,0,1,0,1,0
51909,6881,0,0,deny,66,66,0,1,0,1,0
52470,14037,0,0,deny,66,66,0,1,0,1,0
58020,445,0,0,drop,70,70,0,1,0,1,0
50066,443,28197,443,allow,7144,2505,4639,14,120,7,7
50021,53,13540,53,allow,821,102,719,2,30,1,1
41283,53,41283,53,allow,247,98,149,2,31,1,1
34360,80,12302,80,allow,494,280,214,8,14,5,3
51502,80,42285,80,allow,1515,481,1034,11,15,6,5
63472,445,0,0,drop,66,66,0,1,0,1,0
56311,445,0,0,drop,70,70,0,1,0,1,0
60147,25198,0,0,deny,148,148,0,1,0,1,0
60014,443,60627,443,allow,4275,1488,2787,17,143,9,8
58054,445,0,0,drop,70,70,0,1,0,1,0
35753,80,35753,80,allow,158890,11318,147572,182,30,74,108
5757,80,5757,80,allow,104444,4047,100397,122,126,52,70
60989,443,62484,443,allow,3182,1568,1614,8,120,4,4
26763,443,27928,443,allow,7343,2586,4757,23,20,11,12
53756,445,0,0,drop,66,66,0,1,0,1,0
54945,445,0,0,drop,70,70,0,1,0,1,0
50969,443,54163,443,allow,469,403,66,4,0,3,1
58638,5900,0,0,deny,62,62,0,1,0,1,0
49447,53,53080,53,allow,168,78,90,2,30,1,1
65366,53,65366,53,allow,244,98,146,2,33,1,1
55956,53,7528,53,allow,200,94,106,2,30,1,1
55627,53,20054,53,allow,174,89,85,2,31,1,1
63457,445,0,0,drop,66,66,0,1,0,1,0
50972,3544,54977,3544,allow,409,107,302,4,29,2,2
45103,80,17939,80,allow,1748,716,1032,19,409,6,13
61689,445,0,0,drop,70,70,0,1,0,1,0
55605,53,8091,53,allow,190,97,93,2,31,1,1
64808,62413,0,0,deny,62,62,0,1,0,1,0
61642,445,0,0,drop,70,70,0,1,0,1,0
56744,443,27482,443,allow,8008,1988,6020,20,15,11,9
52875,443,25381,443,allow,89335,4699,84636,107,118,32,75
64180,445,0,0,drop,70,70,0,1,0,1,0
64969,27044,17492,27044,allow,741,462,279,2,30,1,1
55420,445,0,0,drop,66,66,0,1,0,1,0
64154,53,35293,53,allow,194,102,92,2,29,1,1
64469,445,0,0,drop,70,70,0,1,0,1,0
47105,64147,0,0,deny,62,62,0,1,0,1,0
55778,53,1773,53,allow,94,94,0,1,30,1,0
33822,57470,0,0,deny,66,66,0,1,0,1,0
55532,445,0,0,drop,70,70,0,1,0,1,0
59830,443,59830,443,allow,21205,1711,19494,32,1806,11,21
57583,443,57583,443,allow,2512,1466,1046,21,87,10,11
58879,445,0,0,drop,70,70,0,1,0,1,0
10075,53,26138,53,allow,229,86,143,2,30,1,1
61235,445,0,0,drop,66,66,0,1,0,1,0
51353,445,0,0,drop,70,70,0,1,0,1,0
30797,23,0,0,deny,60,60,0,1,0,1,0
60413,445,0,0,drop,70,70,0,1,0,1,0
33409,53,6047,53,allow,241272,234761,6511,2872,89,2833,39
51966,443,65076,443,allow,9249,4498,4751,39,15,22,17
46695,443,28304,443,allow,12787534,288179,12499355,12299,64,4036,8263
50279,443,22072,443,allow,21204,10998,10206,51,392,27,24
3456,11392,0,0,deny,62,62,0,1,0,1,0
37213,36237,0,0,deny,66,66,0,1,0,1,0
56970,443,7987,443,allow,6815,3817,2998,23,143,11,12
56911,53,21649,53,allow,170,87,83,2,30,1,1
52145,36670,58227,36670,allow,316,136,180,6,6,3,3
24608,53,24608,53,allow,209,77,132,2,33,1,1
52332,443,60314,443,allow,15746,4302,11444,17,122,5,12
58993,445,0,0,drop,70,70,0,1,0,1,0
56423,53,58524,53,allow,168,86,82,2,30,1,1
61616,445,0,0,drop,70,70,0,1,0,1,0
49787,53,35169,53,allow,193,102,91,2,30,1,1
56524,53,60434,53,allow,182,102,80,2,31,1,1
54126,443,11328,443,allow,147104,9481,137623,217,115,111,106
53766,445,0,0,drop,70,70,0,1,0,1,0
51264,445,0,0,drop,70,70,0,1,0,1,0
56698,443,19362,443,allow,106055,8460,97595,168,26,79,89
42158,443,61169,443,allow,6865,3366,3499,39,206,15,24
63002,22114,0,0,deny,66,66,0,1,0,1,0
51982,80,47547,80,allow,14487990,289826,14198164,13259,54,3839,9420
45908,33330,0,0,deny,60,60,0,1,0,1,0
34531,23117,0,0,deny,62,62,0,1,0,1,0
55043,443,34590,443,allow,37068,4085,32983,66,48,33,33
11030,17372,0,0,deny,62,62,0,1,0,1,0
60425,60425,17270,60425,allow,1728,1031,697,14,17,8,6
59429,445,0,0,drop,66,66,0,1,0,1,0
64489,53,3033,53,allow,320,97,223,4,50,2,2
49300,5228,46650,5228,allow,12589,6479,6110,172,4146,86,86
37601,443,50258,443,allow,573,425,148,5,0,3,2
55113,53,41095,53,allow,198,102,96,2,29,1,1
53890,23310,52916,23310,allow,70,70,0,2,8,2,0
61722,445,0,0,drop,70,70,0,1,0,1,0
49842,443,3993,443,allow,6212,1823,4389,16,75,9,7
56936,80,5916,80,allow,1490,886,604,10,75,6,4
40781,443,27911,443,allow,362,302,60,2,5,1,1
49334,53,14859,53,allow,184,94,90,2,30,1,1
49201,443,23062,443,allow,13738,6378,7360,70,981,33,37
49383,53,44225,53,allow,94,94,0,1,30,1,0
55727,43736,4643,43736,allow,70,70,0,2,8,2,0
46236,53,38054,53,allow,199,94,105,2,30,1,1
55579,53,14828,53,allow,172,88,84,2,30,1,1
53557,445,0,0,drop,70,70,0,1,0,1,0
28156,50584,0,0,deny,62,62,0,1,0,1,0
64789,445,0,0,drop,66,66,0,1,0,1,0
56764,45797,41990,45797,allow,164,70,94,2,5,1,1
45294,443,12924,443,allow,6290,4832,1458,18,120,11,7
58638,5900,0,0,deny,62,62,0,1,0,1,0
43611,32480,0,0,deny,109,109,0,1,0,1,0
63951,53,30484,53,allow,193,102,91,2,30,1,1
19594,23117,0,0,deny,62,62,0,1,0,1,0
57204,53,65520,53,allow,195,102,93,2,30,1,1
53664,445,0,0,drop,70,70,0,1,0,1,0
34914,26467,0,0,deny,62,62,0,1,0,1,0
27005,27016,47379,27016,allow,882,126,756,2,30,1,1
53563,35440,0,0,deny,62,62,0,1,0,1,0
59747,443,7939,443,allow,304,86,218,2,29,1,1
53986,54070,21018,54070,allow,70,70,0,2,7,2,0
49418,27015,47175,27015,allow,234,78,156,2,30,1,1
65101,53,61768,53,allow,402,118,284,2,30,1,1
55288,53,4599,53,allow,196,102,94,2,30,1,1
65042,53,26467,53,allow,183,94,89,2,29,1,1
60870,53,30144,53,allow,220,94,126,2,30,1,1
56731,443,8891,443,allow,7828,2313,5515,31,64,17,14
63079,64147,0,0,deny,66,66,0,1,0,1,0
30960,45694,42221,45694,allow,330,330,0,6,3610,6,0
58167,445,0,0,drop,70,70,0,1,0,1,0
58034,443,56445,443,allow,4132,2158,1974,35,255,17,18
46555,53,62486,53,allow,168,78,90,2,30,1,1
50016,53,35137,53,allow,275,94,181,2,29,1,1
18632,51505,0,0,deny,66,66,0,1,0,1,0
53570,24874,32383,24874,allow,70,70,0,2,7,2,0
56770,26467,0,0,deny,62,62,0,1,0,1,0
42190,53,42190,53,allow,639,86,553,2,31,1,1
52213,80,42925,80,allow,5022,1422,3600,16,135,8,8
1511,3389,0,0,deny,60,60,0,1,0,1,0
65268,445,0,0,drop,70,70,0,1,0,1,0
50922,443,21315,443,allow,6180,1241,4939,18,982,8,10
65487,53,64939,53,allow,184,94,90,2,31,1,1
64338,443,59182,443,allow,1786,172,1614,7,120,3,4
40363,80,1315,80,allow,3566,1637,1929,18,81,11,7
22904,56205,0,0,deny,62,62,0,1,0,1,0
35450,23,0,0,deny,60,60,0,1,0,1,0
44949,53,44949,53,allow,198,90,108,2,30,1,1
50398,445,0,0,drop,66,66,0,1,0,1,0
39393,22114,0,0,deny,62,62,0,1,0,1,0
55454,53,16777,53,allow,168,78,90,2,30,1,1
27988,40002,6353,40002,allow,140,78,62,2,30,1,1
26900,27017,16696,27017,allow,168,82,86,2,30,1,1
61699,443,44016,443,allow,16358,3103,13255,39,19,19,20
59776,443,24367,443,allow,966,480,486,17,29,9,8
53866,8999,60577,8999,allow,372,186,186,6,15,3,3
49198,445,0,0,drop,66,66,0,1,0,1,0
52154,4635,6285,4635,allow,66,66,0,1,5,1,0
6889,45129,0,0,deny,159,159,0,1,0,1,0
38698,443,50432,443,allow,90261,3545,86716,96,16,32,64
59954,445,0,0,drop,70,70,0,1,0,1,0
9098,443,52183,443,allow,6177,969,5208,17,26,9,8
57470,49160,27757,49160,allow,402,132,270,6,1209,3,3
62549,64147,0,0,deny,62,62,0,1,0,1,0
54610,443,15531,443,allow,19810,7047,12763,54,438,28,26
57315,443,25232,443,allow,134,60,74,3,5,2,1
50326,46824,0,0,deny,66,66,0,1,0,1,0
57470,31566,19027,31566,allow,481,150,331,2,1199,1,1
58997,445,0,0,drop,70,70,0,1,0,1,0
46186,443,59452,443,allow,10103,3482,6621,59,16,29,30
49809,445,0,0,drop,70,70,0,1,0,1,0
62590,7000,62590,7000,allow,2163,676,1487,14,15,7,7
62050,445,0,0,drop,66,66,0,1,0,1,0
34470,57470,0,0,deny,66,66,0,1,0,1,0
9504,25174,0,0,deny,146,146,0,1,0,1,0
41614,5222,29157,5222,allow,768,510,258,9,21,5,4
61242,35253,0,0,deny,66,66,0,1,0,1,0
65403,53,49597,53,allow,359,94,265,2,30,1,1
61697,443,10867,443,allow,9963,2631,7332,37,48,20,17
49661,53,62903,53,allow,344,102,242,2,30,1,1
57633,50584,0,0,deny,146,146,0,1,0,1,0
61479,445,0,0,drop,70,70,0,1,0,1,0
53536,34200,55904,34200,allow,70,70,0,2,7,2,0
54109,36829,0,0,deny,66,66,0,1,0,1,0
53027,445,0,0,drop,70,70,0,1,0,1,0
46369,443,62410,443,allow,12157,3583,8574,81,480,34,47
2077,45850,0,0,reset-both,145,145,0,1,0,1,0
35120,26467,0,0,deny,62,62,0,1,0,1,0
63403,443,54530,443,allow,4470,1597,2873,16,138,8,8
9311,443,26204,443,allow,4082,958,3124,14,26,8,6
55045,443,26442,443,allow,5541,2778,2763,24,15,14,10
52142,443,7937,443,allow,9911,2041,7870,34,120,17,17
54202,53,3615,53,allow,578,286,292,9,16,5,4
55544,445,0,0,drop,70,70,0,1,0,1,0
60089,53,50988,53,allow,297,83,214,2,30,1,1
57661,445,0,0,drop,70,70,0,1,0,1,0
58638,5900,58638,5900,allow,126,62,64,2,5,1,1
49776,53,15280,53,allow,289,92,197,4,31,2,2
6881,55839,0,0,deny,139,139,0,1,0,1,0
60766,28080,32813,28080,allow,70,70,0,1,5,1,0
50106,53,26028,53,allow,209,110,99,2,30,1,1
41996,5900,0,0,deny,60,60,0,1,0,1,0
56742,53,0,0,allow,82,82,0,2,40,2,0
60287,80,62692,80,allow,1052,612,440,10,15,5,5
53625,53,53625,53,allow,643,88,555,2,31,1,1
57989,445,0,0,drop,66,66,0,1,0,1,0
6881,6889,24381,6889,allow,228,118,110,2,1199,1,1
58638,5900,0,0,deny,62,62,0,1,0,1,0
55261,53,40486,53,allow,716,95,621,2,31,1,1
56883,445,0,0,drop,66,66,0,1,0,1,0
50319,53,7677,53,allow,814,110,704,2,30,1,1
55912,53,46949,53,allow,184,94,90,2,30,1,1
35608,443,62915,443,allow,5776,1880,3896,19,272,11,8
53693,445,0,0,drop,70,70,0,1,0,1,0
1024,21247,0,0,deny,62,62,0,1,0,1,0
52733,445,0,0,drop,70,70,0,1,0,1,0
65382,53,48645,53,allow,301,108,193,4,55,2,2
55771,53,22517,53,allow,819,102,717,2,30,1,1
59606,445,0,0,drop,70,70,0,1,0,1,0
55081,53,2837,53,allow,711,87,624,2,31,1,1
64900,53,36772,53,allow,314,102,212,2,29,1,1
55945,445,0,0,drop,70,70,0,1,0,1,0
55325,53,64305,53,allow,711,87,624,2,31,1,1
56561,53,4933,53,allow,167,86,81,2,30,1,1
64622,36829,0,0,deny,66,66,0,1,0,1,0
55995,443,59419,443,allow,7563,2253,5310,20,157,11,9
65155,53,8256,53,allow,295,103,192,4,48,2,2
5859,11392,0,0,deny,66,66,0,1,0,1,0
55515,445,0,0,drop,70,70,0,1,0,1,0
56798,445,0,0,drop,66,66,0,1,0,1,0
54101,80,21675,80,allow,78,78,0,1,5,1,0
38863,443,38863,443,allow,36313,5931,30382,72,108,36,36
49905,443,37995,443,allow,798502,33164,765338,927,103,379,548
50590,53,53774,53,allow,889,404,485,10,30,5,5
51996,35440,0,0,deny,66,66,0,1,0,1,0
54306,443,20116,443,allow,13053,5216,7837,25,135,11,14
34717,53,24183,53,allow,168,78,90,2,31,1,1
37965,16253,55858,16253,allow,5892,3784,2108,81,3115,47,34
55638,53,1033,53,allow,78,78,0,1,30,1,0
57853,64147,0,0,deny,66,66,0,1,0,1,0
55859,445,0,0,drop,66,66,0,1,0,1,0
60479,25174,0,0,deny,66,66,0,1,0,1,0
50584,51413,16088,51413,allow,475,150,325,2,1200,1,1
63728,445,0,0,drop,70,70,0,1,0,1,0
34154,443,26354,443,allow,45554,1695,43859,50,30,15,35
52407,445,0,0,drop,66,66,0,1,0,1,0
61403,445,0,0,drop,66,66,0,1,0,1,0
62286,445,0,0,drop,66,66,0,1,0,1,0
1749,64147,0,0,deny,66,66,0,1,0,1,0
62876,445,0,0,drop,66,66,0,1,0,1,0
49211,53,35833,53,allow,484,100,384,4,56,2,2
51767,80,59527,80,allow,2169,1263,906,13,75,8,5
13285,29892,0,0,deny,145,145,0,1,0,1,0
20133,2767,0,0,deny,62,62,0,1,0,1,0
50432,80,29144,80,allow,318,192,126,6,27,4,2
62747,445,0,0,drop,70,70,0,1,0,1,0
39978,443,47110,443,allow,8030,7064,966,22,30,13,9
56405,53,42424,53,allow,226,102,124,2,30,1,1
52231,50934,0,0,deny,62,62,0,1,0,1,0
50310,80,55858,80,allow,7979,802,7177,17,57,8,9
14070,62413,0,0,deny,62,62,0,1,0,1,0
55726,27015,8012,27015,allow,628,462,166,4,31,2,2
50265,38978,6940,38978,allow,481,150,331,2,1200,1,1
65530,53,2612,53,allow,102,102,0,1,30,1,0
51960,445,0,0,drop,66,66,0,1,0,1,0
37562,443,51859,443,allow,13836,6371,7465,34,23,20,14
46808,25174,0,0,deny,146,146,0,1,0,1,0
39473,443,53063,443,allow,9590,3811,5779,20,122,10,10
52920,443,54361,443,allow,31161,4934,26227,73,115,32,41
22409,55442,0,0,deny,74,74,0,1,0,1,0
50054,445,0,0,drop,70,70,0,1,0,1,0
56470,28678,7618,28678,allow,1806,1806,0,22,224,22,0
55847,443,25138,443,allow,8443,1430,7013,17,141,8,9
63999,10552,13138,10552,allow,66,66,0,2,8,2,0
62523,445,0,0,drop,70,70,0,1,0,1,0
55665,53,45679,53,allow,229,94,135,2,30,1,1
52027,443,40345,443,allow,8698,1393,7305,22,16,12,10
58923,443,63838,443,allow,5167,700,4467,16,14,7,9
50504,443,47105,443,allow,5476,1073,4403,22,78,12,10
50511,445,0,0,drop,66,66,0,1,0,1,0
55907,53,31154,53,allow,184,94,90,2,29,1,1
60196,53,0,0,deny,88,88,0,1,0,1,0
49858,445,0,0,drop,70,70,0,1,0,1,0
49950,445,0,0,drop,70,70,0,1,0,1,0
49841,80,51896,80,allow,3126,469,2657,9,75,5,4
49317,53,48476,53,allow,166,86,80,2,30,1,1
52171,443,52171,443,allow,154883,8710,146173,182,23,69,113
49750,80,55648,80,allow,1788,628,1160,11,15,6,5
56273,53,30021,53,allow,200,102,98,2,30,1,1
55646,445,0,0,drop,70,70,0,1,0,1,0
55820,53,49464,53,allow,184,94,90,2,30,1,1
49318,53,58973,53,allow,718,94,624,2,30,1,1
61085,37965,0,0,deny,62,62,0,1,0,1,0
57988,445,0,0,drop,70,70,0,1,0,1,0
48372,8100,19668,8100,allow,234,234,0,4,11,4,0
55921,443,55921,443,allow,4510,1603,2907,19,27,11,8
49629,443,16590,443,allow,5600,1187,4413,24,80,13,11
57067,53,11799,53,allow,183,94,89,2,30,1,1
53770,443,15341,443,allow,499,425,74,4,0,3,1
58317,445,0,0,drop,70,70,0,1,0,1,0
47211,80,37416,80,allow,1638,1324,314,10,16,5,5
51221,63128,42268,63128,allow,480,149,331,2,1201,1,1
44921,443,18740,443,allow,5440,846,4594,15,15,9,6
37109,80,41807,80,allow,763,434,329,8,14,5,3
59879,55783,0,0,deny,62,62,0,1,0,1,0
36906,50584,0,0,deny,146,146,0,1,0,1,0
49202,80,38617,80,allow,3223,605,2618,13,15,7,6
51921,37744,59756,37744,allow,70,70,0,2,8,2,0
50584,25935,2865,25935,allow,1377,300,1077,6,1200,3,3
56937,8200,55532,8200,allow,78,78,0,1,30,1,0
57275,53,56267,53,allow,177,94,83,2,30,1,1
58638,5900,0,0,deny,62,62,0,1,0,1,0
6666,44818,0,0,deny,60,60,0,1,0,1,0
34809,57470,0,0,deny,66,66,0,1,0,1,0
54617,443,54617,443,allow,3186,1836,1350,16,17,10,6
60496,445,0,0,drop,70,70,0,1,0,1,0
62804,37965,0,0,deny,66,66,0,1,0,1,0
49749,443,9817,443,allow,438048,86860,351188,491,420,213,278
50913,445,0,0,drop,70,70,0,1,0,1,0
55568,445,0,0,drop,70,70,0,1,0,1,0
27046,51505,0,0,deny,66,66,0,1,0,1,0
13408,44847,0,0,deny,62,62,0,1,0,1,0
34073,37965,0,0,deny,62,62,0,1,0,1,0
65212,53,14498,53,allow,273,118,155,2,30,1,1
52459,5555,0,0,deny,60,60,0,1,0,1,0
56030,53,56239,53,allow,815,95,720,2,31,1,1
34424,443,13536,443,allow,8277,2394,5883,31,316,16,15
53761,445,0,0,drop,70,70,0,1,0,1,0
37575,443,28180,443,allow,499,425,74,4,0,3,1
49738,443,52506,443,allow,3085,1404,1681,15,15,7,8
18683,26467,0,0,deny,62,62,0,1,0,1,0
52663,443,53022,443,allow,4416,1702,2714,19,126,9,10
31469,23,0,0,deny,60,60,0,1,0,1,0
49514,39127,0,0,deny,162,162,0,1,0,1,0
60234,80,15861,80,allow,1131,772,359,10,151,6,4
49629,26467,0,0,deny,62,62,0,1,0,1,0
11136,57587,0,0,deny,62,62,0,1,0,1,0
34388,443,29047,443,allow,7002,1252,5750,28,258,15,13
44836,443,51394,443,allow,34881,6721,28160,62,46,30,32
65063,53,52560,53,allow,180,94,86,2,30,1,1
62838,44847,0,0,deny,66,66,0,1,0,1,0
50546,445,0,0,drop,66,66,0,1,0,1,0
64419,53,6330,53,allow,210,102,108,2,30,1,1
50755,80,50755,80,allow,450,246,204,8,25,5,3
13021,25174,0,0,deny,62,62,0,1,0,1,0
64820,53,3092,53,allow,195,102,93,2,30,1,1
44979,443,39259,443,allow,10311,2186,8125,26,186,14,12
49849,443,49569,443,allow,6117,976,5141,21,72,10,11
59705,445,0,0,drop,70,70,0,1,0,1,0
63928,53,2140,53,allow,376,126,250,2,30,1,1
63945,53,51432,53,allow,216,110,106,2,29,1,1
55294,53,48651,53,allow,295,101,194,4,30,2,2
56759,55201,4487,55201,allow,70,70,0,2,8,2,0
2946,53,2946,53,allow,240,96,144,2,30,1,1
55281,53,43570,53,allow,210,102,108,2,30,1,1
49896,53,58946,53,allow,772,102,670,2,30,1,1
57620,445,0,0,drop,66,66,0,1,0,1,0
58053,80,60672,80,allow,3751,3009,742,14,31,8,6
62361,445,0,0,drop,70,70,0,1,0,1,0
53744,10030,43880,10030,allow,320,140,180,6,5,3,3
64149,53,19971,53,allow,301,108,193,4,49,2,2
42106,443,29417,443,allow,5361,973,4388,18,15,10,8
59604,443,43036,443,allow,4507,1525,2982,24,147,13,11
59676,445,0,0,drop,70,70,0,1,0,1,0
49884,53,8513,53,allow,252,102,150,2,30,1,1
59788,443,42215,443,allow,162,102,60,2,5,1,1
58638,5900,0,0,deny,62,62,0,1,0,1,0
42479,80,8740,80,allow,696,413,283,7,15,5,2
35221,443,12640,443,allow,146299,21774,124525,246,141,98,148
57417,53,14881,53,allow,295,101,194,4,31,2,2
64979,53,4667,53,allow,194,102,92,2,31,1,1
15922,44847,0,0,deny,66,66,0,1,0,1,0
65056,53,26315,53,allow,199,102,97,2,29,1,1
57280,445,0,0,drop,66,66,0,1,0,1,0
50584,6881,41717,6881,allow,1357,369,988,6,1200,3,3
58638,5900,0,0,deny,62,62,0,1,0,1,0
49884,445,0,0,drop,70,70,0,1,0,1,0
27005,28015,54917,28015,allow,888,126,762,2,30,1,1
38115,80,9146,80,allow,6442,1404,5038,23,30,12,11
38758,23,0,0,deny,60,60,0,1,0,1,0
51684,445,0,0,drop,70,70,0,1,0,1,0
50711,80,56692,80,allow,708,384,324,12,195,7,5
54587,445,0,0,drop,66,66,0,1,0,1,0
19875,30170,0,0,deny,145,145,0,1,0,1,0
21733,56205,0,0,deny,66,66,0,1,0,1,0
12232,41864,0,0,deny,139,139,0,1,0,1,0
59769,443,37962,443,allow,8432,1967,6465,35,68,17,18
12776,53,12776,53,allow,239,94,145,2,30,1,1
65410,443,49825,443,allow,2494,1643,851,17,25,9,8
21674,28189,0,0,deny,60,60,0,1,0,1,0
50624,80,47844,80,allow,12701,9788,2913,29,52,16,13
56995,53,60804,53,allow,167,86,81,2,30,1,1
57069,53,52685,53,allow,177,94,83,2,31,1,1
49224,53,60967,53,allow,177,94,83,2,30,1,1
64111,1830,17922,1830,allow,66,66,0,2,8,2,0
59182,53,59092,53,allow,168,78,90,2,30,1,1
54013,445,0,0,drop,66,66,0,1,0,1,0
59609,443,2759,443,allow,7762,1777,5985,22,80,13,9
50858,445,0,0,drop,66,66,0,1,0,1,0
57878,445,0,0,drop,70,70,0,1,0,1,0
63966,42532,21022,42532,allow,66,66,0,2,7,2,0
60772,40010,29000,40010,allow,316,136,180,6,5,3,3
26900,27017,3690,27017,allow,422,164,258,6,30,3,3
37297,443,46820,443,allow,232,172,60,3,5,2,1
43600,443,57317,443,allow,172272,14401,157871,254,418,100,154
56989,80,28425,80,allow,526,304,222,8,35,5,3
50987,443,24921,443,allow,3278,1962,1316,20,20,9,11
9267,80,6787,80,allow,318,192,126,6,27,4,2
65386,53,22726,53,allow,184,102,82,2,29,1,1
61630,445,0,0,drop,70,70,0,1,0,1,0
58771,443,41397,443,allow,4726,2487,2239,19,305,9,10
50893,445,0,0,drop,66,66,0,1,0,1,0
64473,53,45182,53,allow,184,94,90,2,31,1,1
60686,445,0,0,drop,70,70,0,1,0,1,0
53208,18375,0,0,deny,62,62,0,1,0,1,0
49284,53,41000,53,allow,195,86,109,2,30,1,1
55727,53,48303,53,allow,177,94,83,2,30,1,1
49160,34068,0,0,deny,146,146,0,1,0,1,0
53687,19010,53687,19010,allow,64,64,0,1,31,1,0
56919,53,16423,53,allow,193,102,91,2,29,1,1
64727,25174,0,0,deny,66,66,0,1,0,1,0
58638,5900,0,0,deny,62,62,0,1,0,1,0
56690,443,7139,443,allow,7914,1925,5989,20,15,11,9
31136,50584,0,0,deny,146,146,0,1,0,1,0
20108,64147,0,0,deny,66,66,0,1,0,1,0
40252,443,46211,443,allow,543828,50144,493684,682,172,254,428
64578,53,30124,53,allow,193,102,91,2,30,1,1
55219,53,47738,53,allow,91,91,0,1,30,1,0
61784,49903,0,0,deny,66,66,0,1,0,1,0
30920,64147,0,0,deny,62,62,0,1,0,1,0
27005,27016,31550,27016,allow,884,126,758,2,30,1,1
2267,53,18224,53,allow,204,118,86,2,31,1,1
35989,161,0,0,allow,18741,9242,9499,96,31,48,48
34489,35440,0,0,deny,66,66,0,1,0,1,0
60183,445,0,0,drop,70,70,0,1,0,1,0
6881,61980,0,0,deny,150,150,0,1,0,1,0
53160,445,0,0,drop,70,70,0,1,0,1,0
55933,53,32005,53,allow,177,94,83,2,30,1,1
49284,6881,63605,6881,allow,411,225,186,6,16,3,3
55030,443,37524,443,allow,5372,1221,4151,23,18,14,9
62262,445,0,0,drop,66,66,0,1,0,1,0
47256,37807,0,0,deny,62,62,0,1,0,1,0
59902,445,0,0,drop,66,66,0,1,0,1,0
64122,443,27502,443,allow,5121090,119252,5001838,5000,55,1680,3320
14694,53,14694,53,allow,230,90,140,2,30,1,1
6121,51505,0,0,deny,62,62,0,1,0,1,0
50644,35440,0,0,deny,66,66,0,1,0,1,0
64988,53,6131,53,allow,360,110,250,2,30,1,1
60374,443,9623,443,allow,130,70,60,2,15,1,1
54276,445,0,0,drop,70,70,0,1,0,1,0
64719,445,0,0,drop,70,70,0,1,0,1,0
5223,21557,0,0,deny,60,60,0,1,0,1,0
54716,443,54716,443,allow,4728,1821,2907,19,29,11,8
8999,59353,0,0,deny,146,146,0,1,0,1,0
58638,5900,0,0,deny,62,62,0,1,0,1,0
49218,53,31585,53,allow,179,86,93,2,30,1,1
57679,445,0,0,drop,70,70,0,1,0,1,0
55105,445,0,0,drop,70,70,0,1,0,1,0
51809,443,10522,443,allow,82930,18836,64094,131,128,55,76
57157,53,8214,53,allow,165,86,79,2,30,1,1
56834,445,0,0,drop,70,70,0,1,0,1,0
49213,53,44755,53,allow,211,102,109,2,30,1,1
58053,445,0,0,drop,70,70,0,1,0,1,0
443,34920,0,0,deny,60,60,0,1,0,1,0
43671,17372,0,0,deny,62,62,0,1,0,1,0
56563,53,56693,53,allow,177,94,83,2,30,1,1
50610,445,0,0,drop,70,70,0,1,0,1,0
57007,53,22368,53,allow,183,94,89,2,30,1,1
22125,23,0,0,deny,60,60,0,1,0,1,0
52490,53,52490,53,allow,240,98,142,2,30,1,1
56846,26665,12553,26665,allow,70,70,0,2,8,2,0
42224,123,27890,123,allow,184,94,90,2,30,1,1
31061,23,0,0,deny,60,60,0,1,0,1,0
49500,443,11255,443,allow,16888,2692,14196,42,150,22,20
59862,445,0,0,drop,70,70,0,1,0,1,0
64578,53,31792,53,allow,193,102,91,2,31,1,1
50881,50584,0,0,deny,66,66,0,1,0,1,0
49211,15576,51582,15576,allow,70,70,0,2,8,2,0
56968,445,0,0,drop,66,66,0,1,0,1,0
60767,40010,24332,40010,allow,316,136,180,6,6,3,3
55867,53,45353,53,allow,178,94,84,2,30,1,1
62014,35440,0,0,deny,66,66,0,1,0,1,0
57139,53,57139,53,allow,235,90,145,2,32,1,1
52197,445,0,0,drop,66,66,0,1,0,1,0
49910,445,0,0,drop,70,70,0,1,0,1,0
58638,5900,0,0,deny,62,62,0,1,0,1,0
55620,53,62411,53,allow,178,94,84,2,30,1,1
11676,25174,0,0,deny,146,146,0,1,0,1,0
34320,443,18156,443,allow,5823,1597,4226,21,19,11,10
57339,53,52334,53,allow,196,94,102,2,30,1,1
50295,443,29927,443,allow,18401,4536,13865,48,27,24,24
65362,80,32536,80,allow,1347,771,576,11,86,7,4
53103,8497,0,0,deny,148,148,0,1,0,1,0
64011,443,26030,443,allow,4196,1407,2789,19,135,9,10
56790,53,40538,53,allow,758,93,665,2,30,1,1
50447,80,50342,80,allow,67694,29654,38040,85,37,40,45
62786,445,0,0,drop,70,70,0,1,0,1,0
49319,443,42333,443,allow,3191,2313,878,17,44,10,7
45941,23386,0,0,deny,60,60,0,1,0,1,0
57470,48622,44893,48622,allow,166,166,0,1,1200,1,0
50265,42805,33244,42805,allow,480,149,331,2,1200,1,1
19875,30170,0,0,deny,145,145,0,1,0,1,0
52033,50584,0,0,deny,66,66,0,1,0,1,0
54954,445,0,0,drop,66,66,0,1,0,1,0
53602,12395,5014,12395,allow,70,70,0,1,5,1,0
51496,443,43516,443,allow,416,210,206,7,15,4,3
58755,445,0,0,drop,66,66,0,1,0,1,0
45461,25174,0,0,deny,62,62,0,1,0,1,0
60281,445,0,0,drop,70,70,0,1,0,1,0
52786,443,4838,443,allow,9032,2673,6359,30,142,16,14
50934,445,0,0,drop,66,66,0,1,0,1,0
63719,445,0,0,drop,66,66,0,1,0,1,0
54826,56205,0,0,deny,66,66,0,1,0,1,0
50442,25174,0,0,deny,66,66,0,1,0,1,0
46310,443,24043,443,allow,172,172,0,2,5,2,0
64096,53,55413,53,allow,197,94,103,2,29,1,1
52876,443,35265,443,allow,501046,7967,493079,419,118,69,350
52946,80,56196,80,allow,4085,2870,1215,23,358,14,9
23218,62413,0,0,deny,66,66,0,1,0,1,0
56192,445,0,0,drop,66,66,0,1,0,1,0
50028,53,16611,53,allow,210,102,108,2,30,1,1
64326,53,53148,53,allow,323,107,216,4,38,2,2
49432,53,51069,53,allow,177,94,83,2,30,1,1
22350,25174,0,0,deny,66,66,0,1,0,1,0
60043,443,26610,443,allow,1015,572,443,11,142,6,5
9473,26467,0,0,deny,66,66,0,1,0,1,0
57470,14806,59723,14806,allow,132,132,0,3,1199,3,0
48189,443,41896,443,allow,1343,616,727,14,82,7,7
48717,443,44246,443,allow,232,172,60,3,5,2,1
47512,443,61793,443,allow,8785,2057,6728,31,396,10,21
54552,64147,0,0,deny,62,62,0,1,0,1,0
53169,443,5040,443,allow,6716,922,5794,20,20,10,10
51166,443,54384,443,allow,13072,4708,8364,47,130,24,23
59535,25174,0,0,deny,62,62,0,1,0,1,0
50393,443,64712,443,allow,1125,595,530,12,29,6,6
56728,53,40582,53,allow,744,95,649,2,31,1,1
49229,53,43907,53,allow,178,94,84,2,30,1,1
62348,50584,0,0,deny,66,66,0,1,0,1,0
60792,443,60792,443,allow,16401,8712,7689,53,297,25,28
49657,445,0,0,drop,70,70,0,1,0,1,0
55660,42459,61425,42459,allow,1717,1129,588,17,25,10,7
47141,50584,0,0,deny,62,62,0,1,0,1,0
58116,445,0,0,drop,70,70,0,1,0,1,0
50324,80,23988,80,allow,1083,653,430,8,15,5,3
40155,25174,0,0,deny,66,66,0,1,0,1,0
55535,53,24278,53,allow,199,102,97,2,29,1,1
61057,31573,0,0,deny,146,146,0,1,0,1,0
22724,9822,0,0,deny,66,66,0,1,0,1,0
60966,443,26414,443,allow,60331,12765,47566,119,105,57,62
53101,443,12106,443,allow,1287,800,487,13,16,9,4
51927,80,21213,80,allow,1945,1002,943,11,20,7,4
53242,443,3574,443,allow,5993,974,5019,19,70,10,9
52701,443,13239,443,allow,130,70,60,3,5,2,1
56969,53,53086,53,allow,196,94,102,2,29,1,1
58638,5900,0,0,deny,62,62,0,1,0,1,0
57284,53,57366,53,allow,165,86,79,2,30,1,1
39313,37965,0,0,deny,62,62,0,1,0,1,0
56214,445,0,0,drop,66,66,0,1,0,1,0
64902,53,39715,53,allow,231,110,121,2,30,1,1
54660,445,0,0,drop,70,70,0,1,0,1,0
55671,17758,7518,17758,allow,422,140,282,6,15,3,3
55688,53,8374,53,allow,184,94,90,2,30,1,1
51418,443,34735,443,allow,7653,1188,6465,21,17,12,9
52277,443,12555,443,allow,13832,4868,8964,91,364,37,54
56951,53,25007,53,allow,198,101,97,2,31,1,1
1882,43890,0,0,deny,62,62,0,1,0,1,0
64999,53,11642,53,allow,757,98,659,2,31,1,1
58638,5900,0,0,deny,62,62,0,1,0,1,0
63841,445,0,0,drop,66,66,0,1,0,1,0
59486,50584,0,0,deny,62,62,0,1,0,1,0
64204,53,12423,53,allow,211,102,109,2,30,1,1
32939,443,44702,443,allow,3312,1936,1376,19,29,10,9
15688,56919,0,0,deny,146,146,0,1,0,1,0
64721,53,12160,53,allow,466,108,358,4,45,2,2
56508,445,0,0,drop,70,70,0,1,0,1,0
50198,445,0,0,drop,70,70,0,1,0,1,0
49160,51413,10192,51413,allow,800,150,650,4,1200,2,2
27005,27016,28994,27016,allow,880,126,754,2,30,1,1
58391,443,1299,443,allow,347192,61325,285867,643,191,297,346
11692,25174,0,0,deny,66,66,0,1,0,1,0
5223,14446,0,0,deny,66,66,0,1,0,1,0
41168,443,17875,443,allow,8949,1938,7011,21,17,12,9
57407,53,20489,53,allow,755,94,661,2,31,1,1
49372,53,37424,53,allow,216,110,106,2,30,1,1
48903,25773,0,0,reset-both,157,157,0,1,0,1,0
63954,53,6162,53,allow,289,102,187,2,30,1,1
61850,34021,0,0,allow,66,66,0,1,91,1,0
65150,445,0,0,drop,66,66,0,1,0,1,0
27783,57470,0,0,deny,62,62,0,1,0,1,0
55747,53,57229,53,allow,215,102,113,2,29,1,1
50007,53,39028,53,allow,216,110,106,2,30,1,1
50492,80,56917,80,allow,318,192,126,6,25,4,2
34658,443,51529,443,allow,3521,516,3005,12,15,6,6
59881,443,61673,443,allow,302,120,182,6,31,3,3
51037,443,13769,443,allow,7298,2661,4637,21,17,11,10
35760,11392,0,0,deny,146,146,0,1,0,1,0
64863,445,0,0,drop,66,66,0,1,0,1,0
32736,22114,0,0,deny,66,66,0,1,0,1,0
51928,443,37238,443,allow,18581,9681,8900,62,103,33,29
32970,64147,0,0,deny,145,145,0,1,0,1,0
59326,57470,0,0,deny,74,74,0,1,0,1,0
58910,445,0,0,drop,70,70,0,1,0,1,0
38702,443,49260,443,allow,1117339,17881,1099458,1006,16,256,750
55012,64147,0,0,deny,66,66,0,1,0,1,0
25101,50584,0,0,deny,62,62,0,1,0,1,0
63958,445,0,0,drop,70,70,0,1,0,1,0
49671,53,47128,53,allow,183,94,89,2,30,1,1
50620,50584,0,0,deny,62,62,0,1,0,1,0
64053,47783,54848,47783,allow,66,66,0,2,7,2,0
51771,19103,1964,19103,allow,70,70,0,1,5,1,0
58486,57470,0,0,deny,66,66,0,1,0,1,0
49418,27018,13297,27018,allow,259,78,181,2,30,1,1
64520,53,48129,53,allow,198,102,96,2,30,1,1
54924,3478,25286,3478,allow,312,140,172,4,31,2,2
14615,57866,0,0,deny,62,62,0,1,0,1,0
62516,445,0,0,drop,66,66,0,1,0,1,0
60417,445,0,0,drop,66,66,0,1,0,1,0
62021,443,62021,443,allow,4625,1718,2907,19,27,11,8
58638,5900,0,0,deny,62,62,0,1,0,1,0
62799,25174,0,0,deny,62,62,0,1,0,1,0
52683,445,0,0,drop,66,66,0,1,0,1,0
43314,443,11137,443,allow,27958,21973,5985,77,403,43,34
63016,443,62521,443,allow,303,85,218,2,31,1,1
59828,443,59390,443,allow,7083,2786,4297,24,81,14,10
64992,53,64992,53,allow,180,82,98,2,30,1,1
53568,445,0,0,drop,66,66,0,1,0,1,0
0,0,0,0,deny,98,98,0,1,0,1,0
48841,51221,0,0,deny,62,62,0,1,0,1,0
52164,42271,30250,42271,allow,70,70,0,2,8,2,0
56914,53,41623,53,allow,731,85,646,2,30,1,1
58943,443,29236,443,allow,6611,4273,2338,22,17,11,11
44911,80,13176,80,allow,1052,612,440,10,15,5,5
49733,443,55919,443,allow,7673,1637,6036,31,23,16,15
59068,57470,0,0,deny,74,74,0,1,0,1,0
49736,443,25787,443,allow,8028,1787,6241,32,28,17,15
56590,53,0,0,allow,82,82,0,1,30,1,0
64173,53,16220,53,allow,210,94,116,2,30,1,1
54002,445,0,0,drop,70,70,0,1,0,1,0
49245,53,64738,53,allow,195,102,93,2,30,1,1
59512,445,0,0,drop,66,66,0,1,0,1,0
4366,51505,0,0,deny,62,62,0,1,0,1,0
34914,53,34914,53,allow,825,99,726,2,30,1,1
62340,445,0,0,drop,70,70,0,1,0,1,0
6999,11119,0,0,deny,143,143,0,1,0,1,0
49890,445,0,0,drop,70,70,0,1,0,1,0
59934,35440,0,0,deny,66,66,0,1,0,1,0
49644,30188,0,0,deny,62,62,0,1,0,1,0
64167,53,3978,53,allow,211,102,109,2,29,1,1
53497,443,53212,443,allow,17187157,553524,16633633,18453,352,6098,12355
50198,5529,0,0,deny,148,148,0,1,0,1,0
61644,445,0,0,drop,66,66,0,1,0,1,0
56101,57470,0,0,deny,66,66,0,1,0,1,0
30306,23,0,0,deny,60,60,0,1,0,1,0
52875,443,52875,443,allow,3133,814,2319,13,136,6,7
57137,53,36481,53,allow,279,96,183,4,31,2,2
51569,445,0,0,drop,66,66,0,1,0,1,0
49429,443,22034,443,allow,990201,31101,959100,1061,192,383,678
56163,53,47774,53,allow,194,102,92,2,30,1,1
51730,33399,62466,33399,allow,70,70,0,2,8,2,0
64941,53,8617,53,allow,199,102,97,2,30,1,1
62088,56205,0,0,deny,66,66,0,1,0,1,0
26752,64147,0,0,deny,62,62,0,1,0,1,0
55078,443,55078,443,allow,4401,1494,2907,19,30,11,8
62011,57354,0,0,deny,159,159,0,1,0,1,0
50336,80,50336,80,allow,2143,676,1467,12,25,7,5
54891,445,0,0,drop,70,70,0,1,0,1,0
27005,28018,47944,28018,allow,1640,126,1514,4,30,2,2
50685,80,6959,80,allow,63891,26626,37265,86,34,39,47
55335,445,0,0,drop,70,70,0,1,0,1,0
57825,13014,0,0,deny,74,74,0,1,0,1,0
49788,1433,0,0,deny,60,60,0,1,0,1,0
33822,57470,0,0,deny,66,66,0,1,0,1,0
33856,443,15583,443,allow,7298,2661,4637,21,21,11,10
63984,25174,0,0,deny,62,62,0,1,0,1,0
60003,445,0,0,drop,70,70,0,1,0,1,0
49812,26467,0,0,deny,62,62,0,1,0,1,0
40866,8434,40866,8434,allow,156,156,0,3,8,3,0
54663,443,5282,443,allow,18311,11567,6744,43,363,21,22
58956,445,0,0,drop,66,66,0,1,0,1,0
60740,443,50087,443,allow,12605,5558,7047,42,101,18,24
27988,40005,9616,40005,allow,148,86,62,2,30,1,1
50679,443,24042,443,allow,14172,2714,11458,32,637,13,19
3765,64147,0,0,deny,66,66,0,1,0,1,0
58791,25174,0,0,deny,146,146,0,1,0,1,0
59722,445,0,0,drop,66,66,0,1,0,1,0
59865,445,0,0,drop,66,66,0,1,0,1,0
56777,53,34621,53,allow,210,94,116,2,30,1,1
49997,445,0,0,drop,66,66,0,1,0,1,0
49960,53,57227,53,allow,198,94,104,2,29,1,1
56118,445,0,0,drop,66,66,0,1,0,1,0
53456,445,0,0,drop,70,70,0,1,0,1,0
60453,24369,51749,24369,allow,70,70,0,2,8,2,0
50872,80,50084,80,allow,54441,4387,50054,75,140,37,38
61218,445,0,0,drop,70,70,0,1,0,1,0
58597,35440,0,0,deny,66,66,0,1,0,1,0
57152,53,41610,53,allow,733,94,639,2,30,1,1
52216,80,58055,80,allow,15824,805,15019,25,18,9,16
42989,443,61280,443,allow,9878,1936,7942,36,121,18,18
53241,443,7784,443,allow,24835,2671,22164,42,323,17,25
49756,53,23691,53,allow,264,89,175,4,48,2,2
16387,3655,0,0,deny,60,60,0,1,0,1,0
53548,23310,1766,23310,allow,70,70,0,2,8,2,0
57940,445,0,0,drop,70,70,0,1,0,1,0
0,0,0,0,allow,244,244,0,2,0,2,0
63644,445,0,0,drop,70,70,0,1,0,1,0
16387,44427,0,0,deny,60,60,0,1,0,1,0
54828,443,7869,443,allow,150,150,0,1,5,1,0
64112,443,40510,443,allow,4116645,96572,4020073,4029,58,1356,2673
49707,80,15833,80,allow,196092,6387,189705,189,108,57,132
49933,445,0,0,drop,70,70,0,1,0,1,0
63224,443,7611,443,allow,1373,734,639,17,155,10,7
57257,445,0,0,drop,70,70,0,1,0,1,0
64965,27049,54387,27049,allow,747,462,285,2,31,1,1
51620,443,44132,443,allow,4320,932,3388,16,15,10,6
64764,53,35102,53,allow,211,102,109,2,30,1,1
56722,80,63327,80,allow,41658,23230,18428,114,798,66,48
49510,53,6465,53,allow,329,118,211,2,29,1,1
64146,53,31528,53,allow,197,102,95,2,30,1,1
64886,53,49173,53,allow,199,102,97,2,29,1,1
45941,23384,0,0,deny,60,60,0,1,0,1,0
55669,53,15322,53,allow,94,94,0,1,29,1,0
8889,33873,8889,33873,allow,124,60,64,2,30,1,1
56186,445,0,0,drop,70,70,0,1,0,1,0
65101,53,44970,53,allow,749,94,655,2,30,1,1
49972,53,55153,53,allow,216,110,106,2,30,1,1
50493,443,55037,443,allow,8164,1206,6958,24,139,12,12
56682,443,39754,443,allow,8735,1819,6916,23,22,14,9
64980,53,1256,53,allow,199,102,97,2,31,1,1
61880,445,0,0,drop,70,70,0,1,0,1,0
64554,53,13352,53,allow,199,102,97,2,29,1,1
50301,80,40498,80,allow,7979,802,7177,17,39,8,9
27005,27017,65015,27017,allow,880,126,754,2,30,1,1
49786,53,64235,53,allow,209,110,99,2,30,1,1
48861,53,40652,53,allow,164,78,86,2,30,1,1
7067,22114,0,0,deny,62,62,0,1,0,1,0
10151,6889,16341,6889,allow,481,150,331,2,1200,1,1
37544,443,15194,443,allow,23647,9422,14225,52,40,28,24
56775,53,28683,53,allow,170,87,83,2,30,1,1
56790,445,0,0,drop,66,66,0,1,0,1,0
49660,53,64845,53,allow,186,95,91,2,30,1,1
38576,443,42458,443,allow,10853,8227,2626,30,360,15,15
61670,57470,0,0,deny,74,74,0,1,0,1,0
49874,53,37266,53,allow,173,94,79,2,30,1,1
59607,443,14075,443,allow,2150,1280,870,18,832,10,8
54475,445,0,0,drop,66,66,0,1,0,1,0
49893,445,0,0,drop,66,66,0,1,0,1,0
60939,53,60939,53,allow,237,91,146,2,32,1,1
54520,1433,0,0,deny,60,60,0,1,0,1,0
57157,443,64238,443,allow,1647,1375,272,9,48,5,4
60244,443,61797,443,allow,17829,9658,8171,92,150,46,46
64904,53,1451,53,allow,211,102,109,2,30,1,1
49698,445,0,0,drop,66,66,0,1,0,1,0
10006,64147,0,0,deny,145,145,0,1,0,1,0
39916,53,62317,53,allow,168,78,90,2,30,1,1
54425,443,49600,443,allow,1648,813,835,17,186,9,8
45783,22114,0,0,deny,62,62,0,1,0,1,0
62838,44847,0,0,deny,66,66,0,1,0,1,0
51980,45478,64521,45478,allow,70,70,0,1,5,1,0
50801,443,41271,443,allow,6893,1384,5509,19,140,9,10
47638,443,5364,443,allow,1056,569,487,10,38,6,4
56472,53,36068,53,allow,167,86,81,2,31,1,1
65000,53,40784,53,allow,168,86,82,2,30,1,1
34079,80,3796,80,allow,5053,4178,875,17,15,9,8
55058,443,16741,443,allow,12435,4022,8413,27,62,15,12
55955,53,2221,53,allow,814,110,704,2,30,1,1
55244,445,0,0,drop,70,70,0,1,0,1,0
55427,445,0,0,drop,70,70,0,1,0,1,0
19534,26467,0,0,deny,66,66,0,1,0,1,0
41538,443,31150,443,allow,8090,2462,5628,22,21,12,10
50326,443,38402,443,allow,552885,34781,518104,733,245,314,419
59751,53,11335,53,allow,304,86,218,2,30,1,1
51432,80,51432,80,allow,42247,4067,38180,58,25,23,35
40729,123,44305,123,allow,184,94,90,2,30,1,1
52730,7000,52730,7000,allow,2163,676,1487,14,15,7,7
55227,53,7352,53,allow,183,102,81,2,30,1,1
53571,445,0,0,drop,70,70,0,1,0,1,0
64685,53,52958,53,allow,186,95,91,2,30,1,1
58692,445,0,0,drop,70,70,0,1,0,1,0
56727,443,57540,443,allow,7889,1900,5989,20,14,11,9
60311,445,0,0,drop,70,70,0,1,0,1,0
58131,15503,0,0,deny,146,146,0,1,0,1,0
55130,53,9076,53,allow,216,110,106,2,31,1,1
61031,445,0,0,drop,70,70,0,1,0,1,0
49486,53,16915,53,allow,177,94,83,2,30,1,1
49785,443,35177,443,allow,7757,1949,5808,22,126,12,10
17119,53,17119,53,allow,217,87,130,2,30,1,1
59680,445,0,0,drop,66,66,0,1,0,1,0
59834,445,0,0,drop,70,70,0,1,0,1,0
16013,35253,0,0,deny,66,66,0,1,0,1,0
57310,445,0,0,drop,66,66,0,1,0,1,0
57271,443,34428,443,allow,7155,2151,5004,34,33,20,14
6881,666,16595,666,allow,268,150,118,2,1199,1,1
44710,25174,0,0,deny,62,62,0,1,0,1,0
51835,443,47905,443,allow,546,300,246,10,31,6,4
5048,53,5048,53,allow,247,98,149,2,34,1,1
6416,22114,0,0,deny,66,66,0,1,0,1,0
55772,53,24055,53,allow,269,110,159,2,30,1,1
59450,445,0,0,drop,66,66,0,1,0,1,0
49747,445,0,0,drop,70,70,0,1,0,1,0
49348,53,21322,53,allow,749,94,655,2,30,1,1
41095,443,28178,443,allow,108842,88940,19902,313,255,159,154
64766,53,54775,53,allow,195,102,93,2,30,1,1
49655,80,10831,80,allow,6485767,147003,6338764,6221,320,2024,4197
58631,445,0,0,drop,70,70,0,1,0,1,0
53472,445,0,0,drop,70,70,0,1,0,1,0
65170,53,60576,53,allow,771,102,669,2,30,1,1
57071,445,0,0,drop,70,70,0,1,0,1,0
53631,443,46993,443,allow,31965,26754,5211,63,22,34,29
51098,80,4123,80,allow,3378,1918,1460,33,131,18,15
51055,445,0,0,drop,70,70,0,1,0,1,0
50516,80,41134,80,allow,502,256,246,9,25,5,4
10243,36237,0,0,deny,62,62,0,1,0,1,0
48238,443,41856,443,allow,2227,1018,1209,17,15,8,9
58890,445,0,0,drop,70,70,0,1,0,1,0
62143,23,0,0,deny,60,60,0,1,0,1,0
55404,443,49426,443,allow,70,70,0,1,5,1,0
14692,25174,0,0,deny,62,62,0,1,0,1,0
57817,445,0,0,drop,70,70,0,1,0,1,0
49317,443,8477,443,allow,1486172,26246,1459926,1245,40,266,979
57378,53,5726,53,allow,350,94,256,2,30,1,1
60186,445,0,0,drop,70,70,0,1,0,1,0
62824,37807,0,0,deny,62,62,0,1,0,1,0
60683,443,28178,443,allow,17071,1532,15539,17,147,3,14
27005,27257,60876,27257,allow,883,126,757,2,30,1,1
58762,443,39294,443,allow,318,192,126,6,25,4,2
22773,443,22773,443,allow,6993,960,6033,17,31,10,7
51414,22,0,0,deny,60,60,0,1,0,1,0
64236,445,0,0,drop,66,66,0,1,0,1,0
43724,35440,0,0,deny,62,62,0,1,0,1,0
53733,443,35168,443,allow,499,425,74,4,0,3,1
53202,445,0,0,drop,70,70,0,1,0,1,0
62396,51050,0,0,deny,146,146,0,1,0,1,0
9256,443,44390,443,allow,6327,833,5494,19,26,10,9
34173,53,34173,53,allow,240,98,142,2,29,1,1
55287,445,0,0,drop,66,66,0,1,0,1,0
53425,445,0,0,drop,66,66,0,1,0,1,0
33878,443,33484,443,allow,2279,1637,642,15,25,9,6
55172,445,0,0,drop,70,70,0,1,0,1,0
53575,445,0,0,drop,66,66,0,1,0,1,0
56046,445,0,0,drop,66,66,0,1,0,1,0
50602,53,48380,53,allow,761,100,661,2,30,1,1
55414,443,59075,443,allow,6053,4104,1949,31,84,17,14
58209,445,0,0,drop,70,70,0,1,0,1,0
49518,80,62849,80,allow,11011,7675,3336,21,26,11,10
12157,80,12157,80,allow,2144,1519,625,9,29,6,3
64668,53,24152,53,allow,211,102,109,2,30,1,1
46298,443,58260,443,allow,52438,4244,48194,77,23,37,40
60874,443,9716,443,allow,4479,788,3691,17,25,9,8
60057,445,0,0,drop,70,70,0,1,0,1,0
57692,445,0,0,drop,66,66,0,1,0,1,0
53495,37807,0,0,deny,66,66,0,1,0,1,0
51300,64147,0,0,deny,66,66,0,1,0,1,0
65177,53,32886,53,allow,256,93,163,2,31,1,1
60706,445,0,0,drop,70,70,0,1,0,1,0
49036,44847,0,0,deny,146,146,0,1,0,1,0
39508,53,12625,53,allow,78,78,0,1,30,1,0
64394,53,6864,53,allow,226,102,124,2,30,1,1
38741,37965,0,0,deny,146,146,0,1,0,1,0
58638,5900,0,0,deny,62,62,0,1,0,1,0
49935,80,29909,80,allow,1130,613,517,11,15,6,5
6546,37965,0,0,deny,62,62,0,1,0,1,0
61682,80,36902,80,allow,1804,884,920,12,49,6,6
50084,26672,0,0,deny,145,145,0,1,0,1,0
63804,445,0,0,drop,66,66,0,1,0,1,0
61030,21247,0,0,deny,62,62,0,1,0,1,0
43465,80,31398,80,allow,1352,848,504,13,255,8,5
26799,6881,0,0,deny,62,62,0,1,0,1,0
42044,60043,0,0,deny,62,62,0,1,0,1,0
37385,443,16177,443,allow,8824,2041,6783,34,255,17,17
50454,445,0,0,drop,70,70,0,1,0,1,0
64697,37965,0,0,deny,66,66,0,1,0,1,0
38520,53,38520,53,allow,231,88,143,2,34,1,1
56741,443,24400,443,allow,9868,2027,7841,24,20,12,12
49520,53,55540,53,allow,229,102,127,2,30,1,1
61763,445,0,0,drop,70,70,0,1,0,1,0
16826,22,0,0,deny,60,60,0,1,0,1,0
57600,443,30518,443,allow,2614,1689,925,18,21,10,8
56324,53,52043,53,allow,177,94,83,2,30,1,1
58914,37965,0,0,deny,66,66,0,1,0,1,0
50656,80,17387,80,allow,318,192,126,6,25,4,2
64913,53,45280,53,allow,188,96,92,2,30,1,1
8998,53,50504,53,allow,225,78,147,2,29,1,1
51418,445,0,0,drop,70,70,0,1,0,1,0
52575,22114,0,0,deny,66,66,0,1,0,1,0
52222,11516,7975,11516,allow,70,70,0,1,5,1,0
35585,53,60283,53,allow,168,78,90,2,29,1,1
55097,53,54198,53,allow,177,94,83,2,29,1,1
28699,53,53419,53,allow,278,86,192,2,30,1,1
61331,445,0,0,drop,70,70,0,1,0,1,0
65304,53,52702,53,allow,194,86,108,2,29,1,1
54530,445,0,0,drop,70,70,0,1,0,1,0
65069,445,0,0,drop,66,66,0,1,0,1,0
57416,53,15222,53,allow,193,102,91,2,30,1,1
47388,443,44848,443,allow,2897,728,2169,10,121,5,5
58908,443,56510,443,allow,6278402,111931,6166471,5306,1119,732,4574
56505,445,0,0,drop,70,70,0,1,0,1,0
53447,22114,0,0,deny,146,146,0,1,0,1,0
65439,53,5065,53,allow,198,94,104,2,30,1,1
11582,41599,40027,41599,allow,70,70,0,1,5,1,0
56071,53,60998,53,allow,193,102,91,2,29,1,1
54135,445,0,0,drop,70,70,0,1,0,1,0
1936,80,29393,80,allow,214,140,74,4,15,3,1
49481,7000,49481,7000,allow,3066,1675,1391,16,14,9,7
40512,57470,0,0,deny,74,74,0,1,0,1,0
60760,20010,54790,20010,allow,70,70,0,2,8,2,0
59969,443,49407,443,allow,6655,1166,5489,21,360,11,10
56711,53,61949,53,allow,209,110,99,2,31,1,1
49200,38001,36048,38001,allow,70,70,0,2,8,2,0
8760,22114,0,0,deny,62,62,0,1,0,1,0
56925,53,23020,53,allow,196,102,94,2,30,1,1
443,60496,0,0,deny,320,320,0,1,0,1,0
3576,8305,0,0,deny,145,145,0,1,0,1,0
20608,28189,0,0,deny,60,60,0,1,0,1,0
51998,445,0,0,drop,70,70,0,1,0,1,0
50010,80,40489,80,allow,5058,4299,759,11,27,6,5
61199,445,0,0,drop,70,70,0,1,0,1,0
56822,53,28434,53,allow,184,94,90,2,30,1,1
64036,23718,0,0,deny,66,66,0,1,0,1,0
49976,22114,0,0,deny,62,62,0,1,0,1,0
50862,445,0,0,drop,70,70,0,1,0,1,0
42642,443,27903,443,allow,6826,1804,5022,21,137,11,10
56769,11155,5156,11155,allow,66,66,0,1,5,1,0
61246,445,0,0,drop,66,66,0,1,0,1,0
55848,53,45545,53,allow,184,102,82,2,30,1,1
51457,445,0,0,drop,70,70,0,1,0,1,0
9445,56205,0,0,deny,66,66,0,1,0,1,0
56903,445,0,0,drop,70,70,0,1,0,1,0
49286,53,40231,53,allow,184,94,90,2,31,1,1
56050,53,45848,53,allow,172,88,84,2,30,1,1
34744,443,31137,443,allow,13175,2432,10743,52,3587,23,29
50588,80,50588,80,allow,2765,1835,930,14,21,8,6
55651,53,8251,53,allow,199,102,97,2,29,1,1
53373,443,1651,443,allow,8557,1755,6802,28,35,14,14
23537,35253,0,0,deny,62,62,0,1,0,1,0
7109,64147,0,0,deny,66,66,0,1,0,1,0
50367,80,15574,80,allow,318,192,126,6,28,4,2
49226,53,7327,53,allow,194,102,92,2,29,1,1
28592,53,28592,53,allow,216,90,126,2,31,1,1
55570,53,44028,53,allow,168,86,82,2,31,1,1
3027,53,3027,53,allow,199,90,109,2,30,1,1
50377,53,9572,53,allow,167,78,89,2,30,1,1
38659,15000,47156,15000,allow,138,78,60,2,5,1,1
1024,64147,0,0,deny,62,62,0,1,0,1,0
49878,80,42487,80,allow,2086,1214,872,8,88,5,3
64614,53,61495,53,allow,538,179,359,6,63,3,3
56186,57470,0,0,deny,62,62,0,1,0,1,0
26365,22,0,0,deny,60,60,0,1,0,1,0
55732,45682,36442,45682,allow,70,70,0,2,8,2,0
48565,53,48565,53,allow,197,90,107,2,30,1,1
60742,20010,63644,20010,allow,70,70,0,2,8,2,0
50585,80,63970,80,allow,1726,963,763,13,80,7,6
62678,445,0,0,drop,70,70,0,1,0,1,0
11816,50584,0,0,deny,62,62,0,1,0,1,0
57439,445,0,0,drop,66,66,0,1,0,1,0
13285,29892,0,0,deny,145,145,0,1,0,1,0
64647,3389,64647,3389,allow,3327,1438,1889,15,17,8,7
52781,57470,0,0,deny,66,66,0,1,0,1,0
50895,443,61149,443,allow,130,70,60,3,5,2,1
10028,25604,0,0,deny,62,62,0,1,0,1,0
55988,443,19724,443,allow,14754,7879,6875,37,231,20,17
63934,53,32673,53,allow,209,110,99,2,29,1,1
13285,29892,0,0,deny,145,145,0,1,0,1,0
60299,80,6795,80,allow,1557,778,779,11,144,6,5
41114,53,0,0,allow,82,82,0,1,30,1,0
53685,38978,33015,38978,allow,70,70,0,1,5,1,0
64122,53,46704,53,allow,255,102,153,2,30,1,1
49246,53,63715,53,allow,286,102,184,2,31,1,1
60049,25174,0,0,deny,66,66,0,1,0,1,0
56144,445,0,0,drop,70,70,0,1,0,1,0
56878,53,29099,53,allow,94,94,0,1,30,1,0
49518,53,53885,53,allow,193,102,91,2,30,1,1
47812,443,45871,443,allow,25864,15150,10714,105,217,54,51
39807,443,25771,443,allow,1684,1031,653,16,92,9,7
36394,443,29956,443,allow,8714,1606,7108,24,34,12,12
59003,443,53579,443,allow,10196,6897,3299,39,121,20,19
49196,53,19330,53,allow,91,91,0,1,30,1,0
64663,53,18610,53,allow,578,286,292,9,15,5,4
38565,51505,0,0,deny,62,62,0,1,0,1,0
56743,443,64118,443,allow,8060,2040,6020,20,15,11,9
43884,80,63772,80,allow,1774,1460,314,13,15,8,5
49774,53,5014,53,allow,236,94,142,2,30,1,1
61232,443,38058,443,allow,1786,172,1614,7,120,3,4
57470,46501,13184,46501,allow,132,132,0,3,1199,3,0
50418,443,31085,443,allow,4507,744,3763,17,29,7,10
53929,443,27958,443,allow,499,425,74,4,0,3,1
44695,53,44695,53,allow,198,89,109,2,30,1,1
49361,53,25462,53,allow,184,94,90,2,30,1,1
42705,80,6053,80,allow,1222,782,440,11,15,6,5
50620,50584,0,0,deny,66,66,0,1,0,1,0
51554,445,0,0,drop,66,66,0,1,0,1,0
59952,445,0,0,drop,70,70,0,1,0,1,0
27539,25174,0,0,deny,146,146,0,1,0,1,0
53821,53,5224,53,allow,199,94,105,2,30,1,1
17097,62413,0,0,deny,62,62,0,1,0,1,0
60894,445,0,0,drop,66,66,0,1,0,1,0
55182,443,46108,443,allow,2970,1689,1281,24,18,13,11
60984,443,58411,443,allow,12163,4876,7287,35,50,20,15
65016,443,10524,443,allow,5957,2481,3476,14,120,8,6
63770,24466,46194,24466,allow,312,132,180,6,6,3,3
43586,443,62166,443,allow,2328,1429,899,18,33,10,8
65277,53,2071,53,allow,775,102,673,2,30,1,1
65265,55067,0,0,deny,62,62,0,1,0,1,0
0,0,0,0,deny,60,60,0,1,0,1,0
52652,443,14258,443,allow,14511,4628,9883,29,559,15,14
54322,27015,26816,27015,allow,924,924,0,3,29,3,0
56792,443,43093,443,allow,8074,2054,6020,20,15,11,9
56119,53,10048,53,allow,199,102,97,2,33,1,1
64622,53,5676,53,allow,738,86,652,2,30,1,1
56119,46824,0,0,deny,62,62,0,1,0,1,0
52974,445,0,0,drop,70,70,0,1,0,1,0
53197,445,0,0,drop,70,70,0,1,0,1,0
60328,445,0,0,drop,70,70,0,1,0,1,0
56357,53,62096,53,allow,168,86,82,2,30,1,1
52002,34348,46608,34348,allow,66,66,0,1,5,1,0
64327,53,41348,53,allow,210,110,100,2,31,1,1
53020,80,53020,80,allow,134273,4066,130207,163,22,59,104
48080,22,0,0,deny,60,60,0,1,0,1,0
59278,443,45402,443,allow,10495,9044,1451,29,35,18,11
56127,53,6171,53,allow,167,86,81,2,30,1,1
49540,50584,0,0,deny,66,66,0,1,0,1,0
56355,53,52899,53,allow,184,94,90,2,31,1,1
52398,445,0,0,drop,70,70,0,1,0,1,0
48230,22114,0,0,deny,146,146,0,1,0,1,0
50850,443,34368,443,allow,6341,1382,4959,19,132,9,10
7048,25174,0,0,deny,62,62,0,1,0,1,0
61910,445,0,0,drop,66,66,0,1,0,1,0
55616,42929,18894,42929,allow,70,70,0,2,8,2,0
42731,443,42301,443,allow,6131,1399,4732,20,983,10,10
39994,80,39994,80,allow,2919,1492,1427,10,15,6,4
33340,443,55389,443,allow,3598,1118,2480,14,120,7,7
63979,445,0,0,drop,66,66,0,1,0,1,0
64023,53,29476,53,allow,179,94,85,2,30,1,1
61667,80,57155,80,allow,21567,1666,19901,35,46,18,17
9158,443,59645,443,allow,5727,491,5236,14,15,7,7
45964,5333,0,0,deny,60,60,0,1,0,1,0
59396,443,16679,443,allow,5801,1995,3806,19,16,10,9
64225,445,0,0,drop,70,70,0,1,0,1,0
62175,445,0,0,drop,70,70,0,1,0,1,0
55343,53,13186,53,allow,770,101,669,2,31,1,1
60485,13314,64825,13314,allow,70,70,0,2,8,2,0
53625,64147,0,0,deny,66,66,0,1,0,1,0
60863,53,60863,53,allow,298,114,184,2,30,1,1
51913,443,51764,443,allow,190,70,120,4,15,2,2
59902,443,47216,443,allow,6196,746,5450,17,28,8,9
53730,37965,0,0,deny,66,66,0,1,0,1,0
60388,80,19317,80,allow,214,140,74,4,15,3,1
31660,35440,0,0,deny,66,66,0,1,0,1,0
28124,8497,0,0,deny,148,148,0,1,0,1,0
54727,445,0,0,drop,70,70,0,1,0,1,0
60029,445,0,0,drop,66,66,0,1,0,1,0
63095,443,9067,443,allow,571,166,405,2,30,1,1
56753,443,16519,443,allow,8058,2038,6020,20,15,11,9
64879,53,48255,53,allow,356,118,238,2,30,1,1
64978,53,11316,53,allow,198,102,96,2,30,1,1
59803,22114,0,0,deny,62,62,0,1,0,1,0
50500,80,1291,80,allow,318,192,126,6,25,4,2
51121,445,0,0,drop,66,66,0,1,0,1,0
47147,443,41911,443,allow,5789,952,4837,19,150,10,9
13003,3389,13003,3389,allow,3424,1710,1714,16,33,8,8
59040,24184,0,0,allow,62,62,0,1,60,1,0
43540,1433,0,0,deny,60,60,0,1,0,1,0
49418,27015,16562,27015,allow,269,71,198,2,31,1,1
56167,53,36482,53,allow,172,88,84,2,31,1,1
51326,443,48019,443,allow,6250,1422,4828,20,17,10,10
49769,443,1740,443,allow,13455,1982,11473,29,31,16,13
52220,445,0,0,drop,66,66,0,1,0,1,0
51521,443,51521,443,allow,138679,4142,134537,141,173,33,108
37008,42707,0,0,deny,62,62,0,1,0,1,0
7275,9524,0,0,deny,66,66,0,1,0,1,0
54048,25174,0,0,deny,66,66,0,1,0,1,0
60558,51221,0,0,deny,62,62,0,1,0,1,0
49653,80,47758,80,allow,2815,1605,1210,17,166,9,8
63840,36829,0,0,deny,66,66,0,1,0,1,0
3047,50584,0,0,deny,146,146,0,1,0,1,0
53408,445,0,0,drop,70,70,0,1,0,1,0
8999,57470,0,0,deny,146,146,0,1,0,1,0
58625,445,0,0,drop,66,66,0,1,0,1,0
49246,53,41120,53,allow,172,94,78,2,30,1,1
37965,6881,46281,6881,allow,479,150,329,2,1199,1,1
3456,11392,0,0,deny,66,66,0,1,0,1,0
57002,445,0,0,drop,70,70,0,1,0,1,0
40296,80,40296,80,allow,1032410,43358,989052,1356,72,591,765
65182,53,61284,53,allow,634,199,435,6,79,3,3
40254,25174,0,0,deny,62,62,0,1,0,1,0
50442,25174,0,0,deny,66,66,0,1,0,1,0
58638,5900,0,0,deny,62,62,0,1,0,1,0
37965,29299,52257,29299,allow,858,858,0,14,1199,14,0
27841,35894,0,0,deny,62,62,0,1,0,1,0
50488,22114,0,0,deny,66,66,0,1,0,1,0
49698,80,3522,80,allow,140258,1720,138538,117,52,18,99
49170,443,23155,443,allow,7743,1601,6142,18,16,10,8
56381,53,14303,53,allow,196,102,94,2,31,1,1
56396,53,44233,53,allow,182,93,89,2,31,1,1
44383,443,25298,443,allow,14780,11289,3491,59,219,32,27
64155,53,12235,53,allow,183,94,89,2,30,1,1
58638,5900,0,0,deny,62,62,0,1,0,1,0
51691,80,8687,80,allow,19384,2720,16664,36,174,18,18
58473,445,0,0,drop,70,70,0,1,0,1,0
54263,445,0,0,drop,70,70,0,1,0,1,0
49975,445,0,0,drop,70,70,0,1,0,1,0
55986,26467,0,0,deny,66,66,0,1,0,1,0
54654,443,37432,443,allow,4869,1016,3853,18,121,9,9
55615,53,40819,53,allow,225,110,115,2,30,1,1
60873,53,0,0,allow,86,86,0,1,30,1,0
56005,445,0,0,drop,66,66,0,1,0,1,0
57849,50584,0,0,deny,66,66,0,1,0,1,0
64949,53,27960,53,allow,472,124,348,4,39,2,2
56553,53,8293,53,allow,199,102,97,2,30,1,1
58987,445,0,0,drop,70,70,0,1,0,1,0
19662,22114,0,0,deny,62,62,0,1,0,1,0
42298,443,6175,443,allow,70,70,0,1,30,1,0
64467,445,0,0,drop,70,70,0,1,0,1,0
13684,25174,0,0,deny,62,62,0,1,0,1,0
50593,443,18063,443,allow,1745,1068,677,18,95,10,8
61289,53,61289,53,allow,197,76,121,2,30,1,1
56717,53,4326,53,allow,183,94,89,2,29,1,1
57470,41813,46944,41813,allow,519,166,353,2,1200,1,1
59437,445,0,0,drop,70,70,0,1,0,1,0
35459,443,23832,443,allow,119911,5690,114221,153,173,63,90
3802,55777,0,0,deny,66,66,0,1,0,1,0
53133,443,4728,443,allow,5610,1599,4011,24,17,14,10
54838,445,0,0,drop,66,66,0,1,0,1,0
55841,53,55031,53,allow,265,86,179,4,59,2,2
42298,40022,41026,40022,allow,717,551,166,4,31,2,2
5664,36237,0,0,deny,62,62,0,1,0,1,0
50800,443,31236,443,allow,7067,1129,5938,19,141,9,10
63568,445,0,0,drop,66,66,0,1,0,1,0
36406,443,50079,443,allow,1149,709,440,13,38,8,5
53298,80,1119,80,allow,12660,7492,5168,27,274,14,13
8889,21251,0,0,deny,60,60,0,1,0,1,0
56940,443,47279,443,allow,5147,2613,2534,19,137,10,9
52915,445,0,0,drop,66,66,0,1,0,1,0
65139,53,15314,53,allow,216,110,106,2,30,1,1
58249,445,0,0,drop,66,66,0,1,0,1,0
53735,58869,24687,58869,allow,70,70,0,1,4,1,0
55310,53,54905,53,allow,180,94,86,2,31,1,1
64327,53,41700,53,allow,210,110,100,2,30,1,1
50754,443,43460,443,allow,10133,2663,7470,35,255,18,17
33908,48983,0,0,deny,145,145,0,1,0,1,0
51868,443,55642,443,allow,4375,1230,3145,16,30,8,8
56968,443,61875,443,allow,5649,2005,3644,21,186,11,10
50994,445,0,0,drop,66,66,0,1,0,1,0
56624,53,44653,53,allow,199,102,97,2,30,1,1
10099,80,20785,80,allow,130,70,60,2,15,1,1
52976,31573,0,0,deny,66,66,0,1,0,1,0
61457,21247,0,0,deny,62,62,0,1,0,1,0
56006,53,47168,53,allow,210,102,108,2,30,1,1
19096,64147,0,0,deny,62,62,0,1,0,1,0
58638,5900,0,0,deny,62,62,0,1,0,1,0
63183,64147,0,0,deny,66,66,0,1,0,1,0
54684,37965,0,0,deny,62,62,0,1,0,1,0
55408,445,0,0,drop,70,70,0,1,0,1,0
60097,445,0,0,drop,66,66,0,1,0,1,0
32983,51221,0,0,deny,66,66,0,1,0,1,0
65049,443,55584,443,allow,12674,1396,11278,12,139,2,10
56705,53,17593,53,allow,168,78,90,2,30,1,1
60045,443,3000,443,allow,1573,769,804,16,47,9,7
57340,53,7589,53,allow,216,110,106,2,30,1,1
63724,445,0,0,drop,66,66,0,1,0,1,0
56899,445,0,0,drop,66,66,0,1,0,1,0
64045,53,1404,53,allow,1011,232,779,6,55,3,3
63757,51413,7176,51413,allow,66,66,0,2,7,2,0
65482,53,17558,53,allow,278,126,152,2,30,1,1
51718,55003,59957,55003,allow,66,66,0,1,5,1,0
56020,53,55046,53,allow,168,86,82,2,30,1,1
54995,443,42324,443,allow,13281,4753,8528,32,17,18,14
58638,5900,0,0,deny,62,62,0,1,0,1,0
49514,443,28704,443,allow,28361,1861,26500,49,195,19,30
56739,53,56739,53,allow,825,99,726,2,30,1,1
53743,23915,44968,23915,allow,70,70,0,1,4,1,0
46774,80,26120,80,allow,2074,1375,699,13,83,7,6
9413,443,2971,443,allow,3510,430,3080,10,15,6,4
53985,30188,0,0,deny,66,66,0,1,0,1,0
8889,16520,0,0,deny,60,60,0,1,0,1,0
33564,443,54838,443,allow,314376,14130,300246,399,246,169,230
14967,24855,0,0,reset-both,62,62,0,1,0,1,0
50366,80,48017,80,allow,23852,1662,22190,36,15,19,17
51831,26270,17546,26270,allow,70,70,0,1,5,1,0
52407,445,0,0,drop,70,70,0,1,0,1,0
58876,57470,0,0,deny,66,66,0,1,0,1,0
53746,7546,50898,7546,allow,70,70,0,1,4,1,0
52180,20121,52199,20121,allow,70,70,0,2,7,2,0
60795,445,0,0,drop,70,70,0,1,0,1,0
65143,445,0,0,drop,66,66,0,1,0,1,0
60419,445,0,0,drop,66,66,0,1,0,1,0
61451,17500,0,0,deny,66,66,0,1,0,1,0
50494,445,0,0,drop,70,70,0,1,0,1,0
57038,53,16760,53,allow,188,96,92,2,30,1,1
61013,41705,0,0,deny,66,66,0,1,0,1,0
49217,53,45409,53,allow,282,93,189,4,45,2,2
50913,443,27670,443,allow,5057,851,4206,15,16,9,6
50082,445,0,0,drop,66,66,0,1,0,1,0
56198,445,0,0,drop,66,66,0,1,0,1,0
55632,45682,33177,45682,allow,70,70,0,1,5,1,0
51147,443,55855,443,allow,6162,925,5237,18,52,10,8
12881,20082,0,0,deny,146,146,0,1,0,1,0
64840,53,24107,53,allow,356,118,238,2,30,1,1
16387,22272,0,0,deny,60,60,0,1,0,1,0
56610,80,6975,80,allow,1604,700,904,15,116,7,8
54966,443,5878,443,allow,4645,2498,2147,14,135,7,7
56659,443,54837,443,allow,8058,2038,6020,20,15,11,9
49501,443,27772,443,allow,1882,1108,774,17,135,10,7
54388,53,31456,53,allow,168,78,90,2,30,1,1
56808,53,41016,53,allow,90,90,0,1,30,1,0
34731,22114,0,0,deny,62,62,0,1,0,1,0
65143,53,22648,53,allow,822,102,720,2,29,1,1
56707,443,1984,443,allow,5928,1558,4370,22,20,13,9
56611,53,12492,53,allow,177,94,83,2,29,1,1
59136,50584,0,0,deny,66,66,0,1,0,1,0
55164,445,0,0,drop,70,70,0,1,0,1,0
56450,53,8472,53,allow,168,86,82,2,30,1,1
64548,445,0,0,drop,70,70,0,1,0,1,0
45908,33330,0,0,deny,60,60,0,1,0,1,0
57470,35988,31535,35988,allow,132,132,0,3,1199,3,0
56432,53,16819,53,allow,195,102,93,2,30,1,1
59494,443,39878,443,allow,448,78,370,6,25,1,5
55312,53,10081,53,allow,190,97,93,2,30,1,1
51191,26467,0,0,deny,66,66,0,1,0,1,0
56653,22114,0,0,deny,66,66,0,1,0,1,0
53222,443,42780,443,allow,4531,974,3557,18,65,10,8
56874,445,0,0,drop,70,70,0,1,0,1,0
60899,443,59717,443,allow,847673,42767,804906,1045,89,441,604
9133,80,26542,80,allow,318,192,126,6,30,4,2
55075,445,0,0,drop,70,70,0,1,0,1,0
55435,25174,0,0,deny,146,146,0,1,0,1,0
55884,445,0,0,drop,66,66,0,1,0,1,0
36420,443,54908,443,allow,7018,1381,5637,24,17,14,10
51966,18716,12930,18716,allow,70,70,0,2,8,2,0
51401,6881,0,0,deny,62,62,0,1,0,1,0
65419,53,59811,53,allow,200,102,98,2,30,1,1
57099,445,0,0,drop,70,70,0,1,0,1,0
14656,36237,0,0,deny,66,66,0,1,0,1,0
52439,35894,0,0,deny,74,74,0,1,0,1,0
52819,15503,0,0,deny,66,66,0,1,0,1,0
62816,445,0,0,drop,66,66,0,1,0,1,0
44839,443,42515,443,allow,308,84,224,4,120,2,2
65422,26467,0,0,deny,62,62,0,1,0,1,0
64878,53,35842,53,allow,511,92,419,4,45,2,2
63665,445,0,0,drop,70,70,0,1,0,1,0
57150,53,64897,53,allow,177,94,83,2,30,1,1
35271,443,35271,443,allow,134405,6968,127437,187,97,85,102
51320,44847,0,0,deny,66,66,0,1,0,1,0
64693,26467,0,0,deny,62,62,0,1,0,1,0
52039,80,22816,80,allow,4185,3462,723,14,15,7,7
49166,443,10443,443,allow,70,70,0,1,5,1,0
3478,61463,0,0,deny,1262,1262,0,1,0,1,0
67,68,0,0,deny,346,346,0,1,0,1,0
61148,37965,0,0,deny,66,66,0,1,0,1,0
49485,11392,0,0,deny,62,62,0,1,0,1,0
80,36466,0,0,deny,1514,1514,0,1,0,1,0
49826,443,4711,443,allow,1738,1159,579,16,74,10,6
52811,44847,0,0,deny,66,66,0,1,0,1,0
4041,50584,0,0,deny,62,62,0,1,0,1,0
49432,53,25699,53,allow,309,94,215,4,32,2,2
55145,11392,0,0,deny,66,66,0,1,0,1,0
62079,30188,0,0,deny,66,66,0,1,0,1,0
60485,13314,55482,13314,allow,70,70,0,1,5,1,0
27471,53,27471,53,allow,237,91,146,2,32,1,1
43164,443,24293,443,allow,10030,3002,7028,24,16,13,11
50009,445,0,0,drop,70,70,0,1,0,1,0
2362,53,2362,53,allow,225,90,135,2,30,1,1
49653,80,62428,80,allow,372,192,180,7,42,4,3
26900,27017,46101,27017,allow,422,164,258,6,30,3,3
65506,53,39413,53,allow,194,99,95,2,30,1,1
50516,443,44017,443,allow,1575,771,804,16,47,9,7
53369,80,53369,80,allow,81339,4340,76999,84,57,22,62
57269,53,41250,53,allow,182,93,89,2,31,1,1
60045,445,0,0,drop,66,66,0,1,0,1,0
37570,443,52731,443,allow,130,64,66,3,6,2,1
54905,445,0,0,drop,70,70,0,1,0,1,0
11133,51505,0,0,deny,66,66,0,1,0,1,0
61147,22114,0,0,deny,66,66,0,1,0,1,0
28306,25604,0,0,deny,62,62,0,1,0,1,0
55010,53,38368,53,allow,190,97,93,2,31,1,1
53804,445,0,0,drop,70,70,0,1,0,1,0
50471,80,51148,80,allow,1658,1247,411,8,15,5,3
36476,5228,61709,5228,allow,21282,7311,13971,96,1216,47,49
52025,42442,45647,42442,allow,70,70,0,1,4,1,0
55437,445,0,0,drop,66,66,0,1,0,1,0
57987,56125,0,0,deny,90,90,0,1,0,1,0
58949,445,0,0,drop,66,66,0,1,0,1,0
39381,53,0,0,allow,82,82,0,1,31,1,0
56556,53,39317,53,allow,762,97,665,2,30,1,1
54342,80,39601,80,allow,1515,481,1034,11,16,6,5
50689,443,50217,443,allow,152,86,66,2,4,1,1
56601,53,46710,53,allow,177,94,83,2,30,1,1
58886,443,31172,443,allow,3404,2124,1280,18,135,10,8
51826,58925,47237,58925,allow,70,70,0,1,4,1,0
49782,443,2557,443,allow,7757,1997,5760,23,126,13,10
49160,1171,0,0,deny,146,146,0,1,0,1,0
57422,53,50721,53,allow,747,90,657,2,30,1,1
51938,80,16530,80,allow,4424,3281,1143,12,27,8,4
5223,44091,0,0,deny,220,220,0,1,0,1,0
58717,443,32923,443,allow,280,140,140,5,130,3,2
59282,51050,0,0,deny,62,62,0,1,0,1,0
59345,25174,0,0,deny,62,62,0,1,0,1,0
63230,443,3094,443,allow,1309,670,639,16,127,9,7
50746,443,7838,443,allow,6354,1372,4982,18,161,9,9
20270,3478,6426,3478,allow,443,294,149,2,300,1,1
57448,53,10658,53,allow,177,94,83,2,29,1,1
55045,443,7851,443,allow,4660,3048,1612,31,81,15,16
50865,445,0,0,drop,66,66,0,1,0,1,0
5881,53,5881,53,allow,231,90,141,2,31,1,1
49958,36829,0,0,deny,66,66,0,1,0,1,0
58850,443,9120,443,allow,18715,10778,7937,39,96,16,23
51589,80,62521,80,allow,2091,1098,993,21,300,11,10
50134,53,40420,53,allow,733,86,647,2,31,1,1
61836,443,61836,443,allow,132180,4407,127773,146,75,51,95
24450,48817,0,0,deny,157,157,0,1,0,1,0
54458,443,1235,443,allow,3885,2355,1530,26,270,13,13
50442,25174,0,0,deny,62,62,0,1,0,1,0
50584,40926,15001,40926,allow,166,166,0,1,1199,1,0
42286,5228,46877,5228,allow,3489,1598,1891,25,631,7,18
55687,53,17643,53,allow,731,85,646,2,31,1,1
49701,53,52830,53,allow,488,110,378,4,32,2,2
56878,53,24786,53,allow,168,86,82,2,31,1,1
65183,53,44616,53,allow,718,94,624,2,31,1,1
49930,443,7030,443,allow,7934,1836,6098,23,15,13,10
65098,445,0,0,drop,70,70,0,1,0,1,0
27969,25174,0,0,deny,66,66,0,1,0,1,0
57106,53,8204,53,allow,760,97,663,2,31,1,1
25565,30367,0,0,deny,60,60,0,1,0,1,0
54056,443,63986,443,allow,8340,3417,4923,20,75,11,9
35961,80,62048,80,allow,11575,902,10673,20,46,11,9
58681,36829,0,0,deny,74,74,0,1,0,1,0
46509,53,4834,53,allow,168,78,90,2,30,1,1
50164,445,0,0,drop,70,70,0,1,0,1,0
62643,445,0,0,drop,66,66,0,1,0,1,0
57433,21247,0,0,deny,66,66,0,1,0,1,0
64430,53,41812,53,allow,493,91,402,4,31,2,2
56837,53,14391,53,allow,195,102,93,2,33,1,1
21365,23718,0,0,deny,62,62,0,1,0,1,0
6881,51413,48817,51413,allow,200,111,89,2,1200,1,1
42380,443,32272,443,allow,1622,1137,485,11,26,7,4
58638,5900,0,0,deny,62,62,0,1,0,1,0
52012,445,0,0,drop,70,70,0,1,0,1,0
49740,53,20760,53,allow,166,85,81,2,30,1,1
41630,15000,14960,15000,allow,130,70,60,2,5,1,1
64077,25174,0,0,deny,62,62,0,1,0,1,0
123,123,42021,123,allow,184,94,90,2,30,1,1
42716,443,52714,443,allow,12561,2901,9660,29,17,15,14
53745,18569,18242,18569,allow,70,70,0,1,5,1,0
60052,37965,0,0,deny,66,66,0,1,0,1,0
57979,443,3610,443,allow,7970957,82522,7888435,6370,179,1027,5343
52165,49740,56721,49740,allow,70,70,0,2,8,2,0
64923,25174,0,0,deny,66,66,0,1,0,1,0
45964,5333,0,0,deny,60,60,0,1,0,1,0
39068,443,31079,443,allow,10831,1381,9450,22,20,12,10
64335,443,56064,443,allow,230615,48569,182046,379,176,157,222
57332,53,48938,53,allow,168,86,82,2,30,1,1
51968,43622,30970,43622,allow,70,70,0,1,4,1,0
51938,11218,41228,11218,allow,70,70,0,1,5,1,0
55899,443,47257,443,allow,4819,2304,2515,16,135,8,8
11136,17500,0,0,deny,62,62,0,1,0,1,0
56954,80,1117,80,allow,1469,970,499,9,65,6,3
51842,80,51842,80,allow,407760,15074,392686,424,25,154,270
443,63113,0,0,deny,100,100,0,1,0,1,0
55906,53,30212,53,allow,264,110,154,2,30,1,1
50432,445,0,0,drop,66,66,0,1,0,1,0
33664,80,55691,80,allow,70,70,0,1,5,1,0
58638,5900,0,0,deny,62,62,0,1,0,1,0
57673,445,0,0,drop,66,66,0,1,0,1,0
55392,53,63211,53,allow,418,94,324,2,30,1,1
59761,445,0,0,drop,70,70,0,1,0,1,0
51455,443,21298,443,allow,8618,3110,5508,34,1695,18,16
49720,443,54089,443,allow,4936,855,4081,17,52,7,10
59936,443,17847,443,allow,34167,3638,30529,50,200,23,27
61711,80,55600,80,allow,4448,2223,2225,18,49,10,8
49779,443,29819,443,allow,10057,1887,8170,23,126,12,11
55145,11392,0,0,deny,66,66,0,1,0,1,0
1972,57470,0,0,deny,78,78,0,1,0,1,0
59793,443,27595,443,allow,840,456,384,14,25,8,6
56961,80,26352,80,allow,5885,3796,2089,16,30,10,6
38781,51505,0,0,deny,62,62,0,1,0,1,0
60884,443,60884,443,allow,4918,1626,3292,17,17,10,7
55265,53,4151,53,allow,199,102,97,2,30,1,1
53953,34661,36111,34661,allow,552,306,246,9,15,5,4
40953,443,21244,443,allow,4093,1595,2498,23,15,12,11
54356,80,42803,80,allow,9608,746,8862,19,82,9,10
65501,445,0,0,drop,70,70,0,1,0,1,0
8836,53,8836,53,allow,203,82,121,2,30,1,1
49588,445,0,0,drop,66,66,0,1,0,1,0
50877,443,13364,443,allow,7984,2447,5537,41,2904,24,17
49916,53,52400,53,allow,395,111,284,2,31,1,1
58917,53,38602,53,allow,192,82,110,2,30,1,1
53257,443,51156,443,allow,8715,1814,6901,26,29,15,11
60113,22114,0,0,deny,66,66,0,1,0,1,0
58844,51505,0,0,deny,66,66,0,1,0,1,0
54601,26467,0,0,deny,66,66,0,1,0,1,0
5087,22114,0,0,deny,62,62,0,1,0,1,0
44205,443,40929,443,allow,13019,4593,8426,71,350,34,37
52973,57470,0,0,deny,74,74,0,1,0,1,0
56664,443,31995,443,allow,7561,2483,5078,26,20,13,13
53140,443,40797,443,allow,8349,1987,6362,23,30,12,11
27209,30170,0,0,deny,145,145,0,1,0,1,0
53194,35440,0,0,deny,66,66,0,1,0,1,0
55384,53,33566,53,allow,212,102,110,2,30,1,1
38281,37807,0,0,deny,62,62,0,1,0,1,0
60408,443,33443,443,allow,7282,1596,5686,21,79,11,10
49531,53,3594,53,allow,182,93,89,2,31,1,1
44864,443,47449,443,allow,8779,1861,6918,34,120,17,17
62489,445,0,0,drop,66,66,0,1,0,1,0
53852,445,0,0,drop,70,70,0,1,0,1,0
50692,445,0,0,drop,66,66,0,1,0,1,0
64798,53,6106,53,allow,177,94,83,2,29,1,1
45859,443,65407,443,allow,5508,999,4509,20,255,11,9
58769,443,51640,443,allow,3923,2459,1464,17,17,8,9
64835,53,60535,53,allow,200,102,98,2,31,1,1
27005,27022,12480,27022,allow,1882,378,1504,6,31,4,2
53818,15337,26034,15337,allow,164,70,94,2,4,1,1
51281,445,0,0,drop,70,70,0,1,0,1,0
55644,445,0,0,drop,70,70,0,1,0,1,0
53626,30317,0,0,deny,66,66,0,1,0,1,0
56823,50291,65479,50291,allow,316,136,180,6,6,3,3
60044,443,17036,443,allow,15769,1619,14150,17,141,4,13
41999,80,10138,80,allow,38137,1920,36217,51,81,24,27
59745,53635,0,0,deny,66,66,0,1,0,1,0
48462,80,48462,80,allow,19738,890,18848,25,20,9,16
65112,53,1739,53,allow,209,110,99,2,31,1,1
38447,443,18020,443,allow,9824,2902,6922,38,48,19,19
9326,443,61009,443,allow,3616,429,3187,11,15,6,5
50236,25174,0,0,deny,66,66,0,1,0,1,0
53449,445,0,0,drop,66,66,0,1,0,1,0
61772,445,0,0,drop,66,66,0,1,0,1,0
65014,53,11511,53,allow,718,94,624,2,29,1,1
37097,80,49884,80,allow,1114,534,580,12,15,7,5
57049,445,0,0,drop,66,66,0,1,0,1,0
52064,22114,0,0,deny,62,62,0,1,0,1,0
16654,50265,0,0,deny,62,62,0,1,0,1,0
14438,51505,0,0,deny,146,146,0,1,0,1,0
55596,53,30266,53,allow,194,102,92,2,31,1,1
61230,22114,0,0,deny,66,66,0,1,0,1,0
53557,39731,45884,39731,allow,70,70,0,1,5,1,0
56630,443,6016,443,allow,7941,1952,5989,20,15,11,9
37565,443,47595,443,allow,8553,3392,5161,25,202,13,12
33260,443,40517,443,allow,4051,2618,1433,21,23,13,8
64614,53,55255,53,allow,168,86,82,2,30,1,1
50052,65008,0,0,deny,60,60,0,1,0,1,0
9158,53,9158,53,allow,237,91,146,2,33,1,1
57219,5223,28908,5223,allow,9687,5105,4582,30,298,16,14
57959,21247,0,0,deny,66,66,0,1,0,1,0
56411,53,33416,53,allow,184,94,90,2,31,1,1
61433,443,18649,443,allow,7796,766,7030,16,27,8,8
59875,445,0,0,drop,70,70,0,1,0,1,0
54114,445,0,0,drop,70,70,0,1,0,1,0
60308,443,63284,443,allow,2622412,144918,2477494,3052,316,1078,1974
17781,50265,0,0,deny,145,145,0,1,0,1,0
55457,443,46084,443,allow,8447,2129,6318,26,250,15,11
57023,443,30630,443,allow,10514,2031,8483,28,149,12,16
55203,445,0,0,drop,70,70,0,1,0,1,0
57437,53,35666,53,allow,193,102,91,2,30,1,1
58974,80,55839,80,allow,214,140,74,4,15,3,1
58424,52700,0,0,deny,66,66,0,1,0,1,0
51581,22114,0,0,deny,66,66,0,1,0,1,0
60033,443,16938,443,allow,2845,1765,1080,15,142,8,7
60617,445,0,0,drop,66,66,0,1,0,1,0
65391,53,47962,53,allow,720,94,626,2,30,1,1
63589,443,25041,443,allow,19134,2422,16712,49,120,22,27
55043,443,10001,443,allow,36707,3750,32957,54,60,24,30
56490,443,62341,443,allow,11756,4004,7752,26,121,12,14
65285,44847,0,0,deny,62,62,0,1,0,1,0
64776,50584,0,0,deny,62,62,0,1,0,1,0
46378,443,41415,443,allow,10675,4478,6197,25,16,13,12
65276,53,33888,53,allow,226,86,140,2,30,1,1
59119,53,4964,53,allow,168,78,90,2,30,1,1
30800,25174,0,0,deny,62,62,0,1,0,1,0
64461,53,2582,53,allow,177,94,83,2,30,1,1
50660,80,51110,80,allow,1658,1247,411,8,15,5,3
56715,443,60472,443,allow,8005,1985,6020,20,15,11,9
52102,443,62995,443,allow,343074,14649,328425,390,41,159,231
65333,445,0,0,drop,70,70,0,1,0,1,0
55667,53,30119,53,allow,305,126,179,2,30,1,1
61744,11392,0,0,deny,66,66,0,1,0,1,0
62859,35440,0,0,deny,66,66,0,1,0,1,0
59884,443,44531,443,allow,6622,2246,4376,21,46,12,9
47788,30170,0,0,deny,146,146,0,1,0,1,0
33244,443,30372,443,allow,4239,2487,1752,19,16,11,8
49160,44512,0,0,deny,146,146,0,1,0,1,0
64029,445,0,0,drop,70,70,0,1,0,1,0
52395,445,0,0,drop,66,66,0,1,0,1,0
23021,25174,0,0,deny,62,62,0,1,0,1,0
57004,80,5611,80,allow,214,140,74,4,30,3,1
62276,445,0,0,drop,70,70,0,1,0,1,0
58087,123,31892,123,allow,184,94,90,2,30,1,1
36084,80,36084,80,allow,514,246,268,9,76,5,4
46785,53,46785,53,allow,230,91,139,2,30,1,1
59245,445,0,0,drop,70,70,0,1,0,1,0
51155,56205,0,0,deny,66,66,0,1,0,1,0
49406,53,22949,53,allow,215,102,113,2,30,1,1
51240,445,0,0,drop,66,66,0,1,0,1,0
54323,445,0,0,drop,66,66,0,1,0,1,0
57664,443,45877,443,allow,5111,2193,2918,19,120,9,10
65287,53,49493,53,allow,180,94,86,2,30,1,1
56072,445,0,0,drop,70,70,0,1,0,1,0
56350,445,0,0,drop,66,66,0,1,0,1,0
56848,19556,62974,19556,allow,70,70,0,2,8,2,0
59841,80,53537,80,allow,711697,18422,693275,716,50,253,463
64586,53,19634,53,allow,252,94,158,2,31,1,1
52209,445,0,0,drop,70,70,0,1,0,1,0
65216,53,15859,53,allow,994,86,908,2,30,1,1
49300,443,31684,443,allow,4364,2129,2235,12,121,6,6
52846,80,43511,80,allow,3626,1778,1848,36,143,19,17
49265,445,0,0,drop,70,70,0,1,0,1,0
59775,443,41953,443,allow,4951,711,4240,15,29,8,7
57157,445,0,0,drop,66,66,0,1,0,1,0
50849,445,0,0,drop,66,66,0,1,0,1,0
52033,50584,0,0,deny,66,66,0,1,0,1,0
39742,62413,0,0,deny,66,66,0,1,0,1,0
52175,443,52175,443,allow,506908,20303,486605,548,25,204,344
50169,445,0,0,drop,66,66,0,1,0,1,0
49472,53,52589,53,allow,209,102,107,2,30,1,1
41741,443,63716,443,allow,20594,4629,15965,46,317,29,17
60450,56494,22867,56494,allow,70,70,0,2,8,2,0
58638,5900,0,0,deny,62,62,0,1,0,1,0
49579,445,0,0,drop,70,70,0,1,0,1,0
58638,5900,0,0,deny,62,62,0,1,0,1,0
52984,445,0,0,drop,66,66,0,1,0,1,0
59061,445,0,0,drop,70,70,0,1,0,1,0
51554,445,0,0,drop,70,70,0,1,0,1,0
64602,53,4497,53,allow,184,94,90,2,30,1,1
59945,80,11723,80,allow,1197,419,778,9,16,5,4
63560,53,63560,53,allow,209,79,130,2,30,1,1
63998,53,51868,53,allow,263,126,137,2,30,1,1
37939,80,33562,80,allow,1616,1302,314,10,15,5,5
65484,53,31170,53,allow,195,102,93,2,30,1,1
49408,53,3483,53,allow,252,102,150,2,30,1,1
10034,53,10034,53,allow,215,98,117,2,29,1,1
52079,1024,34017,1024,allow,70,70,0,2,8,2,0
49660,53,23772,53,allow,193,102,91,2,30,1,1
55455,443,13171,443,allow,1786,172,1614,7,120,3,4
13285,29892,0,0,deny,145,145,0,1,0,1,0
18116,37807,0,0,deny,62,62,0,1,0,1,0
54139,80,14592,80,allow,1515,481,1034,11,15,6,5
37034,25174,0,0,deny,146,146,0,1,0,1,0
57730,445,0,0,drop,66,66,0,1,0,1,0
52179,443,33825,443,allow,7439,1156,6283,19,75,11,8
65165,53,64230,53,allow,177,94,83,2,30,1,1
64245,53,26898,53,allow,199,102,97,2,30,1,1
55552,53,38672,53,allow,767,102,665,2,30,1,1
61822,53,61822,53,allow,237,91,146,2,33,1,1
47682,20541,0,0,deny,62,62,0,1,0,1,0
56794,46824,0,0,deny,66,66,0,1,0,1,0
56596,53,31877,53,allow,350,94,256,2,30,1,1
59663,37965,0,0,deny,66,66,0,1,0,1,0
55887,53,55333,53,allow,212,94,118,2,30,1,1
56745,445,0,0,drop,66,66,0,1,0,1,0
34456,80,16801,80,allow,2913,633,2280,15,16,8,7
63585,445,0,0,drop,66,66,0,1,0,1,0
64876,53,58020,53,allow,737,94,643,2,30,1,1
45941,23386,0,0,deny,60,60,0,1,0,1,0
63751,17102,12860,17102,allow,312,132,180,6,6,3,3
16454,25174,0,0,deny,62,62,0,1,0,1,0
0,0,0,0,deny,98,98,0,1,0,1,0
42298,40017,13967,40017,allow,148,86,62,2,30,1,1
58362,443,29130,443,allow,13272,2360,10912,37,208,19,18
41785,443,3150,443,allow,13183,1682,11501,26,78,12,14
25523,35974,0,0,deny,62,62,0,1,0,1,0
19790,35440,0,0,deny,146,146,0,1,0,1,0
46409,35440,0,0,deny,62,62,0,1,0,1,0
54868,445,0,0,drop,70,70,0,1,0,1,0
58638,5900,0,0,deny,62,62,0,1,0,1,0
57275,53,22195,53,allow,199,102,97,2,31,1,1
58841,443,21745,443,allow,18238,3980,14258,61,152,27,34
56269,53,62645,53,allow,816,102,714,2,30,1,1
63295,445,0,0,drop,70,70,0,1,0,1,0
56335,53,52497,53,allow,193,102,91,2,30,1,1
63334,445,0,0,drop,70,70,0,1,0,1,0
65117,53,5041,53,allow,196,100,96,2,31,1,1
40165,443,53877,443,allow,232,172,60,3,5,2,1
57351,53,50583,53,allow,177,94,83,2,30,1,1
65461,445,0,0,drop,70,70,0,1,0,1,0
58805,445,0,0,drop,70,70,0,1,0,1,0
64439,445,0,0,drop,70,70,0,1,0,1,0
63908,445,0,0,drop,66,66,0,1,0,1,0
49177,53,24852,53,allow,184,94,90,2,30,1,1
56955,53,43873,53,allow,183,94,89,2,30,1,1
5213,44847,0,0,deny,66,66,0,1,0,1,0
53930,443,55523,443,allow,33489,2768,30721,44,121,17,27
65028,53,48786,53,allow,182,93,89,2,31,1,1
64791,443,34950,443,allow,4725,1727,2998,11,121,6,5
57768,37965,0,0,deny,62,62,0,1,0,1,0
65482,53,62841,53,allow,374,91,283,4,33,2,2
49307,53,61453,53,allow,210,102,108,2,29,1,1
61419,57470,0,0,deny,66,66,0,1,0,1,0
41447,26467,0,0,deny,62,62,0,1,0,1,0
62517,445,0,0,drop,70,70,0,1,0,1,0
58664,64147,0,0,deny,66,66,0,1,0,1,0
37621,443,45461,443,allow,27993,2483,25510,51,48,25,26
51889,80,18568,80,allow,15867,8841,7026,29,29,16,13
19634,64147,0,0,deny,62,62,0,1,0,1,0
1955,35974,0,0,deny,60,60,0,1,0,1,0
40204,40026,38971,40026,allow,148,86,62,2,30,1,1
54222,443,54407,443,allow,499,425,74,4,0,3,1
59868,443,32881,443,allow,502,250,252,9,26,5,4
49861,53,46345,53,allow,261,94,167,2,30,1,1
5151,50584,0,0,deny,62,62,0,1,0,1,0
49747,37965,0,0,deny,62,62,0,1,0,1,0
64800,445,0,0,drop,70,70,0,1,0,1,0
65264,53,2001,53,allow,738,86,652,2,30,1,1
56383,445,0,0,drop,70,70,0,1,0,1,0
55504,445,0,0,drop,70,70,0,1,0,1,0
58929,443,63640,443,allow,6160,4121,2039,22,17,11,11
60469,60092,64603,60092,allow,70,70,0,2,8,2,0
50116,22,0,0,deny,60,60,0,1,0,1,0
18904,57470,0,0,deny,62,62,0,1,0,1,0
55296,23718,0,0,deny,66,66,0,1,0,1,0
49702,80,5138,80,allow,71256,962,70294,63,52,11,52
50108,53,40711,53,allow,179,94,85,2,30,1,1
62619,3389,62619,3389,allow,3504,1790,1714,17,34,9,8
49932,53,55615,53,allow,195,102,93,2,30,1,1
45726,64147,0,0,deny,62,62,0,1,0,1,0
55476,80,7666,80,allow,498,280,218,8,26,5,3
58143,445,0,0,drop,70,70,0,1,0,1,0
64177,445,0,0,drop,70,70,0,1,0,1,0
50986,445,0,0,drop,70,70,0,1,0,1,0
61826,445,0,0,drop,70,70,0,1,0,1,0
55330,445,0,0,drop,70,70,0,1,0,1,0
41528,161,0,0,allow,14381,5620,8761,50,30,25,25
8986,443,12105,443,allow,8062,2804,5258,43,161,20,23
63888,57470,0,0,deny,62,62,0,1,0,1,0
53015,445,0,0,drop,70,70,0,1,0,1,0
52686,53,56390,53,allow,199,94,105,2,30,1,1
57861,445,0,0,drop,66,66,0,1,0,1,0
51602,445,0,0,drop,70,70,0,1,0,1,0
51078,443,51078,443,allow,71902,4007,67895,98,127,40,58
35915,80,21762,80,allow,1283,644,639,9,146,5,4
56327,53,21642,53,allow,178,94,84,2,29,1,1
58373,445,0,0,drop,66,66,0,1,0,1,0
53470,53,29709,53,allow,168,78,90,2,30,1,1
37977,443,37977,443,allow,5763,2553,3210,24,80,14,10
52210,445,0,0,drop,70,70,0,1,0,1,0
59358,445,0,0,drop,70,70,0,1,0,1,0
56357,445,0,0,drop,70,70,0,1,0,1,0
55978,445,0,0,drop,70,70,0,1,0,1,0
56537,445,0,0,drop,70,70,0,1,0,1,0
56718,50584,0,0,deny,62,62,0,1,0,1,0
49276,53,23238,53,allow,199,102,97,2,29,1,1
51300,64147,0,0,deny,62,62,0,1,0,1,0
40054,62413,0,0,deny,62,62,0,1,0,1,0
59529,445,0,0,drop,66,66,0,1,0,1,0
16377,21247,0,0,deny,62,62,0,1,0,1,0
60962,53,0,0,allow,180,80,100,2,31,1,1
56313,53,23049,53,allow,198,102,96,2,30,1,1
52054,443,46268,443,allow,9339,4411,4928,20,135,10,10
33200,443,11701,443,allow,67123,10708,56415,100,124,41,59
39059,443,37868,443,allow,3221,1299,1922,15,19,9,6
62948,445,0,0,drop,70,70,0,1,0,1,0
65352,53,23820,53,allow,416,102,314,2,30,1,1
56429,80,57755,80,allow,17188,1559,15629,25,25,10,15
64140,53,22655,53,allow,306,94,212,4,33,2,2
60287,445,0,0,drop,66,66,0,1,0,1,0
49652,445,0,0,drop,70,70,0,1,0,1,0
62902,32468,0,0,deny,66,66,0,1,0,1,0
51974,54759,44353,54759,allow,70,70,0,1,4,1,0
58305,18375,0,0,deny,62,62,0,1,0,1,0
58124,80,58124,80,allow,125299,3364,121935,129,19,44,85
64934,53,64886,53,allow,197,102,95,2,30,1,1
61808,18375,0,0,deny,66,66,0,1,0,1,0
56204,53,48985,53,allow,168,86,82,2,30,1,1
52838,443,32099,443,allow,207289,9233,198056,234,136,83,151
26792,37965,0,0,deny,62,62,0,1,0,1,0
52356,55442,0,0,deny,66,66,0,1,0,1,0
50607,445,0,0,drop,66,66,0,1,0,1,0
56117,445,0,0,drop,66,66,0,1,0,1,0
27153,992,0,0,deny,60,60,0,1,0,1,0
56673,53,13282,53,allow,183,94,89,2,30,1,1
52898,80,57619,80,allow,3020,1414,1606,30,118,16,14
56966,53,65099,53,allow,177,94,83,2,30,1,1
53973,445,0,0,drop,70,70,0,1,0,1,0
55324,445,0,0,drop,70,70,0,1,0,1,0
55516,53,62536,53,allow,211,102,109,2,30,1,1
35460,35440,0,0,deny,146,146,0,1,0,1,0
64767,443,64767,443,allow,4507,1600,2907,19,31,11,8
48022,5228,46270,5228,allow,10096,2251,7845,41,3747,16,25
10874,25174,0,0,deny,62,62,0,1,0,1,0
49562,53,28687,53,allow,198,94,104,2,30,1,1
54173,23,0,0,deny,60,60,0,1,0,1,0
65087,53,63765,53,allow,230,110,120,2,30,1,1
50311,443,61436,443,allow,466,392,74,4,0,3,1
51919,80,35345,80,allow,16004,8270,7734,32,57,17,15
36386,443,8343,443,allow,1209,709,500,14,28,8,6
61210,445,0,0,drop,70,70,0,1,0,1,0
11962,53,11962,53,allow,194,87,107,2,30,1,1
48676,53389,0,0,deny,60,60,0,1,0,1,0
63235,443,19696,443,allow,1373,734,639,17,96,10,7
52167,80,36480,80,allow,1734,800,934,10,16,6,4
57409,445,0,0,drop,70,70,0,1,0,1,0
64991,53,47067,53,allow,625,192,433,6,46,3,3
51615,53,53355,53,allow,207,86,121,2,30,1,1
8191,51221,0,0,deny,62,62,0,1,0,1,0
59900,3389,59900,3389,allow,4286,2261,2025,20,18,11,9
54183,445,0,0,drop,70,70,0,1,0,1,0
43597,443,44647,443,allow,47048,9293,37755,63,412,28,35
49117,443,48924,443,allow,9551,2173,7378,33,27,17,16
39416,443,35535,443,allow,32732,6260,26472,69,217,34,35
61313,445,0,0,drop,70,70,0,1,0,1,0
49726,443,20489,443,allow,5393,1263,4130,21,18,11,10
49786,443,10389,443,allow,8941,1816,7125,27,15,15,12
59728,80,65227,80,allow,821011,16040,804971,778,100,238,540
60207,445,0,0,drop,70,70,0,1,0,1,0
64788,53,47380,53,allow,168,86,82,2,30,1,1
51962,443,60648,443,allow,8600,1735,6865,27,25,14,13
34044,161,0,0,allow,18549,5061,13488,54,30,27,27
54314,445,0,0,drop,66,66,0,1,0,1,0
60464,11385,6156,11385,allow,1090,712,378,16,26,10,6
50052,65010,0,0,deny,60,60,0,1,0,1,0
59408,443,57336,443,allow,2914,1780,1134,16,15,8,8
55440,445,0,0,drop,70,70,0,1,0,1,0
50421,80,60680,80,allow,7162,3201,3961,19,27,11,8
64484,53,23929,53,allow,86,86,0,1,30,1,0
33287,57354,0,0,deny,145,145,0,1,0,1,0
34883,443,14501,443,allow,51393,3538,47855,70,30,29,41
54197,443,61116,443,allow,190,70,120,4,15,2,2
61242,35253,0,0,deny,66,66,0,1,0,1,0
57287,53,47799,53,allow,305,102,203,2,29,1,1
57670,80,41385,80,allow,2274,1660,614,21,15,11,10
62980,445,0,0,drop,70,70,0,1,0,1,0
52657,445,0,0,drop,66,66,0,1,0,1,0
16293,57470,0,0,deny,62,62,0,1,0,1,0
52921,443,44773,443,allow,36892,20283,16609,191,116,77,114
53974,26108,47325,26108,allow,70,70,0,1,4,1,0
42654,443,18143,443,allow,3650,2162,1488,25,80,13,12
28122,443,63914,443,allow,7808,2487,5321,34,446,16,18
56381,51505,0,0,deny,62,62,0,1,0,1,0
51622,445,0,0,drop,70,70,0,1,0,1,0
23807,44847,0,0,deny,66,66,0,1,0,1,0
22150,6881,0,0,deny,62,62,0,1,0,1,0
60405,64722,47645,64722,allow,70,70,0,2,8,2,0
27005,27015,32807,27015,allow,1622,126,1496,4,30,2,2
61711,445,0,0,drop,70,70,0,1,0,1,0
16387,26193,0,0,deny,60,60,0,1,0,1,0
61385,445,0,0,drop,66,66,0,1,0,1,0
40185,64147,0,0,deny,66,66,0,1,0,1,0
54235,445,0,0,drop,70,70,0,1,0,1,0
56071,53,32735,53,allow,193,102,91,2,31,1,1
50095,445,0,0,drop,66,66,0,1,0,1,0
64845,53,4147,53,allow,289,110,179,2,30,1,1
59561,445,0,0,drop,66,66,0,1,0,1,0
6842,42873,0,0,deny,66,66,0,1,0,1,0
49175,53,45258,53,allow,193,102,91,2,31,1,1
17734,53,17734,53,allow,217,90,127,2,30,1,1
60063,443,64614,443,allow,432803,9264,423539,427,141,135,292
52092,48658,51084,48658,allow,316,136,180,6,7,3,3
55051,443,30290,443,allow,6975,1243,5732,29,254,14,15
51834,80,36073,80,allow,366,240,126,7,32,5,2
51922,44847,0,0,deny,62,62,0,1,0,1,0
49201,445,0,0,drop,66,66,0,1,0,1,0
65131,53,1840,53,allow,168,86,82,2,29,1,1
39588,25174,0,0,deny,66,66,0,1,0,1,0
60409,44739,34320,44739,allow,70,70,0,2,8,2,0
59743,80,42514,80,allow,815748,15896,799852,777,90,244,533
57947,443,8723,443,allow,2791,1800,991,26,185,15,11
65317,51221,0,0,deny,78,78,0,1,0,1,0
63017,445,0,0,drop,66,66,0,1,0,1,0
64546,445,0,0,drop,70,70,0,1,0,1,0
52311,445,0,0,drop,70,70,0,1,0,1,0
60509,445,0,0,drop,66,66,0,1,0,1,0
56654,53,7518,53,allow,306,306,0,4,47,4,0
58790,445,0,0,drop,70,70,0,1,0,1,0
33640,443,55083,443,allow,10558,2530,8028,25,186,14,11
53760,45682,34507,45682,allow,70,70,0,2,7,2,0
49644,80,17566,80,allow,2950,601,2349,12,15,6,6
51952,50967,20758,50967,allow,70,70,0,1,5,1,0
57554,445,0,0,drop,66,66,0,1,0,1,0
50045,443,64654,443,allow,4551,2388,2163,16,120,8,8
63063,443,23701,443,allow,303,85,218,2,30,1,1
53881,11513,24027,11513,allow,320,140,180,6,5,3,3
55588,53,33689,53,allow,168,86,82,2,31,1,1
65087,53,12187,53,allow,413,170,243,6,30,3,3
62907,21,0,0,deny,60,60,0,1,0,1,0
55271,53,6211,53,allow,168,86,82,2,30,1,1
65470,445,0,0,drop,70,70,0,1,0,1,0
51311,445,0,0,drop,70,70,0,1,0,1,0
53917,443,58017,443,allow,499,425,74,4,0,3,1
55332,53,52188,53,allow,211,110,101,2,30,1,1
49164,443,45916,443,allow,7292,950,6342,19,75,9,10
55536,445,0,0,drop,70,70,0,1,0,1,0
49555,445,0,0,drop,70,70,0,1,0,1,0
65411,53,34611,53,allow,354,102,252,2,30,1,1
56837,443,38721,443,allow,2349,258,2091,10,120,4,6
20253,53,20253,53,allow,404,259,145,3,33,2,1
43749,443,15009,443,allow,8900,2090,6810,26,80,14,12
53068,445,0,0,drop,70,70,0,1,0,1,0
50364,443,37739,443,allow,1727,926,801,15,30,7,8
60355,445,0,0,drop,70,70,0,1,0,1,0
55668,80,57634,80,allow,70,70,0,1,5,1,0
64934,53,52297,53,allow,197,102,95,2,33,1,1
55077,53,19465,53,allow,277,90,187,4,32,2,2
57571,443,57571,443,allow,881747,19604,862143,728,175,144,584
61415,443,64279,443,allow,6143,1796,4347,21,21,11,10
27064,51221,0,0,deny,72,72,0,1,0,1,0
56586,53,23269,53,allow,170,87,83,2,30,1,1
58023,445,0,0,drop,70,70,0,1,0,1,0
19963,2767,0,0,deny,66,66,0,1,0,1,0
52117,20600,3356,20600,allow,70,70,0,1,5,1,0
50529,80,9935,80,allow,12874,6770,6104,26,28,13,13
53580,48066,41215,48066,allow,70,70,0,2,8,2,0
47008,443,47008,443,allow,4373,1466,2907,19,27,11,8
28668,8696,0,0,deny,60,60,0,1,0,1,0
55678,445,0,0,drop,66,66,0,1,0,1,0
59013,445,0,0,drop,70,70,0,1,0,1,0
50497,443,10813,443,allow,1642025,26957,1615068,1478,17,406,1072
51453,445,0,0,drop,70,70,0,1,0,1,0
57607,21247,0,0,deny,66,66,0,1,0,1,0
50145,53,3618,53,allow,807,94,713,2,30,1,1
3377,50584,0,0,deny,66,66,0,1,0,1,0
56099,53,33681,53,allow,701,88,613,2,30,1,1
59982,443,64265,443,allow,7693,1284,6409,24,81,12,12
10014,40026,21058,40026,allow,156,94,62,2,30,1,1
64289,53,64357,53,allow,199,102,97,2,30,1,1
6881,51413,34368,51413,allow,207,118,89,2,1199,1,1
60449,28260,44457,28260,allow,70,70,0,2,8,2,0
42298,40031,8368,40031,allow,157,94,63,2,30,1,1
60999,445,0,0,drop,70,70,0,1,0,1,0
57374,53,58495,53,allow,216,102,114,2,30,1,1
28156,50584,0,0,deny,146,146,0,1,0,1,0
4015,23117,0,0,deny,62,62,0,1,0,1,0
50165,53,36668,53,allow,211,78,133,2,30,1,1
27005,27018,55202,27018,allow,881,126,755,2,30,1,1
54634,443,32455,443,allow,225732,7330,218402,246,174,86,160
54699,445,0,0,drop,70,70,0,1,0,1,0
55782,445,0,0,drop,70,70,0,1,0,1,0
57196,445,0,0,drop,70,70,0,1,0,1,0
50542,443,1665,443,allow,5779,1472,4307,22,78,12,10
49418,27015,59160,27015,allow,78,78,0,1,30,1,0
51725,32787,39792,32787,allow,70,70,0,2,8,2,0
60136,443,31780,443,allow,21278,12533,8745,57,183,36,21
50750,445,0,0,drop,66,66,0,1,0,1,0
47401,80,21233,80,allow,3158,1159,1999,14,16,8,6
63053,445,0,0,drop,70,70,0,1,0,1,0
30496,57470,0,0,deny,62,62,0,1,0,1,0
59581,445,0,0,drop,70,70,0,1,0,1,0
18771,35440,0,0,deny,66,66,0,1,0,1,0
21998,51221,0,0,deny,62,62,0,1,0,1,0
64807,53,32139,53,allow,246,118,128,2,29,1,1
56482,443,53337,443,allow,10788,6521,4267,61,134,31,30
57137,53,9212,53,allow,279,96,183,4,32,2,2
61614,53,61614,53,allow,257,101,156,2,33,1,1
56981,443,53338,443,allow,7238,2601,4637,20,22,10,10
49535,445,0,0,drop,66,66,0,1,0,1,0
49714,53,19961,53,allow,490,101,389,4,45,2,2
49901,53,39046,53,allow,193,102,91,2,29,1,1
41230,443,13536,443,allow,78,78,0,1,5,1,0
6881,30279,63096,30279,allow,150,150,0,1,1200,1,0
36754,443,36754,443,allow,4699,1792,2907,19,30,11,8
9146,443,17435,443,allow,10056,2310,7746,27,36,14,13
64045,445,0,0,drop,70,70,0,1,0,1,0
62482,443,44604,443,allow,4427,2362,2065,11,119,6,5
58691,445,0,0,drop,70,70,0,1,0,1,0
52459,33890,0,0,deny,60,60,0,1,0,1,0
52430,445,0,0,drop,70,70,0,1,0,1,0
64519,53,39794,53,allow,277,94,183,4,60,2,2
28899,37965,0,0,deny,62,62,0,1,0,1,0
57452,53,64588,53,allow,774,101,673,2,30,1,1
26332,57470,0,0,deny,62,62,0,1,0,1,0
54786,30188,0,0,deny,66,66,0,1,0,1,0
56997,53,59115,53,allow,711,87,624,2,30,1,1
51539,443,4046,443,allow,6359,1559,4800,24,19,13,11
49744,80,36258,80,allow,2455,475,1980,9,81,5,4
55851,53,15581,53,allow,749,94,655,2,30,1,1
39318,443,24928,443,allow,6933,2226,4707,33,140,18,15
18091,32480,0,0,deny,62,62,0,1,0,1,0
52434,80,48898,80,allow,1647,481,1166,13,15,6,7
46862,443,48242,443,allow,6162,925,5237,18,179,10,8
56753,38028,14806,38028,allow,156,66,90,2,5,1,1
51292,445,0,0,drop,70,70,0,1,0,1,0
57607,445,0,0,drop,66,66,0,1,0,1,0
31995,61689,0,0,deny,146,146,0,1,0,1,0
59844,445,0,0,drop,70,70,0,1,0,1,0
58399,56205,0,0,deny,62,62,0,1,0,1,0
55628,53,53766,53,allow,199,94,105,2,30,1,1
56382,53,27838,53,allow,195,102,93,2,30,1,1
51852,445,0,0,drop,70,70,0,1,0,1,0
5223,1210,0,0,deny,103,103,0,1,0,1,0
65380,53,23186,53,allow,180,94,86,2,30,1,1
60309,443,17740,443,allow,130,70,60,3,5,2,1
52642,445,0,0,drop,70,70,0,1,0,1,0
60159,22114,0,0,deny,66,66,0,1,0,1,0
50580,443,17458,443,allow,2723,1383,1340,29,37,16,13
44674,80,41945,80,allow,1298,624,674,12,16,5,7
57455,123,24910,123,allow,184,94,90,2,29,1,1
54194,445,0,0,drop,70,70,0,1,0,1,0
56000,53,49191,53,allow,177,94,83,2,30,1,1
50218,445,0,0,drop,70,70,0,1,0,1,0
58022,5601,0,0,deny,60,60,0,1,0,1,0
55497,445,0,0,drop,66,66,0,1,0,1,0
50022,80,11593,80,allow,10023148,180272,9842876,9438,193,2907,6531
55127,53,49558,53,allow,253,87,166,4,44,2,2
27005,27021,28946,27021,allow,879,126,753,2,31,1,1
49654,53,53040,53,allow,214,110,104,2,30,1,1
64911,53,45523,53,allow,209,110,99,2,30,1,1
52026,26467,0,0,deny,60,60,0,1,0,1,0
52028,53,0,0,allow,354,81,273,2,30,1,1
65034,445,0,0,drop,70,70,0,1,0,1,0
52087,443,46518,443,allow,5780,1646,4134,22,15,11,11
55224,53,26209,53,allow,711,87,624,2,31,1,1
35556,443,35556,443,allow,7201,1167,6034,16,131,8,8
17873,23117,0,0,deny,62,62,0,1,0,1,0
49598,445,0,0,drop,66,66,0,1,0,1,0
64117,53,64117,53,allow,209,77,132,2,32,1,1
53897,445,0,0,drop,66,66,0,1,0,1,0
55377,3389,55377,3389,allow,3343,1454,1889,15,16,8,7
56134,53,5515,53,allow,183,94,89,2,29,1,1
23776,57354,0,0,deny,145,145,0,1,0,1,0
49212,38306,22542,38306,allow,70,70,0,1,5,1,0
63935,51413,5308,51413,allow,312,132,180,6,7,3,3
3272,1433,0,0,deny,60,60,0,1,0,1,0
49930,53,6830,53,allow,361,94,267,2,30,1,1
56606,443,53334,443,allow,9679,1633,8046,25,20,14,11
64192,53,23253,53,allow,308,110,198,2,29,1,1
27005,27019,53599,27019,allow,881,126,755,2,30,1,1
55828,53,62076,53,allow,181,94,87,2,29,1,1
42727,53,0,0,allow,82,82,0,2,40,2,0
51498,443,51057,443,allow,29265,2836,26429,47,16,21,26
58716,9694,0,0,deny,62,62,0,1,0,1,0
56188,445,0,0,drop,70,70,0,1,0,1,0
30129,37965,0,0,deny,72,72,0,1,0,1,0
49160,28890,3522,28890,allow,830,150,680,4,1200,2,2
54998,53,33990,53,allow,179,94,85,2,30,1,1
49805,64147,0,0,deny,62,62,0,1,0,1,0
62829,445,0,0,drop,66,66,0,1,0,1,0
49256,443,30277,443,allow,10619,3257,7362,29,361,13,16
64467,53,41082,53,allow,548,194,354,6,63,3,3
60217,445,0,0,drop,70,70,0,1,0,1,0
3478,61463,0,0,deny,217,217,0,1,0,1,0
53189,80,57818,80,allow,1873,713,1160,10,15,5,5
49529,443,17894,443,allow,9047,1436,7611,22,27,10,12
64569,53,2461,53,allow,214,102,112,2,31,1,1
51535,443,24359,443,allow,322,262,60,2,4,1,1
39716,53,15462,53,allow,86,86,0,1,30,1,0
53967,54589,5598,54589,allow,70,70,0,2,8,2,0
51221,51413,20920,51413,allow,459,149,310,2,1200,1,1
64789,53,40256,53,allow,193,102,91,2,30,1,1
51838,29448,59159,29448,allow,70,70,0,1,5,1,0
64739,53,1998,53,allow,816,102,714,2,30,1,1
65266,53,53450,53,allow,233,102,131,2,29,1,1
60136,56205,0,0,deny,66,66,0,1,0,1,0
16358,50584,0,0,deny,146,146,0,1,0,1,0
65131,53,4831,53,allow,168,86,82,2,30,1,1
62081,443,56055,443,allow,3044,1694,1350,23,45,13,10
58638,5900,0,0,deny,62,62,0,1,0,1,0
52044,5824,26075,5824,allow,70,70,0,1,5,1,0
28385,50584,0,0,deny,146,146,0,1,0,1,0
55867,53,51725,53,allow,184,94,90,2,29,1,1
53956,445,0,0,drop,70,70,0,1,0,1,0
55218,53,56966,53,allow,402,142,260,2,30,1,1
42749,443,12087,443,allow,6172,1310,4862,28,468,10,18
49439,53,11369,53,allow,197,102,95,2,30,1,1
53305,50584,0,0,deny,66,66,0,1,0,1,0
58575,443,10441,443,allow,6453,1742,4711,20,17,10,10
61961,11392,0,0,deny,66,66,0,1,0,1,0
26503,80,26503,80,allow,225609,13986,211623,285,31,134,151
24202,53,24202,53,allow,220,90,130,2,29,1,1
51814,80,8693,80,allow,11975,2907,9068,24,38,14,10
2745,53,2745,53,allow,244,98,146,2,32,1,1
49384,53,48199,53,allow,193,102,91,2,31,1,1
49663,443,52474,443,allow,8161,1929,6232,26,46,15,11
27005,27999,21376,27999,allow,913,126,787,2,31,1,1
58638,5900,0,0,deny,62,62,0,1,0,1,0
56775,53,62594,53,allow,200,94,106,2,29,1,1
49479,56205,0,0,deny,66,66,0,1,0,1,0
43584,24748,0,0,deny,156,156,0,1,0,1,0
60902,443,20935,443,allow,924886,40519,884367,1075,65,442,633
57001,53,43521,53,allow,177,94,83,2,30,1,1
12645,22114,0,0,deny,146,146,0,1,0,1,0
50578,445,0,0,drop,66,66,0,1,0,1,0
56786,443,56786,443,allow,4381,1474,2907,19,27,11,8
45155,53,0,0,allow,226,86,140,2,29,1,1
15442,22114,0,0,deny,66,66,0,1,0,1,0
18796,443,17365,443,allow,2227,1018,1209,17,15,8,9
56497,80,9145,80,allow,410119,16112,394007,424,63,155,269
57416,53,53787,53,allow,193,102,91,2,30,1,1
5588,5588,0,0,allow,3498,1872,1626,48,195,24,24
50868,445,0,0,drop,70,70,0,1,0,1,0
49169,445,0,0,drop,70,70,0,1,0,1,0
45897,443,62629,443,allow,2267946,70852,2197094,2429,316,859,1570
5588,5588,0,0,allow,3354,1792,1562,46,193,23,23
55545,53,60601,53,allow,177,94,83,2,30,1,1
12737,35440,0,0,deny,62,62,0,1,0,1,0
65431,53,65431,53,allow,262,106,156,2,31,1,1
55807,53,4924,53,allow,257,102,155,2,29,1,1
50594,25174,0,0,deny,66,66,0,1,0,1,0
42231,57470,0,0,deny,78,78,0,1,0,1,0
53347,443,16972,443,allow,21456,6153,15303,120,491,46,74
32813,53,32813,53,allow,414,268,146,3,33,2,1
1609,53,1609,53,allow,197,90,107,2,30,1,1
37450,443,11367,443,allow,617919,23432,594487,706,39,297,409
63320,445,0,0,drop,66,66,0,1,0,1,0
56381,53,44431,53,allow,192,98,94,2,31,1,1
36561,2767,0,0,deny,62,62,0,1,0,1,0
53193,22,53193,22,deny,295,126,169,4,0,2,2
42184,53,42184,53,allow,334,226,108,3,30,2,1
49488,53,29306,53,allow,194,102,92,2,30,1,1
49226,443,49226,443,allow,118943,24432,94511,156,96,79,77
56783,53,24430,53,allow,199,102,97,2,31,1,1
52866,443,59183,443,allow,3101,801,2300,13,136,6,7
63560,443,29520,443,allow,2773,1570,1203,22,275,11,11
64756,11392,0,0,deny,146,146,0,1,0,1,0
37965,40840,26004,40840,allow,150,150,0,1,1199,1,0
32729,3389,32729,3389,allow,4021,1916,2105,20,18,12,8
55212,445,0,0,drop,70,70,0,1,0,1,0
37990,49152,47344,49152,allow,156,156,0,3,7,3,0
56252,443,19925,443,allow,6728,1775,4953,25,275,13,12
27995,22114,0,0,deny,146,146,0,1,0,1,0
50090,50265,0,0,deny,66,66,0,1,0,1,0
49999,53,62191,53,allow,316,91,225,4,46,2,2
49380,53,10250,53,allow,198,101,97,2,31,1,1
56515,53,8193,53,allow,177,94,83,2,29,1,1
57734,445,0,0,drop,66,66,0,1,0,1,0
52407,443,29892,443,allow,1043,556,487,10,16,6,4
26888,23,0,0,deny,60,60,0,1,0,1,0
56374,53,54087,53,allow,711,87,624,2,30,1,1
49396,53,21722,53,allow,177,94,83,2,30,1,1
53890,443,45559,443,allow,499,425,74,4,0,3,1
56143,445,0,0,drop,66,66,0,1,0,1,0
50064,445,0,0,drop,70,70,0,1,0,1,0
53155,443,52565,443,allow,3866,2774,1092,21,28,12,9
47733,443,46776,443,allow,556154,55291,500863,1146,559,440,706
49616,30188,0,0,deny,66,66,0,1,0,1,0
56255,44847,0,0,deny,66,66,0,1,0,1,0
57257,53,4922,53,allow,173,94,79,2,30,1,1
58709,443,26417,443,allow,7924,702,7222,17,16,7,10
50443,80,16210,80,allow,378,192,186,7,19,4,3
56572,53,50763,53,allow,438,180,258,6,30,3,3
63332,445,0,0,drop,70,70,0,1,0,1,0
5938,58817,0,0,allow,60,60,0,1,90,1,0
53256,443,59014,443,allow,29039,3057,25982,46,323,19,27
60121,443,30083,443,allow,6351,1857,4494,20,16,11,9
61489,443,14014,443,allow,7299,4561,2738,32,193,16,16
50126,443,42712,443,allow,8464,2699,5765,48,147,26,22
65304,53,18529,53,allow,209,110,99,2,30,1,1
64694,53,58763,53,allow,361,107,254,4,37,2,2
54458,445,0,0,drop,70,70,0,1,0,1,0
53100,443,19603,443,allow,472,406,66,4,0,3,1
50878,23,0,0,deny,60,60,0,1,0,1,0
39895,26467,0,0,deny,62,62,0,1,0,1,0
51099,80,52841,80,allow,3422,1962,1460,33,131,18,15
50307,80,42606,80,allow,3179,863,2316,13,57,7,6
56568,53,16992,53,allow,211,110,101,2,30,1,1
14613,12446,0,0,deny,66,66,0,1,0,1,0
50808,445,0,0,drop,70,70,0,1,0,1,0
62903,445,0,0,drop,70,70,0,1,0,1,0
54463,53,52007,53,allow,164,78,86,2,30,1,1
6014,37965,0,0,deny,66,66,0,1,0,1,0
60061,443,58385,443,allow,3195,1426,1769,15,141,8,7
49989,53,42243,53,allow,677,217,460,6,74,3,3
54304,445,0,0,drop,66,66,0,1,0,1,0
41220,59356,0,0,deny,62,62,0,1,0,1,0
51968,80,1754,80,allow,366,240,126,7,25,5,2
7347,56205,0,0,deny,62,62,0,1,0,1,0
0,0,0,0,allow,152,78,74,2,0,1,1
57328,53,13021,53,allow,1427,101,1326,4,48,2,2
55387,53,17527,53,allow,761,100,661,2,31,1,1
51528,445,0,0,drop,70,70,0,1,0,1,0
56652,443,14295,443,allow,1272,876,396,10,25,6,4
56921,443,49898,443,allow,8416,2142,6274,25,330,12,13
57126,53,50266,53,allow,183,94,89,2,30,1,1
57322,53,27268,53,allow,192,98,94,2,31,1,1
46275,64147,0,0,deny,62,62,0,1,0,1,0
63390,445,0,0,drop,70,70,0,1,0,1,0
63064,445,0,0,drop,70,70,0,1,0,1,0
59360,53,6794,53,allow,429,116,313,2,31,1,1
64998,27037,61288,27037,allow,3287,2072,1215,12,30,6,6
16387,44427,0,0,deny,60,60,0,1,0,1,0
58509,21247,0,0,deny,66,66,0,1,0,1,0
57638,80,57638,80,allow,29263,2432,26831,36,31,13,23
39924,443,50465,443,allow,5229,1002,4227,21,16,11,10
49174,53,1263,53,allow,166,86,80,2,31,1,1
47638,53,47638,53,allow,212,98,114,2,30,1,1
53260,443,37700,443,allow,572,292,280,9,33,5,4
64013,57470,0,0,deny,74,74,0,1,0,1,0
64517,53,39078,53,allow,194,102,92,2,31,1,1
63652,443,53205,443,allow,51005,2084,48921,61,120,22,39
55375,44847,0,0,deny,66,66,0,1,0,1,0
53772,14132,16590,14132,allow,70,70,0,2,8,2,0
63368,445,0,0,drop,70,70,0,1,0,1,0
52067,80,33886,80,allow,362,240,122,7,25,5,2
55981,80,16434,80,allow,824,469,355,9,360,5,4
55966,35440,0,0,deny,66,66,0,1,0,1,0
59971,445,0,0,drop,70,70,0,1,0,1,0
52194,22674,46846,22674,allow,70,70,0,2,8,2,0
64979,53,11759,53,allow,254,102,152,2,30,1,1
14618,6881,0,0,deny,66,66,0,1,0,1,0
57304,53,49312,53,allow,228,110,118,2,31,1,1
56505,443,54192,443,allow,78426,3219,75207,98,96,37,61
56336,445,0,0,drop,70,70,0,1,0,1,0
54955,445,0,0,drop,66,66,0,1,0,1,0
54496,445,0,0,drop,70,70,0,1,0,1,0
49300,445,0,0,drop,70,70,0,1,0,1,0
5180,57866,0,0,deny,66,66,0,1,0,1,0
61817,80,50485,80,allow,3373,591,2782,11,45,6,5
51891,23238,33315,23238,allow,70,70,0,2,8,2,0
52259,25011,50909,25011,allow,70,70,0,2,8,2,0
56670,443,55495,443,allow,8308,3589,4719,25,19,15,10
50496,443,2792,443,allow,751676,8792,742884,617,16,123,494
50722,80,43079,80,allow,7550,5292,2258,13,29,7,6
61294,445,0,0,drop,70,70,0,1,0,1,0
64788,43890,0,0,deny,66,66,0,1,0,1,0
64483,53,26683,53,allow,168,86,82,2,31,1,1
10115,52700,0,0,deny,62,62,0,1,0,1,0
36100,443,53812,443,allow,812,440,372,14,25,8,6
38350,80,18584,80,allow,1678,1364,314,10,16,5,5
49806,53,63116,53,allow,242,118,124,2,30,1,1
40457,443,34174,443,allow,5630,3451,2179,39,67,20,19
63359,445,0,0,drop,70,70,0,1,0,1,0
59373,445,0,0,drop,70,70,0,1,0,1,0
54450,445,0,0,drop,66,66,0,1,0,1,0
63984,445,0,0,drop,70,70,0,1,0,1,0
60645,35440,0,0,deny,66,66,0,1,0,1,0
53280,443,38767,443,allow,4228,1083,3145,15,31,8,7
51656,445,0,0,drop,70,70,0,1,0,1,0
55817,53,30944,53,allow,392,102,290,2,30,1,1
57352,53,35179,53,allow,196,102,94,2,30,1,1
50454,445,0,0,drop,70,70,0,1,0,1,0
41943,443,27053,443,allow,8385,3143,5242,35,98,18,17
60888,443,18783,443,allow,7454,3131,4323,23,46,13,10
50604,445,0,0,drop,66,66,0,1,0,1,0
55694,445,0,0,drop,70,70,0,1,0,1,0
12980,26296,0,0,deny,145,145,0,1,0,1,0
49527,53,19400,53,allow,200,94,106,2,30,1,1
30861,46783,0,0,deny,62,62,0,1,0,1,0
51815,80,14356,80,allow,3910,2158,1752,15,32,10,5
57311,53,54078,53,allow,211,102,109,2,30,1,1
44612,25174,0,0,deny,66,66,0,1,0,1,0
45374,443,48527,443,allow,88469,3492,84977,104,396,35,69
45184,80,27181,80,allow,1718,1404,314,11,15,6,5
65031,53,50837,53,allow,184,94,90,2,30,1,1
51320,37965,0,0,deny,62,62,0,1,0,1,0
49845,443,22803,443,allow,10396,4585,5811,38,54,21,17
49282,53,56718,53,allow,178,94,84,2,30,1,1
55580,53,25974,53,allow,190,97,93,2,30,1,1
51313,25174,0,0,deny,62,62,0,1,0,1,0
10688,25174,0,0,deny,146,146,0,1,0,1,0
55514,445,0,0,drop,70,70,0,1,0,1,0
65133,53,34896,53,allow,198,102,96,2,30,1,1
55609,39869,60499,39869,allow,70,70,0,1,5,1,0
56273,53,10176,53,allow,200,102,98,2,30,1,1
50223,445,0,0,drop,70,70,0,1,0,1,0
65029,445,0,0,drop,70,70,0,1,0,1,0
58721,443,55162,443,allow,7973,4166,3807,28,141,14,14
27368,22114,0,0,deny,62,62,0,1,0,1,0
36629,23117,0,0,deny,62,62,0,1,0,1,0
53748,51413,38549,51413,allow,70,70,0,2,7,2,0
6881,37321,46991,37321,allow,502,150,352,2,1199,1,1
27005,27016,2145,27016,allow,883,126,757,2,30,1,1
4862,37965,0,0,deny,66,66,0,1,0,1,0
49847,23,0,0,deny,60,60,0,1,0,1,0
60528,445,0,0,drop,70,70,0,1,0,1,0
55649,42266,41427,42266,allow,70,70,0,2,8,2,0
55879,53,32478,53,allow,200,94,106,2,30,1,1
46619,57470,0,0,deny,62,62,0,1,0,1,0
49244,80,49244,80,allow,661753,15722,646031,683,17,235,448
55644,53,20547,53,allow,184,94,90,2,30,1,1
49351,445,0,0,drop,70,70,0,1,0,1,0
58638,5900,0,0,deny,62,62,0,1,0,1,0
57432,53,52576,53,allow,186,95,91,2,31,1,1
49641,445,0,0,drop,70,70,0,1,0,1,0
30729,22114,0,0,deny,62,62,0,1,0,1,0
61591,22114,0,0,deny,146,146,0,1,0,1,0
53705,30600,18470,30600,allow,492,306,186,8,15,5,3
43531,53,58732,53,allow,199,94,105,2,30,1,1
62004,445,0,0,drop,70,70,0,1,0,1,0
39639,80,40156,80,allow,1143,401,742,9,360,5,4
54025,443,49847,443,allow,7653,1188,6465,21,16,12,9
63263,57470,0,0,deny,66,66,0,1,0,1,0
64751,53,29777,53,allow,172,88,84,2,30,1,1
48420,31755,0,0,deny,146,146,0,1,0,1,0
65304,53,24960,53,allow,195,102,93,2,31,1,1
64840,445,0,0,drop,70,70,0,1,0,1,0
56658,443,12805,443,allow,1560,988,572,13,23,7,6
50421,445,0,0,drop,66,66,0,1,0,1,0
44095,443,27127,443,allow,6109,3363,2746,60,615,33,27
58217,53,0,0,allow,266,85,181,2,30,1,1
6666,21,0,0,deny,60,60,0,1,0,1,0
65245,53,21925,53,allow,184,102,82,2,30,1,1
36902,443,18209,443,allow,10252,2152,8100,38,126,18,20
61591,80,1732,80,allow,124,64,60,2,16,1,1
52490,443,51639,443,allow,23518,8884,14634,32,15,15,17
51699,445,0,0,drop,70,70,0,1,0,1,0
55392,443,3923,443,allow,7347,2127,5220,18,135,8,10
58311,445,0,0,drop,66,66,0,1,0,1,0
54063,443,37024,443,allow,1313,652,661,13,185,7,6
53896,48027,7654,48027,allow,70,70,0,2,8,2,0
53762,9587,1266,9587,allow,70,70,0,2,7,2,0
46424,443,29456,443,allow,1340,760,580,14,39,8,6
57772,443,4338,443,allow,6783,3270,3513,22,120,11,11
51983,30472,5988,30472,allow,70,70,0,1,5,1,0
48856,53,0,0,allow,86,86,0,1,30,1,0
42384,443,16298,443,allow,8561,2300,6261,37,316,18,19
52859,445,0,0,drop,66,66,0,1,0,1,0
49197,53,54717,53,allow,214,102,112,2,30,1,1
51733,30688,48958,30688,allow,70,70,0,2,8,2,0
51927,63309,60569,63309,allow,70,70,0,1,5,1,0
49188,53,58733,53,allow,621,111,510,4,35,2,2
59933,80,46618,80,allow,1756,414,1342,12,15,6,6
55822,80,1122,80,allow,1052,612,440,10,16,5,5
57266,53,22077,53,allow,209,102,107,2,30,1,1
52161,443,17095,443,allow,1461,924,537,13,31,7,6
49294,445,0,0,drop,70,70,0,1,0,1,0
58594,445,0,0,drop,70,70,0,1,0,1,0
51920,30188,0,0,deny,66,66,0,1,0,1,0
52107,11191,13712,11191,allow,70,70,0,2,7,2,0
43837,443,18055,443,allow,5733,1543,4190,24,28,13,11
46082,443,8016,443,allow,137024,6442,130582,171,109,61,110
56348,445,0,0,drop,70,70,0,1,0,1,0
55450,64147,0,0,deny,66,66,0,1,0,1,0
50039,7000,50039,7000,allow,3050,1659,1391,16,15,9,7
50086,80,23658,80,allow,3148,687,2461,12,15,7,5
52148,443,33858,443,allow,375357,11451,363906,356,61,100,256
25565,58771,0,0,deny,60,60,0,1,0,1,0
57676,64147,0,0,deny,74,74,0,1,0,1,0
64276,26467,0,0,deny,66,66,0,1,0,1,0
60075,445,0,0,drop,66,66,0,1,0,1,0
56275,445,0,0,drop,66,66,0,1,0,1,0
53668,50678,24375,50678,allow,70,70,0,2,7,2,0
46112,53,33823,53,allow,168,78,90,2,30,1,1
49518,53,34801,53,allow,213,102,111,2,30,1,1
52223,11979,45106,11979,allow,70,70,0,1,5,1,0
59141,445,0,0,drop,70,70,0,1,0,1,0
61382,443,28176,443,allow,32082,12801,19281,62,150,25,37
55966,57866,0,0,deny,66,66,0,1,0,1,0
52069,443,58319,443,allow,8593,2221,6372,31,232,17,14
33688,80,62587,80,allow,1638,1324,314,10,16,5,5
55027,53,13864,53,allow,168,86,82,2,30,1,1
62557,445,0,0,drop,66,66,0,1,0,1,0
64404,53,48455,53,allow,224,94,130,2,30,1,1
58139,443,5557,443,allow,9521,5450,4071,30,120,15,15
19068,37965,0,0,deny,62,62,0,1,0,1,0
48706,23393,0,0,deny,60,60,0,1,0,1,0
60536,445,0,0,drop,70,70,0,1,0,1,0
52887,445,0,0,drop,70,70,0,1,0,1,0
10688,25174,0,0,deny,62,62,0,1,0,1,0
42578,443,53109,443,allow,3857,2757,1100,27,22,14,13
8978,53,8978,53,allow,1415,689,726,3,30,2,1
54924,443,37000,443,allow,62,62,0,1,4,1,0
49576,80,6202,80,allow,174140,4942,169198,166,65,47,119
8432,23,8432,23,allow,130,66,64,2,5,1,1
52019,40689,33926,40689,allow,70,70,0,1,5,1,0
62150,445,0,0,drop,70,70,0,1,0,1,0
5938,16167,0,0,allow,60,60,0,1,91,1,0
30114,65151,0,0,deny,60,60,0,1,0,1,0
52292,445,0,0,drop,70,70,0,1,0,1,0
38474,443,30004,443,allow,53562,2314,51248,64,31,24,40
49784,445,0,0,drop,66,66,0,1,0,1,0
60593,80,31498,80,allow,123436,6053,117383,165,241,83,82
38163,53,38163,53,allow,216,89,127,2,30,1,1
28830,37965,0,0,deny,62,62,0,1,0,1,0
55666,35440,0,0,deny,66,66,0,1,0,1,0
50130,53,36317,53,allow,179,94,85,2,30,1,1
443,22238,0,0,deny,112,112,0,1,0,1,0
53794,39607,26801,39607,allow,70,70,0,1,5,1,0
52459,5555,0,0,deny,60,60,0,1,0,1,0
47831,53,0,0,allow,86,86,0,1,30,1,0
57021,443,9946,443,allow,4697,1470,3227,20,131,9,11
61671,445,0,0,drop,66,66,0,1,0,1,0
49522,53,16817,53,allow,688,185,503,6,45,3,3
8884,443,38785,443,allow,5307,3288,2019,25,397,8,17
50439,80,50439,80,allow,96018,5956,90062,107,20,41,66
56627,443,11832,443,allow,7889,1900,5989,20,15,11,9
53192,80,30945,80,allow,814,335,479,10,15,5,5
35507,15503,0,0,deny,62,62,0,1,0,1,0
16403,16384,41860,16384,allow,122,62,60,2,30,1,1
60862,443,5299,443,allow,12604,6376,6228,27,133,16,11
10669,49756,0,0,deny,60,60,0,1,0,1,0
35205,53,35205,53,allow,240,98,142,2,30,1,1
44799,443,2515,443,allow,3467,2186,1281,16,15,9,7
58177,443,64098,443,allow,810,340,470,13,34,6,7
49286,53,16984,53,allow,184,94,90,2,31,1,1
56225,53,43887,53,allow,183,94,89,2,30,1,1
51815,51221,0,0,deny,74,74,0,1,0,1,0
49379,80,26229,80,allow,6307,2851,3456,18,150,9,9
51912,443,41941,443,allow,186,70,116,2,120,1,1
58574,445,0,0,drop,70,70,0,1,0,1,0
45844,443,26065,443,allow,44232,11223,33009,97,460,50,47
64974,53,53114,53,allow,214,110,104,2,30,1,1
51762,80,41389,80,allow,3945,2315,1630,18,74,11,7
48892,443,58975,443,allow,740,210,530,12,110,4,8
12477,80,12477,80,allow,6835,961,5874,17,27,9,8
56927,53,57010,53,allow,749,94,655,2,31,1,1
39038,443,14810,443,allow,3970,2230,1740,17,114,10,7
58638,5900,0,0,deny,62,62,0,1,0,1,0
55031,443,25745,443,allow,3625,1378,2247,14,135,7,7
51468,445,0,0,drop,66,66,0,1,0,1,0
49128,53,21318,53,allow,199,94,105,2,30,1,1
65522,445,0,0,drop,70,70,0,1,0,1,0
6881,6881,37919,6881,allow,238,118,120,2,1200,1,1
60695,445,0,0,drop,66,66,0,1,0,1,0
58638,5900,0,0,deny,62,62,0,1,0,1,0
55310,50584,0,0,deny,66,66,0,1,0,1,0
49774,80,42910,80,allow,254,128,126,5,15,3,2
46576,23718,0,0,deny,66,66,0,1,0,1,0
53876,53380,35736,53380,allow,70,70,0,2,8,2,0
57240,53,16899,53,allow,176,90,86,2,30,1,1
49624,53,37843,53,allow,216,94,122,2,30,1,1
50419,26467,0,0,deny,66,66,0,1,0,1,0
56646,53,16936,53,allow,177,94,83,2,29,1,1
59697,445,0,0,drop,66,66,0,1,0,1,0
49835,443,4788,443,allow,10066,4676,5390,27,123,15,12
55249,445,0,0,drop,66,66,0,1,0,1,0
56960,445,0,0,drop,70,70,0,1,0,1,0
34953,443,6409,443,allow,9415,3482,5933,57,16,29,28
60394,80,52231,80,allow,2047,701,1346,16,26,5,11
64914,53,55728,53,allow,168,86,82,2,30,1,1
64343,6004,0,0,deny,66,66,0,1,0,1,0
53873,52055,19487,52055,allow,70,70,0,1,4,1,0
55632,445,0,0,drop,70,70,0,1,0,1,0
59785,443,14021,443,allow,1077274,41232,1036042,1152,49,455,697
56592,53,10104,53,allow,200,102,98,2,31,1,1
33062,53,30187,53,allow,86,86,0,1,30,1,0
55069,44847,0,0,deny,66,66,0,1,0,1,0
49319,53,1935,53,allow,166,86,80,2,29,1,1
61354,445,0,0,drop,70,70,0,1,0,1,0
443,4205,0,0,deny,187,187,0,1,0,1,0
64902,53,48255,53,allow,762,98,664,2,30,1,1
57431,15503,0,0,deny,66,66,0,1,0,1,0
123,123,52430,123,allow,184,94,90,2,30,1,1
26601,22114,0,0,deny,66,66,0,1,0,1,0
51104,13011,33495,13011,allow,948,473,475,13,15,7,6
38690,443,51124,443,allow,1107678,21465,1086213,1058,16,312,746
6882,24271,34047,24271,allow,228,118,110,2,1200,1,1
60557,23117,0,0,deny,66,66,0,1,0,1,0
64921,445,0,0,drop,66,66,0,1,0,1,0
65502,445,0,0,drop,66,66,0,1,0,1,0
49981,53,37329,53,allow,438,180,258,6,30,3,3
53580,443,57283,443,allow,4669,2251,2418,14,137,7,7
54189,445,0,0,drop,70,70,0,1,0,1,0
65333,53,15875,53,allow,197,94,103,2,29,1,1
41027,80,41027,80,allow,18224,2763,15461,29,126,14,15
32395,30188,0,0,deny,62,62,0,1,0,1,0
64679,445,0,0,drop,66,66,0,1,0,1,0
11136,15503,0,0,deny,62,62,0,1,0,1,0
9017,6881,0,0,deny,66,66,0,1,0,1,0
57172,17,0,0,deny,60,60,0,1,0,1,0
64242,445,0,0,drop,70,70,0,1,0,1,0
60754,53,60754,53,allow,198,90,108,2,30,1,1
50583,53,30118,53,allow,783,96,687,2,30,1,1
5588,5588,0,0,allow,3354,1792,1562,46,194,23,23
9327,443,1143,443,allow,3616,429,3187,11,15,6,5
27005,27014,39253,27014,allow,882,126,756,2,30,1,1
50902,445,0,0,drop,70,70,0,1,0,1,0
52178,30922,40190,30922,allow,70,70,0,2,7,2,0
51411,443,64614,443,allow,7842,1155,6687,19,105,10,9
52081,51835,33500,51835,allow,316,136,180,6,6,3,3
54792,443,48996,443,allow,9515,2231,7284,25,22,14,11
55056,44512,0,0,deny,62,62,0,1,0,1,0
50735,445,0,0,drop,70,70,0,1,0,1,0
55729,53,41477,53,allow,256,96,160,4,41,2,2
52696,21247,0,0,deny,66,66,0,1,0,1,0
49418,27015,65524,27015,allow,287,78,209,2,30,1,1
21733,56205,0,0,deny,66,66,0,1,0,1,0
61104,445,0,0,drop,70,70,0,1,0,1,0
55869,53,49767,53,allow,196,102,94,2,30,1,1
0,0,0,0,deny,156,156,0,2,0,2,0
58638,5900,0,0,deny,62,62,0,1,0,1,0
37647,29892,0,0,deny,145,145,0,1,0,1,0
39047,443,36034,443,allow,10831,1381,9450,22,19,12,10
51770,445,0,0,drop,70,70,0,1,0,1,0
58888,443,13119,443,allow,274616,12640,261976,352,28,167,185
51426,52700,0,0,deny,100,100,0,1,0,1,0
55164,445,0,0,drop,66,66,0,1,0,1,0
5111,53,5111,53,allow,235,90,145,2,33,1,1
57921,445,0,0,drop,70,70,0,1,0,1,0
50699,445,0,0,drop,66,66,0,1,0,1,0
36498,80,36498,80,allow,161054,3432,157622,140,158,24,116
3478,61463,0,0,deny,164,164,0,1,0,1,0
64428,53,56066,53,allow,195,102,93,2,30,1,1
49471,445,0,0,drop,70,70,0,1,0,1,0
65249,53,21680,53,allow,182,102,80,2,30,1,1
63218,22,63218,22,allow,9001,4087,4914,59,39,27,32
36484,67,0,0,deny,60,60,0,1,0,1,0
57706,64147,0,0,deny,62,62,0,1,0,1,0
57298,53,55060,53,allow,323,110,213,2,30,1,1
51268,47662,5610,47662,allow,70,70,0,2,8,2,0
56448,445,0,0,drop,66,66,0,1,0,1,0
58904,123,61821,123,allow,184,94,90,2,30,1,1
50711,80,19117,80,allow,1658,1247,411,8,15,5,3
57798,445,0,0,drop,70,70,0,1,0,1,0
49767,445,0,0,drop,66,66,0,1,0,1,0
55056,53,38233,53,allow,177,94,83,2,29,1,1
50373,443,34130,443,allow,5422,707,4715,16,25,8,8
51283,445,0,0,drop,70,70,0,1,0,1,0
8211,28793,0,0,deny,66,66,0,1,0,1,0
59180,53,28928,53,allow,260,86,174,2,30,1,1
63930,53,2970,53,allow,377,94,283,2,29,1,1
5926,25174,0,0,deny,62,62,0,1,0,1,0
64565,53,48582,53,allow,226,110,116,2,30,1,1
49236,80,22987,80,allow,1904818,59945,1844873,1747,162,498,1249
56986,53,20950,53,allow,259,87,172,4,37,2,2
56206,53,48081,53,allow,711,87,624,2,30,1,1
57415,445,0,0,drop,70,70,0,1,0,1,0
52048,44059,61296,44059,allow,258,70,188,4,8,2,2
65502,445,0,0,drop,70,70,0,1,0,1,0
49564,53,39263,53,allow,193,102,91,2,30,1,1
50583,53,45479,53,allow,196,102,94,2,30,1,1
48676,53395,0,0,deny,60,60,0,1,0,1,0
60330,80,20724,80,allow,374,192,182,7,61,4,3
34628,443,42980,443,allow,6392,1025,5367,18,27,9,9
49323,443,62942,443,allow,9802,2846,6956,33,79,15,18
59440,445,0,0,drop,66,66,0,1,0,1,0
58018,445,0,0,drop,66,66,0,1,0,1,0
63519,445,0,0,drop,66,66,0,1,0,1,0
52438,445,0,0,drop,70,70,0,1,0,1,0
57621,445,0,0,drop,70,70,0,1,0,1,0
61415,80,27732,80,allow,28257,2893,25364,64,138,30,34
40219,443,6179,443,allow,2387,979,1408,15,36,6,9
51590,445,0,0,drop,66,66,0,1,0,1,0
63529,445,0,0,drop,70,70,0,1,0,1,0
55195,443,24998,443,allow,3543,1855,1688,20,122,10,10
50474,445,0,0,drop,70,70,0,1,0,1,0
35584,80,52820,80,allow,1507,454,1053,10,15,5,5
59340,53,59340,53,allow,215,90,125,2,30,1,1
57030,53,58226,53,allow,283,101,182,4,38,2,2
49686,53,9507,53,allow,343,94,249,2,30,1,1
54051,28793,0,0,deny,66,66,0,1,0,1,0
60180,443,13880,443,allow,3667,2243,1424,22,80,11,11
65479,53,45836,53,allow,728,102,626,2,29,1,1
55877,53,52511,53,allow,166,86,80,2,30,1,1
63001,445,0,0,drop,66,66,0,1,0,1,0
58014,39004,0,0,deny,62,62,0,1,0,1,0
38145,443,38145,443,allow,4599,1692,2907,19,29,11,8
41431,443,64563,443,allow,190,70,120,4,15,2,2
64005,53,33305,53,allow,226,102,124,2,30,1,1
56895,445,0,0,drop,70,70,0,1,0,1,0
64324,37807,0,0,deny,62,62,0,1,0,1,0
58867,443,37875,443,allow,16230,11127,5103,69,330,34,35
53431,445,0,0,drop,70,70,0,1,0,1,0
59049,53,37929,53,allow,199,94,105,2,30,1,1
57352,53,8029,53,allow,192,98,94,2,31,1,1
8999,64910,0,0,deny,146,146,0,1,0,1,0
64767,51221,0,0,deny,62,62,0,1,0,1,0
41803,443,1948,443,allow,11804,4009,7795,41,150,21,20
61167,443,24525,443,allow,27000,11646,15354,176,640,82,94
16387,49252,0,0,deny,60,60,0,1,0,1,0
50417,445,0,0,drop,66,66,0,1,0,1,0
56414,53,14395,53,allow,178,94,84,2,30,1,1
64329,53,38742,53,allow,479,111,368,4,50,2,2
49680,53,31932,53,allow,749,94,655,2,30,1,1
64000,44847,0,0,deny,62,62,0,1,0,1,0
10031,443,14432,443,allow,34551,3731,30820,54,112,23,31
443,60040,0,0,deny,60,60,0,1,0,1,0
56713,443,29098,443,allow,373053,9725,363328,374,45,129,245
65303,53,28109,53,allow,94,94,0,1,29,1,0
37559,443,47158,443,allow,9845,2815,7030,26,37,15,11
43309,80,55504,80,allow,805,665,140,6,32,4,2
37569,443,55677,443,allow,120566,15345,105221,173,125,72,101
49927,80,35490,80,allow,1126,609,517,11,15,6,5
38167,443,36158,443,allow,6150,914,5236,18,16,10,8
52126,56057,15046,56057,allow,70,70,0,2,8,2,0
49820,53,12064,53,allow,186,95,91,2,31,1,1
9517,23,9517,23,allow,66,66,0,1,5,1,0
56388,53,39602,53,allow,173,94,79,2,30,1,1
46679,64147,0,0,deny,62,62,0,1,0,1,0
49259,53,59958,53,allow,184,102,82,2,30,1,1
50584,9045,4330,9045,allow,166,166,0,1,1200,1,0
9464,443,61543,443,allow,9340,5582,3758,36,38,21,15
57095,53,22428,53,allow,211,110,101,2,30,1,1
54977,443,46620,443,allow,322265,12756,309509,409,270,173,236
57508,443,43486,443,allow,6749,2649,4100,19,142,9,10
58134,445,0,0,drop,70,70,0,1,0,1,0
63366,30365,36289,30365,allow,70,70,0,1,4,1,0
56063,445,0,0,drop,70,70,0,1,0,1,0
55786,53,41972,53,allow,200,102,98,2,29,1,1
56106,445,0,0,drop,70,70,0,1,0,1,0
51325,443,32371,443,allow,2959,793,2166,10,120,5,5
56335,445,0,0,drop,70,70,0,1,0,1,0
65057,53,53489,53,allow,199,102,97,2,30,1,1
57743,445,0,0,drop,70,70,0,1,0,1,0
63035,443,64744,443,allow,1864,250,1614,8,120,4,4
51432,443,60618,443,allow,194,70,124,3,11,1,2
53044,36237,0,0,deny,66,66,0,1,0,1,0
57357,443,47242,443,allow,126,60,66,3,11,2,1
62341,26467,0,0,deny,66,66,0,1,0,1,0
50153,445,0,0,drop,66,66,0,1,0,1,0
55179,53,47200,53,allow,178,94,84,2,30,1,1
49626,443,38035,443,allow,8266,1963,6303,28,175,14,14
1190,25174,0,0,deny,146,146,0,1,0,1,0
59807,445,0,0,drop,70,70,0,1,0,1,0
62183,57470,0,0,deny,74,74,0,1,0,1,0
50351,445,0,0,drop,66,66,0,1,0,1,0
53960,30041,0,0,deny,62,62,0,1,0,1,0
52318,17,0,0,deny,60,60,0,1,0,1,0
50377,53,60945,53,allow,214,110,104,2,30,1,1
14092,80,14092,80,allow,3182,2082,1100,18,86,10,8
51576,445,0,0,drop,66,66,0,1,0,1,0
53101,443,37557,443,allow,8071,1789,6282,20,326,10,10
63949,53,30252,53,allow,195,102,93,2,31,1,1
26661,53,26661,53,allow,217,87,130,2,31,1,1
45964,3111,0,0,deny,60,60,0,1,0,1,0
49184,443,9767,443,allow,493152,13222,479930,509,19,184,325
49418,27015,26832,27015,allow,248,78,170,2,30,1,1
52322,53,58058,53,allow,86,86,0,1,30,1,0
64812,53,57206,53,allow,347,91,256,4,56,2,2
57400,445,0,0,drop,66,66,0,1,0,1,0
58846,443,58496,443,allow,7680,4905,2775,24,17,12,12
55757,53,45063,53,allow,177,94,83,2,30,1,1
58638,5900,0,0,deny,62,62,0,1,0,1,0
58904,443,20613,443,allow,4732,3142,1590,20,18,9,11
51119,445,0,0,drop,66,66,0,1,0,1,0
57470,40794,36042,40794,allow,132,132,0,3,1199,3,0
57928,30188,0,0,deny,146,146,0,1,0,1,0
61975,445,0,0,drop,66,66,0,1,0,1,0
58475,11392,0,0,deny,66,66,0,1,0,1,0
55664,445,0,0,drop,70,70,0,1,0,1,0
49277,53,15554,53,allow,199,102,97,2,31,1,1
48817,6884,48817,6884,allow,479,277,202,4,1200,2,2
65226,53,19267,53,allow,79,79,0,2,34,2,0
48458,53,30263,53,allow,168,78,90,2,31,1,1
55402,445,0,0,drop,66,66,0,1,0,1,0
65464,443,36070,443,allow,395647,11870,383777,409,16,144,265
64001,445,0,0,drop,70,70,0,1,0,1,0
11967,57470,0,0,deny,62,62,0,1,0,1,0
26081,53,34120,53,allow,75510,75228,282,904,90,902,2
56879,53,15562,53,allow,744,95,649,2,30,1,1
55469,443,55469,443,allow,4579,1672,2907,19,29,11,8
52948,443,49245,443,allow,9629,2119,7510,42,114,20,22
53239,443,22787,443,allow,982624,22331,960293,976,137,293,683
56144,53,34369,53,allow,177,94,83,2,30,1,1
14693,64147,0,0,deny,66,66,0,1,0,1,0
56460,22114,0,0,deny,146,146,0,1,0,1,0
55676,28694,59367,28694,allow,316,190,126,5,15,3,2
52533,445,0,0,drop,70,70,0,1,0,1,0
60970,445,0,0,drop,66,66,0,1,0,1,0
53811,445,0,0,drop,66,66,0,1,0,1,0
11967,57470,0,0,deny,62,62,0,1,0,1,0
53543,44847,0,0,deny,62,62,0,1,0,1,0
59694,50584,0,0,deny,62,62,0,1,0,1,0
41911,443,53613,443,allow,9499,3786,5713,31,315,16,15
52960,80,43936,80,allow,82011,2937,79074,91,358,34,57
55890,53,15703,53,allow,193,102,91,2,29,1,1
50479,80,2241,80,allow,312,192,120,6,25,4,2
56035,1310,0,0,deny,66,66,0,1,0,1,0
41764,443,65468,443,allow,9028,5092,3936,36,257,12,24
56763,445,0,0,drop,70,70,0,1,0,1,0
58485,445,0,0,drop,66,66,0,1,0,1,0
54144,445,0,0,drop,70,70,0,1,0,1,0
56433,53,3210,53,allow,177,94,83,2,30,1,1
56350,53,30997,53,allow,287,102,185,2,30,1,1
49786,53,59022,53,allow,752,110,642,2,30,1,1
34808,22114,0,0,deny,66,66,0,1,0,1,0
52323,445,0,0,drop,70,70,0,1,0,1,0
56550,123,27975,123,allow,184,94,90,2,30,1,1
49374,53,26610,53,allow,307,102,205,4,35,2,2
16057,51050,0,0,deny,66,66,0,1,0,1,0
50643,80,56301,80,allow,5660,3544,2116,17,47,10,7
60231,443,26634,443,allow,1868,1229,639,18,151,11,7
6916,9822,0,0,deny,100,100,0,1,0,1,0
53984,445,0,0,drop,70,70,0,1,0,1,0
61737,445,0,0,drop,70,70,0,1,0,1,0
49715,443,3770,443,allow,7681,1658,6023,21,130,11,10
63965,53,50907,53,allow,306,94,212,2,30,1,1
49532,80,7798,80,allow,4577,3951,626,11,25,6,5
56834,53,6671,53,allow,178,94,84,2,31,1,1
42285,57470,0,0,deny,62,62,0,1,0,1,0
65254,445,0,0,drop,70,70,0,1,0,1,0
64858,53,5118,53,allow,819,102,717,2,30,1,1
62556,445,0,0,drop,66,66,0,1,0,1,0
13159,37965,0,0,deny,66,66,0,1,0,1,0
49429,53,3365,53,allow,199,102,97,2,29,1,1
53588,8999,41805,8999,allow,1268,960,308,9,32,5,4
1024,6881,0,0,deny,62,62,0,1,0,1,0
64290,445,0,0,drop,70,70,0,1,0,1,0
52152,80,10469,80,allow,366,240,126,7,32,5,2
56041,53,6902,53,allow,185,102,83,2,30,1,1
56436,80,34544,80,allow,17067,1439,15628,23,25,8,15
34914,26467,0,0,deny,62,62,0,1,0,1,0
57407,445,0,0,drop,70,70,0,1,0,1,0
55416,445,0,0,drop,66,66,0,1,0,1,0
59944,445,0,0,drop,66,66,0,1,0,1,0
50216,443,60442,443,allow,6320,1382,4938,24,167,13,11
443,46223,0,0,deny,66,66,0,1,0,1,0
54854,19847,0,0,deny,62,62,0,1,0,1,0
10467,25174,0,0,deny,146,146,0,1,0,1,0
65439,445,0,0,drop,70,70,0,1,0,1,0
38598,80,50146,80,allow,1114,534,580,12,16,7,5
54342,445,0,0,drop,66,66,0,1,0,1,0
43304,443,10226,443,allow,4389,797,3592,15,70,8,7
58972,443,21151,443,allow,5979,3487,2492,21,168,10,11
50020,3389,50020,3389,allow,3347,1458,1889,15,18,8,7
50779,445,0,0,drop,70,70,0,1,0,1,0
50638,443,50638,443,allow,4544,1637,2907,19,26,11,8
40474,23117,0,0,deny,62,62,0,1,0,1,0
49676,53,60800,53,allow,322,110,212,4,31,2,2
59766,53,33803,53,allow,512,166,346,2,30,1,1
65406,53,43109,53,allow,273,102,171,2,30,1,1
63343,445,0,0,drop,70,70,0,1,0,1,0
27969,25174,0,0,deny,62,62,0,1,0,1,0
27005,27018,61508,27018,allow,252,252,0,3,2,3,0
55677,445,0,0,drop,70,70,0,1,0,1,0
27309,6881,0,0,deny,146,146,0,1,0,1,0
52185,445,0,0,drop,70,70,0,1,0,1,0
57306,443,21388,443,allow,8699,3391,5308,40,15,24,16
41028,80,41028,80,allow,100182,8294,91888,137,127,69,68
52734,443,39307,443,allow,257777,12962,244815,347,41,162,185
55158,443,7666,443,allow,7963,2657,5306,29,333,13,16
33383,443,13969,443,allow,24440,2215,22225,46,316,20,26
58638,5900,0,0,deny,62,62,0,1,0,1,0
63002,445,0,0,drop,70,70,0,1,0,1,0
49533,53,65286,53,allow,771,101,670,2,30,1,1
57488,445,0,0,drop,70,70,0,1,0,1,0
51701,24343,49961,24343,allow,70,70,0,1,5,1,0
50075,445,0,0,drop,70,70,0,1,0,1,0
50361,445,0,0,drop,70,70,0,1,0,1,0
64746,445,0,0,drop,70,70,0,1,0,1,0
49465,443,48053,443,allow,2894,725,2169,10,121,5,5
27005,27015,24386,27015,allow,882,126,756,3,31,2,1
53834,445,0,0,drop,70,70,0,1,0,1,0
22571,51505,0,0,deny,66,66,0,1,0,1,0
49861,53,42147,53,allow,198,102,96,2,30,1,1
34452,80,18909,80,allow,6260,696,5564,17,16,9,8
63433,443,29608,443,allow,1950,1231,719,20,15,12,8
49653,445,0,0,drop,70,70,0,1,0,1,0
53660,443,7808,443,allow,9028,3897,5131,24,83,15,9
56574,53,9941,53,allow,275,94,181,2,30,1,1
56257,53,60774,53,allow,170,87,83,2,31,1,1
58259,53,21594,53,allow,578,286,292,9,15,5,4
39043,443,33177,443,allow,4832,3054,1778,27,16,14,13
51173,443,28678,443,allow,13341,4805,8536,88,378,42,46
54835,443,32514,443,allow,15578,7071,8507,69,140,33,36
36098,443,41283,443,allow,5901,1324,4577,25,50,14,11
51109,11392,0,0,deny,66,66,0,1,0,1,0
50669,443,37355,443,allow,12463,2350,10113,46,20,19,27
64559,53,6054,53,allow,196,100,96,2,31,1,1
56687,443,42301,443,allow,7889,1900,5989,20,15,11,9
53896,443,17824,443,allow,499,425,74,4,0,3,1
54446,445,0,0,drop,66,66,0,1,0,1,0
64276,53,39382,53,allow,197,102,95,2,29,1,1
3559,30188,0,0,deny,62,62,0,1,0,1,0
56598,443,16755,443,allow,8630,2126,6504,20,15,11,9
31691,50584,0,0,deny,146,146,0,1,0,1,0
56991,443,56991,443,allow,6305,1352,4953,19,16,10,9
3730,37965,0,0,deny,62,62,0,1,0,1,0
47244,443,21922,443,allow,5953,1848,4105,18,17,10,8
47063,15503,0,0,deny,146,146,0,1,0,1,0
60384,64147,0,0,deny,62,62,0,1,0,1,0
2527,53,2527,53,allow,371,237,134,3,34,2,1
50700,80,14024,80,allow,648,256,392,8,27,5,3
53995,445,0,0,drop,70,70,0,1,0,1,0
52522,445,0,0,drop,66,66,0,1,0,1,0
56441,80,22718,80,allow,1272,389,883,16,394,4,12
56894,53,27064,53,allow,178,94,84,2,30,1,1
56380,445,0,0,drop,70,70,0,1,0,1,0
38413,53,37201,53,allow,199,94,105,2,29,1,1
50346,445,0,0,drop,70,70,0,1,0,1,0
53723,443,52693,443,allow,70,70,0,2,8,2,0
60792,53,38025,53,allow,168,78,90,2,29,1,1
57894,443,52904,443,allow,4544,1112,3432,21,176,12,9
43346,443,33396,443,allow,3691281,56325,3634956,3201,138,570,2631
49230,53,32099,53,allow,195,94,101,2,30,1,1
63786,50091,41625,50091,allow,70,70,0,1,5,1,0
56680,53,8517,53,allow,211,102,109,2,30,1,1
57106,53,23546,53,allow,214,94,120,2,29,1,1
56358,443,57449,443,allow,3734,1750,1984,24,203,12,12
51655,445,0,0,drop,66,66,0,1,0,1,0
60474,8999,37889,8999,allow,70,70,0,2,8,2,0
49740,443,61794,443,allow,7554,2281,5273,22,129,13,9
60110,445,0,0,drop,66,66,0,1,0,1,0
17226,35440,0,0,deny,62,62,0,1,0,1,0
65155,53,63407,53,allow,295,103,192,4,49,2,2
49380,21247,0,0,deny,66,66,0,1,0,1,0
65359,445,0,0,drop,70,70,0,1,0,1,0
51268,445,0,0,drop,70,70,0,1,0,1,0
64839,445,0,0,drop,70,70,0,1,0,1,0
50656,445,0,0,drop,70,70,0,1,0,1,0
62348,65348,0,0,deny,145,145,0,1,0,1,0
51848,443,58021,443,allow,68198,5503,62695,102,40,43,59
57533,445,0,0,drop,70,70,0,1,0,1,0
59373,22,59373,22,deny,295,126,169,4,1,2,2
50285,443,58128,443,allow,7210,2382,4828,33,100,19,14
2691,64147,0,0,deny,62,62,0,1,0,1,0
51801,33531,27515,33531,allow,70,70,0,2,8,2,0
55418,445,0,0,drop,66,66,0,1,0,1,0
55703,445,0,0,drop,70,70,0,1,0,1,0
27005,27020,41783,27020,allow,898,126,772,2,30,1,1
51073,445,0,0,drop,66,66,0,1,0,1,0
51169,443,30146,443,allow,975832,29038,946794,991,51,341,650
50211,1688,3994,1688,allow,70,70,0,1,4,1,0
60485,22114,0,0,deny,66,66,0,1,0,1,0
61368,445,0,0,drop,70,70,0,1,0,1,0
55956,443,61641,443,allow,6058,1749,4309,22,200,13,9
58791,25174,0,0,deny,62,62,0,1,0,1,0
26053,33720,0,0,deny,160,160,0,1,0,1,0
33042,443,32323,443,allow,130,70,60,2,14,1,1
63762,41373,50271,41373,allow,66,66,0,2,8,2,0
2704,37,0,0,deny,60,60,0,1,0,1,0
55411,53,60848,53,allow,182,93,89,2,31,1,1
56476,53,63647,53,allow,239,94,145,2,30,1,1
53207,443,15704,443,allow,3655,2344,1311,18,17,9,9
11136,19910,0,0,deny,62,62,0,1,0,1,0
49665,53,62694,53,allow,289,99,190,4,35,2,2
53306,443,56801,443,allow,11114,3066,8048,41,119,22,19
64488,445,0,0,drop,66,66,0,1,0,1,0
53341,445,0,0,drop,70,70,0,1,0,1,0
64091,53,52948,53,allow,172,88,84,2,30,1,1
50090,50265,0,0,deny,66,66,0,1,0,1,0
53959,445,0,0,drop,66,66,0,1,0,1,0
64880,64147,0,0,deny,62,62,0,1,0,1,0
49864,53,63965,53,allow,193,102,91,2,30,1,1
52797,443,2237,443,allow,6876,3332,3544,22,140,11,11
50015,53,0,0,allow,234,86,148,2,30,1,1
55184,53,64437,53,allow,182,93,89,2,31,1,1
34692,443,49759,443,allow,3386,1833,1553,17,255,9,8
60243,445,0,0,drop,70,70,0,1,0,1,0
6882,16276,42707,16276,allow,150,150,0,1,1200,1,0
65453,53,27266,53,allow,251,94,157,2,31,1,1
49316,445,0,0,drop,70,70,0,1,0,1,0
50524,443,21568,443,allow,1389,868,521,12,25,6,6
56565,53,24401,53,allow,164,86,78,2,30,1,1
62767,57470,0,0,deny,74,74,0,1,0,1,0
55984,445,0,0,drop,70,70,0,1,0,1,0
13166,57470,0,0,deny,62,62,0,1,0,1,0
63861,37832,64694,37832,allow,70,70,0,1,5,1,0
55610,445,0,0,drop,66,66,0,1,0,1,0
50543,445,0,0,drop,66,66,0,1,0,1,0
57246,53,53043,53,allow,182,93,89,2,31,1,1
52219,37398,8768,37398,allow,316,136,180,6,8,3,3
64933,53,11327,53,allow,349,94,255,2,30,1,1
37026,80,28562,80,allow,2849,1631,1218,9,721,5,4
51694,80,56366,80,allow,1307,649,658,8,75,5,3
56683,443,10179,443,allow,8735,1819,6916,23,23,14,9
59475,53,33895,53,allow,179,86,93,2,30,1,1
51105,445,0,0,drop,66,66,0,1,0,1,0
39313,37965,0,0,deny,62,62,0,1,0,1,0
57601,445,0,0,drop,66,66,0,1,0,1,0
65225,53,20120,53,allow,822,102,720,2,30,1,1
50196,445,0,0,drop,70,70,0,1,0,1,0
54571,443,54134,443,allow,10546,2453,8093,28,15,16,12
51949,5484,40071,5484,allow,70,70,0,1,5,1,0
56082,53,58517,53,allow,271,88,183,4,38,2,2
58382,50584,0,0,deny,62,62,0,1,0,1,0
48743,443,24308,443,allow,26609,2444,24165,45,21,21,24
49892,443,33274,443,allow,5737,1602,4135,23,86,13,10
36453,23,0,0,deny,60,60,0,1,0,1,0
64645,443,28393,443,allow,7752,4399,3353,34,159,17,17
65407,445,0,0,drop,66,66,0,1,0,1,0
56061,445,0,0,drop,70,70,0,1,0,1,0
57299,445,0,0,drop,70,70,0,1,0,1,0
55103,53,23177,53,allow,392,92,300,4,55,2,2
45202,443,49520,443,allow,15153,8118,7035,45,271,22,23
10380,5223,0,0,deny,148,148,0,1,0,1,0
50579,445,0,0,drop,70,70,0,1,0,1,0
53252,445,0,0,drop,66,66,0,1,0,1,0
56387,25174,0,0,deny,66,66,0,1,0,1,0
59366,35440,0,0,deny,66,66,0,1,0,1,0
61791,445,0,0,drop,66,66,0,1,0,1,0
14693,64147,0,0,deny,62,62,0,1,0,1,0
51799,445,0,0,drop,70,70,0,1,0,1,0
61700,53,0,0,allow,202,86,116,2,30,1,1
64470,53,40171,53,allow,261,94,167,2,30,1,1
51530,445,0,0,drop,66,66,0,1,0,1,0
49418,27015,32130,27015,allow,260,78,182,2,30,1,1
60815,443,60815,443,allow,1320,685,635,14,181,7,7
54331,445,0,0,drop,70,70,0,1,0,1,0
52772,445,0,0,drop,70,70,0,1,0,1,0
62952,38741,48558,38741,allow,18963,9580,9383,211,348,109,102
51948,443,29548,443,allow,4876,2559,2317,32,56,18,14
61444,445,0,0,drop,70,70,0,1,0,1,0
64716,53,18562,53,allow,195,102,93,2,31,1,1
44783,443,27769,443,allow,4173582,66515,4107067,3494,129,510,2984
7977,25174,0,0,deny,62,62,0,1,0,1,0
49312,443,38998,443,allow,3171,2293,878,17,40,10,7
60325,80,16267,80,allow,3697,2062,1635,16,61,9,7
64566,53,1628,53,allow,188,96,92,2,30,1,1
49632,443,35637,443,allow,5598,1185,4413,24,80,13,11
45908,33330,0,0,deny,60,60,0,1,0,1,0
41730,443,24945,443,allow,760,422,338,12,28,7,5
9544,11392,0,0,deny,62,62,0,1,0,1,0
2310,8305,0,0,deny,145,145,0,1,0,1,0
57498,445,0,0,drop,70,70,0,1,0,1,0
56762,53,10015,53,allow,168,86,82,2,29,1,1
55548,53,39542,53,allow,197,102,95,2,35,1,1
55577,53,45509,53,allow,198,101,97,2,31,1,1
49478,80,36631,80,allow,28629,4862,23767,33,39,13,20
58834,443,42035,443,allow,7880,5105,2775,25,17,13,12
6889,65473,0,0,deny,143,143,0,1,0,1,0
52063,445,0,0,drop,70,70,0,1,0,1,0
54808,445,0,0,drop,70,70,0,1,0,1,0
53979,445,0,0,drop,70,70,0,1,0,1,0
49811,53,52504,53,allow,300,118,182,2,29,1,1
60871,443,24250,443,allow,8338,3198,5140,28,46,16,12
42202,443,2028,443,allow,6610,1106,5504,23,361,12,11
59798,443,49371,443,allow,1887,1152,735,18,28,9,9
49797,53,5232,53,allow,787,110,677,2,30,1,1
50110,53,49491,53,allow,172,88,84,2,31,1,1
45941,23386,0,0,deny,60,60,0,1,0,1,0
60403,60092,40292,60092,allow,70,70,0,1,5,1,0
62728,445,0,0,drop,66,66,0,1,0,1,0
53589,445,0,0,drop,70,70,0,1,0,1,0
50674,35440,0,0,deny,62,62,0,1,0,1,0
47509,443,17369,443,allow,7769,2586,5183,18,121,9,9
55011,443,43208,443,allow,134,60,74,3,10,2,1
65456,445,0,0,drop,70,70,0,1,0,1,0
6881,51413,35496,51413,allow,475,150,325,2,1200,1,1
62304,445,0,0,drop,66,66,0,1,0,1,0
57509,443,8553,443,allow,5150,3987,1163,18,38,11,7
56086,443,31892,443,allow,6817,3598,3219,32,143,15,17
50156,53,6756,53,allow,186,102,84,2,30,1,1
61764,445,0,0,drop,70,70,0,1,0,1,0
49162,53,33526,53,allow,183,94,89,2,30,1,1
64524,53,20476,53,allow,274,94,180,4,33,2,2
65282,53,16283,53,allow,193,102,91,2,30,1,1
42344,48637,0,0,deny,60,60,0,1,0,1,0
58153,443,33248,443,allow,12215,7275,4940,26,26,16,10
62813,25174,0,0,deny,62,62,0,1,0,1,0
60801,40010,50650,40010,allow,316,136,180,6,6,3,3
57917,443,1119,443,allow,6520,1550,4970,19,54,11,8
37965,8999,40313,8999,allow,491,150,341,2,1199,1,1
53353,26467,0,0,deny,62,62,0,1,0,1,0
56683,445,0,0,drop,70,70,0,1,0,1,0
52005,33191,61687,33191,allow,70,70,0,2,7,2,0
49972,53,25100,53,allow,328,110,218,4,57,2,2
59984,443,65136,443,allow,2419,330,2089,12,135,5,7
57069,53,3710,53,allow,177,94,83,2,30,1,1
59696,57470,0,0,deny,62,62,0,1,0,1,0
55632,45682,28003,45682,allow,70,70,0,2,8,2,0
54675,445,0,0,drop,70,70,0,1,0,1,0
49915,443,34488,443,allow,7648,2967,4681,23,15,13,10
62397,445,0,0,drop,66,66,0,1,0,1,0
27005,27020,2257,27020,allow,1622,126,1496,4,31,2,2
63173,36237,0,0,deny,66,66,0,1,0,1,0
51909,33509,44942,33509,allow,70,70,0,2,8,2,0
62414,50584,0,0,deny,62,62,0,1,0,1,0
32511,23,0,0,deny,60,60,0,1,0,1,0
64899,445,0,0,drop,70,70,0,1,0,1,0
39158,53,23110,53,allow,168,78,90,2,30,1,1
52373,445,0,0,drop,66,66,0,1,0,1,0
39063,44847,0,0,deny,66,66,0,1,0,1,0
39640,53,64225,53,allow,168,78,90,2,30,1,1
38629,25174,0,0,deny,66,66,0,1,0,1,0
50902,445,0,0,drop,70,70,0,1,0,1,0
51229,443,49748,443,allow,8590,1038,7552,16,120,7,9
49216,53,31679,53,allow,789,110,679,2,29,1,1
63960,53,27823,53,allow,178,94,84,2,30,1,1
3580,53,3580,53,allow,832,106,726,2,30,1,1
63048,53,53568,53,allow,304,86,218,2,30,1,1
1024,64147,0,0,deny,62,62,0,1,0,1,0
45941,23384,0,0,deny,60,60,0,1,0,1,0
49772,80,38136,80,allow,70,70,0,2,8,2,0
43402,53,65461,53,allow,241,78,163,2,30,1,1
42599,443,19054,443,allow,215284,28807,186477,346,129,151,195
55828,53,56117,53,allow,177,94,83,2,30,1,1
65250,445,0,0,drop,66,66,0,1,0,1,0
62856,445,0,0,drop,66,66,0,1,0,1,0
65155,53,21805,53,allow,295,103,192,4,48,2,2
59748,53,27175,53,allow,304,86,218,2,29,1,1
50549,53,21467,53,allow,199,94,105,2,30,1,1
60162,53436,0,0,deny,66,66,0,1,0,1,0
37965,63402,11159,63402,allow,2118,858,1260,28,1283,14,14
62892,993,17111,993,allow,9588,4811,4777,85,193,49,36
60717,443,21678,443,allow,61464,11538,49926,87,32,41,46
49451,443,61379,443,allow,12802,1977,10825,32,25,14,18
65115,53,24571,53,allow,193,102,91,2,29,1,1
42951,44847,0,0,deny,66,66,0,1,0,1,0
60821,445,0,0,drop,66,66,0,1,0,1,0
58638,5900,0,0,deny,62,62,0,1,0,1,0
55872,53,18177,53,allow,177,94,83,2,30,1,1
54202,443,43752,443,allow,499,425,74,4,0,3,1
58512,5222,4015,5222,allow,2834,1238,1596,26,34,13,13
58638,5900,0,0,deny,62,62,0,1,0,1,0
53585,445,0,0,drop,66,66,0,1,0,1,0
60982,445,0,0,drop,66,66,0,1,0,1,0
50490,445,0,0,drop,70,70,0,1,0,1,0
64517,53,41974,53,allow,194,102,92,2,29,1,1
50315,445,0,0,drop,66,66,0,1,0,1,0
57334,53,43556,53,allow,210,110,100,2,30,1,1
56639,80,24086,80,allow,234,234,0,4,12,4,0
51870,53,51870,53,allow,825,99,726,2,30,1,1
55531,80,42208,80,allow,3277,2255,1022,18,39,10,8
64155,60043,0,0,deny,66,66,0,1,0,1,0
50947,445,0,0,drop,70,70,0,1,0,1,0
42936,53,47625,53,allow,199,94,105,2,30,1,1
6895,57354,0,0,deny,148,148,0,1,0,1,0
55027,53,18719,53,allow,168,86,82,2,30,1,1
65446,53,2812,53,allow,184,102,82,2,30,1,1
37008,42707,0,0,deny,62,62,0,1,0,1,0
4269,26672,0,0,deny,60,60,0,1,0,1,0
49700,443,48800,443,allow,64,64,0,2,5,2,0
50180,445,0,0,drop,70,70,0,1,0,1,0
64691,25320,0,0,deny,66,66,0,1,0,1,0
50074,53,31884,53,allow,168,86,82,2,30,1,1
51759,445,0,0,drop,66,66,0,1,0,1,0
56454,445,0,0,drop,66,66,0,1,0,1,0
56357,53,34112,53,allow,178,94,84,2,30,1,1
65179,44847,0,0,deny,62,62,0,1,0,1,0
58765,443,24675,443,allow,26158,17265,8893,57,19,31,26
40599,443,4488,443,allow,7338,2419,4919,19,23,12,7
60166,443,54772,443,allow,7639,2673,4966,36,255,17,19
64549,53,44048,53,allow,273,86,187,2,30,1,1
50822,50584,0,0,deny,62,62,0,1,0,1,0
43423,443,64524,443,allow,130,70,60,2,15,1,1
50932,445,0,0,drop,66,66,0,1,0,1,0
49750,5223,50752,5223,allow,46785,27735,19050,232,5491,123,109
61027,80,42775,80,allow,9483,767,8716,18,14,10,8
49020,80,13819,80,allow,3422,2088,1334,18,152,9,9
63885,6969,58102,6969,allow,70,70,0,1,5,1,0
65443,53,31902,53,allow,730,102,628,2,30,1,1
54628,445,0,0,drop,70,70,0,1,0,1,0
49299,443,14634,443,allow,6681,1950,4731,24,45,14,10
53437,44847,0,0,deny,66,66,0,1,0,1,0
57016,53,13360,53,allow,266,110,156,2,30,1,1
51982,56306,51670,56306,allow,70,70,0,1,5,1,0
64611,53,46299,53,allow,189,102,87,2,30,1,1
56238,80,56238,80,allow,44951,1019,43932,48,15,15,33
64165,445,0,0,drop,66,66,0,1,0,1,0
58468,57587,0,0,deny,66,66,0,1,0,1,0
55623,62853,62347,62853,allow,504,318,186,8,15,5,3
49988,445,0,0,drop,70,70,0,1,0,1,0
64597,445,0,0,drop,70,70,0,1,0,1,0
43584,24748,0,0,deny,156,156,0,1,0,1,0
63842,45682,31353,45682,allow,4687209,3850148,837061,4974,107,3004,1970
57585,443,55906,443,allow,9273,2712,6561,50,615,25,25
52650,44847,0,0,deny,66,66,0,1,0,1,0
54427,53,16738,53,allow,199,94,105,2,30,1,1
33327,53,12719,53,allow,199,94,105,2,29,1,1
58680,445,0,0,drop,66,66,0,1,0,1,0
58638,5900,0,0,deny,62,62,0,1,0,1,0
46409,80,63158,80,allow,1053,613,440,10,15,5,5
42231,57470,0,0,deny,78,78,0,1,0,1,0
50180,443,51713,443,allow,6349,1071,5278,18,42,10,8
60989,443,11071,443,allow,7592,2966,4626,26,15,15,11
51732,54299,38142,54299,allow,70,70,0,1,5,1,0
56966,35440,0,0,deny,62,62,0,1,0,1,0
64723,53,45766,53,allow,329,118,211,2,30,1,1
56904,445,0,0,drop,70,70,0,1,0,1,0
65531,53,43079,53,allow,186,95,91,2,31,1,1
3195,53,3195,53,allow,197,90,107,2,29,1,1
65016,37965,0,0,deny,66,66,0,1,0,1,0
49481,80,30554,80,allow,11436,5021,6415,38,126,20,18
56320,53,14969,53,allow,183,94,89,2,30,1,1
60709,445,0,0,drop,70,70,0,1,0,1,0
61743,445,0,0,drop,70,70,0,1,0,1,0
57560,445,0,0,drop,70,70,0,1,0,1,0
55614,53,42097,53,allow,309,110,199,2,30,1,1
58877,443,35023,443,allow,183394,7389,176005,219,108,87,132
49620,80,21542,80,allow,318,192,126,6,42,4,2
61570,445,0,0,drop,70,70,0,1,0,1,0
42718,443,45721,443,allow,7341,2111,5230,18,135,8,10
33726,44847,0,0,deny,62,62,0,1,0,1,0
61550,5529,0,0,deny,145,145,0,1,0,1,0
52275,445,0,0,drop,66,66,0,1,0,1,0
33071,443,36886,443,allow,4234,2185,2049,36,1099,16,20
55711,53,33941,53,allow,733,93,640,2,31,1,1
42285,57470,0,0,deny,62,62,0,1,0,1,0
15503,6881,37170,6881,allow,490,149,341,2,1200,1,1
2941,7000,2941,7000,allow,3398,947,2451,18,27,9,9
13120,25174,0,0,deny,62,62,0,1,0,1,0
58361,445,0,0,drop,70,70,0,1,0,1,0
55979,53,60691,53,allow,193,102,91,2,30,1,1
49342,53,56835,53,allow,200,102,98,2,30,1,1
52073,16316,63189,16316,allow,70,70,0,1,5,1,0
63918,445,0,0,drop,66,66,0,1,0,1,0
52975,23718,0,0,deny,62,62,0,1,0,1,0
25565,1726,0,0,deny,60,60,0,1,0,1,0
64025,26826,22306,26826,allow,66,66,0,2,7,2,0
49439,53,56004,53,allow,197,102,95,2,31,1,1
56600,445,0,0,drop,66,66,0,1,0,1,0
22783,64147,0,0,deny,66,66,0,1,0,1,0
62818,445,0,0,drop,70,70,0,1,0,1,0
60571,26467,0,0,deny,62,62,0,1,0,1,0
52749,445,0,0,drop,70,70,0,1,0,1,0
51492,80,15284,80,allow,1517,481,1036,11,15,6,5
54758,35993,0,0,deny,66,66,0,1,0,1,0
50792,445,0,0,drop,70,70,0,1,0,1,0
57015,53,23440,53,allow,363,102,261,2,30,1,1
56161,53,2092,53,allow,194,102,92,2,30,1,1
61542,443,4330,443,allow,6049,1986,4063,23,19,12,11
50365,80,49822,80,allow,300,180,120,6,29,4,2
53466,443,35377,443,allow,7866,2625,5241,25,120,11,14
50350,445,0,0,drop,66,66,0,1,0,1,0
56650,443,37147,443,allow,8008,1988,6020,20,15,11,9
65114,53,53193,53,allow,177,94,83,2,29,1,1
57860,445,0,0,drop,70,70,0,1,0,1,0
54138,443,3905,443,allow,5702,1212,4490,19,139,10,9
63213,57866,0,0,deny,66,66,0,1,0,1,0
31003,10511,0,0,deny,145,145,0,1,0,1,0
3478,61463,0,0,deny,455,455,0,1,0,1,0
57386,53,9687,53,allow,186,95,91,2,31,1,1
50593,445,0,0,drop,66,66,0,1,0,1,0
1560,51505,0,0,deny,62,62,0,1,0,1,0
42625,443,18977,443,allow,218298,5904,212394,220,120,63,157
16387,64075,0,0,deny,60,60,0,1,0,1,0
54691,443,33638,443,allow,4851,1269,3582,21,148,9,12
57220,53,51033,53,allow,701,88,613,2,30,1,1
62341,26467,0,0,deny,66,66,0,1,0,1,0
50185,443,5992,443,allow,6350,1071,5279,18,42,10,8
49454,445,0,0,drop,66,66,0,1,0,1,0
61379,445,0,0,drop,70,70,0,1,0,1,0
33768,53,59037,53,allow,168,78,90,2,29,1,1
32704,25174,0,0,deny,62,62,0,1,0,1,0
56282,3389,56282,3389,allow,3425,1470,1955,16,16,8,8
41390,443,29292,443,allow,7240,2035,5205,25,316,12,13
63708,445,0,0,drop,70,70,0,1,0,1,0
38549,22114,0,0,deny,146,146,0,1,0,1,0
55256,445,0,0,drop,70,70,0,1,0,1,0
12471,31573,0,0,deny,62,62,0,1,0,1,0
30179,57470,0,0,deny,60,60,0,1,0,1,0
55055,80,30882,80,allow,306,180,126,6,26,4,2
50508,445,0,0,drop,66,66,0,1,0,1,0
39921,80,15019,80,allow,1151,711,440,10,15,5,5
20168,81,0,0,deny,60,60,0,1,0,1,0
49658,53,43401,53,allow,211,102,109,2,30,1,1
16387,20045,0,0,deny,60,60,0,1,0,1,0
65335,445,0,0,drop,66,66,0,1,0,1,0
54953,53,51225,53,allow,289,134,155,2,30,1,1
57470,24874,7043,24874,allow,132,132,0,3,1199,3,0
60480,57470,0,0,deny,62,62,0,1,0,1,0
58510,445,0,0,drop,70,70,0,1,0,1,0
49485,56972,0,0,deny,66,66,0,1,0,1,0
57470,6346,6625,6346,allow,330,330,0,6,1200,6,0
10886,51505,0,0,deny,62,62,0,1,0,1,0
64911,53,61645,53,allow,202,103,99,2,31,1,1
44847,51572,8318,51572,allow,509,150,359,2,1200,1,1
51506,445,0,0,drop,70,70,0,1,0,1,0
1024,5529,0,0,deny,146,146,0,1,0,1,0
56860,49991,48987,49991,allow,70,70,0,1,5,1,0
62854,443,62854,443,allow,4579,1672,2907,19,29,11,8
26467,6969,46826,6969,allow,192,192,0,4,1200,4,0
58748,80,58748,80,allow,6516,564,5952,16,25,7,9
37616,443,22145,443,allow,6506,1356,5150,24,16,14,10
45908,33330,0,0,deny,60,60,0,1,0,1,0
54960,53,7818,53,allow,448,184,264,6,30,3,3
11133,51505,0,0,deny,66,66,0,1,0,1,0
443,9986,0,0,deny,152,152,0,1,0,1,0
51602,22114,0,0,deny,66,66,0,1,0,1,0
64652,53,53769,53,allow,198,94,104,2,30,1,1
48676,53389,0,0,deny,60,60,0,1,0,1,0
22602,53,22602,53,allow,217,87,130,2,30,1,1
53692,44512,0,0,deny,66,66,0,1,0,1,0
10552,25174,0,0,deny,62,62,0,1,0,1,0
52100,54130,1109,54130,allow,70,70,0,1,4,1,0
8999,8055,0,0,deny,146,146,0,1,0,1,0
36791,80,9992,80,allow,196328,10952,185376,244,31,117,127
64554,53,41182,53,allow,199,102,97,2,30,1,1
46261,80,62301,80,allow,3578,1673,1905,16,186,9,7
49474,7000,49474,7000,allow,3100,783,2317,14,15,7,7
51236,445,0,0,drop,66,66,0,1,0,1,0
37310,443,2394,443,allow,3950,2949,1001,26,69,15,11
58129,26467,0,0,deny,62,62,0,1,0,1,0
54917,60043,0,0,deny,66,66,0,1,0,1,0
64638,53,33072,53,allow,215,102,113,2,29,1,1
52712,443,61572,443,allow,348281,20002,328279,401,350,153,248
61336,61689,0,0,deny,66,66,0,1,0,1,0
55021,443,3999,443,allow,5987,1556,4431,19,47,12,7
49858,53,34344,53,allow,177,94,83,2,30,1,1
9748,21247,0,0,deny,66,66,0,1,0,1,0
65233,23117,0,0,deny,62,62,0,1,0,1,0
56654,53,54903,53,allow,102,102,0,2,31,2,0
51003,445,0,0,drop,70,70,0,1,0,1,0
63917,57826,39527,57826,allow,70,70,0,1,5,1,0
50901,26467,0,0,deny,66,66,0,1,0,1,0
54660,443,15942,443,allow,7077,3245,3832,24,173,12,12
54978,80,11814,80,allow,1448,539,909,17,32,9,8
57414,445,0,0,drop,66,66,0,1,0,1,0
17573,44847,0,0,deny,146,146,0,1,0,1,0
12532,80,12532,80,allow,6215,769,5446,14,16,7,7
12830,25174,0,0,deny,62,62,0,1,0,1,0
7222,57470,0,0,deny,62,62,0,1,0,1,0
61091,443,61091,443,allow,18924,5378,13546,33,18,19,14
48676,53393,0,0,deny,60,60,0,1,0,1,0
50334,445,0,0,drop,70,70,0,1,0,1,0
64155,53,25938,53,allow,183,94,89,2,30,1,1
59513,53,30834,53,allow,212,92,120,2,30,1,1
50524,445,0,0,drop,70,70,0,1,0,1,0
54957,445,0,0,drop,70,70,0,1,0,1,0
51988,53,22023,53,allow,78,78,0,1,30,1,0
57131,35776,0,0,deny,145,145,0,1,0,1,0
61353,443,57410,443,allow,4401,1654,2747,10,120,5,5
50022,53,4784,53,allow,198,110,88,2,29,1,1
39868,55839,0,0,deny,137,137,0,1,0,1,0
51884,22828,5463,22828,allow,70,70,0,2,8,2,0
62887,445,0,0,drop,70,70,0,1,0,1,0
52318,22114,0,0,deny,146,146,0,1,0,1,0
65171,53,47372,53,allow,760,97,663,2,31,1,1
55440,445,0,0,drop,70,70,0,1,0,1,0
51045,445,0,0,drop,66,66,0,1,0,1,0
57169,53,55485,53,allow,177,94,83,2,30,1,1
2707,37,0,0,deny,60,60,0,1,0,1,0
53844,22114,0,0,deny,62,62,0,1,0,1,0
64721,443,45723,443,allow,5552,927,4625,16,15,10,6
56265,445,0,0,drop,66,66,0,1,0,1,0
58458,17,0,0,deny,60,60,0,1,0,1,0
56204,53,16211,53,allow,195,102,93,2,30,1,1
37941,443,61204,443,allow,69429,16478,52951,156,182,83,73
52036,52608,61881,52608,allow,70,70,0,2,8,2,0
55625,445,0,0,drop,66,66,0,1,0,1,0
56293,53,53658,53,allow,166,86,80,2,30,1,1
44933,26467,0,0,deny,62,62,0,1,0,1,0
50136,445,0,0,drop,70,70,0,1,0,1,0
49418,27017,57316,27017,allow,262,78,184,2,30,1,1
54991,36829,0,0,deny,66,66,0,1,0,1,0
16387,64374,0,0,allow,60,60,0,1,61,1,0
51221,52423,24107,52423,allow,322,149,173,2,1201,1,1
50057,53,37422,53,allow,177,94,83,2,30,1,1
58099,445,0,0,drop,66,66,0,1,0,1,0
36542,3142,36542,3142,allow,138,78,60,2,6,1,1
39609,53,46701,53,allow,168,78,90,2,30,1,1
57512,443,32314,443,allow,4265,2639,1626,34,31,16,18
49160,16919,59131,16919,allow,868,150,718,4,1200,2,2
62620,445,0,0,drop,66,66,0,1,0,1,0
49204,445,0,0,drop,66,66,0,1,0,1,0
19840,7000,19840,7000,allow,3610,2043,1567,16,17,9,7
52642,6881,49230,6881,allow,1106,800,306,10,14,5,5
45587,443,45587,443,allow,5523,2276,3247,22,28,13,9
52240,52893,2825,52893,allow,66,66,0,1,5,1,0
64209,53,40539,53,allow,291,94,197,2,29,1,1
56448,53,42442,53,allow,177,94,83,2,30,1,1
65173,53,61112,53,allow,508,186,322,6,51,3,3
63765,445,0,0,drop,70,70,0,1,0,1,0
51115,80,32483,80,allow,1426,930,496,10,22,7,3
65531,53,44923,53,allow,193,102,91,2,30,1,1
6649,80,6649,80,allow,103631,2766,100865,110,39,38,72
57401,53,41706,53,allow,174,89,85,2,31,1,1
30765,56205,0,0,deny,66,66,0,1,0,1,0
25304,64147,0,0,deny,146,146,0,1,0,1,0
49629,53,19594,53,allow,916,86,830,2,30,1,1
56569,53,35579,53,allow,199,102,97,2,30,1,1
29178,35440,0,0,deny,66,66,0,1,0,1,0
4876,42920,0,0,deny,146,146,0,1,0,1,0
55684,53,8013,53,allow,214,110,104,2,30,1,1
64824,53,60323,53,allow,94,94,0,1,30,1,0
49342,53,37970,53,allow,200,102,98,2,30,1,1
5588,5588,0,0,allow,3562,1936,1626,48,194,24,24
51120,445,0,0,drop,66,66,0,1,0,1,0
64766,53,62502,53,allow,214,110,104,2,31,1,1
57309,443,42080,443,allow,134,60,74,3,6,2,1
57445,53,50878,53,allow,342,142,200,2,30,1,1
59750,445,0,0,drop,70,70,0,1,0,1,0
63925,53,47553,53,allow,388,134,254,2,30,1,1
27005,27054,38944,27054,allow,921,126,795,2,30,1,1
50873,80,11525,80,allow,173653,9305,164348,189,141,73,116
49512,445,0,0,drop,70,70,0,1,0,1,0
2990,64147,0,0,deny,66,66,0,1,0,1,0
50270,445,0,0,drop,70,70,0,1,0,1,0
56005,64147,0,0,deny,62,62,0,1,0,1,0
64836,53,53586,53,allow,241,94,147,2,30,1,1
36125,443,36185,443,allow,6620,1197,5423,22,129,12,10
65091,80,65091,80,allow,18499242,314733,18184509,19253,37,4700,14553
51698,445,0,0,drop,66,66,0,1,0,1,0
64019,53,58991,53,allow,267,94,173,2,30,1,1
64909,445,0,0,drop,70,70,0,1,0,1,0
50069,445,0,0,drop,70,70,0,1,0,1,0
5222,21212,0,0,deny,66,66,0,1,0,1,0
51735,50794,43847,50794,allow,70,70,0,2,8,2,0
28378,56205,0,0,deny,62,62,0,1,0,1,0
16387,3655,0,0,deny,60,60,0,1,0,1,0
56641,443,17125,443,allow,7942,1953,5989,20,15,11,9
12128,37965,0,0,deny,62,62,0,1,0,1,0
9246,35440,0,0,deny,62,62,0,1,0,1,0
65152,53,32824,53,allow,167,86,81,2,31,1,1
63538,80,37199,80,allow,578,518,60,2,5,1,1
59859,443,33487,443,allow,10266,7336,2930,49,222,24,25
64803,53,18696,53,allow,403,142,261,2,31,1,1
50655,80,3910,80,allow,1507,682,825,13,20,8,5
49113,50584,0,0,deny,62,62,0,1,0,1,0
56056,53,12861,53,allow,172,94,78,2,29,1,1
62373,445,0,0,drop,70,70,0,1,0,1,0
63690,64147,0,0,deny,62,62,0,1,0,1,0
51769,80,52683,80,allow,74039,4367,69672,91,19,40,51
56639,53,13077,53,allow,168,86,82,2,31,1,1
42252,33306,0,0,deny,60,60,0,1,0,1,0
53458,443,17930,443,allow,144165,6110,138055,170,31,67,103
63742,26305,43986,26305,allow,66,66,0,2,7,2,0
64693,26467,0,0,deny,62,62,0,1,0,1,0
65036,53,9458,53,allow,199,102,97,2,29,1,1
65503,445,0,0,drop,70,70,0,1,0,1,0
31748,56205,0,0,deny,62,62,0,1,0,1,0
43865,443,4892,443,allow,560,280,280,9,26,5,4
41348,5555,0,0,deny,60,60,0,1,0,1,0
19858,64147,0,0,deny,62,62,0,1,0,1,0
60368,445,0,0,drop,70,70,0,1,0,1,0
64724,53,43750,53,allow,195,102,93,2,30,1,1
2084,7000,2084,7000,allow,3566,1999,1567,16,15,8,8
52524,80,48631,80,allow,3224,2776,448,11,15,7,4
49125,53,10970,53,allow,168,78,90,2,30,1,1
49439,53,62852,53,allow,194,99,95,2,31,1,1
58639,443,58639,443,allow,4380,1473,2907,19,30,11,8
49664,37965,0,0,deny,66,66,0,1,0,1,0
54554,445,0,0,drop,70,70,0,1,0,1,0
58886,445,0,0,drop,66,66,0,1,0,1,0
42282,443,42282,443,allow,2052,1187,865,21,76,11,10
49431,53,43013,53,allow,194,102,92,2,30,1,1
49210,53,44765,53,allow,183,94,89,2,30,1,1
63896,80,57609,80,allow,314,192,122,6,15,4,2
31066,57470,0,0,deny,74,74,0,1,0,1,0
65386,53,20616,53,allow,762,101,661,2,30,1,1
53490,62413,0,0,deny,66,66,0,1,0,1,0
26504,80,26504,80,allow,13592,1419,12173,25,31,13,12
50881,50584,0,0,deny,66,66,0,1,0,1,0
62724,443,24098,443,allow,11195,2218,8977,36,80,18,18
1253,25174,0,0,deny,146,146,0,1,0,1,0
60822,443,12029,443,allow,7839,2697,5142,21,137,10,11
60302,443,30801,443,allow,39850,4375,35475,73,80,31,42
58837,443,12859,443,allow,13120,8597,4523,34,17,18,16
47152,443,10144,443,allow,11278,2044,9234,32,178,17,15
51705,22114,0,0,deny,66,66,0,1,0,1,0
49489,443,60116,443,allow,1627,884,743,12,27,6,6
49203,53,20527,53,allow,168,86,82,2,31,1,1
55434,53,17321,53,allow,1335,87,1248,4,38,2,2
52497,445,0,0,drop,70,70,0,1,0,1,0
50940,443,10678,443,allow,6888,1774,5114,25,210,14,11
28192,50584,0,0,deny,66,66,0,1,0,1,0
56258,53,19240,53,allow,167,86,81,2,30,1,1
57494,443,51749,443,allow,2435128,54736,2380392,2151,346,331,1820
6881,60026,38643,60026,allow,509,150,359,2,1199,1,1
38662,443,42991,443,allow,6525,1695,4830,19,51,8,11
10627,23117,0,0,deny,62,62,0,1,0,1,0
54305,39004,0,0,deny,62,62,0,1,0,1,0
57626,443,3957,443,allow,3858,1277,2581,12,120,6,6
56214,53,17373,53,allow,200,102,98,2,30,1,1
53283,445,0,0,drop,70,70,0,1,0,1,0
61471,445,0,0,drop,70,70,0,1,0,1,0
52080,443,29531,443,allow,3052,2014,1038,16,15,9,7
62769,25174,0,0,deny,62,62,0,1,0,1,0
59749,445,0,0,drop,70,70,0,1,0,1,0
52021,445,0,0,drop,66,66,0,1,0,1,0
59808,443,49702,443,allow,147637,6160,141477,164,121,56,108
65461,445,0,0,drop,70,70,0,1,0,1,0
39380,1,0,0,deny,146,146,0,1,0,1,0
57153,445,0,0,drop,70,70,0,1,0,1,0
64332,445,0,0,drop,70,70,0,1,0,1,0
51136,80,1499,80,allow,366,240,126,7,21,5,2
11992,443,11992,443,allow,12020,5977,6043,38,30,23,15
65229,53,65354,53,allow,190,97,93,2,31,1,1
9064,443,8179,443,allow,11738,6980,4758,34,81,19,15
65186,53,43195,53,allow,733,85,648,2,31,1,1
61314,23,0,0,deny,60,60,0,1,0,1,0
51666,445,0,0,drop,70,70,0,1,0,1,0
2467,2767,0,0,deny,66,66,0,1,0,1,0
26900,27017,57594,27017,allow,172,86,86,2,30,1,1
49950,80,54747,80,allow,3991,620,3371,14,15,7,7
45964,2225,0,0,deny,60,60,0,1,0,1,0
41381,23,0,0,deny,60,60,0,1,0,1,0
53385,445,0,0,drop,70,70,0,1,0,1,0
61676,443,64478,443,allow,6353,1520,4833,20,17,12,8
443,29326,0,0,deny,82,82,0,1,0,1,0
45144,25174,0,0,deny,62,62,0,1,0,1,0
23843,26467,0,0,deny,62,62,0,1,0,1,0
65485,53,26681,53,allow,184,94,90,2,29,1,1
50775,445,0,0,drop,66,66,0,1,0,1,0
3580,25174,0,0,deny,62,62,0,1,0,1,0
9552,57470,0,0,deny,62,62,0,1,0,1,0
51111,80,8917,80,allow,366,240,126,7,21,5,2
55947,53,33524,53,allow,311,108,203,4,42,2,2
56635,445,0,0,drop,70,70,0,1,0,1,0
50739,445,0,0,drop,70,70,0,1,0,1,0
22542,30188,0,0,deny,62,62,0,1,0,1,0
60514,39004,0,0,deny,66,66,0,1,0,1,0
49418,27058,37318,27058,allow,263,78,185,2,30,1,1
50263,53,56865,53,allow,164,86,78,2,29,1,1
51925,80,55386,80,allow,51645,3868,47777,67,28,30,37
65052,53,39393,53,allow,200,94,106,2,30,1,1
49592,80,33337,80,allow,4173,2324,1849,14,42,8,6
64930,53,11667,53,allow,317,96,221,4,32,2,2
58876,57470,0,0,deny,66,66,0,1,0,1,0
49790,53,34832,53,allow,195,102,93,2,30,1,1
50272,53,50516,53,allow,168,78,90,2,30,1,1
59864,445,0,0,drop,70,70,0,1,0,1,0
43199,5228,42030,5228,allow,10588,2455,8133,46,5724,19,27
58260,445,0,0,drop,70,70,0,1,0,1,0
33503,5529,0,0,deny,146,146,0,1,0,1,0
58638,5900,0,0,deny,62,62,0,1,0,1,0
36687,53,34461,53,allow,168,78,90,2,31,1,1
37669,443,48889,443,allow,24415,3924,20491,45,48,22,23
443,52365,0,0,deny,97,97,0,1,0,1,0
2636,7302,0,0,deny,66,66,0,1,0,1,0
56845,27201,52716,27201,allow,316,136,180,6,7,3,3
55545,53,22001,53,allow,177,94,83,2,30,1,1
13110,52126,0,0,deny,145,145,0,1,0,1,0
56523,443,42102,443,allow,5212,1037,4175,20,115,10,10
51715,29358,11619,29358,allow,414,136,278,6,16,3,3
51658,80,26955,80,allow,39464,2150,37314,81,20,26,55
64860,445,0,0,drop,66,66,0,1,0,1,0
50532,443,27098,443,allow,7416,1777,5639,23,74,12,11
56832,80,37022,80,allow,54049,2036,52013,69,18,31,38
53907,45622,15618,45622,allow,70,70,0,1,4,1,0
52463,445,0,0,drop,70,70,0,1,0,1,0
60379,443,42355,443,allow,4162,2121,2041,25,95,14,11
29145,8168,0,0,deny,62,62,0,1,0,1,0
55318,53,32183,53,allow,167,86,81,2,31,1,1
64104,445,0,0,drop,70,70,0,1,0,1,0
54761,443,53919,443,allow,103367,3730,99637,117,170,42,75
32892,23,0,0,deny,60,60,0,1,0,1,0
56504,443,16127,443,allow,4467051,102279,4364772,4340,46,1452,2888
12545,25174,0,0,deny,62,62,0,1,0,1,0
56344,53,18094,53,allow,167,86,81,2,30,1,1
54672,443,56107,443,allow,2285,1130,1155,25,120,12,13
39624,53,30103,53,allow,168,78,90,2,30,1,1
25803,53,25803,53,allow,231,88,143,2,33,1,1
56884,53,31028,53,allow,177,94,83,2,30,1,1
64322,53,46298,53,allow,273,90,183,4,32,2,2
54047,50011,0,0,deny,66,66,0,1,0,1,0
61987,445,0,0,drop,70,70,0,1,0,1,0
60104,445,0,0,drop,66,66,0,1,0,1,0
64287,445,0,0,drop,70,70,0,1,0,1,0
50041,443,57357,443,allow,1097,654,443,12,86,7,5
50481,80,4638,80,allow,318,192,126,6,25,4,2
65316,53,63877,53,allow,780,93,687,2,30,1,1
50387,445,0,0,drop,70,70,0,1,0,1,0
3928,64147,0,0,deny,62,62,0,1,0,1,0
56990,445,0,0,drop,70,70,0,1,0,1,0
47165,15000,50664,15000,allow,130,70,60,2,5,1,1
46904,443,22687,443,allow,1314,653,661,13,184,7,6
443,9986,0,0,deny,669,669,0,1,0,1,0
46337,443,56368,443,allow,10379011,159069,10219942,8727,252,1321,7406
57639,445,0,0,drop,70,70,0,1,0,1,0
60368,443,19000,443,allow,10387,2575,7812,26,108,13,13
64017,53,51575,53,allow,202,103,99,2,30,1,1
54606,445,0,0,drop,70,70,0,1,0,1,0
54187,445,0,0,drop,66,66,0,1,0,1,0
51880,445,0,0,drop,70,70,0,1,0,1,0
52665,445,0,0,drop,66,66,0,1,0,1,0
64289,53,28932,53,allow,199,102,97,2,30,1,1
53800,53,27732,53,allow,260,86,174,2,30,1,1
64870,53,51566,53,allow,200,102,98,2,30,1,1
55317,53,36634,53,allow,711,87,624,2,31,1,1
51895,17172,22553,17172,allow,70,70,0,1,5,1,0
51499,445,0,0,drop,66,66,0,1,0,1,0
49383,53,63729,53,allow,226,110,116,2,30,1,1
56069,445,0,0,drop,66,66,0,1,0,1,0
60006,80,32015,80,allow,1836,816,1020,12,143,7,5
55267,53,21533,53,allow,168,86,82,2,30,1,1
52985,445,0,0,drop,66,66,0,1,0,1,0
44746,37965,0,0,deny,62,62,0,1,0,1,0
52925,443,23150,443,allow,5582,1388,4194,19,15,9,10
50007,80,25590,80,allow,2089,1161,928,10,86,6,4
48817,1024,48817,1024,allow,152,152,0,1,1200,1,0
50898,443,4601,443,allow,8480,2236,6244,27,81,15,12
53794,445,0,0,drop,70,70,0,1,0,1,0
60423,35440,0,0,deny,146,146,0,1,0,1,0
64507,53,28479,53,allow,382,102,280,2,29,1,1
61159,445,0,0,drop,66,66,0,1,0,1,0
64055,53,52345,53,allow,181,94,87,2,29,1,1
65484,445,0,0,drop,70,70,0,1,0,1,0
56440,53,62063,53,allow,212,102,110,2,30,1,1
63615,445,0,0,drop,70,70,0,1,0,1,0
58638,5900,0,0,deny,62,62,0,1,0,1,0
44847,58839,4824,58839,allow,501,150,351,2,1200,1,1
65533,53,35566,53,allow,277,134,143,2,30,1,1
43215,443,55751,443,allow,3245691,49693,3195998,2856,38,666,2190
54280,3398,0,0,deny,60,60,0,1,0,1,0
56278,52752,0,0,deny,62,62,0,1,0,1,0
51143,443,51143,443,allow,33565,5938,27627,60,128,24,36
52529,80,44880,80,allow,1056,682,374,10,15,6,4
58284,445,0,0,drop,70,70,0,1,0,1,0
58148,43890,0,0,deny,62,62,0,1,0,1,0
61196,53,61196,53,allow,213,79,134,2,32,1,1
49437,443,4843,443,allow,9621,2347,7274,24,78,12,12
54497,443,48697,443,allow,8318,2068,6250,32,270,16,16
1827,64147,0,0,deny,66,66,0,1,0,1,0
64605,35993,0,0,deny,66,66,0,1,0,1,0
49725,443,10242,443,allow,311104,8270,302834,336,18,99,237
50052,65008,0,0,deny,60,60,0,1,0,1,0
54192,443,18650,443,allow,17821,7006,10815,95,448,48,47
53002,443,30088,443,allow,16537,4585,11952,46,96,24,22
35377,43890,0,0,deny,62,62,0,1,0,1,0
56697,53,16898,53,allow,198,102,96,2,29,1,1
10586,37965,0,0,deny,62,62,0,1,0,1,0
59895,443,59498,443,allow,1537,934,603,14,32,7,7
52029,445,0,0,drop,66,66,0,1,0,1,0
63241,445,0,0,drop,66,66,0,1,0,1,0
40650,443,51106,443,allow,7298,2661,4637,21,17,11,10
51518,443,15866,443,allow,38155,33545,4610,79,26,42,37
53828,443,58283,443,allow,499,425,74,4,0,3,1
43129,15503,0,0,deny,62,62,0,1,0,1,0
55057,80,24701,80,allow,306,180,126,6,26,4,2
63817,445,0,0,drop,70,70,0,1,0,1,0
39486,80,4046,80,allow,1184,524,660,7,78,4,3
49316,53,52712,53,allow,338,102,236,2,30,1,1
10669,49756,0,0,deny,60,60,0,1,0,1,0
57138,443,50278,443,allow,498,210,288,8,26,4,4
2932,44847,0,0,deny,66,66,0,1,0,1,0
49459,53,5838,53,allow,199,102,97,2,29,1,1
55635,38649,60618,38649,allow,70,70,0,2,8,2,0
58816,443,57126,443,allow,5168,700,4468,16,15,7,9
51085,56205,0,0,deny,66,66,0,1,0,1,0
54151,443,32501,443,allow,1749,966,783,13,75,8,5
8892,443,11185,443,allow,8106,1626,6480,31,341,11,20
65206,53,13449,53,allow,330,118,212,2,30,1,1
9588,37965,0,0,deny,66,66,0,1,0,1,0
45315,80,28283,80,allow,6087687,127446,5960241,5920,28,1981,3939
49923,53,15331,53,allow,199,94,105,2,30,1,1
56909,50584,0,0,deny,66,66,0,1,0,1,0
39719,443,7093,443,allow,450036,17745,432291,541,217,241,300
62235,445,0,0,drop,70,70,0,1,0,1,0
65167,445,0,0,drop,70,70,0,1,0,1,0
56907,53,52225,53,allow,193,102,91,2,30,1,1
56202,15503,0,0,deny,146,146,0,1,0,1,0
51951,80,50498,80,allow,366,240,126,7,28,5,2
61394,445,0,0,drop,66,66,0,1,0,1,0
49538,53,56684,53,allow,258,102,156,2,30,1,1
60415,53,60415,53,allow,257,101,156,2,33,1,1
46308,123,1425,123,allow,184,94,90,2,30,1,1
55187,53,20282,53,allow,256,93,163,2,30,1,1
22263,53,22263,53,allow,288,83,205,2,30,1,1
53894,443,56603,443,allow,499,425,74,4,0,3,1
49812,53,36103,53,allow,1411,98,1313,4,52,2,2
54460,443,28221,443,allow,7372,1764,5608,27,547,15,12
14237,53,14237,53,allow,245,98,147,2,29,1,1
56912,443,18350,443,allow,7618,2859,4759,26,17,14,12
54644,443,54644,443,allow,103968,5475,98493,141,18,63,78
55286,53,26564,53,allow,268,87,181,4,35,2,2
57203,445,0,0,drop,66,66,0,1,0,1,0
55717,13517,61965,13517,allow,70,70,0,2,8,2,0
46975,443,49913,443,allow,70,70,0,1,5,1,0
56323,445,0,0,drop,66,66,0,1,0,1,0
42315,443,13240,443,allow,13090,9437,3653,43,188,14,29
56456,53,58146,53,allow,199,102,97,2,30,1,1
49323,53,61963,53,allow,196,102,94,2,30,1,1
65423,443,16318,443,allow,5854,1796,4058,21,142,10,11
56683,443,56683,443,allow,4533,1626,2907,19,28,11,8
47827,67,0,0,deny,60,60,0,1,0,1,0
49730,443,62541,443,allow,400810,14719,386091,506,39,164,342
63128,443,30036,443,allow,4994,379,4615,9,15,4,5
11716,37965,0,0,deny,62,62,0,1,0,1,0
51631,443,52849,443,allow,36602,1919,34683,58,80,19,39
58638,5900,0,0,deny,62,62,0,1,0,1,0
62278,445,0,0,drop,70,70,0,1,0,1,0
64818,53,60686,53,allow,179,94,85,2,30,1,1
46116,51505,0,0,deny,62,62,0,1,0,1,0
57072,53,14779,53,allow,195,102,93,2,30,1,1
40980,443,52078,443,allow,567854,22650,545204,713,158,311,402
58043,445,0,0,drop,70,70,0,1,0,1,0
51274,24399,41980,24399,allow,70,70,0,1,5,1,0
48279,8080,0,0,allow,368,156,212,5,13,3,2
58638,5900,0,0,deny,62,62,0,1,0,1,0
62665,445,0,0,drop,66,66,0,1,0,1,0
61385,445,0,0,drop,70,70,0,1,0,1,0
61119,53,61119,53,allow,217,90,127,2,29,1,1
37555,16384,64075,16384,allow,432,192,240,8,30,4,4
56062,53,34305,53,allow,196,102,94,2,30,1,1
11450,57470,0,0,deny,66,66,0,1,0,1,0
56724,53,34585,53,allow,308,97,211,4,45,2,2
25296,51505,0,0,deny,66,66,0,1,0,1,0
63877,445,0,0,drop,70,70,0,1,0,1,0
55447,53,41152,53,allow,194,102,92,2,30,1,1
55057,443,7517,443,allow,1364,940,424,12,16,7,5
52022,80,47623,80,allow,422,240,182,8,24,5,3
42156,80,29548,80,allow,891,536,355,10,255,6,4
56462,37965,0,0,deny,66,66,0,1,0,1,0
56352,53,39464,53,allow,177,94,83,2,30,1,1
49621,443,55607,443,allow,46983,4167,42816,66,44,28,38
60445,20555,43690,20555,allow,70,70,0,2,8,2,0
64968,53,62769,53,allow,767,102,665,2,30,1,1
54121,25174,0,0,deny,66,66,0,1,0,1,0
50727,27029,42555,27029,allow,269,78,191,2,30,1,1
36881,443,36881,443,allow,4652,1745,2907,19,28,11,8
54145,7000,54145,7000,allow,3370,1595,1775,16,15,9,7
50572,80,21152,80,allow,132,132,0,2,8,2,0
44979,443,29869,443,allow,130,70,60,3,5,2,1
16387,8455,0,0,deny,60,60,0,1,0,1,0
53910,445,0,0,drop,66,66,0,1,0,1,0
43563,53,1876,53,allow,164,78,86,2,30,1,1
49556,443,19377,443,allow,198375,6279,192096,205,153,69,136
56278,52752,0,0,deny,62,62,0,1,0,1,0
9298,443,38844,443,allow,4216,771,3445,16,26,9,7
57327,443,38850,443,allow,5613,733,4880,16,15,9,7
56773,28093,43311,28093,allow,70,70,0,1,5,1,0
51260,80,28140,80,allow,2339,1680,659,11,17,6,5
40358,443,63081,443,allow,626,352,274,10,16,6,4
53789,53,10128,53,allow,167,78,89,2,30,1,1
59082,445,0,0,drop,70,70,0,1,0,1,0
13020,26467,0,0,deny,62,62,0,1,0,1,0
61059,445,0,0,drop,70,70,0,1,0,1,0
53928,445,0,0,drop,66,66,0,1,0,1,0
53261,443,44593,443,allow,5025,973,4052,19,53,10,9
51570,443,51570,443,allow,11204,3773,7431,29,132,12,17
46837,57470,0,0,deny,62,62,0,1,0,1,0
58877,53,28014,53,allow,426,118,308,2,31,1,1
64375,445,0,0,drop,66,66,0,1,0,1,0
49363,53,56997,53,allow,309,94,215,2,29,1,1
60003,36829,0,0,deny,66,66,0,1,0,1,0
40547,24051,0,0,deny,74,74,0,1,0,1,0
65087,53,28763,53,allow,229,94,135,2,30,1,1
52676,53733,0,0,deny,66,66,0,1,0,1,0
55384,53,37937,53,allow,188,96,92,2,31,1,1
63563,24096,60999,24096,allow,198,198,0,1,5,1,0
49100,80,49100,80,allow,3568,2889,679,13,23,8,5
63838,445,0,0,drop,70,70,0,1,0,1,0
57010,53,64390,53,allow,199,102,97,2,30,1,1
50673,445,0,0,drop,66,66,0,1,0,1,0
53852,80,48149,80,allow,130,70,60,2,15,1,1
49767,53,20343,53,allow,177,94,83,2,29,1,1
35965,443,35465,443,allow,14940,9434,5506,30,105,17,13
19330,25174,0,0,deny,62,62,0,1,0,1,0
63368,445,0,0,drop,66,66,0,1,0,1,0
38640,80,6468,80,allow,1013,504,509,10,15,6,4
7619,50584,0,0,deny,146,146,0,1,0,1,0
55358,53,38932,53,allow,183,94,89,2,29,1,1
50584,6881,48204,6881,allow,161,161,0,1,1200,1,0
56917,53,28057,53,allow,194,102,92,2,31,1,1
62899,993,51481,993,allow,9385,3246,6139,53,118,31,22
45286,62413,0,0,deny,146,146,0,1,0,1,0
60740,80,7735,80,allow,254,128,126,5,16,3,2
51697,60619,59919,60619,allow,70,70,0,1,5,1,0
58638,5900,0,0,deny,62,62,0,1,0,1,0
30434,53,30434,53,allow,197,90,107,2,30,1,1
31675,19473,0,0,deny,145,145,0,1,0,1,0
64684,53,15819,53,allow,184,94,90,2,31,1,1
7892,50584,0,0,deny,62,62,0,1,0,1,0
65377,443,4212,443,allow,4864,2496,2368,33,121,17,16
56808,54393,38896,54393,allow,70,70,0,1,5,1,0
59937,37965,0,0,deny,66,66,0,1,0,1,0
37308,43890,0,0,deny,62,62,0,1,0,1,0
58852,443,26155,443,allow,3723,1793,1930,21,69,10,11
50265,59362,35253,59362,allow,4228,2471,1757,55,2758,31,24
32100,53,32100,53,allow,200,90,110,2,29,1,1
62716,2323,0,0,deny,60,60,0,1,0,1,0
59405,443,49077,443,allow,10726,4848,5878,79,588,40,39
50234,53,30924,53,allow,775,102,673,2,30,1,1
56756,13973,64423,13973,allow,70,70,0,1,5,1,0
50584,62758,61935,62758,allow,161,161,0,2,1199,2,0
59342,445,0,0,drop,70,70,0,1,0,1,0
60558,51221,0,0,deny,62,62,0,1,0,1,0
61711,35440,0,0,deny,66,66,0,1,0,1,0
56357,53,43441,53,allow,819,102,717,2,30,1,1
9696,16010,0,0,deny,60,60,0,1,0,1,0
58638,5900,0,0,deny,62,62,0,1,0,1,0
57363,53,6725,53,allow,172,88,84,2,31,1,1
52569,30188,0,0,deny,66,66,0,1,0,1,0
54918,445,0,0,drop,70,70,0,1,0,1,0
62896,445,0,0,drop,70,70,0,1,0,1,0
56367,443,45911,443,allow,3674,1750,1924,23,203,12,11
56395,53,28310,53,allow,177,94,83,2,30,1,1
55463,53,9844,53,allow,216,110,106,2,31,1,1
64024,57470,0,0,deny,66,66,0,1,0,1,0
55765,53,10201,53,allow,770,101,669,2,30,1,1
53775,8999,38559,8999,allow,320,140,180,6,5,3,3
57593,80,6872,80,allow,486,280,206,8,26,5,3
9516,443,9863,443,allow,3909,369,3540,16,35,5,11
50554,80,7103,80,allow,378,192,186,7,26,4,3
57642,445,0,0,drop,70,70,0,1,0,1,0
49552,53,34956,53,allow,194,102,92,2,30,1,1
52124,80,5847,80,allow,366,240,126,7,26,5,2
3578,51505,0,0,deny,62,62,0,1,0,1,0
38710,443,50238,443,allow,89931,3417,86514,94,15,30,64
56704,445,0,0,drop,66,66,0,1,0,1,0
63008,445,0,0,drop,70,70,0,1,0,1,0
19209,62413,0,0,deny,146,146,0,1,0,1,0
63888,57470,0,0,deny,62,62,0,1,0,1,0
38643,443,16669,443,allow,2540,1317,1223,17,28,9,8
51768,61765,18579,61765,allow,70,70,0,2,8,2,0
0,0,0,0,deny,98,98,0,1,0,1,0
51470,445,0,0,drop,70,70,0,1,0,1,0
50694,80,52061,80,allow,3481,1576,1905,17,187,10,7
53918,53,0,0,allow,222,82,140,2,30,1,1
51903,26467,0,0,deny,62,62,0,1,0,1,0
53784,16671,49140,16671,allow,70,70,0,2,7,2,0
19763,53,19763,53,allow,216,82,134,2,32,1,1
49420,80,13977,80,allow,1985,657,1328,11,21,6,5
5223,32965,0,0,deny,220,220,0,1,0,1,0
35452,443,39555,443,allow,5120,3761,1359,21,49,12,9
9452,443,55218,443,allow,5693,499,5194,14,15,7,7
62056,30317,0,0,deny,146,146,0,1,0,1,0
52709,445,0,0,drop,66,66,0,1,0,1,0
11859,64147,0,0,deny,62,62,0,1,0,1,0
57470,6881,1701,6881,allow,453,251,202,4,1199,2,2
24288,23,0,0,deny,60,60,0,1,0,1,0
28316,3389,28316,3389,allow,4695,2520,2175,22,19,13,9
53134,443,53110,443,allow,8361,2182,6179,26,40,15,11
49805,64147,0,0,deny,66,66,0,1,0,1,0
16620,25174,0,0,deny,62,62,0,1,0,1,0
56638,443,63919,443,allow,7855,1866,5989,20,15,11,9
58638,5900,0,0,deny,62,62,0,1,0,1,0
59699,55783,0,0,deny,62,62,0,1,0,1,0
58149,443,24568,443,allow,153,93,60,2,5,1,1
51443,445,0,0,drop,66,66,0,1,0,1,0
49438,443,56148,443,allow,180,60,120,4,15,2,2
54334,445,0,0,drop,70,70,0,1,0,1,0
3478,61463,0,0,deny,164,164,0,1,0,1,0
51772,443,20083,443,allow,2320,327,1993,11,135,5,6
62071,22114,0,0,deny,62,62,0,1,0,1,0
64719,53,55102,53,allow,263,118,145,2,30,1,1
56609,443,31583,443,allow,7982,1962,6020,20,15,11,9
58638,5900,0,0,deny,62,62,0,1,0,1,0
56085,445,0,0,drop,66,66,0,1,0,1,0
62027,445,0,0,drop,70,70,0,1,0,1,0
58638,5900,0,0,deny,62,62,0,1,0,1,0
68,67,0,0,deny,346,346,0,1,0,1,0
12226,37965,0,0,deny,62,62,0,1,0,1,0
3117,37965,0,0,deny,62,62,0,1,0,1,0
49787,53,45265,53,allow,196,94,102,2,30,1,1
56816,12523,45890,12523,allow,70,70,0,1,5,1,0
53654,8100,50250,8100,allow,70,70,0,1,5,1,0
55937,443,21508,443,allow,3363,797,2566,14,135,7,7
55996,53,10816,53,allow,168,86,82,2,30,1,1
34942,443,50978,443,allow,4317,2189,2128,29,82,15,14
26502,64147,0,0,deny,62,62,0,1,0,1,0
62447,445,0,0,drop,70,70,0,1,0,1,0
57674,53,0,0,allow,195,79,116,2,30,1,1
50901,26467,0,0,deny,66,66,0,1,0,1,0
52174,43106,42661,43106,allow,258,70,188,4,9,2,2
32228,53,32228,53,allow,228,90,138,2,33,1,1
39616,443,20055,443,allow,60,60,0,2,5,2,0
60037,443,65363,443,allow,4722,2945,1777,18,142,10,8
58888,443,23971,443,allow,7329,949,6380,17,35,7,10
50800,445,0,0,drop,66,66,0,1,0,1,0
62177,445,0,0,drop,66,66,0,1,0,1,0
44661,443,11205,443,allow,9468,2242,7226,23,15,12,11
49825,53,18724,53,allow,168,86,82,2,29,1,1
5729,22114,0,0,deny,62,62,0,1,0,1,0
54287,443,51264,443,allow,8603,853,7750,27,92,9,18
31871,53,40960,53,allow,209,86,123,2,29,1,1
42279,443,42279,443,allow,3414,1979,1435,22,69,11,11
64716,445,0,0,drop,66,66,0,1,0,1,0
49845,443,44493,443,allow,5996,976,5020,19,72,10,9
56367,53,31807,53,allow,194,102,92,2,30,1,1
56554,445,0,0,drop,70,70,0,1,0,1,0
63085,445,0,0,drop,70,70,0,1,0,1,0
64622,36829,0,0,deny,62,62,0,1,0,1,0
60208,80,42230,80,allow,1313,738,575,10,152,6,4
49159,53,5839,53,allow,195,86,109,2,30,1,1
50277,443,37349,443,allow,3182,1568,1614,8,120,4,4
51374,30317,0,0,deny,66,66,0,1,0,1,0
55748,445,0,0,drop,70,70,0,1,0,1,0
50755,80,64278,80,allow,1783,1346,437,7,15,5,2
56800,443,17462,443,allow,8074,2054,6020,20,16,11,9
6121,51505,0,0,deny,66,66,0,1,0,1,0
65403,53,40925,53,allow,199,102,97,2,29,1,1
47971,443,27561,443,allow,11482,2506,8976,48,1329,24,24
47090,15000,28011,15000,allow,138,78,60,2,5,1,1
55311,445,0,0,drop,70,70,0,1,0,1,0
52572,445,0,0,drop,70,70,0,1,0,1,0
55893,45711,0,0,deny,78,78,0,1,0,1,0
55698,53,13157,53,allow,742,88,654,2,31,1,1
60321,443,49674,443,allow,1743,1164,579,16,25,10,6
14442,443,28353,443,allow,2601,1455,1146,18,15,8,10
65024,53,19328,53,allow,199,102,97,2,30,1,1
53789,53,48550,53,allow,168,78,90,2,30,1,1
51715,443,60037,443,allow,4887,2346,2541,16,120,8,8
63938,53,63032,53,allow,385,110,275,2,30,1,1
57426,66,14765,66,allow,70,70,0,2,8,2,0
49797,25174,0,0,deny,66,66,0,1,0,1,0
52231,50934,0,0,deny,62,62,0,1,0,1,0
51503,443,56151,443,allow,887,635,252,7,23,3,4
52462,25174,0,0,deny,66,66,0,1,0,1,0
53113,8372,13040,8372,allow,758,320,438,11,17,6,5
49399,53,15486,53,allow,775,102,673,2,30,1,1
58638,445,0,0,drop,70,70,0,1,0,1,0
11688,23718,0,0,deny,62,62,0,1,0,1,0
65524,53,59878,53,allow,183,94,89,2,30,1,1
3478,61463,0,0,deny,927,927,0,1,0,1,0
1114,37965,0,0,deny,62,62,0,1,0,1,0
64002,53,17468,53,allow,796,105,691,4,59,2,2
51271,37965,0,0,deny,66,66,0,1,0,1,0
65231,53,23789,53,allow,200,102,98,2,31,1,1
49402,445,0,0,drop,66,66,0,1,0,1,0
61419,443,21446,443,allow,1664127,116770,1547357,2028,401,736,1292
50200,44847,0,0,deny,74,74,0,1,0,1,0
50078,443,50829,443,allow,7418,2721,4697,23,17,12,11
53704,23,0,0,deny,60,60,0,1,0,1,0
49580,443,38727,443,allow,442,262,180,8,42,5,3
27005,27015,45770,27015,allow,874,126,748,2,30,1,1
25010,30188,0,0,deny,62,62,0,1,0,1,0
49383,445,0,0,drop,70,70,0,1,0,1,0
61360,443,42103,443,allow,7653,1226,6427,24,18,14,10
62241,443,33164,443,allow,7205,2250,4955,16,120,7,9
54538,443,10842,443,allow,2936,1546,1390,17,70,10,7
65121,53,39585,53,allow,440,94,346,4,37,2,2
64903,53,57537,53,allow,210,110,100,2,30,1,1
56020,53,46192,53,allow,199,102,97,2,30,1,1
23274,50584,0,0,deny,62,62,0,1,0,1,0
51684,445,0,0,drop,66,66,0,1,0,1,0
50384,443,60892,443,allow,7723,2591,5132,23,49,12,11
64927,445,0,0,drop,70,70,0,1,0,1,0
57151,445,0,0,drop,66,66,0,1,0,1,0
48258,37965,0,0,deny,62,62,0,1,0,1,0
52098,5228,3628,5228,allow,3117,1602,1515,31,66,16,15
53633,443,6086,443,allow,8473,1099,7374,20,18,9,11
48230,57866,0,0,deny,62,62,0,1,0,1,0
56906,50584,0,0,deny,62,62,0,1,0,1,0
52093,40828,32567,40828,allow,258,70,188,4,8,2,2
63930,44330,31365,44330,allow,70,70,0,1,5,1,0
56400,53,12520,53,allow,819,102,717,2,30,1,1
56020,53,34140,53,allow,199,102,97,2,29,1,1
64691,25320,0,0,deny,62,62,0,1,0,1,0
51851,445,0,0,drop,70,70,0,1,0,1,0
56285,443,32543,443,allow,185763,7360,178403,201,120,68,133
53834,443,62616,443,allow,499,425,74,4,0,3,1
63876,445,0,0,drop,70,70,0,1,0,1,0
44821,64147,0,0,deny,62,62,0,1,0,1,0
49571,443,45165,443,allow,3972,887,3085,13,31,6,7
23650,37807,0,0,deny,62,62,0,1,0,1,0
54804,445,0,0,drop,66,66,0,1,0,1,0
58868,443,40093,443,allow,3867,2403,1464,17,15,8,9
58007,445,0,0,drop,70,70,0,1,0,1,0
50327,1433,0,0,deny,60,60,0,1,0,1,0
32071,51221,0,0,deny,62,62,0,1,0,1,0
34672,53,34672,53,allow,213,87,126,2,30,1,1
49198,53,16713,53,allow,261,94,167,2,29,1,1
50097,445,0,0,drop,66,66,0,1,0,1,0
53641,16605,52302,16605,allow,70,70,0,1,5,1,0
53443,123,34007,123,allow,184,94,90,2,30,1,1
46116,57470,0,0,deny,74,74,0,1,0,1,0
9748,21247,0,0,deny,66,66,0,1,0,1,0
58554,80,58554,80,allow,348,132,216,6,26,3,3
443,48346,0,0,deny,81,81,0,1,0,1,0
57408,53,58963,53,allow,195,102,93,2,33,1,1
50878,445,0,0,drop,66,66,0,1,0,1,0
49643,445,0,0,drop,70,70,0,1,0,1,0
13414,23,0,0,deny,60,60,0,1,0,1,0
35609,443,35165,443,allow,237,177,60,3,5,2,1
62486,53,59489,53,allow,102,102,0,1,30,1,0
48349,443,46666,443,allow,42932,2883,40049,63,14,31,32
52039,38541,32643,38541,allow,66,66,0,1,5,1,0
49236,53,51973,53,allow,377,94,283,2,30,1,1
53129,38413,41585,38413,allow,70,70,0,1,5,1,0
58759,445,0,0,drop,66,66,0,1,0,1,0
62045,443,52563,443,allow,10467,4259,6208,65,56,38,27
64687,53,9775,53,allow,183,94,89,2,29,1,1
56793,53,56695,53,allow,192,98,94,2,0,1,1
38772,443,61255,443,allow,410,210,200,7,86,4,3
50577,80,14735,80,allow,469212,19981,449231,601,134,276,325
42389,42873,0,0,deny,74,74,0,1,0,1,0
60439,445,0,0,drop,66,66,0,1,0,1,0
54096,445,0,0,drop,66,66,0,1,0,1,0
53888,39204,51033,39204,allow,70,70,0,1,5,1,0
49602,53,1592,53,allow,178,94,84,2,30,1,1
63022,445,0,0,drop,70,70,0,1,0,1,0
54367,3389,54367,3389,allow,4365,2581,1784,20,32,11,9
33569,443,7892,443,allow,7418,1880,5538,28,396,9,19
53644,58085,53471,58085,allow,70,70,0,1,4,1,0
57153,445,0,0,drop,66,66,0,1,0,1,0
6652,25174,0,0,deny,62,62,0,1,0,1,0
57459,51505,0,0,deny,66,66,0,1,0,1,0
13223,1310,0,0,deny,62,62,0,1,0,1,0
28229,51505,0,0,deny,146,146,0,1,0,1,0
60181,445,0,0,drop,66,66,0,1,0,1,0
63095,445,0,0,drop,70,70,0,1,0,1,0
40544,53,0,0,allow,82,82,0,1,30,1,0
55068,53,54785,53,allow,196,102,94,2,30,1,1
56893,53,20902,53,allow,177,94,83,2,31,1,1
50657,443,9730,443,allow,3339,2205,1134,21,38,13,8
123,123,4169,123,allow,184,94,90,2,31,1,1
57470,56432,6012,56432,allow,132,132,0,3,1199,3,0
33434,5228,15468,5228,allow,12979,2808,10171,46,648,21,25
49666,443,64744,443,allow,14531,7971,6560,36,190,20,16
55270,443,14179,443,allow,6098,778,5320,17,15,8,9
55179,443,6638,443,allow,5839,1984,3855,19,18,11,8
54054,445,0,0,drop,70,70,0,1,0,1,0
58775,445,0,0,drop,66,66,0,1,0,1,0
25150,25174,0,0,deny,62,62,0,1,0,1,0
65165,53,21302,53,allow,200,102,98,2,31,1,1
56336,53,29646,53,allow,178,94,84,2,30,1,1
55937,53,36384,53,allow,177,94,83,2,30,1,1
57238,53,18077,53,allow,701,88,613,2,31,1,1
58315,445,0,0,drop,66,66,0,1,0,1,0
61396,443,45721,443,allow,550484,8433,542051,541,246,99,442
50186,443,57350,443,allow,6363,1073,5290,18,38,10,8
12530,35440,0,0,deny,66,66,0,1,0,1,0
57302,62413,0,0,deny,66,66,0,1,0,1,0
55865,53,56628,53,allow,196,102,94,2,30,1,1
15755,53,15755,53,allow,241,95,146,2,31,1,1
55364,53,21776,53,allow,168,86,82,2,31,1,1
50000,53,33265,53,allow,216,110,106,2,30,1,1
61802,445,0,0,drop,70,70,0,1,0,1,0
50493,80,1565,80,allow,318,192,126,6,25,4,2
49569,53,17630,53,allow,213,94,119,2,30,1,1
58900,37807,0,0,deny,66,66,0,1,0,1,0
3225,64147,0,0,deny,66,66,0,1,0,1,0
50192,445,0,0,drop,70,70,0,1,0,1,0
53540,443,65354,443,allow,20948,4141,16807,76,616,37,39
57617,80,57617,80,allow,542818,11392,531426,466,25,106,360
57438,443,63629,443,allow,7720,2815,4905,22,20,10,12
2078,7000,2078,7000,allow,3006,1615,1391,15,15,8,7
49366,443,29757,443,allow,5777400,184445,5592955,6224,332,2268,3956
57375,445,0,0,drop,70,70,0,1,0,1,0
55064,445,0,0,drop,70,70,0,1,0,1,0
55877,1135,9849,1135,allow,489,149,340,2,1200,1,1
49313,53,45650,53,allow,199,102,97,2,30,1,1
49988,445,0,0,drop,70,70,0,1,0,1,0
56180,53,15802,53,allow,200,102,98,2,30,1,1
65174,53,57194,53,allow,214,110,104,2,30,1,1
56965,445,0,0,drop,70,70,0,1,0,1,0
64766,53,31618,53,allow,195,102,93,2,29,1,1
50281,53,33175,53,allow,195,102,93,2,30,1,1
65241,53,18449,53,allow,200,102,98,2,31,1,1
64467,53,11977,53,allow,184,94,90,2,30,1,1
46879,37807,0,0,deny,146,146,0,1,0,1,0
52727,445,0,0,drop,66,66,0,1,0,1,0
58768,17,58768,17,allow,66,66,0,1,30,1,0
58679,53,27207,53,allow,298,102,196,2,29,1,1
49710,53,2087,53,allow,179,94,85,2,30,1,1
55554,22114,0,0,deny,62,62,0,1,0,1,0
50031,44847,0,0,deny,74,74,0,1,0,1,0
56677,53,25915,53,allow,286,103,183,4,48,2,2
55216,445,0,0,drop,70,70,0,1,0,1,0
56009,53,53982,53,allow,178,94,84,2,30,1,1
59497,64097,0,0,deny,66,66,0,1,0,1,0
60897,445,0,0,drop,66,66,0,1,0,1,0
65498,53,22566,53,allow,752,93,659,2,31,1,1
61369,64147,0,0,deny,66,66,0,1,0,1,0
57290,443,45371,443,allow,2693,1361,1332,17,19,10,7
57392,445,0,0,drop,70,70,0,1,0,1,0
56033,53,58148,53,allow,213,102,111,2,31,1,1
50486,56205,0,0,deny,66,66,0,1,0,1,0
57537,445,0,0,drop,70,70,0,1,0,1,0
55601,53,28384,53,allow,177,94,83,2,30,1,1
63850,6881,4556,6881,allow,70,70,0,1,4,1,0
61843,445,0,0,drop,70,70,0,1,0,1,0
50439,443,55602,443,allow,73712,18850,54862,135,717,61,74
63995,443,63995,443,allow,4673,1766,2907,19,29,11,8
29145,8168,0,0,deny,62,62,0,1,0,1,0
62245,445,0,0,drop,66,66,0,1,0,1,0
37384,443,22279,443,allow,416,210,206,7,29,4,3
59531,445,0,0,drop,70,70,0,1,0,1,0
65366,53,11375,53,allow,199,102,97,2,30,1,1
51991,56980,61136,56980,allow,316,136,180,6,7,3,3
61167,445,0,0,drop,70,70,0,1,0,1,0
48817,49301,48817,49301,allow,490,149,341,2,1200,1,1
53453,443,33620,443,allow,17494,6818,10676,46,46,25,21
52868,80,24153,80,allow,54968,1915,53053,71,125,24,47
57164,50584,0,0,deny,62,62,0,1,0,1,0
56793,53,12485,53,allow,196,102,94,2,30,1,1
65080,53,11923,53,allow,209,110,99,2,30,1,1
63658,445,0,0,drop,66,66,0,1,0,1,0
8229,22114,0,0,deny,62,62,0,1,0,1,0
49973,53,45350,53,allow,309,110,199,2,30,1,1
50232,28356,48349,28356,allow,4728691,2246710,2481981,40252,1121,19716,20536
57632,7302,0,0,deny,146,146,0,1,0,1,0
56597,443,58985,443,allow,8700,2196,6504,21,16,12,9
62748,445,0,0,drop,70,70,0,1,0,1,0
54652,53,54652,53,allow,216,98,118,2,30,1,1
57475,445,0,0,drop,70,70,0,1,0,1,0
33305,443,50193,443,allow,1067,650,417,10,73,6,4
51824,80,16784,80,allow,15487,8701,6786,29,44,17,12
64747,445,0,0,drop,70,70,0,1,0,1,0
52757,445,0,0,drop,66,66,0,1,0,1,0
53404,443,26776,443,allow,8437,4827,3610,50,180,25,25
52058,80,14075,80,allow,362,240,122,7,25,5,2
56876,443,56876,443,allow,18542,1778,16764,30,17,15,15
56186,57470,0,0,deny,62,62,0,1,0,1,0
41581,443,9229,443,allow,6816,1197,5619,24,269,12,12
41972,5222,18449,5222,allow,5709,2977,2732,62,621,31,31
56082,53,50090,53,allow,271,88,183,4,38,2,2
26815,80,16585,80,allow,2894,1095,1799,15,131,8,7
49730,443,47083,443,allow,4484,1063,3421,15,10,7,8
49663,53,12596,53,allow,190,97,93,2,31,1,1
64838,445,0,0,drop,66,66,0,1,0,1,0
52988,445,0,0,drop,66,66,0,1,0,1,0
63953,53,20506,53,allow,426,89,337,4,49,2,2
53300,443,53300,443,allow,4406,1499,2907,19,30,11,8
61364,443,17656,443,allow,7653,1226,6427,24,18,14,10
49179,443,25006,443,allow,686176,17574,668602,702,18,252,450
64414,53,43076,53,allow,193,102,91,2,30,1,1
57369,445,0,0,drop,66,66,0,1,0,1,0
53191,443,21271,443,allow,7694,3364,4330,21,123,11,10
54977,53,63603,53,allow,275,93,182,4,32,2,2
55655,53,4325,53,allow,524,214,310,6,57,3,3
65091,445,0,0,drop,70,70,0,1,0,1,0
49504,443,22336,443,allow,62,62,0,1,5,1,0
50562,443,53886,443,allow,103466,11111,92355,258,140,119,139
51971,80,56168,80,allow,426,240,186,8,26,5,3
53083,445,0,0,drop,70,70,0,1,0,1,0
7619,50584,0,0,deny,62,62,0,1,0,1,0
21502,44847,0,0,deny,66,66,0,1,0,1,0
48906,80,50980,80,allow,2544,1681,863,12,185,7,5
60438,17372,0,0,deny,66,66,0,1,0,1,0
56654,53,22372,53,allow,209,110,99,2,30,1,1
57284,445,0,0,drop,70,70,0,1,0,1,0
50608,443,53757,443,allow,8058,2722,5336,17,31,10,7
64895,53,11867,53,allow,198,101,97,2,30,1,1
62914,11392,0,0,deny,146,146,0,1,0,1,0
55629,42873,0,0,deny,74,74,0,1,0,1,0
56375,53,7933,53,allow,170,87,83,2,30,1,1
16654,50265,0,0,deny,62,62,0,1,0,1,0
49730,445,0,0,drop,70,70,0,1,0,1,0
55821,443,39900,443,allow,128791,11254,117537,141,132,48,93
49511,57470,0,0,deny,66,66,0,1,0,1,0
64716,53,43003,53,allow,195,102,93,2,31,1,1
57402,443,10569,443,allow,6649,1556,5093,23,21,13,10
80,53945,0,0,deny,60,60,0,1,0,1,0
62787,51221,0,0,deny,66,66,0,1,0,1,0
63498,445,0,0,drop,66,66,0,1,0,1,0
57492,445,0,0,drop,70,70,0,1,0,1,0
54763,443,60297,443,allow,7136,5777,1359,22,200,13,9
49772,80,38817,80,allow,70,70,0,1,5,1,0
26900,27017,63924,27017,allow,422,164,258,6,30,3,3
36788,80,9413,80,allow,235873,12126,223747,306,31,154,152
443,38956,0,0,deny,82,82,0,1,0,1,0
55766,36237,0,0,deny,146,146,0,1,0,1,0
64023,12954,37073,12954,allow,504,382,122,8,15,6,2
58413,443,5177,443,allow,9371,1936,7435,26,29,14,12
62309,445,0,0,drop,66,66,0,1,0,1,0
63149,445,0,0,drop,66,66,0,1,0,1,0
55310,53,30986,53,allow,176,90,86,2,31,1,1
27005,33076,26025,33076,allow,889,126,763,2,31,1,1
65287,36829,0,0,deny,146,146,0,1,0,1,0
56738,53,23984,53,allow,264,87,177,4,37,2,2
62025,445,0,0,drop,66,66,0,1,0,1,0
64979,27050,52278,27050,allow,735,462,273,2,30,1,1
59940,50584,0,0,deny,66,66,0,1,0,1,0
50470,61463,0,0,deny,86,86,0,1,0,1,0
48817,6881,48817,6881,allow,334,158,176,2,1200,1,1
52122,443,45457,443,allow,5841,1986,3855,19,15,11,8
33418,443,42698,443,allow,4764,1876,2888,22,81,10,12
34630,443,65434,443,allow,12120,5747,6373,22,120,10,12
50975,445,0,0,drop,66,66,0,1,0,1,0
57287,53,44650,53,allow,752,93,659,2,30,1,1
57096,53,49643,53,allow,443,182,261,6,29,3,3
21018,53,21018,53,allow,235,90,145,2,31,1,1
38675,443,48538,443,allow,5236,1549,3687,19,29,11,8
65140,53,62512,53,allow,199,102,97,2,31,1,1
37865,123,17478,123,allow,184,94,90,2,30,1,1
58784,443,58898,443,allow,41305,2456,38849,63,30,29,34
49885,53,57862,53,allow,786,110,676,2,30,1,1
34306,37965,0,0,deny,62,62,0,1,0,1,0
54112,445,0,0,drop,70,70,0,1,0,1,0
56989,53,25786,53,allow,168,94,74,2,30,1,1
39098,51505,0,0,deny,62,62,0,1,0,1,0
57182,445,0,0,drop,66,66,0,1,0,1,0
58890,53,58890,53,allow,198,90,108,2,30,1,1
50482,445,0,0,drop,66,66,0,1,0,1,0
56953,80,31471,80,allow,37311,3340,33971,52,65,26,26
50975,445,0,0,drop,66,66,0,1,0,1,0
55778,53,54108,53,allow,181,94,87,2,30,1,1
34553,48637,0,0,deny,60,60,0,1,0,1,0
64339,18375,0,0,deny,66,66,0,1,0,1,0
49418,27118,47467,27118,allow,78,78,0,1,30,1,0
55564,80,32717,80,allow,944,529,415,11,315,6,5
60109,443,54198,443,allow,268,120,148,5,10,3,2
54471,445,0,0,drop,70,70,0,1,0,1,0
37299,443,19605,443,allow,10790,5444,5346,21,122,10,11
54963,53,11032,53,allow,210,110,100,2,30,1,1
53785,33324,40281,33324,allow,70,70,0,2,7,2,0
56511,53,50821,53,allow,200,102,98,2,30,1,1
39053,443,36119,443,allow,6699,4494,2205,27,29,14,13
43542,53,13639,53,allow,168,78,90,2,30,1,1
35699,443,53038,443,allow,2060,1106,954,17,150,10,7
55134,53,13756,53,allow,214,110,104,2,30,1,1
41418,443,15753,443,allow,6670,1576,5094,23,200,13,10
9836,22114,0,0,deny,66,66,0,1,0,1,0
58973,57470,0,0,deny,62,62,0,1,0,1,0
52061,35717,37968,35717,allow,70,70,0,1,5,1,0
65324,445,0,0,drop,70,70,0,1,0,1,0
49237,443,49237,443,allow,33985,8645,25340,53,35,28,25
55836,53,20362,53,allow,177,94,83,2,30,1,1
58748,443,1980,443,allow,522925,36953,485972,799,229,304,495
12530,35440,0,0,deny,66,66,0,1,0,1,0
64130,53,8273,53,allow,215,94,121,2,31,1,1
62331,61689,0,0,deny,66,66,0,1,0,1,0
49183,445,0,0,drop,66,66,0,1,0,1,0
64478,445,0,0,drop,70,70,0,1,0,1,0
46370,443,36990,443,allow,11035,8438,2597,39,95,23,16
59791,445,0,0,drop,66,66,0,1,0,1,0
55927,445,0,0,drop,70,70,0,1,0,1,0
23310,22114,0,0,deny,66,66,0,1,0,1,0
54210,64097,0,0,deny,66,66,0,1,0,1,0
50647,445,0,0,drop,70,70,0,1,0,1,0
48840,50584,0,0,deny,146,146,0,1,0,1,0
21502,44847,0,0,deny,66,66,0,1,0,1,0
53909,443,45501,443,allow,499,425,74,4,0,3,1
56478,53,6625,53,allow,177,94,83,2,29,1,1
54737,50584,0,0,deny,66,66,0,1,0,1,0
63867,43618,49838,43618,allow,70,70,0,1,4,1,0
65143,53,45277,53,allow,184,94,90,2,30,1,1
49160,14387,38901,14387,allow,854,150,704,4,1200,2,2
47120,443,47120,443,allow,4604,1697,2907,19,29,11,8
56920,23117,0,0,deny,146,146,0,1,0,1,0
35524,34962,0,0,deny,159,159,0,1,0,1,0
55596,445,0,0,drop,70,70,0,1,0,1,0
18086,25174,0,0,deny,62,62,0,1,0,1,0
21993,25174,0,0,deny,146,146,0,1,0,1,0
55491,443,47772,443,allow,5123,2651,2472,15,123,8,7
12433,53,7842,53,allow,208,86,122,2,30,1,1
55238,21247,0,0,deny,62,62,0,1,0,1,0
50966,443,34957,443,allow,6350,1072,5278,18,40,10,8
41169,443,56459,443,allow,8805,1938,6867,21,17,12,9
43129,15503,0,0,deny,62,62,0,1,0,1,0
22683,39210,0,0,deny,60,60,0,1,0,1,0
48303,53,44805,53,allow,198,93,105,2,31,1,1
64263,445,0,0,drop,66,66,0,1,0,1,0
60424,443,16988,443,allow,1477,940,537,13,26,7,6
60848,53,46740,53,allow,168,78,90,2,30,1,1
53350,443,63189,443,allow,2950,679,2271,13,120,6,7
49295,53,50273,53,allow,280,96,184,4,34,2,2
50172,443,41441,443,allow,161,101,60,2,5,1,1
57277,5223,45346,5223,allow,4339,1521,2818,23,3002,14,9
51275,10924,61359,10924,allow,70,70,0,2,8,2,0
63083,25174,0,0,deny,66,66,0,1,0,1,0
54998,443,38889,443,allow,10151,2256,7895,32,39,17,15
50485,80,52438,80,allow,318,192,126,6,26,4,2
1918,25174,0,0,deny,66,66,0,1,0,1,0
65336,53,13952,53,allow,782,105,677,2,31,1,1
49486,53,40876,53,allow,177,94,83,2,31,1,1
51221,65264,24402,65264,allow,870,330,540,12,1573,6,6
57807,80,6054,80,allow,1013,566,447,8,162,5,3
19629,53,19629,53,allow,244,98,146,2,33,1,1
57082,445,0,0,drop,70,70,0,1,0,1,0
51990,443,58670,443,allow,2094,1402,692,14,15,8,6
57470,1337,11046,1337,allow,132,132,0,3,1199,3,0
56887,53,53946,53,allow,250,87,163,4,60,2,2
55348,53,24176,53,allow,498,204,294,6,30,3,3
58638,5900,0,0,deny,62,62,0,1,0,1,0
5115,53,5115,53,allow,216,90,126,2,30,1,1
61956,80,61956,80,allow,2102,1583,519,11,23,6,5
57044,53,19964,53,allow,194,99,95,2,31,1,1
49418,27016,62306,27016,allow,261,78,183,2,30,1,1
42107,443,39392,443,allow,13704,2379,11325,47,279,22,25
61465,22114,0,0,deny,62,62,0,1,0,1,0
65528,445,0,0,drop,70,70,0,1,0,1,0
49001,40108,0,0,deny,161,161,0,1,0,1,0
51667,25826,2987,25826,allow,9440,9440,0,11,30,11,0
61418,80,59402,80,allow,31954,2972,28982,71,138,36,35
62061,443,61994,443,allow,53531,5139,48392,75,47,34,41
55286,53,17426,53,allow,268,87,181,4,35,2,2
57176,443,31036,443,allow,12844,2619,10225,23,120,10,13
61233,443,12202,443,allow,1775,169,1606,7,120,3,4
64144,445,0,0,drop,66,66,0,1,0,1,0
58053,25,49850,25,allow,1316,442,874,15,16,7,8
65119,445,0,0,drop,70,70,0,1,0,1,0
50473,123,38470,123,allow,184,94,90,2,30,1,1
53750,25174,0,0,deny,66,66,0,1,0,1,0
52308,53,36287,53,allow,70,70,0,1,29,1,0
59386,445,0,0,drop,66,66,0,1,0,1,0
28306,25604,0,0,deny,62,62,0,1,0,1,0
37297,443,18068,443,allow,4514,1928,2586,17,240,8,9
64589,445,0,0,drop,70,70,0,1,0,1,0
51903,35904,40844,35904,allow,70,70,0,1,5,1,0
51459,443,53569,443,allow,202,70,132,3,11,1,2
51534,26467,0,0,deny,62,62,0,1,0,1,0
53717,443,51020,443,allow,499,425,74,4,0,3,1
6881,6881,1541,6881,allow,237,118,119,2,1200,1,1
61853,445,0,0,drop,66,66,0,1,0,1,0
64252,53,2072,53,allow,199,102,97,2,30,1,1
53767,10004,34912,10004,allow,70,70,0,2,7,2,0
443,56513,0,0,deny,78,78,0,1,0,1,0
56611,80,46294,80,allow,4296,2076,2220,31,128,15,16
56925,53,20388,53,allow,196,102,94,2,30,1,1
57395,53,14755,53,allow,262,88,174,4,59,2,2
17750,8953,36082,8953,allow,491,150,341,2,1200,1,1
58638,5900,0,0,deny,62,62,0,1,0,1,0
57418,53,56760,53,allow,209,102,107,2,30,1,1
57149,443,55393,443,allow,1647,1375,272,9,37,5,4
55123,53,64230,53,allow,196,100,96,2,31,1,1
63640,57866,0,0,deny,66,66,0,1,0,1,0
55706,53,9914,53,allow,202,103,99,2,31,1,1
56838,53,18546,53,allow,177,94,83,2,29,1,1
44086,443,28968,443,allow,8542,4191,4351,84,616,46,38
28441,23,28441,23,allow,152,66,86,2,7,1,1
55761,53,38695,53,allow,168,78,90,2,30,1,1
27005,27016,18663,27016,allow,892,126,766,2,30,1,1
61492,80,29860,80,allow,901,398,503,10,15,5,5
52071,80,35224,80,allow,1284,780,504,12,360,7,5
49205,443,49232,443,allow,512444,20822,491622,555,159,191,364
64988,445,0,0,drop,66,66,0,1,0,1,0
57588,443,14769,443,allow,7629,3270,4359,34,337,17,17
53628,50514,20883,50514,allow,70,70,0,2,7,2,0
59722,443,18746,443,allow,70,70,0,2,5,2,0
36158,443,34202,443,allow,9808,3005,6803,36,255,19,17
16387,8455,0,0,deny,60,60,0,1,0,1,0
45394,443,62065,443,allow,1314,653,661,13,185,7,6
55212,443,36417,443,allow,10500,5056,5444,23,143,11,12
46901,26672,0,0,deny,60,60,0,1,0,1,0
52214,27480,12479,27480,allow,70,70,0,2,6,2,0
55377,53,47893,53,allow,190,97,93,2,31,1,1
52676,53733,0,0,deny,66,66,0,1,0,1,0
65332,56205,0,0,deny,62,62,0,1,0,1,0
58648,445,0,0,drop,66,66,0,1,0,1,0
60022,10387,0,0,deny,159,159,0,1,0,1,0
58341,10197,0,0,deny,78,78,0,1,0,1,0
52932,80,19505,80,allow,4214,1921,2293,18,383,10,8
43708,53,62627,53,allow,168,78,90,2,30,1,1
58454,443,58454,443,allow,4593,1616,2977,19,76,10,9
38822,80,14880,80,allow,810,413,397,7,19,5,2
46842,25174,0,0,deny,146,146,0,1,0,1,0
62259,445,0,0,drop,70,70,0,1,0,1,0
53096,443,46942,443,allow,13599,5335,8264,35,171,18,17
54065,445,0,0,drop,70,70,0,1,0,1,0
61988,443,61988,443,allow,4338,1431,2907,19,30,11,8
52940,445,0,0,drop,66,66,0,1,0,1,0
52210,51505,0,0,deny,66,66,0,1,0,1,0
60503,53425,43534,53425,allow,504,318,186,8,16,5,3
25436,53,25436,53,allow,220,90,130,2,30,1,1
54910,445,0,0,drop,66,66,0,1,0,1,0
26048,21,0,0,deny,60,60,0,1,0,1,0
25267,2323,0,0,deny,60,60,0,1,0,1,0
56472,445,0,0,drop,66,66,0,1,0,1,0
49631,80,18406,80,allow,1446,914,532,8,16,5,3
6881,6881,37501,6881,allow,259,150,109,2,1200,1,1
64041,445,0,0,drop,70,70,0,1,0,1,0
36934,443,62872,443,allow,490,210,280,8,131,4,4
62102,443,60782,443,allow,3182,1568,1614,8,121,4,4
50958,80,62860,80,allow,5730351,74236,5656115,4865,78,1088,3777
56712,445,0,0,drop,66,66,0,1,0,1,0
27005,27017,47675,27017,allow,878,126,752,2,31,1,1
50370,443,23415,443,allow,316,136,180,6,6,3,3
26842,443,13375,443,allow,7219,2522,4697,21,20,10,11
53199,30188,0,0,deny,66,66,0,1,0,1,0
39827,53,39827,53,allow,247,98,149,2,33,1,1
55841,53,32658,53,allow,265,86,179,4,58,2,2
51667,25826,43364,25826,allow,9372,9372,0,11,30,11,0
6973,80,6973,80,allow,132958,3923,129035,143,38,53,90
50344,445,0,0,drop,70,70,0,1,0,1,0
60893,443,5461,443,allow,46690,9390,37300,77,54,36,41
51609,37807,0,0,deny,66,66,0,1,0,1,0
63803,41439,24865,41439,allow,66,66,0,1,5,1,0
6040,53,41772,53,allow,323,94,229,2,30,1,1
56878,53,41614,53,allow,168,86,82,2,30,1,1
50822,445,0,0,drop,70,70,0,1,0,1,0
1048,25174,0,0,deny,62,62,0,1,0,1,0
64198,445,0,0,drop,70,70,0,1,0,1,0
49487,443,25025,443,allow,72073,12550,59523,78,45,25,53
62307,8055,0,0,deny,159,159,0,1,0,1,0
63972,53,28656,53,allow,325,94,231,2,30,1,1
59882,445,0,0,drop,70,70,0,1,0,1,0
53600,445,0,0,drop,70,70,0,1,0,1,0
49407,53,35774,53,allow,774,101,673,2,30,1,1
53656,31573,0,0,deny,66,66,0,1,0,1,0
49165,53,17672,53,allow,212,102,110,2,29,1,1
51880,8001,36976,8001,allow,86,86,0,1,30,1,0
52379,445,0,0,drop,70,70,0,1,0,1,0
53637,445,0,0,drop,70,70,0,1,0,1,0
56746,445,0,0,drop,70,70,0,1,0,1,0
60179,445,0,0,drop,66,66,0,1,0,1,0
65063,53,62698,53,allow,176,90,86,2,31,1,1
58006,80,48045,80,allow,318,192,126,6,21,4,2
15933,64147,0,0,deny,62,62,0,1,0,1,0
49541,53,16544,53,allow,745,215,530,6,51,3,3
35745,443,18614,443,allow,7634,4417,3217,35,197,19,16
55571,445,0,0,drop,70,70,0,1,0,1,0
40806,8000,49174,8000,allow,1259,639,620,20,300,10,10
53262,443,28483,443,allow,4385,2869,1516,32,19,18,14
52708,443,22649,443,allow,10748,1634,9114,22,316,10,12
51453,64147,0,0,deny,66,66,0,1,0,1,0
52874,443,59388,443,allow,392514,41757,350757,626,118,209,417
64756,53,60471,53,allow,195,102,93,2,30,1,1
56046,53,4218,53,allow,186,95,91,2,31,1,1
43096,443,6267,443,allow,7098,2628,4470,20,16,12,8
64780,53,40708,53,allow,193,102,91,2,31,1,1
1534,54369,0,0,deny,66,66,0,1,0,1,0
58638,5900,0,0,deny,62,62,0,1,0,1,0
58550,21247,0,0,deny,66,66,0,1,0,1,0
40806,8000,37524,8000,allow,195,71,124,4,58,2,2
45562,5228,50425,5228,allow,29298,3627,25671,67,5346,25,42
64854,53,27051,53,allow,178,94,84,2,30,1,1
55605,53,6586,53,allow,195,102,93,2,30,1,1
39127,6555,15189,6555,allow,922,428,494,10,15,5,5
50391,445,0,0,drop,70,70,0,1,0,1,0
52193,443,50924,443,allow,13948,1150,12798,29,15,14,15
49345,443,4175,443,allow,61954,10029,51925,114,82,50,64
55748,53,57713,53,allow,194,102,92,2,31,1,1
63515,445,0,0,drop,66,66,0,1,0,1,0
59949,44847,0,0,deny,66,66,0,1,0,1,0
65049,53,38762,53,allow,184,94,90,2,30,1,1
59493,44847,0,0,deny,66,66,0,1,0,1,0
31845,55777,0,0,deny,62,62,0,1,0,1,0
50975,445,0,0,drop,70,70,0,1,0,1,0
58638,5900,0,0,deny,62,62,0,1,0,1,0
49882,443,51154,443,allow,79524,18512,61012,205,50,101,104
44388,63874,0,0,deny,66,66,0,1,0,1,0
62026,445,0,0,drop,66,66,0,1,0,1,0
64898,53,53869,53,allow,167,86,81,2,29,1,1
5237,30128,2836,30128,allow,621281,256,621025,881,49,5,876
49346,80,49346,80,allow,450,246,204,8,142,5,3
61416,443,34403,443,allow,6437,1994,4443,22,87,12,10
65024,445,0,0,drop,70,70,0,1,0,1,0
49256,53,36401,53,allow,179,94,85,2,29,1,1
48087,16069,0,0,deny,66,66,0,1,0,1,0
65226,445,0,0,drop,70,70,0,1,0,1,0
10494,23,0,0,deny,60,60,0,1,0,1,0
56381,51505,0,0,deny,146,146,0,1,0,1,0
64198,53,39637,53,allow,321,102,219,2,30,1,1
51678,445,0,0,drop,70,70,0,1,0,1,0
3436,46783,0,0,deny,145,145,0,1,0,1,0
49203,53,26385,53,allow,240,94,146,2,29,1,1
57432,66,52808,66,allow,70,70,0,1,5,1,0
53565,445,0,0,drop,66,66,0,1,0,1,0
44482,443,27809,443,allow,16517,3254,13263,37,271,18,19
22784,9571,0,0,deny,62,62,0,1,0,1,0
58214,445,0,0,drop,70,70,0,1,0,1,0
57203,53,8040,53,allow,199,102,97,2,29,1,1
63786,35440,0,0,deny,66,66,0,1,0,1,0
58708,445,0,0,drop,66,66,0,1,0,1,0
7176,53,7176,53,allow,233,91,142,2,31,1,1
63961,51641,64148,51641,allow,504,382,122,8,16,6,2
26900,27017,39625,27017,allow,422,164,258,6,30,3,3
55973,25174,0,0,deny,62,62,0,1,0,1,0
56279,443,27594,443,allow,15248,5524,9724,54,364,27,27
53672,445,0,0,drop,70,70,0,1,0,1,0
51968,43622,9817,43622,allow,70,70,0,2,8,2,0
37579,443,40926,443,allow,7982,2392,5590,25,26,14,11
59646,5223,10066,5223,allow,139,139,0,1,5,1,0
44594,64147,0,0,deny,66,66,0,1,0,1,0
56072,53,61103,53,allow,199,102,97,2,30,1,1
64950,53,1692,53,allow,183,94,89,2,30,1,1
49971,445,0,0,drop,70,70,0,1,0,1,0
49632,53,30803,53,allow,198,101,97,2,30,1,1
64699,53,61689,53,allow,338,110,228,2,30,1,1
58747,445,0,0,drop,70,70,0,1,0,1,0
63802,445,0,0,drop,66,66,0,1,0,1,0
63308,445,0,0,drop,66,66,0,1,0,1,0
9147,443,1443,443,allow,6334,840,5494,19,29,10,9
26835,47993,0,0,deny,62,62,0,1,0,1,0
51105,80,8408,80,allow,366,240,126,7,20,5,2
57747,15000,28219,15000,allow,130,70,60,2,6,1,1
35187,443,10629,443,allow,13057,1460,11597,28,255,14,14
1028,64147,0,0,deny,62,62,0,1,0,1,0
51032,30188,0,0,deny,66,66,0,1,0,1,0
38956,443,38557,443,allow,9096,4245,4851,29,121,14,15
49662,53,40322,53,allow,268,93,175,4,58,2,2
61361,445,0,0,drop,70,70,0,1,0,1,0
51803,33973,32167,33973,allow,66,66,0,1,5,1,0
55152,53,56189,53,allow,177,94,83,2,30,1,1
50551,80,50551,80,allow,4780,1925,2855,16,22,8,8
6666,2222,0,0,deny,60,60,0,1,0,1,0
49182,53,41433,53,allow,199,102,97,2,29,1,1
62107,445,0,0,drop,70,70,0,1,0,1,0
53666,50321,61664,50321,allow,736,490,246,8,17,4,4
55006,53,44866,53,allow,789,110,679,2,30,1,1
50521,443,9816,443,allow,11880,1972,9908,29,78,15,14
2828,35253,0,0,deny,66,66,0,1,0,1,0
53696,50321,3484,50321,allow,70,70,0,1,4,1,0
35814,443,26348,443,allow,5205,1251,3954,18,15,10,8
56135,53,22804,53,allow,542,112,430,4,34,2,2
62029,22114,0,0,deny,66,66,0,1,0,1,0
57094,53,18443,53,allow,196,102,94,2,31,1,1
50,64147,0,0,deny,62,62,0,1,0,1,0
33576,443,52498,443,allow,170319,23354,146965,283,34,121,162
2346,25174,0,0,deny,62,62,0,1,0,1,0
13825,443,28678,443,allow,8844,949,7895,19,75,9,10
41034,443,11072,443,allow,6055,2800,3255,38,279,19,19
50095,445,0,0,drop,70,70,0,1,0,1,0
59192,445,0,0,drop,66,66,0,1,0,1,0
54642,445,0,0,drop,70,70,0,1,0,1,0
52191,443,40696,443,allow,7018,1766,5252,23,19,13,10
58486,57470,0,0,deny,66,66,0,1,0,1,0
50528,80,29237,80,allow,66430,7013,59417,93,156,40,53
48164,53,51985,53,allow,199,94,105,2,30,1,1
65283,53,18469,53,allow,732,89,643,2,30,1,1
30399,44847,0,0,deny,146,146,0,1,0,1,0
59677,445,0,0,drop,70,70,0,1,0,1,0
53447,44847,0,0,deny,66,66,0,1,0,1,0
56422,53,30231,53,allow,195,102,93,2,30,1,1
2476,6881,0,0,deny,62,62,0,1,0,1,0
60112,443,25865,443,allow,572,280,292,9,16,5,4
52995,445,0,0,drop,70,70,0,1,0,1,0
51863,445,0,0,drop,70,70,0,1,0,1,0
50458,443,25872,443,allow,523577,34256,489321,1025,208,473,552
49384,53,28172,53,allow,181,94,87,2,29,1,1
5195,64147,0,0,deny,66,66,0,1,0,1,0
49156,53,43723,53,allow,195,102,93,2,32,1,1
64530,53,49179,53,allow,782,105,677,2,30,1,1
55464,22114,0,0,deny,62,62,0,1,0,1,0
55425,37965,0,0,deny,66,66,0,1,0,1,0
123,123,26744,123,allow,184,94,90,2,30,1,1
65140,53,5924,53,allow,774,101,673,2,31,1,1
50936,445,0,0,drop,70,70,0,1,0,1,0
64872,53,35777,53,allow,164,84,80,2,30,1,1
56349,53,21926,53,allow,216,110,106,2,30,1,1
65059,445,0,0,drop,70,70,0,1,0,1,0
19875,30170,0,0,deny,145,145,0,1,0,1,0
51444,445,0,0,drop,66,66,0,1,0,1,0
53520,37553,29607,37553,allow,70,70,0,1,4,1,0
59477,36829,0,0,deny,62,62,0,1,0,1,0
52390,2323,0,0,deny,60,60,0,1,0,1,0
50689,445,0,0,drop,70,70,0,1,0,1,0
51756,41471,23556,41471,allow,70,70,0,2,8,2,0
55005,53,64586,53,allow,211,102,109,2,30,1,1
56519,445,0,0,drop,66,66,0,1,0,1,0
55804,445,0,0,drop,66,66,0,1,0,1,0
42252,33303,0,0,deny,60,60,0,1,0,1,0
52743,15503,0,0,deny,66,66,0,1,0,1,0
63998,21247,0,0,deny,66,66,0,1,0,1,0
49769,443,60646,443,allow,14166,2015,12151,27,127,11,16
40845,64147,0,0,deny,62,62,0,1,0,1,0
65375,443,53764,443,allow,2458316,102393,2355923,2942,241,1261,1681
49919,80,15298,80,allow,992,524,468,10,125,6,4
58399,56205,0,0,deny,66,66,0,1,0,1,0
443,20087,0,0,deny,83,83,0,1,0,1,0
60540,443,60540,443,allow,4455,1548,2907,19,27,11,8
49890,443,49782,443,allow,2513598,90400,2423198,2658,280,896,1762
49165,5938,24586,5938,allow,143727,72050,71677,1106,10824,655,451
55646,53,23408,53,allow,182,93,89,2,31,1,1
65000,27019,62331,27019,allow,728,462,266,2,30,1,1
65249,53,5221,53,allow,166,86,80,2,30,1,1
63952,50734,54501,50734,allow,66,66,0,2,8,2,0
53920,34914,18938,34914,allow,1781,1103,678,15,17,9,6
54983,53,35853,53,allow,728,102,626,2,30,1,1
51870,40490,51955,40490,allow,70,70,0,1,5,1,0
18415,37965,0,0,deny,62,62,0,1,0,1,0
55076,53,43465,53,allow,183,94,89,2,30,1,1
60903,443,60903,443,allow,3672,2294,1378,23,17,13,10
50272,53,35628,53,allow,210,110,100,2,29,1,1
8239,37965,0,0,deny,146,146,0,1,0,1,0
56627,443,41594,443,allow,4499,947,3552,14,25,8,6
60324,445,0,0,drop,66,66,0,1,0,1,0
64488,53,54282,53,allow,356,98,258,4,35,2,2
13980,53,13980,53,allow,213,87,126,2,31,1,1
59853,445,0,0,drop,66,66,0,1,0,1,0
33836,443,3806,443,allow,18875,13913,4962,116,788,60,56
55533,53,54545,53,allow,183,94,89,2,29,1,1
45254,443,27475,443,allow,8328,2592,5736,35,34,18,17
58972,80,64079,80,allow,943,513,430,9,14,6,3
49181,80,37044,80,allow,6158,654,5504,15,16,8,7
65494,443,61063,443,allow,92044,4379,87665,102,16,37,65
42732,57470,0,0,deny,62,62,0,1,0,1,0
51229,445,0,0,drop,70,70,0,1,0,1,0
45387,443,38103,443,allow,3999,2255,1744,37,1122,19,18
51062,445,0,0,drop,66,66,0,1,0,1,0
64905,53,62456,53,allow,283,102,181,2,30,1,1
0,0,0,0,allow,156,156,0,2,0,2,0
53108,445,0,0,drop,66,66,0,1,0,1,0
55039,53,21186,53,allow,177,94,83,2,30,1,1
59415,443,30552,443,allow,2854,1700,1154,16,16,8,8
50660,443,1887,443,allow,3845,1814,2031,19,38,11,8
64047,16221,34665,16221,allow,66,66,0,2,8,2,0
64653,445,0,0,drop,70,70,0,1,0,1,0
55222,53,59150,53,allow,1210,950,260,2,29,1,1
58997,443,10081,443,allow,70,70,0,1,4,1,0
18642,42707,0,0,deny,62,62,0,1,0,1,0
19875,30170,0,0,deny,145,145,0,1,0,1,0
64000,14441,58412,14441,allow,70,70,0,1,4,1,0
51709,40705,29645,40705,allow,66,66,0,1,5,1,0
57207,53,55086,53,allow,195,102,93,2,30,1,1
10273,21247,0,0,deny,62,62,0,1,0,1,0
45964,5333,0,0,deny,60,60,0,1,0,1,0
30960,45739,64773,45739,allow,330,330,0,6,3609,6,0
55878,53,24199,53,allow,260,102,158,2,29,1,1
2422,62507,0,0,deny,66,66,0,1,0,1,0
56962,445,0,0,drop,70,70,0,1,0,1,0
33305,53,29793,53,allow,168,78,90,2,30,1,1
64276,53,40042,53,allow,194,99,95,2,31,1,1
59821,80,19887,80,allow,1052,612,440,10,15,5,5
57302,445,0,0,drop,66,66,0,1,0,1,0
2949,57470,0,0,deny,66,66,0,1,0,1,0
53932,27258,53010,27258,allow,70,70,0,1,5,1,0
57487,443,7890,443,allow,17065,11570,5495,76,218,39,37
50282,443,7706,443,allow,24856,2858,21998,57,100,30,27
42890,80,22504,80,allow,2030,586,1444,10,30,6,4
17046,53,17046,53,allow,220,90,130,2,30,1,1
51339,50584,0,0,deny,66,66,0,1,0,1,0
43815,50584,0,0,deny,62,62,0,1,0,1,0
63957,53,44993,53,allow,214,94,120,2,29,1,1
46604,57866,0,0,deny,66,66,0,1,0,1,0
58638,5900,0,0,deny,62,62,0,1,0,1,0
59506,445,0,0,drop,70,70,0,1,0,1,0
55796,53,45006,53,allow,192,98,94,2,31,1,1
49418,27015,13881,27015,allow,237,71,166,2,31,1,1
9169,80,55933,80,allow,318,192,126,6,29,4,2
55547,53,1923,53,allow,339,94,245,2,30,1,1
49455,53,42395,53,allow,1750,184,1566,6,85,3,3
59599,445,0,0,drop,66,66,0,1,0,1,0
64274,445,0,0,drop,70,70,0,1,0,1,0
0,0,0,0,allow,480,244,236,4,0,2,2
59248,445,0,0,drop,70,70,0,1,0,1,0
54553,53,37407,53,allow,102,102,0,1,30,1,0
59018,445,0,0,drop,66,66,0,1,0,1,0
56703,445,0,0,drop,70,70,0,1,0,1,0
2918,37965,0,0,deny,62,62,0,1,0,1,0
39920,22114,0,0,deny,62,62,0,1,0,1,0
52230,50265,0,0,deny,62,62,0,1,0,1,0
49635,53,38499,53,allow,210,110,100,2,29,1,1
51832,443,21428,443,allow,2831,740,2091,11,120,5,6
41322,443,26107,443,allow,6332,944,5388,19,66,10,9
57268,445,0,0,drop,66,66,0,1,0,1,0
53136,443,65509,443,allow,3028365,2245986,782379,11999,627,7647,4352
26900,27017,56455,27017,allow,926,410,516,12,31,6,6
61235,445,0,0,drop,70,70,0,1,0,1,0
63587,443,60950,443,allow,10576,3685,6891,46,92,24,22
41593,53,64892,53,allow,243,86,157,2,29,1,1
7222,57470,0,0,deny,62,62,0,1,0,1,0
58239,445,0,0,drop,70,70,0,1,0,1,0
35319,51505,0,0,deny,146,146,0,1,0,1,0
49418,27016,27118,27016,allow,231,71,160,2,30,1,1
9687,57470,0,0,deny,78,78,0,1,0,1,0
49106,53,49106,53,allow,1415,689,726,3,30,2,1
51339,445,0,0,drop,70,70,0,1,0,1,0
55915,53,47313,53,allow,86,86,0,1,30,1,0
58638,5900,0,0,deny,62,62,0,1,0,1,0
39110,50584,0,0,deny,62,62,0,1,0,1,0
64181,53,18587,53,allow,194,102,92,2,31,1,1
49557,53,33015,53,allow,211,102,109,2,30,1,1
64296,445,0,0,drop,66,66,0,1,0,1,0
36781,443,37104,443,allow,1798,1223,575,13,26,8,5
37696,443,12389,443,allow,32798,2912,29886,58,170,29,29
11599,25174,0,0,deny,146,146,0,1,0,1,0
59946,443,42319,443,allow,11836,3531,8305,37,121,19,18
50433,53,61618,53,allow,770,102,668,2,30,1,1
63192,445,0,0,drop,70,70,0,1,0,1,0
64079,20233,31225,20233,allow,66,66,0,2,7,2,0
50938,445,0,0,drop,70,70,0,1,0,1,0
56028,445,0,0,drop,70,70,0,1,0,1,0
63975,24874,26677,24874,allow,66,66,0,2,7,2,0
56640,53,60510,53,allow,733,93,640,2,31,1,1
10834,50584,0,0,deny,62,62,0,1,0,1,0
53208,80,52746,80,allow,2953,785,2168,12,116,8,4
5588,5588,0,0,allow,3354,1792,1562,46,195,23,23
64469,445,0,0,drop,66,66,0,1,0,1,0
39910,80,12870,80,allow,1658,1344,314,10,15,5,5
56623,80,56144,80,allow,234,234,0,4,12,4,0
33161,80,27979,80,allow,604,530,74,7,15,6,1
57111,53,59340,53,allow,199,94,105,2,30,1,1
59559,445,0,0,deny,66,66,0,1,0,1,0
56694,53,2840,53,allow,427,88,339,4,55,2,2
38947,443,49748,443,allow,16499,9522,6977,44,364,22,22
28649,43890,0,0,deny,66,66,0,1,0,1,0
50000,53,56621,53,allow,216,102,114,2,29,1,1
53867,60272,19562,60272,allow,70,70,0,2,8,2,0
16387,25619,0,0,deny,60,60,0,1,0,1,0
37906,37965,0,0,deny,62,62,0,1,0,1,0
55605,27274,38364,27274,allow,130,70,60,3,5,2,1
2780,23117,0,0,deny,66,66,0,1,0,1,0
56891,53,55899,53,allow,226,110,116,2,30,1,1
65131,53,35643,53,allow,168,86,82,2,30,1,1
3667,56205,0,0,deny,62,62,0,1,0,1,0
52612,445,0,0,drop,70,70,0,1,0,1,0
51471,445,0,0,drop,66,66,0,1,0,1,0
50678,80,40361,80,allow,300,174,126,5,15,3,2
55868,53,29665,53,allow,198,110,88,2,29,1,1
55136,11392,0,0,deny,62,62,0,1,0,1,0
62587,445,0,0,drop,70,70,0,1,0,1,0
62736,80,60766,80,allow,1516,481,1035,11,15,6,5
63965,11785,23827,11785,allow,66,66,0,2,8,2,0
58638,5900,0,0,deny,62,62,0,1,0,1,0
51667,25826,43054,25826,allow,9415,9415,0,11,30,11,0
37680,443,40317,443,allow,16742,3383,13359,57,309,28,29
49612,80,42484,80,allow,1388,562,826,11,315,6,5
65493,445,0,0,drop,70,70,0,1,0,1,0
57470,26944,61791,26944,allow,480,149,331,2,1200,1,1
55264,53,25192,53,allow,177,94,83,2,30,1,1
55687,53,38089,53,allow,193,102,91,2,30,1,1
65370,53,21172,53,allow,193,102,91,2,30,1,1
63022,53,50452,53,allow,384,166,218,2,29,1,1
61658,445,0,0,drop,66,66,0,1,0,1,0
64997,51221,0,0,deny,66,66,0,1,0,1,0
53831,443,39132,443,allow,499,425,74,4,0,3,1
58077,36653,2343,36653,allow,204,64,140,4,10,2,2
62717,443,23146,443,allow,3129,782,2347,17,134,8,9
52220,445,0,0,drop,70,70,0,1,0,1,0
15341,23,0,0,allow,60,60,0,1,90,1,0
49531,445,0,0,drop,66,66,0,1,0,1,0
27005,27015,28808,27015,allow,873,126,747,2,30,1,1
58285,445,0,0,drop,70,70,0,1,0,1,0
60627,443,41376,443,allow,5663,1711,3952,22,17,13,9
55290,445,0,0,drop,70,70,0,1,0,1,0
55024,443,1691,443,allow,552073,14113,537960,536,31,176,360
64096,443,64096,443,allow,5661,2415,3246,26,160,14,12
62293,53,18482,53,allow,232,88,144,2,31,1,1
65453,53,23093,53,allow,311,94,217,2,30,1,1
12164,22114,0,0,deny,146,146,0,1,0,1,0
50905,443,13622,443,allow,124,64,60,2,15,1,1
53877,443,42282,443,allow,499,425,74,4,1,3,1
443,14315,0,0,deny,158,158,0,1,0,1,0
27452,5222,13129,5222,allow,3751,1007,2744,35,425,11,24
13462,35440,0,0,deny,62,62,0,1,0,1,0
56887,53,8046,53,allow,250,87,163,4,57,2,2
55700,26957,2984,26957,allow,70,70,0,1,5,1,0
56896,445,0,0,drop,70,70,0,1,0,1,0
62053,443,33820,443,allow,134,60,74,3,5,2,1
55702,80,56730,80,allow,70,70,0,2,8,2,0
50091,53,1529,53,allow,172,94,78,2,31,1,1
64502,53,56214,53,allow,199,102,97,2,30,1,1
65339,53,50441,53,allow,186,95,91,2,31,1,1
51185,445,0,0,drop,66,66,0,1,0,1,0
52127,44198,39130,44198,allow,70,70,0,2,8,2,0
63645,445,0,0,drop,70,70,0,1,0,1,0
65050,53,2914,53,allow,264,102,162,2,30,1,1
40182,443,24953,443,allow,1312,651,661,13,184,7,6
64788,43890,0,0,deny,62,62,0,1,0,1,0
53105,42707,0,0,deny,66,66,0,1,0,1,0
57253,443,15843,443,allow,8613,2377,6236,41,17,23,18
58268,445,0,0,drop,70,70,0,1,0,1,0
56110,80,5106,80,allow,31087,1654,29433,42,16,18,24
53882,445,0,0,drop,66,66,0,1,0,1,0
3597,11392,0,0,deny,66,66,0,1,0,1,0
60343,80,4297,80,allow,2005,1094,911,11,87,6,5
59157,445,0,0,drop,70,70,0,1,0,1,0
55935,53,36129,53,allow,819,102,717,2,30,1,1
53913,28402,62039,28402,allow,70,70,0,2,7,2,0
58835,445,0,0,drop,66,66,0,1,0,1,0
58129,26467,0,0,deny,62,62,0,1,0,1,0
13166,57470,0,0,deny,62,62,0,1,0,1,0
53736,445,0,0,drop,66,66,0,1,0,1,0
56803,53,37278,53,allow,183,94,89,2,29,1,1
64004,53,17770,53,allow,247,94,153,2,30,1,1
55144,30188,0,0,deny,66,66,0,1,0,1,0
28110,22,0,0,deny,60,60,0,1,0,1,0
63130,445,0,0,drop,66,66,0,1,0,1,0
57677,57470,0,0,deny,62,62,0,1,0,1,0
49247,53,7662,53,allow,478,196,282,6,63,3,3
62680,445,0,0,drop,70,70,0,1,0,1,0
45964,3111,0,0,deny,60,60,0,1,0,1,0
49416,443,60402,443,allow,625995,31468,594527,722,199,256,466
65216,35440,0,0,deny,66,66,0,1,0,1,0
49758,53,63769,53,allow,243,102,141,2,30,1,1
60477,445,0,0,drop,70,70,0,1,0,1,0
64513,53,5790,53,allow,336,93,243,4,33,2,2
58681,36829,0,0,deny,70,70,0,1,0,1,0
54094,445,0,0,drop,70,70,0,1,0,1,0
53739,27290,28914,27290,allow,70,70,0,1,4,1,0
56439,53,20721,53,allow,177,94,83,2,29,1,1
49752,53,13383,53,allow,199,86,113,2,31,1,1
42162,80,42162,80,allow,2941,1499,1442,10,16,6,4
52208,47300,20128,47300,allow,70,70,0,2,9,2,0
47700,51505,0,0,deny,66,66,0,1,0,1,0
49364,443,26461,443,allow,8376,2198,6178,25,81,14,11
65422,26467,0,0,deny,62,62,0,1,0,1,0
43923,5222,15090,5222,allow,3007,1354,1653,28,83,15,13
65074,53,29931,53,allow,284,118,166,2,30,1,1
26642,57470,0,0,deny,62,62,0,1,0,1,0
16393,22114,0,0,deny,66,66,0,1,0,1,0
23338,53,23338,53,allow,242,98,144,2,30,1,1
47173,35440,0,0,deny,62,62,0,1,0,1,0
6881,10385,61159,10385,allow,118,118,0,1,1199,1,0
56756,53,38135,53,allow,167,86,81,2,30,1,1
56650,80,32144,80,allow,234,234,0,4,12,4,0
44414,123,11306,123,allow,184,94,90,2,30,1,1
49905,80,54689,80,allow,1173,672,501,8,31,5,3
58638,5900,0,0,deny,62,62,0,1,0,1,0
51996,57470,0,0,deny,66,66,0,1,0,1,0
58007,445,0,0,drop,66,66,0,1,0,1,0
56775,53,34626,53,allow,763,101,662,2,30,1,1
51244,30228,0,0,deny,100,100,0,1,0,1,0
56612,53,50823,53,allow,184,94,90,2,30,1,1
64791,53,19786,53,allow,526,197,329,6,49,3,3
64095,53,56290,53,allow,177,94,83,2,30,1,1
54991,443,1653,443,allow,20604,3530,17074,40,19,21,19
13588,15503,0,0,deny,62,62,0,1,0,1,0
55224,53,48169,53,allow,182,94,88,2,30,1,1
28899,37965,0,0,deny,62,62,0,1,0,1,0
51735,50794,12843,50794,allow,70,70,0,1,5,1,0
22619,10214,0,0,deny,66,66,0,1,0,1,0
41811,443,11732,443,allow,28899,3134,25765,66,271,32,34
57607,443,42010,443,allow,2614,1689,925,18,20,10,8
64679,53,2951,53,allow,178,94,84,2,30,1,1
62608,445,0,0,drop,70,70,0,1,0,1,0
55161,445,0,0,drop,66,66,0,1,0,1,0
59816,443,30172,443,allow,622,310,312,11,29,6,5
35722,30188,0,0,deny,62,62,0,1,0,1,0
59200,445,0,0,drop,66,66,0,1,0,1,0
1025,35447,0,0,deny,62,62,0,1,0,1,0
49522,443,12494,443,allow,3090,1796,1294,19,26,10,9
443,64347,0,0,deny,85,85,0,1,0,1,0
53198,443,53198,443,allow,4591,1684,2907,19,28,11,8
55804,53,21847,53,allow,193,102,91,2,30,1,1
50305,443,11776,443,allow,3325,1851,1474,19,16,9,10
56582,37965,0,0,deny,62,62,0,1,0,1,0
49669,53,30235,53,allow,197,94,103,2,30,1,1
49220,445,0,0,drop,66,66,0,1,0,1,0
59524,445,0,0,drop,70,70,0,1,0,1,0
50645,445,0,0,drop,70,70,0,1,0,1,0
59622,445,0,0,drop,70,70,0,1,0,1,0
14252,35993,0,0,deny,66,66,0,1,0,1,0
41485,443,16482,443,allow,29513,23962,5551,40,121,24,16
56768,445,0,0,drop,70,70,0,1,0,1,0
65216,445,0,0,drop,70,70,0,1,0,1,0
52831,3389,52831,3389,allow,4145,1976,2169,22,18,13,9
13518,25174,0,0,deny,62,62,0,1,0,1,0
60957,445,0,0,drop,70,70,0,1,0,1,0
46640,4443,0,0,deny,60,60,0,1,0,1,0
64614,445,0,0,drop,66,66,0,1,0,1,0
49794,53,12589,53,allow,197,102,95,2,30,1,1
55742,53,18944,53,allow,193,102,91,2,30,1,1
58638,5900,0,0,deny,62,62,0,1,0,1,0
63963,445,0,0,drop,70,70,0,1,0,1,0
26900,27017,65080,27017,allow,422,164,258,6,30,3,3
51428,445,0,0,drop,70,70,0,1,0,1,0
54526,445,0,0,drop,70,70,0,1,0,1,0
53189,62413,0,0,deny,62,62,0,1,0,1,0
51008,445,0,0,drop,70,70,0,1,0,1,0
51979,443,24826,443,allow,10613,3156,7457,42,15,24,18
9775,30188,0,0,deny,62,62,0,1,0,1,0
57314,53,2474,53,allow,195,102,93,2,31,1,1
59978,443,59552,443,allow,10132,5161,4971,42,15,25,17
64054,54778,50482,54778,allow,312,132,180,6,6,3,3
39568,443,60001,443,allow,4477,2605,1872,22,248,12,10
58638,5900,0,0,deny,62,62,0,1,0,1,0
60066,80,60066,80,allow,355862,9048,346814,358,163,116,242
57470,35667,24783,35667,allow,132,132,0,3,1200,3,0
50502,80,37094,80,allow,318,192,126,6,25,4,2
51001,445,0,0,drop,70,70,0,1,0,1,0
54467,80,25502,80,allow,17572,1518,16054,30,255,16,14
63839,445,0,0,drop,70,70,0,1,0,1,0
55898,445,0,0,drop,66,66,0,1,0,1,0
3964,51505,0,0,deny,62,62,0,1,0,1,0
56771,53,50189,53,allow,166,86,80,2,30,1,1
64113,445,0,0,drop,70,70,0,1,0,1,0
64294,64147,0,0,deny,62,62,0,1,0,1,0
51656,80,50242,80,allow,152651,4700,147951,174,17,65,109
61831,443,61831,443,allow,530764,27638,503126,528,175,179,349
48220,443,48220,443,allow,4627,1720,2907,18,26,10,8
58638,5900,0,0,deny,62,62,0,1,0,1,0
61970,57866,0,0,deny,62,62,0,1,0,1,0
63461,51505,0,0,deny,66,66,0,1,0,1,0
35408,56205,0,0,deny,66,66,0,1,0,1,0
55268,53,37193,53,allow,186,95,91,2,31,1,1
57134,445,0,0,drop,70,70,0,1,0,1,0
51487,443,18707,443,allow,10453,3977,6476,27,54,15,12
64879,53,13290,53,allow,165,86,79,2,30,1,1
49969,53,49918,53,allow,198,101,97,2,31,1,1
59177,445,0,0,drop,70,70,0,1,0,1,0
58664,64147,0,0,deny,62,62,0,1,0,1,0
65482,443,27020,443,allow,6762,3351,3411,31,160,14,17
49915,53,47403,53,allow,225,102,123,2,30,1,1
12299,53,12299,53,allow,229,89,140,2,30,1,1
18063,53,18063,53,allow,219,87,132,2,30,1,1
11988,48817,0,0,deny,66,66,0,1,0,1,0
51675,443,51675,443,allow,4539,1632,2907,19,27,11,8
55031,445,0,0,drop,70,70,0,1,0,1,0
49418,27015,42779,27015,allow,227,71,156,2,30,1,1
10704,25174,0,0,deny,62,62,0,1,0,1,0
65379,443,56474,443,allow,4514,2844,1670,29,84,14,15
52472,7302,0,0,deny,66,66,0,1,0,1,0
59762,443,29034,443,allow,382,164,218,2,31,1,1
60070,44847,0,0,deny,66,66,0,1,0,1,0
63476,445,0,0,drop,70,70,0,1,0,1,0
45941,23386,0,0,deny,60,60,0,1,0,1,0
9457,443,13669,443,allow,5316,488,4828,14,15,7,7
19610,9571,0,0,deny,62,62,0,1,0,1,0
55760,53,9967,53,allow,182,94,88,2,30,1,1
56129,53,60836,53,allow,94,94,0,1,30,1,0
34360,25174,0,0,deny,66,66,0,1,0,1,0
50735,445,0,0,drop,70,70,0,1,0,1,0
53790,443,36167,443,allow,499,425,74,4,0,3,1
10886,51505,0,0,deny,62,62,0,1,0,1,0
50036,445,0,0,drop,70,70,0,1,0,1,0
55159,53,17196,53,allow,168,86,82,2,30,1,1
56388,22114,0,0,deny,66,66,0,1,0,1,0
57385,80,37415,80,allow,2546,1294,1252,17,138,9,8
52208,43890,0,0,deny,66,66,0,1,0,1,0
50475,445,0,0,drop,70,70,0,1,0,1,0
51737,54691,48488,54691,allow,316,136,180,6,5,3,3
55191,445,0,0,drop,66,66,0,1,0,1,0
52036,445,0,0,drop,70,70,0,1,0,1,0
60778,445,0,0,drop,66,66,0,1,0,1,0
53092,443,13048,443,allow,97276,2756,94520,96,96,21,75
56621,53,30051,53,allow,177,94,83,2,31,1,1
49205,53,19317,53,allow,194,102,92,2,31,1,1
51096,63710,0,0,deny,62,62,0,1,0,1,0
64441,445,0,0,drop,66,66,0,1,0,1,0
36738,80,36738,80,allow,416,198,218,7,121,4,3
51658,80,29469,80,allow,318,192,126,6,37,4,2
1972,57470,0,0,deny,78,78,0,1,0,1,0
49608,53,36244,53,allow,177,94,83,2,31,1,1
56375,53,41703,53,allow,177,94,83,2,30,1,1
58820,443,32869,443,allow,5167,700,4467,16,15,7,9
46776,443,41505,443,allow,7389,1786,5603,26,211,14,12
56524,443,14904,443,allow,344632,9074,335558,354,121,122,232
60783,445,0,0,drop,70,70,0,1,0,1,0
54179,445,0,0,drop,70,70,0,1,0,1,0
52508,53,51671,53,allow,168,78,90,2,30,1,1
59699,443,10810,443,allow,9015,2221,6794,27,421,13,14
59626,22114,0,0,deny,66,66,0,1,0,1,0
53869,56205,0,0,deny,62,62,0,1,0,1,0
52186,445,0,0,drop,70,70,0,1,0,1,0
61411,80,31645,80,allow,145440,11034,134406,292,158,135,157
63980,4804,28040,4804,allow,66,66,0,2,8,2,0
42881,443,61289,443,allow,28707,2793,25914,58,115,29,29
58638,5900,0,0,deny,62,62,0,1,0,1,0
1190,25174,0,0,deny,62,62,0,1,0,1,0
60742,20010,30698,20010,allow,70,70,0,1,5,1,0
57010,445,0,0,drop,70,70,0,1,0,1,0
50944,443,50944,443,allow,1210,637,573,14,25,7,7
63939,3389,63939,3389,allow,4134,2109,2025,18,17,9,9
50265,14107,11611,14107,allow,132,132,0,3,1200,3,0
31019,53,31019,53,allow,194,87,107,2,30,1,1
45123,15000,48758,15000,allow,130,70,60,2,6,1,1
43196,80,6981,80,allow,3494,1589,1905,16,186,9,7
60190,443,8550,443,allow,10178,1101,9077,22,125,10,12
33822,57470,0,0,deny,66,66,0,1,0,1,0
65316,445,0,0,drop,70,70,0,1,0,1,0
23021,2222,0,0,deny,60,60,0,1,0,1,0
57240,445,0,0,drop,66,66,0,1,0,1,0
64951,53,50176,53,allow,402,118,284,2,30,1,1
27005,50019,8990,50019,allow,877,126,751,2,31,1,1
55012,53,50167,53,allow,275,110,165,2,30,1,1
65276,53,64809,53,allow,195,86,109,2,30,1,1
54110,445,0,0,drop,70,70,0,1,0,1,0
55657,37273,52099,37273,allow,70,70,0,1,5,1,0
60492,11339,16258,11339,allow,70,70,0,2,8,2,0
34311,5900,0,0,deny,60,60,0,1,0,1,0
57321,53,34343,53,allow,762,98,664,2,30,1,1
49399,80,18487,80,allow,4382,2084,2298,18,66,10,8
61361,443,55767,443,allow,9604,5021,4583,29,86,15,14
57415,53,16994,53,allow,223,86,137,2,30,1,1
65514,53,43311,53,allow,214,110,104,2,30,1,1
65085,445,0,0,drop,66,66,0,1,0,1,0
61671,445,0,0,drop,70,70,0,1,0,1,0
57800,445,0,0,drop,66,66,0,1,0,1,0
52357,445,0,0,drop,70,70,0,1,0,1,0
5588,5588,0,0,allow,3562,1936,1626,48,196,24,24
43518,443,23490,443,allow,10265,2118,8147,23,81,13,10
3996,57470,0,0,deny,62,62,0,1,0,1,0
53754,53,53754,53,allow,257,114,143,2,30,1,1
52152,443,39969,443,allow,433460,26631,406829,595,147,224,371
38805,443,57310,443,allow,6686,1197,5489,23,16,12,11
64292,445,0,0,drop,66,66,0,1,0,1,0
55803,53,50944,53,allow,760,97,663,2,30,1,1
33109,443,18483,443,allow,6749,1593,5156,23,123,12,11
52045,445,0,0,drop,70,70,0,1,0,1,0
58753,443,28125,443,allow,70,70,0,1,5,1,0
55650,53,39411,53,allow,179,94,85,2,29,1,1
51917,26077,25405,26077,allow,70,70,0,1,5,1,0
50110,53,63137,53,allow,178,94,84,2,30,1,1
58868,443,25875,443,allow,1826093,48237,1777856,1873,71,599,1274
64359,53,13819,53,allow,230,102,128,2,30,1,1
54339,443,11466,443,allow,3149,769,2380,10,120,5,5
49668,80,43673,80,allow,318,192,126,6,41,4,2
9353,32761,0,0,deny,110,110,0,1,0,1,0
52813,445,0,0,drop,70,70,0,1,0,1,0
20706,37965,0,0,deny,62,62,0,1,0,1,0
49373,445,0,0,drop,70,70,0,1,0,1,0
58930,443,53896,443,allow,70,70,0,1,5,1,0
35991,443,1116,443,allow,10857,4247,6610,27,121,13,14
19473,41049,5316,41049,allow,149,149,0,1,1200,1,0
51262,35440,0,0,deny,66,66,0,1,0,1,0
49001,48817,0,0,deny,160,160,0,1,0,1,0
49882,53,52287,53,allow,441,104,337,4,48,2,2
65374,53,40635,53,allow,376,102,274,4,47,2,2
57233,50934,0,0,deny,66,66,0,1,0,1,0
56596,53,50700,53,allow,199,102,97,2,30,1,1
56569,53,52915,53,allow,94,94,0,1,30,1,0
37815,443,28606,443,allow,6226,4834,1392,17,125,11,6
49418,27015,32814,27015,allow,257,78,179,2,30,1,1
56646,443,12579,443,allow,7862,1873,5989,20,15,11,9
58764,445,0,0,drop,70,70,0,1,0,1,0
44714,25174,0,0,deny,146,146,0,1,0,1,0
49941,445,0,0,drop,70,70,0,1,0,1,0
45470,443,49980,443,allow,1636,827,809,18,43,10,8
58638,5900,0,0,deny,62,62,0,1,0,1,0
17873,23117,0,0,deny,66,66,0,1,0,1,0
60454,18359,20909,18359,allow,1842,1017,825,19,16,9,10
55317,445,0,0,drop,70,70,0,1,0,1,0
56863,53,37391,53,allow,177,94,83,2,30,1,1
49336,25174,0,0,deny,62,62,0,1,0,1,0
55714,53,2036,53,allow,165,86,79,2,30,1,1
3937,36829,0,0,deny,62,62,0,1,0,1,0
60039,53,37317,53,allow,312,82,230,2,31,1,1
49160,3800,35343,3800,allow,854,150,704,4,1200,2,2
32299,40015,58130,40015,allow,148,86,62,2,30,1,1
64890,53,55634,53,allow,210,110,100,2,29,1,1
45564,443,3708,443,allow,69614,5520,64094,100,21,52,48
27005,1108,19358,1108,allow,873,126,747,2,30,1,1
60428,55172,58181,55172,allow,320,140,180,6,7,3,3
53126,445,0,0,drop,70,70,0,1,0,1,0
55375,53,40220,53,allow,222,102,120,2,30,1,1
56940,53,20579,53,allow,316,97,219,4,33,2,2
53232,443,53232,443,allow,1270,697,573,15,33,8,7
61769,445,0,0,drop,70,70,0,1,0,1,0
59874,22114,0,0,deny,66,66,0,1,0,1,0
56843,445,0,0,drop,70,70,0,1,0,1,0
57294,443,32624,443,allow,122959,4611,118348,142,150,51,91
55643,53,52917,53,allow,183,94,89,2,31,1,1
51885,445,0,0,drop,70,70,0,1,0,1,0
24021,6881,0,0,deny,146,146,0,1,0,1,0
50096,53,50096,53,allow,197,90,107,2,30,1,1
53744,443,46972,443,allow,499,425,74,4,0,3,1
53756,50584,0,0,deny,66,66,0,1,0,1,0
51388,443,13575,443,allow,6703,3312,3391,31,145,14,17
24041,55783,0,0,deny,62,62,0,1,0,1,0
63815,445,0,0,drop,70,70,0,1,0,1,0
59859,53,1491,53,allow,218,86,132,2,30,1,1
52139,445,0,0,drop,70,70,0,1,0,1,0
55354,53,63415,53,allow,214,110,104,2,30,1,1
37597,443,2780,443,allow,10497,3476,7021,34,17,18,16
50969,80,54293,80,allow,921711,12229,909482,780,37,172,608
34100,443,31456,443,allow,2044,1024,1020,17,80,9,8
50290,443,49413,443,allow,26064,2233,23831,44,97,23,21
6666,138,0,0,deny,60,60,0,1,0,1,0
55344,53,42459,53,allow,212,110,102,2,29,1,1
61227,445,0,0,drop,70,70,0,1,0,1,0
51054,445,0,0,drop,70,70,0,1,0,1,0
60962,64147,0,0,deny,66,66,0,1,0,1,0
49903,53,18446,53,allow,215,102,113,2,29,1,1
58836,44847,0,0,deny,74,74,0,1,0,1,0
64013,48970,1892,48970,allow,66,66,0,2,8,2,0
2464,50584,0,0,deny,66,66,0,1,0,1,0
47444,443,24955,443,allow,13920,5009,8911,34,30,18,16
52088,80,52684,80,allow,3442,1728,1714,15,21,9,6
64621,53,62273,53,allow,214,102,112,2,30,1,1
6872,23,0,0,deny,60,60,0,1,0,1,0
46339,443,43068,443,allow,4392,1781,2611,21,20,12,9
48815,22114,0,0,deny,146,146,0,1,0,1,0
49467,53,63815,53,allow,811,94,717,2,30,1,1
49917,443,38114,443,allow,7645,2967,4678,23,15,13,10
56946,80,58825,80,allow,214,140,74,4,30,3,1
51720,445,0,0,drop,66,66,0,1,0,1,0
54305,35440,0,0,deny,62,62,0,1,0,1,0
62160,53,62160,53,allow,205,81,124,2,30,1,1
50283,53,31898,53,allow,767,102,665,2,29,1,1
48292,80,5673,80,allow,14038,3554,10484,45,1142,16,29
56256,80,30485,80,allow,25043,1750,23293,44,30,23,21
49915,35440,0,0,deny,62,62,0,1,0,1,0
58651,445,0,0,drop,70,70,0,1,0,1,0
60159,445,0,0,drop,66,66,0,1,0,1,0
50476,80,25570,80,allow,5049,4344,705,11,30,6,5
58638,5900,0,0,deny,62,62,0,1,0,1,0
54393,445,0,0,drop,70,70,0,1,0,1,0
56584,53,11866,53,allow,214,102,112,2,30,1,1
49222,443,64126,443,allow,476852,12774,464078,491,17,177,314
49298,53,53447,53,allow,230,102,128,2,30,1,1
57654,35440,0,0,deny,66,66,0,1,0,1,0
54816,35440,0,0,deny,62,62,0,1,0,1,0
42332,22114,0,0,deny,66,66,0,1,0,1,0
60381,80,60381,80,allow,448865,6437,442428,380,151,67,313
53437,6057,54615,6057,allow,245,245,0,2,30,2,0
27005,27013,37862,27013,allow,869,126,743,2,30,1,1
55710,63545,52051,63545,allow,504,318,186,8,15,5,3
54602,445,0,0,drop,70,70,0,1,0,1,0
60152,26467,0,0,deny,62,62,0,1,0,1,0
49466,53,56538,53,allow,202,103,99,2,31,1,1
55326,53,39375,53,allow,177,94,83,2,29,1,1
56372,53,63368,53,allow,172,94,78,2,29,1,1
64306,64147,0,0,deny,66,66,0,1,0,1,0
2923,57470,0,0,deny,66,66,0,1,0,1,0
50012,53,31232,53,allow,209,102,107,2,30,1,1
58288,443,25819,443,allow,6438,2646,3792,18,37,11,7
63741,50584,0,0,deny,66,66,0,1,0,1,0
50513,445,0,0,drop,70,70,0,1,0,1,0
17760,50584,0,0,deny,62,62,0,1,0,1,0
48706,23393,0,0,deny,60,60,0,1,0,1,0
16387,56995,0,0,deny,60,60,0,1,0,1,0
7275,39827,0,0,deny,74,74,0,1,0,1,0
53861,53065,16335,53065,allow,70,70,0,2,8,2,0
52664,445,0,0,drop,66,66,0,1,0,1,0
55070,445,0,0,drop,70,70,0,1,0,1,0
58638,5900,0,0,deny,62,62,0,1,0,1,0
32777,443,20717,443,allow,8080,2049,6031,23,255,12,11
57131,443,18384,443,allow,6489,1065,5424,22,255,12,10
56239,445,0,0,drop,70,70,0,1,0,1,0
63196,445,0,0,drop,70,70,0,1,0,1,0
57987,3478,8652,3478,allow,312,140,172,4,30,2,2
52839,443,27104,443,allow,11808,5409,6399,73,123,33,40
38678,443,20008,443,allow,380978,8857,372121,373,16,115,258
58445,445,0,0,drop,70,70,0,1,0,1,0
58638,5900,0,0,deny,62,62,0,1,0,1,0
62977,445,0,0,drop,70,70,0,1,0,1,0
56343,443,34805,443,allow,350,210,140,6,27,4,2
57092,53,3743,53,allow,228,102,126,2,30,1,1
56082,445,0,0,drop,66,66,0,1,0,1,0
62985,8920,45375,8920,allow,823,577,246,9,15,5,4
56963,53,37570,53,allow,199,102,97,2,29,1,1
56231,53,22476,53,allow,779,86,693,2,30,1,1
59147,51505,0,0,deny,62,62,0,1,0,1,0
10916,44847,0,0,deny,66,66,0,1,0,1,0
57389,53,9146,53,allow,193,102,91,2,31,1,1
60242,80,7986,80,allow,1493,737,756,11,150,6,5
56660,443,63035,443,allow,8006,1986,6020,20,15,11,9
57471,62413,0,0,deny,66,66,0,1,0,1,0
49881,53,28896,53,allow,213,102,111,2,30,1,1
51773,23728,8041,23728,allow,70,70,0,1,5,1,0
35657,48637,0,0,deny,62,62,0,1,0,1,0
58239,80,32964,80,allow,2444,2444,0,3,191,3,0
49636,443,48846,443,allow,6158,1149,5009,17,52,9,8
64346,445,0,0,drop,70,70,0,1,0,1,0
64633,53,4250,53,allow,762,98,664,2,30,1,1
18291,37807,0,0,deny,146,146,0,1,0,1,0
26324,30188,0,0,deny,62,62,0,1,0,1,0
56624,443,23164,443,allow,8536,3817,4719,25,20,15,10
62630,445,0,0,drop,66,66,0,1,0,1,0
50837,443,12077,443,allow,3292,2022,1270,16,16,9,7
56813,53,41752,53,allow,753,96,657,2,31,1,1
44448,443,36659,443,allow,5960,1651,4309,21,85,12,9
41176,443,1178,443,allow,31541,25324,6217,49,91,29,20
58894,443,56665,443,allow,354,294,60,2,4,1,1
56906,50584,0,0,deny,62,62,0,1,0,1,0
17481,53,17481,53,allow,198,90,108,2,30,1,1
2348,3389,2348,3389,allow,4145,1976,2169,22,19,13,9
65055,53,55759,53,allow,1426,98,1328,4,55,2,2
55022,23,0,0,deny,60,60,0,1,0,1,0
55032,53,0,0,allow,288,79,209,2,31,1,1
62057,445,0,0,drop,66,66,0,1,0,1,0
55047,80,59301,80,allow,306,180,126,6,32,4,2
56919,53,26686,53,allow,170,87,83,2,30,1,1
64221,53,19919,53,allow,262,102,160,2,30,1,1
56326,445,0,0,drop,66,66,0,1,0,1,0
65360,445,0,0,drop,70,70,0,1,0,1,0
27337,51505,0,0,deny,62,62,0,1,0,1,0
8282,25916,26002,25916,allow,133,64,69,3,33,2,1
53589,40281,13610,40281,allow,70,70,0,2,7,2,0
50555,445,0,0,drop,70,70,0,1,0,1,0
56198,53,15932,53,allow,789,110,679,2,31,1,1
51634,443,38565,443,allow,3174,346,2828,12,121,5,7
56703,53,38555,53,allow,183,94,89,2,30,1,1
56556,53,58365,53,allow,184,94,90,2,31,1,1
65428,53,31541,53,allow,195,102,93,2,31,1,1
54371,443,51699,443,allow,6120,1305,4815,20,983,10,10
57374,53,45450,53,allow,733,86,647,2,31,1,1
64548,53,58347,53,allow,209,110,99,2,30,1,1
38565,51505,0,0,deny,66,66,0,1,0,1,0
6778,50584,0,0,deny,66,66,0,1,0,1,0
50316,80,27928,80,allow,1677,862,815,10,15,5,5
56449,445,0,0,drop,66,66,0,1,0,1,0
50542,53,19780,53,allow,762,98,664,2,30,1,1
64676,445,0,0,drop,70,70,0,1,0,1,0
59848,53,28215,53,allow,239,102,137,2,30,1,1
1873,37965,0,0,deny,62,62,0,1,0,1,0
64722,53,27260,53,allow,184,94,90,2,30,1,1
64344,53,46040,53,allow,286,102,184,4,45,2,2
60052,37965,0,0,deny,66,66,0,1,0,1,0
49476,53,34696,53,allow,764,102,662,2,30,1,1
60794,445,0,0,drop,66,66,0,1,0,1,0
19858,64147,0,0,deny,62,62,0,1,0,1,0
20706,37965,0,0,deny,62,62,0,1,0,1,0
35178,8635,35178,8635,allow,138,78,60,2,5,1,1
37587,443,9282,443,allow,6912,1841,5071,33,27,17,16
50321,40284,0,0,deny,348,348,0,1,0,1,0
64874,445,0,0,drop,70,70,0,1,0,1,0
43227,443,35933,443,allow,1139403,49178,1090225,1155,108,353,802
27005,27019,20474,27019,allow,2024,504,1520,7,33,5,2
49932,53,2052,53,allow,289,94,195,2,30,1,1
50636,23117,0,0,deny,62,62,0,1,0,1,0
38565,51505,0,0,deny,66,66,0,1,0,1,0
52565,445,0,0,drop,70,70,0,1,0,1,0
63194,445,0,0,drop,70,70,0,1,0,1,0
38122,443,65050,443,allow,191454,11241,180213,262,42,128,134
46730,443,28358,443,allow,7648,1671,5977,25,31,13,12
23126,35440,0,0,deny,62,62,0,1,0,1,0
49379,53,1311,53,allow,198,101,97,2,30,1,1
56624,443,46421,443,allow,12807,129,12678,13,147,2,11
55264,53,48968,53,allow,177,94,83,2,30,1,1
39230,23,0,0,deny,60,60,0,1,0,1,0
57790,443,14547,443,allow,6321,3341,2980,19,135,9,10
23006,48817,0,0,deny,62,62,0,1,0,1,0
443,20087,0,0,deny,83,83,0,1,0,1,0
49279,80,12266,80,allow,254,128,126,5,15,3,2
27773,56205,0,0,deny,146,146,0,1,0,1,0
49475,443,44120,443,allow,10402,1945,8457,24,158,11,13
33008,53,33008,53,allow,263,104,159,2,30,1,1
51626,445,0,0,drop,70,70,0,1,0,1,0
52189,443,26207,443,allow,4688,3009,1679,33,80,17,16
37479,53,37479,53,allow,214,82,132,2,30,1,1
58036,443,28433,443,allow,10454,1724,8730,28,525,12,16
2049,32480,0,0,deny,66,66,0,1,0,1,0
59832,443,5609,443,allow,302,120,182,6,28,3,3
27005,27001,29327,27001,allow,883,126,757,2,30,1,1
50125,445,0,0,drop,66,66,0,1,0,1,0
63982,25174,0,0,deny,62,62,0,1,0,1,0
25,63566,25,63566,allow,102,102,0,1,5,1,0
51706,25174,0,0,deny,66,66,0,1,0,1,0
18105,53,18105,53,allow,216,98,118,2,30,1,1
58835,445,0,0,drop,70,70,0,1,0,1,0
28135,34021,0,0,reset-both,62,62,0,1,0,1,0
56297,445,0,0,drop,70,70,0,1,0,1,0
53477,443,34084,443,allow,21476,1330,20146,32,137,12,20
54868,1433,0,0,deny,60,60,0,1,0,1,0
49207,443,35081,443,allow,2643240,203689,2439551,3285,576,1237,2048
51512,443,52808,443,allow,626132,21332,604800,730,33,294,436
60039,80,53912,80,allow,3431,2292,1139,17,142,10,7
55233,445,0,0,drop,70,70,0,1,0,1,0
49830,443,24513,443,allow,8471,2343,6128,30,240,15,15
57107,64147,0,0,deny,66,66,0,1,0,1,0
65228,53,0,0,deny,88,88,0,1,0,1,0
54121,443,54121,443,allow,184574,24037,160537,209,84,87,122
55945,53,51093,53,allow,733,86,647,2,30,1,1
48344,443,64214,443,allow,2588313,95154,2493159,2645,190,811,1834
45964,2225,0,0,deny,60,60,0,1,0,1,0
50584,51413,45972,51413,allow,1275,300,975,6,1200,3,3
52472,445,0,0,drop,70,70,0,1,0,1,0
59599,62413,0,0,deny,146,146,0,1,0,1,0
54962,53,60392,53,allow,194,102,92,2,29,1,1
50319,53,65506,53,allow,194,102,92,2,30,1,1
5908,3389,5908,3389,allow,3850,1745,2105,19,18,11,8
53688,17106,13403,17106,allow,70,70,0,1,4,1,0
64439,53,35218,53,allow,199,102,97,2,31,1,1
57430,80,9392,80,allow,4509,2976,1533,13,15,6,7
56752,44847,0,0,deny,62,62,0,1,0,1,0
53626,445,0,0,drop,70,70,0,1,0,1,0
53864,445,0,0,drop,70,70,0,1,0,1,0
61833,443,61833,443,allow,80743,4724,76019,101,89,37,64
56893,53,7619,53,allow,177,94,83,2,30,1,1
57259,53,28924,53,allow,167,86,81,2,29,1,1
55665,44235,23820,44235,allow,504,318,186,8,15,5,3
53944,445,0,0,drop,70,70,0,1,0,1,0
65277,53,40732,53,allow,199,102,97,2,30,1,1
52983,445,0,0,drop,66,66,0,1,0,1,0
54364,445,0,0,drop,70,70,0,1,0,1,0
46808,25174,0,0,deny,62,62,0,1,0,1,0
55313,443,62411,443,allow,4005,1162,2843,17,142,8,9
55323,443,19578,443,allow,229587,8510,221077,245,121,82,163
62033,445,0,0,drop,66,66,0,1,0,1,0
56832,445,0,0,drop,70,70,0,1,0,1,0
50265,80,26557,80,allow,2100,1146,954,13,46,6,7
57001,53,34470,53,allow,210,110,100,2,30,1,1
49531,53,38676,53,allow,183,94,89,2,29,1,1
64964,53,20852,53,allow,194,99,95,2,31,1,1
19838,23,0,0,deny,60,60,0,1,0,1,0
51834,35440,0,0,deny,66,66,0,1,0,1,0
53514,8999,20953,8999,allow,70,70,0,1,5,1,0
55656,53,30150,53,allow,413,102,311,2,30,1,1
19229,53,19229,53,allow,213,87,126,2,31,1,1
42119,443,42119,443,allow,9299,1697,7602,21,146,12,9
56306,17500,0,0,deny,146,146,0,1,0,1,0
58638,5900,0,0,deny,62,62,0,1,0,1,0
2359,443,2359,443,allow,8209,1695,6514,21,23,13,8
49445,80,19716,80,allow,1586,808,778,13,45,7,6
52158,443,56576,443,allow,2149,1549,600,14,45,8,6
58547,53,0,0,allow,86,86,0,1,29,1,0
26953,30317,0,0,deny,62,62,0,1,0,1,0
55674,445,0,0,drop,66,66,0,1,0,1,0
58638,5900,0,0,deny,62,62,0,1,0,1,0
57500,23,0,0,deny,60,60,0,1,0,1,0
45941,23386,0,0,deny,60,60,0,1,0,1,0
45886,80,22615,80,allow,6959,2024,4935,14,148,8,6
59737,53,18837,53,allow,382,164,218,2,31,1,1
62120,443,62120,443,allow,4378,1471,2907,19,27,11,8
61250,445,0,0,drop,70,70,0,1,0,1,0
38848,80,21726,80,allow,288702,9850,278852,312,105,123,189
45360,443,43206,443,allow,10280,6167,4113,20,15,12,8
50525,445,0,0,drop,66,66,0,1,0,1,0
27063,25174,0,0,deny,62,62,0,1,0,1,0
60261,53,9176,53,allow,233,81,152,2,31,1,1
59534,445,0,0,drop,70,70,0,1,0,1,0
4427,50584,0,0,deny,62,62,0,1,0,1,0
49234,80,29641,80,allow,1103248,36317,1066931,1001,162,276,725
56980,53,33611,53,allow,526,188,338,6,48,3,3
63196,445,0,0,deny,66,66,0,1,0,1,0
55952,445,0,0,drop,66,66,0,1,0,1,0
60650,445,0,0,drop,70,70,0,1,0,1,0
56810,445,0,0,drop,70,70,0,1,0,1,0
50265,57121,42011,57121,allow,132,132,0,3,1200,3,0
60296,80,32377,80,allow,1463,865,598,11,144,6,5
56739,53,42182,53,allow,195,102,93,2,30,1,1
53187,443,36781,443,allow,5244,1925,3319,33,21,17,16
57598,443,59383,443,allow,3323,2398,925,18,21,10,8
49864,53,49733,53,allow,193,102,91,2,29,1,1
49418,27017,35147,27017,allow,78,78,0,1,30,1,0
62019,445,0,0,drop,70,70,0,1,0,1,0
56808,53,18042,53,allow,180,94,86,2,35,1,1
53117,445,0,0,drop,70,70,0,1,0,1,0
53672,20380,35772,20380,allow,70,70,0,2,7,2,0
34158,443,8410,443,allow,130,70,60,2,15,1,1
62488,443,33482,443,allow,1326,876,450,11,32,6,5
58228,53733,0,0,deny,66,66,0,1,0,1,0
57140,53,49557,53,allow,177,94,83,2,30,1,1
59142,445,0,0,drop,66,66,0,1,0,1,0
49522,443,58242,443,allow,2731084,2639957,91127,2979,151,1945,1034
55624,53,2352,53,allow,199,102,97,2,30,1,1
4138,55777,0,0,deny,66,66,0,1,0,1,0
56620,53,51991,53,allow,322,110,212,4,30,2,2
58638,5900,0,0,deny,62,62,0,1,0,1,0
64893,53,6270,53,allow,326,134,192,2,30,1,1
17411,43890,0,0,deny,146,146,0,1,0,1,0
63647,445,0,0,drop,66,66,0,1,0,1,0
55399,53,7515,53,allow,176,90,86,2,31,1,1
56814,53,9627,53,allow,193,102,91,2,30,1,1
55837,53,36982,53,allow,195,102,93,2,29,1,1
27005,27021,33565,27021,allow,879,126,753,2,30,1,1
57909,445,0,0,drop,70,70,0,1,0,1,0
53925,61701,5754,61701,allow,70,70,0,2,8,2,0
49841,443,32376,443,allow,7084,1611,5473,29,71,15,14
51929,53371,28667,53371,allow,70,70,0,1,5,1,0
54346,443,30268,443,allow,12594,5098,7496,32,36,17,15
46773,443,61841,443,allow,10812,3429,7383,39,315,20,19
56517,445,0,0,drop,70,70,0,1,0,1,0
50654,445,0,0,drop,66,66,0,1,0,1,0
47651,443,48756,443,allow,1053,566,487,10,43,6,4
50499,445,0,0,drop,66,66,0,1,0,1,0
27368,22114,0,0,deny,146,146,0,1,0,1,0
50642,443,51887,443,allow,10981,2295,8686,32,63,16,16
50804,1,0,0,deny,62,62,0,1,0,1,0
55795,53,50908,53,allow,177,94,83,2,30,1,1
443,28417,0,0,deny,82,82,0,1,0,1,0
52094,55986,52536,55986,allow,70,70,0,2,8,2,0
49348,53,2617,53,allow,194,102,92,2,30,1,1
25207,48817,0,0,deny,62,62,0,1,0,1,0
49385,31652,0,0,allow,66,66,0,1,91,1,0
38630,443,20829,443,allow,9277,3025,6252,32,109,17,15
56142,53,42662,53,allow,194,102,92,2,31,1,1
50902,80,26223,80,allow,12578792,132594,12446198,10198,133,1845,8353
46596,443,51995,443,allow,4146,2690,1456,31,37,16,15
53771,37965,0,0,deny,66,66,0,1,0,1,0
39538,80,23642,80,allow,2191,1142,1049,21,370,9,12
51505,443,46771,443,allow,645662,22326,623336,743,41,299,444
59435,37807,0,0,deny,66,66,0,1,0,1,0
55083,53,24986,53,allow,325,110,215,4,44,2,2
443,28417,0,0,deny,82,82,0,1,0,1,0
15249,22114,0,0,deny,62,62,0,1,0,1,0
51935,38639,4270,38639,allow,70,70,0,2,8,2,0
56654,53,59245,53,allow,202,103,99,2,31,1,1
55704,53,41998,53,allow,193,102,91,2,30,1,1
63127,55860,37307,55860,allow,316,190,126,5,15,3,2
443,56117,0,0,deny,97,97,0,1,0,1,0
57375,443,64184,443,allow,130,70,60,2,15,1,1
50759,443,24454,443,allow,19782,3596,16186,38,256,21,17
42025,443,40368,443,allow,2394,1365,1029,18,275,9,9
53769,445,0,0,drop,70,70,0,1,0,1,0
49234,53,17547,53,allow,166,85,81,2,31,1,1
4110,35440,0,0,deny,62,62,0,1,0,1,0
63310,443,15095,443,allow,1481,701,780,20,120,10,10
64526,53,11461,53,allow,377,94,283,2,30,1,1
42959,443,5921,443,allow,795,795,0,2,154,2,0
50378,53,26291,53,allow,199,102,97,2,29,1,1
58758,22114,0,0,deny,66,66,0,1,0,1,0
64049,445,0,0,drop,70,70,0,1,0,1,0
59845,44847,0,0,deny,66,66,0,1,0,1,0
15933,64147,0,0,deny,62,62,0,1,0,1,0
59245,445,0,0,drop,70,70,0,1,0,1,0
38891,80,9037,80,allow,5491,2690,2801,13,15,7,6
63276,445,0,0,drop,70,70,0,1,0,1,0
55151,53,16947,53,allow,285,102,183,2,30,1,1
54560,445,0,0,drop,70,70,0,1,0,1,0
65120,445,0,0,drop,66,66,0,1,0,1,0
53861,443,51732,443,allow,499,425,74,4,1,3,1
58923,445,0,0,drop,66,66,0,1,0,1,0
64714,53,29165,53,allow,168,86,82,2,32,1,1
60740,445,0,0,drop,70,70,0,1,0,1,0
56153,445,0,0,drop,66,66,0,1,0,1,0
6881,50321,40130,50321,allow,238,118,120,2,1199,1,1
57174,53,65010,53,allow,755,94,661,2,30,1,1
50719,445,0,0,deny,66,66,0,1,0,1,0
64850,53,27196,53,allow,167,86,81,2,30,1,1
65270,3855,0,0,deny,78,78,0,1,0,1,0
51922,18413,55909,18413,allow,70,70,0,2,8,2,0
42298,40038,63975,40038,allow,148,86,62,2,30,1,1
49849,53,61078,53,allow,196,102,94,2,31,1,1
57983,443,8445,443,allow,315701,12378,303323,358,137,129,229
49178,80,4471,80,allow,2807,587,2220,13,16,7,6
49272,53,30273,53,allow,168,86,82,2,31,1,1
51547,445,0,0,drop,70,70,0,1,0,1,0
58082,443,14473,443,allow,45314943,1391230,43923713,47149,303,15196,31953
7060,53,45870,53,allow,197,94,103,2,30,1,1
55573,445,0,0,drop,70,70,0,1,0,1,0
26448,80,26448,80,allow,642,338,304,10,32,6,4
52159,16297,42997,16297,allow,70,70,0,1,5,1,0
49840,53,48921,53,allow,277,102,175,2,30,1,1
49687,53,12525,53,allow,194,99,95,2,31,1,1
53974,443,28676,443,allow,3330,1694,1636,15,30,8,7
55856,53,9134,53,allow,1410,93,1317,4,59,2,2
63307,445,0,0,drop,66,66,0,1,0,1,0
47993,443,45711,443,allow,5272,1535,3737,17,35,12,5
20650,26467,0,0,deny,66,66,0,1,0,1,0
50269,445,0,0,drop,70,70,0,1,0,1,0
37650,443,41900,443,allow,6898,5202,1696,25,25,15,10
60083,443,30237,443,allow,490571,27526,463045,511,141,170,341
52459,5555,0,0,deny,60,60,0,1,0,1,0
51308,445,0,0,drop,70,70,0,1,0,1,0
50291,445,0,0,drop,66,66,0,1,0,1,0
2346,25174,0,0,deny,66,66,0,1,0,1,0
57584,443,57584,443,allow,8019,4063,3956,33,92,16,17
50640,445,0,0,drop,70,70,0,1,0,1,0
49256,53,34162,53,allow,174,89,85,2,31,1,1
63729,80,63729,80,allow,7324,1017,6307,16,20,8,8
8108,80,8108,80,allow,7972,840,7132,16,50,6,10
56748,53,15879,53,allow,184,94,90,2,30,1,1
53757,445,0,0,drop,70,70,0,1,0,1,0
64689,53,34039,53,allow,183,94,89,2,30,1,1
62727,445,0,0,drop,70,70,0,1,0,1,0
53937,445,0,0,drop,66,66,0,1,0,1,0
57558,445,0,0,drop,66,66,0,1,0,1,0
51403,443,43951,443,allow,334,70,264,5,17,1,4
44641,80,65447,80,allow,1354,850,504,13,256,8,5
35311,443,37900,443,allow,6584,1945,4639,14,120,7,7
65381,53,45140,53,allow,241,110,131,2,30,1,1
56978,80,63683,80,allow,214,140,74,4,35,3,1
55842,443,52718,443,allow,8661,2036,6625,40,256,19,21
49534,53,17481,53,allow,315,84,231,4,40,2,2
52116,80,18216,80,allow,422,240,182,8,26,5,3
61567,53,3917,53,allow,183,86,97,2,30,1,1
51781,445,0,0,deny,70,70,0,1,0,1,0
64472,53,7630,53,allow,182,93,89,2,30,1,1
59350,445,0,0,drop,66,66,0,1,0,1,0
53576,23505,46519,23505,allow,70,70,0,1,5,1,0
43725,57470,0,0,deny,109,109,0,1,0,1,0
80,53945,0,0,deny,60,60,0,1,0,1,0
49911,53,26669,53,allow,258,110,148,2,30,1,1
58565,445,0,0,drop,70,70,0,1,0,1,0
62229,445,0,0,drop,70,70,0,1,0,1,0
58868,443,58939,443,allow,239435,36478,202957,319,111,133,186
50086,53,16389,53,allow,193,102,91,2,30,1,1
53830,445,0,0,drop,70,70,0,1,0,1,0
45941,23386,0,0,deny,60,60,0,1,0,1,0
17750,12550,53024,12550,allow,491,150,341,2,1200,1,1
53353,26467,0,0,deny,62,62,0,1,0,1,0
18472,5278,0,0,deny,145,145,0,1,0,1,0
65227,445,0,0,drop,70,70,0,1,0,1,0
55686,445,0,0,drop,70,70,0,1,0,1,0
25565,34677,0,0,deny,60,60,0,1,0,1,0
44162,80,44162,80,allow,457843,10253,447590,452,26,152,300
55063,445,0,0,drop,70,70,0,1,0,1,0
35168,443,20668,443,allow,7447,2133,5314,27,348,14,13
62023,53,10426,53,allow,301,102,199,2,30,1,1
59270,445,0,0,drop,66,66,0,1,0,1,0
56928,53,48986,53,allow,172,88,84,2,31,1,1
37663,80,36231,80,allow,974,481,493,8,15,5,3
59377,445,0,0,drop,70,70,0,1,0,1,0
65515,22114,0,0,deny,66,66,0,1,0,1,0
55028,443,52319,443,allow,6791,1415,5376,19,51,12,7
62825,445,0,0,drop,70,70,0,1,0,1,0
22530,23718,0,0,deny,66,66,0,1,0,1,0
53955,3290,25446,3290,allow,70,70,0,1,5,1,0
56810,53,20653,53,allow,438,180,258,6,30,3,3
63803,41439,2152,41439,allow,66,66,0,2,8,2,0
59739,35253,0,0,deny,62,62,0,1,0,1,0
64425,53,6282,53,allow,182,86,96,2,29,1,1
54019,445,0,0,drop,70,70,0,1,0,1,0
44516,443,18408,443,allow,156324,6993,149331,192,108,81,111
48478,49903,0,0,deny,62,62,0,1,0,1,0
59147,25174,0,0,deny,62,62,0,1,0,1,0
56997,53,44658,53,allow,168,86,82,2,30,1,1
21482,22114,0,0,deny,62,62,0,1,0,1,0
56485,445,0,0,drop,70,70,0,1,0,1,0
52074,80,8248,80,allow,422,240,182,8,26,5,3
37511,443,37511,443,allow,4673,1766,2907,19,26,11,8
56454,445,0,0,drop,70,70,0,1,0,1,0
56897,7003,14885,7003,allow,1098,672,426,14,734,8,6
58166,53,23423,53,allow,224,94,130,2,30,1,1
56894,53,54448,53,allow,178,94,84,2,29,1,1
55347,443,1685,443,allow,116686,21822,94864,224,186,112,112
26921,26467,0,0,deny,62,62,0,1,0,1,0
57100,53,28423,53,allow,180,94,86,2,31,1,1
65419,26467,0,0,deny,62,62,0,1,0,1,0
49746,443,2591,443,allow,54014,2565,51449,65,128,24,41
51985,80,32955,80,allow,1479,822,657,11,25,7,4
9265,37965,0,0,deny,66,66,0,1,0,1,0
49824,53,50073,53,allow,198,94,104,2,30,1,1
58763,53,58763,53,allow,228,90,138,2,29,1,1
54220,445,0,0,drop,70,70,0,1,0,1,0
58638,5900,0,0,deny,62,62,0,1,0,1,0
56489,53,35362,53,allow,178,94,84,2,29,1,1
56581,443,17747,443,allow,4884,1015,3869,17,25,9,8
56698,443,46123,443,allow,8058,2038,6020,20,15,11,9
51346,51221,0,0,deny,70,70,0,1,0,1,0
53358,23,0,0,deny,60,60,0,1,0,1,0
6881,35894,0,0,deny,62,62,0,1,0,1,0
49694,5900,0,0,deny,60,60,0,1,0,1,0
16330,50584,0,0,deny,62,62,0,1,0,1,0
27089,30627,0,0,deny,146,146,0,1,0,1,0
60093,443,38976,443,allow,292,172,120,4,15,2,2
47662,80,15716,80,allow,1067,697,370,8,63,5,3
59451,50584,0,0,deny,66,66,0,1,0,1,0
58893,445,0,0,drop,70,70,0,1,0,1,0
51075,445,0,0,drop,70,70,0,1,0,1,0
55694,53,17874,53,allow,274,85,189,4,35,2,2
57929,53,0,0,allow,294,86,208,2,30,1,1
50201,445,0,0,drop,70,70,0,1,0,1,0
49665,53,6360,53,allow,779,298,481,8,67,4,4
49647,443,38723,443,allow,11011,4522,6489,35,43,17,18
60030,445,0,0,drop,66,66,0,1,0,1,0
50123,443,58250,443,allow,15011,5619,9392,50,35,26,24
56082,53,4620,53,allow,182,94,88,2,30,1,1
4752,30188,0,0,deny,62,62,0,1,0,1,0
56703,53,54677,53,allow,183,94,89,2,30,1,1
38053,50584,0,0,deny,62,62,0,1,0,1,0
63931,443,46072,443,allow,103248,6121,97127,124,144,47,77
50279,53,54207,53,allow,749,94,655,2,29,1,1
51166,31573,0,0,deny,66,66,0,1,0,1,0
63961,53,2242,53,allow,373,171,202,5,40,3,2
49670,443,17269,443,allow,98424,28850,69574,508,2054,274,234
55820,53,20613,53,allow,168,86,82,2,30,1,1
56965,80,39996,80,allow,526,304,222,8,30,5,3
33388,53,33388,53,allow,229,98,131,2,30,1,1
56241,80,56241,80,allow,101607,1692,99915,94,15,24,70
62493,50584,0,0,deny,62,62,0,1,0,1,0
65328,445,0,0,drop,70,70,0,1,0,1,0
47042,80,50684,80,allow,1122,682,440,11,15,6,5
40030,443,25382,443,allow,2651,1331,1320,18,17,10,8
9172,443,4913,443,allow,89362,3092,86270,100,21,37,63
48817,10528,48817,10528,allow,2736,1992,744,37,1580,25,12
64622,36829,0,0,deny,66,66,0,1,0,1,0
31410,25174,0,0,deny,62,62,0,1,0,1,0
27179,53,27179,53,allow,398,255,143,3,34,2,1
50817,53,0,0,allow,182,73,109,2,30,1,1
53453,443,41566,443,allow,6824,2097,4727,19,15,11,8
49814,445,0,0,drop,70,70,0,1,0,1,0
50065,445,0,0,drop,70,70,0,1,0,1,0
57470,44822,45311,44822,allow,132,132,0,3,1200,3,0
2278,25174,0,0,deny,62,62,0,1,0,1,0
19096,64147,0,0,deny,62,62,0,1,0,1,0
52830,22114,0,0,deny,62,62,0,1,0,1,0
54898,443,54771,443,allow,78537,4022,74515,120,386,55,65
53888,39204,30742,39204,allow,70,70,0,2,8,2,0
52788,445,0,0,drop,66,66,0,1,0,1,0
51840,443,42990,443,allow,246,120,126,5,32,3,2
65366,443,3510,443,allow,4319,2473,1846,24,85,10,14
39597,443,19827,443,allow,1350,689,661,14,18,8,6
61612,445,0,0,drop,70,70,0,1,0,1,0
54572,445,0,0,drop,66,66,0,1,0,1,0
59072,445,0,0,drop,70,70,0,1,0,1,0
53678,31592,2735,31592,allow,70,70,0,2,8,2,0
50292,22114,0,0,deny,66,66,0,1,0,1,0
47595,33435,0,0,allow,106,106,0,1,60,1,0
50324,445,0,0,drop,70,70,0,1,0,1,0
3478,61463,0,0,deny,944,944,0,1,0,1,0
23940,41615,0,0,deny,146,146,0,1,0,1,0
58054,445,0,0,drop,66,66,0,1,0,1,0
52215,445,0,0,deny,66,66,0,1,0,1,0
57513,445,0,0,drop,66,66,0,1,0,1,0
34203,443,27925,443,allow,33068,2556,30512,48,81,21,27
10462,25174,0,0,deny,146,146,0,1,0,1,0
49862,53,62626,53,allow,744,89,655,2,31,1,1
9219,32480,0,0,deny,72,72,0,1,0,1,0
12841,37965,0,0,deny,62,62,0,1,0,1,0
60204,445,0,0,drop,66,66,0,1,0,1,0
53714,6882,41499,6882,allow,70,70,0,1,4,1,0
7686,80,7686,80,allow,176670,11287,165383,216,46,96,120
54277,22114,0,0,deny,62,62,0,1,0,1,0
45218,25174,0,0,deny,146,146,0,1,0,1,0
56932,53,30512,53,allow,172,94,78,2,30,1,1
49991,443,60218,443,allow,622,210,412,10,21,4,6
19361,23117,0,0,deny,66,66,0,1,0,1,0
57470,61768,42520,61768,allow,330,330,0,6,1199,6,0
64052,445,0,0,drop,70,70,0,1,0,1,0
47368,443,14689,443,allow,7057,2186,4871,25,316,13,12
55855,53,27713,53,allow,182,102,80,2,30,1,1
443,14591,0,0,deny,131,131,0,1,0,1,0
55688,53,29259,53,allow,184,94,90,2,31,1,1
64638,53,19660,53,allow,397,102,295,2,30,1,1
32845,9797,0,0,deny,60,60,0,1,0,1,0
51497,443,32306,443,allow,4710,699,4011,12,15,8,4
61848,445,0,0,drop,70,70,0,1,0,1,0
41228,443,9093,443,allow,9161,2210,6951,23,187,11,12
58925,25174,0,0,deny,66,66,0,1,0,1,0
65251,53,45927,53,allow,183,98,85,3,31,2,1
55752,53,32253,53,allow,177,94,83,2,30,1,1
59481,41182,0,0,deny,66,66,0,1,0,1,0
51827,56205,0,0,deny,66,66,0,1,0,1,0
57351,62413,0,0,deny,66,66,0,1,0,1,0
65242,445,0,0,drop,66,66,0,1,0,1,0
54074,445,0,0,drop,66,66,0,1,0,1,0
55447,445,0,0,drop,66,66,0,1,0,1,0
3377,50584,0,0,deny,66,66,0,1,0,1,0
22574,44847,0,0,deny,62,62,0,1,0,1,0
55339,445,0,0,drop,70,70,0,1,0,1,0
55596,53,19558,53,allow,177,94,83,2,30,1,1
62649,48817,0,0,deny,148,148,0,1,0,1,0
52455,445,0,0,drop,66,66,0,1,0,1,0
80,63761,0,0,deny,66,66,0,1,0,1,0
41410,80,40896,80,allow,1484,877,607,11,34,6,5
55467,53,34377,53,allow,193,102,91,2,30,1,1
1024,44847,0,0,deny,62,62,0,1,0,1,0
63823,51558,34606,51558,allow,66,66,0,2,7,2,0
53986,443,26855,443,allow,6734,2264,4470,19,16,11,8
8239,37965,0,0,deny,146,146,0,1,0,1,0
55671,53,40091,53,allow,196,102,94,2,33,1,1
56995,445,0,0,drop,70,70,0,1,0,1,0
62043,80,35524,80,allow,3466,665,2801,14,16,7,7
65179,44847,0,0,deny,66,66,0,1,0,1,0
34166,22114,0,0,deny,62,62,0,1,0,1,0
57643,445,0,0,drop,70,70,0,1,0,1,0
48533,443,47218,443,allow,160,69,91,2,121,1,1
64587,53,28928,53,allow,166,85,81,2,30,1,1
62551,445,0,0,drop,66,66,0,1,0,1,0
55461,53,35895,53,allow,198,110,88,2,30,1,1
56602,443,24699,443,allow,27035,4207,22828,43,31,21,22
60830,445,0,0,drop,70,70,0,1,0,1,0
48163,53,27599,53,allow,199,94,105,2,30,1,1
52002,80,36032,80,allow,546,300,246,10,24,6,4
21294,57470,0,0,deny,62,62,0,1,0,1,0
56772,53,27354,53,allow,168,86,82,2,30,1,1
59943,443,41706,443,allow,2979,914,2065,10,120,5,5
48440,53,22120,53,allow,198,93,105,2,30,1,1
35570,443,64379,443,allow,3221,705,2516,15,135,7,8
56006,23,0,0,deny,60,60,0,1,0,1,0
24009,53,24009,53,allow,825,99,726,2,30,1,1
11317,61248,0,0,reset-both,143,143,0,1,0,1,0
55797,53,20315,53,allow,177,94,83,2,29,1,1
56269,53,36395,53,allow,102,102,0,1,30,1,0
51863,22038,18854,22038,allow,70,70,0,2,7,2,0
59060,50584,0,0,deny,66,66,0,1,0,1,0
49433,53,41471,53,allow,165,86,79,2,30,1,1
49591,53,51142,53,allow,168,86,82,2,30,1,1
25091,64147,0,0,deny,66,66,0,1,0,1,0
49662,443,39223,443,allow,2690,1342,1348,23,19,12,11
60498,445,0,0,drop,66,66,0,1,0,1,0
49952,53,64431,53,allow,195,102,93,2,29,1,1
58638,5900,0,0,deny,62,62,0,1,0,1,0
46991,53,46991,53,allow,262,106,156,2,31,1,1
54601,26467,0,0,deny,62,62,0,1,0,1,0
49935,53,45170,53,allow,168,86,82,2,30,1,1
55656,53,44214,53,allow,214,110,104,2,30,1,1
49708,53,14475,53,allow,185,102,83,2,30,1,1
60513,443,14543,443,allow,9456,1987,7469,28,30,15,13
64980,445,0,0,drop,70,70,0,1,0,1,0
49631,443,7469,443,allow,11772,5416,6356,25,49,15,10
64200,53,53095,53,allow,193,102,91,2,30,1,1
36908,26467,0,0,deny,62,62,0,1,0,1,0
50193,53,18428,53,allow,770,101,669,2,30,1,1
44864,25,44864,25,allow,130,66,64,2,5,1,1
34338,443,58177,443,allow,4542,2358,2184,20,20,11,9
35657,48637,0,0,deny,62,62,0,1,0,1,0
55082,25174,0,0,deny,66,66,0,1,0,1,0
63882,49163,63411,49163,allow,66,66,0,2,8,2,0
54398,445,0,0,drop,66,66,0,1,0,1,0
55776,53,13718,53,allow,182,93,89,3,33,2,1
52728,80,55587,80,allow,13372,7598,5774,29,555,18,11
56422,53,35593,53,allow,716,95,621,2,30,1,1
57898,445,0,0,drop,70,70,0,1,0,1,0
21954,53,21954,53,allow,220,90,130,2,30,1,1
57472,44847,0,0,deny,66,66,0,1,0,1,0
51896,43357,20029,43357,allow,70,70,0,1,5,1,0
50324,443,12034,443,allow,13002,1895,11107,31,202,17,14
14844,37965,0,0,deny,62,62,0,1,0,1,0
61923,80,14146,80,allow,4295,719,3576,16,125,8,8
58771,80,64938,80,allow,2062,904,1158,10,258,6,4
55577,53,12118,53,allow,199,102,97,2,30,1,1
51996,35440,0,0,deny,66,66,0,1,0,1,0
5588,5588,0,0,allow,3354,1792,1562,46,192,23,23
27005,27015,28442,27015,allow,881,126,755,2,31,1,1
62525,445,0,0,drop,66,66,0,1,0,1,0
58542,445,0,0,drop,70,70,0,1,0,1,0
47051,443,3373,443,allow,3304,2161,1143,21,16,11,10
59647,47993,0,0,deny,66,66,0,1,0,1,0
20727,53,20727,53,allow,217,82,135,2,32,1,1
41462,443,21403,443,allow,10331,2157,8174,37,137,18,19
50126,23117,0,0,deny,62,62,0,1,0,1,0
49586,443,54181,443,allow,5879,870,5009,18,53,9,9
9480,443,14084,443,allow,6100,777,5323,17,25,9,8
60138,443,19544,443,allow,2993,1992,1001,16,15,8,8
56251,445,0,0,drop,70,70,0,1,0,1,0
57780,53,53500,53,allow,70,70,0,1,30,1,0
55662,53,45972,53,allow,212,102,110,2,30,1,1
42685,51180,0,0,deny,62,62,0,1,0,1,0
58638,5900,0,0,deny,62,62,0,1,0,1,0
51999,37965,0,0,deny,62,62,0,1,0,1,0
64636,53,4639,53,allow,325,102,223,2,30,1,1
56522,53,58867,53,allow,322,134,188,2,30,1,1
37552,443,42195,443,allow,9959,2495,7464,27,37,15,12
49347,53,23678,53,allow,342,91,251,4,54,2,2
6666,62078,0,0,deny,60,60,0,1,0,1,0
49418,30003,43016,30003,allow,71,71,0,1,30,1,0
55929,80,55929,80,allow,450,246,204,8,29,5,3
53015,64147,0,0,deny,145,145,0,1,0,1,0
60657,445,0,0,drop,70,70,0,1,0,1,0
63995,15396,7460,15396,allow,66,66,0,2,7,2,0
56246,80,56246,80,allow,101654,1739,99915,95,15,25,70
47266,25174,0,0,deny,146,146,0,1,0,1,0
49627,445,0,0,drop,70,70,0,1,0,1,0
29145,8168,0,0,deny,62,62,0,1,0,1,0
47504,443,4278,443,allow,6496,3631,2865,71,606,39,32
20217,8333,0,0,deny,60,60,0,1,0,1,0
19882,22114,0,0,deny,146,146,0,1,0,1,0
63968,53,62729,53,allow,200,102,98,2,30,1,1
44207,44847,0,0,deny,62,62,0,1,0,1,0
32820,443,45406,443,allow,11455,5836,5619,40,317,20,20
52166,26467,0,0,deny,66,66,0,1,0,1,0
52849,445,0,0,drop,70,70,0,1,0,1,0
58638,5900,58638,5900,allow,66,66,0,1,4,1,0
1024,64147,0,0,deny,62,62,0,1,0,1,0
50014,445,0,0,drop,70,70,0,1,0,1,0
64184,443,64184,443,allow,4561,1654,2907,19,28,11,8
49679,443,62696,443,allow,7938,1721,6217,25,172,12,13
11317,53563,0,0,reset-both,143,143,0,1,0,1,0
56869,445,0,0,drop,70,70,0,1,0,1,0
56715,53,19827,53,allow,184,94,90,2,30,1,1
55395,53,45676,53,allow,767,102,665,2,31,1,1
55635,53,27124,53,allow,170,87,83,2,30,1,1
60281,443,39585,443,allow,63696,4774,58922,83,125,32,51
1818,22114,0,0,deny,146,146,0,1,0,1,0
60259,445,0,0,drop,70,70,0,1,0,1,0
49426,57470,0,0,deny,66,66,0,1,0,1,0
55520,445,0,0,drop,70,70,0,1,0,1,0
54870,445,0,0,drop,70,70,0,1,0,1,0
64104,22114,0,0,deny,66,66,0,1,0,1,0
65189,28125,44608,28125,allow,78,78,0,1,29,1,0
55451,53,24181,53,allow,193,102,91,2,29,1,1
51077,443,6425,443,allow,2997,1906,1091,29,186,17,12
52070,80,56531,80,allow,3572,2746,826,14,15,8,6
54322,27015,10656,27015,allow,924,924,0,3,30,3,0
33784,443,3722,443,allow,2378,1126,1252,14,979,7,7
63017,443,7644,443,allow,571,166,405,2,29,1,1
60502,445,0,0,drop,66,66,0,1,0,1,0
37965,46008,3180,46008,allow,132,132,0,3,1200,3,0
49594,80,30490,80,allow,25430,15577,9853,37,41,19,18
52459,33890,0,0,deny,60,60,0,1,0,1,0
58602,443,31018,443,allow,3182,1568,1614,8,121,4,4
56283,53,17978,53,allow,315,102,213,2,30,1,1
59904,443,14583,443,allow,694,370,324,12,34,7,5
64469,445,0,0,drop,70,70,0,1,0,1,0
58284,445,0,0,drop,70,70,0,1,0,1,0
55488,53,31385,53,allow,210,94,116,2,29,1,1
54526,44847,0,0,deny,66,66,0,1,0,1,0
12530,35440,0,0,deny,62,62,0,1,0,1,0
56005,53,10080,53,allow,199,102,97,2,30,1,1
47765,443,53985,443,allow,8035,2176,5859,25,331,12,13
52156,18238,49104,18238,allow,70,70,0,2,7,2,0
10004,40014,64871,40014,allow,156,94,62,2,30,1,1
13159,37965,0,0,deny,66,66,0,1,0,1,0
51948,445,0,0,drop,70,70,0,1,0,1,0
52724,64147,0,0,deny,62,62,0,1,0,1,0
56943,44847,0,0,deny,62,62,0,1,0,1,0
63968,37264,37420,37264,allow,504,382,122,8,15,6,2
50659,445,0,0,drop,70,70,0,1,0,1,0
62722,443,49389,443,allow,3491257,62261,3428996,3146,155,768,2378
27005,27080,21162,27080,allow,926,126,800,2,31,1,1
52211,56648,11346,56648,allow,70,70,0,1,4,1,0
55616,445,0,0,drop,66,66,0,1,0,1,0
54218,443,2874,443,allow,499,425,74,4,0,3,1
14070,62413,0,0,deny,66,66,0,1,0,1,0
49454,53,56383,53,allow,762,97,665,2,31,1,1
51554,443,48017,443,allow,4263,671,3592,14,75,8,6
46389,27098,0,0,deny,66,66,0,1,0,1,0
55877,38597,28809,38597,allow,481,150,331,2,1200,1,1
24910,64147,0,0,deny,66,66,0,1,0,1,0
50470,80,50470,80,allow,2144,900,1244,11,26,7,4
58807,443,28426,443,allow,6033,770,5263,18,15,8,10
56439,53,49648,53,allow,198,102,96,2,29,1,1
50304,445,0,0,drop,70,70,0,1,0,1,0
14341,80,14341,80,allow,3360,2260,1100,19,61,11,8
47711,443,57619,443,allow,11793,7188,4605,34,128,17,17
13287,16933,0,0,deny,62,62,0,1,0,1,0
50516,53,53120,53,allow,168,86,82,2,30,1,1
65026,53,30024,53,allow,193,102,91,2,30,1,1
59791,443,43640,443,allow,6603,1085,5518,23,28,11,12
58839,443,35385,443,allow,8595,2118,6477,40,179,22,18
56766,443,14480,443,allow,10137,4019,6118,42,8169,24,18
49615,445,0,0,drop,70,70,0,1,0,1,0
57151,39004,0,0,deny,66,66,0,1,0,1,0
49686,53,55592,53,allow,183,94,89,2,30,1,1
57417,445,0,0,drop,66,66,0,1,0,1,0
63788,80,49704,80,allow,314,192,122,6,15,4,2
63569,445,0,0,drop,70,70,0,1,0,1,0
52212,445,0,0,drop,66,66,0,1,0,1,0
54352,443,22800,443,allow,6854,2318,4536,20,16,11,9
58305,18375,0,0,deny,66,66,0,1,0,1,0
57228,53,5585,53,allow,198,101,97,2,30,1,1
59422,53,43330,53,allow,168,78,90,2,30,1,1
56395,53,20688,53,allow,170,87,83,2,31,1,1
55388,445,0,0,drop,70,70,0,1,0,1,0
53859,443,52772,443,allow,499,425,74,4,1,3,1
50360,35440,0,0,deny,66,66,0,1,0,1,0
39267,123,6756,123,allow,184,94,90,2,30,1,1
34348,22114,0,0,deny,62,62,0,1,0,1,0
8486,56205,0,0,deny,66,66,0,1,0,1,0
58638,5900,0,0,deny,62,62,0,1,0,1,0
49290,443,20906,443,allow,1629306,22920,1606386,1339,116,262,1077
58556,80,23584,80,allow,884,529,355,10,255,6,4
24376,50584,0,0,deny,62,62,0,1,0,1,0
56522,53,65076,53,allow,177,94,83,2,31,1,1
64989,53,11063,53,allow,578,286,292,9,15,5,4
56710,53,43417,53,allow,190,97,93,2,31,1,1
50700,80,7007,80,allow,142,142,0,1,5,1,0
59991,443,45209,443,allow,5108,2834,2274,21,143,10,11
24351,57470,0,0,deny,62,62,0,1,0,1,0
49499,443,1804,443,allow,5541,2623,2918,28,144,15,13
51569,445,0,0,drop,70,70,0,1,0,1,0
61643,22114,0,0,deny,62,62,0,1,0,1,0
55022,53,7516,53,allow,195,102,93,2,30,1,1
65021,53,29006,53,allow,256,93,163,2,30,1,1
57892,443,5458,443,allow,6845,1743,5102,22,81,13,9
56375,53,48204,53,allow,177,94,83,2,30,1,1
52814,53,53198,53,allow,578,286,292,9,15,5,4
51157,443,53993,443,allow,5378,1423,3955,19,22,11,8
54687,445,0,0,drop,66,66,0,1,0,1,0
56804,33375,39167,33375,allow,70,70,0,2,8,2,0
55620,30188,0,0,deny,66,66,0,1,0,1,0
65419,53,10153,53,allow,198,101,97,2,31,1,1
53205,443,46818,443,allow,3658,2347,1311,18,17,9,9
65266,53,57275,53,allow,216,110,106,2,29,1,1
60668,445,0,0,drop,70,70,0,1,0,1,0
7968,2767,0,0,deny,66,66,0,1,0,1,0
58638,5900,0,0,deny,62,62,0,1,0,1,0
57331,53,47400,53,allow,178,94,84,2,31,1,1
26937,23,0,0,deny,60,60,0,1,0,1,0
48982,53,28037,53,allow,306,212,94,3,29,2,1
9117,80,20757,80,allow,318,192,126,6,29,4,2
56587,53,5530,53,allow,184,94,90,2,31,1,1
6881,6881,52538,6881,allow,118,118,0,1,1200,1,0
54560,53,54560,53,allow,832,106,726,2,30,1,1
53883,24830,60159,24830,allow,164,70,94,2,5,1,1
49073,443,9351,443,allow,7032,2643,4389,23,16,12,11
50463,80,9327,80,allow,1718,1247,471,9,15,5,4
53115,445,0,0,drop,66,66,0,1,0,1,0
43356,443,48473,443,allow,79561,11513,68048,183,94,95,88
58355,445,0,0,drop,66,66,0,1,0,1,0
50345,445,0,0,drop,66,66,0,1,0,1,0
56917,53,28541,53,allow,194,102,92,2,30,1,1
27005,27016,63308,27016,allow,887,126,761,2,30,1,1
55388,53,60267,53,allow,170,87,83,2,31,1,1
56040,445,0,0,drop,70,70,0,1,0,1,0
65514,53,50854,53,allow,170,87,83,2,30,1,1
55310,53,54071,53,allow,180,94,86,2,30,1,1
50868,80,40174,80,allow,12388,742,11646,18,130,7,11
58977,37965,0,0,deny,66,66,0,1,0,1,0
15465,64147,0,0,deny,62,62,0,1,0,1,0
55457,53,25879,53,allow,177,94,83,2,30,1,1
55082,53,13671,53,allow,755,93,662,2,31,1,1
49217,53,30696,53,allow,282,93,189,4,45,2,2
1024,48817,0,0,deny,148,148,0,1,0,1,0
49313,443,5265,443,allow,3185,2263,922,18,25,9,9
61340,443,7462,443,allow,31549,6352,25197,64,206,26,38
8283,45858,63554,45858,allow,130,70,60,2,30,1,1
63786,35440,0,0,deny,62,62,0,1,0,1,0
58638,5900,0,0,deny,62,62,0,1,0,1,0
55714,18904,51148,18904,allow,320,140,180,6,6,3,3
55115,53,54899,53,allow,758,96,662,2,31,1,1
63278,445,0,0,drop,70,70,0,1,0,1,0
50477,443,35054,443,allow,2604,1413,1191,15,83,9,6
60433,6881,35052,6881,allow,70,70,0,1,5,1,0
60500,443,54155,443,allow,103479,7755,95724,165,19,70,95
58638,5900,0,0,deny,62,62,0,1,0,1,0
50274,445,0,0,drop,70,70,0,1,0,1,0
56955,53,35942,53,allow,183,94,89,2,30,1,1
41295,443,40323,443,allow,7661,1115,6546,19,35,10,9
1866,51505,0,0,deny,62,62,0,1,0,1,0
56463,53,28170,53,allow,368,118,250,2,30,1,1
10001,40041,23223,40041,allow,151,89,62,2,30,1,1
56514,445,0,0,drop,70,70,0,1,0,1,0
3068,36237,0,0,deny,62,62,0,1,0,1,0
52272,37105,49502,37105,allow,316,136,180,6,6,3,3
6881,51719,22526,51719,allow,324,150,174,2,1199,1,1
51967,80,56439,80,allow,426,240,186,8,25,5,3
27005,30015,42725,30015,allow,1700,126,1574,4,31,2,2
5380,53,15988,53,allow,377,94,283,2,30,1,1
55603,32520,10079,32520,allow,5982,1890,4092,30,75,15,15
37427,443,48428,443,allow,10281,4850,5431,23,400,13,10
54730,445,0,0,drop,66,66,0,1,0,1,0
55667,19667,52444,19667,allow,70,70,0,2,8,2,0
53257,37450,0,0,deny,62,62,0,1,0,1,0
64886,53,36555,53,allow,199,102,97,2,30,1,1
53866,443,56444,443,allow,499,425,74,4,1,3,1
65019,53,36796,53,allow,195,102,93,2,30,1,1
57470,445,0,0,drop,70,70,0,1,0,1,0
55454,445,0,0,drop,70,70,0,1,0,1,0
46585,443,60959,443,allow,9439,3223,6216,27,137,13,14
65370,53,23524,53,allow,193,102,91,2,30,1,1
54038,445,0,0,drop,66,66,0,1,0,1,0
62504,443,1666,443,allow,10385,7051,3334,27,33,15,12
64055,445,0,0,drop,66,66,0,1,0,1,0
30960,45689,37422,45689,allow,330,330,0,6,3609,6,0
56344,53,6437,53,allow,199,102,97,2,31,1,1
58646,44847,0,0,deny,62,62,0,1,0,1,0
56432,80,52279,80,allow,17128,1499,15629,24,25,9,15
56775,20617,21189,20617,allow,70,70,0,1,5,1,0
49241,443,49241,443,allow,31778,6075,25703,54,49,28,26
49585,53,39603,53,allow,732,86,646,2,30,1,1
64106,64147,0,0,deny,66,66,0,1,0,1,0
29413,53,29413,53,allow,217,82,135,2,32,1,1
54153,443,43773,443,allow,5008,2097,2911,13,121,6,7
54071,50265,0,0,deny,62,62,0,1,0,1,0
29989,26467,0,0,deny,66,66,0,1,0,1,0
57721,443,65259,443,allow,1019,644,375,10,37,6,4
43513,443,9885,443,allow,224,164,60,3,5,2,1
57314,53,31776,53,allow,195,102,93,2,30,1,1
31404,59961,0,0,deny,100,100,0,1,0,1,0
6037,43890,0,0,deny,74,74,0,1,0,1,0
55591,53,58697,53,allow,190,97,93,2,31,1,1
22571,51505,0,0,deny,66,66,0,1,0,1,0
52838,37965,0,0,deny,66,66,0,1,0,1,0
56767,445,0,0,drop,70,70,0,1,0,1,0
6338,23117,0,0,deny,66,66,0,1,0,1,0
63999,10552,38263,10552,allow,70,70,0,1,4,1,0
57470,24451,64687,24451,allow,166,166,0,1,1200,1,0
50584,56112,8598,56112,allow,1377,300,1077,6,1200,3,3
56580,445,0,0,drop,66,66,0,1,0,1,0
11826,53,11826,53,allow,216,98,118,2,30,1,1
19962,53,19962,53,allow,832,106,726,2,30,1,1
52985,80,52009,80,allow,3111,1364,1747,28,112,15,13
36413,443,33262,443,allow,2064683,47545,2017138,1994,33,657,1337
6712,5632,0,0,deny,60,60,0,1,0,1,0
50265,42698,16471,42698,allow,726,726,0,12,1200,12,0
58917,80,56785,80,allow,4107,3453,654,13,16,7,6
52009,443,52009,443,allow,588633,17490,571143,578,51,186,392
65388,55783,0,0,deny,66,66,0,1,0,1,0
9317,443,63611,443,allow,5687,499,5188,14,16,7,7
61538,445,0,0,drop,66,66,0,1,0,1,0
52928,443,12845,443,allow,56910,3384,53526,85,115,33,52
32299,40021,3069,40021,allow,148,86,62,2,31,1,1
55271,53,23423,53,allow,168,86,82,2,30,1,1
50421,443,23778,443,allow,562,222,340,9,26,4,5
55619,445,0,0,drop,70,70,0,1,0,1,0
17786,44847,0,0,deny,62,62,0,1,0,1,0
53094,445,0,0,drop,66,66,0,1,0,1,0
61983,50432,0,0,deny,66,66,0,1,0,1,0
10151,19083,54566,19083,allow,489,149,340,2,1200,1,1
42332,22114,0,0,deny,66,66,0,1,0,1,0
57262,53,45135,53,allow,94,94,0,1,30,1,0
57074,445,0,0,drop,66,66,0,1,0,1,0
38647,443,52794,443,allow,15266,12916,2350,42,81,24,18
50574,80,15293,80,allow,61763,2941,58822,75,135,33,42
3478,61463,0,0,deny,240,240,0,1,0,1,0
62374,445,0,0,drop,70,70,0,1,0,1,0
55223,445,0,0,drop,70,70,0,1,0,1,0
53469,36237,0,0,deny,66,66,0,1,0,1,0
51564,50584,0,0,deny,62,62,0,1,0,1,0
58627,25174,0,0,deny,62,62,0,1,0,1,0
55647,53,53361,53,allow,250,86,164,4,31,2,2
64681,35993,0,0,deny,66,66,0,1,0,1,0
61702,80,48411,80,allow,1553,953,600,14,47,8,6
64173,445,0,0,drop,70,70,0,1,0,1,0
6881,33454,0,0,deny,100,100,0,1,0,1,0
52703,445,0,0,drop,70,70,0,1,0,1,0
54075,443,31475,443,allow,76388,4341,72047,107,169,48,59
52327,53,21249,53,allow,224,94,130,2,29,1,1
50894,445,0,0,drop,70,70,0,1,0,1,0
16403,16385,35308,16385,allow,308,128,180,6,30,3,3
59966,443,53241,443,allow,7165,1312,5853,22,16,12,10
27005,27015,51947,27015,allow,879,126,753,2,30,1,1
54423,445,0,0,drop,66,66,0,1,0,1,0
59845,44847,0,0,deny,66,66,0,1,0,1,0
44293,23,0,0,deny,60,60,0,1,0,1,0
53746,36237,0,0,deny,66,66,0,1,0,1,0
63050,57470,0,0,deny,74,74,0,1,0,1,0
58086,445,0,0,drop,70,70,0,1,0,1,0
51609,445,0,0,drop,70,70,0,1,0,1,0
49932,53,14546,53,allow,195,102,93,2,30,1,1
50443,445,0,0,drop,66,66,0,1,0,1,0
55232,53,45264,53,allow,170,87,83,2,30,1,1
57225,445,0,0,drop,70,70,0,1,0,1,0
49667,443,61228,443,allow,334,140,194,6,25,3,3
50085,80,7079,80,allow,3326,684,2642,12,15,7,5
50424,445,0,0,drop,70,70,0,1,0,1,0
44320,443,45352,443,allow,1657,1128,529,15,35,9,6
50708,80,26997,80,allow,1658,1247,411,8,15,5,3
56697,53,1249,53,allow,198,102,96,2,30,1,1
1024,62609,0,0,deny,148,148,0,1,0,1,0
59187,445,0,0,drop,70,70,0,1,0,1,0
57121,445,0,0,drop,70,70,0,1,0,1,0
1036,64147,0,0,deny,62,62,0,1,0,1,0
56306,1,0,0,deny,146,146,0,1,0,1,0
38093,11392,0,0,deny,146,146,0,1,0,1,0
51943,53,57117,53,allow,200,86,114,2,30,1,1
49506,53,52835,53,allow,200,102,98,2,31,1,1
51413,57470,0,0,deny,72,72,0,1,0,1,0
45119,443,35597,443,allow,2227,1018,1209,17,16,8,9
54287,443,5975,443,allow,250,190,60,2,5,1,1
52460,445,0,0,drop,70,70,0,1,0,1,0
10965,22114,0,0,deny,62,62,0,1,0,1,0
49795,53,15978,53,allow,209,110,99,2,30,1,1
1130,37965,0,0,deny,145,145,0,1,0,1,0
54572,445,0,0,drop,70,70,0,1,0,1,0
9405,443,45039,443,allow,5691,503,5188,14,15,7,7
62571,445,0,0,drop,66,66,0,1,0,1,0
14263,22114,0,0,deny,66,66,0,1,0,1,0
52128,37807,0,0,deny,66,66,0,1,0,1,0
55614,29731,2636,29731,allow,70,70,0,2,8,2,0
19473,6889,63001,6889,allow,480,149,331,2,1200,1,1
59005,443,25143,443,allow,4921,2525,2396,14,135,7,7
64705,445,0,0,drop,66,66,0,1,0,1,0
51591,80,40282,80,allow,12683,8567,4116,53,271,33,20
55257,53,9976,53,allow,749,89,660,2,30,1,1
49750,445,0,0,drop,70,70,0,1,0,1,0
58037,80,32783,80,allow,2339,1122,1217,11,20,6,5
42306,443,42899,443,allow,449862,38989,410873,644,280,286,358
1646,23,0,0,deny,60,60,0,1,0,1,0
58434,443,57588,443,allow,170342,10231,160111,264,136,130,134
52339,26467,0,0,deny,66,66,0,1,0,1,0
56512,53,8579,53,allow,166,86,80,2,29,1,1
56970,443,55404,443,allow,16378,3002,13376,35,17,17,18
51956,36995,10789,36995,allow,66,66,0,1,5,1,0
55576,443,55576,443,allow,4665,1758,2907,19,28,11,8
60332,445,0,0,drop,66,66,0,1,0,1,0
54575,445,0,0,drop,66,66,0,1,0,1,0
50067,53,8496,53,allow,177,94,83,2,30,1,1
56582,53,23626,53,allow,711,87,624,2,31,1,1
43895,443,52101,443,allow,1442,721,721,15,199,8,7
56101,57470,0,0,deny,66,66,0,1,0,1,0
55520,53,33643,53,allow,188,96,92,2,31,1,1
44062,443,39025,443,allow,4614,853,3761,16,127,9,7
59964,443,4370,443,allow,48525,4928,43597,111,660,55,56
56115,53,39416,53,allow,278,96,182,4,53,2,2
56281,443,8565,443,allow,22352,9825,12527,111,370,55,56
63201,53,63201,53,allow,262,106,156,2,32,1,1
30960,45723,17261,45723,allow,330,330,0,6,3608,6,0
53715,62348,45392,62348,allow,672,306,366,11,14,5,6
64124,53,32205,53,allow,236,86,150,2,30,1,1
13408,44847,0,0,deny,66,66,0,1,0,1,0
54664,443,62017,443,allow,175780,7700,168080,196,36,78,118
59710,445,0,0,drop,66,66,0,1,0,1,0
49515,80,17973,80,allow,5101,2867,2234,15,38,8,7
49160,63307,39518,63307,allow,854,150,704,4,1200,2,2
34932,38608,0,0,deny,62,62,0,1,0,1,0
54489,445,0,0,drop,70,70,0,1,0,1,0
56882,53,4292,53,allow,87,87,0,2,61,2,0
57701,445,0,0,drop,70,70,0,1,0,1,0
48737,443,47925,443,allow,5220,2290,2930,15,121,7,8
59594,445,0,0,drop,66,66,0,1,0,1,0
27005,27022,21223,27022,allow,890,126,764,2,31,1,1
49319,53,9038,53,allow,199,102,97,2,30,1,1
11073,3389,11073,3389,allow,4085,1916,2169,21,18,12,9
57669,64147,0,0,deny,62,62,0,1,0,1,0
56123,445,0,0,drop,66,66,0,1,0,1,0
62499,445,0,0,drop,70,70,0,1,0,1,0
49966,445,0,0,drop,66,66,0,1,0,1,0
6881,6881,0,0,deny,62,62,0,1,0,1,0
27005,27080,13244,27080,allow,926,126,800,2,31,1,1
61409,80,63776,80,allow,201243,14555,186688,357,158,145,212
50848,80,48215,80,allow,1213557,27203,1186354,1120,133,327,793
50255,53,25168,53,allow,199,102,97,2,29,1,1
49162,53,60010,53,allow,182,93,89,2,31,1,1
6721,37965,0,0,deny,66,66,0,1,0,1,0
64261,53,48738,53,allow,295,110,185,2,30,1,1
51270,48061,22070,48061,allow,70,70,0,1,5,1,0
64642,53,2609,53,allow,307,94,213,2,30,1,1
62106,445,0,0,drop,70,70,0,1,0,1,0
55170,53,27773,53,allow,250,94,156,2,30,1,1
50624,26467,0,0,deny,66,66,0,1,0,1,0
49542,445,0,0,drop,66,66,0,1,0,1,0
38717,443,31292,443,allow,958865,18695,940170,908,16,266,642
53987,445,0,0,drop,70,70,0,1,0,1,0
49666,80,7693,80,allow,2356,499,1857,10,125,6,4
12262,22114,0,0,deny,146,146,0,1,0,1,0
64036,53,10774,53,allow,182,93,89,2,31,1,1
62731,443,62731,443,allow,9938,3644,6294,31,18,18,13
56611,443,65034,443,allow,1473,868,605,10,25,6,4
57001,445,0,0,drop,70,70,0,1,0,1,0
59422,51221,0,0,deny,66,66,0,1,0,1,0
65516,53,45586,53,allow,749,94,655,2,31,1,1
65425,80,38267,80,allow,366,180,186,7,29,4,3
1030,64147,0,0,deny,62,62,0,1,0,1,0
64649,53,33149,53,allow,225,102,123,2,30,1,1
10547,57470,0,0,deny,62,62,0,1,0,1,0
38131,443,7949,443,allow,85590,4656,80934,111,37,47,64
51857,40561,9754,40561,allow,70,70,0,2,8,2,0
55807,80,55807,80,allow,424,198,226,7,142,4,3
37308,43890,0,0,deny,62,62,0,1,0,1,0
50706,443,45520,443,allow,13948,10445,3503,25,121,14,11
55148,445,0,0,drop,70,70,0,1,0,1,0
49418,27015,52265,27015,allow,266,78,188,2,30,1,1
52629,53,0,0,allow,418,154,264,4,33,2,2
55706,53,61735,53,allow,209,110,99,2,30,1,1
27038,51505,0,0,deny,146,146,0,1,0,1,0
62489,23117,0,0,deny,66,66,0,1,0,1,0
50428,443,6305,443,allow,4356,806,3550,14,15,7,7
58890,80,50368,80,allow,23867,3316,20551,38,135,20,18
53446,443,53446,443,allow,960,539,421,9,30,5,4
56960,53,22344,53,allow,192,98,94,2,31,1,1
58754,445,0,0,drop,66,66,0,1,0,1,0
50480,443,25461,443,allow,57535,3735,53800,70,122,26,44
55441,53,20150,53,allow,216,110,106,2,31,1,1
59042,445,0,0,drop,66,66,0,1,0,1,0
51866,22114,0,0,deny,62,62,0,1,0,1,0
51098,443,32791,443,allow,7250,2813,4437,21,62,12,9
56782,53,53429,53,allow,194,99,95,2,30,1,1
56765,443,20044,443,allow,12038195,322404,11715791,12026,153,3435,8591
56655,53,21531,53,allow,209,110,99,2,30,1,1
57436,66,13833,66,allow,70,70,0,2,7,2,0
55727,53,2459,53,allow,195,102,93,2,29,1,1
16387,35583,0,0,deny,60,60,0,1,0,1,0
57223,445,0,0,drop,66,66,0,1,0,1,0
58884,445,0,0,drop,70,70,0,1,0,1,0
64559,53,8772,53,allow,198,102,96,2,30,1,1
33259,443,58382,443,allow,4193,2689,1504,23,23,14,9
25233,23,0,0,deny,60,60,0,1,0,1,0
14309,56205,0,0,deny,62,62,0,1,0,1,0
56862,53,7245,53,allow,198,94,104,2,30,1,1
58638,5900,0,0,deny,62,62,0,1,0,1,0
49788,445,0,0,drop,70,70,0,1,0,1,0
49849,53,48086,53,allow,325,126,199,2,30,1,1
56068,53,60568,53,allow,168,94,74,2,30,1,1
55375,44847,0,0,deny,66,66,0,1,0,1,0
55743,53,6640,53,allow,748,106,642,2,31,1,1
59779,443,11374,443,allow,142,142,0,1,5,1,0
49783,445,0,0,drop,66,66,0,1,0,1,0
64231,53,19664,53,allow,196,94,102,2,30,1,1
64652,445,0,0,drop,70,70,0,1,0,1,0
443,2629,0,0,deny,135,135,0,1,0,1,0
54914,445,0,0,drop,70,70,0,1,0,1,0
56389,53,50951,53,allow,279,93,186,4,32,2,2
2332,35440,0,0,deny,62,62,0,1,0,1,0
33834,443,55526,443,allow,1178,820,358,9,15,6,3
58328,445,0,0,drop,70,70,0,1,0,1,0
55627,26192,18323,26192,allow,70,70,0,1,5,1,0
65481,53,51485,53,allow,168,86,82,2,31,1,1
64421,445,0,0,drop,66,66,0,1,0,1,0
58703,445,0,0,drop,70,70,0,1,0,1,0
23519,25174,0,0,deny,62,62,0,1,0,1,0
56887,53,15975,53,allow,170,87,83,3,56,2,1
42384,443,3442,443,allow,101952,6925,95027,143,333,72,71
57095,53,7010,53,allow,177,94,83,2,30,1,1
36080,26467,0,0,deny,62,62,0,1,0,1,0
34469,53,59263,53,allow,226,78,148,2,30,1,1
65077,443,2224,443,allow,6118,5698,420,12,123,6,6
50418,53,2799,53,allow,760,96,664,2,31,1,1
49621,53,22875,53,allow,182,93,89,2,31,1,1
55735,53,16181,53,allow,199,102,97,2,30,1,1
64627,445,0,0,drop,70,70,0,1,0,1,0
48038,5222,35034,5222,allow,49279,23110,26169,459,384,239,220
61203,445,0,0,drop,70,70,0,1,0,1,0
62618,445,0,0,drop,66,66,0,1,0,1,0
49844,443,42026,443,allow,6117,976,5141,21,72,10,11
50052,65008,0,0,deny,60,60,0,1,0,1,0
50202,53,23143,53,allow,166,86,80,2,30,1,1
50094,445,0,0,drop,66,66,0,1,0,1,0
6881,13234,11039,13234,allow,324,150,174,2,1201,1,1
49843,53,21434,53,allow,193,102,91,2,30,1,1
55698,45710,57579,45710,allow,70,70,0,1,5,1,0
51826,58925,42484,58925,allow,70,70,0,2,9,2,0
53866,445,0,0,drop,70,70,0,1,0,1,0
41051,443,30990,443,allow,37711,4074,33637,69,32,31,38
61464,445,0,0,drop,70,70,0,1,0,1,0
10416,64147,0,0,deny,62,62,0,1,0,1,0
38053,50584,0,0,deny,62,62,0,1,0,1,0
16393,22114,0,0,deny,62,62,0,1,0,1,0
53194,35440,0,0,deny,66,66,0,1,0,1,0
62570,445,0,0,drop,70,70,0,1,0,1,0
54991,36829,0,0,deny,66,66,0,1,0,1,0
56066,53,13837,53,allow,184,102,82,2,30,1,1
33328,25174,0,0,deny,146,146,0,1,0,1,0
6943,14984,0,0,deny,100,100,0,1,0,1,0
53629,443,28491,443,allow,123122,115571,7551,161,23,93,68
63076,443,41788,443,allow,7975,423,7552,15,119,6,9
56263,53,57350,53,allow,385,134,251,2,31,1,1
1873,37965,0,0,deny,62,62,0,1,0,1,0
54009,445,0,0,drop,70,70,0,1,0,1,0
57763,52752,0,0,deny,66,66,0,1,0,1,0
54661,445,0,0,drop,70,70,0,1,0,1,0
63964,53,22176,53,allow,323,85,238,4,34,2,2
27337,51505,0,0,deny,66,66,0,1,0,1,0
57115,53,57910,53,allow,788,108,680,2,30,1,1
57314,443,14727,443,allow,134,60,74,3,6,2,1
51723,10622,43836,10622,allow,70,70,0,2,8,2,0
56513,443,40120,443,allow,4989,1014,3975,16,32,9,7
56112,80,39554,80,allow,8113,1082,7031,19,16,10,9
55788,445,0,0,drop,70,70,0,1,0,1,0
54187,445,0,0,drop,70,70,0,1,0,1,0
54292,445,0,0,drop,66,66,0,1,0,1,0
52157,80,19874,80,allow,366,240,126,7,32,5,2
37673,443,65454,443,allow,3226,2225,1001,18,47,11,7
54353,443,50678,443,allow,9976,3230,6746,22,56,13,9
57838,445,0,0,drop,70,70,0,1,0,1,0
56430,53,26813,53,allow,199,102,97,2,30,1,1
48245,443,12754,443,allow,7417,1760,5657,21,256,12,9
56367,443,5869,443,allow,4863,3011,1852,20,234,12,8
55117,443,14752,443,allow,1350,689,661,14,18,8,6
50334,64147,0,0,deny,66,66,0,1,0,1,0
61332,445,0,0,drop,70,70,0,1,0,1,0
49609,80,50781,80,allow,318,192,126,6,41,4,2
42557,443,48761,443,allow,123082,8734,114348,200,84,101,99
41973,443,27764,443,allow,26109,3251,22858,60,256,31,29
26698,57470,0,0,deny,62,62,0,1,0,1,0
12060,37965,0,0,deny,66,66,0,1,0,1,0
55144,53,47771,53,allow,209,102,107,2,30,1,1
47739,53,26929,53,allow,168,78,90,2,29,1,1
50267,445,0,0,drop,70,70,0,1,0,1,0
39054,53,31083,53,allow,168,78,90,2,30,1,1
1025,46776,0,0,deny,62,62,0,1,0,1,0
60786,25174,0,0,deny,66,66,0,1,0,1,0
58068,445,0,0,drop,66,66,0,1,0,1,0
41842,443,41842,443,allow,4707,1800,2907,19,28,11,8
18725,35440,0,0,deny,62,62,0,1,0,1,0
59837,445,0,0,drop,66,66,0,1,0,1,0
14438,51505,0,0,deny,62,62,0,1,0,1,0
51927,63309,55046,63309,allow,70,70,0,2,8,2,0
52479,443,31867,443,allow,9326,1833,7493,24,131,12,12
60066,445,0,0,drop,66,66,0,1,0,1,0
56963,445,0,0,drop,66,66,0,1,0,1,0
39414,443,32057,443,allow,4179,1480,2699,18,124,9,9
53128,443,20598,443,allow,14603,4208,10395,39,48,20,19
49856,443,13732,443,allow,18685,4528,14157,31,151,13,18
42783,443,65446,443,allow,13510,5888,7622,65,86,33,32
50170,53,38281,53,allow,260,86,174,2,29,1,1
57119,80,41470,80,allow,5774,783,4991,17,75,10,7
57547,80,39933,80,allow,32368,2187,30181,45,337,23,22
6881,26296,0,0,deny,143,143,0,1,0,1,0
443,43775,0,0,deny,97,97,0,1,0,1,0
49523,445,0,0,drop,70,70,0,1,0,1,0
56385,53,3618,53,allow,249,85,164,4,55,2,2
57131,7774,0,0,deny,145,145,0,1,0,1,0
50321,18593,0,0,deny,143,143,0,1,0,1,0
55290,53,19726,53,allow,198,94,104,2,30,1,1
57303,53,43423,53,allow,177,94,83,2,30,1,1
56491,80,30431,80,allow,37154,2381,34773,50,135,23,27
55920,25174,0,0,deny,62,62,0,1,0,1,0
60893,443,56200,443,allow,4252,1594,2658,13,135,6,7
57896,49903,0,0,deny,100,100,0,1,0,1,0
53918,24300,60964,24300,allow,1735,975,760,11,16,7,4
56929,53,59011,53,allow,177,94,83,2,30,1,1
56625,443,59240,443,allow,7888,1899,5989,20,15,11,9
51774,80,22011,80,allow,240,120,120,5,27,3,2
49266,443,52610,443,allow,183,70,113,2,120,1,1
61247,445,0,0,drop,70,70,0,1,0,1,0
32805,443,65246,443,allow,438124,21529,416595,481,398,138,343
55261,445,0,0,drop,70,70,0,1,0,1,0
53539,6881,61115,6881,allow,492,306,186,8,14,5,3
22714,30188,0,0,deny,62,62,0,1,0,1,0
54280,3398,0,0,deny,60,60,0,1,0,1,0
55718,16805,42718,16805,allow,70,70,0,2,8,2,0
51548,445,0,0,drop,70,70,0,1,0,1,0
64567,53,13390,53,allow,193,102,91,2,30,1,1
60505,443,23004,443,allow,1061,727,334,9,26,4,5
55813,443,55813,443,allow,4543,1636,2907,19,29,11,8
62540,445,0,0,drop,70,70,0,1,0,1,0
49152,514,0,0,allow,142,142,0,2,30,2,0
49824,53,46232,53,allow,178,94,84,2,30,1,1
50584,16455,26852,16455,allow,1356,300,1056,6,1200,3,3
56127,35440,0,0,deny,62,62,0,1,0,1,0
56481,80,14814,80,allow,71347,4788,66559,83,136,34,49
64359,53,14911,53,allow,196,102,94,2,30,1,1
4738,53,4738,53,allow,213,87,126,2,30,1,1
59763,25604,0,0,deny,62,62,0,1,0,1,0
42853,443,44169,443,allow,130,70,60,3,5,2,1
56708,443,9469,443,allow,6155,919,5236,18,55,10,8
53004,445,0,0,drop,66,66,0,1,0,1,0
65375,53,14200,53,allow,196,94,102,2,31,1,1
61815,80,10742,80,allow,4268,653,3615,13,45,7,6
64743,445,0,0,drop,70,70,0,1,0,1,0
50520,53,46734,53,allow,732,86,646,2,30,1,1
60292,445,0,0,drop,70,70,0,1,0,1,0
65027,445,0,0,drop,70,70,0,1,0,1,0
57139,53,30822,53,allow,193,102,91,2,30,1,1
43477,443,38784,443,allow,20739,7254,13485,97,734,44,53
41292,443,17156,443,allow,7644,1098,6546,19,35,10,9
55917,53,40255,53,allow,177,94,83,2,30,1,1
45390,80,63396,80,allow,16713,1698,15015,31,32,17,14
61417,80,18297,80,allow,214,140,74,4,55,3,1
3800,48817,0,0,deny,146,146,0,1,0,1,0
49511,443,56126,443,allow,1200,623,577,13,27,6,7
14659,11392,0,0,deny,146,146,0,1,0,1,0
14605,53,14605,53,allow,209,77,132,2,32,1,1
45755,80,26274,80,allow,52352,11192,41160,90,476,44,46
55318,53,35151,53,allow,166,85,81,2,30,1,1
59873,443,3851,443,allow,1066,545,521,11,28,5,6
57144,53,55905,53,allow,178,94,84,2,30,1,1
41490,25174,0,0,deny,62,62,0,1,0,1,0
58883,443,51515,443,allow,1115,591,524,12,25,6,6
65312,53,55577,53,allow,182,94,88,2,30,1,1
64489,445,0,0,drop,70,70,0,1,0,1,0
54118,443,16400,443,allow,3182,1568,1614,8,120,4,4
58794,443,45135,443,allow,20298,11977,8321,85,139,45,40
50334,53,13800,53,allow,216,110,106,2,30,1,1
48833,443,62502,443,allow,1348406,28891,1319515,1247,31,340,907
45964,3111,0,0,deny,60,60,0,1,0,1,0
62921,993,3682,993,allow,8856,4253,4603,79,27,42,37
64987,53,14036,53,allow,192,98,94,2,30,1,1
9414,443,33463,443,allow,5689,501,5188,14,15,7,7
64403,53,2916,53,allow,193,102,91,2,29,1,1
53706,59208,33732,59208,allow,258,70,188,4,8,2,2
25384,443,25384,443,allow,3072,696,2376,13,16,8,5
55638,53,63082,53,allow,168,86,82,2,30,1,1
55710,53,65057,53,allow,198,93,105,2,30,1,1
49479,56205,0,0,deny,66,66,0,1,0,1,0
56351,445,0,0,drop,70,70,0,1,0,1,0
59116,53,59116,53,allow,203,82,121,2,30,1,1
27005,27015,60376,27015,allow,878,126,752,2,30,1,1
54942,445,0,0,drop,70,70,0,1,0,1,0
52625,25174,0,0,deny,62,62,0,1,0,1,0
1024,44847,0,0,deny,146,146,0,1,0,1,0
65249,25864,0,0,deny,72,72,0,1,0,1,0
0,0,0,0,deny,98,98,0,1,0,1,0
58985,443,13213,443,allow,9218,1776,7442,28,23,13,15
55581,53,26872,53,allow,167,86,81,2,30,1,1
50578,443,12552,443,allow,13595,7140,6455,39,116,24,15
20345,57470,0,0,deny,146,146,0,1,0,1,0
54440,445,0,0,drop,70,70,0,1,0,1,0
35922,443,6231,443,allow,6997,1773,5224,27,17,15,12
64882,43890,0,0,deny,66,66,0,1,0,1,0
57349,445,0,0,drop,66,66,0,1,0,1,0
55797,53,58246,53,allow,817,102,715,2,30,1,1
65501,57470,0,0,deny,72,72,0,1,0,1,0
50050,443,8381,443,allow,7912,3269,4643,23,95,12,11
47783,80,47783,80,allow,1904,1455,449,10,19,6,4
49978,53,38632,53,allow,195,102,93,2,29,1,1
58638,5900,0,0,deny,62,62,0,1,0,1,0
55730,445,0,0,drop,66,66,0,1,0,1,0
49477,7000,49477,7000,allow,5910,4455,1455,19,15,11,8
3407,57866,0,0,deny,66,66,0,1,0,1,0
49216,53,14364,53,allow,181,94,87,2,30,1,1
55230,53,65301,53,allow,467,96,371,4,44,2,2
49790,53,51287,53,allow,195,102,93,2,30,1,1
63360,445,0,0,drop,70,70,0,1,0,1,0
56082,53,1185,53,allow,730,102,628,2,29,1,1
57633,445,0,0,drop,70,70,0,1,0,1,0
54754,50432,0,0,deny,66,66,0,1,0,1,0
13285,29892,0,0,deny,145,145,0,1,0,1,0
50690,80,44292,80,allow,56951,28706,28245,236,174,116,120
49928,53,15390,53,allow,243,102,141,2,30,1,1
50479,443,65060,443,allow,25979,7217,18762,36,16,19,17
59378,50584,0,0,deny,66,66,0,1,0,1,0
61550,5529,0,0,deny,145,145,0,1,0,1,0
58892,445,0,0,drop,70,70,0,1,0,1,0
54967,445,0,0,drop,66,66,0,1,0,1,0
52018,57866,0,0,deny,66,66,0,1,0,1,0
62783,445,0,0,drop,70,70,0,1,0,1,0
42283,443,51990,443,allow,16831,14003,2828,31,63,18,13
55018,53,64174,53,allow,312,89,223,4,36,2,2
63779,12226,30689,12226,allow,70,70,0,1,4,1,0
51167,445,0,0,drop,70,70,0,1,0,1,0
34247,48817,0,0,deny,145,145,0,1,0,1,0
52685,445,0,0,drop,70,70,0,1,0,1,0
58638,5900,0,0,deny,62,62,0,1,0,1,0
52857,443,23236,443,allow,10234,2550,7684,47,139,23,24
65482,53,50244,53,allow,179,94,85,2,30,1,1
47201,44847,0,0,deny,66,66,0,1,0,1,0
13514,53,13514,53,allow,244,98,146,2,32,1,1
12150,443,12150,443,allow,6981,948,6033,17,27,10,7
50566,22114,0,0,deny,62,62,0,1,0,1,0
56810,443,52495,443,allow,8072,2052,6020,20,16,11,9
60900,445,0,0,drop,70,70,0,1,0,1,0
47893,443,63291,443,allow,172,172,0,2,4,2,0
54756,445,0,0,deny,70,70,0,1,0,1,0
60272,443,56856,443,allow,13199834,344312,12855522,13125,121,3739,9386
49778,443,56574,443,allow,10105,1951,8154,24,126,13,11
65200,51050,0,0,deny,66,66,0,1,0,1,0
7664,2149,0,0,deny,66,66,0,1,0,1,0
48271,15000,29989,15000,allow,130,70,60,2,5,1,1
56741,443,30975,443,allow,8059,2039,6020,20,15,11,9
57284,53,33476,53,allow,173,94,79,2,29,1,1
44856,51505,0,0,deny,62,62,0,1,0,1,0
54456,445,0,0,drop,66,66,0,1,0,1,0
56633,443,38597,443,allow,7889,1900,5989,20,15,11,9
52803,443,59403,443,allow,4913,751,4162,18,28,8,10
47817,443,22532,443,allow,190,70,120,4,14,2,2
55735,53,28047,53,allow,184,94,90,2,30,1,1
58638,5900,0,0,deny,62,62,0,1,0,1,0
61706,80,6564,80,allow,1840,1242,598,11,16,6,5
55633,53,26791,53,allow,793,101,692,2,31,1,1
34169,443,8049,443,allow,6507,1060,5447,22,255,12,10
65037,53,26531,53,allow,210,110,100,2,29,1,1
36430,443,7560,443,allow,9423,2105,7318,31,26,16,15
55808,53,62686,53,allow,174,89,85,2,30,1,1
63718,445,0,0,drop,70,70,0,1,0,1,0
55543,3389,55543,3389,allow,3488,1774,1714,17,32,9,8
55155,53,1843,53,allow,183,94,89,2,30,1,1
48706,23393,0,0,deny,60,60,0,1,0,1,0
58672,43890,0,0,deny,66,66,0,1,0,1,0
60748,445,0,0,drop,66,66,0,1,0,1,0
57416,53,37012,53,allow,771,101,670,2,31,1,1
44886,23,0,0,deny,60,60,0,1,0,1,0
64494,443,46008,443,allow,2872,717,2155,14,135,6,8
53132,445,0,0,drop,66,66,0,1,0,1,0
62140,445,0,0,drop,70,70,0,1,0,1,0
49936,445,0,0,drop,70,70,0,1,0,1,0
48883,53,16845,53,allow,168,78,90,2,30,1,1
1025,25174,0,0,deny,62,62,0,1,0,1,0
63817,50808,9849,50808,allow,66,66,0,2,8,2,0
55284,53,36720,53,allow,193,102,91,2,29,1,1
51334,445,0,0,drop,70,70,0,1,0,1,0
54429,445,0,0,drop,70,70,0,1,0,1,0
52206,445,0,0,drop,70,70,0,1,0,1,0
59511,21247,0,0,deny,66,66,0,1,0,1,0
48817,47005,48817,47005,allow,158,158,0,1,1200,1,0
63551,445,0,0,drop,70,70,0,1,0,1,0
62744,62413,0,0,deny,66,66,0,1,0,1,0
60203,53,37285,53,allow,328,86,242,2,30,1,1
12458,161,0,0,deny,85,85,0,1,0,1,0
65006,445,0,0,drop,66,66,0,1,0,1,0
57251,443,64913,443,allow,54515,20774,33741,167,36,88,79
52208,43890,0,0,deny,62,62,0,1,0,1,0
56532,53,25649,53,allow,193,102,91,2,30,1,1
62600,445,0,0,drop,66,66,0,1,0,1,0
36551,23,0,0,deny,60,60,0,1,0,1,0
56446,443,26551,443,allow,8620,2018,6602,34,80,18,16
58638,5900,0,0,deny,62,62,0,1,0,1,0
6666,5000,0,0,deny,60,60,0,1,0,1,0
3694,80,3582,80,allow,6919,1220,5699,20,104,12,8
49518,53,62825,53,allow,266,110,156,2,30,1,1
49385,443,34796,443,allow,44437,2600,41837,62,16,28,34
57188,443,9507,443,allow,20317684,620294,19697390,20965,186,6716,14249
64847,22114,0,0,deny,66,66,0,1,0,1,0
36126,53,44357,53,allow,326,78,248,2,31,1,1
51881,17997,36769,17997,allow,414,136,278,6,16,3,3
56998,53,8754,53,allow,170,87,83,2,31,1,1
61148,37965,0,0,deny,66,66,0,1,0,1,0
48079,43227,0,0,deny,62,62,0,1,0,1,0
60548,53,24812,53,allow,199,94,105,2,29,1,1
53676,35974,0,0,deny,60,60,0,1,0,1,0
55159,53,6565,53,allow,200,102,98,2,30,1,1
53766,3596,64680,3596,allow,70,70,0,2,8,2,0
33149,5228,22043,5228,allow,15651,3559,12092,63,6557,28,35
56330,53,48374,53,allow,271,95,176,4,47,2,2
51866,445,0,0,drop,70,70,0,1,0,1,0
50784,52952,0,0,deny,62,62,0,1,0,1,0
58638,5900,0,0,deny,62,62,0,1,0,1,0
56056,445,0,0,drop,70,70,0,1,0,1,0
64137,53,55466,53,allow,228,94,134,2,30,1,1
60818,37965,0,0,deny,66,66,0,1,0,1,0
49418,27017,11133,27017,allow,247,78,169,2,30,1,1
58060,80,29313,80,allow,1854,735,1119,8,16,5,3
64858,53,1882,53,allow,227,102,125,2,30,1,1
63964,53,34726,53,allow,195,102,93,2,30,1,1
48343,443,59139,443,allow,1985333,91427,1893906,2159,190,721,1438
18843,25174,0,0,deny,146,146,0,1,0,1,0
28795,37965,0,0,deny,62,62,0,1,0,1,0
64779,80,26888,80,allow,82972,2084,80888,85,98,26,59
37314,80,28984,80,allow,1348,844,504,13,255,8,5
25295,53,30242,53,allow,200,94,106,2,30,1,1
64565,53,49218,53,allow,802,104,698,2,31,1,1
50945,445,0,0,drop,66,66,0,1,0,1,0
57355,53,57355,53,allow,242,98,144,2,30,1,1
53049,445,0,0,drop,70,70,0,1,0,1,0
37035,443,37035,443,allow,4510,1603,2907,19,28,11,8
50651,25174,0,0,deny,146,146,0,1,0,1,0
54528,443,20055,443,allow,6256,1871,4385,20,45,12,8
56963,80,25455,80,allow,6974,3906,3068,19,30,11,8
7487,443,7487,443,allow,4265,1184,3081,18,16,9,9
64327,53,51961,53,allow,210,110,100,2,30,1,1
49883,53,14693,53,allow,177,94,83,2,30,1,1
43828,44847,0,0,deny,66,66,0,1,0,1,0
64510,53,63517,53,allow,280,118,162,2,29,1,1
21064,25174,0,0,deny,146,146,0,1,0,1,0
24212,21247,0,0,deny,146,146,0,1,0,1,0
55950,53,65022,53,allow,752,93,659,2,31,1,1
64431,53,36891,53,allow,177,94,83,2,30,1,1
37786,443,52361,443,allow,5544,2626,2918,28,145,15,13
25150,53,25150,53,allow,217,87,130,2,30,1,1
37382,80,11429,80,allow,1221,781,440,11,16,6,5
6882,41923,41297,41923,allow,492,150,342,2,1200,1,1
64124,443,56676,443,allow,1411,852,559,13,25,7,6
61184,445,0,0,drop,70,70,0,1,0,1,0
60015,445,0,0,drop,70,70,0,1,0,1,0
49505,445,0,0,drop,70,70,0,1,0,1,0
47564,5900,0,0,deny,60,60,0,1,0,1,0
55362,53,13886,53,allow,190,97,93,2,31,1,1
49936,53,12720,53,allow,754,94,660,2,30,1,1
57723,45129,0,0,deny,148,148,0,1,0,1,0
58199,445,0,0,drop,66,66,0,1,0,1,0
50568,445,0,0,drop,66,66,0,1,0,1,0
48970,80,48970,80,allow,24303,4898,19405,40,28,21,19
58638,5900,0,0,deny,62,62,0,1,0,1,0
58537,445,0,0,drop,66,66,0,1,0,1,0
28825,23,0,0,deny,60,60,0,1,0,1,0
30304,64147,0,0,deny,66,66,0,1,0,1,0
64771,445,0,0,drop,70,70,0,1,0,1,0
34772,15503,0,0,deny,146,146,0,1,0,1,0
64444,53,57791,53,allow,183,94,89,2,29,1,1
49824,53,29358,53,allow,178,94,84,2,31,1,1
49417,53,14090,53,allow,211,110,101,2,30,1,1
27005,27015,64723,27015,allow,901,126,775,2,30,1,1
57362,53,38084,53,allow,177,94,83,2,30,1,1
53921,443,59413,443,allow,499,425,74,4,0,3,1
58638,5900,0,0,deny,62,62,0,1,0,1,0
56810,53,11762,53,allow,177,94,83,2,30,1,1
40481,22114,0,0,deny,66,66,0,1,0,1,0
14374,443,14374,443,allow,1582,883,699,18,32,10,8
31675,19473,0,0,deny,62,62,0,1,0,1,0
53525,34759,11727,34759,allow,70,70,0,1,5,1,0
59571,445,0,0,drop,70,70,0,1,0,1,0
59559,443,47582,443,allow,3255,1089,2166,10,122,5,5
55762,445,0,0,drop,70,70,0,1,0,1,0
55692,53,51127,53,allow,198,102,96,2,30,1,1
19885,64147,0,0,deny,62,62,0,1,0,1,0
49222,53,15691,53,allow,199,94,105,2,30,1,1
54144,445,0,0,drop,70,70,0,1,0,1,0
54684,37965,0,0,deny,62,62,0,1,0,1,0
60718,443,23092,443,allow,71105,20647,50458,107,38,53,54
49160,38098,52628,38098,allow,676,367,309,6,1200,3,3
50534,80,11143,80,allow,318,192,126,6,25,4,2
24145,35440,0,0,deny,62,62,0,1,0,1,0
38644,443,44476,443,allow,8165,1664,6501,30,62,14,16
63033,53,19877,53,allow,304,86,218,2,30,1,1
53893,11344,37839,11344,allow,70,70,0,2,8,2,0
1114,37965,0,0,deny,62,62,0,1,0,1,0
51582,48817,0,0,deny,66,66,0,1,0,1,0
4500,4500,0,0,deny,862,862,0,1,0,1,0
58830,445,0,0,drop,66,66,0,1,0,1,0
56755,53,13799,53,allow,184,94,90,2,29,1,1
52088,35605,28933,35605,allow,70,70,0,2,8,2,0
33806,443,17179,443,allow,37541,4945,32596,69,127,31,38
58638,5900,0,0,deny,62,62,0,1,0,1,0
58169,445,0,0,drop,70,70,0,1,0,1,0
56217,5900,0,0,deny,60,60,0,1,0,1,0
59787,443,23637,443,allow,276238,23971,252267,482,138,188,294
54062,31573,0,0,deny,66,66,0,1,0,1,0
12527,50584,0,0,deny,62,62,0,1,0,1,0
50532,445,0,0,drop,66,66,0,1,0,1,0
9087,37965,0,0,deny,62,62,0,1,0,1,0
53500,443,53500,443,allow,960,539,421,9,35,5,4
47548,53,51360,53,allow,168,78,90,2,30,1,1
55167,48817,0,0,deny,66,66,0,1,0,1,0
57639,80,57639,80,allow,104868,1493,103375,90,31,17,73
54955,443,20454,443,allow,10265,1831,8434,34,319,17,17
58638,5900,0,0,deny,62,62,0,1,0,1,0
41672,53,20887,53,allow,240,76,164,2,30,1,1
58809,443,34899,443,allow,4054,2590,1464,18,16,9,9
58882,445,0,0,drop,66,66,0,1,0,1,0
58638,5900,0,0,deny,62,62,0,1,0,1,0
65427,53,2149,53,allow,238,94,144,2,30,1,1
65287,3389,65287,3389,allow,3409,1454,1955,16,16,8,8
49168,53,56952,53,allow,196,102,94,2,30,1,1
58638,5900,0,0,deny,62,62,0,1,0,1,0
64124,25174,0,0,deny,146,146,0,1,0,1,0
50528,80,29242,80,allow,1658,1247,411,8,16,5,3
5588,5588,0,0,allow,3498,1872,1626,48,200,24,24
55637,53,58251,53,allow,209,110,99,2,30,1,1
62870,445,0,0,drop,70,70,0,1,0,1,0
51550,53,60452,53,allow,168,78,90,2,30,1,1
58850,443,33361,443,allow,9035,5883,3152,26,17,14,12
61839,445,0,0,drop,70,70,0,1,0,1,0
52765,445,0,0,drop,70,70,0,1,0,1,0
41924,53,41924,53,allow,237,91,146,2,33,1,1
58638,5900,0,0,deny,62,62,0,1,0,1,0
65241,53,65497,53,allow,196,100,96,2,30,1,1
53559,445,0,0,drop,70,70,0,1,0,1,0
49622,53,58073,53,allow,244,94,150,2,30,1,1
49986,53,35150,53,allow,209,94,115,2,30,1,1
52461,443,54450,443,allow,16541,4900,11641,62,131,26,36
53254,443,33543,443,allow,4498,916,3582,18,17,9,9
49259,445,0,0,drop,70,70,0,1,0,1,0
52732,445,0,0,drop,66,66,0,1,0,1,0
51413,54351,0,0,deny,136,136,0,1,0,1,0
49901,443,33276,443,allow,5583,1567,4016,16,85,9,7
59790,445,0,0,drop,70,70,0,1,0,1,0
65344,53,8855,53,allow,180,94,86,2,35,1,1
15451,25174,0,0,deny,146,146,0,1,0,1,0
57887,53,44516,53,allow,174,81,93,2,30,1,1
42023,443,45040,443,allow,42402,3988,38414,82,89,39,43
49256,53,15315,53,allow,212,102,110,2,30,1,1
65365,53,19962,53,allow,192,98,94,2,30,1,1
53579,42707,0,0,deny,66,66,0,1,0,1,0
49206,53,61280,53,allow,174,89,85,2,31,1,1
52078,443,12860,443,allow,9757,2051,7706,34,256,15,19
24504,37965,0,0,deny,62,62,0,1,0,1,0
8211,28793,0,0,deny,62,62,0,1,0,1,0
50875,443,41381,443,allow,1786,172,1614,7,121,3,4
43750,443,22954,443,allow,248384,70243,178141,544,588,246,298
16387,63752,0,0,deny,60,60,0,1,0,1,0
52719,445,0,0,drop,70,70,0,1,0,1,0
3697,80,55800,80,allow,6688,1208,5480,20,104,12,8
48996,443,35257,443,allow,128299,119001,9298,178,280,103,75
51766,445,0,0,drop,70,70,0,1,0,1,0
57348,25174,0,0,deny,146,146,0,1,0,1,0
2543,25174,0,0,deny,62,62,0,1,0,1,0
0,0,0,0,allow,320,320,0,5,0,5,0
52272,80,52272,80,allow,237488,7574,229914,231,27,71,160
58371,23,0,0,deny,60,60,0,1,0,1,0
51999,37965,0,0,deny,62,62,0,1,0,1,0
51175,445,0,0,drop,70,70,0,1,0,1,0
56646,445,0,0,drop,70,70,0,1,0,1,0
48817,6881,48817,6881,allow,479,277,202,4,1200,2,2
55958,53,60321,53,allow,170,87,83,2,31,1,1
50298,445,0,0,drop,70,70,0,1,0,1,0
58029,443,3427,443,allow,1312,651,661,13,185,7,6
60805,20010,40863,20010,allow,70,70,0,2,8,2,0
49891,53,42483,53,allow,164,84,80,2,31,1,1
11133,51505,0,0,deny,66,66,0,1,0,1,0
59466,445,0,0,drop,66,66,0,1,0,1,0
34998,443,4497,443,allow,9114,2208,6906,36,120,19,17
53201,445,0,0,drop,66,66,0,1,0,1,0
23349,30188,0,0,deny,146,146,0,1,0,1,0
59960,445,0,0,drop,70,70,0,1,0,1,0
36661,443,26709,443,allow,16244,2265,13979,35,262,19,16
56160,53,58234,53,allow,195,102,93,2,31,1,1
55397,445,0,0,drop,70,70,0,1,0,1,0
58827,443,27580,443,allow,5167,700,4467,16,15,7,9
62405,445,0,0,drop,70,70,0,1,0,1,0
51755,24236,52970,24236,allow,136,136,0,3,13,3,0
49880,80,21728,80,allow,2087,1215,872,8,88,5,3
56809,40641,18349,40641,allow,70,70,0,1,5,1,0
63951,55255,6079,55255,allow,1277,856,421,9,15,6,3
24504,37965,0,0,deny,62,62,0,1,0,1,0
61729,445,0,0,drop,70,70,0,1,0,1,0
65313,53,63714,53,allow,164,84,80,2,31,1,1
31112,50584,0,0,deny,66,66,0,1,0,1,0
57678,445,0,0,drop,66,66,0,1,0,1,0
64617,53,32317,53,allow,756,95,661,2,30,1,1
60429,46854,20959,46854,allow,70,70,0,1,5,1,0
39107,443,62182,443,allow,692830,23263,669567,784,114,306,478
60185,445,0,0,drop,70,70,0,1,0,1,0
49418,27017,45242,27017,allow,259,78,181,2,31,1,1
53686,8999,46759,8999,allow,70,70,0,2,7,2,0
9865,15503,0,0,deny,146,146,0,1,0,1,0
55129,53,28774,53,allow,754,94,660,2,31,1,1
53552,8999,58202,8999,allow,70,70,0,2,7,2,0
41220,59356,0,0,deny,62,62,0,1,0,1,0
39730,17372,0,0,deny,66,66,0,1,0,1,0
44636,443,35730,443,allow,6297,1831,4466,20,16,9,11
65522,443,46739,443,allow,399281,11940,387341,412,16,145,267
23349,30188,0,0,deny,62,62,0,1,0,1,0
10011,40005,27073,40005,allow,148,86,62,2,30,1,1
64127,53,58268,53,allow,177,94,83,2,30,1,1
61026,445,0,0,drop,66,66,0,1,0,1,0
63083,25174,0,0,deny,62,62,0,1,0,1,0
36663,22114,0,0,deny,146,146,0,1,0,1,0
0,0,0,0,deny,156,156,0,2,0,2,0
9262,80,26310,80,allow,378,192,186,7,26,4,3
57251,445,0,0,drop,70,70,0,1,0,1,0
51765,80,50481,80,allow,5569,3270,2299,21,74,13,8
62074,443,62074,443,allow,151233,12592,138641,190,19,88,102
56394,443,3047,443,allow,5019,946,4073,19,34,9,10
51704,443,61850,443,allow,7117,619,6498,19,34,6,13
56050,53,60245,53,allow,178,94,84,2,30,1,1
50377,443,39949,443,allow,7738,879,6859,19,27,10,9
55240,443,28397,443,allow,6902,1936,4966,22,45,11,11
63929,443,53771,443,allow,14647,2365,12282,22,136,10,12
53020,61903,0,0,deny,159,159,0,1,0,1,0
58686,18375,0,0,deny,66,66,0,1,0,1,0
56198,53,28713,53,allow,184,102,82,2,30,1,1
49348,80,49348,80,allow,450,246,204,8,142,5,3
54816,445,0,0,drop,70,70,0,1,0,1,0
52064,22114,0,0,deny,66,66,0,1,0,1,0
64590,443,12398,443,allow,24686,1935,22751,36,17,17,19
55413,37965,0,0,deny,62,62,0,1,0,1,0
51201,445,0,0,drop,66,66,0,1,0,1,0
55325,53,5383,53,allow,199,102,97,2,30,1,1
62106,445,0,0,drop,66,66,0,1,0,1,0
52907,445,0,0,drop,70,70,0,1,0,1,0
64605,25174,0,0,deny,66,66,0,1,0,1,0
2383,37965,0,0,deny,66,66,0,1,0,1,0
50575,53,5901,53,allow,766,102,664,2,30,1,1
64420,53,18764,53,allow,386,102,284,2,30,1,1
56260,80,50522,80,allow,72600,58760,13840,186,1232,107,79
40086,22114,0,0,deny,62,62,0,1,0,1,0
38368,15000,38283,15000,allow,130,70,60,2,5,1,1
46556,443,5923,443,allow,9316,1720,7596,25,16,13,12
58705,80,29021,80,allow,2543,1880,663,12,14,6,6
51931,19416,18686,19416,allow,70,70,0,1,5,1,0
52910,445,0,0,drop,66,66,0,1,0,1,0
49671,80,23759,80,allow,2122,1018,1104,13,41,7,6
9494,23,0,0,deny,60,60,0,1,0,1,0
50130,53,12691,53,allow,183,94,89,2,29,1,1
58582,50584,0,0,deny,66,66,0,1,0,1,0
58505,445,0,0,drop,66,66,0,1,0,1,0
60085,443,22950,443,allow,1000,557,443,11,141,6,5
53718,1053,4101,1053,allow,320,140,180,6,8,3,3
37736,443,40675,443,allow,498507,26210,472297,544,207,200,344
37965,62918,1138,62918,allow,489,149,340,2,1200,1,1
49804,443,24644,443,allow,5938,1521,4417,20,125,10,10
64674,53,62663,53,allow,183,94,89,2,29,1,1
52173,443,52173,443,allow,201007,10015,190992,239,22,100,139
55980,123,7764,123,allow,184,94,90,2,30,1,1
54976,443,13251,443,allow,8156,3281,4875,43,71,21,22
56783,445,0,0,drop,70,70,0,1,0,1,0
9100,443,50468,443,allow,4945,431,4514,12,15,6,6
64121,445,0,0,drop,70,70,0,1,0,1,0
49374,53,54400,53,allow,186,95,91,2,31,1,1
58638,5900,0,0,deny,62,62,0,1,0,1,0
47918,123,27276,123,allow,184,94,90,2,30,1,1
65477,445,0,0,drop,70,70,0,1,0,1,0
54155,445,0,0,drop,66,66,0,1,0,1,0
51957,443,52201,443,allow,3516,1732,1784,34,42,19,15
53447,44847,0,0,deny,62,62,0,1,0,1,0
56614,443,7546,443,allow,20451,1899,18552,33,17,14,19
50365,443,19679,443,allow,712,374,338,11,28,6,5
48697,5222,62184,5222,allow,8355,4135,4220,79,616,41,38
64903,51050,0,0,deny,66,66,0,1,0,1,0
43875,443,31372,443,allow,18367,3429,14938,41,500,23,18
49986,443,64470,443,allow,11626,1206,10420,31,74,13,18
56435,445,0,0,drop,66,66,0,1,0,1,0
53258,443,49616,443,allow,26995,3729,23266,40,137,16,24
57335,53,58927,53,allow,177,94,83,2,30,1,1
62421,445,0,0,drop,70,70,0,1,0,1,0
57089,445,0,0,drop,70,70,0,1,0,1,0
65000,445,0,0,drop,70,70,0,1,0,1,0
58190,53,48181,53,allow,648,86,562,4,51,2,2
21534,42246,0,0,deny,66,66,0,1,0,1,0
52325,443,28114,443,allow,3188,1601,1587,34,48,18,16
51414,22,0,0,deny,60,60,0,1,0,1,0
18116,37807,0,0,deny,66,66,0,1,0,1,0
61150,11392,0,0,deny,66,66,0,1,0,1,0
16387,44427,0,0,deny,60,60,0,1,0,1,0
52217,445,0,0,drop,66,66,0,1,0,1,0
54519,443,46768,443,allow,70,70,0,1,5,1,0
58095,445,0,0,drop,70,70,0,1,0,1,0
49836,443,16827,443,allow,6611,2169,4442,20,123,12,8
62828,445,0,0,drop,70,70,0,1,0,1,0
22528,25174,0,0,deny,62,62,0,1,0,1,0
61030,21247,0,0,deny,66,66,0,1,0,1,0
60482,2924,18303,2924,allow,320,140,180,6,7,3,3
56734,45086,42195,45086,allow,1640,460,1180,8,30,4,4
49794,443,25276,443,allow,7307,841,6466,18,126,9,9
57994,443,31591,443,allow,10027,2130,7897,27,27,16,11
49604,445,0,0,drop,70,70,0,1,0,1,0
52163,443,4704,443,allow,4187,773,3414,16,30,9,7
58715,64097,0,0,deny,62,62,0,1,0,1,0
55026,445,0,0,drop,70,70,0,1,0,1,0
56341,53,11727,53,allow,243,94,149,2,30,1,1
56962,80,49373,80,allow,8730,5681,3049,21,31,12,9
63083,25174,0,0,deny,66,66,0,1,0,1,0
56553,445,0,0,drop,70,70,0,1,0,1,0
58638,5900,0,0,deny,62,62,0,1,0,1,0
64076,53,18119,53,allow,353,118,235,2,30,1,1
35925,443,8324,443,allow,1092248,9101,1083147,860,195,111,749
42298,40020,47579,40020,allow,148,86,62,2,31,1,1
27005,27016,39937,27016,allow,914,126,788,2,31,1,1
50127,443,64951,443,allow,31982,9936,22046,61,16,33,28
45275,443,51304,443,allow,9908271,123308,9784963,8531,359,1708,6823
64586,443,13912,443,allow,8573,2039,6534,25,32,14,11
55516,123,34894,123,allow,184,94,90,2,30,1,1
54314,445,0,0,drop,70,70,0,1,0,1,0
57927,445,0,0,drop,70,70,0,1,0,1,0
58638,5900,0,0,deny,62,62,0,1,0,1,0
50757,80,50757,80,allow,514,246,268,9,42,5,4
47705,443,21979,443,allow,25643,2181,23462,44,363,18,26
55273,53,3281,53,allow,764,99,665,2,31,1,1
21133,33447,47731,33447,allow,481,150,331,2,1199,1,1
61083,445,0,0,drop,66,66,0,1,0,1,0
54966,53,44405,53,allow,171,88,83,3,33,2,1
37309,53,0,0,allow,82,82,0,1,30,1,0
55436,445,0,0,drop,70,70,0,1,0,1,0
53577,445,0,0,drop,66,66,0,1,0,1,0
53723,443,51817,443,allow,70,70,0,1,5,1,0
49929,26467,0,0,deny,62,62,0,1,0,1,0
60502,445,0,0,drop,70,70,0,1,0,1,0
38119,53,41188,53,allow,199,94,105,2,30,1,1
58415,443,47391,443,allow,145249,142210,3039,143,185,106,37
35229,32468,0,0,deny,62,62,0,1,0,1,0
53596,56732,3415,56732,allow,70,70,0,1,4,1,0
64021,53,7172,53,allow,402,97,305,4,31,2,2
52870,22197,0,0,deny,66,66,0,1,0,1,0
64376,53,46569,53,allow,247,94,153,2,30,1,1
56246,445,0,0,drop,66,66,0,1,0,1,0
61023,26467,0,0,deny,62,62,0,1,0,1,0
55439,445,0,0,drop,70,70,0,1,0,1,0
64817,445,0,0,drop,70,70,0,1,0,1,0
9513,443,25594,443,allow,3615,435,3180,11,16,6,5
64149,53,6477,53,allow,301,108,193,4,49,2,2
37965,46405,21208,46405,allow,1217,594,623,16,1764,10,6
58638,5900,0,0,deny,62,62,0,1,0,1,0
44725,443,58969,443,allow,7998,1347,6651,49,1647,10,39
60863,443,14093,443,allow,134,60,74,3,5,2,1
49434,443,8627,443,allow,197635,12994,184641,287,183,143,144
5538,23,0,0,deny,60,60,0,1,0,1,0
50193,3389,50193,3389,allow,3473,1518,1955,17,19,9,8
54146,445,0,0,drop,70,70,0,1,0,1,0
57179,53,11960,53,allow,325,94,231,2,30,1,1
55478,53,56587,53,allow,177,94,83,2,30,1,1
37643,443,56932,443,allow,10517,2926,7591,29,20,16,13
58627,64097,0,0,deny,66,66,0,1,0,1,0
61383,445,0,0,drop,70,70,0,1,0,1,0
63379,36237,0,0,deny,66,66,0,1,0,1,0
50880,80,36202,80,allow,395978,13168,382810,411,143,151,260
11897,443,11897,443,allow,1452,817,635,16,29,9,7
2238,22114,0,0,deny,62,62,0,1,0,1,0
58638,5900,0,0,deny,62,62,0,1,0,1,0
59312,22,59312,22,deny,327,140,187,4,0,2,2
49266,53,6643,53,allow,199,102,97,2,29,1,1
5588,5588,0,0,allow,3354,1792,1562,46,193,23,23
65071,53,49896,53,allow,93,93,0,2,60,2,0
56297,53,38652,53,allow,228,75,153,4,31,2,2
46310,443,45813,443,allow,10106,2096,8010,24,186,13,11
55479,445,0,0,drop,66,66,0,1,0,1,0
52200,445,0,0,drop,70,70,0,1,0,1,0
52190,29765,3143,29765,allow,70,70,0,2,8,2,0
59514,445,0,0,drop,70,70,0,1,0,1,0
55681,445,0,0,drop,66,66,0,1,0,1,0
34713,22114,0,0,deny,146,146,0,1,0,1,0
62857,445,0,0,drop,70,70,0,1,0,1,0
36621,443,53395,443,allow,2239099,75601,2163498,2512,71,983,1529
56192,53,15421,53,allow,170,87,83,2,30,1,1
1441,51221,0,0,deny,62,62,0,1,0,1,0
64937,53,42639,53,allow,204,104,100,2,31,1,1
61788,445,0,0,drop,70,70,0,1,0,1,0
63812,445,0,0,drop,70,70,0,1,0,1,0
59009,445,0,0,drop,70,70,0,1,0,1,0
19204,57866,0,0,deny,62,62,0,1,0,1,0
40422,53,0,0,allow,82,82,0,1,30,1,0
50510,80,5594,80,allow,378,192,186,7,25,4,3
11937,35440,0,0,deny,146,146,0,1,0,1,0
64341,57470,0,0,deny,62,62,0,1,0,1,0
37466,443,58228,443,allow,13829,1724,12105,28,516,13,15
15450,53,15450,53,allow,216,82,134,2,33,1,1
8861,443,39985,443,allow,42890,30849,12041,214,420,106,108
49218,53,22762,53,allow,195,102,93,2,31,1,1
58638,5900,0,0,deny,62,62,0,1,0,1,0
54173,445,0,0,drop,70,70,0,1,0,1,0
54630,53,54630,53,allow,825,99,726,2,30,1,1
62759,443,5744,443,allow,9928,5183,4745,34,134,17,17
3470,53,3470,53,allow,217,82,135,2,32,1,1
49685,80,12171,80,allow,1548,847,701,10,16,5,5
58472,445,0,0,drop,70,70,0,1,0,1,0
53458,445,0,0,drop,70,70,0,1,0,1,0
45409,53,56925,53,allow,307,86,221,2,31,1,1
49418,27015,42227,27015,allow,251,78,173,2,30,1,1
58022,8112,0,0,deny,60,60,0,1,0,1,0
64021,53,10744,53,allow,339,118,221,2,29,1,1
51039,445,0,0,drop,70,70,0,1,0,1,0
57470,52215,48091,52215,allow,528,528,0,9,1200,9,0
53682,445,0,0,drop,66,66,0,1,0,1,0
65092,53,28213,53,allow,197,102,95,2,29,1,1
57259,53,43312,53,allow,199,102,97,2,31,1,1
56048,53,3715,53,allow,296,110,186,2,30,1,1
49931,25174,0,0,deny,66,66,0,1,0,1,0
49708,53,50223,53,allow,193,102,91,2,30,1,1
61937,445,0,0,drop,70,70,0,1,0,1,0
7619,50584,0,0,deny,62,62,0,1,0,1,0
38420,80,16840,80,allow,4535,1637,2898,23,2899,14,9
33469,61903,0,0,deny,145,145,0,1,0,1,0
64615,53,40640,53,allow,198,94,104,2,30,1,1
61589,21247,0,0,deny,66,66,0,1,0,1,0
58859,445,0,0,drop,70,70,0,1,0,1,0
53922,445,0,0,drop,70,70,0,1,0,1,0
64672,445,0,0,drop,70,70,0,1,0,1,0
53137,443,3588,443,allow,7648,3641,4007,29,42,13,16
56544,53,44845,53,allow,183,86,97,2,31,1,1
60371,443,40685,443,allow,7202,2596,4606,24,83,12,12
53392,53,29793,53,allow,164,78,86,2,31,1,1
52176,443,22865,443,allow,8048,1360,6688,24,23,12,12
55821,445,0,0,drop,70,70,0,1,0,1,0
58638,5900,0,0,deny,62,62,0,1,0,1,0
52988,53567,0,0,deny,62,62,0,1,0,1,0
50064,443,49945,443,allow,4118,2209,1909,36,239,21,15
55249,53,63785,53,allow,711,87,624,2,30,1,1
53656,31573,0,0,deny,66,66,0,1,0,1,0
56272,445,0,0,drop,70,70,0,1,0,1,0
53897,46913,50139,46913,allow,552,306,246,9,15,5,4
61404,52700,0,0,deny,72,72,0,1,0,1,0
57870,445,0,0,drop,66,66,0,1,0,1,0
65498,443,2400,443,allow,92290,4799,87491,107,16,43,64
56982,53,54411,53,allow,177,94,83,2,29,1,1
50626,445,0,0,drop,66,66,0,1,0,1,0
35268,81,0,0,deny,60,60,0,1,0,1,0
27005,27015,13852,27015,allow,881,126,755,2,30,1,1
49627,443,59623,443,allow,20583,3435,17148,54,95,27,27
61051,445,0,0,drop,70,70,0,1,0,1,0
60161,445,0,0,drop,66,66,0,1,0,1,0
51387,443,47138,443,allow,9584,1871,7713,28,106,14,14
51195,123,46436,123,allow,184,94,90,2,30,1,1
58721,51505,0,0,deny,66,66,0,1,0,1,0
59000,443,41990,443,allow,9876,5325,4551,25,131,14,11
9786,53,9786,53,allow,230,91,139,2,30,1,1
63910,53,63969,53,allow,178,75,103,2,30,1,1
40766,443,50985,443,allow,1093,662,431,10,41,6,4
52720,445,0,0,drop,70,70,0,1,0,1,0
1143,25198,0,0,deny,148,148,0,1,0,1,0
65419,26467,0,0,deny,62,62,0,1,0,1,0
64605,35993,0,0,deny,62,62,0,1,0,1,0
60789,40010,35327,40010,allow,316,136,180,6,6,3,3
55044,445,0,0,drop,70,70,0,1,0,1,0
55075,8080,0,0,deny,60,60,0,1,0,1,0
11235,30188,0,0,deny,66,66,0,1,0,1,0
49368,443,7264,443,allow,9482,4710,4772,19,17,11,8
56924,53,30417,53,allow,216,110,106,2,31,1,1
54236,36829,0,0,deny,66,66,0,1,0,1,0
51052,53,0,0,allow,82,82,0,1,30,1,0
59181,445,0,0,drop,70,70,0,1,0,1,0
51230,80,8702,80,allow,1594,1280,314,10,15,5,5
47038,443,65328,443,allow,2809,1884,925,19,24,11,8
51174,443,12417,443,allow,786014,23908,762106,803,47,276,527
56603,443,20013,443,allow,7890,1901,5989,20,16,11,9
53891,443,8709,443,allow,499,425,74,4,0,3,1
59544,445,0,0,drop,70,70,0,1,0,1,0
6881,57470,0,0,deny,146,146,0,1,0,1,0
49308,22114,0,0,deny,66,66,0,1,0,1,0
63975,53,64486,53,allow,316,94,222,2,30,1,1
62462,53,62462,53,allow,238,99,139,2,30,1,1
50289,443,30139,443,allow,9571,2811,6760,45,87,24,21
43411,443,13391,443,allow,2895,726,2169,10,121,5,5
61315,53,20800,53,allow,8616,4944,3672,22,87,11,11
55416,445,0,0,drop,70,70,0,1,0,1,0
49991,80,28668,80,allow,2095,1010,1085,11,87,6,5
29677,53,29677,53,allow,218,90,128,2,29,1,1
3047,50584,0,0,deny,62,62,0,1,0,1,0
56458,53,38538,53,allow,196,102,94,2,30,1,1
1814,62413,0,0,deny,66,66,0,1,0,1,0
58955,445,0,0,drop,70,70,0,1,0,1,0
25651,48817,0,0,deny,140,140,0,1,0,1,0
49193,445,0,0,drop,70,70,0,1,0,1,0
41597,53,41597,53,allow,213,79,134,2,32,1,1
49690,53,24171,53,allow,216,110,106,2,30,1,1
49390,53,36883,53,allow,210,110,100,2,30,1,1
55505,53,51745,53,allow,199,102,97,2,31,1,1
49269,445,0,0,drop,66,66,0,1,0,1,0
53773,15459,17716,15459,allow,70,70,0,1,4,1,0
53503,445,0,0,drop,70,70,0,1,0,1,0
38568,443,10055,443,allow,11418,1999,9419,28,22,13,15
55144,443,5039,443,allow,3522,869,2653,13,121,6,7
36488,443,36488,443,allow,8448,2150,6298,39,98,21,18
60026,443,38651,443,allow,3643,607,3036,13,120,6,7
65318,53,17829,53,allow,184,94,90,2,31,1,1
13518,25174,0,0,deny,62,62,0,1,0,1,0
49271,445,0,0,drop,66,66,0,1,0,1,0
58108,445,0,0,drop,70,70,0,1,0,1,0
64024,57470,0,0,deny,62,62,0,1,0,1,0
38549,22114,0,0,deny,62,62,0,1,0,1,0
18574,56205,0,0,deny,66,66,0,1,0,1,0
49870,53,17515,53,allow,194,102,92,2,30,1,1
56365,53,1142,53,allow,198,101,97,2,30,1,1
41220,59356,0,0,deny,62,62,0,1,0,1,0
57598,443,10245,443,allow,12463,6762,5701,28,31,14,14
65468,53,8938,53,allow,200,94,106,2,30,1,1
61406,443,11878,443,allow,12588,4915,7673,28,94,15,13
63077,53,21461,53,allow,304,86,218,2,30,1,1
57940,24748,0,0,deny,148,148,0,1,0,1,0
61018,445,0,0,drop,70,70,0,1,0,1,0
50008,53,33522,53,allow,193,102,91,2,29,1,1
38364,15000,10224,15000,allow,130,70,60,2,5,1,1
55003,445,0,0,drop,70,70,0,1,0,1,0
49418,30008,26844,30008,allow,236,78,158,2,30,1,1
55346,53,62620,53,allow,177,94,83,2,31,1,1
56111,53,45505,53,allow,179,94,85,2,30,1,1
64905,53,16169,53,allow,245,94,151,2,30,1,1
57472,44847,0,0,deny,66,66,0,1,0,1,0
28832,36237,0,0,deny,66,66,0,1,0,1,0
65511,53,22579,53,allow,545,136,409,4,56,2,2
60126,445,0,0,drop,70,70,0,1,0,1,0
53182,443,14179,443,allow,16255,8279,7976,42,422,21,21
53646,16561,53092,16561,allow,422,140,282,6,15,3,3
57204,443,59109,443,allow,35981,14676,21305,63,320,31,32
58638,5900,0,0,deny,62,62,0,1,0,1,0
21704,16933,0,0,deny,62,62,0,1,0,1,0
59065,443,57168,443,allow,25840,18434,7406,45,171,26,19
64780,443,53095,443,allow,70785,3306,67479,99,80,34,65
57067,53,21723,53,allow,183,94,89,2,31,1,1
17010,57470,0,0,deny,62,62,0,1,0,1,0
65381,80,14160,80,allow,1630,982,648,13,78,7,6
58416,445,0,0,drop,70,70,0,1,0,1,0
43815,50584,0,0,deny,146,146,0,1,0,1,0
49872,443,65245,443,allow,3120,1862,1258,18,15,11,7
1480,12447,0,0,deny,66,66,0,1,0,1,0
5223,44091,0,0,deny,220,220,0,1,0,1,0
56412,80,47207,80,allow,34476,818,33658,35,104,9,26
39684,80,40129,80,allow,680,70,610,11,392,2,9
62559,445,0,0,drop,70,70,0,1,0,1,0
56721,445,0,0,drop,70,70,0,1,0,1,0
56649,443,48324,443,allow,3469,1006,2463,15,121,7,8
26851,59858,0,0,deny,146,146,0,1,0,1,0
64630,53,37942,53,allow,350,94,256,2,30,1,1
56710,53,63295,53,allow,193,94,99,2,29,1,1
49632,443,26348,443,allow,3618,961,2657,13,121,6,7
53358,443,35239,443,allow,8626,2839,5787,47,27,24,23
38603,5228,52662,5228,allow,3534,1679,1855,30,3640,11,19
64984,53,54223,53,allow,177,94,83,2,30,1,1
60462,47821,9617,47821,allow,70,70,0,1,5,1,0
61636,25735,61636,25735,allow,3828,1516,2312,29,5271,18,11
61784,445,0,0,drop,70,70,0,1,0,1,0
55541,53,4475,53,allow,177,94,83,2,30,1,1
18085,26467,0,0,deny,66,66,0,1,0,1,0
49488,53,14006,53,allow,188,96,92,2,30,1,1
56056,53,19190,53,allow,184,86,98,2,30,1,1
62334,443,24621,443,allow,3244,1630,1614,8,120,4,4
44334,26467,0,0,deny,62,62,0,1,0,1,0
49183,53,55748,53,allow,177,94,83,2,30,1,1
19875,30170,0,0,deny,145,145,0,1,0,1,0
51208,443,14745,443,allow,3477,1216,2261,16,136,8,8
63713,445,0,0,drop,66,66,0,1,0,1,0
54768,25,54768,25,allow,194,66,128,3,15,1,2
54877,53,59244,53,allow,199,94,105,2,30,1,1
37321,53,37321,53,allow,197,90,107,2,30,1,1
63929,48477,10688,48477,allow,66,66,0,2,7,2,0
1860,25174,0,0,deny,66,66,0,1,0,1,0
62767,445,0,0,drop,70,70,0,1,0,1,0
49231,443,44532,443,allow,474745,13542,461203,502,17,189,313
5914,10214,0,0,deny,100,100,0,1,0,1,0
64959,53,9017,53,allow,209,110,99,2,30,1,1
45346,443,29212,443,allow,2438,1442,996,21,20,12,9
45641,443,12763,443,allow,99276,88410,10866,143,333,78,65
49401,53,41126,53,allow,258,102,156,2,30,1,1
59965,36237,0,0,deny,66,66,0,1,0,1,0
58993,443,55872,443,allow,416,210,206,7,26,4,3
57246,53,12592,53,allow,183,94,89,2,30,1,1
49838,53,52067,53,allow,183,94,89,2,31,1,1
55672,45682,48139,45682,allow,70,70,0,2,8,2,0
50675,56205,0,0,deny,66,66,0,1,0,1,0
5661,37965,0,0,deny,66,66,0,1,0,1,0
60572,80,35245,80,allow,556,280,276,9,28,5,4
49426,57470,0,0,deny,66,66,0,1,0,1,0
59989,445,0,0,drop,70,70,0,1,0,1,0
50204,80,48586,80,allow,1221,781,440,11,14,6,5
34301,21247,0,0,deny,62,62,0,1,0,1,0
9745,26467,0,0,deny,62,62,0,1,0,1,0
9239,80,63339,80,allow,318,192,126,6,26,4,2
62473,445,0,0,drop,66,66,0,1,0,1,0
54982,53,63300,53,allow,282,96,186,4,48,2,2
48604,53,57366,53,allow,164,78,86,2,30,1,1
60341,443,14614,443,allow,54103,3190,50913,68,362,27,41
62037,80,19447,80,allow,1670,422,1248,13,17,5,8
50676,445,0,0,drop,66,66,0,1,0,1,0
64926,53,0,0,allow,371,77,294,2,30,1,1
56326,80,40390,80,allow,2541,689,1852,13,60,8,5
41907,53,41907,53,allow,233,90,143,2,33,1,1
41462,2323,0,0,deny,60,60,0,1,0,1,0
55258,53,48782,53,allow,177,94,83,2,30,1,1
59563,445,0,0,drop,70,70,0,1,0,1,0
49348,443,47501,443,allow,2879984,113967,2766017,3396,129,1423,1973
60307,445,0,0,drop,66,66,0,1,0,1,0
17702,6881,0,0,deny,66,66,0,1,0,1,0
62664,445,0,0,drop,70,70,0,1,0,1,0
12457,57866,0,0,deny,66,66,0,1,0,1,0
49650,445,0,0,drop,70,70,0,1,0,1,0
64011,53,63004,53,allow,228,110,118,2,29,1,1
61479,443,17440,443,allow,104543,5227,99316,130,47,57,73
52159,445,0,0,drop,66,66,0,1,0,1,0
50509,53,14571,53,allow,789,110,679,2,31,1,1
65285,445,0,0,drop,70,70,0,1,0,1,0
14059,21247,0,0,deny,62,62,0,1,0,1,0
46587,57470,0,0,deny,62,62,0,1,0,1,0
21064,25174,0,0,deny,62,62,0,1,0,1,0
54382,53,54382,53,allow,414,268,146,3,33,2,1
56846,445,0,0,drop,70,70,0,1,0,1,0
65071,445,0,0,drop,66,66,0,1,0,1,0
59612,445,0,0,drop,70,70,0,1,0,1,0
64525,445,0,0,drop,70,70,0,1,0,1,0
18357,51180,0,0,deny,62,62,0,1,0,1,0
49503,443,13223,443,allow,9678,4552,5126,22,76,12,10
49457,445,0,0,drop,66,66,0,1,0,1,0
56924,53,38205,53,allow,177,94,83,2,31,1,1
56672,445,0,0,drop,70,70,0,1,0,1,0
20576,37965,0,0,deny,62,62,0,1,0,1,0
65099,53,38778,53,allow,199,102,97,2,29,1,1
64511,445,0,0,drop,70,70,0,1,0,1,0
56667,53,35767,53,allow,168,86,82,2,29,1,1
46774,53,46774,53,allow,235,90,145,2,33,1,1
58638,5900,0,0,deny,62,62,0,1,0,1,0
56985,53,26642,53,allow,916,86,830,2,30,1,1
2704,37,0,0,deny,60,60,0,1,0,1,0
55549,445,0,0,drop,70,70,0,1,0,1,0
63590,445,0,0,drop,66,66,0,1,0,1,0
49589,445,0,0,drop,66,66,0,1,0,1,0
38305,443,38305,443,allow,5510,2263,3247,22,40,13,9
44938,443,27497,443,allow,46323,1563,44760,49,30,15,34
41385,53,41385,53,allow,244,98,146,2,34,1,1
61955,445,0,0,drop,70,70,0,1,0,1,0
52834,445,0,0,drop,70,70,0,1,0,1,0
11677,56205,0,0,deny,62,62,0,1,0,1,0
64932,53,8604,53,allow,230,102,128,2,30,1,1
36930,22,36930,22,deny,293,126,167,4,0,2,2
57909,80,57909,80,allow,2648,921,1727,12,20,7,5
43680,53,64871,53,allow,271,102,169,2,30,1,1
45268,443,29338,443,allow,7503,2345,5158,34,256,17,17
65270,3855,0,0,deny,78,78,0,1,0,1,0
10168,80,10168,80,allow,450,246,204,8,24,5,3
38523,53,38523,53,allow,214,82,132,2,32,1,1
58842,443,44558,443,allow,16260,10863,5397,39,19,21,18
51598,56079,0,0,deny,66,66,0,1,0,1,0
49183,53,38350,53,allow,177,94,83,2,30,1,1
60089,443,5576,443,allow,1000,557,443,11,141,6,5
51581,17546,0,0,deny,66,66,0,1,0,1,0
61798,35440,0,0,deny,66,66,0,1,0,1,0
61666,445,0,0,drop,66,66,0,1,0,1,0
48817,47719,48817,47719,allow,1837,852,985,8,1200,4,4
5232,46495,40739,46495,allow,832,832,0,14,96,14,0
5588,5588,0,0,allow,3354,1792,1562,46,193,23,23
55697,53,64657,53,allow,193,102,91,2,31,1,1
57769,445,0,0,drop,66,66,0,1,0,1,0
49270,53,43465,53,allow,216,110,106,2,30,1,1
42044,60043,0,0,deny,66,66,0,1,0,1,0
63045,443,61231,443,allow,510,164,346,2,30,1,1
56358,445,0,0,drop,70,70,0,1,0,1,0
63079,64147,0,0,deny,62,62,0,1,0,1,0
38565,51505,0,0,deny,62,62,0,1,0,1,0
49168,443,13015,443,allow,17765,1565,16200,29,16,12,17
27005,27022,35280,27022,allow,1654,126,1528,4,31,2,2
53392,53,53392,53,allow,832,106,726,2,30,1,1
57290,53,13860,53,allow,178,94,84,2,30,1,1
60581,53,60581,53,allow,197,76,121,2,30,1,1
59296,445,0,0,drop,70,70,0,1,0,1,0
60422,445,0,0,drop,70,70,0,1,0,1,0
14309,56205,0,0,deny,146,146,0,1,0,1,0
65436,53,10665,53,allow,102,102,0,1,30,1,0
49479,56205,0,0,deny,62,62,0,1,0,1,0
18642,42707,0,0,deny,62,62,0,1,0,1,0
53820,7488,11201,7488,allow,70,70,0,2,8,2,0
27005,1308,46544,1308,allow,855,126,729,2,30,1,1
65419,53,4348,53,allow,295,101,194,4,31,2,2
52053,34411,20997,34411,allow,70,70,0,2,7,2,0
2085,7010,2085,7010,allow,3342,1983,1359,16,15,8,8
61968,445,0,0,drop,70,70,0,1,0,1,0
49753,445,0,0,drop,70,70,0,1,0,1,0
49352,443,51520,443,allow,10055,1184,8871,21,76,9,12
2541,51505,0,0,deny,66,66,0,1,0,1,0
55924,53,5985,53,allow,711,87,624,2,31,1,1
62504,445,0,0,drop,70,70,0,1,0,1,0
46590,443,20776,443,allow,6665,1130,5535,24,287,13,11
64028,53,51007,53,allow,293,134,159,2,30,1,1
65344,46824,0,0,deny,62,62,0,1,0,1,0
64700,53,51210,53,allow,458,188,270,6,29,3,3
62361,445,0,0,drop,66,66,0,1,0,1,0
53792,443,8707,443,allow,499,425,74,4,0,3,1
53005,443,10690,443,allow,13028,4115,8913,45,95,23,22
64461,53,10856,53,allow,170,87,83,2,30,1,1
23613,53,55694,53,allow,177,94,83,2,29,1,1
61238,445,0,0,drop,70,70,0,1,0,1,0
55753,53,0,0,allow,82,82,0,2,40,2,0
41472,443,2469,443,allow,4500,2769,1731,29,80,14,15
57470,53377,9260,53377,allow,594,594,0,10,1199,10,0
56849,23745,9953,23745,allow,66,66,0,1,5,1,0
30114,65151,0,0,deny,60,60,0,1,0,1,0
49828,53,30864,53,allow,340,110,230,2,31,1,1
65411,53,12985,53,allow,194,94,100,2,30,1,1
1045,36237,0,0,deny,62,62,0,1,0,1,0
65264,53,54273,53,allow,88,88,0,1,30,1,0
59089,445,0,0,drop,70,70,0,1,0,1,0
56663,445,0,0,drop,70,70,0,1,0,1,0
1377,44847,0,0,deny,146,146,0,1,0,1,0
37965,51413,17500,51413,allow,848,252,596,4,1199,2,2
59126,57470,0,0,deny,66,66,0,1,0,1,0
49976,445,0,0,drop,70,70,0,1,0,1,0
48509,443,53083,443,allow,4922,950,3972,17,34,10,7
49664,445,0,0,drop,66,66,0,1,0,1,0
56163,53,45369,53,allow,265,85,180,4,41,2,2
58305,443,38970,443,allow,11659,1027,10632,25,29,11,14
56676,37965,0,0,deny,66,66,0,1,0,1,0
62888,445,0,0,drop,70,70,0,1,0,1,0
50725,443,41613,443,allow,6593,3522,3071,56,76,33,23
55025,80,12764,80,allow,1142,626,516,8,180,5,3
52397,445,0,0,drop,70,70,0,1,0,1,0
1190,25174,0,0,deny,62,62,0,1,0,1,0
51103,53,0,0,allow,174,77,97,2,30,1,1
56405,62413,0,0,deny,66,66,0,1,0,1,0
57321,53,57606,53,allow,199,102,97,2,30,1,1
59447,445,0,0,drop,70,70,0,1,0,1,0
56118,53,56118,53,allow,233,91,142,2,30,1,1
61426,64910,0,0,deny,66,66,0,1,0,1,0
64472,53,42723,53,allow,183,94,89,2,30,1,1
36963,23,0,0,deny,60,60,0,1,0,1,0
56985,80,59526,80,allow,214,140,74,4,35,3,1
58941,80,60543,80,allow,1114,534,580,12,15,7,5
60223,80,32982,80,allow,17923,13519,4404,41,151,26,15
53671,60416,30870,60416,allow,70,70,0,1,4,1,0
56191,22114,0,0,deny,62,62,0,1,0,1,0
49165,53,64334,53,allow,780,104,676,2,30,1,1
50405,445,0,0,drop,70,70,0,1,0,1,0
55600,80,11201,80,allow,70,70,0,2,8,2,0
49875,53,51820,53,allow,399,86,313,4,49,2,2
58638,5900,0,0,deny,62,62,0,1,0,1,0
1330,53567,0,0,deny,146,146,0,1,0,1,0
37875,55108,0,0,deny,148,148,0,1,0,1,0
64392,25174,0,0,deny,62,62,0,1,0,1,0
60949,445,0,0,drop,66,66,0,1,0,1,0
63955,53,0,0,allow,219,81,138,2,30,1,1
37590,443,37590,443,allow,4572,1665,2907,19,27,11,8
61881,445,0,0,drop,70,70,0,1,0,1,0
54265,445,0,0,drop,70,70,0,1,0,1,0
3303,80,51748,80,allow,2338,1419,919,10,15,5,5
64276,53,55136,53,allow,197,102,95,2,31,1,1
59730,443,46246,443,allow,303,85,218,2,30,1,1
51198,443,22207,443,allow,8075,2723,5352,42,117,24,18
55531,53,46307,53,allow,216,110,106,2,30,1,1
41059,443,46382,443,allow,1248874,30382,1218492,1261,111,425,836
58509,21247,0,0,deny,66,66,0,1,0,1,0
60481,40075,20355,40075,allow,70,70,0,1,5,1,0
28584,37965,0,0,deny,62,62,0,1,0,1,0
61560,445,0,0,drop,70,70,0,1,0,1,0
443,62732,0,0,deny,332,332,0,1,0,1,0
51510,7000,51510,7000,allow,3490,1923,1567,14,16,7,7
26900,27017,21436,27017,allow,422,164,258,6,30,3,3
60107,443,49027,443,allow,9766,3290,6476,40,57,20,20
61406,445,0,0,drop,70,70,0,1,0,1,0
58738,443,24230,443,allow,12382,9652,2730,43,58,26,17
53629,445,0,0,drop,70,70,0,1,0,1,0
47096,443,23148,443,allow,6211,1753,4458,43,215,15,28
46734,53,39721,53,allow,168,78,90,2,30,1,1
49727,53,64244,53,allow,280,110,170,2,31,1,1
63154,443,63154,443,allow,4642,1735,2907,19,30,11,8
56342,445,0,0,drop,70,70,0,1,0,1,0
59731,445,0,0,drop,66,66,0,1,0,1,0
52217,36746,31872,36746,allow,316,136,180,6,9,3,3
49626,443,3697,443,allow,35474,2800,32674,56,135,27,29
41165,23,0,0,deny,60,60,0,1,0,1,0
58814,443,50784,443,allow,1549485,41822,1507663,1612,179,520,1092
50472,445,0,0,drop,66,66,0,1,0,1,0
56561,53,36683,53,allow,167,86,81,2,30,1,1
55975,53,44915,53,allow,195,102,93,2,31,1,1
53594,27639,27513,27639,allow,552,306,246,9,15,5,4
56115,53,60323,53,allow,167,86,81,2,30,1,1
57306,53,25248,53,allow,177,94,83,2,29,1,1
49676,53,26255,53,allow,216,110,106,2,30,1,1
65136,53,36348,53,allow,438,180,258,6,30,3,3
49480,445,0,0,drop,70,70,0,1,0,1,0
64566,445,0,0,drop,70,70,0,1,0,1,0
17579,57470,0,0,deny,62,62,0,1,0,1,0
34240,53,34240,53,allow,229,89,140,2,31,1,1
46509,36237,0,0,deny,66,66,0,1,0,1,0
57240,445,0,0,drop,70,70,0,1,0,1,0
53864,445,0,0,drop,66,66,0,1,0,1,0
45060,37965,0,0,deny,62,62,0,1,0,1,0
51814,55393,12935,55393,allow,70,70,0,2,7,2,0
65277,53,20067,53,allow,196,102,94,2,30,1,1
6881,58293,28909,58293,allow,228,118,110,2,1200,1,1
61797,23,61797,23,allow,60,60,0,1,5,1,0
50820,53,0,0,allow,371,77,294,2,30,1,1
14059,21247,0,0,deny,62,62,0,1,0,1,0
65503,53,29061,53,allow,177,94,83,2,30,1,1
60387,80,36861,80,allow,214,140,74,4,15,3,1
39915,443,23556,443,allow,27886,17603,10283,138,462,76,62
26265,37965,0,0,deny,66,66,0,1,0,1,0
62860,443,23047,443,allow,4954,2554,2400,11,122,6,5
51805,443,60178,443,allow,6339,1901,4438,16,120,8,8
58638,5900,0,0,deny,62,62,0,1,0,1,0
42796,22114,0,0,deny,62,62,0,1,0,1,0
60455,443,23230,443,allow,25055,5440,19615,65,84,35,30
64884,53,55819,53,allow,195,102,93,2,31,1,1
40183,443,34811,443,allow,6065,2277,3788,17,135,8,9
65414,443,41456,443,allow,2494,1643,851,17,25,9,8
39531,19473,0,0,deny,62,62,0,1,0,1,0
49962,53,48309,53,allow,184,94,90,2,30,1,1
30188,32873,43392,32873,allow,502,150,352,2,1200,1,1
49291,443,62267,443,allow,18607,4906,13701,47,255,20,27
49418,27016,31344,27016,allow,250,78,172,2,31,1,1
3381,44847,0,0,deny,78,78,0,1,0,1,0
47471,80,60446,80,allow,1114,534,580,12,16,7,5
52078,15518,32282,15518,allow,70,70,0,1,4,1,0
58638,5900,0,0,deny,62,62,0,1,0,1,0
56740,80,35362,80,allow,1462,703,759,8,17,5,3
53963,6882,6880,6882,allow,70,70,0,1,5,1,0
64791,53,7738,53,allow,184,94,90,2,30,1,1
63465,56205,0,0,deny,66,66,0,1,0,1,0
64282,53,55682,53,allow,215,94,121,2,30,1,1
7749,36237,0,0,deny,66,66,0,1,0,1,0
60954,445,0,0,drop,66,66,0,1,0,1,0
62597,53,49610,53,allow,306,306,0,4,47,4,0
5938,35070,0,0,allow,60,60,0,1,90,1,0
51643,80,38570,80,allow,499,192,307,6,38,4,2
64515,445,0,0,drop,70,70,0,1,0,1,0
63342,445,0,0,drop,70,70,0,1,0,1,0
59889,443,31832,443,allow,1576,973,603,14,28,7,7
6666,3389,0,0,deny,60,60,0,1,0,1,0
49997,80,20317,80,allow,2863,604,2259,11,15,6,5
65384,53,45912,53,allow,735,88,647,2,31,1,1
50035,445,0,0,drop,70,70,0,1,0,1,0
55443,53,49327,53,allow,188,96,92,2,30,1,1
55577,53,3000,53,allow,699,204,495,6,57,3,3
6881,51184,15075,51184,allow,324,150,174,2,1203,1,1
50254,445,0,0,drop,70,70,0,1,0,1,0
34772,15503,0,0,deny,146,146,0,1,0,1,0
5588,5588,0,0,allow,3562,1936,1626,48,195,24,24
27995,22114,0,0,deny,62,62,0,1,0,1,0
65501,26467,0,0,deny,62,62,0,1,0,1,0
10436,53,10436,53,allow,237,91,146,2,32,1,1
49223,2710,26016,2710,allow,3492,3432,60,12,36,11,1
55748,53,53147,53,allow,194,102,92,2,31,1,1
50562,445,0,0,drop,66,66,0,1,0,1,0
65221,53,47234,53,allow,199,102,97,2,30,1,1
60511,443,60511,443,allow,4658,1751,2907,19,30,11,8
32704,25174,0,0,deny,62,62,0,1,0,1,0
9327,57470,0,0,deny,62,62,0,1,0,1,0
53715,53,53715,53,allow,216,98,118,2,29,1,1
1024,44847,0,0,deny,146,146,0,1,0,1,0
55798,445,0,0,drop,70,70,0,1,0,1,0
60569,445,0,0,drop,66,66,0,1,0,1,0
49949,53,15582,53,allow,193,102,91,2,30,1,1
33060,443,63569,443,allow,25617,6531,19086,87,220,46,41
55408,64147,0,0,deny,66,66,0,1,0,1,0
52216,8848,22408,8848,allow,136,136,0,3,11,3,0
58838,443,31088,443,allow,5167,700,4467,16,15,7,9
17009,53733,0,0,deny,66,66,0,1,0,1,0
57377,53,26653,53,allow,2235,93,2142,4,30,2,2
49542,443,62121,443,allow,40423,35897,4526,52,16,33,19
55902,53,58638,53,allow,181,94,87,2,30,1,1
65114,53,15041,53,allow,196,102,94,2,29,1,1
57945,443,56695,443,allow,3522,1763,1759,31,32,16,15
53209,8081,13912,8081,allow,5349,1928,3421,17,114,10,7
52198,12727,50505,12727,allow,66,66,0,2,10,2,0
51213,445,0,0,drop,70,70,0,1,0,1,0
63769,47661,26406,47661,allow,70,70,0,1,5,1,0
50535,51505,0,0,deny,62,62,0,1,0,1,0
51613,7000,51613,7000,allow,2163,676,1487,14,15,7,7
58638,5900,0,0,deny,62,62,0,1,0,1,0
56470,53,41515,53,allow,198,102,96,2,30,1,1
55421,53,47278,53,allow,200,102,98,2,30,1,1
44594,64147,0,0,deny,66,66,0,1,0,1,0
55251,53,30492,53,allow,212,110,102,2,30,1,1
51159,8090,0,0,deny,60,60,0,1,0,1,0
45847,443,35477,443,allow,1134,490,644,18,42,8,10
60083,445,0,0,drop,70,70,0,1,0,1,0
59214,57866,0,0,deny,66,66,0,1,0,1,0
45101,443,3854,443,allow,7912,2739,5173,26,516,14,12
49420,53,47944,53,allow,183,94,89,2,30,1,1
33845,443,64577,443,allow,6495,1547,4948,19,318,10,9
64707,53,47683,53,allow,258,102,156,2,30,1,1
57432,53,35465,53,allow,193,102,91,2,29,1,1
49937,53,46761,53,allow,718,94,624,2,30,1,1
56804,33375,57101,33375,allow,70,70,0,1,5,1,0
49402,53,34826,53,allow,214,110,104,2,30,1,1
65240,53,20571,53,allow,453,186,267,6,30,3,3
64175,53,22231,53,allow,453,100,353,4,57,2,2
51972,80,30646,80,allow,426,240,186,8,26,5,3
33453,64147,0,0,deny,62,62,0,1,0,1,0
54074,443,19199,443,allow,72465,3991,68474,98,169,43,55
38321,80,40490,80,allow,543,469,74,6,16,5,1
56521,443,48766,443,allow,8760,3693,5067,20,90,12,8
59068,49813,0,0,deny,74,74,0,1,0,1,0
64677,53,35002,53,allow,190,97,93,2,31,1,1
55594,53,11300,53,allow,753,96,657,2,31,1,1
55464,53,8236,53,allow,214,110,104,2,30,1,1
64080,11801,41031,11801,allow,66,66,0,1,5,1,0
61744,443,1594,443,allow,3743,1654,2089,10,121,5,5
57586,445,0,0,drop,66,66,0,1,0,1,0
57275,53,57643,53,allow,199,102,97,2,30,1,1
50853,50584,0,0,deny,66,66,0,1,0,1,0
42661,80,47037,80,allow,78310,9243,69067,109,93,57,52
50369,53,47601,53,allow,166,86,80,2,30,1,1
50663,445,0,0,drop,70,70,0,1,0,1,0
60430,445,0,0,drop,70,70,0,1,0,1,0
3478,61463,0,0,deny,164,164,0,1,0,1,0
46963,443,17005,443,allow,70,70,0,1,5,1,0
53492,445,0,0,drop,70,70,0,1,0,1,0
64103,445,0,0,drop,70,70,0,1,0,1,0
56222,445,0,0,drop,70,70,0,1,0,1,0
58638,5900,0,0,deny,62,62,0,1,0,1,0
64484,53,57722,53,allow,168,86,82,2,30,1,1
7720,44847,0,0,deny,66,66,0,1,0,1,0
55611,58049,54667,58049,allow,504,318,186,8,15,5,3
51747,7000,51747,7000,allow,3132,815,2317,14,15,7,7
51807,443,44757,443,allow,3561,1098,2463,10,121,5,5
50604,443,50604,443,allow,4401,1494,2907,19,28,11,8
58799,30188,0,0,deny,62,62,0,1,0,1,0
57140,445,0,0,drop,70,70,0,1,0,1,0
52694,80,51604,80,allow,1960,1366,594,12,34,7,5
55487,53,40739,53,allow,199,102,97,2,30,1,1
443,61686,0,0,deny,1484,1484,0,1,0,1,0
2267,53,3037,53,allow,826,826,0,8,44,8,0
21447,53,34557,53,allow,80280,68084,12196,889,90,816,73
62178,445,0,0,drop,66,66,0,1,0,1,0
47929,80,47929,80,allow,11976,6928,5048,25,24,14,11
60293,445,0,0,drop,70,70,0,1,0,1,0
16524,22114,0,0,deny,62,62,0,1,0,1,0
41699,443,36765,443,allow,40273,3243,37030,60,77,28,32
27005,27202,9481,27202,allow,872,126,746,2,29,1,1
64274,53,21757,53,allow,299,104,195,4,35,2,2
55033,443,56054,443,allow,13944,2069,11875,28,30,15,13
64199,53,4669,53,allow,215,102,113,2,30,1,1
49607,25174,0,0,deny,66,66,0,1,0,1,0
40549,443,33434,443,allow,5591,3194,2397,16,122,8,8
38606,53,21514,53,allow,168,78,90,2,30,1,1
56200,53,10019,53,allow,211,110,101,2,30,1,1
57238,445,0,0,drop,70,70,0,1,0,1,0
1334,8497,0,0,deny,148,148,0,1,0,1,0
64233,445,0,0,drop,66,66,0,1,0,1,0
55252,443,43197,443,allow,16179,1763,14416,38,46,17,21
7288,25174,0,0,deny,66,66,0,1,0,1,0
27528,35440,0,0,deny,66,66,0,1,0,1,0
55127,53,39994,53,allow,253,87,166,4,43,2,2
13285,29892,0,0,deny,145,145,0,1,0,1,0
56009,53,4440,53,allow,232,94,138,2,30,1,1
56070,53,12726,53,allow,193,102,91,2,30,1,1
12471,31573,0,0,deny,62,62,0,1,0,1,0
63494,445,0,0,drop,70,70,0,1,0,1,0
53140,80,7682,80,allow,9602,814,8788,19,129,10,9
58638,5900,0,0,deny,62,62,0,1,0,1,0
45941,23386,0,0,deny,60,60,0,1,0,1,0
50996,443,60752,443,allow,12654,1719,10935,28,21,15,13
56141,53,48700,53,allow,277,134,143,2,30,1,1
50863,443,18214,443,allow,1501,590,911,12,26,6,6
42140,443,52282,443,allow,12322,3893,8429,28,139,13,15
53302,445,0,0,drop,70,70,0,1,0,1,0
28570,25174,0,0,deny,146,146,0,1,0,1,0
46849,36237,0,0,deny,62,62,0,1,0,1,0
47179,53733,0,0,deny,146,146,0,1,0,1,0
63186,445,0,0,drop,66,66,0,1,0,1,0
65505,53,13490,53,allow,166,86,80,2,30,1,1
65287,53,16028,53,allow,180,94,86,2,30,1,1
57577,443,53525,443,allow,4752,2561,2191,32,256,16,16
49402,53,17640,53,allow,177,94,83,2,30,1,1
55306,53,44864,53,allow,177,94,83,2,31,1,1
60017,443,51690,443,allow,134,60,74,3,10,2,1
64098,10096,50669,10096,allow,70,70,0,1,4,1,0
7347,56205,0,0,deny,66,66,0,1,0,1,0
64223,53,57211,53,allow,199,94,105,2,30,1,1
56945,53,27105,53,allow,176,90,86,2,31,1,1
35570,443,53736,443,allow,3297,2327,970,22,37,11,11
56955,53,34703,53,allow,183,94,89,2,30,1,1
52458,53,52458,53,allow,231,88,143,2,33,1,1
47087,443,29605,443,allow,7187,2550,4637,20,18,10,10
52514,80,52514,80,allow,1916,1467,449,10,19,6,4
49264,445,0,0,drop,66,66,0,1,0,1,0
64245,445,0,0,drop,70,70,0,1,0,1,0
49589,443,40471,443,allow,327575,8400,319175,334,316,113,221
60152,80,38610,80,allow,1056,682,374,10,15,6,4
50354,53,23392,53,allow,209,110,99,2,30,1,1
49956,80,11904,80,allow,10819,819,10000,19,15,9,10
56828,53156,12395,53156,allow,66,66,0,1,5,1,0
42587,53,63043,53,allow,199,94,105,2,30,1,1
59918,44847,0,0,deny,66,66,0,1,0,1,0
49945,53,22837,53,allow,821,102,719,2,30,1,1
54876,25174,0,0,deny,62,62,0,1,0,1,0
53309,445,0,0,drop,66,66,0,1,0,1,0
58872,443,51853,443,allow,342665,10261,332404,369,90,117,252
64029,53,31401,53,allow,176,90,86,2,30,1,1
6882,51505,0,0,deny,66,66,0,1,0,1,0
53204,443,30061,443,allow,3655,2344,1311,18,17,9,9
49475,80,53528,80,allow,1548,847,701,10,16,5,5
55955,53,39332,53,allow,164,86,78,2,30,1,1
56836,445,0,0,drop,70,70,0,1,0,1,0
64567,443,55637,443,allow,272081,11032,261049,304,139,107,197
56984,80,27269,80,allow,214,140,74,4,35,3,1
59407,443,31789,443,allow,3298,2132,1166,16,15,8,8
54604,80,54604,80,allow,2244,1549,695,11,18,7,4
58876,57470,0,0,deny,66,66,0,1,0,1,0
62893,445,0,0,drop,66,66,0,1,0,1,0
64586,80,64586,80,allow,123115,6863,116252,160,29,76,84
55580,53,4575,53,allow,195,102,93,2,31,1,1
51808,443,64378,443,allow,3871,1166,2705,13,136,6,7
38528,443,36554,443,allow,13608,3518,10090,48,217,24,24
56474,53,9698,53,allow,209,110,99,2,29,1,1
53144,443,6960,443,allow,7121,2564,4557,26,127,15,11
64025,24855,0,0,allow,66,66,0,1,90,1,0
59303,21247,0,0,deny,62,62,0,1,0,1,0
55517,25174,0,0,deny,66,66,0,1,0,1,0
53650,37096,27046,37096,allow,70,70,0,1,5,1,0
51248,445,0,0,drop,70,70,0,1,0,1,0
64694,53,57973,53,allow,209,102,107,2,30,1,1
58638,5900,0,0,deny,62,62,0,1,0,1,0
58963,445,0,0,drop,66,66,0,1,0,1,0
49372,443,30393,443,allow,6158,3587,2571,37,104,19,18
53539,44847,0,0,deny,62,62,0,1,0,1,0
443,5705,0,0,deny,60,60,0,1,0,1,0
2370,23,0,0,deny,60,60,0,1,0,1,0
51660,80,21356,80,allow,52002,2984,49018,77,35,35,42
53903,51339,21513,51339,allow,70,70,0,2,7,2,0
57934,445,0,0,drop,70,70,0,1,0,1,0
56980,53,33367,53,allow,267,87,180,4,38,2,2
4683,53,49166,53,allow,207,86,121,2,30,1,1
60284,80,50056,80,allow,1430,754,676,11,146,6,5
47910,7454,0,0,deny,60,60,0,1,0,1,0
55022,60100,63915,60100,allow,1550,1130,420,15,25,9,6
52607,443,60417,443,allow,18341,14819,3522,59,1044,31,28
51174,443,5740,443,allow,12037,3531,8506,35,271,18,17
50285,445,0,0,drop,70,70,0,1,0,1,0
53862,445,0,0,drop,66,66,0,1,0,1,0
31362,23,31362,23,allow,60,60,0,1,5,1,0
64772,64147,0,0,deny,66,66,0,1,0,1,0
52084,30863,64593,30863,allow,70,70,0,2,7,2,0
32132,25174,0,0,deny,66,66,0,1,0,1,0
65509,53,55791,53,allow,321,102,219,2,30,1,1
51750,54567,46467,54567,allow,70,70,0,1,5,1,0
50885,80,41376,80,allow,291594,13131,278463,312,159,116,196
53814,445,0,0,drop,66,66,0,1,0,1,0
63750,445,0,0,drop,70,70,0,1,0,1,0
56552,443,10361,443,allow,9518,3057,6461,21,43,12,9
64332,53,56016,53,allow,195,102,93,2,30,1,1
63180,445,0,0,drop,66,66,0,1,0,1,0
61543,445,0,0,drop,70,70,0,1,0,1,0
61953,445,0,0,drop,70,70,0,1,0,1,0
52246,443,52246,443,allow,1615,941,674,15,21,7,8
16403,16385,49252,16385,allow,548,248,300,10,30,5,5
65153,445,0,0,drop,70,70,0,1,0,1,0
50522,445,0,0,drop,70,70,0,1,0,1,0
59473,80,31869,80,allow,1052,612,440,10,15,5,5
58797,443,17991,443,allow,5167,700,4467,16,15,7,9
41892,443,2330,443,allow,2594,1280,1314,17,17,9,8
49907,445,0,0,drop,70,70,0,1,0,1,0
42053,443,49116,443,allow,2351,1546,805,20,40,11,9
51548,80,13460,80,allow,1861,1219,642,10,15,5,5
34217,23,0,0,deny,60,60,0,1,0,1,0
44921,53,22635,53,allow,168,78,90,2,30,1,1
52076,28895,29171,28895,allow,66,66,0,1,5,1,0
64686,445,0,0,drop,70,70,0,1,0,1,0
45912,443,22419,443,allow,4306,1107,3199,17,30,9,8
54196,11392,0,0,deny,66,66,0,1,0,1,0
53114,32975,31768,32975,allow,70,70,0,2,8,2,0
55059,53,53925,53,allow,711,87,624,2,30,1,1
50128,53,3916,53,allow,757,98,659,2,30,1,1
58638,5900,0,0,deny,62,62,0,1,0,1,0
15875,50584,0,0,deny,62,62,0,1,0,1,0
56419,80,4193,80,allow,34098,808,33290,34,104,9,25
15180,26467,0,0,deny,62,62,0,1,0,1,0
52537,37965,0,0,deny,66,66,0,1,0,1,0
57354,53,64428,53,allow,198,94,104,2,29,1,1
28649,43890,0,0,deny,66,66,0,1,0,1,0
52152,58114,56068,58114,allow,70,70,0,1,5,1,0
63672,22114,0,0,deny,66,66,0,1,0,1,0
47453,6881,0,0,deny,146,146,0,1,0,1,0
58499,123,31733,123,allow,184,94,90,2,30,1,1
37152,443,20347,443,allow,7794,2670,5124,27,316,14,13
50336,445,0,0,drop,70,70,0,1,0,1,0
64892,53,50035,53,allow,252,102,150,2,29,1,1
51908,38446,5874,38446,allow,316,136,180,6,6,3,3
51100,445,0,0,drop,70,70,0,1,0,1,0
33027,443,54809,443,allow,3723,2408,1315,28,376,15,13
52247,445,0,0,drop,70,70,0,1,0,1,0
59748,53,55446,53,allow,230,110,120,2,29,1,1
49685,445,0,0,drop,70,70,0,1,0,1,0
50927,80,64147,80,allow,876,519,357,10,75,6,4
52432,50265,0,0,deny,66,66,0,1,0,1,0
49901,7000,49901,7000,allow,3310,1535,1775,15,15,8,7
46478,64147,0,0,deny,145,145,0,1,0,1,0
64874,53,41940,53,allow,324,94,230,2,30,1,1
56532,53,37108,53,allow,164,86,78,2,30,1,1
55808,53,19839,53,allow,182,93,89,2,31,1,1
56697,443,50660,443,allow,3593,2749,844,18,22,11,7
55311,53,61632,53,allow,298,101,197,4,31,2,2
51696,445,0,0,drop,70,70,0,1,0,1,0
64576,53,14840,53,allow,194,102,92,2,31,1,1
37580,443,37580,443,allow,1452,817,635,16,20,9,7
59052,53,59052,53,allow,235,90,145,2,32,1,1
51713,33724,27696,33724,allow,70,70,0,1,5,1,0
50285,53,26837,53,allow,760,97,663,2,31,1,1
55589,443,3953,443,allow,7894,1557,6337,20,150,9,11
11878,37807,0,0,deny,62,62,0,1,0,1,0
3478,61463,0,0,deny,1262,1262,0,1,0,1,0
64461,53,47213,53,allow,177,94,83,2,31,1,1
25961,55783,0,0,deny,66,66,0,1,0,1,0
49379,445,0,0,drop,66,66,0,1,0,1,0
64937,53,49091,53,allow,94,94,0,1,30,1,0
55896,53,34756,53,allow,168,86,82,2,30,1,1
50121,53,43532,53,allow,152,78,74,2,31,1,1
56225,53,8973,53,allow,194,102,92,2,29,1,1
51740,35988,5363,35988,allow,136,136,0,3,14,3,0
56973,443,43404,443,allow,22953,5010,17943,38,123,14,24
55981,31573,0,0,deny,146,146,0,1,0,1,0
64640,53,17711,53,allow,249,94,155,2,30,1,1
27005,27015,65390,27015,allow,891,126,765,2,31,1,1
55613,56511,52356,56511,allow,504,318,186,8,15,5,3
1880,57470,0,0,deny,146,146,0,1,0,1,0
51555,445,0,0,drop,66,66,0,1,0,1,0
58387,445,0,0,drop,70,70,0,1,0,1,0
61381,445,0,0,drop,70,70,0,1,0,1,0
60953,445,0,0,drop,66,66,0,1,0,1,0
18592,44612,0,0,deny,62,62,0,1,0,1,0
56062,53,55161,53,allow,537,98,439,4,40,2,2
59557,445,0,0,drop,70,70,0,1,0,1,0
56361,53,48019,53,allow,816,102,714,2,30,1,1
63951,443,17963,443,allow,6718,3582,3136,18,126,10,8
6825,53,6825,53,allow,217,87,130,2,30,1,1
54966,53,23127,53,allow,170,87,83,3,32,2,1
52740,51505,0,0,deny,66,66,0,1,0,1,0
53166,39564,27898,39564,allow,70,70,0,2,8,2,0
59481,445,0,0,drop,66,66,0,1,0,1,0
59276,445,0,0,drop,66,66,0,1,0,1,0
51842,27665,50059,27665,allow,70,70,0,1,5,1,0
50294,443,54513,443,allow,9999,2316,7683,30,26,15,15
56839,49949,49715,49949,allow,70,70,0,1,5,1,0
53805,34155,31252,34155,allow,70,70,0,2,7,2,0
52919,445,0,0,drop,66,66,0,1,0,1,0
52245,53652,1791,53652,allow,70,70,0,2,7,2,0
26448,9192,0,0,deny,145,145,0,1,0,1,0
50576,443,29225,443,allow,7282,953,6329,18,16,10,8
64089,53,43918,53,allow,340,96,244,4,35,2,2
59878,53,26296,53,allow,391,102,289,2,29,1,1
49527,53,30173,53,allow,165,86,79,2,30,1,1
61662,445,0,0,drop,70,70,0,1,0,1,0
53531,445,0,0,drop,70,70,0,1,0,1,0
49597,53,63650,53,allow,168,86,82,2,31,1,1
54924,3478,2909,3478,allow,312,140,172,4,30,2,2
59252,443,29438,443,allow,8442,1134,7308,23,15,13,10
65363,53,10206,53,allow,181,94,87,2,30,1,1
50794,445,0,0,drop,66,66,0,1,0,1,0
54059,445,0,0,drop,70,70,0,1,0,1,0
0,0,0,0,allow,156,156,0,2,0,2,0
56068,53,2215,53,allow,752,93,659,2,30,1,1
53608,39004,0,0,deny,66,66,0,1,0,1,0
55296,23718,0,0,deny,66,66,0,1,0,1,0
62261,445,0,0,drop,70,70,0,1,0,1,0
55386,53,64239,53,allow,822,102,720,2,30,1,1
60413,43555,1703,43555,allow,70,70,0,1,5,1,0
49918,53,25518,53,allow,198,102,96,2,31,1,1
64685,53,12212,53,allow,534,193,341,6,78,3,3
49968,445,0,0,drop,70,70,0,1,0,1,0
64595,53,56897,53,allow,183,94,89,2,29,1,1
56176,53,42328,53,allow,194,102,92,2,30,1,1
58638,5900,0,0,deny,62,62,0,1,0,1,0
57131,8055,0,0,deny,145,145,0,1,0,1,0
37920,53,0,0,allow,82,82,0,1,30,1,0
32914,5222,62781,5222,allow,8702,4668,4034,92,626,50,42
50593,64147,0,0,deny,62,62,0,1,0,1,0
58226,52848,0,0,deny,62,62,0,1,0,1,0
10088,37807,0,0,deny,66,66,0,1,0,1,0
50346,53,1416,53,allow,168,78,90,2,30,1,1
61744,11392,0,0,deny,66,66,0,1,0,1,0
53108,80,57072,80,allow,1797,1070,727,10,15,5,5
59994,11446,0,0,deny,66,66,0,1,0,1,0
34176,51505,0,0,deny,146,146,0,1,0,1,0
56779,53,5601,53,allow,173,94,79,2,30,1,1
64251,53,65162,53,allow,177,94,83,2,30,1,1
62051,11392,0,0,deny,66,66,0,1,0,1,0
32805,80,38439,80,allow,7450,2372,5078,26,24,15,11
51667,21391,14607,21391,allow,1345,679,666,9,30,5,4
56291,53,51569,53,allow,260,102,158,2,30,1,1
57293,25174,0,0,deny,146,146,0,1,0,1,0
60168,35440,0,0,deny,66,66,0,1,0,1,0
47787,53,24914,53,allow,198,93,105,2,31,1,1
53553,2297,50955,2297,allow,70,70,0,1,4,1,0
49492,53,34957,53,allow,199,102,97,2,31,1,1
59048,57470,0,0,deny,66,66,0,1,0,1,0
45060,37965,0,0,deny,62,62,0,1,0,1,0
22683,39210,0,0,deny,60,60,0,1,0,1,0
49276,51505,0,0,deny,66,66,0,1,0,1,0
51867,48059,33998,48059,allow,258,70,188,4,8,2,2
53867,443,58511,443,allow,499,425,74,4,1,3,1
40909,443,25631,443,allow,1062,724,338,16,41,11,5
51599,443,24581,443,allow,25546,5284,20262,48,149,26,22
55253,53,63534,53,allow,754,94,660,2,31,1,1
64454,53,61289,53,allow,293,110,183,2,29,1,1
50021,53,58776,53,allow,963,391,572,10,83,5,5
49703,53,62145,53,allow,228,110,118,2,30,1,1
27005,27015,27369,27015,allow,889,126,763,2,30,1,1
49565,443,37074,443,allow,378,192,186,7,14,4,3
57288,53,40505,53,allow,177,94,83,2,30,1,1
54552,64147,0,0,deny,62,62,0,1,0,1,0
57342,53,16666,53,allow,167,86,81,2,31,1,1
49262,53,60170,53,allow,168,86,82,2,30,1,1
56455,53,12391,53,allow,183,94,89,2,30,1,1
49716,443,11903,443,allow,9323,3144,6179,24,130,14,10
55003,53,61767,53,allow,196,102,94,2,30,1,1
54550,443,54550,443,allow,13490,2525,10965,30,18,17,13
64602,445,0,0,drop,66,66,0,1,0,1,0
62121,443,9258,443,allow,1864,250,1614,8,120,4,4
47030,81,0,0,deny,60,60,0,1,0,1,0
54204,445,0,0,drop,70,70,0,1,0,1,0
52471,22114,0,0,deny,62,62,0,1,0,1,0
56263,53,42126,53,allow,214,110,104,2,30,1,1
27005,1201,20493,1201,allow,867,126,741,2,30,1,1
56806,46903,25071,46903,allow,3060,1569,1491,12,17,7,5
53676,80,62250,80,allow,154478,6934,147544,194,24,86,108
64240,53,21453,53,allow,256,110,146,2,30,1,1
49834,23,0,0,deny,60,60,0,1,0,1,0
39340,443,15093,443,allow,334,140,194,6,25,3,3
49487,53,45596,53,allow,267,102,165,2,30,1,1
56439,53,18376,53,allow,198,102,96,2,30,1,1
51927,445,0,0,drop,70,70,0,1,0,1,0
54578,26467,0,0,deny,66,66,0,1,0,1,0
51915,5222,45227,5222,allow,11827,5467,6360,100,144,54,46
30307,51505,0,0,deny,62,62,0,1,0,1,0
50121,53,5203,53,allow,152,78,74,2,30,1,1
64586,53,2228,53,allow,173,94,79,2,30,1,1
57291,443,9776,443,allow,2685,1353,1332,17,19,10,7
50007,445,0,0,drop,70,70,0,1,0,1,0
59564,57470,0,0,deny,66,66,0,1,0,1,0
41295,443,9928,443,allow,1482,988,494,12,26,7,5
50980,443,12783,443,allow,3964,1908,2056,23,94,13,10
53793,53,24147,53,allow,213,78,135,2,30,1,1
1280,25174,0,0,deny,66,66,0,1,0,1,0
50101,445,0,0,drop,66,66,0,1,0,1,0
26053,33720,0,0,deny,160,160,0,1,0,1,0
59734,443,60915,443,allow,512,166,346,2,29,1,1
49639,445,0,0,drop,66,66,0,1,0,1,0
5588,5588,0,0,allow,3354,1792,1562,46,196,23,23
50919,443,16242,443,allow,5962,1621,4341,16,75,9,7
55836,53,33356,53,allow,177,94,83,2,30,1,1
51777,63497,24893,63497,allow,316,136,180,6,6,3,3
56770,52920,10024,52920,allow,70,70,0,1,5,1,0
54231,445,0,0,drop,70,70,0,1,0,1,0
51062,1433,0,0,deny,60,60,0,1,0,1,0
51457,445,0,0,drop,70,70,0,1,0,1,0
53912,26467,0,0,deny,66,66,0,1,0,1,0
1876,53,51383,53,allow,404,261,143,3,30,2,1
45939,5228,13443,5228,allow,7528,1416,6112,29,811,11,18
55689,37558,18058,37558,allow,70,70,0,1,5,1,0
53900,53,54773,53,allow,270,168,102,3,30,2,1
64009,53,32252,53,allow,209,110,99,2,30,1,1
39672,443,58171,443,allow,6540,5046,1494,19,115,12,7
64698,445,0,0,drop,66,66,0,1,0,1,0
46341,443,54451,443,allow,9172,3518,5654,39,103,21,18
50306,445,0,0,drop,66,66,0,1,0,1,0
58638,5900,0,0,deny,62,62,0,1,0,1,0
62679,445,0,0,drop,70,70,0,1,0,1,0
50622,445,0,0,drop,66,66,0,1,0,1,0
38709,443,40146,443,allow,398925,9369,389556,391,16,123,268
55087,53,1147,53,allow,183,94,89,2,31,1,1
49665,53,16462,53,allow,168,86,82,2,32,1,1
57893,80,44001,80,allow,318,192,126,6,26,4,2
14397,37965,0,0,deny,62,62,0,1,0,1,0
54892,445,0,0,drop,70,70,0,1,0,1,0
44977,443,32272,443,allow,4848,1030,3818,16,26,9,7
41249,50584,0,0,deny,62,62,0,1,0,1,0
65327,445,0,0,drop,66,66,0,1,0,1,0
47357,50584,0,0,deny,62,62,0,1,0,1,0
54944,445,0,0,drop,70,70,0,1,0,1,0
55044,53,10792,53,allow,196,102,94,2,31,1,1
61085,37965,0,0,deny,62,62,0,1,0,1,0
55217,53,21902,53,allow,189,102,87,2,30,1,1
57441,443,53245,443,allow,9774,3034,6740,29,19,14,15
55718,445,0,0,drop,70,70,0,1,0,1,0
54312,445,0,0,drop,70,70,0,1,0,1,0
64752,53,50636,53,allow,195,102,93,2,30,1,1
29145,8168,0,0,deny,62,62,0,1,0,1,0
22542,30188,0,0,deny,62,62,0,1,0,1,0
60879,445,0,0,drop,66,66,0,1,0,1,0
55341,39004,0,0,deny,74,74,0,1,0,1,0
65143,445,0,0,drop,70,70,0,1,0,1,0
49279,445,0,0,drop,70,70,0,1,0,1,0
60000,443,63999,443,allow,1641,730,911,14,18,8,6
50106,31573,0,0,deny,66,66,0,1,0,1,0
58638,5900,0,0,deny,62,62,0,1,0,1,0
36641,25174,0,0,deny,66,66,0,1,0,1,0
35439,443,50661,443,allow,3730,2455,1275,18,256,10,8
58764,53,65299,53,allow,268,94,174,2,30,1,1
54204,445,0,0,drop,66,66,0,1,0,1,0
50496,80,19242,80,allow,318,192,126,6,25,4,2
45074,443,48285,443,allow,4493,2566,1927,40,130,21,19
64793,80,12166,80,allow,508,256,252,9,77,5,4
65386,443,29589,443,allow,5405,4034,1371,25,43,10,15
443,28417,0,0,deny,82,82,0,1,0,1,0
49838,445,0,0,drop,66,66,0,1,0,1,0
46512,443,4517,443,allow,22641,10532,12109,62,200,35,27
54740,445,0,0,drop,70,70,0,1,0,1,0
55582,445,0,0,drop,70,70,0,1,0,1,0
38674,80,36626,80,allow,1114,534,580,12,16,7,5
44719,80,51210,80,allow,1998,1422,576,10,15,6,4
63071,445,0,0,drop,70,70,0,1,0,1,0
64164,53,32232,53,allow,229,102,127,2,30,1,1
60250,443,56947,443,allow,12389,5180,7209,31,149,17,14
63976,53,34685,53,allow,200,102,98,2,30,1,1
57251,53,30748,53,allow,780,104,676,2,31,1,1
28897,35440,0,0,deny,62,62,0,1,0,1,0
6882,30499,61301,30499,allow,150,150,0,1,1200,1,0
56262,445,0,0,drop,70,70,0,1,0,1,0
443,54507,0,0,deny,82,82,0,1,0,1,0
36933,23117,0,0,deny,66,66,0,1,0,1,0
56470,53,27427,53,allow,168,78,90,2,30,1,1
51971,53,51971,53,allow,240,98,142,2,30,1,1
55098,53,14805,53,allow,180,94,86,2,30,1,1
43357,443,61952,443,allow,146374,13143,133231,238,131,116,122
59974,443,48312,443,allow,200862,57949,142913,361,24,172,189
45202,23,0,0,deny,60,60,0,1,0,1,0
55711,26467,0,0,deny,66,66,0,1,0,1,0
56180,53,48216,53,allow,757,98,659,2,31,1,1
43311,80,24777,80,allow,811,671,140,6,31,4,2
57487,445,0,0,drop,70,70,0,1,0,1,0
57404,445,0,0,drop,70,70,0,1,0,1,0
49741,53,35577,53,allow,766,102,664,2,30,1,1
59192,25174,0,0,deny,66,66,0,1,0,1,0
49818,53,22415,53,allow,211,102,109,2,29,1,1
58941,445,0,0,drop,70,70,0,1,0,1,0
56552,53,56552,53,allow,223,86,137,2,30,1,1
53052,443,60187,443,allow,8476,2030,6446,38,91,19,19
51800,80,7944,80,allow,2169,472,1697,10,77,6,4
60900,443,51308,443,allow,7426,1877,5549,22,81,13,9
54883,51505,0,0,deny,62,62,0,1,0,1,0
28014,443,49655,443,allow,6435,1089,5346,18,75,9,9
51081,53,49643,53,allow,168,78,90,2,30,1,1
50497,445,0,0,drop,66,66,0,1,0,1,0
56175,445,0,0,drop,66,66,0,1,0,1,0
52784,443,37799,443,allow,16022,3217,12805,25,138,11,14
62725,51221,0,0,deny,62,62,0,1,0,1,0
52171,63033,25728,63033,allow,70,70,0,1,5,1,0
60405,64722,55660,64722,allow,70,70,0,1,5,1,0
13371,2323,13371,2323,allow,124,60,64,2,5,1,1
26573,44847,0,0,deny,66,66,0,1,0,1,0
56336,53,53884,53,allow,196,102,94,2,35,1,1
52760,445,0,0,drop,70,70,0,1,0,1,0
55077,53,1629,53,allow,174,89,85,2,31,1,1
55600,22,0,0,deny,60,60,0,1,0,1,0
5223,14446,0,0,deny,220,220,0,1,0,1,0
37736,443,59185,443,allow,16925,11562,5363,36,363,19,17
50516,445,0,0,drop,70,70,0,1,0,1,0
53879,43702,31911,43702,allow,320,140,180,6,6,3,3
59711,445,0,0,drop,70,70,0,1,0,1,0
53934,48339,61953,48339,allow,320,140,180,6,6,3,3
50826,443,44270,443,allow,820870,30523,790347,918,218,337,581
10381,22114,0,0,deny,62,62,0,1,0,1,0
60391,47212,53433,47212,allow,258,70,188,4,8,2,2
50,64147,0,0,deny,66,66,0,1,0,1,0
57004,445,0,0,drop,70,70,0,1,0,1,0
56513,445,0,0,drop,66,66,0,1,0,1,0
54472,445,0,0,drop,70,70,0,1,0,1,0
52450,443,7964,443,allow,9648,3653,5995,37,155,19,18
57023,53,46258,53,allow,179,94,85,2,29,1,1
64517,53,41461,53,allow,211,102,109,2,30,1,1
58638,5900,0,0,deny,62,62,0,1,0,1,0
59128,445,0,0,drop,66,66,0,1,0,1,0
23537,35253,0,0,deny,66,66,0,1,0,1,0
54816,53,4342,53,allow,168,78,90,2,30,1,1
50868,445,0,0,drop,66,66,0,1,0,1,0
49428,53,23705,53,allow,200,94,106,2,30,1,1
21133,59392,22505,59392,allow,481,150,331,2,1199,1,1
49981,53,18517,53,allow,200,94,106,2,30,1,1
34430,53,54160,53,allow,199,94,105,2,30,1,1
57564,56205,0,0,deny,66,66,0,1,0,1,0
37965,33149,27231,33149,allow,3957,2324,1633,51,1732,29,22
50470,61463,0,0,deny,86,86,0,1,0,1,0
56631,443,17729,443,allow,7889,1900,5989,20,16,11,9
12567,53,12567,53,allow,231,90,141,2,30,1,1
24144,57470,0,0,deny,62,62,0,1,0,1,0
50036,80,50018,80,allow,1665,923,742,7,32,4,3
55088,53,58589,53,allow,193,102,91,2,30,1,1
49068,443,37354,443,allow,98965,16634,82331,187,30,82,105
62115,445,0,0,drop,70,70,0,1,0,1,0
51954,57470,0,0,deny,66,66,0,1,0,1,0
49604,53,29103,53,allow,89,89,0,1,30,1,0
54587,53,0,0,allow,82,82,0,1,30,1,0
56524,443,12291,443,allow,5212,1037,4175,20,115,10,10
56288,53,45590,53,allow,200,102,98,2,31,1,1
9439,443,40829,443,allow,6092,775,5317,17,25,9,8
11816,50584,0,0,deny,66,66,0,1,0,1,0
56887,53,57938,53,allow,170,87,83,2,30,1,1
62682,445,0,0,drop,66,66,0,1,0,1,0
56120,443,26246,443,allow,551795,18805,532990,603,43,220,383
14752,53,14752,53,allow,229,98,131,2,30,1,1
58638,5900,0,0,deny,62,62,0,1,0,1,0
14333,51050,0,0,deny,62,62,0,1,0,1,0
38639,443,56279,443,allow,10556,3559,6997,38,82,21,17
54146,445,0,0,drop,70,70,0,1,0,1,0
52588,445,0,0,drop,70,70,0,1,0,1,0
56183,53,29912,53,allow,179,94,85,2,31,1,1
36227,23,0,0,deny,60,60,0,1,0,1,0
38834,53,64506,53,allow,168,78,90,2,30,1,1
55202,445,0,0,drop,70,70,0,1,0,1,0
63888,57470,0,0,deny,62,62,0,1,0,1,0
53045,445,0,0,drop,66,66,0,1,0,1,0
51937,80,32427,80,allow,37552,16143,21409,54,28,26,28
49402,443,59952,443,allow,7965,4044,3921,63,464,30,33
64569,53,17459,53,allow,183,94,89,2,30,1,1
51244,445,0,0,drop,66,66,0,1,0,1,0
62941,57470,0,0,deny,74,74,0,1,0,1,0
53403,445,0,0,drop,70,70,0,1,0,1,0
65108,53,46911,53,allow,195,94,101,2,29,1,1
5223,13602,0,0,deny,66,66,0,1,0,1,0
57574,443,28846,443,allow,3595,1957,1638,17,361,9,8
56489,53,16732,53,allow,208,106,102,2,31,1,1
58638,5900,0,0,deny,62,62,0,1,0,1,0
42764,53,15953,53,allow,164,78,86,2,31,1,1
51221,51413,63036,51413,allow,459,149,310,2,1200,1,1
36058,443,41067,443,allow,11769,1894,9875,27,99,13,14
52968,445,0,0,drop,66,66,0,1,0,1,0
49237,53,49766,53,allow,735,88,647,2,31,1,1
64295,26467,0,0,deny,66,66,0,1,0,1,0
55164,53,64984,53,allow,177,94,83,2,30,1,1
44714,443,14525,443,allow,7389,2124,5265,26,316,12,14
37574,443,27983,443,allow,499,425,74,4,0,3,1
53260,443,22555,443,allow,23664,2213,21451,41,323,17,24
49418,26259,63056,26259,allow,254,78,176,2,30,1,1
63677,15503,0,0,deny,66,66,0,1,0,1,0
32967,80,37431,80,allow,21387,1482,19905,38,18,19,19
63855,445,0,0,drop,66,66,0,1,0,1,0
57133,445,0,0,drop,70,70,0,1,0,1,0
65166,53,40990,53,allow,211,102,109,2,30,1,1
55578,445,0,0,drop,70,70,0,1,0,1,0
45273,80,45273,80,allow,18685,7141,11544,33,28,17,16
30274,23,0,0,deny,60,60,0,1,0,1,0
62101,445,0,0,drop,66,66,0,1,0,1,0
64965,445,0,0,drop,66,66,0,1,0,1,0
51116,80,26188,80,allow,14873,8100,6773,36,32,19,17
2323,23117,0,0,deny,62,62,0,1,0,1,0
64535,37965,0,0,deny,66,66,0,1,0,1,0
62923,993,4264,993,allow,9848,4639,5209,83,41,42,41
53729,40721,59100,40721,allow,70,70,0,2,8,2,0
49987,445,0,0,drop,70,70,0,1,0,1,0
27005,27018,51393,27018,allow,881,126,755,2,30,1,1
13553,53,13553,53,allow,235,90,145,2,32,1,1
54828,445,0,0,drop,70,70,0,1,0,1,0
43601,80,43601,80,allow,1252,539,713,10,20,5,5
0,0,0,0,allow,707,707,0,2,0,2,0
57839,53,57631,53,allow,231,231,0,4,47,4,0
53705,445,0,0,drop,66,66,0,1,0,1,0
50193,3389,50193,3389,allow,3409,1454,1955,16,16,8,8
49777,443,42531,443,allow,35152,27056,8096,56,104,31,25
56281,53,4042,53,allow,177,94,83,2,30,1,1
55617,53,11638,53,allow,214,110,104,2,30,1,1
52236,15313,26526,15313,allow,70,70,0,1,5,1,0
60960,49049,0,0,deny,62,62,0,1,0,1,0
62926,445,0,0,drop,70,70,0,1,0,1,0
49445,443,22095,443,allow,462587,17396,445191,527,130,198,329
49286,445,0,0,drop,66,66,0,1,0,1,0
53928,47287,32055,47287,allow,612,306,306,10,14,5,5
51695,445,0,0,drop,70,70,0,1,0,1,0
48655,80,39370,80,allow,956,541,415,11,315,6,5
64567,445,0,0,drop,66,66,0,1,0,1,0
55631,445,0,0,drop,66,66,0,1,0,1,0
42946,31573,0,0,deny,146,146,0,1,0,1,0
53821,443,22487,443,allow,499,425,74,4,0,3,1
55429,53,31053,53,allow,182,102,80,2,30,1,1
52106,80,35207,80,allow,422,240,182,8,26,5,3
49460,445,0,0,drop,66,66,0,1,0,1,0
65227,445,0,0,drop,70,70,0,1,0,1,0
50555,80,24136,80,allow,318,192,126,6,26,4,2
60276,445,0,0,drop,66,66,0,1,0,1,0
55004,443,44724,443,allow,7960,2219,5741,27,35,16,11
52905,445,0,0,drop,66,66,0,1,0,1,0
54772,443,51519,443,allow,3388,894,2494,19,154,8,11
58023,47808,0,0,deny,60,60,0,1,0,1,0
2467,2767,0,0,deny,66,66,0,1,0,1,0
53776,53,0,0,allow,82,82,0,2,40,2,0
38535,443,55811,443,allow,910,358,552,14,47,6,8
64930,53,28381,53,allow,193,102,91,2,31,1,1
57673,53,25100,53,allow,273,94,179,2,30,1,1
50160,57470,0,0,deny,146,146,0,1,0,1,0
57137,53,46999,53,allow,279,96,183,4,32,2,2
33174,22,0,0,deny,60,60,0,1,0,1,0
63972,53,46168,53,allow,193,102,91,2,30,1,1
58646,44847,0,0,deny,66,66,0,1,0,1,0
49601,53,30079,53,allow,88,88,0,1,31,1,0
50637,445,0,0,drop,66,66,0,1,0,1,0
49597,53,32706,53,allow,168,86,82,2,31,1,1
50172,53,37056,53,allow,211,78,133,2,30,1,1
57192,445,0,0,drop,70,70,0,1,0,1,0
61423,443,8022,443,allow,1113,589,524,12,28,6,6
45394,80,27437,80,allow,4886,1260,3626,17,17,10,7
63098,35440,0,0,deny,62,62,0,1,0,1,0
46324,443,40837,443,allow,24465,3945,20520,39,18,18,21
56461,445,0,0,drop,66,66,0,1,0,1,0
62400,35993,0,0,deny,66,66,0,1,0,1,0
60195,445,0,0,drop,66,66,0,1,0,1,0
60501,443,35631,443,allow,12006,3698,8308,23,15,13,10
53706,445,0,0,drop,70,70,0,1,0,1,0
61699,445,0,0,drop,70,70,0,1,0,1,0
53581,53,57842,53,allow,231,94,137,2,30,1,1
49812,53,11228,53,allow,166,86,80,2,30,1,1
64799,443,56278,443,allow,1671,1004,667,16,76,8,8
53759,445,0,0,drop,70,70,0,1,0,1,0
29706,50584,0,0,deny,66,66,0,1,0,1,0
60196,80,43098,80,allow,70,70,0,2,8,2,0
50481,443,21430,443,allow,1258,716,542,13,83,7,6
38832,443,4622,443,allow,23292,17154,6138,141,522,79,62
55069,44847,0,0,deny,62,62,0,1,0,1,0
50210,445,0,0,drop,66,66,0,1,0,1,0
55662,36445,15210,36445,allow,504,318,186,8,17,5,3
56802,53,9464,53,allow,753,93,660,2,31,1,1
54553,53,43102,53,allow,101,101,0,2,31,2,0
64979,53,23009,53,allow,188,96,92,2,31,1,1
62818,445,0,0,drop,66,66,0,1,0,1,0
23658,18375,0,0,deny,62,62,0,1,0,1,0
40355,443,8929,443,allow,15367456,244322,15123134,12866,268,1819,11047
27010,64147,0,0,deny,62,62,0,1,0,1,0
51151,64147,0,0,deny,66,66,0,1,0,1,0
60012,443,58670,443,allow,8127,1796,6331,21,79,12,9
65030,445,0,0,drop,70,70,0,1,0,1,0
49323,53,50782,53,allow,210,110,100,2,29,1,1
49754,443,12620,443,allow,17243,5482,11761,82,316,41,41
50505,445,0,0,drop,70,70,0,1,0,1,0
53919,443,62398,443,allow,499,425,74,4,0,3,1
21179,44847,0,0,deny,62,62,0,1,0,1,0
49510,443,40862,443,allow,9571,3757,5814,48,221,26,22
49958,445,0,0,drop,70,70,0,1,0,1,0
55194,53,43998,53,allow,195,102,93,2,30,1,1
50376,53,47622,53,allow,167,78,89,2,30,1,1
62049,445,0,0,drop,66,66,0,1,0,1,0
35917,443,52534,443,allow,13480,8545,4935,35,94,19,16
3407,57866,0,0,deny,66,66,0,1,0,1,0
54028,445,0,0,drop,70,70,0,1,0,1,0
51443,443,36286,443,allow,70,70,0,1,5,1,0
60429,445,0,0,drop,70,70,0,1,0,1,0
49166,53,8191,53,allow,468,93,375,4,34,2,2
55230,445,0,0,drop,70,70,0,1,0,1,0
56052,53,19569,53,allow,177,94,83,2,30,1,1
37390,443,2795,443,allow,4859,964,3895,17,26,10,7
53207,50584,0,0,deny,66,66,0,1,0,1,0
53835,15000,42611,15000,allow,130,70,60,2,5,1,1
57805,445,0,0,drop,66,66,0,1,0,1,0
56534,60043,0,0,deny,145,145,0,1,0,1,0
54951,443,4064,443,allow,30123,21849,8274,65,77,38,27
52754,26467,0,0,deny,66,66,0,1,0,1,0
39802,80,39802,80,allow,424,198,226,7,142,4,3
49792,443,37527,443,allow,9841,3185,6656,25,186,14,11
59588,445,0,0,drop,70,70,0,1,0,1,0
52961,5228,16793,5228,allow,1410,933,477,11,3600,6,5
58970,80,38149,80,allow,1521,967,554,10,75,6,4
61746,443,1496,443,allow,251,69,182,3,120,1,2
50403,80,8423,80,allow,4332,3596,736,14,32,8,6
52257,445,0,0,drop,70,70,0,1,0,1,0
54125,443,54125,443,allow,65572,14874,50698,92,84,48,44
59786,25174,0,0,deny,62,62,0,1,0,1,0
49310,53,37425,53,allow,239,102,137,2,30,1,1
55658,45261,61900,45261,allow,70,70,0,1,5,1,0
33954,53,7602,53,allow,168,78,90,2,29,1,1
57752,445,0,0,drop,66,66,0,1,0,1,0
50639,445,0,0,drop,70,70,0,1,0,1,0
65461,53,60419,53,allow,226,94,132,2,30,1,1
16430,31573,0,0,deny,62,62,0,1,0,1,0
64796,53,3205,53,allow,184,94,90,2,31,1,1
58101,46314,0,0,deny,72,72,0,1,0,1,0
51987,443,55315,443,allow,134,60,74,3,5,2,1
64823,53,7121,53,allow,199,102,97,2,31,1,1
57883,443,47068,443,allow,1786,1147,639,17,177,10,7
64917,53,1366,53,allow,243,94,149,2,30,1,1
56443,53,9982,53,allow,168,86,82,2,31,1,1
64444,53,35858,53,allow,183,94,89,2,29,1,1
51635,80,49291,80,allow,318,192,126,6,39,4,2
51618,15000,8356,15000,allow,130,70,60,2,5,1,1
54516,445,0,0,drop,70,70,0,1,0,1,0
61945,48817,0,0,deny,66,66,0,1,0,1,0
56885,445,0,0,drop,66,66,0,1,0,1,0
64583,445,0,0,drop,70,70,0,1,0,1,0
27005,27014,60898,27014,allow,879,126,753,2,30,1,1
63710,54740,50464,54740,allow,70,70,0,1,4,1,0
65440,53,49659,53,allow,181,94,87,2,30,1,1
52782,445,0,0,drop,66,66,0,1,0,1,0
51686,445,0,0,drop,70,70,0,1,0,1,0
53300,445,0,0,drop,66,66,0,1,0,1,0
6886,55839,0,0,deny,139,139,0,1,0,1,0
65456,53,31398,53,allow,364,102,262,2,29,1,1
26263,8168,0,0,deny,62,62,0,1,0,1,0
49905,445,0,0,drop,66,66,0,1,0,1,0
3478,61463,0,0,deny,342,342,0,1,0,1,0
61185,54532,0,0,deny,62,62,0,1,0,1,0
54826,56205,0,0,deny,66,66,0,1,0,1,0
58638,5900,0,0,deny,62,62,0,1,0,1,0
59898,443,27640,443,allow,1265,684,581,13,30,6,7
45944,44847,0,0,deny,62,62,0,1,0,1,0
58638,5900,0,0,deny,62,62,0,1,0,1,0
65200,51050,0,0,deny,62,62,0,1,0,1,0
49548,443,63354,443,allow,8912,2297,6615,43,255,20,23
60811,443,53507,443,allow,740,222,518,11,3631,4,7
53884,48754,22273,48754,allow,70,70,0,1,4,1,0
55868,53,11909,53,allow,198,110,88,2,29,1,1
56630,443,17918,443,allow,6156,918,5238,18,26,10,8
64357,53,4119,53,allow,182,93,89,2,31,1,1
50177,445,0,0,drop,70,70,0,1,0,1,0
58887,15000,7750,15000,allow,138,78,60,2,6,1,1
37356,443,58036,443,allow,1842,1134,708,14,315,8,6
52783,443,32956,443,allow,1581,924,657,15,125,7,8
58851,443,28195,443,allow,344,130,214,6,77,3,3
49169,443,62824,443,allow,11168,3827,7341,42,16,20,22
27005,50002,4449,50002,allow,1642,126,1516,4,31,2,2
53620,445,0,0,drop,70,70,0,1,0,1,0
51954,12380,62025,12380,allow,70,70,0,2,7,2,0
63944,8999,41992,8999,allow,70,70,0,1,5,1,0
59327,445,0,0,drop,70,70,0,1,0,1,0
56528,443,48835,443,allow,158084,6138,151946,173,95,64,109
59891,445,0,0,drop,70,70,0,1,0,1,0
21534,42246,0,0,deny,66,66,0,1,0,1,0
61223,37965,0,0,deny,66,66,0,1,0,1,0
51727,445,0,0,drop,70,70,0,1,0,1,0
52817,445,0,0,drop,70,70,0,1,0,1,0
41674,443,45032,443,allow,14424911,433341,13991570,15454,320,5482,9972
44380,443,20721,443,allow,5624,2556,3068,29,80,15,14
9475,443,36657,443,allow,4063,969,3094,16,26,9,7
61457,21247,0,0,deny,66,66,0,1,0,1,0
50362,53,58174,53,allow,214,110,104,2,29,1,1
50309,445,0,0,drop,70,70,0,1,0,1,0
49948,53,31894,53,allow,755,102,653,2,30,1,1
53236,443,39010,443,allow,41247,1363,39884,51,37,13,38
55050,443,54563,443,allow,126,60,66,3,5,2,1
59757,443,13672,443,allow,11663,1141,10522,30,41,14,16
53564,63344,20702,63344,allow,1721,971,750,15,16,8,7
56779,53,27714,53,allow,165,86,79,2,30,1,1
49943,80,26149,80,allow,10767,783,9984,19,15,9,10
55085,80,12175,80,allow,306,180,126,6,85,4,2
47091,5228,39353,5228,allow,3113,1395,1718,20,3608,8,12
64430,445,0,0,drop,70,70,0,1,0,1,0
43628,443,48034,443,allow,13974,3774,10200,29,120,12,17
56795,443,62237,443,allow,8021,2001,6020,20,15,11,9
49501,53,50847,53,allow,193,102,91,2,31,1,1
27005,27017,53801,27017,allow,1634,126,1508,4,31,2,2
46849,36237,0,0,deny,66,66,0,1,0,1,0
58638,5900,0,0,deny,62,62,0,1,0,1,0
59083,445,0,0,drop,66,66,0,1,0,1,0
2346,25174,0,0,deny,66,66,0,1,0,1,0
49614,53,48437,53,allow,258,110,148,2,30,1,1
28875,51505,0,0,deny,62,62,0,1,0,1,0
63732,445,0,0,drop,70,70,0,1,0,1,0
62804,37965,0,0,deny,66,66,0,1,0,1,0
60927,443,47688,443,allow,3642,606,3036,13,119,6,7
50977,56205,0,0,deny,66,66,0,1,0,1,0
53707,53,63109,53,allow,86,86,0,1,30,1,0
32921,443,5993,443,allow,7578,2270,5308,17,123,8,9
44187,443,10571,443,allow,12382,2688,9694,37,361,19,18
53197,80,29002,80,allow,748,459,289,8,254,5,3
57284,53,51341,53,allow,214,110,104,2,30,1,1
64980,53,54616,53,allow,200,102,98,2,30,1,1
53154,443,28335,443,allow,3947,2796,1151,22,28,12,10
53779,51505,0,0,deny,66,66,0,1,0,1,0
58638,5900,0,0,deny,62,62,0,1,0,1,0
58638,5900,0,0,deny,62,62,0,1,0,1,0
56138,53,30181,53,allow,284,94,190,2,29,1,1
56946,445,0,0,drop,66,66,0,1,0,1,0
36804,25174,0,0,deny,66,66,0,1,0,1,0
58794,5222,61380,5222,allow,47445,16812,30633,144,870,65,79
8080,37965,0,0,deny,62,62,0,1,0,1,0
59858,443,47016,443,allow,2069,1044,1025,22,44,9,13
52169,443,53007,443,allow,7905,4819,3086,27,139,13,14
52003,44512,0,0,deny,66,66,0,1,0,1,0
55450,445,0,0,drop,70,70,0,1,0,1,0
65400,36237,0,0,deny,66,66,0,1,0,1,0
54047,50011,0,0,deny,66,66,0,1,0,1,0
49965,53,5956,53,allow,257,110,147,2,30,1,1
51935,445,0,0,drop,70,70,0,1,0,1,0
50523,443,11789,443,allow,1579,988,591,13,45,7,6
51271,37965,0,0,deny,66,66,0,1,0,1,0
55675,53,17939,53,allow,190,97,93,2,0,1,1
3945,35440,0,0,deny,66,66,0,1,0,1,0
22013,53,22013,53,allow,198,90,108,2,30,1,1
36881,56205,0,0,deny,62,62,0,1,0,1,0
65304,53,31926,53,allow,195,102,93,2,29,1,1
55820,60038,0,0,allow,66,66,0,1,91,1,0
65180,53,3585,53,allow,165,86,79,2,29,1,1
40808,53,41572,53,allow,168,78,90,2,29,1,1
1128,44847,0,0,deny,62,62,0,1,0,1,0
56377,53,45673,53,allow,793,101,692,2,31,1,1
62800,80,25172,80,allow,1437,659,778,11,45,6,5
49545,443,58325,443,allow,7189,1694,5495,31,131,14,17
65480,53,23239,53,allow,211,102,109,2,30,1,1
65071,445,0,0,drop,70,70,0,1,0,1,0
53158,443,62480,443,allow,4940,2342,2598,21,135,10,11
55179,80,55179,80,allow,374,240,134,7,15,5,2
1114,37965,0,0,deny,62,62,0,1,0,1,0
59585,443,47956,443,allow,4815,2461,2354,47,58,26,21
56700,53,42094,53,allow,443,182,261,6,30,3,3
54073,445,0,0,drop,66,66,0,1,0,1,0
64393,53,36156,53,allow,183,94,89,2,30,1,1
53303,445,0,0,drop,70,70,0,1,0,1,0
50937,445,0,0,drop,70,70,0,1,0,1,0
27839,53,27839,53,allow,213,87,126,2,31,1,1
63999,53,50492,53,allow,193,102,91,2,29,1,1
50203,443,50531,443,allow,3792,871,2921,16,121,7,9
60439,47783,39683,47783,allow,70,70,0,1,5,1,0
57464,53,0,0,allow,86,86,0,1,30,1,0
55973,25174,0,0,deny,62,62,0,1,0,1,0
53415,445,0,0,drop,66,66,0,1,0,1,0
38406,80,52487,80,allow,52105,1615,50490,61,18,24,37
49566,53,59606,53,allow,200,94,106,2,30,1,1
55102,53,13108,53,allow,195,102,93,2,29,1,1
39063,44847,0,0,deny,66,66,0,1,0,1,0
62284,445,0,0,drop,70,70,0,1,0,1,0
46286,21247,0,0,deny,62,62,0,1,0,1,0
63898,13205,50081,13205,allow,70,70,0,1,4,1,0
65317,51221,0,0,deny,78,78,0,1,0,1,0
55994,53,14780,53,allow,182,93,89,2,30,1,1
50347,445,0,0,drop,66,66,0,1,0,1,0
48176,50584,0,0,deny,62,62,0,1,0,1,0
65269,53,18855,53,allow,226,102,124,2,30,1,1
53699,36887,39756,36887,allow,492,306,186,8,15,5,3
49604,53,14213,53,allow,86,86,0,1,29,1,0
56128,445,0,0,drop,66,66,0,1,0,1,0
61033,445,0,0,drop,70,70,0,1,0,1,0
47207,443,60906,443,allow,11085,2554,8531,48,19,24,24
1987,26467,0,0,deny,62,62,0,1,0,1,0
60347,445,0,0,drop,70,70,0,1,0,1,0
60241,443,21837,443,allow,4512,1810,2702,16,135,7,9
49167,443,26021,443,allow,8271,1357,6914,26,17,12,14
57956,443,29445,443,allow,7842,2164,5678,48,5441,20,28
55786,53,55786,53,allow,247,98,149,2,32,1,1
64181,445,0,0,drop,70,70,0,1,0,1,0
56837,53,1718,53,allow,227,110,117,2,30,1,1
19371,53,19371,53,allow,214,82,132,2,31,1,1
58114,11119,0,0,deny,148,148,0,1,0,1,0
50728,445,0,0,drop,66,66,0,1,0,1,0
64555,53,55605,53,allow,167,86,81,2,30,1,1
59400,443,43611,443,allow,6489,2731,3758,19,16,10,9
49910,443,39120,443,allow,4712,908,3804,18,75,9,9
56968,80,38598,80,allow,2273,1511,762,7,29,4,3
65067,80,65067,80,allow,342198,13793,328405,355,23,126,229
50692,443,32817,443,allow,180,60,120,4,15,2,2
50978,80,49892,80,allow,81390,4223,77167,103,21,49,54
18907,53,18907,53,allow,237,91,146,2,32,1,1
61848,445,0,0,drop,66,66,0,1,0,1,0
12290,22114,0,0,deny,62,62,0,1,0,1,0
50314,80,10727,80,allow,1030,310,720,11,56,6,5
55424,38303,0,0,deny,66,66,0,1,0,1,0
40876,443,14567,443,allow,6450,1003,5447,21,360,11,10
56669,445,0,0,drop,70,70,0,1,0,1,0
1737,80,1737,80,allow,424934,9929,415005,411,95,129,282
55968,56205,0,0,deny,66,66,0,1,0,1,0
62273,50584,0,0,deny,66,66,0,1,0,1,0
56614,25174,0,0,deny,66,66,0,1,0,1,0
52658,445,0,0,drop,66,66,0,1,0,1,0
65265,55067,0,0,deny,66,66,0,1,0,1,0
56522,80,49102,80,allow,798,401,397,7,17,5,2
61802,443,61802,443,allow,4521,1614,2907,19,26,11,8
42920,443,33787,443,allow,883886,26396,857490,947,444,340,607
55850,445,0,0,drop,70,70,0,1,0,1,0
51091,80,22433,80,allow,4033,2712,1321,35,130,19,16
12162,53,12162,53,allow,233,90,143,2,33,1,1
38692,443,23262,443,allow,10335,2523,7812,42,32,20,22
64677,53,46523,53,allow,195,102,93,2,31,1,1
57115,53,18402,53,allow,178,94,84,2,30,1,1
53787,53,59844,53,allow,224,86,138,2,30,1,1
59564,57470,0,0,deny,66,66,0,1,0,1,0
58638,5900,0,0,deny,62,62,0,1,0,1,0
61349,443,14011,443,allow,1786,172,1614,7,120,3,4
63326,445,0,0,drop,66,66,0,1,0,1,0
61059,32480,0,0,deny,146,146,0,1,0,1,0
55291,445,0,0,drop,66,66,0,1,0,1,0
60210,80,21481,80,allow,5141,3706,1435,17,151,10,7
39651,443,15343,443,allow,18514,4506,14008,72,105,41,31
51650,80,36691,80,allow,141348,4210,137138,161,17,58,103
50539,445,0,0,drop,66,66,0,1,0,1,0
37576,53,58836,53,allow,168,78,90,2,30,1,1
65049,53,4020,53,allow,210,110,100,2,31,1,1
55038,443,25937,443,allow,11429,4904,6525,33,156,18,15
65166,445,0,0,drop,70,70,0,1,0,1,0
56137,53,49352,53,allow,199,102,97,2,29,1,1
49556,443,13898,443,allow,6440,1844,4596,22,141,11,11
51401,443,22599,443,allow,202,70,132,3,11,1,2
30303,30303,0,0,deny,171,171,0,1,0,1,0
51999,445,0,0,drop,70,70,0,1,0,1,0
60172,445,0,0,drop,70,70,0,1,0,1,0
25360,51505,0,0,deny,62,62,0,1,0,1,0
60489,445,0,0,drop,70,70,0,1,0,1,0
55509,53,37936,53,allow,215,102,113,2,30,1,1
55545,53,31002,53,allow,177,94,83,2,30,1,1
49783,53,25868,53,allow,179,94,85,2,30,1,1
41653,21247,0,0,deny,62,62,0,1,0,1,0
34553,48637,0,0,deny,60,60,0,1,0,1,0
61124,445,0,0,drop,70,70,0,1,0,1,0
5588,5588,0,0,allow,3354,1792,1562,46,194,23,23
57302,62413,0,0,deny,66,66,0,1,0,1,0
55217,443,55217,443,allow,3239,740,2499,15,40,8,7
28580,64147,0,0,deny,62,62,0,1,0,1,0
42904,53,51732,53,allow,308,118,190,2,30,1,1
27005,27216,53096,27216,allow,883,126,757,2,31,1,1
56887,53,15011,53,allow,312,94,218,2,30,1,1
64341,53,61484,53,allow,355,118,237,2,30,1,1
36701,53,35437,53,allow,199,94,105,2,30,1,1
51880,8000,29097,8000,allow,270,270,0,4,33,4,0
58638,5900,58638,5900,allow,160,66,94,2,9,1,1
51054,445,0,0,drop,66,66,0,1,0,1,0
50584,49001,14591,49001,allow,166,166,0,1,1199,1,0
56598,445,0,0,drop,70,70,0,1,0,1,0
27350,80,31798,80,allow,3943,1809,2134,21,82,11,10
63069,445,0,0,drop,66,66,0,1,0,1,0
65119,53,47223,53,allow,568,188,380,6,60,3,3
51009,445,0,0,drop,66,66,0,1,0,1,0
49917,53,29420,53,allow,209,110,99,2,29,1,1
61281,443,15563,443,allow,3169,979,2190,14,135,7,7
56750,80,10595,80,allow,194,128,66,4,25,3,1
50214,53,15199,53,allow,718,94,624,2,29,1,1
58608,62413,0,0,deny,66,66,0,1,0,1,0
56106,53,18399,53,allow,193,102,91,2,30,1,1
53932,445,0,0,drop,70,70,0,1,0,1,0
54221,57470,0,0,deny,66,66,0,1,0,1,0
52335,445,0,0,drop,70,70,0,1,0,1,0
51051,445,0,0,drop,66,66,0,1,0,1,0
52482,443,8869,443,allow,26154,6874,19280,35,17,16,19
60198,445,0,0,drop,70,70,0,1,0,1,0
54846,445,0,0,drop,66,66,0,1,0,1,0
50632,445,0,0,drop,66,66,0,1,0,1,0
49913,53,47185,53,allow,216,110,106,2,30,1,1
9313,443,38695,443,allow,4618,840,3778,16,26,9,7
50458,443,34106,443,allow,44532,3294,41238,56,128,21,35
63102,443,30669,443,allow,8848,3081,5767,56,335,26,30
57177,53,5547,53,allow,174,89,85,2,31,1,1
50799,37807,0,0,deny,66,66,0,1,0,1,0
42156,80,50916,80,allow,1323,335,988,10,15,5,5
59756,53,24009,53,allow,211,78,133,2,29,1,1
54166,25174,0,0,deny,66,66,0,1,0,1,0
59284,443,33120,443,allow,10243,3289,6954,41,26,21,20
13528,51221,0,0,deny,62,62,0,1,0,1,0
53442,443,36564,443,allow,28728581,857403,27871178,29322,132,8944,20378
49912,445,0,0,drop,70,70,0,1,0,1,0
50036,445,0,0,drop,66,66,0,1,0,1,0
64843,443,36183,443,allow,13583,4157,9426,26,120,11,15
50419,26467,0,0,deny,66,66,0,1,0,1,0
50021,445,0,0,drop,66,66,0,1,0,1,0
62687,445,0,0,drop,66,66,0,1,0,1,0
55365,53,47603,53,allow,184,94,90,2,31,1,1
55444,443,64554,443,allow,13284,3562,9722,38,26,21,17
60050,445,0,0,drop,66,66,0,1,0,1,0
49418,31000,56556,31000,allow,260,78,182,2,30,1,1
56781,443,59501,443,allow,7870,1881,5989,20,15,11,9
63149,445,0,0,drop,70,70,0,1,0,1,0
56937,80,7429,80,allow,2567,1586,981,13,75,8,5
59005,443,56215,443,allow,6306,1780,4526,28,33,14,14
58176,445,0,0,drop,70,70,0,1,0,1,0
51944,53,51944,53,allow,832,106,726,2,30,1,1
18986,44847,0,0,deny,66,66,0,1,0,1,0
60267,445,0,0,drop,70,70,0,1,0,1,0
54726,30041,0,0,deny,66,66,0,1,0,1,0
37617,443,6093,443,allow,1654,931,723,20,16,11,9
6676,63836,0,0,deny,145,145,0,1,0,1,0
65515,53,32592,53,allow,204,104,100,2,31,1,1
49776,445,0,0,drop,66,66,0,1,0,1,0
21054,53,21054,53,allow,216,98,118,2,30,1,1
64356,53,40978,53,allow,243,94,149,2,30,1,1
49418,27015,14381,27015,allow,248,71,177,2,31,1,1
62176,445,0,0,drop,66,66,0,1,0,1,0
57470,61803,17706,61803,allow,792,792,0,13,1200,13,0
50819,443,23164,443,allow,1663508,63528,1599980,1853,251,692,1161
26254,56205,0,0,deny,62,62,0,1,0,1,0
56192,53,54480,53,allow,177,94,83,2,30,1,1
47910,7454,0,0,deny,60,60,0,1,0,1,0
62346,80,27241,80,allow,2328,580,1748,12,16,6,6
52776,80,21861,80,allow,432,240,192,8,101,5,3
50584,51748,57588,51748,allow,1356,300,1056,6,1200,3,3
45309,443,7993,443,allow,3094,2048,1046,18,16,9,9
64359,53,44275,53,allow,196,102,94,2,30,1,1
53531,445,0,0,drop,70,70,0,1,0,1,0
63567,445,0,0,drop,70,70,0,1,0,1,0
63942,445,0,0,drop,70,70,0,1,0,1,0
54807,443,9391,443,allow,10078,2210,7868,36,120,19,17
53677,10657,26875,10657,allow,70,70,0,2,8,2,0
53702,445,0,0,drop,70,70,0,1,0,1,0
46859,15000,30674,15000,allow,130,70,60,2,6,1,1
34674,41864,0,0,deny,145,145,0,1,0,1,0
62883,53,56502,53,allow,205,86,119,2,29,1,1
65115,53,30107,53,allow,253,87,166,4,31,2,2
52258,58792,14441,58792,allow,316,136,180,6,8,3,3
62679,445,0,0,drop,70,70,0,1,0,1,0
63084,53,39134,53,allow,86,86,0,2,31,2,0
1100,27540,42086,27540,allow,132,70,62,2,29,1,1
55055,445,0,0,drop,70,70,0,1,0,1,0
46824,53,42441,53,allow,326,78,248,2,30,1,1
55524,46232,0,0,deny,62,62,0,1,0,1,0
52165,445,0,0,drop,70,70,0,1,0,1,0
49113,50584,0,0,deny,66,66,0,1,0,1,0
55938,53,31705,53,allow,209,110,99,2,30,1,1
48286,443,64439,443,allow,9590,3002,6588,25,96,14,11
62149,445,0,0,drop,70,70,0,1,0,1,0
59652,445,0,0,drop,70,70,0,1,0,1,0
50608,80,12728,80,allow,10029,8683,1346,20,36,11,9
14903,10387,0,0,deny,159,159,0,1,0,1,0
50653,80,52730,80,allow,1658,1247,411,8,15,5,3
58138,445,0,0,drop,70,70,0,1,0,1,0
57892,443,36599,443,allow,6394,3923,2471,42,176,22,20
53321,445,0,0,drop,66,66,0,1,0,1,0
57018,53,57758,53,allow,177,94,83,2,30,1,1
52784,443,47288,443,allow,2802,1626,1176,18,72,9,9
39058,443,63912,443,allow,8028,5439,2589,32,27,16,16
42686,53,42686,53,allow,262,106,156,2,32,1,1
62726,445,0,0,drop,66,66,0,1,0,1,0
50340,445,0,0,drop,70,70,0,1,0,1,0
51690,445,0,0,drop,70,70,0,1,0,1,0
55633,53,54670,53,allow,816,97,719,2,30,1,1
51654,80,36290,80,allow,170875,6864,164011,255,35,93,162
50052,65008,0,0,deny,60,60,0,1,0,1,0
6666,138,0,0,deny,60,60,0,1,0,1,0
54189,22114,0,0,deny,66,66,0,1,0,1,0
56924,53,50260,53,allow,170,87,83,2,31,1,1
51396,56205,0,0,deny,62,62,0,1,0,1,0
58515,445,0,0,drop,70,70,0,1,0,1,0
43677,443,54935,443,allow,30090,19982,10108,77,543,41,36
53053,64147,0,0,deny,62,62,0,1,0,1,0
57464,443,33460,443,allow,7715,1772,5943,25,275,13,12
55132,445,0,0,drop,70,70,0,1,0,1,0
28132,53,28132,53,allow,176,78,98,2,30,1,1
2073,7000,2073,7000,allow,3566,1999,1567,16,15,8,8
53683,445,0,0,drop,66,66,0,1,0,1,0
52336,443,7480,443,allow,134,60,74,3,10,2,1
59792,445,0,0,drop,70,70,0,1,0,1,0
49281,53,63913,53,allow,251,102,149,2,30,1,1
45549,80,33456,80,allow,1117,762,355,10,255,6,4
32879,443,46058,443,allow,8137,2110,6027,29,394,10,19
60798,40010,54476,40010,allow,316,136,180,6,6,3,3
51035,443,33243,443,allow,2227,1018,1209,17,16,8,9
56864,53,65006,53,allow,200,102,98,2,31,1,1
65343,53,45519,53,allow,328,99,229,4,45,2,2
56945,53,12864,53,allow,180,94,86,2,30,1,1
58805,80,4161,80,allow,1702,1388,314,10,16,5,5
59582,445,0,0,drop,66,66,0,1,0,1,0
64724,53,45753,53,allow,336,110,226,2,30,1,1
54014,445,0,0,drop,70,70,0,1,0,1,0
55199,21247,0,0,deny,66,66,0,1,0,1,0
52009,445,0,0,drop,66,66,0,1,0,1,0
55660,443,55660,443,allow,51312,5706,45606,77,48,38,39
51814,55393,29283,55393,allow,70,70,0,1,4,1,0
52263,445,0,0,drop,66,66,0,1,0,1,0
64677,57470,0,0,deny,66,66,0,1,0,1,0
64106,64147,0,0,deny,62,62,0,1,0,1,0
25878,25174,0,0,deny,66,66,0,1,0,1,0
55273,53,51928,53,allow,166,85,81,2,31,1,1
49275,53,35482,53,allow,195,102,93,2,31,1,1
52122,80,30528,80,allow,4137,1236,2901,27,418,14,13
50256,445,0,0,drop,70,70,0,1,0,1,0
45269,50584,0,0,deny,62,62,0,1,0,1,0
50544,53,48893,53,allow,816,102,714,2,30,1,1
43514,5223,35160,5223,allow,3651,1103,2548,17,1802,10,7
65195,53,58646,53,allow,249,94,155,2,30,1,1
55660,445,0,0,drop,70,70,0,1,0,1,0
1924,80,29370,80,allow,214,140,74,4,15,3,1
56986,2310,0,0,deny,159,159,0,1,0,1,0
51811,20740,61529,20740,allow,70,70,0,2,8,2,0
39213,25174,0,0,deny,62,62,0,1,0,1,0
54989,443,3314,443,allow,7745,2583,5162,27,100,15,12
64235,53,40648,53,allow,197,102,95,2,30,1,1
52150,443,44913,443,allow,5481,3086,2395,26,49,13,13
60816,443,60816,443,allow,1320,685,635,14,182,7,7
55003,53,31448,53,allow,196,102,94,2,30,1,1
60798,443,60798,443,allow,1092,645,447,10,34,6,4
38670,443,55536,443,allow,501559,13849,487710,527,15,193,334
63762,41373,27152,41373,allow,70,70,0,1,4,1,0
7977,25174,0,0,deny,146,146,0,1,0,1,0
58115,445,0,0,drop,70,70,0,1,0,1,0
64707,53,25293,53,allow,216,102,114,2,30,1,1
49990,443,43414,443,allow,622,210,412,10,21,4,6
43260,41615,0,0,deny,145,145,0,1,0,1,0
52126,443,32440,443,allow,12096,3734,8362,53,102,25,28
56729,443,23413,443,allow,8652,2148,6504,20,15,11,9
29606,53,29606,53,allow,216,90,126,2,30,1,1
46983,443,17844,443,allow,2809,1884,925,19,25,11,8
65038,445,0,0,drop,66,66,0,1,0,1,0
51623,445,0,0,drop,70,70,0,1,0,1,0
51112,445,0,0,drop,66,66,0,1,0,1,0
53126,53,53126,53,allow,247,98,149,2,32,1,1
50951,53,0,0,allow,82,82,0,1,30,1,0
49497,443,34229,443,allow,185560,47806,137754,421,295,217,204
62381,445,0,0,drop,66,66,0,1,0,1,0
53435,443,53435,443,allow,2503,1457,1046,21,102,10,11
37052,53,37052,53,allow,178,82,96,2,30,1,1
64324,53,8144,53,allow,179,94,85,2,30,1,1
50537,5223,31982,5223,allow,12710,4688,8022,44,2961,19,25
63763,17368,13988,17368,allow,66,66,0,2,8,2,0
36258,23,0,0,deny,60,60,0,1,0,1,0
50375,1,0,0,allow,74,74,0,1,91,1,0
50358,80,31825,80,allow,318,192,126,6,28,4,2
60943,443,53022,443,allow,4960,896,4064,14,18,8,6
55941,53,27410,53,allow,184,94,90,2,30,1,1
27005,27015,24724,27015,allow,878,126,752,2,30,1,1
58247,57866,0,0,deny,66,66,0,1,0,1,0
1059,44847,0,0,deny,62,62,0,1,0,1,0
36953,443,22801,443,allow,70,70,0,1,5,1,0
55878,7302,0,0,deny,62,62,0,1,0,1,0
49334,53,54606,53,allow,184,94,90,2,31,1,1
59493,44847,0,0,deny,66,66,0,1,0,1,0
50408,53,10616,53,allow,183,94,89,2,30,1,1
27005,1107,18135,1107,allow,824,126,698,2,29,1,1
58614,443,16756,443,allow,12164,4840,7324,29,198,16,13
59404,443,10904,443,allow,2962,1844,1118,16,15,8,8
65240,53,35636,53,allow,755,102,653,2,30,1,1
56119,53,42460,53,allow,198,101,97,2,30,1,1
46099,80,56104,80,allow,70,70,0,2,5,2,0
59988,64147,0,0,deny,66,66,0,1,0,1,0
39540,37965,0,0,deny,66,66,0,1,0,1,0
19787,53,19787,53,allow,414,268,146,3,32,2,1
41316,443,15056,443,allow,4997074,153969,4843105,5249,343,1861,3388
50650,443,2408,443,allow,9741,7503,2238,24,32,14,10
53534,443,20648,443,allow,7639,1831,5808,29,76,15,14
53092,443,57966,443,allow,8071,1789,6282,20,326,10,10
42880,443,28151,443,allow,134,60,74,3,4,2,1
64538,53,57273,53,allow,194,102,92,2,30,1,1
29697,51221,0,0,deny,62,62,0,1,0,1,0
6354,53,6354,53,allow,217,87,130,2,30,1,1
61704,80,4261,80,allow,1555,954,601,14,47,8,6
64947,53,61833,53,allow,275,96,179,4,41,2,2
55582,53,57520,53,allow,177,94,83,2,30,1,1
58949,443,63115,443,allow,5166,700,4466,16,15,7,9
36053,443,36053,443,allow,79562,17054,62508,111,109,54,57
63064,443,24318,443,allow,12008,2367,9641,32,151,18,14
56263,445,0,0,drop,66,66,0,1,0,1,0
61574,445,0,0,drop,70,70,0,1,0,1,0
56314,53,10977,53,allow,183,94,89,2,30,1,1
57168,53,20859,53,allow,760,96,664,2,30,1,1
49332,443,62500,443,allow,27727,1971,25756,51,80,21,30
33255,53,27087,53,allow,86,86,0,1,30,1,0
49827,443,61208,443,allow,5523,3016,2507,36,75,20,16
57396,443,32290,443,allow,152,78,74,2,4,1,1
48982,15000,10476,15000,allow,130,70,60,2,5,1,1
29884,25174,0,0,deny,146,146,0,1,0,1,0
59898,443,21573,443,allow,5429,2835,2594,19,140,9,10
56571,53,30480,53,allow,749,94,655,2,31,1,1
56523,443,56096,443,allow,28479,3138,25341,42,42,17,25
64279,53,15836,53,allow,170,87,83,2,30,1,1
58737,443,61229,443,allow,16417,13221,3196,50,74,31,19
65212,22114,0,0,deny,146,146,0,1,0,1,0
56961,445,0,0,drop,70,70,0,1,0,1,0
21522,80,0,0,deny,60,60,0,1,0,1,0
58932,443,14070,443,allow,1413,876,537,12,28,6,6
62282,445,0,0,drop,66,66,0,1,0,1,0
65514,53,32610,53,allow,214,110,104,2,31,1,1
59017,445,0,0,drop,66,66,0,1,0,1,0
50584,53,13408,53,allow,793,101,692,2,30,1,1
51194,443,35674,443,allow,1561,768,793,17,185,9,8
59430,50584,0,0,deny,66,66,0,1,0,1,0
62293,443,17682,443,allow,598,598,0,8,40,8,0
57000,53,37935,53,allow,193,94,99,2,30,1,1
55398,445,0,0,drop,70,70,0,1,0,1,0
55339,445,0,0,drop,70,70,0,1,0,1,0
50598,445,0,0,drop,70,70,0,1,0,1,0
65336,445,0,0,drop,70,70,0,1,0,1,0
28498,36237,0,0,deny,62,62,0,1,0,1,0
56497,53,5207,53,allow,214,110,104,2,30,1,1
53687,51471,5153,51471,allow,70,70,0,1,5,1,0
52618,80,60049,80,allow,1141,529,612,10,18,6,4
54081,443,47129,443,allow,444890,27602,417288,580,176,265,315
54926,6789,33904,6789,allow,124239,48650,75589,1342,84,628,714
60470,443,16410,443,allow,7289,1899,5390,29,317,16,13
54996,80,15340,80,allow,1979,826,1153,13,17,9,4
51947,445,0,0,drop,70,70,0,1,0,1,0
9318,443,40235,443,allow,3649,424,3225,12,15,6,6
58131,42416,0,0,deny,146,146,0,1,0,1,0
54471,445,0,0,drop,66,66,0,1,0,1,0
55692,53,4863,53,allow,198,102,96,2,29,1,1
10427,32480,0,0,deny,66,66,0,1,0,1,0
49235,53,43539,53,allow,164,78,86,2,29,1,1
56004,53,60416,53,allow,178,94,84,2,29,1,1
50584,49533,38774,49533,allow,161,161,0,1,1200,1,0
55089,80,46073,80,allow,1558,452,1106,11,15,6,5
35719,443,27839,443,allow,9736,4347,5389,23,361,11,12
50880,445,0,0,drop,70,70,0,1,0,1,0
61347,443,30207,443,allow,5589,2260,3329,36,217,17,19
42917,52952,0,0,deny,62,62,0,1,0,1,0
55618,45341,55864,45341,allow,70,70,0,2,8,2,0
55463,53,33769,53,allow,216,110,106,2,29,1,1
49418,27015,47844,27015,allow,214,71,143,2,30,1,1
35350,443,47252,443,allow,13168,2505,10663,21,121,9,12
55120,445,0,0,drop,70,70,0,1,0,1,0
55173,445,0,0,drop,70,70,0,1,0,1,0
56151,445,0,0,drop,70,70,0,1,0,1,0
28345,11392,0,0,deny,66,66,0,1,0,1,0
50237,443,44543,443,allow,2994,1521,1473,15,83,9,6
43440,80,5073,80,allow,2093,825,1268,12,45,7,5
60714,50584,0,0,deny,66,66,0,1,0,1,0
60132,50584,0,0,deny,62,62,0,1,0,1,0
6881,48533,62658,48533,allow,502,150,352,2,1199,1,1
51149,443,26017,443,allow,5092,2574,2518,14,135,7,7
443,37338,0,0,deny,118,118,0,1,0,1,0
1865,25174,0,0,deny,62,62,0,1,0,1,0
52618,445,0,0,drop,66,66,0,1,0,1,0
47856,443,54908,443,allow,7816,2371,5445,34,255,18,16
50375,53,64896,53,allow,211,110,101,2,30,1,1
55315,53,5468,53,allow,196,102,94,2,31,1,1
45908,33330,0,0,deny,60,60,0,1,0,1,0
64615,53,56632,53,allow,395,89,306,4,32,2,2
61978,445,0,0,drop,66,66,0,1,0,1,0
64786,53,39238,53,allow,810,108,702,2,31,1,1
57271,445,0,0,drop,66,66,0,1,0,1,0
51980,80,2288,80,allow,366,240,126,7,25,5,2
63948,445,0,0,drop,70,70,0,1,0,1,0
24236,8055,0,0,deny,148,148,0,1,0,1,0
64618,53,55916,53,allow,198,102,96,2,31,1,1
49776,53,42364,53,allow,182,94,88,2,30,1,1
49935,53,55130,53,allow,458,111,347,4,59,2,2
45227,80,43141,80,allow,1114,534,580,12,16,7,5
59994,53,59994,53,allow,86,86,0,1,29,1,0
58298,445,0,0,drop,66,66,0,1,0,1,0
51455,53733,0,0,deny,66,66,0,1,0,1,0
48354,5222,3961,5222,allow,7786,1403,6383,44,434,15,29
4184,53,4184,53,allow,216,90,126,2,29,1,1
60117,445,0,0,drop,70,70,0,1,0,1,0
57367,53,32502,53,allow,177,94,83,2,30,1,1
21294,57470,0,0,deny,62,62,0,1,0,1,0
53815,44847,0,0,deny,66,66,0,1,0,1,0
56030,445,0,0,drop,70,70,0,1,0,1,0
49044,443,55687,443,allow,5150,853,4297,16,27,9,7
55879,53,11765,53,allow,184,94,90,2,30,1,1
54601,26467,0,0,deny,66,66,0,1,0,1,0
57643,80,14145,80,allow,172,172,0,2,5,2,0
57012,53,13483,53,allow,230,86,144,2,29,1,1
63318,445,0,0,drop,70,70,0,1,0,1,0
47135,53,52086,53,allow,199,94,105,2,30,1,1
52160,443,26040,443,allow,956,420,536,15,26,7,8
60403,22114,0,0,deny,66,66,0,1,0,1,0
64493,53,45305,53,allow,198,101,97,2,30,1,1
61791,445,0,0,drop,70,70,0,1,0,1,0
65337,53,53258,53,allow,460,112,348,4,56,2,2
51110,445,0,0,drop,66,66,0,1,0,1,0
63993,17866,56109,17866,allow,4607,2045,2562,24,45,14,10
56439,445,0,0,drop,70,70,0,1,0,1,0
53720,50795,49301,50795,allow,320,140,180,6,7,3,3
33931,50584,0,0,deny,62,62,0,1,0,1,0
64128,53,32109,53,allow,186,95,91,2,30,1,1
49424,53,45939,53,allow,198,102,96,2,32,1,1
52076,28895,42169,28895,allow,70,70,0,2,8,2,0
57996,53,57996,53,allow,265,114,151,2,30,1,1
1926,53,62848,53,allow,210,78,132,2,30,1,1
51965,48708,36849,48708,allow,66,66,0,1,5,1,0
53586,44515,38182,44515,allow,678,432,246,10,15,6,4
65351,53,49727,53,allow,228,110,118,2,30,1,1
50584,53,23534,53,allow,744,89,655,2,31,1,1
49202,31719,45347,31719,allow,70,70,0,2,8,2,0
40907,443,19035,443,allow,7183,1824,5359,27,316,14,13
51670,443,38480,443,allow,1203,703,500,14,38,8,6
44227,443,19248,443,allow,7491,1930,5561,26,263,14,12
60180,53,36445,53,allow,225,110,115,2,30,1,1
60367,53,22365,53,allow,233,110,123,2,30,1,1
42298,40025,58686,40025,allow,140,78,62,2,31,1,1
30084,21247,0,0,deny,146,146,0,1,0,1,0
63300,445,0,0,drop,70,70,0,1,0,1,0
49934,445,0,0,drop,70,70,0,1,0,1,0
11066,50584,0,0,deny,66,66,0,1,0,1,0
35894,53,14493,53,allow,198,93,105,2,30,1,1
56163,53,47516,53,allow,265,85,180,4,41,2,2
0,0,0,0,deny,182,182,0,1,0,1,0
59518,445,0,0,drop,70,70,0,1,0,1,0
58638,5900,0,0,deny,62,62,0,1,0,1,0
63437,445,0,0,drop,66,66,0,1,0,1,0
14023,37965,0,0,deny,62,62,0,1,0,1,0
53904,443,54254,443,allow,495,421,74,4,0,3,1
48285,8080,0,0,allow,184,78,106,3,10,2,1
50084,26672,0,0,deny,62,62,0,1,0,1,0
56215,53,1097,53,allow,216,110,106,2,30,1,1
53151,34935,46356,34935,allow,698,320,378,10,17,6,4
60776,4156,9252,4156,allow,70,70,0,2,8,2,0
6889,5529,0,0,deny,143,143,0,1,0,1,0
34183,443,44472,443,allow,10459,2529,7930,31,375,13,18
53979,26308,39677,26308,allow,70,70,0,2,7,2,0
62042,445,0,0,drop,66,66,0,1,0,1,0
51490,445,0,0,drop,66,66,0,1,0,1,0
61379,445,0,0,drop,70,70,0,1,0,1,0
55711,53,17367,53,allow,177,94,83,2,30,1,1
39615,443,10074,443,allow,6133,1343,4790,22,275,12,10
55254,50584,0,0,deny,66,66,0,1,0,1,0
65131,445,0,0,drop,70,70,0,1,0,1,0
30181,61689,0,0,deny,62,62,0,1,0,1,0
64422,53,39408,53,allow,180,94,86,2,31,1,1
55717,13517,54958,13517,allow,70,70,0,1,5,1,0
2394,43890,0,0,deny,62,62,0,1,0,1,0
43679,44847,0,0,deny,62,62,0,1,0,1,0
50498,80,12035,80,allow,312,192,120,6,25,4,2
55609,39869,9261,39869,allow,70,70,0,2,8,2,0
52678,445,0,0,drop,66,66,0,1,0,1,0
57570,443,57570,443,allow,175212,28668,146544,186,180,69,117
37390,80,51104,80,allow,234,234,0,4,12,4,0
58701,80,43595,80,allow,12499310,161518,12337792,10496,70,2325,8171
55951,30188,0,0,deny,66,66,0,1,0,1,0
52340,64147,0,0,deny,66,66,0,1,0,1,0
55573,445,0,0,drop,66,66,0,1,0,1,0
65460,53,1825,53,allow,177,94,83,2,30,1,1
49242,53,7199,53,allow,166,85,81,2,31,1,1
58022,7474,0,0,deny,60,60,0,1,0,1,0
49983,53,57759,53,allow,211,110,101,2,30,1,1
64180,53,29611,53,allow,180,94,86,2,31,1,1
6881,6881,0,0,deny,146,146,0,1,0,1,0
49418,27200,10128,27200,allow,78,78,0,1,30,1,0
60970,20541,0,0,deny,66,66,0,1,0,1,0
58638,5900,0,0,deny,62,62,0,1,0,1,0
9453,443,40885,443,allow,5693,499,5194,14,15,7,7
54329,443,7872,443,allow,7827,2416,5411,18,136,8,10
23270,443,23270,443,allow,5802,2592,3210,24,76,14,10
52094,445,0,0,drop,70,70,0,1,0,1,0
55238,443,7974,443,allow,6186,1650,4536,20,16,11,9
50031,53,15521,53,allow,181,94,87,2,30,1,1
52108,445,0,0,drop,66,66,0,1,0,1,0
58248,50584,0,0,deny,62,62,0,1,0,1,0
53766,51505,0,0,deny,62,62,0,1,0,1,0
61318,445,0,0,drop,70,70,0,1,0,1,0
60423,52001,49584,52001,allow,260,140,120,5,9,3,2
55529,44847,0,0,deny,66,66,0,1,0,1,0
38859,22114,0,0,deny,66,66,0,1,0,1,0
25469,57470,0,0,deny,62,62,0,1,0,1,0
49737,53,3736,53,allow,338,110,228,2,30,1,1
62035,445,0,0,drop,70,70,0,1,0,1,0
43487,443,46134,443,allow,10015,3476,6539,30,28,19,11
42971,3478,30951,3478,allow,312,140,172,4,30,2,2
54115,443,7544,443,allow,6840,1394,5446,29,270,14,15
57149,445,0,0,drop,70,70,0,1,0,1,0
50463,445,0,0,drop,70,70,0,1,0,1,0
59570,443,28825,443,allow,24203,14278,9925,168,320,74,94
42298,40042,19672,40042,allow,148,86,62,2,30,1,1
46525,5228,57899,5228,allow,1410,933,477,11,3601,6,5
11136,15503,0,0,deny,62,62,0,1,0,1,0
43584,24748,0,0,deny,156,156,0,1,0,1,0
9249,443,2759,443,allow,6132,767,5365,17,26,9,8
57132,53,11896,53,allow,216,110,106,2,31,1,1
52348,80,52348,80,allow,2910,1489,1421,10,16,6,4
53405,445,0,0,drop,66,66,0,1,0,1,0
49878,53,34561,53,allow,216,94,122,2,30,1,1
59271,445,0,0,drop,66,66,0,1,0,1,0
60875,56205,0,0,deny,66,66,0,1,0,1,0
50411,445,0,0,drop,66,66,0,1,0,1,0
55022,80,15142,80,allow,1080714,29230,1051484,1137,174,436,701
53466,25174,0,0,deny,146,146,0,1,0,1,0
53970,1024,11868,1024,allow,260,140,120,5,6,3,2
50137,445,0,0,drop,70,70,0,1,0,1,0
62088,56205,0,0,deny,62,62,0,1,0,1,0
58552,445,0,0,drop,66,66,0,1,0,1,0
54134,64147,0,0,deny,66,66,0,1,0,1,0
41128,443,53510,443,allow,3474,2349,1125,29,3438,17,12
45964,55559,0,0,deny,60,60,0,1,0,1,0
63034,443,51705,443,allow,37694,8319,29375,85,153,36,49
6712,123,0,0,deny,90,90,0,1,0,1,0
53856,445,0,0,drop,70,70,0,1,0,1,0
51414,22,0,0,deny,60,60,0,1,0,1,0
53546,445,0,0,drop,70,70,0,1,0,1,0
55981,80,6270,80,allow,130,70,60,2,15,1,1
56611,53,59791,53,allow,181,94,87,2,31,1,1
52168,445,0,0,drop,66,66,0,1,0,1,0
61180,445,0,0,drop,70,70,0,1,0,1,0
34891,53,37025,53,allow,396,257,139,3,30,2,1
52208,80,51352,80,allow,372,246,126,6,28,4,2
50063,443,44505,443,allow,39888,5010,34878,60,104,32,28
62137,445,0,0,drop,70,70,0,1,0,1,0
42699,5222,6919,5222,allow,420,156,264,7,18,3,4
61399,445,0,0,drop,66,66,0,1,0,1,0
42604,443,37985,443,allow,3243,2026,1217,16,15,8,8
56567,53,28811,53,allow,194,102,92,2,31,1,1
64125,53,22287,53,allow,199,102,97,2,31,1,1
49700,443,6522,443,allow,39240,3804,35436,72,133,38,34
49649,443,20901,443,allow,10099,1721,8378,27,46,14,13
51861,53,51861,53,allow,305,160,145,3,33,2,1
40547,24051,0,0,deny,74,74,0,1,0,1,0
52283,445,0,0,drop,66,66,0,1,0,1,0
16905,57866,0,0,deny,66,66,0,1,0,1,0
50935,445,0,0,drop,70,70,0,1,0,1,0
55804,80,55804,80,allow,424,198,226,7,143,4,3
52348,445,0,0,drop,66,66,0,1,0,1,0
49349,443,17096,443,allow,5282,1090,4192,17,25,10,7
56907,53,30481,53,allow,186,95,91,2,30,1,1
58700,443,30626,443,allow,8124,1079,7045,16,26,8,8
54862,445,0,0,drop,70,70,0,1,0,1,0
41925,443,48625,443,allow,8333,2153,6180,31,100,18,13
60214,445,0,0,drop,66,66,0,1,0,1,0
51121,443,8150,443,allow,5553,2844,2709,21,30,11,10
50705,445,0,0,drop,70,70,0,1,0,1,0
46423,443,25968,443,allow,1340,760,580,14,39,8,6
50103,53,21620,53,allow,168,86,82,2,30,1,1
24351,57470,0,0,deny,62,62,0,1,0,1,0
49305,445,0,0,drop,70,70,0,1,0,1,0
55286,53,55062,53,allow,188,96,92,2,30,1,1
64519,53,20237,53,allow,277,94,183,4,60,2,2
49246,53,4565,53,allow,177,94,83,2,30,1,1
50102,17546,0,0,deny,66,66,0,1,0,1,0
34219,53,25349,53,allow,199,94,105,2,30,1,1
61476,443,42404,443,allow,230640,12863,217777,253,62,98,155
53132,29384,35704,29384,allow,70,70,0,1,5,1,0
6881,49001,20436,49001,allow,210,111,99,2,1201,1,1
65048,53,24505,53,allow,396,84,312,4,54,2,2
45499,443,58024,443,allow,17031,8260,8771,39,128,19,20
57984,80,44496,80,allow,5474,3658,1816,27,76,14,13
58765,445,0,0,drop,70,70,0,1,0,1,0
59125,445,0,0,drop,70,70,0,1,0,1,0
50406,445,0,0,drop,70,70,0,1,0,1,0
44894,443,39327,443,allow,1849,1130,719,17,36,9,8
65245,445,0,0,drop,70,70,0,1,0,1,0
6881,6881,0,0,deny,62,62,0,1,0,1,0
55760,445,0,0,drop,66,66,0,1,0,1,0
55733,53,46441,53,allow,463,128,335,4,41,2,2
49837,53,39920,53,allow,212,108,104,2,30,1,1
59788,445,0,0,drop,70,70,0,1,0,1,0
49057,5900,0,0,deny,60,60,0,1,0,1,0
58195,38303,0,0,deny,66,66,0,1,0,1,0
50512,445,0,0,drop,70,70,0,1,0,1,0
49203,53,4131,53,allow,403,99,304,4,32,2,2
58040,445,0,0,drop,66,66,0,1,0,1,0
56769,53,28212,53,allow,182,93,89,2,30,1,1
57655,56205,0,0,deny,66,66,0,1,0,1,0
62554,445,0,0,drop,70,70,0,1,0,1,0
58663,53,40233,53,allow,167,78,89,2,30,1,1
39927,443,15384,443,allow,7787,2370,5417,23,242,11,12
55024,53,28341,53,allow,168,86,82,2,30,1,1
50226,443,45230,443,allow,7726,4613,3113,21,137,11,10
58386,445,0,0,drop,70,70,0,1,0,1,0
60871,443,15673,443,allow,95311,21869,73442,140,62,61,79
53795,22719,37217,22719,allow,258,70,188,4,8,2,2
55770,53,54138,53,allow,167,86,81,2,30,1,1
55979,53,36976,53,allow,186,95,91,2,31,1,1
64320,53,61236,53,allow,199,102,97,2,30,1,1
44187,53,44187,53,allow,233,90,143,2,32,1,1
52537,37965,0,0,deny,62,62,0,1,0,1,0
57190,53,17320,53,allow,757,102,655,2,30,1,1
51102,80,31602,80,allow,2794,2075,719,15,30,9,6
50460,443,12819,443,allow,1346,918,428,10,31,6,4
57438,53,26523,53,allow,340,110,230,2,29,1,1
50149,445,0,0,drop,70,70,0,1,0,1,0
11136,15503,0,0,deny,62,62,0,1,0,1,0
36881,56205,0,0,deny,146,146,0,1,0,1,0
49175,443,3024,443,allow,4429,2593,1836,34,1126,18,16
55232,53,4973,53,allow,177,94,83,2,30,1,1
38260,443,50232,443,allow,7173,1419,5754,32,383,11,21
39390,15503,0,0,deny,74,74,0,1,0,1,0
51064,5529,0,0,deny,146,146,0,1,0,1,0
50927,445,0,0,drop,66,66,0,1,0,1,0
53176,445,0,0,drop,70,70,0,1,0,1,0
52327,443,53473,443,allow,134,60,74,3,6,2,1
55502,445,0,0,drop,66,66,0,1,0,1,0
49171,443,1136,443,allow,15437,8368,7069,40,361,19,21
55990,53,30769,53,allow,183,94,89,2,30,1,1
61937,443,25012,443,allow,24420,19966,4454,64,136,35,29
65079,445,0,0,drop,70,70,0,1,0,1,0
55169,53,64266,53,allow,775,103,672,2,30,1,1
27005,27015,11891,27015,allow,885,126,759,2,30,1,1
40103,443,5740,443,allow,416,210,206,7,34,4,3
15677,64147,0,0,deny,145,145,0,1,0,1,0
58292,445,0,0,drop,66,66,0,1,0,1,0
80,5101,0,0,deny,78,78,0,1,0,1,0
55526,53,8264,53,allow,250,86,164,2,30,1,1
55088,53,34841,53,allow,177,94,83,2,30,1,1
56538,443,45521,443,allow,7760,1599,6161,23,80,13,10
49907,53,31143,53,allow,363,98,265,4,54,2,2
55062,53,13920,53,allow,733,86,647,2,31,1,1
56000,445,0,0,drop,70,70,0,1,0,1,0
37640,443,4915,443,allow,11442,3116,8326,32,46,19,13
58638,5900,0,0,deny,62,62,0,1,0,1,0
56555,53,42493,53,allow,348,94,254,2,30,1,1
62532,57354,0,0,deny,159,159,0,1,0,1,0
49498,443,36900,443,allow,267319,11446,255873,336,192,117,219
60875,443,60875,443,allow,1092,645,447,10,34,6,4
43563,443,50861,443,allow,466,392,74,4,0,3,1
29011,7000,29011,7000,allow,3756,2125,1631,18,17,10,8
53018,443,37160,443,allow,6352,1552,4800,23,17,12,11
64586,50584,0,0,deny,62,62,0,1,0,1,0
49185,53,26156,53,allow,307,94,213,2,29,1,1
56783,21279,18481,21279,allow,70,70,0,2,8,2,0
51998,80,30634,80,allow,52288,7809,44479,105,37,40,65
56415,53,13196,53,allow,199,102,97,2,29,1,1
57886,53,57886,53,allow,216,90,126,2,29,1,1
55862,62413,0,0,deny,62,62,0,1,0,1,0
38711,443,23557,443,allow,459089,10521,448568,449,16,141,308
21759,51505,0,0,deny,62,62,0,1,0,1,0
49922,445,0,0,drop,70,70,0,1,0,1,0
65489,445,0,0,drop,70,70,0,1,0,1,0
63817,50808,64390,50808,allow,70,70,0,1,4,1,0
6889,47807,0,0,deny,143,143,0,1,0,1,0
63239,445,0,0,drop,66,66,0,1,0,1,0
39223,80,40485,80,allow,1052,612,440,10,15,5,5
61363,443,19587,443,allow,7653,1226,6427,24,18,14,10
64546,57470,0,0,deny,66,66,0,1,0,1,0
54351,53,59901,53,allow,168,78,90,2,29,1,1
54278,445,0,0,drop,70,70,0,1,0,1,0
63591,443,24703,443,allow,11746,3874,7872,44,141,22,22
58468,57587,0,0,deny,66,66,0,1,0,1,0
53985,30188,0,0,deny,62,62,0,1,0,1,0
56639,443,28147,443,allow,7849,1860,5989,20,16,11,9
56374,53,12810,53,allow,177,94,83,2,29,1,1
55862,62413,0,0,deny,66,66,0,1,0,1,0
0,0,0,0,allow,200,102,98,2,0,1,1
22633,53,0,0,allow,300,90,210,2,30,1,1
50623,443,64489,443,allow,1350,773,577,15,107,8,7
65244,445,0,0,drop,66,66,0,1,0,1,0
28370,23,0,0,deny,60,60,0,1,0,1,0
19632,37965,0,0,deny,62,62,0,1,0,1,0
55542,53,50778,53,allow,177,94,83,2,30,1,1
54227,443,59982,443,allow,499,425,74,4,0,3,1
41780,53,0,0,allow,86,86,0,1,30,1,0
55931,53,3407,53,allow,168,78,90,2,30,1,1
28013,443,29765,443,allow,6130,1264,4866,18,75,9,9
35610,37965,0,0,deny,62,62,0,1,0,1,0
52847,53,50629,53,allow,86,86,0,1,30,1,0
55223,53,34886,53,allow,168,86,82,2,31,1,1
64741,53,9431,53,allow,715,94,621,2,29,1,1
56793,14902,9937,14902,allow,264,70,194,4,19,1,3
443,23133,0,0,deny,97,97,0,1,0,1,0
60228,443,13572,443,allow,1058,641,417,10,50,6,4
56896,53,19605,53,allow,256,87,169,2,30,1,1
55481,445,0,0,drop,66,66,0,1,0,1,0
46212,443,38830,443,allow,67265,57889,9376,174,102,98,76
58463,53,64645,53,allow,380,88,292,2,30,1,1
57897,443,36818,443,allow,1865,1226,639,18,176,11,7
62331,61689,0,0,deny,66,66,0,1,0,1,0
53687,19010,53687,19010,allow,64,64,0,1,30,1,0
54654,6881,17557,6881,allow,470,348,122,6,26,4,2
52987,445,0,0,drop,66,66,0,1,0,1,0
60825,445,0,0,drop,66,66,0,1,0,1,0
54470,443,54470,443,allow,101021,6173,94848,142,18,65,77
59477,36829,0,0,deny,66,66,0,1,0,1,0
47825,443,54151,443,allow,932130,36511,895619,1142,167,465,677
51329,445,0,0,drop,70,70,0,1,0,1,0
56582,23718,0,0,deny,62,62,0,1,0,1,0
52086,445,0,0,drop,66,66,0,1,0,1,0
58013,445,0,0,drop,70,70,0,1,0,1,0
50578,445,0,0,drop,70,70,0,1,0,1,0
50605,80,50605,80,allow,2909,1798,1111,14,23,8,6
58771,445,0,0,drop,70,70,0,1,0,1,0
0,0,0,0,allow,156,156,0,2,0,2,0
5753,65473,0,0,deny,146,146,0,1,0,1,0
36191,443,31290,443,allow,9386,1934,7452,32,135,17,15
58058,53,63439,53,allow,168,78,90,2,29,1,1
55633,445,0,0,drop,70,70,0,1,0,1,0
64021,53,54662,53,allow,195,102,93,2,30,1,1
52838,443,36112,443,allow,14518,10453,4065,43,120,21,22
47516,80,2518,80,allow,956,541,415,11,316,6,5
51754,18375,0,0,deny,66,66,0,1,0,1,0
35939,443,12067,443,allow,9111,2919,6192,27,19,14,13
57453,443,43967,443,allow,2233,1347,886,23,135,13,10
49364,53,13056,53,allow,307,307,0,4,60,4,0
45941,23386,0,0,deny,60,60,0,1,0,1,0
44929,443,44929,443,allow,5469,2222,3247,22,38,13,9
37546,80,60597,80,allow,10438,979,9459,21,38,11,10
21870,53,21870,53,allow,209,77,132,2,32,1,1
36656,64147,0,0,deny,62,62,0,1,0,1,0
9588,37965,0,0,deny,62,62,0,1,0,1,0
63657,445,0,0,drop,70,70,0,1,0,1,0
37244,53,37244,53,allow,172,76,96,2,30,1,1
51034,445,0,0,drop,70,70,0,1,0,1,0
52896,80,13613,80,allow,3020,1414,1606,30,118,16,14
61483,443,51261,443,allow,107901,5004,102897,127,46,53,74
3937,36829,0,0,deny,62,62,0,1,0,1,0
45118,15000,63789,15000,allow,130,70,60,2,6,1,1
64548,445,0,0,drop,70,70,0,1,0,1,0
54976,443,15305,443,allow,10335,2317,8018,24,188,13,11
62048,445,0,0,drop,70,70,0,1,0,1,0
50226,80,43900,80,allow,9659,1454,8205,28,278,13,15
2267,53,57413,53,allow,204,118,86,2,31,1,1
42469,80,53240,80,allow,2169,1419,750,10,15,6,4
64169,445,0,0,drop,70,70,0,1,0,1,0
49631,53,37899,53,allow,184,102,82,2,30,1,1
42898,443,46834,443,allow,4999,2845,2154,41,87,22,19
30114,65151,0,0,deny,60,60,0,1,0,1,0
57255,445,0,0,drop,70,70,0,1,0,1,0
0,0,0,0,allow,244,244,0,2,0,2,0
58811,53976,0,0,deny,66,66,0,1,0,1,0
50470,61463,0,0,deny,86,86,0,1,0,1,0
56233,80,56233,80,allow,44955,1023,43932,48,15,15,33
20563,21247,0,0,deny,66,66,0,1,0,1,0
50458,445,0,0,drop,70,70,0,1,0,1,0
10850,53,10850,53,allow,237,91,146,2,34,1,1
38368,443,41740,443,allow,4392,1164,3228,17,34,9,8
58790,443,27687,443,allow,3558,2453,1105,17,15,9,8
64396,53,1161,53,allow,211,102,109,2,30,1,1
64093,64828,28561,64828,allow,66,66,0,2,7,2,0
54883,445,0,0,drop,70,70,0,1,0,1,0
58497,443,60144,443,allow,1640,831,809,18,43,10,8
64241,445,0,0,drop,70,70,0,1,0,1,0
27005,30005,39246,30005,allow,890,126,764,2,31,1,1
58982,443,29770,443,allow,6400453,202937,6197516,6806,226,2259,4547
53429,445,0,0,drop,70,70,0,1,0,1,0
59096,8604,0,0,deny,66,66,0,1,0,1,0
56174,445,0,0,drop,70,70,0,1,0,1,0
63870,6881,42274,6881,allow,66,66,0,2,7,2,0
1024,57470,0,0,deny,62,62,0,1,0,1,0
4773,53,4773,53,allow,197,90,107,2,30,1,1
55376,53,17349,53,allow,199,102,97,2,30,1,1
38056,443,15075,443,allow,9528,2738,6790,27,81,15,12
50010,53,37943,53,allow,205,86,119,2,30,1,1
42298,40007,30822,40007,allow,143,81,62,2,31,1,1
63988,22114,0,0,deny,66,66,0,1,0,1,0
43094,443,34606,443,allow,6443,1973,4470,19,16,11,8
64068,53,31141,53,allow,168,86,82,2,30,1,1
58638,5900,0,0,deny,62,62,0,1,0,1,0
55553,37965,0,0,deny,66,66,0,1,0,1,0
55059,445,0,0,drop,70,70,0,1,0,1,0
40992,443,49820,443,allow,8705,3570,5135,35,100,20,15
61867,445,0,0,drop,70,70,0,1,0,1,0
49851,443,11118,443,allow,6058,1038,5020,20,71,11,9
10000,10214,0,0,deny,62,62,0,1,0,1,0
12821,37965,0,0,deny,66,66,0,1,0,1,0
53644,445,0,0,drop,70,70,0,1,0,1,0
34076,53,22329,53,allow,168,78,90,2,30,1,1
10329,7774,0,0,deny,143,143,0,1,0,1,0
49577,53,58264,53,allow,389,134,255,2,29,1,1
19632,37965,0,0,deny,62,62,0,1,0,1,0
25090,9192,0,0,deny,145,145,0,1,0,1,0
25889,11446,0,0,deny,66,66,0,1,0,1,0
50799,37807,0,0,deny,66,66,0,1,0,1,0
55090,53,47013,53,allow,192,98,94,2,30,1,1
53460,445,0,0,drop,70,70,0,1,0,1,0
36361,80,36361,80,allow,514,246,268,9,76,5,4
57681,53,57681,53,allow,220,100,120,2,31,1,1
55684,80,6722,80,allow,70,70,0,2,8,2,0
56196,53,30280,53,allow,214,110,104,2,29,1,1
55884,53,23694,53,allow,438,180,258,6,30,3,3
47836,443,38604,443,allow,36324,2308,34016,55,81,22,33
57281,445,0,0,drop,70,70,0,1,0,1,0
57070,445,0,0,drop,70,70,0,1,0,1,0
33818,53,62977,53,allow,168,78,90,2,30,1,1
55529,445,0,0,drop,66,66,0,1,0,1,0
64945,53,44242,53,allow,243,94,149,2,30,1,1
64789,53,62569,53,allow,816,102,714,2,30,1,1
57175,445,0,0,drop,70,70,0,1,0,1,0
3802,55777,0,0,deny,66,66,0,1,0,1,0
65186,27126,54671,27126,allow,268,78,190,2,30,1,1
65426,443,27740,443,allow,14205,1527,12678,13,145,2,11
58638,5900,0,0,deny,62,62,0,1,0,1,0
51357,80,45603,80,allow,124,64,60,2,16,1,1
56619,443,13830,443,allow,7982,1962,6020,20,15,11,9
59531,445,0,0,drop,66,66,0,1,0,1,0
50391,443,17235,443,allow,5968,985,4983,17,29,8,9
55762,53,8136,53,allow,196,86,110,2,29,1,1
57377,443,4552,443,allow,5553,927,4626,16,15,10,6
64697,53,51206,53,allow,199,102,97,2,30,1,1
49374,53,45816,53,allow,193,102,91,2,30,1,1
60110,445,0,0,drop,70,70,0,1,0,1,0
56586,53,7577,53,allow,754,94,660,2,31,1,1
33829,443,29338,443,allow,568,222,346,9,26,4,5
51586,445,0,0,drop,66,66,0,1,0,1,0
49482,53,61985,53,allow,460,84,376,4,46,2,2
51977,18504,5519,18504,allow,70,70,0,1,5,1,0
56386,53,9835,53,allow,177,94,83,2,31,1,1
55431,53,1200,53,allow,196,102,94,2,31,1,1
56526,53,41730,53,allow,168,94,74,2,30,1,1
52837,443,26069,443,allow,843201,50940,792261,1191,159,451,740
52076,80,2859,80,allow,366,240,126,7,26,5,2
51910,80,31121,80,allow,4994,3658,1336,11,26,6,5
43841,443,59699,443,allow,6516,3085,3431,33,80,17,16
64331,53,61619,53,allow,179,94,85,2,30,1,1
56688,53,52079,53,allow,196,102,94,2,31,1,1
62217,37807,0,0,deny,66,66,0,1,0,1,0
61244,445,0,0,drop,70,70,0,1,0,1,0
49166,53,45421,53,allow,770,101,669,2,31,1,1
38867,53,38867,53,allow,213,79,134,2,32,1,1
59226,53,59226,53,allow,194,87,107,2,30,1,1
443,4205,0,0,deny,320,320,0,1,0,1,0
59405,443,1405,443,allow,276,70,206,5,26,2,3
56805,53,62222,53,allow,815,95,720,2,31,1,1
55235,53,63921,53,allow,178,94,84,2,30,1,1
57745,445,0,0,drop,70,70,0,1,0,1,0
49537,53,25046,53,allow,269,96,173,4,59,2,2
20576,37965,0,0,deny,62,62,0,1,0,1,0
54621,26296,0,0,deny,145,145,0,1,0,1,0
49513,53,13327,53,allow,200,102,98,2,31,1,1
56381,443,16712,443,allow,7236,2290,4946,18,16,11,7
35195,443,32117,443,allow,3672,1259,2413,16,120,8,8
50166,80,59884,80,allow,2181,849,1332,14,97,7,7
57345,445,0,0,drop,66,66,0,1,0,1,0
13956,53,13956,53,allow,244,98,146,2,34,1,1
31710,53,31710,53,allow,233,90,143,2,32,1,1
30800,25174,0,0,deny,62,62,0,1,0,1,0
7521,20234,0,0,deny,157,157,0,1,0,1,0
56583,53,33992,53,allow,177,94,83,2,29,1,1
57281,53,14335,53,allow,178,94,84,2,30,1,1
50788,48817,0,0,deny,66,66,0,1,0,1,0
0,0,0,0,allow,134,64,70,2,0,1,1
49961,53,9720,53,allow,327,126,201,2,30,1,1
52651,53,52651,53,allow,414,268,146,3,31,2,1
9327,57470,0,0,deny,62,62,0,1,0,1,0
51445,445,0,0,drop,66,66,0,1,0,1,0
55640,445,0,0,drop,70,70,0,1,0,1,0
27005,27015,1344,27015,allow,880,126,754,3,31,2,1
39484,80,6764,80,allow,1403,651,752,10,16,6,4
50696,80,3909,80,allow,55872,28838,27034,234,175,117,117
64456,53,28818,53,allow,341,110,231,2,29,1,1
54503,443,54503,443,allow,157452,26878,130574,213,214,111,102
40840,21247,0,0,deny,62,62,0,1,0,1,0
55719,13302,11300,13302,allow,70,70,0,2,8,2,0
16620,25174,0,0,deny,62,62,0,1,0,1,0
48676,53393,0,0,deny,60,60,0,1,0,1,0
59597,37965,0,0,deny,66,66,0,1,0,1,0
50673,445,0,0,drop,70,70,0,1,0,1,0
58326,50584,0,0,deny,146,146,0,1,0,1,0
64144,53,27291,53,allow,193,102,91,2,31,1,1
55704,53,57746,53,allow,193,102,91,2,30,1,1
49861,53,56690,53,allow,198,102,96,2,31,1,1
29139,64147,0,0,deny,62,62,0,1,0,1,0
55029,443,11495,443,allow,7682,3198,4484,27,17,16,11
62569,44847,0,0,deny,66,66,0,1,0,1,0
46101,80,15092,80,allow,70,70,0,2,5,2,0
57122,53,32018,53,allow,216,110,106,2,30,1,1
59899,445,0,0,drop,66,66,0,1,0,1,0
53355,23117,0,0,deny,62,62,0,1,0,1,0
65323,53,29690,53,allow,816,102,714,2,30,1,1
45963,443,45963,443,allow,4592,1685,2907,19,27,11,8
55503,53,44075,53,allow,216,110,106,2,30,1,1
62864,445,0,0,drop,70,70,0,1,0,1,0
63087,443,39607,443,allow,448,166,282,2,31,1,1
17027,1,0,0,deny,62,62,0,1,0,1,0
64309,53,55479,53,allow,549,188,361,6,57,3,3
58638,5900,0,0,deny,62,62,0,1,0,1,0
60957,443,60957,443,allow,70839,5466,65373,98,19,47,51
11295,40032,25935,40032,allow,148,86,62,2,30,1,1
63863,34678,27822,34678,allow,504,382,122,8,15,6,2
65388,445,0,0,drop,70,70,0,1,0,1,0
55877,51413,55340,51413,allow,460,150,310,2,1200,1,1
56614,443,40071,443,allow,8034,2014,6020,20,15,11,9
58690,445,0,0,drop,66,66,0,1,0,1,0
1377,44847,0,0,deny,62,62,0,1,0,1,0
60520,445,0,0,drop,66,66,0,1,0,1,0
60818,37965,0,0,deny,66,66,0,1,0,1,0
60155,23718,0,0,deny,66,66,0,1,0,1,0
64982,53,7315,53,allow,195,102,93,2,30,1,1
61869,445,0,0,drop,66,66,0,1,0,1,0
57305,53,33562,53,allow,177,94,83,2,30,1,1
60883,64147,0,0,deny,74,74,0,1,0,1,0
49701,443,31912,443,allow,13022,1500,11522,30,23,15,15
65295,53,41511,53,allow,944,205,739,6,45,3,3
53122,443,25117,443,allow,23067,5901,17166,43,73,21,22
61666,80,7138,80,allow,16580,1400,15180,33,48,15,18
42298,25161,56288,25161,allow,138,70,68,2,30,1,1
49993,37965,0,0,deny,66,66,0,1,0,1,0
49302,443,39111,443,allow,454,262,192,8,27,5,3
11136,15503,0,0,deny,145,145,0,1,0,1,0
52470,443,33189,443,allow,7915,1213,6702,23,50,12,11
65374,53,60025,53,allow,261,102,159,2,30,1,1
49742,53,64876,53,allow,223,102,121,2,30,1,1
53059,445,0,0,drop,70,70,0,1,0,1,0
48478,49903,0,0,deny,62,62,0,1,0,1,0
65377,445,0,0,drop,66,66,0,1,0,1,0
57839,53,54040,53,allow,78,78,0,1,30,1,0
57910,443,61063,443,allow,1853,1214,639,18,156,11,7
64967,53,8909,53,allow,184,94,90,2,29,1,1
51733,5228,35376,5228,allow,6967,1929,5038,25,128,14,11
10462,25174,0,0,deny,62,62,0,1,0,1,0
58609,445,0,0,drop,70,70,0,1,0,1,0
0,0,0,0,allow,244,244,0,2,0,2,0
49418,27017,34824,27017,allow,255,71,184,2,31,1,1
5830,22114,0,0,deny,66,66,0,1,0,1,0
60416,55998,61754,55998,allow,70,70,0,2,8,2,0
52808,445,0,0,drop,66,66,0,1,0,1,0
23483,57470,0,0,deny,109,109,0,1,0,1,0
55304,53,64050,53,allow,711,87,624,2,30,1,1
58638,5900,0,0,deny,62,62,0,1,0,1,0
55873,445,0,0,drop,70,70,0,1,0,1,0
6652,25174,0,0,deny,62,62,0,1,0,1,0
54423,21247,0,0,deny,66,66,0,1,0,1,0
65016,37965,0,0,deny,66,66,0,1,0,1,0
49869,80,36356,80,allow,43386,3876,39510,79,22,42,37
63627,443,58785,443,allow,17242,3015,14227,19,143,5,14
51513,443,33339,443,allow,75323,6054,69269,110,38,52,58
62940,445,0,0,drop,70,70,0,1,0,1,0
50917,445,0,0,drop,70,70,0,1,0,1,0
56676,445,0,0,drop,70,70,0,1,0,1,0
42336,443,36600,443,allow,4181,998,3183,14,26,7,7
63503,42707,0,0,deny,66,66,0,1,0,1,0
33858,443,46476,443,allow,12017,2031,9986,38,216,18,20
56494,57587,0,0,deny,146,146,0,1,0,1,0
6666,21,0,0,deny,60,60,0,1,0,1,0
53234,443,53234,443,allow,1276,703,573,15,33,8,7
26494,26467,0,0,deny,62,62,0,1,0,1,0
58638,5900,0,0,deny,62,62,0,1,0,1,0
64795,53,2622,53,allow,338,110,228,2,30,1,1
43733,443,15802,443,allow,27525,2389,25136,47,27,22,25
56259,445,0,0,drop,70,70,0,1,0,1,0
60506,56243,34455,56243,allow,70,70,0,2,8,2,0
56594,53,29926,53,allow,788,108,680,2,30,1,1
62245,445,0,0,drop,70,70,0,1,0,1,0
60251,445,0,0,drop,66,66,0,1,0,1,0
56518,53,9053,53,allow,170,87,83,2,30,1,1
59470,445,0,0,drop,66,66,0,1,0,1,0
50541,80,22542,80,allow,4296,3281,1015,12,33,7,5
49168,57470,0,0,deny,66,66,0,1,0,1,0
63981,445,0,0,drop,70,70,0,1,0,1,0
49321,445,0,0,drop,70,70,0,1,0,1,0
56762,53,10998,53,allow,168,86,82,2,30,1,1
64642,53,54204,53,allow,751,94,657,2,30,1,1
31136,50584,0,0,deny,62,62,0,1,0,1,0
57157,53,38785,53,allow,173,94,79,2,30,1,1
57351,53,48992,53,allow,177,94,83,2,30,1,1
51449,443,58007,443,allow,9602,3315,6287,25,37,15,10
26448,41864,0,0,deny,145,145,0,1,0,1,0
55490,443,55467,443,allow,3080,1018,2062,10,120,5,5
64532,445,0,0,drop,66,66,0,1,0,1,0
63328,445,0,0,drop,66,66,0,1,0,1,0
58226,52848,0,0,deny,62,62,0,1,0,1,0
48173,443,63016,443,allow,4342,2152,2190,19,255,10,9
58638,5900,0,0,deny,62,62,0,1,0,1,0
51968,443,14636,443,allow,122815,48545,74270,164,95,76,88
49671,443,7194,443,allow,1485,940,545,13,57,7,6
65065,445,0,0,drop,66,66,0,1,0,1,0
63786,50091,30767,50091,allow,66,66,0,2,7,2,0
5222,32859,0,0,deny,66,66,0,1,0,1,0
30960,45730,17923,45730,allow,330,330,0,6,3610,6,0
65307,53,33704,53,allow,365,94,271,4,58,2,2
34367,443,31324,443,allow,25205,2243,22962,41,149,17,24
29300,35440,0,0,deny,62,62,0,1,0,1,0
50622,53,57483,53,allow,185,102,83,2,30,1,1
56982,445,0,0,drop,70,70,0,1,0,1,0
52262,14418,18744,14418,allow,70,70,0,2,8,2,0
56805,53,35322,53,allow,172,88,84,2,30,1,1
50002,53,23419,53,allow,183,102,81,2,30,1,1
36927,80,32507,80,allow,130,70,60,2,14,1,1
11677,56205,0,0,deny,66,66,0,1,0,1,0
55262,53,28090,53,allow,762,98,664,2,31,1,1
49868,443,36753,443,allow,6251,1706,4545,16,88,9,7
64903,53,49771,53,allow,777,87,690,2,31,1,1
56718,50584,0,0,deny,66,66,0,1,0,1,0
61550,5529,0,0,deny,145,145,0,1,0,1,0
53648,31637,13598,31637,allow,744,618,126,10,28,8,2
59008,443,16532,443,allow,10214,2669,7545,30,170,14,16
14000,14914,0,0,deny,157,157,0,1,0,1,0
52018,57866,0,0,deny,66,66,0,1,0,1,0
49411,445,0,0,drop,66,66,0,1,0,1,0
52473,443,5513,443,allow,1625,1038,587,14,28,8,6
50005,53,1672,53,allow,199,102,97,2,30,1,1
56134,53,62024,53,allow,183,94,89,2,31,1,1
16477,37807,0,0,deny,66,66,0,1,0,1,0
62613,445,0,0,drop,66,66,0,1,0,1,0
55706,33677,37931,33677,allow,210,140,70,4,14,3,1
9659,81,0,0,deny,60,60,0,1,0,1,0
49348,53,25745,53,allow,188,96,92,2,31,1,1
22321,80,22321,80,allow,490,264,226,8,26,5,3
61221,35440,0,0,deny,66,66,0,1,0,1,0
60471,19776,35509,19776,allow,70,70,0,2,8,2,0
55051,53,56758,53,allow,167,86,81,2,30,1,1
64331,53,13624,53,allow,226,110,116,2,30,1,1
59303,445,0,0,drop,66,66,0,1,0,1,0
51839,80,34402,80,allow,3240,1194,2046,14,20,9,5
49215,52611,6615,52611,allow,70,70,0,1,5,1,0
44718,80,25526,80,allow,4336,2408,1928,18,21,10,8
49325,445,0,0,drop,70,70,0,1,0,1,0
38936,53,29060,53,allow,215,86,129,2,30,1,1
52067,445,0,0,drop,70,70,0,1,0,1,0
57714,445,0,0,drop,66,66,0,1,0,1,0
55646,14420,30714,14420,allow,70,70,0,1,5,1,0
51609,443,37311,443,allow,4598,2312,2286,17,34,9,8
50586,80,50586,80,allow,5320,3428,1892,22,21,12,10
49415,443,33045,443,allow,29561,4857,24704,44,44,15,29
46912,53,4234,53,allow,168,78,90,2,30,1,1
50866,445,0,0,drop,70,70,0,1,0,1,0
58829,64147,0,0,deny,66,66,0,1,0,1,0
37155,443,46832,443,allow,7303,2206,5097,23,255,12,11
54123,443,54123,443,allow,79652,20710,58942,112,84,58,54
60433,445,0,0,drop,66,66,0,1,0,1,0
55321,53,63193,53,allow,193,102,91,2,30,1,1
56604,17372,0,0,deny,66,66,0,1,0,1,0
49449,80,49449,80,allow,416,198,218,7,29,4,3
38634,443,57626,443,allow,9398,4241,5157,22,135,11,11
57074,53,56571,53,allow,190,97,93,2,30,1,1
22987,15503,0,0,deny,146,146,0,1,0,1,0
52210,15604,53741,15604,allow,70,70,0,1,5,1,0
65524,443,51488,443,allow,282968,9210,273758,296,15,106,190
51620,56205,0,0,deny,66,66,0,1,0,1,0
36194,443,29201,443,allow,5674,1556,4118,23,271,13,10
55642,53,4187,53,allow,711,87,624,2,30,1,1
63796,60557,39305,60557,allow,66,66,0,2,8,2,0
44794,443,36304,443,allow,11158,3338,7820,27,16,16,11
6712,161,0,0,deny,82,82,0,1,0,1,0
65252,445,0,0,drop,70,70,0,1,0,1,0
50100,53,47683,53,allow,216,110,106,2,30,1,1
49598,53,15528,53,allow,214,102,112,2,30,1,1
2422,62507,0,0,deny,66,66,0,1,0,1,0
26900,27017,60597,27017,allow,422,164,258,6,31,3,3
55046,80,10209,80,allow,2775,1332,1443,12,34,7,5
52072,25595,16816,25595,allow,66,66,0,1,5,1,0
55165,445,0,0,drop,70,70,0,1,0,1,0
64047,16221,14226,16221,allow,70,70,0,1,4,1,0
51877,445,0,0,drop,70,70,0,1,0,1,0
59910,445,0,0,drop,70,70,0,1,0,1,0
40657,443,5933,443,allow,9869,2395,7474,36,129,20,16
59691,445,0,0,drop,70,70,0,1,0,1,0
32854,443,34612,443,allow,9695,4412,5283,22,172,13,9
52508,445,0,0,drop,70,70,0,1,0,1,0
54526,445,0,0,drop,66,66,0,1,0,1,0
55479,53,22790,53,allow,184,94,90,2,30,1,1
43106,443,35974,443,allow,3259,1913,1346,18,16,8,10
65196,53,58386,53,allow,177,94,83,2,30,1,1
52662,445,0,0,drop,70,70,0,1,0,1,0
49590,80,22848,80,allow,314,128,186,6,26,3,3
63956,44512,0,0,deny,145,145,0,1,0,1,0
64733,445,0,0,drop,70,70,0,1,0,1,0
49756,53,23582,53,allow,264,89,175,4,47,2,2
58638,5900,0,0,deny,62,62,0,1,0,1,0
65522,53,17756,53,allow,1281,94,1187,2,30,1,1
59830,445,0,0,drop,70,70,0,1,0,1,0
65420,443,40711,443,allow,3213,2242,971,19,25,9,10
56561,53,15305,53,allow,216,110,106,2,30,1,1
56787,53,40108,53,allow,209,110,99,2,30,1,1
57927,445,0,0,drop,66,66,0,1,0,1,0
50574,80,53098,80,allow,2734,1250,1484,16,15,10,6
60209,443,58823,443,allow,26423,2338,24085,50,152,24,26
48756,443,37837,443,allow,6353,1075,5278,18,33,10,8
56491,53,2856,53,allow,165,86,79,2,30,1,1
55675,445,0,0,drop,70,70,0,1,0,1,0
52459,33890,0,0,deny,60,60,0,1,0,1,0
16477,37807,0,0,deny,66,66,0,1,0,1,0
56787,443,11653,443,allow,5639,846,4793,18,27,10,8
59884,443,34275,443,allow,1401,864,537,12,28,6,6
56313,443,7717,443,allow,37465,18615,18850,299,588,135,164
55082,25174,0,0,deny,66,66,0,1,0,1,0
56070,53,26270,53,allow,193,102,91,2,30,1,1
52594,445,0,0,drop,70,70,0,1,0,1,0
55713,53,11593,53,allow,308,94,214,2,30,1,1
49787,443,47487,443,allow,34175,1680,32495,42,126,15,27
62064,445,0,0,drop,70,70,0,1,0,1,0
50296,53,13683,53,allow,183,94,89,2,30,1,1
55625,10480,18268,10480,allow,564,318,246,9,15,5,4
57470,6882,62846,6882,allow,528,528,0,9,1200,9,0
46671,53,46671,53,allow,832,106,726,2,30,1,1
64715,53,35107,53,allow,209,110,99,2,30,1,1
60388,80,7152,80,allow,2424,529,1895,11,125,6,5
58022,8800,0,0,deny,60,60,0,1,0,1,0
50699,443,40507,443,allow,9382,3057,6325,35,1220,17,18
49128,443,6577,443,allow,3062,1747,1315,17,16,9,8
29509,25174,0,0,deny,62,62,0,1,0,1,0
64782,53,60235,53,allow,212,102,110,2,29,1,1
58638,5900,0,0,deny,62,62,0,1,0,1,0
40364,443,43021,443,allow,20594,14251,6343,40,361,22,18
46982,443,35062,443,allow,3847,2650,1197,22,35,13,9
63985,445,0,0,drop,70,70,0,1,0,1,0
65028,53,18830,53,allow,182,93,89,2,30,1,1
56712,53,47464,53,allow,177,94,83,2,30,1,1
48480,443,23315,443,allow,10409,2670,7739,94,5805,17,77
57228,53,50397,53,allow,344,94,250,2,30,1,1
57749,445,0,0,drop,70,70,0,1,0,1,0
49414,445,0,0,drop,66,66,0,1,0,1,0
33405,37965,0,0,deny,62,62,0,1,0,1,0
54441,445,0,0,drop,70,70,0,1,0,1,0
49372,53,17589,53,allow,216,110,106,2,31,1,1
54424,445,0,0,drop,70,70,0,1,0,1,0
53108,7003,16327,7003,allow,512,326,186,9,22,6,3
65511,445,0,0,drop,70,70,0,1,0,1,0
56142,53,12873,53,allow,188,96,92,2,30,1,1
53403,443,55979,443,allow,38342,14090,24252,83,159,40,43
38799,53,0,0,allow,86,86,0,1,30,1,0
51453,445,0,0,drop,66,66,0,1,0,1,0
59282,51050,0,0,deny,66,66,0,1,0,1,0
57244,443,45761,443,allow,230914,10401,220513,290,76,121,169
53904,1024,55644,1024,allow,70,70,0,1,4,1,0
49989,53,19506,53,allow,301,85,216,4,53,2,2
50998,445,0,0,drop,70,70,0,1,0,1,0
28878,51505,0,0,deny,146,146,0,1,0,1,0
57987,56125,0,0,deny,90,90,0,1,0,1,0
50562,80,50562,80,allow,1696,996,700,11,22,6,5
50364,445,0,0,drop,70,70,0,1,0,1,0
49511,445,0,0,drop,66,66,0,1,0,1,0
50543,443,30180,443,allow,38667,3344,35323,56,210,24,32
55891,443,55891,443,allow,4581,1674,2907,19,30,11,8
63213,35440,0,0,deny,62,62,0,1,0,1,0
19634,64147,0,0,deny,62,62,0,1,0,1,0
55582,53,48223,53,allow,344,107,237,4,54,2,2
64048,44918,54494,44918,allow,70,70,0,1,4,1,0
59929,445,0,0,drop,70,70,0,1,0,1,0
33793,80,7506,80,allow,1286,782,504,12,361,7,5
49332,53,28193,53,allow,281,98,183,4,56,2,2
34657,443,29815,443,allow,3521,516,3005,12,15,6,6
49219,443,60965,443,allow,70,70,0,2,4,2,0
60792,443,58920,443,allow,5037,1343,3694,18,45,11,7
60830,445,0,0,drop,70,70,0,1,0,1,0
50421,53,19651,53,allow,762,98,664,2,30,1,1
56104,53,24374,53,allow,197,102,95,2,30,1,1
64950,445,0,0,drop,70,70,0,1,0,1,0
27761,53,27761,53,allow,832,106,726,2,30,1,1
55450,53,15433,53,allow,186,95,91,2,30,1,1
51838,29448,55370,29448,allow,70,70,0,2,7,2,0
46573,50584,0,0,deny,66,66,0,1,0,1,0
56964,445,0,0,drop,66,66,0,1,0,1,0
55262,53,22053,53,allow,193,102,91,2,30,1,1
57108,53,35898,53,allow,193,102,91,2,30,1,1
52207,4637,29875,4637,allow,136,136,0,3,14,3,0
57285,443,38646,443,allow,21198,9647,11551,97,20,52,45
52298,445,0,0,drop,66,66,0,1,0,1,0
10914,35974,0,0,deny,60,60,0,1,0,1,0
52910,51221,0,0,deny,78,78,0,1,0,1,0
59810,443,31870,443,allow,27370,17071,10299,51,30,26,25
57150,53,63337,53,allow,286,97,189,4,47,2,2
50840,57470,0,0,deny,66,66,0,1,0,1,0
41398,443,9003,443,allow,3135,1968,1167,22,72,12,10
56231,53,34438,53,allow,757,98,659,2,30,1,1
64591,445,0,0,drop,70,70,0,1,0,1,0
9544,7302,0,0,deny,62,62,0,1,0,1,0
51548,995,0,0,deny,60,60,0,1,0,1,0
9334,443,58101,443,allow,674,128,546,12,46,3,9
62575,12207,0,0,deny,66,66,0,1,0,1,0
53574,23650,56670,23650,allow,320,140,180,6,5,3,3
52942,443,55996,443,allow,14696,5947,8749,53,115,26,27
51796,48779,55326,48779,allow,70,70,0,2,8,2,0
58638,5900,0,0,deny,62,62,0,1,0,1,0
60661,53,54714,53,allow,278,102,176,2,31,1,1
49893,25174,0,0,deny,66,66,0,1,0,1,0
51908,445,0,0,drop,66,66,0,1,0,1,0
59134,443,19073,443,allow,6857,1727,5130,23,316,13,10
63932,63241,5696,63241,allow,436,254,182,7,15,4,3
21777,50584,0,0,deny,62,62,0,1,0,1,0
59895,53,59895,53,allow,643,88,555,2,30,1,1
47831,443,18559,443,allow,180582,6020,174562,196,200,70,126
50086,57470,0,0,deny,66,66,0,1,0,1,0
26480,64147,0,0,deny,62,62,0,1,0,1,0
58870,443,45632,443,allow,1411,921,490,12,15,7,5
56542,443,7908,443,allow,3701,1521,2180,19,7,10,9
56710,443,25252,443,allow,8057,2037,6020,20,15,11,9
29576,37807,0,0,deny,66,66,0,1,0,1,0
49991,80,45821,80,allow,2668,543,2125,12,28,6,6
61876,445,0,0,drop,70,70,0,1,0,1,0
56603,53,24241,53,allow,179,94,85,2,30,1,1
51238,443,29233,443,allow,8034,2584,5450,39,16,23,16
59112,53,0,0,allow,296,76,220,2,30,1,1
61530,445,0,0,drop,70,70,0,1,0,1,0
61838,37965,0,0,deny,66,66,0,1,0,1,0
51267,445,0,0,drop,70,70,0,1,0,1,0
65488,443,64323,443,allow,92286,4799,87487,107,16,43,64
57416,66,12942,66,allow,70,70,0,1,4,1,0
37429,25174,0,0,deny,62,62,0,1,0,1,0
24731,51505,0,0,deny,62,62,0,1,0,1,0
35337,443,49436,443,allow,6550678,172191,6378487,6426,82,2117,4309
62744,62413,0,0,deny,66,66,0,1,0,1,0
56909,50584,0,0,deny,62,62,0,1,0,1,0
57456,443,23040,443,allow,1857,1218,639,18,119,11,7
48495,443,14805,443,allow,3108,1711,1397,24,813,11,13
51972,13604,16172,13604,allow,258,70,188,4,8,2,2
56288,53,49732,53,allow,183,94,89,2,31,1,1
50018,445,0,0,drop,70,70,0,1,0,1,0
62438,37807,0,0,deny,66,66,0,1,0,1,0
52115,443,22081,443,allow,11551,3870,7681,29,37,16,13
55090,445,0,0,drop,66,66,0,1,0,1,0
64323,53,30451,53,allow,195,102,93,2,31,1,1
35644,67,0,0,deny,60,60,0,1,0,1,0
57406,53,49515,53,allow,194,102,92,2,30,1,1
53179,80,43162,80,allow,1628,828,800,10,25,6,4
52785,445,0,0,drop,70,70,0,1,0,1,0
65514,53,51532,53,allow,177,94,83,2,30,1,1
55727,53,65316,53,allow,711,87,624,2,31,1,1
55705,445,0,0,drop,70,70,0,1,0,1,0
55796,53,55796,53,allow,253,99,154,2,32,1,1
56060,53,26992,53,allow,224,102,122,2,30,1,1
57768,37965,0,0,deny,66,66,0,1,0,1,0
56223,53,26337,53,allow,177,94,83,2,30,1,1
49418,16666,10447,16666,allow,71,71,0,1,30,1,0
35755,80,35755,80,allow,201552,13184,188368,245,30,111,134
38085,443,38085,443,allow,1452,817,635,16,20,9,7
52688,445,0,0,drop,70,70,0,1,0,1,0
52168,443,14996,443,allow,73105,13398,59707,220,374,108,112
38143,443,38143,443,allow,36902,3203,33699,57,90,31,26
58638,5900,0,0,deny,62,62,0,1,0,1,0
58633,445,0,0,drop,70,70,0,1,0,1,0
49838,445,0,0,drop,70,70,0,1,0,1,0
53865,443,28083,443,allow,499,425,74,4,1,3,1
53204,445,0,0,drop,70,70,0,1,0,1,0
49857,80,39166,80,allow,7800,1743,6057,20,89,11,9
48706,23393,0,0,deny,60,60,0,1,0,1,0
65512,44847,0,0,deny,66,66,0,1,0,1,0
61053,44847,0,0,deny,66,66,0,1,0,1,0
55950,445,0,0,drop,70,70,0,1,0,1,0
49764,53,54622,53,allow,199,102,97,2,30,1,1
59459,37807,0,0,deny,66,66,0,1,0,1,0
54408,445,0,0,drop,70,70,0,1,0,1,0
59228,445,0,0,drop,70,70,0,1,0,1,0
61127,445,0,0,drop,70,70,0,1,0,1,0
39892,443,8583,443,allow,2186,1319,867,23,20,13,10
64711,53,26786,53,allow,211,110,101,2,30,1,1
57204,53,62909,53,allow,195,102,93,2,31,1,1
56617,443,25954,443,allow,7981,1961,6020,20,16,11,9
55248,443,36636,443,allow,30281,3919,26362,44,62,21,23
49424,443,6642,443,allow,77408,4295,73113,106,271,52,54
50095,50584,0,0,deny,62,62,0,1,0,1,0
62188,443,50318,443,allow,6973,2413,4560,22,148,11,11
52744,25174,0,0,deny,66,66,0,1,0,1,0
59500,445,0,0,drop,70,70,0,1,0,1,0
51797,80,10283,80,allow,9897,4338,5559,27,58,16,11
1024,25174,0,0,deny,146,146,0,1,0,1,0
4781,443,51838,443,allow,1191,692,499,12,40,7,5
443,20087,0,0,deny,83,83,0,1,0,1,0
55979,53,21397,53,allow,193,102,91,2,31,1,1
57424,53,65254,53,allow,177,94,83,2,30,1,1
18203,23,0,0,deny,60,60,0,1,0,1,0
42040,5228,65521,5228,allow,3467,1977,1490,29,3742,14,15
56616,443,54486,443,allow,8033,2013,6020,20,15,11,9
51166,53,27662,53,allow,168,78,90,2,30,1,1
27195,21247,0,0,deny,146,146,0,1,0,1,0
7810,25174,0,0,deny,62,62,0,1,0,1,0
51353,46314,0,0,deny,145,145,0,1,0,1,0
16382,17500,0,0,deny,62,62,0,1,0,1,0
56324,53,56324,53,allow,257,101,156,2,34,1,1
48025,44847,0,0,deny,62,62,0,1,0,1,0
57368,53,6129,53,allow,701,88,613,2,30,1,1
21145,11392,0,0,deny,62,62,0,1,0,1,0
51994,25509,12796,25509,allow,66,66,0,1,5,1,0
63729,6969,28915,6969,allow,70,70,0,1,5,1,0
52150,37603,39264,37603,allow,70,70,0,2,7,2,0
27005,27015,19502,27015,allow,880,126,754,2,30,1,1
59807,445,0,0,drop,70,70,0,1,0,1,0
55183,445,0,0,drop,70,70,0,1,0,1,0
63776,445,0,0,drop,70,70,0,1,0,1,0
52920,443,42636,443,allow,6253,2132,4121,19,16,10,9
49297,53,2852,53,allow,183,94,89,2,30,1,1
38659,443,10582,443,allow,11202,2200,9002,39,131,20,19
56639,443,6220,443,allow,10138,2213,7925,27,30,16,11
57903,443,20952,443,allow,4823,708,4115,19,240,6,13
51091,80,6090,80,allow,3324,663,2661,12,15,7,5
50019,445,0,0,drop,66,66,0,1,0,1,0
45885,80,47215,80,allow,23259,2769,20490,36,143,19,17
53842,57861,18155,57861,allow,492,306,186,8,14,5,3
6881,41019,41697,41019,allow,150,150,0,1,1200,1,0
64075,1026,24378,1026,allow,70,70,0,1,4,1,0
57131,7774,0,0,deny,145,145,0,1,0,1,0
61619,445,0,0,drop,66,66,0,1,0,1,0
52913,2767,0,0,deny,66,66,0,1,0,1,0
11136,57587,0,0,deny,145,145,0,1,0,1,0
53912,8999,51602,8999,allow,1869,1009,860,15,18,9,6
60645,35440,0,0,deny,66,66,0,1,0,1,0
58435,64631,0,0,deny,74,74,0,1,0,1,0
48844,443,50866,443,allow,36383,29447,6936,103,163,51,52
52494,443,23008,443,allow,5782,1008,4774,17,15,8,9
56596,53,51860,53,allow,199,102,97,2,30,1,1
56621,50584,0,0,deny,62,62,0,1,0,1,0
58432,445,0,0,drop,70,70,0,1,0,1,0
57083,445,0,0,drop,70,70,0,1,0,1,0
64683,445,0,0,drop,66,66,0,1,0,1,0
59668,51505,0,0,deny,66,66,0,1,0,1,0
55262,44847,0,0,deny,62,62,0,1,0,1,0
49316,53,61603,53,allow,184,94,90,2,30,1,1
38194,53,38194,53,allow,210,98,112,2,29,1,1
50076,80,29026,80,allow,26128,9214,16914,81,512,40,41
39945,443,42447,443,allow,5446,805,4641,17,26,9,8
49531,443,49531,443,allow,95223,30803,64420,107,23,50,57
38134,8497,0,0,deny,143,143,0,1,0,1,0
49174,53,58915,53,allow,198,101,97,2,30,1,1
29989,26467,0,0,deny,66,66,0,1,0,1,0
33150,53,60040,53,allow,816,228,588,8,30,4,4
50227,80,3538,80,allow,1935,895,1040,15,75,8,7
59477,443,7119,443,allow,14489,12206,2283,25,120,15,10
50111,445,0,0,drop,70,70,0,1,0,1,0
56922,53,64459,53,allow,168,86,82,2,30,1,1
56120,53,62724,53,allow,168,78,90,2,30,1,1
4515,37807,0,0,deny,62,62,0,1,0,1,0
51783,12296,8284,12296,allow,316,136,180,6,6,3,3
63969,445,0,0,drop,70,70,0,1,0,1,0
58638,5900,0,0,deny,62,62,0,1,0,1,0
55732,53,40584,53,allow,194,102,92,2,31,1,1
53023,445,0,0,drop,70,70,0,1,0,1,0
57797,64147,0,0,deny,62,62,0,1,0,1,0
35691,123,42659,123,allow,184,94,90,2,30,1,1
16454,25174,0,0,deny,66,66,0,1,0,1,0
55019,443,52718,443,allow,6484,1915,4569,26,131,14,12
51763,445,0,0,drop,66,66,0,1,0,1,0
11319,443,11319,443,allow,179461,16904,162557,220,36,105,115
55704,53,48604,53,allow,186,95,91,2,31,1,1
6057,51221,0,0,deny,78,78,0,1,0,1,0
54537,80,39580,80,allow,4096,3455,641,13,15,8,5
64787,53,33533,53,allow,179,94,85,2,30,1,1
56521,32480,0,0,deny,62,62,0,1,0,1,0
48817,51413,48817,51413,allow,485,158,327,2,1200,1,1
60925,445,0,0,drop,70,70,0,1,0,1,0
64762,53,50554,53,allow,194,102,92,2,30,1,1
57470,16288,57203,16288,allow,924,924,0,15,1200,15,0
65049,53,51039,53,allow,184,94,90,2,30,1,1
42207,443,33313,443,allow,7870,2945,4925,19,136,9,10
49298,443,58144,443,allow,3949,2535,1414,24,75,12,12
55339,53,49453,53,allow,194,94,100,2,30,1,1
50095,53,59595,53,allow,250,86,164,4,30,2,2
54569,445,0,0,drop,70,70,0,1,0,1,0
64538,443,60340,443,allow,4658,1652,3006,10,121,5,5
40122,443,13389,443,allow,8235,2076,6159,24,330,11,13
57886,443,10717,443,allow,33667,25477,8190,60,33,34,26
63588,445,0,0,drop,70,70,0,1,0,1,0
53586,445,0,0,drop,70,70,0,1,0,1,0
63627,445,0,0,drop,66,66,0,1,0,1,0
49765,53,55763,53,allow,188,96,92,2,31,1,1
14255,2767,0,0,deny,62,62,0,1,0,1,0
16327,55442,0,0,deny,66,66,0,1,0,1,0
59879,443,12932,443,allow,302,120,182,6,32,3,3
50036,445,0,0,drop,70,70,0,1,0,1,0
2383,37965,0,0,deny,66,66,0,1,0,1,0
48742,443,3234,443,allow,4801,2138,2663,23,15,12,11
55439,53,53595,53,allow,209,110,99,2,29,1,1
58253,25174,0,0,deny,146,146,0,1,0,1,0
55224,53,33137,53,allow,209,110,99,2,30,1,1
53246,5222,38090,5222,allow,10577,3496,7081,68,616,36,32
18102,53,59095,53,allow,223,86,137,2,30,1,1
58507,445,0,0,drop,70,70,0,1,0,1,0
57470,13613,29471,13613,allow,1577,594,983,20,1600,10,10
60646,445,0,0,drop,70,70,0,1,0,1,0
55779,445,0,0,drop,70,70,0,1,0,1,0
50537,443,21381,443,allow,6250,1595,4655,23,150,12,11
57273,53,29269,53,allow,177,94,83,2,30,1,1
55992,53,33542,53,allow,194,94,100,2,30,1,1
64998,27037,52668,27037,allow,3573,2238,1335,16,34,8,8
52569,30188,0,0,deny,66,66,0,1,0,1,0
59103,443,44683,443,allow,2192,1049,1143,24,119,11,13
58638,5900,0,0,deny,62,62,0,1,0,1,0
41626,15000,7526,15000,allow,130,70,60,2,5,1,1
62877,53,36980,53,allow,248,78,170,2,30,1,1
64374,53,64374,53,allow,240,98,142,2,30,1,1
51585,80,50569,80,allow,3192,624,2568,10,155,5,5
21133,21689,35631,21689,allow,481,150,331,2,1199,1,1
57730,445,0,0,drop,70,70,0,1,0,1,0
36665,443,51014,443,allow,5814771,76275,5738496,4959,154,976,3983
63587,22114,0,0,deny,146,146,0,1,0,1,0
49335,445,0,0,drop,70,70,0,1,0,1,0
64808,27098,0,0,deny,66,66,0,1,0,1,0
50377,53,24974,53,allow,753,94,659,2,30,1,1
39132,44847,0,0,deny,66,66,0,1,0,1,0
38581,22114,0,0,deny,146,146,0,1,0,1,0
61132,445,0,0,drop,66,66,0,1,0,1,0
56625,53,10109,53,allow,711,87,624,2,31,1,1
51677,445,0,0,drop,70,70,0,1,0,1,0
53300,37807,0,0,deny,62,62,0,1,0,1,0
50551,445,0,0,drop,70,70,0,1,0,1,0
58638,5900,0,0,deny,62,62,0,1,0,1,0
55733,53,30284,53,allow,177,94,83,2,30,1,1
63460,55160,0,0,deny,66,66,0,1,0,1,0
51674,51505,0,0,deny,66,66,0,1,0,1,0
54370,443,2250,443,allow,11876,2769,9107,30,76,15,15
31619,51221,0,0,deny,62,62,0,1,0,1,0
50456,445,0,0,drop,70,70,0,1,0,1,0
53912,3478,54737,3478,allow,3532,1792,1740,58,88,29,29
46495,4607,0,0,deny,60,60,0,1,0,1,0
55044,445,0,0,drop,70,70,0,1,0,1,0
49521,53,26950,53,allow,182,93,89,2,30,1,1
49936,53,39032,53,allow,216,110,106,2,29,1,1
59801,445,0,0,drop,70,70,0,1,0,1,0
49813,443,15951,443,allow,10103,3140,6963,29,126,16,13
58621,53,5007,53,allow,256,94,162,2,29,1,1
55165,53,33843,53,allow,186,95,91,2,31,1,1
63024,53,42862,53,allow,569,164,405,2,30,1,1
37087,80,29544,80,allow,946,531,415,11,296,6,5
51891,445,0,0,drop,66,66,0,1,0,1,0
52213,445,0,0,drop,66,66,0,1,0,1,0
52953,445,0,0,drop,70,70,0,1,0,1,0
51903,443,13827,443,allow,1612,1089,523,12,15,7,5
51416,445,0,0,drop,70,70,0,1,0,1,0
54200,443,47040,443,allow,499,425,74,4,0,3,1
43603,443,42478,443,allow,8420,2986,5434,23,138,13,10
32722,25174,0,0,deny,62,62,0,1,0,1,0
55613,53,57785,53,allow,177,94,83,2,30,1,1
43584,24748,0,0,deny,156,156,0,1,0,1,0
42969,8146,0,0,deny,62,62,0,1,0,1,0
26923,443,40541,443,allow,7362,1770,5592,31,87,16,15
54348,443,11963,443,allow,8863,3511,5352,20,120,9,11
60175,445,0,0,drop,66,66,0,1,0,1,0
27005,27015,19285,27015,allow,892,126,766,2,30,1,1
55427,53,54288,53,allow,200,102,98,2,30,1,1
52128,443,43146,443,allow,16113,2152,13961,35,20,18,17
65080,53,25627,53,allow,209,110,99,2,30,1,1
49663,53,65385,53,allow,195,102,93,2,30,1,1
49757,80,22692,80,allow,1396,864,532,9,15,5,4
56420,80,57757,80,allow,34636,928,33708,37,104,11,26
33261,443,59567,443,allow,14176,1843,12333,30,201,16,14
37133,80,37133,80,allow,12799,979,11820,20,17,9,11
54128,445,0,0,drop,70,70,0,1,0,1,0
53768,445,0,0,drop,66,66,0,1,0,1,0
60549,445,0,0,drop,70,70,0,1,0,1,0
56905,53,61024,53,allow,239,110,129,2,30,1,1
51979,55803,35511,55803,allow,70,70,0,2,7,2,0
51408,443,61197,443,allow,1576,789,787,17,122,9,8
56561,53,8736,53,allow,183,94,89,2,29,1,1
56324,445,0,0,drop,70,70,0,1,0,1,0
48817,38081,48817,38081,allow,863,363,500,4,1200,2,2
53975,40978,50066,40978,allow,1946,1019,927,10,15,6,4
51615,15000,33004,15000,allow,130,70,60,2,5,1,1
51830,80,53910,80,allow,486,300,186,9,31,6,3
52471,443,64710,443,allow,8398,1552,6846,27,50,14,13
49577,445,0,0,drop,70,70,0,1,0,1,0
49891,53,31414,53,allow,243,94,149,2,30,1,1
49624,443,56067,443,allow,6440,1965,4475,22,36,12,10
50669,443,15933,443,allow,8464,2256,6208,25,255,13,12
54583,445,0,0,drop,70,70,0,1,0,1,0
47758,443,3505,443,allow,299614,32024,267590,587,115,304,283
57006,80,58727,80,allow,214,140,74,4,30,3,1
54810,80,61461,80,allow,6098,1916,4182,31,357,16,15
49620,445,0,0,drop,70,70,0,1,0,1,0
57470,22070,58715,22070,allow,559,198,361,5,1200,4,1
60485,22114,0,0,deny,66,66,0,1,0,1,0
49364,443,4324,443,allow,5141,896,4245,17,69,8,9
64632,443,35078,443,allow,8391,5178,3213,41,256,20,21
17800,3389,17800,3389,reset-both,293,223,70,4,0,3,1
56161,62413,0,0,deny,62,62,0,1,0,1,0
64773,53,48477,53,allow,328,150,178,2,30,1,1
50574,443,63021,443,allow,7352,1023,6329,19,16,11,8
59486,80,62432,80,allow,2633,1151,1482,10,32,6,4
49771,53,11315,53,allow,728,96,632,2,31,1,1
35049,80,15791,80,allow,5773,1197,4576,14,32,8,6
49346,443,65391,443,allow,7292,950,6342,19,75,9,10
7197,80,7197,80,allow,450,246,204,8,31,5,3
56795,35465,29402,35465,allow,70,70,0,1,5,1,0
60473,8765,52424,8765,allow,1370,750,620,21,329,11,10
49531,443,58024,443,allow,8107,2474,5633,24,25,12,12
65019,53,29209,53,allow,195,102,93,2,31,1,1
56517,445,0,0,drop,66,66,0,1,0,1,0
59822,56205,0,0,deny,66,66,0,1,0,1,0
60118,445,0,0,drop,70,70,0,1,0,1,0
28039,443,43641,443,allow,5576,1388,4188,19,15,9,10
60423,35440,0,0,deny,62,62,0,1,0,1,0
43260,41615,0,0,deny,145,145,0,1,0,1,0
65245,53,10432,53,allow,479,98,381,4,57,2,2
43129,15503,0,0,deny,62,62,0,1,0,1,0
57011,49813,0,0,deny,62,62,0,1,0,1,0
59345,445,0,0,drop,66,66,0,1,0,1,0
56925,445,0,0,drop,66,66,0,1,0,1,0
50002,445,0,0,drop,70,70,0,1,0,1,0
38701,443,23957,443,allow,1065134,19929,1045205,1009,16,288,721
5859,11392,0,0,deny,66,66,0,1,0,1,0
40634,443,26237,443,allow,4917,1273,3644,17,34,10,7
10128,443,36900,443,allow,22677,11756,10921,45,315,26,19
54759,445,0,0,drop,66,66,0,1,0,1,0
51918,443,34743,443,allow,28031,11553,16478,122,108,61,61
51406,443,19359,443,allow,5360,3775,1585,22,35,13,9
25360,51505,0,0,deny,66,66,0,1,0,1,0
64952,53,2309,53,allow,232,94,138,2,30,1,1
57416,53,52623,53,allow,186,95,91,2,30,1,1
56332,53,27865,53,allow,209,110,99,2,30,1,1
60874,443,2065,443,allow,777438,37182,740256,940,64,407,533
61939,443,12700,443,allow,3698,1049,2649,13,135,6,7
50345,53,44210,53,allow,193,102,91,2,30,1,1
3352,50584,0,0,deny,66,66,0,1,0,1,0
53838,15000,39426,15000,allow,130,70,60,2,5,1,1
51813,63933,44889,63933,allow,66,66,0,1,5,1,0
56618,445,0,0,drop,70,70,0,1,0,1,0
59822,56205,0,0,deny,62,62,0,1,0,1,0
60896,53,29321,53,allow,168,78,90,2,31,1,1
51065,445,0,0,drop,66,66,0,1,0,1,0
6975,29028,0,0,deny,139,139,0,1,0,1,0
57263,53,2666,53,allow,167,86,81,2,29,1,1
57563,443,58695,443,allow,10044,2134,7910,42,34,23,19
63884,445,0,0,drop,66,66,0,1,0,1,0
58638,5900,0,0,deny,62,62,0,1,0,1,0
55887,53,33560,53,allow,166,86,80,2,31,1,1
59731,443,4869,443,allow,384,166,218,2,31,1,1
10151,38030,53424,38030,allow,481,150,331,2,1200,1,1
53252,445,0,0,drop,70,70,0,1,0,1,0
58638,5900,0,0,deny,62,62,0,1,0,1,0
60462,80,40235,80,allow,1588,553,1035,10,75,6,4
64903,445,0,0,drop,70,70,0,1,0,1,0
49577,80,46203,80,allow,147113,4021,143092,144,65,41,103
64124,25174,0,0,deny,62,62,0,1,0,1,0
41039,443,10141,443,allow,1053,566,487,10,31,6,4
58286,445,0,0,drop,70,70,0,1,0,1,0
36438,5223,19564,5223,allow,5243,1898,3345,34,3005,18,16
53676,3678,29317,3678,allow,70,70,0,2,7,2,0
55668,445,0,0,drop,70,70,0,1,0,1,0
50415,445,0,0,drop,66,66,0,1,0,1,0
49182,445,0,0,drop,70,70,0,1,0,1,0
12143,56205,0,0,deny,66,66,0,1,0,1,0
53609,445,0,0,drop,66,66,0,1,0,1,0
65061,53,31774,53,allow,299,103,196,4,33,2,2
55759,53,16569,53,allow,177,94,83,2,30,1,1
58023,445,0,0,drop,70,70,0,1,0,1,0
53575,53,50120,53,allow,198,93,105,2,30,1,1
56500,53,38812,53,allow,164,86,78,2,30,1,1
49429,53,2752,53,allow,194,102,92,2,30,1,1
18655,44847,0,0,deny,66,66,0,1,0,1,0
56000,53,26233,53,allow,177,94,83,2,30,1,1
48478,49903,0,0,deny,62,62,0,1,0,1,0
53528,20485,38765,20485,allow,70,70,0,2,7,2,0
55081,80,13620,80,allow,1680,697,983,10,52,6,4
65529,35440,0,0,deny,62,62,0,1,0,1,0
52132,55014,27986,55014,allow,70,70,0,1,4,1,0
52361,445,0,0,drop,66,66,0,1,0,1,0
50253,53,52044,53,allow,167,86,81,2,29,1,1
6404,64147,0,0,deny,145,145,0,1,0,1,0
51221,3054,33559,3054,allow,870,330,540,12,1320,6,6
59998,53,31845,53,allow,481,110,371,2,31,1,1
59998,445,0,0,drop,70,70,0,1,0,1,0
59270,445,0,0,drop,70,70,0,1,0,1,0
64658,53,60447,53,allow,195,102,93,2,29,1,1
57174,53,49148,53,allow,210,94,116,2,30,1,1
53771,57470,0,0,deny,66,66,0,1,0,1,0
52077,51638,13368,51638,allow,70,70,0,2,8,2,0
56319,53,40959,53,allow,455,94,361,2,30,1,1
51578,44847,0,0,deny,66,66,0,1,0,1,0
50269,445,0,0,drop,66,66,0,1,0,1,0
64246,445,0,0,drop,66,66,0,1,0,1,0
10427,32480,0,0,deny,66,66,0,1,0,1,0
61701,44847,0,0,deny,66,66,0,1,0,1,0
10102,443,2452,443,allow,5415,864,4551,19,360,9,10
42366,57470,0,0,deny,66,66,0,1,0,1,0
52224,37178,41727,37178,allow,136,136,0,3,14,3,0
51956,443,47122,443,allow,8256,3157,5099,28,46,16,12
59516,443,21075,443,allow,9943,1882,8061,32,33,15,17
13970,42873,0,0,deny,66,66,0,1,0,1,0
51221,51413,55208,51413,allow,460,150,310,2,1201,1,1
1038,37965,0,0,deny,62,62,0,1,0,1,0
50431,445,0,0,drop,70,70,0,1,0,1,0
65436,53,8668,53,allow,234,94,140,2,29,1,1
60162,53436,0,0,deny,66,66,0,1,0,1,0
46265,443,19534,443,allow,173828,9311,164517,245,448,118,127
52629,445,0,0,drop,66,66,0,1,0,1,0
65419,443,11559,443,allow,2494,1643,851,17,24,9,8
52405,443,45940,443,allow,227267,18022,209245,424,38,239,185
49557,443,57017,443,allow,38022,18448,19574,53,57,27,26
63733,47013,45780,47013,allow,66,66,0,2,8,2,0
1046,48817,0,0,deny,62,62,0,1,0,1,0
49191,35440,0,0,deny,62,62,0,1,0,1,0
1025,35447,0,0,deny,62,62,0,1,0,1,0
50398,80,47950,80,allow,318,192,126,6,26,4,2
60227,443,25151,443,allow,6553,871,5682,19,45,9,10
51746,25174,0,0,deny,66,66,0,1,0,1,0
59465,445,0,0,drop,70,70,0,1,0,1,0
45713,53,45713,53,allow,217,87,130,2,30,1,1
50584,40420,46560,40420,allow,868,150,718,4,1200,2,2
51808,46390,34181,46390,allow,70,70,0,1,4,1,0
55088,445,0,0,drop,70,70,0,1,0,1,0
58904,445,0,0,drop,66,66,0,1,0,1,0
52125,53,31811,53,allow,205,86,119,2,29,1,1
59950,53,40733,53,allow,168,78,90,2,31,1,1
60660,445,0,0,drop,70,70,0,1,0,1,0
55979,53,61976,53,allow,275,110,165,2,30,1,1
64567,53,24261,53,allow,199,102,97,2,30,1,1
55216,53,56986,53,allow,179,94,85,2,30,1,1
46537,25174,0,0,deny,62,62,0,1,0,1,0
55966,53,62624,53,allow,747,92,655,2,30,1,1
45977,53,27186,53,allow,164,78,86,2,30,1,1
59401,445,0,0,drop,70,70,0,1,0,1,0
57071,53,20542,53,allow,166,86,80,2,29,1,1
62431,445,0,0,drop,66,66,0,1,0,1,0
59552,445,0,0,drop,66,66,0,1,0,1,0
57459,51505,0,0,deny,66,66,0,1,0,1,0
65161,53,65161,53,allow,256,114,142,2,30,1,1
57557,64147,0,0,deny,62,62,0,1,0,1,0
45627,443,47069,443,allow,7092,1883,5209,21,21,12,9
50920,443,55566,443,allow,6273,1375,4898,18,127,9,9
49511,80,32515,80,allow,1693924,34466,1659458,1627,230,522,1105
57284,445,0,0,drop,66,66,0,1,0,1,0
55065,53,9474,53,allow,168,78,90,2,30,1,1
63904,18268,33783,18268,allow,70,70,0,1,4,1,0
55117,445,0,0,drop,70,70,0,1,0,1,0
49218,445,0,0,drop,70,70,0,1,0,1,0
56778,35440,0,0,deny,66,66,0,1,0,1,0
56864,53,28207,53,allow,200,102,98,2,30,1,1
34179,80,3058,80,allow,2137,1258,879,11,150,6,5
55688,53,38445,53,allow,183,94,89,2,29,1,1
54360,443,26291,443,allow,12260,3870,8390,52,283,27,25
53305,445,0,0,drop,70,70,0,1,0,1,0
42868,443,8590,443,allow,10049,2289,7760,35,27,19,16
62068,64147,0,0,deny,66,66,0,1,0,1,0
48658,53,48919,53,allow,368,80,288,4,30,2,2
55732,53,1656,53,allow,194,102,92,2,30,1,1
53763,50144,49298,50144,allow,492,306,186,8,16,5,3
54815,3389,54815,3389,allow,3428,1714,1714,16,32,8,8
51992,22670,31187,22670,allow,70,70,0,1,4,1,0
50972,443,8971,443,allow,469,403,66,4,0,3,1
56640,443,64695,443,allow,7797,1808,5989,20,14,11,9
55008,21247,0,0,deny,66,66,0,1,0,1,0
56683,443,65170,443,allow,268,120,148,5,11,3,2
38330,44847,0,0,deny,66,66,0,1,0,1,0
49176,443,57308,443,allow,10225,3155,7070,28,57,19,9
59320,445,0,0,drop,70,70,0,1,0,1,0
14567,37965,0,0,deny,62,62,0,1,0,1,0
50582,445,0,0,drop,70,70,0,1,0,1,0
55524,46232,0,0,deny,66,66,0,1,0,1,0
50269,443,37644,443,allow,8272,2455,5817,29,391,10,19
56509,80,38678,80,allow,3697,832,2865,12,15,7,5
57027,123,48138,123,allow,184,94,90,2,30,1,1
39118,443,29645,443,allow,5229,2388,2841,23,367,12,11
11235,30188,0,0,deny,62,62,0,1,0,1,0
37132,443,37132,443,allow,4381,1474,2907,19,27,11,8
51339,50584,0,0,deny,66,66,0,1,0,1,0
59841,445,0,0,drop,66,66,0,1,0,1,0
53817,445,0,0,drop,70,70,0,1,0,1,0
64408,53,53381,53,allow,199,94,105,2,29,1,1
46670,51505,0,0,deny,146,146,0,1,0,1,0
52142,445,0,0,drop,70,70,0,1,0,1,0
65405,53,15243,53,allow,210,102,108,2,30,1,1
65376,445,0,0,drop,66,66,0,1,0,1,0
64670,53,49938,53,allow,228,94,134,2,30,1,1
6881,6881,0,0,deny,146,146,0,1,0,1,0
61518,22,61518,22,allow,7306,2583,4723,36,25,19,17
36907,53,36907,53,allow,237,91,146,2,33,1,1
52273,80,52273,80,allow,156876,7015,149861,158,28,49,109
55072,53,58133,53,allow,168,86,82,2,30,1,1
36785,443,22172,443,allow,1799,1224,575,13,26,8,5
54644,443,51226,443,allow,6440,3492,2948,19,135,9,10
54280,3385,0,0,deny,60,60,0,1,0,1,0
57562,445,0,0,drop,70,70,0,1,0,1,0
2074,32480,0,0,deny,146,146,0,1,0,1,0
64967,53,42572,53,allow,184,94,90,2,29,1,1
50025,53,20225,53,allow,215,94,121,2,30,1,1
63093,443,45246,443,allow,304,86,218,2,30,1,1
49448,53,48392,53,allow,210,102,108,2,30,1,1
52731,445,0,0,drop,66,66,0,1,0,1,0
56543,443,26469,443,allow,245527,10641,234886,322,405,136,186
49558,53,18984,53,allow,177,94,83,2,30,1,1
60899,7275,19563,7275,allow,2875,449,2426,12,16,7,5
41850,443,17792,443,allow,6714,1515,5199,23,196,13,10
52929,1433,0,0,deny,60,60,0,1,0,1,0
57371,53,14687,53,allow,321,108,213,4,33,2,2
55411,53,35188,53,allow,200,94,106,2,30,1,1
51508,443,54920,443,allow,98292,24468,73824,179,52,81,98
60143,445,0,0,drop,70,70,0,1,0,1,0
55525,53,3773,53,allow,214,110,104,2,30,1,1
64905,53,22894,53,allow,458,188,270,6,29,3,3
37343,21247,0,0,deny,62,62,0,1,0,1,0
51910,443,32865,443,allow,308,188,120,4,15,2,2
49698,443,62719,443,allow,14762,1871,12891,30,34,16,14
14084,43890,0,0,deny,146,146,0,1,0,1,0
61886,443,1075,443,allow,8829,3335,5494,16,126,9,7
56807,443,49269,443,allow,8020,2000,6020,20,16,11,9
61509,443,47638,443,allow,1506,984,522,14,27,8,6
50975,80,56708,80,allow,1095845,7641,1088204,839,35,114,725
34454,80,32778,80,allow,1638,1324,314,10,14,5,5
50827,443,7368,443,allow,388366,15919,372447,435,219,158,277
123,123,15561,123,allow,184,94,90,2,30,1,1
58950,5900,0,0,deny,60,60,0,1,0,1,0
49517,80,14591,80,allow,6123,3105,3018,16,38,8,8
56522,53,28369,53,allow,170,87,83,2,30,1,1
49191,80,25150,80,allow,2807,587,2220,13,16,7,6
65291,53,62097,53,allow,247,118,129,2,30,1,1
64145,53,46343,53,allow,177,94,83,2,30,1,1
443,28417,0,0,deny,82,82,0,1,0,1,0
50945,80,53857,80,allow,6920116,91852,6828264,6765,79,1277,5488
57034,44847,0,0,deny,66,66,0,1,0,1,0
35713,443,23137,443,allow,5315,2861,2454,16,135,8,8
53491,445,0,0,drop,70,70,0,1,0,1,0
33642,443,1036,443,allow,8533,4446,4087,65,160,32,33
60786,445,0,0,drop,70,70,0,1,0,1,0
443,60496,0,0,deny,320,320,0,1,0,1,0
62792,53,0,0,deny,88,88,0,1,0,1,0
3478,61463,0,0,deny,409,409,0,1,0,1,0
63743,25174,0,0,deny,62,62,0,1,0,1,0
9226,57470,0,0,deny,66,66,0,1,0,1,0
8889,10794,0,0,deny,60,60,0,1,0,1,0
50007,445,0,0,drop,66,66,0,1,0,1,0
53218,443,1969,443,allow,245772,8639,237133,291,66,103,188
50,64147,0,0,deny,66,66,0,1,0,1,0
48326,53,48326,53,allow,398,255,143,3,33,2,1
65196,445,0,0,drop,66,66,0,1,0,1,0
52119,49239,18789,49239,allow,258,70,188,4,8,2,2
58887,80,17469,80,allow,1493,765,728,10,90,6,4
58404,445,0,0,drop,70,70,0,1,0,1,0
54145,443,52108,443,allow,118,118,0,1,120,1,0
44559,443,29969,443,allow,6903,1185,5718,26,255,12,14
55658,445,0,0,drop,66,66,0,1,0,1,0
50012,445,0,0,drop,70,70,0,1,0,1,0
64020,53,34722,53,allow,196,102,94,2,30,1,1
65528,53,21468,53,allow,168,86,82,2,30,1,1
60832,5222,60932,5222,allow,3848,1039,2809,37,662,11,26
49725,53,18742,53,allow,211,102,109,2,29,1,1
51501,445,0,0,drop,70,70,0,1,0,1,0
57600,53,41878,53,allow,168,78,90,2,30,1,1
62018,445,0,0,drop,70,70,0,1,0,1,0
48817,50321,48817,50321,allow,334,158,176,2,1203,1,1
51486,445,0,0,drop,70,70,0,1,0,1,0
52836,36829,0,0,deny,62,62,0,1,0,1,0
36503,443,18047,443,allow,3549,899,2650,13,120,6,7
56219,53,60572,53,allow,177,94,83,2,30,1,1
47400,80,8007,80,allow,9083,1822,7261,20,257,5,15
53878,445,0,0,drop,66,66,0,1,0,1,0
51098,445,0,0,drop,70,70,0,1,0,1,0
49216,53,46478,53,allow,316,91,225,4,32,2,2
39098,443,35056,443,allow,5519,1493,4026,20,121,9,11
54823,53,13813,53,allow,198,93,105,2,30,1,1
42204,443,21062,443,allow,6197,942,5255,19,361,10,9
22078,53,22078,53,allow,229,98,131,2,30,1,1
22683,39210,0,0,deny,60,60,0,1,0,1,0
55677,445,0,0,drop,70,70,0,1,0,1,0
49557,53,61895,53,allow,1298,100,1198,4,32,2,2
52022,53657,34064,53657,allow,70,70,0,2,8,2,0
58638,5900,0,0,deny,62,62,0,1,0,1,0
27005,27015,35469,27015,allow,886,126,760,2,30,1,1
50017,53,60474,53,allow,195,102,93,2,30,1,1
52787,443,46630,443,allow,352,218,134,6,28,4,2
60353,80,51111,80,allow,1679,1269,410,8,15,5,3
58638,5900,0,0,deny,62,62,0,1,0,1,0
65209,57866,0,0,deny,66,66,0,1,0,1,0
64858,53,57701,53,allow,196,102,94,2,30,1,1
52430,22114,0,0,deny,62,62,0,1,0,1,0
55580,445,0,0,drop,70,70,0,1,0,1,0
15503,58675,42815,58675,allow,2227,1224,1003,20,1200,11,9
58326,445,0,0,drop,66,66,0,1,0,1,0
57286,445,0,0,drop,70,70,0,1,0,1,0
38405,80,54534,80,allow,1114,534,580,12,16,7,5
16001,48817,0,0,deny,143,143,0,1,0,1,0
52055,20019,40122,20019,allow,316,136,180,6,7,3,3
49846,443,59260,443,allow,278883,9002,269881,313,72,115,198
52091,11392,0,0,deny,66,66,0,1,0,1,0
57753,445,0,0,drop,70,70,0,1,0,1,0
49949,80,34072,80,allow,16663,923,15740,25,15,11,14
56682,53,37640,53,allow,168,86,82,2,30,1,1
59125,445,0,0,drop,66,66,0,1,0,1,0
63082,445,0,0,drop,70,70,0,1,0,1,0
56914,53,35890,53,allow,100,100,0,2,35,2,0
16376,35440,0,0,deny,62,62,0,1,0,1,0
27005,33052,60950,33052,allow,873,126,747,2,31,1,1
55855,445,0,0,drop,70,70,0,1,0,1,0
59569,445,0,0,drop,66,66,0,1,0,1,0
10701,11392,0,0,deny,62,62,0,1,0,1,0
56659,443,25934,443,allow,1579,988,591,13,24,7,6
16620,25174,0,0,deny,62,62,0,1,0,1,0
44074,443,54425,443,allow,5498,3406,2092,28,95,16,12
61566,44847,0,0,deny,62,62,0,1,0,1,0
7342,22114,0,0,deny,66,66,0,1,0,1,0
58638,5900,0,0,deny,62,62,0,1,0,1,0
60610,443,53274,443,allow,187258,9720,177538,225,211,86,139
60176,445,0,0,drop,70,70,0,1,0,1,0
49609,80,24955,80,allow,11534,719,10815,18,61,7,11
50773,445,0,0,drop,70,70,0,1,0,1,0
36993,443,63240,443,allow,7768,3071,4697,23,17,12,11
64373,53,26971,53,allow,554,96,458,4,60,2,2
55597,7485,9099,7485,allow,70,70,0,2,8,2,0
49823,53,39665,53,allow,209,110,99,2,31,1,1
58727,445,0,0,drop,70,70,0,1,0,1,0
56939,53,50675,53,allow,216,110,106,2,31,1,1
52640,64147,0,0,deny,62,62,0,1,0,1,0
40786,53,0,0,allow,82,82,0,1,30,1,0
65180,53,26372,53,allow,165,86,79,2,30,1,1
51699,37224,26533,37224,allow,66,66,0,1,5,1,0
55061,443,38247,443,allow,18682,8068,10614,42,62,22,20
57235,445,0,0,drop,70,70,0,1,0,1,0
65315,53,35548,53,allow,178,94,84,2,29,1,1
50025,53,33178,53,allow,761,102,659,2,30,1,1
39687,443,29168,443,allow,10412,5123,5289,36,236,19,17
27947,26467,0,0,deny,62,62,0,1,0,1,0
55427,64147,0,0,deny,66,66,0,1,0,1,0
64813,53,11826,53,allow,335,90,245,4,35,2,2
49674,53,9150,53,allow,211,102,109,2,29,1,1
49319,53,62578,53,allow,199,102,97,2,30,1,1
56131,445,0,0,drop,70,70,0,1,0,1,0
51608,443,59688,443,allow,4646,2347,2299,17,34,9,8
55828,53,17599,53,allow,181,94,87,2,30,1,1
52160,443,34670,443,allow,6679,3424,3255,19,138,10,9
39569,443,39569,443,allow,4601,1694,2907,19,28,11,8
49500,80,17093,80,allow,309313,41646,267667,433,486,113,320
57300,53,9339,53,allow,184,94,90,2,29,1,1
56363,53,60359,53,allow,269,94,175,2,30,1,1
52108,80,27420,80,allow,182,60,122,4,25,2,2
60382,62582,18649,62582,allow,70,70,0,2,8,2,0
54734,445,0,0,drop,70,70,0,1,0,1,0
56770,52920,52041,52920,allow,70,70,0,2,8,2,0
50212,1688,47539,1688,allow,70,70,0,1,5,1,0
35400,443,23133,443,allow,11083,4080,7003,38,40,14,24
56656,53,41327,53,allow,255,88,167,4,52,2,2
54951,443,21945,443,allow,69882,3520,66362,96,320,38,58
54071,50265,0,0,deny,66,66,0,1,0,1,0
65423,445,0,0,drop,70,70,0,1,0,1,0
27081,10197,0,0,deny,62,62,0,1,0,1,0
51692,993,54748,993,allow,11462,4282,7180,61,37,28,33
46162,25174,0,0,deny,62,62,0,1,0,1,0
57470,51413,13214,51413,allow,490,163,327,2,1200,1,1
443,15564,0,0,deny,85,85,0,1,0,1,0
40847,25174,0,0,deny,146,146,0,1,0,1,0
57247,445,0,0,drop,66,66,0,1,0,1,0
52563,17235,0,0,deny,74,74,0,1,0,1,0
64305,445,0,0,drop,70,70,0,1,0,1,0
35100,11392,0,0,deny,62,62,0,1,0,1,0
22530,25174,0,0,deny,146,146,0,1,0,1,0
55178,80,55178,80,allow,374,240,134,7,15,5,2
43872,53,52878,53,allow,199,94,105,2,30,1,1
50584,8999,33361,8999,allow,1237,369,868,6,1199,3,3
60251,445,0,0,drop,70,70,0,1,0,1,0
61414,80,32431,80,allow,22368,2947,19421,53,137,24,29
52184,57262,17429,57262,allow,66,66,0,1,5,1,0
27005,27015,23860,27015,allow,871,126,745,2,31,1,1
15180,26467,0,0,deny,62,62,0,1,0,1,0
53786,53,10105,53,allow,260,86,174,2,30,1,1
58263,445,0,0,drop,70,70,0,1,0,1,0
49841,53,36944,53,allow,227,110,117,2,30,1,1
34306,37965,0,0,deny,62,62,0,1,0,1,0
23934,41615,0,0,deny,145,145,0,1,0,1,0
61419,57470,0,0,deny,66,66,0,1,0,1,0
64217,53,58721,53,allow,186,95,91,2,31,1,1
65024,51505,0,0,deny,62,62,0,1,0,1,0
56079,53,40631,53,allow,199,102,97,2,29,1,1
55254,443,18680,443,allow,13275,3587,9688,38,27,20,18
50915,443,63177,443,allow,9599,3465,6134,20,16,11,9
51962,80,39391,80,allow,422,240,182,8,25,5,3
65009,445,0,0,drop,66,66,0,1,0,1,0
49638,443,58989,443,allow,5776,1079,4697,15,52,8,7
37965,15357,58016,15357,allow,481,150,331,2,1200,1,1
9373,80,65080,80,allow,1643,485,1158,10,15,5,5
35554,443,35554,443,allow,4378,1471,2907,19,28,11,8
55972,445,0,0,drop,70,70,0,1,0,1,0
57007,53,30076,53,allow,182,93,89,2,31,1,1
62207,445,0,0,drop,70,70,0,1,0,1,0
45964,7778,0,0,deny,60,60,0,1,0,1,0
18011,44847,0,0,deny,66,66,0,1,0,1,0
51801,33531,13546,33531,allow,70,70,0,1,5,1,0
51045,25174,0,0,deny,66,66,0,1,0,1,0
47167,15000,34015,15000,allow,130,70,60,2,6,1,1
59378,445,0,0,drop,70,70,0,1,0,1,0
41628,15000,25474,15000,allow,130,70,60,2,6,1,1
56358,80,8330,80,allow,1569,1077,492,11,30,6,5
33227,443,20860,443,allow,8888,1757,7131,26,174,15,11
52380,443,20377,443,allow,8659,3601,5058,34,80,18,16
58139,445,0,0,drop,70,70,0,1,0,1,0
55439,53,12410,53,allow,738,86,652,2,30,1,1
24592,50584,0,0,deny,62,62,0,1,0,1,0
54748,53,4076,53,allow,245,110,135,2,30,1,1
53404,445,0,0,drop,70,70,0,1,0,1,0
50710,445,0,0,drop,70,70,0,1,0,1,0
34710,53,34710,53,allow,244,98,146,2,33,1,1
65207,53,42618,53,allow,277,110,167,2,30,1,1
53042,443,14232,443,allow,5452,1545,3907,22,16,13,9
57649,6881,0,0,deny,62,62,0,1,0,1,0
49227,53,18246,53,allow,179,94,85,2,31,1,1
54238,445,0,0,drop,70,70,0,1,0,1,0
26425,22114,0,0,deny,62,62,0,1,0,1,0
56126,445,0,0,drop,70,70,0,1,0,1,0
55114,443,11994,443,allow,14680,6119,8561,35,152,16,19
59225,57587,0,0,deny,66,66,0,1,0,1,0
64318,53,59823,53,allow,182,93,89,2,31,1,1
54305,35440,0,0,deny,62,62,0,1,0,1,0
57255,443,56046,443,allow,36865,3692,33173,61,47,30,31
55921,53,12219,53,allow,747,92,655,2,31,1,1
55699,21063,52402,21063,allow,70,70,0,1,5,1,0
49437,53,10171,53,allow,199,102,97,2,30,1,1
42451,443,55087,443,allow,4886,895,3991,16,31,9,7
10396,62609,0,0,deny,148,148,0,1,0,1,0
56026,53,28063,53,allow,183,94,89,2,30,1,1
53821,7788,19069,7788,allow,70,70,0,2,8,2,0
56646,443,10246,443,allow,1327,918,409,10,26,6,4
63586,46824,0,0,deny,62,62,0,1,0,1,0
49499,443,13640,443,allow,87970,5355,82615,141,483,55,86
64715,53,13561,53,allow,770,102,668,2,30,1,1
46774,64147,0,0,deny,145,145,0,1,0,1,0
56543,443,22323,443,allow,1323,616,707,18,120,9,9
55005,53,24549,53,allow,183,94,89,2,30,1,1
58497,39004,0,0,deny,66,66,0,1,0,1,0
65189,27257,41492,27257,allow,252,78,174,2,29,1,1
56330,53,24669,53,allow,711,87,624,2,30,1,1
52122,445,0,0,drop,70,70,0,1,0,1,0
49682,53,35686,53,allow,341,110,231,2,29,1,1
65107,53,22367,53,allow,266,87,179,4,35,2,2
56819,53,1488,53,allow,209,110,99,2,30,1,1
20864,51221,0,0,deny,62,62,0,1,0,1,0
48758,443,1312,443,allow,6353,1075,5278,18,33,10,8
50895,445,0,0,drop,70,70,0,1,0,1,0
52088,35605,27322,35605,allow,70,70,0,1,5,1,0
52611,9571,0,0,deny,62,62,0,1,0,1,0
57378,445,0,0,drop,66,66,0,1,0,1,0
51942,22272,28402,22272,allow,140,70,70,2,5,1,1
55146,53,34694,53,allow,181,94,87,2,30,1,1
443,50755,0,0,deny,102,102,0,1,0,1,0
15442,22114,0,0,deny,62,62,0,1,0,1,0
35666,443,50206,443,allow,3389452,85022,3304430,3290,159,997,2293
57122,445,0,0,drop,66,66,0,1,0,1,0
53869,443,21669,443,allow,499,425,74,4,1,3,1
64493,53,34209,53,allow,280,97,183,4,59,2,2
61467,443,56685,443,allow,130792,4916,125876,161,89,69,92
58638,5900,0,0,deny,62,62,0,1,0,1,0
53100,445,0,0,drop,70,70,0,1,0,1,0
60786,25174,0,0,deny,66,66,0,1,0,1,0
45007,22114,0,0,deny,146,146,0,1,0,1,0
8978,443,11135,443,allow,49938,20855,29083,165,216,81,84
55835,443,26347,443,allow,10087,3968,6119,32,271,17,15
26699,35253,0,0,deny,62,62,0,1,0,1,0
64387,37965,0,0,deny,62,62,0,1,0,1,0
52161,19897,37234,19897,allow,70,70,0,1,4,1,0
60241,445,0,0,drop,70,70,0,1,0,1,0
52179,14354,64270,14354,allow,70,70,0,2,8,2,0
63234,445,0,0,drop,70,70,0,1,0,1,0
52067,46837,56641,46837,allow,70,70,0,1,5,1,0
50673,443,61982,443,allow,14723,2606,12117,54,19,22,32
58830,443,23946,443,allow,5168,700,4468,16,15,7,9
56079,53,34259,53,allow,740,93,647,2,31,1,1
30109,5223,0,0,deny,148,148,0,1,0,1,0
52150,445,0,0,drop,70,70,0,1,0,1,0
36829,443,57108,443,allow,560,280,280,9,27,5,4
56109,53,59181,53,allow,323,102,221,2,29,1,1
50265,43178,20188,43178,allow,481,150,331,2,1200,1,1
55636,80,55636,80,allow,1916,1467,449,10,19,6,4
50210,1688,10212,1688,allow,70,70,0,1,5,1,0
64183,445,0,0,drop,66,66,0,1,0,1,0
27005,27056,45270,27056,allow,908,126,782,2,31,1,1
64287,53,53632,53,allow,181,94,87,2,30,1,1
57656,445,0,0,drop,66,66,0,1,0,1,0
5926,25174,0,0,deny,146,146,0,1,0,1,0
58034,443,53963,443,allow,10192,3621,6571,24,36,12,12
56878,53,21554,53,allow,168,86,82,2,31,1,1
0,0,0,0,allow,600,306,294,6,0,3,3
27005,27027,32399,27027,allow,880,126,754,2,31,1,1
58858,445,0,0,drop,66,66,0,1,0,1,0
60263,443,35248,443,allow,5889,2893,2996,45,149,24,21
62194,50584,0,0,deny,62,62,0,1,0,1,0
53324,44847,0,0,deny,66,66,0,1,0,1,0
21187,53,21187,53,allow,208,94,114,2,30,1,1
53065,445,0,0,drop,66,66,0,1,0,1,0
56917,443,25330,443,allow,14033,1591,12442,26,132,10,16
52210,15604,53868,15604,allow,70,70,0,2,8,2,0
48817,45682,48817,45682,allow,513,152,361,2,1200,1,1
61865,35440,0,0,deny,66,66,0,1,0,1,0
34233,993,0,0,deny,60,60,0,1,0,1,0
41157,443,35776,443,allow,78535,3648,74887,94,30,41,53
44849,46478,0,0,deny,74,74,0,1,0,1,0
55836,53,27528,53,allow,181,94,87,2,30,1,1
56852,443,47368,443,allow,8215,2882,5333,32,90,16,16
60097,22114,0,0,deny,66,66,0,1,0,1,0
58638,5900,0,0,deny,62,62,0,1,0,1,0
63974,80,35530,80,allow,314,192,122,6,15,4,2
53476,5900,0,0,deny,60,60,0,1,0,1,0
38658,443,22719,443,allow,1294,864,430,12,81,7,5
64382,53,40543,53,allow,278,102,176,2,30,1,1
58127,445,0,0,drop,66,66,0,1,0,1,0
59162,445,0,0,drop,70,70,0,1,0,1,0
54064,445,0,0,drop,66,66,0,1,0,1,0
2089,7000,2089,7000,allow,2227,676,1551,15,14,7,8
59639,445,0,0,drop,70,70,0,1,0,1,0
56215,53,26623,53,allow,216,110,106,2,31,1,1
58835,443,12321,443,allow,9823,2600,7223,46,195,23,23
49777,53,59395,53,allow,164,84,80,2,31,1,1
49253,53,38638,53,allow,727,86,641,2,29,1,1
55836,53,8077,53,allow,170,87,83,2,31,1,1
49528,443,34727,443,allow,5968,985,4983,17,28,8,9
49333,443,11751,443,allow,30571,1990,28581,53,80,21,32
17027,1,0,0,deny,62,62,0,1,0,1,0
54327,445,0,0,drop,70,70,0,1,0,1,0
64339,445,0,0,drop,70,70,0,1,0,1,0
64420,53,48861,53,allow,294,95,199,4,42,2,2
56834,445,0,0,drop,66,66,0,1,0,1,0
56496,53,60823,53,allow,186,95,91,2,30,1,1
36368,80,60128,80,allow,78,78,0,1,5,1,0
48360,3389,48360,3389,allow,4085,1916,2169,21,19,12,9
58318,445,0,0,drop,70,70,0,1,0,1,0
60081,443,25599,443,allow,10893,4674,6219,43,121,19,24
64088,53,9032,53,allow,434,108,326,4,51,2,2
53691,445,0,0,drop,66,66,0,1,0,1,0
58178,53,58178,53,allow,237,93,144,2,31,1,1
62875,53,0,0,allow,205,80,125,2,30,1,1
59724,64147,0,0,deny,62,62,0,1,0,1,0
27898,52700,0,0,deny,62,62,0,1,0,1,0
58511,50584,0,0,deny,62,62,0,1,0,1,0
64340,53,7157,53,allow,266,110,156,2,30,1,1
52038,14487,65073,14487,allow,66,66,0,1,5,1,0
53907,443,41234,443,allow,499,425,74,4,0,3,1
59993,443,5215,443,allow,6452,2146,4306,30,125,14,16
43625,53,13195,53,allow,86,86,0,1,30,1,0
51101,80,9411,80,allow,366,240,126,7,20,5,2
49780,445,0,0,drop,70,70,0,1,0,1,0
55850,53,58369,53,allow,816,97,719,2,30,1,1
57470,64738,24802,64738,allow,1577,594,983,20,1582,10,10
51982,80,16574,80,allow,2776,2091,685,9,47,5,4
57165,53,7622,53,allow,498,204,294,6,30,3,3
49512,53,64595,53,allow,210,102,108,2,30,1,1
55153,443,47094,443,allow,5897,1982,3915,20,18,11,9
52200,42430,15926,42430,allow,66,66,0,2,10,2,0
31627,64147,0,0,deny,62,62,0,1,0,1,0
51815,28665,10000,28665,allow,70,70,0,1,4,1,0
26698,25174,0,0,deny,62,62,0,1,0,1,0
17010,57470,0,0,deny,62,62,0,1,0,1,0
50210,26467,0,0,deny,62,62,0,1,0,1,0
39011,80,17481,80,allow,1114,534,580,12,15,7,5
64036,53,37626,53,allow,692,224,468,6,49,3,3
55340,53,11264,53,allow,184,94,90,2,30,1,1
14042,22114,0,0,deny,146,146,0,1,0,1,0
63228,445,0,0,drop,70,70,0,1,0,1,0
55715,443,55715,443,allow,4575,1668,2907,19,30,11,8
60329,443,10695,443,allow,2859,1499,1360,20,315,10,10
6916,52700,0,0,deny,100,100,0,1,0,1,0
52928,80,52040,80,allow,1996,691,1305,10,359,6,4
43368,443,39927,443,allow,190,70,120,4,15,2,2
58638,5900,0,0,deny,62,62,0,1,0,1,0
51029,445,0,0,drop,70,70,0,1,0,1,0
58241,445,0,0,drop,66,66,0,1,0,1,0
54620,80,5302,80,allow,14855,1611,13244,26,77,14,12
60215,80,6497,80,allow,21073,15881,5192,47,151,30,17
18686,53,18686,53,allow,235,90,145,2,32,1,1
62550,51505,0,0,deny,66,66,0,1,0,1,0
50679,80,31597,80,allow,62,62,0,1,4,1,0
49889,445,0,0,drop,66,66,0,1,0,1,0
53353,26467,0,0,deny,62,62,0,1,0,1,0
49283,6881,34041,6881,allow,803,617,186,6,16,3,3
58653,53,0,0,allow,82,82,0,1,30,1,0
57000,53,24193,53,allow,194,102,92,2,30,1,1
51426,80,51426,80,allow,114697,3049,111648,114,26,35,79
2182,53,2182,53,allow,643,88,555,2,30,1,1
23900,64147,0,0,deny,62,62,0,1,0,1,0
57477,445,0,0,drop,70,70,0,1,0,1,0
62089,445,0,0,drop,66,66,0,1,0,1,0
55624,53,59892,53,allow,308,101,207,4,53,2,2
50380,53,4521,53,allow,737,94,643,2,29,1,1
61927,445,0,0,drop,70,70,0,1,0,1,0
59128,44847,0,0,deny,66,66,0,1,0,1,0
62328,443,62328,443,allow,1210,637,573,14,51,7,7
51814,443,41543,443,allow,6133,1655,4478,12,120,5,7
80,44459,0,0,deny,66,66,0,1,0,1,0
22714,30188,0,0,deny,146,146,0,1,0,1,0
50307,53,50594,53,allow,1370,89,1281,4,33,2,2
56928,53,57142,53,allow,178,94,84,2,30,1,1
55808,53,36895,53,allow,183,94,89,2,30,1,1
6590,80,6590,80,allow,326,186,140,6,29,4,2
55349,53,28852,53,allow,744,89,655,2,30,1,1
61600,56205,0,0,deny,66,66,0,1,0,1,0
57470,52177,52924,52177,allow,1980,1980,0,31,2321,31,0
53930,19831,55247,19831,allow,70,70,0,1,5,1,0
65036,53,28927,53,allow,214,110,104,2,30,1,1
49676,53,40519,53,allow,197,102,95,2,30,1,1
64022,53,2782,53,allow,197,102,95,2,30,1,1
50530,445,0,0,drop,66,66,0,1,0,1,0
57277,445,0,0,drop,66,66,0,1,0,1,0
49531,80,57829,80,allow,78,78,0,1,5,1,0
61329,445,0,0,drop,70,70,0,1,0,1,0
51407,443,24262,443,allow,22626,10213,12413,35,57,20,15
64742,53,25271,53,allow,165,86,79,2,29,1,1
52830,445,0,0,drop,70,70,0,1,0,1,0
65515,53,42704,53,allow,210,110,100,2,29,1,1
23216,53,23216,53,allow,235,90,145,2,33,1,1
57470,54154,42196,54154,allow,480,149,331,2,1200,1,1
27005,29999,60743,29999,allow,887,126,761,2,31,1,1
49945,53,62137,53,allow,198,102,96,2,30,1,1
55752,8060,41329,8060,allow,70,70,0,1,4,1,0
49385,53,59773,53,allow,241,102,139,2,29,1,1
51262,35440,0,0,deny,66,66,0,1,0,1,0
7744,32480,0,0,deny,62,62,0,1,0,1,0
27209,25198,0,0,deny,145,145,0,1,0,1,0
53722,443,10654,443,allow,70,70,0,2,7,2,0
64802,80,15134,80,allow,2424,529,1895,11,75,6,5
5955,55160,0,0,deny,74,74,0,1,0,1,0
64643,53,62127,53,allow,177,94,83,2,30,1,1
56380,53,36495,53,allow,177,94,83,2,30,1,1
49150,51505,0,0,deny,146,146,0,1,0,1,0
51401,445,0,0,drop,70,70,0,1,0,1,0
2904,44847,0,0,deny,78,78,0,1,0,1,0
55463,53,53091,53,allow,216,110,106,2,31,1,1
40797,25174,0,0,deny,62,62,0,1,0,1,0
50552,80,50552,80,allow,2887,1776,1111,14,22,8,6
58638,5900,58638,5900,allow,130,66,64,2,4,1,1
53314,64097,0,0,deny,66,66,0,1,0,1,0
3077,50584,0,0,deny,146,146,0,1,0,1,0
55822,445,0,0,drop,70,70,0,1,0,1,0
51662,443,4972,443,allow,7532,3051,4481,13,121,6,7
55771,80,55771,80,allow,3538,701,2837,11,20,6,5
51836,37753,15245,37753,allow,70,70,0,2,7,2,0
55076,80,31296,80,allow,1129,580,549,11,74,6,5
57409,53,6816,53,allow,168,86,82,2,31,1,1
42252,33303,0,0,deny,60,60,0,1,0,1,0
34014,80,56105,80,allow,1951,731,1220,11,150,6,5
49470,443,50216,443,allow,2772,1777,995,16,124,9,7
49849,53,11014,53,allow,196,102,94,2,30,1,1
52162,15104,24399,15104,allow,70,70,0,1,5,1,0
58845,443,51619,443,allow,22402,14820,7582,52,20,29,23
46593,28678,34181,28678,allow,1806,1806,0,22,224,22,0
55142,53,43974,53,allow,889,404,485,10,30,5,5
55692,53,35310,53,allow,196,100,96,2,30,1,1
55190,445,0,0,drop,70,70,0,1,0,1,0
52952,443,15638,443,allow,9381,3074,6307,47,114,24,23
6832,51505,0,0,deny,66,66,0,1,0,1,0
56924,26467,0,0,deny,62,62,0,1,0,1,0
50280,57470,0,0,deny,78,78,0,1,0,1,0
14343,6881,0,0,deny,146,146,0,1,0,1,0
54786,30188,0,0,deny,66,66,0,1,0,1,0
56624,53,45708,53,allow,170,87,83,2,30,1,1
21892,15503,0,0,deny,62,62,0,1,0,1,0
60357,5900,0,0,deny,60,60,0,1,0,1,0
49627,53,57352,53,allow,288,110,178,2,31,1,1
57162,443,26306,443,allow,1798,1223,575,13,25,8,5
57005,445,0,0,drop,70,70,0,1,0,1,0
51795,60258,28772,60258,allow,70,70,0,1,5,1,0
50901,80,6668,80,allow,14661588,141996,14519592,11768,134,2012,9756
51876,35624,49210,35624,allow,70,70,0,1,5,1,0
55468,23,0,0,deny,60,60,0,1,0,1,0
60861,445,0,0,drop,70,70,0,1,0,1,0
65480,443,49360,443,allow,310863,9840,301023,323,16,115,208
53772,443,49684,443,allow,499,425,74,4,0,3,1
62912,443,19185,443,allow,10829,2227,8602,35,47,20,15
49474,445,0,0,drop,70,70,0,1,0,1,0
53716,443,22368,443,allow,7055,1261,5794,21,82,10,11
48301,25174,0,0,deny,62,62,0,1,0,1,0
63091,443,18908,443,allow,382,164,218,2,30,1,1
55975,53,39571,53,allow,195,102,93,2,30,1,1
64955,53,11149,53,allow,761,100,661,2,0,1,1
57452,445,0,0,drop,70,70,0,1,0,1,0
63067,443,13404,443,allow,2570995,60656,2510339,2538,34,844,1694
49384,53,2964,53,allow,186,95,91,2,30,1,1
28539,53,28539,53,allow,231,88,143,2,32,1,1
35185,3389,35185,3389,allow,3424,1710,1714,16,33,8,8
49284,53,21270,53,allow,177,94,83,2,30,1,1
49413,53,52444,53,allow,231,110,121,2,30,1,1
3792,52700,0,0,deny,62,62,0,1,0,1,0
37628,443,37587,443,allow,5783,1761,4022,24,46,14,10
41451,53,15515,53,allow,359,86,273,2,30,1,1
61382,25174,0,0,deny,66,66,0,1,0,1,0
64381,53,26257,53,allow,198,102,96,2,30,1,1
26799,50584,0,0,deny,62,62,0,1,0,1,0
56214,53,46867,53,allow,200,102,98,2,33,1,1
58638,5900,0,0,deny,62,62,0,1,0,1,0
50777,53,12522,53,allow,199,94,105,2,30,1,1
64791,53,19745,53,allow,763,102,661,2,29,1,1
1620,53567,0,0,deny,62,62,0,1,0,1,0
50868,445,0,0,drop,66,66,0,1,0,1,0
7968,2767,0,0,deny,66,66,0,1,0,1,0
65501,26467,0,0,deny,66,66,0,1,0,1,0
49171,53,3246,53,allow,199,102,97,2,30,1,1
49480,53,59035,53,allow,184,94,90,2,31,1,1
55569,443,40443,443,allow,8867,3511,5356,20,120,9,11
50063,35776,0,0,deny,148,148,0,1,0,1,0
27309,6881,0,0,deny,62,62,0,1,0,1,0
52491,53,62857,53,allow,289,86,203,2,30,1,1
57092,53,22566,53,allow,756,95,661,2,31,1,1
38691,443,60473,443,allow,90369,3417,86952,95,15,30,65
23537,35253,0,0,deny,66,66,0,1,0,1,0
36287,443,35494,443,allow,6419,2962,3457,25,148,12,13
33637,443,44559,443,allow,24214,18131,6083,81,118,44,37
49737,53,34228,53,allow,184,86,98,2,31,1,1
57396,53,31064,53,allow,183,94,89,2,30,1,1
3093,62413,0,0,deny,62,62,0,1,0,1,0
49844,445,0,0,drop,66,66,0,1,0,1,0
51221,53239,19108,53239,allow,1487,594,893,19,1571,10,9
62012,445,0,0,drop,70,70,0,1,0,1,0
23939,41615,0,0,deny,146,146,0,1,0,1,0
22530,23718,0,0,deny,62,62,0,1,0,1,0
49696,443,61815,443,allow,42348,4871,37477,71,150,40,31
46910,443,1706,443,allow,5714,1536,4178,24,21,13,11
50072,53,26115,53,allow,164,86,78,2,30,1,1
57927,445,0,0,drop,70,70,0,1,0,1,0
45079,31573,0,0,deny,66,66,0,1,0,1,0
51370,445,0,0,drop,70,70,0,1,0,1,0
50523,53,17417,53,allow,199,102,97,2,30,1,1
56773,28093,5962,28093,allow,70,70,0,2,8,2,0
9687,57470,0,0,deny,78,78,0,1,0,1,0
41447,64147,0,0,deny,62,62,0,1,0,1,0
1323,64147,0,0,deny,66,66,0,1,0,1,0
62840,445,0,0,drop,70,70,0,1,0,1,0
52210,80,30096,80,allow,372,246,126,6,30,4,2
55156,53,47092,53,allow,256,87,169,4,36,2,2
53252,443,27483,443,allow,31843,2847,28996,50,323,20,30
49289,53,16244,53,allow,177,94,83,2,30,1,1
61191,445,0,0,drop,66,66,0,1,0,1,0
64982,53,19403,53,allow,190,97,93,2,31,1,1
56400,445,0,0,drop,66,66,0,1,0,1,0
59840,445,0,0,drop,70,70,0,1,0,1,0
45118,39004,0,0,deny,74,74,0,1,0,1,0
9149,443,28137,443,allow,6128,763,5365,17,29,9,8
57904,443,64826,443,allow,7912,3215,4697,23,20,12,11
42151,53,3505,53,allow,168,78,90,2,30,1,1
65024,53,10602,53,allow,196,94,102,2,30,1,1
50116,22,50116,22,allow,184,120,64,4,4,3,1
47821,53,47821,53,allow,228,97,131,2,30,1,1
11478,51221,0,0,deny,66,66,0,1,0,1,0
8760,22114,0,0,deny,66,66,0,1,0,1,0
32381,50584,0,0,deny,66,66,0,1,0,1,0
60091,443,19389,443,allow,2531,1288,1243,17,140,9,8
58209,53,48023,53,allow,259,86,173,2,30,1,1
59618,443,47989,443,allow,5682,1562,4120,23,61,13,10
52560,445,0,0,drop,70,70,0,1,0,1,0
49825,443,10152,443,allow,15401,3011,12390,37,65,21,16
56227,53,28291,53,allow,179,94,85,2,30,1,1
0,0,0,0,allow,156,156,0,2,0,2,0
44849,46478,0,0,deny,74,74,0,1,0,1,0
61686,53,52741,53,allow,196,86,110,2,30,1,1
52202,443,56757,443,allow,3036,818,2218,12,119,6,6
65005,53,27346,53,allow,776,102,674,2,30,1,1
25328,23,0,0,deny,60,60,0,1,0,1,0
27005,27015,18996,27015,allow,1618,126,1492,4,30,2,2
53300,37807,0,0,deny,66,66,0,1,0,1,0
42758,123,49346,123,allow,184,94,90,2,30,1,1
49865,443,1213,443,allow,8535,1936,6599,22,87,12,10
59094,445,0,0,drop,66,66,0,1,0,1,0
33818,443,39799,443,allow,16265,3132,13133,54,276,26,28
58259,445,0,0,drop,70,70,0,1,0,1,0
63811,80,47846,80,allow,314,192,122,6,15,4,2
56450,445,0,0,drop,70,70,0,1,0,1,0
51622,445,0,0,drop,66,66,0,1,0,1,0
53102,53,13819,53,allow,70,70,0,1,30,1,0
60395,6890,18737,6890,allow,70,70,0,1,5,1,0
55010,445,0,0,drop,70,70,0,1,0,1,0
56125,53,57582,53,allow,168,86,82,2,30,1,1
1821,64147,0,0,deny,66,66,0,1,0,1,0
50326,443,7479,443,allow,7819,2474,5345,25,82,13,12
61918,445,0,0,drop,66,66,0,1,0,1,0
62911,36237,0,0,deny,66,66,0,1,0,1,0
20939,60461,0,0,deny,60,60,0,1,0,1,0
33830,443,43990,443,allow,448,78,370,6,25,1,5
55916,445,0,0,drop,70,70,0,1,0,1,0
64485,53,38773,53,allow,182,93,89,2,30,1,1
54014,5228,26717,5228,allow,2493,1541,952,16,3601,8,8
57206,123,21797,123,allow,184,94,90,2,30,1,1
56386,53,3694,53,allow,177,94,83,2,30,1,1
13413,44847,0,0,deny,66,66,0,1,0,1,0
53801,443,63448,443,allow,499,425,74,4,0,3,1
57564,56205,0,0,deny,62,62,0,1,0,1,0
47749,53,47749,53,allow,248,106,142,2,30,1,1
49573,443,25314,443,allow,1820,1101,719,18,16,10,8
57436,53,48007,53,allow,183,94,89,2,30,1,1
63766,80,33525,80,allow,314,192,122,6,15,4,2
55271,53,59088,53,allow,168,86,82,2,29,1,1
56741,53,9430,53,allow,814,110,704,2,30,1,1
55144,443,25818,443,allow,6918,2826,4092,26,21,16,10
49308,53,4514,53,allow,195,102,93,2,30,1,1
61782,445,0,0,drop,66,66,0,1,0,1,0
51140,80,51140,80,allow,514,246,268,9,42,5,4
52912,53,52912,53,allow,237,91,146,2,32,1,1
50109,53,42164,53,allow,198,110,88,2,30,1,1
55829,53,11417,53,allow,212,110,102,2,29,1,1
49442,445,0,0,drop,66,66,0,1,0,1,0
443,20087,0,0,deny,83,83,0,1,0,1,0
59115,445,0,0,drop,70,70,0,1,0,1,0
51342,445,0,0,drop,70,70,0,1,0,1,0
50645,53,43858,53,allow,256,93,163,2,31,1,1
51623,445,0,0,drop,66,66,0,1,0,1,0
51222,35440,0,0,deny,66,66,0,1,0,1,0
60723,445,0,0,drop,70,70,0,1,0,1,0
51745,57470,0,0,deny,62,62,0,1,0,1,0
41343,443,31271,443,allow,7601,1595,6006,25,35,12,13
19944,22114,0,0,deny,66,66,0,1,0,1,0
43584,24748,0,0,deny,156,156,0,1,0,1,0
50424,55777,0,0,deny,62,62,0,1,0,1,0
24910,64147,0,0,deny,66,66,0,1,0,1,0
1054,15503,0,0,deny,62,62,0,1,0,1,0
63882,445,0,0,drop,70,70,0,1,0,1,0
33401,51505,0,0,deny,66,66,0,1,0,1,0
33884,53,0,0,allow,86,86,0,1,30,1,0
64815,53,51366,53,allow,214,110,104,2,30,1,1
55133,53,7400,53,allow,711,87,624,2,30,1,1
50630,53,37346,53,allow,754,94,660,2,30,1,1
50897,445,0,0,drop,70,70,0,1,0,1,0
38330,44847,0,0,deny,66,66,0,1,0,1,0
65437,53,38141,53,allow,195,102,93,2,29,1,1
59740,53,42403,53,allow,304,86,218,2,30,1,1
55521,53,35090,53,allow,701,88,613,2,30,1,1
50387,8080,50387,8080,allow,7241,3224,4017,23,61,14,9
65447,445,0,0,drop,66,66,0,1,0,1,0
56369,22114,0,0,deny,62,62,0,1,0,1,0
63976,53,54023,53,allow,200,102,98,2,33,1,1
49962,53,58375,53,allow,184,94,90,2,31,1,1
57005,53,24332,53,allow,762,98,664,2,30,1,1
57492,53,57492,53,allow,218,90,128,2,30,1,1
9412,7302,0,0,deny,62,62,0,1,0,1,0
52690,7302,0,0,deny,66,66,0,1,0,1,0
59254,443,5881,443,allow,8332,1024,7308,21,25,11,10
59169,56205,0,0,deny,62,62,0,1,0,1,0
47894,443,25578,443,allow,52038,3333,48705,74,157,30,44
21674,28189,0,0,deny,60,60,0,1,0,1,0
60068,443,30976,443,allow,2227,1018,1209,17,16,8,9
54280,3398,0,0,deny,60,60,0,1,0,1,0
65066,53,65066,53,allow,240,98,142,2,30,1,1
53893,443,15377,443,allow,499,425,74,4,0,3,1
33122,80,28324,80,allow,9055,863,8192,18,45,10,8
9059,443,42849,443,allow,19816,13030,6786,80,159,40,40
57158,445,0,0,drop,66,66,0,1,0,1,0
63798,16357,18681,16357,allow,66,66,0,2,8,2,0
59076,25174,0,0,deny,62,62,0,1,0,1,0
54530,46776,0,0,deny,66,66,0,1,0,1,0
49006,443,37569,443,allow,119425284,929428,118495856,93687,498,9675,84012
55634,53,60487,53,allow,204,104,100,2,31,1,1
53945,445,0,0,drop,70,70,0,1,0,1,0
58638,5900,0,0,deny,62,62,0,1,0,1,0
54936,445,0,0,drop,70,70,0,1,0,1,0
35292,8100,19734,8100,allow,234,234,0,4,11,4,0
51913,445,0,0,drop,70,70,0,1,0,1,0
52459,5555,0,0,deny,60,60,0,1,0,1,0
59395,445,0,0,drop,70,70,0,1,0,1,0
55585,48063,46430,48063,allow,70,70,0,2,8,2,0
49976,53,44388,53,allow,245,110,135,2,30,1,1
57319,53,4407,53,allow,189,102,87,2,30,1,1
49418,27015,32548,27015,allow,255,78,177,2,29,1,1
53018,443,30354,443,allow,48877,5205,43672,95,93,32,63
65224,445,0,0,drop,66,66,0,1,0,1,0
50161,445,0,0,drop,66,66,0,1,0,1,0
56640,445,0,0,drop,70,70,0,1,0,1,0
55387,53,41194,53,allow,164,86,78,2,30,1,1
52131,28980,37358,28980,allow,66,66,0,1,5,1,0
64755,445,0,0,drop,70,70,0,1,0,1,0
56654,53,7307,53,allow,209,110,99,2,30,1,1
50260,53,50381,53,allow,196,86,110,2,30,1,1
40836,443,10613,443,allow,9524,3934,5590,20,135,10,10
55780,53,61304,53,allow,322,134,188,2,29,1,1
60644,445,0,0,drop,66,66,0,1,0,1,0
57470,13244,33439,13244,allow,166,166,0,1,1199,1,0
43129,15503,0,0,deny,62,62,0,1,0,1,0
49838,53,31499,53,allow,183,94,89,2,31,1,1
57344,53,21861,53,allow,177,94,83,2,30,1,1
26900,27017,41011,27017,allow,422,164,258,6,30,3,3
52024,47600,56931,47600,allow,70,70,0,2,8,2,0
52929,43890,0,0,deny,66,66,0,1,0,1,0
46271,443,30209,443,allow,70,70,0,2,4,2,0
49820,53,40891,53,allow,211,102,109,2,30,1,1
64637,53,52362,53,allow,194,102,92,2,30,1,1
49333,25174,0,0,deny,62,62,0,1,0,1,0
60570,445,0,0,drop,70,70,0,1,0,1,0
50116,445,0,0,drop,66,66,0,1,0,1,0
58778,445,0,0,drop,70,70,0,1,0,1,0
27005,27015,15191,27015,allow,889,126,763,2,30,1,1
58638,5900,0,0,deny,62,62,0,1,0,1,0
59940,50584,0,0,deny,62,62,0,1,0,1,0
49520,443,49520,443,allow,88797,5446,83351,137,76,70,67
34097,443,35195,443,allow,5241,860,4381,17,15,9,8
54142,445,0,0,drop,70,70,0,1,0,1,0
55351,445,0,0,drop,66,66,0,1,0,1,0
53114,443,33125,443,allow,15277,10027,5250,36,46,21,15
35579,443,33211,443,allow,130,70,60,2,15,1,1
60852,443,55582,443,allow,7471,2914,4557,26,47,15,11
55637,53,24847,53,allow,202,103,99,2,31,1,1
60548,445,0,0,drop,66,66,0,1,0,1,0
17344,62413,0,0,deny,66,66,0,1,0,1,0
62110,445,0,0,drop,70,70,0,1,0,1,0
58638,5900,0,0,deny,62,62,0,1,0,1,0
56967,443,1130,443,allow,9222,3148,6074,26,91,14,12
57431,15503,0,0,deny,62,62,0,1,0,1,0
57282,445,0,0,drop,70,70,0,1,0,1,0
49159,53,33263,53,allow,733,86,647,2,31,1,1
52841,445,0,0,drop,70,70,0,1,0,1,0
49843,53,31745,53,allow,186,95,91,2,31,1,1
49891,53,46766,53,allow,199,102,97,2,30,1,1
54967,53,43919,53,allow,178,94,84,2,31,1,1
54998,53,27657,53,allow,198,102,96,2,31,1,1
63847,443,1340,443,allow,1786,172,1614,7,120,3,4
53228,443,53228,443,allow,4456,2436,2020,19,24,10,9
61369,64147,0,0,deny,62,62,0,1,0,1,0
49408,443,42776,443,allow,4189,2286,1903,35,256,17,18
58638,5900,0,0,deny,62,62,0,1,0,1,0
42165,443,38543,443,allow,7583,607,6976,18,119,7,11
65348,53,57406,53,allow,214,102,112,2,31,1,1
43108,443,38121,443,allow,7578,2358,5220,18,121,8,10
35217,443,21700,443,allow,2388,1628,760,18,294,11,7
55199,445,0,0,drop,70,70,0,1,0,1,0
6889,11119,0,0,deny,143,143,0,1,0,1,0
50330,443,24584,443,allow,9585,2138,7447,26,82,13,13
51880,8001,53470,8001,allow,86,86,0,1,29,1,0
54821,445,0,0,drop,70,70,0,1,0,1,0
60404,37869,39714,37869,allow,258,70,188,4,8,2,2
55448,53,34800,53,allow,184,94,90,2,29,1,1
61121,445,0,0,drop,70,70,0,1,0,1,0
65231,50584,0,0,deny,62,62,0,1,0,1,0
65193,53,19280,53,allow,436,94,342,2,30,1,1
60486,445,0,0,drop,66,66,0,1,0,1,0
61665,445,0,0,drop,66,66,0,1,0,1,0
50868,443,26459,443,allow,7646,1697,5949,31,271,15,16
65047,445,0,0,drop,66,66,0,1,0,1,0
52930,443,54761,443,allow,21194,5779,15415,118,115,47,71
1827,64147,0,0,deny,66,66,0,1,0,1,0
55311,53,55274,53,allow,298,101,197,4,31,2,2
58638,5900,58638,5900,allow,66,66,0,1,4,1,0
51461,445,0,0,drop,66,66,0,1,0,1,0
60204,2767,0,0,deny,66,66,0,1,0,1,0
61275,445,0,0,drop,70,70,0,1,0,1,0
49780,53,4418,53,allow,183,94,89,2,29,1,1
51733,30688,11073,30688,allow,70,70,0,1,4,1,0
39108,443,16198,443,allow,330651,13398,317253,404,115,179,225
53140,443,26358,443,allow,6401,1225,5176,18,324,9,9
55903,53,48648,53,allow,177,94,83,2,30,1,1
22199,443,22199,443,allow,79787,12741,67046,117,31,65,52
56624,445,0,0,drop,70,70,0,1,0,1,0
51594,53,61639,53,allow,172,80,92,2,31,1,1
1230,3389,1230,3389,allow,3910,1805,2105,20,19,12,8
55840,53,9224,53,allow,170,87,83,2,30,1,1
8040,44847,0,0,deny,66,66,0,1,0,1,0
57149,53,34608,53,allow,382,94,288,2,30,1,1
56046,53,22169,53,allow,289,160,129,3,29,2,1
49238,445,0,0,drop,70,70,0,1,0,1,0
34990,80,31222,80,allow,350,210,140,6,28,4,2
63143,445,0,0,drop,70,70,0,1,0,1,0
65426,53,23528,53,allow,706,195,511,6,52,3,3
56897,11446,0,0,deny,66,66,0,1,0,1,0
51035,445,0,0,drop,66,66,0,1,0,1,0
55211,53,19820,53,allow,760,97,663,2,30,1,1
49656,443,4978,443,allow,182624,7130,175494,212,132,77,135
52111,44847,0,0,deny,66,66,0,1,0,1,0
64354,53,25529,53,allow,240,78,162,2,30,1,1
49532,53,59388,53,allow,331,92,239,4,40,2,2
50270,443,3425,443,allow,868,514,354,13,18,8,5
47403,57470,0,0,deny,109,109,0,1,0,1,0
58583,443,61583,443,allow,8605,3169,5436,19,17,12,7
52459,33890,0,0,deny,60,60,0,1,0,1,0
55308,445,0,0,deny,70,70,0,1,0,1,0
49932,53,19133,53,allow,237,86,151,2,30,1,1
10243,36237,0,0,deny,62,62,0,1,0,1,0
62392,15503,0,0,deny,146,146,0,1,0,1,0
62184,445,0,0,drop,70,70,0,1,0,1,0
26553,57470,0,0,deny,66,66,0,1,0,1,0
53463,29500,1810,29500,allow,877,577,300,10,143,5,5
62625,37965,0,0,deny,66,66,0,1,0,1,0
56222,443,56222,443,allow,4378,1471,2907,19,27,11,8
38084,443,21809,443,allow,2697,1520,1177,21,182,10,11
39681,37965,0,0,deny,66,66,0,1,0,1,0
21173,37965,0,0,deny,62,62,0,1,0,1,0
52394,53,35816,53,allow,168,78,90,2,30,1,1
47809,53,47809,53,allow,260,106,154,2,32,1,1
54518,25174,0,0,deny,62,62,0,1,0,1,0
38677,443,26000,443,allow,5306,1619,3687,20,29,12,8
52038,50584,0,0,deny,62,62,0,1,0,1,0
56709,443,60934,443,allow,1239919,29325,1210594,1214,46,409,805
40942,123,62465,123,allow,184,94,90,2,30,1,1
52149,52188,59594,52188,allow,70,70,0,2,8,2,0
37752,53,54109,53,allow,220,78,142,2,30,1,1
42558,64147,0,0,deny,62,62,0,1,0,1,0
49900,4500,1746,4500,allow,78,78,0,1,5,1,0
53661,445,0,0,drop,70,70,0,1,0,1,0
55834,53,38945,53,allow,184,94,90,2,31,1,1
65024,53,6765,53,allow,199,102,97,2,30,1,1
48975,443,52782,443,allow,130,70,60,3,5,2,1
52218,31573,0,0,deny,62,62,0,1,0,1,0
2062,35440,0,0,deny,66,66,0,1,0,1,0
55964,443,21962,443,allow,4455,798,3657,17,136,7,10
57337,64147,0,0,deny,66,66,0,1,0,1,0
64127,53,29234,53,allow,170,87,83,2,31,1,1
52924,443,50522,443,allow,21789,7672,14117,78,115,39,39
80,37649,0,0,deny,60,60,0,1,0,1,0
55026,53,50435,53,allow,177,94,83,2,30,1,1
44674,25174,0,0,deny,62,62,0,1,0,1,0
64959,27038,6979,27038,allow,996,462,534,4,30,2,2
17855,53,17855,53,allow,240,98,142,2,30,1,1
64664,53,45386,53,allow,250,86,164,4,33,2,2
10669,49756,0,0,deny,60,60,0,1,0,1,0
55733,51505,0,0,deny,66,66,0,1,0,1,0
58844,51505,0,0,deny,66,66,0,1,0,1,0
27005,26259,57804,26259,allow,889,126,763,2,31,1,1
56356,53,24415,53,allow,184,102,82,2,30,1,1
52818,445,0,0,drop,70,70,0,1,0,1,0
65190,445,0,0,drop,70,70,0,1,0,1,0
49633,53,1926,53,allow,245,94,151,2,29,1,1
7308,50584,0,0,deny,66,66,0,1,0,1,0
26527,25174,0,0,deny,66,66,0,1,0,1,0
63046,53,33586,53,allow,510,164,346,2,30,1,1
40831,80,63406,80,allow,1614,1300,314,10,15,5,5
52544,445,0,0,drop,70,70,0,1,0,1,0
51466,443,58507,443,allow,7638,1758,5880,24,17,13,11
52555,443,31121,443,allow,4362,1826,2536,18,134,8,10
55417,53,42244,53,allow,179,94,85,2,30,1,1
53774,51505,0,0,deny,66,66,0,1,0,1,0
17916,48817,0,0,deny,148,148,0,1,0,1,0
43705,443,47459,443,allow,8060,2001,6059,24,19,14,10
49682,443,37715,443,allow,9766,1633,8133,27,172,13,14
55974,80,55609,80,allow,613,539,74,7,15,6,1
55523,445,0,0,drop,70,70,0,1,0,1,0
56354,443,18179,443,allow,3775,1791,1984,24,203,12,12
65136,53,1364,53,allow,86,86,0,1,30,1,0
3440,7000,3440,7000,allow,3127,676,2451,15,19,7,8
42417,22114,0,0,deny,62,62,0,1,0,1,0
20520,53,20520,53,allow,215,80,135,2,32,1,1
34176,51505,0,0,deny,62,62,0,1,0,1,0
55678,53,40642,53,allow,270,88,182,4,54,2,2
54152,445,0,0,drop,70,70,0,1,0,1,0
36352,443,46352,443,allow,3256,1753,1503,17,315,10,7
50609,445,0,0,drop,70,70,0,1,0,1,0
64194,53,10058,53,allow,262,126,136,2,30,1,1
55386,37965,0,0,deny,66,66,0,1,0,1,0
52989,445,0,0,drop,70,70,0,1,0,1,0
39596,53,5876,53,allow,168,78,90,2,30,1,1
57906,443,49224,443,allow,9316,3279,6037,39,186,20,19
52406,443,64172,443,allow,13978,8842,5136,46,52,26,20
55542,443,51637,443,allow,58975,3359,55616,78,26,34,44
56420,443,51933,443,allow,5220,922,4298,17,135,10,7
65258,53,21767,53,allow,178,94,84,2,30,1,1
2467,2767,0,0,deny,62,62,0,1,0,1,0
64020,53,44407,53,allow,192,98,94,2,31,1,1
60777,40010,8810,40010,allow,316,136,180,6,6,3,3
51931,445,0,0,drop,70,70,0,1,0,1,0
54024,443,29413,443,allow,7653,1188,6465,21,16,12,9
11404,64147,0,0,deny,62,62,0,1,0,1,0
1538,50584,0,0,deny,146,146,0,1,0,1,0
60593,445,0,0,drop,66,66,0,1,0,1,0
50704,80,48490,80,allow,1082,896,186,18,214,15,3
27869,51221,0,0,deny,66,66,0,1,0,1,0
49988,443,8213,443,allow,642,582,60,2,5,1,1
49914,53,9646,53,allow,718,94,624,2,30,1,1
60939,445,0,0,drop,70,70,0,1,0,1,0
57817,445,0,0,drop,66,66,0,1,0,1,0
58713,445,0,0,drop,66,66,0,1,0,1,0
56909,50584,0,0,deny,66,66,0,1,0,1,0
61693,443,50704,443,allow,12203,3519,8684,65,18,35,30
50356,53,30610,53,allow,180,94,86,2,30,1,1
64980,53,39962,53,allow,90,90,0,1,31,1,0
65255,445,0,0,drop,70,70,0,1,0,1,0
52394,445,0,0,drop,70,70,0,1,0,1,0
56198,443,56198,443,allow,27729,5508,22221,60,18,31,29
55146,445,0,0,drop,66,66,0,1,0,1,0
54876,25174,0,0,deny,62,62,0,1,0,1,0
56812,443,34534,443,allow,8073,2053,6020,20,15,11,9
49308,22114,0,0,deny,66,66,0,1,0,1,0
65381,445,0,0,drop,70,70,0,1,0,1,0
37642,443,20516,443,allow,69348,4180,65168,86,45,37,49
59418,443,6727,443,allow,2946,1812,1134,16,15,8,8
49856,443,10855,443,allow,5512,978,4534,20,60,10,10
49961,53,61953,53,allow,322,110,212,4,31,2,2
63741,50584,0,0,deny,62,62,0,1,0,1,0
49749,53,60642,53,allow,200,102,98,2,30,1,1
10354,81,0,0,deny,60,60,0,1,0,1,0
47812,30627,0,0,deny,62,62,0,1,0,1,0
57906,80,15891,80,allow,318,192,126,6,26,4,2
58364,53,50367,53,allow,167,78,89,2,30,1,1
56386,53,21142,53,allow,177,94,83,2,30,1,1
55680,23711,23434,23711,allow,70,70,0,2,8,2,0
52711,443,58119,443,allow,15118,3979,11139,34,353,17,17
50477,443,60268,443,allow,130,70,60,2,15,1,1
49216,63752,26927,63752,allow,70,70,0,1,5,1,0
54846,53,32938,53,allow,168,78,90,2,30,1,1
55553,443,62763,443,allow,6639,3918,2721,16,135,8,8
62911,36237,0,0,deny,66,66,0,1,0,1,0
45964,2225,0,0,deny,60,60,0,1,0,1,0
49480,53,4215,53,allow,168,78,90,2,29,1,1
54956,53,60675,53,allow,194,102,92,2,31,1,1
55975,53,65159,53,allow,190,97,93,2,30,1,1
49237,445,0,0,drop,70,70,0,1,0,1,0
57293,445,0,0,drop,70,70,0,1,0,1,0
64636,53,42647,53,allow,727,223,504,6,70,3,3
12794,25174,0,0,deny,146,146,0,1,0,1,0
56415,53,18388,53,allow,179,94,85,2,29,1,1
51515,443,8850,443,allow,16287,13303,2984,49,38,26,23
60319,23,0,0,deny,60,60,0,1,0,1,0
50734,37965,0,0,deny,62,62,0,1,0,1,0
27402,37965,0,0,deny,66,66,0,1,0,1,0
58193,23,0,0,deny,60,60,0,1,0,1,0
55619,443,51009,443,allow,13144,7075,6069,33,161,16,17
28809,50584,0,0,deny,62,62,0,1,0,1,0
60722,37965,0,0,deny,62,62,0,1,0,1,0
50947,80,65255,80,allow,5427472,61630,5365842,4509,79,894,3615
53500,443,64344,443,allow,558,210,348,9,29,4,5
56015,53,32700,53,allow,190,97,93,2,31,1,1
50100,445,0,0,drop,66,66,0,1,0,1,0
64628,53,58574,53,allow,199,102,97,2,29,1,1
50690,445,0,0,drop,70,70,0,1,0,1,0
56857,53,15955,53,allow,195,102,93,2,30,1,1
61276,445,0,0,drop,66,66,0,1,0,1,0
27005,27015,64415,27015,allow,875,126,749,2,30,1,1
56157,50584,0,0,deny,62,62,0,1,0,1,0
56772,61424,18304,61424,allow,70,70,0,2,8,2,0
55134,53,14594,53,allow,212,108,104,2,30,1,1
54118,6004,0,0,deny,66,66,0,1,0,1,0
47561,26467,0,0,deny,62,62,0,1,0,1,0
53765,16178,52610,16178,allow,70,70,0,2,7,2,0
11478,51221,0,0,deny,66,66,0,1,0,1,0
55743,53,47802,53,allow,165,86,79,2,30,1,1
57772,50584,0,0,deny,66,66,0,1,0,1,0
56218,445,0,0,drop,70,70,0,1,0,1,0
34597,80,9526,80,allow,1540,553,987,10,15,6,4
56153,445,0,0,drop,70,70,0,1,0,1,0
49001,55108,0,0,deny,160,160,0,1,0,1,0
49744,445,0,0,drop,70,70,0,1,0,1,0
39056,22114,0,0,deny,62,62,0,1,0,1,0
45021,53,45021,53,allow,213,79,134,2,32,1,1
49867,53,10689,53,allow,177,94,83,2,30,1,1
60848,443,33330,443,allow,6513,1863,4650,28,255,15,13
10092,443,29539,443,allow,130,70,60,3,5,2,1
58638,5900,0,0,deny,62,62,0,1,0,1,0
57238,53,29243,53,allow,165,86,79,2,30,1,1
47282,443,1990,443,allow,130,70,60,2,15,1,1
58321,445,0,0,drop,70,70,0,1,0,1,0
36456,25174,0,0,deny,62,62,0,1,0,1,0
58638,5900,0,0,deny,62,62,0,1,0,1,0
33923,443,55200,443,allow,4472,1666,2806,13,121,6,7
55877,56036,49566,56036,allow,469,150,319,2,1200,1,1
19054,3389,19054,3389,allow,3564,1850,1714,18,35,10,8
59789,443,5705,443,allow,6695,2021,4674,23,45,11,12
54191,445,0,0,drop,66,66,0,1,0,1,0
35869,80,16584,80,allow,2604,1690,914,20,610,11,9
60807,40010,25177,40010,allow,316,136,180,6,5,3,3
60500,44739,45783,44739,allow,70,70,0,2,8,2,0
8403,46824,0,0,deny,62,62,0,1,0,1,0
56204,53,48094,53,allow,195,102,93,2,30,1,1
8313,51505,0,0,deny,66,66,0,1,0,1,0
29616,53,29616,53,allow,241,98,143,2,30,1,1
6881,35766,64668,35766,allow,221,111,110,2,1200,1,1
8103,65473,0,0,deny,157,157,0,1,0,1,0
49845,53,18683,53,allow,168,86,82,2,31,1,1
49393,53,14583,53,allow,183,86,97,2,30,1,1
5664,36237,0,0,deny,66,66,0,1,0,1,0
2037,23,2037,23,allow,152,66,86,2,10,1,1
52728,443,50981,443,allow,186399,56439,129960,335,45,170,165
61461,50584,0,0,deny,66,66,0,1,0,1,0
49211,445,0,0,drop,70,70,0,1,0,1,0
51774,16930,9118,16930,allow,70,70,0,1,5,1,0
57152,53,61515,53,allow,183,94,89,2,29,1,1
49210,443,19575,443,allow,9530,2183,7347,45,256,21,24
50355,43890,0,0,deny,62,62,0,1,0,1,0
53698,8120,50996,8120,allow,70,70,0,2,8,2,0
50607,443,33073,443,allow,3947,2271,1676,22,140,13,9
50581,445,0,0,drop,66,66,0,1,0,1,0
53858,6889,25438,6889,allow,372,186,186,6,16,3,3
55072,53,50967,53,allow,177,94,83,2,31,1,1
23798,23,0,0,deny,60,60,0,1,0,1,0
54236,36829,0,0,deny,62,62,0,1,0,1,0
57157,445,0,0,drop,70,70,0,1,0,1,0
60606,445,0,0,drop,70,70,0,1,0,1,0
50076,443,58457,443,allow,9920,5013,4907,41,15,25,16
56661,53,21967,53,allow,288,93,195,4,32,2,2
63950,53,31406,53,allow,200,102,98,2,30,1,1
56192,53,2949,53,allow,170,87,83,2,30,1,1
57330,445,0,0,drop,66,66,0,1,0,1,0
49160,1025,14161,1025,allow,868,150,718,4,1200,2,2
40547,24051,0,0,deny,74,74,0,1,0,1,0
43578,15503,0,0,deny,74,74,0,1,0,1,0
30834,53,30834,53,allow,194,87,107,2,30,1,1
58739,445,0,0,drop,66,66,0,1,0,1,0
55839,56535,0,0,deny,62,62,0,1,0,1,0
51978,57496,25018,57496,allow,70,70,0,2,8,2,0
57914,80,49885,80,allow,6527,1210,5317,15,18,8,7
55849,53,3530,53,allow,889,404,485,10,30,5,5
52501,445,0,0,drop,70,70,0,1,0,1,0
57585,51221,0,0,deny,62,62,0,1,0,1,0
49678,80,44529,80,allow,1977,921,1056,9,15,5,4
61520,23718,0,0,deny,62,62,0,1,0,1,0
0,0,0,0,deny,98,98,0,1,0,1,0
20619,25174,0,0,deny,66,66,0,1,0,1,0
65019,445,0,0,drop,66,66,0,1,0,1,0
37566,443,56010,443,allow,214,140,74,4,15,3,1
56326,53,62646,53,allow,177,94,83,2,30,1,1
47748,161,0,0,allow,6387,2535,3852,22,30,11,11
65139,53,12315,53,allow,210,102,108,2,30,1,1
57411,445,0,0,drop,66,66,0,1,0,1,0
52148,80,52148,80,allow,62796,1961,60835,72,141,26,46
56532,445,0,0,drop,66,66,0,1,0,1,0
56114,53,31669,53,allow,194,86,108,2,30,1,1
41322,53,41322,53,allow,244,98,146,2,32,1,1
51982,443,54748,443,allow,9010,2779,6231,30,361,15,15
43674,80,54012,80,allow,3714,1646,2068,18,186,9,9
55015,443,24425,443,allow,22687,6933,15754,50,50,26,24
55689,443,55689,443,allow,177498,9805,167693,244,80,119,125
59034,445,0,0,drop,70,70,0,1,0,1,0
55770,64147,0,0,deny,66,66,0,1,0,1,0
50408,53,36344,53,allow,182,93,89,2,31,1,1
56759,443,10401,443,allow,8058,2038,6020,20,15,11,9
63750,63343,38388,63343,allow,66,66,0,2,8,2,0
53923,445,0,0,drop,70,70,0,1,0,1,0
49722,53,64718,53,allow,200,102,98,2,29,1,1
55759,53,54947,53,allow,756,95,661,2,30,1,1
64824,37965,0,0,deny,62,62,0,1,0,1,0
56600,443,35329,443,allow,7941,1952,5989,20,15,11,9
51751,445,0,0,drop,70,70,0,1,0,1,0
1162,57470,0,0,deny,62,62,0,1,0,1,0
56740,443,56740,443,allow,41851,2810,39041,66,45,31,35
60159,22114,0,0,deny,62,62,0,1,0,1,0
54133,445,0,0,drop,70,70,0,1,0,1,0
49261,53,20112,53,allow,453,186,267,6,30,3,3
58911,443,49541,443,allow,23915,4341,19574,37,120,15,22
49359,64147,0,0,deny,66,66,0,1,0,1,0
62392,15503,0,0,deny,146,146,0,1,0,1,0
52498,445,0,0,drop,70,70,0,1,0,1,0
7030,80,7030,80,allow,115811,3862,111949,123,38,44,79
57478,7302,0,0,deny,66,66,0,1,0,1,0
49762,53,33292,53,allow,184,94,90,2,30,1,1
33651,36237,0,0,deny,62,62,0,1,0,1,0
60899,25174,0,0,deny,62,62,0,1,0,1,0
57220,445,0,0,drop,70,70,0,1,0,1,0
55841,443,33701,443,allow,9333,2019,7314,41,255,19,22
54195,443,39081,443,allow,1786,172,1614,7,120,3,4
49218,53,12399,53,allow,195,102,93,2,31,1,1
22357,6004,0,0,deny,62,62,0,1,0,1,0
56727,53,51350,53,allow,250,86,164,4,54,2,2
53123,445,0,0,drop,66,66,0,1,0,1,0
47665,443,4370,443,allow,214,140,74,4,15,3,1
49996,53,34015,53,allow,210,102,108,2,30,1,1
12087,59033,0,0,deny,148,148,0,1,0,1,0
48831,443,51436,443,allow,10129,5016,5113,18,120,9,9
62152,56205,0,0,deny,66,66,0,1,0,1,0
45637,443,46378,443,allow,6701,3487,3214,35,196,19,16
52426,53,52426,53,allow,310,94,216,2,31,1,1
443,62451,0,0,deny,199,199,0,1,0,1,0
12969,55777,0,0,deny,66,66,0,1,0,1,0
58251,36237,0,0,deny,66,66,0,1,0,1,0
59242,443,7294,443,allow,7192,2002,5190,24,360,11,13
56515,443,56741,443,allow,5083,969,4114,18,32,10,8
50082,445,0,0,drop,70,70,0,1,0,1,0
55754,53,32469,53,allow,170,87,83,2,31,1,1
53807,443,54173,443,allow,499,425,74,4,0,3,1
45426,80,3986,80,allow,416,210,206,7,28,4,3
42843,53,7011,53,allow,168,78,90,2,30,1,1
44147,64147,0,0,deny,62,62,0,1,0,1,0
59010,53,59010,53,allow,832,106,726,2,29,1,1
56704,53,10036,53,allow,194,102,92,2,31,1,1
50553,443,23117,443,allow,1632,1023,609,16,133,9,7
32549,37807,0,0,deny,146,146,0,1,0,1,0
55445,443,10778,443,allow,1373295,46189,1327106,1448,31,527,921
56832,445,0,0,drop,66,66,0,1,0,1,0
58986,445,0,0,drop,70,70,0,1,0,1,0
45308,443,7277,443,allow,3657,1867,1790,22,391,7,15
50812,445,0,0,drop,70,70,0,1,0,1,0
56155,53,9599,53,allow,199,102,97,2,30,1,1
59534,53,0,0,allow,627,72,555,2,30,1,1
56330,445,0,0,drop,70,70,0,1,0,1,0
52373,445,0,0,drop,70,70,0,1,0,1,0
0,0,0,0,allow,480,244,236,4,0,2,2
60875,50584,0,0,deny,62,62,0,1,0,1,0
49838,445,0,0,drop,70,70,0,1,0,1,0
60058,25174,0,0,deny,66,66,0,1,0,1,0
53899,443,60991,443,allow,21288,10113,11175,107,31,51,56
56131,445,0,0,drop,70,70,0,1,0,1,0
64978,53,20864,53,allow,198,102,96,2,30,1,1
60433,123,65242,123,allow,184,94,90,2,29,1,1
55836,53,6468,53,allow,177,94,83,2,30,1,1
52959,443,64973,443,allow,9257,2079,7178,39,113,19,20
50035,53,20021,53,allow,308,102,206,2,29,1,1
65176,53,36351,53,allow,193,102,91,2,31,1,1
64128,53,22207,53,allow,194,94,100,2,31,1,1
61536,445,0,0,drop,66,66,0,1,0,1,0
60490,62336,7987,62336,allow,504,318,186,8,15,5,3
64670,53,60367,53,allow,193,102,91,2,30,1,1
52583,445,0,0,drop,70,70,0,1,0,1,0
50222,445,0,0,drop,66,66,0,1,0,1,0
63563,24096,6074,24096,allow,70,70,0,1,5,1,0
57075,53,41557,53,allow,443,182,261,6,31,3,3
55656,445,0,0,drop,70,70,0,1,0,1,0
54069,443,6998,443,allow,887350,41179,846171,1082,210,487,595
52030,443,43838,443,allow,9090,1914,7176,24,25,13,11
56864,15646,57596,15646,allow,70,70,0,1,5,1,0
26900,27017,54890,27017,allow,758,328,430,10,30,5,5
56381,445,0,0,drop,66,66,0,1,0,1,0
55179,53,18189,53,allow,183,94,89,2,30,1,1
56997,123,16433,123,allow,184,94,90,2,30,1,1
57420,22114,0,0,deny,62,62,0,1,0,1,0
56645,80,11255,80,allow,234,234,0,4,12,4,0
9321,443,54415,443,allow,3345,432,2913,11,15,6,5
65135,445,0,0,drop,66,66,0,1,0,1,0
59373,445,0,0,drop,66,66,0,1,0,1,0
55428,445,0,0,drop,70,70,0,1,0,1,0
63032,53,34881,53,allow,304,86,218,2,30,1,1
61691,53,19669,53,allow,256,94,162,2,30,1,1
49969,445,0,0,drop,70,70,0,1,0,1,0
59779,443,59854,443,allow,568,568,0,5,10,5,0
55704,53,62671,53,allow,193,102,91,2,30,1,1
61448,443,1765,443,allow,6109,1902,4207,33,141,19,14
59696,57470,0,0,deny,62,62,0,1,0,1,0
55657,443,55657,443,allow,30650,11103,19547,66,51,40,26
58638,5900,0,0,deny,62,62,0,1,0,1,0
31096,53,31096,53,allow,216,82,134,2,32,1,1
57967,445,0,0,drop,70,70,0,1,0,1,0
56973,445,0,0,drop,70,70,0,1,0,1,0
46640,3780,0,0,deny,60,60,0,1,0,1,0
63545,25174,0,0,deny,66,66,0,1,0,1,0
51221,51413,53021,51413,allow,460,150,310,2,1200,1,1
33453,64147,0,0,deny,62,62,0,1,0,1,0
40517,53,18726,53,allow,284,79,205,2,30,1,1
61736,443,61172,443,allow,148467,8298,140169,192,17,93,99
6712,5632,0,0,deny,60,60,0,1,0,1,0
63453,445,0,0,drop,70,70,0,1,0,1,0
35589,25174,0,0,deny,66,66,0,1,0,1,0
56125,80,62901,80,allow,2091,799,1292,10,15,6,4
49493,445,0,0,drop,70,70,0,1,0,1,0
58602,53,5583,53,allow,197,86,111,2,29,1,1
58638,5900,0,0,deny,62,62,0,1,0,1,0
31172,22114,0,0,deny,62,62,0,1,0,1,0
56307,53,55446,53,allow,185,102,83,2,31,1,1
58001,443,15727,443,allow,300,180,120,6,28,4,2
65508,445,0,0,drop,70,70,0,1,0,1,0
443,14591,0,0,deny,131,131,0,1,0,1,0
59916,445,0,0,drop,66,66,0,1,0,1,0
52363,123,30662,123,allow,184,94,90,2,30,1,1
14697,8000,41154,8000,allow,274,150,124,4,60,2,2
57991,53,26816,53,allow,220,78,142,2,30,1,1
38809,443,49064,443,allow,79659,3269,76390,96,170,37,59
46974,443,29237,443,allow,5861,1151,4710,18,34,10,8
62724,443,47821,443,allow,87797,47766,40031,754,453,303,451
50316,37965,0,0,deny,66,66,0,1,0,1,0
61437,445,0,0,drop,70,70,0,1,0,1,0
13285,29892,0,0,deny,145,145,0,1,0,1,0
51034,445,0,0,drop,70,70,0,1,0,1,0
64959,53,63198,53,allow,245,102,143,2,31,1,1
54844,445,0,0,drop,66,66,0,1,0,1,0
60776,4156,29632,4156,allow,66,66,0,1,5,1,0
60374,57470,0,0,deny,62,62,0,1,0,1,0
58001,445,0,0,drop,70,70,0,1,0,1,0
57060,50584,0,0,deny,62,62,0,1,0,1,0
63586,46824,0,0,deny,62,62,0,1,0,1,0
49314,445,0,0,drop,66,66,0,1,0,1,0
55155,53,52768,53,allow,194,102,92,2,31,1,1
63758,443,30040,443,allow,3263,1643,1620,9,119,5,4
1024,57470,0,0,deny,62,62,0,1,0,1,0
58605,443,40025,443,allow,3301,1240,2061,14,135,7,7
65495,445,0,0,drop,70,70,0,1,0,1,0
60598,445,0,0,drop,70,70,0,1,0,1,0
51999,34619,53326,34619,allow,70,70,0,1,5,1,0
27327,53,27327,53,allow,823,98,725,2,30,1,1
50167,445,0,0,drop,70,70,0,1,0,1,0
56612,53,23653,53,allow,172,88,84,2,31,1,1
51603,443,54804,443,allow,19849,6817,13032,45,37,23,22
65357,53,23805,53,allow,180,94,86,2,30,1,1
64587,443,60822,443,allow,24686,1935,22751,36,18,17,19
58638,5900,58638,5900,allow,66,66,0,1,4,1,0
9505,443,9745,443,allow,3613,433,3180,11,16,6,5
55899,57470,0,0,deny,78,78,0,1,0,1,0
60518,80,21543,80,allow,1915,797,1118,8,16,5,3
59301,445,0,0,drop,66,66,0,1,0,1,0
54990,445,0,0,drop,70,70,0,1,0,1,0
50604,53,2592,53,allow,752,93,659,2,31,1,1
37608,443,17459,443,allow,499,425,74,4,0,3,1
10050,31573,0,0,deny,146,146,0,1,0,1,0
60313,445,0,0,drop,70,70,0,1,0,1,0
48731,443,18575,443,allow,5959,1709,4250,27,1211,15,12
50833,445,0,0,drop,70,70,0,1,0,1,0
60277,443,60277,443,allow,7428,729,6699,19,80,7,12
24972,27262,0,0,deny,60,60,0,1,0,1,0
54458,64147,0,0,deny,62,62,0,1,0,1,0
45863,53,45863,53,allow,229,90,139,2,30,1,1
56425,80,34044,80,allow,17188,1559,15629,25,31,10,15
56613,443,6770,443,allow,6016,1284,4732,18,984,8,10
44774,22114,0,0,deny,62,62,0,1,0,1,0
64341,445,0,0,drop,66,66,0,1,0,1,0
64154,53,43771,53,allow,194,102,92,2,30,1,1
27677,22114,0,0,deny,62,62,0,1,0,1,0
57793,37807,0,0,deny,66,66,0,1,0,1,0
58638,5900,0,0,deny,62,62,0,1,0,1,0
58638,5900,0,0,deny,62,62,0,1,0,1,0
26698,25174,0,0,deny,66,66,0,1,0,1,0
65049,53,59454,53,allow,184,94,90,2,31,1,1
53548,445,0,0,drop,66,66,0,1,0,1,0
63598,445,0,0,drop,66,66,0,1,0,1,0
49412,443,56019,443,allow,46271,6834,39437,63,47,19,44
58638,5900,0,0,deny,62,62,0,1,0,1,0
43464,443,26785,443,allow,8198,656,7542,19,327,5,14
57246,443,63215,443,allow,360050,17258,342792,432,68,185,247
3478,61463,0,0,deny,814,814,0,1,0,1,0
56889,53,34075,53,allow,177,94,83,2,30,1,1
47766,53,58844,53,allow,164,78,86,2,29,1,1
49840,445,0,0,drop,70,70,0,1,0,1,0
64319,53,63281,53,allow,193,102,91,2,29,1,1
56490,445,0,0,drop,70,70,0,1,0,1,0
37556,16386,44427,16386,allow,432,192,240,8,30,4,4
52402,445,0,0,drop,70,70,0,1,0,1,0
39994,80,41282,80,allow,2387,930,1457,14,16,7,7
55130,445,0,0,drop,70,70,0,1,0,1,0
59874,22114,0,0,deny,66,66,0,1,0,1,0
9278,23,9278,23,allow,146,60,86,2,10,1,1
54702,445,0,0,drop,70,70,0,1,0,1,0
43218,443,21139,443,allow,7375,2087,5288,24,255,12,12
49635,53,55370,53,allow,204,104,100,2,30,1,1
50348,443,42997,443,allow,1385,868,517,12,30,6,6
32869,53,32869,53,allow,197,90,107,2,30,1,1
63586,445,0,0,drop,66,66,0,1,0,1,0
53144,53,53144,53,allow,231,90,141,2,31,1,1
59313,445,0,0,drop,70,70,0,1,0,1,0
51789,445,0,0,drop,70,70,0,1,0,1,0
45941,23388,0,0,deny,60,60,0,1,0,1,0
59435,37807,0,0,deny,62,62,0,1,0,1,0
55413,53,7034,53,allow,779,86,693,2,30,1,1
52096,443,13873,443,allow,4747,3601,1146,18,15,10,8
30303,30303,0,0,deny,181,181,0,1,0,1,0
27005,27022,10825,27022,allow,890,126,764,2,31,1,1
54393,445,0,0,drop,66,66,0,1,0,1,0
53051,44847,0,0,deny,66,66,0,1,0,1,0
55829,53,4732,53,allow,208,106,102,2,31,1,1
55551,53,65057,53,allow,180,94,86,2,30,1,1
51918,41488,54208,41488,allow,70,70,0,2,8,2,0
51183,56205,0,0,deny,66,66,0,1,0,1,0
27005,27025,22813,27025,allow,887,126,761,2,31,1,1
54518,7000,54518,7000,allow,3518,1951,1567,15,15,8,7
58897,23,0,0,deny,60,60,0,1,0,1,0
65228,53,28840,53,allow,200,102,98,2,30,1,1
49826,80,54409,80,allow,6311,4340,1971,20,186,12,8
55551,445,0,0,drop,66,66,0,1,0,1,0
60390,56494,64175,56494,allow,70,70,0,2,8,2,0
51846,41510,42814,41510,allow,70,70,0,1,5,1,0
36804,25174,0,0,deny,66,66,0,1,0,1,0
58338,3375,0,0,deny,60,60,0,1,0,1,0
65353,53,24740,53,allow,177,94,83,2,30,1,1
49661,443,46909,443,allow,10553,2117,8436,24,46,12,12
53535,1393,14227,1393,allow,70,70,0,1,5,1,0
28989,53,28989,53,allow,197,90,107,2,29,1,1
55387,445,0,0,drop,70,70,0,1,0,1,0
6882,25021,51756,25021,allow,509,150,359,2,1200,1,1
51829,36134,0,0,deny,66,66,0,1,0,1,0
51917,80,25082,80,allow,43399,5061,38338,55,29,24,31
54496,53,1798,53,allow,164,86,78,2,29,1,1
60987,445,0,0,drop,70,70,0,1,0,1,0
56739,443,41966,443,allow,7914,1925,5989,20,15,11,9
57385,53,42061,53,allow,177,94,83,2,30,1,1
60676,57866,0,0,deny,66,66,0,1,0,1,0
58662,53,17171,53,allow,167,78,89,2,31,1,1
30728,53,30728,53,allow,196,88,108,2,30,1,1
59156,50584,0,0,deny,66,66,0,1,0,1,0
63772,445,0,0,drop,70,70,0,1,0,1,0
42386,443,40078,443,allow,10424,3393,7031,31,274,16,15
59008,51221,0,0,deny,62,62,0,1,0,1,0
55133,53,13417,53,allow,168,86,82,2,30,1,1
49712,445,0,0,drop,70,70,0,1,0,1,0
33292,50584,0,0,deny,62,62,0,1,0,1,0
40082,22,0,0,deny,60,60,0,1,0,1,0
55443,53,14783,53,allow,194,102,92,2,30,1,1
26254,56205,0,0,deny,66,66,0,1,0,1,0
58638,5900,0,0,deny,62,62,0,1,0,1,0
3428,22,0,0,deny,60,60,0,1,0,1,0
52601,443,40695,443,allow,2046,1026,1020,17,80,9,8
51860,443,38045,443,allow,6577,1938,4639,14,121,7,7
48600,23718,0,0,deny,66,66,0,1,0,1,0
50415,445,0,0,drop,66,66,0,1,0,1,0
2572,17546,0,0,deny,66,66,0,1,0,1,0
55235,445,0,0,drop,70,70,0,1,0,1,0
51077,13021,36103,13021,allow,154976,25739,129237,605,387,321,284
56486,80,1722,80,allow,46682,3447,43235,61,135,27,34
10736,35440,0,0,deny,66,66,0,1,0,1,0
56443,53,2207,53,allow,168,86,82,2,30,1,1
52188,13182,17024,13182,allow,70,70,0,1,4,1,0
61469,443,16667,443,allow,6204,1125,5079,23,89,13,10
51441,445,0,0,drop,70,70,0,1,0,1,0
45852,53,58364,53,allow,164,78,86,2,30,1,1
26531,37965,0,0,deny,62,62,0,1,0,1,0
46346,35440,0,0,deny,66,66,0,1,0,1,0
55325,53,48577,53,allow,198,101,97,2,30,1,1
49540,50584,0,0,deny,66,66,0,1,0,1,0
80,9918,0,0,deny,60,60,0,1,0,1,0
51422,80,51422,80,allow,9962,3379,6583,26,26,13,13
60094,445,0,0,drop,70,70,0,1,0,1,0
55339,443,4853,443,allow,2552065,30474,2521591,2074,129,236,1838
16013,35253,0,0,deny,66,66,0,1,0,1,0
49668,443,64842,443,allow,1288,754,534,13,50,5,8
55772,53,9529,53,allow,782,105,677,2,30,1,1
57115,53,57243,53,allow,178,94,84,2,29,1,1
33801,62413,0,0,deny,66,66,0,1,0,1,0
22916,25174,0,0,deny,146,146,0,1,0,1,0
55770,53,17489,53,allow,167,86,81,2,30,1,1
55023,443,26981,443,allow,8527,2218,6309,30,26,17,13
64463,53,5557,53,allow,182,93,89,2,0,1,1
60987,445,0,0,drop,70,70,0,1,0,1,0
60389,16933,0,0,deny,66,66,0,1,0,1,0
45511,443,41466,443,allow,130,70,60,2,15,1,1
52432,445,0,0,drop,70,70,0,1,0,1,0
58916,443,3751,443,allow,6376,4098,2278,20,16,10,10
64115,2767,0,0,deny,66,66,0,1,0,1,0
51802,443,19479,443,allow,4426,1518,2908,12,120,6,6
45452,443,54388,443,allow,16362,3716,12646,79,601,38,41
16425,15503,0,0,deny,62,62,0,1,0,1,0
31727,57470,0,0,deny,62,62,0,1,0,1,0
65114,53,28927,53,allow,196,102,94,2,30,1,1
52056,80,60936,80,allow,3641,846,2795,18,44,7,11
39042,443,60755,443,allow,3589,1251,2338,15,20,9,6
18061,25174,0,0,deny,62,62,0,1,0,1,0
56361,53,14867,53,allow,193,102,91,2,30,1,1
11754,25174,0,0,deny,62,62,0,1,0,1,0
58730,445,0,0,drop,70,70,0,1,0,1,0
51595,443,19980,443,allow,632,158,474,2,30,1,1
54148,445,0,0,drop,70,70,0,1,0,1,0
55647,53,31412,53,allow,168,86,82,2,29,1,1
57470,20433,47061,20433,allow,726,726,0,12,1200,12,0
37653,5223,9635,5223,allow,417,417,0,4,13,4,0
35957,51185,0,0,deny,60,60,0,1,0,1,0
51411,443,11555,443,allow,202,70,132,3,11,1,2
443,18368,0,0,deny,60,60,0,1,0,1,0
9416,443,41034,443,allow,6090,773,5317,17,25,9,8
14829,443,14829,443,allow,214215,11945,202270,260,94,110,150
59697,445,0,0,drop,70,70,0,1,0,1,0
49320,443,28886,443,allow,2371,1839,532,14,45,8,6
42968,56205,0,0,deny,62,62,0,1,0,1,0
58638,5900,0,0,deny,62,62,0,1,0,1,0
65380,53,11853,53,allow,176,90,86,2,31,1,1
46275,64147,0,0,deny,62,62,0,1,0,1,0
63801,445,0,0,drop,70,70,0,1,0,1,0
58682,80,4123,80,allow,1345,726,619,16,362,8,8
64287,53,8601,53,allow,181,94,87,2,31,1,1
49435,53,64990,53,allow,608,199,409,6,69,3,3
50512,443,55722,443,allow,6945,1842,5103,25,87,14,11
49401,445,0,0,drop,70,70,0,1,0,1,0
43161,443,23414,443,allow,10102,3072,7030,25,16,14,11
5938,39160,0,0,allow,60,60,0,1,91,1,0
56217,53,53375,53,allow,183,94,89,2,30,1,1
57288,53,13037,53,allow,177,94,83,2,30,1,1
52758,80,33293,80,allow,1746,980,766,15,151,8,7
61339,445,0,0,drop,66,66,0,1,0,1,0
42663,80,49274,80,allow,5562,1204,4358,11,91,7,4
9823,53,9823,53,allow,244,98,146,2,32,1,1
60775,40010,2313,40010,allow,316,136,180,6,6,3,3
61961,445,0,0,drop,66,66,0,1,0,1,0
65111,445,0,0,drop,70,70,0,1,0,1,0
56735,80,56735,80,allow,2243,1548,695,11,46,7,4
57086,53,59882,53,allow,228,102,126,2,29,1,1
63464,443,46979,443,allow,24271,2640,21631,38,123,16,22
55200,53,50421,53,allow,209,110,99,2,30,1,1
443,45788,0,0,deny,332,332,0,1,0,1,0
50072,443,58353,443,allow,827,484,343,8,15,5,3
56906,53,50869,53,allow,166,85,81,2,31,1,1
49809,53,6008,53,allow,386,134,252,2,30,1,1
50637,36237,0,0,deny,62,62,0,1,0,1,0
50741,445,0,0,drop,66,66,0,1,0,1,0
55773,53,61209,53,allow,199,102,97,2,30,1,1
49415,53,16500,53,allow,194,102,92,2,30,1,1
12694,22114,0,0,deny,66,66,0,1,0,1,0
49711,14984,0,0,deny,66,66,0,1,0,1,0
63041,50584,0,0,deny,62,62,0,1,0,1,0
56513,53,54850,53,allow,215,102,113,2,30,1,1
53156,51689,64576,51689,allow,546,306,240,9,142,5,4
52049,443,18143,443,allow,7710,2476,5234,18,135,8,10
61004,445,0,0,drop,66,66,0,1,0,1,0
54762,53,0,0,allow,86,86,0,1,30,1,0
64606,53,12951,53,allow,290,102,188,2,30,1,1
52101,80,34628,80,allow,55117,3792,51325,69,36,29,40
50415,64147,0,0,deny,66,66,0,1,0,1,0
5244,35440,0,0,deny,66,66,0,1,0,1,0
64982,445,0,0,drop,70,70,0,1,0,1,0
58034,443,61141,443,allow,4553,856,3697,17,362,9,8
55593,80,19208,80,allow,3276,404,2872,11,15,5,6
56725,53,45081,53,allow,262,90,172,4,53,2,2
41133,443,38649,443,allow,6964782,246690,6718092,7203,184,2494,4709
51233,443,5696,443,allow,9925,2939,6986,30,46,17,13
49356,443,28911,443,allow,5946,1254,4692,20,33,10,10
38238,443,28773,443,allow,33229,5348,27881,55,125,26,29
49115,443,63602,443,allow,361013,18864,342149,392,296,110,282
65285,50584,0,0,deny,66,66,0,1,0,1,0
54189,64147,0,0,deny,66,66,0,1,0,1,0
64227,445,0,0,drop,66,66,0,1,0,1,0
22583,9822,0,0,deny,62,62,0,1,0,1,0
38111,443,61640,443,allow,566856,28278,538578,737,37,351,386
58248,445,0,0,drop,70,70,0,1,0,1,0
57799,10387,0,0,deny,145,145,0,1,0,1,0
52445,445,0,0,drop,70,70,0,1,0,1,0
60199,443,60774,443,allow,8958,1697,7261,18,15,9,9
59630,445,0,0,drop,70,70,0,1,0,1,0
49418,27014,49598,27014,allow,235,71,164,2,31,1,1
52159,80,40700,80,allow,1278,731,547,10,15,6,4
57873,445,0,0,drop,70,70,0,1,0,1,0
62524,445,0,0,drop,70,70,0,1,0,1,0
22583,9822,0,0,deny,62,62,0,1,0,1,0
60612,443,17628,443,allow,117190,11380,105810,171,212,67,104
49327,53,15373,53,allow,396,102,294,2,30,1,1
58638,5900,0,0,deny,62,62,0,1,0,1,0
60721,22114,0,0,deny,66,66,0,1,0,1,0
58638,5900,58638,5900,allow,156,62,94,2,10,1,1
60399,161,0,0,allow,18789,5169,13620,54,30,27,27
51490,1,0,0,deny,100,100,0,1,0,1,0
23844,26467,0,0,deny,62,62,0,1,0,1,0
57605,80,57605,80,allow,36471,5174,31297,57,38,23,34
50671,80,18183,80,allow,1658,1247,411,8,15,5,3
32974,37965,0,0,deny,66,66,0,1,0,1,0
50239,53,39194,53,allow,183,94,89,2,30,1,1
51702,445,0,0,drop,66,66,0,1,0,1,0
63090,53,11762,53,allow,510,164,346,2,31,1,1
64123,445,0,0,drop,70,70,0,1,0,1,0
58638,5900,0,0,deny,62,62,0,1,0,1,0
50635,53,9293,53,allow,199,94,105,2,30,1,1
49826,53,60102,53,allow,466,192,274,6,83,3,3
55503,53,12220,53,allow,200,102,98,2,30,1,1
59339,80,59339,80,allow,107838,4143,103695,178,15,59,119
63191,445,0,0,drop,70,70,0,1,0,1,0
55704,53,10411,53,allow,177,94,83,2,31,1,1
8889,16164,0,0,deny,60,60,0,1,0,1,0
29623,37807,0,0,deny,146,146,0,1,0,1,0
23277,53733,0,0,deny,66,66,0,1,0,1,0
52845,443,44053,443,allow,2082,1322,760,14,41,8,6
49250,80,27382,80,allow,1623,629,994,8,75,5,3
34658,80,20483,80,allow,6094,954,5140,15,3601,8,7
65116,53,63214,53,allow,200,94,106,2,30,1,1
46604,57866,0,0,deny,66,66,0,1,0,1,0
59757,53,47514,53,allow,260,86,174,2,30,1,1
50167,53,41841,53,allow,260,86,174,2,30,1,1
49429,53,55360,53,allow,194,102,92,2,30,1,1
50464,445,0,0,drop,70,70,0,1,0,1,0
64726,53,62108,53,allow,172,88,84,2,31,1,1
53951,8999,2950,8999,allow,70,70,0,2,7,2,0
54080,26467,0,0,deny,62,62,0,1,0,1,0
64145,53,5953,53,allow,504,105,399,4,35,2,2
64256,53,5483,53,allow,334,94,240,2,31,1,1
49193,80,37184,80,allow,6158,654,5504,15,16,8,7
58638,5900,0,0,deny,62,62,0,1,0,1,0
0,0,0,0,deny,156,156,0,2,0,2,0
49555,53,37709,53,allow,199,102,97,2,30,1,1
58117,445,0,0,drop,70,70,0,1,0,1,0
56467,53,49050,53,allow,578,286,292,9,15,5,4
61110,445,0,0,drop,70,70,0,1,0,1,0
46248,443,47277,443,allow,979612,946319,33293,1091,25,690,401
49418,30050,47158,30050,allow,78,78,0,1,30,1,0
49774,53,40062,53,allow,234,102,132,2,30,1,1
50987,80,34293,80,allow,8047,2291,5756,22,19,13,9
49308,53,5550,53,allow,195,94,101,2,29,1,1
27005,27016,56355,27016,allow,1646,126,1520,4,31,2,2
57548,445,0,0,drop,70,70,0,1,0,1,0
57295,53,34997,53,allow,448,184,264,6,30,3,3
55851,53,30574,53,allow,183,102,81,2,30,1,1
6666,2222,6666,2222,allow,130,66,64,2,5,1,1
49001,40108,0,0,deny,161,161,0,1,0,1,0
60020,445,0,0,drop,66,66,0,1,0,1,0
64426,53,39298,53,allow,669,200,469,6,49,3,3
57364,53,42885,53,allow,177,94,83,2,29,1,1
60419,61248,0,0,reset-both,145,145,0,1,0,1,0
50738,445,0,0,drop,70,70,0,1,0,1,0
49573,53,10183,53,allow,770,102,668,2,30,1,1
64312,53,41455,53,allow,225,110,115,2,30,1,1
55464,53,43920,53,allow,216,94,122,2,30,1,1
44411,37965,0,0,deny,62,62,0,1,0,1,0
48020,443,61756,443,allow,33481,5635,27846,73,287,32,41
64410,53,32197,53,allow,286,98,188,4,40,2,2
56497,53,2084,53,allow,170,87,83,2,31,1,1
56005,445,0,0,drop,70,70,0,1,0,1,0
61524,445,0,0,drop,70,70,0,1,0,1,0
64847,22114,0,0,deny,66,66,0,1,0,1,0
515,10214,0,0,deny,62,62,0,1,0,1,0
11350,3389,11350,3389,allow,3850,1745,2105,19,18,11,8
55054,443,7526,443,allow,6903,1481,5422,33,612,12,21
43439,443,4737,443,allow,13482,3731,9751,40,500,17,23
53927,64147,0,0,deny,66,66,0,1,0,1,0
49872,443,32419,443,allow,4595,1038,3557,19,54,11,8
62765,443,43288,443,allow,52223,3318,48905,75,321,30,45
60126,443,24609,443,allow,3015,2086,929,16,15,9,7
51051,443,1978,443,allow,7712,2203,5509,24,516,14,10
48941,443,53829,443,allow,10085,3487,6598,21,120,9,12
48706,23393,0,0,deny,60,60,0,1,0,1,0
51156,53,46247,53,allow,168,78,90,2,29,1,1
55569,443,6204,443,allow,8049,1560,6489,19,151,9,10
50261,445,0,0,drop,70,70,0,1,0,1,0
65266,53,39575,53,allow,216,110,106,2,30,1,1
63467,445,0,0,drop,66,66,0,1,0,1,0
56798,40759,43301,40759,allow,70,70,0,1,5,1,0
50584,9301,1872,9301,allow,498,150,348,4,2396,2,2
49396,443,4932,443,allow,1394,733,661,14,80,8,6
30861,46783,0,0,deny,62,62,0,1,0,1,0
51648,443,53191,443,allow,30116,4336,25780,44,123,18,26
58638,5900,0,0,deny,62,62,0,1,0,1,0
38402,443,34859,443,allow,8119,1962,6157,24,360,11,13
54943,445,0,0,drop,70,70,0,1,0,1,0
56236,80,56236,80,allow,44755,823,43932,45,15,12,33
58753,443,18417,443,allow,10379,2361,8018,27,20,16,11
59764,53,23530,53,allow,304,86,218,2,30,1,1
57035,80,15633,80,allow,953,524,429,11,256,6,5
64081,443,44288,443,allow,7280,2277,5003,19,136,9,10
55068,53,59463,53,allow,196,102,94,2,29,1,1
58638,5900,0,0,deny,62,62,0,1,0,1,0
57143,53,17926,53,allow,184,94,90,2,30,1,1
27005,27015,40148,27015,allow,886,126,760,2,31,1,1
1462,41599,48660,41599,allow,70,70,0,2,8,2,0
2572,35440,0,0,deny,66,66,0,1,0,1,0
55154,443,34870,443,allow,2251,1098,1153,25,120,12,13
35339,443,19701,443,allow,6677,1006,5671,19,27,11,8
54998,53,24555,53,allow,168,78,90,2,30,1,1
60995,443,11816,443,allow,7583,2669,4914,31,17,16,15
58799,30188,0,0,deny,66,66,0,1,0,1,0
59214,445,0,0,drop,70,70,0,1,0,1,0
53799,445,0,0,drop,70,70,0,1,0,1,0
56860,53,63586,53,allow,184,102,82,2,30,1,1
56292,443,38026,443,allow,162,102,60,2,5,1,1
55349,53,40115,53,allow,701,88,613,2,31,1,1
49418,27017,55350,27017,allow,275,71,204,2,31,1,1
26573,44847,0,0,deny,62,62,0,1,0,1,0
52956,445,0,0,drop,70,70,0,1,0,1,0
65405,445,0,0,drop,70,70,0,1,0,1,0
55642,445,0,0,drop,70,70,0,1,0,1,0
60141,30188,0,0,deny,66,66,0,1,0,1,0
46750,443,52499,443,allow,350,210,140,6,25,4,2
47141,443,51949,443,allow,2011,1238,773,16,330,9,7
58552,443,44204,443,allow,28468,2316,26152,43,42,15,28
55043,80,21312,80,allow,306,180,126,6,34,4,2
137,137,20437,137,allow,384,384,0,5,51,5,0
62961,53,49359,53,allow,209,102,107,2,30,1,1
50601,80,50601,80,allow,4206,3273,933,17,19,9,8
27005,50003,20006,50003,allow,887,126,761,2,31,1,1
33569,443,28286,443,allow,9032,2162,6870,34,34,18,16
48733,443,64638,443,allow,316457,19287,297170,382,80,157,225
60865,445,0,0,drop,70,70,0,1,0,1,0
56413,51221,0,0,deny,66,66,0,1,0,1,0
57174,57470,0,0,deny,66,66,0,1,0,1,0
58889,445,0,0,drop,66,66,0,1,0,1,0
58502,445,0,0,drop,70,70,0,1,0,1,0
49522,21247,0,0,deny,62,62,0,1,0,1,0
11786,53,11786,53,allow,194,87,107,2,30,1,1
57082,53,0,0,allow,82,82,0,1,30,1,0
49607,53,13201,53,allow,259,102,157,2,29,1,1
50228,53,44907,53,allow,173,94,79,2,30,1,1
53166,61600,0,0,deny,62,62,0,1,0,1,0
34692,80,34692,80,allow,3530,2851,679,13,20,8,5
50584,6889,7914,6889,allow,1326,300,1026,6,1200,3,3
1500,10387,0,0,deny,157,157,0,1,0,1,0
48348,443,49861,443,allow,20838,2211,18627,40,14,20,20
43671,17372,0,0,deny,62,62,0,1,0,1,0
56725,53,46910,53,allow,262,90,172,4,59,2,2
53434,53,32877,53,allow,261,261,0,4,47,4,0
55100,53,26652,53,allow,178,94,84,2,31,1,1
33108,22,33108,22,allow,7930,3351,4579,56,38,27,29
9202,80,37636,80,allow,2949,546,2403,11,25,6,5
50910,445,0,0,drop,70,70,0,1,0,1,0
52728,445,0,0,drop,70,70,0,1,0,1,0
57891,80,37829,80,allow,6518,1210,5308,15,24,8,7
58314,445,0,0,drop,70,70,0,1,0,1,0
27018,61508,0,0,deny,753,753,0,1,0,1,0
64895,53,23891,53,allow,199,102,97,2,29,1,1
65473,53,40939,53,allow,309,94,215,2,30,1,1
59031,25174,0,0,deny,62,62,0,1,0,1,0
52017,26175,30441,26175,allow,66,66,0,1,5,1,0
57344,443,31123,443,allow,30232,22633,7599,77,23,46,31
54636,443,3394,443,allow,311000,8576,302424,319,175,103,216
58600,443,58600,443,allow,4398,1491,2907,19,28,11,8
51086,80,8200,80,allow,6365,3093,3272,36,130,19,17
30578,55783,0,0,deny,145,145,0,1,0,1,0
2080,7000,2080,7000,allow,754151,15395,738756,762,16,239,523
56256,62413,0,0,deny,66,66,0,1,0,1,0
55617,18319,24832,18319,allow,320,140,180,6,7,3,3
61811,443,37922,443,allow,214,140,74,4,15,3,1
59529,445,0,0,drop,70,70,0,1,0,1,0
62776,62413,0,0,deny,146,146,0,1,0,1,0
56809,53,37625,53,allow,167,86,81,2,30,1,1
515,10214,0,0,deny,66,66,0,1,0,1,0
123,123,12424,123,allow,184,94,90,2,30,1,1
1280,25174,0,0,deny,62,62,0,1,0,1,0
64761,53,64761,53,allow,220,100,120,2,31,1,1
55012,445,0,0,drop,70,70,0,1,0,1,0
51374,30317,0,0,deny,62,62,0,1,0,1,0
50907,445,0,0,drop,70,70,0,1,0,1,0
51978,80,26908,80,allow,4612,3409,1203,14,25,9,5
58638,5900,0,0,deny,62,62,0,1,0,1,0
56143,53,42893,53,allow,195,94,101,2,30,1,1
60394,11136,28099,11136,allow,7512,2276,5236,39,94,21,18
50906,443,11737,443,allow,124,64,60,2,15,1,1
9305,443,52742,443,allow,3616,429,3187,11,16,6,5
56960,53,36561,53,allow,196,102,94,2,30,1,1
61744,11392,0,0,deny,66,66,0,1,0,1,0
64981,445,0,0,drop,70,70,0,1,0,1,0
60600,445,0,0,drop,70,70,0,1,0,1,0
10963,53,10963,53,allow,216,90,126,2,30,1,1
64987,53,4145,53,allow,196,102,94,2,30,1,1
56428,80,32588,80,allow,17247,1619,15628,26,25,11,15
26889,50265,0,0,deny,66,66,0,1,0,1,0
58718,80,58718,80,allow,106571,3881,102690,128,16,56,72
56431,443,60135,443,allow,55149,7806,47343,134,108,61,73
34162,443,17948,443,allow,4897,850,4047,15,15,9,6
64969,445,0,0,drop,70,70,0,1,0,1,0
57357,445,0,0,drop,70,70,0,1,0,1,0
56890,443,61166,443,allow,6935,1415,5520,22,186,12,10
27005,27015,29834,27015,allow,1634,126,1508,4,30,2,2
45679,53,45679,53,allow,262,106,156,2,33,1,1
52154,80,54882,80,allow,366,240,126,7,32,5,2
56941,443,33358,443,allow,4581,2831,1750,29,96,15,14
55145,445,0,0,drop,70,70,0,1,0,1,0
11907,57470,0,0,deny,66,66,0,1,0,1,0
51815,51221,0,0,deny,74,74,0,1,0,1,0
14740,26467,0,0,deny,62,62,0,1,0,1,0
38118,443,46227,443,allow,70,70,0,1,5,1,0
49426,53,14946,53,allow,492,91,401,4,56,2,2
57339,57470,0,0,deny,66,66,0,1,0,1,0
57281,53,55108,53,allow,178,94,84,2,30,1,1
63263,57470,0,0,deny,66,66,0,1,0,1,0
58805,53,42120,53,allow,237,86,151,2,30,1,1
64755,31573,0,0,deny,66,66,0,1,0,1,0
60173,445,0,0,drop,70,70,0,1,0,1,0
58638,5900,0,0,deny,62,62,0,1,0,1,0
5228,3434,0,0,deny,601,601,0,1,0,1,0
64732,53,44138,53,allow,189,102,87,2,29,1,1
41459,80,32156,80,allow,1866,1032,834,11,150,6,5
62560,445,0,0,drop,70,70,0,1,0,1,0
56929,53,55156,53,allow,784,94,690,2,30,1,1
55421,53,33025,53,allow,200,102,98,2,29,1,1
52827,25174,0,0,deny,146,146,0,1,0,1,0
64068,53,59683,53,allow,168,86,82,2,30,1,1
49364,53,25963,53,allow,307,307,0,4,61,4,0
50038,53,0,0,allow,275,85,190,2,31,1,1
49651,80,48758,80,allow,1854,945,909,13,106,7,6
42012,443,37519,443,allow,14271,2106,12165,42,227,17,25
59352,37965,0,0,deny,66,66,0,1,0,1,0
27005,27015,31216,27015,allow,939,126,813,2,30,1,1
59630,443,48650,443,allow,3304,1468,1836,18,139,10,8
48808,443,13852,443,allow,8192,2071,6121,23,361,10,13
63873,445,0,0,drop,70,70,0,1,0,1,0
16630,44847,0,0,deny,62,62,0,1,0,1,0
53712,44822,45976,44822,allow,320,140,180,6,5,3,3
56415,443,20835,443,allow,6032,1722,4310,22,117,13,9
53196,445,0,0,drop,66,66,0,1,0,1,0
60720,445,0,0,drop,70,70,0,1,0,1,0
52073,443,26285,443,allow,22714,21388,1326,33,30,22,11
50829,53,16960,53,allow,168,78,90,2,30,1,1
53993,445,0,0,drop,70,70,0,1,0,1,0
5688,44847,0,0,deny,62,62,0,1,0,1,0
58020,80,26488,80,allow,2312,1094,1218,25,89,13,12
55027,53,18379,53,allow,168,86,82,2,31,1,1
64914,53,63909,53,allow,86,86,0,1,29,1,0
51764,443,27947,443,allow,5660,3864,1796,27,95,14,13
49536,53,5228,53,allow,239,94,145,2,30,1,1
52699,445,0,0,drop,70,70,0,1,0,1,0
50972,3544,16024,3544,allow,258,107,151,2,30,1,1
50388,53,14304,53,allow,177,94,83,2,29,1,1
50321,48817,0,0,deny,143,143,0,1,0,1,0
57289,31573,0,0,deny,66,66,0,1,0,1,0
48360,443,45618,443,allow,8400,2088,6312,33,20,18,15
63111,445,0,0,drop,70,70,0,1,0,1,0
51574,445,0,0,drop,66,66,0,1,0,1,0
49763,53,30741,53,allow,258,110,148,2,30,1,1
55292,53,33154,53,allow,211,102,109,2,31,1,1
11296,443,11296,443,allow,1311,782,529,12,23,7,5
49797,445,0,0,drop,66,66,0,1,0,1,0
50467,445,0,0,drop,66,66,0,1,0,1,0
42209,36237,0,0,deny,146,146,0,1,0,1,0
52437,443,30974,443,allow,384,384,0,7,33,7,0
49750,443,8728,443,allow,7370,1474,5896,19,128,10,9
50265,61668,33376,61668,allow,132,132,0,3,1201,3,0
45964,55559,0,0,deny,60,60,0,1,0,1,0
60823,445,0,0,drop,66,66,0,1,0,1,0
40288,80,46706,80,allow,1195,763,432,10,32,6,4
55179,53,31015,53,allow,178,94,84,2,30,1,1
58638,5900,0,0,deny,62,62,0,1,0,1,0
26448,9192,0,0,deny,145,145,0,1,0,1,0
15978,50584,0,0,deny,146,146,0,1,0,1,0
48024,443,44709,443,allow,9194,1066,8128,21,27,12,9
53523,445,0,0,drop,66,66,0,1,0,1,0
9204,443,60040,443,allow,5399,368,5031,18,31,5,13
61075,445,0,0,drop,70,70,0,1,0,1,0
24276,53,24276,53,allow,233,90,143,2,33,1,1
55180,53,29558,53,allow,209,110,99,2,30,1,1
27005,33111,35417,33111,allow,895,126,769,2,31,1,1
57269,53,5905,53,allow,183,94,89,2,30,1,1
65468,443,32669,443,allow,421329,12430,408899,433,16,152,281
60372,53,60372,53,allow,222,90,132,2,30,1,1
49177,54532,0,0,deny,60,60,0,1,0,1,0
49254,53,55219,53,allow,265,110,155,2,30,1,1
65348,53,36995,53,allow,170,87,83,2,30,1,1
60559,445,0,0,drop,70,70,0,1,0,1,0
62208,37965,0,0,deny,66,66,0,1,0,1,0
1238,51505,0,0,deny,62,62,0,1,0,1,0
45628,80,45628,80,allow,1243,530,713,10,20,5,5
39742,62413,0,0,deny,62,62,0,1,0,1,0
57259,443,65344,443,allow,6439,1702,4737,21,68,13,8
61389,445,0,0,drop,66,66,0,1,0,1,0
59570,443,54074,443,allow,6713,3052,3661,49,5974,15,34
49418,27015,36683,27015,allow,251,71,180,2,31,1,1
57353,445,0,0,drop,70,70,0,1,0,1,0
50549,43890,0,0,deny,66,66,0,1,0,1,0
57880,445,0,0,drop,70,70,0,1,0,1,0
49734,23,0,0,deny,60,60,0,1,0,1,0
2083,25174,0,0,deny,146,146,0,1,0,1,0
55945,53,7616,53,allow,177,94,83,2,29,1,1
14618,6881,0,0,deny,66,66,0,1,0,1,0
54438,62413,0,0,deny,66,66,0,1,0,1,0
56526,53,17737,53,allow,168,94,74,2,30,1,1
3478,61463,0,0,deny,1345,1345,0,1,0,1,0
49982,53,19488,53,allow,211,110,101,2,30,1,1
56720,443,60130,443,allow,4989,1014,3975,16,53,9,7
46532,17372,0,0,deny,145,145,0,1,0,1,0
65219,53,31087,53,allow,197,102,95,2,29,1,1
50734,445,0,0,drop,66,66,0,1,0,1,0
52295,53,54282,53,allow,322,102,220,2,30,1,1
64756,53,35378,53,allow,195,102,93,2,30,1,1
63913,24806,2171,24806,allow,630,508,122,9,15,7,2
53199,30188,0,0,deny,66,66,0,1,0,1,0
55836,445,0,0,drop,70,70,0,1,0,1,0
55024,53,16229,53,allow,179,94,85,2,30,1,1
51766,80,8995,80,allow,2190,1284,906,13,74,8,5
55443,445,0,0,drop,70,70,0,1,0,1,0
63909,445,0,0,drop,70,70,0,1,0,1,0
50345,443,44342,443,allow,1385,868,517,12,30,6,6
34073,37965,0,0,deny,62,62,0,1,0,1,0
34134,30188,0,0,deny,62,62,0,1,0,1,0
56761,445,0,0,drop,66,66,0,1,0,1,0
62489,445,0,0,drop,70,70,0,1,0,1,0
51920,30188,0,0,deny,62,62,0,1,0,1,0
50875,80,60669,80,allow,141059,7791,133268,168,140,72,96
50387,443,41513,443,allow,8507,1945,6562,21,33,10,11
35595,80,11916,80,allow,1566,684,882,10,15,5,5
52647,443,40426,443,allow,46502,33690,12812,93,234,55,38
5588,5588,0,0,allow,3354,1792,1562,46,195,23,23
58638,5900,0,0,deny,62,62,0,1,0,1,0
57211,443,58131,443,allow,25881,12394,13487,221,579,105,116
54676,443,17245,443,allow,5747,1892,3855,19,17,11,8
53998,443,53998,443,allow,4613,1706,2907,19,30,11,8
53841,37965,0,0,deny,66,66,0,1,0,1,0
59763,445,0,0,drop,70,70,0,1,0,1,0
50584,39812,60344,39812,allow,161,161,0,1,1200,1,0
56738,53,58828,53,allow,198,102,96,2,30,1,1
51458,445,0,0,drop,70,70,0,1,0,1,0
58263,443,17697,443,allow,12494,5331,7163,48,122,21,27
55240,53,36394,53,allow,816,102,714,2,30,1,1
27005,27015,60571,27015,allow,902,126,776,2,30,1,1
50383,443,21192,443,allow,452,386,66,4,1,3,1
53687,445,0,0,drop,70,70,0,1,0,1,0
37607,443,8291,443,allow,499,425,74,4,0,3,1
49423,443,63927,443,allow,4287346,130607,4156739,4409,282,1473,2936
60126,35440,0,0,deny,66,66,0,1,0,1,0
60008,443,9561,443,allow,7060,1850,5210,35,110,21,14
36464,443,36464,443,allow,4373,1466,2907,19,29,11,8
61779,445,0,0,drop,70,70,0,1,0,1,0
58638,5900,0,0,deny,62,62,0,1,0,1,0
58318,445,0,0,drop,66,66,0,1,0,1,0
57002,53,38861,53,allow,731,85,646,2,30,1,1
64785,53,44600,53,allow,281,94,187,2,29,1,1
49110,443,4488,443,allow,43476,3775,39701,67,397,28,39
56681,53,26694,53,allow,195,102,93,2,30,1,1
64543,50265,0,0,deny,66,66,0,1,0,1,0
4862,37965,0,0,deny,66,66,0,1,0,1,0
59493,44847,0,0,deny,66,66,0,1,0,1,0
49915,35440,0,0,deny,146,146,0,1,0,1,0
63927,53,30501,53,allow,196,94,102,2,30,1,1
52023,41791,61647,41791,allow,70,70,0,2,8,2,0
52477,443,18110,443,allow,8788,2185,6603,15,134,7,8
59917,445,0,0,drop,66,66,0,1,0,1,0
61168,443,61168,443,allow,4599,1692,2907,19,29,11,8
63864,44139,1189,44139,allow,66,66,0,2,7,2,0
21833,22114,0,0,deny,62,62,0,1,0,1,0
65399,53,0,0,allow,191,75,116,2,30,1,1
63731,26467,0,0,deny,62,62,0,1,0,1,0
61534,445,0,0,drop,70,70,0,1,0,1,0
55475,53,28600,53,allow,757,102,655,2,29,1,1
58183,443,49158,443,allow,841459,41656,799803,1083,141,389,694
59920,443,3699,443,allow,7359,2050,5309,18,16,10,8
5729,22114,0,0,deny,66,66,0,1,0,1,0
57335,8631,57083,8631,allow,742,298,444,11,16,5,6
42298,40022,65114,40022,allow,148,86,62,2,30,1,1
60722,445,0,0,drop,66,66,0,1,0,1,0
49950,23,0,0,deny,60,60,0,1,0,1,0
38099,11392,0,0,deny,62,62,0,1,0,1,0
35011,37965,0,0,deny,62,62,0,1,0,1,0
50597,80,50597,80,allow,16296,9143,7153,48,27,26,22
37135,443,52476,443,allow,16921,7469,9452,40,138,19,21
39194,53,39194,53,allow,414,268,146,3,32,2,1
56431,53,39797,53,allow,177,94,83,2,30,1,1
55966,53,61391,53,allow,86,86,0,1,29,1,0
7905,22114,0,0,deny,62,62,0,1,0,1,0
50408,443,29487,443,allow,5638,4258,1380,19,34,11,8
28608,80,28608,80,allow,602483,18143,584340,627,27,219,408
45994,443,45994,443,allow,1494,898,596,12,142,6,6
50961,5222,36046,5222,allow,8318,2850,5468,54,255,27,27
49701,80,18933,80,allow,6132,634,5498,13,130,6,7
60292,7129,0,0,deny,62,62,0,1,0,1,0
55196,10387,0,0,deny,159,159,0,1,0,1,0
53818,445,0,0,drop,66,66,0,1,0,1,0
56219,22114,0,0,deny,66,66,0,1,0,1,0
63912,18318,13803,18318,allow,1295,926,369,13,17,9,4
64493,53,42355,53,allow,199,102,97,2,29,1,1
54978,443,60259,443,allow,225539,162879,62660,476,70,262,214
56441,80,25376,80,allow,130,70,60,2,15,1,1
58638,5900,0,0,deny,62,62,0,1,0,1,0
55396,26467,0,0,deny,62,62,0,1,0,1,0
53886,443,40309,443,allow,499,425,74,4,0,3,1
58779,443,44782,443,allow,5166,700,4466,16,15,7,9
2305,35440,0,0,deny,62,62,0,1,0,1,0
53089,24211,0,0,deny,66,66,0,1,0,1,0
36374,30228,0,0,deny,145,145,0,1,0,1,0
54979,53,11444,53,allow,183,94,89,2,30,1,1
57228,53,47856,53,allow,199,102,97,2,31,1,1
58792,445,0,0,drop,70,70,0,1,0,1,0
60830,50584,0,0,deny,62,62,0,1,0,1,0
50788,48817,0,0,deny,66,66,0,1,0,1,0
31130,30188,0,0,deny,66,66,0,1,0,1,0
43112,443,7009,443,allow,3197,1931,1266,19,15,9,10
54817,47993,0,0,deny,66,66,0,1,0,1,0
62920,445,0,0,drop,70,70,0,1,0,1,0
63092,443,8576,443,allow,4771341,155341,4616000,5024,147,1667,3357
57410,443,21541,443,allow,7435,2697,4738,23,30,13,10
52099,28401,4027,28401,allow,70,70,0,2,8,2,0
40217,443,1676,443,allow,14944,7430,7514,32,25,19,13
55759,53,35937,53,allow,177,94,83,2,30,1,1
40797,25174,0,0,deny,62,62,0,1,0,1,0
39611,443,31755,443,allow,234,234,0,4,12,4,0
60294,30188,0,0,deny,62,62,0,1,0,1,0
49291,53,21649,53,allow,771,102,669,2,30,1,1
19557,53,19557,53,allow,194,87,107,2,30,1,1
49864,53,65077,53,allow,212,102,110,2,30,1,1
50630,53,64139,53,allow,209,110,99,2,30,1,1
52021,80,35964,80,allow,422,240,182,8,25,5,3
56403,443,13577,443,allow,1710,976,734,16,81,8,8
62341,26467,0,0,deny,62,62,0,1,0,1,0
65176,53,48862,53,allow,193,102,91,2,31,1,1
30960,45731,48545,45731,allow,330,330,0,6,3610,6,0
3375,35253,0,0,deny,66,66,0,1,0,1,0
51992,445,0,0,drop,70,70,0,1,0,1,0
5886,80,5886,80,allow,138678,5557,133121,152,16,58,94
56754,53,50250,53,allow,209,110,99,2,30,1,1
57878,55108,0,0,deny,148,148,0,1,0,1,0
55865,53,56298,53,allow,168,86,82,2,30,1,1
49717,53,48239,53,allow,444,96,348,4,44,2,2
53883,445,0,0,drop,66,66,0,1,0,1,0
28668,8696,0,0,deny,60,60,0,1,0,1,0
58598,50584,0,0,deny,62,62,0,1,0,1,0
59925,80,15613,80,allow,2287,1534,753,11,16,6,5
54140,43890,0,0,deny,66,66,0,1,0,1,0
49767,53,37135,53,allow,170,87,83,2,30,1,1
64575,443,61163,443,allow,24686,1935,22751,36,16,17,19
13285,29892,0,0,deny,145,145,0,1,0,1,0
65340,53,24167,53,allow,313,110,203,4,34,2,2
53634,443,2193,443,allow,2005,1100,905,16,17,9,7
56522,53,55041,53,allow,177,94,83,2,30,1,1
33545,443,31253,443,allow,9737,3353,6384,27,32,13,14
49701,53,61488,53,allow,197,102,95,2,30,1,1
55584,53,31260,53,allow,184,80,104,2,30,1,1
64483,53,37576,53,allow,300,90,210,4,30,2,2
55161,53,36813,53,allow,197,94,103,2,30,1,1
49319,53,3849,53,allow,198,101,97,2,30,1,1
38017,7275,45146,7275,allow,4615,664,3951,15,15,9,6
58686,18375,0,0,deny,66,66,0,1,0,1,0
56876,30188,0,0,deny,66,66,0,1,0,1,0
49181,443,9716,443,allow,50097,3666,46431,79,256,36,43
62076,443,11320,443,allow,7370,2873,4497,23,47,13,10
23089,48817,0,0,deny,62,62,0,1,0,1,0
57521,445,0,0,drop,70,70,0,1,0,1,0
56841,53,62125,53,allow,177,94,83,2,30,1,1
9310,443,7475,443,allow,4458,1022,3436,16,26,9,7
51052,80,32804,80,allow,5678,1692,3986,13,17,8,5
54438,62413,0,0,deny,66,66,0,1,0,1,0
52195,443,11275,443,allow,13948,1150,12798,29,15,14,15
55187,53,40713,53,allow,172,94,78,2,30,1,1
63495,50584,0,0,deny,66,66,0,1,0,1,0
36804,25174,0,0,deny,66,66,0,1,0,1,0
41603,443,56421,443,allow,16028,3246,12782,37,272,19,18
65171,53,41753,53,allow,752,110,642,2,30,1,1
53667,22114,0,0,deny,66,66,0,1,0,1,0
49919,80,50897,80,allow,2821387,64706,2756681,2277,183,418,1859
57131,31061,0,0,deny,145,145,0,1,0,1,0
56809,443,9000,443,allow,7929,1909,6020,20,15,11,9
1024,25174,0,0,deny,62,62,0,1,0,1,0
62180,445,0,0,drop,70,70,0,1,0,1,0
1025,64147,0,0,deny,62,62,0,1,0,1,0
57915,443,51000,443,allow,4103,2950,1153,26,131,16,10
50828,445,0,0,drop,70,70,0,1,0,1,0
55068,53,43226,53,allow,196,102,94,2,31,1,1
17306,25174,0,0,deny,66,66,0,1,0,1,0
49206,53,44411,53,allow,179,94,85,2,30,1,1
55392,445,0,0,drop,70,70,0,1,0,1,0
11030,17372,0,0,deny,62,62,0,1,0,1,0
57904,443,36166,443,allow,4042,2515,1527,28,169,14,14
64018,53,10598,53,allow,229,94,135,2,30,1,1
49465,445,0,0,drop,70,70,0,1,0,1,0
57223,443,27688,443,allow,24283,14945,9338,46,318,26,20
65482,445,0,0,drop,70,70,0,1,0,1,0
65061,53,34099,53,allow,297,101,196,4,31,2,2
60578,443,8619,443,allow,27150,3104,24046,55,157,24,31
52729,443,62575,443,allow,9026,3447,5579,50,45,26,24
47971,443,21107,443,allow,9021,1511,7510,21,121,11,10
64090,445,0,0,drop,70,70,0,1,0,1,0
49745,53,63902,53,allow,1472,98,1374,4,54,2,2
56028,53,49252,53,allow,770,102,668,2,31,1,1
58338,3369,0,0,deny,60,60,0,1,0,1,0
52506,445,0,0,drop,70,70,0,1,0,1,0
9687,57470,0,0,deny,78,78,0,1,0,1,0
50317,443,44223,443,allow,13565,6019,7546,35,112,19,16
61532,445,0,0,drop,70,70,0,1,0,1,0
55990,53,6469,53,allow,183,94,89,2,30,1,1
34429,443,39079,443,allow,1701,1048,653,15,38,8,7
52978,445,0,0,drop,70,70,0,1,0,1,0
50597,445,0,0,drop,70,70,0,1,0,1,0
54387,5228,7370,5228,allow,7019,1592,5427,25,3600,14,11
60425,80,53766,80,allow,186,64,122,4,28,2,2
53513,443,7067,443,allow,1625,1038,587,14,34,8,6
56883,22114,0,0,deny,62,62,0,1,0,1,0
60058,25174,0,0,deny,66,66,0,1,0,1,0
65017,445,0,0,drop,70,70,0,1,0,1,0
49263,53,17752,53,allow,178,94,84,2,30,1,1
55156,445,0,0,drop,70,70,0,1,0,1,0
61384,80,43597,80,allow,2526,843,1683,12,255,7,5
47178,53,0,0,allow,82,82,0,2,40,2,0
58110,53,0,0,allow,178,79,99,2,30,1,1
54348,443,31489,443,allow,27760,9709,18051,56,45,27,29
49479,53,55939,53,allow,213,94,119,2,29,1,1
62408,50584,0,0,deny,66,66,0,1,0,1,0
36956,443,8939,443,allow,9273,2731,6542,31,403,10,21
50970,445,0,0,drop,70,70,0,1,0,1,0
36834,443,42042,443,allow,8975,1129,7846,19,31,10,9
56111,53,27769,53,allow,227,110,117,2,30,1,1
65038,445,0,0,drop,70,70,0,1,0,1,0
59489,445,0,0,drop,70,70,0,1,0,1,0
49182,21247,0,0,deny,66,66,0,1,0,1,0
35422,443,35422,443,allow,5172,1925,3247,22,39,13,9
26922,443,5779,443,allow,7647,2890,4757,23,20,11,12
52356,55442,0,0,deny,62,62,0,1,0,1,0
55317,53,30681,53,allow,216,102,114,2,30,1,1
49541,443,61178,443,allow,8464,2891,5573,20,30,10,10
49363,445,0,0,drop,70,70,0,1,0,1,0
58723,443,11514,443,allow,24079,11282,12797,44,17,22,22
27419,23,0,0,deny,60,60,0,1,0,1,0
50265,54145,30228,54145,allow,858,858,0,14,1200,14,0
64573,443,4149,443,allow,4158,2117,2041,11,120,6,5
54356,443,29580,443,allow,18744,10266,8478,44,35,21,23
26351,22114,0,0,deny,62,62,0,1,0,1,0
57470,51413,18747,51413,allow,604,275,329,4,1199,2,2
57426,445,0,0,drop,70,70,0,1,0,1,0
60969,48637,0,0,deny,78,78,0,1,0,1,0
15733,3389,15733,3389,allow,3910,1805,2105,20,19,12,8
63919,445,0,0,drop,70,70,0,1,0,1,0
59792,80,7891,80,allow,1453540,37280,1416260,1552,96,507,1045
56351,53,53304,53,allow,195,102,93,2,33,1,1
64641,445,0,0,drop,70,70,0,1,0,1,0
64087,80,46757,80,allow,314,192,122,6,15,4,2
43309,443,32781,443,allow,60,60,0,1,5,1,0
57470,43323,55435,43323,allow,2292,332,1960,11,1200,5,6
40521,23117,0,0,deny,66,66,0,1,0,1,0
56288,53,26260,53,allow,200,102,98,2,31,1,1
53667,80,16085,80,allow,5090,4357,733,17,15,11,6
55405,53,55361,53,allow,199,102,97,2,30,1,1
64889,53,50666,53,allow,215,102,113,2,30,1,1
15403,51505,0,0,deny,66,66,0,1,0,1,0
52575,22114,0,0,deny,66,66,0,1,0,1,0
51564,50584,0,0,deny,66,66,0,1,0,1,0
56156,53,34308,53,allow,711,87,624,2,31,1,1
56511,53,55404,53,allow,200,102,98,2,30,1,1
62909,445,0,0,drop,66,66,0,1,0,1,0
65222,53,8527,53,allow,212,102,110,2,30,1,1
56181,53,54189,53,allow,764,99,665,2,31,1,1
49767,53,52894,53,allow,727,86,641,2,30,1,1
59228,445,0,0,drop,66,66,0,1,0,1,0
64245,53,44468,53,allow,199,102,97,2,30,1,1
51640,80,25604,80,allow,2895,1428,1467,12,38,7,5
62310,445,0,0,drop,70,70,0,1,0,1,0
46683,443,34091,443,allow,416,210,206,7,28,4,3
56745,443,56745,443,allow,101899,20048,81851,132,62,67,65
49966,445,0,0,drop,70,70,0,1,0,1,0
11983,57470,0,0,deny,62,62,0,1,0,1,0
63237,445,0,0,drop,70,70,0,1,0,1,0
63765,51221,0,0,deny,62,62,0,1,0,1,0
53951,445,0,0,drop,66,66,0,1,0,1,0
53796,17546,0,0,deny,62,62,0,1,0,1,0
42947,53,42947,53,allow,260,106,154,2,33,1,1
65446,53,45033,53,allow,204,104,100,2,30,1,1
51963,21638,43079,21638,allow,70,70,0,1,5,1,0
60466,64337,26945,64337,allow,70,70,0,1,5,1,0
56808,53,42088,53,allow,180,94,86,2,35,1,1
56038,53,20578,53,allow,177,94,83,2,29,1,1
49417,38558,0,0,deny,66,66,0,1,0,1,0
50286,53,44602,53,allow,766,102,664,2,30,1,1
64307,445,0,0,drop,70,70,0,1,0,1,0
49715,445,0,0,drop,66,66,0,1,0,1,0
56558,443,56558,443,allow,4656,1749,2907,19,27,11,8
58052,80,61267,80,allow,1550,853,697,9,15,5,4
64755,443,45264,443,allow,23561,3667,19894,40,121,19,21
49847,53,33024,53,allow,448,184,264,6,29,3,3
65500,443,21161,443,allow,91813,4379,87434,101,16,37,64
15701,37965,0,0,deny,146,146,0,1,0,1,0
57222,53,54587,53,allow,177,94,83,2,30,1,1
57649,445,0,0,drop,70,70,0,1,0,1,0
65229,53,28081,53,allow,195,102,93,2,30,1,1
13684,25174,0,0,deny,62,62,0,1,0,1,0
50709,445,0,0,drop,70,70,0,1,0,1,0
8976,44847,0,0,deny,66,66,0,1,0,1,0
58638,5900,0,0,deny,62,62,0,1,0,1,0
55171,53,9139,53,allow,199,102,97,2,29,1,1
49296,53,53194,53,allow,193,102,91,2,31,1,1
55809,443,23452,443,allow,180,180,0,4,11,4,0
12164,22114,0,0,deny,62,62,0,1,0,1,0
55118,445,0,0,drop,70,70,0,1,0,1,0
43809,443,45485,443,allow,9842,2961,6881,31,19,16,15
62219,25174,0,0,deny,146,146,0,1,0,1,0
52278,443,55005,443,allow,7196,1791,5405,18,31,11,7
12986,64147,0,0,deny,145,145,0,1,0,1,0
48817,11602,48817,11602,allow,152,152,0,1,1200,1,0
53104,445,0,0,drop,70,70,0,1,0,1,0
63957,445,0,0,drop,66,66,0,1,0,1,0
53268,80,36603,80,allow,2960,1928,1032,13,75,8,5
65435,53,59924,53,allow,196,94,102,2,29,1,1
43014,53,60826,53,allow,198,93,105,2,30,1,1
59714,445,0,0,drop,66,66,0,1,0,1,0
41524,443,23023,443,allow,3976,2652,1324,20,312,11,9
58356,443,14561,443,allow,10817,2611,8206,44,135,21,23
9687,35440,0,0,deny,66,66,0,1,0,1,0
46980,443,8668,443,allow,7633,5620,2013,31,60,19,12
50252,445,0,0,drop,70,70,0,1,0,1,0
59846,445,0,0,drop,66,66,0,1,0,1,0
51206,443,30642,443,allow,12274,2677,9597,51,17,29,22
35991,443,8225,443,allow,2509208,64544,2444664,2429,304,700,1729
55443,445,0,0,drop,70,70,0,1,0,1,0
1063,7302,0,0,deny,62,62,0,1,0,1,0
11023,51505,0,0,deny,62,62,0,1,0,1,0
62716,23,0,0,deny,60,60,0,1,0,1,0
47962,16069,0,0,deny,62,62,0,1,0,1,0
51636,80,6805,80,allow,318,192,126,6,39,4,2
20576,37965,0,0,deny,62,62,0,1,0,1,0
57080,445,0,0,drop,70,70,0,1,0,1,0
50470,61463,0,0,deny,86,86,0,1,0,1,0
42971,3478,30766,3478,allow,312,140,172,4,30,2,2
64852,53,7184,53,allow,248,102,146,2,29,1,1
53599,445,0,0,drop,70,70,0,1,0,1,0
43719,53,43719,53,allow,295,90,205,2,30,1,1
51313,25174,0,0,deny,66,66,0,1,0,1,0
52160,49212,45447,49212,allow,316,136,180,6,6,3,3
56725,53,37417,53,allow,176,90,86,3,55,2,1
59534,53,0,0,allow,216,72,144,2,30,1,1
51742,20110,30208,20110,allow,136,136,0,3,14,3,0
55229,53,55587,53,allow,199,94,105,2,30,1,1
53667,22114,0,0,deny,66,66,0,1,0,1,0
50547,22197,0,0,deny,66,66,0,1,0,1,0
50122,443,55695,443,allow,6407,1101,5306,18,26,10,8
59601,445,0,0,drop,66,66,0,1,0,1,0
54991,445,0,0,drop,70,70,0,1,0,1,0
63704,28291,53778,28291,allow,504,382,122,8,15,6,2
56422,53,25062,53,allow,195,102,93,2,31,1,1
41775,443,57658,443,allow,7036547,93047,6943500,5816,186,995,4821
64084,445,0,0,drop,66,66,0,1,0,1,0
16454,25174,0,0,deny,66,66,0,1,0,1,0
50947,445,0,0,drop,66,66,0,1,0,1,0
34470,57470,0,0,deny,66,66,0,1,0,1,0
65175,53,9313,53,allow,778,103,675,2,30,1,1
49528,53,46480,53,allow,170,87,83,2,30,1,1
61550,5529,0,0,deny,145,145,0,1,0,1,0
61054,445,0,0,drop,70,70,0,1,0,1,0
55514,53,31515,53,allow,747,93,654,2,30,1,1
50278,443,50420,443,allow,36958,2966,33992,48,120,18,30
6889,45850,0,0,reset-both,143,143,0,1,0,1,0
49870,443,21099,443,allow,6062,1042,5020,20,55,11,9
59582,443,37348,443,allow,22106,5214,16892,23,127,9,14
60437,445,0,0,drop,66,66,0,1,0,1,0
56948,53,35699,53,allow,93,93,0,1,30,1,0
33084,443,45325,443,allow,15474,4188,11286,14,139,4,10
60308,37965,0,0,deny,66,66,0,1,0,1,0
65061,53,50134,53,allow,297,101,196,4,33,2,2
59923,53,29358,53,allow,197,78,119,2,30,1,1
52178,445,0,0,drop,70,70,0,1,0,1,0
56889,53,24379,53,allow,177,94,83,2,30,1,1
65089,53,28362,53,allow,199,102,97,2,30,1,1
55176,53,60647,53,allow,195,102,93,2,30,1,1
53105,42707,0,0,deny,66,66,0,1,0,1,0
65251,53,53427,53,allow,199,102,97,2,30,1,1
39456,443,56286,443,allow,6944,1650,5294,24,40,14,10
61365,445,0,0,drop,70,70,0,1,0,1,0
49773,445,0,0,drop,70,70,0,1,0,1,0
64986,53,9099,53,allow,183,94,89,2,30,1,1
51123,443,33422,443,allow,6625,1673,4952,20,20,10,10
62709,445,0,0,drop,70,70,0,1,0,1,0
53923,25267,60857,25267,allow,1724,1157,567,14,17,9,5
50428,445,0,0,drop,70,70,0,1,0,1,0
56720,53,11601,53,allow,177,94,83,2,29,1,1
50877,30041,0,0,deny,66,66,0,1,0,1,0
59813,53,1465,53,allow,355,118,237,2,30,1,1
58853,443,20470,443,allow,155516,6298,149218,174,107,49,125
50662,443,7273,443,allow,4606,3263,1343,19,304,10,9
1162,57470,0,0,deny,62,62,0,1,0,1,0
61436,443,20457,443,allow,1401,940,461,11,29,7,4
54593,445,0,0,drop,66,66,0,1,0,1,0
65188,53,51573,53,allow,731,91,640,2,31,1,1
50977,80,13754,80,allow,45483,4137,41346,68,21,36,32
55439,37965,0,0,deny,66,66,0,1,0,1,0
37034,25174,0,0,deny,62,62,0,1,0,1,0
57761,30317,0,0,deny,66,66,0,1,0,1,0
58429,53,0,0,allow,1254,160,1094,4,49,2,2
40302,443,5180,443,allow,7586,3785,3801,20,30,11,9
56654,443,53376,443,allow,4972,2136,2836,21,24,12,9
55989,53,12782,53,allow,821,102,719,2,30,1,1
49895,445,0,0,drop,70,70,0,1,0,1,0
12031,36237,0,0,deny,66,66,0,1,0,1,0
22683,39210,0,0,deny,60,60,0,1,0,1,0
57220,26467,0,0,deny,62,62,0,1,0,1,0
49655,80,18992,80,allow,1056,682,374,10,15,6,4
56751,32300,2097,32300,allow,70,70,0,1,5,1,0
53971,55442,0,0,deny,66,66,0,1,0,1,0
9330,443,63077,443,allow,3255,430,2825,11,15,6,5
55664,53,23659,53,allow,177,94,83,2,30,1,1
56555,443,29813,443,allow,6308,829,5479,18,15,9,9
56765,443,7248,443,allow,7940,1951,5989,20,15,11,9
56096,445,0,0,drop,70,70,0,1,0,1,0
50672,80,6037,80,allow,1718,1247,471,9,14,5,4
45397,443,38399,443,allow,970804,44459,926345,1113,200,446,667
8999,32480,0,0,deny,146,146,0,1,0,1,0
64580,53,58707,53,allow,425,90,335,4,43,2,2
64669,445,0,0,drop,70,70,0,1,0,1,0
65495,11392,0,0,deny,66,66,0,1,0,1,0
49177,54532,0,0,deny,60,60,0,1,0,1,0
49290,445,0,0,drop,70,70,0,1,0,1,0
60859,445,0,0,drop,70,70,0,1,0,1,0
52049,52557,23041,52557,allow,70,70,0,1,5,1,0
63217,443,63217,443,allow,11907,1406,10501,25,22,11,14
63855,25174,0,0,deny,146,146,0,1,0,1,0
56427,53,42294,53,allow,166,86,80,2,30,1,1
49156,53,9695,53,allow,190,97,93,2,30,1,1
35644,53,9492,53,allow,198,93,105,2,30,1,1
49418,27016,30888,27016,allow,255,78,177,2,30,1,1
62659,445,0,0,drop,70,70,0,1,0,1,0
63161,445,0,0,drop,70,70,0,1,0,1,0
56694,53,57041,53,allow,196,102,94,2,30,1,1
42446,123,14987,123,allow,184,94,90,2,30,1,1
60295,80,60202,80,allow,8876,1061,7815,18,144,9,9
22452,443,22452,443,allow,5785,2575,3210,24,76,14,10
25101,50584,0,0,deny,146,146,0,1,0,1,0
52779,445,0,0,drop,70,70,0,1,0,1,0
49861,53,49122,53,allow,196,100,96,2,31,1,1
62972,445,0,0,drop,70,70,0,1,0,1,0
60683,5900,0,0,deny,60,60,0,1,0,1,0
52657,445,0,0,drop,70,70,0,1,0,1,0
56756,53,46487,53,allow,166,85,81,2,31,1,1
52818,445,0,0,drop,70,70,0,1,0,1,0
57165,53,9169,53,allow,216,102,114,2,30,1,1
49712,53,3465,53,allow,178,94,84,2,30,1,1
3996,57470,0,0,deny,62,62,0,1,0,1,0
30960,45718,62760,45718,allow,330,330,0,6,3609,6,0
56354,445,0,0,drop,70,70,0,1,0,1,0
49839,53,59644,53,allow,258,110,148,2,29,1,1
55800,445,0,0,drop,70,70,0,1,0,1,0
55233,445,0,0,drop,70,70,0,1,0,1,0
55154,53,5239,53,allow,184,94,90,2,30,1,1
5233,22683,23073,22683,allow,832,832,0,14,95,14,0
57164,445,0,0,drop,70,70,0,1,0,1,0
443,63113,0,0,deny,100,100,0,1,0,1,0
49400,80,44770,80,allow,3651,2020,1631,16,65,9,7
27416,53,27416,53,allow,214,82,132,2,32,1,1
49386,53,12060,53,allow,332,102,230,2,30,1,1
54455,445,0,0,drop,66,66,0,1,0,1,0
44594,64147,0,0,deny,66,66,0,1,0,1,0
52277,445,0,0,drop,70,70,0,1,0,1,0
58658,445,0,0,drop,70,70,0,1,0,1,0
57479,56205,0,0,deny,66,66,0,1,0,1,0
50757,64147,0,0,deny,62,62,0,1,0,1,0
52184,22114,0,0,deny,66,66,0,1,0,1,0
46176,53,12412,53,allow,168,78,90,2,30,1,1
3117,37965,0,0,deny,62,62,0,1,0,1,0
61017,64147,0,0,deny,66,66,0,1,0,1,0
52182,60769,21483,60769,allow,70,70,0,1,5,1,0
58638,5900,0,0,deny,62,62,0,1,0,1,0
63472,445,0,0,drop,70,70,0,1,0,1,0
1035,57470,0,0,deny,72,72,0,1,0,1,0
49001,48817,0,0,deny,160,160,0,1,0,1,0
50459,62413,0,0,deny,66,66,0,1,0,1,0
35941,443,48738,443,allow,190,70,120,4,18,2,2
50243,445,0,0,drop,70,70,0,1,0,1,0
50339,25174,0,0,deny,146,146,0,1,0,1,0
57351,62413,0,0,deny,62,62,0,1,0,1,0
54666,123,26890,123,allow,184,94,90,2,31,1,1
25523,35974,0,0,deny,62,62,0,1,0,1,0
64665,53,19631,53,allow,181,94,87,2,31,1,1
55107,53,40259,53,allow,184,94,90,2,30,1,1
52182,53,52182,53,allow,832,106,726,2,30,1,1
61770,445,0,0,drop,66,66,0,1,0,1,0
55804,445,0,0,drop,70,70,0,1,0,1,0
49343,443,10308,443,allow,1556,769,787,17,134,9,8
56540,53,53541,53,allow,735,88,647,2,30,1,1
53962,16251,40390,16251,allow,70,70,0,2,7,2,0
49522,53,15202,53,allow,753,96,657,2,31,1,1
50602,443,33341,443,allow,572966,109738,463228,1277,624,639,638
58536,445,0,0,drop,70,70,0,1,0,1,0
27005,27016,53095,27016,allow,889,126,763,3,31,2,1
53433,445,0,0,drop,66,66,0,1,0,1,0
38093,11392,0,0,deny,62,62,0,1,0,1,0
34952,53,65291,53,allow,177,94,83,2,30,1,1
49920,443,27141,443,allow,9759,1989,7770,25,16,13,12
11488,22114,0,0,deny,66,66,0,1,0,1,0
55757,53,48609,53,allow,177,94,83,2,30,1,1
60549,445,0,0,drop,66,66,0,1,0,1,0
49466,443,64942,443,allow,4562,2466,2096,20,119,11,9
51247,443,62660,443,allow,5747,1892,3855,19,16,11,8
50553,445,0,0,drop,66,66,0,1,0,1,0
58638,5900,0,0,deny,62,62,0,1,0,1,0
63945,53,38413,53,allow,216,110,106,2,30,1,1
52247,443,52247,443,allow,948720,23674,925046,988,26,349,639
55182,53,36739,53,allow,293,94,199,2,30,1,1
58638,5900,0,0,deny,62,62,0,1,0,1,0
49189,443,23027,443,allow,9734,1613,8121,24,17,12,12
56542,53,15813,53,allow,183,94,89,2,30,1,1
62549,53733,0,0,deny,66,66,0,1,0,1,0
61739,445,0,0,drop,70,70,0,1,0,1,0
46434,443,35412,443,allow,14879,4981,9898,43,121,21,22
52812,25174,0,0,deny,66,66,0,1,0,1,0
1660,8696,0,0,deny,62,62,0,1,0,1,0
49312,53,33674,53,allow,306,94,212,2,29,1,1
51760,36558,43821,36558,allow,70,70,0,2,8,2,0
63116,22114,0,0,deny,146,146,0,1,0,1,0
58036,445,0,0,drop,66,66,0,1,0,1,0
9916,53,9916,53,allow,235,90,145,2,33,1,1
35292,8100,45355,8100,allow,78,78,0,1,4,1,0
55002,443,46892,443,allow,6953,2447,4506,26,37,15,11
49973,53,27114,53,allow,261,94,167,2,30,1,1
53045,445,0,0,drop,70,70,0,1,0,1,0
53042,445,0,0,drop,66,66,0,1,0,1,0
56626,80,44276,80,allow,234,234,0,4,12,4,0
50285,445,0,0,drop,70,70,0,1,0,1,0
40561,443,22594,443,allow,3167,2456,711,15,16,10,5
55056,53,32343,53,allow,177,94,83,2,31,1,1
64312,53,39914,53,allow,209,110,99,2,30,1,1
65426,80,28723,80,allow,65980,5156,60824,86,23,39,47
49298,18593,0,0,deny,145,145,0,1,0,1,0
51672,445,0,0,drop,70,70,0,1,0,1,0
49160,6889,25152,6889,allow,834,150,684,4,1200,2,2
52082,80,6337,80,allow,4560,3934,626,11,29,6,5
2475,6881,0,0,deny,66,66,0,1,0,1,0
56785,53,64900,53,allow,186,95,91,2,31,1,1
51855,23268,62200,23268,allow,70,70,0,2,7,2,0
5462,21247,0,0,deny,62,62,0,1,0,1,0
56561,443,57452,443,allow,341343,9074,332269,353,121,122,231
49418,33056,16028,33056,allow,237,78,159,2,30,1,1
993,4543,0,0,deny,66,66,0,1,0,1,0
25363,22114,0,0,deny,66,66,0,1,0,1,0
55046,53,11757,53,allow,198,102,96,2,29,1,1
61461,443,31107,443,allow,9073,2899,6174,36,94,19,17
53930,445,0,0,drop,70,70,0,1,0,1,0
63237,443,45268,443,allow,1369,670,699,17,141,9,8
50477,443,6875,443,allow,25979,7217,18762,36,15,19,17
52095,443,20736,443,allow,325846,10609,315237,326,38,106,220
65330,53,53724,53,allow,723,102,621,2,30,1,1
43029,443,37384,443,allow,6053,1321,4732,19,980,9,10
63051,445,0,0,drop,66,66,0,1,0,1,0
55598,53,46757,53,allow,186,102,84,2,30,1,1
64992,53,39214,53,allow,177,94,83,2,29,1,1
64937,53,43310,53,allow,183,94,89,2,29,1,1
50504,53,13475,53,allow,168,86,82,2,31,1,1
27005,27019,21783,27019,allow,1648,126,1522,4,31,2,2
55613,53,25861,53,allow,177,94,83,2,30,1,1
56177,53,33735,53,allow,184,94,90,2,30,1,1
52199,445,0,0,drop,66,66,0,1,0,1,0
56046,53,6511,53,allow,193,102,91,2,31,1,1
64038,28187,42501,28187,allow,70,70,0,1,4,1,0
51683,5228,43500,5228,allow,9476,2759,6717,27,3601,15,12
60531,80,48244,80,allow,2122,1559,563,13,16,7,6
30794,37965,0,0,deny,62,62,0,1,0,1,0
7249,30349,0,0,deny,143,143,0,1,0,1,0
50609,53,13488,53,allow,766,102,664,2,30,1,1
52329,443,52329,443,allow,4453,1546,2907,21,86,11,10
45013,50584,0,0,deny,146,146,0,1,0,1,0
50422,50584,0,0,deny,66,66,0,1,0,1,0
50360,80,38167,80,allow,5307,2694,2613,17,25,9,8
56822,53,60070,53,allow,184,94,90,2,30,1,1
8102,57470,0,0,deny,62,62,0,1,0,1,0
60464,53,0,0,allow,180,82,98,2,30,1,1
57726,37965,0,0,deny,62,62,0,1,0,1,0
60194,445,0,0,drop,70,70,0,1,0,1,0
52643,36237,0,0,deny,66,66,0,1,0,1,0
65372,53,52621,53,allow,330,91,239,4,44,2,2
9162,443,30671,443,allow,5658,501,5157,14,15,7,7
56679,51505,0,0,deny,62,62,0,1,0,1,0
53203,445,0,0,drop,70,70,0,1,0,1,0
59715,443,21725,443,allow,3420,983,2437,15,121,7,8
9231,443,14526,443,allow,4942,429,4513,12,15,6,6
35195,443,7133,443,allow,153,93,60,2,5,1,1
49448,445,0,0,drop,70,70,0,1,0,1,0
64103,38976,24644,38976,allow,66,66,0,2,8,2,0
65171,445,0,0,drop,70,70,0,1,0,1,0
58638,5900,0,0,deny,62,62,0,1,0,1,0
57030,53,12910,53,allow,283,101,182,4,38,2,2
52280,995,52280,995,allow,142,78,64,2,5,1,1
65189,27017,19229,27017,allow,239,78,161,2,30,1,1
55435,25174,0,0,deny,62,62,0,1,0,1,0
49443,443,17566,443,allow,70988,47020,23968,152,652,79,73
1790,48817,0,0,deny,66,66,0,1,0,1,0
40521,23117,0,0,deny,66,66,0,1,0,1,0
59538,80,24164,80,allow,3835,1767,2068,21,187,12,9
56778,35292,48198,35292,allow,70,70,0,1,5,1,0
64800,80,8529,80,allow,508,256,252,9,75,5,4
57990,443,7309,443,allow,3182,1568,1614,8,120,4,4
56746,80,35139,80,allow,876072,26350,849722,935,27,335,600
60969,443,65231,443,allow,1373,712,661,14,105,8,6
64172,445,0,0,drop,66,66,0,1,0,1,0
49764,443,53395,443,allow,7128,865,6263,19,127,9,10
65176,53,65083,53,allow,183,94,89,2,30,1,1
64525,443,3519,443,allow,5981,1902,4079,14,120,7,7
59156,50584,0,0,deny,62,62,0,1,0,1,0
54247,445,0,0,drop,66,66,0,1,0,1,0
55273,445,0,0,drop,70,70,0,1,0,1,0
46093,443,55794,443,allow,14746,3097,11649,34,19,19,15
55346,445,0,0,drop,66,66,0,1,0,1,0
52352,445,0,0,drop,70,70,0,1,0,1,0
65250,53,37683,53,allow,353,98,255,4,32,2,2
45682,37965,0,0,deny,62,62,0,1,0,1,0
57613,42707,0,0,deny,66,66,0,1,0,1,0
57029,445,0,0,drop,70,70,0,1,0,1,0
50862,443,14909,443,allow,9930,2085,7845,21,318,11,10
22285,3389,22285,3389,reset-both,293,223,70,4,0,3,1
55136,445,0,0,drop,70,70,0,1,0,1,0
63716,445,0,0,drop,70,70,0,1,0,1,0
49889,445,0,0,drop,70,70,0,1,0,1,0
14082,50584,0,0,deny,66,66,0,1,0,1,0
62671,445,0,0,drop,66,66,0,1,0,1,0
17750,39318,52655,39318,allow,481,150,331,2,1200,1,1
59423,445,0,0,drop,70,70,0,1,0,1,0
36837,443,3546,443,allow,9311,1387,7924,20,31,10,10
1227,56205,0,0,deny,66,66,0,1,0,1,0
54979,445,0,0,drop,70,70,0,1,0,1,0
50629,443,56409,443,allow,70,70,0,1,5,1,0
52252,443,52252,443,allow,221672,9306,212366,249,21,97,152
46999,993,56009,993,allow,45153,20621,24532,323,43,165,158
36157,53,43020,53,allow,164,78,86,2,31,1,1
63935,445,0,0,drop,66,66,0,1,0,1,0
61574,445,0,0,drop,66,66,0,1,0,1,0
51755,5900,0,0,deny,60,60,0,1,0,1,0
52150,39109,0,0,deny,66,66,0,1,0,1,0
65380,53,10002,53,allow,180,94,86,2,30,1,1
53193,443,17954,443,allow,1462,965,497,13,18,7,6
44147,64147,0,0,deny,62,62,0,1,0,1,0
32940,443,60631,443,allow,13056,4233,8823,27,121,12,15
55417,53,4838,53,allow,199,102,97,2,30,1,1
49835,53,27246,53,allow,214,94,120,2,30,1,1
12694,22114,0,0,deny,66,66,0,1,0,1,0
62723,443,17496,443,allow,126815,114702,12113,243,86,139,104
44847,22467,39791,22467,allow,150,150,0,1,1200,1,0
51676,23718,0,0,deny,62,62,0,1,0,1,0
64615,53,39093,53,allow,190,97,93,2,31,1,1
60720,23718,0,0,deny,66,66,0,1,0,1,0
55341,445,0,0,drop,70,70,0,1,0,1,0
27005,31000,35910,31000,allow,898,126,772,2,31,1,1
27005,27015,15539,27015,allow,881,126,755,2,30,1,1
56811,445,0,0,drop,70,70,0,1,0,1,0
49492,53,44432,53,allow,199,102,97,2,30,1,1
42595,443,31051,443,allow,1093,606,487,11,15,7,4
44910,443,16825,443,allow,2841,1916,925,18,26,10,8
27005,27015,63024,27015,allow,897,126,771,2,31,1,1
51745,57470,0,0,deny,62,62,0,1,0,1,0
54702,445,0,0,drop,66,66,0,1,0,1,0
60459,445,0,0,drop,70,70,0,1,0,1,0
27005,27015,50781,27015,allow,881,126,755,2,30,1,1
37263,53,37263,53,allow,220,90,130,2,30,1,1
62197,22114,0,0,deny,66,66,0,1,0,1,0
23980,53,23980,53,allow,220,100,120,2,31,1,1
55707,53,31512,53,allow,177,94,83,2,30,1,1
56129,445,0,0,drop,70,70,0,1,0,1,0
64009,80,25096,80,allow,314,192,122,6,15,4,2
60138,445,0,0,drop,70,70,0,1,0,1,0
53253,443,34431,443,allow,36393,27741,8652,147,210,76,71
58113,445,0,0,drop,66,66,0,1,0,1,0
65376,53,8405,53,allow,184,94,90,2,30,1,1
65097,53,14229,53,allow,718,94,624,2,30,1,1
56523,53,49008,53,allow,184,102,82,2,30,1,1
49742,53,44369,53,allow,199,94,105,2,30,1,1
33906,80,51887,80,allow,1248,660,588,8,15,4,4
50680,445,0,0,drop,70,70,0,1,0,1,0
55255,53,4437,53,allow,282,94,188,2,29,1,1
59969,445,0,0,drop,70,70,0,1,0,1,0
55991,53,53761,53,allow,182,93,89,2,30,1,1
51442,443,61245,443,allow,4591,3237,1354,18,271,10,8
55955,53,53026,53,allow,184,94,90,2,30,1,1
51108,445,0,0,drop,70,70,0,1,0,1,0
57368,7302,0,0,deny,66,66,0,1,0,1,0
56245,53,47709,53,allow,200,102,98,2,30,1,1
60513,47094,45469,47094,allow,320,140,180,6,7,3,3
50338,80,9655,80,allow,2668,870,1798,13,47,7,6
49714,445,0,0,drop,66,66,0,1,0,1,0
53722,443,28671,443,allow,70,70,0,1,5,1,0
52860,9694,0,0,deny,62,62,0,1,0,1,0
52720,443,21173,443,allow,11732,4753,6979,41,397,17,24
61336,61689,0,0,deny,66,66,0,1,0,1,0
54883,51505,0,0,deny,66,66,0,1,0,1,0
62992,445,0,0,drop,70,70,0,1,0,1,0
57220,26467,0,0,deny,66,66,0,1,0,1,0
58761,445,0,0,drop,66,66,0,1,0,1,0
52916,443,43880,443,allow,5455,1388,4067,17,15,9,8
36405,443,39984,443,allow,466,392,74,4,0,3,1
10151,22208,55626,22208,allow,323,150,173,2,1203,1,1
39437,80,3186,80,allow,2088,472,1616,15,155,3,12
49844,80,65486,80,allow,18950,788,18162,23,89,8,15
58698,445,0,0,drop,66,66,0,1,0,1,0
36533,443,27150,443,allow,10488,4495,5993,38,32,20,18
51517,443,51517,443,allow,153968,7663,146305,170,173,43,127
56748,443,11472,443,allow,8007,1987,6020,20,15,11,9
56339,445,0,0,drop,70,70,0,1,0,1,0
57140,53,49322,53,allow,177,94,83,2,30,1,1
60569,445,0,0,drop,70,70,0,1,0,1,0
65237,53,3519,53,allow,225,94,131,2,30,1,1
61734,443,59784,443,allow,231110,14545,216565,307,18,154,153
22636,30188,0,0,deny,66,66,0,1,0,1,0
38732,443,56897,443,allow,9217,1548,7669,25,50,13,12
58052,25,34376,25,allow,540,256,284,9,30,5,4
64566,53,24742,53,allow,194,102,92,2,30,1,1
49448,80,49448,80,allow,3193,2163,1030,17,79,10,7
63902,445,0,0,drop,66,66,0,1,0,1,0
9393,51505,0,0,deny,66,66,0,1,0,1,0
64801,53,33594,53,allow,728,96,632,2,30,1,1
49230,53,46684,53,allow,168,86,82,2,30,1,1
63878,22114,0,0,deny,62,62,0,1,0,1,0
15274,19473,0,0,deny,62,62,0,1,0,1,0
54148,445,0,0,drop,70,70,0,1,0,1,0
55112,53,21380,53,allow,245,94,151,2,30,1,1
58289,445,0,0,drop,70,70,0,1,0,1,0
54048,25174,0,0,deny,66,66,0,1,0,1,0
61435,445,0,0,drop,70,70,0,1,0,1,0
55841,53,44587,53,allow,265,86,179,4,58,2,2
54975,445,0,0,drop,70,70,0,1,0,1,0
38871,80,51643,80,allow,2057,1263,794,10,15,6,4
58638,5900,0,0,deny,62,62,0,1,0,1,0
56966,53,53823,53,allow,177,94,83,2,30,1,1
50433,53,29987,53,allow,193,102,91,2,30,1,1
63967,53,11149,53,allow,195,102,93,2,30,1,1
49835,445,0,0,drop,70,70,0,1,0,1,0
58063,445,0,0,drop,70,70,0,1,0,1,0
49346,53,28098,53,allow,212,102,110,2,30,1,1
10467,25174,0,0,deny,62,62,0,1,0,1,0
55487,53,60324,53,allow,199,102,97,2,31,1,1
60376,58302,44068,58302,allow,624,318,306,10,15,5,5
39775,443,49168,443,allow,6883,1887,4996,23,361,12,11
51997,14398,23393,14398,allow,130,70,60,2,4,1,1
55942,445,0,0,drop,70,70,0,1,0,1,0
60192,53,4239,53,allow,236,94,142,2,30,1,1
50582,53,14787,53,allow,216,110,106,2,30,1,1
51126,445,0,0,drop,66,66,0,1,0,1,0
41784,443,54389,443,allow,20365,2035,18330,36,15,17,19
55484,445,0,0,drop,66,66,0,1,0,1,0
50327,445,0,0,drop,70,70,0,1,0,1,0
1114,37965,0,0,deny,62,62,0,1,0,1,0
55893,53,56779,53,allow,711,87,624,2,30,1,1
52056,50328,8366,50328,allow,70,70,0,1,5,1,0
43146,80,15239,80,allow,1102,545,557,10,16,6,4
48706,23393,0,0,deny,60,60,0,1,0,1,0
58638,5900,0,0,deny,62,62,0,1,0,1,0
1937,53,32884,53,allow,210,78,132,2,30,1,1
59940,50584,0,0,deny,66,66,0,1,0,1,0
60763,445,0,0,drop,66,66,0,1,0,1,0
51490,50432,0,0,deny,100,100,0,1,0,1,0
54261,445,0,0,drop,66,66,0,1,0,1,0
39516,23,0,0,deny,60,60,0,1,0,1,0
33080,53,44512,53,allow,86,86,0,1,29,1,0
62071,22114,0,0,deny,62,62,0,1,0,1,0
56889,53,35698,53,allow,177,94,83,2,30,1,1
55007,443,13149,443,allow,14030,7043,6987,32,123,18,14
34529,443,30445,443,allow,62652,30891,31761,158,381,67,91
49824,445,0,0,drop,66,66,0,1,0,1,0
50326,46824,0,0,deny,66,66,0,1,0,1,0
53026,443,50319,443,allow,14051,6332,7719,43,92,21,22
56308,22114,0,0,deny,146,146,0,1,0,1,0
54512,80,54512,80,allow,1923,1474,449,10,20,6,4
59652,443,50919,443,allow,562,562,0,4,175,4,0
32806,53,32806,53,allow,194,87,107,2,31,1,1
49250,53,62470,53,allow,298,87,211,4,48,2,2
56275,443,61048,443,allow,513682,20015,493667,523,226,126,397
64122,53,11077,53,allow,214,110,104,2,30,1,1
62876,445,0,0,drop,70,70,0,1,0,1,0
56626,443,50553,443,allow,8240,3521,4719,25,18,15,10
23397,53,23397,53,allow,234,93,141,2,30,1,1
5588,5588,0,0,allow,3354,1792,1562,46,193,23,23
64599,445,0,0,drop,66,66,0,1,0,1,0
9449,443,11942,443,allow,5693,499,5194,14,15,7,7
52870,443,27625,443,allow,113894,15573,98321,182,119,67,115
49749,445,0,0,drop,70,70,0,1,0,1,0
44228,443,32223,443,allow,7352,1790,5562,24,263,12,12
58773,445,0,0,drop,70,70,0,1,0,1,0
56499,445,0,0,drop,66,66,0,1,0,1,0
53815,17290,63882,17290,allow,70,70,0,2,7,2,0
13485,43708,0,0,deny,554,554,0,1,0,1,0
58638,5900,0,0,deny,62,62,0,1,0,1,0
23936,41615,0,0,deny,146,146,0,1,0,1,0
57731,445,0,0,drop,66,66,0,1,0,1,0
5476,23,0,0,deny,60,60,0,1,0,1,0
56931,445,0,0,drop,70,70,0,1,0,1,0
49901,53,32175,53,allow,231,102,129,2,30,1,1
50065,445,0,0,drop,70,70,0,1,0,1,0
43319,53,43319,53,allow,237,91,146,2,32,1,1
54968,445,0,0,drop,66,66,0,1,0,1,0
52651,445,0,0,drop,70,70,0,1,0,1,0
56072,53,56771,53,allow,199,102,97,2,30,1,1
64751,53,23466,53,allow,458,188,270,6,31,3,3
65246,53,34223,53,allow,182,93,89,2,31,1,1
50522,443,12346,443,allow,13347,4662,8685,40,202,24,16
51415,443,38416,443,allow,9284,2172,7112,39,83,19,20
64766,53,32517,53,allow,214,110,104,2,30,1,1
33912,25174,0,0,deny,62,62,0,1,0,1,0
49718,53,50641,53,allow,184,94,90,2,30,1,1
44219,443,26012,443,allow,35920,26656,9264,60,128,30,30
51282,443,3652,443,allow,4933,2248,2685,14,135,7,7
56817,48650,23825,48650,allow,130,70,60,2,5,1,1
44511,53,15897,53,allow,199,94,105,2,30,1,1
51937,38056,36648,38056,allow,70,70,0,2,8,2,0
52240,443,52240,443,allow,1615,941,674,15,21,7,8
56993,80,53078,80,allow,214,140,74,4,35,3,1
53943,40534,14905,40534,allow,320,140,180,6,5,3,3
34896,53,34896,53,allow,231,90,141,2,30,1,1
56078,445,0,0,drop,70,70,0,1,0,1,0
56343,53,58460,53,allow,194,102,92,2,31,1,1
50403,8080,50403,8080,allow,2203,575,1628,10,15,6,4
49839,445,0,0,deny,70,70,0,1,0,1,0
8889,60961,0,0,deny,60,60,0,1,0,1,0
49969,53,27742,53,allow,199,102,97,2,30,1,1
9227,443,31374,443,allow,5146,960,4186,17,25,9,8
50265,37449,54760,37449,allow,925,594,331,11,2335,10,1
64611,53,9832,53,allow,181,94,87,2,29,1,1
7423,22114,0,0,deny,62,62,0,1,0,1,0
59877,443,61626,443,allow,9024,1533,7491,25,110,11,14
22784,9571,0,0,deny,62,62,0,1,0,1,0
30270,37965,0,0,deny,66,66,0,1,0,1,0
55008,21247,0,0,deny,62,62,0,1,0,1,0
1537,22114,0,0,deny,146,146,0,1,0,1,0
19924,53,19924,53,allow,235,90,145,2,32,1,1
58074,443,57514,443,allow,2974,408,2566,13,135,6,7
53044,445,0,0,drop,70,70,0,1,0,1,0
44710,443,12033,443,allow,13320,3575,9745,38,26,19,19
64364,53,21283,53,allow,193,94,99,2,31,1,1
55723,80,48588,80,allow,70,70,0,1,5,1,0
1356,57470,0,0,deny,72,72,0,1,0,1,0
45627,443,27902,443,allow,6410,1610,4800,24,17,13,11
55384,53,51117,53,allow,194,102,92,2,30,1,1
8243,443,8243,443,allow,1024,539,485,10,58,5,5
53746,445,0,0,drop,70,70,0,1,0,1,0
63822,14382,65355,14382,allow,66,66,0,2,8,2,0
44404,443,27524,443,allow,9060,3523,5537,27,319,15,12
57447,443,62052,443,allow,7847,1377,6470,27,15,12,15
50594,445,0,0,drop,70,70,0,1,0,1,0
33595,23,0,0,deny,60,60,0,1,0,1,0
52120,42751,65345,42751,allow,70,70,0,2,8,2,0
58932,80,50607,80,allow,2424,529,1895,11,75,6,5
59404,445,0,0,drop,70,70,0,1,0,1,0
19204,48817,0,0,deny,148,148,0,1,0,1,0
34993,15503,0,0,deny,62,62,0,1,0,1,0
53987,57470,0,0,deny,66,66,0,1,0,1,0
60340,80,29761,80,allow,9406,1913,7493,14,16,7,7
55564,53,50276,53,allow,775,103,672,2,30,1,1
63968,53,61368,53,allow,310,142,168,2,30,1,1
3580,25174,0,0,deny,62,62,0,1,0,1,0
59089,443,40663,443,allow,77560,5020,72540,93,121,34,59
54781,445,0,0,drop,70,70,0,1,0,1,0
64036,53,20328,53,allow,183,94,89,2,30,1,1
55972,445,0,0,drop,70,70,0,1,0,1,0
51769,19165,28138,19165,allow,70,70,0,2,8,2,0
45060,37965,0,0,deny,62,62,0,1,0,1,0
35494,22114,0,0,deny,66,66,0,1,0,1,0
51024,445,0,0,drop,66,66,0,1,0,1,0
58124,123,43315,123,allow,184,94,90,2,30,1,1
58297,445,0,0,drop,70,70,0,1,0,1,0
50584,6881,56597,6881,allow,161,161,0,1,1201,1,0
53796,48019,39849,48019,allow,70,70,0,2,7,2,0
41576,443,2351,443,allow,2227,1018,1209,17,15,8,9
64551,53,55757,53,allow,755,94,661,2,31,1,1
55728,53,18036,53,allow,195,102,93,2,29,1,1
65284,53,18214,53,allow,758,96,662,2,31,1,1
56946,1,0,0,deny,66,66,0,1,0,1,0
33305,54532,0,0,deny,60,60,0,1,0,1,0
31748,56205,0,0,deny,146,146,0,1,0,1,0
53268,443,58840,443,allow,4241,706,3535,14,25,8,6
65408,53,61605,53,allow,764,99,665,2,30,1,1
51978,57496,57419,57496,allow,70,70,0,1,5,1,0
42154,80,50458,80,allow,73277,3302,69975,102,16,52,50
51765,52862,65009,52862,allow,66,66,0,1,5,1,0
55509,445,0,0,drop,70,70,0,1,0,1,0
56715,445,0,0,drop,70,70,0,1,0,1,0
52431,50265,0,0,deny,62,62,0,1,0,1,0
60320,443,16711,443,allow,1743,1164,579,16,25,10,6
50485,445,0,0,drop,70,70,0,1,0,1,0
58912,11392,0,0,deny,62,62,0,1,0,1,0
56213,26467,0,0,deny,66,66,0,1,0,1,0
26698,25174,0,0,deny,66,66,0,1,0,1,0
48894,53,34771,53,allow,164,78,86,2,31,1,1
5222,7493,0,0,deny,66,66,0,1,0,1,0
62043,25174,0,0,deny,62,62,0,1,0,1,0
51714,123,49877,123,allow,184,94,90,2,30,1,1
33047,443,1345,443,allow,204,70,134,4,25,2,2
53949,445,0,0,drop,66,66,0,1,0,1,0
56770,443,57005,443,allow,124,64,60,2,16,1,1
56559,53,63676,53,allow,177,94,83,2,30,1,1
49164,25174,0,0,deny,62,62,0,1,0,1,0
57957,80,26267,80,allow,3524,1945,1579,32,131,17,15
52071,445,0,0,drop,66,66,0,1,0,1,0
55800,53,5218,53,allow,177,94,83,2,30,1,1
55936,53,1988,53,allow,177,94,83,2,29,1,1
33994,443,56656,443,allow,19547,2951,16596,42,82,21,21
64746,53,11815,53,allow,186,95,91,2,31,1,1
25254,5555,0,0,deny,60,60,0,1,0,1,0
64758,53,8387,53,allow,734,94,640,2,30,1,1
58894,443,4103,443,allow,152,86,66,2,4,1,1
19473,51413,8434,51413,allow,459,149,310,2,1200,1,1
57022,443,20898,443,allow,4228,1470,2758,19,131,9,10
62408,3478,14278,3478,allow,142,142,0,1,30,1,0
56357,443,45710,443,allow,3674,1750,1924,23,203,12,11
58638,5900,0,0,deny,62,62,0,1,0,1,0
56586,443,35077,443,allow,7110,2183,4927,22,16,12,10
49705,445,0,0,drop,70,70,0,1,0,1,0
55330,53,46578,53,allow,188,96,92,2,30,1,1
52089,443,10472,443,allow,15525,1642,13883,32,16,16,16
56754,445,0,0,drop,70,70,0,1,0,1,0
58883,445,0,0,drop,66,66,0,1,0,1,0
52012,443,5821,443,allow,126,60,66,3,10,2,1
53124,52917,26989,52917,allow,70,70,0,1,5,1,0
53367,445,0,0,drop,70,70,0,1,0,1,0
60438,445,0,0,drop,66,66,0,1,0,1,0
41249,50584,0,0,deny,66,66,0,1,0,1,0
57095,445,0,0,drop,66,66,0,1,0,1,0
55803,445,0,0,drop,70,70,0,1,0,1,0
49936,80,9467,80,allow,1130,613,517,11,15,6,5
65209,53,37823,53,allow,166,86,80,2,31,1,1
55593,53,53460,53,allow,102,102,0,1,30,1,0
61015,445,0,0,drop,66,66,0,1,0,1,0
59813,443,22135,443,allow,23244,13793,9451,50,29,26,24
55940,53,15244,53,allow,168,86,82,2,30,1,1
56658,53,11385,53,allow,186,95,91,2,31,1,1
63988,43365,3645,43365,allow,624,382,242,10,15,6,4
61391,443,41670,443,allow,11151,3001,8150,51,365,25,26
43744,53,43744,53,allow,235,90,145,2,32,1,1
65232,445,0,0,drop,66,66,0,1,0,1,0
58082,445,0,0,drop,70,70,0,1,0,1,0
55070,53,21493,53,allow,195,102,93,2,30,1,1
57803,445,0,0,drop,66,66,0,1,0,1,0
49318,445,0,0,drop,70,70,0,1,0,1,0
65133,445,0,0,drop,70,70,0,1,0,1,0
49415,53,12077,53,allow,313,83,230,4,54,2,2
59262,5228,3053,5228,allow,7054,2076,4978,32,5115,11,21
53825,58968,36842,58968,allow,70,70,0,1,4,1,0
51083,445,0,0,drop,66,66,0,1,0,1,0
64438,53,9645,53,allow,184,94,90,2,29,1,1
37965,61872,44512,61872,allow,1548,265,1283,4,1201,2,2
37802,80,16566,80,allow,1702,1388,314,10,16,5,5
54803,445,0,0,drop,70,70,0,1,0,1,0
63599,445,0,0,drop,66,66,0,1,0,1,0
52150,80,40663,80,allow,546,300,246,10,32,6,4
49324,443,63452,443,allow,6586,3686,2900,35,75,17,18
51182,445,0,0,drop,66,66,0,1,0,1,0
51904,51883,62551,51883,allow,70,70,0,2,8,2,0
61431,443,2753,443,allow,1401,940,461,11,28,7,4
50465,445,0,0,drop,70,70,0,1,0,1,0
58847,443,48579,443,allow,5167,700,4467,16,15,7,9
55364,53,12032,53,allow,168,86,82,2,30,1,1
51679,445,0,0,drop,70,70,0,1,0,1,0
37606,443,60055,443,allow,499,425,74,4,0,3,1
58119,445,0,0,drop,66,66,0,1,0,1,0
6881,6881,26676,6881,allow,238,118,120,2,1200,1,1
63765,51221,0,0,deny,62,62,0,1,0,1,0
53759,42873,0,0,deny,74,74,0,1,0,1,0
43095,443,16830,443,allow,3067,1817,1250,18,16,8,10
45932,53,57917,53,allow,199,94,105,2,30,1,1
49912,53,4964,53,allow,733,94,639,2,29,1,1
63905,445,0,0,drop,66,66,0,1,0,1,0
50407,80,54250,80,allow,1388,917,471,11,26,6,5
6881,6881,30399,6881,allow,238,118,120,2,1199,1,1
64217,53,31853,53,allow,193,102,91,2,29,1,1
55760,53,53617,53,allow,180,92,88,2,31,1,1
60097,22114,0,0,deny,66,66,0,1,0,1,0
16979,56205,0,0,deny,62,62,0,1,0,1,0
18086,25174,0,0,deny,62,62,0,1,0,1,0
63997,53,40711,53,allow,676,192,484,6,84,3,3
49001,48983,0,0,deny,161,161,0,1,0,1,0
53935,42874,31408,42874,allow,1973,1021,952,10,15,6,4
49717,57470,0,0,deny,62,62,0,1,0,1,0
37644,443,35046,443,allow,3886,2516,1370,22,95,12,10
53879,445,0,0,drop,66,66,0,1,0,1,0
64878,26467,0,0,deny,62,62,0,1,0,1,0
58004,443,48941,443,allow,13206,7781,5425,29,253,15,14
55308,443,11904,443,allow,14364,4095,10269,33,404,13,20
50583,53,37919,53,allow,819,102,717,2,30,1,1
58638,5900,0,0,deny,62,62,0,1,0,1,0
43111,443,29874,443,allow,3117,1867,1250,19,15,9,10
42820,443,51976,443,allow,25721,8999,16722,38,121,18,20
61435,443,45257,443,allow,1401,940,461,11,29,7,4
52024,445,0,0,drop,70,70,0,1,0,1,0
35094,53,9610,53,allow,371,94,277,2,30,1,1
54925,445,0,0,drop,70,70,0,1,0,1,0
59355,51505,0,0,deny,66,66,0,1,0,1,0
58072,445,0,0,drop,70,70,0,1,0,1,0
54483,25174,0,0,deny,66,66,0,1,0,1,0
37142,443,20503,443,allow,17201,10578,6623,57,145,27,30
64075,1026,16814,1026,allow,66,66,0,2,7,2,0
53029,443,57596,443,allow,9246,1808,7438,35,92,17,18
49910,53,38613,53,allow,218,94,124,2,30,1,1
53853,53,0,0,allow,139,70,69,2,30,1,1
56772,53,46490,53,allow,185,102,83,2,31,1,1
58638,5900,0,0,deny,62,62,0,1,0,1,0
10381,22114,0,0,deny,62,62,0,1,0,1,0
54996,53,2476,53,allow,168,86,82,2,31,1,1
62293,443,13135,443,allow,4755,1142,3613,15,273,8,7
65357,53,15221,53,allow,176,90,86,2,30,1,1
49884,443,34007,443,allow,5265,1647,3618,16,88,9,7
50561,53,34475,53,allow,763,102,661,2,30,1,1
64913,53,23262,53,allow,194,102,92,2,29,1,1
65398,53,64225,53,allow,214,110,104,2,30,1,1
50121,443,24047,443,allow,307104860,2750998,304353862,234597,6122,15017,219580
49837,53,44716,53,allow,734,86,648,2,30,1,1
57266,53,10699,53,allow,753,96,657,2,31,1,1
63852,35440,0,0,deny,66,66,0,1,0,1,0
65234,5228,52749,5228,allow,4149,2263,1886,46,708,23,23
60978,445,0,0,drop,70,70,0,1,0,1,0
54963,53,23635,53,allow,210,110,100,2,30,1,1
62394,80,62394,80,allow,29401,10036,19365,49,28,24,25
58751,9571,0,0,deny,62,62,0,1,0,1,0
23846,22114,0,0,deny,146,146,0,1,0,1,0
65110,53,31746,53,allow,406,142,264,2,30,1,1
55358,53,28706,53,allow,183,94,89,2,31,1,1
56771,53,12754,53,allow,261,94,167,2,30,1,1
5588,5588,0,0,allow,3562,1936,1626,48,192,24,24
64251,53,24532,53,allow,177,94,83,2,30,1,1
59984,445,0,0,drop,66,66,0,1,0,1,0
56435,80,7640,80,allow,17248,1619,15629,26,25,11,15
50594,80,12498,80,allow,1635,824,811,10,15,5,5
56924,53,57471,53,allow,177,94,83,2,30,1,1
42567,80,40138,80,allow,2161,1178,983,16,17,10,6
56656,53,3129,53,allow,255,88,167,4,53,2,2
57363,53,3624,53,allow,193,102,91,2,30,1,1
63347,445,0,0,drop,70,70,0,1,0,1,0
62080,443,19549,443,allow,2902,1562,1340,22,46,12,10
64071,53,28084,53,allow,424,104,320,4,31,2,2
57431,80,59179,80,allow,11357,5000,6357,22,30,11,11
55337,53,8346,53,allow,294,106,188,4,56,2,2
52732,443,31396,443,allow,27467,22472,4995,85,42,45,40
64576,53,63457,53,allow,194,102,92,2,31,1,1
59628,445,0,0,drop,70,70,0,1,0,1,0
56334,1433,0,0,deny,60,60,0,1,0,1,0
46360,443,51396,443,allow,1053,566,487,10,16,6,4
56043,445,0,0,drop,70,70,0,1,0,1,0
57057,53,25166,53,allow,194,102,92,2,30,1,1
53606,54476,23615,54476,allow,320,140,180,6,6,3,3
39058,443,50860,443,allow,70,70,0,1,5,1,0
60779,40010,64094,40010,allow,316,136,180,6,5,3,3
15774,56205,0,0,deny,66,66,0,1,0,1,0
49981,44847,0,0,deny,62,62,0,1,0,1,0
56186,53,36968,53,allow,198,102,96,2,30,1,1
51829,46209,24768,46209,allow,66,66,0,1,5,1,0
2267,53,42129,53,allow,204,118,86,2,31,1,1
45941,23386,0,0,deny,60,60,0,1,0,1,0
53490,445,0,0,drop,70,70,0,1,0,1,0
57990,445,0,0,drop,70,70,0,1,0,1,0
49227,445,0,0,drop,66,66,0,1,0,1,0
4545,1900,0,0,deny,136,136,0,1,0,1,0
64974,53,44237,53,allow,212,108,104,2,31,1,1
56846,443,26374,443,allow,9370,3805,5565,43,181,21,22
6881,7005,9518,7005,allow,118,118,0,1,1200,1,0
63145,445,0,0,drop,70,70,0,1,0,1,0
62189,64147,0,0,deny,62,62,0,1,0,1,0
60745,40010,27877,40010,allow,316,136,180,6,6,3,3
57842,53,57842,53,allow,225,87,138,2,30,1,1
60420,80,1065,80,allow,14498,6454,8044,24,120,12,12
50575,53,41966,53,allow,184,94,90,2,30,1,1
64152,53,18184,53,allow,232,110,122,2,30,1,1
50140,53,14261,53,allow,177,94,83,2,30,1,1
50695,80,60576,80,allow,58726,30286,28440,246,175,123,123
33380,48817,0,0,deny,146,146,0,1,0,1,0
53799,6881,35241,6881,allow,70,70,0,2,7,2,0
57326,443,3757,443,allow,64382,9305,55077,101,123,41,60
49872,53,36268,53,allow,331,126,205,2,30,1,1
44922,443,33552,443,allow,5578,764,4814,14,15,8,6
64064,29856,32936,29856,allow,66,66,0,1,5,1,0
50066,30188,0,0,deny,66,66,0,1,0,1,0
56529,53,10690,53,allow,378,94,284,2,30,1,1
60416,37965,0,0,deny,66,66,0,1,0,1,0
65388,53,55189,53,allow,764,99,665,2,31,1,1
52622,445,0,0,drop,70,70,0,1,0,1,0
48810,443,34983,443,allow,6478,2684,3794,18,122,8,10
1054,15503,0,0,deny,62,62,0,1,0,1,0
52016,58318,32216,58318,allow,70,70,0,2,9,2,0
55014,443,4277,443,allow,4962,1352,3610,19,135,9,10
51861,80,40570,80,allow,366,240,126,7,31,5,2
64417,53,47310,53,allow,369,94,275,4,49,2,2
64158,445,0,0,drop,70,70,0,1,0,1,0
56015,56205,0,0,deny,66,66,0,1,0,1,0
52850,443,50911,443,allow,4982,3414,1568,19,362,9,10
54887,443,19441,443,allow,4364,2141,2223,15,137,7,8
14023,37965,0,0,deny,62,62,0,1,0,1,0
49183,53,53469,53,allow,194,102,92,2,30,1,1
63029,445,0,0,drop,70,70,0,1,0,1,0
50502,123,1103,123,allow,184,94,90,2,30,1,1
65002,445,0,0,drop,66,66,0,1,0,1,0
64211,445,0,0,drop,70,70,0,1,0,1,0
49225,443,49225,443,allow,854266,56622,797644,969,98,420,549
29884,25174,0,0,deny,62,62,0,1,0,1,0
49236,443,49236,443,allow,554853,293345,261508,600,69,317,283
51214,443,63195,443,allow,7924,3247,4677,32,71,19,13
64467,53,16595,53,allow,184,94,90,2,31,1,1
29509,25174,0,0,deny,62,62,0,1,0,1,0
51188,64147,0,0,deny,62,62,0,1,0,1,0
64346,51505,0,0,deny,66,66,0,1,0,1,0
64831,53,42481,53,allow,216,110,106,2,30,1,1
62348,30349,0,0,deny,148,148,0,1,0,1,0
50397,445,0,0,drop,66,66,0,1,0,1,0
63943,445,0,0,drop,70,70,0,1,0,1,0
27005,27241,34573,27241,allow,885,126,759,2,30,1,1
52095,48896,12899,48896,allow,70,70,0,2,8,2,0
62002,445,0,0,drop,70,70,0,1,0,1,0
46569,443,56973,443,allow,6409,984,5425,21,360,11,10
53136,80,42745,80,allow,23974,12718,11256,37,36,19,18
56109,445,0,0,drop,70,70,0,1,0,1,0
54886,443,54886,443,allow,136775,6729,130046,181,18,82,99
64382,44847,0,0,deny,66,66,0,1,0,1,0
64157,53,49752,53,allow,370,126,244,2,30,1,1
52062,443,2872,443,allow,61141,52577,8564,102,363,50,52
58836,443,33212,443,allow,383990,15580,368410,490,212,192,298
65343,53,12113,53,allow,184,94,90,2,30,1,1
50700,80,35384,80,allow,142,142,0,1,4,1,0
55544,3389,55544,3389,allow,3657,1638,2019,20,18,11,9
63824,445,0,0,drop,70,70,0,1,0,1,0
6729,51505,0,0,deny,62,62,0,1,0,1,0
50529,44847,0,0,deny,66,66,0,1,0,1,0
64517,53,41007,53,allow,188,96,92,2,31,1,1
21294,21247,0,0,deny,146,146,0,1,0,1,0
57470,8100,10100,8100,allow,3281,894,2387,14,1200,7,7
52110,445,0,0,drop,70,70,0,1,0,1,0
16403,16384,8455,16384,allow,426,186,240,8,30,4,4
18091,32480,0,0,deny,66,66,0,1,0,1,0
56446,443,39205,443,allow,15813,5998,9815,30,120,14,16
52005,443,38700,443,allow,4802,866,3936,19,26,10,9
59377,443,61380,443,allow,43483,26315,17168,86,62,54,32
55246,31573,0,0,deny,62,62,0,1,0,1,0
65047,53,39231,53,allow,645,185,460,6,40,3,3
49271,53,54358,53,allow,186,102,84,2,30,1,1
8893,123,39834,123,allow,94,94,0,1,30,1,0
62230,443,57839,443,allow,3709,1176,2533,14,135,7,7
34239,80,12111,80,allow,1056,682,374,10,15,6,4
32609,64097,0,0,deny,66,66,0,1,0,1,0
53267,443,33925,443,allow,6156,2009,4147,26,18,14,12
63100,445,0,0,drop,70,70,0,1,0,1,0
43910,443,49945,443,allow,10506,2984,7522,30,15,17,13
17786,44847,0,0,deny,62,62,0,1,0,1,0
58791,25174,0,0,deny,62,62,0,1,0,1,0
49377,445,0,0,drop,70,70,0,1,0,1,0
63344,445,0,0,drop,70,70,0,1,0,1,0
46684,443,11949,443,allow,26724,2570,24154,52,42,26,26
29011,32468,0,0,deny,66,66,0,1,0,1,0
52572,80,52572,80,allow,1680,696,984,11,142,6,5
57013,445,0,0,drop,70,70,0,1,0,1,0
60474,445,0,0,drop,66,66,0,1,0,1,0
65379,22114,0,0,deny,62,62,0,1,0,1,0
61398,80,45091,80,allow,2425,529,1896,11,75,6,5
37564,443,37233,443,allow,1386,924,462,12,30,7,5
57199,445,0,0,drop,70,70,0,1,0,1,0
56320,53,53678,53,allow,183,94,89,2,30,1,1
54095,26467,0,0,deny,62,62,0,1,0,1,0
62273,50584,0,0,deny,66,66,0,1,0,1,0
54775,443,48406,443,allow,9501,1502,7999,24,29,13,11
53316,445,0,0,drop,70,70,0,1,0,1,0
23844,26467,0,0,deny,62,62,0,1,0,1,0
51414,22,0,0,deny,60,60,0,1,0,1,0
56661,53,1967,53,allow,900,110,790,2,30,1,1
57440,443,35509,443,allow,8200,2465,5735,30,18,14,16
29029,53,43871,53,allow,323,77,246,4,30,2,2
64116,53,6578,53,allow,267,94,173,4,59,2,2
32486,443,32486,443,allow,5497,2520,2977,20,16,11,9
56733,53,1965,53,allow,177,94,83,2,30,1,1
50928,80,36754,80,allow,875,518,357,10,75,6,4
8907,443,50464,443,allow,7594,1457,6137,26,404,10,16
50584,6881,29773,6881,allow,502,150,352,2,1200,1,1
49585,445,0,0,drop,66,66,0,1,0,1,0
60795,443,29587,443,allow,3282,1018,2264,10,121,5,5
60861,25174,0,0,deny,66,66,0,1,0,1,0
54742,37965,0,0,deny,66,66,0,1,0,1,0
27005,32073,35249,32073,allow,884,126,758,2,31,1,1
45908,33330,0,0,deny,60,60,0,1,0,1,0
65228,53,51061,53,allow,267,93,174,4,46,2,2
50154,445,0,0,drop,70,70,0,1,0,1,0
65114,53,42555,53,allow,380,86,294,2,30,1,1
53828,51354,7216,51354,allow,70,70,0,2,8,2,0
51324,465,51324,465,allow,320,128,192,6,5,3,3
49206,443,6191,443,allow,15982,9199,6783,95,160,40,55
58030,445,0,0,drop,70,70,0,1,0,1,0
55929,445,0,0,drop,70,70,0,1,0,1,0
58701,445,0,0,drop,70,70,0,1,0,1,0
59769,445,0,0,drop,70,70,0,1,0,1,0
49228,443,55799,443,allow,842887,22143,820744,866,19,314,552
52368,445,0,0,drop,70,70,0,1,0,1,0
65320,445,0,0,drop,66,66,0,1,0,1,0
49258,53,9142,53,allow,228,102,126,2,30,1,1
6881,59353,0,0,deny,146,146,0,1,0,1,0
50162,445,0,0,drop,66,66,0,1,0,1,0
50687,445,0,0,drop,70,70,0,1,0,1,0
39477,443,24151,443,allow,3655,2308,1347,18,15,10,8
38115,443,13490,443,allow,281978,16098,265880,405,67,204,201
63873,44847,0,0,deny,66,66,0,1,0,1,0
53790,21011,61681,21011,allow,70,70,0,2,8,2,0
56855,445,0,0,drop,66,66,0,1,0,1,0
65396,53,32966,53,allow,178,94,84,2,30,1,1
59193,445,0,0,drop,70,70,0,1,0,1,0
1027,57866,0,0,deny,62,62,0,1,0,1,0
57322,443,7352,443,allow,8237,2784,5453,35,16,21,14
60443,443,1656,443,allow,10961,4286,6675,53,320,21,32
63860,445,0,0,drop,66,66,0,1,0,1,0
42488,53,42488,53,allow,235,90,145,2,32,1,1
50547,443,55787,443,allow,5895,1068,4827,22,149,12,10
59470,53,45081,53,allow,184,86,98,2,29,1,1
54986,53,42487,53,allow,214,110,104,2,30,1,1
54575,11392,0,0,deny,66,66,0,1,0,1,0
64126,53,37940,53,allow,216,102,114,2,30,1,1
64701,53,54317,53,allow,195,94,101,2,30,1,1
57907,53,57907,53,allow,228,97,131,2,31,1,1
64768,53,30558,53,allow,394,102,292,2,29,1,1
14422,443,38791,443,allow,1857,1218,639,18,95,11,7
49418,4444,6124,4444,allow,238,78,160,2,31,1,1
64255,53,2166,53,allow,332,102,230,2,30,1,1
50851,80,30396,80,allow,1123758,19319,1104439,1037,133,278,759
52914,37965,0,0,deny,66,66,0,1,0,1,0
55809,53,62877,53,allow,731,85,646,2,31,1,1
58638,5900,0,0,deny,62,62,0,1,0,1,0
51046,53,51046,53,allow,244,106,138,2,30,1,1
58975,445,0,0,drop,70,70,0,1,0,1,0
63108,445,0,0,drop,70,70,0,1,0,1,0
58638,5900,0,0,deny,62,62,0,1,0,1,0
64790,53,30667,53,allow,182,93,89,2,30,1,1
49707,443,44929,443,allow,593578,18531,575047,531,210,128,403
58924,443,13598,443,allow,7783,2690,5093,24,255,13,11
60076,445,0,0,drop,70,70,0,1,0,1,0
57082,53,9901,53,allow,239,94,145,2,30,1,1
56993,445,0,0,drop,70,70,0,1,0,1,0
49295,53,11197,53,allow,280,96,184,4,36,2,2
49364,53,20144,53,allow,183,94,89,2,30,1,1
62595,445,0,0,drop,70,70,0,1,0,1,0
65143,53,18193,53,allow,184,94,90,2,30,1,1
56484,80,16261,80,allow,97842,4441,93401,109,135,41,68
64162,445,0,0,drop,70,70,0,1,0,1,0
55565,64147,0,0,deny,66,66,0,1,0,1,0
44943,443,56912,443,allow,16225,2078,14147,38,42,19,19
49230,445,0,0,drop,70,70,0,1,0,1,0
52071,443,56996,443,allow,8232,3997,4235,21,16,11,10
41886,53,43611,53,allow,168,78,90,2,30,1,1
59756,445,0,0,drop,70,70,0,1,0,1,0
56467,80,52250,80,allow,22601,1621,20980,35,142,18,17
49583,443,53752,443,allow,10877,2925,7952,56,285,23,33
54990,445,0,0,drop,70,70,0,1,0,1,0
16490,25174,0,0,deny,66,66,0,1,0,1,0
50995,445,0,0,drop,70,70,0,1,0,1,0
57258,53,4190,53,allow,177,94,83,2,29,1,1
58182,445,0,0,drop,66,66,0,1,0,1,0
45952,22114,0,0,deny,62,62,0,1,0,1,0
443,44683,0,0,deny,83,83,0,1,0,1,0
53829,53,12567,53,allow,258,86,172,2,31,1,1
58895,443,55555,443,allow,148,82,66,2,10,1,1
50344,80,51584,80,allow,3132,730,2402,13,42,7,6
57071,53,47529,53,allow,274,110,164,2,31,1,1
50584,1191,3170,1191,allow,161,161,0,2,1200,2,0
40905,443,30832,443,allow,6982,1535,5447,30,26,15,15
3410,17372,0,0,deny,62,62,0,1,0,1,0
62678,57470,0,0,deny,62,62,0,1,0,1,0
59509,64147,0,0,deny,62,62,0,1,0,1,0
63261,445,0,0,drop,70,70,0,1,0,1,0
56063,53,29074,53,allow,196,102,94,2,31,1,1
52643,15941,0,0,deny,66,66,0,1,0,1,0
51403,443,50805,443,allow,190,70,120,4,8,2,2
58095,80,30247,80,allow,4468,1145,3323,15,16,9,6
13559,57866,0,0,deny,66,66,0,1,0,1,0
59400,22114,0,0,deny,62,62,0,1,0,1,0
56847,53,58381,53,allow,252,102,150,2,30,1,1
50113,51505,0,0,deny,62,62,0,1,0,1,0
58836,443,51260,443,allow,12230,8144,4086,33,17,18,15
56430,53,61403,53,allow,193,102,91,2,30,1,1
6712,44818,0,0,deny,66,66,0,1,0,1,0
16387,3655,0,0,deny,60,60,0,1,0,1,0
59965,80,33685,80,allow,1638,1324,314,10,15,5,5
2990,64147,0,0,deny,62,62,0,1,0,1,0
64218,53,41220,53,allow,212,94,118,2,30,1,1
36003,443,8954,443,allow,70007,4677,65330,92,172,36,56
62252,445,0,0,drop,70,70,0,1,0,1,0
49889,53,36232,53,allow,197,102,95,2,29,1,1
53831,443,42938,443,allow,190,70,120,4,15,2,2
64874,53,28911,53,allow,808,110,698,2,30,1,1
32707,11392,0,0,deny,62,62,0,1,0,1,0
57171,53,25491,53,allow,214,102,112,2,30,1,1
48706,23393,0,0,deny,60,60,0,1,0,1,0
39195,25174,0,0,deny,62,62,0,1,0,1,0
56389,53,40774,53,allow,279,93,186,4,32,2,2
56817,53,9899,53,allow,772,103,669,2,30,1,1
55421,53,63396,53,allow,168,78,90,2,30,1,1
51491,445,0,0,drop,70,70,0,1,0,1,0
65073,445,0,0,drop,70,70,0,1,0,1,0
21268,62609,0,0,deny,146,146,0,1,0,1,0
50914,443,19872,443,allow,8058,1136,6922,19,129,9,10
52076,443,51633,443,allow,24299,8382,15917,69,93,35,34
40204,40029,46066,40029,allow,148,86,62,2,30,1,1
53363,445,0,0,drop,70,70,0,1,0,1,0
61594,445,0,0,drop,66,66,0,1,0,1,0
52666,445,0,0,drop,66,66,0,1,0,1,0
50675,56205,0,0,deny,66,66,0,1,0,1,0
65144,53,32702,53,allow,653,86,567,4,46,2,2
56722,443,4374,443,allow,7941,1952,5989,20,15,11,9
54994,443,29516,443,allow,13580,3864,9716,40,18,23,17
22981,15503,0,0,deny,62,62,0,1,0,1,0
42597,443,16661,443,allow,8533,2023,6510,23,15,12,11
45525,53,45525,53,allow,469,165,304,4,30,2,2
62339,443,17791,443,allow,9125,2616,6509,30,76,14,16
55660,53,31252,53,allow,177,94,83,2,30,1,1
50022,53,60834,53,allow,174,89,85,2,31,1,1
50784,50584,0,0,deny,146,146,0,1,0,1,0
63285,445,0,0,drop,66,66,0,1,0,1,0
11716,37965,0,0,deny,62,62,0,1,0,1,0
8889,2917,0,0,deny,60,60,0,1,0,1,0
48817,30201,48817,30201,allow,469,150,319,2,1200,1,1
51540,445,0,0,drop,70,70,0,1,0,1,0
49713,445,0,0,drop,66,66,0,1,0,1,0
23969,57470,0,0,deny,62,62,0,1,0,1,0
9245,80,28513,80,allow,378,192,186,7,26,4,3
37627,443,10583,443,allow,70,70,0,2,5,2,0
56111,53,56414,53,allow,152,78,74,2,30,1,1
52340,64147,0,0,deny,66,66,0,1,0,1,0
1024,44847,0,0,deny,62,62,0,1,0,1,0
58649,445,0,0,drop,70,70,0,1,0,1,0
60111,443,2026,443,allow,11519,3163,8356,51,25,26,25
52035,36498,46508,36498,allow,70,70,0,2,9,2,0
51053,80,62409,80,allow,1638,1324,314,10,14,5,5
60786,3389,60786,3389,allow,4226,2201,2025,19,18,10,9
49281,443,26289,443,allow,7655,2377,5278,20,135,11,9
28000,443,52315,443,allow,5746,1271,4475,25,105,12,13
41937,53,0,0,allow,82,82,0,1,31,1,0
62749,53,25858,53,allow,184,86,98,2,30,1,1
55049,443,10286,443,allow,12851,3808,9043,30,61,16,14
62081,445,0,0,drop,70,70,0,1,0,1,0
53073,32468,0,0,deny,62,62,0,1,0,1,0
50431,80,44826,80,allow,318,192,126,6,27,4,2
55408,64147,0,0,deny,66,66,0,1,0,1,0
49473,53,57880,53,allow,290,118,172,2,30,1,1
62409,445,0,0,drop,66,66,0,1,0,1,0
55872,445,0,0,drop,66,66,0,1,0,1,0
55058,53,37390,53,allow,216,110,106,2,30,1,1
28221,37965,0,0,deny,62,62,0,1,0,1,0
52041,48103,36252,48103,allow,70,70,0,2,8,2,0
37639,53,37639,53,allow,245,106,139,2,29,1,1
57252,53,37679,53,allow,183,94,89,2,30,1,1
49749,53,47748,53,allow,200,102,98,2,30,1,1
48936,443,24863,443,allow,494,280,214,8,49,5,3
57877,443,6198,443,allow,9256443,112898,9143545,7609,178,1428,6181
56335,53,31703,53,allow,260,102,158,2,30,1,1
57025,445,0,0,drop,66,66,0,1,0,1,0
64795,445,0,0,drop,70,70,0,1,0,1,0
55932,53,22197,53,allow,209,110,99,2,30,1,1
50333,445,0,0,drop,70,70,0,1,0,1,0
58853,443,38782,443,allow,59754,9493,50261,131,367,68,63
64950,53,8334,53,allow,186,95,91,2,31,1,1
5588,5588,0,0,allow,3562,1936,1626,48,193,24,24
64214,445,0,0,drop,66,66,0,1,0,1,0
50596,445,0,0,drop,66,66,0,1,0,1,0
33720,995,0,0,deny,60,60,0,1,0,1,0
27005,37579,27251,37579,allow,886,126,760,2,31,1,1
38858,443,38858,443,allow,226465,10306,216159,292,104,135,157
64633,53,20577,53,allow,255,102,153,2,30,1,1
49767,53,43872,53,allow,200,102,98,2,31,1,1
63928,445,0,0,drop,70,70,0,1,0,1,0
50601,445,0,0,drop,66,66,0,1,0,1,0
49272,445,0,0,drop,66,66,0,1,0,1,0
51979,80,40174,80,allow,366,240,126,7,25,5,2
19068,37965,0,0,deny,62,62,0,1,0,1,0
10016,443,37717,443,allow,6575,1263,5312,22,315,12,10
15266,55783,0,0,deny,145,145,0,1,0,1,0
11056,6881,0,0,deny,62,62,0,1,0,1,0
64097,445,0,0,drop,66,66,0,1,0,1,0
56872,21247,0,0,deny,74,74,0,1,0,1,0
61696,445,0,0,drop,70,70,0,1,0,1,0
52474,445,0,0,drop,66,66,0,1,0,1,0
443,62732,0,0,deny,332,332,0,1,0,1,0
50584,6881,12157,6881,allow,166,166,0,1,1200,1,0
55695,53,46724,53,allow,209,102,107,2,30,1,1
46845,443,36578,443,allow,5506,878,4628,16,26,9,7
65437,53,4286,53,allow,165,86,79,2,30,1,1
38852,37965,0,0,deny,62,62,0,1,0,1,0
56055,53,24959,53,allow,168,86,82,2,30,1,1
54210,64097,0,0,deny,66,66,0,1,0,1,0
49422,53,52820,53,allow,719,208,511,6,32,3,3
64240,50584,0,0,deny,66,66,0,1,0,1,0
56673,53,29686,53,allow,193,102,91,2,30,1,1
50739,445,0,0,drop,66,66,0,1,0,1,0
50748,445,0,0,drop,66,66,0,1,0,1,0
63978,63776,45573,63776,allow,66,66,0,2,8,2,0
64873,53,26833,53,allow,380,110,270,2,30,1,1
50013,53,8187,53,allow,199,102,97,2,30,1,1
53656,58624,15076,58624,allow,70,70,0,2,8,2,0
33563,14037,0,0,deny,78,78,0,1,0,1,0
51767,59158,21535,59158,allow,70,70,0,2,8,2,0
8297,37965,0,0,deny,62,62,0,1,0,1,0
56835,53,60962,53,allow,177,94,83,2,29,1,1
60256,80,21007,80,allow,3401,2157,1244,12,149,7,5
49183,53,29477,53,allow,209,110,99,2,30,1,1
27144,25174,0,0,deny,66,66,0,1,0,1,0
55260,53,54111,53,allow,183,94,89,2,30,1,1
52978,445,0,0,drop,70,70,0,1,0,1,0
56113,443,21683,443,allow,103486,7416,96070,161,42,82,79
50277,445,0,0,drop,70,70,0,1,0,1,0
55939,445,0,0,drop,66,66,0,1,0,1,0
57235,53,60743,53,allow,757,102,655,2,29,1,1
57504,44847,0,0,deny,66,66,0,1,0,1,0
63755,17866,46456,17866,allow,2568,1944,624,20,29,13,7
57058,53,2739,53,allow,167,86,81,2,31,1,1
59500,445,0,0,drop,70,70,0,1,0,1,0
57052,53,26525,53,allow,177,94,83,2,30,1,1
52645,6881,55258,6881,allow,841,535,306,10,14,5,5
52238,26467,0,0,deny,62,62,0,1,0,1,0
4910,2149,0,0,deny,66,66,0,1,0,1,0
55946,53,3113,53,allow,762,98,664,2,31,1,1
60960,49049,0,0,deny,66,66,0,1,0,1,0
57365,53,10039,53,allow,780,104,676,2,31,1,1
58568,53,2690,53,allow,294,86,208,2,30,1,1
52824,443,27899,443,allow,4114,2920,1194,19,80,11,8
58715,57470,0,0,deny,66,66,0,1,0,1,0
55673,445,0,0,drop,66,66,0,1,0,1,0
17750,27517,53975,27517,allow,491,150,341,2,1200,1,1
65487,445,0,0,drop,70,70,0,1,0,1,0
54147,443,52345,443,allow,3334,331,3003,10,120,5,5
33087,53,33087,53,allow,228,97,131,2,31,1,1
56580,443,55118,443,allow,2343,1296,1047,17,196,10,7
50456,80,33099,80,allow,4473,3398,1075,14,34,8,6
36690,443,36517,443,allow,1520,1058,462,12,29,8,4
5223,44091,0,0,deny,220,220,0,1,0,1,0
39795,5900,0,0,deny,60,60,0,1,0,1,0
64912,53,24794,53,allow,183,94,89,2,30,1,1
60452,62582,61377,62582,allow,70,70,0,2,8,2,0
51401,443,9077,443,allow,130,70,60,2,4,1,1
49878,53,64175,53,allow,327,102,225,2,30,1,1
50265,55637,31401,55637,allow,528,528,0,9,1200,9,0
50354,443,37764,443,allow,71226,18632,52594,137,318,63,74
26884,57866,0,0,deny,74,74,0,1,0,1,0
49558,53,42255,53,allow,350,93,257,4,42,2,2
35555,53,35555,53,allow,194,87,107,2,30,1,1
49908,443,25535,443,allow,4712,908,3804,18,75,9,9
53036,80,53036,80,allow,2954,720,2234,13,143,6,7
58438,53,46803,53,allow,246,102,144,2,29,1,1
64762,53,32990,53,allow,188,96,92,2,30,1,1
65026,53,1071,53,allow,194,102,92,2,30,1,1
56655,445,0,0,drop,70,70,0,1,0,1,0
57320,443,20383,443,allow,5989,926,5063,19,14,10,9
56761,34725,47498,34725,allow,70,70,0,1,5,1,0
56622,443,50835,443,allow,8302,3583,4719,24,17,14,10
26235,37965,0,0,deny,66,66,0,1,0,1,0
65460,53,42143,53,allow,194,99,95,2,31,1,1
59093,445,0,0,drop,70,70,0,1,0,1,0
49564,53,46836,53,allow,186,95,91,2,31,1,1
45410,1,0,0,deny,62,62,0,1,0,1,0
55563,53,42353,53,allow,177,94,83,2,30,1,1
50047,443,14680,443,allow,4612,947,3665,18,85,10,8
60487,1134,57270,1134,allow,70,70,0,1,5,1,0
57249,443,12847,443,allow,7965,2643,5322,42,15,24,18
58848,24855,0,0,allow,66,66,0,1,90,1,0
3883,50265,0,0,deny,66,66,0,1,0,1,0
58185,445,0,0,drop,70,70,0,1,0,1,0
49959,443,21643,443,allow,102240,4349,97891,128,136,46,82
58215,445,0,0,drop,70,70,0,1,0,1,0
37610,443,1253,443,allow,499,425,74,4,0,3,1
13528,51221,0,0,deny,62,62,0,1,0,1,0
45319,443,29767,443,allow,9284,2430,6854,25,82,14,11
52190,443,60064,443,allow,570322,21029,549293,569,46,181,388
43129,20220,0,0,deny,62,62,0,1,0,1,0
35012,80,6218,80,allow,1295,572,723,12,15,7,5
64903,51050,0,0,deny,62,62,0,1,0,1,0
49432,53,56971,53,allow,170,87,83,2,31,1,1
60337,30188,0,0,deny,66,66,0,1,0,1,0
59530,445,0,0,drop,66,66,0,1,0,1,0
49209,52030,14863,52030,allow,66,66,0,1,5,1,0
33968,443,15691,443,allow,10073,4379,5694,33,42,17,16
45941,23388,0,0,deny,60,60,0,1,0,1,0
52990,445,0,0,drop,70,70,0,1,0,1,0
1694,30188,0,0,deny,62,62,0,1,0,1,0
47969,443,44705,443,allow,10825,4667,6158,25,159,15,10
55318,445,0,0,drop,70,70,0,1,0,1,0
51142,443,51142,443,allow,261206,9686,251520,308,128,121,187
27322,443,7841,443,allow,5235,1839,3396,22,48,10,12
38914,80,38914,80,allow,2993,1469,1524,13,20,8,5
46899,443,24525,443,allow,70,70,0,1,5,1,0
51196,53,0,0,allow,206,83,123,2,0,1,1
49632,53,26153,53,allow,199,102,97,2,30,1,1
4257,35440,0,0,deny,62,62,0,1,0,1,0
55319,445,0,0,drop,70,70,0,1,0,1,0
1026,30188,0,0,deny,62,62,0,1,0,1,0
49767,53,2563,53,allow,177,94,83,2,30,1,1
55232,53,52840,53,allow,177,94,83,2,30,1,1
21145,11392,0,0,deny,62,62,0,1,0,1,0
3478,61463,0,0,deny,164,164,0,1,0,1,0
7222,57470,0,0,deny,62,62,0,1,0,1,0
41336,443,51571,443,allow,350,210,140,6,30,4,2
36262,443,11222,443,allow,678861,22499,656362,749,19,290,459
52519,44847,0,0,deny,62,62,0,1,0,1,0
50642,53,60676,53,allow,173,94,79,2,30,1,1
57419,53,1217,53,allow,819,102,717,2,30,1,1
26385,53,26385,53,allow,235,90,145,2,33,1,1
49450,443,10791,443,allow,5792,1511,4281,19,77,11,8
64016,25174,0,0,deny,62,62,0,1,0,1,0
37597,50584,0,0,deny,66,66,0,1,0,1,0
55688,445,0,0,drop,70,70,0,1,0,1,0
51485,445,0,0,drop,70,70,0,1,0,1,0
56618,443,31063,443,allow,3096,1882,1214,19,16,10,9
56621,80,4891,80,allow,234,234,0,4,12,4,0
64308,445,0,0,drop,70,70,0,1,0,1,0
57478,445,0,0,drop,70,70,0,1,0,1,0
50693,80,54649,80,allow,4465,3390,1075,14,30,8,6
56704,53,49275,53,allow,177,94,83,2,31,1,1
65367,53,6408,53,allow,251,94,157,2,30,1,1
64660,445,0,0,drop,66,66,0,1,0,1,0
49683,80,8217,80,allow,1548,847,701,10,15,5,5
51221,64509,12506,64509,allow,3564,3564,0,55,4073,55,0
58777,443,42281,443,allow,2577,1550,1027,15,16,7,8
49385,53,7961,53,allow,214,102,112,2,30,1,1
61072,445,0,0,drop,70,70,0,1,0,1,0
63957,445,0,0,drop,70,70,0,1,0,1,0
50298,445,0,0,drop,70,70,0,1,0,1,0
64341,57470,0,0,deny,62,62,0,1,0,1,0
58022,8010,0,0,deny,60,60,0,1,0,1,0
53033,445,0,0,drop,66,66,0,1,0,1,0
46362,35440,0,0,deny,66,66,0,1,0,1,0
56464,53,56163,53,allow,177,94,83,2,30,1,1
57424,53,59355,53,allow,197,102,95,2,29,1,1
11775,25174,0,0,deny,62,62,0,1,0,1,0
62728,445,0,0,drop,70,70,0,1,0,1,0
59523,37965,0,0,deny,62,62,0,1,0,1,0
50465,80,35475,80,allow,8499,2011,6488,17,21,8,9
55021,53,50748,53,allow,179,94,85,2,30,1,1
51834,30309,65352,30309,allow,70,70,0,2,7,2,0
16387,35583,0,0,deny,60,60,0,1,0,1,0
52607,80,12616,80,allow,2543,691,1852,13,30,8,5
56896,445,0,0,drop,66,66,0,1,0,1,0
55604,53,44456,53,allow,758,93,665,2,31,1,1
25833,53,31276,53,allow,404,261,143,3,30,2,1
58322,53,41674,53,allow,352,78,274,2,30,1,1
61522,445,0,0,drop,66,66,0,1,0,1,0
57058,445,0,0,drop,70,70,0,1,0,1,0
49212,80,10274,80,allow,912,410,502,10,15,5,5
49894,443,19598,443,allow,7418,2721,4697,23,20,12,11
65516,53,20089,53,allow,506,204,302,6,57,3,3
64336,445,0,0,drop,70,70,0,1,0,1,0
51732,50934,0,0,deny,146,146,0,1,0,1,0
51312,445,0,0,drop,66,66,0,1,0,1,0
29719,22114,0,0,deny,146,146,0,1,0,1,0
40464,80,50769,80,allow,15535,2173,13362,30,21,17,13
9418,443,37541,443,allow,5691,503,5188,14,15,7,7
56497,443,18628,443,allow,1343,763,580,14,26,8,6
52376,443,24814,443,allow,33906,25094,8812,63,447,36,27
3478,61463,0,0,deny,893,893,0,1,0,1,0
60750,42707,0,0,deny,62,62,0,1,0,1,0
42568,443,34410,443,allow,8049,2043,6006,23,360,11,12
53640,25174,0,0,deny,66,66,0,1,0,1,0
49900,443,9178,443,allow,6300,2644,3656,16,121,8,8
52626,445,0,0,drop,70,70,0,1,0,1,0
50146,445,0,0,drop,66,66,0,1,0,1,0
62617,445,0,0,drop,70,70,0,1,0,1,0
42298,40009,62202,40009,allow,148,86,62,2,30,1,1
58638,5900,0,0,deny,62,62,0,1,0,1,0
26729,57470,0,0,deny,66,66,0,1,0,1,0
43611,50939,0,0,deny,145,145,0,1,0,1,0
54086,443,46250,443,allow,4982,2205,2777,46,61,24,22
65149,443,54688,443,allow,2963,1304,1659,28,120,14,14
45941,23388,0,0,deny,60,60,0,1,0,1,0
38716,443,32682,443,allow,90273,3481,86792,96,15,31,65
33043,443,21466,443,allow,11414,6355,5059,30,40,15,15
443,32698,0,0,deny,89,89,0,1,0,1,0
8889,33698,0,0,deny,60,60,0,1,0,1,0
56304,53,62384,53,allow,443,182,261,6,31,3,3
64374,53,45440,53,allow,239,102,137,2,30,1,1
56369,53,59261,53,allow,193,102,91,2,29,1,1
65319,53,28841,53,allow,285,103,182,4,43,2,2
60139,53,31222,53,allow,218,78,140,2,30,1,1
49855,36180,0,0,deny,62,62,0,1,0,1,0
3478,61463,0,0,deny,159,159,0,1,0,1,0
58279,53,58279,53,allow,847,110,737,2,31,1,1
54285,445,0,0,drop,66,66,0,1,0,1,0
59335,445,0,0,drop,66,66,0,1,0,1,0
58638,5900,0,0,deny,62,62,0,1,0,1,0
49491,443,28351,443,allow,1627,884,743,12,27,6,6
49251,443,56131,443,allow,15567,1944,13623,40,81,17,23
16948,990,0,0,deny,60,60,0,1,0,1,0
54210,445,0,0,drop,70,70,0,1,0,1,0
51984,80,5183,80,allow,48285,2659,45626,65,15,32,33
51588,80,26710,80,allow,2016,1050,966,21,300,11,10
56224,445,0,0,drop,70,70,0,1,0,1,0
61111,445,0,0,drop,70,70,0,1,0,1,0
63464,443,28849,443,allow,3120,976,2144,13,135,6,7
19642,23,0,0,deny,60,60,0,1,0,1,0
50711,443,57174,443,allow,7240,2265,4975,24,351,13,11
52936,5228,12223,5228,allow,9201,2130,7071,41,5528,21,20
10306,44847,0,0,deny,62,62,0,1,0,1,0
49677,64147,0,0,deny,62,62,0,1,0,1,0
62953,445,0,0,drop,66,66,0,1,0,1,0
57782,57470,0,0,deny,66,66,0,1,0,1,0
48157,443,51436,443,allow,7209,2331,4878,20,23,11,9
50612,445,0,0,drop,70,70,0,1,0,1,0
56391,53,63935,53,allow,758,93,665,2,31,1,1
53656,31573,0,0,deny,62,62,0,1,0,1,0
38646,443,44799,443,allow,2335,1247,1088,15,28,8,7
55222,445,0,0,drop,66,66,0,1,0,1,0
55689,37965,0,0,deny,66,66,0,1,0,1,0
64712,53,32542,53,allow,181,98,83,2,31,1,1
50308,445,0,0,drop,70,70,0,1,0,1,0
44674,25174,0,0,deny,146,146,0,1,0,1,0
58040,445,0,0,drop,70,70,0,1,0,1,0
57574,443,57574,443,allow,164451,18310,146141,163,175,52,111
21133,63622,33830,63622,allow,150,150,0,1,1199,1,0
62552,445,0,0,drop,70,70,0,1,0,1,0
62725,51221,0,0,deny,66,66,0,1,0,1,0
53159,443,33030,443,allow,9711,3950,5761,38,28,22,16
56377,445,0,0,drop,66,66,0,1,0,1,0
57543,445,0,0,drop,70,70,0,1,0,1,0
54180,445,0,0,drop,70,70,0,1,0,1,0
64983,53,5979,53,allow,181,94,87,2,30,1,1
55845,443,55416,443,allow,505207,16025,489182,464,139,97,367
9698,53,9698,53,allow,197,90,107,2,30,1,1
62976,445,0,0,drop,70,70,0,1,0,1,0
58293,443,58293,443,allow,7134,2478,4656,18,75,10,8
57460,445,0,0,drop,66,66,0,1,0,1,0
49227,53,61588,53,allow,179,94,85,2,30,1,1
61430,37965,0,0,deny,66,66,0,1,0,1,0
57396,443,55887,443,allow,1054,567,487,10,24,6,4
65445,80,60875,80,allow,1279,714,565,11,19,6,5
49817,53,29101,53,allow,401,91,310,4,29,2,2
6881,6881,5588,6881,allow,324,150,174,2,1203,1,1
57612,28793,0,0,deny,66,66,0,1,0,1,0
50733,445,0,0,drop,66,66,0,1,0,1,0
51829,445,0,0,drop,66,66,0,1,0,1,0
1027,11392,0,0,deny,62,62,0,1,0,1,0
35051,53,35051,53,allow,194,87,107,2,31,1,1
50067,445,0,0,drop,70,70,0,1,0,1,0
2636,11392,0,0,deny,66,66,0,1,0,1,0
58445,445,0,0,drop,66,66,0,1,0,1,0
64097,443,64097,443,allow,13511,6811,6700,43,159,23,20
26400,44847,0,0,deny,146,146,0,1,0,1,0
56604,443,5643,443,allow,7915,1926,5989,20,15,11,9
51868,30305,17475,30305,allow,70,70,0,1,5,1,0
34212,11392,0,0,deny,62,62,0,1,0,1,0
64537,53,63183,53,allow,718,94,624,2,30,1,1
443,4205,0,0,deny,187,187,0,1,0,1,0
34811,56205,0,0,deny,66,66,0,1,0,1,0
62299,53,62299,53,allow,259,108,151,2,31,1,1
61845,11392,0,0,deny,66,66,0,1,0,1,0
51645,80,57006,80,allow,318,192,126,6,38,4,2
65505,443,12963,443,allow,458741,13270,445471,469,16,164,305
49834,443,52390,443,allow,8332,3418,4914,31,95,17,14
56629,443,11922,443,allow,23887293,546911,23340382,23137,108,7700,15437
45648,80,30446,80,allow,130,70,60,2,15,1,1
37905,443,37905,443,allow,4707,1800,2907,19,26,11,8
63547,37965,0,0,deny,66,66,0,1,0,1,0
65493,443,45559,443,allow,438968,12780,426188,449,16,157,292
6666,2222,0,0,deny,60,60,0,1,0,1,0
55238,53,7598,53,allow,168,86,82,2,31,1,1
56356,53,26889,53,allow,277,118,159,2,30,1,1
41739,53,41739,53,allow,235,90,145,2,32,1,1
30598,46824,0,0,deny,62,62,0,1,0,1,0
49646,53,5301,53,allow,199,102,97,2,30,1,1
57470,38871,35688,38871,allow,545,166,379,2,1199,1,1
53278,443,20618,443,allow,12634,1635,10999,26,322,11,15
43214,443,49896,443,allow,1563663,41030,1522633,1538,40,479,1059
53035,80,53035,80,allow,373926,8227,365699,379,143,130,249
55955,53,56880,53,allow,184,94,90,2,30,1,1
65487,53,62751,53,allow,204,104,100,2,31,1,1
50976,80,46012,80,allow,1094127,5977,1088150,812,35,88,724
59982,445,0,0,drop,70,70,0,1,0,1,0
56855,53,37174,53,allow,775,103,672,2,31,1,1
58627,64097,0,0,deny,62,62,0,1,0,1,0
49677,25174,0,0,deny,66,66,0,1,0,1,0
38083,443,10081,443,allow,2465,1356,1109,18,180,8,10
64026,53,2303,53,allow,244,94,150,2,31,1,1
39101,443,49967,443,allow,201217,15748,185469,327,207,163,164
37965,51413,49792,51413,allow,789,152,637,4,1199,2,2
56205,51505,0,0,deny,66,66,0,1,0,1,0
53672,445,0,0,drop,70,70,0,1,0,1,0
56157,50584,0,0,deny,66,66,0,1,0,1,0
51421,445,0,0,drop,70,70,0,1,0,1,0
50584,6881,16713,6881,allow,166,166,0,1,1200,1,0
50976,80,37762,80,allow,3030,1372,1658,13,21,8,5
63959,15922,28893,15922,allow,2136,1536,600,18,22,12,6
55614,445,0,0,drop,70,70,0,1,0,1,0
51412,443,11649,443,allow,8933,1958,6975,25,81,14,11
52921,443,13055,443,allow,5581,1388,4193,19,15,9,10
18173,25174,0,0,deny,62,62,0,1,0,1,0
60508,445,0,0,drop,70,70,0,1,0,1,0
37655,443,5274,443,allow,17842,11204,6638,43,174,24,19
49824,25174,0,0,deny,62,62,0,1,0,1,0
51096,63710,0,0,deny,66,66,0,1,0,1,0
56315,123,48493,123,allow,184,94,90,2,30,1,1
52018,80,20950,80,allow,1660,791,869,11,32,6,5
64068,53,47417,53,allow,168,86,82,2,31,1,1
49367,51505,0,0,deny,66,66,0,1,0,1,0
51590,445,0,0,drop,70,70,0,1,0,1,0
56604,445,0,0,drop,70,70,0,1,0,1,0
5790,43890,0,0,deny,62,62,0,1,0,1,0
17251,10387,0,0,deny,159,159,0,1,0,1,0
61963,6881,0,0,deny,146,146,0,1,0,1,0
27005,33055,54134,33055,allow,888,126,762,2,31,1,1
58282,53,59362,53,allow,215,102,113,2,30,1,1
52643,36237,0,0,deny,66,66,0,1,0,1,0
49302,443,8225,443,allow,3182,1568,1614,8,120,4,4
49666,80,13546,80,allow,7270,3119,4151,14,41,7,7
31780,11392,0,0,deny,62,62,0,1,0,1,0
50470,61463,0,0,deny,86,86,0,1,0,1,0
50721,443,49373,443,allow,5828,1439,4389,16,75,9,7
58638,5900,0,0,deny,62,62,0,1,0,1,0
3352,50584,0,0,deny,62,62,0,1,0,1,0
61225,445,0,0,drop,70,70,0,1,0,1,0
52158,80,31502,80,allow,502,310,192,9,31,6,3
50867,445,0,0,drop,70,70,0,1,0,1,0
13749,53,13749,53,allow,237,91,146,2,32,1,1
50635,445,0,0,drop,70,70,0,1,0,1,0
65354,53,6099,53,allow,168,86,82,2,31,1,1
57837,64147,0,0,deny,62,62,0,1,0,1,0
53464,443,61601,443,allow,6550,1555,4995,25,53,13,12
50148,53,50148,53,allow,198,90,108,2,29,1,1
57659,80,4317,80,allow,742,140,602,12,409,3,9
54827,445,0,0,drop,70,70,0,1,0,1,0
39948,5223,55367,5223,allow,5551,1338,4213,28,1323,11,17
56536,53,49265,53,allow,209,110,99,2,30,1,1
57069,443,33403,443,allow,15125,2482,12643,53,38,27,26
56047,443,45831,443,allow,126,60,66,3,4,2,1
61919,445,0,0,drop,70,70,0,1,0,1,0
35623,443,1828,443,allow,9685,2504,7181,26,153,11,15
42780,53,61676,53,allow,198,93,105,2,30,1,1
28435,23,0,0,deny,60,60,0,1,0,1,0
52912,443,9289,443,allow,41094,14929,26165,126,116,69,57
55932,53,3248,53,allow,209,110,99,2,30,1,1
52282,37965,0,0,deny,66,66,0,1,0,1,0
57187,53,15982,53,allow,782,105,677,2,30,1,1
9291,80,9291,80,allow,208056,7568,200488,227,39,88,139
62905,443,5789,443,allow,8426,2893,5533,27,16,15,12
56550,53,64220,53,allow,183,94,89,2,31,1,1
50116,22,50116,22,allow,146,60,86,2,9,1,1
20892,53,20892,53,allow,825,99,726,2,30,1,1
49548,443,37968,443,allow,1346,918,428,10,22,6,4
53139,50285,41730,50285,allow,320,140,180,6,6,3,3
64491,445,0,0,drop,66,66,0,1,0,1,0
50683,443,25335,443,allow,6414,1372,5042,19,171,9,10
49233,53,56407,53,allow,196,102,94,2,29,1,1
54679,445,0,0,drop,66,66,0,1,0,1,0
60739,40010,46673,40010,allow,316,136,180,6,6,3,3
53588,3389,53588,3389,allow,3489,1534,1955,17,16,9,8
48000,443,53560,443,allow,7193,1890,5303,22,37,15,7
26629,56079,0,0,deny,62,62,0,1,0,1,0
50375,443,20024,443,allow,4707,865,3842,17,30,9,8
39311,443,39728,443,allow,12825,8114,4711,63,269,25,38
57218,445,0,0,drop,70,70,0,1,0,1,0
48706,23393,0,0,deny,60,60,0,1,0,1,0
54760,445,0,0,drop,66,66,0,1,0,1,0
62375,445,0,0,drop,70,70,0,1,0,1,0
36314,443,44182,443,allow,6287,1476,4811,25,16,13,12
51975,11998,29831,11998,allow,66,66,0,1,5,1,0
23126,35440,0,0,deny,66,66,0,1,0,1,0
64251,53,54906,53,allow,451,118,333,2,30,1,1
47600,53,23679,53,allow,168,78,90,2,29,1,1
50783,445,0,0,drop,70,70,0,1,0,1,0
47534,443,60052,443,allow,291717,11752,279965,319,137,123,196
64095,1976,59947,1976,allow,66,66,0,2,8,2,0
8762,53,8762,53,allow,233,91,142,2,31,1,1
5222,48709,0,0,deny,66,66,0,1,0,1,0
52037,45647,32087,45647,allow,316,136,180,6,7,3,3
52275,80,52275,80,allow,210890,8286,202604,208,28,64,144
1847,64147,0,0,deny,66,66,0,1,0,1,0
58784,443,22318,443,allow,5168,700,4468,16,15,7,9
33415,53,42301,53,allow,164,78,86,2,29,1,1
42986,25174,0,0,deny,66,66,0,1,0,1,0
58478,443,30017,443,allow,19356,2148,17208,34,112,17,17
56152,53,35520,53,allow,195,102,93,2,29,1,1
53864,53,19118,53,allow,168,78,90,2,30,1,1
56577,53,39696,53,allow,182,94,88,2,30,1,1
45567,443,10380,443,allow,1473,988,485,12,25,7,5
25533,22114,0,0,deny,62,62,0,1,0,1,0
49310,445,0,0,drop,70,70,0,1,0,1,0
9969,2323,0,0,deny,60,60,0,1,0,1,0
25565,47158,0,0,deny,60,60,0,1,0,1,0
49990,445,0,0,drop,66,66,0,1,0,1,0
56712,53,4721,53,allow,448,184,264,6,29,3,3
55485,445,0,0,drop,70,70,0,1,0,1,0
443,49031,0,0,deny,74,74,0,1,0,1,0
25878,25174,0,0,deny,66,66,0,1,0,1,0
52024,25174,0,0,deny,66,66,0,1,0,1,0
59487,80,24242,80,allow,350,210,140,6,26,4,2
32966,53,20380,53,allow,199,94,105,2,30,1,1
65294,53,15570,53,allow,710,89,621,2,30,1,1
53579,59332,61782,59332,allow,70,70,0,1,5,1,0
32137,44512,0,0,deny,62,62,0,1,0,1,0
63696,445,0,0,drop,70,70,0,1,0,1,0
65153,53,31638,53,allow,184,86,98,2,29,1,1
42252,33303,0,0,deny,60,60,0,1,0,1,0
27005,27017,60411,27017,allow,1644,126,1518,4,30,2,2
55706,53,23729,53,allow,209,110,99,2,30,1,1
41501,80,33952,80,allow,306627,58973,247654,556,297,246,310
65199,53,63329,53,allow,793,207,586,6,59,3,3
64616,53,29802,53,allow,184,80,104,2,30,1,1
50455,445,0,0,drop,70,70,0,1,0,1,0
56520,53,53336,53,allow,177,94,83,2,31,1,1
63645,445,0,0,drop,66,66,0,1,0,1,0
58638,5900,58638,5900,allow,126,62,64,2,5,1,1
38910,53,21140,53,allow,198,93,105,2,31,1,1
51424,80,51424,80,allow,4995,3443,1552,23,26,13,10
50738,445,0,0,drop,70,70,0,1,0,1,0
44384,80,20153,80,allow,51651,48866,2785,74,19,38,36
63008,53,31909,53,allow,183,86,97,2,30,1,1
52124,11296,48870,11296,allow,66,66,0,1,5,1,0
10333,22114,0,0,deny,146,146,0,1,0,1,0
54693,30188,0,0,deny,66,66,0,1,0,1,0
51919,10298,22024,10298,allow,70,70,0,2,8,2,0
64494,445,0,0,drop,66,66,0,1,0,1,0
55721,53,4903,53,allow,212,94,118,2,30,1,1
27005,27015,17359,27015,allow,878,126,752,2,30,1,1
65348,53,40565,53,allow,177,94,83,2,30,1,1
57371,53,40591,53,allow,728,96,632,2,30,1,1
62073,443,32648,443,allow,9559,3243,6316,28,46,16,12
64990,55442,0,0,deny,66,66,0,1,0,1,0
56949,22,0,0,deny,60,60,0,1,0,1,0
54955,53,57414,53,allow,170,87,83,2,30,1,1
55714,53,64632,53,allow,173,94,79,2,30,1,1
49367,51505,0,0,deny,62,62,0,1,0,1,0
51958,443,6859,443,allow,9994,8270,1724,34,68,19,15
36237,23,0,0,deny,60,60,0,1,0,1,0
3478,61463,0,0,deny,1162,1162,0,1,0,1,0
61459,445,0,0,drop,70,70,0,1,0,1,0
50914,443,57800,443,allow,22211,8661,13550,173,854,77,96
65291,53,53725,53,allow,889,404,485,10,30,5,5
49656,443,43316,443,allow,19544,4428,15116,79,119,39,40
51197,57470,0,0,deny,66,66,0,1,0,1,0
52346,445,0,0,drop,66,66,0,1,0,1,0
54302,445,0,0,drop,70,70,0,1,0,1,0
55777,445,0,0,drop,70,70,0,1,0,1,0
9104,443,36522,443,allow,6240,1399,4841,24,44,12,12
80,37649,0,0,deny,60,60,0,1,0,1,0
51444,443,44166,443,allow,7658,1309,6349,24,75,13,11
62085,445,0,0,drop,70,70,0,1,0,1,0
56603,53,10898,53,allow,174,89,85,2,31,1,1
45720,443,24721,443,allow,1625,1038,587,14,26,8,6
57130,53,10466,53,allow,778,103,675,2,31,1,1
62109,445,0,0,drop,66,66,0,1,0,1,0
65515,22114,0,0,deny,62,62,0,1,0,1,0
65498,445,0,0,drop,70,70,0,1,0,1,0
60315,445,0,0,drop,70,70,0,1,0,1,0
55531,53,64298,53,allow,216,110,106,2,30,1,1
56882,53,12251,53,allow,87,87,0,2,60,2,0
29080,50265,0,0,deny,62,62,0,1,0,1,0
53557,39731,46000,39731,allow,70,70,0,2,8,2,0
19875,30170,0,0,deny,145,145,0,1,0,1,0
57780,445,0,0,drop,66,66,0,1,0,1,0
37581,53,0,0,allow,86,86,0,1,30,1,0
56438,3389,56438,3389,allow,3425,1470,1955,16,17,8,8
55907,53,18391,53,allow,184,94,90,2,31,1,1
42453,17,0,0,deny,60,60,0,1,0,1,0
55883,445,0,0,drop,70,70,0,1,0,1,0
64838,445,0,0,drop,70,70,0,1,0,1,0
52267,443,8782,443,allow,24712,9272,15440,65,136,34,31
61242,35253,0,0,deny,62,62,0,1,0,1,0
65500,443,41851,443,allow,8177,3420,4757,23,124,11,12
49547,443,35951,443,allow,1346,918,428,10,23,6,4
14447,25174,0,0,deny,146,146,0,1,0,1,0
58486,57470,0,0,deny,66,66,0,1,0,1,0
63715,29834,21653,29834,allow,70,70,0,1,4,1,0
19570,50584,0,0,deny,66,66,0,1,0,1,0
39444,53,0,0,allow,86,86,0,1,29,1,0
52190,29765,59554,29765,allow,70,70,0,1,4,1,0
53271,443,53446,443,allow,34908,2650,32258,52,45,23,29
57008,443,25539,443,allow,10572,5109,5463,24,122,12,12
59788,443,40327,443,allow,134688,7027,127661,166,37,64,102
57689,445,0,0,drop,66,66,0,1,0,1,0
53833,443,61114,443,allow,499,425,74,4,0,3,1
49963,53,15871,53,allow,279,96,183,4,58,2,2
54993,445,0,0,drop,70,70,0,1,0,1,0
56770,53,41386,53,allow,212,110,102,2,30,1,1
60779,80,5237,80,allow,1248,516,732,9,15,4,5
57317,445,0,0,drop,70,70,0,1,0,1,0
64719,445,0,0,drop,70,70,0,1,0,1,0
54305,39004,0,0,deny,62,62,0,1,0,1,0
56882,445,0,0,drop,70,70,0,1,0,1,0
43288,443,20649,443,allow,11123,2634,8489,22,121,10,12
63988,445,0,0,drop,66,66,0,1,0,1,0
6057,51221,0,0,deny,78,78,0,1,0,1,0
61044,445,0,0,drop,70,70,0,1,0,1,0
52511,445,0,0,drop,70,70,0,1,0,1,0
41153,53,8565,53,allow,168,78,90,2,30,1,1
65428,53,7407,53,allow,731,85,646,2,31,1,1
43671,37965,0,0,deny,62,62,0,1,0,1,0
65396,445,0,0,drop,70,70,0,1,0,1,0
49630,22,49630,22,deny,295,126,169,4,1,2,2
54788,445,0,0,drop,70,70,0,1,0,1,0
49450,445,0,0,drop,70,70,0,1,0,1,0
60441,64337,24616,64337,allow,70,70,0,1,5,1,0
32974,37965,0,0,deny,66,66,0,1,0,1,0
51148,9571,0,0,deny,66,66,0,1,0,1,0
60290,445,0,0,drop,66,66,0,1,0,1,0
50528,445,0,0,drop,70,70,0,1,0,1,0
64355,445,0,0,drop,66,66,0,1,0,1,0
62806,445,0,0,drop,70,70,0,1,0,1,0
62123,445,0,0,drop,70,70,0,1,0,1,0
63973,53,57018,53,allow,346,98,248,4,31,2,2
39442,443,24613,443,allow,6420,1513,4907,25,26,14,11
46970,443,52704,443,allow,8394,3155,5239,28,271,16,12
37508,443,44640,443,allow,8586,1714,6872,25,43,14,11
64155,60043,0,0,deny,66,66,0,1,0,1,0
55083,445,0,0,drop,70,70,0,1,0,1,0
57761,30317,0,0,deny,66,66,0,1,0,1,0
50895,443,43273,443,allow,14584,6798,7786,37,181,18,19
17640,55442,0,0,deny,62,62,0,1,0,1,0
49269,445,0,0,drop,70,70,0,1,0,1,0
48388,44847,0,0,deny,62,62,0,1,0,1,0
49418,27035,7817,27035,allow,250,78,172,2,31,1,1
38970,443,29135,443,allow,4144,2479,1665,19,361,10,9
46936,35440,0,0,deny,62,62,0,1,0,1,0
51270,445,0,0,drop,70,70,0,1,0,1,0
63882,49163,63966,49163,allow,66,66,0,1,5,1,0
57411,53,22912,53,allow,192,98,94,2,31,1,1
53751,445,0,0,drop,66,66,0,1,0,1,0
56352,445,0,0,drop,70,70,0,1,0,1,0
49507,445,0,0,drop,66,66,0,1,0,1,0
37434,443,37114,443,allow,11113,2993,8120,26,143,14,12
64227,53,32450,53,allow,245,94,151,2,30,1,1
53644,58085,31937,58085,allow,70,70,0,2,7,2,0
61516,445,0,0,drop,66,66,0,1,0,1,0
20961,35440,0,0,deny,62,62,0,1,0,1,0
54828,443,63990,443,allow,70,70,0,1,5,1,0
65058,53,6038,53,allow,249,94,155,2,30,1,1
51202,445,0,0,drop,70,70,0,1,0,1,0
993,49276,0,0,deny,129,129,0,1,0,1,0
8910,62413,0,0,deny,146,146,0,1,0,1,0
37785,80,22917,80,allow,2293,1576,717,12,15,6,6
55586,17332,8583,17332,allow,70,70,0,1,5,1,0
36535,443,64497,443,allow,6805,1662,5143,25,17,13,12
51930,445,0,0,drop,70,70,0,1,0,1,0
57493,443,0,0,deny,60,60,0,1,0,1,0
53176,445,0,0,drop,66,66,0,1,0,1,0
27910,53,18233,53,allow,211,94,117,2,30,1,1
26651,25174,0,0,deny,62,62,0,1,0,1,0
55372,53,55372,53,allow,216,90,126,2,30,1,1
56989,53,15263,53,allow,152,78,74,2,30,1,1
7532,53,7532,53,allow,228,90,138,2,31,1,1
62388,445,0,0,drop,66,66,0,1,0,1,0
55420,445,0,0,drop,70,70,0,1,0,1,0
54139,445,0,0,drop,66,66,0,1,0,1,0
38168,443,45970,443,allow,6136,1404,4732,20,979,10,10
30304,26467,0,0,deny,62,62,0,1,0,1,0
64661,445,0,0,drop,66,66,0,1,0,1,0
55036,443,41925,443,allow,10001,2547,7454,27,35,14,13
38140,443,56534,443,allow,11484,3842,7642,30,31,16,14
42379,443,23086,443,allow,6598,1506,5092,22,305,12,10
54866,37965,0,0,deny,62,62,0,1,0,1,0
53831,53,28587,53,allow,260,86,174,2,30,1,1
26900,27017,60227,27017,allow,422,164,258,6,30,3,3
50465,445,0,0,drop,66,66,0,1,0,1,0
27005,27011,25017,27011,allow,1622,126,1496,4,31,2,2
56668,53,43075,53,allow,199,102,97,2,30,1,1
53071,25174,0,0,deny,66,66,0,1,0,1,0
65498,53,57439,53,allow,209,110,99,2,30,1,1
51155,56205,0,0,deny,66,66,0,1,0,1,0
52060,445,0,0,drop,70,70,0,1,0,1,0
50486,443,7512,443,allow,1043,556,487,10,16,6,4
61899,445,0,0,drop,70,70,0,1,0,1,0
55157,7302,0,0,deny,66,66,0,1,0,1,0
46604,57866,0,0,deny,62,62,0,1,0,1,0
53607,51631,7980,51631,allow,70,70,0,2,8,2,0
61164,445,0,0,drop,66,66,0,1,0,1,0
65183,53,12672,53,allow,381,89,292,4,43,2,2
60887,443,40935,443,allow,3795,2679,1116,27,45,15,12
9188,443,11737,443,allow,5955,728,5227,17,15,8,9
55343,53,44963,53,allow,366,94,272,2,30,1,1
49429,53,29436,53,allow,188,96,92,2,31,1,1
55599,53,39999,53,allow,258,94,164,2,29,1,1
45079,80,36951,80,allow,233914,10359,223555,294,442,136,158
43518,443,43518,443,allow,4691,1784,2907,19,29,11,8
57698,64147,0,0,deny,66,66,0,1,0,1,0
61916,64097,0,0,deny,62,62,0,1,0,1,0
42298,40042,16142,40042,allow,148,86,62,2,30,1,1
50367,53,22257,53,allow,578,286,292,9,15,5,4
63971,42759,55186,42759,allow,504,382,122,8,15,6,2
24144,57470,0,0,deny,62,62,0,1,0,1,0
28367,23,0,0,deny,60,60,0,1,0,1,0
52355,445,0,0,drop,70,70,0,1,0,1,0
42225,443,6040,443,allow,8962,1601,7361,26,186,14,12
49949,53,8662,53,allow,307,110,197,2,30,1,1
33362,50584,0,0,deny,146,146,0,1,0,1,0
51827,443,46992,443,allow,11946,8904,3042,42,42,26,16
49407,80,27843,80,allow,2408,1466,942,10,124,6,4
49163,53,24237,53,allow,166,85,81,2,30,1,1
35132,53,35132,53,allow,86,86,0,1,30,1,0
56582,37965,0,0,deny,66,66,0,1,0,1,0
54987,443,54987,443,allow,3154,2012,1142,16,18,10,6
55933,53,55116,53,allow,330,92,238,4,43,2,2
57305,53,52868,53,allow,168,86,82,2,29,1,1
50432,445,0,0,drop,66,66,0,1,0,1,0
53680,443,32656,443,allow,7035,2364,4671,18,75,10,8
57994,443,19602,443,allow,14465,1797,12668,30,170,14,16
63181,445,0,0,drop,66,66,0,1,0,1,0
52415,445,0,0,drop,70,70,0,1,0,1,0
58638,5900,0,0,deny,62,62,0,1,0,1,0
50023,53,60476,53,allow,166,86,80,2,31,1,1
51959,443,27606,443,allow,2648,1797,851,19,23,11,8
60027,443,59128,443,allow,25215,5119,20096,55,144,26,29
54974,53,5978,53,allow,212,102,110,2,30,1,1
65452,53,12771,53,allow,819,102,717,2,30,1,1
22408,22114,0,0,deny,66,66,0,1,0,1,0
58847,445,0,0,drop,70,70,0,1,0,1,0
49607,80,52438,80,allow,378,192,186,7,41,4,3
56938,53,56411,53,allow,199,102,97,2,31,1,1
57322,53,53567,53,allow,196,102,94,2,29,1,1
42226,53,42226,53,allow,259,114,145,2,29,1,1
64286,53,59300,53,allow,274,94,180,2,30,1,1
56039,53,8952,53,allow,762,98,664,2,30,1,1
59738,443,4655,443,allow,510,164,346,2,31,1,1
22130,61248,0,0,reset-both,159,159,0,1,0,1,0
38400,53,0,0,allow,82,82,0,1,30,1,0
49767,53,3628,53,allow,177,94,83,2,29,1,1
53143,24796,50959,24796,allow,698,320,378,10,16,6,4
51974,443,46910,443,allow,17456,7877,9579,47,49,24,23
53352,445,0,0,drop,70,70,0,1,0,1,0
38733,443,51557,443,allow,7655,2018,5637,31,93,16,15
55039,445,0,0,drop,70,70,0,1,0,1,0
45964,2228,0,0,deny,60,60,0,1,0,1,0
53138,443,15464,443,allow,6760,1346,5414,18,325,9,9
52314,445,0,0,drop,70,70,0,1,0,1,0
53419,445,0,0,drop,70,70,0,1,0,1,0
37222,443,57670,443,allow,4713,895,3818,18,16,10,8
51973,44847,0,0,deny,62,62,0,1,0,1,0
58638,5900,0,0,deny,62,62,0,1,0,1,0
6881,6881,0,0,deny,146,146,0,1,0,1,0
57665,52700,0,0,deny,66,66,0,1,0,1,0
52096,55854,2133,55854,allow,70,70,0,2,7,2,0
58638,5900,0,0,deny,62,62,0,1,0,1,0
57083,53,25967,53,allow,196,100,96,2,31,1,1
49798,53,43543,53,allow,196,102,94,2,30,1,1
52565,445,0,0,drop,70,70,0,1,0,1,0
54268,443,64525,443,allow,10173,1548,8625,25,41,14,11
59985,443,35984,443,allow,55132,17147,37985,126,150,55,71
65448,445,0,0,drop,66,66,0,1,0,1,0
55936,53,21289,53,allow,177,94,83,2,30,1,1
49601,80,15488,80,allow,378,192,186,7,41,4,3
0,0,0,0,allow,320,320,0,5,0,5,0
54819,443,17467,443,allow,70,70,0,1,4,1,0
32971,443,32971,443,allow,18895,2061,16834,34,17,18,16
5588,5588,0,0,allow,3354,1792,1562,46,192,23,23
60756,40010,4489,40010,allow,316,136,180,6,6,3,3
50499,80,43182,80,allow,318,192,126,6,25,4,2
55341,39004,0,0,deny,74,74,0,1,0,1,0
64543,50265,0,0,deny,66,66,0,1,0,1,0
57978,80,62070,80,allow,4402,2878,1524,29,105,15,14
50116,22,0,0,deny,60,60,0,1,0,1,0
60812,80,61213,80,allow,1658,1344,314,10,14,5,5
55834,53,32935,53,allow,184,94,90,2,31,1,1
49504,443,29645,443,allow,26816,2982,23834,50,270,23,27
61906,445,0,0,drop,70,70,0,1,0,1,0
56426,53,8485,53,allow,184,94,90,2,30,1,1
55760,443,60909,443,allow,12723734,404530,12319204,13539,134,4494,9045
44034,80,44034,80,allow,18510,706,17804,22,16,6,16
56730,53,39267,53,allow,177,94,83,2,29,1,1
56693,53,6310,53,allow,756,95,661,2,31,1,1
51910,443,52422,443,allow,29367,10171,19196,66,184,32,34
60891,445,0,0,drop,66,66,0,1,0,1,0
45345,443,9986,443,allow,2438,1442,996,21,27,12,9
38118,443,33958,443,allow,574857,27894,546963,745,57,346,399
50962,53,0,0,allow,229,85,144,2,29,1,1
53481,445,0,0,drop,66,66,0,1,0,1,0
51028,445,0,0,drop,70,70,0,1,0,1,0
54196,80,31560,80,allow,2640,540,2100,12,45,6,6
55136,11392,0,0,deny,66,66,0,1,0,1,0
61195,56205,0,0,deny,66,66,0,1,0,1,0
50233,445,0,0,deny,70,70,0,1,0,1,0
50670,445,0,0,drop,66,66,0,1,0,1,0
55605,53,59793,53,allow,198,102,96,2,33,1,1
47089,22114,0,0,deny,146,146,0,1,0,1,0
56267,53,59732,53,allow,453,186,267,6,30,3,3
64429,445,0,0,drop,70,70,0,1,0,1,0
64684,445,0,0,drop,70,70,0,1,0,1,0
54903,445,0,0,drop,66,66,0,1,0,1,0
56798,9571,0,0,deny,66,66,0,1,0,1,0
63203,443,63203,443,allow,9324,4240,5084,24,16,13,11
65113,53,56187,53,allow,232,102,130,2,29,1,1
35197,443,30510,443,allow,12481,2743,9738,53,20,26,27
50737,445,0,0,drop,66,66,0,1,0,1,0
51837,37965,0,0,deny,66,66,0,1,0,1,0
52501,443,44230,443,allow,163226,10147,153079,233,101,101,132
55704,53,8827,53,allow,177,94,83,2,31,1,1
50972,3544,39467,3544,allow,258,107,151,2,30,1,1
48984,15000,36697,15000,allow,130,70,60,2,5,1,1
49707,53,6726,53,allow,733,85,648,2,31,1,1
57330,53,31519,53,allow,228,94,134,2,30,1,1
58638,5900,0,0,deny,62,62,0,1,0,1,0
42574,443,64198,443,allow,130,70,60,3,5,2,1
49676,53,4887,53,allow,216,110,106,2,30,1,1
51798,37020,11736,37020,allow,70,70,0,2,8,2,0
53952,26973,12520,26973,allow,70,70,0,2,8,2,0
53669,59056,24869,59056,allow,70,70,0,2,7,2,0
56254,53,3663,53,allow,498,204,294,6,30,3,3
50148,80,57004,80,allow,9058,868,8190,18,46,10,8
55261,53,19627,53,allow,173,94,79,2,30,1,1
49837,53,4839,53,allow,180,94,86,2,29,1,1
51783,50584,0,0,deny,62,62,0,1,0,1,0
51917,26077,8998,26077,allow,70,70,0,2,8,2,0
45913,443,64072,443,allow,4046,967,3079,13,27,7,6
26553,57470,0,0,deny,66,66,0,1,0,1,0
57802,443,19538,443,allow,37181,32491,4690,93,81,54,39
49501,53,50538,53,allow,229,110,119,2,30,1,1
56104,53,63968,53,allow,197,102,95,2,30,1,1
49415,53,4512,53,allow,194,102,92,2,30,1,1
54136,80,25504,80,allow,1585,863,722,12,15,6,6
33150,53,63816,53,allow,816,228,588,8,29,4,4
50780,445,0,0,drop,70,70,0,1,0,1,0
64790,53,60024,53,allow,178,94,84,2,29,1,1
51120,443,19662,443,allow,2940,787,2153,11,119,5,6
50578,123,63477,123,allow,184,94,90,2,30,1,1
64860,445,0,0,drop,70,70,0,1,0,1,0
60855,35440,0,0,deny,66,66,0,1,0,1,0
50939,443,29204,443,allow,134,60,74,3,5,2,1
64069,53,35417,53,allow,183,86,97,2,29,1,1
44491,50584,0,0,deny,62,62,0,1,0,1,0
11815,30188,0,0,deny,146,146,0,1,0,1,0
57134,53,24003,53,allow,195,102,93,2,29,1,1
58801,443,36000,443,allow,8937,5785,3152,26,16,14,12
64584,80,64584,80,allow,142674,8057,134617,192,27,94,98
60709,443,60709,443,allow,1092,645,447,10,34,6,4
49625,443,57635,443,allow,4252,726,3526,13,16,7,6
55002,53,54595,53,allow,192,98,94,2,31,1,1
37965,46994,50866,46994,allow,4089,2456,1633,53,1773,31,22
51324,445,0,0,drop,70,70,0,1,0,1,0
44967,443,36379,443,allow,7474,1946,5528,33,270,18,15
65274,53,19286,53,allow,295,101,194,4,32,2,2
64483,53,3911,53,allow,168,86,82,2,30,1,1
55269,53,35707,53,allow,193,102,91,2,31,1,1
49903,53,41942,53,allow,194,94,100,2,30,1,1
51907,47518,40645,47518,allow,316,136,180,6,5,3,3
50466,445,0,0,drop,70,70,0,1,0,1,0
51994,80,37899,80,allow,366,240,126,7,26,5,2
52191,32843,31336,32843,allow,70,70,0,1,4,1,0
65472,53,63288,53,allow,202,103,99,2,31,1,1
51742,30317,0,0,deny,66,66,0,1,0,1,0
59153,35440,0,0,deny,66,66,0,1,0,1,0
50820,443,59076,443,allow,6133,1655,4478,12,121,5,7
61495,37965,0,0,deny,66,66,0,1,0,1,0
60493,55172,57169,55172,allow,320,140,180,6,7,3,3
65071,53,11229,53,allow,93,93,0,2,60,2,0
49628,445,0,0,drop,70,70,0,1,0,1,0
55392,53,8146,53,allow,195,102,93,2,30,1,1
44265,80,44265,80,allow,22407,7251,15156,35,23,16,19
11056,6881,0,0,deny,146,146,0,1,0,1,0
51514,443,43958,443,allow,2188,1329,859,23,19,13,10
64614,53,3783,53,allow,168,86,82,2,30,1,1
55475,53,3330,53,allow,381,102,279,4,44,2,2
65209,53,17107,53,allow,212,102,110,2,30,1,1
13062,52274,0,0,deny,66,66,0,1,0,1,0
58638,5900,58638,5900,allow,130,66,64,2,4,1,1
54276,39004,0,0,deny,66,66,0,1,0,1,0
49434,53,30404,53,allow,326,134,192,2,30,1,1
56620,53,31427,53,allow,216,110,106,2,30,1,1
48171,443,3704,443,allow,10420,3506,6914,33,274,18,15
52145,80,50375,80,allow,366,240,126,7,32,5,2
17548,36829,0,0,deny,62,62,0,1,0,1,0
49690,53,62022,53,allow,322,110,212,4,30,2,2
52166,57975,20041,57975,allow,66,66,0,1,5,1,0
49926,445,0,0,drop,70,70,0,1,0,1,0
1663,30188,0,0,deny,66,66,0,1,0,1,0
57235,443,36461,443,allow,8954,3404,5550,34,46,19,15
41919,53,41919,53,allow,223,86,137,2,30,1,1
43892,443,53731,443,allow,9754,4277,5477,27,330,14,13
54307,443,65534,443,allow,5661,1444,4217,19,135,11,8
53791,16881,2744,16881,allow,70,70,0,1,5,1,0
49274,445,0,0,drop,66,66,0,1,0,1,0
53876,443,64698,443,allow,499,425,74,4,1,3,1
61147,22114,0,0,deny,66,66,0,1,0,1,0
53670,32016,15201,32016,allow,70,70,0,1,4,1,0
65511,53,1627,53,allow,212,102,110,2,30,1,1
53912,445,0,0,drop,70,70,0,1,0,1,0
54745,445,0,0,drop,70,70,0,1,0,1,0
62630,445,0,0,drop,70,70,0,1,0,1,0
63545,25174,0,0,deny,62,62,0,1,0,1,0
35428,443,14497,443,allow,9592,2361,7231,25,15,14,11
51600,443,3011,443,allow,12552,2564,9988,29,16,17,12
56276,443,43498,443,allow,71414,17145,54269,194,292,91,103
49173,53,27694,53,allow,214,110,104,2,30,1,1
16221,50584,0,0,deny,62,62,0,1,0,1,0
36306,53,36306,53,allow,229,89,140,2,30,1,1
19648,7000,19648,7000,allow,3610,2043,1567,16,15,9,7
64037,18592,23660,18592,allow,66,66,0,2,7,2,0
60587,443,60587,443,allow,4572,1665,2907,19,27,11,8
65236,53,5620,53,allow,758,102,656,2,30,1,1
54124,443,47726,443,allow,13210,3034,10176,47,153,19,28
30960,45701,51481,45701,allow,330,330,0,6,3609,6,0
57237,21247,0,0,deny,62,62,0,1,0,1,0
53431,80,15544,80,allow,1638,1324,314,10,15,5,5
59069,445,0,0,drop,70,70,0,1,0,1,0
62518,445,0,0,drop,66,66,0,1,0,1,0
50140,53,17472,53,allow,209,110,99,2,30,1,1
1818,22114,0,0,deny,62,62,0,1,0,1,0
44816,80,47339,80,allow,130,70,60,2,15,1,1
58751,443,12034,443,allow,10505,6856,3649,29,16,15,14
56226,53,12248,53,allow,284,96,188,4,33,2,2
51873,19311,58554,19311,allow,70,70,0,2,7,2,0
65189,27216,23592,27216,allow,226,71,155,2,31,1,1
58380,80,42000,80,allow,3130,2290,840,15,135,8,7
65338,53,10255,53,allow,314,88,226,4,44,2,2
5357,32468,0,0,deny,66,66,0,1,0,1,0
54520,443,49982,443,allow,8152,4874,3278,22,138,11,11
48125,7548,0,0,deny,60,60,0,1,0,1,0
56804,445,0,0,drop,70,70,0,1,0,1,0
51746,25174,0,0,deny,62,62,0,1,0,1,0
58760,443,41927,443,allow,45482,2178,43304,56,15,22,34
50912,80,58684,80,allow,9578491,119422,9459069,8079,137,1689,6390
19573,53,49198,53,allow,183,78,105,2,30,1,1
60816,445,0,0,drop,70,70,0,1,0,1,0
16387,35244,0,0,deny,60,60,0,1,0,1,0
51752,7000,51752,7000,allow,3638,2087,1551,17,16,10,7
64347,53,36083,53,allow,186,95,91,2,30,1,1
50685,80,30111,80,allow,60374,30984,29390,250,175,123,127
51351,445,0,0,drop,66,66,0,1,0,1,0
57233,50934,0,0,deny,66,66,0,1,0,1,0
55615,445,0,0,deny,70,70,0,1,0,1,0
55070,53,23784,53,allow,195,102,93,2,31,1,1
46508,80,61419,80,allow,1056,682,374,10,15,6,4
36575,443,29496,443,allow,412,140,272,7,25,3,4
57470,64430,53438,64430,allow,1386,1386,0,22,1526,22,0
62632,35440,0,0,deny,66,66,0,1,0,1,0
43584,24748,0,0,deny,156,156,0,1,0,1,0
64886,53,44785,53,allow,199,102,97,2,29,1,1
65382,53,33350,53,allow,301,108,193,4,55,2,2
4269,26672,0,0,deny,60,60,0,1,0,1,0
58966,443,39805,443,allow,8209,2174,6035,25,210,12,13
50482,443,60480,443,allow,7653,1188,6465,21,15,12,9
17282,7000,17282,7000,allow,2163,676,1487,14,15,7,7
46461,53,27823,53,allow,199,94,105,2,30,1,1
45458,80,54981,80,allow,138,78,60,2,5,1,1
62559,445,0,0,drop,70,70,0,1,0,1,0
55917,445,0,0,drop,66,66,0,1,0,1,0
54944,443,7511,443,allow,4891,2237,2654,12,121,6,6
15466,41864,0,0,deny,148,148,0,1,0,1,0
49840,443,49840,443,allow,4645,1738,2907,19,30,11,8
59209,25174,0,0,deny,66,66,0,1,0,1,0
49638,53,28303,53,allow,331,88,243,4,32,2,2
48144,21247,0,0,deny,66,66,0,1,0,1,0
60318,80,34962,80,allow,2714,2154,560,12,26,7,5
50219,53,44100,53,allow,751,95,656,2,31,1,1
43827,443,38851,443,allow,677212,30094,647118,785,136,282,503
56152,53,61194,53,allow,190,97,93,2,31,1,1
54444,445,0,0,drop,70,70,0,1,0,1,0
60795,40010,57308,40010,allow,316,136,180,6,6,3,3
1955,35974,0,0,deny,60,60,0,1,0,1,0
57334,53,14690,53,allow,210,110,100,2,30,1,1
45844,80,40841,80,allow,152,78,74,2,5,1,1
3585,64147,0,0,deny,62,62,0,1,0,1,0
64862,53,23535,53,allow,223,94,129,2,29,1,1
61528,445,0,0,drop,70,70,0,1,0,1,0
65285,50584,0,0,deny,66,66,0,1,0,1,0
62596,445,0,0,drop,70,70,0,1,0,1,0
64051,19548,23106,19548,allow,66,66,0,1,5,1,0
58113,3389,58113,3389,allow,4245,2461,1784,18,33,9,9
49212,38306,32120,38306,allow,70,70,0,2,8,2,0
80,54605,0,0,deny,66,66,0,1,0,1,0
33397,443,15065,443,allow,1348,687,661,14,42,8,6
59812,443,39961,443,allow,6412,1530,4882,24,255,11,13
49220,2710,38165,2710,allow,70,70,0,1,5,1,0
56947,445,0,0,drop,66,66,0,1,0,1,0
54972,80,43170,80,allow,1074,691,383,12,66,7,5
55625,80,27507,80,allow,389326,9849,379477,391,21,138,253
51870,443,29475,443,allow,4375,1230,3145,16,26,8,8
56360,445,0,0,drop,66,66,0,1,0,1,0
42231,57470,0,0,deny,78,78,0,1,0,1,0
32185,53,63584,53,allow,86,86,0,1,30,1,0
54117,443,30153,443,allow,661695,28430,633265,779,118,335,444
18357,51180,0,0,deny,62,62,0,1,0,1,0
51553,443,28429,443,allow,6662,522,6140,15,16,5,10
47613,53,0,0,allow,82,82,0,1,30,1,0
52740,51505,0,0,deny,66,66,0,1,0,1,0
63701,46824,0,0,deny,66,66,0,1,0,1,0
6881,6881,10552,6881,allow,238,118,120,2,1200,1,1
49826,53,41958,53,allow,279,95,184,4,59,2,2
63141,55860,18547,55860,allow,316,190,126,5,15,3,2
51068,445,0,0,drop,70,70,0,1,0,1,0
38681,15503,0,0,deny,74,74,0,1,0,1,0
56829,33418,63291,33418,allow,316,136,180,6,5,3,3
5938,22455,0,0,allow,60,60,0,1,90,1,0
56631,80,27363,80,allow,61771,2713,59058,80,45,35,45
57470,13332,8538,13332,allow,166,166,0,1,1199,1,0
56937,8200,52360,8200,allow,78,78,0,1,30,1,0
59018,443,37679,443,allow,1786,172,1614,7,120,3,4
34993,15503,0,0,deny,62,62,0,1,0,1,0
51950,17499,60701,17499,allow,66,66,0,1,5,1,0
27502,50584,0,0,deny,62,62,0,1,0,1,0
64792,445,0,0,drop,66,66,0,1,0,1,0
59055,11392,0,0,deny,66,66,0,1,0,1,0
60290,80,20522,80,allow,1366,785,581,11,145,6,5
48542,80,42394,80,allow,811,671,140,6,32,4,2
5223,59023,0,0,deny,66,66,0,1,0,1,0
49217,53,50933,53,allow,282,93,189,4,45,2,2
53653,17436,61017,17436,allow,70,70,0,1,5,1,0
55627,53,4823,53,allow,193,102,91,2,30,1,1
2572,17546,0,0,deny,62,62,0,1,0,1,0
57068,445,0,0,drop,70,70,0,1,0,1,0
58170,445,0,0,drop,66,66,0,1,0,1,0
57789,30188,0,0,deny,62,62,0,1,0,1,0
51414,50584,0,0,deny,62,62,0,1,0,1,0
58638,5900,0,0,deny,62,62,0,1,0,1,0
11136,17500,0,0,deny,62,62,0,1,0,1,0
57119,53,0,0,allow,318,95,223,2,31,1,1
50651,80,37006,80,allow,1555,1103,452,9,21,5,4
47147,443,62760,443,allow,70,70,0,1,5,1,0
49564,443,50036,443,allow,180388,3938,176450,145,161,20,125
59909,445,0,0,drop,70,70,0,1,0,1,0
60888,445,0,0,drop,70,70,0,1,0,1,0
60160,445,0,0,drop,66,66,0,1,0,1,0
57946,443,19612,443,allow,2791,1800,991,26,185,15,11
51509,24855,0,0,allow,66,66,0,1,90,1,0
58316,443,4061,443,allow,7493,1658,5835,22,255,12,10
62273,445,0,0,drop,70,70,0,1,0,1,0
41052,443,41052,443,allow,4596,1689,2907,19,27,11,8
57371,53,32883,53,allow,212,108,104,2,31,1,1
57372,53,34702,53,allow,756,95,661,2,31,1,1
54976,15503,0,0,deny,66,66,0,1,0,1,0
56810,33957,19531,33957,allow,70,70,0,1,5,1,0
50584,51413,47261,51413,allow,1275,300,975,6,1200,3,3
55711,10480,9991,10480,allow,564,318,246,9,18,5,4
60104,80,20513,80,allow,18480,7940,10540,48,71,27,21
57470,60560,62247,60560,allow,527,166,361,2,1200,1,1
58725,443,25110,443,allow,9279,5062,4217,56,259,25,31
38807,443,45968,443,allow,99092,3694,95398,115,170,43,72
52518,35440,0,0,deny,66,66,0,1,0,1,0
62982,445,0,0,drop,66,66,0,1,0,1,0
61147,22114,0,0,deny,62,62,0,1,0,1,0
11951,45026,0,0,deny,60,60,0,1,0,1,0
50241,53,25762,53,allow,728,102,626,2,30,1,1
50242,80,35975,80,allow,2793,1071,1722,14,105,7,7
34112,44847,0,0,deny,66,66,0,1,0,1,0
65212,53,45804,53,allow,196,102,94,2,30,1,1
7881,48817,0,0,deny,133,133,0,1,0,1,0
56827,53,56181,53,allow,195,102,93,2,30,1,1
58326,50584,0,0,deny,62,62,0,1,0,1,0
56671,443,59090,443,allow,7940,1951,5989,20,16,11,9
37659,443,25278,443,allow,3354,2353,1001,18,45,11,7
56406,445,0,0,drop,70,70,0,1,0,1,0
59617,445,0,0,drop,66,66,0,1,0,1,0
64104,53,45169,53,allow,288,101,187,4,28,2,2
49625,53,64446,53,allow,251,102,149,2,30,1,1
55377,53,7280,53,allow,164,78,86,2,30,1,1
65342,53,53223,53,allow,760,97,663,2,30,1,1
65082,53,42896,53,allow,305,94,211,4,35,2,2
27005,27017,4799,27017,allow,883,126,757,2,30,1,1
58961,80,48953,80,allow,5412,4758,654,14,14,8,6
45633,80,23400,80,allow,1573,702,871,12,45,7,5
15503,51508,42580,51508,allow,481,150,331,2,1200,1,1
50981,443,20620,443,allow,5553,1179,4374,24,80,13,11
9420,443,29951,443,allow,9308,2125,7183,27,34,13,14
57249,445,0,0,drop,70,70,0,1,0,1,0
53049,443,20030,443,allow,7393,2050,5343,34,92,16,18
50647,443,3164,443,allow,3201,1812,1389,15,19,9,6
50465,80,51689,80,allow,3688274,86827,3601447,3622,32,1228,2394
61678,80,36347,80,allow,79505,3799,75706,105,53,43,62
3730,37965,0,0,deny,62,62,0,1,0,1,0
49258,80,49258,80,allow,17197,1551,15646,29,27,13,16
30456,36237,0,0,deny,62,62,0,1,0,1,0
37570,443,53443,443,allow,986,499,487,9,17,5,4
65504,53,33205,53,allow,193,102,91,2,30,1,1
44344,23,0,0,deny,60,60,0,1,0,1,0
55250,443,44147,443,allow,1271,918,353,9,15,6,3
53853,443,28816,443,allow,3692,2154,1538,25,81,12,13
41677,57470,0,0,deny,66,66,0,1,0,1,0
56887,53,35999,53,allow,177,94,83,2,30,1,1
37235,443,30384,443,allow,8877,1380,7497,30,18,15,15
61652,445,0,0,drop,70,70,0,1,0,1,0
53525,34759,57554,34759,allow,70,70,0,2,8,2,0
56306,57587,0,0,deny,146,146,0,1,0,1,0
53982,24226,50334,24226,allow,70,70,0,2,7,2,0
65428,53,61145,53,allow,195,102,93,2,30,1,1
40671,443,5840,443,allow,190,70,120,4,15,2,2
51566,445,0,0,drop,70,70,0,1,0,1,0
50066,30188,0,0,deny,62,62,0,1,0,1,0
49844,53,62050,53,allow,368,118,250,2,30,1,1
65489,53,57940,53,allow,531,97,434,4,35,2,2
52118,80,62172,80,allow,3158,1309,1849,28,418,15,13
51620,56205,0,0,deny,66,66,0,1,0,1,0
46269,123,16380,123,allow,184,94,90,2,30,1,1
48625,443,29976,443,allow,7605,2028,5577,23,159,11,12
54252,443,11078,443,allow,499,425,74,4,0,3,1
65196,445,0,0,drop,70,70,0,1,0,1,0
55019,443,26461,443,allow,6866,1983,4883,23,330,11,12
57172,53,10868,53,allow,196,102,94,2,31,1,1
38700,53,38476,53,allow,164,78,86,2,30,1,1
58114,445,0,0,drop,66,66,0,1,0,1,0
57071,443,54499,443,allow,20873,8800,12073,68,19,37,31
55468,53,52823,53,allow,754,94,660,2,31,1,1
49716,5900,0,0,deny,60,60,0,1,0,1,0
50680,445,0,0,drop,66,66,0,1,0,1,0
123,123,24489,123,allow,184,94,90,2,29,1,1
56795,53,22826,53,allow,177,94,83,2,30,1,1
41751,443,36135,443,allow,4570,792,3778,15,15,8,7
59267,53,59267,53,allow,222,87,135,2,31,1,1
64957,53,56586,53,allow,196,102,94,2,31,1,1
57113,53,7922,53,allow,215,102,113,2,30,1,1
50503,445,0,0,drop,66,66,0,1,0,1,0
63991,53,25716,53,allow,193,102,91,2,31,1,1
64582,53,29517,53,allow,209,110,99,2,30,1,1
56765,53,1940,53,allow,188,96,92,2,31,1,1
9522,51505,0,0,deny,66,66,0,1,0,1,0
64958,445,0,0,drop,66,66,0,1,0,1,0
63023,51505,0,0,deny,66,66,0,1,0,1,0
49418,30006,39633,30006,allow,244,71,173,2,30,1,1
50542,80,60343,80,allow,1607,970,637,8,16,5,3
53874,43922,52145,43922,allow,320,140,180,6,6,3,3
51407,443,40522,443,allow,25490,8419,17071,54,48,30,24
35570,22114,0,0,deny,62,62,0,1,0,1,0
50674,445,0,0,drop,70,70,0,1,0,1,0
49752,53,61999,53,allow,182,94,88,2,30,1,1
49690,53,46468,53,allow,198,94,104,2,30,1,1
64623,445,0,0,drop,66,66,0,1,0,1,0
49174,53,31879,53,allow,199,102,97,2,33,1,1
28236,443,42527,443,allow,9686,2335,7351,28,124,13,15
6881,6881,0,0,deny,146,146,0,1,0,1,0
49184,53,41219,53,allow,199,94,105,2,30,1,1
64128,53,26433,53,allow,193,102,91,2,30,1,1
52002,80,8270,80,allow,7480,4670,2810,47,324,30,17
56081,53,46764,53,allow,186,102,84,2,29,1,1
27005,30004,43558,30004,allow,1646,126,1520,4,30,2,2
57171,3389,57171,3389,allow,3428,1714,1714,16,33,8,8
57300,53,21469,53,allow,184,94,90,2,30,1,1
63589,445,0,0,drop,70,70,0,1,0,1,0
55098,53,33176,53,allow,474,200,274,6,44,3,3
28795,37965,0,0,deny,62,62,0,1,0,1,0
65370,53,4186,53,allow,778,103,675,2,31,1,1
47832,50584,0,0,deny,62,62,0,1,0,1,0
63914,32805,62469,32805,allow,66,66,0,2,8,2,0
42974,53,0,0,allow,82,82,0,1,30,1,0
64380,53,22158,53,allow,193,102,91,2,29,1,1
49529,53,23720,53,allow,211,94,117,2,30,1,1
55376,53,17927,53,allow,711,87,624,2,30,1,1
54977,53,19132,53,allow,275,93,182,4,32,2,2
60605,53,5384,53,allow,275,86,189,2,30,1,1
53793,20468,19761,20468,allow,70,70,0,1,5,1,0
57070,30170,0,0,deny,146,146,0,1,0,1,0
50470,61463,0,0,deny,86,86,0,1,0,1,0
53208,443,19606,443,allow,11664,7921,3743,23,16,14,9
15503,38120,41177,38120,allow,481,150,331,2,1200,1,1
49667,443,39894,443,allow,8329,2188,6141,29,100,16,13
48706,23393,0,0,deny,60,60,0,1,0,1,0
35261,15503,0,0,deny,74,74,0,1,0,1,0
60786,51505,0,0,deny,62,62,0,1,0,1,0
56618,445,0,0,drop,70,70,0,1,0,1,0
56318,53,8880,53,allow,182,93,89,2,31,1,1
59699,55783,0,0,deny,62,62,0,1,0,1,0
27005,27027,61298,27027,allow,880,126,754,2,31,1,1
58682,443,48693,443,allow,5061,876,4185,16,70,8,8
56535,445,0,0,drop,70,70,0,1,0,1,0
18485,81,18485,81,allow,146,60,86,2,10,1,1
49291,53,26536,53,allow,277,110,167,2,30,1,1
63578,35440,0,0,deny,66,66,0,1,0,1,0
41339,443,20728,443,allow,7450,1203,6247,22,16,12,10
56078,80,65466,80,allow,2458,531,1927,11,75,6,5
56680,8100,25887,8100,allow,234,234,0,4,11,4,0
51655,80,54219,80,allow,318,192,126,6,37,4,2
59803,445,0,0,drop,66,66,0,1,0,1,0
59759,53,55695,53,allow,384,166,218,2,29,1,1
56991,80,27805,80,allow,1638,1324,314,10,15,5,5
56479,53,28725,53,allow,775,103,672,2,30,1,1
15131,50584,0,0,deny,62,62,0,1,0,1,0
19651,53,19651,53,allow,216,90,126,2,30,1,1
53589,53,45469,53,allow,578,286,292,9,15,5,4
56633,53,42067,53,allow,164,84,80,2,31,1,1
59050,445,0,0,drop,70,70,0,1,0,1,0
65529,53,2543,53,allow,199,102,97,2,30,1,1
64999,53,20323,53,allow,515,86,429,4,45,2,2
60908,445,0,0,drop,66,66,0,1,0,1,0
50958,445,0,0,drop,70,70,0,1,0,1,0
55887,443,44668,443,allow,3954,778,3176,17,121,8,9
64343,53,64343,53,allow,216,98,118,2,30,1,1
55708,443,3177,443,allow,10710,4573,6137,53,3376,31,22
56111,53,5335,53,allow,179,94,85,2,30,1,1
63532,445,0,0,drop,70,70,0,1,0,1,0
56622,443,13170,443,allow,8034,2014,6020,20,15,11,9
57027,53,59688,53,allow,177,94,83,2,31,1,1
64428,445,0,0,drop,70,70,0,1,0,1,0
55677,445,0,0,drop,66,66,0,1,0,1,0
59636,80,29464,80,allow,1352,848,504,13,169,8,5
19850,53,19850,53,allow,404,259,145,3,32,2,1
58638,5900,0,0,deny,62,62,0,1,0,1,0
45435,443,1325,443,allow,8034,400,7634,14,193,2,12
61784,445,0,0,drop,66,66,0,1,0,1,0
51298,57470,0,0,deny,66,66,0,1,0,1,0
49196,443,53527,443,allow,789207,20847,768360,812,23,294,518
51969,80,21230,80,allow,622,70,552,10,1117,2,8
49995,445,0,0,drop,70,70,0,1,0,1,0
56556,53,6278,53,allow,184,94,90,2,31,1,1
50613,53,60735,53,allow,814,110,704,2,30,1,1
65289,46776,0,0,deny,66,66,0,1,0,1,0
49128,18593,0,0,deny,157,157,0,1,0,1,0
49225,8080,49225,8080,allow,43790,20134,23656,73,400,45,28
60977,445,0,0,drop,70,70,0,1,0,1,0
37653,5223,42431,5223,allow,142,142,0,1,5,1,0
64880,53,31529,53,allow,166,86,80,2,30,1,1
22619,10214,0,0,deny,66,66,0,1,0,1,0
50593,64147,0,0,deny,66,66,0,1,0,1,0
62170,53,16163,53,allow,234,94,140,2,29,1,1
5611,25174,0,0,deny,146,146,0,1,0,1,0
42454,443,47292,443,allow,3513,795,2718,11,120,5,6
26084,36237,0,0,deny,62,62,0,1,0,1,0
53721,443,6188,443,allow,70,70,0,1,4,1,0
50211,445,0,0,drop,70,70,0,1,0,1,0
56597,53,9477,53,allow,197,197,0,3,60,3,0
45344,53,14086,53,allow,538,328,210,3,29,2,1
52793,443,27629,443,allow,1942,1281,661,22,228,16,6
64172,445,0,0,drop,70,70,0,1,0,1,0
65314,53,39947,53,allow,195,102,93,2,30,1,1
65177,445,0,0,drop,66,66,0,1,0,1,0
64580,443,64391,443,allow,24686,1935,22751,36,20,17,19
64104,53,19823,53,allow,288,101,187,4,57,2,2
58477,443,37357,443,allow,10026,5706,4320,20,120,10,10
52948,48482,33406,48482,allow,5180,2470,2710,49,339,25,24
55946,443,34803,443,allow,9274,5282,3992,42,186,22,20
57538,30188,0,0,deny,66,66,0,1,0,1,0
33507,443,18740,443,allow,194174,11657,182517,258,31,124,134
41271,50584,0,0,deny,146,146,0,1,0,1,0
51742,30317,0,0,deny,66,66,0,1,0,1,0
50237,445,0,0,drop,70,70,0,1,0,1,0
12457,57866,0,0,deny,66,66,0,1,0,1,0
38640,443,50053,443,allow,6171,1091,5080,22,82,12,10
55675,49271,26954,49271,allow,504,318,186,8,16,5,3
48252,443,55839,443,allow,60300,47341,12959,192,39,108,84
54508,445,0,0,drop,70,70,0,1,0,1,0
58638,5900,0,0,deny,62,62,0,1,0,1,0
57745,15000,1994,15000,allow,130,70,60,2,5,1,1
28004,443,21121,443,allow,5517,1390,4127,18,15,9,9
52281,161,0,0,allow,550,550,0,6,35,6,0
33705,80,63150,80,allow,1288,496,792,8,43,5,3
50265,31101,44674,31101,allow,150,150,0,1,1200,1,0
57807,443,2939,443,allow,9783,5855,3928,22,122,11,11
59842,62413,0,0,deny,66,66,0,1,0,1,0
61908,445,0,0,drop,70,70,0,1,0,1,0
38581,22114,0,0,deny,62,62,0,1,0,1,0
64016,53,59779,53,allow,184,94,90,2,31,1,1
58018,443,65091,443,allow,8828,2193,6635,38,99,17,21
58447,445,0,0,drop,70,70,0,1,0,1,0
51046,443,28730,443,allow,17469,2444,15025,39,207,17,22
39762,123,46956,123,allow,184,94,90,2,30,1,1
28875,51505,0,0,deny,62,62,0,1,0,1,0
52104,51756,50928,51756,allow,66,66,0,1,5,1,0
51179,53,60232,53,allow,86,86,0,1,30,1,0
56911,53,39355,53,allow,177,94,83,2,30,1,1
56704,53,43778,53,allow,194,102,92,2,29,1,1
52852,53,0,0,allow,82,82,0,1,30,1,0
64749,445,0,0,drop,66,66,0,1,0,1,0
44498,53,11053,53,allow,168,78,90,2,30,1,1
26900,27017,15895,27017,allow,254,82,172,4,30,2,2
56492,80,31421,80,allow,74105,3416,70689,84,135,32,52
42298,40037,29650,40037,allow,208,86,122,4,30,2,2
57987,56125,0,0,deny,90,90,0,1,0,1,0
58638,5900,0,0,deny,62,62,0,1,0,1,0
50652,445,0,0,drop,70,70,0,1,0,1,0
53143,443,21953,443,allow,4962,887,4075,15,28,9,6
50724,443,48529,443,allow,12515,5891,6624,42,166,22,20
45839,80,2983,80,allow,1638,1324,314,10,15,5,5
56269,445,0,0,drop,70,70,0,1,0,1,0
49773,53,20298,53,allow,994,86,908,2,30,1,1
64656,53,17241,53,allow,387,102,285,2,29,1,1
58906,80,61612,80,allow,742,350,392,12,28,6,6
65323,445,0,0,drop,66,66,0,1,0,1,0
51719,13715,9141,13715,allow,66,66,0,1,5,1,0
53924,445,0,0,drop,70,70,0,1,0,1,0
50360,37965,0,0,deny,66,66,0,1,0,1,0
60469,60092,63327,60092,allow,70,70,0,1,5,1,0
33627,36237,0,0,deny,62,62,0,1,0,1,0
61017,445,0,0,drop,66,66,0,1,0,1,0
65189,27015,25924,27015,allow,233,71,162,2,30,1,1
65522,445,0,0,drop,66,66,0,1,0,1,0
57108,53,1595,53,allow,193,102,91,2,30,1,1
57431,53,4214,53,allow,733,94,639,2,30,1,1
50517,80,63449,80,allow,5997,1327,4670,18,157,10,8
52397,443,10007,443,allow,9680,2399,7281,47,136,27,20
12242,51221,0,0,deny,62,62,0,1,0,1,0
61572,53,61572,53,allow,213,79,134,2,33,1,1
56835,35894,0,0,deny,66,66,0,1,0,1,0
49195,53,13959,53,allow,239,110,129,2,30,1,1
63071,443,65203,443,allow,569,164,405,2,30,1,1
53132,29384,28228,29384,allow,70,70,0,2,8,2,0
52897,80,31689,80,allow,4292,1932,2360,32,118,17,15
57597,443,32556,443,allow,12528,7238,5290,26,91,15,11
51834,35440,0,0,deny,66,66,0,1,0,1,0
57317,443,9547,443,allow,5614,733,4881,16,15,9,7
55919,53,44823,53,allow,177,94,83,2,30,1,1
53687,445,0,0,drop,66,66,0,1,0,1,0
53755,443,8268,443,allow,499,425,74,4,0,3,1
49418,32056,18212,32056,allow,245,78,167,2,30,1,1
40800,443,27923,443,allow,19403,4043,15360,36,48,19,17
44400,443,34284,443,allow,6576,1937,4639,14,120,7,7
55130,53,39778,53,allow,216,110,106,2,29,1,1
52662,445,0,0,drop,70,70,0,1,0,1,0
59011,443,8442,443,allow,9619,6442,3177,33,122,15,18
61248,445,0,0,drop,70,70,0,1,0,1,0
58327,445,0,0,drop,70,70,0,1,0,1,0
61140,27520,0,0,deny,62,62,0,1,0,1,0
60745,445,0,0,drop,66,66,0,1,0,1,0
61102,445,0,0,drop,70,70,0,1,0,1,0
46410,80,31458,80,allow,1163,705,458,10,15,6,4
45860,443,61779,443,allow,12852,3554,9298,35,24,19,16
64516,443,9177,443,allow,2649258,1156086,1493172,7283,5215,3384,3899
56707,53,58987,53,allow,199,94,105,2,30,1,1
59328,445,0,0,drop,70,70,0,1,0,1,0
64710,53,46845,53,allow,393,110,283,2,30,1,1
33133,443,21005,443,allow,8138,2101,6037,17,121,9,8
49496,445,0,0,drop,70,70,0,1,0,1,0
57040,53,36140,53,allow,179,94,85,2,31,1,1
50898,443,1887,443,allow,6883,1378,5505,19,128,9,10
56587,53,64159,53,allow,184,94,90,2,31,1,1
8239,37965,0,0,deny,146,146,0,1,0,1,0
37568,443,13649,443,allow,1702,861,841,19,110,10,9
50158,53,45524,53,allow,758,96,662,2,30,1,1
49356,445,0,0,drop,66,66,0,1,0,1,0
56288,53,3353,53,allow,200,102,98,2,30,1,1
65496,443,16540,443,allow,92799,4939,87860,111,16,45,66
65251,53,42946,53,allow,199,102,97,2,30,1,1
55401,53,24581,53,allow,168,86,82,2,30,1,1
58638,5900,0,0,deny,62,62,0,1,0,1,0
55534,53,23781,53,allow,168,86,82,2,30,1,1
63999,53,20780,53,allow,193,102,91,2,31,1,1
64605,53,57757,53,allow,183,94,89,2,29,1,1
51721,35426,54780,35426,allow,70,70,0,1,5,1,0
54800,443,18015,443,allow,18814,10011,8803,42,129,21,21
51174,445,0,0,drop,70,70,0,1,0,1,0
48783,53,0,0,allow,86,86,0,1,30,1,0
35080,80,13868,80,allow,71843,2833,69010,83,16,36,47
63565,22114,0,0,deny,146,146,0,1,0,1,0
50046,22114,0,0,deny,66,66,0,1,0,1,0
56362,443,16235,443,allow,3734,1750,1984,24,203,12,12
60773,20010,46646,20010,allow,70,70,0,1,5,1,0
49418,27015,26473,27015,allow,280,71,209,2,31,1,1
53976,445,0,0,drop,70,70,0,1,0,1,0
56560,53,34693,53,allow,196,100,96,2,31,1,1
63972,445,0,0,drop,70,70,0,1,0,1,0
61057,25174,0,0,deny,62,62,0,1,0,1,0
16119,57470,0,0,deny,145,145,0,1,0,1,0
34146,1433,0,0,deny,60,60,0,1,0,1,0
60355,443,30669,443,allow,5341,2434,2907,19,135,9,10
27386,53,27386,53,allow,194,87,107,2,31,1,1
48755,53,17288,53,allow,168,78,90,2,30,1,1
46332,443,57498,443,allow,3132,1697,1435,17,15,10,7
45141,443,63115,443,allow,4497,2208,2289,15,137,7,8
123,123,44084,123,allow,184,94,90,2,30,1,1
56615,443,31008,443,allow,7982,1962,6020,20,15,11,9
64121,443,64564,443,allow,1411,852,559,13,24,7,6
13020,26467,0,0,deny,66,66,0,1,0,1,0
65117,53,55253,53,allow,542,100,442,4,51,2,2
3584,25174,0,0,deny,62,62,0,1,0,1,0
44633,443,21223,443,allow,5715,1536,4179,24,16,13,11
57204,53,58502,53,allow,182,93,89,2,30,1,1
59653,80,58858,80,allow,1139,609,530,10,34,6,4
51275,10924,1826,10924,allow,70,70,0,1,5,1,0
1027,25174,0,0,deny,146,146,0,1,0,1,0
55303,445,0,0,drop,70,70,0,1,0,1,0
51794,53911,31763,53911,allow,70,70,0,2,8,2,0
53397,445,0,0,drop,66,66,0,1,0,1,0
50367,445,0,0,drop,66,66,0,1,0,1,0
48304,443,22064,443,allow,6606,2153,4453,22,95,13,9
56956,53,49926,53,allow,183,94,89,2,30,1,1
51490,30228,0,0,deny,100,100,0,1,0,1,0
58143,57866,0,0,deny,66,66,0,1,0,1,0
33215,37965,0,0,deny,62,62,0,1,0,1,0
65435,80,40330,80,allow,11239,7307,3932,19,25,10,9
46478,64147,0,0,deny,62,62,0,1,0,1,0
57161,445,0,0,drop,70,70,0,1,0,1,0
60360,445,0,0,drop,66,66,0,1,0,1,0
45987,443,65054,443,allow,3160640,65300,3095340,2786,144,547,2239
30960,45700,20531,45700,allow,330,330,0,6,3609,6,0
58958,80,41174,80,allow,6969,6315,654,15,15,9,6
27055,25174,0,0,deny,62,62,0,1,0,1,0
37590,443,21881,443,allow,499,425,74,4,0,3,1
51646,37965,0,0,deny,62,62,0,1,0,1,0
53714,443,10907,443,allow,4933,957,3976,17,15,10,7
57990,80,35454,80,allow,42086,9535,32551,48,21,19,29
55633,53,59677,53,allow,195,102,93,2,30,1,1
42542,25174,0,0,deny,146,146,0,1,0,1,0
63666,445,0,0,drop,70,70,0,1,0,1,0
4903,42873,0,0,deny,70,70,0,1,0,1,0
49257,445,0,0,drop,70,70,0,1,0,1,0
39827,443,61705,443,allow,6128,3746,2382,48,46,25,23
57615,445,0,0,drop,70,70,0,1,0,1,0
65095,53,43220,53,allow,718,94,624,2,30,1,1
53480,445,0,0,drop,66,66,0,1,0,1,0
63071,445,0,0,drop,70,70,0,1,0,1,0
64312,53,19518,53,allow,209,110,99,2,30,1,1
60375,53,25105,53,allow,226,94,132,2,31,1,1
61551,445,0,0,drop,70,70,0,1,0,1,0
57163,443,53866,443,allow,4694,2454,2240,14,135,7,7
49432,53,40864,53,allow,338,118,220,2,29,1,1
56754,14715,43516,14715,allow,66,66,0,1,5,1,0
59011,445,0,0,drop,66,66,0,1,0,1,0
60565,443,42590,443,allow,6483,3687,2796,18,135,9,9
49953,53,45166,53,allow,214,110,104,2,30,1,1
56959,445,0,0,drop,70,70,0,1,0,1,0
55872,53,6785,53,allow,196,102,94,2,30,1,1
49437,53,23949,53,allow,199,102,97,2,30,1,1
52886,443,7611,443,allow,26307,17595,8712,52,498,29,23
53714,445,0,0,drop,66,66,0,1,0,1,0
43103,443,44934,443,allow,3149,1899,1250,19,15,9,10
49289,53,43256,53,allow,177,94,83,2,30,1,1
52480,445,0,0,drop,70,70,0,1,0,1,0
63576,445,0,0,drop,70,70,0,1,0,1,0
56274,53,29071,53,allow,177,94,83,2,29,1,1
53765,443,33408,443,allow,499,425,74,4,0,3,1
65023,445,0,0,drop,66,66,0,1,0,1,0
65006,53,31072,53,allow,793,101,692,2,30,1,1
56337,53,29643,53,allow,268,89,179,4,45,2,2
65501,53,16521,53,allow,443,182,261,6,29,3,3
65063,53,22032,53,allow,180,94,86,2,30,1,1
52254,443,36907,443,allow,13640,2316,11324,24,136,10,14
56844,443,48471,443,allow,10878,4815,6063,60,196,31,29
51739,62163,32244,62163,allow,70,70,0,1,5,1,0
60463,6890,27604,6890,allow,70,70,0,1,5,1,0
55083,53,35659,53,allow,216,110,106,2,30,1,1
57470,1337,44694,1337,allow,594,594,0,10,1199,10,0
58046,80,28676,80,allow,2306,1112,1194,23,76,12,11
65212,53,35167,53,allow,192,98,94,2,31,1,1
44933,443,37036,443,allow,8958,1683,7275,24,23,10,14
23127,53,23127,53,allow,233,91,142,2,30,1,1
58151,53,58151,53,allow,241,98,143,2,30,1,1
61608,445,0,0,drop,66,66,0,1,0,1,0
60960,443,48167,443,allow,7488,1552,5936,23,46,13,10
41466,443,58480,443,allow,3356,2158,1198,21,82,11,10
55556,53,41769,53,allow,224,94,130,2,30,1,1
56565,443,50266,443,allow,52157,3066,49091,65,80,26,39
53132,443,46008,443,allow,6515,1516,4999,23,16,12,11
17171,22114,0,0,deny,66,66,0,1,0,1,0
58147,443,65421,443,allow,8365,2826,5539,27,693,15,12
43207,26467,0,0,deny,62,62,0,1,0,1,0
50116,22,50116,22,allow,152,66,86,2,9,1,1
56691,443,48234,443,allow,3986,2645,1341,18,18,10,8
49849,53,33985,53,allow,173,94,79,2,31,1,1
56676,53,39365,53,allow,178,94,84,2,31,1,1
1888,51505,0,0,deny,62,62,0,1,0,1,0
58195,38303,0,0,deny,66,66,0,1,0,1,0
3304,80,1558,80,allow,2340,1419,921,10,15,5,5
53750,25174,0,0,deny,66,66,0,1,0,1,0
49439,53,40925,53,allow,197,102,95,2,30,1,1
59012,443,51105,443,allow,6278,3531,2747,23,122,12,11
50321,48817,0,0,deny,143,143,0,1,0,1,0
65329,53,20205,53,allow,278,102,176,2,29,1,1
52058,8329,19334,8329,allow,70,70,0,2,9,2,0
56964,53,45347,53,allow,267,87,180,4,54,2,2
64367,443,15536,443,allow,4741,1306,3435,26,300,14,12
49252,445,0,0,drop,66,66,0,1,0,1,0
52252,46314,0,0,deny,62,62,0,1,0,1,0
58088,8765,45865,8765,allow,336,150,186,6,89,3,3
60546,443,51628,443,allow,52666,33941,18725,95,139,49,46
65074,53,7213,53,allow,227,94,133,2,29,1,1
50061,80,3362,80,allow,405,285,120,5,15,3,2
54888,443,50282,443,allow,1775,169,1606,7,122,3,4
53928,15503,0,0,deny,62,62,0,1,0,1,0
58281,443,12495,443,allow,4039,805,3234,17,120,8,9
62336,443,4923,443,allow,8217,2075,6142,31,76,15,16
52135,445,0,0,drop,66,66,0,1,0,1,0
55101,53,27553,53,allow,194,99,95,2,30,1,1
49789,53,65450,53,allow,177,94,83,2,30,1,1
51923,11542,51093,11542,allow,70,70,0,1,5,1,0
7285,51221,0,0,deny,66,66,0,1,0,1,0
44854,26467,0,0,deny,62,62,0,1,0,1,0
47677,80,49789,80,allow,1304,850,454,11,31,6,5
55107,53,32486,53,allow,193,102,91,2,30,1,1
34616,443,64459,443,allow,9265,4429,4836,23,18,14,9
7749,36237,0,0,deny,62,62,0,1,0,1,0
64432,53,49029,53,allow,168,86,82,2,30,1,1
55337,53,11833,53,allow,294,106,188,4,56,2,2
37316,22114,0,0,deny,62,62,0,1,0,1,0
23650,37807,0,0,deny,66,66,0,1,0,1,0
56225,445,0,0,drop,70,70,0,1,0,1,0
49716,443,56032,443,allow,4653,785,3868,14,52,6,8
65266,53,11513,53,allow,754,94,660,2,30,1,1
59734,445,0,0,drop,70,70,0,1,0,1,0
55429,25174,0,0,deny,66,66,0,1,0,1,0
27005,27222,26856,27222,allow,890,126,764,2,30,1,1
4545,1900,0,0,deny,136,136,0,1,0,1,0
58007,62413,0,0,deny,66,66,0,1,0,1,0
59146,445,0,0,drop,66,66,0,1,0,1,0
60427,61137,28150,61137,allow,70,70,0,1,5,1,0
58659,53,58909,53,allow,167,78,89,2,30,1,1
49869,53,17507,53,allow,414,103,311,4,31,2,2
63711,445,0,0,drop,66,66,0,1,0,1,0
64838,53,23821,53,allow,338,110,228,2,30,1,1
50642,445,0,0,drop,70,70,0,1,0,1,0
49531,26467,0,0,deny,62,62,0,1,0,1,0
50432,445,0,0,drop,70,70,0,1,0,1,0
62045,445,0,0,drop,70,70,0,1,0,1,0
56869,53,8171,53,allow,198,94,104,2,31,1,1
51317,443,42808,443,allow,3565,640,2925,16,153,7,9
53495,445,0,0,drop,66,66,0,1,0,1,0
51155,56205,0,0,deny,62,62,0,1,0,1,0
36828,80,12290,80,allow,5189,2979,2210,19,136,12,7
32132,25174,0,0,deny,62,62,0,1,0,1,0
30960,45656,54549,45656,allow,66,66,0,1,3600,1,0
9446,443,50836,443,allow,8672,1863,6809,22,46,11,11
60418,39537,10622,39537,allow,70,70,0,1,5,1,0
55075,53,35995,53,allow,181,94,87,2,30,1,1
3478,61463,0,0,deny,585,585,0,1,0,1,0
2886,35440,0,0,deny,66,66,0,1,0,1,0
51222,445,0,0,drop,70,70,0,1,0,1,0
52891,443,27899,443,allow,320255,9207,311048,343,117,107,236
60462,47821,34484,47821,allow,70,70,0,2,8,2,0
64298,50584,0,0,deny,66,66,0,1,0,1,0
34301,21247,0,0,deny,146,146,0,1,0,1,0
7105,25174,0,0,deny,66,66,0,1,0,1,0
50907,80,50964,80,allow,16037318,218904,15818414,13595,136,2976,10619
51783,445,0,0,drop,70,70,0,1,0,1,0
50767,445,0,0,drop,70,70,0,1,0,1,0
49161,53,58630,53,allow,184,102,82,2,30,1,1
25565,38308,0,0,deny,60,60,0,1,0,1,0
58638,5900,0,0,deny,62,62,0,1,0,1,0
42986,25174,0,0,deny,66,66,0,1,0,1,0
20371,35440,0,0,deny,62,62,0,1,0,1,0
38633,443,38633,443,allow,4378,1471,2907,19,29,11,8
56629,53,33066,53,allow,177,94,83,2,30,1,1
49760,53,45249,53,allow,183,94,89,2,29,1,1
55228,53,59087,53,allow,212,102,110,2,30,1,1
54144,443,45159,443,allow,5736,1990,3746,25,16,14,11
56082,53,15374,53,allow,271,88,183,4,37,2,2
1725,80,3568,80,allow,254,128,126,5,16,3,2
58182,445,0,0,drop,70,70,0,1,0,1,0
53873,52055,21698,52055,allow,70,70,0,2,8,2,0
64613,53,15938,53,allow,179,94,85,2,30,1,1
49393,30188,0,0,deny,66,66,0,1,0,1,0
61840,25174,0,0,deny,62,62,0,1,0,1,0
42951,44847,0,0,deny,66,66,0,1,0,1,0
6882,9220,16555,9220,allow,654,150,504,3,1200,1,2
55609,53,4360,53,allow,178,94,84,2,30,1,1
57484,30317,0,0,deny,66,66,0,1,0,1,0
60038,80,60038,80,allow,12881,767,12114,21,21,9,12
48019,22114,0,0,deny,66,66,0,1,0,1,0
42298,40005,13329,40005,allow,148,86,62,2,29,1,1
51728,44847,0,0,deny,66,66,0,1,0,1,0
50584,45270,4666,45270,allow,1377,300,1077,6,1200,3,3
64513,53,7726,53,allow,396,102,294,2,31,1,1
64775,53,35140,53,allow,445,86,359,2,29,1,1
50880,80,50880,80,allow,163985,6578,157407,188,26,72,116
54614,37807,0,0,deny,66,66,0,1,0,1,0
49215,445,0,0,drop,70,70,0,1,0,1,0
61109,445,0,0,drop,70,70,0,1,0,1,0
6713,2222,0,0,deny,60,60,0,1,0,1,0
64839,53,30697,53,allow,443,182,261,6,30,3,3
61447,445,0,0,drop,66,66,0,1,0,1,0
64568,445,0,0,drop,66,66,0,1,0,1,0
55056,53,24229,53,allow,177,94,83,2,30,1,1
64709,445,0,0,drop,70,70,0,1,0,1,0
55268,53,38039,53,allow,318,91,227,4,33,2,2
55232,443,11743,443,allow,9619,2504,7115,28,46,15,13
49885,443,59973,443,allow,37539,4310,33229,63,51,27,36
38885,21247,0,0,deny,62,62,0,1,0,1,0
38859,22114,0,0,deny,62,62,0,1,0,1,0
63873,445,0,0,drop,66,66,0,1,0,1,0
52103,53733,0,0,deny,62,62,0,1,0,1,0
443,49988,0,0,deny,82,82,0,1,0,1,0
60347,445,0,0,drop,70,70,0,1,0,1,0
61216,12250,0,0,deny,148,148,0,1,0,1,0
47400,80,1203,80,allow,1052,612,440,10,15,5,5
50484,445,0,0,drop,66,66,0,1,0,1,0
59790,445,0,0,drop,66,66,0,1,0,1,0
49357,80,5006,80,allow,3014,1052,1962,14,97,9,5
57294,53,3249,53,allow,760,97,663,2,31,1,1
50895,80,56986,80,allow,9046,1139,7907,20,255,11,9
64303,53,50389,53,allow,253,87,166,4,31,2,2
50353,443,5439,443,allow,130,70,60,3,4,2,1
51969,80,59733,80,allow,366,240,126,7,25,5,2
51872,445,0,0,drop,70,70,0,1,0,1,0
30913,33876,0,0,deny,145,145,0,1,0,1,0
57726,37965,0,0,deny,62,62,0,1,0,1,0
57020,445,0,0,drop,66,66,0,1,0,1,0
51106,80,9259,80,allow,9767,6194,3573,40,47,21,19
30960,45732,62764,45732,allow,330,330,0,6,3610,6,0
55087,445,0,0,drop,66,66,0,1,0,1,0
27922,25174,0,0,deny,62,62,0,1,0,1,0
57470,53380,4441,53380,allow,330,330,0,6,1200,6,0
51865,61689,0,0,deny,66,66,0,1,0,1,0
49703,443,4967,443,allow,421435,16499,404936,388,210,95,293
65157,445,0,0,drop,70,70,0,1,0,1,0
65247,445,0,0,drop,70,70,0,1,0,1,0
50305,53,38735,53,allow,209,110,99,2,30,1,1
61404,443,64202,443,allow,4526,2655,1871,24,98,14,10
56340,53,42393,53,allow,198,102,96,2,30,1,1
56481,445,0,0,drop,66,66,0,1,0,1,0
50878,53733,0,0,deny,66,66,0,1,0,1,0
63254,445,0,0,drop,70,70,0,1,0,1,0
54339,23117,0,0,deny,66,66,0,1,0,1,0
38897,443,50921,443,allow,11019,4204,6815,23,49,13,10
50674,35440,0,0,deny,146,146,0,1,0,1,0
56750,53,18998,53,allow,279,118,161,2,30,1,1
61681,443,6029,443,allow,5922,1917,4005,24,18,14,10
58598,50584,0,0,deny,66,66,0,1,0,1,0
35722,30188,0,0,deny,62,62,0,1,0,1,0
63640,57866,0,0,deny,66,66,0,1,0,1,0
6881,6881,44839,6881,allow,238,118,120,2,1200,1,1
38125,443,63227,443,allow,497663,22937,474726,585,38,245,340
55553,37965,0,0,deny,66,66,0,1,0,1,0
62638,445,0,0,drop,70,70,0,1,0,1,0
15056,2222,0,0,deny,60,60,0,1,0,1,0
58890,53,0,0,allow,180,82,98,2,31,1,1
62260,445,0,0,drop,66,66,0,1,0,1,0
52718,53,15399,53,allow,164,78,86,2,30,1,1
65189,27015,44891,27015,allow,255,78,177,2,30,1,1
63067,53,20594,53,allow,384,166,218,2,30,1,1
57608,445,0,0,drop,66,66,0,1,0,1,0
21544,41599,59404,41599,allow,70,70,0,2,8,2,0
57932,443,47126,443,allow,29612,2205,27407,53,186,21,32
49861,445,0,0,drop,70,70,0,1,0,1,0
62781,445,0,0,drop,70,70,0,1,0,1,0
55692,443,55692,443,allow,7516,1498,6018,25,79,11,14
52522,80,14593,80,allow,3290,2776,514,12,15,7,5
44908,443,9126,443,allow,2931,1940,991,19,25,10,9
49961,80,19985,80,allow,8315,820,7495,18,15,9,9
55834,443,1790,443,allow,190,70,120,4,15,2,2
53181,443,19571,443,allow,2309,1443,866,16,17,8,8
49616,30188,0,0,deny,62,62,0,1,0,1,0
65011,53,38944,53,allow,182,93,89,2,30,1,1
52603,445,0,0,drop,70,70,0,1,0,1,0
45020,443,48024,443,allow,10427,2928,7499,34,106,16,18
65264,445,0,0,drop,66,66,0,1,0,1,0
59168,445,0,0,drop,70,70,0,1,0,1,0
49897,53,22937,53,allow,384,94,290,2,30,1,1
53126,443,9290,443,allow,5604,2738,2866,20,325,10,10
58638,5900,58638,5900,allow,62,62,0,1,5,1,0
56015,56205,0,0,deny,62,62,0,1,0,1,0
64765,53,50725,53,allow,177,94,83,2,30,1,1
64689,445,0,0,drop,70,70,0,1,0,1,0
54280,3385,0,0,deny,60,60,0,1,0,1,0
53434,53,34860,53,allow,87,87,0,2,31,2,0
48734,443,7322,443,allow,256887,11565,245322,293,56,112,181
9212,51505,0,0,deny,146,146,0,1,0,1,0
63779,445,0,0,drop,66,66,0,1,0,1,0
1888,51505,0,0,deny,62,62,0,1,0,1,0
46704,80,21758,80,allow,1193,451,742,10,15,6,4
56693,1900,0,0,deny,139,139,0,1,0,1,0
52518,35440,0,0,deny,62,62,0,1,0,1,0
60217,80,28538,80,allow,21163,16003,5160,47,151,30,17
57010,53,20752,53,allow,198,101,97,2,30,1,1
60505,53,0,0,allow,340,90,250,2,31,1,1
3478,61463,0,0,deny,928,928,0,1,0,1,0
51997,53,57972,53,allow,164,78,86,2,30,1,1
25497,44847,0,0,deny,146,146,0,1,0,1,0
57321,443,61348,443,allow,5613,733,4880,16,14,9,7
51375,445,0,0,drop,66,66,0,1,0,1,0
57433,445,0,0,drop,70,70,0,1,0,1,0
50007,445,0,0,drop,70,70,0,1,0,1,0
46362,35440,0,0,deny,66,66,0,1,0,1,0
31609,26296,0,0,deny,148,148,0,1,0,1,0
51825,443,16261,443,allow,4943,936,4007,21,32,11,10
59997,443,62198,443,allow,3063,1395,1668,16,144,8,8
55767,443,58129,443,allow,1786,172,1614,7,122,3,4
443,20982,0,0,deny,97,97,0,1,0,1,0
36535,443,10367,443,allow,416,210,206,7,27,4,3
51881,445,0,0,drop,70,70,0,1,0,1,0
47935,443,5335,443,allow,12403,2139,10264,38,22,19,19
52668,51221,0,0,deny,66,66,0,1,0,1,0
53687,51471,3936,51471,allow,70,70,0,2,8,2,0
50222,42873,0,0,deny,66,66,0,1,0,1,0
65192,445,0,0,drop,66,66,0,1,0,1,0
53986,445,0,0,drop,70,70,0,1,0,1,0
58656,445,0,0,drop,70,70,0,1,0,1,0
56922,53,56922,53,allow,219,98,121,2,30,1,1
53043,445,0,0,drop,70,70,0,1,0,1,0
50052,65008,0,0,deny,60,60,0,1,0,1,0
64934,53,51307,53,allow,197,102,95,2,33,1,1
49574,443,40939,443,allow,16191,13348,2843,30,55,17,13
58759,445,0,0,drop,70,70,0,1,0,1,0
44323,5228,8392,5228,allow,7292,4509,2783,50,6392,25,25
65294,53,43260,53,allow,173,94,79,2,30,1,1
65246,53,26370,53,allow,179,94,85,2,30,1,1
59593,445,0,0,drop,66,66,0,1,0,1,0
59658,443,21276,443,allow,6695,1617,5078,23,200,13,10
60481,445,0,0,drop,70,70,0,1,0,1,0
24731,51505,0,0,deny,62,62,0,1,0,1,0
58638,5900,0,0,deny,62,62,0,1,0,1,0
50418,445,0,0,drop,66,66,0,1,0,1,0
46232,53,46232,53,allow,194,87,107,2,30,1,1
55661,49671,27582,49671,allow,70,70,0,1,5,1,0
57144,8525,57144,8525,allow,138,78,60,2,5,1,1
54276,37628,0,0,deny,66,66,0,1,0,1,0
4269,26672,0,0,deny,60,60,0,1,0,1,0
49999,53,13553,53,allow,181,94,87,2,29,1,1
42298,40031,52392,40031,allow,156,94,62,2,30,1,1
35937,25174,0,0,deny,66,66,0,1,0,1,0
53638,443,51723,443,allow,24895,2856,22039,46,270,22,24
63010,57470,0,0,deny,145,145,0,1,0,1,0
57287,445,0,0,drop,70,70,0,1,0,1,0
61657,445,0,0,drop,70,70,0,1,0,1,0
61993,445,0,0,drop,70,70,0,1,0,1,0
4110,35440,0,0,deny,66,66,0,1,0,1,0
54178,445,0,0,drop,70,70,0,1,0,1,0
443,50238,0,0,deny,331,331,0,1,0,1,0
37657,443,62208,443,allow,8926,2746,6180,27,46,16,11
33062,17,0,0,deny,60,60,0,1,0,1,0
53816,445,0,0,drop,66,66,0,1,0,1,0
56665,80,42041,80,allow,234,234,0,4,12,4,0
54291,443,41478,443,allow,8056,3762,4294,55,517,28,27
61346,445,0,0,drop,70,70,0,1,0,1,0
58432,443,22620,443,allow,26845,11746,15099,187,161,104,83
443,50238,0,0,deny,331,331,0,1,0,1,0
43591,443,60892,443,allow,1848,1141,707,14,566,8,6
35796,443,15213,443,allow,664348,23858,640490,757,119,292,465
51961,80,32070,80,allow,26804,11349,15455,45,26,25,20
58174,443,55907,443,allow,11141,2777,8364,33,58,14,19
54280,445,0,0,drop,70,70,0,1,0,1,0
49730,53,46996,53,allow,211,110,101,2,30,1,1
58703,50584,0,0,deny,66,66,0,1,0,1,0
2267,53,29941,53,allow,204,118,86,2,31,1,1
48150,443,17947,443,allow,502,222,280,8,28,4,4
50881,80,50881,80,allow,13503,1052,12451,23,21,10,13
54768,445,0,0,deny,70,70,0,1,0,1,0
65129,53,27603,53,allow,213,102,111,2,30,1,1
59759,53,58276,53,allow,211,78,133,2,30,1,1
50611,445,0,0,drop,70,70,0,1,0,1,0
3766,25174,0,0,deny,62,62,0,1,0,1,0
37426,443,35217,443,allow,7477,3305,4172,21,400,12,9
55174,445,0,0,drop,70,70,0,1,0,1,0
56648,443,4719,443,allow,7080,2136,4944,18,121,8,10
54567,445,0,0,drop,70,70,0,1,0,1,0
50347,80,44018,80,allow,1671,862,809,10,15,5,5
57431,53,54427,53,allow,181,94,87,2,30,1,1
45673,30188,0,0,deny,62,62,0,1,0,1,0
59168,39004,0,0,deny,62,62,0,1,0,1,0
56226,53,8376,53,allow,284,96,188,4,31,2,2
51221,64767,41578,64767,allow,330,330,0,6,1200,6,0
51667,25826,12114,25826,allow,9434,9434,0,11,30,11,0
49418,27015,40733,27015,allow,242,78,164,2,30,1,1
57266,443,58500,443,allow,10174,2163,8011,25,81,14,11
27005,33070,2152,33070,allow,883,126,757,2,30,1,1
56941,53,44223,53,allow,196,102,94,2,30,1,1
51887,445,0,0,drop,70,70,0,1,0,1,0
62406,445,0,0,drop,70,70,0,1,0,1,0
49304,445,0,0,drop,70,70,0,1,0,1,0
64818,53,61380,53,allow,260,102,158,2,30,1,1
58638,5900,0,0,deny,62,62,0,1,0,1,0
59943,37807,0,0,deny,62,62,0,1,0,1,0
58309,53,16090,53,allow,255,86,169,2,30,1,1
7100,53,7100,53,allow,644,90,554,2,30,1,1
58753,445,0,0,drop,66,66,0,1,0,1,0
54911,445,0,0,drop,70,70,0,1,0,1,0
6666,6379,0,0,deny,60,60,0,1,0,1,0
35333,80,8364,80,allow,1432,663,769,10,19,6,4
51452,443,19936,443,allow,6936,1761,5175,17,16,11,6
52780,443,29664,443,allow,122,62,60,2,15,1,1
1040,37965,0,0,deny,62,62,0,1,0,1,0
55049,445,0,0,drop,70,70,0,1,0,1,0
53810,443,43179,443,allow,499,425,74,4,0,3,1
43657,50011,0,0,deny,62,62,0,1,0,1,0
50589,53,31342,53,allow,177,94,83,2,29,1,1
10920,53,0,0,allow,266,85,181,2,31,1,1
65176,53,64926,53,allow,183,94,89,2,29,1,1
50265,63104,28604,63104,allow,330,330,0,6,1200,6,0
51362,445,0,0,drop,66,66,0,1,0,1,0
64872,53,64528,53,allow,166,86,80,2,31,1,1
52488,443,19422,443,allow,7165,1099,6066,16,18,9,7
54099,80,63919,80,allow,214,140,74,4,15,3,1
55898,443,55898,443,deny,1850,431,1419,5,0,3,2
58578,445,0,0,drop,70,70,0,1,0,1,0
52122,43073,59163,43073,allow,70,70,0,1,5,1,0
51880,8000,15502,8000,allow,750,360,390,10,60,5,5
49368,443,53544,443,allow,14412,3279,11133,33,19,17,16
57167,53,41895,53,allow,195,102,93,2,30,1,1
49907,53,32516,53,allow,199,102,97,2,30,1,1
38300,443,24962,443,allow,200383,4673,195710,196,30,58,138
53141,8595,16874,8595,allow,70,70,0,1,5,1,0
60944,443,4014,443,allow,5081,896,4185,16,70,8,8
53490,80,9100,80,allow,2577,1278,1299,14,267,8,6
51717,63436,58721,63436,allow,66,66,0,1,5,1,0
60351,445,0,0,drop,70,70,0,1,0,1,0
61299,25174,0,0,deny,146,146,0,1,0,1,0
56910,53,22546,53,allow,199,102,97,2,29,1,1
58638,5900,0,0,deny,62,62,0,1,0,1,0
49524,80,21220,80,allow,1401,828,573,11,38,6,5
443,39878,0,0,deny,74,74,0,1,0,1,0
58865,443,1630,443,allow,505070,16437,488633,543,45,187,356
56217,53,65360,53,allow,711,87,624,2,30,1,1
49701,53,61542,53,allow,197,102,95,2,30,1,1
55365,53,26447,53,allow,184,94,90,2,30,1,1
65449,445,0,0,drop,66,66,0,1,0,1,0
8403,46824,0,0,deny,62,62,0,1,0,1,0
64882,53,2357,53,allow,176,90,86,2,30,1,1
60627,51050,0,0,deny,66,66,0,1,0,1,0
49774,443,43328,443,allow,8130,2220,5910,23,16,13,10
65178,445,0,0,drop,66,66,0,1,0,1,0
38698,443,26967,443,allow,628,250,378,11,39,5,6
27005,33056,59284,33056,allow,885,126,759,2,31,1,1
57982,64147,0,0,deny,66,66,0,1,0,1,0
65093,53,16648,53,allow,266,118,148,2,29,1,1
64288,445,0,0,drop,70,70,0,1,0,1,0
50238,445,0,0,drop,70,70,0,1,0,1,0
38680,443,52567,443,allow,90091,3481,86610,95,15,31,64
44235,443,40190,443,allow,2863,1501,1362,20,317,10,10
28413,64147,0,0,deny,66,66,0,1,0,1,0
60956,445,0,0,drop,66,66,0,1,0,1,0
60048,445,0,0,drop,70,70,0,1,0,1,0
27005,27015,61503,27015,allow,868,126,742,3,31,2,1
63992,53,33581,53,allow,198,101,97,2,31,1,1
56603,53,59539,53,allow,168,86,82,2,31,1,1
55294,445,0,0,drop,66,66,0,1,0,1,0
51941,19333,59185,19333,allow,70,70,0,1,5,1,0
56689,445,0,0,drop,66,66,0,1,0,1,0
11574,51505,0,0,deny,66,66,0,1,0,1,0
57923,443,34874,443,allow,13736,1702,12034,26,15,12,14
53719,443,60186,443,allow,70,70,0,1,5,1,0
64230,53,48297,53,allow,193,94,99,2,30,1,1
60049,25174,0,0,deny,66,66,0,1,0,1,0
56970,53,18773,53,allow,230,110,120,2,30,1,1
62233,443,62233,443,allow,41941,3388,38553,67,77,26,41
65524,53,9019,53,allow,386,122,264,4,52,2,2
49639,443,62054,443,allow,5776,1079,4697,15,53,8,7
58654,445,0,0,drop,70,70,0,1,0,1,0
64674,53,50248,53,allow,183,94,89,2,29,1,1
51813,445,0,0,drop,66,66,0,1,0,1,0
55972,53,37415,53,allow,699,438,261,2,30,1,1
24174,57470,0,0,deny,62,62,0,1,0,1,0
50210,80,7597,80,allow,1277,460,817,16,71,5,11
53052,443,55345,443,allow,214,140,74,4,15,3,1
56263,53,62395,53,allow,214,110,104,2,29,1,1
61639,37965,0,0,deny,66,66,0,1,0,1,0
64258,53,3209,53,allow,260,86,174,2,30,1,1
43131,53,0,0,allow,82,82,0,1,30,1,0
49925,53,18861,53,allow,953,215,738,6,46,3,3
0,0,0,0,allow,480,244,236,4,0,2,2
57176,53,65163,53,allow,793,101,692,2,31,1,1
56078,53,48093,53,allow,178,94,84,2,29,1,1
53074,445,0,0,drop,70,70,0,1,0,1,0
53120,445,0,0,drop,70,70,0,1,0,1,0
41199,443,15931,443,allow,30604,3050,27554,45,122,18,27
26940,443,35054,443,allow,7599,2842,4757,27,22,15,12
6889,65473,0,0,deny,143,143,0,1,0,1,0
34809,57470,0,0,deny,66,66,0,1,0,1,0
63597,443,64564,443,allow,19821,11622,8199,77,135,39,38
57340,53,29949,53,allow,216,110,106,2,30,1,1
50995,445,0,0,deny,66,66,0,1,0,1,0
49257,80,49257,80,allow,19393,1504,17889,30,32,12,18
13864,30718,0,0,deny,60,60,0,1,0,1,0
54423,445,0,0,drop,70,70,0,1,0,1,0
47750,443,44039,443,allow,70,70,0,1,5,1,0
43323,1,0,0,deny,62,62,0,1,0,1,0
52523,443,12913,443,allow,4307,2005,2302,37,18,20,17
59842,62413,0,0,deny,66,66,0,1,0,1,0
57420,22114,0,0,deny,62,62,0,1,0,1,0
49951,80,39870,80,allow,1706,505,1201,8,14,5,3
55147,53,27402,53,allow,184,94,90,2,31,1,1
55752,53,35033,53,allow,170,87,83,2,31,1,1
23719,22114,0,0,deny,62,62,0,1,0,1,0
56617,443,38005,443,allow,5325,1074,4251,18,25,10,8
54502,443,10226,443,allow,6750,1755,4995,16,103,9,7
62909,445,0,0,drop,70,70,0,1,0,1,0
65028,53,59262,53,allow,183,94,89,2,31,1,1
60922,445,0,0,drop,70,70,0,1,0,1,0
53131,443,52675,443,allow,33229,7810,25419,63,44,24,39
16059,22114,0,0,deny,62,62,0,1,0,1,0
33193,50584,0,0,deny,62,62,0,1,0,1,0
49706,53,42213,53,allow,296,102,194,4,41,2,2
20388,53,20388,53,allow,203,82,121,2,30,1,1
64753,443,41377,443,allow,145226,5591,139635,164,120,58,106
60118,53,0,0,allow,216,84,132,2,30,1,1
57350,445,0,0,drop,66,66,0,1,0,1,0
63734,28221,59198,28221,allow,66,66,0,2,7,2,0
35817,443,2802,443,allow,3120,1862,1258,18,15,11,7
55985,53,19393,53,allow,738,86,652,2,30,1,1
63234,443,45160,443,allow,5846,3321,2525,34,96,19,15
53978,27091,3798,27091,allow,320,140,180,6,7,3,3
65359,53,55689,53,allow,193,102,91,2,30,1,1
56595,445,0,0,drop,66,66,0,1,0,1,0
61672,445,0,0,drop,70,70,0,1,0,1,0
51654,80,46130,80,allow,318,192,126,6,37,4,2
65035,53,56043,53,allow,234,102,132,2,30,1,1
60665,445,0,0,drop,66,66,0,1,0,1,0
50034,53,20576,53,allow,179,94,85,2,30,1,1
58638,5900,0,0,deny,62,62,0,1,0,1,0
59580,445,0,0,drop,70,70,0,1,0,1,0
64133,53,32044,53,allow,216,102,114,2,30,1,1
49537,53,41171,53,allow,686,276,410,8,74,4,4
51265,63960,62847,63960,allow,70,70,0,1,5,1,0
56131,37807,0,0,deny,66,66,0,1,0,1,0
64443,53,23166,53,allow,878,184,694,6,71,3,3
49760,53,59419,53,allow,183,94,89,2,30,1,1
27005,1102,9620,1102,allow,867,126,741,2,30,1,1
55018,53,37429,53,allow,179,94,85,2,30,1,1
63731,445,0,0,drop,70,70,0,1,0,1,0
64272,53,63528,53,allow,626,190,436,6,60,3,3
64583,53,25231,53,allow,174,89,85,2,30,1,1
63617,53,24659,53,allow,299,102,197,2,30,1,1
52927,443,29135,443,allow,5582,1388,4194,19,15,9,10
55454,443,35001,443,allow,1784,247,1537,7,120,4,3
62483,445,0,0,drop,70,70,0,1,0,1,0
55971,53,55971,53,allow,233,90,143,2,33,1,1
59836,443,19606,443,allow,1587,924,663,15,27,7,8
55867,53,4524,53,allow,184,94,90,2,31,1,1
59476,445,0,0,drop,70,70,0,1,0,1,0
36622,443,36622,443,allow,16116,3253,12863,52,97,29,23
46653,443,4259,443,allow,4037,1058,2979,12,120,6,6
14102,80,14102,80,allow,722,300,422,11,158,5,6
64841,53,24677,53,allow,165,86,79,2,30,1,1
58638,5900,0,0,deny,62,62,0,1,0,1,0
52570,445,0,0,drop,70,70,0,1,0,1,0
49856,80,12008,80,allow,13992,1645,12347,23,89,10,13
49512,53,53127,53,allow,190,97,93,2,31,1,1
59845,15503,0,0,deny,66,66,0,1,0,1,0
13917,18033,0,0,deny,62,62,0,1,0,1,0
52056,80,64858,80,allow,4562,3936,626,11,28,6,5
50575,443,24477,443,allow,5197,3181,2016,50,261,26,24
56759,55201,40009,55201,allow,66,66,0,1,5,1,0
13285,29892,0,0,deny,145,145,0,1,0,1,0
33003,28543,0,0,deny,62,62,0,1,0,1,0
6126,25174,0,0,deny,62,62,0,1,0,1,0
53246,443,15204,443,allow,134,60,74,3,11,2,1
50265,45599,34078,45599,allow,330,330,0,6,1200,6,0
42846,443,19024,443,allow,162,102,60,2,5,1,1
15176,62413,0,0,deny,62,62,0,1,0,1,0
61492,445,0,0,drop,70,70,0,1,0,1,0
15111,53,15111,53,allow,210,98,112,2,29,1,1
64079,53,36707,53,allow,232,94,138,2,30,1,1
59793,443,44894,443,allow,41635,3977,37658,63,121,25,38
27005,27017,28274,27017,allow,880,126,754,2,31,1,1
64013,57470,0,0,deny,74,74,0,1,0,1,0
64000,445,0,0,drop,70,70,0,1,0,1,0
57470,6881,1895,6881,allow,528,528,0,9,1200,9,0
65462,53,20337,53,allow,196,102,94,2,33,1,1
42128,54532,0,0,deny,60,60,0,1,0,1,0
64406,25174,0,0,deny,66,66,0,1,0,1,0
56015,53,39973,53,allow,195,102,93,2,30,1,1
57597,80,57597,80,allow,80556,2669,77887,84,144,28,56
58638,5900,0,0,deny,62,62,0,1,0,1,0
49991,53,8139,53,allow,198,102,96,2,30,1,1
58866,443,52755,443,allow,2353,1453,900,16,15,8,8
50584,49001,53256,49001,allow,480,150,330,2,1200,1,1
53053,64147,0,0,deny,66,66,0,1,0,1,0
55131,445,0,0,drop,70,70,0,1,0,1,0
53770,64147,0,0,deny,66,66,0,1,0,1,0
59997,445,0,0,drop,66,66,0,1,0,1,0
0,0,0,0,deny,98,98,0,1,0,1,0
50470,61463,0,0,deny,86,86,0,1,0,1,0
26287,56205,0,0,deny,66,66,0,1,0,1,0
54324,7000,54324,7000,allow,4007,1690,2317,15,0,8,7
42811,80,59018,80,allow,1114,534,580,12,16,7,5
49674,445,0,0,drop,70,70,0,1,0,1,0
47053,80,59078,80,allow,1188,463,725,8,15,5,3
57677,23,0,0,deny,60,60,0,1,0,1,0
64642,53,40634,53,allow,265,94,171,2,30,1,1
59683,443,22150,443,allow,13310,4422,8888,47,136,27,20
49180,53,47398,53,allow,402,102,300,2,30,1,1
11228,25174,0,0,deny,66,66,0,1,0,1,0
58638,5900,0,0,deny,62,62,0,1,0,1,0
41482,443,54813,443,allow,1062197,37438,1024759,1129,31,416,713
2077,53,2077,53,allow,212,98,114,2,30,1,1
50129,443,15530,443,allow,9199,2329,6870,30,133,17,13
64651,443,22018,443,allow,317618,11688,305930,350,164,118,232
58301,445,0,0,drop,66,66,0,1,0,1,0
46162,25174,0,0,deny,62,62,0,1,0,1,0
51656,80,3808,80,allow,318,192,126,6,37,4,2
49805,64147,0,0,deny,66,66,0,1,0,1,0
62322,80,60035,80,allow,384,384,0,7,34,7,0
62278,445,0,0,drop,70,70,0,1,0,1,0
52195,50930,54222,50930,allow,70,70,0,1,5,1,0
55621,53,47829,53,allow,453,186,267,6,30,3,3
49648,445,0,0,drop,66,66,0,1,0,1,0
60855,35440,0,0,deny,66,66,0,1,0,1,0
45941,23386,0,0,deny,60,60,0,1,0,1,0
50265,49083,4910,49083,allow,132,132,0,3,1200,3,0
57466,445,0,0,drop,70,70,0,1,0,1,0
46028,80,31228,80,allow,1176793,65077,1111716,1528,85,788,740
58938,443,4576,443,allow,6035,770,5265,18,15,8,10
53498,445,0,0,drop,66,66,0,1,0,1,0
8592,35993,0,0,deny,62,62,0,1,0,1,0
57257,53,11711,53,allow,764,99,665,2,30,1,1
56388,53,34689,53,allow,275,95,180,4,49,2,2
27005,30008,41191,30008,allow,881,126,755,2,31,1,1
49708,80,56764,80,allow,179277,5324,173953,171,108,49,122
56483,443,20342,443,allow,6463,3844,2619,39,135,21,18
54600,6881,0,0,deny,62,62,0,1,0,1,0
55159,53,29350,53,allow,200,102,98,2,30,1,1
56861,33412,8103,33412,allow,70,70,0,1,5,1,0
63171,2323,0,0,deny,60,60,0,1,0,1,0
57335,53,28128,53,allow,185,102,83,2,30,1,1
51948,34853,60337,34853,allow,316,136,180,6,6,3,3
55273,53,48247,53,allow,197,94,103,2,30,1,1
17262,25174,0,0,deny,62,62,0,1,0,1,0
33967,80,35208,80,allow,1836,662,1174,15,3826,6,9
56472,53,12167,53,allow,711,87,624,2,30,1,1
57262,445,0,0,drop,70,70,0,1,0,1,0
54701,445,0,0,drop,70,70,0,1,0,1,0
65474,53,12902,53,allow,198,94,104,2,30,1,1
60481,40075,5787,40075,allow,70,70,0,2,8,2,0
62621,445,0,0,drop,66,66,0,1,0,1,0
38619,443,65221,443,allow,469799,14616,455183,474,129,155,319
65519,443,19659,443,allow,436359,12780,423579,448,16,157,291
53726,26083,18088,26083,allow,70,70,0,2,8,2,0
57444,445,0,0,drop,70,70,0,1,0,1,0
52607,445,0,0,drop,70,70,0,1,0,1,0
64324,37807,0,0,deny,62,62,0,1,0,1,0
56434,53,28860,53,allow,316,94,222,2,30,1,1
57027,445,0,0,drop,66,66,0,1,0,1,0
59766,443,36182,443,allow,508206,39212,468994,748,192,296,452
56346,53,56346,53,allow,262,106,156,2,32,1,1
61827,445,0,0,drop,70,70,0,1,0,1,0
49611,53,44426,53,allow,184,94,90,2,30,1,1
53465,57470,0,0,deny,62,62,0,1,0,1,0
27621,50584,0,0,deny,62,62,0,1,0,1,0
55091,443,55091,443,allow,21122,2591,18531,36,17,18,18
53273,445,0,0,drop,70,70,0,1,0,1,0
52029,52093,64487,52093,allow,70,70,0,1,5,1,0
58638,5900,0,0,deny,62,62,0,1,0,1,0
57316,53,12512,53,allow,177,94,83,2,30,1,1
64077,53,54964,53,allow,199,94,105,2,30,1,1
59424,50265,0,0,deny,70,70,0,1,0,1,0
59051,27520,0,0,deny,62,62,0,1,0,1,0
59724,64147,0,0,deny,66,66,0,1,0,1,0
55384,53,19331,53,allow,94,94,0,1,30,1,0
55282,53,18223,53,allow,771,101,670,2,31,1,1
39980,443,30240,443,allow,2674,1386,1288,17,120,8,9
33793,23,0,0,deny,60,60,0,1,0,1,0
45753,80,11896,80,allow,48495,10969,37526,83,477,39,44
62215,445,0,0,drop,70,70,0,1,0,1,0
50038,53,46782,53,allow,177,94,83,2,31,1,1
26900,27017,46103,27017,allow,422,164,258,6,30,3,3
65526,53,17627,53,allow,199,102,97,2,29,1,1
57205,53,27220,53,allow,711,87,624,2,30,1,1
64697,37965,0,0,deny,66,66,0,1,0,1,0
50017,3389,50017,3389,allow,3428,1714,1714,16,34,8,8
27005,33060,25157,33060,allow,928,126,802,2,31,1,1
56914,445,0,0,drop,66,66,0,1,0,1,0
1171,18375,0,0,deny,146,146,0,1,0,1,0
49514,53,53009,53,allow,749,94,655,2,30,1,1
46092,443,17410,443,allow,130,70,60,2,15,1,1
59833,53,30174,53,allow,377,86,291,2,29,1,1
54716,445,0,0,drop,66,66,0,1,0,1,0
59259,80,59259,80,allow,101244,15308,85936,165,15,53,112
55757,53,50237,53,allow,177,94,83,2,30,1,1
45169,14037,0,0,deny,74,74,0,1,0,1,0
56656,53,54597,53,allow,255,88,167,4,53,2,2
20706,37965,0,0,deny,62,62,0,1,0,1,0
58228,445,0,0,drop,66,66,0,1,0,1,0
3399,25174,0,0,deny,66,66,0,1,0,1,0
60409,80,41783,80,allow,10970,7709,3261,24,29,13,11
0,0,0,0,allow,244,244,0,2,0,2,0
58638,5900,0,0,deny,62,62,0,1,0,1,0
65092,53,7341,53,allow,197,102,95,2,30,1,1
30114,65151,0,0,deny,60,60,0,1,0,1,0
10026,50584,0,0,deny,146,146,0,1,0,1,0
48386,9485,0,0,deny,60,60,0,1,0,1,0
56090,445,0,0,drop,70,70,0,1,0,1,0
58002,445,0,0,drop,70,70,0,1,0,1,0
38383,51221,0,0,deny,66,66,0,1,0,1,0
9129,80,33910,80,allow,318,192,126,6,30,4,2
57552,445,0,0,drop,70,70,0,1,0,1,0
59162,80,16258,80,allow,1031,314,717,13,175,3,10
59823,443,6570,443,allow,27406,15466,11940,123,188,62,61
42144,30170,0,0,deny,146,146,0,1,0,1,0
50374,443,61017,443,allow,8485,1804,6681,30,316,14,16
55707,53,50594,53,allow,177,94,83,2,30,1,1
56408,443,56408,443,allow,4373,1466,2907,19,28,11,8
443,45788,0,0,deny,332,332,0,1,0,1,0
56049,445,0,0,drop,66,66,0,1,0,1,0
61637,53,21621,53,allow,86,86,0,1,30,1,0
54287,443,13671,443,allow,122,62,60,2,15,1,1
51132,80,62444,80,allow,426,240,186,8,21,5,3
52345,445,0,0,drop,66,66,0,1,0,1,0
49773,53,59337,53,allow,225,110,115,2,30,1,1
55236,53,27697,53,allow,196,102,94,2,29,1,1
64160,445,0,0,drop,70,70,0,1,0,1,0
58638,5900,0,0,deny,62,62,0,1,0,1,0
27005,27017,35476,27017,allow,882,126,756,2,31,1,1
59568,445,0,0,drop,70,70,0,1,0,1,0
53428,445,0,0,drop,66,66,0,1,0,1,0
65305,51221,0,0,deny,66,66,0,1,0,1,0
52988,53567,0,0,deny,66,66,0,1,0,1,0
52749,443,45343,443,allow,148418,107579,40839,315,6090,107,208
16059,22114,0,0,deny,62,62,0,1,0,1,0
55047,53,41022,53,allow,308,94,214,2,29,1,1
50470,80,36047,80,allow,8593,2011,6582,17,23,8,9
58226,52848,0,0,deny,145,145,0,1,0,1,0
50621,443,42624,443,allow,10905,4352,6553,30,18,18,12
49777,53,28087,53,allow,216,110,106,2,30,1,1
33582,44847,0,0,deny,66,66,0,1,0,1,0
54473,80,28386,80,allow,14035,1381,12654,26,255,14,12
30188,51403,44357,51403,allow,502,150,352,2,1200,1,1
33611,443,49502,443,allow,9490,1158,8332,24,256,13,11
35066,443,6201,443,allow,33823,28233,5590,84,102,47,37
60517,53,55123,53,allow,215,94,121,2,29,1,1
39978,443,51684,443,allow,6834,2189,4645,40,29,26,14
62059,445,0,0,drop,70,70,0,1,0,1,0
60448,8106,52879,8106,allow,3105,1298,1807,20,16,10,10
61537,57866,0,0,deny,66,66,0,1,0,1,0
61983,50432,0,0,deny,62,62,0,1,0,1,0
49574,53,25202,53,allow,816,102,714,2,30,1,1
56783,21279,24337,21279,allow,70,70,0,1,5,1,0
45424,23,0,0,deny,60,60,0,1,0,1,0
58638,5900,0,0,deny,62,62,0,1,0,1,0
57843,443,8894,443,allow,130,70,60,2,15,1,1
53651,443,17075,443,allow,9485,2173,7312,32,27,17,15
56586,53,6320,53,allow,170,87,83,2,30,1,1
64460,53,1617,53,allow,196,102,94,2,30,1,1
58255,445,0,0,drop,70,70,0,1,0,1,0
59962,53,13839,53,allow,316,94,222,2,30,1,1
16382,17500,0,0,deny,62,62,0,1,0,1,0
443,61686,0,0,deny,1484,1484,0,1,0,1,0
56903,53,50850,53,allow,232,94,138,2,30,1,1
27065,53,10980,53,allow,822,466,356,3,30,2,1
35098,161,0,0,allow,15190,7454,7736,78,30,39,39
51451,443,12053,443,allow,6957,1775,5182,22,17,12,10
6546,37965,0,0,deny,62,62,0,1,0,1,0
52191,32843,25090,32843,allow,70,70,0,2,8,2,0
52892,445,0,0,drop,70,70,0,1,0,1,0
50584,26301,47178,26301,allow,161,161,0,2,1199,2,0
59888,80,59888,80,allow,55739,967,54772,53,15,13,40
52243,445,0,0,drop,66,66,0,1,0,1,0
37510,443,18789,443,allow,8619,2288,6331,41,361,16,25
63213,15503,0,0,deny,66,66,0,1,0,1,0
38468,53,0,0,allow,82,82,0,2,40,2,0
50027,53,20964,53,allow,264,110,154,2,30,1,1
52489,443,60427,443,allow,32975,9028,23947,39,15,18,21
63771,7426,29432,7426,allow,66,66,0,2,7,2,0
50091,53,60727,53,allow,183,94,89,2,30,1,1
50973,80,57219,80,allow,314164,13077,301087,356,25,144,212
60495,6882,55669,6882,allow,70,70,0,2,8,2,0
60422,62456,45228,62456,allow,341,215,126,5,16,3,2
64374,53,21299,53,allow,194,94,100,2,30,1,1
56102,53,3387,53,allow,757,98,659,2,0,1,1
57129,445,0,0,drop,66,66,0,1,0,1,0
48817,6889,48817,6889,allow,158,158,0,1,1200,1,0
50298,37965,0,0,deny,66,66,0,1,0,1,0
51991,445,0,0,drop,70,70,0,1,0,1,0
56496,445,0,0,drop,70,70,0,1,0,1,0
56627,53,14624,53,allow,193,102,91,2,30,1,1
51214,445,0,0,drop,70,70,0,1,0,1,0
49672,443,34216,443,allow,10080,2728,7352,28,188,14,14
34153,443,49528,443,allow,7037,1282,5755,21,30,11,10
28124,37965,0,0,deny,145,145,0,1,0,1,0
60710,445,0,0,drop,66,66,0,1,0,1,0
57470,6969,29118,6969,allow,528,528,0,9,1199,9,0
65507,53,3700,53,allow,167,86,81,2,30,1,1
56137,445,0,0,drop,66,66,0,1,0,1,0
48252,443,35978,443,allow,283034,39462,243572,536,224,257,279
64695,53,7882,53,allow,275,118,157,2,30,1,1
49679,445,0,0,drop,70,70,0,1,0,1,0
51761,19136,25240,19136,allow,70,70,0,1,5,1,0
60425,443,26007,443,allow,1541,1004,537,14,26,8,6
37833,53,37833,53,allow,222,90,132,2,30,1,1
54658,6881,23302,6881,allow,705,583,122,6,26,4,2
65111,53,19274,53,allow,355,96,259,4,38,2,2
55833,445,0,0,drop,70,70,0,1,0,1,0
9494,23,0,0,deny,60,60,0,1,0,1,0
52537,57866,0,0,deny,62,62,0,1,0,1,0
64291,445,0,0,drop,66,66,0,1,0,1,0
59129,445,0,0,drop,70,70,0,1,0,1,0
58638,5900,0,0,deny,62,62,0,1,0,1,0
14103,35440,0,0,deny,62,62,0,1,0,1,0
64628,53,26706,53,allow,753,93,660,2,30,1,1
61510,37965,0,0,deny,66,66,0,1,0,1,0
57094,53,64941,53,allow,192,98,94,2,31,1,1
54986,53,53684,53,allow,164,78,86,2,30,1,1
57096,53,22814,53,allow,196,100,96,2,31,1,1
55610,53,5256,53,allow,822,102,720,2,29,1,1
55627,53,32877,53,allow,179,94,85,2,30,1,1
6666,2222,0,0,deny,60,60,0,1,0,1,0
49225,53,22731,53,allow,295,101,194,4,48,2,2
65525,445,0,0,drop,70,70,0,1,0,1,0
58638,5900,0,0,deny,62,62,0,1,0,1,0
49469,53,2393,53,allow,185,102,83,2,30,1,1
64560,53,45431,53,allow,807,94,713,2,30,1,1
49843,445,0,0,drop,70,70,0,1,0,1,0
49257,53,41185,53,allow,166,86,80,2,30,1,1
57008,123,60959,123,allow,184,94,90,2,30,1,1
63085,445,0,0,drop,66,66,0,1,0,1,0
49962,53,19275,53,allow,184,94,90,2,31,1,1
33401,51505,0,0,deny,62,62,0,1,0,1,0
49376,53,19245,53,allow,209,110,99,2,30,1,1
1081,1970,0,0,deny,146,146,0,1,0,1,0
32554,34729,0,0,deny,62,62,0,1,0,1,0
4651,443,4651,443,allow,14579,1280,13299,25,16,9,16
0,0,0,0,allow,244,244,0,2,0,2,0
14715,56205,0,0,deny,62,62,0,1,0,1,0
44157,53,44157,53,allow,216,90,126,2,29,1,1
62050,443,56297,443,allow,7955,2503,5452,33,16,19,14
39583,53,11422,53,allow,86,86,0,1,30,1,0
57990,445,0,0,drop,70,70,0,1,0,1,0
50453,445,0,0,drop,70,70,0,1,0,1,0
51830,42707,0,0,deny,66,66,0,1,0,1,0
14641,443,14641,443,allow,254281,66535,187746,336,317,183,153
60228,445,0,0,drop,70,70,0,1,0,1,0
27005,27035,11763,27035,allow,891,126,765,2,31,1,1
49478,53,25544,53,allow,172,94,78,2,30,1,1
55806,445,0,0,drop,66,66,0,1,0,1,0
49654,22,49654,22,allow,7791,3373,4418,54,36,26,28
59319,445,0,0,drop,70,70,0,1,0,1,0
10003,64147,0,0,deny,62,62,0,1,0,1,0
56699,443,19537,443,allow,8006,1986,6020,20,15,11,9
63146,445,0,0,drop,66,66,0,1,0,1,0
58638,5900,58638,5900,allow,156,62,94,2,10,1,1
55181,53,13217,53,allow,711,87,624,2,30,1,1
41799,443,41969,443,allow,10518,3356,7162,24,121,11,13
55705,54638,46726,54638,allow,504,318,186,8,15,5,3
59893,53,45221,53,allow,198,93,105,2,30,1,1
37840,53,37840,53,allow,216,90,126,2,30,1,1
35628,443,42437,443,allow,7840,1829,6011,24,85,14,10
41207,80,55374,80,allow,79441,3092,76349,103,16,48,55
50538,80,28093,80,allow,4314,3518,796,15,32,8,7
54953,443,55555,443,allow,9996,2043,7953,42,271,20,22
62187,443,25960,443,allow,36473,7710,28763,63,124,27,36
63422,443,21466,443,allow,10617247,317598,10299649,11317,243,4141,7176
27005,27017,62934,27017,allow,1658,126,1532,4,30,2,2
35072,53,51638,53,allow,168,78,90,2,30,1,1
9279,443,53983,443,allow,4275,760,3515,15,27,8,7
58597,35440,0,0,deny,66,66,0,1,0,1,0
2850,64147,0,0,deny,66,66,0,1,0,1,0
51973,445,0,0,drop,70,70,0,1,0,1,0
57442,53,59819,53,allow,411,110,301,2,30,1,1
38460,443,18587,443,allow,14768,3347,11421,69,1902,32,37
60457,16881,27690,16881,allow,1948,891,1057,16,18,8,8
58207,51505,0,0,deny,62,62,0,1,0,1,0
51165,445,0,0,drop,70,70,0,1,0,1,0
56826,22114,0,0,deny,66,66,0,1,0,1,0
55593,53,62454,53,allow,193,102,91,2,30,1,1
54310,80,7871,80,allow,552,280,272,9,30,5,4
5235,34592,6891,34592,allow,247495,256,247239,361,49,5,356
60428,80,55142,80,allow,20301,1264,19037,28,26,11,17
55039,443,27278,443,allow,8209,2789,5420,24,42,14,10
65444,53,15259,53,allow,86,86,0,1,30,1,0
55008,21247,0,0,deny,66,66,0,1,0,1,0
55253,445,0,0,drop,70,70,0,1,0,1,0
63129,445,0,0,drop,70,70,0,1,0,1,0
57741,445,0,0,drop,70,70,0,1,0,1,0
49948,53,30662,53,allow,214,94,120,2,30,1,1
56023,53,4937,53,allow,338,106,232,4,37,2,2
49201,17852,10581,17852,allow,66,66,0,1,5,1,0
64537,443,9854,443,allow,3182,1568,1614,8,120,4,4
50172,443,51694,443,allow,3756,1914,1842,19,361,9,10
61398,445,0,0,drop,70,70,0,1,0,1,0
64075,445,0,0,drop,70,70,0,1,0,1,0
56261,53,2901,53,allow,184,94,90,2,30,1,1
61135,50265,0,0,deny,62,62,0,1,0,1,0
49171,53,63019,53,allow,301,102,199,2,30,1,1
52108,443,27930,443,allow,18735,3452,15283,42,52,22,20
56180,53,32734,53,allow,200,102,98,2,31,1,1
27300,6881,0,0,deny,62,62,0,1,0,1,0
26900,27017,49635,27017,allow,422,164,258,6,30,3,3
49646,53,18495,53,allow,199,102,97,2,30,1,1
45396,53,7036,53,allow,168,78,90,2,30,1,1
49269,53,8382,53,allow,198,110,88,2,30,1,1
44509,80,44509,80,allow,84030,4287,79743,107,145,47,60
56614,80,65163,80,allow,234,234,0,4,11,4,0
55445,53,39762,53,allow,192,192,0,3,46,3,0
11136,15503,0,0,deny,62,62,0,1,0,1,0
10669,49756,0,0,deny,60,60,0,1,0,1,0
45816,443,14384,443,allow,21950,3632,18318,46,140,20,26
65089,53,20611,53,allow,199,102,97,2,30,1,1
52354,445,0,0,drop,70,70,0,1,0,1,0
51324,11392,0,0,deny,66,66,0,1,0,1,0
59890,443,21509,443,allow,9801,2337,7464,25,47,13,12
64316,53,34882,53,allow,184,94,90,2,31,1,1
52012,445,0,0,drop,66,66,0,1,0,1,0
63030,25174,0,0,deny,62,62,0,1,0,1,0
22568,37965,0,0,deny,66,66,0,1,0,1,0
58936,443,47053,443,allow,9081,3368,5713,42,76,24,18
64439,53,21739,53,allow,198,101,97,2,30,1,1
46288,443,54873,443,allow,28173,21385,6788,100,41,51,49
51313,40573,0,0,deny,100,100,0,1,0,1,0
46009,53,4263,53,allow,199,94,105,2,30,1,1
49418,27016,46428,27016,allow,249,71,178,2,30,1,1
48301,25174,0,0,deny,66,66,0,1,0,1,0
58338,3369,0,0,deny,60,60,0,1,0,1,0
52016,443,52016,443,allow,219803,9390,210413,222,49,72,150
46592,53,27919,53,allow,168,78,90,2,30,1,1
12668,42707,0,0,deny,62,62,0,1,0,1,0
51048,445,0,0,drop,70,70,0,1,0,1,0
49522,445,0,0,drop,66,66,0,1,0,1,0
50878,53733,0,0,deny,66,66,0,1,0,1,0
60775,445,0,0,drop,70,70,0,1,0,1,0
49724,53,30037,53,allow,470,131,339,4,32,2,2
58638,5900,0,0,deny,62,62,0,1,0,1,0
38779,80,43301,80,allow,540,540,0,10,186,10,0
60384,443,3369,443,allow,4315,928,3387,16,15,10,6
60455,445,0,0,drop,70,70,0,1,0,1,0
50977,445,0,0,drop,66,66,0,1,0,1,0
55334,53,36263,53,allow,199,102,97,2,30,1,1
24127,56205,0,0,deny,66,66,0,1,0,1,0
57334,443,4953,443,allow,11347,2434,8913,28,62,15,13
54627,80,54627,80,allow,12385,1831,10554,20,20,9,11
7686,25174,0,0,deny,62,62,0,1,0,1,0
55300,445,0,0,drop,70,70,0,1,0,1,0
64318,53,41262,53,allow,499,183,316,6,57,3,3
57170,38303,0,0,deny,66,66,0,1,0,1,0
55924,80,55924,80,allow,450,246,204,8,28,5,3
55311,44847,0,0,deny,66,66,0,1,0,1,0
50156,53,2104,53,allow,777,87,690,2,0,1,1
44191,443,19988,443,allow,7151,1943,5208,30,25,17,13
63495,445,0,0,drop,70,70,0,1,0,1,0
34739,5222,35050,5222,allow,26914,4119,22795,85,539,41,44
49369,53,54778,53,allow,183,94,89,2,30,1,1
56415,53,9528,53,allow,199,102,97,2,30,1,1
51038,445,0,0,drop,66,66,0,1,0,1,0
64583,443,48873,443,allow,9150,2109,7041,27,32,15,12
64166,35440,0,0,deny,62,62,0,1,0,1,0
63926,53,50565,53,allow,260,102,158,2,31,1,1
64724,53,63918,53,allow,319,97,222,4,31,2,2
50211,51050,0,0,deny,66,66,0,1,0,1,0
61421,80,3203,80,allow,214,140,74,4,41,3,1
59326,80,59326,80,allow,109128,4773,104355,197,16,68,129
55469,445,0,0,drop,70,70,0,1,0,1,0
61566,53,28325,53,allow,86,86,0,1,30,1,0
64196,53,65372,53,allow,262,94,168,2,30,1,1
55804,53,9951,53,allow,816,102,714,2,30,1,1
55570,53,7060,53,allow,889,404,485,10,30,5,5
58903,80,49363,80,allow,22851,3171,19680,39,147,20,19
56439,53,35642,53,allow,198,102,96,2,31,1,1
50596,80,46998,80,allow,1598,937,661,13,78,7,6
59936,445,0,0,drop,66,66,0,1,0,1,0
50765,22114,0,0,deny,66,66,0,1,0,1,0
62183,57470,0,0,deny,74,74,0,1,0,1,0
51528,445,0,0,drop,66,66,0,1,0,1,0
55222,53,13241,53,allow,181,94,87,2,29,1,1
56274,443,23756,443,allow,3093,868,2225,10,120,5,5
46367,36237,0,0,deny,66,66,0,1,0,1,0
38713,443,14389,443,allow,90241,3033,87208,89,16,24,65
64002,2880,57977,2880,allow,66,66,0,2,8,2,0
49871,445,0,0,drop,70,70,0,1,0,1,0
61173,2323,0,0,deny,60,60,0,1,0,1,0
49739,53,37326,53,allow,757,102,655,2,30,1,1
11404,64147,0,0,deny,62,62,0,1,0,1,0
49200,38001,12165,38001,allow,70,70,0,1,5,1,0
50594,443,48288,443,allow,4337,3026,1311,21,141,12,9
45743,8765,60687,8765,allow,336,150,186,6,89,3,3
64835,53,33008,53,allow,200,102,98,2,29,1,1
60199,443,24633,443,allow,5858,1511,4347,20,21,11,9
55473,53,5965,53,allow,186,102,84,2,30,1,1
58638,5900,0,0,deny,62,62,0,1,0,1,0
27005,27016,54268,27016,allow,1642,126,1516,4,31,2,2
63548,443,63548,443,allow,4742,1835,2907,19,29,11,8
58638,5900,0,0,deny,62,62,0,1,0,1,0
60298,443,32921,443,allow,9565,3317,6248,25,144,14,11
64942,53,56338,53,allow,803,390,413,9,71,5,4
60257,445,0,0,drop,66,66,0,1,0,1,0
30129,37965,0,0,deny,72,72,0,1,0,1,0
64946,53,5511,53,allow,452,118,334,2,30,1,1
28580,64147,0,0,deny,62,62,0,1,0,1,0
56364,53,33489,53,allow,308,94,214,2,30,1,1
60828,445,0,0,drop,66,66,0,1,0,1,0
51864,445,0,0,drop,70,70,0,1,0,1,0
51843,80,51843,80,allow,35384,3225,32159,49,26,20,29
56010,53,24880,53,allow,184,94,90,2,30,1,1
61150,445,0,0,drop,66,66,0,1,0,1,0
56550,53,58694,53,allow,84,84,0,1,31,1,0
55634,53,10243,53,allow,210,110,100,2,30,1,1
64104,53,54315,53,allow,288,101,187,4,58,2,2
62580,25174,0,0,deny,62,62,0,1,0,1,0
55286,445,0,0,drop,70,70,0,1,0,1,0
49693,443,16419,443,allow,12060,4857,7203,25,71,14,11
53565,443,13839,443,allow,12007,942,11065,19,120,8,11
47910,7454,0,0,deny,60,60,0,1,0,1,0
1025,51221,0,0,deny,62,62,0,1,0,1,0
49973,53,28904,53,allow,747,93,654,2,30,1,1
45964,2228,0,0,deny,60,60,0,1,0,1,0
64894,53,19330,53,allow,195,102,93,2,30,1,1
57011,80,37769,80,allow,214,140,74,4,30,3,1
49637,443,18252,443,allow,50296,4666,45630,90,31,43,47
46478,64147,0,0,deny,62,62,0,1,0,1,0
53643,8118,59357,8118,allow,2104,1209,895,15,16,7,8
50122,53,55627,53,allow,811,94,717,2,31,1,1
64112,445,0,0,drop,70,70,0,1,0,1,0
51638,80,60451,80,allow,318,192,126,6,39,4,2
57316,53,57316,53,allow,216,82,134,2,32,1,1
50625,80,24486,80,allow,8688,4248,4440,56,131,34,22
49369,53,33288,53,allow,232,110,122,2,30,1,1
65336,53,64946,53,allow,275,94,181,2,30,1,1
51058,445,0,0,drop,70,70,0,1,0,1,0
51103,80,39889,80,allow,2792,2073,719,15,30,9,6
57291,53,9525,53,allow,178,94,84,2,30,1,1
55037,445,0,0,drop,66,66,0,1,0,1,0
55133,53,36178,53,allow,184,102,82,2,31,1,1
49776,53,56083,53,allow,180,92,88,2,30,1,1
49654,53,46255,53,allow,775,102,673,2,30,1,1
57499,445,0,0,drop,70,70,0,1,0,1,0
50931,443,19777,443,allow,4178,2310,1868,39,30,23,16
50337,443,21907,443,allow,9653,1740,7913,23,81,12,11
50077,53,35101,53,allow,787,110,677,2,30,1,1
45300,443,4696,443,allow,11748,7422,4326,59,113,31,28
35078,443,18726,443,allow,78,78,0,1,5,1,0
61029,445,0,0,drop,70,70,0,1,0,1,0
56104,53,20610,53,allow,194,99,95,2,31,1,1
1036,64147,0,0,deny,62,62,0,1,0,1,0
59420,443,36806,443,allow,7913,5787,2126,28,316,14,14
47201,44847,0,0,deny,66,66,0,1,0,1,0
49411,53,10560,53,allow,195,102,93,2,31,1,1
56568,53,15733,53,allow,711,87,624,2,30,1,1
26900,27017,31467,27017,allow,422,164,258,6,30,3,3
43260,41615,0,0,deny,145,145,0,1,0,1,0
52138,443,52138,443,allow,80933,20860,60073,121,324,66,55
57432,445,0,0,drop,66,66,0,1,0,1,0
49476,445,0,0,drop,70,70,0,1,0,1,0
64422,53,12114,53,allow,180,94,86,2,31,1,1
52415,443,32301,443,allow,2007,1152,855,14,15,8,6
19698,502,0,0,deny,60,60,0,1,0,1,0
55966,445,0,0,drop,70,70,0,1,0,1,0
57268,443,5467,443,allow,1617,1073,544,16,15,9,7
53261,12348,58794,12348,allow,552,306,246,9,142,5,4
65433,80,53822,80,allow,486,240,246,9,28,5,4
3074,64147,0,0,deny,62,62,0,1,0,1,0
63517,445,0,0,drop,66,66,0,1,0,1,0
51490,57587,0,0,deny,100,100,0,1,0,1,0
49717,53,61877,53,allow,781,94,687,2,30,1,1
58509,80,60586,80,allow,1666,1130,536,12,16,7,5
56203,53,21719,53,allow,751,95,656,2,30,1,1
60544,53,63580,53,allow,211,78,133,2,30,1,1
51725,32787,46505,32787,allow,70,70,0,1,5,1,0
56583,443,5338,443,allow,9416,2366,7050,25,19,14,11
55082,445,0,0,drop,70,70,0,1,0,1,0
49931,53,2557,53,allow,195,102,93,2,30,1,1
52795,443,15981,443,allow,1444,723,721,15,198,8,7
52123,46261,33776,46261,allow,70,70,0,1,4,1,0
60333,443,9820,443,allow,8945,5766,3179,30,130,18,12
60542,53,46573,53,allow,260,86,174,2,30,1,1
2267,53,54928,53,allow,204,118,86,2,31,1,1
52374,445,0,0,drop,70,70,0,1,0,1,0
0,0,0,0,deny,70,70,0,1,0,1,0
38862,443,38862,443,allow,23553,2583,20970,46,103,19,27
50675,56205,0,0,deny,66,66,0,1,0,1,0
48890,443,48166,443,allow,79665,4371,75294,110,256,45,65
61719,80,27024,80,allow,32457,1499,30958,42,50,16,26
61406,1,0,0,deny,78,78,0,1,0,1,0
49651,53,30768,53,allow,312,94,218,2,29,1,1
59432,445,0,0,drop,66,66,0,1,0,1,0
5938,47968,0,0,allow,60,60,0,1,91,1,0
49667,53,65196,53,allow,183,94,89,2,30,1,1
56140,53,23511,53,allow,195,86,109,2,30,1,1
64913,53,27503,53,allow,183,94,89,2,30,1,1
52199,35549,6211,35549,allow,70,70,0,1,5,1,0
36786,443,50412,443,allow,1798,1223,575,13,26,8,5
35163,30188,0,0,deny,66,66,0,1,0,1,0
64930,53,29648,53,allow,193,102,91,2,29,1,1
49512,53,26273,53,allow,195,102,93,2,30,1,1
64052,53,55826,53,allow,232,102,130,2,30,1,1
52907,445,0,0,drop,70,70,0,1,0,1,0
55024,53,61199,53,allow,174,89,85,2,30,1,1
60892,443,56728,443,allow,22772,8095,14677,46,54,24,22
56803,53,60073,53,allow,190,97,93,2,30,1,1
38143,443,25496,443,allow,84884,5896,78988,128,36,66,62
59883,17637,0,0,deny,66,66,0,1,0,1,0
60873,443,47153,443,allow,60954,33730,27224,101,63,50,51
51518,445,0,0,drop,70,70,0,1,0,1,0
49479,443,58848,443,allow,4591,2492,2099,20,113,11,9
57063,53,6247,53,allow,193,102,91,2,29,1,1
51865,14732,26909,14732,allow,70,70,0,2,7,2,0
51313,64147,0,0,deny,66,66,0,1,0,1,0
54874,445,0,0,drop,70,70,0,1,0,1,0
31017,50584,0,0,deny,62,62,0,1,0,1,0
65071,53,53845,53,allow,411,99,312,4,52,2,2
55725,14704,64431,14704,allow,70,70,0,1,5,1,0
27745,50584,0,0,deny,62,62,0,1,0,1,0
58638,5900,0,0,deny,62,62,0,1,0,1,0
59886,64147,0,0,deny,72,72,0,1,0,1,0
21184,53,21184,53,allow,194,87,107,2,30,1,1
49514,65504,0,0,deny,162,162,0,1,0,1,0
50488,22114,0,0,deny,62,62,0,1,0,1,0
56395,445,0,0,drop,66,66,0,1,0,1,0
6881,6881,0,0,deny,146,146,0,1,0,1,0
60812,445,0,0,drop,70,70,0,1,0,1,0
56637,53,33997,53,allow,199,102,97,2,31,1,1
51146,23117,0,0,deny,66,66,0,1,0,1,0
50675,445,0,0,drop,66,66,0,1,0,1,0
65417,44847,0,0,deny,66,66,0,1,0,1,0
57538,30188,0,0,deny,66,66,0,1,0,1,0
57304,445,0,0,drop,70,70,0,1,0,1,0
35373,443,52870,443,allow,255313,6947,248366,253,123,74,179
40005,36237,0,0,deny,62,62,0,1,0,1,0
49440,53,64789,53,allow,415,88,327,4,52,2,2
58263,5223,22492,5223,allow,3721,1173,2548,18,20,11,7
42298,40040,5414,40040,allow,140,78,62,2,30,1,1
59653,445,0,0,drop,70,70,0,1,0,1,0
53343,445,0,0,drop,70,70,0,1,0,1,0
12969,55777,0,0,deny,66,66,0,1,0,1,0
58411,445,0,0,drop,70,70,0,1,0,1,0
6881,6889,14083,6889,allow,228,118,110,2,1199,1,1
54070,443,51450,443,allow,828875,45659,783216,1020,210,456,564
38495,443,26566,443,allow,7778,1724,6054,29,17,16,13
63642,445,0,0,drop,66,66,0,1,0,1,0
60116,445,0,0,drop,70,70,0,1,0,1,0
59148,443,64998,443,allow,26615,22329,4286,52,272,30,22
57643,28189,0,0,deny,60,60,0,1,0,1,0
35292,8100,23509,8100,allow,78,78,0,1,5,1,0
64368,22114,0,0,deny,66,66,0,1,0,1,0
50489,443,43121,443,allow,8389,1077,7312,24,140,12,12
64040,12226,39321,12226,allow,66,66,0,2,7,2,0
56085,53,34233,53,allow,167,86,81,2,30,1,1
63598,443,20938,443,allow,164604,5676,158928,188,39,70,118
53357,445,0,0,drop,70,70,0,1,0,1,0
60558,51221,0,0,deny,62,62,0,1,0,1,0
63455,445,0,0,drop,70,70,0,1,0,1,0
55925,80,55925,80,allow,450,246,204,8,28,5,3
443,11135,0,0,deny,66,66,0,1,0,1,0
60607,445,0,0,drop,70,70,0,1,0,1,0
6882,6889,19915,6889,allow,492,150,342,2,1200,1,1
52313,80,52313,80,allow,450,246,204,8,29,5,3
27005,27111,57650,27111,allow,893,126,767,2,30,1,1
49359,443,64650,443,allow,63494,7222,56272,107,81,49,58
63985,43081,42263,43081,allow,66,66,0,2,7,2,0
57587,80,57587,80,allow,218150,5323,212827,218,145,69,149
48737,53,48737,53,allow,227,90,137,2,30,1,1
55650,53,4298,53,allow,179,94,85,2,29,1,1
54749,445,0,0,drop,70,70,0,1,0,1,0
58429,443,42456,443,allow,10588,1664,8924,29,631,11,18
50717,80,28545,80,allow,1649,963,686,7,15,5,2
58070,443,16488,443,allow,5041,2002,3039,14,120,7,7
56710,445,0,0,drop,66,66,0,1,0,1,0
7275,9524,0,0,deny,66,66,0,1,0,1,0
56697,53,31729,53,allow,196,100,96,2,31,1,1
64034,53,21913,53,allow,188,96,92,2,31,1,1
10738,50584,0,0,deny,62,62,0,1,0,1,0
443,38956,0,0,deny,82,82,0,1,0,1,0
58687,11392,0,0,deny,62,62,0,1,0,1,0
63697,25010,4091,25010,allow,504,382,122,8,16,6,2
46013,80,29418,80,allow,134,60,74,3,6,2,1
55652,443,58286,443,allow,6672,2258,4414,19,16,10,9
49001,40108,0,0,deny,161,161,0,1,0,1,0
37580,443,1520,443,allow,499,425,74,4,0,3,1
56939,53,27310,53,allow,216,110,106,2,30,1,1
64579,445,0,0,drop,70,70,0,1,0,1,0
55682,32765,50295,32765,allow,3529,1769,1760,11,15,6,5
62895,445,0,0,drop,70,70,0,1,0,1,0
53648,80,65465,80,allow,2162,1608,554,10,34,6,4
64575,53,36717,53,allow,268,110,158,2,31,1,1
51042,445,0,0,drop,70,70,0,1,0,1,0
50387,443,3636,443,allow,2227,1018,1209,17,16,8,9
57888,443,55452,443,allow,113115,8327,104788,184,177,77,107
56588,53,38290,53,allow,305,99,206,4,49,2,2
56795,53,50687,53,allow,177,94,83,2,29,1,1
49333,53,61415,53,allow,392,102,290,2,30,1,1
63112,445,0,0,drop,66,66,0,1,0,1,0
36367,443,61564,443,allow,1209,709,500,14,26,8,6
56091,53,8508,53,allow,771,101,670,2,31,1,1
61430,445,0,0,drop,70,70,0,1,0,1,0
36828,53,40804,53,allow,168,78,90,2,30,1,1
49340,53,57846,53,allow,387,134,253,2,30,1,1
43104,26467,0,0,deny,62,62,0,1,0,1,0
51455,53733,0,0,deny,62,62,0,1,0,1,0
49001,22114,0,0,deny,62,62,0,1,0,1,0
35671,443,43722,443,allow,6824,1142,5682,24,134,13,11
65530,53,49940,53,allow,96,96,0,1,30,1,0
64087,50265,0,0,deny,145,145,0,1,0,1,0
9307,443,6375,443,allow,4458,1022,3436,16,26,9,7
58638,5900,0,0,deny,62,62,0,1,0,1,0
62234,445,0,0,drop,66,66,0,1,0,1,0
55547,445,0,0,drop,70,70,0,1,0,1,0
55955,445,0,0,drop,70,70,0,1,0,1,0
51818,80,64733,80,allow,366,240,126,7,25,5,2
59486,443,24695,443,allow,9161,2202,6959,28,374,14,14
55043,57470,0,0,deny,78,78,0,1,0,1,0
58631,445,0,0,drop,70,70,0,1,0,1,0
53781,36366,2063,36366,allow,70,70,0,1,5,1,0
48785,443,37520,443,allow,6464,1223,5241,25,33,12,13
60750,53,24428,53,allow,198,93,105,2,30,1,1
49001,40108,0,0,deny,161,161,0,1,0,1,0
51839,27256,49193,27256,allow,70,70,0,1,5,1,0
55776,445,0,0,drop,70,70,0,1,0,1,0
53010,443,23300,443,allow,31660,3248,28412,58,93,23,35
65342,53,59254,53,allow,183,94,89,2,30,1,1
59736,445,0,0,drop,70,70,0,1,0,1,0
1045,36237,0,0,deny,66,66,0,1,0,1,0
54563,443,54563,443,allow,109880,24958,84922,154,20,83,71
56289,25174,0,0,deny,66,66,0,1,0,1,0
55346,53,65324,53,allow,177,94,83,2,29,1,1
52052,27427,24815,27427,allow,316,136,180,6,6,3,3
1575,53,0,0,allow,254,86,168,2,30,1,1
55740,8060,29494,8060,allow,70,70,0,2,7,2,0
46987,443,48389,443,allow,3847,2650,1197,22,32,13,9
54216,445,0,0,deny,70,70,0,1,0,1,0
58638,5900,0,0,deny,62,62,0,1,0,1,0
65075,53,5602,53,allow,164,86,78,2,31,1,1
41473,443,44182,443,allow,4987881,144889,4842992,5257,85,1888,3369
64923,25174,0,0,deny,66,66,0,1,0,1,0
55188,443,45668,443,allow,6649,1556,5093,23,24,13,10
39460,23117,0,0,deny,66,66,0,1,0,1,0
64506,53,36287,53,allow,184,86,98,2,30,1,1
35717,443,25554,443,allow,8290,2954,5336,24,361,13,11
49290,53,62128,53,allow,184,94,90,2,30,1,1
55261,53,55428,53,allow,165,86,79,2,29,1,1
65148,53,60062,53,allow,498,204,294,6,29,3,3
50116,22,0,0,deny,60,60,0,1,0,1,0
50642,80,53491,80,allow,27013,3578,23435,36,21,15,21
33543,44847,0,0,deny,66,66,0,1,0,1,0
1025,51221,0,0,deny,62,62,0,1,0,1,0
58968,443,55462,443,allow,4934,1351,3583,21,21,11,10
40489,1433,0,0,deny,60,60,0,1,0,1,0
52310,53,0,0,allow,247,76,171,2,30,1,1
51795,60258,12488,60258,allow,70,70,0,2,8,2,0
44855,58414,0,0,deny,146,146,0,1,0,1,0
55484,443,18380,443,allow,782,428,354,12,25,7,5
55920,25174,0,0,deny,62,62,0,1,0,1,0
49594,445,0,0,drop,70,70,0,1,0,1,0
26900,27017,12614,27017,allow,422,164,258,6,29,3,3
44036,443,28418,443,allow,6599,3950,2649,36,186,20,16
26900,27017,4107,27017,allow,422,164,258,6,29,3,3
65127,443,61568,443,allow,648,648,0,7,15,7,0
26352,53,26352,53,allow,231,90,141,2,31,1,1
29159,39004,0,0,deny,62,62,0,1,0,1,0
48660,21622,0,0,deny,143,143,0,1,0,1,0
49585,53,59933,53,allow,718,94,624,2,30,1,1
50666,80,35544,80,allow,2937,1241,1696,12,22,7,5
55072,53,55776,53,allow,177,94,83,2,30,1,1
62188,445,0,0,drop,70,70,0,1,0,1,0
53479,23,0,0,deny,60,60,0,1,0,1,0
49577,57470,0,0,deny,66,66,0,1,0,1,0
63553,445,0,0,drop,66,66,0,1,0,1,0
63094,53,39482,53,allow,384,166,218,2,30,1,1
64569,53,10194,53,allow,182,93,89,2,31,1,1
51075,80,51075,80,allow,450,246,204,8,26,5,3
55251,53,49536,53,allow,212,110,102,2,30,1,1
6666,990,0,0,deny,60,60,0,1,0,1,0
64333,445,0,0,drop,70,70,0,1,0,1,0
50467,80,31924,80,allow,197269,14917,182352,254,204,107,147
52976,445,0,0,drop,70,70,0,1,0,1,0
53166,80,34843,80,allow,1487,838,649,10,323,6,4
54967,80,54666,80,allow,1848,851,997,10,515,6,4
53406,44847,0,0,deny,66,66,0,1,0,1,0
36456,25174,0,0,deny,146,146,0,1,0,1,0
57470,19641,64041,19641,allow,132,132,0,3,1199,3,0
51164,445,0,0,drop,66,66,0,1,0,1,0
52931,443,64191,443,allow,416,210,206,7,26,4,3
47744,443,50454,443,allow,7761,2376,5385,24,256,12,12
49938,80,5232,80,allow,1130,613,517,11,15,6,5
41166,443,62560,443,allow,8933,1938,6995,21,16,12,9
49176,53,50257,53,allow,528,178,350,6,43,3,3
61002,37965,0,0,deny,145,145,0,1,0,1,0
62109,44847,0,0,deny,66,66,0,1,0,1,0
44981,57470,0,0,deny,66,66,0,1,0,1,0
50022,53,19595,53,allow,182,94,88,2,30,1,1
53987,16571,41017,16571,allow,70,70,0,2,7,2,0
54948,445,0,0,drop,70,70,0,1,0,1,0
55693,45341,22935,45341,allow,70,70,0,1,5,1,0
54557,80,41721,80,allow,2091,799,1292,10,15,6,4
11136,15503,0,0,deny,62,62,0,1,0,1,0
49686,53,47017,53,allow,183,94,89,2,30,1,1
50518,53,60220,53,allow,802,104,698,2,31,1,1
49505,445,0,0,drop,70,70,0,1,0,1,0
50837,445,0,0,drop,70,70,0,1,0,1,0
48555,53,5829,53,allow,215,86,129,2,30,1,1
65444,3389,65444,3389,allow,4305,2521,1784,19,34,10,9
443,54507,0,0,deny,82,82,0,1,0,1,0
54760,445,0,0,drop,70,70,0,1,0,1,0
64654,53,63011,53,allow,240,110,130,2,30,1,1
58902,445,0,0,drop,70,70,0,1,0,1,0
39548,8696,0,0,deny,60,60,0,1,0,1,0
3478,61463,0,0,deny,1273,1273,0,1,0,1,0
12143,56205,0,0,deny,66,66,0,1,0,1,0
58044,443,46397,443,allow,24527,2438,22089,43,329,19,24
42532,22114,0,0,deny,62,62,0,1,0,1,0
58054,445,0,0,drop,70,70,0,1,0,1,0
43166,80,43166,80,allow,26540,1137,25403,36,136,15,21
12694,12446,0,0,deny,62,62,0,1,0,1,0
59315,35440,0,0,deny,66,66,0,1,0,1,0
62108,445,0,0,drop,66,66,0,1,0,1,0
56789,445,0,0,drop,70,70,0,1,0,1,0
15319,51505,0,0,deny,66,66,0,1,0,1,0
9468,80,22561,80,allow,1835,421,1414,9,15,4,5
53562,445,0,0,drop,70,70,0,1,0,1,0
49943,53,18559,53,allow,718,94,624,2,30,1,1
56227,53,50602,53,allow,278,102,176,2,30,1,1
18743,53,18743,53,allow,235,90,145,2,31,1,1
65515,53,15950,53,allow,652,209,443,6,50,3,3
64321,53,14158,53,allow,296,97,199,4,53,2,2
57410,25174,0,0,deny,62,62,0,1,0,1,0
55203,445,0,0,drop,70,70,0,1,0,1,0
57310,443,42139,443,allow,134,60,74,3,6,2,1
43271,50584,0,0,deny,62,62,0,1,0,1,0
56047,445,0,0,drop,70,70,0,1,0,1,0
35047,53,40543,53,allow,214830,214584,246,2594,88,2591,3
55822,53,10353,53,allow,324,126,198,2,30,1,1
53660,443,43128,443,allow,350,210,140,6,24,4,2
50127,64147,0,0,deny,66,66,0,1,0,1,0
58655,445,0,0,drop,66,66,0,1,0,1,0
60889,445,0,0,drop,70,70,0,1,0,1,0
42228,51050,0,0,deny,66,66,0,1,0,1,0
41444,80,42580,80,allow,1000,577,423,10,200,6,4
50767,57470,0,0,deny,62,62,0,1,0,1,0
57345,445,0,0,drop,70,70,0,1,0,1,0
57613,42707,0,0,deny,62,62,0,1,0,1,0
6486,64147,0,0,deny,66,66,0,1,0,1,0
55306,53,39881,53,allow,177,94,83,2,30,1,1
13285,29892,0,0,deny,145,145,0,1,0,1,0
65042,53,25956,53,allow,182,93,89,2,31,1,1
50052,65008,0,0,deny,60,60,0,1,0,1,0
2138,53,2138,53,allow,235,90,145,2,34,1,1
49531,26467,0,0,deny,66,66,0,1,0,1,0
63376,445,0,0,drop,70,70,0,1,0,1,0
63847,45598,22596,45598,allow,376,254,122,6,15,4,2
50316,53,38175,53,allow,753,94,659,2,29,1,1
63872,445,0,0,drop,70,70,0,1,0,1,0
0,0,0,0,allow,124,64,60,2,0,1,1
64611,445,0,0,drop,70,70,0,1,0,1,0
57094,445,0,0,drop,70,70,0,1,0,1,0
58899,443,33038,443,allow,3690,2585,1105,17,16,9,8
63938,3389,63938,3389,allow,3364,1714,1650,15,32,8,7
64607,53,58592,53,allow,211,110,101,2,31,1,1
9140,80,58869,80,allow,49165,1785,47380,56,36,21,35
49418,27018,21489,27018,allow,255,78,177,2,31,1,1
38085,443,21750,443,allow,234,234,0,4,12,4,0
52578,34021,0,0,reset-both,62,62,0,1,0,1,0
59015,445,0,0,drop,70,70,0,1,0,1,0
49883,53,18157,53,allow,170,87,83,2,30,1,1
45151,53,40658,53,allow,168,78,90,2,30,1,1
40906,8434,40906,8434,allow,156,156,0,3,8,3,0
63595,51050,0,0,deny,62,62,0,1,0,1,0
6057,51221,0,0,deny,62,62,0,1,0,1,0
49379,53,28766,53,allow,199,102,97,2,30,1,1
45673,30188,0,0,deny,146,146,0,1,0,1,0
51160,445,0,0,drop,70,70,0,1,0,1,0
49743,445,0,0,drop,70,70,0,1,0,1,0
50637,36237,0,0,deny,66,66,0,1,0,1,0
51817,443,24496,443,allow,2811130,115323,2695807,3382,206,1445,1937
59956,25,59956,25,allow,1867,743,1124,24,16,11,13
59999,443,56048,443,allow,3047,1277,1770,16,144,8,8
23658,18375,0,0,deny,62,62,0,1,0,1,0
55889,53,65516,53,allow,168,86,82,2,30,1,1
55674,445,0,0,drop,70,70,0,1,0,1,0
42298,40029,56928,40029,allow,208,86,122,4,29,2,2
55350,445,0,0,drop,66,66,0,1,0,1,0
55853,53,20879,53,allow,197,102,95,2,29,1,1
59818,445,0,0,drop,66,66,0,1,0,1,0
45064,25174,0,0,deny,62,62,0,1,0,1,0
64077,20208,51700,20208,allow,70,70,0,1,4,1,0
49386,445,0,0,drop,70,70,0,1,0,1,0
4594,35993,0,0,deny,66,66,0,1,0,1,0
54559,445,0,0,drop,70,70,0,1,0,1,0
64407,445,0,0,drop,70,70,0,1,0,1,0
19136,64147,0,0,deny,62,62,0,1,0,1,0
1038,37965,0,0,deny,62,62,0,1,0,1,0
57545,35440,0,0,deny,66,66,0,1,0,1,0
56373,445,0,0,drop,66,66,0,1,0,1,0
58638,5900,58638,5900,allow,66,66,0,1,5,1,0
55075,53,29760,53,allow,178,91,87,2,30,1,1
53684,25933,35129,25933,allow,552,306,246,9,15,5,4
35214,8635,35214,8635,allow,138,78,60,2,5,1,1
51434,445,0,0,drop,70,70,0,1,0,1,0
63685,445,0,0,drop,70,70,0,1,0,1,0
65068,445,0,0,drop,70,70,0,1,0,1,0
0,0,0,0,allow,320,320,0,5,0,5,0
49601,53,44219,53,allow,178,94,84,2,30,1,1
64403,53,23409,53,allow,193,102,91,2,30,1,1
12830,25174,0,0,deny,146,146,0,1,0,1,0
50584,63591,44593,63591,allow,161,161,0,2,1200,2,0
54989,50265,0,0,deny,66,66,0,1,0,1,0
51726,64147,0,0,deny,66,66,0,1,0,1,0
49699,53,49094,53,allow,209,110,99,2,30,1,1
50339,445,0,0,drop,70,70,0,1,0,1,0
60945,443,30602,443,allow,7771,2691,5080,34,28,19,15
54860,445,0,0,drop,66,66,0,1,0,1,0
54796,22114,0,0,deny,66,66,0,1,0,1,0
54610,443,65041,443,allow,9948,2463,7485,41,27,22,19
52009,443,21173,443,allow,10339,2028,8311,28,46,16,12
58866,53,56575,53,allow,355,118,237,2,29,1,1
49623,53,34250,53,allow,790,110,680,2,29,1,1
50862,445,0,0,drop,70,70,0,1,0,1,0
57470,51413,6363,51413,allow,493,166,327,2,1200,1,1
52976,445,0,0,drop,70,70,0,1,0,1,0
56186,53,1999,53,allow,196,100,96,2,31,1,1
58638,5900,0,0,deny,62,62,0,1,0,1,0
27005,31000,15120,31000,allow,898,126,772,2,30,1,1
53459,445,0,0,drop,70,70,0,1,0,1,0
57021,443,20461,443,allow,227559,47160,180399,379,143,187,192
40967,1433,0,0,deny,60,60,0,1,0,1,0
28010,443,22569,443,allow,5515,1388,4127,18,15,9,9
42465,57470,0,0,deny,60,60,0,1,0,1,0
61158,443,55712,443,allow,12854,2237,10617,47,638,19,28
5087,22114,0,0,deny,66,66,0,1,0,1,0
56922,53,43765,53,allow,86,86,0,1,30,1,0
61560,445,0,0,drop,70,70,0,1,0,1,0
61387,443,3059,443,allow,12231,6846,5385,38,160,19,19
30129,37965,0,0,deny,72,72,0,1,0,1,0
49699,53,23875,53,allow,202,103,99,2,31,1,1
53824,41482,6861,41482,allow,70,70,0,1,4,1,0
2267,53,17239,53,allow,204,118,86,2,31,1,1
55631,443,48681,443,allow,17521,3850,13671,30,121,13,17
63567,443,49835,443,allow,2467,1198,1269,22,186,11,11
53654,53,13764,53,allow,523,85,438,4,31,2,2
28470,80,28470,80,allow,355544,12402,343142,378,26,134,244
53470,445,0,0,drop,70,70,0,1,0,1,0
61080,445,0,0,drop,66,66,0,1,0,1,0
64413,443,46827,443,allow,5660875,75934,5584941,4719,141,686,4033
59944,80,51806,80,allow,1186,390,796,9,16,5,4
62820,53,62820,53,allow,237,91,146,2,33,1,1
63701,46824,0,0,deny,66,66,0,1,0,1,0
0,0,0,0,allow,600,306,294,6,0,3,3
57315,53,60318,53,allow,748,95,653,2,30,1,1
56035,53,45102,53,allow,173,94,79,2,30,1,1
59668,50584,0,0,deny,66,66,0,1,0,1,0
51604,443,37096,443,allow,7086,2173,4913,20,16,10,10
56075,443,56807,443,allow,5640,3241,2399,22,120,11,11
35291,44847,0,0,deny,66,66,0,1,0,1,0
49160,38552,12049,38552,allow,868,150,718,4,1200,2,2
58638,5900,0,0,deny,62,62,0,1,0,1,0
53928,15503,0,0,deny,62,62,0,1,0,1,0
60232,445,0,0,drop,70,70,0,1,0,1,0
27005,30007,42736,30007,allow,890,126,764,2,31,1,1
24311,22617,0,0,deny,60,60,0,1,0,1,0
57132,445,0,0,drop,70,70,0,1,0,1,0
61887,443,28383,443,allow,81136,7785,73351,109,131,40,69
60276,445,0,0,drop,70,70,0,1,0,1,0
50033,53,63649,53,allow,533,184,349,6,76,3,3
56668,443,3930,443,allow,8005,1985,6020,20,15,11,9
56161,62413,0,0,deny,66,66,0,1,0,1,0
59849,443,38799,443,allow,8368,1360,7008,19,18,7,12
49323,53,60402,53,allow,210,110,100,2,31,1,1
65197,445,0,0,drop,66,66,0,1,0,1,0
65162,53,50444,53,allow,328,102,226,2,30,1,1
52745,57866,0,0,deny,62,62,0,1,0,1,0
50106,53,56744,53,allow,296,94,202,2,30,1,1
42608,1,0,0,deny,62,62,0,1,0,1,0
59430,50584,0,0,deny,66,66,0,1,0,1,0
49620,53,15285,53,allow,211,110,101,2,30,1,1
33324,42873,0,0,deny,62,62,0,1,0,1,0
26494,26467,0,0,deny,62,62,0,1,0,1,0
64585,53,55669,53,allow,210,110,100,2,30,1,1
39918,443,58004,443,allow,7542,1235,6307,23,15,12,11
53141,443,52504,443,allow,37389,3972,33417,69,133,32,37
48135,443,38274,443,allow,6426,1858,4568,22,16,12,10
2919,37965,0,0,deny,62,62,0,1,0,1,0
27005,1108,29177,1108,allow,873,126,747,2,30,1,1
50619,80,32397,80,allow,499,192,307,6,26,4,2
41643,443,51338,443,allow,16032,13508,2524,37,36,19,18
36067,443,36067,443,allow,228681,29484,199197,303,110,149,154
55429,443,27216,443,allow,343735,15691,328044,423,171,179,244
50974,11392,0,0,deny,66,66,0,1,0,1,0
56314,53,50014,53,allow,183,94,89,2,30,1,1
12545,25174,0,0,deny,62,62,0,1,0,1,0
49897,445,0,0,drop,66,66,0,1,0,1,0
51891,80,21420,80,allow,7434,3830,3604,17,30,9,8
64538,53,8098,53,allow,194,102,92,2,29,1,1
64710,53,5594,53,allow,195,102,93,2,29,1,1
9235,80,17442,80,allow,318,192,126,6,26,4,2
50523,445,0,0,drop,70,70,0,1,0,1,0
49351,53,27652,53,allow,166,86,80,2,30,1,1
51641,443,64110,443,allow,4692,2882,1810,32,80,14,18
64244,53,63345,53,allow,199,102,97,2,31,1,1
64032,445,0,0,drop,70,70,0,1,0,1,0
48040,53,11212,53,allow,168,78,90,2,30,1,1
41279,443,39948,443,allow,8119,1411,6708,20,200,11,9
57433,21247,0,0,deny,66,66,0,1,0,1,0
52747,445,0,0,drop,66,66,0,1,0,1,0
50187,445,0,0,drop,70,70,0,1,0,1,0
7109,64147,0,0,deny,62,62,0,1,0,1,0
55672,445,0,0,drop,70,70,0,1,0,1,0
64723,53,15149,53,allow,229,110,119,2,30,1,1
50547,445,0,0,drop,70,70,0,1,0,1,0
54343,445,0,0,drop,70,70,0,1,0,1,0
64631,53,41468,53,allow,186,95,91,2,31,1,1
53023,445,0,0,drop,66,66,0,1,0,1,0
51685,80,11134,80,allow,1516,481,1035,11,15,6,5
63086,53,16338,53,allow,512,166,346,2,30,1,1
27160,64147,0,0,deny,66,66,0,1,0,1,0
51135,443,21022,443,allow,640504,257235,383269,1476,797,643,833
19004,51505,0,0,deny,66,66,0,1,0,1,0
52328,443,52328,443,allow,5438,2255,3183,23,86,12,11
56272,53,41462,53,allow,193,102,91,2,30,1,1
47523,443,49117,443,allow,429929,11379,418550,456,21,174,282
55088,53,55518,53,allow,193,102,91,2,30,1,1
50077,53,51701,53,allow,261,97,164,4,44,2,2
5239,6064,8462,6064,allow,217199,128,217071,316,37,3,313
64540,445,0,0,drop,70,70,0,1,0,1,0
41639,8080,18114,8080,allow,78,78,0,2,8,2,0
57195,53,47926,53,allow,195,102,93,2,33,1,1
57127,53,61936,53,allow,193,102,91,2,31,1,1
55786,53,65115,53,allow,186,95,91,2,31,1,1
59379,443,58325,443,allow,4518,1784,2734,30,23,15,15
9287,443,31377,443,allow,5539,1486,4053,21,23,11,10
59171,445,0,0,drop,66,66,0,1,0,1,0
63493,445,0,0,drop,70,70,0,1,0,1,0
65153,38303,0,0,deny,62,62,0,1,0,1,0
60001,445,0,0,drop,66,66,0,1,0,1,0
47289,443,7853,443,allow,16114,7882,8232,37,104,15,22
26183,22114,0,0,deny,62,62,0,1,0,1,0
60513,443,43919,443,allow,9047,2015,7032,25,39,13,12
65219,445,0,0,drop,70,70,0,1,0,1,0
62960,445,0,0,drop,70,70,0,1,0,1,0
50936,80,62610,80,allow,10423067,111935,10311132,8558,119,1601,6957
58938,445,0,0,drop,70,70,0,1,0,1,0
37648,443,15216,443,allow,9618,7387,2231,30,26,18,12
51506,443,52823,443,allow,584947,21842,563105,678,36,286,392
45122,15000,56634,15000,allow,130,70,60,2,5,1,1
59912,443,31539,443,allow,7763,1354,6409,25,82,13,12
64252,53,2109,53,allow,199,102,97,2,29,1,1
63603,445,0,0,drop,70,70,0,1,0,1,0
56755,443,40162,443,allow,8059,2039,6020,20,15,11,9
57150,53,60378,53,allow,177,94,83,2,29,1,1
38524,443,15396,443,allow,5846879,177697,5669182,6043,41,2261,3782
40672,443,9807,443,allow,9150,2155,6995,38,295,15,23
44569,3389,0,0,deny,60,60,0,1,0,1,0
50540,80,53400,80,allow,2175,1539,636,13,27,8,5
56173,37807,0,0,deny,62,62,0,1,0,1,0
53677,10657,55902,10657,allow,70,70,0,1,4,1,0
56964,53,57920,53,allow,179,94,85,2,30,1,1
50973,445,0,0,drop,70,70,0,1,0,1,0
1955,53,1955,53,allow,216,89,127,2,30,1,1
62364,445,0,0,drop,66,66,0,1,0,1,0
50307,443,50307,443,allow,4378,1471,2907,19,30,11,8
54525,80,24122,80,allow,50436663,1205750,49230913,49415,198,16827,32588
50497,53,25431,53,allow,747,93,654,2,30,1,1
55680,445,0,0,drop,66,66,0,1,0,1,0
62709,57470,0,0,deny,62,62,0,1,0,1,0
56119,37965,0,0,deny,62,62,0,1,0,1,0
43303,443,47473,443,allow,6448,1982,4466,22,16,11,11
58914,53,2441,53,allow,244,86,158,2,30,1,1
53610,443,29299,443,allow,3096,962,2134,13,135,6,7
56579,53,34186,53,allow,711,87,624,2,30,1,1
28238,443,59283,443,allow,8456,3501,4955,20,90,11,9
27005,27013,23327,27013,allow,869,126,743,2,30,1,1
64924,53,58224,53,allow,747,93,654,2,31,1,1
19875,30170,0,0,deny,145,145,0,1,0,1,0
56019,53,13898,53,allow,194,102,92,2,30,1,1
59951,80,3769,80,allow,1221,339,882,9,16,5,4
51823,15843,1473,15843,allow,70,70,0,1,5,1,0
64687,53,62553,53,allow,182,93,89,2,31,1,1
54614,443,21022,443,allow,36109,16793,19316,62,19,32,30
65304,53,22589,53,allow,308,97,211,4,33,2,2
47276,443,53172,443,allow,190,70,120,4,15,2,2
5690,23,0,0,deny,60,60,0,1,0,1,0
49512,53,60222,53,allow,195,102,93,2,31,1,1
56326,56205,0,0,deny,66,66,0,1,0,1,0
49700,80,32872,80,allow,56411,2447,53964,58,130,19,39
27005,27016,25389,27016,allow,1006,252,754,4,32,3,1
46839,51050,0,0,deny,62,62,0,1,0,1,0
34422,64147,0,0,deny,145,145,0,1,0,1,0
44546,32468,0,0,deny,146,146,0,1,0,1,0
24411,12809,0,0,deny,60,60,0,1,0,1,0
56654,443,29055,443,allow,18544,4402,14142,31,191,14,17
58398,445,0,0,drop,70,70,0,1,0,1,0
35111,22114,0,0,deny,66,66,0,1,0,1,0
22327,53,22327,53,allow,237,91,146,2,32,1,1
63651,443,19234,443,allow,333668,12291,321377,321,170,72,249
65206,53,9006,53,allow,762,98,664,2,30,1,1
57217,445,0,0,drop,70,70,0,1,0,1,0
48778,443,13282,443,allow,6770,2047,4723,26,16,14,12
57201,53,63092,53,allow,195,102,93,2,30,1,1
58638,5900,0,0,deny,62,62,0,1,0,1,0
64923,25174,0,0,deny,66,66,0,1,0,1,0
49548,53,2066,53,allow,263,102,161,2,29,1,1
53044,36237,0,0,deny,66,66,0,1,0,1,0
28649,43890,0,0,deny,62,62,0,1,0,1,0
60324,443,7520,443,allow,1743,1164,579,16,25,10,6
55716,445,0,0,drop,70,70,0,1,0,1,0
50688,53,22980,53,allow,78,78,0,1,30,1,0
58917,445,0,0,drop,70,70,0,1,0,1,0
28809,50584,0,0,deny,66,66,0,1,0,1,0
48817,8999,48817,8999,allow,512,158,354,2,1200,1,1
56273,53,51229,53,allow,197,102,95,2,33,1,1
43444,53,43444,53,allow,314,98,216,2,30,1,1
55132,445,0,0,drop,70,70,0,1,0,1,0
43482,443,29764,443,allow,2316,1280,1036,20,278,11,9
50690,443,9122,443,allow,152,86,66,2,4,1,1
54958,445,0,0,drop,70,70,0,1,0,1,0
59762,80,15903,80,allow,1278,774,504,12,361,7,5
49491,443,61216,443,allow,33157,17446,15711,66,135,38,28
59201,51221,0,0,deny,66,66,0,1,0,1,0
60523,443,60523,443,allow,1088,641,447,10,25,6,4
49980,53,10608,53,allow,503,103,400,4,47,2,2
32491,15503,0,0,deny,66,66,0,1,0,1,0
58751,9571,0,0,deny,62,62,0,1,0,1,0
52568,80,52568,80,allow,16474,1881,14593,28,143,12,16
52091,4789,12478,4789,allow,70,70,0,2,7,2,0
52034,80,13450,80,allow,4185,3462,723,14,16,7,7
60753,40010,14923,40010,allow,316,136,180,6,6,3,3
65384,53,46519,53,allow,197,102,95,2,33,1,1
50353,443,15424,443,allow,1775,169,1606,7,121,3,4
8889,26330,0,0,deny,60,60,0,1,0,1,0
52777,80,21198,80,allow,432,240,192,8,100,5,3
64904,53,57832,53,allow,199,102,97,2,29,1,1
36144,443,36144,443,allow,170890,13800,157090,246,97,123,123
57470,54343,65136,54343,allow,330,330,0,6,1200,6,0
56720,53,7909,53,allow,177,94,83,2,30,1,1
30179,57470,0,0,deny,60,60,0,1,0,1,0
50352,80,51125,80,allow,2537,783,1754,13,25,7,6
56177,53,3037,53,allow,807,94,713,2,31,1,1
55187,445,0,0,drop,70,70,0,1,0,1,0
55018,53,31411,53,allow,174,89,85,2,30,1,1
59195,445,0,0,drop,66,66,0,1,0,1,0
56951,53,31366,53,allow,168,86,82,2,29,1,1
63867,64147,0,0,deny,62,62,0,1,0,1,0
33462,53,33462,53,allow,256,114,142,2,30,1,1
49246,53,24337,53,allow,779,86,693,2,30,1,1
49691,443,33512,443,allow,1183,659,524,13,56,7,6
42252,33303,0,0,deny,60,60,0,1,0,1,0
52441,445,0,0,drop,70,70,0,1,0,1,0
49368,443,28033,443,allow,5224,1560,3664,15,165,9,6
49402,53,18505,53,allow,214,110,104,2,30,1,1
54368,443,18976,443,allow,10707,2548,8159,27,39,15,12
27005,27019,17502,27019,allow,873,126,747,2,30,1,1
50906,80,26380,80,allow,13949172,164502,13784670,11537,135,2287,9250
57262,53,58338,53,allow,180,94,86,2,30,1,1
53244,445,0,0,drop,66,66,0,1,0,1,0
55675,53,52778,53,allow,764,99,665,2,31,1,1
30039,7363,0,0,deny,145,145,0,1,0,1,0
58999,53,58999,53,allow,825,99,726,2,30,1,1
63165,445,0,0,drop,70,70,0,1,0,1,0
39133,5223,14877,5223,allow,4113,1213,2900,22,713,12,10
27005,1305,58083,1305,allow,855,126,729,2,29,1,1
56498,80,33330,80,allow,174021,11443,162578,197,63,81,116
9552,57470,0,0,deny,66,66,0,1,0,1,0
63998,21247,0,0,deny,62,62,0,1,0,1,0
58638,5900,0,0,deny,62,62,0,1,0,1,0
50081,443,6983,443,allow,18754,5240,13514,31,16,15,16
51087,445,0,0,drop,70,70,0,1,0,1,0
55003,53,14075,53,allow,192,98,94,2,31,1,1
50353,80,65364,80,allow,8007,830,7177,17,30,8,9
58638,5900,58638,5900,allow,160,66,94,2,9,1,1
61691,445,0,0,drop,70,70,0,1,0,1,0
27005,27018,6738,27018,allow,888,126,762,2,30,1,1
56491,443,52771,443,allow,6066,1016,5050,20,26,11,9
39119,53,39119,53,allow,221,89,132,2,30,1,1
44847,6881,59803,6881,allow,484,150,334,2,1200,1,1
64205,53,39534,53,allow,327,88,239,4,52,2,2
49646,53,51164,53,allow,353,118,235,2,30,1,1
50945,80,50945,80,allow,78911,2499,76412,88,26,32,56
55669,53,15952,53,allow,177,94,83,2,30,1,1
993,58185,0,0,deny,129,129,0,1,0,1,0
49300,443,26110,443,allow,8282,3240,5042,40,255,20,20
61563,37807,0,0,deny,66,66,0,1,0,1,0
42298,40013,31078,40013,allow,140,78,62,2,30,1,1
49825,53,31559,53,allow,168,86,82,2,29,1,1
56730,53,30044,53,allow,170,87,83,2,31,1,1
50323,80,57798,80,allow,2074,793,1281,11,48,6,5
32975,443,44703,443,allow,4648,1885,2763,20,95,10,10
49418,27015,49804,27015,allow,248,78,170,2,30,1,1
57707,53,34372,53,allow,70,70,0,1,30,1,0
37183,443,43656,443,allow,9631,4184,5447,33,271,17,16
53723,443,16354,443,allow,499,425,74,4,0,3,1
39818,443,44736,443,allow,2211,1181,1030,23,40,11,12
55677,16588,6838,16588,allow,70,70,0,1,5,1,0
55809,443,47324,443,allow,62,62,0,1,4,1,0
57835,53,49650,53,allow,308,118,190,2,29,1,1
52652,445,0,0,drop,66,66,0,1,0,1,0
49646,443,41538,443,allow,5647,1832,3815,16,36,9,7
60488,27615,38598,27615,allow,70,70,0,1,5,1,0
60605,3389,0,0,deny,60,60,0,1,0,1,0
48422,53,48422,53,allow,229,89,140,2,30,1,1
46573,50584,0,0,deny,66,66,0,1,0,1,0
6881,6881,57384,6881,allow,238,118,120,2,1200,1,1
62624,443,17860,443,allow,6990,2057,4933,19,121,9,10
58638,5900,0,0,deny,62,62,0,1,0,1,0
60936,445,0,0,drop,70,70,0,1,0,1,0
50986,445,0,0,drop,70,70,0,1,0,1,0
53149,445,0,0,drop,70,70,0,1,0,1,0
46116,57470,0,0,deny,74,74,0,1,0,1,0
64813,53,46374,53,allow,177,94,83,2,30,1,1
52049,445,0,0,drop,70,70,0,1,0,1,0
49655,443,28580,443,allow,50533,7291,43242,74,61,34,40
36712,53,0,0,allow,139,70,69,2,30,1,1
39820,443,46872,443,allow,2190,1249,941,23,26,12,11
56627,445,0,0,drop,66,66,0,1,0,1,0
58463,11392,0,0,deny,66,66,0,1,0,1,0
52135,46475,48450,46475,allow,70,70,0,2,8,2,0
63704,445,0,0,drop,70,70,0,1,0,1,0
50967,443,62336,443,allow,5841,1986,3855,19,17,11,8
28914,26296,0,0,deny,159,159,0,1,0,1,0
62697,445,0,0,drop,70,70,0,1,0,1,0
60070,44847,0,0,deny,66,66,0,1,0,1,0
57226,51505,0,0,deny,66,66,0,1,0,1,0
27005,27015,43397,27015,allow,884,126,758,2,30,1,1
59665,445,0,0,drop,66,66,0,1,0,1,0
49358,443,2362,443,allow,9482,4710,4772,19,16,11,8
49990,53,60528,53,allow,198,102,96,2,30,1,1
5588,5588,0,0,allow,3354,1792,1562,46,194,23,23
54523,445,0,0,drop,70,70,0,1,0,1,0
55232,53,8300,53,allow,177,94,83,2,30,1,1
30574,64147,0,0,deny,62,62,0,1,0,1,0
60306,443,28741,443,allow,9188,3421,5767,43,83,19,24
58435,445,0,0,drop,66,66,0,1,0,1,0
54360,443,12392,443,allow,7723,2282,5441,22,255,11,11
52080,445,0,0,drop,70,70,0,1,0,1,0
22205,443,22205,443,allow,10793,2049,8744,23,30,14,9
62896,445,0,0,drop,70,70,0,1,0,1,0
50645,53,27805,53,allow,177,94,83,2,30,1,1
50428,445,0,0,drop,70,70,0,1,0,1,0
56681,53,9758,53,allow,195,102,93,2,30,1,1
59374,51505,0,0,deny,62,62,0,1,0,1,0
61700,445,0,0,drop,70,70,0,1,0,1,0
27005,27017,42794,27017,allow,880,126,754,2,30,1,1
52077,80,35958,80,allow,366,240,126,7,26,5,2
27005,30009,8020,30009,allow,889,126,763,3,31,2,1
56381,25174,0,0,deny,62,62,0,1,0,1,0
56625,53,48390,53,allow,193,102,91,2,29,1,1
63905,19899,5860,19899,allow,312,132,180,6,7,3,3
49418,27001,35049,27001,allow,256,78,178,2,30,1,1
6881,55981,51460,55981,allow,228,118,110,2,1200,1,1
13859,53,13859,53,allow,215,98,117,2,30,1,1
63347,25174,0,0,deny,66,66,0,1,0,1,0
55134,53,55976,53,allow,214,110,104,2,31,1,1
50292,22114,0,0,deny,62,62,0,1,0,1,0
33229,443,52661,443,allow,2161,1231,930,17,180,9,8
60319,80,61391,80,allow,194,128,66,4,25,3,1
2180,63710,0,0,deny,66,66,0,1,0,1,0
34417,53,11898,53,allow,168,78,90,2,30,1,1
58367,445,0,0,drop,70,70,0,1,0,1,0
49418,27444,10177,27444,allow,258,78,180,2,30,1,1
63753,445,0,0,drop,70,70,0,1,0,1,0
55558,445,0,0,drop,70,70,0,1,0,1,0
65067,53,2919,53,allow,214,110,104,2,30,1,1
51427,445,0,0,drop,70,70,0,1,0,1,0
60498,443,60498,443,allow,8233,948,7285,18,30,10,8
57028,8080,10225,8080,allow,78,78,0,2,8,2,0
60586,445,0,0,drop,70,70,0,1,0,1,0
25237,57470,0,0,deny,62,62,0,1,0,1,0
53966,57470,0,0,deny,62,62,0,1,0,1,0
57293,443,21825,443,allow,5161,2421,2740,14,122,7,7
64379,445,0,0,drop,70,70,0,1,0,1,0
60303,443,13935,443,allow,3928,2467,1461,27,144,14,13
27005,27015,46152,27015,allow,875,126,749,2,30,1,1
63970,28423,20673,28423,allow,564,382,182,9,15,6,3
56548,53,18583,53,allow,199,102,97,2,30,1,1
50400,443,40237,443,allow,316,136,180,6,6,3,3
50412,445,0,0,drop,66,66,0,1,0,1,0
55619,445,0,0,drop,70,70,0,1,0,1,0
58254,80,49705,80,allow,1151,711,440,10,15,5,5
65292,53,10766,53,allow,385,106,279,4,33,2,2
3478,61463,0,0,deny,1053,1053,0,1,0,1,0
28858,80,28858,80,allow,83253,4938,78315,99,26,39,60
50245,44847,0,0,deny,62,62,0,1,0,1,0
32551,51221,0,0,deny,66,66,0,1,0,1,0
21399,35440,0,0,deny,146,146,0,1,0,1,0
50803,443,13145,443,allow,98472,44922,53550,491,658,181,310
51783,50584,0,0,deny,66,66,0,1,0,1,0
59232,445,0,0,drop,70,70,0,1,0,1,0
65215,445,0,0,drop,66,66,0,1,0,1,0
54150,443,60800,443,allow,230997,10675,220322,291,75,122,169
50533,445,0,0,drop,66,66,0,1,0,1,0
10008,40004,11500,40004,allow,156,94,62,2,30,1,1
56374,53,38425,53,allow,770,102,668,2,31,1,1
56261,53,22541,53,allow,184,94,90,2,31,1,1
49812,53,21383,53,allow,164,84,80,2,31,1,1
56631,53,31631,53,allow,199,94,105,2,30,1,1
58220,445,0,0,drop,70,70,0,1,0,1,0
7318,443,16542,443,allow,6458,2658,3800,34,255,16,18
58638,5900,0,0,deny,62,62,0,1,0,1,0
64239,445,0,0,drop,66,66,0,1,0,1,0
62696,50584,0,0,deny,62,62,0,1,0,1,0
55358,445,0,0,drop,70,70,0,1,0,1,0
53298,26467,0,0,deny,62,62,0,1,0,1,0
36685,443,19672,443,allow,10753,1585,9168,24,120,10,14
60272,443,24375,443,allow,1853,1214,639,18,87,11,7
56119,46824,0,0,deny,62,62,0,1,0,1,0
65437,53,6994,53,allow,173,94,79,2,30,1,1
56951,53,51481,53,allow,250,86,164,4,31,2,2
61939,445,0,0,drop,70,70,0,1,0,1,0
50934,80,52977,80,allow,10213447,100765,10112682,8215,121,1412,6803
5431,53,5431,53,allow,224,88,136,2,31,1,1
52359,23,0,0,deny,60,60,0,1,0,1,0
6881,55980,18375,55980,allow,226,118,108,2,1199,1,1
50038,53,4648,53,allow,281,78,203,2,31,1,1
51949,5484,1068,5484,allow,70,70,0,2,8,2,0
52131,443,17836,443,allow,6565,1251,5314,27,31,14,13
56975,53,53582,53,allow,194,99,95,2,30,1,1
49234,53,44202,53,allow,167,86,81,2,30,1,1
53276,80,53276,80,allow,42664,1998,40666,53,27,20,33
55641,445,0,0,drop,70,70,0,1,0,1,0
55534,80,1439,80,allow,3335,2314,1021,19,38,11,8
65008,53,11411,53,allow,276,118,158,2,29,1,1
64128,53,50271,53,allow,606,182,424,6,71,3,3
55700,53,12317,53,allow,337,110,227,2,30,1,1
58766,443,24380,443,allow,6031,770,5261,18,15,8,10
50920,445,0,0,drop,70,70,0,1,0,1,0
65492,443,42698,443,allow,92573,4519,88054,105,16,39,66
49543,53,5363,53,allow,200,102,98,2,30,1,1
39186,443,31509,443,allow,8126,2183,5943,29,270,14,15
40204,40034,20615,40034,allow,164,102,62,2,30,1,1
68,67,0,0,deny,346,346,0,1,0,1,0
2717,31573,0,0,deny,62,62,0,1,0,1,0
57615,80,57615,80,allow,126266,7980,118286,126,25,37,89
64509,9571,0,0,deny,62,62,0,1,0,1,0
51501,443,62787,443,allow,10861,5281,5580,65,49,33,32
58638,5900,0,0,deny,62,62,0,1,0,1,0
5826,26467,0,0,deny,62,62,0,1,0,1,0
55002,53,6216,53,allow,196,102,94,2,30,1,1
52687,445,0,0,drop,70,70,0,1,0,1,0
12942,10387,0,0,deny,159,159,0,1,0,1,0
49534,53,40703,53,allow,193,102,91,2,29,1,1
53162,60352,6170,60352,allow,70,70,0,1,5,1,0
10949,22114,0,0,deny,62,62,0,1,0,1,0
58973,57470,0,0,deny,66,66,0,1,0,1,0
21133,27613,37990,27613,allow,481,150,331,2,1199,1,1
55572,445,0,0,drop,70,70,0,1,0,1,0
51918,445,0,0,drop,66,66,0,1,0,1,0
9253,443,42267,443,allow,6135,770,5365,17,26,9,8
42951,22114,0,0,deny,66,66,0,1,0,1,0
53460,443,30062,443,allow,30688,2660,28028,51,31,23,28
34305,80,22535,80,allow,2443,1794,649,11,76,6,5
1026,57866,0,0,deny,146,146,0,1,0,1,0
53750,27352,21637,27352,allow,70,70,0,2,8,2,0
49562,443,58637,443,allow,9908,4692,5216,30,92,16,14
53146,50393,21783,50393,allow,70,70,0,2,8,2,0
45981,51505,0,0,deny,146,146,0,1,0,1,0
56368,445,0,0,drop,70,70,0,1,0,1,0
27316,443,39777,443,allow,9439,1890,7549,29,67,14,15
65438,445,0,0,deny,70,70,0,1,0,1,0
58889,443,6054,443,allow,7871,5455,2416,24,18,13,11
57000,80,51268,80,allow,214,140,74,4,35,3,1
56297,53,58728,53,allow,168,86,82,2,30,1,1
64914,53,14005,53,allow,224,94,130,2,30,1,1
59977,30188,0,0,deny,66,66,0,1,0,1,0
51412,443,35247,443,allow,200230,8733,191497,250,122,106,144
1024,9319,0,0,deny,62,62,0,1,0,1,0
26229,21247,0,0,deny,66,66,0,1,0,1,0
19473,13315,3345,13315,allow,460,150,310,2,1200,1,1
58257,445,0,0,drop,70,70,0,1,0,1,0
6881,41872,4010,41872,allow,509,150,359,2,1200,1,1
56456,53,39368,53,allow,199,102,97,2,30,1,1
57370,445,0,0,drop,70,70,0,1,0,1,0
55266,445,0,0,drop,70,70,0,1,0,1,0
55613,445,0,0,drop,70,70,0,1,0,1,0
50447,443,44649,443,allow,12362,3372,8990,34,143,18,16
59455,445,0,0,drop,70,70,0,1,0,1,0
55281,53,41810,53,allow,236,94,142,2,30,1,1
64036,53,62200,53,allow,183,94,89,2,29,1,1
63625,445,0,0,drop,70,70,0,1,0,1,0
65233,445,0,0,drop,70,70,0,1,0,1,0
58638,5900,0,0,deny,62,62,0,1,0,1,0
11988,48817,0,0,deny,66,66,0,1,0,1,0
52201,445,0,0,drop,70,70,0,1,0,1,0
63596,443,27876,443,allow,8104,2201,5903,28,135,15,13
39945,80,32105,80,allow,1948,728,1220,11,150,6,5
64850,53,36878,53,allow,196,102,94,2,31,1,1
49814,53,14666,53,allow,189,102,87,2,30,1,1
49214,53,64649,53,allow,227,102,125,2,30,1,1
49480,53,12824,53,allow,184,94,90,2,30,1,1
53874,445,0,0,drop,70,70,0,1,0,1,0
33328,25174,0,0,deny,62,62,0,1,0,1,0
53354,445,0,0,drop,70,70,0,1,0,1,0
49224,53,51489,53,allow,199,102,97,2,34,1,1
54520,445,0,0,drop,66,66,0,1,0,1,0
58638,5900,0,0,deny,62,62,0,1,0,1,0
27005,27015,38552,27015,allow,876,126,750,2,31,1,1
56429,53,7462,53,allow,762,98,664,2,31,1,1
63433,445,0,0,drop,70,70,0,1,0,1,0
4041,50584,0,0,deny,62,62,0,1,0,1,0
2267,53,18938,53,allow,204,118,86,2,30,1,1
55080,53,13972,53,allow,165,86,79,2,29,1,1
56709,443,54114,443,allow,8007,1987,6020,20,15,11,9
65504,53,13937,53,allow,216,94,122,2,30,1,1
52029,445,0,0,drop,70,70,0,1,0,1,0
65377,53,29691,53,allow,193,102,91,2,30,1,1
56000,53,8849,53,allow,177,94,83,2,31,1,1
51419,443,59979,443,allow,13049,4849,8200,31,31,15,16
50888,80,61019,80,allow,538995,15959,523036,552,140,201,351
52405,443,59113,443,allow,10506,2063,8443,31,46,17,14
57544,7000,57544,7000,allow,3502,1935,1567,15,15,8,7
50818,445,0,0,drop,70,70,0,1,0,1,0
52202,64241,19062,64241,allow,250,66,184,4,9,2,2
7701,80,7701,80,allow,900,519,381,7,141,4,3
55619,42873,30146,42873,allow,422,140,282,6,16,3,3
34434,80,45920,80,allow,2913,633,2280,15,15,8,7
49729,53,55522,53,allow,210,102,108,2,30,1,1
49455,445,0,0,drop,66,66,0,1,0,1,0
58421,30188,0,0,deny,66,66,0,1,0,1,0
63933,443,50085,443,allow,6822,3370,3452,21,135,10,11
57382,2258,57382,2258,allow,156,156,0,3,8,3,0
54924,3478,45480,3478,allow,452,280,172,5,30,3,2
50116,443,45796,443,allow,48255,4798,43457,100,149,47,53
56434,53,56434,53,allow,243,94,149,2,32,1,1
54666,36237,0,0,deny,66,66,0,1,0,1,0
49577,57470,0,0,deny,62,62,0,1,0,1,0
64356,445,0,0,drop,66,66,0,1,0,1,0
60355,445,0,0,drop,66,66,0,1,0,1,0
56696,443,27730,443,allow,3140,1782,1358,18,17,10,8
47050,443,20550,443,allow,10868,2200,8668,32,44,14,18
55145,445,0,0,drop,66,66,0,1,0,1,0
49553,53,5635,53,allow,614,239,375,6,53,3,3
53527,443,25088,443,allow,127391,26326,101065,179,172,76,103
58230,64147,0,0,deny,66,66,0,1,0,1,0
49890,53,63142,53,allow,767,102,665,2,30,1,1
54036,443,30085,443,allow,43295,8391,34904,66,49,32,34
65200,53,50135,53,allow,214,110,104,2,30,1,1
56714,443,39694,443,allow,8057,2037,6020,20,15,11,9
55342,53,57972,53,allow,994,86,908,2,30,1,1
51420,443,42852,443,allow,7653,1188,6465,21,16,12,9
55532,80,33980,80,allow,12971,971,12000,22,15,12,10
49206,12242,32509,12242,allow,70,70,0,2,8,2,0
60537,445,0,0,drop,66,66,0,1,0,1,0
59573,443,39847,443,allow,289380,13628,275752,335,70,142,193
42298,40018,26921,40018,allow,148,86,62,2,30,1,1
51897,57057,49158,57057,allow,70,70,0,2,8,2,0
64169,53,8733,53,allow,209,110,99,2,30,1,1
64232,53,50382,53,allow,258,110,148,2,30,1,1
63717,37965,0,0,deny,66,66,0,1,0,1,0
50919,443,47767,443,allow,6412,1370,5042,19,129,9,10
34066,36829,0,0,deny,146,146,0,1,0,1,0
42252,33303,0,0,deny,60,60,0,1,0,1,0
58574,21247,0,0,deny,66,66,0,1,0,1,0
41889,443,23289,443,allow,6516,1722,4794,26,17,15,11
64414,53,58315,53,allow,406,142,264,2,30,1,1
50985,80,32837,80,allow,5823,1570,4253,17,20,10,7
55973,445,0,0,drop,66,66,0,1,0,1,0
24351,57470,0,0,deny,62,62,0,1,0,1,0
65006,53,44331,53,allow,763,102,661,2,30,1,1
50589,53,3456,53,allow,177,94,83,2,30,1,1
13445,44847,0,0,deny,66,66,0,1,0,1,0
65508,443,2648,443,allow,92884,4939,87945,111,16,45,66
20112,64147,0,0,deny,62,62,0,1,0,1,0
55088,53,2549,53,allow,186,95,91,2,31,1,1
55182,53,55293,53,allow,199,102,97,2,30,1,1
40334,53,40334,53,allow,213,87,126,2,30,1,1
64334,25174,0,0,deny,66,66,0,1,0,1,0
56320,53,53146,53,allow,183,94,89,2,30,1,1
63981,34250,52912,34250,allow,70,70,0,1,4,1,0
48372,8100,12918,8100,allow,78,78,0,1,5,1,0
50230,80,65071,80,allow,12572,8562,4010,48,442,26,22
65134,53,52533,53,allow,812,110,702,2,29,1,1
57130,445,0,0,drop,70,70,0,1,0,1,0
31130,30188,0,0,deny,62,62,0,1,0,1,0
62194,445,0,0,drop,70,70,0,1,0,1,0
55477,22114,0,0,deny,146,146,0,1,0,1,0
61550,5529,0,0,deny,145,145,0,1,0,1,0
12242,51221,0,0,deny,62,62,0,1,0,1,0
64156,53,39777,53,allow,409,92,317,4,30,2,2
56215,53,29779,53,allow,165,86,79,2,30,1,1
65189,28015,14178,28015,allow,240,78,162,2,29,1,1
49169,445,0,0,drop,70,70,0,1,0,1,0
52194,22674,61715,22674,allow,66,66,0,1,5,1,0
64132,445,0,0,drop,70,70,0,1,0,1,0
64810,53,44808,53,allow,272,93,179,4,33,2,2
64586,53,9543,53,allow,183,94,89,2,30,1,1
49278,80,1561,80,allow,254,128,126,5,16,3,2
49667,445,0,0,drop,70,70,0,1,0,1,0
56983,80,30863,80,allow,214,140,74,4,35,3,1
56689,443,17106,443,allow,4857,3938,919,18,81,11,7
56833,23117,0,0,deny,62,62,0,1,0,1,0
54758,35993,0,0,deny,66,66,0,1,0,1,0
52774,80,57936,80,allow,432,240,192,8,101,5,3
58856,443,44646,443,allow,4552,2750,1802,27,95,15,12
5284,53,5284,53,allow,178,82,96,2,30,1,1
50446,26467,0,0,deny,66,66,0,1,0,1,0
49996,53,3392,53,allow,182,93,89,2,31,1,1
52026,80,21940,80,allow,422,240,182,8,25,5,3
64473,7000,64473,7000,allow,3434,1595,1839,17,15,9,8
58475,11392,0,0,deny,66,66,0,1,0,1,0
61964,443,61964,443,allow,4378,1471,2907,19,30,11,8
58638,5900,0,0,deny,62,62,0,1,0,1,0
49995,80,2817,80,allow,2669,604,2065,11,16,6,5
61681,443,50543,443,allow,10714,3531,7183,26,120,12,14
56636,43890,0,0,deny,66,66,0,1,0,1,0
61424,80,26157,80,allow,214,140,74,4,41,3,1
50149,445,0,0,drop,66,66,0,1,0,1,0
52471,22114,0,0,deny,66,66,0,1,0,1,0
6881,13929,23344,13929,allow,502,150,352,2,1200,1,1
15239,53,15239,53,allow,229,89,140,2,30,1,1
56232,80,56232,80,allow,44752,820,43932,45,15,12,33
49863,53,59500,53,allow,200,86,114,2,30,1,1
53980,443,7192,443,allow,4957,1627,3330,17,120,8,9
55664,53,32292,53,allow,195,102,93,2,30,1,1
50423,445,0,0,drop,70,70,0,1,0,1,0
6881,33156,0,0,deny,146,146,0,1,0,1,0
58638,5900,0,0,deny,62,62,0,1,0,1,0
65062,53,47695,53,allow,229,110,119,2,30,1,1
53627,445,0,0,drop,66,66,0,1,0,1,0
53365,445,0,0,drop,66,66,0,1,0,1,0
48706,23393,0,0,deny,60,60,0,1,0,1,0
52613,445,0,0,drop,70,70,0,1,0,1,0
61408,30188,0,0,deny,66,66,0,1,0,1,0
37636,443,48056,443,allow,9658,2602,7056,32,66,14,18
54094,5900,0,0,deny,60,60,0,1,0,1,0
41482,23,0,0,deny,60,60,0,1,0,1,0
63149,445,0,0,drop,70,70,0,1,0,1,0
38976,46824,0,0,deny,62,62,0,1,0,1,0
49730,53,34658,53,allow,194,102,92,2,30,1,1
57052,443,57052,443,allow,4616,1709,2907,19,28,11,8
57925,443,19196,443,allow,43126,33414,9712,214,220,108,106
50390,8080,50390,8080,allow,378,180,198,7,54,4,3
53294,445,0,0,drop,66,66,0,1,0,1,0
53960,445,0,0,drop,70,70,0,1,0,1,0
62894,993,44411,993,allow,8840,4151,4689,80,190,41,39
55142,53,21559,53,allow,770,101,669,2,31,1,1
51452,445,0,0,drop,70,70,0,1,0,1,0
50309,53,52592,53,allow,816,102,714,2,29,1,1
56387,53,7178,53,allow,182,93,89,2,31,1,1
51880,51881,42143,51881,allow,86,86,0,1,30,1,0
40834,50584,0,0,deny,62,62,0,1,0,1,0
64024,22114,0,0,deny,66,66,0,1,0,1,0
49354,53,61914,53,allow,196,102,94,2,30,1,1
55849,443,27388,443,allow,5944,1501,4443,27,163,13,14
65293,53,30071,53,allow,349,110,239,2,30,1,1
57059,445,0,0,drop,70,70,0,1,0,1,0
56717,53,10005,53,allow,183,94,89,2,30,1,1
6881,16869,32052,16869,allow,509,150,359,2,1200,1,1
55877,64536,41597,64536,allow,469,150,319,2,1200,1,1
52931,80,5991,80,allow,234,234,0,4,11,4,0
51376,445,0,0,drop,70,70,0,1,0,1,0
22659,53,22659,53,allow,247,98,149,2,32,1,1
60910,443,19521,443,allow,3862,2679,1183,28,46,15,13
63561,445,0,0,drop,70,70,0,1,0,1,0
52811,44847,0,0,deny,66,66,0,1,0,1,0
52049,52557,35035,52557,allow,70,70,0,2,8,2,0
61810,445,0,0,drop,70,70,0,1,0,1,0
59564,57470,0,0,deny,66,66,0,1,0,1,0
24145,35440,0,0,deny,62,62,0,1,0,1,0
59975,443,17092,443,allow,7875,3100,4775,42,24,22,20
443,46223,0,0,deny,66,66,0,1,0,1,0
63953,445,0,0,drop,70,70,0,1,0,1,0
64411,443,21450,443,allow,23357,2589,20768,33,120,13,20
55772,445,0,0,drop,70,70,0,1,0,1,0
52304,445,0,0,drop,70,70,0,1,0,1,0
56926,80,46037,80,allow,214,140,74,4,25,3,1
54396,445,0,0,drop,66,66,0,1,0,1,0
62410,445,0,0,drop,66,66,0,1,0,1,0
51283,443,17367,443,allow,638,292,346,10,28,5,5
56991,53,36997,53,allow,748,106,642,2,30,1,1
50712,445,0,0,drop,70,70,0,1,0,1,0
59245,445,0,0,drop,66,66,0,1,0,1,0
52514,80,2585,80,allow,3224,2776,448,11,15,7,4
56506,53,39583,53,allow,807,94,713,2,30,1,1
55979,53,33606,53,allow,193,102,91,2,30,1,1
55570,53,24983,53,allow,168,86,82,2,29,1,1
42790,443,55460,443,allow,13859,3232,10627,50,256,21,29
51371,445,0,0,drop,66,66,0,1,0,1,0
17244,22114,0,0,deny,62,62,0,1,0,1,0
56663,443,10408,443,allow,8057,2037,6020,20,15,11,9
50367,37965,0,0,deny,66,66,0,1,0,1,0
46278,443,29099,443,allow,6685,4843,1842,29,17,18,11
17750,44597,35749,44597,allow,481,150,331,2,1200,1,1
50086,53,18970,53,allow,816,102,714,2,30,1,1
50390,53,29650,53,allow,772,103,669,2,30,1,1
55593,53,41754,53,allow,749,89,660,2,30,1,1
42241,11392,0,0,deny,62,62,0,1,0,1,0
51010,445,0,0,drop,70,70,0,1,0,1,0
37554,443,12881,443,allow,13220,4632,8588,32,37,19,13
52458,443,42668,443,allow,4550,1777,2773,17,135,8,9
50598,443,44338,443,allow,1653,1010,643,16,94,9,7
38664,37965,0,0,deny,62,62,0,1,0,1,0
56701,53,54684,53,allow,211,110,101,2,30,1,1
57093,26467,0,0,deny,62,62,0,1,0,1,0
1968,23,0,0,deny,60,60,0,1,0,1,0
55106,445,0,0,drop,70,70,0,1,0,1,0
10088,443,42389,443,allow,7243,1860,5383,26,330,14,12
50331,445,0,0,drop,70,70,0,1,0,1,0
63965,53,30693,53,allow,192,90,102,2,31,1,1
32390,53,32390,53,allow,229,89,140,2,30,1,1
33063,443,10345,443,allow,6411,1611,4800,24,17,13,11
56629,53,58033,53,allow,182,93,89,2,30,1,1
55453,445,0,0,drop,70,70,0,1,0,1,0
40082,2222,0,0,deny,60,60,0,1,0,1,0
57470,8999,31471,8999,allow,1577,594,983,20,1614,10,10
60163,443,56805,443,allow,8929,3204,5725,25,80,14,11
63988,53,50282,53,allow,559,193,366,6,67,3,3
33539,443,27903,443,allow,3244,2042,1202,17,16,9,8
10151,11809,51182,11809,allow,481,150,331,2,1200,1,1
65096,443,53521,443,allow,2414,639,1775,9,121,5,4
52174,443,52174,443,allow,55503,7279,48224,79,22,32,47
59927,445,0,0,drop,70,70,0,1,0,1,0
56674,53,20676,53,allow,183,94,89,2,30,1,1
45064,25174,0,0,deny,62,62,0,1,0,1,0
59876,44847,0,0,deny,66,66,0,1,0,1,0
50730,53,50730,53,allow,228,97,131,2,30,1,1
58506,445,0,0,drop,70,70,0,1,0,1,0
65078,53,48280,53,allow,339,110,229,2,29,1,1
50486,80,43523,80,allow,378,192,186,7,21,4,3
53129,443,62080,443,allow,51742,10734,41008,85,44,33,52
53261,443,39643,443,allow,96485,4565,91920,119,150,45,74
58921,443,47044,443,allow,10782,7193,3589,30,16,17,13
52077,443,25258,443,allow,6317,2196,4121,19,15,10,9
60786,40010,58556,40010,allow,316,136,180,6,7,3,3
57762,445,0,0,drop,66,66,0,1,0,1,0
51499,443,64851,443,allow,43980,3500,40480,65,16,31,34
58638,5900,0,0,deny,62,62,0,1,0,1,0
55600,445,0,0,drop,66,66,0,1,0,1,0
6703,21247,0,0,deny,62,62,0,1,0,1,0
52454,445,0,0,drop,70,70,0,1,0,1,0
50468,80,2157,80,allow,314,192,122,6,28,4,2
14618,6881,0,0,deny,62,62,0,1,0,1,0
65530,53,20918,53,allow,167,86,81,2,29,1,1
64986,53,17110,53,allow,183,94,89,2,31,1,1
57325,445,0,0,drop,70,70,0,1,0,1,0
5236,35120,49591,35120,allow,23369,64,23305,65,31,2,63
57116,445,0,0,drop,70,70,0,1,0,1,0
55734,53,29847,53,allow,733,94,639,2,30,1,1
46456,443,58612,443,allow,4921,2134,2787,21,95,10,11
52537,443,37723,443,allow,132577,21019,111558,348,236,142,206
48726,443,17212,443,allow,6644134,184008,6460126,6659,204,2197,4462
8531,53,8531,53,allow,213,87,126,2,30,1,1
50552,53,56537,53,allow,710,89,621,2,30,1,1
55685,48407,34505,48407,allow,320,140,180,6,6,3,3
54306,443,48186,443,allow,6376,1576,4800,24,19,13,11
52117,445,0,0,drop,66,66,0,1,0,1,0
59877,80,9809,80,allow,1306,557,749,10,25,6,4
55991,53,9133,53,allow,199,102,97,2,30,1,1
61902,22114,0,0,deny,66,66,0,1,0,1,0
62422,443,30175,443,allow,16258,11067,5191,37,45,21,16
65176,53,39241,53,allow,193,102,91,2,30,1,1
62287,443,17565,443,allow,3644,610,3034,13,119,6,7
50124,443,33361,443,allow,24329,7675,16654,47,16,25,22
65159,37965,0,0,deny,74,74,0,1,0,1,0
46563,443,26794,443,allow,127147,41867,85280,198,240,91,107
59810,6004,0,0,deny,66,66,0,1,0,1,0
58776,443,47713,443,allow,3991,2587,1404,17,16,9,8
22539,53,19206,53,allow,86,86,0,1,30,1,0
51548,445,0,0,drop,70,70,0,1,0,1,0
55549,53,31074,53,allow,202,103,99,2,31,1,1
48557,37965,0,0,deny,62,62,0,1,0,1,0
49980,445,0,0,drop,70,70,0,1,0,1,0
59339,445,0,0,drop,66,66,0,1,0,1,0
58907,80,55384,80,allow,694,350,344,11,28,6,5
50016,53,14072,53,allow,766,103,663,4,41,2,2
62828,443,62828,443,allow,4604,1697,2907,19,29,11,8
21833,22114,0,0,deny,62,62,0,1,0,1,0
36336,443,11755,443,allow,8111,5060,3051,31,396,11,20
60118,445,0,0,drop,66,66,0,1,0,1,0
51032,445,0,0,drop,66,66,0,1,0,1,0
49203,53,46894,53,allow,168,86,82,2,30,1,1
52856,445,0,0,drop,66,66,0,1,0,1,0
65466,443,13984,443,allow,478996,13760,465236,490,16,171,319
50370,445,0,0,drop,70,70,0,1,0,1,0
53487,445,0,0,drop,70,70,0,1,0,1,0
54302,445,0,0,drop,70,70,0,1,0,1,0
58854,443,18047,443,allow,5202,3361,1841,19,16,10,9
51335,445,0,0,drop,70,70,0,1,0,1,0
38633,51221,0,0,deny,62,62,0,1,0,1,0
64626,53,31838,53,allow,326,102,224,2,30,1,1
54985,80,44594,80,allow,2452,680,1772,9,17,6,3
50734,37965,0,0,deny,62,62,0,1,0,1,0
56258,3389,56258,3389,allow,4768,1600,3168,19,17,10,9
63988,22114,0,0,deny,66,66,0,1,0,1,0
64935,53,55369,53,allow,198,102,96,2,30,1,1
6247,51221,0,0,deny,62,62,0,1,0,1,0
48437,443,48848,443,allow,934,420,514,15,30,7,8
42854,443,46516,443,allow,4268,2836,1432,25,19,13,12
34741,53,34741,53,allow,414,268,146,3,33,2,1
57895,443,60971,443,allow,10639,4680,5959,53,176,24,29
63956,38211,0,0,deny,62,62,0,1,0,1,0
44208,26467,0,0,deny,62,62,0,1,0,1,0
49691,53,43996,53,allow,378,127,251,2,30,1,1
62705,443,33676,443,allow,178,118,60,2,15,1,1
49924,445,0,0,drop,66,66,0,1,0,1,0
56726,53,58672,53,allow,223,102,121,2,30,1,1
65218,53,47163,53,allow,276,126,150,2,30,1,1
55958,53,25725,53,allow,209,102,107,2,30,1,1
56711,445,0,0,drop,66,66,0,1,0,1,0
50209,1688,49264,1688,allow,70,70,0,2,8,2,0
63936,14832,6153,14832,allow,312,190,122,5,16,3,2
49550,80,26667,80,allow,3531,1965,1566,14,29,8,6
55969,53,43128,53,allow,731,91,640,2,31,1,1
64034,445,0,0,drop,66,66,0,1,0,1,0
50406,8080,50406,8080,allow,47078,2874,44204,66,51,32,34
2182,57354,0,0,deny,145,145,0,1,0,1,0
57887,443,20597,443,allow,6938,1531,5407,23,195,13,10
62027,445,0,0,drop,66,66,0,1,0,1,0
55498,53,29212,53,allow,177,94,83,2,30,1,1
58638,5900,0,0,deny,62,62,0,1,0,1,0
64822,53,9057,53,allow,200,94,106,2,30,1,1
56793,56205,0,0,deny,62,62,0,1,0,1,0
63205,9571,0,0,deny,66,66,0,1,0,1,0
50345,80,27840,80,allow,736,670,66,6,15,5,1
53645,445,0,0,drop,66,66,0,1,0,1,0
65200,53,41473,53,allow,214,110,104,2,29,1,1
53522,24116,32649,24116,allow,70,70,0,2,8,2,0
63433,57866,0,0,deny,66,66,0,1,0,1,0
63062,53,6744,53,allow,303,85,218,2,30,1,1
51911,80,54033,80,allow,5474,1920,3554,20,65,12,8
40500,25356,0,0,deny,146,146,0,1,0,1,0
60565,445,0,0,drop,66,66,0,1,0,1,0
59165,445,0,0,drop,70,70,0,1,0,1,0
34417,443,59906,443,allow,6378,1571,4807,23,315,12,11
65181,445,0,0,drop,70,70,0,1,0,1,0
64634,53,16629,53,allow,786,110,676,2,30,1,1
55171,53,44438,53,allow,199,102,97,2,30,1,1
53117,445,0,0,drop,70,70,0,1,0,1,0
57750,445,0,0,drop,66,66,0,1,0,1,0
56491,53,20777,53,allow,165,86,79,2,31,1,1
64393,445,0,0,drop,66,66,0,1,0,1,0
64481,53,22915,53,allow,386,106,280,4,51,2,2
7166,64147,0,0,deny,62,62,0,1,0,1,0
43129,15503,0,0,deny,62,62,0,1,0,1,0
11295,40033,3453,40033,allow,213,89,124,4,32,2,2
28754,50584,0,0,deny,66,66,0,1,0,1,0
27005,27015,49083,27015,allow,872,126,746,2,30,1,1
54898,443,38797,443,allow,4559,2054,2505,11,120,6,5
58638,5900,0,0,deny,62,62,0,1,0,1,0
49639,443,59144,443,allow,13604,1980,11624,33,46,18,15
65315,53,56097,53,allow,216,110,106,2,30,1,1
64231,445,0,0,drop,70,70,0,1,0,1,0
46505,443,30509,443,allow,59700,5399,54301,109,32,57,52
65348,53,17423,53,allow,177,94,83,2,29,1,1
68,67,0,0,deny,594,594,0,1,0,1,0
55377,53,9978,53,allow,228,110,118,2,30,1,1
56178,445,0,0,drop,66,66,0,1,0,1,0
28305,25773,0,0,reset-both,148,148,0,1,0,1,0
52349,445,0,0,drop,70,70,0,1,0,1,0
63937,53,33435,53,allow,183,94,89,2,30,1,1
65073,53,7816,53,allow,195,102,93,2,30,1,1
64217,53,33943,53,allow,193,102,91,2,30,1,1
57017,53,16260,53,allow,177,94,83,2,30,1,1
61594,445,0,0,drop,70,70,0,1,0,1,0
56835,445,0,0,drop,66,66,0,1,0,1,0
61862,445,0,0,drop,70,70,0,1,0,1,0
58811,53976,0,0,deny,62,62,0,1,0,1,0
52710,445,0,0,drop,70,70,0,1,0,1,0
64791,443,54264,443,allow,8580,5765,2815,46,82,22,24
54943,60038,0,0,allow,66,66,0,1,90,1,0
49767,443,22404,443,allow,11883,1419,10464,26,127,11,15
51462,445,0,0,drop,70,70,0,1,0,1,0
59614,53,24145,53,allow,417,78,339,2,30,1,1
46679,64147,0,0,deny,62,62,0,1,0,1,0
56354,53,51631,53,allow,200,94,106,2,30,1,1
57878,80,49228,80,allow,5518,527,4991,13,75,6,7
9261,80,32507,80,allow,378,192,186,7,26,4,3
64727,25174,0,0,deny,66,66,0,1,0,1,0
52221,445,0,0,drop,70,70,0,1,0,1,0
57338,443,31270,443,allow,222159,52803,169356,361,26,173,188
48852,443,7799,443,allow,38886,2134,36752,55,16,24,31
50648,80,9788,80,allow,1717,1247,470,9,15,5,4
58638,5900,0,0,deny,62,62,0,1,0,1,0
60388,445,0,0,drop,66,66,0,1,0,1,0
52475,445,0,0,drop,70,70,0,1,0,1,0
8888,53,8888,53,allow,214,97,117,2,30,1,1
52930,80,36918,80,allow,76193,2105,74088,75,359,23,52
38011,443,62208,443,allow,14337,3375,10962,47,121,23,24
50624,26467,0,0,deny,66,66,0,1,0,1,0
60059,445,0,0,drop,70,70,0,1,0,1,0
50978,445,0,0,drop,66,66,0,1,0,1,0
44061,443,59659,443,allow,8551,1685,6866,24,170,12,12
1660,8696,0,0,deny,62,62,0,1,0,1,0
58715,80,58715,80,allow,5140,4161,979,17,28,10,7
58914,37965,0,0,deny,66,66,0,1,0,1,0
64213,445,0,0,drop,70,70,0,1,0,1,0
56601,53,60579,53,allow,168,78,90,2,30,1,1
39718,443,11292,443,allow,10186,3128,7058,26,16,13,13
57168,445,0,0,drop,70,70,0,1,0,1,0
56694,53,29552,53,allow,192,98,94,2,30,1,1
51878,9999,7906,9999,allow,66,66,0,1,5,1,0
56780,48298,2043,48298,allow,264,70,194,4,19,1,3
57215,53,55858,53,allow,810,108,702,2,30,1,1
64850,53,29250,53,allow,167,86,81,2,30,1,1
36961,443,20198,443,allow,7326,1399,5927,29,280,15,14
52907,443,48453,443,allow,9303,3133,6170,26,22,13,13
49384,445,0,0,drop,70,70,0,1,0,1,0
59014,443,31435,443,allow,27298,11122,16176,59,31,30,29
50736,445,0,0,drop,66,66,0,1,0,1,0
65144,53,24637,53,allow,210,110,100,2,30,1,1
27005,33026,58261,33026,allow,879,126,753,3,32,2,1
59182,53,44334,53,allow,260,86,174,2,30,1,1
53247,443,42679,443,allow,7461,1789,5672,25,69,14,11
56918,53,41255,53,allow,778,103,675,2,30,1,1
53467,445,0,0,drop,70,70,0,1,0,1,0
64053,47783,24062,47783,allow,70,70,0,1,5,1,0
64586,445,0,0,drop,66,66,0,1,0,1,0
443,48120,0,0,deny,97,97,0,1,0,1,0
52521,80,12951,80,allow,3676,3228,448,11,15,7,4
49353,443,32645,443,allow,7030,1195,5835,20,76,10,10
60875,443,41853,443,allow,7251,2098,5153,27,25,15,12
65041,53,3296,53,allow,200,94,106,2,29,1,1
11136,19910,0,0,deny,62,62,0,1,0,1,0
56269,53,56636,53,allow,326,126,200,2,30,1,1
53251,443,53251,443,allow,1404,697,707,17,121,8,9
1027,57866,0,0,deny,146,146,0,1,0,1,0
50591,80,63944,80,allow,318,192,126,6,25,4,2
51585,443,25112,443,allow,2840,330,2510,12,135,5,7
32997,50584,0,0,deny,62,62,0,1,0,1,0
18608,11392,0,0,deny,66,66,0,1,0,1,0
58858,15503,0,0,deny,66,66,0,1,0,1,0
63064,443,8160,443,allow,448,166,282,2,30,1,1
8889,63001,0,0,deny,60,60,0,1,0,1,0
56430,445,0,0,drop,70,70,0,1,0,1,0
60794,20010,2485,20010,allow,70,70,0,1,5,1,0
55147,445,0,0,drop,70,70,0,1,0,1,0
64631,53,5606,53,allow,193,102,91,2,30,1,1
48350,57470,0,0,deny,74,74,0,1,0,1,0
64052,53,43180,53,allow,211,102,109,2,30,1,1
64950,53,37238,53,allow,725,277,448,8,61,4,4
51051,22,51051,22,deny,327,140,187,4,0,2,2
51979,25174,0,0,deny,66,66,0,1,0,1,0
49227,53,40527,53,allow,340,89,251,4,44,2,2
54984,445,0,0,drop,66,66,0,1,0,1,0
47281,443,8413,443,allow,190,70,120,4,15,2,2
49582,445,0,0,drop,70,70,0,1,0,1,0
50679,80,31176,80,allow,2139,1167,972,10,20,6,4
21133,41620,37961,41620,allow,150,150,0,1,1199,1,0
54366,445,0,0,drop,70,70,0,1,0,1,0
10091,22114,0,0,deny,62,62,0,1,0,1,0
64917,53,41071,53,allow,194,94,100,2,30,1,1
60517,53,31898,53,allow,198,86,112,2,30,1,1
22904,56205,0,0,deny,62,62,0,1,0,1,0
58074,11392,0,0,deny,66,66,0,1,0,1,0
57541,445,0,0,drop,66,66,0,1,0,1,0
49197,30188,0,0,deny,146,146,0,1,0,1,0
40107,53,34833,53,allow,168,78,90,2,30,1,1
65335,445,0,0,drop,70,70,0,1,0,1,0
57410,37965,0,0,deny,66,66,0,1,0,1,0
58408,445,0,0,drop,70,70,0,1,0,1,0
45964,3111,0,0,deny,60,60,0,1,0,1,0
14084,43890,0,0,deny,62,62,0,1,0,1,0
55890,445,0,0,drop,70,70,0,1,0,1,0
53609,38060,12354,38060,allow,70,70,0,2,8,2,0
61279,443,45971,443,allow,4076,1378,2698,14,136,7,7
42298,40016,13493,40016,allow,148,86,62,2,30,1,1
59097,2767,0,0,deny,66,66,0,1,0,1,0
47943,50584,0,0,deny,74,74,0,1,0,1,0
49489,443,58403,443,allow,3170,977,2193,13,135,6,7
50040,53,5250,53,allow,193,102,91,2,30,1,1
65332,56205,0,0,deny,66,66,0,1,0,1,0
55688,53,29682,53,allow,183,94,89,2,31,1,1
64355,53,49915,53,allow,402,118,284,2,29,1,1
56611,53,8939,53,allow,91,91,0,1,30,1,0
62149,22114,0,0,deny,66,66,0,1,0,1,0
64378,445,0,0,drop,70,70,0,1,0,1,0
63049,443,56063,443,allow,384,166,218,2,30,1,1
56381,51505,0,0,deny,62,62,0,1,0,1,0
64080,443,11837,443,allow,75064,64938,10126,147,277,71,76
55993,53,52586,53,allow,199,102,97,2,30,1,1
55991,53,7983,53,allow,183,94,89,2,30,1,1
57131,26296,0,0,deny,145,145,0,1,0,1,0
62247,445,0,0,drop,70,70,0,1,0,1,0
137,137,55406,137,allow,114,114,0,2,32,2,0
37965,23215,60797,23215,allow,537,158,379,2,1199,1,1
54415,443,40112,443,allow,7129,4391,2738,32,196,16,16
57911,443,43789,443,allow,10141,5997,4144,56,156,28,28
61382,25174,0,0,deny,62,62,0,1,0,1,0
54320,27016,15570,27016,allow,924,924,0,3,30,3,0
55907,53,18173,53,allow,184,94,90,2,30,1,1
55791,53,4698,53,allow,811,94,717,2,30,1,1
45551,443,26442,443,allow,7764,1734,6030,23,20,13,10
62423,443,31493,443,allow,28031,7016,21015,51,45,23,28
51493,80,21444,80,allow,9524,736,8788,18,131,9,9
56786,443,23041,443,allow,7929,1940,5989,20,16,11,9
27679,37965,0,0,deny,62,62,0,1,0,1,0
64994,443,32046,443,allow,3547,1351,2196,17,135,8,9
56381,53,54551,53,allow,196,102,94,2,30,1,1
63819,18445,64902,18445,allow,66,66,0,2,7,2,0
63962,10115,25745,10115,allow,66,66,0,1,5,1,0
47595,33437,0,0,allow,106,106,0,1,61,1,0
50283,49169,0,0,deny,66,66,0,1,0,1,0
46392,443,48556,443,allow,232,172,60,3,5,2,1
64113,53,6414,53,allow,216,102,114,2,30,1,1
50977,56205,0,0,deny,66,66,0,1,0,1,0
55456,443,5231,443,allow,7409,2302,5107,19,135,9,10
27005,12345,54236,12345,allow,898,126,772,2,30,1,1
57504,44847,0,0,deny,66,66,0,1,0,1,0
56984,53,53152,53,allow,199,102,97,2,29,1,1
51100,80,29611,80,allow,12300,4454,7846,26,30,13,13
50331,80,36568,80,allow,1677,862,815,10,15,5,5
52094,443,12498,443,allow,2960,1982,978,15,16,9,6
56075,53,1883,53,allow,215,102,113,2,30,1,1
50008,53,59037,53,allow,359,95,264,4,46,2,2
59942,22114,0,0,deny,62,62,0,1,0,1,0
56492,53,62080,53,allow,184,94,90,2,30,1,1
57110,445,0,0,drop,70,70,0,1,0,1,0
60478,443,17919,443,allow,5045,2009,3036,14,120,7,7
64793,53,25945,53,allow,168,86,82,2,29,1,1
49776,443,33796,443,allow,214,140,74,4,15,3,1
55292,53,15138,53,allow,274,94,180,2,30,1,1
64815,445,0,0,drop,70,70,0,1,0,1,0
10427,50584,0,0,deny,146,146,0,1,0,1,0
50829,443,2487,443,allow,1445207,43930,1401277,1562,219,556,1006
443,62732,0,0,deny,332,332,0,1,0,1,0
55525,53,23543,53,allow,212,108,104,2,31,1,1
49331,443,20933,443,allow,4889,763,4126,18,30,8,10
56861,53,42758,53,allow,756,95,661,2,31,1,1
44913,36866,0,0,deny,148,148,0,1,0,1,0
59101,445,0,0,drop,70,70,0,1,0,1,0
36712,53,0,0,allow,139,70,69,2,30,1,1
41636,123,47665,123,allow,184,94,90,2,30,1,1
13235,44847,0,0,deny,66,66,0,1,0,1,0
34167,80,27156,80,allow,3643,1738,1905,17,187,10,7
50734,37965,0,0,deny,62,62,0,1,0,1,0
56627,53,42658,53,allow,186,95,91,2,31,1,1
49497,445,0,0,drop,70,70,0,1,0,1,0
51746,25174,0,0,deny,66,66,0,1,0,1,0
53630,64745,62898,64745,allow,70,70,0,2,7,2,0
53268,443,33392,443,allow,13176,4779,8397,47,17,29,18
55584,53,28071,53,allow,177,94,83,2,30,1,1
993,3979,0,0,deny,129,129,0,1,0,1,0
49160,33586,34033,33586,allow,1377,300,1077,6,1200,3,3
48066,443,56844,443,allow,62,62,0,1,4,1,0
62887,445,0,0,drop,70,70,0,1,0,1,0
50274,445,0,0,drop,70,70,0,1,0,1,0
56931,443,32343,443,allow,34750,2997,31753,61,95,29,32
50265,43974,25412,43974,allow,132,132,0,3,1200,3,0
54842,443,49660,443,allow,5860,1151,4709,18,283,10,8
64014,3389,64014,3389,reset-both,293,223,70,4,0,3,1
13287,16933,0,0,deny,62,62,0,1,0,1,0
54249,443,37595,443,allow,499,425,74,4,0,3,1
54361,443,48340,443,allow,12268,2979,9289,35,81,18,17
50930,443,59751,443,allow,9354,2370,6984,24,16,13,11
61832,80,61832,80,allow,2221,1482,739,11,149,6,5
55271,53,61756,53,allow,751,95,656,2,31,1,1
63547,445,0,0,drop,70,70,0,1,0,1,0
50878,80,60118,80,allow,325925,18062,307863,377,146,161,216
55363,445,0,0,drop,70,70,0,1,0,1,0
51516,443,51516,443,allow,143921,6996,136925,152,174,42,110
53922,443,26654,443,allow,499,425,74,4,0,3,1
56322,53,0,0,allow,166,73,93,2,31,1,1
64454,445,0,0,drop,70,70,0,1,0,1,0
53526,45046,24762,45046,allow,552,306,246,9,15,5,4
49532,53,58267,53,allow,334,92,242,4,49,2,2
