Source Port,Destination Port,NAT Source Port,NAT Destination Port,Action,Bytes,Bytes Sent,Bytes Received,Packets,Elapsed Time (sec),pkts_sent,pkts_received
16230,53,64249,53,allow,223,78,145,2,30,1,1
56340,53,20646,53,allow,780,104,676,2,30,1,1
64543,445,0,0,drop,70,70,0,1,0,1,0
59683,443,7689,443,allow,16524,4274,12250,35,133,15,20
51997,443,19517,443,allow,2648,1797,851,19,22,11,8
58819,1433,58819,1433,allow,124,60,64,2,5,1,1
65365,445,0,0,drop,70,70,0,1,0,1,0
55754,53,48167,53,allow,177,94,83,2,29,1,1
65166,62413,0,0,deny,66,66,0,1,0,1,0
49335,443,62056,443,allow,125790,4516,121274,118,55,28,90
29512,30188,0,0,deny,66,66,0,1,0,1,0
48865,443,7956,443,allow,12824,2604,10220,46,255,20,26
56388,22114,0,0,deny,66,66,0,1,0,1,0
35017,443,23449,443,allow,826,362,464,13,30,6,7
55918,53,24727,53,allow,184,94,90,2,30,1,1
33166,53,0,0,allow,82,82,0,2,40,2,0
1025,50584,0,0,deny,62,62,0,1,0,1,0
39324,64147,0,0,deny,62,62,0,1,0,1,0
49990,53,43468,53,allow,198,102,96,2,30,1,1
34230,53,34230,53,allow,823,98,725,2,31,1,1
50732,27029,64378,27029,allow,269,78,191,2,30,1,1
60759,40010,60253,40010,allow,316,136,180,6,7,3,3
50411,53,28874,53,allow,86,86,0,1,30,1,0
65102,53,65408,53,allow,183,94,89,2,30,1,1
64756,53,21500,53,allow,195,102,93,2,30,1,1
55451,56205,0,0,deny,66,66,0,1,0,1,0
56937,53,49569,53,allow,181,94,87,2,33,1,1
23461,34021,0,0,reset-both,62,62,0,1,0,1,0
54617,64147,0,0,deny,62,62,0,1,0,1,0
37653,5223,25600,5223,allow,142,142,0,1,5,1,0
51388,445,0,0,drop,70,70,0,1,0,1,0
59223,17500,0,0,deny,66,66,0,1,0,1,0
65251,53,12989,53,allow,199,102,97,2,29,1,1
59896,445,0,0,drop,70,70,0,1,0,1,0
49690,50265,0,0,deny,66,66,0,1,0,1,0
49611,53,60181,53,allow,170,87,83,2,31,1,1
59347,57470,0,0,deny,66,66,0,1,0,1,0
55937,445,0,0,drop,66,66,0,1,0,1,0
55044,53,52145,53,allow,196,102,94,2,29,1,1
50040,443,40234,443,allow,1097,654,443,12,86,7,5
19245,64147,0,0,deny,66,66,0,1,0,1,0
49392,53,35647,53,allow,398,93,305,4,45,2,2
52590,445,0,0,drop,70,70,0,1,0,1,0
56805,53,60553,53,allow,178,94,84,2,30,1,1
57001,53,25113,53,allow,177,94,83,2,30,1,1
62155,445,0,0,drop,66,66,0,1,0,1,0
55719,8060,30409,8060,allow,70,70,0,2,7,2,0
52823,445,0,0,drop,70,70,0,1,0,1,0
65494,53,0,0,deny,88,88,0,1,0,1,0
49160,12176,2844,12176,allow,852,150,702,4,1200,2,2
57528,445,0,0,drop,66,66,0,1,0,1,0
50575,443,8721,443,allow,149414,8612,140802,208,25,107,101
54744,443,54744,443,allow,4737,2854,1883,25,117,13,12
53298,26467,0,0,deny,66,66,0,1,0,1,0
38662,15000,56543,15000,allow,138,78,60,2,6,1,1
54577,445,0,0,drop,66,66,0,1,0,1,0
56344,53,27123,53,allow,198,101,97,2,31,1,1
64787,53,29856,53,allow,728,102,626,2,30,1,1
49837,53,3661,53,allow,183,102,81,2,30,1,1
55404,445,0,0,drop,70,70,0,1,0,1,0
43916,21,0,0,deny,60,60,0,1,0,1,0
64852,53,45042,53,allow,209,110,99,2,30,1,1
55598,445,0,0,drop,70,70,0,1,0,1,0
54973,53,16224,53,allow,181,94,87,2,31,1,1
57595,80,57595,80,allow,254,120,134,5,26,3,2
50564,443,64623,443,allow,1894028,31411,1862617,1579,122,209,1370
63768,53,12206,53,allow,298,102,196,2,30,1,1
63213,35440,0,0,deny,146,146,0,1,0,1,0
45682,37965,0,0,deny,62,62,0,1,0,1,0
62980,445,0,0,drop,70,70,0,1,0,1,0
57432,445,0,0,drop,70,70,0,1,0,1,0
56736,80,11534,80,allow,194,128,66,4,25,3,1
52097,23279,3582,23279,allow,70,70,0,2,7,2,0
39543,7276,23316,7276,allow,1142,558,584,16,16,8,8
44960,443,32145,443,allow,306066,33556,272510,414,196,162,252
35191,53,35191,53,allow,825,99,726,2,31,1,1
60430,443,49199,443,allow,5696,1143,4553,23,119,12,11
49863,8100,50615,8100,allow,234,234,0,4,11,4,0
56730,443,7897,443,allow,347884,9284,338600,360,31,125,235
49722,53,48716,53,allow,200,102,98,2,30,1,1
63581,445,0,0,drop,70,70,0,1,0,1,0
49998,53,11230,53,allow,467,90,377,4,39,2,2
52173,80,40738,80,allow,362,240,122,7,17,5,2
55784,445,0,0,drop,70,70,0,1,0,1,0
58720,443,50201,443,allow,32598,22046,10552,83,60,49,34
62275,443,20241,443,allow,18482489,568378,17914111,19386,214,6466,12920
56493,443,6298,443,allow,10532,6786,3746,55,81,28,27
57334,53,29836,53,allow,204,104,100,2,31,1,1
40146,53,0,0,allow,300,86,214,2,30,1,1
65158,445,0,0,drop,70,70,0,1,0,1,0
62105,445,0,0,drop,66,66,0,1,0,1,0
61408,80,60964,80,allow,420720,29056,391664,771,159,325,446
65279,53,28048,53,allow,183,94,89,2,31,1,1
58533,443,53373,443,allow,17356,5096,12260,46,26,24,22
57109,53,6255,53,allow,168,86,82,2,30,1,1
64146,53,19064,53,allow,212,102,110,2,29,1,1
50584,6881,21374,6881,allow,161,161,0,1,1200,1,0
3549,64147,0,0,deny,62,62,0,1,0,1,0
18252,18242,0,0,reset-both,62,62,0,1,0,1,0
25222,37965,0,0,deny,62,62,0,1,0,1,0
56204,53,61458,53,allow,168,86,82,2,30,1,1
51761,19136,54705,19136,allow,70,70,0,2,8,2,0
54695,80,64600,80,allow,2001,1107,894,13,150,7,6
51544,50584,0,0,deny,62,62,0,1,0,1,0
36998,80,39862,80,allow,130,70,60,2,15,1,1
37906,443,56891,443,allow,11293,3979,7314,29,125,17,12
55983,53,48141,53,allow,255,102,153,2,30,1,1
57339,50584,0,0,deny,66,66,0,1,0,1,0
57250,445,0,0,drop,66,66,0,1,0,1,0
13567,23684,0,0,deny,168,168,0,1,0,1,0
51424,53,58777,53,allow,269,94,175,2,30,1,1
30602,36237,0,0,deny,146,146,0,1,0,1,0
58199,445,0,0,drop,70,70,0,1,0,1,0
49410,53,35309,53,allow,167,86,81,2,31,1,1
54551,445,0,0,drop,70,70,0,1,0,1,0
38281,37807,0,0,deny,62,62,0,1,0,1,0
22,37469,22,37469,allow,178,118,60,2,4,1,1
56067,445,0,0,drop,66,66,0,1,0,1,0
60665,445,0,0,drop,70,70,0,1,0,1,0
31738,51505,0,0,deny,62,62,0,1,0,1,0
60976,443,6084,443,allow,5027222,114898,4912324,4763,109,1375,3388
49791,443,8451,443,allow,6057,767,5290,16,126,8,8
63643,445,0,0,drop,70,70,0,1,0,1,0
37665,443,54006,443,allow,8134,2717,5417,24,16,15,9
52098,29067,64917,29067,allow,70,70,0,1,5,1,0
54136,443,42387,443,allow,1053,566,487,10,16,6,4
38484,48637,0,0,deny,60,60,0,1,0,1,0
60758,445,0,0,drop,70,70,0,1,0,1,0
49324,53,24551,53,allow,258,94,164,2,30,1,1
64874,53,59017,53,allow,323,110,213,2,30,1,1
61205,445,0,0,drop,70,70,0,1,0,1,0
58829,64147,0,0,deny,66,66,0,1,0,1,0
56656,443,38705,443,allow,8006,1986,6020,20,15,11,9
60993,443,45715,443,allow,7201,2107,5094,23,61,13,10
64649,53,32892,53,allow,807,94,713,2,30,1,1
55830,53,42279,53,allow,170,87,83,2,30,1,1
54703,53,49581,53,allow,168,78,90,2,30,1,1
55386,445,0,0,drop,70,70,0,1,0,1,0
64525,53,5631,53,allow,199,102,97,2,29,1,1
50263,445,0,0,drop,70,70,0,1,0,1,0
59096,57866,0,0,deny,66,66,0,1,0,1,0
47971,443,15056,443,allow,130,70,60,2,15,1,1
4232,50584,0,0,deny,66,66,0,1,0,1,0
50584,8999,18180,8999,allow,1356,300,1056,6,1200,3,3
63667,57470,0,0,deny,145,145,0,1,0,1,0
7931,30170,0,0,deny,146,146,0,1,0,1,0
58832,443,5090,443,allow,3862,2458,1404,16,15,8,8
50265,33734,14802,33734,allow,132,132,0,3,1200,3,0
56583,53,53516,53,allow,170,87,83,2,31,1,1
46617,53,46617,53,allow,213,87,126,2,30,1,1
50386,443,59778,443,allow,1346,918,428,10,26,6,4
53122,443,60812,443,allow,12409,2224,10185,36,26,19,17
53433,443,53433,443,allow,15095,2556,12539,37,102,15,22
40471,53,40471,53,allow,194,87,107,2,31,1,1
53911,1025,4663,1025,allow,70,70,0,1,4,1,0
52177,25320,0,0,deny,66,66,0,1,0,1,0
26900,27017,2675,27017,allow,422,164,258,6,30,3,3
58297,443,46075,443,allow,7338,2419,4919,19,17,12,7
49164,53,54796,53,allow,226,102,124,2,30,1,1
60366,443,31619,443,allow,14484,7411,7073,26,60,15,11
49214,80,50752,80,allow,2734,1498,1236,21,262,11,10
27005,27214,50051,27214,allow,876,126,750,2,29,1,1
63786,35440,0,0,deny,66,66,0,1,0,1,0
56658,53,12429,53,allow,229,94,135,2,30,1,1
50494,445,0,0,drop,66,66,0,1,0,1,0
55746,53,18233,53,allow,302,84,218,4,46,2,2
39119,44847,0,0,deny,62,62,0,1,0,1,0
43628,53,19035,53,allow,168,78,90,2,29,1,1
53875,43611,35716,43611,allow,70,70,0,2,8,2,0
55352,53,47404,53,allow,216,110,106,2,30,1,1
7744,32480,0,0,deny,62,62,0,1,0,1,0
57073,53,4074,53,allow,99,99,0,1,31,1,0
56336,53,24893,53,allow,172,88,84,2,30,1,1
61791,80,61791,80,allow,16848,822,16026,23,16,9,14
56532,445,0,0,drop,70,70,0,1,0,1,0
37589,443,25099,443,allow,499,425,74,4,0,3,1
49418,27017,33582,27017,allow,71,71,0,1,30,1,0
55056,53,8605,53,allow,170,87,83,2,30,1,1
50478,443,64929,443,allow,36345,2308,34037,52,83,23,29
49870,53,21637,53,allow,188,96,92,2,31,1,1
51754,18375,0,0,deny,62,62,0,1,0,1,0
50295,3389,50295,3389,allow,5936,2690,3246,25,20,15,10
54035,443,43754,443,allow,7724,2555,5169,26,47,15,11
65389,53,2887,53,allow,215,102,113,2,30,1,1
59097,2767,0,0,deny,66,66,0,1,0,1,0
7810,25174,0,0,deny,66,66,0,1,0,1,0
54973,53,49914,53,allow,811,94,717,2,29,1,1
49224,53,17208,53,allow,185,102,83,2,30,1,1
9327,57470,0,0,deny,62,62,0,1,0,1,0
59023,64097,0,0,deny,66,66,0,1,0,1,0
51932,36498,40161,36498,allow,70,70,0,1,5,1,0
6881,33720,0,0,deny,157,157,0,1,0,1,0
56524,53,26224,53,allow,182,102,80,2,30,1,1
42203,443,25522,443,allow,6345,1024,5321,21,361,11,10
48420,35974,0,0,deny,146,146,0,1,0,1,0
17750,58572,62694,58572,allow,150,150,0,1,1200,1,0
6655,2323,0,0,deny,60,60,0,1,0,1,0
51525,35440,0,0,deny,66,66,0,1,0,1,0
56305,53,56939,53,allow,242,118,124,2,30,1,1
61619,445,0,0,drop,70,70,0,1,0,1,0
58120,25174,0,0,deny,66,66,0,1,0,1,0
35173,53,0,0,allow,82,82,0,1,30,1,0
59043,35440,0,0,deny,66,66,0,1,0,1,0
56418,53,28996,53,allow,183,94,89,2,31,1,1
65515,443,2957,443,allow,419763,12080,407683,429,16,147,282
61675,80,46507,80,allow,5108,676,4432,14,15,7,7
56268,44847,0,0,deny,66,66,0,1,0,1,0
64102,53,54377,53,allow,619,102,517,4,43,2,2
62857,445,0,0,drop,66,66,0,1,0,1,0
9486,443,47731,443,allow,3642,421,3221,12,16,6,6
37042,48983,0,0,deny,159,159,0,1,0,1,0
50711,445,0,0,drop,70,70,0,1,0,1,0
64324,53,12173,53,allow,174,89,85,2,30,1,1
1030,44847,0,0,deny,146,146,0,1,0,1,0
63319,53,8378,53,allow,315,102,213,2,31,1,1
24281,23,0,0,deny,60,60,0,1,0,1,0
56762,443,61918,443,allow,8005,1985,6020,20,15,11,9
65220,445,0,0,drop,70,70,0,1,0,1,0
46212,443,28562,443,allow,190,70,120,4,15,2,2
63951,53,13752,53,allow,186,95,91,2,31,1,1
57435,443,34425,443,allow,13536,5529,8007,55,18,24,31
65220,53,21177,53,allow,184,94,90,2,30,1,1
55058,53,31545,53,allow,216,110,106,2,30,1,1
3911,37965,0,0,deny,66,66,0,1,0,1,0
54712,8080,31768,8080,allow,110,110,0,1,31,1,0
50613,445,0,0,drop,66,66,0,1,0,1,0
65350,53,8382,53,allow,390,105,285,4,42,2,2
32096,55108,0,0,deny,139,139,0,1,0,1,0
57964,445,0,0,drop,70,70,0,1,0,1,0
52157,23002,50044,23002,allow,70,70,0,1,5,1,0
17038,36829,0,0,deny,146,146,0,1,0,1,0
58727,443,14813,443,allow,26922,13251,13671,50,18,26,24
64941,53,34820,53,allow,295,101,194,4,31,2,2
51759,445,0,0,drop,70,70,0,1,0,1,0
56053,445,0,0,drop,70,70,0,1,0,1,0
50283,49169,0,0,deny,66,66,0,1,0,1,0
4581,23,0,0,deny,60,60,0,1,0,1,0
49737,443,48877,443,allow,35419,29471,5948,42,31,27,15
48706,23394,0,0,deny,60,60,0,1,0,1,0
61420,443,13668,443,allow,6327,1143,5184,18,28,9,9
59407,445,0,0,drop,70,70,0,1,0,1,0
6881,6881,0,0,deny,146,146,0,1,0,1,0
49436,53,61599,53,allow,718,94,624,2,30,1,1
49370,11392,0,0,deny,66,66,0,1,0,1,0
49437,443,14429,443,allow,586175,29694,556481,753,182,349,404
3764,9694,0,0,deny,66,66,0,1,0,1,0
443,25740,0,0,deny,131,131,0,1,0,1,0
56979,53,43376,53,allow,180,94,86,2,31,1,1
51736,34343,5872,34343,allow,70,70,0,2,8,2,0
60796,443,14652,443,allow,69973,4662,65311,108,135,43,65
50674,35440,0,0,deny,62,62,0,1,0,1,0
52459,5555,0,0,deny,60,60,0,1,0,1,0
56730,53,28651,53,allow,177,94,83,2,30,1,1
55053,443,38835,443,allow,23234,3906,19328,40,61,19,21
13985,34159,0,0,deny,66,66,0,1,0,1,0
56737,443,49751,443,allow,7915,1926,5989,20,16,11,9
34932,38608,0,0,deny,62,62,0,1,0,1,0
46532,3389,46532,3389,allow,4145,1976,2169,22,20,13,9
60178,445,0,0,drop,66,66,0,1,0,1,0
57550,50584,0,0,deny,66,66,0,1,0,1,0
50684,80,2387,80,allow,132,132,0,2,8,2,0
51966,443,48480,443,allow,130,70,60,2,15,1,1
49529,21247,0,0,deny,62,62,0,1,0,1,0
47150,9339,62687,9339,allow,179194,19657,159537,415,149,202,213
32976,37965,0,0,deny,66,66,0,1,0,1,0
41107,53,24186,53,allow,168,78,90,2,30,1,1
55617,445,0,0,drop,66,66,0,1,0,1,0
49855,53,54307,53,allow,212,102,110,2,30,1,1
63329,445,0,0,drop,66,66,0,1,0,1,0
34726,53,62948,53,allow,168,78,90,2,30,1,1
65499,53,38166,53,allow,166,86,80,2,29,1,1
59316,443,4398,443,allow,17547,11857,5690,34,159,20,14
59779,445,0,0,drop,70,70,0,1,0,1,0
55468,445,0,0,drop,70,70,0,1,0,1,0
61884,445,0,0,drop,70,70,0,1,0,1,0
48817,39388,48817,39388,allow,1267,631,636,6,1199,3,3
55048,53,48265,53,allow,215,94,121,2,29,1,1
31330,15503,0,0,deny,145,145,0,1,0,1,0
54539,26467,0,0,deny,62,62,0,1,0,1,0
55928,443,33892,443,allow,5433,3275,2158,16,135,8,8
49637,53,0,0,allow,86,86,0,1,30,1,0
53007,443,38198,443,allow,25010,3519,21491,42,135,17,25
62048,445,0,0,drop,66,66,0,1,0,1,0
55163,53,4604,53,allow,197,102,95,2,31,1,1
55625,53,6982,53,allow,94,94,0,1,30,1,0
64945,53,11913,53,allow,760,97,663,2,30,1,1
52749,64147,0,0,deny,66,66,0,1,0,1,0
51149,445,0,0,drop,70,70,0,1,0,1,0
51784,34568,52434,34568,allow,66,66,0,1,5,1,0
63409,50265,0,0,deny,66,66,0,1,0,1,0
58813,445,0,0,drop,70,70,0,1,0,1,0
59343,53,0,0,allow,178,72,106,2,29,1,1
56637,53,51918,53,allow,214,110,104,2,30,1,1
62074,445,0,0,drop,70,70,0,1,0,1,0
45546,80,52456,80,allow,1213,471,742,10,255,6,4
52968,53,0,0,allow,82,82,0,1,30,1,0
52573,80,52573,80,allow,3487,696,2791,13,142,6,7
63691,53,63691,53,allow,198,90,108,2,30,1,1
52012,445,0,0,drop,70,70,0,1,0,1,0
51558,37965,0,0,deny,72,72,0,1,0,1,0
55824,80,14752,80,allow,1281,398,883,16,393,4,12
61460,445,0,0,drop,70,70,0,1,0,1,0
49786,443,41630,443,allow,10079,2855,7224,23,126,12,11
55567,445,0,0,drop,70,70,0,1,0,1,0
60361,57470,0,0,deny,66,66,0,1,0,1,0
55664,53,37409,53,allow,195,102,93,2,30,1,1
56331,445,0,0,drop,70,70,0,1,0,1,0
49051,443,25390,443,allow,7683,1817,5866,42,3089,15,27
63617,445,0,0,drop,70,70,0,1,0,1,0
55582,53,11114,53,allow,778,103,675,2,31,1,1
49708,53,49250,53,allow,193,102,91,2,30,1,1
55616,56205,0,0,deny,66,66,0,1,0,1,0
32215,22114,0,0,deny,66,66,0,1,0,1,0
62995,53,20908,53,allow,202,202,0,3,46,3,0
52147,80,1117,80,allow,366,240,126,7,32,5,2
58207,443,31795,443,allow,10209,2530,7679,33,223,17,16
10547,57470,0,0,deny,62,62,0,1,0,1,0
55739,445,0,0,drop,66,66,0,1,0,1,0
49790,53,41551,53,allow,195,102,93,2,29,1,1
65451,53,43825,53,allow,172,88,84,2,31,1,1
57034,445,0,0,drop,70,70,0,1,0,1,0
65359,445,0,0,drop,70,70,0,1,0,1,0
50806,445,0,0,drop,70,70,0,1,0,1,0
56371,445,0,0,drop,66,66,0,1,0,1,0
59962,443,64092,443,allow,19201,1566,17635,34,16,16,18
42298,40007,25770,40007,allow,206,84,122,4,29,2,2
49761,53,14047,53,allow,183,94,89,2,30,1,1
6572,23,0,0,deny,60,60,0,1,0,1,0
63068,443,50738,443,allow,571,166,405,2,30,1,1
52092,80,65314,80,allow,3163,716,2447,12,28,7,5
44402,443,62685,443,allow,196732,11940,184792,257,139,103,154
52006,443,14012,443,allow,2898,2047,851,19,22,11,8
39197,443,22296,443,allow,65158,3519,61639,89,200,41,48
55714,445,0,0,drop,70,70,0,1,0,1,0
50097,53,57646,53,allow,199,94,105,2,30,1,1
61738,445,0,0,drop,70,70,0,1,0,1,0
52238,26467,0,0,deny,62,62,0,1,0,1,0
49526,443,23120,443,allow,6032,1049,4983,18,26,9,9
50535,22,50535,22,allow,6292,2375,3917,35,20,19,16
40893,443,32829,443,allow,10450,3898,6552,20,135,11,9
65026,53,34108,53,allow,193,102,91,2,29,1,1
23844,26467,0,0,deny,62,62,0,1,0,1,0
55818,443,58281,443,allow,5100,2001,3099,15,119,7,8
55820,53,49367,53,allow,194,102,92,2,30,1,1
58638,5900,0,0,deny,62,62,0,1,0,1,0
50052,53,23158,53,allow,789,102,687,2,30,1,1
56312,53,62143,53,allow,711,87,624,2,30,1,1
57340,2258,57340,2258,allow,156,156,0,3,8,3,0
61013,445,0,0,drop,70,70,0,1,0,1,0
60248,80,33298,80,allow,22768,6548,16220,31,149,14,17
55385,53,61909,53,allow,710,89,621,2,0,1,1
2180,63710,0,0,deny,62,62,0,1,0,1,0
49754,53,60786,53,allow,180,94,86,2,30,1,1
56629,25174,0,0,deny,66,66,0,1,0,1,0
56211,445,0,0,drop,66,66,0,1,0,1,0
64505,53,32135,53,allow,214,102,112,2,30,1,1
64556,53,11651,53,allow,195,102,93,2,29,1,1
53890,445,0,0,drop,70,70,0,1,0,1,0
64595,53,64819,53,allow,166,85,81,2,31,1,1
57236,53733,0,0,deny,66,66,0,1,0,1,0
59343,445,0,0,drop,66,66,0,1,0,1,0
64381,443,33769,443,allow,4838,1059,3779,16,54,8,8
65014,53,3896,53,allow,186,95,91,2,31,1,1
55056,443,52975,443,allow,8309,1561,6748,26,204,14,12
37857,443,49755,443,allow,7051,5086,1965,32,100,18,14
49648,443,58904,443,allow,11011,4522,6489,35,45,17,18
43473,53,43473,53,allow,220,100,120,2,30,1,1
56752,53,57000,53,allow,182,93,89,2,30,1,1
56365,53,8027,53,allow,199,102,97,2,30,1,1
48817,41768,48817,41768,allow,511,152,359,2,1200,1,1
10669,49756,0,0,deny,60,60,0,1,0,1,0
50562,37965,0,0,deny,66,66,0,1,0,1,0
55999,53,41388,53,allow,774,101,673,2,30,1,1
54528,53,37583,53,allow,197,94,103,2,30,1,1
35111,22114,0,0,deny,66,66,0,1,0,1,0
43326,443,43455,443,allow,8065,2689,5376,27,315,14,13
57813,443,65376,443,allow,6163,925,5238,18,109,10,8
33671,443,8770,443,allow,12536,1564,10972,30,809,13,17
49234,53,14008,53,allow,177,94,83,2,30,1,1
55032,62413,0,0,deny,66,66,0,1,0,1,0
64624,445,0,0,drop,66,66,0,1,0,1,0
50560,53,62139,53,allow,755,94,661,2,30,1,1
5841,22114,0,0,deny,62,62,0,1,0,1,0
64825,53,38972,53,allow,184,94,90,2,30,1,1
65481,53,17512,53,allow,168,86,82,2,30,1,1
39460,23117,0,0,deny,62,62,0,1,0,1,0
52287,445,0,0,drop,66,66,0,1,0,1,0
62723,445,0,0,drop,70,70,0,1,0,1,0
65231,50584,0,0,deny,66,66,0,1,0,1,0
65249,53,43445,53,allow,733,94,639,2,30,1,1
42487,443,53584,443,allow,4887,895,3992,16,29,9,7
1128,44847,0,0,deny,62,62,0,1,0,1,0
53214,80,58168,80,allow,19877,856,19021,22,16,6,16
52711,37965,0,0,deny,62,62,0,1,0,1,0
45082,17,0,0,deny,60,60,0,1,0,1,0
60396,443,5888,443,allow,5964,1586,4378,19,80,10,9
59374,445,0,0,drop,70,70,0,1,0,1,0
53865,64000,37089,64000,allow,492,306,186,8,15,5,3
57470,1337,6563,1337,allow,330,330,0,6,1200,6,0
60929,80,45754,80,allow,2235,1055,1180,12,15,7,5
64086,443,64086,443,allow,79107,10743,68364,96,172,42,54
60356,445,0,0,drop,66,66,0,1,0,1,0
62768,445,0,0,drop,70,70,0,1,0,1,0
57782,445,0,0,drop,66,66,0,1,0,1,0
54982,53,26204,53,allow,282,96,186,4,48,2,2
37662,443,57596,443,allow,4428,2241,2187,19,46,11,8
51559,443,32426,443,allow,254,70,184,5,21,2,3
57470,64108,16646,64108,allow,330,330,0,6,1199,6,0
51356,22114,0,0,deny,62,62,0,1,0,1,0
58638,5900,0,0,deny,62,62,0,1,0,1,0
51859,35365,59521,35365,allow,70,70,0,1,5,1,0
49981,53,44663,53,allow,360,102,258,2,30,1,1
56066,53,44669,53,allow,196,86,110,2,30,1,1
47903,443,31427,443,allow,9323,2192,7131,25,25,13,12
47928,443,47928,443,allow,4564,1657,2907,19,27,11,8
49291,53,35462,53,allow,212,102,110,2,29,1,1
58039,445,0,0,drop,66,66,0,1,0,1,0
48550,443,45303,443,allow,778,358,420,12,43,6,6
56039,50584,0,0,deny,66,66,0,1,0,1,0
49831,30188,0,0,deny,62,62,0,1,0,1,0
14844,37965,0,0,deny,62,62,0,1,0,1,0
54359,445,0,0,drop,70,70,0,1,0,1,0
51848,28960,25741,28960,allow,70,70,0,2,9,2,0
49936,53,34115,53,allow,318,110,208,4,50,2,2
48337,443,44874,443,allow,227876,8050,219826,236,36,83,153
19875,30170,0,0,deny,145,145,0,1,0,1,0
57446,443,49278,443,allow,9642,3343,6299,37,16,17,20
49684,80,60336,80,allow,13889,4084,9805,27,16,13,14
65384,57470,0,0,deny,66,66,0,1,0,1,0
51221,50861,60298,50861,allow,490,149,341,2,1200,1,1
60210,445,0,0,drop,70,70,0,1,0,1,0
52696,21247,0,0,deny,66,66,0,1,0,1,0
51961,443,43999,443,allow,6913,1658,5255,22,17,12,10
55052,443,42502,443,allow,4425,876,3549,15,29,8,7
51122,445,0,0,drop,66,66,0,1,0,1,0
14263,22114,0,0,deny,62,62,0,1,0,1,0
35104,53,13881,53,allow,168,78,90,2,29,1,1
65189,27016,20619,27016,allow,249,78,171,2,29,1,1
55505,53,30588,53,allow,199,102,97,2,31,1,1
37906,443,31579,443,allow,416,210,206,7,26,4,3
56800,443,33972,443,allow,7518,2862,4656,18,75,10,8
47594,443,65055,443,allow,5447,1074,4373,21,17,10,11
2425,23117,0,0,deny,66,66,0,1,0,1,0
62330,443,31152,443,allow,21361086,218978,21142108,16512,170,2203,14309
59199,445,0,0,drop,70,70,0,1,0,1,0
49978,445,0,0,drop,70,70,0,1,0,1,0
44847,2499,58207,2499,allow,502,150,352,2,1200,1,1
64156,445,0,0,drop,70,70,0,1,0,1,0
49861,445,0,0,drop,70,70,0,1,0,1,0
58755,443,8030,443,allow,11839,7753,4086,30,17,15,15
57908,445,0,0,drop,66,66,0,1,0,1,0
55814,445,0,0,drop,70,70,0,1,0,1,0
57194,445,0,0,drop,70,70,0,1,0,1,0
10914,35974,0,0,deny,60,60,0,1,0,1,0
51947,16935,4514,16935,allow,70,70,0,1,5,1,0
46056,80,34041,80,allow,5066,4404,662,11,30,6,5
65373,53,50644,53,allow,197,102,95,2,31,1,1
49831,53,63335,53,allow,198,94,104,2,30,1,1
20389,64147,0,0,deny,66,66,0,1,0,1,0
42955,80,63046,80,allow,72023,4897,67126,97,115,46,51
56853,53,30375,53,allow,167,86,81,2,29,1,1
53577,53,0,0,allow,82,82,0,2,40,2,0
55715,53,53520,53,allow,168,86,82,2,30,1,1
65428,53,32499,53,allow,190,97,93,2,31,1,1
56988,53,29456,53,allow,216,110,106,2,30,1,1
31235,22114,0,0,deny,146,146,0,1,0,1,0
58658,445,0,0,drop,66,66,0,1,0,1,0
54964,445,0,0,drop,66,66,0,1,0,1,0
46495,4607,0,0,deny,60,60,0,1,0,1,0
62082,445,0,0,drop,70,70,0,1,0,1,0
65249,25864,0,0,deny,72,72,0,1,0,1,0
62748,445,0,0,drop,70,70,0,1,0,1,0
64181,53,43777,53,allow,194,102,92,2,30,1,1
58935,443,64941,443,allow,5167,700,4467,16,15,7,9
5588,5588,0,0,allow,3354,1792,1562,46,195,23,23
34146,51221,0,0,deny,62,62,0,1,0,1,0
59703,443,2631,443,allow,8867,2701,6166,21,105,9,12
31780,11392,0,0,deny,62,62,0,1,0,1,0
65189,27268,56111,27268,allow,232,78,154,2,29,1,1
45218,25174,0,0,deny,62,62,0,1,0,1,0
64487,53,6176,53,allow,225,110,115,2,30,1,1
40159,53,40159,53,allow,229,89,140,2,31,1,1
65212,53,36121,53,allow,230,102,128,2,30,1,1
38770,443,2311,443,allow,7431,3525,3906,18,15,10,8
52076,44847,0,0,deny,66,66,0,1,0,1,0
58029,445,0,0,drop,70,70,0,1,0,1,0
65479,445,0,0,drop,70,70,0,1,0,1,0
443,60496,0,0,deny,187,187,0,1,0,1,0
52179,14354,22942,14354,allow,70,70,0,1,5,1,0
46859,50584,0,0,deny,62,62,0,1,0,1,0
49947,80,44031,80,allow,362232,10443,351789,387,15,147,240
65220,53,55552,53,allow,172,88,84,2,31,1,1
63411,445,0,0,drop,70,70,0,1,0,1,0
57072,53,31261,53,allow,816,102,714,2,29,1,1
49498,443,65049,443,allow,5394,2785,2609,14,134,7,7
56445,445,0,0,drop,70,70,0,1,0,1,0
59867,445,0,0,drop,70,70,0,1,0,1,0
64199,50584,0,0,deny,146,146,0,1,0,1,0
38645,443,41278,443,allow,2535,1177,1358,16,28,7,9
56672,53,60163,53,allow,199,102,97,2,30,1,1
57231,53,46027,53,allow,168,86,82,2,30,1,1
50771,80,8237,80,allow,6420,677,5743,13,151,6,7
9605,57470,0,0,deny,62,62,0,1,0,1,0
51540,445,0,0,drop,70,70,0,1,0,1,0
50552,445,0,0,drop,70,70,0,1,0,1,0
57970,445,0,0,drop,66,66,0,1,0,1,0
45855,25174,0,0,deny,146,146,0,1,0,1,0
51504,445,0,0,drop,66,66,0,1,0,1,0
49329,445,0,0,drop,66,66,0,1,0,1,0
64942,445,0,0,drop,70,70,0,1,0,1,0
44847,6881,46281,6881,allow,150,150,0,1,1200,1,0
53166,445,0,0,drop,70,70,0,1,0,1,0
49421,443,23073,443,allow,301494,6917,294577,306,48,101,205
57019,53,50222,53,allow,193,102,91,2,30,1,1
53139,445,0,0,drop,66,66,0,1,0,1,0
8622,64147,0,0,deny,66,66,0,1,0,1,0
12549,50265,0,0,deny,146,146,0,1,0,1,0
44907,5900,44907,5900,allow,130,66,64,2,4,1,1
55677,53,14201,53,allow,177,94,83,2,29,1,1
55321,53,43693,53,allow,186,95,91,2,31,1,1
53789,443,10563,443,allow,499,425,74,4,0,3,1
1027,11392,0,0,deny,62,62,0,1,0,1,0
36663,22114,0,0,deny,62,62,0,1,0,1,0
64971,27026,15730,27026,allow,1012,462,550,4,30,2,2
61673,445,0,0,drop,70,70,0,1,0,1,0
53745,18569,48041,18569,allow,70,70,0,2,8,2,0
59654,445,0,0,drop,70,70,0,1,0,1,0
18713,40108,0,0,deny,146,146,0,1,0,1,0
61801,445,0,0,drop,70,70,0,1,0,1,0
55034,445,0,0,drop,66,66,0,1,0,1,0
55934,53,39869,53,allow,196,102,94,2,31,1,1
54875,445,0,0,drop,70,70,0,1,0,1,0
51981,445,0,0,drop,70,70,0,1,0,1,0
52558,443,32057,443,allow,3530,1002,2528,12,120,6,6
50403,445,0,0,drop,66,66,0,1,0,1,0
52914,445,0,0,drop,70,70,0,1,0,1,0
10167,80,10167,80,allow,450,246,204,8,25,5,3
49197,53,3341,53,allow,249,94,155,2,30,1,1
59476,445,0,0,drop,66,66,0,1,0,1,0
49277,53,3822,53,allow,821,102,719,2,30,1,1
58638,5900,0,0,deny,62,62,0,1,0,1,0
53550,1,57289,1,allow,70,70,0,1,5,1,0
65529,445,0,0,drop,70,70,0,1,0,1,0
45538,5228,21561,5228,allow,2372,1452,920,16,3600,8,8
55487,53,39202,53,allow,195,102,93,2,30,1,1
56773,53,6473,53,allow,735,88,647,2,30,1,1
10273,21247,0,0,deny,66,66,0,1,0,1,0
64804,445,0,0,drop,66,66,0,1,0,1,0
60399,445,0,0,drop,70,70,0,1,0,1,0
37965,56605,48626,56605,allow,847,152,695,4,1201,2,2
64973,53,14211,53,allow,210,102,108,2,30,1,1
56202,53,48899,53,allow,749,94,655,2,30,1,1
33877,443,16562,443,allow,9449,3441,6008,27,41,17,10
52726,56205,0,0,deny,66,66,0,1,0,1,0
61645,443,61645,443,allow,4702,1795,2907,19,28,11,8
51018,445,0,0,drop,70,70,0,1,0,1,0
64579,443,6221,443,allow,24686,1935,22751,36,20,17,19
60142,443,18976,443,allow,2998,1997,1001,16,16,8,8
49552,80,31507,80,allow,1963,1067,896,11,15,6,5
51961,445,0,0,drop,70,70,0,1,0,1,0
49241,8080,49241,8080,allow,12477,3635,8842,23,55,13,10
64862,53,39051,53,allow,211,110,101,2,30,1,1
33982,80,37305,80,allow,1152,712,440,10,15,5,5
64506,53,14791,53,allow,230,94,136,2,30,1,1
60382,62582,16978,62582,allow,70,70,0,1,5,1,0
55562,50584,0,0,deny,66,66,0,1,0,1,0
49449,53,37523,53,allow,216,110,106,2,29,1,1
59579,445,0,0,drop,66,66,0,1,0,1,0
49234,53,56023,53,allow,177,94,83,2,30,1,1
50736,445,0,0,drop,66,66,0,1,0,1,0
56880,53,13587,53,allow,209,110,99,2,30,1,1
65096,37807,0,0,deny,66,66,0,1,0,1,0
8889,25033,0,0,deny,60,60,0,1,0,1,0
39572,443,3299,443,allow,2396,1144,1252,14,982,7,7
58888,23718,0,0,deny,66,66,0,1,0,1,0
55886,445,0,0,drop,70,70,0,1,0,1,0
51563,445,0,0,drop,70,70,0,1,0,1,0
56362,53,16824,53,allow,195,102,93,2,30,1,1
58305,445,0,0,drop,70,70,0,1,0,1,0
55102,80,41246,80,allow,46215,1615,44600,57,18,24,33
58638,5900,0,0,deny,62,62,0,1,0,1,0
54993,53,53914,53,allow,751,95,656,2,31,1,1
49878,53,52467,53,allow,262,126,136,2,30,1,1
58638,5900,0,0,deny,62,62,0,1,0,1,0
58871,443,24134,443,allow,5106,700,4406,15,15,7,8
65180,53,33252,53,allow,751,95,656,2,30,1,1
49965,53,10762,53,allow,226,110,116,2,30,1,1
55293,445,0,0,drop,70,70,0,1,0,1,0
65224,53,48832,53,allow,758,93,665,2,30,1,1
49658,53,46008,53,allow,195,102,93,2,29,1,1
63037,445,0,0,drop,66,66,0,1,0,1,0
53875,43611,37582,43611,allow,70,70,0,1,5,1,0
53838,443,50005,443,allow,499,425,74,4,0,3,1
39966,53,39966,53,allow,235,90,145,2,32,1,1
26379,23,0,0,deny,60,60,0,1,0,1,0
26900,27017,43852,27017,allow,422,164,258,6,29,3,3
51947,443,7702,443,allow,3893,2046,1847,29,56,16,13
59424,50265,0,0,deny,74,74,0,1,0,1,0
49284,53,55787,53,allow,185,102,83,2,30,1,1
17315,11392,0,0,deny,66,66,0,1,0,1,0
49622,443,43494,443,allow,15336,2803,12533,47,202,24,23
63461,51505,0,0,deny,66,66,0,1,0,1,0
53495,445,0,0,drop,70,70,0,1,0,1,0
56256,445,0,0,drop,66,66,0,1,0,1,0
39375,443,57783,443,allow,36154,9709,26445,60,161,27,33
60146,53,47250,53,allow,218,78,140,2,30,1,1
56450,53,63813,53,allow,177,94,83,2,30,1,1
4009,53,4009,53,allow,231,88,143,2,33,1,1
50518,445,0,0,drop,70,70,0,1,0,1,0
58439,445,0,0,drop,66,66,0,1,0,1,0
38852,37965,0,0,deny,62,62,0,1,0,1,0
58936,80,60272,80,allow,10003,5095,4908,21,76,12,9
55877,445,0,0,drop,70,70,0,1,0,1,0
49515,443,49515,443,allow,102168,31819,70349,140,62,75,65
45882,443,31867,443,allow,6617,1852,4765,23,132,13,10
51553,445,0,0,drop,66,66,0,1,0,1,0
39496,80,39496,80,allow,2898,1485,1413,10,15,6,4
65361,53,33877,53,allow,760,97,663,2,30,1,1
50478,51505,0,0,deny,66,66,0,1,0,1,0
12951,50584,0,0,deny,66,66,0,1,0,1,0
58413,445,0,0,drop,70,70,0,1,0,1,0
49516,53,42173,53,allow,183,94,89,2,30,1,1
65256,53,29045,53,allow,357,105,252,4,57,2,2
57371,445,0,0,drop,70,70,0,1,0,1,0
443,58101,0,0,deny,60,60,0,1,0,1,0
61530,445,0,0,drop,66,66,0,1,0,1,0
53981,445,0,0,drop,70,70,0,1,0,1,0
63937,53,1528,53,allow,183,94,89,2,29,1,1
52399,445,0,0,drop,70,70,0,1,0,1,0
58492,443,51321,443,allow,5611,1560,4051,22,266,13,9
53102,443,30366,443,allow,7149,1719,5430,18,326,9,9
50700,80,4259,80,allow,417,417,0,4,9,4,0
56937,53,51825,53,allow,178,91,87,2,30,1,1
13062,52752,0,0,deny,66,66,0,1,0,1,0
54455,443,54455,443,allow,324001,46592,277409,409,177,203,206
46985,53,9920,53,allow,199,94,105,2,30,1,1
56753,80,58241,80,allow,1462,703,759,8,16,5,3
55430,443,62629,443,allow,805321,15163,790158,752,171,204,548
9687,57470,0,0,deny,78,78,0,1,0,1,0
60132,445,0,0,drop,66,66,0,1,0,1,0
56221,445,0,0,drop,66,66,0,1,0,1,0
38086,53,54095,53,allow,199,94,105,2,30,1,1
56201,445,0,0,drop,70,70,0,1,0,1,0
64087,445,0,0,drop,70,70,0,1,0,1,0
58638,5900,0,0,deny,62,62,0,1,0,1,0
41576,443,6870,443,allow,5954,1607,4347,27,215,14,13
56456,1433,0,0,deny,60,60,0,1,0,1,0
56288,53,34669,53,allow,183,94,89,2,30,1,1
36793,80,35918,80,allow,156726,8626,148100,206,32,104,102
59416,443,53026,443,allow,10642,3654,6988,26,125,14,12
58610,445,0,0,drop,66,66,0,1,0,1,0
50000,53,12799,53,allow,216,110,106,2,31,1,1
57411,53,7355,53,allow,196,102,94,2,30,1,1
57443,443,31881,443,allow,8287,2469,5818,31,18,14,17
61273,25174,0,0,deny,146,146,0,1,0,1,0
17262,25174,0,0,deny,146,146,0,1,0,1,0
50968,445,0,0,drop,70,70,0,1,0,1,0
64689,445,0,0,drop,66,66,0,1,0,1,0
53146,443,41053,443,allow,29874004,955051,28918953,31844,303,10580,21264
40988,60043,0,0,deny,146,146,0,1,0,1,0
60300,80,12014,80,allow,1343,846,497,11,145,6,5
52016,80,9292,80,allow,124703,6134,118569,147,125,64,83
57047,445,0,0,drop,70,70,0,1,0,1,0
55159,53,25315,53,allow,199,102,97,2,29,1,1
57367,53,62826,53,allow,170,87,83,2,30,1,1
51869,443,60062,443,allow,4435,1290,3145,17,31,9,8
51576,443,48626,443,allow,21523,4681,16842,37,149,18,19
44815,36829,0,0,deny,62,62,0,1,0,1,0
59236,17,0,0,deny,60,60,0,1,0,1,0
55045,53,38947,53,allow,747,92,655,2,30,1,1
62918,993,34205,993,allow,8324,3635,4689,76,53,35,41
35180,443,55162,443,allow,13838,1370,12468,26,34,13,13
49418,31000,20791,31000,allow,78,78,0,1,30,1,0
56778,443,16345,443,allow,8654,2150,6504,20,15,11,9
59165,53,3283,53,allow,186,78,108,2,30,1,1
34916,51185,0,0,deny,62,62,0,1,0,1,0
49341,53,47990,53,allow,199,102,97,2,31,1,1
59522,443,54778,443,allow,8743,2676,6067,30,25,16,14
55648,80,53307,80,allow,70,70,0,2,8,2,0
61407,443,61407,443,allow,4552,1645,2907,19,26,11,8
53835,445,0,0,drop,66,66,0,1,0,1,0
53041,443,37580,443,allow,7263,1834,5429,27,16,15,12
50448,443,40818,443,allow,1119,595,524,12,26,6,6
34487,443,45811,443,allow,8363,1573,6790,24,49,14,10
36236,443,36236,443,allow,4625,1718,2907,19,31,11,8
54476,443,29193,443,allow,48303,3997,44306,69,271,30,39
50306,443,54494,443,allow,9889,2800,7089,28,82,17,11
52068,39864,59001,39864,allow,70,70,0,2,8,2,0
50582,443,54824,443,allow,7453,1467,5986,19,25,10,9
49851,53,3240,53,allow,166,86,80,2,30,1,1
9472,443,45589,443,allow,5699,505,5194,14,15,7,7
37959,3855,0,0,deny,72,72,0,1,0,1,0
41156,443,9223,443,allow,59486,3261,56225,74,360,29,45
53437,445,0,0,drop,70,70,0,1,0,1,0
64287,53,20763,53,allow,178,91,87,2,31,1,1
55098,53,15101,53,allow,474,200,274,6,43,3,3
56020,53,24675,53,allow,168,86,82,2,31,1,1
34988,53,12799,53,allow,199,94,105,2,30,1,1
56047,445,0,0,drop,66,66,0,1,0,1,0
56304,53,20690,53,allow,184,94,90,2,30,1,1
58449,445,0,0,drop,70,70,0,1,0,1,0
52853,445,0,0,drop,66,66,0,1,0,1,0
49840,443,58601,443,allow,6998,1906,5092,22,24,12,10
32156,51505,0,0,deny,146,146,0,1,0,1,0
46495,4607,0,0,deny,60,60,0,1,0,1,0
65452,445,0,0,drop,70,70,0,1,0,1,0
55666,35440,0,0,deny,60,60,0,1,0,1,0
54197,445,0,0,drop,66,66,0,1,0,1,0
64091,53,24113,53,allow,178,94,84,2,30,1,1
52080,9554,2824,9554,allow,70,70,0,2,7,2,0
53247,445,0,0,drop,70,70,0,1,0,1,0
50979,445,0,0,drop,66,66,0,1,0,1,0
50470,61463,0,0,deny,86,86,0,1,0,1,0
53394,53,24735,53,allow,86,86,0,1,30,1,0
123,123,41547,123,allow,184,94,90,2,30,1,1
0,0,0,0,allow,244,244,0,2,0,2,0
59661,445,0,0,drop,66,66,0,1,0,1,0
59210,8168,0,0,deny,66,66,0,1,0,1,0
37635,443,24027,443,allow,9406,2044,7362,27,21,16,11
64788,43890,0,0,deny,66,66,0,1,0,1,0
52154,4635,63801,4635,allow,70,70,0,2,8,2,0
59874,22114,0,0,deny,66,66,0,1,0,1,0
46162,25174,0,0,deny,146,146,0,1,0,1,0
53928,445,0,0,drop,70,70,0,1,0,1,0
8412,8412,23033,8412,allow,66,66,0,1,30,1,0
64146,53,41885,53,allow,194,99,95,2,31,1,1
60402,80,24295,80,allow,1135,736,399,7,95,4,3
46587,57470,0,0,deny,66,66,0,1,0,1,0
55838,445,0,0,drop,70,70,0,1,0,1,0
52506,445,0,0,drop,70,70,0,1,0,1,0
49321,445,0,0,drop,70,70,0,1,0,1,0
45908,33330,0,0,deny,60,60,0,1,0,1,0
53691,11528,36171,11528,allow,492,306,186,8,16,5,3
4269,26672,0,0,deny,60,60,0,1,0,1,0
49539,53,64502,53,allow,340,87,253,4,50,2,2
51027,445,0,0,drop,70,70,0,1,0,1,0
49938,57470,0,0,deny,62,62,0,1,0,1,0
34070,53,34070,53,allow,250,108,142,2,30,1,1
51414,443,57873,443,allow,8292,2164,6128,31,120,17,14
46280,443,46280,443,allow,4754,1847,2907,19,26,11,8
24285,26467,0,0,deny,62,62,0,1,0,1,0
52032,55505,56842,55505,allow,70,70,0,2,8,2,0
57470,62348,3608,62348,allow,149,149,0,1,1200,1,0
55164,53,14668,53,allow,177,94,83,2,30,1,1
59757,443,52007,443,allow,384,166,218,2,29,1,1
34767,443,6327,443,allow,6313,1368,4945,21,846,11,10
64683,445,0,0,drop,70,70,0,1,0,1,0
60474,53,36065,53,allow,195,94,101,2,30,1,1
49360,445,0,0,drop,70,70,0,1,0,1,0
49521,53,3193,53,allow,183,94,89,2,30,1,1
64406,53,3194,53,allow,102,102,0,1,30,1,0
64853,53,39005,53,allow,199,102,97,2,30,1,1
49945,53,3434,53,allow,281,97,184,4,57,2,2
49687,445,0,0,drop,70,70,0,1,0,1,0
53079,80,59311,80,allow,2424,1110,1314,11,78,7,4
59090,445,0,0,drop,70,70,0,1,0,1,0
58582,445,0,0,drop,66,66,0,1,0,1,0
49337,443,20876,443,allow,3185,2263,922,18,26,9,9
6666,6001,0,0,deny,60,60,0,1,0,1,0
56721,443,14378,443,allow,7889,1900,5989,20,15,11,9
63404,445,0,0,drop,66,66,0,1,0,1,0
58998,445,0,0,drop,66,66,0,1,0,1,0
49235,8080,49235,8080,allow,2600,844,1756,13,136,7,6
47276,443,16535,443,allow,7613,2230,5383,22,360,11,11
48817,6889,48817,6889,allow,480,149,331,2,1200,1,1
53689,42719,61267,42719,allow,70,70,0,2,7,2,0
49152,53,49230,53,allow,211,110,101,2,31,1,1
56677,53,47518,53,allow,200,102,98,2,30,1,1
45964,2225,0,0,deny,60,60,0,1,0,1,0
64587,43890,0,0,deny,62,62,0,1,0,1,0
56767,53,58838,53,allow,177,94,83,2,30,1,1
2049,23,0,0,deny,60,60,0,1,0,1,0
58638,5900,0,0,deny,62,62,0,1,0,1,0
3978,35440,0,0,deny,62,62,0,1,0,1,0
61661,445,0,0,drop,70,70,0,1,0,1,0
43101,443,55812,443,allow,20846,11163,9683,55,318,30,25
64949,44847,0,0,deny,66,66,0,1,0,1,0
50016,80,57935,80,allow,827,687,140,6,32,4,2
36657,443,2188,443,allow,10985,3186,7799,29,204,14,15
49187,2710,53094,2710,allow,70,70,0,1,5,1,0
56101,53,11714,53,allow,194,102,92,2,30,1,1
49771,53,28192,53,allow,177,94,83,2,29,1,1
55875,53,42726,53,allow,228,110,118,2,30,1,1
52232,35126,34717,35126,allow,70,70,0,1,5,1,0
58357,62413,0,0,deny,62,62,0,1,0,1,0
63867,35993,0,0,deny,66,66,0,1,0,1,0
62766,445,0,0,drop,70,70,0,1,0,1,0
59023,64097,0,0,deny,66,66,0,1,0,1,0
51346,51221,0,0,deny,74,74,0,1,0,1,0
40458,53,17783,53,allow,168,78,90,2,31,1,1
53681,31466,20007,31466,allow,70,70,0,1,5,1,0
59925,443,55867,443,allow,10302,3853,6449,27,61,16,11
41916,53,0,0,deny,60,60,0,1,0,1,0
38664,443,19990,443,allow,8195,1780,6415,23,60,12,11
65528,53,47715,53,allow,217,75,142,4,30,2,2
50265,38203,29229,38203,allow,480,149,331,2,1200,1,1
36132,80,36132,80,allow,514,246,268,9,76,5,4
52990,443,9852,443,allow,7093,2235,4858,39,111,20,19
49860,53,13520,53,allow,550,129,421,4,57,2,2
61875,445,0,0,drop,70,70,0,1,0,1,0
49323,53,47360,53,allow,196,102,94,2,29,1,1
49382,53,52485,53,allow,200,102,98,2,31,1,1
62872,445,0,0,drop,66,66,0,1,0,1,0
60420,443,16410,443,allow,7330,1565,5765,20,134,10,10
9436,443,44079,443,allow,5693,499,5194,14,15,7,7
58889,445,0,0,drop,70,70,0,1,0,1,0
4594,35993,0,0,deny,66,66,0,1,0,1,0
57987,56125,0,0,deny,90,90,0,1,0,1,0
57470,1,27948,1,allow,132,132,0,3,1199,3,0
64249,53,23999,53,allow,181,94,87,2,33,1,1
57456,443,62626,443,allow,6350,1550,4800,23,41,12,11
17702,6881,0,0,deny,66,66,0,1,0,1,0
49644,30188,0,0,deny,66,66,0,1,0,1,0
40033,80,40033,80,allow,424,198,226,7,142,4,3
25448,23,25448,23,allow,66,66,0,1,5,1,0
65037,53,41367,53,allow,210,110,100,2,29,1,1
53932,80,32355,80,allow,1134,465,669,9,18,6,3
55684,53,10799,53,allow,186,95,91,2,30,1,1
57341,3389,57341,3389,allow,3428,1714,1714,16,33,8,8
59451,50584,0,0,deny,62,62,0,1,0,1,0
51572,443,51572,443,allow,1724,916,808,17,128,7,10
56148,37965,0,0,deny,66,66,0,1,0,1,0
28824,44847,0,0,deny,62,62,0,1,0,1,0
49889,53,48150,53,allow,197,102,95,2,31,1,1
50261,443,64119,443,allow,10320,3495,6825,45,136,25,20
54262,53,54262,53,allow,198,90,108,2,30,1,1
61637,445,0,0,drop,70,70,0,1,0,1,0
64862,445,0,0,drop,70,70,0,1,0,1,0
51928,52520,20049,52520,allow,258,70,188,4,8,2,2
55290,445,0,0,drop,66,66,0,1,0,1,0
56453,53,58094,53,allow,243,94,149,2,30,1,1
65471,53,5865,53,allow,441,90,351,4,48,2,2
40890,53,0,0,allow,86,86,0,1,30,1,0
60952,443,35261,443,allow,391561,17125,374436,478,17,213,265
56196,445,0,0,drop,66,66,0,1,0,1,0
55342,53,5897,53,allow,323,110,213,2,30,1,1
56318,445,0,0,drop,70,70,0,1,0,1,0
64853,53,57521,53,allow,814,110,704,2,29,1,1
38573,443,38573,443,allow,5744,2534,3210,24,80,14,10
55495,53,17025,53,allow,210,110,100,2,30,1,1
64404,53,7876,53,allow,251,110,141,2,30,1,1
64811,53,22274,53,allow,195,102,93,2,29,1,1
15465,64147,0,0,deny,66,66,0,1,0,1,0
50894,80,18419,80,allow,53024,5569,47455,72,140,35,37
57262,53,33477,53,allow,180,94,86,2,30,1,1
49475,53,30283,53,allow,819,102,717,2,30,1,1
65469,53,60792,53,allow,327,110,217,2,30,1,1
58195,38303,0,0,deny,66,66,0,1,0,1,0
48692,57470,0,0,deny,62,62,0,1,0,1,0
62131,50584,0,0,deny,66,66,0,1,0,1,0
49418,27015,11506,27015,allow,248,78,170,2,30,1,1
1081,43109,0,0,deny,146,146,0,1,0,1,0
56250,36237,0,0,deny,66,66,0,1,0,1,0
49257,53,2534,53,allow,198,101,97,2,30,1,1
51604,443,15214,443,allow,2911,2062,849,14,134,8,6
52982,25174,0,0,deny,146,146,0,1,0,1,0
54286,123,33034,123,allow,184,94,90,2,30,1,1
51414,22,0,0,deny,60,60,0,1,0,1,0
53227,443,53227,443,allow,4107,2486,1621,20,24,10,10
51410,445,0,0,drop,70,70,0,1,0,1,0
50359,80,41698,80,allow,318,192,126,6,28,4,2
54583,445,0,0,drop,66,66,0,1,0,1,0
55246,31573,0,0,deny,66,66,0,1,0,1,0
9189,443,50417,443,allow,4941,429,4512,12,15,6,6
59744,80,14710,80,allow,699554,16426,683128,701,95,244,457
53500,443,28730,443,allow,3036,975,2061,14,136,7,7
61908,7000,61908,7000,allow,4131,1750,2381,17,15,9,8
60489,445,0,0,drop,66,66,0,1,0,1,0
55844,445,0,0,drop,70,70,0,1,0,1,0
55386,32480,0,0,deny,62,62,0,1,0,1,0
61277,445,0,0,drop,70,70,0,1,0,1,0
61497,443,26455,443,allow,15302,2355,12947,30,32,14,16
50534,53,37578,53,allow,168,86,82,2,31,1,1
64021,53,21293,53,allow,190,97,93,2,30,1,1
58638,5900,0,0,deny,62,62,0,1,0,1,0
6881,6881,22683,6881,allow,502,150,352,2,1200,1,1
53710,27935,28057,27935,allow,70,70,0,2,7,2,0
59147,25174,0,0,deny,62,62,0,1,0,1,0
49757,53,24825,53,allow,212,94,118,2,29,1,1
60884,443,11637,443,allow,7411,3022,4389,26,46,15,11
53165,18504,45814,18504,allow,70,70,0,2,8,2,0
58638,5900,0,0,deny,62,62,0,1,0,1,0
45964,2666,0,0,deny,60,60,0,1,0,1,0
49339,445,0,0,drop,70,70,0,1,0,1,0
13418,22,0,0,deny,60,60,0,1,0,1,0
49724,53,13142,53,allow,183,94,89,2,30,1,1
57428,53,16884,53,allow,198,94,104,2,30,1,1
49418,27025,65106,27025,allow,240,78,162,2,30,1,1
26921,37965,0,0,deny,62,62,0,1,0,1,0
35743,443,39300,443,allow,560,280,280,9,28,5,4
51743,64147,0,0,deny,62,62,0,1,0,1,0
57158,53,11939,53,allow,969,86,883,2,30,1,1
49781,53,57974,53,allow,188,96,92,2,30,1,1
55275,445,0,0,drop,70,70,0,1,0,1,0
54654,445,0,0,drop,66,66,0,1,0,1,0
6932,80,6932,80,allow,124405,3747,120658,131,38,46,85
55267,53,26990,53,allow,214,102,112,2,29,1,1
59393,25174,0,0,deny,66,66,0,1,0,1,0
54924,443,20791,443,allow,53816,22991,30825,139,306,71,68
3478,61463,0,0,deny,441,441,0,1,0,1,0
50138,445,0,0,drop,70,70,0,1,0,1,0
10035,443,49026,443,allow,7915,1634,6281,25,315,11,14
60011,443,4713,443,allow,11061,2230,8831,40,109,23,17
57350,53,53074,53,allow,257,94,163,2,30,1,1
64996,53,37849,53,allow,547,91,456,4,35,2,2
53706,80,53481,80,allow,1398,590,808,9,111,6,3
54976,2273,0,0,deny,60,60,0,1,0,1,0
52033,445,0,0,drop,70,70,0,1,0,1,0
59896,445,0,0,drop,70,70,0,1,0,1,0
51915,443,2041,443,allow,362,180,182,7,28,4,3
65487,53,56832,53,allow,210,110,100,2,30,1,1
49194,443,5495,443,allow,605037,246018,359019,1735,1300,846,889
41677,57470,0,0,deny,66,66,0,1,0,1,0
49676,53,32954,53,allow,197,102,95,2,30,1,1
42980,80,62897,80,allow,944,529,415,11,315,6,5
42630,443,10044,443,allow,6039,1327,4712,19,121,11,8
54997,26467,0,0,deny,62,62,0,1,0,1,0
51037,445,0,0,drop,66,66,0,1,0,1,0
51798,80,50477,80,allow,1825,824,1001,21,134,11,10
64113,53,33491,53,allow,294,134,160,2,30,1,1
48016,57470,0,0,deny,62,62,0,1,0,1,0
9243,80,7873,80,allow,318,192,126,6,26,4,2
52598,445,0,0,drop,66,66,0,1,0,1,0
62005,445,0,0,drop,70,70,0,1,0,1,0
50338,443,61638,443,allow,6441,1651,4790,22,53,12,10
50140,53,8390,53,allow,177,94,83,2,30,1,1
49305,57470,0,0,deny,66,66,0,1,0,1,0
5588,5588,0,0,allow,3354,1792,1562,46,195,23,23
64214,53,1437,53,allow,337,106,231,4,43,2,2
49646,53,41795,53,allow,209,102,107,2,30,1,1
54280,3398,0,0,deny,60,60,0,1,0,1,0
51313,33669,0,0,deny,100,100,0,1,0,1,0
59147,445,0,0,drop,66,66,0,1,0,1,0
9432,443,6777,443,allow,6094,771,5323,17,26,9,8
55587,43890,0,0,deny,66,66,0,1,0,1,0
52471,22114,0,0,deny,66,66,0,1,0,1,0
5588,5588,0,0,allow,3354,1792,1562,46,195,23,23
58056,443,35080,443,allow,10493,2658,7835,50,1469,26,24
62799,25174,0,0,deny,62,62,0,1,0,1,0
13484,37965,0,0,deny,66,66,0,1,0,1,0
58944,445,0,0,drop,66,66,0,1,0,1,0
60426,57470,0,0,deny,62,62,0,1,0,1,0
39325,443,37130,443,allow,1396,735,661,14,80,8,6
60297,25604,0,0,deny,62,62,0,1,0,1,0
48706,23393,0,0,deny,60,60,0,1,0,1,0
58885,445,0,0,drop,66,66,0,1,0,1,0
60401,445,0,0,drop,70,70,0,1,0,1,0
14997,57470,0,0,deny,72,72,0,1,0,1,0
51824,445,0,0,drop,70,70,0,1,0,1,0
53012,443,44779,443,allow,13938,3220,10718,44,93,21,23
56492,443,36078,443,allow,3715,1659,2056,35,188,18,17
9401,443,34975,443,allow,7135,1346,5789,21,32,10,11
51575,445,0,0,drop,66,66,0,1,0,1,0
23031,22114,0,0,deny,146,146,0,1,0,1,0
56169,53,53942,53,allow,210,110,100,2,30,1,1
50620,445,0,0,drop,66,66,0,1,0,1,0
1091,37965,0,0,deny,62,62,0,1,0,1,0
54612,445,0,0,drop,70,70,0,1,0,1,0
50584,49001,15411,49001,allow,889,161,728,3,1200,2,1
64672,53,41499,53,allow,576,195,381,6,51,3,3
53867,445,0,0,drop,70,70,0,1,0,1,0
19330,25174,0,0,deny,146,146,0,1,0,1,0
57406,53,28886,53,allow,761,100,661,2,30,1,1
50272,53,9644,53,allow,744,95,649,2,30,1,1
50356,445,0,0,drop,66,66,0,1,0,1,0
64744,3389,64744,3389,allow,3428,1714,1714,16,33,8,8
61785,64147,0,0,deny,62,62,0,1,0,1,0
49918,80,19931,80,allow,751,455,296,8,125,5,3
53436,443,53436,443,allow,2505,1460,1045,21,102,10,11
5223,16383,0,0,deny,66,66,0,1,0,1,0
52340,22114,0,0,deny,66,66,0,1,0,1,0
55586,445,0,0,drop,70,70,0,1,0,1,0
63718,80,18056,80,allow,314,192,122,6,15,4,2
26900,27017,19370,27017,allow,422,164,258,6,29,3,3
50415,445,0,0,drop,70,70,0,1,0,1,0
49897,443,63900,443,allow,113036,13164,99872,191,144,89,102
26084,36237,0,0,deny,66,66,0,1,0,1,0
53665,445,0,0,drop,70,70,0,1,0,1,0
16387,64075,0,0,deny,60,60,0,1,0,1,0
1528,53,1528,53,allow,193,90,103,2,30,1,1
49569,53,19473,53,allow,198,102,96,2,30,1,1
58446,443,26245,443,allow,111535,9830,101705,141,192,62,79
51419,445,0,0,drop,70,70,0,1,0,1,0
50584,10312,63675,10312,allow,161,161,0,2,1200,2,0
56336,53,15481,53,allow,489,88,401,4,46,2,2
56075,23,0,0,deny,60,60,0,1,0,1,0
10006,64147,0,0,deny,62,62,0,1,0,1,0
2425,23117,0,0,deny,62,62,0,1,0,1,0
56322,80,56322,80,allow,27189,4515,22674,34,23,14,20
8024,80,8024,80,allow,572,240,332,10,83,5,5
34335,23,0,0,deny,60,60,0,1,0,1,0
55920,53,58162,53,allow,770,102,668,2,30,1,1
40819,30975,0,0,deny,157,157,0,1,0,1,0
58638,5900,58638,5900,allow,66,66,0,1,4,1,0
50487,445,0,0,drop,70,70,0,1,0,1,0
52256,41337,31273,41337,allow,316,136,180,6,8,3,3
62874,445,0,0,drop,66,66,0,1,0,1,0
53650,37096,53395,37096,allow,70,70,0,2,8,2,0
26879,37965,0,0,deny,145,145,0,1,0,1,0
27005,27444,25309,27444,allow,893,126,767,2,30,1,1
56243,80,56243,80,allow,101477,1626,99851,93,15,23,70
55478,53,12055,53,allow,170,87,83,2,31,1,1
58850,445,0,0,drop,70,70,0,1,0,1,0
60360,443,62556,443,allow,5212,1101,4111,22,123,12,10
61022,445,0,0,drop,66,66,0,1,0,1,0
54167,50584,0,0,deny,66,66,0,1,0,1,0
52481,443,46031,443,allow,6270,1368,4902,22,15,12,10
60261,25174,0,0,deny,66,66,0,1,0,1,0
56661,443,26302,443,allow,18375,7252,11123,47,40,24,23
57227,445,0,0,drop,70,70,0,1,0,1,0
52926,445,0,0,drop,66,66,0,1,0,1,0
59008,51221,0,0,deny,66,66,0,1,0,1,0
56271,53,27532,53,allow,195,102,93,2,29,1,1
50146,445,0,0,drop,70,70,0,1,0,1,0
29022,23,0,0,deny,60,60,0,1,0,1,0
19789,53,19789,53,allow,371,237,134,3,33,2,1
64592,443,64064,443,allow,24682,1935,22747,36,17,17,19
58869,445,0,0,drop,66,66,0,1,0,1,0
64959,53,59416,53,allow,202,103,99,2,31,1,1
47947,80,61494,80,allow,2917,870,2047,14,16,8,6
52176,17572,9912,17572,allow,70,70,0,1,5,1,0
53813,445,0,0,drop,70,70,0,1,0,1,0
25360,51505,0,0,deny,66,66,0,1,0,1,0
52667,80,1897,80,allow,1272,633,639,9,150,5,4
55165,53,15099,53,allow,199,102,97,2,30,1,1
39886,443,46428,443,allow,315567,15410,300157,404,46,189,215
52029,52093,47612,52093,allow,70,70,0,2,7,2,0
65357,53,40859,53,allow,194,102,92,2,29,1,1
57513,443,18231,443,allow,4346,1212,3134,13,120,6,7
51424,30188,0,0,deny,66,66,0,1,0,1,0
65164,53,40444,53,allow,265,102,163,2,29,1,1
51899,47537,54934,47537,allow,70,70,0,2,8,2,0
56126,445,0,0,drop,66,66,0,1,0,1,0
51433,445,0,0,drop,70,70,0,1,0,1,0
9957,32480,0,0,deny,62,62,0,1,0,1,0
3478,61463,0,0,deny,743,743,0,1,0,1,0
51602,443,19598,443,allow,2013,1363,650,12,134,7,5
49516,53,60499,53,allow,183,94,89,2,29,1,1
62796,445,0,0,drop,70,70,0,1,0,1,0
51853,443,32598,443,allow,7415,1550,5865,28,37,15,13
65273,445,0,0,drop,70,70,0,1,0,1,0
42238,25174,0,0,deny,66,66,0,1,0,1,0
52768,445,0,0,drop,70,70,0,1,0,1,0
55498,53,58802,53,allow,170,87,83,2,30,1,1
3341,23117,0,0,deny,66,66,0,1,0,1,0
52183,13503,62699,13503,allow,70,70,0,2,8,2,0
37635,443,51413,443,allow,4883,1327,3556,18,135,9,9
56477,53,54398,53,allow,199,102,97,2,30,1,1
3377,50584,0,0,deny,62,62,0,1,0,1,0
62130,445,0,0,drop,70,70,0,1,0,1,0
45832,51050,0,0,deny,66,66,0,1,0,1,0
57204,53,58516,53,allow,183,94,89,2,30,1,1
57470,46941,64707,46941,allow,899,288,611,4,1199,2,2
57731,53,26408,53,allow,237,86,151,2,30,1,1
44236,80,40314,80,allow,2982,2565,417,12,15,7,5
3478,61463,0,0,deny,1188,1188,0,1,0,1,0
59902,53,0,0,allow,220,83,137,2,30,1,1
27005,30006,1523,30006,allow,888,126,762,2,31,1,1
50696,445,0,0,drop,66,66,0,1,0,1,0
44355,80,33572,80,allow,26085,2508,23577,52,38,29,23
49654,445,0,0,drop,70,70,0,1,0,1,0
59890,445,0,0,drop,70,70,0,1,0,1,0
53292,445,0,0,drop,70,70,0,1,0,1,0
50427,445,0,0,drop,66,66,0,1,0,1,0
6666,6001,0,0,deny,60,60,0,1,0,1,0
50734,37965,0,0,deny,62,62,0,1,0,1,0
55072,53,38583,53,allow,86,86,0,1,30,1,0
56807,18177,32535,18177,allow,70,70,0,1,5,1,0
56177,443,61837,443,allow,6826,5299,1527,22,330,12,10
52573,445,0,0,drop,70,70,0,1,0,1,0
55827,445,0,0,drop,66,66,0,1,0,1,0
50335,445,0,0,drop,66,66,0,1,0,1,0
64161,445,0,0,drop,66,66,0,1,0,1,0
38688,443,23677,443,allow,90166,3481,86685,96,16,31,65
56711,443,47786,443,allow,8005,1985,6020,20,15,11,9
35101,443,31000,443,allow,4988930,161289,4827641,5384,290,1964,3420
51221,445,0,0,drop,66,66,0,1,0,1,0
52141,443,17579,443,allow,15637,4217,11420,42,83,19,23
51894,26116,38290,26116,allow,70,70,0,2,8,2,0
31845,55777,0,0,deny,62,62,0,1,0,1,0
19872,53,19872,53,allow,235,90,145,2,32,1,1
19983,18242,0,0,reset-both,146,146,0,1,0,1,0
51605,443,55829,443,allow,8095,3030,5065,27,95,14,13
48978,25174,0,0,deny,62,62,0,1,0,1,0
60065,443,12163,443,allow,6395,2524,3871,18,141,10,8
38579,80,3885,80,allow,996,507,489,10,200,5,5
62292,445,0,0,drop,70,70,0,1,0,1,0
64243,53,38194,53,allow,257,102,155,2,30,1,1
43828,44847,0,0,deny,66,66,0,1,0,1,0
63487,129,0,0,deny,60,60,0,1,0,1,0
62498,443,43471,443,allow,14786,3978,10808,32,26,15,17
14615,57866,0,0,deny,66,66,0,1,0,1,0
56697,443,20511,443,allow,8007,1987,6020,20,15,11,9
64201,53,54602,53,allow,434,96,338,4,30,2,2
62792,53,0,0,deny,88,88,0,1,0,1,0
49609,53,22044,53,allow,170,87,83,2,30,1,1
64172,53,37844,53,allow,197,102,95,2,33,1,1
52667,443,52477,443,allow,4797,2794,2003,20,271,11,9
49320,53,59903,53,allow,177,94,83,2,30,1,1
60885,445,0,0,drop,70,70,0,1,0,1,0
54000,53,0,0,allow,202,86,116,2,30,1,1
65359,53,37489,53,allow,210,102,108,2,30,1,1
50596,53,52895,53,allow,168,86,82,2,29,1,1
59725,443,1736,443,allow,89790,6036,83754,112,55,41,71
64346,445,0,0,drop,70,70,0,1,0,1,0
49210,33757,53103,33757,allow,70,70,0,2,8,2,0
58638,5900,0,0,deny,62,62,0,1,0,1,0
39416,443,62311,443,allow,11188,5277,5911,95,587,44,51
60544,445,0,0,drop,70,70,0,1,0,1,0
50971,445,0,0,drop,70,70,0,1,0,1,0
63433,445,0,0,drop,70,70,0,1,0,1,0
55191,445,0,0,drop,70,70,0,1,0,1,0
56847,53,17178,53,allow,761,100,661,2,31,1,1
993,34205,0,0,deny,66,66,0,1,0,1,0
49671,53,2651,53,allow,166,86,80,2,31,1,1
56638,443,50177,443,allow,44984,28294,16690,77,40,40,37
56221,53,42617,53,allow,177,94,83,2,29,1,1
51855,23268,16577,23268,allow,70,70,0,1,5,1,0
56333,53,31573,53,allow,209,110,99,2,30,1,1
56487,53,29660,53,allow,778,103,675,2,31,1,1
14614,25174,0,0,deny,66,66,0,1,0,1,0
55940,445,0,0,drop,66,66,0,1,0,1,0
49573,443,42644,443,allow,111881,6152,105729,137,139,51,86
60792,445,0,0,drop,70,70,0,1,0,1,0
50638,80,16658,80,allow,21873,2252,19621,27,21,10,17
2267,53,19148,53,allow,826,826,0,8,44,8,0
44211,53,44211,53,allow,850,114,736,2,30,1,1
27505,25174,0,0,deny,62,62,0,1,0,1,0
57913,443,36692,443,allow,10457,4216,6241,70,194,31,39
64237,445,0,0,drop,70,70,0,1,0,1,0
62186,445,0,0,drop,66,66,0,1,0,1,0
63280,445,0,0,drop,70,70,0,1,0,1,0
56879,445,0,0,drop,70,70,0,1,0,1,0
11136,15503,0,0,deny,62,62,0,1,0,1,0
10586,37965,0,0,deny,62,62,0,1,0,1,0
50046,443,28953,443,allow,12134,6888,5246,27,37,15,12
60986,445,0,0,drop,70,70,0,1,0,1,0
58326,80,34084,80,allow,804,449,355,9,256,5,4
48889,443,65230,443,allow,87648,6895,80753,131,364,66,65
63925,18912,65425,18912,allow,66,66,0,2,8,2,0
51690,443,24259,443,allow,9320,4615,4705,25,120,12,13
52015,443,52015,443,allow,32358,7474,24884,49,49,23,26
54445,445,0,0,drop,66,66,0,1,0,1,0
43704,465,0,0,deny,60,60,0,1,0,1,0
64893,53,31080,53,allow,232,102,130,2,30,1,1
57246,445,0,0,drop,70,70,0,1,0,1,0
64026,53,1792,53,allow,211,102,109,2,30,1,1
51952,50967,36786,50967,allow,70,70,0,2,7,2,0
63699,445,0,0,drop,66,66,0,1,0,1,0
48681,11392,0,0,deny,62,62,0,1,0,1,0
19875,30170,0,0,deny,145,145,0,1,0,1,0
50050,445,0,0,drop,66,66,0,1,0,1,0
54858,443,53726,443,allow,5252,3392,1860,22,316,12,10
45937,443,35765,443,allow,4592,697,3895,14,25,8,6
43088,5228,50878,5228,allow,4708,1753,2955,27,4133,12,15
56569,53,62895,53,allow,199,102,97,2,30,1,1
58366,53,25101,53,allow,167,78,89,2,30,1,1
50265,445,0,0,drop,70,70,0,1,0,1,0
55933,445,0,0,drop,70,70,0,1,0,1,0
1943,48817,0,0,deny,62,62,0,1,0,1,0
50899,80,62536,80,allow,13974043,173337,13800706,11715,134,2429,9286
60410,443,3323,443,allow,3683,1899,1784,20,20,10,10
47180,443,38596,443,allow,6007,1727,4280,27,1128,15,12
64915,53,25917,53,allow,98,98,0,1,31,1,0
53548,445,0,0,drop,70,70,0,1,0,1,0
58930,60038,0,0,allow,66,66,0,1,91,1,0
56426,53,37263,53,allow,184,94,90,2,31,1,1
1025,46776,0,0,deny,62,62,0,1,0,1,0
50974,11392,0,0,deny,66,66,0,1,0,1,0
38653,443,63492,443,allow,6969,2162,4807,20,15,11,9
54398,445,0,0,drop,70,70,0,1,0,1,0
53214,443,52186,443,allow,526,156,370,8,14,3,5
52288,443,59643,443,allow,38314,11683,26631,76,34,38,38
55742,53,55832,53,allow,193,102,91,2,30,1,1
45060,37965,0,0,deny,62,62,0,1,0,1,0
63041,53,42776,53,allow,448,166,282,2,30,1,1
62269,445,0,0,drop,66,66,0,1,0,1,0
57063,53,54503,53,allow,177,94,83,2,30,1,1
50584,11888,51615,11888,allow,1356,300,1056,6,1200,3,3
33258,443,43741,443,allow,6958,4394,2564,30,28,17,13
61226,443,29248,443,allow,3135,1603,1532,22,632,7,15
28885,53,28885,53,allow,404,259,145,3,32,2,1
53811,8999,57709,8999,allow,1322,799,523,13,16,8,5
55795,53,49814,53,allow,177,94,83,2,30,1,1
56724,53,33113,53,allow,182,94,88,2,29,1,1
53777,62955,56420,62955,allow,70,70,0,1,4,1,0
27005,27015,42167,27015,allow,869,126,743,2,30,1,1
55386,37965,0,0,deny,66,66,0,1,0,1,0
52441,53,0,0,allow,86,86,0,1,30,1,0
50462,53,31547,53,allow,299,94,205,2,30,1,1
49661,443,16392,443,allow,9021,2548,6473,38,80,19,19
49429,53,47373,53,allow,194,102,92,2,30,1,1
65252,53,49878,53,allow,249,102,147,2,30,1,1
6141,23,0,0,deny,60,60,0,1,0,1,0
33289,50584,0,0,deny,62,62,0,1,0,1,0
56497,53,27099,53,allow,177,94,83,2,30,1,1
65521,443,8234,443,allow,92427,4519,87908,105,15,39,66
42500,443,20918,443,allow,8932,2039,6893,23,24,12,11
65437,445,0,0,drop,70,70,0,1,0,1,0
53282,443,7574,443,allow,604924,37384,567540,846,154,315,531
60444,445,0,0,drop,70,70,0,1,0,1,0
55026,443,39326,443,allow,3591,1906,1685,22,80,11,11
30644,25174,0,0,deny,62,62,0,1,0,1,0
51812,445,0,0,drop,66,66,0,1,0,1,0
56572,53,56572,53,allow,253,99,154,2,32,1,1
61545,445,0,0,drop,70,70,0,1,0,1,0
64943,53,17729,53,allow,341,110,231,2,29,1,1
60827,53,38613,53,allow,224,86,138,2,29,1,1
58245,445,0,0,drop,66,66,0,1,0,1,0
64066,23718,0,0,deny,66,66,0,1,0,1,0
51417,445,0,0,drop,70,70,0,1,0,1,0
64599,53,27573,53,allow,398,102,296,2,30,1,1
58481,53,42506,53,allow,290,110,180,2,30,1,1
60060,443,0,0,deny,1097,1097,0,1,0,1,0
34458,80,25271,80,allow,6260,696,5564,17,16,9,8
49936,53,17708,53,allow,168,94,74,2,30,1,1
41648,56205,0,0,deny,66,66,0,1,0,1,0
64155,53,2380,53,allow,183,94,89,2,30,1,1
39114,443,44592,443,allow,1238821,42695,1196126,1389,72,535,854
50052,65008,0,0,deny,60,60,0,1,0,1,0
49656,53,53430,53,allow,193,102,91,2,30,1,1
49519,53,62256,53,allow,264,94,170,2,30,1,1
58638,5900,0,0,deny,62,62,0,1,0,1,0
54891,80,41573,80,allow,1222,782,440,11,15,6,5
55524,46232,0,0,deny,66,66,0,1,0,1,0
40787,57470,0,0,deny,62,62,0,1,0,1,0
52583,445,0,0,drop,66,66,0,1,0,1,0
45343,443,52570,443,allow,2312,1382,930,19,26,11,8
57018,53,10253,53,allow,177,94,83,2,30,1,1
56229,53,12969,53,allow,165,86,79,2,30,1,1
58638,5900,0,0,deny,62,62,0,1,0,1,0
61455,445,0,0,drop,70,70,0,1,0,1,0
55989,53,12123,53,allow,198,102,96,2,30,1,1
52389,445,0,0,drop,70,70,0,1,0,1,0
60404,445,0,0,drop,70,70,0,1,0,1,0
1024,48817,0,0,deny,145,145,0,1,0,1,0
44891,23,0,0,deny,60,60,0,1,0,1,0
59833,443,63196,443,allow,15252,5376,9876,35,154,16,19
60158,445,0,0,drop,70,70,0,1,0,1,0
50570,445,0,0,drop,70,70,0,1,0,1,0
62092,35440,0,0,deny,66,66,0,1,0,1,0
6882,51508,23505,51508,allow,238,118,120,2,1200,1,1
58076,21247,0,0,deny,62,62,0,1,0,1,0
64334,53,61866,53,allow,311,94,217,2,30,1,1
55660,53,37547,53,allow,757,98,659,2,30,1,1
64417,53,37642,53,allow,184,94,90,2,31,1,1
54773,50584,0,0,deny,66,66,0,1,0,1,0
56098,64147,0,0,deny,66,66,0,1,0,1,0
52616,80,52616,80,allow,3366,2547,819,15,49,8,7
50935,80,12497,80,allow,40645,6133,34512,66,274,33,33
58952,443,55046,443,allow,5166,700,4466,16,15,7,9
49196,25174,0,0,deny,62,62,0,1,0,1,0
54938,445,0,0,drop,70,70,0,1,0,1,0
65261,53,34538,53,allow,168,86,82,2,30,1,1
65169,53,4248,53,allow,211,102,109,2,30,1,1
37011,25174,0,0,deny,146,146,0,1,0,1,0
51878,9999,48543,9999,allow,70,70,0,2,8,2,0
37075,48817,0,0,deny,62,62,0,1,0,1,0
55415,53,31153,53,allow,183,94,89,2,31,1,1
38624,443,30332,443,allow,6385,1090,5295,18,33,10,8
56176,53,4646,53,allow,188,96,92,2,30,1,1
3090,1,0,0,deny,62,62,0,1,0,1,0
55025,53,22515,53,allow,183,94,89,2,30,1,1
58543,6881,0,0,deny,146,146,0,1,0,1,0
58745,30188,0,0,deny,66,66,0,1,0,1,0
64792,53,60591,53,allow,166,86,80,2,30,1,1
58638,5900,0,0,deny,62,62,0,1,0,1,0
56667,53,36173,53,allow,232,94,138,2,30,1,1
60460,54233,40952,54233,allow,70,70,0,2,8,2,0
57470,13551,21268,13551,allow,761,166,595,2,1200,1,1
58077,443,14905,443,allow,9138,4704,4434,24,315,13,11
27269,53,56522,53,allow,199,94,105,2,31,1,1
49624,80,29847,80,allow,3314,1478,1836,16,41,9,7
54932,445,0,0,drop,66,66,0,1,0,1,0
57416,53,21354,53,allow,193,102,91,2,30,1,1
443,28417,0,0,deny,82,82,0,1,0,1,0
48625,443,33941,443,allow,29988,20891,9097,170,598,95,75
60114,445,0,0,drop,70,70,0,1,0,1,0
51905,65253,13795,65253,allow,70,70,0,2,8,2,0
39600,5900,0,0,deny,60,60,0,1,0,1,0
53870,443,3316,443,allow,499,425,74,4,1,3,1
49892,443,11967,443,allow,5930,910,5020,18,36,9,9
55590,443,56220,443,allow,7906,1569,6337,20,150,9,11
51999,37965,0,0,deny,62,62,0,1,0,1,0
30181,61689,0,0,deny,62,62,0,1,0,1,0
30188,12494,61043,12494,allow,502,150,352,2,1200,1,1
59269,445,0,0,drop,66,66,0,1,0,1,0
60575,445,0,0,drop,66,66,0,1,0,1,0
27233,53,27233,53,allow,213,87,126,2,31,1,1
58496,53,58496,53,allow,204,92,112,2,30,1,1
58638,5900,0,0,deny,62,62,0,1,0,1,0
56739,53,65216,53,allow,195,102,93,2,30,1,1
47034,443,4001,443,allow,4531,3268,1263,23,27,13,10
55162,445,0,0,drop,66,66,0,1,0,1,0
55003,443,26179,443,allow,7925,2114,5811,27,37,16,11
50798,36237,0,0,deny,62,62,0,1,0,1,0
60133,1,0,0,deny,66,66,0,1,0,1,0
55270,445,0,0,drop,70,70,0,1,0,1,0
45418,443,36338,443,allow,137754,15176,122578,229,99,106,123
51786,37832,29443,37832,allow,70,70,0,1,5,1,0
57166,53,41004,53,allow,170,87,83,2,30,1,1
61455,64147,0,0,deny,66,66,0,1,0,1,0
56873,53,29966,53,allow,184,94,90,2,30,1,1
53613,11309,52250,11309,allow,492,306,186,8,16,5,3
55726,32463,13679,32463,allow,70,70,0,2,8,2,0
64927,53,2368,53,allow,315,110,205,2,30,1,1
56070,53,55660,53,allow,186,95,91,2,31,1,1
27160,64147,0,0,deny,62,62,0,1,0,1,0
64940,53,23084,53,allow,250,94,156,2,30,1,1
53145,27067,38874,27067,allow,1231702,397859,833843,10382,185,4780,5602
38701,443,3001,443,allow,4478,1133,3345,13,27,8,5
54594,445,0,0,drop,70,70,0,1,0,1,0
27988,40017,42811,40017,allow,148,86,62,2,30,1,1
52802,53,8957,53,allow,350,210,140,6,14,4,2
29742,50584,0,0,deny,62,62,0,1,0,1,0
49894,443,43523,443,allow,5597,1462,4135,21,86,11,10
50265,37711,22022,37711,allow,132,132,0,3,1200,3,0
64095,443,64095,443,allow,17046,2620,14426,42,159,19,23
52100,443,58970,443,allow,190,70,120,4,15,2,2
55451,53,63000,53,allow,751,95,656,2,30,1,1
41541,25174,0,0,deny,66,66,0,1,0,1,0
58338,3363,0,0,deny,60,60,0,1,0,1,0
51776,14645,41362,14645,allow,70,70,0,2,8,2,0
63471,445,0,0,drop,70,70,0,1,0,1,0
14352,8055,0,0,deny,148,148,0,1,0,1,0
58188,445,0,0,drop,70,70,0,1,0,1,0
52989,443,57788,443,allow,182945,23135,159810,191,111,63,128
13963,50584,0,0,deny,62,62,0,1,0,1,0
51287,26467,0,0,deny,66,66,0,1,0,1,0
61415,445,0,0,drop,70,70,0,1,0,1,0
52854,53,0,0,allow,86,86,0,1,30,1,0
64421,53,64542,53,allow,172,88,84,2,31,1,1
14183,26467,0,0,deny,62,62,0,1,0,1,0
51324,443,31259,443,allow,2359,1283,1076,17,17,9,8
56955,53,64522,53,allow,183,94,89,2,30,1,1
56768,445,0,0,drop,70,70,0,1,0,1,0
41803,53,41803,53,allow,243,104,139,2,30,1,1
63860,445,0,0,drop,70,70,0,1,0,1,0
52158,3841,65016,3841,allow,70,70,0,2,7,2,0
56191,445,0,0,drop,70,70,0,1,0,1,0
54699,53,18510,53,allow,236,86,150,2,30,1,1
60051,80,25182,80,allow,1327,839,488,10,142,6,4
39324,64147,0,0,deny,62,62,0,1,0,1,0
52699,25174,0,0,deny,62,62,0,1,0,1,0
56875,53,47885,53,allow,166,85,81,2,31,1,1
50268,445,0,0,drop,66,66,0,1,0,1,0
58638,5900,0,0,deny,62,62,0,1,0,1,0
53608,445,0,0,drop,66,66,0,1,0,1,0
50440,53,45707,53,allow,216,110,106,2,30,1,1
52474,443,15526,443,allow,14908,4027,10881,28,136,11,17
59368,53,55998,53,allow,241,118,123,2,29,1,1
60981,443,40562,443,allow,22449,19500,2949,53,21,31,22
49984,53,22558,53,allow,178,94,84,2,30,1,1
64637,53,39523,53,allow,194,102,92,2,31,1,1
50395,80,11837,80,allow,487,180,307,6,26,4,2
10125,443,63386,443,allow,6151,2939,3212,28,332,13,15
64450,53,63147,53,allow,196,94,102,2,31,1,1
65417,53,31307,53,allow,183,94,89,2,30,1,1
49652,53,26066,53,allow,229,110,119,2,30,1,1
60923,445,0,0,drop,70,70,0,1,0,1,0
56388,22114,0,0,deny,66,66,0,1,0,1,0
49293,53,22414,53,allow,811,94,717,2,30,1,1
58638,5900,0,0,deny,62,62,0,1,0,1,0
50820,445,0,0,drop,70,70,0,1,0,1,0
62709,57470,0,0,deny,62,62,0,1,0,1,0
56228,53,46587,53,allow,711,87,624,2,30,1,1
53510,445,0,0,drop,70,70,0,1,0,1,0
35558,15503,0,0,deny,66,66,0,1,0,1,0
56836,445,0,0,drop,66,66,0,1,0,1,0
6666,16010,0,0,deny,60,60,0,1,0,1,0
58638,5900,0,0,deny,62,62,0,1,0,1,0
60341,445,0,0,drop,70,70,0,1,0,1,0
2298,53,2298,53,allow,221,83,138,2,32,1,1
54025,53,41690,53,allow,578,286,292,9,0,5,4
61339,443,59710,443,allow,31648,6288,25360,62,247,25,37
59422,445,0,0,drop,66,66,0,1,0,1,0
27005,27017,8108,27017,allow,1658,126,1532,4,30,2,2
56226,53,44944,53,allow,284,96,188,4,33,2,2
55316,445,0,0,drop,66,66,0,1,0,1,0
34095,53,34095,53,allow,243,104,139,2,30,1,1
45908,3383,0,0,deny,60,60,0,1,0,1,0
56972,53,60729,53,allow,301,126,175,2,30,1,1
50593,80,24582,80,allow,2365,1068,1297,13,79,7,6
60962,443,57911,443,allow,50093,8331,41762,75,48,36,39
49920,445,0,0,drop,70,70,0,1,0,1,0
44252,443,6888,443,allow,14455,6007,8448,45,120,26,19
54579,445,0,0,drop,70,70,0,1,0,1,0
28824,44847,0,0,deny,66,66,0,1,0,1,0
65146,53,35272,53,allow,763,102,661,2,31,1,1
55484,443,11193,443,allow,5039,2002,3037,14,120,7,7
52341,80,52341,80,allow,1928,1339,589,12,48,6,6
30583,25174,0,0,deny,66,66,0,1,0,1,0
50404,80,8357,80,allow,4242,3615,627,15,32,8,7
56488,445,0,0,drop,70,70,0,1,0,1,0
55687,47613,14281,47613,allow,164,70,94,2,5,1,1
57470,34879,21991,34879,allow,1914,1914,0,30,1766,30,0
56794,1,30345,1,allow,70,70,0,1,5,1,0
50642,53,37858,53,allow,775,102,673,2,30,1,1
59938,445,0,0,drop,70,70,0,1,0,1,0
58517,445,0,0,drop,70,70,0,1,0,1,0
47996,80,47996,80,allow,1920,1471,449,10,19,6,4
45099,443,21949,443,allow,94099,5885,88214,140,104,69,71
49210,80,26357,80,allow,2965,715,2250,9,75,5,4
55330,53,4334,53,allow,216,102,114,2,30,1,1
62757,44847,0,0,deny,146,146,0,1,0,1,0
52988,53567,0,0,deny,66,66,0,1,0,1,0
26713,64147,0,0,deny,62,62,0,1,0,1,0
50570,57470,0,0,deny,66,66,0,1,0,1,0
80,9918,0,0,deny,60,60,0,1,0,1,0
58638,5900,0,0,deny,62,62,0,1,0,1,0
40369,57470,0,0,deny,62,62,0,1,0,1,0
51977,445,0,0,drop,66,66,0,1,0,1,0
52712,80,52712,80,allow,2012,1423,589,12,48,6,6
60714,445,0,0,drop,70,70,0,1,0,1,0
50090,445,0,0,drop,70,70,0,1,0,1,0
49994,53,33575,53,allow,86,86,0,1,29,1,0
443,60082,0,0,deny,74,74,0,1,0,1,0
54307,445,0,0,drop,70,70,0,1,0,1,0
57470,6881,10120,6881,allow,163,163,0,1,1200,1,0
59270,53,59270,53,allow,825,99,726,2,30,1,1
65098,53,11310,53,allow,260,94,166,2,30,1,1
53080,443,53725,443,allow,108155,4527,103628,115,83,30,85
56378,53,11573,53,allow,214,102,112,2,30,1,1
49912,80,32939,80,allow,1590,858,732,10,110,6,4
58398,44847,0,0,deny,62,62,0,1,0,1,0
64907,53,21503,53,allow,247,86,161,3,31,2,1
57264,53,5808,53,allow,197,102,95,2,29,1,1
33886,65504,0,0,deny,162,162,0,1,0,1,0
64414,53,2206,53,allow,183,94,89,2,30,1,1
52460,53,0,0,allow,82,82,0,1,30,1,0
57224,445,0,0,drop,70,70,0,1,0,1,0
49508,53,17731,53,allow,199,102,97,2,30,1,1
54205,445,0,0,drop,70,70,0,1,0,1,0
57673,445,0,0,drop,70,70,0,1,0,1,0
54518,25174,0,0,deny,62,62,0,1,0,1,0
47982,443,20773,443,allow,83558,8567,74991,180,171,92,88
59693,443,23790,443,allow,1867,250,1617,8,120,4,4
64989,53,13455,53,allow,167,86,81,2,30,1,1
55027,53,44978,53,allow,177,94,83,2,29,1,1
38366,15000,19494,15000,allow,130,70,60,2,6,1,1
50584,56209,14402,56209,allow,166,166,0,1,1200,1,0
49266,53,8623,53,allow,86,86,0,1,30,1,0
49831,53,24463,53,allow,364,102,262,2,30,1,1
50605,445,0,0,drop,70,70,0,1,0,1,0
26900,27017,23576,27017,allow,340,82,258,5,29,2,3
55019,53,27465,53,allow,299,110,189,4,31,2,2
60219,445,0,0,drop,70,70,0,1,0,1,0
51959,42269,61621,42269,allow,70,70,0,1,4,1,0
54052,443,54052,443,allow,1386,751,635,15,181,8,7
61898,445,0,0,drop,66,66,0,1,0,1,0
1294,53,1294,53,allow,216,82,134,2,32,1,1
60608,53,20949,53,allow,199,94,105,2,30,1,1
54377,445,0,0,drop,66,66,0,1,0,1,0
55549,53,24179,53,allow,209,110,99,2,29,1,1
64467,53,4748,53,allow,184,94,90,2,30,1,1
38076,80,55546,80,allow,15538,1307,14231,27,45,15,12
56403,51505,0,0,deny,66,66,0,1,0,1,0
34775,5900,0,0,deny,60,60,0,1,0,1,0
62615,445,0,0,drop,70,70,0,1,0,1,0
64846,445,0,0,drop,70,70,0,1,0,1,0
56649,443,46574,443,allow,4628,1035,3593,19,25,11,8
51378,3027,51378,3027,allow,156,156,0,3,8,3,0
50002,53,33820,53,allow,192,98,94,2,31,1,1
57353,443,32586,443,allow,150,150,0,1,5,1,0
51967,12110,53548,12110,allow,70,70,0,1,4,1,0
52199,35549,28334,35549,allow,66,66,0,2,10,2,0
56320,445,0,0,drop,66,66,0,1,0,1,0
64797,53,56821,53,allow,183,94,89,2,30,1,1
48576,443,26108,443,allow,476,410,66,4,0,3,1
57232,53,8301,53,allow,198,102,96,2,30,1,1
52924,443,13021,443,allow,5583,1390,4193,19,15,9,10
59097,2767,0,0,deny,66,66,0,1,0,1,0
56120,53,38603,53,allow,177,94,83,2,30,1,1
51163,23,0,0,deny,60,60,0,1,0,1,0
63835,30794,25747,30794,allow,66,66,0,1,5,1,0
49838,443,59419,443,allow,6915,3106,3809,21,144,10,11
53995,25174,0,0,deny,66,66,0,1,0,1,0
55384,445,0,0,drop,70,70,0,1,0,1,0
49501,11392,0,0,deny,62,62,0,1,0,1,0
5588,5588,0,0,allow,3354,1792,1562,46,194,23,23
51716,44847,0,0,deny,62,62,0,1,0,1,0
58203,445,0,0,drop,70,70,0,1,0,1,0
56615,53,15642,53,allow,177,94,83,2,29,1,1
60884,443,1605,443,allow,6505,2038,4467,26,46,15,11
49800,53,22865,53,allow,182,93,89,2,31,1,1
56986,445,0,0,drop,70,70,0,1,0,1,0
65143,53,8081,53,allow,199,102,97,2,30,1,1
56170,443,45296,443,allow,9201,4926,4275,19,120,10,9
54926,445,0,0,drop,70,70,0,1,0,1,0
51243,445,0,0,drop,70,70,0,1,0,1,0
57440,53,28373,53,allow,199,102,97,2,30,1,1
57402,445,0,0,drop,66,66,0,1,0,1,0
53707,44209,9971,44209,allow,1513,989,524,17,16,10,7
43683,443,23640,443,allow,6941,1551,5390,25,200,12,13
65218,443,1874,443,allow,2767,681,2086,10,120,5,5
63005,445,0,0,drop,66,66,0,1,0,1,0
65002,27064,63916,27064,allow,735,462,273,2,30,1,1
55457,53,65037,53,allow,372,126,246,2,29,1,1
2622,25174,0,0,deny,146,146,0,1,0,1,0
37918,443,47034,443,allow,6521,2079,4442,32,3827,19,13
64641,53,15849,53,allow,193,94,99,2,30,1,1
57470,64050,27080,64050,allow,1660,677,983,20,1600,10,10
60913,443,14058,443,allow,18805,1162,17643,28,135,11,17
56805,445,0,0,drop,70,70,0,1,0,1,0
50274,445,0,0,drop,70,70,0,1,0,1,0
53537,53,1672,53,allow,391,102,289,2,29,1,1
49377,443,17002,443,allow,11627,4670,6957,37,155,16,21
43231,443,33460,443,allow,56226,4852,51374,71,106,30,41
55683,19215,63970,19215,allow,320,140,180,6,7,3,3
55180,445,0,0,drop,70,70,0,1,0,1,0
51945,445,0,0,drop,70,70,0,1,0,1,0
49761,80,49761,80,allow,2937,703,2234,13,142,6,7
60716,443,33650,443,allow,6898,2843,4055,21,17,11,10
55046,53,59080,53,allow,300,102,198,4,40,2,2
45941,23388,0,0,deny,60,60,0,1,0,1,0
6721,37965,0,0,deny,66,66,0,1,0,1,0
61408,443,17703,443,allow,9492,3543,5949,49,117,25,24
59790,443,41784,443,allow,238429,14932,223497,314,48,159,155
43659,443,24456,443,allow,17592,11518,6074,51,248,26,25
55618,53,59211,53,allow,255,102,153,2,30,1,1
28124,37965,0,0,deny,145,145,0,1,0,1,0
51605,443,15283,443,allow,4343,2350,1993,17,36,9,8
42569,443,10285,443,allow,7284,1456,5828,21,360,10,11
52142,54954,48530,54954,allow,66,66,0,1,5,1,0
53556,1024,47936,1024,allow,70,70,0,1,4,1,0
65460,80,65460,80,allow,48356,4069,44287,55,48,19,36
9412,7302,0,0,deny,66,66,0,1,0,1,0
49407,445,0,0,drop,70,70,0,1,0,1,0
49270,443,33027,443,allow,10367,2273,8094,43,730,22,21
6661,23,0,0,deny,60,60,0,1,0,1,0
65359,53,28420,53,allow,193,102,91,2,30,1,1
51038,443,30038,443,allow,7263,1830,5433,27,16,15,12
47342,20541,0,0,deny,66,66,0,1,0,1,0
57013,80,43644,80,allow,5696,703,4993,14,75,8,6
65497,53,35507,53,allow,194,99,95,2,31,1,1
65234,53,35438,53,allow,193,102,91,2,30,1,1
52292,443,35142,443,allow,21680,2897,18783,35,120,15,20
63921,445,0,0,drop,70,70,0,1,0,1,0
55107,53,60741,53,allow,184,94,90,2,29,1,1
37431,25174,0,0,deny,146,146,0,1,0,1,0
59641,445,0,0,drop,66,66,0,1,0,1,0
57144,53,45834,53,allow,178,94,84,2,30,1,1
57352,53,28583,53,allow,193,102,91,2,30,1,1
54830,445,0,0,drop,70,70,0,1,0,1,0
63460,55160,0,0,deny,62,62,0,1,0,1,0
60248,46776,0,0,deny,66,66,0,1,0,1,0
42030,25,0,0,deny,74,74,0,1,0,1,0
43210,443,51289,443,allow,5960402,99613,5860789,5017,133,952,4065
47910,7454,0,0,deny,60,60,0,1,0,1,0
1024,60043,0,0,deny,145,145,0,1,0,1,0
56641,53,52292,53,allow,453,186,267,6,30,3,3
64997,53,57263,53,allow,166,86,80,2,31,1,1
52267,55982,31620,55982,allow,70,70,0,2,6,2,0
59315,445,0,0,drop,70,70,0,1,0,1,0
50681,445,0,0,drop,66,66,0,1,0,1,0
33971,443,52032,443,allow,244193,7090,237103,260,136,87,173
27005,27015,65078,27015,allow,878,126,752,2,30,1,1
58638,5900,0,0,deny,62,62,0,1,0,1,0
35649,53,35649,53,allow,220,90,130,2,29,1,1
49225,53,59832,53,allow,295,101,194,4,49,2,2
24838,39828,0,0,deny,60,60,0,1,0,1,0
65328,53,18942,53,allow,166,86,80,2,30,1,1
52925,5555,0,0,deny,60,60,0,1,0,1,0
12656,53,33403,53,allow,211,86,125,2,30,1,1
49264,443,65214,443,allow,2424,258,2166,9,120,4,5
27005,27017,63290,27017,allow,917,126,791,2,30,1,1
60641,445,0,0,drop,70,70,0,1,0,1,0
54274,445,0,0,drop,70,70,0,1,0,1,0
45052,443,46441,443,allow,6084,1723,4361,23,201,13,10
49986,53,46060,53,allow,779,110,669,2,30,1,1
48840,50584,0,0,deny,62,62,0,1,0,1,0
50040,445,0,0,drop,66,66,0,1,0,1,0
64804,53,26105,53,allow,182,102,80,2,30,1,1
40326,443,22959,443,allow,7937,3883,4054,65,4602,25,40
59103,443,51275,443,allow,4209,2056,2153,50,277,24,26
22263,30188,0,0,deny,66,66,0,1,0,1,0
46505,443,50685,443,allow,7072,1541,5531,27,271,12,15
55526,80,64372,80,allow,6138,1242,4896,15,40,7,8
53126,443,58223,443,allow,11811,4242,7569,27,46,15,12
35900,443,35900,443,allow,5661,2414,3247,22,39,13,9
61655,445,0,0,drop,66,66,0,1,0,1,0
55953,445,0,0,drop,70,70,0,1,0,1,0
56303,53,13622,53,allow,170,87,83,2,30,1,1
6881,8229,31730,8229,allow,150,150,0,1,1200,1,0
51706,25174,0,0,deny,66,66,0,1,0,1,0
61589,21247,0,0,deny,62,62,0,1,0,1,0
49994,26467,0,0,deny,66,66,0,1,0,1,0
443,14591,0,0,deny,100,100,0,1,0,1,0
54867,445,0,0,drop,66,66,0,1,0,1,0
34466,443,32529,443,allow,1402,910,492,11,360,6,5
33270,80,23251,80,allow,1614,1300,314,10,15,5,5
56424,53,45965,53,allow,177,94,83,2,29,1,1
37989,49152,16381,49152,allow,156,156,0,3,8,3,0
55411,53,47570,53,allow,183,94,89,2,30,1,1
64854,53,42024,53,allow,172,88,84,2,30,1,1
53719,49306,15851,49306,allow,70,70,0,1,5,1,0
0,0,0,0,allow,156,156,0,2,0,2,0
53258,443,34531,443,allow,5916,1774,4142,25,15,14,11
58600,53,58600,53,allow,217,82,135,2,32,1,1
50584,64368,19845,64368,allow,161,161,0,2,1200,2,0
53047,443,44730,443,allow,13229,3527,9702,56,91,28,28
60725,445,0,0,drop,70,70,0,1,0,1,0
39931,443,19532,443,allow,4464,2847,1617,29,80,15,14
63242,50584,0,0,deny,66,66,0,1,0,1,0
44847,6881,3655,6881,allow,324,150,174,2,1201,1,1
51373,445,0,0,drop,66,66,0,1,0,1,0
44847,23628,55980,23628,allow,509,150,359,2,1200,1,1
30365,45991,0,0,deny,60,60,0,1,0,1,0
5938,20273,0,0,allow,60,60,0,1,90,1,0
13062,52752,0,0,deny,66,66,0,1,0,1,0
56951,53,23495,53,allow,199,102,97,2,30,1,1
34366,53,0,0,allow,82,82,0,1,31,1,0
6666,16010,0,0,deny,60,60,0,1,0,1,0
40781,443,17024,443,allow,14327,1918,12409,37,270,17,20
51753,15038,3918,15038,allow,70,70,0,2,7,2,0
59750,443,51830,443,allow,2633,1179,1454,20,74,8,12
51526,4545,51526,4545,allow,156,156,0,3,8,3,0
56615,443,6112,443,allow,22938,14436,8502,43,41,23,20
55294,53,55276,53,allow,199,102,97,2,30,1,1
48521,53,27557,53,allow,78,78,0,1,30,1,0
55681,31948,14765,31948,allow,70,70,0,1,5,1,0
48738,443,11931,443,allow,131514,7190,124324,183,53,72,111
39480,8055,0,0,deny,148,148,0,1,0,1,0
48754,80,48754,80,allow,560,264,296,9,44,5,4
51711,1027,5156,1027,allow,70,70,0,1,5,1,0
54138,445,0,0,drop,66,66,0,1,0,1,0
51981,445,0,0,drop,70,70,0,1,0,1,0
61605,445,0,0,drop,70,70,0,1,0,1,0
57684,445,0,0,drop,66,66,0,1,0,1,0
64637,53,50285,53,allow,188,96,92,2,30,1,1
40216,50265,0,0,deny,62,62,0,1,0,1,0
49418,27021,53913,27021,allow,232,71,161,2,30,1,1
43584,24748,0,0,deny,156,156,0,1,0,1,0
52188,443,37924,443,allow,1768,1034,734,16,65,8,8
55008,53,25566,53,allow,762,98,664,2,30,1,1
49487,53,55528,53,allow,183,94,89,2,30,1,1
40086,22114,0,0,deny,146,146,0,1,0,1,0
49337,53,44481,53,allow,199,102,97,2,30,1,1
49477,53,44035,53,allow,168,78,90,2,30,1,1
53322,445,0,0,drop,70,70,0,1,0,1,0
44459,37807,0,0,deny,62,62,0,1,0,1,0
64415,53,15855,53,allow,221,94,127,2,30,1,1
47136,53,53463,53,allow,222,78,144,2,30,1,1
57093,80,11310,80,allow,130,70,60,2,15,1,1
62192,445,0,0,drop,70,70,0,1,0,1,0
49649,443,64805,443,allow,5964,674,5290,16,60,7,9
35722,443,40129,443,allow,13035,2590,10445,27,125,14,13
50018,53,63073,53,allow,350,91,259,4,41,2,2
55102,53,47869,53,allow,195,102,93,2,30,1,1
55037,445,0,0,drop,70,70,0,1,0,1,0
60607,53,60607,53,allow,832,106,726,2,30,1,1
34997,22,0,0,deny,60,60,0,1,0,1,0
63793,48970,37925,48970,allow,66,66,0,2,7,2,0
443,45940,0,0,deny,85,85,0,1,0,1,0
65343,53,2539,53,allow,184,94,90,2,31,1,1
53554,8999,6458,8999,allow,130,70,60,3,6,2,1
49472,53,31228,53,allow,772,102,670,2,30,1,1
65331,53,14108,53,allow,308,102,206,2,30,1,1
52179,445,0,0,drop,70,70,0,1,0,1,0
57536,443,25705,443,allow,232,172,60,3,5,2,1
43595,443,60251,443,allow,31194,5024,26170,44,121,18,26
38769,443,3016,443,allow,7352,3452,3900,18,15,10,8
54876,445,0,0,drop,70,70,0,1,0,1,0
53626,443,63196,443,allow,10520,3200,7320,29,38,16,13
50734,37965,0,0,deny,62,62,0,1,0,1,0
60037,445,0,0,drop,70,70,0,1,0,1,0
63995,15396,40455,15396,allow,70,70,0,1,4,1,0
58049,445,0,0,drop,70,70,0,1,0,1,0
57810,445,0,0,drop,66,66,0,1,0,1,0
65379,22114,0,0,deny,66,66,0,1,0,1,0
49205,53,61916,53,allow,194,102,92,2,30,1,1
51105,50584,0,0,deny,66,66,0,1,0,1,0
49646,445,0,0,drop,70,70,0,1,0,1,0
51398,445,0,0,drop,70,70,0,1,0,1,0
58248,53,0,0,allow,186,83,103,2,30,1,1
64935,53,16580,53,allow,765,102,663,2,30,1,1
56712,53,4358,53,allow,177,94,83,2,30,1,1
57177,443,54507,443,allow,1610,771,839,22,120,11,11
56601,80,22349,80,allow,234,234,0,4,12,4,0
49676,53,19443,53,allow,216,110,106,2,30,1,1
56639,53,16587,53,allow,168,86,82,2,36,1,1
52231,1026,54310,1026,allow,136,136,0,3,14,3,0
51231,443,6800,443,allow,63550,10766,52784,98,131,43,55
64366,445,0,0,drop,66,66,0,1,0,1,0
2070,53,2070,53,allow,233,90,143,2,32,1,1
52432,50265,0,0,deny,66,66,0,1,0,1,0
64283,53,30888,53,allow,193,102,91,2,31,1,1
49219,53,24039,53,allow,264,102,162,2,30,1,1
49245,53,3951,53,allow,190,97,93,2,31,1,1
58126,443,22478,443,allow,3179,954,2225,10,120,5,5
52474,445,0,0,drop,70,70,0,1,0,1,0
58975,80,4684,80,allow,214,140,74,4,15,3,1
65081,445,0,0,drop,70,70,0,1,0,1,0
65528,53,22092,53,allow,199,86,113,2,29,1,1
49736,443,37577,443,allow,378,192,186,7,15,4,3
0,0,0,0,deny,156,156,0,2,0,2,0
63596,445,0,0,drop,66,66,0,1,0,1,0
51989,445,0,0,drop,66,66,0,1,0,1,0
65492,53,51377,53,allow,707,94,613,2,29,1,1
59962,445,0,0,drop,70,70,0,1,0,1,0
61264,445,0,0,drop,66,66,0,1,0,1,0
55145,11392,0,0,deny,66,66,0,1,0,1,0
36579,30188,0,0,deny,66,66,0,1,0,1,0
51172,44847,0,0,deny,62,62,0,1,0,1,0
43776,7000,43776,7000,allow,3174,1617,1557,17,18,9,8
55323,53,20826,53,allow,178,94,84,2,30,1,1
49607,25174,0,0,deny,62,62,0,1,0,1,0
5826,26467,0,0,deny,62,62,0,1,0,1,0
53294,445,0,0,drop,70,70,0,1,0,1,0
52744,53,32462,53,allow,218,81,137,2,31,1,1
58638,5900,0,0,deny,62,62,0,1,0,1,0
49516,35894,0,0,deny,62,62,0,1,0,1,0
52236,445,0,0,drop,70,70,0,1,0,1,0
49954,445,0,0,drop,70,70,0,1,0,1,0
56310,445,0,0,drop,70,70,0,1,0,1,0
53883,24830,47697,24830,allow,258,70,188,4,7,2,2
56245,53,57808,53,allow,200,102,98,2,31,1,1
51930,57470,0,0,deny,62,62,0,1,0,1,0
61532,445,0,0,drop,66,66,0,1,0,1,0
51186,445,0,0,drop,66,66,0,1,0,1,0
50415,445,0,0,drop,70,70,0,1,0,1,0
54998,53,29340,53,allow,438,89,349,4,60,2,2
56631,445,0,0,drop,66,66,0,1,0,1,0
0,0,0,0,deny,98,98,0,1,0,1,0
49731,80,40624,80,allow,318,192,126,6,130,4,2
50573,443,27732,443,allow,7282,953,6329,18,16,10,8
47089,15000,57898,15000,allow,138,78,60,2,5,1,1
60434,11339,17493,11339,allow,70,70,0,1,5,1,0
30304,64147,0,0,deny,62,62,0,1,0,1,0
50122,443,3201,443,allow,15217,5689,9528,52,35,27,25
64967,445,0,0,drop,66,66,0,1,0,1,0
53727,8999,52156,8999,allow,320,140,180,6,5,3,3
64357,53,37789,53,allow,183,94,89,2,31,1,1
1972,57470,0,0,deny,78,78,0,1,0,1,0
59709,445,0,0,drop,66,66,0,1,0,1,0
62655,445,0,0,drop,70,70,0,1,0,1,0
34661,53,34661,53,allow,414,268,146,3,33,2,1
39132,44847,0,0,deny,66,66,0,1,0,1,0
48978,25174,0,0,deny,66,66,0,1,0,1,0
38784,443,14395,443,allow,9185,3854,5331,23,16,13,10
49361,53,51044,53,allow,184,94,90,2,31,1,1
9745,26467,0,0,deny,62,62,0,1,0,1,0
443,62732,0,0,deny,332,332,0,1,0,1,0
46697,5228,40766,5228,allow,9263,549,8714,17,3638,5,12
58964,80,7375,80,allow,5541,4758,783,16,16,8,8
64140,53,44344,53,allow,184,94,90,2,31,1,1
52107,53,0,0,allow,621,77,544,2,29,1,1
56119,53,14584,53,allow,199,102,97,2,33,1,1
59646,5223,55530,5223,allow,70,70,0,1,5,1,0
50990,23884,0,0,deny,66,66,0,1,0,1,0
34428,443,49184,443,allow,21512,4620,16892,22,127,8,14
57837,445,0,0,drop,70,70,0,1,0,1,0
53010,80,53010,80,allow,210304,4398,205906,225,21,65,160
60338,7000,60338,7000,allow,3486,1983,1503,15,16,8,7
49562,53,45656,53,allow,380,90,290,4,48,2,2
51109,80,7098,80,allow,366,240,126,7,20,5,2
64270,53,47275,53,allow,455,102,353,4,33,2,2
34924,443,1749,443,allow,2401,1149,1252,14,982,7,7
65229,53,47918,53,allow,195,102,93,2,30,1,1
59945,443,18013,443,allow,10477,3435,7042,34,20,18,16
53522,24116,50290,24116,allow,70,70,0,1,4,1,0
64608,53,62804,53,allow,212,110,102,2,30,1,1
55025,53,42219,53,allow,183,94,89,2,30,1,1
55448,445,0,0,drop,70,70,0,1,0,1,0
49973,80,59362,80,allow,1352,364,988,13,15,6,7
56282,53,56282,53,allow,194,87,107,2,31,1,1
37542,53,41860,53,allow,240,76,164,2,30,1,1
5223,1210,0,0,deny,66,66,0,1,0,1,0
10151,34592,23117,34592,allow,480,149,331,2,1200,1,1
64810,53,30848,53,allow,257,126,131,2,30,1,1
10063,443,38761,443,allow,822903,35544,787359,1068,153,463,605
50990,445,0,0,drop,66,66,0,1,0,1,0
57596,80,57596,80,allow,64768,3074,61694,72,145,26,46
57000,53,32346,53,allow,194,102,92,2,30,1,1
49908,53,39258,53,allow,789,110,679,2,30,1,1
55082,443,25259,443,allow,8944,4006,4938,31,16,18,13
443,39851,0,0,deny,112,112,0,1,0,1,0
55709,30217,33191,30217,allow,70,70,0,2,8,2,0
10632,25174,0,0,deny,146,146,0,1,0,1,0
19617,39004,0,0,deny,62,62,0,1,0,1,0
52459,5555,0,0,deny,60,60,0,1,0,1,0
33546,53,33546,53,allow,400,257,143,3,32,2,1
50523,445,0,0,drop,70,70,0,1,0,1,0
55397,445,0,0,drop,70,70,0,1,0,1,0
55224,53,43043,53,allow,182,94,88,2,30,1,1
8108,55108,0,0,deny,157,157,0,1,0,1,0
34416,443,60300,443,allow,10255,2803,7452,35,26,18,17
42285,57470,0,0,deny,62,62,0,1,0,1,0
64968,27030,53742,27030,allow,735,462,273,2,30,1,1
56720,53,21366,53,allow,170,87,83,2,31,1,1
50046,445,0,0,drop,70,70,0,1,0,1,0
53957,35440,0,0,deny,62,62,0,1,0,1,0
55466,445,0,0,drop,66,66,0,1,0,1,0
49211,80,44277,80,allow,8971,1094,7877,17,15,7,10
5208,63836,0,0,deny,145,145,0,1,0,1,0
54828,443,24747,443,allow,6296,1556,4740,22,16,12,10
51204,445,0,0,drop,70,70,0,1,0,1,0
51897,57057,43684,57057,allow,70,70,0,1,5,1,0
53524,45395,27489,45395,allow,70,70,0,1,5,1,0
50558,445,0,0,drop,70,70,0,1,0,1,0
45401,443,44939,443,allow,9535,3495,6040,18,121,10,8
36138,443,58693,443,allow,50384,5218,45166,76,99,26,50
56562,44847,0,0,deny,66,66,0,1,0,1,0
37965,32305,6845,32305,allow,1650,1650,0,26,1537,26,0
57470,51413,16094,51413,allow,700,275,425,4,1200,2,2
51894,445,0,0,drop,70,70,0,1,0,1,0
5385,22,5385,22,allow,66,66,0,1,4,1,0
56369,53,3400,53,allow,168,86,82,2,30,1,1
53678,445,0,0,drop,70,70,0,1,0,1,0
54518,445,0,0,drop,66,66,0,1,0,1,0
54991,53,42971,53,allow,253,87,166,4,29,2,2
56441,53,35817,53,allow,209,110,99,2,29,1,1
55432,445,0,0,drop,70,70,0,1,0,1,0
10145,21247,0,0,deny,62,62,0,1,0,1,0
51644,53,17659,53,allow,195,78,117,2,30,1,1
64648,53,9787,53,allow,215,94,121,2,30,1,1
18889,50584,0,0,deny,146,146,0,1,0,1,0
50870,80,58385,80,allow,7313,1684,5629,15,148,8,7
25901,50265,0,0,deny,62,62,0,1,0,1,0
2740,22,0,0,deny,60,60,0,1,0,1,0
62485,445,0,0,drop,70,70,0,1,0,1,0
64472,445,0,0,drop,66,66,0,1,0,1,0
48676,53395,0,0,deny,60,60,0,1,0,1,0
60654,445,0,0,drop,70,70,0,1,0,1,0
18001,35440,0,0,deny,146,146,0,1,0,1,0
8734,56205,0,0,deny,66,66,0,1,0,1,0
61291,445,0,0,drop,70,70,0,1,0,1,0
58004,445,0,0,drop,70,70,0,1,0,1,0
44320,443,32394,443,allow,154,94,60,2,4,1,1
52255,16087,20036,16087,allow,70,70,0,2,8,2,0
49264,80,49264,80,allow,698,366,332,12,44,7,5
9687,57470,0,0,deny,78,78,0,1,0,1,0
65012,53,58709,53,allow,775,102,673,2,30,1,1
49390,1433,0,0,deny,60,60,0,1,0,1,0
46334,443,50617,443,allow,9759,2304,7455,28,138,14,14
64592,53,37714,53,allow,202,103,99,2,31,1,1
30114,65151,0,0,deny,60,60,0,1,0,1,0
57470,1930,53151,1930,allow,858,858,0,14,1199,14,0
55840,445,0,0,drop,70,70,0,1,0,1,0
49591,53,7823,53,allow,402,118,284,2,30,1,1
18029,50584,0,0,deny,66,66,0,1,0,1,0
49687,53,9331,53,allow,184,102,82,2,30,1,1
64586,53,51199,53,allow,183,94,89,2,29,1,1
60346,80,8391,80,allow,2124,1158,966,13,87,7,6
61420,445,0,0,drop,70,70,0,1,0,1,0
50756,445,0,0,drop,66,66,0,1,0,1,0
51815,445,0,0,drop,70,70,0,1,0,1,0
49257,53,51437,53,allow,199,102,97,2,30,1,1
41431,443,28233,443,allow,1843,996,847,17,275,8,9
13840,37965,0,0,deny,146,146,0,1,0,1,0
36080,26467,0,0,deny,62,62,0,1,0,1,0
58786,445,0,0,drop,70,70,0,1,0,1,0
53301,11000,8510,11000,allow,1642,822,820,5,30,1,4
63015,53,58315,53,allow,303,85,218,2,31,1,1
56590,53,44528,53,allow,305,94,211,2,30,1,1
56062,53,2393,53,allow,192,98,94,2,31,1,1
58562,53,31864,53,allow,215,102,113,2,30,1,1
63459,445,0,0,drop,70,70,0,1,0,1,0
49308,22114,0,0,deny,62,62,0,1,0,1,0
58952,445,0,0,drop,70,70,0,1,0,1,0
65107,53,21629,53,allow,186,95,91,2,31,1,1
36586,80,45063,80,allow,1114,534,580,12,15,7,5
60854,42873,0,0,deny,66,66,0,1,0,1,0
57075,53,9642,53,allow,199,94,105,2,30,1,1
51819,59208,38763,59208,allow,70,70,0,1,5,1,0
50636,53,31294,53,allow,772,100,672,2,31,1,1
38820,80,32872,80,allow,1150,613,537,10,16,6,4
58638,5900,0,0,deny,62,62,0,1,0,1,0
52155,80,42520,80,allow,1056,682,374,10,15,6,4
64266,53,18916,53,allow,180,94,86,2,31,1,1
48706,23393,0,0,deny,60,60,0,1,0,1,0
55337,53,22307,53,allow,294,106,188,4,55,2,2
56215,53,24448,53,allow,216,110,106,2,30,1,1
54553,53,62342,53,allow,202,202,0,3,46,3,0
49001,40108,0,0,deny,161,161,0,1,0,1,0
55119,53,12117,53,allow,994,86,908,2,29,1,1
59828,443,44871,443,allow,306,180,126,6,29,4,2
55158,445,0,0,drop,70,70,0,1,0,1,0
54349,443,33751,443,allow,14063,6328,7735,33,37,16,17
62153,35440,0,0,deny,62,62,0,1,0,1,0
64657,53,35491,53,allow,370,96,274,4,39,2,2
57045,53,2181,53,allow,177,94,83,2,30,1,1
55377,445,0,0,drop,70,70,0,1,0,1,0
35430,443,18104,443,allow,6267,1810,4457,25,18,14,11
49192,8106,32598,8106,allow,2050,1277,773,15,15,8,7
49708,53,5780,53,allow,172,88,84,2,31,1,1
58638,5900,0,0,deny,62,62,0,1,0,1,0
55201,26467,0,0,deny,66,66,0,1,0,1,0
53795,53,11623,53,allow,224,86,138,2,30,1,1
55611,445,0,0,drop,70,70,0,1,0,1,0
27005,27015,7639,27015,allow,919,126,793,2,30,1,1
64457,53,27221,53,allow,261,102,159,2,30,1,1
45852,53,16051,53,allow,774,76,698,4,29,2,2
57000,445,0,0,drop,70,70,0,1,0,1,0
63869,34368,47992,34368,allow,66,66,0,2,8,2,0
56323,57470,0,0,deny,74,74,0,1,0,1,0
39380,46783,0,0,deny,146,146,0,1,0,1,0
51602,443,19989,443,allow,19664,8943,10721,42,37,22,20
62883,445,0,0,drop,70,70,0,1,0,1,0
443,64347,0,0,deny,131,131,0,1,0,1,0
57897,445,0,0,drop,70,70,0,1,0,1,0
64627,53,39841,53,allow,199,102,97,2,31,1,1
59833,445,0,0,drop,70,70,0,1,0,1,0
48817,1025,48817,1025,allow,334,158,176,2,1199,1,1
33641,443,2360,443,allow,15017,6951,8066,49,20,25,24
38031,80,38031,80,allow,37629,3025,34604,51,24,22,29
50448,443,19311,443,allow,1346,918,428,10,35,6,4
35657,48637,0,0,deny,62,62,0,1,0,1,0
1847,64147,0,0,deny,66,66,0,1,0,1,0
11458,2767,0,0,deny,66,66,0,1,0,1,0
37230,554,0,0,deny,60,60,0,1,0,1,0
51688,445,0,0,drop,70,70,0,1,0,1,0
60406,64337,47861,64337,allow,70,70,0,2,8,2,0
56308,53,37236,53,allow,184,94,90,2,31,1,1
56759,53,4446,53,allow,177,94,83,2,30,1,1
50181,443,54274,443,allow,8113,2063,6050,23,255,11,12
44459,37807,0,0,deny,62,62,0,1,0,1,0
60379,34301,5453,34301,allow,320,140,180,6,7,3,3
51676,23718,0,0,deny,66,66,0,1,0,1,0
53667,22114,0,0,deny,62,62,0,1,0,1,0
49634,443,60698,443,allow,20860,1618,19242,35,122,15,20
18750,57866,0,0,deny,62,62,0,1,0,1,0
56287,445,0,0,drop,70,70,0,1,0,1,0
50405,80,63982,80,allow,4530,3395,1135,15,32,8,7
44890,443,40961,443,allow,2134,1397,737,18,1162,10,8
65049,53,22516,53,allow,210,110,100,2,30,1,1
50593,64147,0,0,deny,66,66,0,1,0,1,0
41024,443,41024,443,allow,4639,1732,2907,19,30,11,8
56869,17637,0,0,deny,66,66,0,1,0,1,0
55713,25174,0,0,deny,62,62,0,1,0,1,0
51762,443,40334,443,allow,5048,2345,2703,13,121,7,6
44040,443,39447,443,allow,11774,5465,6309,75,585,38,37
58829,64147,0,0,deny,62,62,0,1,0,1,0
43657,50011,0,0,deny,62,62,0,1,0,1,0
49606,53,26399,53,allow,231,110,121,2,31,1,1
55591,443,37425,443,allow,7902,1565,6337,20,150,9,11
9756,26467,0,0,deny,66,66,0,1,0,1,0
51227,445,0,0,drop,70,70,0,1,0,1,0
56919,445,0,0,drop,66,66,0,1,0,1,0
65431,53,63045,53,allow,210,102,108,2,30,1,1
51647,443,26913,443,allow,6400,1830,4570,26,316,13,13
56768,445,0,0,drop,66,66,0,1,0,1,0
11688,23718,0,0,deny,62,62,0,1,0,1,0
50748,443,45400,443,allow,12166,8765,3401,52,561,25,27
60638,53,31002,53,allow,337,86,251,2,29,1,1
53864,443,31491,443,allow,3124,1556,1568,21,275,11,10
50347,53,8937,53,allow,756,95,661,2,30,1,1
58638,5900,0,0,deny,62,62,0,1,0,1,0
50466,53,25118,53,allow,295,101,194,4,30,2,2
60675,445,0,0,drop,70,70,0,1,0,1,0
15530,49718,0,0,deny,146,146,0,1,0,1,0
49892,443,4679,443,allow,6966,1436,5530,32,600,13,19
45941,23386,0,0,deny,60,60,0,1,0,1,0
55638,53,11091,53,allow,168,86,82,2,30,1,1
65248,445,0,0,drop,66,66,0,1,0,1,0
49308,53,0,0,allow,627,80,547,2,29,1,1
54386,445,0,0,drop,70,70,0,1,0,1,0
49677,445,0,0,drop,70,70,0,1,0,1,0
57695,443,41532,443,allow,9493,2266,7227,24,14,13,11
61661,445,0,0,drop,66,66,0,1,0,1,0
49451,445,0,0,drop,70,70,0,1,0,1,0
64945,53,32076,53,allow,733,94,639,2,30,1,1
43177,443,43177,443,allow,4493,1586,2907,19,26,11,8
1280,25174,0,0,deny,66,66,0,1,0,1,0
37420,44847,0,0,deny,66,66,0,1,0,1,0
56829,53,59229,53,allow,199,102,97,2,30,1,1
51844,12471,8982,12471,allow,70,70,0,1,5,1,0
52003,18150,63580,18150,allow,70,70,0,1,5,1,0
40039,80,11580,80,allow,1112,534,578,12,16,7,5
51852,445,0,0,drop,70,70,0,1,0,1,0
65156,445,0,0,drop,70,70,0,1,0,1,0
10445,46824,0,0,deny,62,62,0,1,0,1,0
60413,80,20847,80,allow,958,543,415,11,315,6,5
49728,443,15564,443,allow,7626,1676,5950,29,63,10,19
1034,26296,0,0,deny,159,159,0,1,0,1,0
63628,445,0,0,drop,66,66,0,1,0,1,0
50017,53,55318,53,allow,190,97,93,2,31,1,1
56813,445,0,0,drop,70,70,0,1,0,1,0
50824,443,63186,443,allow,337727,11283,326444,367,208,126,241
49711,80,42345,80,allow,2269,821,1448,15,51,8,7
58611,53,0,0,allow,172,78,94,2,30,1,1
57257,80,32555,80,allow,1369,495,874,12,361,6,6
54748,445,0,0,drop,70,70,0,1,0,1,0
61720,445,0,0,drop,70,70,0,1,0,1,0
16425,15503,0,0,deny,62,62,0,1,0,1,0
54830,443,23517,443,allow,4478,1133,3345,13,26,8,5
50140,53,26490,53,allow,209,110,99,2,30,1,1
35722,30188,0,0,deny,146,146,0,1,0,1,0
19662,22114,0,0,deny,62,62,0,1,0,1,0
48817,21939,48817,21939,allow,513,152,361,2,1200,1,1
50187,53,34456,53,allow,168,78,90,2,30,1,1
39322,443,56925,443,allow,7450,2503,4947,21,977,11,10
61126,445,0,0,drop,70,70,0,1,0,1,0
52062,80,7748,80,allow,366,240,126,7,26,5,2
56327,53,30596,53,allow,199,102,97,2,30,1,1
26536,53,62994,53,allow,306,99,207,2,0,1,1
49701,443,3982,443,allow,28497,1646,26851,31,138,9,22
123,123,4741,123,allow,184,94,90,2,30,1,1
56939,445,0,0,drop,70,70,0,1,0,1,0
48817,6881,48817,6881,allow,863,363,500,4,1200,2,2
53669,59056,20109,59056,allow,70,70,0,1,5,1,0
56457,443,49133,443,allow,3654,1144,2510,10,120,5,5
26900,27017,55723,27017,allow,20322,11404,8918,118,133,67,51
65295,53,10641,53,allow,212,102,110,2,29,1,1
55048,53,59185,53,allow,780,104,676,2,30,1,1
51839,27256,26214,27256,allow,70,70,0,2,7,2,0
49687,53,16473,53,allow,197,102,95,2,29,1,1
346,23,0,0,deny,60,60,0,1,0,1,0
49730,53,58094,53,allow,767,102,665,2,30,1,1
54990,53,13608,53,allow,168,86,82,2,31,1,1
62514,37807,0,0,deny,66,66,0,1,0,1,0
62855,445,0,0,drop,70,70,0,1,0,1,0
56653,443,38474,443,allow,8059,2039,6020,20,15,11,9
50207,53,12070,53,allow,189,102,87,2,31,1,1
55237,53,24870,53,allow,259,87,172,4,56,2,2
9074,443,22062,443,allow,318,192,126,6,29,4,2
59326,57470,0,0,deny,74,74,0,1,0,1,0
8403,46824,0,0,deny,62,62,0,1,0,1,0
60751,20010,62533,20010,allow,70,70,0,1,5,1,0
36656,64147,0,0,deny,62,62,0,1,0,1,0
61085,37965,0,0,deny,62,62,0,1,0,1,0
48817,41706,48817,41706,allow,513,152,361,2,1200,1,1
65139,53,18725,53,allow,216,110,106,2,29,1,1
50618,80,9879,80,allow,25890,3442,22448,33,21,13,20
55344,53,59156,53,allow,212,110,102,2,30,1,1
36857,80,4468,80,allow,11216,2684,8532,28,163,11,17
10028,25604,0,0,deny,62,62,0,1,0,1,0
56873,53,11452,53,allow,184,94,90,2,29,1,1
61229,445,0,0,drop,66,66,0,1,0,1,0
64882,53,14352,53,allow,180,94,86,2,30,1,1
49787,445,0,0,drop,70,70,0,1,0,1,0
56800,1,46367,1,allow,70,70,0,1,5,1,0
50520,53,8153,53,allow,183,94,89,2,30,1,1
52882,445,0,0,drop,70,70,0,1,0,1,0
52169,59681,49857,59681,allow,66,66,0,1,5,1,0
56578,64147,0,0,deny,62,62,0,1,0,1,0
63963,53,7667,53,allow,262,86,176,4,46,2,2
30169,35776,0,0,deny,159,159,0,1,0,1,0
63934,53,45085,53,allow,202,103,99,2,30,1,1
56144,53,26768,53,allow,180,94,86,2,30,1,1
50464,80,50464,80,allow,218570,13559,205011,291,22,146,145
55788,53,26476,53,allow,231,110,121,2,30,1,1
63342,53,0,0,deny,72,72,0,1,0,1,0
54633,36237,0,0,deny,66,66,0,1,0,1,0
52079,1024,39803,1024,allow,66,66,0,1,5,1,0
52584,445,0,0,drop,66,66,0,1,0,1,0
53157,34841,3594,34841,allow,698,320,378,10,16,6,4
57432,66,6875,66,allow,70,70,0,2,8,2,0
65094,53,59382,53,allow,630,204,426,6,64,3,3
55101,443,55990,443,allow,1786,172,1614,7,120,3,4
443,22323,0,0,deny,83,83,0,1,0,1,0
63271,52752,0,0,deny,78,78,0,1,0,1,0
51763,34121,50527,34121,allow,70,70,0,1,5,1,0
58908,443,8392,443,allow,5166,700,4466,16,16,7,9
60043,445,0,0,drop,70,70,0,1,0,1,0
64001,53,1260,53,allow,183,94,89,2,30,1,1
31859,33909,0,0,deny,66,66,0,1,0,1,0
49925,80,49556,80,allow,1126,609,517,11,15,6,5
57987,56125,0,0,deny,90,90,0,1,0,1,0
27005,37579,44292,37579,allow,886,126,760,2,30,1,1
50637,44847,0,0,deny,66,66,0,1,0,1,0
64051,36829,0,0,deny,62,62,0,1,0,1,0
49686,53,23134,53,allow,183,94,89,2,30,1,1
58045,80,55044,80,allow,62067,24127,37940,79,34,33,46
40764,443,58656,443,allow,3321,1297,2024,13,28,7,6
54164,445,0,0,drop,66,66,0,1,0,1,0
52537,37965,0,0,deny,66,66,0,1,0,1,0
7198,53,7198,53,allow,398,255,143,3,32,2,1
63610,445,0,0,drop,70,70,0,1,0,1,0
55354,53,62421,53,allow,214,110,104,2,30,1,1
49380,53,58826,53,allow,199,102,97,2,31,1,1
46619,57470,0,0,deny,62,62,0,1,0,1,0
57470,48096,60784,48096,allow,132,132,0,3,1200,3,0
51414,22,0,0,deny,60,60,0,1,0,1,0
48706,23393,0,0,deny,60,60,0,1,0,1,0
36789,80,36658,80,allow,129896,7448,122448,172,32,87,85
38460,443,14446,443,allow,272822,10124,262698,330,81,126,204
51996,41888,55881,41888,allow,70,70,0,2,7,2,0
51187,445,0,0,drop,66,66,0,1,0,1,0
10013,40024,56811,40024,allow,156,94,62,2,30,1,1
53567,64147,0,0,deny,66,66,0,1,0,1,0
49699,443,3417,443,allow,9968,2106,7862,27,128,14,13
51506,443,39609,443,allow,4869,699,4170,14,15,8,6
55286,53,19401,53,allow,268,87,181,4,35,2,2
55919,64147,0,0,deny,62,62,0,1,0,1,0
52625,53,52625,53,allow,231,88,143,2,32,1,1
53587,32029,60710,32029,allow,70,70,0,2,8,2,0
61886,445,0,0,drop,70,70,0,1,0,1,0
56678,443,56425,443,allow,7889,1900,5989,20,15,11,9
27005,23010,35544,23010,allow,881,126,755,2,29,1,1
44974,443,22658,443,allow,17760,13913,3847,54,167,25,29
61792,445,0,0,drop,70,70,0,1,0,1,0
53860,443,53373,443,allow,8712,2293,6419,26,315,13,13
36146,443,42647,443,allow,2514,1249,1265,19,76,9,10
63107,443,39326,443,allow,3272,800,2472,10,120,5,5
52459,33890,0,0,deny,60,60,0,1,0,1,0
1882,43890,0,0,deny,62,62,0,1,0,1,0
50500,445,0,0,drop,70,70,0,1,0,1,0
55084,443,37269,443,allow,5556,1438,4118,22,196,12,10
31130,30188,0,0,deny,66,66,0,1,0,1,0
52064,80,62647,80,allow,65658,3155,62503,76,621,26,50
1036,64147,0,0,deny,62,62,0,1,0,1,0
57470,6890,10619,6890,allow,520,166,354,2,1199,1,1
60497,443,60497,443,allow,12727,948,11779,21,30,10,11
51311,445,0,0,drop,66,66,0,1,0,1,0
61002,26314,0,0,deny,143,143,0,1,0,1,0
64878,26467,0,0,deny,62,62,0,1,0,1,0
65299,445,0,0,drop,70,70,0,1,0,1,0
9445,443,7220,443,allow,6094,771,5323,17,25,9,8
26406,37965,0,0,deny,66,66,0,1,0,1,0
58549,445,0,0,drop,66,66,0,1,0,1,0
65290,53,22798,53,allow,181,94,87,2,29,1,1
11136,17500,0,0,deny,62,62,0,1,0,1,0
443,1785,0,0,deny,97,97,0,1,0,1,0
50195,53,43781,53,allow,199,102,97,2,30,1,1
60968,445,0,0,drop,70,70,0,1,0,1,0
59770,443,37125,443,allow,7316,1933,5383,27,16,15,12
50559,80,62420,80,allow,318,192,126,6,26,4,2
36433,80,4245,80,allow,1585,863,722,12,15,6,6
58443,445,0,0,drop,70,70,0,1,0,1,0
65075,53,30736,53,allow,278,100,178,4,30,2,2
52178,30922,2429,30922,allow,70,70,0,1,5,1,0
49769,53,37724,53,allow,780,93,687,2,31,1,1
54340,443,58977,443,allow,79305,3202,76103,98,347,32,66
53906,44512,0,0,deny,62,62,0,1,0,1,0
63787,445,0,0,drop,66,66,0,1,0,1,0
46518,44847,0,0,deny,62,62,0,1,0,1,0
54443,445,0,0,drop,70,70,0,1,0,1,0
49160,57470,0,0,deny,146,146,0,1,0,1,0
49595,80,13926,80,allow,1285,772,513,11,53,6,5
50544,443,14371,443,allow,11083,4570,6513,24,35,13,11
36369,51505,0,0,deny,62,62,0,1,0,1,0
57470,31112,14070,31112,allow,132,132,0,3,1199,3,0
57470,21158,39017,21158,allow,2182,798,1384,19,1199,10,9
52526,30188,0,0,deny,62,62,0,1,0,1,0
61591,445,0,0,drop,66,66,0,1,0,1,0
56543,445,0,0,drop,70,70,0,1,0,1,0
50008,53,47667,53,allow,193,102,91,2,31,1,1
44757,53,59516,53,allow,179,86,93,2,30,1,1
49929,26467,0,0,deny,66,66,0,1,0,1,0
58958,445,0,0,drop,66,66,0,1,0,1,0
62699,445,0,0,drop,70,70,0,1,0,1,0
56366,53,46809,53,allow,754,94,660,2,31,1,1
50527,53,64659,53,allow,969,86,883,2,30,1,1
50164,53,36057,53,allow,260,86,174,2,29,1,1
57115,53,1229,53,allow,178,94,84,2,30,1,1
50727,443,38985,443,allow,26161,3618,22543,80,119,31,49
64779,53,46294,53,allow,497,102,395,4,40,2,2
36699,443,33647,443,allow,11086707,166045,10920662,9176,172,1285,7891
54114,443,54114,443,allow,171467,27550,143917,220,85,108,112
45632,443,51632,443,allow,55844,3452,52392,85,255,38,47
13971,53,13971,53,allow,220,90,130,2,30,1,1
64723,56205,0,0,deny,62,62,0,1,0,1,0
27005,30002,50231,30002,allow,1780,252,1528,5,44,3,2
56606,445,0,0,drop,70,70,0,1,0,1,0
49671,53,34167,53,allow,242,110,132,2,30,1,1
41790,443,32230,443,allow,232,172,60,3,4,2,1
26386,53,26386,53,allow,231,90,141,2,30,1,1
63301,445,0,0,drop,70,70,0,1,0,1,0
56207,53,30514,53,allow,260,102,158,2,30,1,1
50250,53,19188,53,allow,172,88,84,2,30,1,1
1923,53,53314,53,allow,260,86,174,2,30,1,1
58638,5900,0,0,deny,62,62,0,1,0,1,0
26227,23,26227,23,allow,146,60,86,2,10,1,1
53142,443,26091,443,allow,4962,887,4075,15,28,9,6
51880,18468,1087,18468,allow,70,70,0,2,8,2,0
51700,445,0,0,drop,66,66,0,1,0,1,0
64306,53,34963,53,allow,216,110,106,2,31,1,1
54866,37965,0,0,deny,62,62,0,1,0,1,0
42298,4126,11425,4126,allow,132,64,68,2,30,1,1
40931,443,31983,443,allow,7399,3328,4071,76,4153,33,43
41409,80,32220,80,allow,1484,877,607,11,34,6,5
44300,443,36814,443,allow,7746,2015,5731,29,15,16,13
58568,445,0,0,drop,70,70,0,1,0,1,0
54182,443,54182,443,allow,4581,1674,2907,19,29,11,8
53037,445,0,0,drop,66,66,0,1,0,1,0
47595,33440,0,0,allow,106,106,0,1,61,1,0
50825,80,41226,80,allow,35970,11674,24296,108,265,55,53
64070,53,27144,53,allow,258,110,148,2,30,1,1
50998,443,19722,443,allow,3482,1985,1497,21,17,10,11
50796,445,0,0,drop,66,66,0,1,0,1,0
65198,445,0,0,drop,66,66,0,1,0,1,0
58638,5900,0,0,deny,62,62,0,1,0,1,0
51291,25174,0,0,deny,62,62,0,1,0,1,0
53504,443,31592,443,allow,2291912,60511,2231401,2353,196,863,1490
58638,5900,0,0,deny,62,62,0,1,0,1,0
36258,23,0,0,deny,60,60,0,1,0,1,0
51893,80,59031,80,allow,14289,7263,7026,27,27,14,13
49160,6886,47580,6886,allow,854,150,704,4,1200,2,2
26762,22114,0,0,deny,62,62,0,1,0,1,0
65077,53,33139,53,allow,734,86,648,2,30,1,1
43700,30188,0,0,deny,62,62,0,1,0,1,0
62591,7000,62591,7000,allow,3530,2027,1503,16,15,9,7
61458,443,40730,443,allow,3505,2042,1463,27,82,15,12
49418,33032,30338,33032,allow,78,78,0,1,30,1,0
55871,53,54584,53,allow,177,94,83,2,29,1,1
49393,443,42342,443,allow,62,62,0,1,5,1,0
10480,26467,0,0,deny,62,62,0,1,0,1,0
55043,57470,0,0,deny,78,78,0,1,0,1,0
55425,37965,0,0,deny,66,66,0,1,0,1,0
49963,53,30474,53,allow,279,96,183,4,58,2,2
49862,53,52956,53,allow,715,94,621,2,31,1,1
58535,30317,0,0,deny,62,62,0,1,0,1,0
37604,443,27839,443,allow,573,425,148,5,0,3,2
58926,443,61395,443,allow,5329,3428,1901,20,16,10,10
58209,53,58209,53,allow,645,90,555,2,30,1,1
33196,53,25269,53,allow,181,86,95,2,30,1,1
38576,443,38576,443,allow,225915,9896,216019,283,80,128,155
58992,445,0,0,drop,70,70,0,1,0,1,0
13525,51505,0,0,deny,146,146,0,1,0,1,0
65298,53,31126,53,allow,277,110,167,2,30,1,1
55864,445,0,0,drop,70,70,0,1,0,1,0
50620,445,0,0,drop,70,70,0,1,0,1,0
53121,8986,41857,8986,allow,70,70,0,2,8,2,0
65424,445,0,0,drop,70,70,0,1,0,1,0
51017,80,29159,80,allow,2654,796,1858,12,18,7,5
59956,443,50575,443,allow,2162,1113,1049,18,16,10,8
63321,37807,0,0,deny,66,66,0,1,0,1,0
62642,25174,0,0,deny,62,62,0,1,0,1,0
61241,22114,0,0,deny,66,66,0,1,0,1,0
64958,53,27605,53,allow,216,94,122,2,30,1,1
36732,443,61155,443,allow,7449,2359,5090,15,120,7,8
64575,53,5183,53,allow,182,102,80,2,31,1,1
49946,443,3936,443,allow,8725,3341,5384,25,136,12,13
45964,3111,0,0,deny,60,60,0,1,0,1,0
12821,37965,0,0,deny,66,66,0,1,0,1,0
53774,58433,12540,58433,allow,320,140,180,6,7,3,3
54822,445,0,0,drop,70,70,0,1,0,1,0
62421,445,0,0,drop,70,70,0,1,0,1,0
59319,53,47365,53,allow,285,106,179,2,31,1,1
64803,53,24000,53,allow,303,303,0,4,47,4,0
55421,53,44471,53,allow,200,102,98,2,30,1,1
56089,445,0,0,drop,70,70,0,1,0,1,0
59940,80,29186,80,allow,1169137,23501,1145636,1104,22,344,760
64040,53,17235,53,allow,226,102,124,2,29,1,1
61592,445,0,0,drop,70,70,0,1,0,1,0
58638,5900,0,0,deny,62,62,0,1,0,1,0
55831,53,9463,53,allow,183,94,89,2,30,1,1
57881,443,48213,443,allow,3486,2064,1422,26,177,14,12
60950,445,0,0,drop,70,70,0,1,0,1,0
51260,445,0,0,drop,70,70,0,1,0,1,0
64243,53,24679,53,allow,244,94,150,2,30,1,1
63581,445,0,0,drop,66,66,0,1,0,1,0
47957,443,9309,443,allow,7658,4247,3411,29,31,15,14
55937,53,44427,53,allow,758,93,665,2,31,1,1
28331,53,28331,53,allow,213,87,126,2,30,1,1
55622,445,0,0,drop,70,70,0,1,0,1,0
56975,80,23804,80,allow,214,140,74,4,35,3,1
56445,53,50550,53,allow,353,110,243,4,46,2,2
38253,23117,0,0,deny,146,146,0,1,0,1,0
56701,443,57052,443,allow,8007,1987,6020,20,15,11,9
49516,53,32390,53,allow,183,94,89,2,31,1,1
60342,445,0,0,drop,70,70,0,1,0,1,0
55820,53,60004,53,allow,194,102,92,2,31,1,1
47595,33441,0,0,allow,106,106,0,1,60,1,0
56478,445,0,0,drop,70,70,0,1,0,1,0
9138,80,8999,80,allow,318,192,126,6,29,4,2
58751,51221,0,0,deny,62,62,0,1,0,1,0
59787,443,50421,443,allow,173218,14836,158382,227,48,114,113
8485,80,8485,80,allow,572,240,332,10,84,5,5
20198,17372,0,0,deny,62,62,0,1,0,1,0
34600,443,63857,443,allow,7950,1925,6025,26,66,14,12
49978,53,55753,53,allow,195,102,93,2,30,1,1
50644,443,24533,443,allow,1514,852,662,16,86,9,7
64900,53,46043,53,allow,197,102,95,2,30,1,1
60811,40010,33835,40010,allow,316,136,180,6,5,3,3
55056,445,0,0,drop,70,70,0,1,0,1,0
52126,443,21159,443,allow,1672,1149,523,13,37,8,5
57813,445,0,0,drop,70,70,0,1,0,1,0
12632,25174,0,0,deny,62,62,0,1,0,1,0
52695,26467,0,0,deny,66,66,0,1,0,1,0
22541,64147,0,0,deny,66,66,0,1,0,1,0
27005,27018,44540,27018,allow,882,126,756,2,30,1,1
51553,445,0,0,drop,70,70,0,1,0,1,0
60452,445,0,0,drop,70,70,0,1,0,1,0
64687,53,10483,53,allow,183,94,89,2,29,1,1
47355,161,0,0,allow,7809,3013,4796,28,31,14,14
7310,44847,0,0,deny,66,66,0,1,0,1,0
35321,443,13287,443,allow,9675,2671,7004,36,262,18,18
63925,37965,0,0,deny,66,66,0,1,0,1,0
49765,53,13036,53,allow,194,102,92,2,31,1,1
54375,445,0,0,drop,66,66,0,1,0,1,0
64935,53,3553,53,allow,198,102,96,2,30,1,1
56182,53,55538,53,allow,762,98,664,2,0,1,1
30707,30317,0,0,deny,62,62,0,1,0,1,0
7067,22114,0,0,deny,62,62,0,1,0,1,0
6881,6883,20913,6883,allow,259,150,109,2,1200,1,1
65218,53,11039,53,allow,188,96,92,2,30,1,1
55542,53,5269,53,allow,711,87,624,2,31,1,1
49501,53,7726,53,allow,734,94,640,2,29,1,1
54817,47993,0,0,deny,66,66,0,1,0,1,0
19455,25174,0,0,deny,62,62,0,1,0,1,0
50265,17555,24395,17555,allow,1488,930,558,21,1200,12,9
52850,443,36065,443,allow,5743,1339,4404,18,180,8,10
63176,445,0,0,drop,66,66,0,1,0,1,0
51876,35624,28526,35624,allow,70,70,0,2,8,2,0
63527,50584,0,0,deny,66,66,0,1,0,1,0
61507,443,11095,443,allow,443128,10267,432861,362,45,60,302
25629,28678,25311,28678,allow,1806,1806,0,22,225,22,0
63092,46776,0,0,deny,78,78,0,1,0,1,0
50292,62413,0,0,deny,146,146,0,1,0,1,0
56065,445,0,0,drop,66,66,0,1,0,1,0
50311,80,32414,80,allow,366,180,186,7,57,4,3
51838,443,42521,443,allow,9329,3898,5431,21,39,12,9
60906,443,59580,443,allow,11543,5375,6168,45,47,24,21
58021,80,10301,80,allow,318,192,126,6,20,4,2
64416,53,56387,53,allow,291,110,181,2,30,1,1
57297,53,52793,53,allow,242,102,140,2,30,1,1
50353,445,0,0,drop,66,66,0,1,0,1,0
33119,80,62481,80,allow,1638,1324,314,10,14,5,5
60866,445,0,0,drop,70,70,0,1,0,1,0
65342,445,0,0,drop,66,66,0,1,0,1,0
64166,445,0,0,drop,66,66,0,1,0,1,0
55889,53,50897,53,allow,199,102,97,2,29,1,1
53179,445,0,0,drop,66,66,0,1,0,1,0
49339,443,31744,443,allow,208,70,138,4,25,2,2
54971,443,20430,443,allow,13124,8442,4682,40,43,24,16
56039,50584,0,0,deny,62,62,0,1,0,1,0
57063,53,16093,53,allow,186,95,91,2,31,1,1
56648,443,37098,443,allow,1327,918,409,10,26,6,4
56733,53,5625,53,allow,183,94,89,2,30,1,1
53130,443,27794,443,allow,7169,1715,5454,18,325,9,9
56470,53,54674,53,allow,198,102,96,2,31,1,1
35797,443,35797,443,allow,4378,1471,2907,19,27,11,8
59983,443,26904,443,allow,296863,14073,282790,351,127,130,221
56977,53,42818,53,allow,273,102,171,2,30,1,1
58638,5900,0,0,deny,62,62,0,1,0,1,0
50514,445,0,0,drop,70,70,0,1,0,1,0
44847,6881,11410,6881,allow,502,150,352,2,1200,1,1
49815,443,20999,443,allow,3964,780,3184,14,125,8,6
25523,35974,0,0,deny,62,62,0,1,0,1,0
57470,15564,5143,15564,allow,1577,594,983,20,1624,10,10
56327,44512,0,0,deny,66,66,0,1,0,1,0
17009,53733,0,0,deny,66,66,0,1,0,1,0
58115,53,48692,53,allow,578,286,292,9,15,5,4
1441,51221,0,0,deny,62,62,0,1,0,1,0
2383,37965,0,0,deny,62,62,0,1,0,1,0
49570,443,54043,443,allow,1013,492,521,10,30,4,6
51080,445,0,0,drop,66,66,0,1,0,1,0
56878,445,0,0,drop,70,70,0,1,0,1,0
65189,53,45878,53,allow,180,94,86,2,30,1,1
35186,443,1570,443,allow,130,70,60,3,5,2,1
46445,443,57162,443,allow,13942,8293,5649,59,172,31,28
49924,53,63883,53,allow,353,94,259,2,31,1,1
40254,443,35283,443,allow,7646,1024,6622,19,15,11,8
3478,61463,0,0,deny,1292,1292,0,1,0,1,0
61355,443,38386,443,allow,17666,3045,14621,52,213,21,31
55932,53,3397,53,allow,186,95,91,2,30,1,1
62080,54532,0,0,deny,60,60,0,1,0,1,0
53501,445,0,0,drop,70,70,0,1,0,1,0
62912,26467,0,0,deny,62,62,0,1,0,1,0
51791,445,0,0,drop,70,70,0,1,0,1,0
42520,53,41857,53,allow,168,78,90,2,30,1,1
56553,53,56242,53,allow,199,102,97,2,30,1,1
43657,50011,0,0,deny,62,62,0,1,0,1,0
8283,52443,34417,52443,allow,130,70,60,2,30,1,1
49607,25174,0,0,deny,66,66,0,1,0,1,0
37008,42707,0,0,deny,62,62,0,1,0,1,0
4650,53,4650,53,allow,300,90,210,2,29,1,1
62189,64147,0,0,deny,62,62,0,1,0,1,0
54397,445,0,0,drop,70,70,0,1,0,1,0
3090,1,0,0,deny,66,66,0,1,0,1,0
65096,445,0,0,drop,66,66,0,1,0,1,0
59983,443,57676,443,allow,158230,9208,149022,214,21,105,109
12226,37965,0,0,deny,62,62,0,1,0,1,0
56098,64147,0,0,deny,66,66,0,1,0,1,0
14350,56205,0,0,deny,146,146,0,1,0,1,0
41029,80,41029,80,allow,12386,2651,9735,24,126,12,12
57364,53,57364,53,allow,213,79,134,2,32,1,1
50470,53,11331,53,allow,770,102,668,2,30,1,1
55647,443,60557,443,allow,90956,83597,7359,106,127,70,36
52240,445,0,0,drop,70,70,0,1,0,1,0
64892,445,0,0,drop,66,66,0,1,0,1,0
62911,993,63006,993,allow,8753,4199,4554,76,54,41,35
65471,443,32170,443,allow,92569,4939,87630,111,15,45,66
57356,443,4225,443,allow,7802,4189,3613,22,136,11,11
56557,53,31623,53,allow,212,108,104,2,31,1,1
27005,32025,26233,32025,allow,887,126,761,2,30,1,1
55627,26192,42431,26192,allow,70,70,0,2,8,2,0
3478,61463,0,0,deny,1188,1188,0,1,0,1,0
63497,445,0,0,drop,70,70,0,1,0,1,0
10602,3389,10602,3389,allow,3910,1805,2105,20,19,12,8
58638,5900,0,0,deny,62,62,0,1,0,1,0
56160,53,63340,53,allow,190,97,93,2,30,1,1
56375,445,0,0,drop,66,66,0,1,0,1,0
60848,445,0,0,drop,70,70,0,1,0,1,0
61090,445,0,0,drop,70,70,0,1,0,1,0
55094,53,35029,53,allow,244,94,150,2,30,1,1
45964,2225,0,0,deny,60,60,0,1,0,1,0
52929,1433,0,0,deny,60,60,0,1,0,1,0
51922,44847,0,0,deny,66,66,0,1,0,1,0
63366,30365,45991,30365,allow,738,318,420,12,163,5,7
56199,53,11587,53,allow,79,79,0,2,33,2,0
30046,15503,0,0,deny,62,62,0,1,0,1,0
35515,80,62151,80,allow,841,715,126,5,15,3,2
26921,57470,0,0,deny,62,62,0,1,0,1,0
12668,42707,0,0,deny,62,62,0,1,0,1,0
27005,1103,38860,1103,allow,822,126,696,2,30,1,1
55545,445,0,0,drop,70,70,0,1,0,1,0
51015,64147,0,0,deny,62,62,0,1,0,1,0
57470,6881,47770,6881,allow,330,330,0,6,1200,6,0
13484,37965,0,0,deny,62,62,0,1,0,1,0
62745,445,0,0,drop,70,70,0,1,0,1,0
46090,50584,0,0,deny,66,66,0,1,0,1,0
39895,443,43258,443,allow,10727,3308,7419,33,503,15,18
23331,25174,0,0,deny,66,66,0,1,0,1,0
27005,27019,44528,27019,allow,880,126,754,2,30,1,1
50726,443,27589,443,allow,12350,2504,9846,41,137,21,20
39342,80,30469,80,allow,1638,1324,314,10,16,5,5
65466,53,9762,53,allow,298,102,196,4,39,2,2
57173,44847,0,0,deny,62,62,0,1,0,1,0
35577,443,21477,443,allow,15162,8505,6657,55,197,29,26
64026,80,47805,80,allow,314,192,122,6,15,4,2
50038,445,0,0,drop,66,66,0,1,0,1,0
64202,53,3004,53,allow,316,89,227,4,50,2,2
57362,53,3531,53,allow,177,94,83,2,30,1,1
53611,445,0,0,drop,70,70,0,1,0,1,0
58638,5900,0,0,deny,62,62,0,1,0,1,0
50172,443,57262,443,allow,130,70,60,2,14,1,1
64421,53,32983,53,allow,178,94,84,2,29,1,1
61983,50432,0,0,deny,66,66,0,1,0,1,0
51998,1877,49263,1877,allow,316,136,180,6,6,3,3
43185,443,5462,443,allow,6951,1333,5618,26,271,14,12
56619,80,59686,80,allow,234,234,0,4,12,4,0
56781,17548,14113,17548,allow,70,70,0,1,5,1,0
55081,445,0,0,drop,70,70,0,1,0,1,0
63954,53,25119,53,allow,352,102,250,2,29,1,1
57195,53,29138,53,allow,190,97,93,2,31,1,1
46275,64147,0,0,deny,62,62,0,1,0,1,0
53309,445,0,0,drop,70,70,0,1,0,1,0
65270,3855,0,0,deny,78,78,0,1,0,1,0
51825,80,15500,80,allow,540,540,0,10,194,10,0
49241,53,22091,53,allow,785,110,675,2,30,1,1
35232,36602,0,0,deny,74,74,0,1,0,1,0
3478,61463,0,0,deny,64,64,0,1,0,1,0
54166,445,0,0,drop,70,70,0,1,0,1,0
28973,30188,0,0,deny,66,66,0,1,0,1,0
60479,53928,50197,53928,allow,70,70,0,2,8,2,0
41738,53,43971,53,allow,168,78,90,2,30,1,1
51904,51883,50262,51883,allow,70,70,0,1,5,1,0
64867,445,0,0,drop,70,70,0,1,0,1,0
56362,53,49455,53,allow,195,102,93,2,30,1,1
50321,445,0,0,drop,70,70,0,1,0,1,0
53653,17436,48182,17436,allow,70,70,0,2,8,2,0
64406,25174,0,0,deny,66,66,0,1,0,1,0
53830,445,0,0,drop,70,70,0,1,0,1,0
65106,53,60145,53,allow,438,180,258,6,30,3,3
58981,445,0,0,drop,70,70,0,1,0,1,0
50265,13826,10952,13826,allow,330,330,0,6,1200,6,0
55055,443,60639,443,allow,14492,3190,11302,34,16,19,15
44959,443,64557,443,allow,373033,19903,353130,469,143,180,289
43014,443,37896,443,allow,134,60,74,3,5,2,1
56094,53,60857,53,allow,764,99,665,2,31,1,1
48014,80,51000,80,allow,4006,3572,434,14,15,7,7
49812,53,37839,53,allow,195,86,109,2,30,1,1
49454,80,13717,80,allow,3920,2138,1782,23,135,12,11
9178,443,33091,443,allow,5731,495,5236,14,15,7,7
51646,80,63912,80,allow,1038219,43977,994242,1734,30,616,1118
56455,53,48314,53,allow,182,93,89,2,31,1,1
50672,445,0,0,drop,70,70,0,1,0,1,0
58638,5900,0,0,deny,62,62,0,1,0,1,0
59464,443,49741,443,allow,7333,1933,5400,27,16,15,12
60438,17372,0,0,deny,66,66,0,1,0,1,0
61703,80,42538,80,allow,1494,954,540,13,51,8,5
58843,443,44716,443,allow,6033,770,5263,18,16,8,10
57761,30317,0,0,deny,66,66,0,1,0,1,0
65334,443,56103,443,allow,3182,1568,1614,8,120,4,4
59155,39004,0,0,deny,74,74,0,1,0,1,0
50297,80,4817,80,allow,145266,14613,130653,165,161,63,102
56848,53,54786,53,allow,764,99,665,2,31,1,1
63702,445,0,0,drop,66,66,0,1,0,1,0
52128,37807,0,0,deny,66,66,0,1,0,1,0
64613,445,0,0,drop,70,70,0,1,0,1,0
61593,445,0,0,drop,66,66,0,1,0,1,0
53016,443,45563,443,allow,50403,2032,48371,66,108,21,45
42288,443,48757,443,allow,16985,7850,9135,39,121,19,20
50108,53,31749,53,allow,174,89,85,2,30,1,1
32959,443,7767,443,allow,9262,2792,6470,53,616,28,25
57348,25174,0,0,deny,62,62,0,1,0,1,0
64164,445,0,0,drop,66,66,0,1,0,1,0
52001,80,32528,80,allow,7578,4652,2926,49,323,30,19
56652,53,11062,53,allow,177,94,83,2,30,1,1
49525,80,7498,80,allow,454,262,192,8,38,5,3
50800,445,0,0,drop,66,66,0,1,0,1,0
2890,443,2890,443,allow,6915,882,6033,16,134,9,7
38655,443,22510,443,allow,498,210,288,8,26,4,4
37593,443,32259,443,allow,21234,9602,11632,48,70,28,20
53820,445,0,0,drop,70,70,0,1,0,1,0
63843,445,0,0,drop,70,70,0,1,0,1,0
56495,445,0,0,drop,70,70,0,1,0,1,0
62896,993,16279,993,allow,9831,4069,5762,88,192,40,48
60877,445,0,0,drop,70,70,0,1,0,1,0
6881,37232,47143,37232,allow,502,150,352,2,1199,1,1
45225,443,59513,443,allow,11233,3101,8132,37,150,18,19
6666,3493,6666,3493,allow,60,60,0,1,5,1,0
61012,445,0,0,drop,70,70,0,1,0,1,0
60488,27615,36232,27615,allow,70,70,0,2,8,2,0
55329,445,0,0,drop,70,70,0,1,0,1,0
57678,445,0,0,drop,70,70,0,1,0,1,0
60857,443,19971,443,allow,18385,7771,10614,47,48,27,20
38484,48637,0,0,deny,60,60,0,1,0,1,0
55208,53,14602,53,allow,177,94,83,2,30,1,1
57814,443,32836,443,allow,6162,925,5237,18,108,10,8
63751,445,0,0,drop,70,70,0,1,0,1,0
56678,445,0,0,drop,70,70,0,1,0,1,0
61176,445,0,0,drop,70,70,0,1,0,1,0
49859,80,22070,80,allow,1644,1324,320,10,15,5,5
57323,443,4968,443,allow,5613,733,4880,16,14,9,7
57299,53,60240,53,allow,338,110,228,2,30,1,1
49418,27016,26293,27016,allow,257,71,186,2,30,1,1
55207,80,45213,80,allow,1979,1326,653,16,500,10,6
65020,53,24466,53,allow,290,94,196,4,55,2,2
50669,80,58976,80,allow,1485,806,679,13,15,7,6
40147,443,40147,443,allow,1092,575,517,10,145,5,5
53872,24710,60030,24710,allow,70,70,0,2,7,2,0
36477,40740,0,0,deny,145,145,0,1,0,1,0
55615,53,23565,53,allow,772,100,672,2,31,1,1
56032,443,63053,443,allow,1775,169,1606,7,120,3,4
54140,17372,0,0,deny,66,66,0,1,0,1,0
50438,53,44786,53,allow,296,101,195,4,31,2,2
65006,26467,0,0,deny,66,66,0,1,0,1,0
443,62451,0,0,deny,199,199,0,1,0,1,0
52989,445,0,0,drop,70,70,0,1,0,1,0
53416,445,0,0,drop,70,70,0,1,0,1,0
45269,50584,0,0,deny,62,62,0,1,0,1,0
55839,443,48499,443,allow,13469,2007,11462,44,256,19,25
2267,53,13716,53,allow,204,118,86,2,30,1,1
63992,53,19496,53,allow,199,102,97,2,30,1,1
37707,53,28750,53,allow,168,78,90,2,30,1,1
25296,51505,0,0,deny,66,66,0,1,0,1,0
64882,53,8935,53,allow,246,94,152,2,30,1,1
37653,443,30565,443,allow,9605,2939,6666,29,46,17,12
54775,443,18687,443,allow,12150,2950,9200,35,341,17,18
58638,5900,0,0,deny,62,62,0,1,0,1,0
60403,22114,0,0,deny,66,66,0,1,0,1,0
64929,53,46254,53,allow,168,86,82,2,31,1,1
56965,53,26904,53,allow,183,94,89,2,30,1,1
65359,53,19133,53,allow,193,102,91,2,31,1,1
41022,30975,0,0,deny,157,157,0,1,0,1,0
60491,445,0,0,drop,70,70,0,1,0,1,0
60971,443,16884,443,allow,4548,2858,1690,42,111,22,20
64967,53,49030,53,allow,184,94,90,2,31,1,1
64744,445,0,0,drop,70,70,0,1,0,1,0
55483,445,0,0,drop,70,70,0,1,0,1,0
39566,443,50145,443,allow,9748,5209,4539,22,121,11,11
58638,5900,0,0,deny,62,62,0,1,0,1,0
60885,443,31610,443,allow,887,542,345,11,15,6,5
55872,123,4281,123,allow,184,94,90,2,30,1,1
53946,27426,37838,27426,allow,612,306,306,10,14,5,5
58912,11392,0,0,deny,66,66,0,1,0,1,0
53964,445,0,0,drop,70,70,0,1,0,1,0
63143,16884,9026,16884,allow,618,318,300,10,16,5,5
56609,80,38761,80,allow,234,234,0,4,12,4,0
57556,443,56704,443,allow,162,102,60,2,5,1,1
50412,445,0,0,drop,70,70,0,1,0,1,0
48817,51234,48817,51234,allow,158,158,0,1,1200,1,0
54908,445,0,0,drop,66,66,0,1,0,1,0
59770,445,0,0,drop,70,70,0,1,0,1,0
50638,445,0,0,drop,70,70,0,1,0,1,0
51125,80,6897,80,allow,2880,815,2065,12,25,7,5
53218,56205,0,0,deny,66,66,0,1,0,1,0
52054,445,0,0,drop,70,70,0,1,0,1,0
53984,57077,13402,57077,allow,70,70,0,2,8,2,0
8204,53,48850,53,allow,86,86,0,1,30,1,0
63672,445,0,0,drop,70,70,0,1,0,1,0
44389,53,44389,53,allow,235,90,145,2,32,1,1
39023,443,14196,443,allow,1017,705,312,9,20,4,5
55951,30188,0,0,deny,66,66,0,1,0,1,0
50578,80,53375,80,allow,1114,534,580,12,16,7,5
56498,443,11650,443,allow,1343,763,580,14,26,8,6
52001,80,13411,80,allow,546,300,246,10,25,6,4
54502,34729,0,0,deny,66,66,0,1,0,1,0
49675,53,62009,53,allow,78,78,0,1,30,1,0
28234,36653,45143,36653,allow,64,64,0,1,10,1,0
64573,53,34650,53,allow,184,94,90,2,30,1,1
55011,53,15618,53,allow,760,96,664,2,31,1,1
56101,53,1484,53,allow,188,96,92,2,40,1,1
62580,23,0,0,deny,60,60,0,1,0,1,0
23753,25174,0,0,deny,62,62,0,1,0,1,0
53144,445,0,0,drop,70,70,0,1,0,1,0
49681,443,34762,443,allow,7383,2461,4922,18,135,8,10
48817,6889,48817,6889,allow,502,158,344,2,1200,1,1
55195,443,41833,443,allow,907774,32911,874863,898,460,195,703
18415,37965,0,0,deny,62,62,0,1,0,1,0
55106,53,58487,53,allow,177,94,83,2,30,1,1
64162,53,51950,53,allow,255,118,137,2,29,1,1
64249,445,0,0,drop,70,70,0,1,0,1,0
53969,13156,32626,13156,allow,70,70,0,1,4,1,0
64397,53,47942,53,allow,658,186,472,6,51,3,3
58832,443,61522,443,allow,274798,9459,265339,343,201,136,207
49409,443,26346,443,allow,6574,2176,4398,28,124,14,14
30960,45760,12069,45760,allow,462,462,0,8,3632,8,0
50615,53,31516,53,allow,785,110,675,2,30,1,1
64969,445,0,0,drop,70,70,0,1,0,1,0
60048,445,0,0,drop,70,70,0,1,0,1,0
50584,53743,42258,53743,allow,1356,300,1056,6,1201,3,3
54883,60043,0,0,deny,62,62,0,1,0,1,0
57376,443,40721,443,allow,7211,823,6388,16,15,10,6
54028,37965,0,0,deny,62,62,0,1,0,1,0
56674,443,42391,443,allow,7889,1900,5989,20,15,11,9
47828,443,4397,443,allow,512466,48982,463484,912,124,446,466
27005,27021,13743,27021,allow,1616,126,1490,4,30,2,2
51650,80,16811,80,allow,312,192,120,6,37,4,2
52519,44847,0,0,deny,66,66,0,1,0,1,0
54371,443,18994,443,allow,11828,2811,9017,31,76,16,15
59063,445,0,0,drop,66,66,0,1,0,1,0
49980,53,9358,53,allow,168,94,74,2,31,1,1
62412,445,0,0,drop,70,70,0,1,0,1,0
49418,27016,22907,27016,allow,254,71,183,2,30,1,1
57211,53,8547,53,allow,258,110,148,2,30,1,1
59101,445,0,0,drop,66,66,0,1,0,1,0
64690,53,18350,53,allow,338,110,228,2,30,1,1
65487,53,2041,53,allow,210,110,100,2,29,1,1
62353,80,60521,80,allow,2895,771,2124,12,24,6,6
63717,37965,0,0,deny,66,66,0,1,0,1,0
62497,443,15059,443,allow,10393,7059,3334,27,26,15,12
57287,445,0,0,drop,66,66,0,1,0,1,0
60985,443,15568,443,allow,30399,22692,7707,57,144,31,26
14923,51505,0,0,deny,66,66,0,1,0,1,0
50383,445,0,0,drop,66,66,0,1,0,1,0
64001,53,52493,53,allow,183,94,89,2,29,1,1
6890,11204,0,0,deny,146,146,0,1,0,1,0
37605,443,2336,443,allow,573,425,148,5,0,3,2
55479,53,3977,53,allow,789,110,679,2,30,1,1
49239,8080,49239,8080,allow,378,180,198,7,53,4,3
57379,445,0,0,drop,70,70,0,1,0,1,0
43039,53,37075,53,allow,241,78,163,2,30,1,1
49416,53,16616,53,allow,185,102,83,2,30,1,1
62849,62413,0,0,deny,62,62,0,1,0,1,0
58363,53,45299,53,allow,167,78,89,2,30,1,1
55744,445,0,0,drop,70,70,0,1,0,1,0
60770,443,16135,443,allow,4239,2026,2213,15,120,7,8
56979,53,50230,53,allow,209,110,99,2,30,1,1
50099,445,0,0,drop,66,66,0,1,0,1,0
39135,443,24335,443,allow,8286,2195,6091,24,256,12,12
48389,443,33224,443,allow,6616,3644,2972,18,122,9,9
49201,53,51989,53,allow,200,102,98,2,30,1,1
59111,443,56216,443,allow,10912,6095,4817,28,17,15,13
34331,443,8773,443,allow,1717,1153,564,13,26,7,6
63122,445,0,0,drop,70,70,0,1,0,1,0
11136,15503,0,0,deny,62,62,0,1,0,1,0
42973,57470,0,0,deny,62,62,0,1,0,1,0
50265,32988,60132,32988,allow,1488,930,558,21,1200,12,9
55605,53,59160,53,allow,198,102,96,2,30,1,1
55493,80,50792,80,allow,133558,8265,125293,186,31,93,93
61474,445,0,0,drop,70,70,0,1,0,1,0
49418,27016,33402,27016,allow,259,78,181,2,29,1,1
49667,80,7772,80,allow,27534,4859,22675,34,41,14,20
46327,25903,54070,25903,allow,134,64,70,2,10,1,1
58736,445,0,0,drop,70,70,0,1,0,1,0
44847,6882,30467,6882,allow,502,150,352,2,1200,1,1
49172,53,13814,53,allow,305,94,211,2,30,1,1
63160,445,0,0,drop,70,70,0,1,0,1,0
30373,23,0,0,deny,60,60,0,1,0,1,0
50497,80,3021,80,allow,19946,10573,9373,29,25,14,15
33710,22114,0,0,deny,146,146,0,1,0,1,0
32770,51505,0,0,deny,62,62,0,1,0,1,0
38144,443,38144,443,allow,14849,2263,12586,29,90,17,12
52063,7886,16483,7886,allow,70,70,0,1,5,1,0
56712,46824,0,0,deny,66,66,0,1,0,1,0
40360,443,31288,443,allow,3146,766,2380,10,120,5,5
55012,25174,0,0,deny,66,66,0,1,0,1,0
53572,22754,38870,22754,allow,70,70,0,2,8,2,0
52159,16297,7644,16297,allow,70,70,0,2,8,2,0
58638,5900,0,0,deny,62,62,0,1,0,1,0
53073,32468,0,0,deny,66,66,0,1,0,1,0
50842,445,0,0,drop,70,70,0,1,0,1,0
60807,445,0,0,drop,66,66,0,1,0,1,0
21542,57470,0,0,deny,74,74,0,1,0,1,0
34531,23117,0,0,deny,62,62,0,1,0,1,0
51721,35426,42015,35426,allow,70,70,0,2,8,2,0
56486,443,16895,443,allow,2673671,30446,2643225,2145,125,234,1911
60766,28080,64298,28080,allow,70,70,0,2,8,2,0
60805,5900,0,0,deny,60,60,0,1,0,1,0
65349,53,10010,53,allow,275,110,165,2,30,1,1
61401,443,65147,443,allow,33774,1880,31894,58,195,19,39
51813,443,19561,443,allow,3182,1568,1614,8,121,4,4
39941,2767,0,0,deny,62,62,0,1,0,1,0
60292,7129,0,0,deny,62,62,0,1,0,1,0
62599,445,0,0,drop,70,70,0,1,0,1,0
20012,8443,0,0,deny,60,60,0,1,0,1,0
42019,443,22698,443,allow,21620,7973,13647,112,488,57,55
53898,12172,10905,12172,allow,70,70,0,2,7,2,0
58638,5900,0,0,deny,62,62,0,1,0,1,0
63000,445,0,0,drop,66,66,0,1,0,1,0
64870,53,42981,53,allow,200,102,98,2,33,1,1
55193,445,0,0,drop,70,70,0,1,0,1,0
55957,53,38699,53,allow,172,88,84,2,30,1,1
57409,53,32069,53,allow,168,86,82,2,31,1,1
56665,443,57309,443,allow,1299,730,569,13,25,7,6
64890,445,0,0,drop,70,70,0,1,0,1,0
56543,53,0,0,allow,82,82,0,1,31,1,0
58779,445,0,0,drop,70,70,0,1,0,1,0
49418,27015,35116,27015,allow,78,78,0,1,30,1,0
49248,80,49248,80,allow,163556,12140,151416,207,22,97,110
10218,2323,0,0,deny,60,60,0,1,0,1,0
49806,443,11715,443,allow,37255,2202,35053,46,125,17,29
51914,80,46843,80,allow,366,240,126,7,28,5,2
64326,445,0,0,drop,70,70,0,1,0,1,0
33446,80,33446,80,allow,1753,833,920,10,20,6,4
27328,21247,0,0,deny,62,62,0,1,0,1,0
39817,443,13115,443,allow,516080,28328,487752,660,95,305,355
61916,64097,0,0,deny,66,66,0,1,0,1,0
50606,80,30995,80,allow,83795,22317,61478,117,43,52,65
49671,445,0,0,drop,66,66,0,1,0,1,0
13160,7905,0,0,deny,62,62,0,1,0,1,0
9130,80,10198,80,allow,318,192,126,6,30,4,2
59219,445,0,0,drop,70,70,0,1,0,1,0
53469,36237,0,0,deny,66,66,0,1,0,1,0
59248,443,51315,443,allow,8332,1024,7308,21,25,11,10
38633,443,28633,443,allow,4393,1151,3242,22,165,13,9
56230,445,0,0,drop,70,70,0,1,0,1,0
35804,443,35654,443,allow,232,172,60,3,5,2,1
50298,445,0,0,drop,70,70,0,1,0,1,0
37542,443,40273,443,allow,13299,2872,10427,34,41,19,15
49893,443,34865,443,allow,7115,1670,5445,24,35,13,11
57997,80,61005,80,allow,318,192,126,6,21,4,2
51105,445,0,0,drop,66,66,0,1,0,1,0
61386,445,0,0,drop,66,66,0,1,0,1,0
50984,80,27335,80,allow,8706,2289,6417,22,19,13,9
36400,51505,0,0,deny,62,62,0,1,0,1,0
51986,41982,32620,41982,allow,70,70,0,1,5,1,0
53438,443,53438,443,allow,2511,1465,1046,21,102,10,11
60693,445,0,0,drop,66,66,0,1,0,1,0
64303,443,22839,443,allow,3205,781,2424,17,135,8,9
56606,445,0,0,drop,66,66,0,1,0,1,0
55581,64301,29198,64301,allow,316,190,126,5,15,3,2
1024,57470,0,0,deny,62,62,0,1,0,1,0
55836,445,0,0,drop,66,66,0,1,0,1,0
47013,44512,0,0,deny,62,62,0,1,0,1,0
43120,80,4226,80,allow,1151,711,440,10,15,5,5
26629,56079,0,0,deny,62,62,0,1,0,1,0
58638,5900,0,0,deny,62,62,0,1,0,1,0
55842,445,0,0,drop,70,70,0,1,0,1,0
43363,26467,0,0,deny,66,66,0,1,0,1,0
51812,15279,41054,15279,allow,70,70,0,1,4,1,0
50126,445,0,0,drop,70,70,0,1,0,1,0
54525,445,0,0,drop,66,66,0,1,0,1,0
53281,80,26227,80,allow,124,64,60,3,5,2,1
60287,53,47078,53,allow,215,86,129,2,30,1,1
53110,445,0,0,drop,66,66,0,1,0,1,0
39575,53,26625,53,allow,198,93,105,2,30,1,1
60534,80,60534,80,allow,84558,3469,81089,94,16,34,60
50819,443,24202,443,allow,11217,3882,7335,42,164,19,23
47132,1433,0,0,deny,60,60,0,1,0,1,0
64613,53,44378,53,allow,179,94,85,2,30,1,1
56960,80,32758,80,allow,6363,3790,2573,16,30,10,6
58447,445,0,0,drop,70,70,0,1,0,1,0
56818,53,44106,53,allow,755,94,661,2,30,1,1
60493,445,0,0,drop,66,66,0,1,0,1,0
55727,53,61818,53,allow,177,94,83,2,30,1,1
62692,443,51155,443,allow,14518,2409,12109,23,135,10,13
58345,123,37586,123,allow,184,94,90,2,30,1,1
26941,443,39877,443,allow,8466,3146,5320,30,20,15,15
56603,53,25992,53,allow,1400,97,1303,4,57,2,2
36943,10387,0,0,deny,159,159,0,1,0,1,0
60907,443,25513,443,allow,7477,3022,4455,27,45,15,12
9238,80,17779,80,allow,378,192,186,7,26,4,3
55733,51505,0,0,deny,66,66,0,1,0,1,0
64082,445,0,0,drop,66,66,0,1,0,1,0
55252,445,0,0,drop,70,70,0,1,0,1,0
55063,80,20796,80,allow,2776,1333,1443,12,37,7,5
54361,445,0,0,drop,70,70,0,1,0,1,0
57122,53,3566,53,allow,216,110,106,2,30,1,1
56328,36237,0,0,deny,66,66,0,1,0,1,0
54127,443,25652,443,allow,148422,10568,137854,223,115,114,109
49536,80,12566,80,allow,4544,3602,942,15,15,8,7
55626,63805,65310,63805,allow,70,70,0,2,8,2,0
26900,27017,11369,27017,allow,422,164,258,6,30,3,3
62149,445,0,0,drop,70,70,0,1,0,1,0
47424,25174,0,0,deny,66,66,0,1,0,1,0
49418,12345,11846,12345,allow,249,71,178,2,30,1,1
61945,445,0,0,drop,70,70,0,1,0,1,0
49871,445,0,0,drop,66,66,0,1,0,1,0
58294,445,0,0,drop,66,66,0,1,0,1,0
12128,37965,0,0,deny,62,62,0,1,0,1,0
56475,80,2240,80,allow,36057,2080,33977,45,134,19,26
37924,80,11096,80,allow,214,140,74,4,15,3,1
58638,5900,0,0,deny,62,62,0,1,0,1,0
49246,80,49246,80,allow,378,180,198,7,53,4,3
49484,443,58905,443,allow,407843,11895,395948,436,271,157,279
56577,445,0,0,drop,66,66,0,1,0,1,0
50648,80,55586,80,allow,132,132,0,2,8,2,0
13747,8887,13747,8887,deny,500,500,0,1,0,1,0
60617,64147,0,0,deny,62,62,0,1,0,1,0
58283,443,44449,443,allow,42792,12402,30390,98,370,45,53
64312,53,28741,53,allow,209,110,99,2,29,1,1
49727,443,62181,443,allow,1461,761,700,15,130,8,7
57341,53,40485,53,allow,296,97,199,4,41,2,2
42811,443,38598,443,allow,2766,1907,859,17,25,10,7
49916,53,53241,53,allow,118,118,0,1,30,1,0
50956,25174,0,0,deny,146,146,0,1,0,1,0
42862,443,59113,443,allow,10233,2198,8035,25,81,14,11
51898,50677,8224,50677,allow,70,70,0,1,5,1,0
63988,50584,0,0,deny,66,66,0,1,0,1,0
10438,23,0,0,deny,60,60,0,1,0,1,0
51446,3855,0,0,deny,100,100,0,1,0,1,0
33825,443,12586,443,allow,15400,12233,3167,75,995,38,37
56480,80,24972,80,allow,289731,8487,281244,294,136,104,190
65530,445,0,0,drop,66,66,0,1,0,1,0
52425,443,43475,443,allow,8454,978,7476,20,15,10,10
41346,30188,0,0,deny,62,62,0,1,0,1,0
42060,53,44916,53,allow,164,78,86,2,30,1,1
64116,53,45149,53,allow,267,94,173,4,59,2,2
60261,25174,0,0,deny,66,66,0,1,0,1,0
50730,445,0,0,drop,66,66,0,1,0,1,0
53201,443,51458,443,allow,3655,2344,1311,18,17,9,9
49438,443,56354,443,allow,13740,5392,8348,35,134,18,17
54197,443,1352,443,allow,499,425,74,4,0,3,1
41620,53,41620,53,allow,257,101,156,2,32,1,1
55636,443,29047,443,allow,13506,5979,7527,39,127,20,19
64527,53,58780,53,allow,228,102,126,2,30,1,1
64959,53,35711,53,allow,173,94,79,2,30,1,1
1687,25174,0,0,deny,146,146,0,1,0,1,0
50208,445,0,0,drop,66,66,0,1,0,1,0
56799,443,37236,443,allow,7511,2237,5274,17,16,9,8
55353,53,50744,53,allow,168,86,82,2,30,1,1
53931,445,0,0,drop,70,70,0,1,0,1,0
20624,53,20624,53,allow,229,89,140,2,31,1,1
64614,53,52648,53,allow,168,86,82,2,31,1,1
63053,445,0,0,drop,66,66,0,1,0,1,0
37567,443,40594,443,allow,149229,139639,9590,226,256,124,102
54461,445,0,0,drop,70,70,0,1,0,1,0
36873,80,37820,80,allow,1115,534,581,12,16,7,5
55600,53,6191,53,allow,209,110,99,2,29,1,1
50370,80,12726,80,allow,318,192,126,6,28,4,2
56019,53,28168,53,allow,194,102,92,2,31,1,1
58885,15000,9072,15000,allow,138,78,60,2,5,1,1
57810,445,0,0,drop,70,70,0,1,0,1,0
33543,44847,0,0,deny,62,62,0,1,0,1,0
60578,445,0,0,drop,70,70,0,1,0,1,0
55913,53,58939,53,allow,170,87,83,2,31,1,1
50200,44847,0,0,deny,70,70,0,1,0,1,0
49761,53,37619,53,allow,382,94,288,2,30,1,1
58638,5900,0,0,deny,62,62,0,1,0,1,0
38133,53,38133,53,allow,194,87,107,2,30,1,1
56772,53,47377,53,allow,168,86,82,2,30,1,1
27005,27016,63808,27016,allow,879,126,753,2,30,1,1
80,37649,0,0,deny,60,60,0,1,0,1,0
50433,53,63561,53,allow,193,102,91,2,29,1,1
55413,53,38303,53,allow,216,110,106,2,29,1,1
50226,80,13987,80,allow,1746,780,966,19,102,7,12
6881,34746,2559,34746,allow,484,150,334,2,1200,1,1
50801,445,0,0,drop,66,66,0,1,0,1,0
63248,445,0,0,drop,70,70,0,1,0,1,0
56333,53,40833,53,allow,209,110,99,2,30,1,1
56373,53,63287,53,allow,200,102,98,2,30,1,1
33098,443,57667,443,allow,6044,780,5264,16,66,8,8
54189,64147,0,0,deny,66,66,0,1,0,1,0
51658,80,20246,80,allow,44842,2446,42396,73,255,34,39
56041,53,17868,53,allow,179,94,85,2,31,1,1
49902,443,36938,443,allow,109400,8787,100613,159,81,78,81
56941,445,0,0,drop,70,70,0,1,0,1,0
61701,44847,0,0,deny,66,66,0,1,0,1,0
64311,53,4229,53,allow,199,102,97,2,29,1,1
56255,44847,0,0,deny,66,66,0,1,0,1,0
29313,48817,0,0,deny,145,145,0,1,0,1,0
35568,443,33534,443,allow,5383,3710,1673,27,309,14,13
60270,80,22290,80,allow,1528,946,582,11,149,6,5
58638,5900,0,0,deny,62,62,0,1,0,1,0
58787,443,18932,443,allow,5107,700,4407,15,15,7,8
44704,443,31142,443,allow,7228,3478,3750,37,164,17,20
56794,443,16368,443,allow,8073,2053,6020,20,15,11,9
56478,53,29572,53,allow,177,94,83,2,29,1,1
56939,53,41325,53,allow,216,110,106,2,31,1,1
64679,53,60915,53,allow,178,94,84,2,30,1,1
52227,445,0,0,drop,70,70,0,1,0,1,0
55009,53,51311,53,allow,241,78,163,2,30,1,1
56414,80,4969,80,allow,33712,928,32784,36,104,11,25
35824,443,2741,443,allow,7237,2204,5033,15,120,7,8
49683,443,27198,443,allow,11301,2219,9082,29,187,14,15
26900,27017,11967,27017,allow,422,164,258,6,30,3,3
57008,80,59299,80,allow,214,140,74,4,31,3,1
52169,59681,50827,59681,allow,70,70,0,2,8,2,0
6881,20326,20950,20326,allow,509,150,359,2,1200,1,1
62516,445,0,0,drop,70,70,0,1,0,1,0
9099,443,46908,443,allow,6677,1097,5580,21,25,11,10
56866,53,52471,53,allow,194,102,92,2,30,1,1
61467,445,0,0,drop,66,66,0,1,0,1,0
58000,80,21507,80,allow,48253,13664,34589,66,75,25,41
15345,36829,0,0,deny,66,66,0,1,0,1,0
50632,445,0,0,drop,70,70,0,1,0,1,0
50679,80,21512,80,allow,132,132,0,2,8,2,0
59328,445,0,0,drop,66,66,0,1,0,1,0
52682,22114,0,0,deny,66,66,0,1,0,1,0
56771,43648,21453,43648,allow,70,70,0,1,5,1,0
33324,42873,0,0,deny,62,62,0,1,0,1,0
63832,25174,0,0,deny,66,66,0,1,0,1,0
57272,443,35317,443,allow,6445,2145,4300,29,33,17,12
51426,443,3125,443,allow,15947,5526,10421,38,622,16,22
58638,5900,0,0,deny,62,62,0,1,0,1,0
50824,80,46115,80,allow,36051,11695,24356,109,265,55,54
64784,53,44632,53,allow,195,102,93,2,30,1,1
37612,443,15502,443,allow,499,425,74,4,0,3,1
65216,53,41251,53,allow,292,94,198,2,30,1,1
0,0,0,0,deny,156,156,0,2,0,2,0
49271,53,62549,53,allow,178,94,84,2,30,1,1
19697,26296,0,0,deny,159,159,0,1,0,1,0
56100,57470,0,0,deny,62,62,0,1,0,1,0
53275,21247,0,0,deny,66,66,0,1,0,1,0
53171,443,32050,443,allow,11080,4277,6803,23,42,10,13
60327,80,34206,80,allow,2125,1159,966,13,61,7,6
64793,53,59763,53,allow,168,86,82,2,31,1,1
32675,53,58212,53,allow,218,78,140,2,30,1,1
42298,40036,17125,40036,allow,141,79,62,2,30,1,1
24127,56205,0,0,deny,66,66,0,1,0,1,0
62546,443,43210,443,allow,7740,2603,5137,13,120,7,6
64907,53,3413,53,allow,168,86,82,2,30,1,1
56446,443,1598,443,allow,16401,10833,5568,32,362,18,14
53145,44634,36222,44634,allow,70,70,0,1,5,1,0
50863,80,47507,80,allow,5874,744,5130,14,131,7,7
39171,22114,0,0,deny,146,146,0,1,0,1,0
49450,443,1753,443,allow,2319947,69322,2250625,2464,70,870,1594
45315,443,19700,443,allow,56118,3429,52689,77,26,35,42
64587,53,63035,53,allow,167,86,81,2,30,1,1
55538,53,33092,53,allow,250,86,164,4,30,2,2
39943,80,39943,80,allow,424,198,226,7,142,4,3
62067,443,12137,443,allow,4833,2196,2637,13,120,7,6
32833,53,32833,53,allow,227,88,139,2,30,1,1
65499,445,0,0,drop,66,66,0,1,0,1,0
64619,53,54626,53,allow,174,89,85,2,31,1,1
57166,53,52593,53,allow,177,94,83,2,30,1,1
56878,53,49284,53,allow,168,86,82,2,31,1,1
1377,44847,0,0,deny,62,62,0,1,0,1,0
58638,5900,0,0,deny,62,62,0,1,0,1,0
62778,443,47503,443,allow,6676,2316,4360,34,318,16,18
35023,53,0,0,allow,82,82,0,2,40,2,0
55489,53,32012,53,allow,193,102,91,2,30,1,1
53398,445,0,0,drop,70,70,0,1,0,1,0
56368,443,23641,443,allow,3734,1750,1984,24,203,12,12
47561,26467,0,0,deny,62,62,0,1,0,1,0
53737,443,15661,443,allow,499,425,74,4,0,3,1
49260,80,56058,80,allow,2013987,64000,1949987,1818,160,504,1314
50320,53,19368,53,allow,754,94,660,2,29,1,1
49643,80,57400,80,allow,312,192,120,6,41,4,2
25207,48817,0,0,deny,62,62,0,1,0,1,0
54743,80,43064,80,allow,6453,1316,5137,16,315,9,7
45682,25604,0,0,deny,62,62,0,1,0,1,0
19175,50584,0,0,deny,146,146,0,1,0,1,0
45780,443,35080,443,allow,7847,1591,6256,23,186,13,10
9097,5228,6402,5228,allow,6138,1256,4882,22,58,11,11
38278,443,39999,443,allow,448,78,370,6,25,1,5
9335,443,4512,443,allow,674,128,546,12,45,3,9
62796,37807,0,0,deny,66,66,0,1,0,1,0
64222,53,1206,53,allow,264,94,170,2,30,1,1
60446,6882,2486,6882,allow,70,70,0,2,8,2,0
52051,29868,57987,29868,allow,70,70,0,1,4,1,0
56344,53,55607,53,allow,167,86,81,2,30,1,1
54276,39004,0,0,deny,66,66,0,1,0,1,0
55205,53,45357,53,allow,167,86,81,2,29,1,1
56340,53,14544,53,allow,196,100,96,2,31,1,1
57418,443,57418,443,allow,4736,1759,2977,20,26,11,9
53750,25174,0,0,deny,62,62,0,1,0,1,0
38621,443,27614,443,allow,1593,946,647,15,64,8,7
51221,19072,17591,19072,allow,330,330,0,6,1200,6,0
60247,445,0,0,drop,70,70,0,1,0,1,0
30114,65151,0,0,deny,60,60,0,1,0,1,0
50545,443,51366,443,allow,9654,1771,7883,27,186,14,13
57091,445,0,0,drop,66,66,0,1,0,1,0
52239,443,55922,443,allow,6564,3283,3281,19,140,10,9
49815,53,18819,53,allow,212,102,110,2,29,1,1
3478,61463,0,0,deny,164,164,0,1,0,1,0
55153,53,36786,53,allow,733,94,639,2,30,1,1
49474,443,32026,443,allow,10315,2018,8297,24,158,12,12
56771,53,2287,53,allow,270,95,175,4,60,2,2
6881,6881,0,0,deny,146,146,0,1,0,1,0
55000,5222,35744,5222,allow,32608,22014,10594,225,215,124,101
60858,443,17492,443,allow,64658,47775,16883,115,16,63,52
64213,53,34758,53,allow,342,105,237,4,53,2,2
56682,443,61779,443,allow,8654,2150,6504,20,15,11,9
56218,43890,0,0,deny,66,66,0,1,0,1,0
51332,445,0,0,drop,70,70,0,1,0,1,0
64762,53,20987,53,allow,194,102,92,2,31,1,1
53314,443,30512,443,allow,12053,6627,5426,47,1043,26,21
65354,53,35359,53,allow,272,94,178,2,31,1,1
55305,53,52264,53,allow,1448,103,1345,4,54,2,2
55941,53,18127,53,allow,184,94,90,2,30,1,1
49994,443,12654,443,allow,378,82,296,5,17,1,4
50778,445,0,0,drop,70,70,0,1,0,1,0
48817,16156,48817,16156,allow,513,152,361,2,1200,1,1
30960,45758,64660,45758,allow,462,462,0,8,3632,8,0
61571,445,0,0,drop,70,70,0,1,0,1,0
14567,37965,0,0,deny,62,62,0,1,0,1,0
58638,5900,0,0,deny,62,62,0,1,0,1,0
55920,25174,0,0,deny,146,146,0,1,0,1,0
41627,15000,9881,15000,allow,130,70,60,2,5,1,1
39326,53,39326,53,allow,233,90,143,2,32,1,1
55802,445,0,0,drop,70,70,0,1,0,1,0
51527,445,0,0,drop,70,70,0,1,0,1,0
50076,445,0,0,drop,70,70,0,1,0,1,0
9417,443,16764,443,allow,324745,7830,316915,327,31,112,215
64430,53,25685,53,allow,245,118,127,2,30,1,1
56953,443,23008,443,allow,66324,17448,48876,86,331,39,47
23514,53,23514,53,allow,245,98,147,2,30,1,1
63462,445,0,0,drop,70,70,0,1,0,1,0
57985,445,0,0,drop,66,66,0,1,0,1,0
65343,53,12324,53,allow,194,99,95,2,30,1,1
62332,53,0,0,allow,170,75,95,2,29,1,1
55115,53,46461,53,allow,313,110,203,4,35,2,2
55786,53,13962,53,allow,193,102,91,2,30,1,1
62044,445,0,0,drop,66,66,0,1,0,1,0
65036,53,4183,53,allow,199,102,97,2,30,1,1
62150,445,0,0,drop,70,70,0,1,0,1,0
57292,53,58837,53,allow,395,102,293,2,30,1,1
55759,53,49971,53,allow,177,94,83,2,30,1,1
41247,80,40368,80,allow,78,78,0,1,5,1,0
35913,443,5129,443,allow,14329,8250,6079,26,22,16,10
55417,53,60973,53,allow,198,102,96,2,30,1,1
56876,11392,0,0,deny,66,66,0,1,0,1,0
41487,443,27679,443,allow,7112,5916,1196,20,30,10,10
55442,53,42681,53,allow,177,94,83,2,30,1,1
52143,37807,0,0,deny,62,62,0,1,0,1,0
51438,443,45079,443,allow,42419,28515,13904,108,246,53,55
58925,25174,0,0,deny,66,66,0,1,0,1,0
60472,20273,4062,20273,allow,70,70,0,1,5,1,0
56594,53,16703,53,allow,167,86,81,2,30,1,1
56464,53,58795,53,allow,177,94,83,2,30,1,1
7210,22114,0,0,deny,62,62,0,1,0,1,0
53597,42845,3911,42845,allow,678,492,186,10,18,7,3
56492,53,1811,53,allow,94,94,0,1,30,1,0
47521,53,9404,53,allow,198,93,105,2,30,1,1
63712,21917,18745,21917,allow,504,382,122,8,15,6,2
49312,53,27461,53,allow,772,102,670,2,30,1,1
61430,37965,0,0,deny,66,66,0,1,0,1,0
64424,445,0,0,drop,66,66,0,1,0,1,0
65428,53,15132,53,allow,195,102,93,2,29,1,1
39396,443,4891,443,allow,7531,2720,4811,24,331,13,11
50786,445,0,0,drop,70,70,0,1,0,1,0
37647,36237,0,0,deny,66,66,0,1,0,1,0
49828,53,44800,53,allow,733,86,647,2,29,1,1
22636,30188,0,0,deny,66,66,0,1,0,1,0
53713,443,10339,443,allow,33323,3349,29974,45,123,18,27
51819,59208,18687,59208,allow,66,66,0,2,8,2,0
64913,53,34114,53,allow,211,102,109,2,30,1,1
50265,24387,12796,24387,allow,132,132,0,3,1200,3,0
53128,29593,52824,29593,allow,70,70,0,1,4,1,0
41269,443,34077,443,allow,234,234,0,4,12,4,0
57987,56125,0,0,deny,90,90,0,1,0,1,0
50684,80,50889,80,allow,1658,1247,411,8,15,5,3
54780,445,0,0,drop,66,66,0,1,0,1,0
51892,46647,34851,46647,allow,70,70,0,2,8,2,0
41640,8080,50397,8080,allow,78,78,0,2,8,2,0
42665,443,42665,443,allow,4620,1713,2907,19,26,11,8
38329,80,52994,80,allow,350,210,140,6,16,4,2
50481,445,0,0,drop,70,70,0,1,0,1,0
60856,445,0,0,drop,70,70,0,1,0,1,0
50449,443,5504,443,allow,7588,1850,5738,19,25,10,9
44881,53,62824,53,allow,212,78,134,2,30,1,1
14409,7363,0,0,deny,145,145,0,1,0,1,0
50354,80,47927,80,allow,306,180,126,6,25,4,2
32679,37965,0,0,deny,62,62,0,1,0,1,0
60192,35440,0,0,deny,146,146,0,1,0,1,0
51121,445,0,0,drop,66,66,0,1,0,1,0
64820,53,13245,53,allow,190,97,93,2,31,1,1
54774,443,8128,443,allow,9501,1502,7999,24,29,13,11
56095,445,0,0,drop,70,70,0,1,0,1,0
55462,53,13103,53,allow,188,96,92,2,30,1,1
64143,53,9554,53,allow,174,89,85,2,31,1,1
52329,53,12571,53,allow,294,86,208,2,30,1,1
51111,80,36793,80,allow,1614,1300,314,10,15,5,5
64031,445,0,0,drop,70,70,0,1,0,1,0
51866,22114,0,0,deny,66,66,0,1,0,1,0
51758,31009,36831,31009,allow,70,70,0,2,8,2,0
59075,445,0,0,drop,70,70,0,1,0,1,0
58822,443,37574,443,allow,5166,700,4466,16,15,7,9
51177,443,18641,443,allow,154,94,60,2,4,1,1
53559,58968,7595,58968,allow,70,70,0,2,7,2,0
65049,53,13947,53,allow,199,102,97,2,29,1,1
63984,25174,0,0,deny,146,146,0,1,0,1,0
38400,51505,0,0,deny,146,146,0,1,0,1,0
60451,17432,27417,17432,allow,504,318,186,8,17,5,3
49270,53,27956,53,allow,216,110,106,2,31,1,1
49603,80,3315,80,allow,378,192,186,7,41,4,3
57964,445,0,0,drop,70,70,0,1,0,1,0
56987,53,64863,53,allow,196,102,94,2,30,1,1
56912,53,3525,53,allow,199,102,97,2,30,1,1
53995,41985,42236,41985,allow,70,70,0,2,7,2,0
51726,64147,0,0,deny,62,62,0,1,0,1,0
58725,443,21181,443,allow,26960,13206,13754,53,17,28,25
43830,443,46012,443,allow,2257,461,1796,9,39,4,5
64567,53,19362,53,allow,199,102,97,2,30,1,1
9192,443,26579,443,allow,318,192,126,6,22,4,2
33314,44847,0,0,deny,62,62,0,1,0,1,0
49633,443,51430,443,allow,4348,911,3437,14,135,8,6
56723,53,2628,53,allow,733,85,648,2,31,1,1
443,21255,0,0,deny,66,66,0,1,0,1,0
47652,51505,0,0,deny,62,62,0,1,0,1,0
59871,445,0,0,drop,70,70,0,1,0,1,0
42252,33303,0,0,deny,60,60,0,1,0,1,0
57278,445,0,0,drop,70,70,0,1,0,1,0
53215,443,56280,443,allow,6983,1629,5354,17,15,9,8
57030,53,10715,53,allow,749,94,655,2,30,1,1
57350,53,14841,53,allow,177,94,83,2,30,1,1
49696,443,49696,443,allow,4871,1623,3248,18,137,8,10
54779,445,0,0,drop,70,70,0,1,0,1,0
64124,53,4238,53,allow,183,94,89,2,30,1,1
60393,46347,14352,46347,allow,320,140,180,6,7,3,3
54711,445,0,0,drop,66,66,0,1,0,1,0
443,39711,0,0,deny,74,74,0,1,0,1,0
50765,22114,0,0,deny,62,62,0,1,0,1,0
64596,445,0,0,drop,70,70,0,1,0,1,0
45964,2666,0,0,deny,60,60,0,1,0,1,0
55927,53,41588,53,allow,720,94,626,2,29,1,1
24073,22114,0,0,deny,62,62,0,1,0,1,0
3981,23117,0,0,deny,66,66,0,1,0,1,0
6666,138,0,0,deny,60,60,0,1,0,1,0
55656,53,20503,53,allow,760,96,664,2,30,1,1
62337,44847,0,0,deny,62,62,0,1,0,1,0
64915,53,41416,53,allow,177,94,83,2,31,1,1
63969,57635,11400,57635,allow,504,382,122,8,17,6,2
56993,53,24692,53,allow,184,102,82,2,29,1,1
57202,53,28601,53,allow,184,94,90,2,30,1,1
49332,53,38516,53,allow,281,98,183,4,57,2,2
33640,53,0,0,allow,138,69,69,2,30,1,1
55990,53,28837,53,allow,183,94,89,2,30,1,1
57884,445,0,0,drop,70,70,0,1,0,1,0
62400,35993,0,0,deny,66,66,0,1,0,1,0
56773,445,0,0,drop,66,66,0,1,0,1,0
49677,25174,0,0,deny,62,62,0,1,0,1,0
50085,80,41165,80,allow,5514,2362,3152,37,469,19,18
55152,53,27991,53,allow,176,90,86,2,30,1,1
49203,445,0,0,drop,66,66,0,1,0,1,0
51486,4545,51486,4545,allow,156,156,0,3,8,3,0
52520,443,9446,443,allow,4463,1215,3248,16,121,8,8
53692,53,53692,53,allow,262,82,180,2,29,1,1
35052,80,38624,80,allow,350,210,140,6,30,4,2
65085,22114,0,0,deny,62,62,0,1,0,1,0
39762,443,10128,443,allow,9264,2848,6416,31,100,16,15
57354,53,4539,53,allow,177,94,83,2,30,1,1
27005,27015,38295,27015,allow,874,126,748,2,30,1,1
56035,1310,0,0,deny,66,66,0,1,0,1,0
37965,58909,50714,58909,allow,1577,594,983,20,1724,10,10
22948,26467,0,0,deny,62,62,0,1,0,1,0
46986,443,11457,443,allow,2809,1884,925,19,27,11,8
51881,445,0,0,drop,66,66,0,1,0,1,0
64921,445,0,0,drop,70,70,0,1,0,1,0
57478,445,0,0,drop,66,66,0,1,0,1,0
61459,80,3928,80,allow,4671,2593,2078,15,85,9,6
49742,53,40944,53,allow,790,110,680,2,30,1,1
23332,80,23332,80,allow,490,264,226,8,26,5,3
49418,27015,44388,27015,allow,71,71,0,1,30,1,0
53318,445,0,0,drop,70,70,0,1,0,1,0
49674,443,62205,443,allow,8656,2060,6596,20,57,10,10
22419,1433,22419,1433,allow,146,60,86,2,9,1,1
54967,445,0,0,drop,70,70,0,1,0,1,0
40970,80,47105,80,allow,1052,612,440,10,15,5,5
54219,443,4743,443,allow,10323,2834,7489,44,256,21,23
49805,443,42807,443,allow,2839,1654,1185,15,126,9,6
63962,53,52393,53,allow,483,189,294,6,85,3,3
55816,53,14968,53,allow,214,110,104,2,29,1,1
52046,59791,21148,59791,allow,70,70,0,1,4,1,0
65420,53,28650,53,allow,166,86,80,2,31,1,1
58715,57470,0,0,deny,62,62,0,1,0,1,0
64762,53,23924,53,allow,200,94,106,2,30,1,1
43584,24748,0,0,deny,156,156,0,1,0,1,0
50907,445,0,0,drop,66,66,0,1,0,1,0
64440,53,9584,53,allow,270,110,160,2,30,1,1
59397,445,0,0,drop,70,70,0,1,0,1,0
61630,445,0,0,drop,70,70,0,1,0,1,0
55600,443,16865,443,allow,11891,2141,9750,40,231,19,21
54712,443,60548,443,allow,5158,2609,2549,11,121,6,5
56617,80,63909,80,allow,234,234,0,4,12,4,0
0,0,0,0,allow,320,320,0,5,0,5,0
52010,80,42870,80,allow,29838,2481,27357,56,31,24,32
58876,80,60067,80,allow,32098,2435,29663,47,75,24,23
40834,50584,0,0,deny,62,62,0,1,0,1,0
63583,37965,0,0,deny,62,62,0,1,0,1,0
34158,53,34158,53,allow,217,87,130,2,30,1,1
58638,5900,0,0,deny,62,62,0,1,0,1,0
63554,44847,0,0,deny,62,62,0,1,0,1,0
65206,443,20256,443,allow,7525,3267,4258,36,120,17,19
51810,33776,47745,33776,allow,66,66,0,1,5,1,0
38647,443,59827,443,allow,2634,1411,1223,18,28,10,8
59505,53733,0,0,deny,62,62,0,1,0,1,0
11030,37965,0,0,deny,62,62,0,1,0,1,0
59523,37965,0,0,deny,62,62,0,1,0,1,0
47245,443,62935,443,allow,1989,1183,806,16,94,9,7
10461,53,10461,53,allow,220,90,130,2,30,1,1
59336,80,59336,80,allow,24437,12718,11719,41,15,16,25
50917,445,0,0,drop,70,70,0,1,0,1,0
64561,53,17308,53,allow,461,91,370,4,60,2,2
49162,53,61794,53,allow,371,94,277,2,29,1,1
49999,445,0,0,drop,66,66,0,1,0,1,0
57189,53,57433,53,allow,174,89,85,2,30,1,1
8999,42873,0,0,deny,146,146,0,1,0,1,0
49918,443,5366,443,allow,3291,1714,1577,18,16,11,7
35596,5228,54963,5228,allow,3235,1448,1787,26,811,8,18
50426,53,23864,53,allow,760,97,663,2,30,1,1
18652,64147,0,0,deny,62,62,0,1,0,1,0
42600,443,64399,443,allow,3137,1986,1151,15,15,8,7
55857,53,27164,53,allow,192,98,94,2,30,1,1
9469,80,38587,80,allow,1641,483,1158,10,15,5,5
36276,7000,36276,7000,allow,3638,2027,1611,17,15,9,8
47163,53,47163,53,allow,825,99,726,2,31,1,1
56395,53,7674,53,allow,177,94,83,2,30,1,1
26239,25174,0,0,deny,66,66,0,1,0,1,0
39981,57470,0,0,deny,62,62,0,1,0,1,0
29177,44847,0,0,deny,66,66,0,1,0,1,0
52093,80,7625,80,allow,3019,716,2303,12,23,7,5
28999,37807,0,0,deny,146,146,0,1,0,1,0
58638,5900,0,0,deny,62,62,0,1,0,1,0
41631,123,31654,123,allow,184,94,90,2,30,1,1
44314,443,36123,443,allow,1268867,60489,1208378,1558,141,557,1001
45535,25174,0,0,deny,66,66,0,1,0,1,0
57850,445,0,0,drop,70,70,0,1,0,1,0
56881,445,0,0,drop,70,70,0,1,0,1,0
56458,445,0,0,drop,70,70,0,1,0,1,0
1024,57470,0,0,deny,62,62,0,1,0,1,0
62937,80,62937,80,allow,1918,1469,449,10,20,6,4
46149,23,0,0,deny,60,60,0,1,0,1,0
49591,53,21458,53,allow,86,86,0,1,29,1,0
64569,445,0,0,drop,70,70,0,1,0,1,0
32806,7275,35238,7275,allow,130,70,60,2,15,1,1
63152,445,0,0,drop,70,70,0,1,0,1,0
57131,7774,0,0,deny,145,145,0,1,0,1,0
49418,27015,20814,27015,allow,249,78,171,2,30,1,1
42993,443,4203,443,allow,7821,3237,4584,39,149,19,20
64573,53,37433,53,allow,757,102,655,2,30,1,1
52615,445,0,0,drop,66,66,0,1,0,1,0
58247,57866,0,0,deny,66,66,0,1,0,1,0
56635,443,56247,443,allow,8654,2150,6504,20,15,11,9
63959,445,0,0,drop,66,66,0,1,0,1,0
59732,27036,24754,27036,allow,1218,924,294,6,30,3,3
58481,15503,0,0,deny,146,146,0,1,0,1,0
49762,53,56822,53,allow,184,94,90,2,31,1,1
64958,53,60361,53,allow,197,102,95,2,30,1,1
59060,50584,0,0,deny,62,62,0,1,0,1,0
50872,445,0,0,drop,70,70,0,1,0,1,0
43693,53,25103,53,allow,164,78,86,2,30,1,1
56366,443,31914,443,allow,3715,1791,1924,23,203,12,11
49952,80,46004,80,allow,4023,620,3403,14,15,7,7
58745,443,47699,443,allow,14654,9694,4960,36,17,19,17
23150,53,23150,53,allow,365,233,132,3,32,2,1
61072,53,60652,53,allow,1139,878,261,2,30,1,1
49613,445,0,0,drop,66,66,0,1,0,1,0
36258,23,0,0,deny,60,60,0,1,0,1,0
65440,53,38806,53,allow,240,86,154,2,29,1,1
56706,445,0,0,drop,70,70,0,1,0,1,0
56415,53,6950,53,allow,179,94,85,2,30,1,1
50665,445,0,0,drop,66,66,0,1,0,1,0
38346,80,22623,80,allow,1818,1504,314,13,16,8,5
51140,443,48264,443,allow,5759,1904,3855,19,15,11,8
63583,443,3577,443,allow,7339,2638,4701,33,167,18,15
55503,53,6618,53,allow,216,110,106,2,29,1,1
52007,37732,20807,37732,allow,70,70,0,1,4,1,0
41490,25174,0,0,deny,62,62,0,1,0,1,0
49628,53,6846,53,allow,168,86,82,2,31,1,1
64306,53,23219,53,allow,216,110,106,2,30,1,1
55130,53,35650,53,allow,216,110,106,2,30,1,1
52117,20600,30733,20600,allow,70,70,0,2,8,2,0
61462,443,27750,443,allow,6271,1191,5080,24,94,14,10
58754,443,12477,443,allow,7674,4959,2715,24,16,13,11
55042,53,54765,53,allow,782,105,677,2,30,1,1
64790,53,64538,53,allow,779,86,693,2,30,1,1
62717,445,0,0,drop,70,70,0,1,0,1,0
58298,445,0,0,drop,70,70,0,1,0,1,0
60432,445,0,0,drop,66,66,0,1,0,1,0
57027,53,33808,53,allow,177,94,83,2,30,1,1
64190,445,0,0,drop,66,66,0,1,0,1,0
50470,61463,0,0,deny,86,86,0,1,0,1,0
58012,53,0,0,allow,82,82,0,1,30,1,0
57115,53,47701,53,allow,172,88,84,2,30,1,1
56681,443,64351,443,allow,19154,11130,8024,40,102,24,16
42841,53,47596,53,allow,168,78,90,2,30,1,1
65441,445,0,0,drop,70,70,0,1,0,1,0
59887,445,0,0,drop,70,70,0,1,0,1,0
56996,53,54322,53,allow,177,94,83,2,30,1,1
55142,26467,0,0,deny,62,62,0,1,0,1,0
55644,445,0,0,drop,70,70,0,1,0,1,0
53199,443,19271,443,allow,1582,965,617,15,18,7,8
49297,53,44299,53,allow,183,94,89,2,30,1,1
55032,443,43927,443,allow,12704,3182,9522,35,49,16,19
58701,445,0,0,drop,66,66,0,1,0,1,0
50587,80,50587,80,allow,1711,1011,700,11,21,6,5
51823,80,56758,80,allow,4456,1889,2567,11,39,6,5
27005,32056,54567,32056,allow,886,126,760,2,31,1,1
49302,443,38802,443,allow,9232,3149,6083,55,40,31,24
55201,22114,0,0,deny,66,66,0,1,0,1,0
57832,443,1165,443,allow,91134,7506,83628,132,130,52,80
37487,25174,0,0,deny,66,66,0,1,0,1,0
64343,6004,0,0,deny,66,66,0,1,0,1,0
55163,53,9459,53,allow,197,102,95,2,30,1,1
1026,64147,0,0,deny,62,62,0,1,0,1,0
64642,445,0,0,drop,70,70,0,1,0,1,0
31235,22114,0,0,deny,62,62,0,1,0,1,0
49749,80,64733,80,allow,230959,4381,226578,217,91,60,157
61503,445,0,0,drop,70,70,0,1,0,1,0
4427,50584,0,0,deny,62,62,0,1,0,1,0
52881,443,3297,443,allow,130,70,60,2,15,1,1
26092,23,0,0,deny,60,60,0,1,0,1,0
58519,445,0,0,drop,70,70,0,1,0,1,0
16387,29288,0,0,allow,60,60,0,1,61,1,0
58638,5900,0,0,deny,62,62,0,1,0,1,0
56799,53,3973,53,allow,353,94,259,2,30,1,1
60599,445,0,0,drop,70,70,0,1,0,1,0
53799,3478,23545,3478,allow,3736,1944,1792,58,91,29,29
51762,12747,44025,12747,allow,70,70,0,2,8,2,0
55141,53,55990,53,allow,184,94,90,2,30,1,1
64114,53,0,0,allow,200,90,110,2,30,1,1
27005,30006,32139,30006,allow,890,126,764,3,31,2,1
54808,443,25043,443,allow,9657,1944,7713,31,82,15,16
3478,61463,0,0,deny,1290,1290,0,1,0,1,0
52165,49740,12957,49740,allow,70,70,0,1,5,1,0
53985,30188,0,0,deny,66,66,0,1,0,1,0
47450,443,22297,443,allow,162,102,60,2,5,1,1
64599,53,12199,53,allow,767,102,665,2,30,1,1
25961,55783,0,0,deny,60,60,0,1,0,1,0
49255,7000,49255,7000,allow,2163,676,1487,14,14,7,7
51898,80,53700,80,allow,366,240,126,7,28,5,2
56763,443,10844,443,allow,8058,2038,6020,20,15,11,9
6666,16010,0,0,deny,60,60,0,1,0,1,0
64404,445,0,0,drop,66,66,0,1,0,1,0
57322,445,0,0,drop,70,70,0,1,0,1,0
2849,30188,0,0,deny,66,66,0,1,0,1,0
49834,443,28335,443,allow,9890,4516,5374,26,124,14,12
21420,44847,0,0,deny,66,66,0,1,0,1,0
64565,443,57848,443,allow,24984,2042,22942,41,33,19,22
46455,53,32632,53,allow,168,78,90,2,30,1,1
64596,53,15356,53,allow,215,86,129,2,30,1,1
64322,53,52794,53,allow,250,94,156,2,30,1,1
60558,445,0,0,drop,70,70,0,1,0,1,0
62295,443,30041,443,allow,3538,2015,1523,28,325,14,14
58638,5900,0,0,deny,62,62,0,1,0,1,0
50495,53,24606,53,allow,182,102,80,2,30,1,1
50624,50584,0,0,deny,66,66,0,1,0,1,0
55393,44512,0,0,deny,66,66,0,1,0,1,0
49393,445,0,0,drop,66,66,0,1,0,1,0
64516,53,41634,53,allow,216,110,106,2,30,1,1
49255,53,62654,53,allow,212,102,110,2,30,1,1
64567,445,0,0,drop,70,70,0,1,0,1,0
57020,36237,0,0,deny,62,62,0,1,0,1,0
46518,44847,0,0,deny,146,146,0,1,0,1,0
55900,53,13889,53,allow,194,102,92,2,30,1,1
64261,445,0,0,drop,70,70,0,1,0,1,0
50393,8080,50393,8080,allow,378,180,198,7,31,4,3
49652,445,0,0,drop,66,66,0,1,0,1,0
59563,56205,0,0,deny,66,66,0,1,0,1,0
57711,445,0,0,drop,70,70,0,1,0,1,0
50436,445,0,0,drop,66,66,0,1,0,1,0
53101,443,16538,443,allow,27964,15805,12159,204,904,120,84
57117,445,0,0,drop,70,70,0,1,0,1,0
52133,443,32677,443,allow,7601,1919,5682,24,76,13,11
64378,53,28947,53,allow,273,94,179,2,30,1,1
53604,1046,44060,1046,allow,320,140,180,6,5,3,3
56655,53,28955,53,allow,168,86,82,2,29,1,1
48882,443,39008,443,allow,8105,1902,6203,24,26,14,10
53245,443,26528,443,allow,7705,2005,5700,26,120,13,13
48706,23393,0,0,deny,60,60,0,1,0,1,0
22948,26467,0,0,deny,62,62,0,1,0,1,0
36881,56205,0,0,deny,62,62,0,1,0,1,0
50290,445,0,0,drop,66,66,0,1,0,1,0
60335,445,0,0,drop,66,66,0,1,0,1,0
51993,55279,27826,55279,allow,316,136,180,6,7,3,3
51548,80,33223,80,allow,1654,1340,314,11,15,6,5
63369,445,0,0,drop,70,70,0,1,0,1,0
60480,443,16166,443,allow,6511,2810,3701,34,3665,12,22
53862,36120,51667,36120,allow,2254,1281,973,17,17,10,7
39785,53,39785,53,allow,229,98,131,2,30,1,1
49989,53,26196,53,allow,346,111,235,2,30,1,1
50467,80,50467,80,allow,886702,38812,847890,1134,23,558,576
63234,445,0,0,drop,70,70,0,1,0,1,0
62725,445,0,0,drop,70,70,0,1,0,1,0
43026,443,33561,443,allow,138,78,60,2,4,1,1
64946,53,40387,53,allow,202,95,107,2,31,1,1
50478,51505,0,0,deny,66,66,0,1,0,1,0
53010,445,0,0,drop,66,66,0,1,0,1,0
50503,443,44653,443,allow,9295,3094,6201,24,82,12,12
14441,443,20256,443,allow,2629,1470,1159,18,15,8,10
54709,443,26640,443,allow,5493,933,4560,18,41,9,9
65060,445,0,0,drop,70,70,0,1,0,1,0
42186,443,43705,443,allow,10165,2433,7732,19,49,10,9
49461,53,60884,53,allow,314,102,212,2,30,1,1
52205,5222,24221,5222,allow,684,280,404,11,26,5,6
64082,43786,41878,43786,allow,504,382,122,8,14,6,2
57396,53,65107,53,allow,183,94,89,2,30,1,1
61522,445,0,0,drop,70,70,0,1,0,1,0
10037,443,24188,443,allow,6061,1884,4177,27,16,15,12
57478,7302,0,0,deny,62,62,0,1,0,1,0
57356,53,7268,53,allow,199,102,97,2,29,1,1
62183,57470,0,0,deny,74,74,0,1,0,1,0
65262,53,52236,53,allow,216,110,106,2,30,1,1
45457,443,33286,443,allow,11989,7908,4081,61,120,31,30
55386,53,14835,53,allow,199,102,97,2,30,1,1
62521,445,0,0,drop,70,70,0,1,0,1,0
60897,443,29377,443,allow,10706,1679,9027,27,46,15,12
52710,443,22445,443,allow,203346,21619,181727,301,376,140,161
52352,445,0,0,drop,70,70,0,1,0,1,0
27005,27015,41826,27015,allow,868,126,742,2,30,1,1
64493,53,5722,53,allow,353,101,252,4,54,2,2
1739,80,1739,80,allow,198357,5070,193287,197,95,63,134
49921,443,56889,443,allow,11831,1466,10365,24,135,11,13
57323,53,18058,53,allow,188,96,92,2,31,1,1
63679,443,51267,443,allow,7987,2092,5895,18,119,8,10
55504,445,0,0,drop,70,70,0,1,0,1,0
53447,445,0,0,drop,66,66,0,1,0,1,0
60026,445,0,0,drop,70,70,0,1,0,1,0
51985,38904,1159,38904,allow,70,70,0,1,5,1,0
64912,53,12678,53,allow,182,93,89,2,31,1,1
57470,6889,39885,6889,allow,507,163,344,2,1200,1,1
50641,53,60493,53,allow,760,97,663,2,30,1,1
55675,53,24009,53,allow,195,102,93,2,30,1,1
9997,53,9997,53,allow,235,90,145,2,32,1,1
49996,80,14871,80,allow,3007,604,2403,11,15,6,5
46090,50584,0,0,deny,66,66,0,1,0,1,0
52420,445,0,0,drop,70,70,0,1,0,1,0
58342,445,0,0,drop,70,70,0,1,0,1,0
27005,27017,24115,27017,allow,880,126,754,2,30,1,1
54981,443,51323,443,allow,36008,2548,33460,55,69,26,29
62384,445,0,0,drop,70,70,0,1,0,1,0
10547,57470,0,0,deny,62,62,0,1,0,1,0
50505,80,62173,80,allow,318,192,126,6,25,4,2
29706,50584,0,0,deny,62,62,0,1,0,1,0
56965,53,39310,53,allow,183,94,89,2,30,1,1
18950,50584,0,0,deny,146,146,0,1,0,1,0
64073,445,0,0,drop,70,70,0,1,0,1,0
60247,80,40412,80,allow,21505,6581,14924,31,149,14,17
60443,50284,16097,50284,allow,258,70,188,4,8,2,2
55859,53,0,0,allow,82,82,0,1,30,1,0
61705,80,47319,80,allow,134,60,74,3,11,2,1
27076,80,27076,80,allow,6337,947,5390,15,17,8,7
55469,53,31769,53,allow,193,102,91,2,30,1,1
42298,40010,33875,40010,allow,148,86,62,2,31,1,1
52266,445,0,0,drop,70,70,0,1,0,1,0
57326,53,28871,53,allow,90,90,0,1,30,1,0
58624,445,0,0,drop,70,70,0,1,0,1,0
64913,53,26175,53,allow,555,195,360,6,62,3,3
59147,25174,0,0,deny,146,146,0,1,0,1,0
55313,53,17189,53,allow,198,94,104,2,29,1,1
51244,42416,0,0,deny,100,100,0,1,0,1,0
51902,443,16953,443,allow,6155,888,5267,17,15,8,9
14397,37965,0,0,deny,62,62,0,1,0,1,0
50120,443,54666,443,allow,29503,9695,19808,55,34,30,25
50086,57470,0,0,deny,66,66,0,1,0,1,0
55205,53,56363,53,allow,167,86,81,2,30,1,1
49862,445,0,0,drop,66,66,0,1,0,1,0
50479,443,34516,443,allow,5491,2608,2883,17,122,8,9
61773,445,0,0,drop,66,66,0,1,0,1,0
45551,443,60203,443,allow,6964,2091,4873,20,15,10,10
50667,445,0,0,drop,66,66,0,1,0,1,0
55919,53,57611,53,allow,754,94,660,2,31,1,1
55380,53,60904,53,allow,289,97,192,4,45,2,2
62253,445,0,0,drop,66,66,0,1,0,1,0
50615,443,36645,443,allow,1577,949,628,16,71,9,7
58343,445,0,0,drop,70,70,0,1,0,1,0
62957,445,0,0,drop,70,70,0,1,0,1,0
53726,445,0,0,drop,70,70,0,1,0,1,0
65245,53,31425,53,allow,184,102,82,2,30,1,1
64444,445,0,0,drop,70,70,0,1,0,1,0
49418,27020,23482,27020,allow,248,78,170,2,30,1,1
55471,53,27819,53,allow,256,93,163,2,30,1,1
55666,36653,34073,36653,allow,70,70,0,1,5,1,0
55043,57470,0,0,deny,78,78,0,1,0,1,0
52711,445,0,0,drop,70,70,0,1,0,1,0
63331,51221,0,0,deny,62,62,0,1,0,1,0
51558,37965,0,0,deny,72,72,0,1,0,1,0
65078,445,0,0,drop,66,66,0,1,0,1,0
56226,53,58477,53,allow,780,104,676,2,31,1,1
50712,445,0,0,drop,70,70,0,1,0,1,0
28221,37965,0,0,deny,62,62,0,1,0,1,0
3478,61463,0,0,deny,437,437,0,1,0,1,0
55591,53,62499,53,allow,195,102,93,2,31,1,1
63075,445,0,0,drop,70,70,0,1,0,1,0
60241,445,0,0,drop,70,70,0,1,0,1,0
65075,53,31161,53,allow,293,94,199,2,29,1,1
56688,53,38230,53,allow,192,98,94,2,30,1,1
50684,80,15318,80,allow,62,62,0,1,5,1,0
51320,44847,0,0,deny,66,66,0,1,0,1,0
64449,30188,0,0,deny,66,66,0,1,0,1,0
57297,51221,0,0,deny,66,66,0,1,0,1,0
50540,443,25941,443,allow,134507,6585,127922,148,121,51,97
62760,445,0,0,drop,70,70,0,1,0,1,0
45891,443,41811,443,allow,5718,1527,4191,24,22,13,11
0,0,0,0,allow,2000,1020,980,20,0,10,10
56932,53,43209,53,allow,172,94,78,2,29,1,1
57202,443,8164,443,allow,1728,1153,575,12,28,7,5
52479,443,9730,443,allow,11052,4417,6635,19,137,10,9
52344,445,0,0,drop,70,70,0,1,0,1,0
53546,17203,56777,17203,allow,320,140,180,6,7,3,3
63779,26467,0,0,deny,62,62,0,1,0,1,0
39056,22114,0,0,deny,62,62,0,1,0,1,0
57620,443,56080,443,allow,5177,3010,2167,37,83,17,20
55518,445,0,0,drop,70,70,0,1,0,1,0
64460,445,0,0,drop,70,70,0,1,0,1,0
16387,26193,0,0,deny,60,60,0,1,0,1,0
56251,80,56251,80,allow,101529,1646,99883,94,15,24,70
37965,39108,36972,39108,allow,1056,1056,0,17,1550,17,0
54970,445,0,0,drop,66,66,0,1,0,1,0
49230,443,49230,443,allow,123041,10988,112053,185,67,86,99
36729,443,18622,443,allow,7480,1122,6358,27,257,13,14
42137,443,46635,443,allow,9173,2080,7093,22,18,13,9
51757,54657,4096,54657,allow,70,70,0,2,8,2,0
1882,43890,0,0,deny,62,62,0,1,0,1,0
55530,53,3862,53,allow,758,93,665,2,31,1,1
49506,53,26702,53,allow,200,102,98,2,31,1,1
52651,445,0,0,drop,66,66,0,1,0,1,0
58638,5900,0,0,deny,62,62,0,1,0,1,0
49513,53,20128,53,allow,391,102,289,4,31,2,2
57424,53,34088,53,allow,177,94,83,2,30,1,1
54977,53,36032,53,allow,275,93,182,4,31,2,2
61723,443,17384,443,allow,6962,979,5983,19,15,10,9
62122,53,41697,53,allow,179,86,93,2,30,1,1
53268,443,17713,443,allow,22541,2143,20398,38,322,16,22
16697,64147,0,0,deny,145,145,0,1,0,1,0
56801,443,16437,443,allow,8022,2002,6020,20,15,11,9
57238,53,58179,53,allow,165,86,79,2,30,1,1
64326,53,50909,53,allow,196,102,94,2,31,1,1
56309,22114,0,0,deny,146,146,0,1,0,1,0
50562,37965,0,0,deny,62,62,0,1,0,1,0
60634,445,0,0,drop,66,66,0,1,0,1,0
58638,5900,0,0,deny,62,62,0,1,0,1,0
64093,53,8656,53,allow,225,110,115,2,30,1,1
65475,443,62261,443,allow,429726,12570,417156,440,16,154,286
54204,443,50779,443,allow,18159,12786,5373,34,270,19,15
50595,443,32592,443,allow,8981,4625,4356,22,135,11,11
58839,445,0,0,drop,66,66,0,1,0,1,0
60483,443,59259,443,allow,3089,866,2223,11,121,6,5
64756,53,52664,53,allow,190,97,93,2,31,1,1
12064,53,12064,53,allow,244,98,146,2,33,1,1
65288,44847,0,0,deny,66,66,0,1,0,1,0
50717,445,0,0,drop,70,70,0,1,0,1,0
58974,443,58974,443,allow,6792,1521,5271,18,28,11,7
64070,53,32128,53,allow,243,94,149,2,31,1,1
9190,443,45715,443,allow,4943,429,4514,12,15,6,6
59892,443,22013,443,allow,1813,1004,809,16,28,8,8
58868,445,0,0,drop,66,66,0,1,0,1,0
52625,25174,0,0,deny,66,66,0,1,0,1,0
55774,53,26343,53,allow,701,88,613,2,30,1,1
49341,53,41507,53,allow,199,102,97,2,30,1,1
64790,443,44733,443,allow,15810,7525,8285,35,97,18,17
57470,41024,3847,41024,allow,330,330,0,6,1200,6,0
56001,53,33036,53,allow,196,94,102,2,30,1,1
56973,53,9162,53,allow,193,102,91,2,30,1,1
65386,445,0,0,drop,70,70,0,1,0,1,0
57067,53,64624,53,allow,172,88,84,2,30,1,1
40071,443,38223,443,allow,7855,1850,6005,24,187,14,10
63836,445,0,0,drop,70,70,0,1,0,1,0
19473,51413,49212,51413,allow,459,149,310,2,1200,1,1
64001,53,5288,53,allow,182,93,89,2,30,1,1
61526,443,1145,443,allow,13977,5303,8674,48,152,20,28
38922,443,18971,443,allow,346170,16091,330079,454,16,225,229
59481,41182,0,0,deny,66,66,0,1,0,1,0
56279,23,0,0,deny,60,60,0,1,0,1,0
49515,53,21422,53,allow,226,110,116,2,29,1,1
60220,80,36816,80,allow,21108,15948,5160,47,151,30,17
2267,53,35940,53,allow,204,118,86,2,30,1,1
59943,37807,0,0,deny,62,62,0,1,0,1,0
40940,443,19885,443,allow,9856,1973,7883,32,140,17,15
50523,53,46429,53,allow,376,78,298,2,31,1,1
62343,445,0,0,drop,70,70,0,1,0,1,0
56041,53,56903,53,allow,179,94,85,2,30,1,1
56734,80,64954,80,allow,194,128,66,4,25,3,1
49418,22114,0,0,deny,66,66,0,1,0,1,0
56915,445,0,0,drop,70,70,0,1,0,1,0
59698,445,0,0,drop,70,70,0,1,0,1,0
46981,443,34961,443,allow,2809,1884,925,19,25,11,8
50692,445,0,0,drop,70,70,0,1,0,1,0
51244,29517,0,0,deny,100,100,0,1,0,1,0
64896,53,50820,53,allow,195,94,101,2,30,1,1
60869,443,60836,443,allow,10630,3315,7315,27,46,15,12
27366,5222,55342,5222,allow,3833,1007,2826,27,68,11,16
57015,80,50968,80,allow,1348,844,504,13,255,8,5
59663,37965,0,0,deny,66,66,0,1,0,1,0
49732,80,36115,80,allow,5236,1070,4166,13,145,6,7
56494,3033,0,0,deny,146,146,0,1,0,1,0
54308,445,0,0,drop,70,70,0,1,0,1,0
64315,53,11433,53,allow,322,102,220,2,30,1,1
55664,45682,37882,45682,allow,320,140,180,6,6,3,3
65106,53,17651,53,allow,354,94,260,2,29,1,1
51957,445,0,0,drop,66,66,0,1,0,1,0
55447,53,15473,53,allow,1449,108,1341,4,33,2,2
59696,57470,0,0,deny,62,62,0,1,0,1,0
57204,53,62842,53,allow,195,102,93,2,29,1,1
54162,443,34813,443,allow,2680,1488,1192,19,41,10,9
38759,443,29453,443,allow,8057,2726,5331,27,239,13,14
55810,53,35208,53,allow,183,94,89,2,29,1,1
49746,53,29622,53,allow,185,102,83,2,30,1,1
54006,445,0,0,drop,70,70,0,1,0,1,0
57433,443,58515,443,allow,11243,4236,7007,47,15,22,25
17860,53,17860,53,allow,216,90,126,2,30,1,1
64171,53,47261,53,allow,179,94,85,2,30,1,1
49418,27016,50703,27016,allow,258,78,180,2,31,1,1
63508,62413,0,0,deny,66,66,0,1,0,1,0
49582,53,42965,53,allow,775,103,672,2,30,1,1
46398,443,65303,443,allow,12982,7168,5814,50,165,23,27
3064,44847,0,0,deny,62,62,0,1,0,1,0
2932,44847,0,0,deny,62,62,0,1,0,1,0
58549,445,0,0,drop,70,70,0,1,0,1,0
2717,31573,0,0,deny,66,66,0,1,0,1,0
53971,50265,0,0,deny,66,66,0,1,0,1,0
56726,443,54514,443,allow,4221,666,3555,13,15,7,6
52586,445,0,0,drop,70,70,0,1,0,1,0
65189,27214,42310,27214,allow,231,78,153,2,29,1,1
49189,445,0,0,drop,70,70,0,1,0,1,0
443,64347,0,0,deny,131,131,0,1,0,1,0
49301,53,20768,53,allow,214,102,112,2,30,1,1
54325,27016,47516,27016,allow,924,924,0,3,30,3,0
52840,445,0,0,drop,66,66,0,1,0,1,0
52828,51221,0,0,deny,66,66,0,1,0,1,0
50732,445,0,0,drop,70,70,0,1,0,1,0
56125,80,28714,80,allow,891,536,355,10,255,6,4
56586,53,63496,53,allow,177,94,83,2,31,1,1
55679,445,0,0,drop,70,70,0,1,0,1,0
55673,53,41151,53,allow,179,94,85,2,30,1,1
56572,445,0,0,drop,70,70,0,1,0,1,0
54306,445,0,0,drop,70,70,0,1,0,1,0
55720,445,0,0,drop,70,70,0,1,0,1,0
62763,443,43714,443,allow,7755,4481,3274,17,135,9,8
65387,443,41173,443,allow,2289,1583,706,14,18,8,6
25207,48817,0,0,deny,62,62,0,1,0,1,0
65320,53,12285,53,allow,227,110,117,2,30,1,1
46640,8880,0,0,deny,60,60,0,1,0,1,0
44409,53,42084,53,allow,199,94,105,2,30,1,1
53475,3389,0,0,deny,62,62,0,1,0,1,0
54952,443,11665,443,allow,61842,4466,57376,109,293,46,63
39644,80,29707,80,allow,2631,1207,1424,14,16,9,5
54571,445,0,0,drop,70,70,0,1,0,1,0
49686,44847,0,0,deny,66,66,0,1,0,1,0
52397,445,0,0,drop,66,66,0,1,0,1,0
52277,443,52277,443,allow,1880,941,939,17,21,7,10
52036,52608,31210,52608,allow,70,70,0,1,4,1,0
58648,443,61974,443,allow,7509,1262,6247,22,16,12,10
55596,53,49236,53,allow,177,94,83,2,30,1,1
64379,37965,0,0,deny,66,66,0,1,0,1,0
61211,445,0,0,drop,66,66,0,1,0,1,0
56945,53,29864,53,allow,711,87,624,2,30,1,1
61451,17500,0,0,deny,62,62,0,1,0,1,0
46827,443,46276,443,allow,8277,1368,6909,31,120,14,17
59754,53,11671,53,allow,260,86,174,2,30,1,1
62038,80,20471,80,allow,668,224,444,10,18,4,6
36417,443,64743,443,allow,8611,2046,6565,31,394,10,21
10000,10214,0,0,deny,62,62,0,1,0,1,0
49743,443,63725,443,allow,157156,3872,153284,160,128,48,112
55932,445,0,0,drop,66,66,0,1,0,1,0
63545,25174,0,0,deny,66,66,0,1,0,1,0
59763,443,10249,443,allow,24828,8387,16441,80,111,44,36
65060,445,0,0,drop,70,70,0,1,0,1,0
34310,80,6005,80,allow,1614,1300,314,10,15,5,5
57272,445,0,0,drop,66,66,0,1,0,1,0
41755,48817,0,0,deny,145,145,0,1,0,1,0
56846,53,22209,53,allow,196,102,94,2,31,1,1
41231,443,41940,443,allow,65667,5371,60296,89,85,36,53
49384,53,27649,53,allow,181,94,87,2,30,1,1
58638,5900,0,0,deny,62,62,0,1,0,1,0
55833,53,34904,53,allow,177,94,83,2,30,1,1
56340,53,40288,53,allow,198,102,96,2,30,1,1
56601,53,12996,53,allow,170,87,83,2,30,1,1
1035,64147,0,0,deny,145,145,0,1,0,1,0
6881,25243,30519,25243,allow,498,150,348,4,1273,2,2
64256,445,0,0,drop,70,70,0,1,0,1,0
49315,443,55462,443,allow,160961,7302,153659,171,87,49,122
63345,53,0,0,deny,75,75,0,1,0,1,0
63314,57470,0,0,deny,66,66,0,1,0,1,0
55579,53,24866,53,allow,178,94,84,2,29,1,1
63780,28124,24113,28124,allow,4536,2883,1653,27,94,15,12
49404,53,39531,53,allow,253,102,151,2,30,1,1
41170,443,30807,443,allow,8837,1938,6899,21,17,12,9
49197,2710,8644,2710,allow,70,70,0,2,7,2,0
51540,3389,51540,3389,allow,4425,2641,1784,21,33,12,9
51747,54301,33615,54301,allow,136,136,0,3,14,3,0
64159,445,0,0,drop,66,66,0,1,0,1,0
3803,51505,0,0,deny,66,66,0,1,0,1,0
57384,443,63051,443,allow,546,280,266,9,28,5,4
59347,445,0,0,drop,70,70,0,1,0,1,0
49466,53,24088,53,allow,209,110,99,2,30,1,1
61968,445,0,0,drop,70,70,0,1,0,1,0
50436,53,50436,53,allow,248,106,142,2,30,1,1
59995,445,0,0,drop,70,70,0,1,0,1,0
50672,443,34507,443,allow,6202,1828,4374,25,18,12,13
64003,38926,33075,38926,allow,66,66,0,2,8,2,0
56492,53,3429,53,allow,177,94,83,2,30,1,1
51974,80,47213,80,allow,38272,2881,35391,54,54,26,28
2707,37,0,0,deny,60,60,0,1,0,1,0
58858,15503,0,0,deny,66,66,0,1,0,1,0
64000,53,28661,53,allow,241,102,139,2,30,1,1
61417,443,25149,443,allow,652760,608740,44020,734,432,496,238
56769,53,31740,53,allow,183,94,89,2,30,1,1
45118,39004,0,0,deny,74,74,0,1,0,1,0
57952,443,57780,443,allow,480591,8786,471805,442,46,102,340
59210,8168,0,0,deny,66,66,0,1,0,1,0
59485,445,0,0,drop,70,70,0,1,0,1,0
61313,445,0,0,drop,70,70,0,1,0,1,0
10013,443,27326,443,allow,10336,4760,5576,37,315,18,19
53670,445,0,0,drop,70,70,0,1,0,1,0
41395,443,34255,443,allow,6292,1492,4800,22,17,11,11
49580,53,21716,53,allow,192,98,94,2,30,1,1
59773,53,11146,53,allow,218,78,140,2,31,1,1
6060,15503,0,0,deny,146,146,0,1,0,1,0
55199,445,0,0,drop,70,70,0,1,0,1,0
55067,53,26485,53,allow,178,94,84,2,31,1,1
64747,53,25665,53,allow,167,78,89,2,30,1,1
49594,445,0,0,drop,70,70,0,1,0,1,0
62217,445,0,0,drop,66,66,0,1,0,1,0
57806,445,0,0,drop,66,66,0,1,0,1,0
60678,445,0,0,drop,70,70,0,1,0,1,0
50265,27034,40304,27034,allow,480,149,331,2,1200,1,1
57453,445,0,0,drop,70,70,0,1,0,1,0
36011,25174,0,0,deny,66,66,0,1,0,1,0
63263,57470,0,0,deny,66,66,0,1,0,1,0
54101,443,19141,443,allow,4013,2840,1173,23,27,13,10
57471,62413,0,0,deny,62,62,0,1,0,1,0
57470,43259,40741,43259,allow,517,163,354,2,1200,1,1
64294,53,36421,53,allow,329,118,211,2,30,1,1
31227,53,31227,53,allow,407,261,146,3,32,2,1
65246,445,0,0,drop,66,66,0,1,0,1,0
61320,53,0,0,allow,194,80,114,2,30,1,1
60461,10138,64431,10138,allow,70,70,0,1,5,1,0
49278,80,32439,80,allow,991,525,466,10,136,6,4
2923,57470,0,0,deny,66,66,0,1,0,1,0
49673,443,32250,443,allow,6404,829,5575,18,57,9,9
61766,44847,0,0,deny,62,62,0,1,0,1,0
60188,15503,0,0,deny,66,66,0,1,0,1,0
9283,57470,0,0,deny,66,66,0,1,0,1,0
61018,443,61018,443,allow,4400,1493,2907,19,29,11,8
49273,7000,49273,7000,allow,2163,676,1487,14,15,7,7
55087,443,24413,443,allow,101356,10743,90613,178,31,90,88
64899,53,5067,53,allow,199,102,97,2,31,1,1
51657,80,10496,80,allow,318,192,126,6,37,4,2
38469,80,38469,80,allow,555104,4582,550522,446,20,60,386
22150,6881,0,0,deny,146,146,0,1,0,1,0
65303,53,22620,53,allow,760,96,664,2,31,1,1
56326,53,47935,53,allow,177,94,83,2,31,1,1
9434,443,11212,443,allow,5693,499,5194,14,15,7,7
63297,445,0,0,drop,70,70,0,1,0,1,0
58638,5900,0,0,deny,62,62,0,1,0,1,0
49754,35440,0,0,deny,146,146,0,1,0,1,0
64984,53,22465,53,allow,177,94,83,2,30,1,1
63962,53,21344,53,allow,185,93,92,3,58,2,1
62827,1,0,0,deny,66,66,0,1,0,1,0
19747,37965,0,0,deny,62,62,0,1,0,1,0
52127,443,33029,443,allow,18360,1198,17162,27,25,9,18
49929,53,13431,53,allow,260,124,136,2,31,1,1
43516,53,56876,53,allow,168,78,90,2,30,1,1
53705,443,25596,443,allow,1579,988,591,13,44,7,6
59712,445,0,0,drop,70,70,0,1,0,1,0
38959,25174,0,0,deny,62,62,0,1,0,1,0
61417,443,31390,443,allow,4890,1219,3671,17,28,10,7
60417,443,24567,443,allow,8590,1987,6603,23,86,12,11
49982,53,52781,53,allow,206,105,101,2,31,1,1
42298,40016,11792,40016,allow,148,86,62,2,30,1,1
61865,445,0,0,drop,66,66,0,1,0,1,0
58688,53,58261,53,allow,184,78,106,2,30,1,1
64995,53,18804,53,allow,204,104,100,2,31,1,1
64414,53,3637,53,allow,193,102,91,2,30,1,1
46899,80,46899,80,allow,82739,3221,79518,91,156,28,63
56442,53,30750,53,allow,167,86,81,2,30,1,1
64772,53,2611,53,allow,633,231,402,6,47,3,3
42672,443,42672,443,allow,4378,1471,2907,19,30,11,8
10007,443,53248,443,allow,3811,1846,1965,20,330,9,11
50526,80,52180,80,allow,259593,12828,246765,308,156,118,190
56624,53,64033,53,allow,199,102,97,2,30,1,1
55417,53,13088,53,allow,174,89,85,2,30,1,1
60168,35440,0,0,deny,66,66,0,1,0,1,0
33939,443,3295,443,allow,3191,1047,2144,13,135,6,7
50998,445,0,0,drop,66,66,0,1,0,1,0
55763,8060,49115,8060,allow,70,70,0,2,7,2,0
56756,53,60834,53,allow,167,86,81,2,30,1,1
55248,67,0,0,deny,60,60,0,1,0,1,0
54248,445,0,0,drop,66,66,0,1,0,1,0
49154,53,7041,53,allow,763,204,559,6,40,3,3
52176,445,0,0,drop,70,70,0,1,0,1,0
49533,443,49533,443,allow,20402,16563,3839,29,24,17,12
48265,443,35728,443,allow,7379,2268,5111,18,134,8,10
60674,8055,0,0,deny,145,145,0,1,0,1,0
45964,3111,0,0,deny,60,60,0,1,0,1,0
56574,445,0,0,drop,70,70,0,1,0,1,0
61916,64097,0,0,deny,66,66,0,1,0,1,0
63757,51413,50296,51413,allow,70,70,0,1,4,1,0
37965,18122,9264,18122,allow,3957,2324,1633,51,1794,29,22
50081,443,5325,443,allow,11958,2983,8975,28,48,15,13
58342,445,0,0,drop,70,70,0,1,0,1,0
49192,53,8580,53,allow,212,102,110,2,30,1,1
53028,80,12775,80,allow,3470,1464,2006,21,190,10,11
58724,43890,0,0,deny,66,66,0,1,0,1,0
49418,27015,11221,27015,allow,240,78,162,2,30,1,1
50265,11035,48783,11035,allow,132,132,0,3,1200,3,0
55947,53,4712,53,allow,94,94,0,1,30,1,0
14082,50584,0,0,deny,62,62,0,1,0,1,0
63321,37807,0,0,deny,66,66,0,1,0,1,0
57934,445,0,0,drop,66,66,0,1,0,1,0
59244,53,54257,53,allow,168,78,90,2,30,1,1
65005,53,2818,53,allow,239,94,145,2,30,1,1
8415,8415,47085,8415,allow,66,66,0,1,30,1,0
49349,80,49349,80,allow,450,246,204,8,141,5,3
37774,443,33221,443,allow,282171,13444,268727,377,201,175,202
28136,443,42266,443,allow,8805,3429,5376,33,475,16,17
55162,445,0,0,drop,70,70,0,1,0,1,0
63194,50265,0,0,deny,66,66,0,1,0,1,0
62488,445,0,0,drop,70,70,0,1,0,1,0
63731,445,0,0,drop,66,66,0,1,0,1,0
53406,50584,0,0,deny,62,62,0,1,0,1,0
51981,38274,61701,38274,allow,206,136,70,4,13,3,1
64995,53,32224,53,allow,210,110,100,2,30,1,1
53580,445,0,0,drop,66,66,0,1,0,1,0
54961,443,58980,443,allow,1015861,30762,985099,1147,257,421,726
58007,62413,0,0,deny,62,62,0,1,0,1,0
43197,80,55210,80,allow,3605,1700,1905,16,186,9,7
11136,15503,0,0,deny,145,145,0,1,0,1,0
54372,80,17871,80,allow,3517,1612,1905,17,186,10,7
55251,445,0,0,drop,70,70,0,1,0,1,0
51380,445,0,0,drop,66,66,0,1,0,1,0
50310,445,0,0,drop,66,66,0,1,0,1,0
443,4205,0,0,deny,320,320,0,1,0,1,0
49369,53,36980,53,allow,183,94,89,2,30,1,1
56608,445,0,0,drop,70,70,0,1,0,1,0
55450,64147,0,0,deny,66,66,0,1,0,1,0
61493,443,44435,443,allow,5325,1242,4083,23,27,13,10
65080,53,46581,53,allow,741,94,647,2,30,1,1
26900,27017,41768,27017,allow,422,164,258,6,30,3,3
58273,53,40385,53,allow,202,86,116,2,30,1,1
55163,445,0,0,drop,70,70,0,1,0,1,0
65503,445,0,0,drop,66,66,0,1,0,1,0
56337,443,18375,443,allow,9683,2173,7510,35,26,17,18
65111,443,62828,443,allow,3255,1259,1996,13,135,7,6
56292,53,23956,53,allow,197,102,95,2,30,1,1
62453,443,7833,443,allow,8698,3272,5426,22,26,11,11
50207,53,4187,53,allow,195,102,93,2,29,1,1
55938,53,44450,53,allow,209,110,99,2,30,1,1
61165,445,0,0,drop,70,70,0,1,0,1,0
40105,80,32685,80,allow,9656,3195,6461,19,23,12,7
51826,445,0,0,drop,70,70,0,1,0,1,0
65403,53,24512,53,allow,249,102,147,2,30,1,1
50972,3544,28007,3544,allow,258,107,151,2,31,1,1
50804,1,0,0,deny,62,62,0,1,0,1,0
58008,445,0,0,drop,70,70,0,1,0,1,0
60410,18359,27575,18359,allow,1759,820,939,18,16,8,10
63458,445,0,0,drop,70,70,0,1,0,1,0
5588,5588,0,0,allow,3354,1792,1562,46,194,23,23
18203,23,0,0,deny,60,60,0,1,0,1,0
51918,41488,58958,41488,allow,70,70,0,1,5,1,0
56458,53,47423,53,allow,196,102,94,2,30,1,1
55072,53,7801,53,allow,177,94,83,2,30,1,1
1227,56205,0,0,deny,66,66,0,1,0,1,0
50558,80,10581,80,allow,318,192,126,6,26,4,2
51538,443,28169,443,allow,6384,1899,4485,16,75,9,7
30389,53,30389,53,allow,235,90,145,2,33,1,1
58801,445,0,0,drop,70,70,0,1,0,1,0
50352,445,0,0,drop,66,66,0,1,0,1,0
64025,53,10807,53,allow,199,94,105,2,30,1,1
61550,5529,0,0,deny,145,145,0,1,0,1,0
10072,25174,0,0,deny,62,62,0,1,0,1,0
40098,443,58425,443,allow,4564,3204,1360,19,348,10,9
51234,445,0,0,drop,66,66,0,1,0,1,0
60472,443,5896,443,allow,3779,2809,970,23,47,12,11
39333,443,52867,443,allow,7832,1895,5937,24,83,14,10
45325,53,64530,53,allow,168,78,90,2,30,1,1
54956,53,34992,53,allow,188,96,92,2,31,1,1
52720,35894,0,0,deny,62,62,0,1,0,1,0
55746,53,61389,53,allow,216,110,106,2,31,1,1
61660,64097,0,0,deny,62,62,0,1,0,1,0
56526,443,53927,443,allow,1560,988,572,13,25,7,6
56618,80,46340,80,allow,234,234,0,4,12,4,0
0,0,0,0,deny,164,164,0,2,0,2,0
46728,443,17105,443,allow,7087,746,6341,16,15,9,7
55196,443,1122,443,allow,13568,2119,11449,35,316,17,18
49603,53,64849,53,allow,733,94,639,2,30,1,1
53641,445,0,0,drop,70,70,0,1,0,1,0
55194,53,9824,53,allow,195,102,93,2,31,1,1
51221,65427,56298,65427,allow,460,150,310,2,1200,1,1
54241,445,0,0,deny,70,70,0,1,0,1,0
65270,3855,0,0,deny,78,78,0,1,0,1,0
22390,19473,0,0,deny,66,66,0,1,0,1,0
57188,53,20332,53,allow,193,102,91,2,30,1,1
55585,48063,18600,48063,allow,70,70,0,1,5,1,0
49527,53,42526,53,allow,268,94,174,2,29,1,1
38627,443,6493,443,allow,32864,2590,30274,41,82,14,27
64340,53,64340,53,allow,847,110,737,2,30,1,1
16377,21247,0,0,deny,62,62,0,1,0,1,0
35154,42707,0,0,deny,62,62,0,1,0,1,0
56396,53,48729,53,allow,338,110,228,2,30,1,1
62637,42873,0,0,deny,66,66,0,1,0,1,0
49677,25174,0,0,deny,66,66,0,1,0,1,0
56367,53,30541,53,allow,194,102,92,2,30,1,1
58638,5900,0,0,deny,62,62,0,1,0,1,0
46189,443,46189,443,allow,4398,1491,2907,19,30,11,8
58308,445,0,0,drop,66,66,0,1,0,1,0
44812,443,17089,443,allow,6152,420,5732,13,120,6,7
64814,53,26949,53,allow,165,86,79,2,31,1,1
8734,56205,0,0,deny,66,66,0,1,0,1,0
58881,443,10013,443,allow,1413,876,537,12,26,6,6
7539,30317,0,0,deny,62,62,0,1,0,1,0
62844,445,0,0,drop,70,70,0,1,0,1,0
53977,22266,9645,22266,allow,492,306,186,8,17,5,3
51425,445,0,0,drop,66,66,0,1,0,1,0
38517,53,38517,53,allow,214,82,132,2,32,1,1
50667,80,50667,80,allow,15686,1227,14459,24,20,11,13
19473,6881,31231,6881,allow,490,149,341,2,1200,1,1
58638,5900,0,0,deny,62,62,0,1,0,1,0
55152,53,21399,53,allow,180,94,86,2,29,1,1
61419,445,0,0,drop,70,70,0,1,0,1,0
52459,33890,0,0,deny,60,60,0,1,0,1,0
64080,445,0,0,drop,70,70,0,1,0,1,0
50772,35440,0,0,deny,66,66,0,1,0,1,0
58638,5900,0,0,deny,62,62,0,1,0,1,0
57281,53,42469,53,allow,172,88,84,2,30,1,1
47727,25174,0,0,deny,62,62,0,1,0,1,0
25536,50584,0,0,deny,62,62,0,1,0,1,0
27147,22114,0,0,deny,62,62,0,1,0,1,0
60489,53151,11462,53151,allow,70,70,0,1,5,1,0
56518,53,3673,53,allow,177,94,83,2,31,1,1
65446,53,11171,53,allow,168,86,82,2,30,1,1
63204,443,63204,443,allow,9340,4256,5084,24,16,13,11
6881,45711,0,0,deny,100,100,0,1,0,1,0
50324,443,9934,443,allow,8725,2284,6441,17,120,8,9
49432,53,61997,53,allow,312,94,218,2,30,1,1
61426,64910,0,0,deny,66,66,0,1,0,1,0
24066,25174,0,0,deny,146,146,0,1,0,1,0
3478,61463,0,0,deny,1188,1188,0,1,0,1,0
61403,445,0,0,drop,70,70,0,1,0,1,0
55147,53,48564,53,allow,184,94,90,2,30,1,1
54264,445,0,0,drop,66,66,0,1,0,1,0
49808,445,0,0,drop,70,70,0,1,0,1,0
18130,25174,0,0,deny,62,62,0,1,0,1,0
49234,53,62807,53,allow,167,86,81,2,29,1,1
41861,5223,49797,5223,allow,5169,1103,4066,26,214,10,16
49178,53,11567,53,allow,822,102,720,2,29,1,1
60886,443,45692,443,allow,12652,6172,6480,44,16,26,18
57006,53,15142,53,allow,819,102,717,2,30,1,1
51260,80,52216,80,allow,23175,13071,10104,134,1929,67,67
55043,53,37629,53,allow,167,86,81,2,30,1,1
57837,64147,0,0,deny,66,66,0,1,0,1,0
50375,80,22563,80,allow,350,210,140,6,15,4,2
42995,26467,0,0,deny,62,62,0,1,0,1,0
7331,53,7331,53,allow,213,79,134,2,32,1,1
50863,445,0,0,drop,66,66,0,1,0,1,0
42309,443,23092,443,allow,7295,1469,5826,30,360,9,21
26239,25174,0,0,deny,66,66,0,1,0,1,0
62750,445,0,0,drop,70,70,0,1,0,1,0
64303,445,0,0,drop,66,66,0,1,0,1,0
61278,445,0,0,drop,70,70,0,1,0,1,0
55749,53,21707,53,allow,413,170,243,6,30,3,3
58638,5900,0,0,deny,62,62,0,1,0,1,0
56901,53,23977,53,allow,710,89,621,2,31,1,1
65258,53,25267,53,allow,193,102,91,2,30,1,1
55648,445,0,0,drop,70,70,0,1,0,1,0
50264,443,26394,443,allow,25435,5293,20142,104,138,54,50
56560,53,21034,53,allow,198,102,96,2,31,1,1
59758,445,0,0,drop,70,70,0,1,0,1,0
56912,53,43272,53,allow,216,94,122,2,30,1,1
49741,53,12587,53,allow,211,102,109,2,30,1,1
56876,53,55574,53,allow,711,87,624,2,31,1,1
49764,53,36622,53,allow,199,102,97,2,31,1,1
56810,53,59842,53,allow,751,95,656,2,30,1,1
50809,445,0,0,drop,66,66,0,1,0,1,0
1027,23684,0,0,deny,159,159,0,1,0,1,0
50246,445,0,0,drop,70,70,0,1,0,1,0
56697,53,34605,53,allow,198,102,96,2,30,1,1
26900,27017,1204,27017,allow,422,164,258,6,30,3,3
62155,445,0,0,drop,70,70,0,1,0,1,0
58933,443,10888,443,allow,5167,700,4467,16,15,7,9
64090,443,49482,443,allow,7360,2435,4925,19,135,9,10
55675,53,34777,53,allow,287,91,196,4,60,2,2
58296,445,0,0,drop,66,66,0,1,0,1,0
56609,53,65200,53,allow,199,102,97,2,30,1,1
62685,443,28394,443,allow,7023,2352,4671,18,75,10,8
48817,6884,48817,6884,allow,328,152,176,2,1200,1,1
64559,53,32115,53,allow,193,102,91,2,29,1,1
53135,80,21609,80,allow,2959,610,2349,12,15,6,6
49844,53,1140,53,allow,762,98,664,2,31,1,1
64530,53,20478,53,allow,261,87,174,4,44,2,2
13581,51505,0,0,deny,66,66,0,1,0,1,0
27005,30008,37635,30008,allow,881,126,755,2,30,1,1
49418,443,14696,443,allow,318,192,126,6,16,4,2
55338,445,0,0,drop,70,70,0,1,0,1,0
54062,49813,0,0,deny,62,62,0,1,0,1,0
49161,445,0,0,drop,70,70,0,1,0,1,0
51889,44348,63585,44348,allow,70,70,0,2,8,2,0
49604,53,12616,53,allow,179,94,85,2,30,1,1
59772,62413,0,0,deny,66,66,0,1,0,1,0
53163,445,0,0,drop,66,66,0,1,0,1,0
57592,80,57592,80,allow,3118,689,2429,13,144,6,7
45257,443,55440,443,allow,36062,4663,31399,87,33,41,46
58143,443,15049,443,allow,17812,8128,9684,55,343,27,28
49520,53,8068,53,allow,209,110,99,2,29,1,1
62905,445,0,0,drop,70,70,0,1,0,1,0
61664,445,0,0,drop,70,70,0,1,0,1,0
37965,10909,61398,10909,allow,844,152,692,4,1199,2,2
57203,443,49091,443,allow,1798,1223,575,13,28,8,5
64492,445,0,0,drop,66,66,0,1,0,1,0
57470,1337,56441,1337,allow,792,792,0,13,1199,13,0
51793,12210,25465,12210,allow,70,70,0,1,5,1,0
49719,445,0,0,drop,70,70,0,1,0,1,0
56268,44847,0,0,deny,66,66,0,1,0,1,0
60452,443,43264,443,allow,5807,2168,3639,17,135,8,9
48841,51221,0,0,deny,62,62,0,1,0,1,0
64547,53,37211,53,allow,762,97,665,2,30,1,1
51781,43909,49326,43909,allow,66,66,0,1,5,1,0
55088,53,3753,53,allow,193,102,91,2,29,1,1
55821,53,40940,53,allow,168,86,82,2,30,1,1
50641,443,27533,443,allow,1473,890,583,13,140,7,6
63068,445,0,0,drop,70,70,0,1,0,1,0
17957,64097,0,0,deny,66,66,0,1,0,1,0
47910,7454,0,0,deny,60,60,0,1,0,1,0
44839,443,23952,443,allow,3188,2056,1132,23,121,13,10
37419,443,55901,443,allow,558,210,348,9,28,4,5
56571,53,44608,53,allow,211,102,109,2,30,1,1
42348,53,29230,53,allow,199,94,105,2,30,1,1
56078,53,50373,53,allow,178,94,84,2,29,1,1
38363,15000,1161,15000,allow,130,70,60,2,6,1,1
56070,53,35943,53,allow,770,101,669,2,30,1,1
65251,53,54208,53,allow,183,98,85,3,36,2,1
50594,80,50594,80,allow,9937,4191,5746,27,17,13,14
56950,53,15623,53,allow,363,109,254,4,46,2,2
58215,443,23391,443,allow,7337,1630,5707,23,256,12,11
54270,445,0,0,drop,70,70,0,1,0,1,0
54618,445,0,0,drop,70,70,0,1,0,1,0
56984,53,20901,53,allow,199,102,97,2,29,1,1
58772,443,9884,443,allow,5106,700,4406,15,15,7,8
55935,53,44322,53,allow,196,102,94,2,30,1,1
5228,3434,0,0,deny,345,345,0,1,0,1,0
37533,443,8271,443,allow,5516,1774,3742,21,46,13,8
35832,443,44222,443,allow,17110,4513,12597,42,121,19,23
58785,53,58785,53,allow,216,90,126,2,30,1,1
44129,53,44129,53,allow,182,81,101,2,30,1,1
41744,37965,0,0,deny,62,62,0,1,0,1,0
49818,53,37745,53,allow,86,86,0,1,30,1,0
52269,445,0,0,drop,70,70,0,1,0,1,0
53578,445,0,0,drop,70,70,0,1,0,1,0
61583,64147,0,0,deny,66,66,0,1,0,1,0
54478,445,0,0,drop,70,70,0,1,0,1,0
1054,57470,0,0,deny,62,62,0,1,0,1,0
38093,11392,0,0,deny,62,62,0,1,0,1,0
64985,53,34087,53,allow,194,102,92,2,30,1,1
48710,22,48710,22,allow,11002,3445,7557,60,42,26,34
56356,443,29331,443,allow,3734,1750,1984,24,203,12,12
53548,443,18610,443,allow,6812,1127,5685,24,255,11,13
56185,53,59066,53,allow,216,94,122,2,30,1,1
51607,53,31669,53,allow,284,86,198,2,30,1,1
51218,445,0,0,drop,70,70,0,1,0,1,0
9443,443,55182,443,allow,7398,1480,5918,24,39,12,12
30188,23453,55935,23453,allow,502,150,352,2,1200,1,1
37007,22114,0,0,deny,146,146,0,1,0,1,0
51653,443,13431,443,allow,6660,1542,5118,21,305,11,10
56661,443,39690,443,allow,7900,3324,4576,28,139,13,15
57675,445,0,0,drop,70,70,0,1,0,1,0
53269,443,51596,443,allow,5766,1925,3841,22,17,14,8
63133,80,57043,80,allow,18055,904,17151,22,15,7,15
60290,53,35403,53,allow,213,86,127,2,30,1,1
28235,443,3343,443,allow,8830,2388,6442,29,124,14,15
56860,53,58794,53,allow,168,86,82,2,30,1,1
1027,64147,0,0,deny,62,62,0,1,0,1,0
53933,20801,53397,20801,allow,70,70,0,1,4,1,0
64908,53,50995,53,allow,304,94,210,2,30,1,1
62408,50584,0,0,deny,66,66,0,1,0,1,0
51870,40490,10666,40490,allow,70,70,0,2,8,2,0
63413,445,0,0,drop,70,70,0,1,0,1,0
2437,53,2437,53,allow,229,90,139,2,30,1,1
39461,53,45858,53,allow,168,78,90,2,30,1,1
63685,445,0,0,drop,70,70,0,1,0,1,0
49326,53,62713,53,allow,193,102,91,2,30,1,1
27064,51221,0,0,deny,72,72,0,1,0,1,0
49301,53,26968,53,allow,353,118,235,2,31,1,1
57246,53,49639,53,allow,183,94,89,2,31,1,1
36500,3142,36500,3142,allow,138,78,60,2,6,1,1
62227,443,62227,443,allow,197342,62255,135087,232,170,110,122
59340,445,0,0,drop,70,70,0,1,0,1,0
59634,445,0,0,drop,70,70,0,1,0,1,0
61942,3389,61942,3389,allow,3347,1458,1889,15,18,8,7
55987,53,22591,53,allow,733,85,648,2,0,1,1
56416,445,0,0,drop,70,70,0,1,0,1,0
55644,45579,38445,45579,allow,70,70,0,2,8,2,0
49591,53,36017,53,allow,168,86,82,2,31,1,1
49265,53,37179,53,allow,181,94,87,2,30,1,1
51426,59737,0,0,deny,100,100,0,1,0,1,0
64220,53,21263,53,allow,265,110,155,2,30,1,1
51230,445,0,0,drop,66,66,0,1,0,1,0
32160,53,32160,53,allow,233,90,143,2,32,1,1
54922,445,0,0,drop,70,70,0,1,0,1,0
12338,64147,0,0,deny,66,66,0,1,0,1,0
29226,80,29226,80,allow,490,264,226,8,35,5,3
62329,445,0,0,drop,70,70,0,1,0,1,0
51782,445,0,0,drop,70,70,0,1,0,1,0
33886,52255,0,0,deny,162,162,0,1,0,1,0
56980,445,0,0,drop,70,70,0,1,0,1,0
50942,445,0,0,drop,70,70,0,1,0,1,0
34478,443,59065,443,allow,9107,2253,6854,22,185,11,11
65328,53,23014,53,allow,179,94,85,2,30,1,1
51000,443,65422,443,allow,6544,939,5605,17,17,10,7
65000,53,35253,53,allow,184,102,82,2,30,1,1
27005,28215,29356,28215,allow,879,126,753,2,30,1,1
56739,443,56739,443,allow,94524,4465,90059,126,45,56,70
64125,53,18557,53,allow,199,102,97,2,30,1,1
64321,53,62198,53,allow,195,102,93,2,30,1,1
10128,23718,0,0,deny,146,146,0,1,0,1,0
50299,443,56417,443,allow,86,86,0,1,4,1,0
36445,443,44215,443,allow,234,234,0,4,12,4,0
40804,8434,40804,8434,allow,156,156,0,3,8,3,0
55171,53,26173,53,allow,762,97,665,2,31,1,1
50742,445,0,0,drop,70,70,0,1,0,1,0
65388,80,37790,80,allow,1498,392,1106,10,16,5,5
55688,33958,16437,33958,allow,70,70,0,1,5,1,0
54021,25174,0,0,deny,146,146,0,1,0,1,0
58638,5900,0,0,deny,62,62,0,1,0,1,0
56649,53,35726,53,allow,152,78,74,2,30,1,1
54870,443,54870,443,allow,313399,38167,275232,411,23,205,206
44577,443,43261,443,allow,30773,9123,21650,90,104,48,42
46093,32661,0,0,deny,74,74,0,1,0,1,0
57163,443,13914,443,allow,1779,1375,404,11,40,5,6
59355,51505,0,0,deny,66,66,0,1,0,1,0
37759,53,3026,53,allow,199,94,105,2,30,1,1
65466,53,26406,53,allow,248,94,154,2,30,1,1
62491,445,0,0,drop,66,66,0,1,0,1,0
16387,44427,0,0,deny,60,60,0,1,0,1,0
27005,27015,43696,27015,allow,876,126,750,2,30,1,1
53667,56205,0,0,deny,62,62,0,1,0,1,0
57166,53,13391,53,allow,177,94,83,2,30,1,1
36369,443,28864,443,allow,4039,2616,1423,24,45,14,10
56482,80,53743,80,allow,180583,6825,173758,188,136,68,120
49828,443,43122,443,allow,7284,1353,5931,26,186,14,12
65499,53,26043,53,allow,167,86,81,2,29,1,1
1024,50265,0,0,deny,62,62,0,1,0,1,0
45334,443,8591,443,allow,8798,1667,7131,25,22,14,11
9087,37965,0,0,deny,62,62,0,1,0,1,0
53114,443,28454,443,allow,3796,1523,2273,20,135,10,10
52447,43890,0,0,deny,62,62,0,1,0,1,0
60818,37965,0,0,deny,62,62,0,1,0,1,0
52955,445,0,0,drop,70,70,0,1,0,1,0
49769,445,0,0,drop,66,66,0,1,0,1,0
60438,17148,53794,17148,allow,70,70,0,2,8,2,0
50827,443,28235,443,allow,166814,93487,73327,620,4017,312,308
64017,445,0,0,drop,70,70,0,1,0,1,0
55001,445,0,0,drop,70,70,0,1,0,1,0
43195,80,21562,80,allow,3477,1572,1905,16,186,9,7
56215,445,0,0,drop,70,70,0,1,0,1,0
52637,445,0,0,drop,70,70,0,1,0,1,0
58638,5900,0,0,deny,62,62,0,1,0,1,0
61635,445,0,0,drop,70,70,0,1,0,1,0
58862,445,0,0,drop,70,70,0,1,0,1,0
55788,53,13740,53,allow,755,93,662,2,31,1,1
49795,445,0,0,drop,66,66,0,1,0,1,0
58602,445,0,0,drop,70,70,0,1,0,1,0
57373,445,0,0,drop,70,70,0,1,0,1,0
65318,53,11252,53,allow,184,94,90,2,30,1,1
55262,443,33483,443,allow,28633618,753499,27880119,30116,102,8846,21270
56620,53,8741,53,allow,214,102,112,2,30,1,1
63271,445,0,0,drop,70,70,0,1,0,1,0
50218,53,12883,53,allow,165,86,79,2,29,1,1
51014,445,0,0,drop,66,66,0,1,0,1,0
56914,53,24598,53,allow,821,102,719,2,30,1,1
49356,53,31993,53,allow,763,102,661,2,31,1,1
49418,27015,20028,27015,allow,264,78,186,2,29,1,1
30201,53,30201,53,allow,235,90,145,2,33,1,1
56733,445,0,0,drop,70,70,0,1,0,1,0
56782,53,44895,53,allow,197,102,95,2,30,1,1
8999,52290,0,0,deny,146,146,0,1,0,1,0
50771,445,0,0,drop,70,70,0,1,0,1,0
53532,8569,14217,8569,allow,546,306,240,9,143,5,4
63242,443,5586,443,allow,9042,4612,4430,31,175,17,14
62080,54532,0,0,deny,60,60,0,1,0,1,0
56004,443,46384,443,allow,130,70,60,3,4,2,1
56660,53,3127,53,allow,338,110,228,2,30,1,1
57144,53,1605,53,allow,178,94,84,2,29,1,1
43207,26467,0,0,deny,62,62,0,1,0,1,0
56716,445,0,0,drop,70,70,0,1,0,1,0
51211,443,40776,443,allow,7638,2405,5233,44,17,25,19
45768,80,41776,80,allow,2784,1804,980,17,20,9,8
40025,443,22559,443,allow,10012,3016,6996,40,133,19,21
61590,445,0,0,drop,70,70,0,1,0,1,0
40472,443,17256,443,allow,317215,285998,31217,436,982,244,192
64462,445,0,0,drop,70,70,0,1,0,1,0
56562,53,61427,53,allow,183,94,89,2,30,1,1
53229,443,57933,443,allow,91414,11700,79714,174,59,65,109
58638,5900,58638,5900,allow,66,66,0,1,4,1,0
57506,445,0,0,drop,66,66,0,1,0,1,0
5631,80,5631,80,allow,16287,756,15531,23,16,9,14
50903,80,4352,80,allow,8600,1437,7163,18,144,10,8
16776,53,16776,53,allow,197,90,107,2,30,1,1
51402,443,14600,443,allow,7788,2581,5207,39,70,19,20
65495,11392,0,0,deny,62,62,0,1,0,1,0
58969,443,56637,443,allow,2768,1593,1175,22,21,11,11
65471,53,50193,53,allow,498,204,294,6,31,3,3
49867,445,0,0,drop,70,70,0,1,0,1,0
48344,443,40212,443,allow,232,172,60,3,5,2,1
53007,445,0,0,drop,70,70,0,1,0,1,0
59889,30188,0,0,deny,66,66,0,1,0,1,0
55513,53,13816,53,allow,184,94,90,2,30,1,1
64436,445,0,0,drop,70,70,0,1,0,1,0
42490,1433,0,0,deny,60,60,0,1,0,1,0
49168,53,14343,53,allow,196,102,94,2,30,1,1
44638,443,36875,443,allow,20062,11233,8829,48,94,29,19
56791,53,55367,53,allow,250,87,163,4,58,2,2
63200,445,0,0,drop,70,70,0,1,0,1,0
60976,22114,0,0,deny,66,66,0,1,0,1,0
64144,445,0,0,drop,70,70,0,1,0,1,0
58575,445,0,0,drop,70,70,0,1,0,1,0
65207,443,12429,443,allow,8188,2769,5419,22,611,12,10
65253,445,0,0,drop,70,70,0,1,0,1,0
58392,3389,58392,3389,allow,4624,1524,3100,17,17,9,8
58784,445,0,0,drop,66,66,0,1,0,1,0
55238,443,54700,443,allow,6165,1407,4758,21,45,12,9
52150,445,0,0,drop,66,66,0,1,0,1,0
55718,16805,50581,16805,allow,70,70,0,1,5,1,0
43616,5228,36276,5228,allow,2322,1296,1026,15,3600,6,9
64113,22211,60375,22211,allow,312,132,180,6,7,3,3
56185,53,13789,53,allow,167,86,81,2,30,1,1
59974,445,0,0,drop,66,66,0,1,0,1,0
38409,443,38409,443,allow,1452,817,635,16,20,9,7
5588,5588,0,0,allow,3354,1792,1562,46,194,23,23
53871,37965,0,0,deny,66,66,0,1,0,1,0
53718,445,0,0,drop,70,70,0,1,0,1,0
56399,445,0,0,drop,70,70,0,1,0,1,0
64822,445,0,0,drop,70,70,0,1,0,1,0
65344,53,52002,53,allow,190,90,100,3,60,2,1
64869,53,31516,53,allow,195,94,101,2,30,1,1
64336,443,26343,443,allow,10099,4296,5803,30,124,13,17
55568,443,60113,443,allow,8979,5057,3922,89,110,51,38
5223,14446,0,0,deny,220,220,0,1,0,1,0
48754,443,18594,443,allow,6490,1145,5345,20,33,11,9
16660,55783,0,0,deny,62,62,0,1,0,1,0
49527,443,43125,443,allow,5968,985,4983,17,26,8,9
64552,445,0,0,drop,66,66,0,1,0,1,0
50478,445,0,0,drop,70,70,0,1,0,1,0
58638,5900,58638,5900,allow,62,62,0,1,5,1,0
64460,53,42311,53,allow,196,102,94,2,31,1,1
21641,51505,0,0,deny,62,62,0,1,0,1,0
45119,15000,61352,15000,allow,130,70,60,2,5,1,1
0,0,0,0,deny,98,98,0,1,0,1,0
65189,27202,50060,27202,allow,230,78,152,2,29,1,1
59173,445,0,0,drop,66,66,0,1,0,1,0
60326,80,6892,80,allow,3697,2062,1635,16,61,9,7
49942,443,49942,443,allow,29781,5947,23834,63,47,32,31
57186,53,41154,53,allow,177,94,83,2,30,1,1
56950,53,53864,53,allow,183,94,89,2,30,1,1
63792,445,0,0,drop,70,70,0,1,0,1,0
55454,53,51580,53,allow,168,86,82,2,33,1,1
50377,80,8000,80,allow,1451,796,655,11,31,6,5
36034,35440,0,0,deny,62,62,0,1,0,1,0
56633,80,19210,80,allow,234,234,0,4,12,4,0
59436,22114,0,0,deny,62,62,0,1,0,1,0
55220,53,55080,53,allow,758,96,662,2,30,1,1
50777,445,0,0,drop,70,70,0,1,0,1,0
56204,53,36998,53,allow,168,86,82,2,30,1,1
56223,53,26065,53,allow,768,99,669,2,30,1,1
443,60040,0,0,deny,60,60,0,1,0,1,0
62453,445,0,0,drop,70,70,0,1,0,1,0
49635,53,17449,53,allow,210,110,100,2,30,1,1
47191,443,13970,443,allow,8756,2298,6458,39,314,18,21
49418,27018,46953,27018,allow,249,71,178,2,31,1,1
59352,53,59352,53,allow,283,114,169,2,31,1,1
59394,445,0,0,drop,70,70,0,1,0,1,0
54234,445,0,0,drop,70,70,0,1,0,1,0
61960,445,0,0,drop,66,66,0,1,0,1,0
53671,80,50539,80,allow,956,502,454,12,15,7,5
34994,443,34994,443,allow,5046,2069,2977,20,15,11,9
37850,443,54127,443,allow,3595,1468,2127,13,135,6,7
64714,445,0,0,drop,70,70,0,1,0,1,0
61948,48817,0,0,deny,145,145,0,1,0,1,0
14394,443,16776,443,allow,4649,2928,1721,40,415,21,19
1067,51221,0,0,deny,62,62,0,1,0,1,0
47824,53,65037,53,allow,199,94,105,2,30,1,1
49838,53,33413,53,allow,183,94,89,2,30,1,1
50874,80,33456,80,allow,331828,15003,316825,363,141,140,223
64668,53,32390,53,allow,772,103,669,2,31,1,1
57842,445,0,0,drop,66,66,0,1,0,1,0
51880,8001,32545,8001,allow,86,86,0,1,30,1,0
19944,22114,0,0,deny,66,66,0,1,0,1,0
3478,61463,0,0,deny,857,857,0,1,0,1,0
56152,56205,0,0,deny,66,66,0,1,0,1,0
59018,445,0,0,drop,70,70,0,1,0,1,0
33876,53,33876,53,allow,404,259,145,3,32,2,1
26287,56205,0,0,deny,62,62,0,1,0,1,0
55267,53,18171,53,allow,168,86,82,2,31,1,1
31539,37965,0,0,deny,62,62,0,1,0,1,0
56487,53,32287,53,allow,194,102,92,2,30,1,1
57023,53,56230,53,allow,179,94,85,2,30,1,1
53999,445,0,0,drop,70,70,0,1,0,1,0
49921,80,16260,80,allow,1126,609,517,11,15,6,5
26504,443,26504,443,allow,1251,722,529,11,147,6,5
57325,60043,0,0,deny,66,66,0,1,0,1,0
5223,14446,0,0,deny,66,66,0,1,0,1,0
49403,53,28281,53,allow,228,102,126,2,29,1,1
61733,443,10616,443,allow,168812,5693,163119,186,21,68,118
44821,64147,0,0,deny,62,62,0,1,0,1,0
61535,445,0,0,drop,66,66,0,1,0,1,0
49614,53,25029,53,allow,380,110,270,2,29,1,1
55826,42771,0,0,deny,66,66,0,1,0,1,0
52068,80,54676,80,allow,362,240,122,7,25,5,2
49894,443,1865,443,allow,8633,2099,6534,29,35,15,14
54269,445,0,0,drop,66,66,0,1,0,1,0
64361,53,3934,53,allow,194,94,100,2,30,1,1
26424,27189,0,0,deny,66,66,0,1,0,1,0
49899,443,6307,443,allow,1820,1101,719,18,72,10,8
31404,12082,0,0,deny,100,100,0,1,0,1,0
15333,44847,0,0,deny,62,62,0,1,0,1,0
51073,443,51073,443,allow,1210,637,573,14,25,7,7
50226,445,0,0,drop,66,66,0,1,0,1,0
49236,53,40534,53,allow,723,102,621,2,30,1,1
53791,53,19031,53,allow,102,102,0,1,30,1,0
55654,53,20360,53,allow,726,85,641,2,31,1,1
46792,443,1807,443,allow,7298,2661,4637,21,18,11,10
15131,50584,0,0,deny,62,62,0,1,0,1,0
49781,445,0,0,drop,70,70,0,1,0,1,0
52038,14487,18653,14487,allow,70,70,0,2,7,2,0
43976,80,46864,80,allow,130,70,60,2,15,1,1
19999,30170,0,0,deny,145,145,0,1,0,1,0
53235,445,0,0,drop,70,70,0,1,0,1,0
54277,22114,0,0,deny,146,146,0,1,0,1,0
50506,10214,0,0,deny,66,66,0,1,0,1,0
57550,445,0,0,drop,66,66,0,1,0,1,0
51502,445,0,0,drop,70,70,0,1,0,1,0
54602,445,0,0,drop,66,66,0,1,0,1,0
56332,53,1947,53,allow,209,110,99,2,31,1,1
51471,445,0,0,drop,70,70,0,1,0,1,0
52931,445,0,0,drop,70,70,0,1,0,1,0
57470,10154,49581,10154,allow,924,924,0,15,1200,15,0
49636,53,5352,53,allow,790,110,680,2,30,1,1
65194,53,10314,53,allow,178,91,87,2,31,1,1
49267,53,44367,53,allow,184,94,90,2,31,1,1
49520,445,0,0,drop,70,70,0,1,0,1,0
56303,53,31666,53,allow,177,94,83,2,30,1,1
50560,443,20442,443,allow,17710,10880,6830,44,271,25,19
44722,80,3568,80,allow,3162,1159,2003,14,16,8,6
63131,34880,2031,34880,allow,316,190,126,5,15,3,2
55912,53,11122,53,allow,199,102,97,2,30,1,1
49688,53,10693,53,allow,782,110,672,2,30,1,1
28035,443,12518,443,allow,5458,1390,4068,17,15,9,8
50550,443,16736,443,allow,4551,2140,2411,14,135,6,8
49406,445,0,0,drop,70,70,0,1,0,1,0
60441,64337,31545,64337,allow,70,70,0,2,8,2,0
42615,25174,0,0,deny,146,146,0,1,0,1,0
64488,53,18852,53,allow,291,102,189,2,29,1,1
59342,80,59342,80,allow,107768,4073,103695,177,15,58,119
52857,445,0,0,drop,66,66,0,1,0,1,0
65194,53,62268,53,allow,298,102,196,2,29,1,1
64288,443,27448,443,allow,252,70,182,3,120,1,2
1938,53,25817,53,allow,210,78,132,2,30,1,1
56204,53,35086,53,allow,195,102,93,2,30,1,1
64114,445,0,0,drop,66,66,0,1,0,1,0
26263,8168,0,0,deny,66,66,0,1,0,1,0
49962,53,32122,53,allow,402,118,284,2,30,1,1
50005,53,15477,53,allow,199,102,97,2,30,1,1
7210,22114,0,0,deny,66,66,0,1,0,1,0
49666,53,7037,53,allow,325,126,199,2,30,1,1
54062,49813,0,0,deny,62,62,0,1,0,1,0
25054,36827,0,0,deny,66,66,0,1,0,1,0
64330,53,63113,53,allow,200,94,106,2,29,1,1
60631,445,0,0,drop,70,70,0,1,0,1,0
65080,445,0,0,drop,70,70,0,1,0,1,0
60987,443,57213,443,allow,9029,2323,6706,31,16,17,14
54749,443,23422,443,allow,273283,194709,78574,1567,3312,746,821
49253,53,44015,53,allow,199,102,97,2,30,1,1
49756,53,1585,53,allow,264,89,175,4,48,2,2
52197,19845,30024,19845,allow,70,70,0,2,7,2,0
50968,80,19228,80,allow,109660,1992,107668,99,35,20,79
51920,30188,0,0,deny,66,66,0,1,0,1,0
59968,445,0,0,drop,70,70,0,1,0,1,0
47173,35440,0,0,deny,146,146,0,1,0,1,0
62668,445,0,0,drop,66,66,0,1,0,1,0
55791,445,0,0,drop,70,70,0,1,0,1,0
41267,443,45130,443,allow,8248,876,7372,25,186,9,16
53791,53,53567,53,allow,260,86,174,2,30,1,1
37549,443,18373,443,allow,203299,6930,196369,231,16,92,139
49658,443,50327,443,allow,14121,2299,11822,37,19,19,18
64797,53,45567,53,allow,216,102,114,2,30,1,1
56472,53,13780,53,allow,167,86,81,2,31,1,1
33733,443,7805,443,allow,6998,2361,4637,20,17,10,10
44155,53,24482,53,allow,168,78,90,2,29,1,1
50007,53,43367,53,allow,216,110,106,2,30,1,1
32899,443,18208,443,allow,47948,40338,7610,82,17,43,39
65053,53,65053,53,allow,235,90,145,2,31,1,1
47493,53,47493,53,allow,227,92,135,2,31,1,1
52764,445,0,0,drop,70,70,0,1,0,1,0
65206,53,46359,53,allow,167,86,81,2,30,1,1
5394,23,5394,23,allow,124,60,64,2,5,1,1
37264,443,36936,443,allow,3068,1678,1390,17,241,9,8
55466,53,26661,53,allow,177,94,83,2,29,1,1
62640,443,62640,443,allow,27723,5572,22151,59,47,31,28
56835,27582,44303,27582,allow,130,70,60,2,5,1,1
64298,443,45877,443,allow,115035,5282,109753,128,120,44,84
43916,21,0,0,deny,60,60,0,1,0,1,0
56482,445,0,0,drop,70,70,0,1,0,1,0
53651,47758,11315,47758,allow,70,70,0,1,5,1,0
57201,53,57201,53,allow,220,90,130,2,30,1,1
50013,445,0,0,drop,70,70,0,1,0,1,0
58077,36653,14563,36653,allow,204,64,140,4,10,2,2
51786,37832,38503,37832,allow,70,70,0,2,8,2,0
41252,53,41252,53,allow,398,255,143,3,32,2,1
55201,22114,0,0,deny,66,66,0,1,0,1,0
58265,445,0,0,drop,70,70,0,1,0,1,0
57398,53,47898,53,allow,232,110,122,2,30,1,1
58638,5900,0,0,deny,62,62,0,1,0,1,0
1928,53,30597,53,allow,210,78,132,2,29,1,1
55093,445,0,0,drop,70,70,0,1,0,1,0
52602,445,0,0,drop,70,70,0,1,0,1,0
55374,445,0,0,drop,70,70,0,1,0,1,0
42685,51180,0,0,deny,62,62,0,1,0,1,0
52793,443,12880,443,allow,130,70,60,2,14,1,1
35742,443,2430,443,allow,5612,1251,4361,22,65,12,10
50382,80,4705,80,allow,1369,799,570,13,77,7,6
57108,53,37838,53,allow,193,102,91,2,30,1,1
55757,53,24073,53,allow,177,94,83,2,30,1,1
56951,443,11252,443,allow,5601,1203,4398,14,60,9,5
53085,445,0,0,drop,70,70,0,1,0,1,0
24040,22114,0,0,deny,62,62,0,1,0,1,0
55030,445,0,0,drop,70,70,0,1,0,1,0
7364,50584,0,0,deny,66,66,0,1,0,1,0
38673,443,39946,443,allow,379440,8281,371159,362,16,106,256
58638,5900,58638,5900,allow,66,66,0,1,4,1,0
58744,1433,0,0,deny,60,60,0,1,0,1,0
55272,53,42714,53,allow,285,103,182,4,50,2,2
49709,445,0,0,drop,70,70,0,1,0,1,0
27005,27015,17073,27015,allow,886,126,760,2,30,1,1
57051,53,27315,53,allow,170,87,83,2,31,1,1
50529,44847,0,0,deny,66,66,0,1,0,1,0
64581,53,40086,53,allow,214,110,104,2,30,1,1
49414,53,44484,53,allow,561,112,449,4,53,2,2
50466,80,50466,80,allow,78335,7114,71221,114,22,60,54
60386,80,35408,80,allow,214,140,74,4,15,3,1
56631,80,19501,80,allow,234,234,0,4,12,4,0
65465,53,62433,53,allow,372,126,246,2,30,1,1
20724,19750,0,0,deny,78,78,0,1,0,1,0
51598,443,10892,443,allow,14194,4643,9551,34,30,19,15
49444,445,0,0,drop,70,70,0,1,0,1,0
49479,7000,49479,7000,allow,5200,3745,1455,18,15,10,8
46291,443,48252,443,allow,70,70,0,1,5,1,0
55013,53,63318,53,allow,728,102,626,2,29,1,1
542,46783,0,0,deny,62,62,0,1,0,1,0
56258,53,14638,53,allow,167,86,81,2,29,1,1
65056,53,34239,53,allow,199,102,97,2,29,1,1
64393,53,49935,53,allow,182,93,89,2,31,1,1
0,0,0,0,allow,244,244,0,2,0,2,0
3630,26467,0,0,deny,66,66,0,1,0,1,0
42939,48817,0,0,deny,156,156,0,1,0,1,0
65319,53,47160,53,allow,285,103,182,4,44,2,2
58511,50584,0,0,deny,62,62,0,1,0,1,0
49803,80,1813,80,allow,2553,1621,932,13,126,8,5
60491,38789,32066,38789,allow,320,140,180,6,7,3,3
35374,443,7317,443,allow,1558,971,587,14,123,8,6
55476,445,0,0,drop,66,66,0,1,0,1,0
65470,443,40363,443,allow,372361,11310,361051,385,16,136,249
6721,37965,0,0,deny,66,66,0,1,0,1,0
27046,51505,0,0,deny,66,66,0,1,0,1,0
56166,53,32897,53,allow,193,102,91,2,31,1,1
56038,53,40238,53,allow,177,94,83,2,29,1,1
28636,25174,0,0,deny,146,146,0,1,0,1,0
55276,445,0,0,drop,70,70,0,1,0,1,0
53869,17089,2091,17089,allow,70,70,0,2,7,2,0
50280,57470,0,0,deny,78,78,0,1,0,1,0
63062,35440,0,0,deny,62,62,0,1,0,1,0
55773,445,0,0,drop,70,70,0,1,0,1,0
61140,445,0,0,drop,70,70,0,1,0,1,0
60177,445,0,0,drop,66,66,0,1,0,1,0
60611,443,2263,443,allow,478331,21023,457308,573,211,201,372
64351,53,15747,53,allow,228,102,126,2,30,1,1
60446,6882,37809,6882,allow,70,70,0,1,5,1,0
38633,51221,0,0,deny,66,66,0,1,0,1,0
27005,27015,35363,27015,allow,884,126,758,2,31,1,1
45195,80,65375,80,allow,1115,534,581,12,15,7,5
53213,80,60340,80,allow,18040,904,17136,22,15,7,15
40599,443,12842,443,allow,89724,81316,8408,148,404,69,79
35657,48637,0,0,deny,145,145,0,1,0,1,0
53936,5915,64456,5915,allow,70,70,0,2,7,2,0
58798,443,46435,443,allow,5167,700,4467,16,15,7,9
38936,80,38936,80,allow,8429,1098,7331,16,20,8,8
39004,443,10788,443,allow,38459,27564,10895,97,189,49,48
55555,445,0,0,drop,70,70,0,1,0,1,0
51951,65387,33774,65387,allow,70,70,0,1,5,1,0
56612,53,25509,53,allow,274,87,187,4,31,2,2
59900,443,59900,443,allow,5980,1122,4858,18,58,9,9
64835,445,0,0,drop,70,70,0,1,0,1,0
50920,443,56379,443,allow,3440,2371,1069,17,96,10,7
63817,445,0,0,drop,70,70,0,1,0,1,0
63723,445,0,0,drop,70,70,0,1,0,1,0
47647,443,47647,443,allow,4565,1658,2907,19,28,11,8
54991,443,64659,443,allow,15109,5866,9243,71,362,29,42
64862,445,0,0,drop,66,66,0,1,0,1,0
27005,27056,32268,27056,allow,908,126,782,2,30,1,1
17932,53,17932,53,allow,213,87,126,2,30,1,1
61566,44847,0,0,deny,66,66,0,1,0,1,0
61850,445,0,0,drop,66,66,0,1,0,1,0
51442,443,50943,443,allow,15321,3760,11561,56,170,23,33
52203,1024,52908,1024,allow,136,136,0,3,14,3,0
64763,445,0,0,drop,70,70,0,1,0,1,0
51571,443,51571,443,allow,1724,916,808,17,128,7,10
49701,445,0,0,drop,70,70,0,1,0,1,0
18415,37965,0,0,deny,62,62,0,1,0,1,0
62068,64147,0,0,deny,66,66,0,1,0,1,0
49942,53,37670,53,allow,196,94,102,2,31,1,1
58774,443,50443,443,allow,7254,838,6416,27,290,9,18
49850,53,15104,53,allow,166,86,80,2,30,1,1
45564,443,62998,443,allow,4851,848,4003,16,16,9,7
40120,23,0,0,deny,60,60,0,1,0,1,0
27446,30188,0,0,deny,66,66,0,1,0,1,0
13160,7905,0,0,deny,62,62,0,1,0,1,0
55542,443,7716,443,allow,11550,3336,8214,52,130,25,27
55305,53,21908,53,allow,94,94,0,1,30,1,0
53864,53,0,0,allow,181,86,95,2,30,1,1
53195,443,44058,443,allow,2016,1160,856,17,46,9,8
62776,445,0,0,drop,70,70,0,1,0,1,0
57335,443,6083,443,allow,4048,3089,959,24,15,13,11
443,62732,0,0,deny,199,199,0,1,0,1,0
5588,5588,0,0,allow,3354,1792,1562,46,193,23,23
60036,161,64579,161,allow,2800,2800,0,28,111,28,0
5379,37965,0,0,deny,66,66,0,1,0,1,0
62267,445,0,0,drop,70,70,0,1,0,1,0
55532,80,8734,80,allow,3367,2346,1021,19,39,11,8
50700,445,0,0,drop,70,70,0,1,0,1,0
55659,443,55659,443,allow,25716,7632,18084,52,48,31,21
49397,80,15765,80,allow,4382,2084,2298,18,66,10,8
36410,53,36410,53,allow,268,114,154,2,30,1,1
50859,445,0,0,drop,66,66,0,1,0,1,0
55285,53,22135,53,allow,268,95,173,4,45,2,2
64522,53,42718,53,allow,230,102,128,2,31,1,1
49408,443,34465,443,allow,7967,2176,5791,27,125,14,13
57986,80,14489,80,allow,1898,1524,374,14,15,8,6
37617,443,47875,443,allow,499,425,74,4,0,3,1
62766,443,26712,443,allow,4911,3442,1469,29,322,16,13
54276,37628,0,0,deny,66,66,0,1,0,1,0
49654,53,5508,53,allow,184,94,90,2,30,1,1
64122,53,29748,53,allow,214,110,104,2,30,1,1
53027,443,45299,443,allow,26309,3035,23274,69,92,27,42
57001,53,51576,53,allow,177,94,83,2,31,1,1
53495,37807,0,0,deny,66,66,0,1,0,1,0
51118,80,26346,80,allow,1952,1118,834,21,365,11,10
54076,443,7008,443,allow,55394,4535,50859,91,170,47,44
57527,445,0,0,drop,70,70,0,1,0,1,0
56281,53,7565,53,allow,177,94,83,2,30,1,1
47454,443,6613,443,allow,21782,2823,18959,42,16,20,22
3669,53,3669,53,allow,825,99,726,2,30,1,1
56052,53,22562,53,allow,177,94,83,2,30,1,1
65219,53,39844,53,allow,410,99,311,4,56,2,2
57789,445,0,0,drop,66,66,0,1,0,1,0
65071,53,37727,53,allow,93,93,0,2,60,2,0
49171,445,0,0,drop,70,70,0,1,0,1,0
55690,443,55690,443,allow,14768,2185,12583,32,80,13,19
58276,43890,0,0,deny,66,66,0,1,0,1,0
55117,53,60693,53,allow,756,95,661,2,31,1,1
63003,445,0,0,drop,66,66,0,1,0,1,0
49960,80,58313,80,allow,9718,819,8899,19,15,9,10
53625,64147,0,0,deny,62,62,0,1,0,1,0
64561,53,6022,53,allow,209,110,99,2,30,1,1
59001,443,42456,443,allow,9860,5309,4551,25,131,14,11
65176,53,64803,53,allow,299,103,196,4,51,2,2
63968,53,37221,53,allow,200,102,98,2,30,1,1
52318,22114,0,0,deny,62,62,0,1,0,1,0
52781,445,0,0,drop,66,66,0,1,0,1,0
58327,445,0,0,drop,70,70,0,1,0,1,0
58971,445,0,0,drop,70,70,0,1,0,1,0
56769,53,26341,53,allow,195,102,93,2,30,1,1
9482,443,2770,443,allow,5657,487,5170,14,15,7,7
63294,445,0,0,drop,66,66,0,1,0,1,0
64381,53,50743,53,allow,198,102,96,2,31,1,1
46901,26672,0,0,deny,60,60,0,1,0,1,0
56766,445,0,0,drop,70,70,0,1,0,1,0
56477,445,0,0,drop,70,70,0,1,0,1,0
65204,53,50425,53,allow,183,94,89,2,29,1,1
57470,10748,14210,10748,allow,594,594,0,10,1200,10,0
46883,443,30067,443,allow,40443,5300,35143,88,134,38,50
56196,53,38043,53,allow,214,110,104,2,30,1,1
52456,445,0,0,drop,66,66,0,1,0,1,0
55206,445,0,0,drop,70,70,0,1,0,1,0
6527,53,6527,53,allow,235,90,145,2,32,1,1
55563,443,55563,443,allow,4628,1721,2907,19,30,11,8
56703,50584,0,0,deny,66,66,0,1,0,1,0
59082,443,59082,443,allow,6264,1435,4829,21,15,11,10
63972,53,23173,53,allow,186,95,91,2,30,1,1
51614,15000,49065,15000,allow,130,70,60,2,5,1,1
39132,44847,0,0,deny,62,62,0,1,0,1,0
35752,80,35752,80,allow,871846,24071,847775,900,30,326,574
56892,53,32986,53,allow,199,102,97,2,31,1,1
58638,5900,0,0,deny,62,62,0,1,0,1,0
57409,443,54706,443,allow,1054,567,487,10,15,6,4
50188,80,44459,80,allow,1746,780,966,19,56,7,12
55048,443,61796,443,allow,12799,3662,9137,40,50,22,18
34209,80,4661,80,allow,1280,586,694,10,14,5,5
54708,443,18474,443,allow,5702,1143,4559,21,41,12,9
55553,37965,0,0,deny,66,66,0,1,0,1,0
55647,53,8145,53,allow,168,86,82,2,30,1,1
49113,50584,0,0,deny,66,66,0,1,0,1,0
37597,50584,0,0,deny,66,66,0,1,0,1,0
42252,33303,0,0,deny,60,60,0,1,0,1,0
57444,443,62310,443,allow,7975,1742,6233,24,81,14,10
64721,53,36880,53,allow,212,108,104,2,30,1,1
51630,445,0,0,drop,70,70,0,1,0,1,0
57772,445,0,0,drop,70,70,0,1,0,1,0
58956,53,19380,53,allow,213,89,124,2,30,1,1
27005,32036,10706,32036,allow,876,126,750,2,30,1,1
57390,445,0,0,drop,70,70,0,1,0,1,0
55828,443,33777,443,allow,8420,4472,3948,63,450,32,31
65202,445,0,0,drop,70,70,0,1,0,1,0
50306,445,0,0,drop,70,70,0,1,0,1,0
59043,35440,0,0,deny,62,62,0,1,0,1,0
53756,443,48419,443,allow,499,425,74,4,0,3,1
55097,53,14648,53,allow,177,94,83,2,29,1,1
6712,5632,0,0,deny,60,60,0,1,0,1,0
21087,80,21087,80,allow,159790,4676,155114,177,128,67,110
26323,50584,0,0,deny,146,146,0,1,0,1,0
15333,44847,0,0,deny,62,62,0,1,0,1,0
64326,53,26486,53,allow,196,102,94,2,30,1,1
46025,80,38311,80,allow,5037,1911,3126,18,86,10,8
53730,443,15340,443,allow,499,425,74,4,0,3,1
60442,53,50367,53,allow,184,78,106,2,30,1,1
48817,42099,48817,42099,allow,479,152,327,2,1200,1,1
14350,56205,0,0,deny,62,62,0,1,0,1,0
36337,443,41043,443,allow,3781,1917,1864,23,396,7,16
65189,28115,45956,28115,allow,284,78,206,2,29,1,1
49937,80,61073,80,allow,1130,613,517,11,15,6,5
61288,23,0,0,deny,60,60,0,1,0,1,0
27005,27016,61455,27016,allow,881,126,755,2,31,1,1
59204,443,10417,443,allow,9335,3052,6283,25,125,11,14
57090,53,19646,53,allow,198,102,96,2,30,1,1
49210,33757,6282,33757,allow,70,70,0,1,5,1,0
46830,80,6947,80,allow,1764,751,1013,10,16,6,4
54109,445,0,0,drop,70,70,0,1,0,1,0
58614,53,27670,53,allow,218,78,140,2,31,1,1
53618,445,0,0,drop,70,70,0,1,0,1,0
53723,51501,50854,51501,allow,70,70,0,2,7,2,0
55274,53,15789,53,allow,711,87,624,2,30,1,1
57470,47191,13630,47191,allow,528,528,0,9,1200,9,0
55715,34309,29460,34309,allow,260,140,120,5,8,3,2
52941,445,0,0,drop,70,70,0,1,0,1,0
58638,5900,0,0,deny,62,62,0,1,0,1,0
55999,443,22014,443,allow,3640,606,3034,13,120,6,7
52034,26467,0,0,deny,62,62,0,1,0,1,0
62388,39004,0,0,deny,145,145,0,1,0,1,0
27005,32039,29232,32039,allow,883,126,757,2,31,1,1
51879,38564,27585,38564,allow,70,70,0,2,8,2,0
28792,22,0,0,deny,60,60,0,1,0,1,0
52493,443,57807,443,allow,32907,8900,24007,38,16,16,22
27005,27016,9591,27016,allow,884,126,758,2,30,1,1
22807,443,22807,443,allow,4518,1665,2853,19,25,11,8
56746,443,56746,443,allow,68504,9909,58595,93,62,46,47
50611,445,0,0,drop,66,66,0,1,0,1,0
51035,445,0,0,drop,70,70,0,1,0,1,0
54819,3389,54819,3389,allow,3327,1438,1889,15,17,8,7
32701,23,0,0,deny,60,60,0,1,0,1,0
56738,53,54145,53,allow,264,87,177,4,36,2,2
50265,44843,10747,44843,allow,70,70,0,1,1200,1,0
60129,55442,0,0,deny,66,66,0,1,0,1,0
38405,443,30504,443,allow,9876,1976,7900,27,27,13,14
51369,445,0,0,drop,66,66,0,1,0,1,0
56529,80,56529,80,allow,1915,1466,449,10,20,6,4
50020,53,1594,53,allow,210,102,108,2,30,1,1
1078,30975,0,0,deny,143,143,0,1,0,1,0
60684,80,43634,80,allow,1737,796,941,12,16,7,5
60052,445,0,0,drop,66,66,0,1,0,1,0
52066,80,29968,80,allow,692,300,392,9,26,6,3
58294,443,58294,443,allow,7356,1014,6342,20,76,10,10
27785,37965,0,0,deny,66,66,0,1,0,1,0
58121,445,0,0,drop,66,66,0,1,0,1,0
50946,44847,0,0,deny,62,62,0,1,0,1,0
65080,53,49569,53,allow,193,102,91,2,29,1,1
50820,57470,0,0,deny,66,66,0,1,0,1,0
9212,51505,0,0,deny,62,62,0,1,0,1,0
64595,64147,0,0,deny,66,66,0,1,0,1,0
50609,80,7480,80,allow,12986,6816,6170,26,26,12,14
63848,445,0,0,drop,70,70,0,1,0,1,0
57598,80,57598,80,allow,1810,821,989,10,20,6,4
57470,59208,35897,59208,allow,1367,664,703,16,1199,9,7
33028,80,50046,80,allow,130,70,60,2,15,1,1
50298,37965,0,0,deny,62,62,0,1,0,1,0
65525,443,9387,443,allow,92247,4799,87448,107,15,43,64
40418,25174,0,0,deny,66,66,0,1,0,1,0
58101,53,38765,53,allow,86,86,0,1,30,1,0
41790,443,64093,443,allow,2350,1392,958,17,275,9,8
30729,22114,0,0,deny,66,66,0,1,0,1,0
51754,7000,51754,7000,allow,4727,2346,2381,19,16,12,7
50444,445,0,0,drop,70,70,0,1,0,1,0
52171,63033,49679,63033,allow,70,70,0,2,8,2,0
56015,56205,0,0,deny,66,66,0,1,0,1,0
5612,53,5612,53,allow,227,89,138,2,30,1,1
52221,53,60196,53,allow,164,78,86,2,29,1,1
60377,443,48988,443,allow,8588,2020,6568,20,76,10,10
56413,53,30670,53,allow,224,94,130,2,30,1,1
58020,80,7358,80,allow,2482,516,1966,11,75,6,5
64534,445,0,0,drop,66,66,0,1,0,1,0
48652,443,38749,443,allow,6388,964,5424,21,255,11,10
23719,22114,0,0,deny,146,146,0,1,0,1,0
57326,53,16719,53,allow,180,94,86,2,35,1,1
56215,53,45300,53,allow,168,78,90,2,29,1,1
45908,33330,0,0,deny,60,60,0,1,0,1,0
64811,51221,0,0,deny,62,62,0,1,0,1,0
62935,445,0,0,drop,66,66,0,1,0,1,0
61898,50584,0,0,deny,66,66,0,1,0,1,0
52210,51505,0,0,deny,62,62,0,1,0,1,0
51414,22,0,0,deny,60,60,0,1,0,1,0
61185,54532,0,0,deny,62,62,0,1,0,1,0
55375,53,30516,53,allow,214,110,104,2,30,1,1
41332,80,41332,80,allow,230861,5063,225798,227,18,74,153
63072,443,30970,443,allow,304,86,218,2,30,1,1
22275,51505,0,0,deny,62,62,0,1,0,1,0
65136,445,0,0,drop,70,70,0,1,0,1,0
58638,5900,0,0,deny,62,62,0,1,0,1,0
12128,37965,0,0,deny,62,62,0,1,0,1,0
57418,53,45442,53,allow,165,86,79,2,30,1,1
46731,443,46731,443,allow,4603,1696,2907,19,30,11,8
11716,37965,0,0,deny,62,62,0,1,0,1,0
55154,53,39546,53,allow,184,94,90,2,30,1,1
49601,53,32118,53,allow,178,94,84,2,30,1,1
49977,57470,0,0,deny,62,62,0,1,0,1,0
55836,53,32275,53,allow,178,91,87,2,31,1,1
58638,5900,0,0,deny,62,62,0,1,0,1,0
57385,53,7964,53,allow,197,102,95,2,30,1,1
55867,53,6696,53,allow,184,94,90,2,30,1,1
56766,53,19363,53,allow,210,110,100,2,30,1,1
54473,37807,0,0,deny,66,66,0,1,0,1,0
45964,2666,0,0,deny,60,60,0,1,0,1,0
65515,53,18245,53,allow,195,102,93,2,31,1,1
60442,49556,41273,49556,allow,624,318,306,10,15,5,5
57025,53,3380,53,allow,168,86,82,2,31,1,1
52998,443,34422,443,allow,57778,2562,55216,73,200,29,44
64797,445,0,0,drop,70,70,0,1,0,1,0
55936,53,2278,53,allow,170,87,83,2,30,1,1
34157,443,57470,443,allow,154,94,60,2,5,1,1
64931,53,32751,53,allow,174,89,85,2,31,1,1
49556,53,40428,53,allow,300,100,200,4,44,2,2
57208,53,63369,53,allow,182,93,89,2,31,1,1
56648,445,0,0,drop,70,70,0,1,0,1,0
51827,56205,0,0,deny,66,66,0,1,0,1,0
53043,51050,0,0,deny,62,62,0,1,0,1,0
54904,445,0,0,drop,66,66,0,1,0,1,0
65004,53,7635,53,allow,261,102,159,2,30,1,1
22922,35440,0,0,deny,66,66,0,1,0,1,0
62386,37965,0,0,deny,66,66,0,1,0,1,0
50654,123,28946,123,allow,184,94,90,2,30,1,1
56092,56205,0,0,deny,146,146,0,1,0,1,0
64763,53,14685,53,allow,214,110,104,2,30,1,1
62794,445,0,0,drop,66,66,0,1,0,1,0
61372,445,0,0,drop,70,70,0,1,0,1,0
58312,445,0,0,drop,70,70,0,1,0,1,0
42745,50011,0,0,deny,62,62,0,1,0,1,0
64319,53,2772,53,allow,193,102,91,2,30,1,1
62348,50584,0,0,deny,66,66,0,1,0,1,0
62846,445,0,0,drop,70,70,0,1,0,1,0
64986,53,8227,53,allow,180,94,86,2,30,1,1
56415,53,33684,53,allow,199,102,97,2,29,1,1
54316,53,0,0,allow,325,77,248,2,31,1,1
11491,53,11491,53,allow,247,98,149,2,32,1,1
53888,443,42576,443,allow,8935,4627,4308,22,121,12,10
21604,50201,0,0,deny,62,62,0,1,0,1,0
34916,51185,0,0,deny,62,62,0,1,0,1,0
34636,23,0,0,deny,60,60,0,1,0,1,0
61687,80,48451,80,allow,11437,2775,8662,32,53,15,17
49554,80,58941,80,allow,1515,481,1034,11,15,6,5
65057,53,5504,53,allow,199,102,97,2,30,1,1
53725,443,12003,443,allow,499,425,74,4,0,3,1
60791,443,31785,443,allow,15013,10159,4854,34,46,19,15
38639,80,55224,80,allow,1013,504,509,10,15,6,4
60702,445,0,0,drop,70,70,0,1,0,1,0
64689,53,48296,53,allow,183,94,89,2,30,1,1
64144,53,47875,53,allow,193,102,91,2,30,1,1
50105,53,29739,53,allow,969,86,883,2,30,1,1
57545,443,29665,443,allow,25540,8247,17293,187,574,79,108
49772,80,25587,80,allow,1155,781,374,10,15,6,4
59287,445,0,0,drop,70,70,0,1,0,1,0
57412,445,0,0,drop,66,66,0,1,0,1,0
55336,53,13699,53,allow,295,101,194,4,31,2,2
51560,46783,0,0,deny,62,62,0,1,0,1,0
55449,443,46191,443,allow,480989,16896,464093,507,22,178,329
52929,43890,0,0,deny,62,62,0,1,0,1,0
49692,53,33543,53,allow,212,110,102,2,30,1,1
51893,445,0,0,drop,66,66,0,1,0,1,0
50418,445,0,0,drop,70,70,0,1,0,1,0
50892,80,51133,80,allow,256436,14131,242305,283,141,111,172
56547,445,0,0,drop,70,70,0,1,0,1,0
60923,445,0,0,drop,70,70,0,1,0,1,0
32215,22114,0,0,deny,62,62,0,1,0,1,0
53486,445,0,0,drop,70,70,0,1,0,1,0
55706,53,9851,53,allow,258,102,156,2,30,1,1
52918,445,0,0,drop,70,70,0,1,0,1,0
53930,19831,49369,19831,allow,70,70,0,2,7,2,0
21817,22114,0,0,deny,62,62,0,1,0,1,0
56098,55442,0,0,deny,66,66,0,1,0,1,0
57894,44847,0,0,deny,66,66,0,1,0,1,0
51092,445,0,0,drop,66,66,0,1,0,1,0
63571,443,39273,443,allow,1882441,60775,1821666,2129,129,795,1334
61478,445,0,0,drop,70,70,0,1,0,1,0
64578,53,11531,53,allow,193,102,91,2,30,1,1
56922,53,40001,53,allow,168,86,82,2,30,1,1
51559,26467,0,0,deny,66,66,0,1,0,1,0
49487,53,26714,53,allow,183,94,89,2,31,1,1
59487,53,59487,53,allow,211,80,131,2,30,1,1
11362,64147,0,0,deny,145,145,0,1,0,1,0
47010,53,59094,53,allow,294,94,200,2,30,1,1
65260,53,28900,53,allow,184,94,90,2,30,1,1
49528,53,57566,53,allow,177,94,83,2,30,1,1
64605,445,0,0,drop,70,70,0,1,0,1,0
49418,27015,8182,27015,allow,252,78,174,2,29,1,1
49922,80,11141,80,allow,1126,609,517,11,15,6,5
60180,31573,0,0,deny,146,146,0,1,0,1,0
43916,21,0,0,deny,60,60,0,1,0,1,0
49485,443,26234,443,allow,49823,7236,42587,56,29,20,36
56045,445,0,0,drop,70,70,0,1,0,1,0
14447,25174,0,0,deny,62,62,0,1,0,1,0
57969,53,57969,53,allow,194,87,107,2,31,1,1
47918,443,24262,443,allow,7936,2847,5089,15,120,7,8
50534,53,50534,53,allow,216,88,128,2,30,1,1
58485,40740,0,0,deny,145,145,0,1,0,1,0
50621,53,54722,53,allow,256,93,163,2,31,1,1
57235,15187,23276,15187,allow,1269359015,948477220,320881795,1036116,9283,747520,288596
61398,445,0,0,drop,66,66,0,1,0,1,0
65023,53,34897,53,allow,587,104,483,4,40,2,2
49905,53,29720,53,allow,180,94,86,2,30,1,1
56773,445,0,0,drop,70,70,0,1,0,1,0
55782,53,3411,53,allow,238,87,151,2,30,1,1
56192,53,30886,53,allow,177,94,83,2,30,1,1
51935,38639,36468,38639,allow,70,70,0,1,5,1,0
58638,5900,0,0,deny,62,62,0,1,0,1,0
54717,445,0,0,drop,66,66,0,1,0,1,0
49994,26467,0,0,deny,62,62,0,1,0,1,0
57992,80,4887,80,allow,10247,3696,6551,32,33,16,16
54977,445,0,0,drop,70,70,0,1,0,1,0
63876,5968,28223,5968,allow,66,66,0,2,8,2,0
62486,445,0,0,drop,66,66,0,1,0,1,0
62327,443,62327,443,allow,1210,637,573,14,51,7,7
65323,53,20486,53,allow,193,102,91,2,30,1,1
49248,53,1565,53,allow,301,90,211,4,46,2,2
56041,53,39211,53,allow,185,102,83,2,31,1,1
58420,445,0,0,drop,70,70,0,1,0,1,0
49806,53,49806,53,allow,229,89,140,2,31,1,1
47612,5228,36863,5228,allow,2880,1648,1232,22,3602,10,12
16387,61049,0,0,deny,60,60,0,1,0,1,0
59862,445,0,0,drop,70,70,0,1,0,1,0
39393,22114,0,0,deny,146,146,0,1,0,1,0
49567,53,35834,53,allow,168,86,82,2,30,1,1
53344,445,0,0,drop,70,70,0,1,0,1,0
63076,443,26735,443,allow,304,86,218,2,31,1,1
50437,53,50192,53,allow,413,170,243,6,30,3,3
62915,993,36226,993,allow,8257,4187,4070,70,43,42,28
60245,445,0,0,drop,66,66,0,1,0,1,0
3478,61463,0,0,deny,343,343,0,1,0,1,0
53771,64351,44787,64351,allow,70,70,0,2,8,2,0
52374,445,0,0,drop,70,70,0,1,0,1,0
50611,80,6797,80,allow,2933,1237,1696,12,20,7,5
51179,445,0,0,drop,66,66,0,1,0,1,0
52189,24190,59596,24190,allow,70,70,0,1,5,1,0
53366,445,0,0,drop,66,66,0,1,0,1,0
63810,27064,25460,27064,allow,1778,1386,392,8,31,4,4
33264,53,24560,53,allow,164,78,86,2,30,1,1
54415,445,0,0,drop,70,70,0,1,0,1,0
53823,443,24155,443,allow,499,425,74,4,0,3,1
61925,51505,0,0,deny,62,62,0,1,0,1,0
54196,11392,0,0,deny,66,66,0,1,0,1,0
56500,80,50985,80,allow,177736,11174,166562,198,63,77,121
61230,53,16263,53,allow,177,94,83,2,29,1,1
53822,25174,0,0,deny,66,66,0,1,0,1,0
48016,57470,0,0,deny,62,62,0,1,0,1,0
53916,443,57375,443,allow,499,425,74,4,0,3,1
49660,443,16842,443,allow,3721,1477,2244,15,121,8,7
51134,3389,51134,3389,allow,4213,2429,1784,18,32,9,9
53163,443,16194,443,allow,7432,1694,5738,23,27,12,11
31994,53,31994,53,allow,244,98,146,2,33,1,1
65180,53,35991,53,allow,199,102,97,2,30,1,1
6881,1564,62594,1564,allow,324,150,174,2,1200,1,1
51934,36180,0,0,deny,62,62,0,1,0,1,0
58436,443,57353,443,allow,18290,3012,15278,46,136,24,22
64723,53,38339,53,allow,165,86,79,2,30,1,1
49160,13917,61966,13917,allow,150,150,0,1,1201,1,0
56496,53,21788,53,allow,164,86,78,2,30,1,1
52250,445,0,0,drop,70,70,0,1,0,1,0
34856,443,47870,443,allow,7524,1903,5621,31,22,18,13
58524,445,0,0,drop,70,70,0,1,0,1,0
65074,443,20920,443,allow,7584,7094,490,14,124,7,7
49898,80,5457,80,allow,1550,1157,393,8,86,5,3
65167,53,20946,53,allow,219,94,125,2,30,1,1
49929,26467,0,0,deny,66,66,0,1,0,1,0
51598,56079,0,0,deny,66,66,0,1,0,1,0
49418,49000,14471,49000,allow,270,78,192,2,30,1,1
56355,53,13355,53,allow,184,94,90,2,30,1,1
15503,56331,21797,56331,allow,481,150,331,2,1200,1,1
36430,443,61120,443,allow,3777,1509,2268,18,120,9,9
65477,443,34529,443,allow,409770,12150,397620,421,16,148,273
8999,57470,0,0,deny,146,146,0,1,0,1,0
56358,53,16023,53,allow,104,104,0,1,30,1,0
49760,80,49760,80,allow,613303,16858,596445,666,143,251,415
64403,53,2532,53,allow,199,102,97,2,31,1,1
50052,65008,0,0,deny,60,60,0,1,0,1,0
55127,53,18845,53,allow,253,87,166,4,44,2,2
57170,3389,57170,3389,allow,3413,1458,1955,16,19,8,8
60600,445,0,0,drop,70,70,0,1,0,1,0
64643,53,40117,53,allow,177,94,83,2,30,1,1
49328,53,46932,53,allow,748,94,654,2,30,1,1
17750,1024,34469,1024,allow,323,150,173,2,1200,1,1
33070,80,34842,80,allow,3483,1578,1905,17,186,10,7
35940,47808,0,0,deny,60,60,0,1,0,1,0
56919,445,0,0,drop,70,70,0,1,0,1,0
58724,443,37298,443,allow,21610,9250,12360,40,17,19,21
51382,56205,0,0,deny,66,66,0,1,0,1,0
56652,443,7084,443,allow,8006,1986,6020,20,15,11,9
52699,26467,0,0,deny,62,62,0,1,0,1,0
55130,25174,0,0,deny,66,66,0,1,0,1,0
55131,53,55323,53,allow,244,94,150,2,30,1,1
2238,22114,0,0,deny,146,146,0,1,0,1,0
30114,65151,0,0,deny,60,60,0,1,0,1,0
52274,80,52274,80,allow,852970,14195,838775,769,28,207,562
64324,53,40799,53,allow,179,94,85,2,29,1,1
50017,443,54344,443,allow,51055,17321,33734,147,612,77,70
63047,443,26730,443,allow,304,86,218,2,30,1,1
4257,35440,0,0,deny,62,62,0,1,0,1,0
58889,15000,32384,15000,allow,138,78,60,2,6,1,1
50084,26672,0,0,deny,62,62,0,1,0,1,0
55686,44049,11130,44049,allow,504,318,186,8,15,5,3
32342,62413,0,0,deny,62,62,0,1,0,1,0
36256,443,38729,443,allow,3936219,107920,3828299,3880,132,1208,2672
49495,443,17412,443,allow,12452,10841,1611,26,27,14,12
48817,49157,48817,49157,allow,328,152,176,2,1200,1,1
45295,443,2561,443,allow,6864,1633,5231,20,315,10,10
55600,22,0,0,deny,60,60,0,1,0,1,0
14597,53,14597,53,allow,404,259,145,3,32,2,1
56217,53,54817,53,allow,182,93,89,2,31,1,1
22916,25174,0,0,deny,62,62,0,1,0,1,0
59227,445,0,0,drop,70,70,0,1,0,1,0
55609,53,45313,53,allow,172,88,84,2,30,1,1
48817,46429,48817,46429,allow,763,296,467,4,1200,2,2
54721,22114,0,0,deny,62,62,0,1,0,1,0
33871,443,48273,443,allow,11277,2233,9044,43,215,20,23
43226,443,42884,443,allow,1583877,43930,1539947,1405,93,297,1108
45051,23,0,0,deny,60,60,0,1,0,1,0
58243,445,0,0,drop,70,70,0,1,0,1,0
58638,5900,0,0,deny,62,62,0,1,0,1,0
53448,445,0,0,drop,66,66,0,1,0,1,0
55989,443,55989,443,allow,4378,1471,2907,19,29,11,8
49709,443,24927,443,allow,523518,15431,508087,466,210,109,357
44059,53,51061,53,allow,199,94,105,2,30,1,1
60166,80,1732,80,allow,186,64,122,4,28,2,2
5664,36237,0,0,deny,66,66,0,1,0,1,0
53506,445,0,0,drop,66,66,0,1,0,1,0
49435,443,3627,443,allow,10377,3140,7237,23,52,11,12
46328,443,26248,443,allow,446664,48034,398630,698,223,326,372
54853,443,64447,443,allow,7689,3574,4115,65,308,32,33
50911,445,0,0,drop,70,70,0,1,0,1,0
50770,445,0,0,drop,70,70,0,1,0,1,0
62296,445,0,0,drop,66,66,0,1,0,1,0
40547,24051,0,0,deny,74,74,0,1,0,1,0
9529,26467,0,0,deny,62,62,0,1,0,1,0
50958,53,30226,53,allow,264,264,0,4,47,4,0
51148,443,4211,443,allow,4942,2409,2533,11,120,6,5
0,0,0,0,allow,320,320,0,5,0,5,0
50066,445,0,0,drop,70,70,0,1,0,1,0
58805,443,39224,443,allow,9030,2311,6719,24,362,13,11
56235,53,15523,53,allow,199,94,105,2,30,1,1
51251,443,24124,443,allow,7950,2502,5448,38,16,22,16
56642,80,4720,80,allow,234,234,0,4,12,4,0
55527,80,13344,80,allow,20513,1960,18553,39,21,18,21
5180,80,5180,80,allow,33443,797,32646,33,16,9,24
43024,53,45972,53,allow,198,93,105,2,30,1,1
60581,445,0,0,drop,70,70,0,1,0,1,0
50491,53,0,0,allow,183,86,97,2,29,1,1
25151,58833,0,0,deny,62,62,0,1,0,1,0
57131,31061,0,0,deny,145,145,0,1,0,1,0
49932,53,49932,53,allow,404,259,145,3,32,2,1
60308,37965,0,0,deny,66,66,0,1,0,1,0
56521,53,35277,53,allow,305,86,219,2,30,1,1
49994,445,0,0,drop,70,70,0,1,0,1,0
59911,80,3482,80,allow,2025658,45348,1980310,1992,44,640,1352
61421,443,24287,443,allow,7206,1897,5309,20,21,11,9
13917,18033,0,0,deny,62,62,0,1,0,1,0
60627,51050,0,0,deny,66,66,0,1,0,1,0
49978,53,17082,53,allow,195,102,93,2,31,1,1
26085,10387,0,0,deny,148,148,0,1,0,1,0
49493,80,3964,80,allow,143422,12598,130824,226,487,52,174
53482,445,0,0,drop,70,70,0,1,0,1,0
49988,53,19025,53,allow,214,102,112,2,30,1,1
56511,445,0,0,drop,70,70,0,1,0,1,0
64904,53,60868,53,allow,198,101,97,2,31,1,1
55142,26467,0,0,deny,66,66,0,1,0,1,0
59346,445,0,0,drop,70,70,0,1,0,1,0
61936,443,38328,443,allow,4348,1643,2705,14,138,6,8
50367,53,23115,53,allow,198,102,96,2,30,1,1
27005,33084,13746,33084,allow,906,126,780,2,30,1,1
52181,1038,23058,1038,allow,70,70,0,2,8,2,0
51993,25174,0,0,deny,66,66,0,1,0,1,0
65040,53,46633,53,allow,180,94,86,2,29,1,1
54835,443,59753,443,allow,678,280,398,11,26,5,6
48905,80,43588,80,allow,1868,1374,494,12,15,7,5
64091,80,64091,80,allow,2244,1505,739,11,146,6,5
49611,19000,49520,19000,allow,594,174,420,2,31,1,1
51764,443,51764,443,allow,4632,1725,2907,19,27,11,8
52002,34348,16658,34348,allow,70,70,0,2,7,2,0
54737,50584,0,0,deny,66,66,0,1,0,1,0
61550,5529,0,0,deny,145,145,0,1,0,1,0
64554,53,25900,53,allow,198,101,97,2,31,1,1
38306,51221,0,0,deny,62,62,0,1,0,1,0
16768,53,24708,53,allow,199,94,105,2,30,1,1
47279,443,50478,443,allow,7948,1520,6428,21,16,13,8
49574,53,2504,53,allow,496,92,404,4,58,2,2
49663,445,0,0,drop,70,70,0,1,0,1,0
48786,443,62894,443,allow,7130,1890,5240,25,33,12,13
56765,53,52854,53,allow,711,87,624,2,30,1,1
56615,80,9225,80,allow,234,234,0,4,11,4,0
55480,53,36431,53,allow,378,97,281,4,33,2,2
35501,53,35501,53,allow,213,79,134,2,33,1,1
57101,445,0,0,drop,70,70,0,1,0,1,0
65392,443,55705,443,allow,5939,772,5167,17,27,9,8
50657,80,54275,80,allow,23292,2267,21025,28,21,10,18
52155,63867,61917,63867,allow,70,70,0,1,5,1,0
3117,37965,0,0,deny,62,62,0,1,0,1,0
56660,443,12588,443,allow,1579,988,591,13,25,7,6
64612,445,0,0,drop,66,66,0,1,0,1,0
38633,443,44108,443,allow,3448,1619,1829,18,18,8,10
53736,37168,47120,37168,allow,70,70,0,2,7,2,0
61229,53,16392,53,allow,261,261,0,4,47,4,0
55820,53,6966,53,allow,168,86,82,2,31,1,1
50190,53,51481,53,allow,754,94,660,2,30,1,1
52804,443,52702,443,allow,70,70,0,2,154,2,0
17008,35440,0,0,deny,146,146,0,1,0,1,0
58884,15000,25949,15000,allow,138,78,60,2,5,1,1
56121,53,17284,53,allow,207,86,121,2,30,1,1
58638,5900,0,0,deny,62,62,0,1,0,1,0
49945,445,0,0,drop,70,70,0,1,0,1,0
42094,35440,0,0,deny,62,62,0,1,0,1,0
60212,445,0,0,drop,70,70,0,1,0,1,0
56357,53,35688,53,allow,270,110,160,2,30,1,1
49378,53,42308,53,allow,306,94,212,2,30,1,1
49218,5222,44351,5222,allow,85080,31769,53311,661,1172,305,356
61723,445,0,0,drop,66,66,0,1,0,1,0
40185,64147,0,0,deny,66,66,0,1,0,1,0
58055,80,48571,80,allow,3791,2804,987,14,31,8,6
34811,56205,0,0,deny,62,62,0,1,0,1,0
10056,443,53947,443,allow,12677,10470,2207,42,80,23,19
52122,43073,9475,43073,allow,70,70,0,2,8,2,0
6712,5060,0,0,deny,410,410,0,1,0,1,0
50376,443,64568,443,allow,7738,879,6859,19,27,10,9
54137,445,0,0,drop,66,66,0,1,0,1,0
7877,22114,0,0,deny,66,66,0,1,0,1,0
56574,443,10843,443,allow,6974,1513,5461,21,81,11,10
46966,5222,45433,5222,allow,12521,2892,9629,64,356,27,37
65353,53,55498,53,allow,351,105,246,4,57,2,2
56985,53,39491,53,allow,165,86,79,2,30,1,1
60456,58675,9788,58675,allow,1307,786,521,15,16,8,7
15296,37965,0,0,deny,66,66,0,1,0,1,0
57281,53,58597,53,allow,711,87,624,2,31,1,1
63651,445,0,0,drop,70,70,0,1,0,1,0
18331,53,15455,53,allow,376,94,282,2,30,1,1
56609,443,13546,443,allow,11061,1566,9495,25,19,13,12
32554,34729,0,0,deny,62,62,0,1,0,1,0
52990,445,0,0,drop,70,70,0,1,0,1,0
65380,53,28417,53,allow,180,94,86,2,30,1,1
49332,53,39051,53,allow,740,93,647,2,31,1,1
27988,40005,15276,40005,allow,148,86,62,2,30,1,1
6666,8888,0,0,deny,60,60,0,1,0,1,0
12929,41864,0,0,deny,145,145,0,1,0,1,0
49876,443,4745,443,allow,5993,974,5019,19,54,10,9
51202,53,51202,53,allow,221,89,132,2,30,1,1
55292,445,0,0,drop,66,66,0,1,0,1,0
55796,53,36094,53,allow,196,102,94,2,30,1,1
51009,445,0,0,drop,70,70,0,1,0,1,0
65469,53,59478,53,allow,190,97,93,2,30,1,1
28221,37965,0,0,deny,62,62,0,1,0,1,0
27005,27015,65142,27015,allow,883,126,757,2,30,1,1
12230,53,12230,53,allow,216,90,126,2,29,1,1
50297,445,0,0,drop,66,66,0,1,0,1,0
60539,445,0,0,drop,70,70,0,1,0,1,0
42861,443,12903,443,allow,2337,1394,943,17,275,9,8
59692,443,65414,443,allow,6129,3123,3006,12,120,7,5
56077,80,49245,80,allow,2481,529,1952,11,75,6,5
56713,53,30137,53,allow,226,110,116,2,30,1,1
49403,445,0,0,drop,66,66,0,1,0,1,0
64722,53,22432,53,allow,184,94,90,2,31,1,1
49742,53,51185,53,allow,216,110,106,2,30,1,1
55935,445,0,0,drop,70,70,0,1,0,1,0
56893,445,0,0,drop,66,66,0,1,0,1,0
26528,51221,0,0,deny,78,78,0,1,0,1,0
63458,443,33627,443,allow,7934,1372,6562,25,63,12,13
50699,445,0,0,drop,70,70,0,1,0,1,0
52650,36237,0,0,deny,62,62,0,1,0,1,0
53130,80,42031,80,allow,3683,606,3077,12,15,6,6
51697,445,0,0,drop,66,66,0,1,0,1,0
35098,443,17186,443,allow,7703,1606,6097,23,80,13,10
50864,53,14255,53,allow,199,94,105,2,30,1,1
55333,445,0,0,drop,70,70,0,1,0,1,0
50642,53,41798,53,allow,165,86,79,2,30,1,1
61192,35440,0,0,deny,146,146,0,1,0,1,0
58706,80,52999,80,allow,4175,3452,723,14,15,7,7
443,47582,0,0,deny,85,85,0,1,0,1,0
50419,26467,0,0,deny,62,62,0,1,0,1,0
62067,80,14393,80,allow,1862,616,1246,11,15,6,5
43487,443,8725,443,allow,6886,1291,5595,27,285,15,12
54391,80,1850,80,allow,1378,808,570,13,361,7,6
50626,443,22681,443,allow,1604,987,617,16,93,9,7
51205,445,0,0,drop,70,70,0,1,0,1,0
49512,443,49512,443,allow,217225,47956,169269,284,64,149,135
55109,445,0,0,drop,70,70,0,1,0,1,0
51734,445,0,0,drop,70,70,0,1,0,1,0
51619,15000,21734,15000,allow,130,70,60,2,6,1,1
64857,53,57218,53,allow,332,104,228,2,30,1,1
55126,53,18152,53,allow,193,102,91,2,30,1,1
55133,445,0,0,drop,70,70,0,1,0,1,0
49810,80,21965,80,allow,1469,979,490,10,125,6,4
64644,53,30010,53,allow,364,89,275,4,33,2,2
10753,22114,0,0,deny,146,146,0,1,0,1,0
60997,445,0,0,drop,70,70,0,1,0,1,0
58638,5900,0,0,deny,62,62,0,1,0,1,0
5223,22981,0,0,deny,60,60,0,1,0,1,0
55487,53,11679,53,allow,195,102,93,2,30,1,1
9504,25174,0,0,deny,62,62,0,1,0,1,0
51573,445,0,0,drop,66,66,0,1,0,1,0
50242,445,0,0,drop,70,70,0,1,0,1,0
49749,53,61513,53,allow,200,102,98,2,30,1,1
57905,80,48820,80,allow,12974,3246,9728,29,29,16,13
64854,53,60425,53,allow,178,94,84,2,30,1,1
53979,80,42117,80,allow,64091,62467,1624,61,16,48,13
54236,445,0,0,drop,70,70,0,1,0,1,0
6889,48817,0,0,deny,143,143,0,1,0,1,0
54794,445,0,0,drop,66,66,0,1,0,1,0
56552,53,11395,53,allow,190,97,93,2,31,1,1
3765,64147,0,0,deny,62,62,0,1,0,1,0
51531,443,29173,443,allow,898,460,438,12,39,5,7
8414,8414,6179,8414,allow,66,66,0,1,30,1,0
49396,445,0,0,drop,66,66,0,1,0,1,0
50535,53,14934,53,allow,210,110,100,2,29,1,1
50784,50584,0,0,deny,62,62,0,1,0,1,0
28011,443,11393,443,allow,5577,1390,4187,19,15,9,10
64314,445,0,0,drop,70,70,0,1,0,1,0
50293,445,0,0,drop,70,70,0,1,0,1,0
56307,53,24670,53,allow,185,102,83,2,29,1,1
57883,443,38550,443,allow,5932,1264,4668,21,155,11,10
52090,443,7071,443,allow,6383,5237,1146,19,16,11,8
55130,27046,9695,27046,allow,1798,1386,412,8,29,4,4
56066,53,46856,53,allow,208,106,102,2,30,1,1
62737,64147,0,0,deny,66,66,0,1,0,1,0
39920,22114,0,0,deny,146,146,0,1,0,1,0
65132,445,0,0,drop,66,66,0,1,0,1,0
49332,443,44143,443,allow,142684,5997,136687,134,48,31,103
6927,4660,0,0,deny,100,100,0,1,0,1,0
53149,47383,18287,47383,allow,694,320,374,10,18,6,4
443,61686,0,0,deny,1484,1484,0,1,0,1,0
49552,53,59587,53,allow,188,96,92,2,30,1,1
57470,60080,37928,60080,allow,12668,8506,4162,117,3745,74,43
58057,80,12753,80,allow,254,128,126,5,15,3,2
40404,80,22213,80,allow,1502,467,1035,9,180,5,4
61817,445,0,0,drop,70,70,0,1,0,1,0
44133,53,62526,53,allow,164,78,86,2,30,1,1
49898,443,53027,443,allow,44110,4769,39341,90,108,46,44
57147,53,63811,53,allow,166,86,80,2,29,1,1
63346,53,0,0,deny,75,75,0,1,0,1,0
60168,35440,0,0,deny,66,66,0,1,0,1,0
53513,445,0,0,drop,70,70,0,1,0,1,0
15176,62413,0,0,deny,66,66,0,1,0,1,0
58039,80,32642,80,allow,318,192,126,6,21,4,2
33305,54532,0,0,deny,60,60,0,1,0,1,0
46902,443,9815,443,allow,1312,651,661,13,184,7,6
55655,53,43785,53,allow,754,94,660,2,31,1,1
49097,80,63676,80,allow,1739,740,999,17,235,5,12
13235,44847,0,0,deny,66,66,0,1,0,1,0
53757,443,15611,443,allow,499,425,74,4,0,3,1
46550,443,47907,443,allow,3322,1760,1562,19,255,10,9
62250,23117,0,0,deny,66,66,0,1,0,1,0
55133,445,0,0,drop,70,70,0,1,0,1,0
59779,443,2318,443,allow,5834,1810,4024,24,17,13,11
61933,445,0,0,drop,70,70,0,1,0,1,0
46500,443,37783,443,allow,494,280,214,8,29,5,3
63691,445,0,0,drop,70,70,0,1,0,1,0
56100,53,9631,53,allow,177,94,83,2,30,1,1
60854,42873,0,0,deny,66,66,0,1,0,1,0
49361,53,37385,53,allow,184,94,90,2,29,1,1
55479,53,23646,53,allow,184,94,90,2,31,1,1
55703,13836,54739,13836,allow,70,70,0,2,8,2,0
63258,445,0,0,drop,66,66,0,1,0,1,0
61210,445,0,0,drop,66,66,0,1,0,1,0
53882,13613,12263,13613,allow,320,140,180,6,5,3,3
3376,35440,0,0,deny,66,66,0,1,0,1,0
56747,445,0,0,drop,70,70,0,1,0,1,0
49954,445,0,0,drop,66,66,0,1,0,1,0
57108,445,0,0,drop,70,70,0,1,0,1,0
61745,443,5419,443,allow,8123,5308,2815,18,134,9,9
58638,5900,0,0,deny,62,62,0,1,0,1,0
15018,37965,0,0,deny,62,62,0,1,0,1,0
39040,443,45031,443,allow,25034,7042,17992,58,21,29,29
49176,53,17276,53,allow,264,110,154,2,30,1,1
53336,445,0,0,drop,70,70,0,1,0,1,0
50766,445,0,0,drop,70,70,0,1,0,1,0
49650,443,63033,443,allow,93063,2948,90115,107,80,30,77
36712,53,0,0,allow,138,69,69,2,30,1,1
54991,53,33819,53,allow,177,94,83,2,30,1,1
58890,80,3070,80,allow,1883,1448,435,11,16,6,5
48327,57470,0,0,deny,145,145,0,1,0,1,0
49345,80,49345,80,allow,450,246,204,8,142,5,3
56897,11446,0,0,deny,62,62,0,1,0,1,0
57716,445,0,0,drop,66,66,0,1,0,1,0
55310,445,0,0,drop,70,70,0,1,0,1,0
36983,80,48738,80,allow,1143,401,742,9,360,5,4
16716,57470,0,0,deny,145,145,0,1,0,1,0
49635,53,16265,53,allow,458,188,270,6,30,3,3
61465,22114,0,0,deny,62,62,0,1,0,1,0
56332,53,13726,53,allow,202,103,99,2,31,1,1
64864,53,28778,53,allow,275,126,149,2,30,1,1
48013,53,0,0,allow,82,82,0,1,30,1,0
50407,53,51161,53,allow,749,89,660,2,31,1,1
50120,443,33702,443,allow,23870,3485,20385,55,143,29,26
34746,443,4348,443,allow,284320,14149,270171,398,244,203,195
58731,443,5711,443,allow,2383,1460,923,18,201,10,8
55179,53,32980,53,allow,183,94,89,2,30,1,1
55694,53,12759,53,allow,167,86,81,2,30,1,1
12895,37965,0,0,deny,62,62,0,1,0,1,0
55649,5228,61882,5228,allow,5378,2359,3019,35,3786,16,19
58638,5900,0,0,deny,62,62,0,1,0,1,0
52181,443,64436,443,allow,7855,815,7040,21,15,9,12
57192,53,34742,53,allow,170,87,83,2,31,1,1
54786,30188,0,0,deny,66,66,0,1,0,1,0
63989,445,0,0,drop,70,70,0,1,0,1,0
53112,29258,48583,29258,allow,70,70,0,1,5,1,0
56363,2710,2278,2710,allow,1222,747,475,10,25,5,5
44277,443,64665,443,allow,36026,28458,7568,70,407,30,40
60188,443,15594,443,allow,9811,1112,8699,21,125,10,11
58638,5900,0,0,deny,62,62,0,1,0,1,0
64449,53,34818,53,allow,255,102,153,2,31,1,1
59823,443,61551,443,allow,306,180,126,6,29,4,2
52748,445,0,0,drop,70,70,0,1,0,1,0
58782,53,58782,53,allow,310,94,216,2,30,1,1
63225,443,50090,443,allow,4882,2412,2470,32,155,16,16
59417,443,49153,443,allow,2898,1700,1198,16,15,8,8
51205,443,62572,443,allow,8857,2827,6030,52,17,29,23
52052,80,13756,80,allow,2308,1541,767,11,18,7,4
57470,22646,6893,22646,allow,353,166,187,2,1200,1,1
51850,80,53740,80,allow,2188,1421,767,11,61,7,4
53455,443,54035,443,allow,240325,8131,232194,262,31,100,162
49883,443,3067,443,allow,4960,1114,3846,21,51,12,9
57132,53,31918,53,allow,177,94,83,2,30,1,1
60883,64147,0,0,deny,70,70,0,1,0,1,0
52319,445,0,0,drop,70,70,0,1,0,1,0
55794,443,55794,443,allow,4578,1671,2907,19,28,11,8
7364,50584,0,0,deny,66,66,0,1,0,1,0
58957,80,23483,80,allow,13330975,109486,13221489,10177,23,1394,8783
45941,23388,0,0,deny,60,60,0,1,0,1,0
50856,445,0,0,drop,66,66,0,1,0,1,0
65325,445,0,0,drop,70,70,0,1,0,1,0
15854,50584,0,0,deny,146,146,0,1,0,1,0
51094,35440,0,0,deny,62,62,0,1,0,1,0
46949,53,11241,53,allow,168,78,90,2,29,1,1
57215,445,0,0,drop,70,70,0,1,0,1,0
64729,53,52284,53,allow,770,102,668,2,30,1,1
54005,445,0,0,drop,70,70,0,1,0,1,0
57302,443,55784,443,allow,5614,733,4881,16,15,9,7
54375,443,15828,443,allow,5642,3872,1770,32,81,17,15
0,0,0,0,deny,98,98,0,1,0,1,0
47732,80,47732,80,allow,9621,1618,8003,19,20,10,9
51850,11981,61118,11981,allow,316,136,180,6,7,3,3
0,0,0,0,allow,134,64,70,2,0,1,1
55019,443,55019,443,allow,3773,2325,1448,24,18,13,11
27005,27016,64097,27016,allow,880,126,754,2,30,1,1
64432,53,45233,53,allow,482,188,294,6,44,3,3
49342,53,2621,53,allow,200,102,98,2,30,1,1
49777,53,2324,53,allow,485,79,406,4,31,2,2
56275,53,62167,53,allow,177,94,83,2,29,1,1
59861,445,0,0,drop,66,66,0,1,0,1,0
54280,3385,0,0,deny,60,60,0,1,0,1,0
55360,80,13495,80,allow,130,70,60,2,15,1,1
49734,53,20221,53,allow,216,110,106,2,30,1,1
61583,80,61583,80,allow,12301,1642,10659,20,20,9,11
443,64347,0,0,deny,60,60,0,1,0,1,0
48817,51413,48817,51413,allow,485,158,327,2,1199,1,1
52080,9554,43185,9554,allow,70,70,0,1,5,1,0
60367,443,5802,443,allow,12979,6398,6581,39,115,22,17
56853,53,24934,53,allow,167,86,81,2,29,1,1
55498,445,0,0,drop,70,70,0,1,0,1,0
1821,64147,0,0,deny,66,66,0,1,0,1,0
49543,53,24051,53,allow,880,189,691,6,75,3,3
62417,443,4381,443,allow,79513,7480,72033,106,122,39,67
6224,37965,0,0,deny,62,62,0,1,0,1,0
50265,5554,7404,5554,allow,472,150,322,2,1200,1,1
53892,25933,31211,25933,allow,552,306,246,9,15,5,4
61123,80,61123,80,allow,21678,2120,19558,33,20,16,17
57330,53,57913,53,allow,177,94,83,2,30,1,1
49951,53,52674,53,allow,525,110,415,2,30,1,1
60487,1134,43276,1134,allow,70,70,0,2,8,2,0
51167,80,51167,80,allow,1502,817,685,10,20,6,4
50729,27029,59296,27029,allow,269,78,191,2,30,1,1
60354,445,0,0,drop,70,70,0,1,0,1,0
55555,53,19089,53,allow,778,103,675,2,30,1,1
48706,23393,0,0,deny,60,60,0,1,0,1,0
58724,43890,0,0,deny,66,66,0,1,0,1,0
49465,443,16999,443,allow,4555,2472,2083,20,119,11,9
3254,3389,3254,3389,allow,3790,1685,2105,18,17,10,8
40394,67,0,0,deny,60,60,0,1,0,1,0
26566,44847,0,0,deny,66,66,0,1,0,1,0
7226,50584,0,0,deny,62,62,0,1,0,1,0
8082,53,8082,53,allow,237,91,146,2,33,1,1
38306,51221,0,0,deny,62,62,0,1,0,1,0
65259,37965,0,0,deny,66,66,0,1,0,1,0
37565,443,6723,443,allow,499,425,74,4,0,3,1
57444,53,22248,53,allow,170,87,83,2,30,1,1
7891,25174,0,0,deny,66,66,0,1,0,1,0
60369,443,60379,443,allow,7939,955,6984,22,107,11,11
51344,445,0,0,drop,70,70,0,1,0,1,0
28306,25604,0,0,deny,62,62,0,1,0,1,0
50802,80,54812,80,allow,3874,684,3190,11,141,6,5
50584,1283,8544,1283,allow,1617,161,1456,4,1199,2,2
55708,8060,17338,8060,allow,70,70,0,1,5,1,0
58602,445,0,0,drop,70,70,0,1,0,1,0
55123,445,0,0,drop,66,66,0,1,0,1,0
56267,445,0,0,drop,70,70,0,1,0,1,0
55371,53,15832,53,allow,184,102,82,2,29,1,1
41294,443,46411,443,allow,7595,1115,6480,18,35,10,8
35136,443,3606,443,allow,25542,17843,7699,58,59,34,24
64859,53,0,0,allow,220,81,139,2,30,1,1
64732,53,52596,53,allow,189,102,87,2,30,1,1
51308,445,0,0,drop,66,66,0,1,0,1,0
61410,445,0,0,drop,66,66,0,1,0,1,0
32722,25174,0,0,deny,62,62,0,1,0,1,0
56760,53,60380,53,allow,760,96,664,2,31,1,1
55352,53,6913,53,allow,216,110,106,2,31,1,1
58613,445,0,0,drop,70,70,0,1,0,1,0
55427,443,18604,443,allow,9255,2064,7191,43,78,18,25
63038,53,49856,53,allow,303,85,218,2,31,1,1
63254,445,0,0,drop,66,66,0,1,0,1,0
56774,39553,19722,39553,allow,66,66,0,1,5,1,0
55058,80,17892,80,allow,48751,3044,45707,57,60,23,34
53365,80,32049,80,allow,405,285,120,5,15,3,2
56628,443,8752,443,allow,6654,3821,2833,60,3037,30,30
50182,445,0,0,drop,66,66,0,1,0,1,0
47132,1433,0,0,deny,60,60,0,1,0,1,0
63963,50584,0,0,deny,66,66,0,1,0,1,0
42898,25174,0,0,deny,62,62,0,1,0,1,0
45941,23388,0,0,deny,60,60,0,1,0,1,0
49435,443,28726,443,allow,8602,1050,7552,16,120,7,9
64038,53,4227,53,allow,321,102,219,2,30,1,1
64054,53,42745,53,allow,182,93,89,2,31,1,1
32007,26543,0,0,deny,145,145,0,1,0,1,0
21017,3389,21017,3389,allow,4085,1916,2169,21,18,12,9
26900,27017,11839,27017,allow,422,164,258,6,30,3,3
62547,443,41349,443,allow,54095,6413,47682,151,450,61,90
52682,443,30711,443,allow,5406,922,4484,19,360,10,9
56937,445,0,0,drop,70,70,0,1,0,1,0
59324,17,0,0,deny,60,60,0,1,0,1,0
5588,5588,0,0,allow,3562,1936,1626,48,194,24,24
52929,443,26411,443,allow,8623,4829,3794,44,195,22,22
39063,5900,0,0,deny,60,60,0,1,0,1,0
63995,53,52864,53,allow,212,94,118,2,30,1,1
49719,443,56556,443,allow,560073,155518,404555,923,110,411,512
57396,53,7718,53,allow,184,94,90,2,30,1,1
52208,43890,0,0,deny,66,66,0,1,0,1,0
2791,7302,0,0,deny,62,62,0,1,0,1,0
56385,445,0,0,drop,66,66,0,1,0,1,0
63861,37832,6242,37832,allow,66,66,0,2,7,2,0
56772,61424,62775,61424,allow,66,66,0,1,5,1,0
57762,25174,0,0,deny,62,62,0,1,0,1,0
51832,445,0,0,drop,66,66,0,1,0,1,0
6881,6881,2620,6881,allow,150,150,0,1,1200,1,0
49710,53,33849,53,allow,183,102,81,2,30,1,1
56370,445,0,0,drop,70,70,0,1,0,1,0
43260,41615,0,0,deny,145,145,0,1,0,1,0
44044,23,0,0,deny,60,60,0,1,0,1,0
5588,5588,0,0,allow,3354,1792,1562,46,193,23,23
64935,53,11961,53,allow,186,95,91,2,31,1,1
48838,8080,7294,8080,allow,533,327,206,8,33,5,3
55732,53,56337,53,allow,280,126,154,2,30,1,1
38130,443,8733,443,allow,717020,36766,680254,939,60,449,490
55176,80,55176,80,allow,374,240,134,7,15,5,2
63566,443,27176,443,allow,2537,1268,1269,23,186,12,11
55413,53,59906,53,allow,216,110,106,2,31,1,1
29245,80,29245,80,allow,27233,4047,23186,44,27,20,24
62088,445,0,0,drop,66,66,0,1,0,1,0
64685,53,47182,53,allow,193,102,91,2,30,1,1
58373,443,64061,443,allow,78832,12408,66424,109,162,46,63
6881,47488,39178,47488,allow,150,150,0,2,1200,2,0
50369,50584,0,0,deny,62,62,0,1,0,1,0
36266,443,8453,443,allow,6043,1568,4475,11,119,4,7
30960,45708,10232,45708,allow,330,330,0,6,3609,6,0
52788,64147,0,0,deny,62,62,0,1,0,1,0
61932,25174,0,0,deny,66,66,0,1,0,1,0
5841,22114,0,0,deny,62,62,0,1,0,1,0
27005,27016,44583,27016,allow,898,126,772,3,31,2,1
59481,41182,0,0,deny,62,62,0,1,0,1,0
55629,53,44695,53,allow,168,86,82,2,31,1,1
42805,443,52110,443,allow,130,70,60,2,15,1,1
56260,445,0,0,drop,66,66,0,1,0,1,0
16979,56205,0,0,deny,66,66,0,1,0,1,0
54797,445,0,0,drop,70,70,0,1,0,1,0
37272,443,58616,443,allow,10809,2465,8344,45,121,21,24
56266,53,53849,53,allow,182,102,80,2,30,1,1
57436,66,1487,66,allow,70,70,0,1,4,1,0
63786,25174,0,0,deny,66,66,0,1,0,1,0
64835,53,44115,53,allow,371,126,245,2,30,1,1
59373,445,0,0,drop,70,70,0,1,0,1,0
53283,443,23870,443,allow,9121,2486,6635,22,45,13,9
59390,445,0,0,drop,70,70,0,1,0,1,0
39959,23117,0,0,deny,146,146,0,1,0,1,0
50317,80,56458,80,allow,3800,2776,1024,16,83,9,7
53938,445,0,0,drop,70,70,0,1,0,1,0
40682,443,13381,443,allow,10010,4051,5959,32,346,17,15
57314,53,53459,53,allow,195,102,93,2,30,1,1
59068,445,0,0,drop,66,66,0,1,0,1,0
49820,53,29495,53,allow,193,102,91,2,31,1,1
53137,35111,32550,35111,allow,70,70,0,1,5,1,0
34244,443,6672,443,allow,3528,1045,2483,13,120,6,7
61349,445,0,0,drop,66,66,0,1,0,1,0
57889,443,40826,443,allow,1851,1212,639,18,177,11,7
65125,445,0,0,deny,70,70,0,1,0,1,0
55740,53,13751,53,allow,228,110,118,2,30,1,1
50374,53,63648,53,allow,755,102,653,2,29,1,1
43323,1,0,0,deny,62,62,0,1,0,1,0
51080,445,0,0,drop,70,70,0,1,0,1,0
49492,80,50602,80,allow,1680,1210,470,9,15,5,4
7435,62609,0,0,deny,148,148,0,1,0,1,0
58743,35894,0,0,deny,66,66,0,1,0,1,0
53956,41578,43631,41578,allow,492,306,186,8,17,5,3
52266,50038,0,0,deny,66,66,0,1,0,1,0
51818,37965,0,0,deny,66,66,0,1,0,1,0
49853,53,4793,53,allow,291,102,189,2,30,1,1
37576,443,21717,443,allow,11777,4005,7772,35,44,15,20
56167,53,49116,53,allow,178,94,84,2,30,1,1
54261,445,0,0,drop,70,70,0,1,0,1,0
59210,445,0,0,drop,66,66,0,1,0,1,0
56689,53,22159,53,allow,738,86,652,2,30,1,1
58103,10197,0,0,deny,66,66,0,1,0,1,0
34193,17,0,0,deny,60,60,0,1,0,1,0
52007,443,2667,443,allow,10217,8266,1951,33,39,20,13
57496,445,0,0,drop,70,70,0,1,0,1,0
39611,443,2531,443,allow,78,78,0,1,5,1,0
27005,27015,57619,27015,allow,902,126,776,2,30,1,1
55012,64147,0,0,deny,66,66,0,1,0,1,0
59802,445,0,0,drop,70,70,0,1,0,1,0
62819,56205,0,0,deny,62,62,0,1,0,1,0
50861,3389,50861,3389,allow,4241,2521,1720,18,32,10,8
55995,53,56863,53,allow,182,94,88,2,30,1,1
60447,36396,58005,36396,allow,70,70,0,1,5,1,0
62616,445,0,0,drop,70,70,0,1,0,1,0
42576,30188,0,0,deny,146,146,0,1,0,1,0
64140,53,60265,53,allow,184,94,90,2,31,1,1
55933,53,2538,53,allow,180,92,88,2,30,1,1
36088,443,55123,443,allow,7229,2357,4872,26,270,14,12
31675,19473,0,0,deny,62,62,0,1,0,1,0
57074,53,27906,53,allow,259,78,181,2,30,1,1
50341,80,19405,80,allow,306,180,126,6,41,4,2
443,48120,0,0,deny,97,97,0,1,0,1,0
52898,80,52898,80,allow,1916,1467,449,10,19,6,4
58367,53,2848,53,allow,167,78,89,2,30,1,1
64606,445,0,0,drop,70,70,0,1,0,1,0
54444,443,16103,443,allow,6275,3787,2488,17,147,8,9
55291,445,0,0,drop,70,70,0,1,0,1,0
56395,443,48597,443,allow,77506,2940,74566,100,80,38,62
59216,445,0,0,drop,70,70,0,1,0,1,0
55605,53,27341,53,allow,195,102,93,2,30,1,1
62910,993,51747,993,allow,9108,4045,5063,84,72,39,45
15503,19168,41378,19168,allow,481,150,331,2,1200,1,1
60384,443,37407,443,allow,39385,3771,35614,67,129,27,40
65461,53,1880,53,allow,268,110,158,2,30,1,1
49620,445,0,0,drop,70,70,0,1,0,1,0
61500,443,52553,443,allow,14738,2175,12563,24,16,10,14
6036,51505,0,0,deny,66,66,0,1,0,1,0
53136,5228,42128,5228,allow,26821,4295,22526,95,5045,40,55
54898,36237,0,0,deny,66,66,0,1,0,1,0
60908,443,62015,443,allow,10043,4993,5050,45,15,27,18
49290,53,15607,53,allow,760,97,663,2,31,1,1
64804,53,31085,53,allow,182,102,80,2,30,1,1
55288,445,0,0,drop,70,70,0,1,0,1,0
57436,53,46375,53,allow,183,94,89,2,30,1,1
57385,445,0,0,drop,70,70,0,1,0,1,0
53529,445,0,0,drop,70,70,0,1,0,1,0
55066,53,62750,53,allow,180,94,86,2,30,1,1
20378,23,0,0,deny,60,60,0,1,0,1,0
33846,443,41735,443,allow,7760,2646,5114,24,16,13,11
49759,53,54239,53,allow,166,86,80,2,30,1,1
52072,445,0,0,drop,66,66,0,1,0,1,0
52062,60388,61139,60388,allow,70,70,0,2,8,2,0
65161,445,0,0,drop,70,70,0,1,0,1,0
55551,53,54639,53,allow,788,108,680,2,30,1,1
50709,80,40115,80,allow,1658,1247,411,8,15,5,3
49418,27015,19557,27015,allow,255,78,177,2,30,1,1
6881,6889,64062,6889,allow,228,118,110,2,1199,1,1
52812,445,0,0,drop,66,66,0,1,0,1,0
27005,27015,44783,27015,allow,939,126,813,2,30,1,1
59389,445,0,0,drop,70,70,0,1,0,1,0
63955,445,0,0,drop,66,66,0,1,0,1,0
60868,80,60868,80,allow,5973,779,5194,17,16,9,8
53140,80,7687,80,allow,2560,2083,477,13,15,7,6
64421,53,53236,53,allow,398,88,310,4,54,2,2
50225,445,0,0,drop,66,66,0,1,0,1,0
40587,53,36507,53,allow,271,102,169,2,30,1,1
1485,53,1485,53,allow,194,87,107,2,30,1,1
53273,443,62514,443,allow,17169,6566,10603,52,37,24,28
59122,80,13058,80,allow,2865,2000,865,12,16,7,5
34424,443,56503,443,allow,773546,29906,743640,881,1166,350,531
53144,445,0,0,drop,70,70,0,1,0,1,0
7301,14914,0,0,deny,157,157,0,1,0,1,0
50339,53,28610,53,allow,498,204,294,6,29,3,3
58681,36829,0,0,deny,74,74,0,1,0,1,0
27005,27015,40771,27015,allow,1618,126,1492,4,31,2,2
50496,445,0,0,drop,70,70,0,1,0,1,0
56293,53,25636,53,allow,166,86,80,2,30,1,1
64884,53,27376,53,allow,195,102,93,2,31,1,1
10003,64147,0,0,deny,62,62,0,1,0,1,0
56063,445,0,0,drop,66,66,0,1,0,1,0
25523,35974,0,0,deny,145,145,0,1,0,1,0
35145,443,40787,443,allow,3542,1045,2497,13,120,6,7
55080,53,5647,53,allow,330,86,244,2,30,1,1
49418,53,32330,53,allow,165,86,79,2,29,1,1
55577,53,15503,53,allow,199,102,97,2,31,1,1
38261,443,49964,443,allow,134,60,74,3,4,2,1
61457,21247,0,0,deny,66,66,0,1,0,1,0
54457,445,0,0,drop,70,70,0,1,0,1,0
49643,443,30041,443,allow,1640,1089,551,14,15,8,6
3524,25174,0,0,deny,66,66,0,1,0,1,0
50326,46824,0,0,deny,66,66,0,1,0,1,0
49365,53,27288,53,allow,195,102,93,2,29,1,1
13281,51050,0,0,deny,62,62,0,1,0,1,0
38791,53,38791,53,allow,229,89,140,2,30,1,1
45067,443,54041,443,allow,7794,2844,4950,26,29,16,10
34750,80,47643,80,allow,111678,5254,106424,150,240,71,79
64229,445,0,0,drop,66,66,0,1,0,1,0
53541,59939,24806,59939,allow,70,70,0,2,7,2,0
43260,41615,0,0,deny,145,145,0,1,0,1,0
54590,443,20540,443,allow,12094,4159,7935,21,135,10,11
56164,445,0,0,drop,70,70,0,1,0,1,0
57907,443,20224,443,allow,1584,953,631,17,124,9,8
49738,443,60730,443,allow,5572,1446,4126,17,129,10,7
64698,53,59784,53,allow,430,106,324,4,58,2,2
55577,53,20988,53,allow,199,102,97,2,30,1,1
48452,443,56539,443,allow,9553,2175,7378,33,27,17,16
55225,53,24302,53,allow,199,102,97,2,30,1,1
58446,56205,0,0,deny,62,62,0,1,0,1,0
3478,61463,0,0,deny,431,431,0,1,0,1,0
58642,443,2998,443,allow,7127,3015,4112,24,144,12,12
60312,57470,0,0,deny,74,74,0,1,0,1,0
64811,53,5466,53,allow,190,97,93,2,31,1,1
53140,64128,33195,64128,allow,698,320,378,10,17,6,4
50312,445,0,0,drop,70,70,0,1,0,1,0
38450,443,8906,443,allow,593,473,120,4,15,2,2
60762,445,0,0,drop,66,66,0,1,0,1,0
62447,53,48844,53,allow,296,94,202,2,30,1,1
2707,37,0,0,deny,60,60,0,1,0,1,0
57371,53,5536,53,allow,214,110,104,2,30,1,1
61054,53,61054,53,allow,237,91,146,2,33,1,1
42981,44847,0,0,deny,62,62,0,1,0,1,0
56939,53,59190,53,allow,216,110,106,2,31,1,1
58940,443,24448,443,allow,5108,700,4408,15,15,7,8
58638,5900,0,0,deny,62,62,0,1,0,1,0
55156,53,26617,53,allow,194,102,92,2,31,1,1
50169,53,35420,53,allow,223,78,145,2,30,1,1
42564,50584,0,0,deny,62,62,0,1,0,1,0
57046,53,24095,53,allow,234,94,140,2,29,1,1
61333,445,0,0,drop,70,70,0,1,0,1,0
54104,445,0,0,drop,70,70,0,1,0,1,0
63082,443,41312,443,allow,303,85,218,2,30,1,1
54011,22114,0,0,deny,62,62,0,1,0,1,0
64926,53,21011,53,allow,166,86,80,2,31,1,1
28064,53,28064,53,allow,233,90,143,2,32,1,1
62055,445,0,0,drop,70,70,0,1,0,1,0
49855,80,46269,80,allow,41720,6568,35152,47,89,17,30
18653,42707,0,0,deny,66,66,0,1,0,1,0
65059,445,0,0,drop,70,70,0,1,0,1,0
51759,55308,58744,55308,allow,70,70,0,2,8,2,0
50059,445,0,0,drop,70,70,0,1,0,1,0
49724,53,47705,53,allow,183,94,89,2,30,1,1
61902,445,0,0,drop,66,66,0,1,0,1,0
6881,45711,37473,45711,allow,228,118,110,2,1199,1,1
51432,80,62424,80,allow,1675,539,1136,8,178,5,3
53475,3389,0,0,deny,66,66,0,1,0,1,0
49248,445,0,0,drop,66,66,0,1,0,1,0
51072,445,0,0,drop,70,70,0,1,0,1,0
5200,6643,0,0,deny,145,145,0,1,0,1,0
57514,445,0,0,drop,70,70,0,1,0,1,0
64482,53,47729,53,allow,196,102,94,2,30,1,1
57470,19853,37734,19853,allow,132,132,0,3,1200,3,0
57385,445,0,0,drop,66,66,0,1,0,1,0
50566,443,50394,443,allow,11116,4583,6533,39,256,19,20
54887,445,0,0,drop,66,66,0,1,0,1,0
19875,30170,0,0,deny,145,145,0,1,0,1,0
16221,50584,0,0,deny,146,146,0,1,0,1,0
65304,53,61262,53,allow,209,110,99,2,30,1,1
52404,445,0,0,drop,66,66,0,1,0,1,0
64746,53,23146,53,allow,193,102,91,2,30,1,1
57089,443,54231,443,allow,5574,999,4575,21,256,11,10
27005,27015,19164,27015,allow,871,126,745,2,31,1,1
6546,37965,0,0,deny,62,62,0,1,0,1,0
53668,50678,10621,50678,allow,70,70,0,1,5,1,0
49723,53,26637,53,allow,209,110,99,2,30,1,1
64516,53,13798,53,allow,216,110,106,2,30,1,1
25015,64147,0,0,deny,66,66,0,1,0,1,0
49612,53,33123,53,allow,234,94,140,2,31,1,1
53275,443,20326,443,allow,364,142,222,6,10,3,3
51871,443,4793,443,allow,554,310,244,10,30,6,4
41713,443,59804,443,allow,61983,10061,51922,85,130,35,50
51756,445,0,0,drop,70,70,0,1,0,1,0
56852,445,0,0,drop,70,70,0,1,0,1,0
64520,53,30136,53,allow,198,102,96,2,31,1,1
57119,445,0,0,drop,70,70,0,1,0,1,0
44443,80,37663,80,allow,1114,534,580,12,16,7,5
49418,27015,33472,27015,allow,71,71,0,1,30,1,0
47636,443,43225,443,allow,5921,1018,4903,21,150,11,10
58638,5900,0,0,deny,62,62,0,1,0,1,0
64063,37832,48121,37832,allow,66,66,0,2,7,2,0
50534,53,27625,53,allow,168,86,82,2,30,1,1
50272,443,27135,443,allow,772,432,340,12,18,7,5
6666,443,0,0,deny,60,60,0,1,0,1,0
64677,57470,0,0,deny,66,66,0,1,0,1,0
58638,5900,0,0,deny,62,62,0,1,0,1,0
64080,11801,22050,11801,allow,66,66,0,2,8,2,0
51788,35787,25759,35787,allow,70,70,0,1,4,1,0
53612,1032,48115,1032,allow,130,70,60,2,6,1,1
64789,53,27915,53,allow,199,102,97,2,30,1,1
13718,23,0,0,deny,60,60,0,1,0,1,0
58782,443,19890,443,allow,5397,3496,1901,20,16,10,10
60411,445,0,0,drop,70,70,0,1,0,1,0
55161,37807,0,0,deny,62,62,0,1,0,1,0
8820,41864,0,0,deny,143,143,0,1,0,1,0
60729,443,20106,443,allow,5737,1929,3808,19,201,11,8
49547,53,1649,53,allow,186,95,91,2,31,1,1
59517,443,5605,443,allow,6285,1545,4740,22,17,12,10
52883,445,0,0,drop,66,66,0,1,0,1,0
28139,22114,0,0,deny,62,62,0,1,0,1,0
53852,443,26865,443,allow,499,425,74,4,0,3,1
52593,445,0,0,drop,70,70,0,1,0,1,0
52187,38153,15114,38153,allow,70,70,0,2,9,2,0
55713,47783,26233,47783,allow,70,70,0,1,5,1,0
55192,53,55863,53,allow,178,94,84,2,30,1,1
52866,445,0,0,drop,70,70,0,1,0,1,0
50757,64147,0,0,deny,66,66,0,1,0,1,0
54958,445,0,0,drop,66,66,0,1,0,1,0
55491,445,0,0,drop,70,70,0,1,0,1,0
54006,445,0,0,drop,66,66,0,1,0,1,0
64543,50265,0,0,deny,66,66,0,1,0,1,0
59999,445,0,0,drop,70,70,0,1,0,1,0
64809,445,0,0,drop,66,66,0,1,0,1,0
33694,443,52274,443,allow,18876,16514,2362,43,95,24,19
53109,445,0,0,drop,66,66,0,1,0,1,0
62288,445,0,0,drop,66,66,0,1,0,1,0
55427,53,42725,53,allow,442,110,332,4,44,2,2
56200,445,0,0,drop,70,70,0,1,0,1,0
50711,445,0,0,drop,70,70,0,1,0,1,0
17750,14132,3203,14132,allow,150,150,0,1,1200,1,0
33409,53,54982,53,allow,79268,76966,2302,936,88,923,13
55551,445,0,0,drop,70,70,0,1,0,1,0
10151,27949,13472,27949,allow,469,149,320,2,1200,1,1
50774,443,8773,443,allow,6074,4349,1725,22,361,11,11
57181,53,65198,53,allow,733,93,640,2,31,1,1
50372,443,12434,443,allow,456,390,66,4,0,3,1
9106,53,9106,53,allow,227,89,138,2,30,1,1
50152,80,46738,80,allow,731402,17622,713780,600,97,116,484
35519,80,60080,80,allow,841,715,126,5,15,3,2
45908,3383,0,0,deny,60,60,0,1,0,1,0
3478,61463,0,0,deny,164,164,0,1,0,1,0
56837,53,17666,53,allow,190,97,93,2,31,1,1
49568,53,17593,53,allow,214,102,112,2,30,1,1
56247,53,34021,53,allow,751,95,656,2,30,1,1
56249,55442,0,0,deny,66,66,0,1,0,1,0
53381,25174,0,0,deny,66,66,0,1,0,1,0
57039,445,0,0,drop,70,70,0,1,0,1,0
53116,445,0,0,drop,70,70,0,1,0,1,0
57352,53,30931,53,allow,711,87,624,2,31,1,1
57917,44847,0,0,deny,62,62,0,1,0,1,0
55057,53,26203,53,allow,211,110,101,2,30,1,1
55054,443,36646,443,allow,7993,677,7316,16,15,8,8
50413,123,48114,123,allow,184,94,90,2,31,1,1
64172,53,0,0,allow,174,79,95,2,30,1,1
63927,50265,0,0,deny,62,62,0,1,0,1,0
64967,53,49368,53,allow,184,94,90,2,31,1,1
50469,445,0,0,drop,66,66,0,1,0,1,0
64842,53,15693,53,allow,340,95,245,4,47,2,2
51732,54299,27558,54299,allow,70,70,0,2,8,2,0
55339,445,0,0,drop,70,70,0,1,0,1,0
59949,80,40471,80,allow,730296,15564,714732,723,57,218,505
62566,35993,0,0,deny,66,66,0,1,0,1,0
20682,57470,0,0,deny,62,62,0,1,0,1,0
61981,445,0,0,drop,66,66,0,1,0,1,0
59918,44847,0,0,deny,66,66,0,1,0,1,0
51650,80,8862,80,allow,2681,1044,1637,22,255,12,10
53966,57470,0,0,deny,62,62,0,1,0,1,0
38684,443,33741,443,allow,90449,3289,87160,93,16,28,65
64701,445,0,0,drop,70,70,0,1,0,1,0
55245,53,15511,53,allow,193,102,91,2,30,1,1
50280,57470,0,0,deny,78,78,0,1,0,1,0
51998,445,0,0,drop,70,70,0,1,0,1,0
55009,445,0,0,drop,70,70,0,1,0,1,0
52476,443,35367,443,allow,7787,3056,4731,19,87,10,9
49825,445,0,0,drop,70,70,0,1,0,1,0
58864,443,26989,443,allow,312852,8845,304007,317,45,99,218
64225,53,35755,53,allow,322,118,204,2,30,1,1
49991,53,62734,53,allow,257,102,155,2,29,1,1
62566,35993,0,0,deny,66,66,0,1,0,1,0
55026,443,35367,443,allow,17336,5332,12004,33,121,18,15
47102,123,23383,123,allow,184,94,90,2,30,1,1
56100,53,57045,53,allow,216,110,106,2,31,1,1
59876,44847,0,0,deny,62,62,0,1,0,1,0
51430,25174,0,0,deny,62,62,0,1,0,1,0
47727,25174,0,0,deny,146,146,0,1,0,1,0
59470,443,18542,443,allow,3726,688,3038,14,119,7,7
45077,443,32205,443,allow,6533,1777,4756,24,271,13,11
58559,445,0,0,drop,70,70,0,1,0,1,0
55684,53,0,0,allow,219,86,133,2,29,1,1
59509,64147,0,0,deny,62,62,0,1,0,1,0
48276,15000,65405,15000,allow,130,70,60,2,5,1,1
51551,445,0,0,drop,70,70,0,1,0,1,0
56006,445,0,0,drop,70,70,0,1,0,1,0
59658,445,0,0,drop,66,66,0,1,0,1,0
60601,443,55669,443,allow,6180,926,5254,18,36,10,8
64874,445,0,0,drop,70,70,0,1,0,1,0
48676,53393,0,0,deny,60,60,0,1,0,1,0
54979,53,4787,53,allow,102,102,0,1,59,1,0
60211,53,51487,53,allow,205,86,119,2,30,1,1
55691,16410,1413,16410,allow,70,70,0,1,5,1,0
10028,25604,0,0,deny,62,62,0,1,0,1,0
56638,64147,0,0,deny,62,62,0,1,0,1,0
47422,80,55452,80,allow,1614,1300,314,10,18,5,5
56322,53,21211,53,allow,166,86,80,2,29,1,1
50980,443,34954,443,allow,7959,3288,4671,19,97,11,8
60648,445,0,0,drop,66,66,0,1,0,1,0
56850,64932,41419,64932,allow,70,70,0,1,5,1,0
57181,53,16955,53,allow,753,96,657,2,31,1,1
27110,22114,0,0,deny,62,62,0,1,0,1,0
63761,25933,42159,25933,allow,436,254,182,7,15,4,3
55577,80,44269,80,allow,70,70,0,1,5,1,0
62549,53733,0,0,deny,66,66,0,1,0,1,0
64066,80,28023,80,allow,314,192,122,6,15,4,2
5222,7493,0,0,deny,66,66,0,1,0,1,0
56772,53,30219,53,allow,185,102,83,2,29,1,1
50628,80,65125,80,allow,4349,647,3702,16,22,7,9
53685,445,0,0,drop,66,66,0,1,0,1,0
50297,445,0,0,drop,70,70,0,1,0,1,0
57995,445,0,0,drop,70,70,0,1,0,1,0
63019,445,0,0,drop,66,66,0,1,0,1,0
49976,53,5693,53,allow,393,110,283,2,30,1,1
27783,57470,0,0,deny,62,62,0,1,0,1,0
55308,445,0,0,drop,70,70,0,1,0,1,0
64876,445,0,0,drop,66,66,0,1,0,1,0
64595,53,24899,53,allow,167,86,81,2,29,1,1
61345,445,0,0,drop,70,70,0,1,0,1,0
55640,54435,47783,54435,allow,70,70,0,2,8,2,0
56862,445,0,0,drop,66,66,0,1,0,1,0
63960,53,46740,53,allow,228,110,118,2,29,1,1
32912,53,0,0,allow,82,82,0,1,31,1,0
35894,17,0,0,deny,60,60,0,1,0,1,0
55958,53,40832,53,allow,177,94,83,2,30,1,1
56690,443,32613,443,allow,3936,2585,1351,18,18,10,8
52596,17372,0,0,deny,62,62,0,1,0,1,0
8890,443,57332,443,allow,4367,1108,3259,37,426,11,26
49752,53,46099,53,allow,180,92,88,2,31,1,1
44628,80,44628,80,allow,2898,1485,1413,10,15,6,4
56867,445,0,0,drop,70,70,0,1,0,1,0
49242,445,0,0,drop,70,70,0,1,0,1,0
65071,80,65071,80,allow,296372,11959,284413,311,23,113,198
53703,16426,15322,16426,allow,70,70,0,2,7,2,0
55208,443,24176,443,allow,7224,114,7110,9,122,2,7
56589,53,14177,53,allow,166,86,80,2,30,1,1
41011,443,63172,443,allow,175097,9838,165259,244,106,120,124
59282,443,30587,443,allow,5413,968,4445,20,15,11,9
55616,53,41127,53,allow,776,102,674,2,30,1,1
56822,53,60516,53,allow,184,94,90,2,30,1,1
50967,445,0,0,drop,70,70,0,1,0,1,0
52661,53,0,0,allow,86,86,0,1,30,1,0
58914,37965,0,0,deny,66,66,0,1,0,1,0
46770,80,34528,80,allow,2068,1371,697,13,83,7,6
42096,80,4456,80,allow,1711,698,1013,14,17,6,8
1790,48817,0,0,deny,66,66,0,1,0,1,0
56731,443,49373,443,allow,7907,1918,5989,20,15,11,9
65044,443,31714,443,allow,4446,2496,1950,9,120,5,4
56448,53,33079,53,allow,200,102,98,2,30,1,1
62956,445,0,0,drop,66,66,0,1,0,1,0
65413,445,0,0,drop,70,70,0,1,0,1,0
50339,80,14820,80,allow,306,180,126,6,41,4,2
49401,445,0,0,drop,66,66,0,1,0,1,0
45964,2225,0,0,deny,60,60,0,1,0,1,0
60979,445,0,0,drop,66,66,0,1,0,1,0
52672,22114,0,0,deny,146,146,0,1,0,1,0
31627,64147,0,0,deny,62,62,0,1,0,1,0
44528,5900,0,0,deny,60,60,0,1,0,1,0
27005,27016,52333,27016,allow,892,126,766,2,30,1,1
61039,445,0,0,drop,70,70,0,1,0,1,0
5938,51883,0,0,allow,60,60,0,1,91,1,0
54007,50265,0,0,deny,66,66,0,1,0,1,0
65235,53,39902,53,allow,216,94,122,2,30,1,1
64722,53,55455,53,allow,214,110,104,2,30,1,1
8979,443,54799,443,allow,62149740,2002795,60146945,62894,211,19380,43514
50543,443,11342,443,allow,11275,4454,6821,24,36,13,11
49257,53,51275,53,allow,166,86,80,2,29,1,1
57397,53,42342,53,allow,256,93,163,2,31,1,1
57258,53,22772,53,allow,821,102,719,2,30,1,1
43463,443,25009,443,allow,6919,1449,5470,21,186,12,9
49780,53,7446,53,allow,182,93,89,2,31,1,1
64288,53,49667,53,allow,183,94,89,2,29,1,1
62044,445,0,0,drop,70,70,0,1,0,1,0
60375,445,0,0,drop,70,70,0,1,0,1,0
60505,53,0,0,allow,340,90,250,2,31,1,1
57470,42329,52817,42329,allow,1782,1782,0,28,1559,28,0
8999,57099,0,0,deny,146,146,0,1,0,1,0
58038,80,30379,80,allow,5029,2608,2421,15,25,9,6
53819,9472,3134,9472,allow,70,70,0,1,5,1,0
53804,24067,28773,24067,allow,70,70,0,1,4,1,0
30307,51505,0,0,deny,62,62,0,1,0,1,0
56050,53,45376,53,allow,178,94,84,2,30,1,1
57142,445,0,0,drop,66,66,0,1,0,1,0
63709,21989,3950,21989,allow,696,508,188,10,16,7,3
23089,48817,0,0,deny,62,62,0,1,0,1,0
49920,443,45165,443,allow,8888,2265,6623,18,15,9,9
48229,53,48229,53,allow,213,87,126,2,31,1,1
63313,443,9713,443,allow,1786,172,1614,7,120,3,4
52923,443,55900,443,allow,5581,1388,4193,19,15,9,10
64756,11392,0,0,deny,62,62,0,1,0,1,0
59255,445,0,0,drop,66,66,0,1,0,1,0
65133,53,55111,53,allow,198,102,96,2,30,1,1
65246,53,33087,53,allow,174,89,85,2,31,1,1
57009,53,48433,53,allow,177,94,83,2,30,1,1
58836,51505,0,0,deny,66,66,0,1,0,1,0
55300,445,0,0,drop,66,66,0,1,0,1,0
52123,1433,0,0,deny,60,60,0,1,0,1,0
58677,28678,3047,28678,allow,1806,1806,0,22,225,22,0
50530,445,0,0,drop,70,70,0,1,0,1,0
57833,443,7309,443,allow,215996,13055,202941,265,127,96,169
51582,443,29660,443,allow,9080,2186,6894,27,108,14,13
47605,443,46505,443,allow,12572,3471,9101,34,363,14,20
62424,445,0,0,drop,66,66,0,1,0,1,0
40375,443,13030,443,allow,130,70,60,3,5,2,1
52898,445,0,0,drop,70,70,0,1,0,1,0
22394,53,22394,53,allow,233,91,142,2,31,1,1
51567,443,62736,443,allow,400,70,330,7,17,2,5
55995,53,32542,53,allow,329,118,211,2,30,1,1
55464,22114,0,0,deny,62,62,0,1,0,1,0
65218,53,5567,53,allow,194,102,92,2,31,1,1
58306,443,59387,443,allow,864,436,428,13,29,7,6
33588,443,49965,443,allow,6382,2331,4051,24,109,13,11
58638,5900,0,0,deny,62,62,0,1,0,1,0
49743,53,12081,53,allow,636,202,434,6,47,3,3
64116,53,5820,53,allow,184,94,90,2,31,1,1
51710,43069,28929,43069,allow,70,70,0,1,5,1,0
51212,445,0,0,drop,70,70,0,1,0,1,0
50667,80,4915,80,allow,3778,2082,1696,12,21,7,5
52757,80,11666,80,allow,2426,1594,832,17,151,9,8
6881,34635,39166,34635,allow,228,118,110,2,1200,1,1
58638,5900,0,0,deny,62,62,0,1,0,1,0
53571,19636,50196,19636,allow,70,70,0,2,7,2,0
59395,445,0,0,drop,70,70,0,1,0,1,0
32908,443,31863,443,allow,1780845,46018,1734827,1751,141,546,1205
17842,22114,0,0,deny,62,62,0,1,0,1,0
56534,53,33541,53,allow,276,94,182,2,30,1,1
51788,80,12159,80,allow,35407,1784,33623,46,20,20,26
7273,64147,0,0,deny,66,66,0,1,0,1,0
49678,445,0,0,drop,70,70,0,1,0,1,0
62238,443,62238,443,allow,58141,3051,55090,78,78,29,49
55563,53,39714,53,allow,194,102,92,2,30,1,1
54654,445,0,0,drop,70,70,0,1,0,1,0
65228,53,60799,53,allow,267,93,174,4,47,2,2
62765,445,0,0,drop,70,70,0,1,0,1,0
50213,53,31929,53,allow,774,102,672,2,30,1,1
65108,53,40239,53,allow,215,94,121,2,30,1,1
60117,50934,0,0,deny,62,62,0,1,0,1,0
22583,9822,0,0,deny,62,62,0,1,0,1,0
53563,35440,0,0,deny,66,66,0,1,0,1,0
53620,443,60649,443,allow,15422,1623,13799,34,18,14,20
49508,445,0,0,drop,70,70,0,1,0,1,0
57435,53,39763,53,allow,184,102,82,2,30,1,1
9231,3389,0,0,deny,66,66,0,1,0,1,0
55812,53,26314,53,allow,215,94,121,2,30,1,1
16905,57866,0,0,deny,66,66,0,1,0,1,0
59993,445,0,0,drop,70,70,0,1,0,1,0
50396,445,0,0,drop,70,70,0,1,0,1,0
33136,443,16239,443,allow,6648,1556,5092,23,29,13,10
38699,443,63342,443,allow,759586,14873,744713,719,16,209,510
58638,5900,58638,5900,allow,62,62,0,1,5,1,0
63138,51452,7117,51452,allow,70,70,0,1,5,1,0
50209,1688,16419,1688,allow,70,70,0,1,4,1,0
55190,53,7214,53,allow,733,86,647,2,31,1,1
53233,443,53233,443,allow,4114,2535,1579,25,139,13,12
10425,23,0,0,deny,60,60,0,1,0,1,0
6824,26467,0,0,deny,66,66,0,1,0,1,0
27345,53,27345,53,allow,398,255,143,3,33,2,1
65529,35440,0,0,deny,62,62,0,1,0,1,0
52459,3399,0,0,deny,60,60,0,1,0,1,0
19473,32332,63968,32332,allow,481,150,331,2,1200,1,1
54366,443,39148,443,allow,17629,5828,11801,39,41,20,19
63062,11392,0,0,deny,62,62,0,1,0,1,0
57496,445,0,0,drop,70,70,0,1,0,1,0
56213,26467,0,0,deny,66,66,0,1,0,1,0
49724,443,6596,443,allow,7226,844,6382,19,50,9,10
17213,22114,0,0,deny,62,62,0,1,0,1,0
65060,35440,0,0,deny,66,66,0,1,0,1,0
56661,53,16607,53,allow,288,93,195,4,32,2,2
61295,443,61295,443,allow,5014,1722,3292,17,18,10,7
52024,25174,0,0,deny,66,66,0,1,0,1,0
52965,443,44159,443,allow,86041,4656,81385,102,113,34,68
65521,53,52937,53,allow,167,86,81,2,30,1,1
57179,445,0,0,drop,70,70,0,1,0,1,0
36551,443,34195,443,allow,8674,2101,6573,25,15,13,12
62139,53,5028,53,allow,298,102,196,2,30,1,1
14429,443,41458,443,allow,4118,2905,1213,27,87,16,11
62895,993,31409,993,allow,10457,4879,5578,98,186,50,48
56966,80,60389,80,allow,214,140,74,4,30,3,1
61392,50584,0,0,deny,62,62,0,1,0,1,0
36851,53,31171,53,allow,86,86,0,1,30,1,0
58225,445,0,0,drop,70,70,0,1,0,1,0
62122,445,0,0,drop,66,66,0,1,0,1,0
33638,443,11926,443,allow,1784,1010,774,16,185,9,7
58274,445,0,0,drop,66,66,0,1,0,1,0
65381,53,27857,53,allow,317,102,215,2,31,1,1
45079,443,33534,443,allow,7298,2661,4637,21,18,11,10
59383,445,0,0,drop,70,70,0,1,0,1,0
29697,51221,0,0,deny,62,62,0,1,0,1,0
51209,443,64337,443,allow,84768,21103,63665,136,133,58,78
56427,53,59297,53,allow,164,84,80,2,31,1,1
2918,37965,0,0,deny,62,62,0,1,0,1,0
39550,80,36745,80,allow,1598,731,867,17,362,8,9
35232,36602,0,0,deny,74,74,0,1,0,1,0
4752,30188,0,0,deny,62,62,0,1,0,1,0
61402,445,0,0,drop,70,70,0,1,0,1,0
45908,3383,0,0,deny,60,60,0,1,0,1,0
57419,445,0,0,drop,70,70,0,1,0,1,0
51842,443,3576,443,allow,1503,984,519,13,31,8,5
65143,53,4098,53,allow,184,94,90,2,31,1,1
16319,44847,0,0,deny,62,62,0,1,0,1,0
53785,53,12230,53,allow,167,78,89,2,31,1,1
52128,21294,45027,21294,allow,70,70,0,1,4,1,0
49723,80,53474,80,allow,2367,557,1810,10,82,6,4
58587,445,0,0,drop,70,70,0,1,0,1,0
65325,53,57020,53,allow,216,110,106,2,29,1,1
45964,5333,0,0,deny,60,60,0,1,0,1,0
55634,445,0,0,drop,70,70,0,1,0,1,0
49795,445,0,0,drop,70,70,0,1,0,1,0
59315,35440,0,0,deny,66,66,0,1,0,1,0
37845,443,37845,443,allow,4441,1534,2907,19,25,11,8
55379,445,0,0,drop,70,70,0,1,0,1,0
17781,44847,0,0,deny,146,146,0,1,0,1,0
56639,53,41760,53,allow,168,86,82,2,30,1,1
49642,80,32526,80,allow,312,192,120,6,41,4,2
50116,22,50116,22,allow,184,120,64,4,11,3,1
62470,443,10717,443,allow,38402253,1191239,37211014,39088,243,12126,26962
50337,37965,0,0,deny,66,66,0,1,0,1,0
56658,443,35998,443,allow,18959,1799,17160,35,110,15,20
59597,37965,0,0,deny,66,66,0,1,0,1,0
56404,445,0,0,drop,70,70,0,1,0,1,0
51072,80,39928,80,allow,1299,793,506,12,16,6,6
50690,443,43818,443,allow,354,294,60,2,5,1,1
56502,53,50256,53,allow,726,85,641,2,31,1,1
37584,80,39013,80,allow,3587,2484,1103,19,135,10,9
50308,445,0,0,drop,70,70,0,1,0,1,0
60721,22114,0,0,deny,66,66,0,1,0,1,0
42443,443,56747,443,allow,5378,1512,3866,20,16,11,9
37031,443,21372,443,allow,43818,31519,12299,85,259,49,36
55592,445,0,0,drop,70,70,0,1,0,1,0
3818,37965,0,0,deny,66,66,0,1,0,1,0
57445,66,37294,66,allow,70,70,0,2,8,2,0
44847,12269,58091,12269,allow,502,150,352,2,1200,1,1
16285,23,0,0,deny,60,60,0,1,0,1,0
22856,22114,0,0,deny,62,62,0,1,0,1,0
22981,15503,0,0,deny,62,62,0,1,0,1,0
49789,53,40494,53,allow,177,94,83,2,30,1,1
58638,5900,0,0,deny,62,62,0,1,0,1,0
65075,445,0,0,drop,70,70,0,1,0,1,0
56660,53,40707,53,allow,183,94,89,2,30,1,1
58649,443,35795,443,allow,7701,2215,5486,28,373,14,14
53933,445,0,0,drop,66,66,0,1,0,1,0
0,0,0,0,allow,124,64,60,2,0,1,1
56333,53,9058,53,allow,822,102,720,2,29,1,1
52177,25320,0,0,deny,66,66,0,1,0,1,0
49516,35894,0,0,deny,62,62,0,1,0,1,0
58638,5900,0,0,deny,62,62,0,1,0,1,0
59976,80,48173,80,allow,890,469,421,10,360,5,5
56752,44847,0,0,deny,66,66,0,1,0,1,0
63416,445,0,0,drop,66,66,0,1,0,1,0
49626,53,39799,53,allow,969,86,883,2,30,1,1
65131,53,44924,53,allow,168,86,82,2,30,1,1
61550,445,0,0,drop,70,70,0,1,0,1,0
50316,37965,0,0,deny,66,66,0,1,0,1,0
52233,42673,65112,42673,allow,136,136,0,3,14,3,0
51742,30317,0,0,deny,66,66,0,1,0,1,0
65498,53,26410,53,allow,209,110,99,2,30,1,1
50993,445,0,0,drop,66,66,0,1,0,1,0
51382,56205,0,0,deny,62,62,0,1,0,1,0
20108,64147,0,0,deny,66,66,0,1,0,1,0
53730,37096,47492,37096,allow,70,70,0,2,7,2,0
53173,445,0,0,drop,66,66,0,1,0,1,0
54684,37965,0,0,deny,62,62,0,1,0,1,0
56339,53,35770,53,allow,280,78,202,2,30,1,1
64926,53,24382,53,allow,166,86,80,2,30,1,1
65485,53,26521,53,allow,184,94,90,2,31,1,1
52135,2790,0,0,deny,66,66,0,1,0,1,0
65160,443,49536,443,allow,1786,172,1614,7,120,3,4
56291,53,26835,53,allow,177,94,83,2,30,1,1
54953,53,34688,53,allow,263,94,169,2,30,1,1
56536,53,3128,53,allow,209,110,99,2,31,1,1
52564,15503,0,0,deny,74,74,0,1,0,1,0
51062,80,29351,80,allow,36568,23029,13539,94,194,47,47
65493,445,0,0,drop,70,70,0,1,0,1,0
52060,443,18866,443,allow,40726,3421,37305,52,121,20,32
56164,53,3250,53,allow,226,110,116,2,30,1,1
64867,53,35181,53,allow,184,86,98,2,30,1,1
62348,57470,0,0,deny,109,109,0,1,0,1,0
51269,36983,59727,36983,allow,70,70,0,1,5,1,0
49567,443,55321,443,allow,6408,2531,3877,21,15,11,10
2506,443,2506,443,allow,35555,4646,30909,59,23,33,26
19473,28867,41961,28867,allow,480,149,331,2,1200,1,1
1446,35440,0,0,deny,62,62,0,1,0,1,0
15341,23,0,0,deny,60,60,0,1,0,1,0
44929,443,17835,443,allow,554,280,274,9,111,5,4
49394,443,62275,443,allow,1392,731,661,14,80,8,6
5213,44847,0,0,deny,62,62,0,1,0,1,0
44847,17977,12872,17977,allow,502,150,352,2,1200,1,1
50237,53,33615,53,allow,183,94,89,2,30,1,1
33730,443,53132,443,allow,5947,1579,4368,22,315,12,10
55368,53,50855,53,allow,760,97,663,2,31,1,1
6881,6881,0,0,deny,62,62,0,1,0,1,0
65189,27241,23433,27241,allow,235,71,164,2,31,1,1
57470,6881,10823,6881,allow,132,132,0,3,1200,3,0
60226,443,32684,443,allow,1907736,31488,1876248,1747,21,470,1277
65248,53,49147,53,allow,212,110,102,2,30,1,1
32515,443,32515,443,allow,34885,6636,28249,74,51,38,36
64006,445,0,0,drop,70,70,0,1,0,1,0
65201,53,45437,53,allow,334,94,240,2,30,1,1
54403,445,0,0,drop,70,70,0,1,0,1,0
65213,53,54852,53,allow,298,94,204,2,30,1,1
49837,53,8590,53,allow,176,90,86,2,30,1,1
51150,53,51368,53,allow,167,78,89,2,30,1,1
15341,23,0,0,deny,60,60,0,1,0,1,0
58757,445,0,0,drop,70,70,0,1,0,1,0
13285,29892,0,0,deny,145,145,0,1,0,1,0
63419,445,0,0,drop,70,70,0,1,0,1,0
55887,53,42850,53,allow,164,84,80,2,31,1,1
42349,443,27589,443,allow,90562,4227,86335,118,200,49,69
65003,57470,0,0,deny,78,78,0,1,0,1,0
56919,53,56265,53,allow,177,94,83,2,30,1,1
48223,5222,8848,5222,allow,14939,1037,13902,35,579,11,24
59051,445,0,0,drop,66,66,0,1,0,1,0
18683,26467,0,0,deny,62,62,0,1,0,1,0
53552,8999,43016,8999,allow,70,70,0,1,4,1,0
55917,53,22277,53,allow,177,94,83,2,30,1,1
55519,53,47075,53,allow,193,102,91,2,30,1,1
62382,445,0,0,drop,70,70,0,1,0,1,0
50394,80,50061,80,allow,306,180,126,6,26,4,2
64424,53,20113,53,allow,194,94,100,2,30,1,1
15530,49718,0,0,deny,146,146,0,1,0,1,0
65285,50584,0,0,deny,62,62,0,1,0,1,0
8760,22114,0,0,deny,66,66,0,1,0,1,0
1025,50584,0,0,deny,62,62,0,1,0,1,0
28899,37965,0,0,deny,62,62,0,1,0,1,0
64541,53,6698,53,allow,363,94,269,2,30,1,1
33734,53,33734,53,allow,257,101,156,2,33,1,1
65209,445,0,0,drop,70,70,0,1,0,1,0
54031,53,23447,53,allow,168,78,90,2,30,1,1
58821,443,62939,443,allow,16200,10803,5397,42,18,24,18
55938,53,49190,53,allow,780,93,687,2,30,1,1
55037,443,21745,443,allow,2639,258,2381,9,120,4,5
53063,443,53063,443,allow,6793,3206,3587,25,52,15,10
65160,53,39178,53,allow,198,94,104,2,30,1,1
58922,57470,0,0,deny,66,66,0,1,0,1,0
50982,445,0,0,drop,66,66,0,1,0,1,0
50386,80,26554,80,allow,6718,3126,3592,16,77,8,8
44847,51413,1303,51413,allow,475,150,325,2,1200,1,1
22583,53,22583,53,allow,213,82,131,2,30,1,1
42964,5900,0,0,deny,60,60,0,1,0,1,0
3945,35440,0,0,deny,66,66,0,1,0,1,0
57063,445,0,0,drop,70,70,0,1,0,1,0
33995,443,61498,443,allow,6419,995,5424,21,361,11,10
27828,56205,0,0,deny,146,146,0,1,0,1,0
51635,50265,0,0,deny,66,66,0,1,0,1,0
37662,2323,0,0,deny,60,60,0,1,0,1,0
50442,445,0,0,drop,70,70,0,1,0,1,0
35626,22114,0,0,deny,66,66,0,1,0,1,0
61100,445,0,0,drop,66,66,0,1,0,1,0
63063,445,0,0,drop,66,66,0,1,0,1,0
56360,443,55866,443,allow,188316,24744,163572,302,172,119,183
55594,53,43491,53,allow,167,86,81,2,30,1,1
52131,28980,48915,28980,allow,70,70,0,2,8,2,0
55624,80,8124,80,allow,70,70,0,2,8,2,0
49533,80,42327,80,allow,8220,849,7371,13,28,5,8
57090,445,0,0,drop,70,70,0,1,0,1,0
59044,445,0,0,drop,66,66,0,1,0,1,0
64062,445,0,0,drop,66,66,0,1,0,1,0
56825,445,0,0,drop,70,70,0,1,0,1,0
64274,445,0,0,drop,66,66,0,1,0,1,0
57299,443,9312,443,allow,23282,4482,18800,67,17,35,32
51833,47388,26582,47388,allow,70,70,0,2,6,2,0
12608,21247,0,0,deny,66,66,0,1,0,1,0
55558,445,0,0,drop,70,70,0,1,0,1,0
64911,53,46196,53,allow,209,110,99,2,31,1,1
58986,445,0,0,drop,66,66,0,1,0,1,0
56426,53,49161,53,allow,184,94,90,2,30,1,1
16387,8455,0,0,deny,60,60,0,1,0,1,0
60348,80,15161,80,allow,10335,1617,8718,19,124,9,10
53895,443,53348,443,allow,499,425,74,4,0,3,1
58866,443,35097,443,allow,5166,700,4466,16,15,7,9
60742,443,40207,443,allow,2258,559,1699,22,120,6,16
60820,445,0,0,drop,66,66,0,1,0,1,0
4300,37838,0,0,deny,146,146,0,1,0,1,0
52522,445,0,0,drop,70,70,0,1,0,1,0
52327,445,0,0,drop,70,70,0,1,0,1,0
61714,445,0,0,drop,70,70,0,1,0,1,0
50584,34393,36839,34393,allow,509,150,359,2,1200,1,1
27005,27019,28663,27019,allow,1652,126,1526,4,31,2,2
50563,37965,0,0,deny,66,66,0,1,0,1,0
49900,443,38776,443,allow,8417,1173,7244,18,86,9,9
56222,53,43289,53,allow,168,78,90,2,30,1,1
2088,7010,2088,7010,allow,10300,8829,1471,24,15,13,11
62332,53,0,0,allow,633,75,558,2,29,1,1
49347,443,42711,443,allow,8309,949,7360,19,75,9,10
59637,445,0,0,drop,70,70,0,1,0,1,0
53916,23505,16942,23505,allow,70,70,0,1,5,1,0
57032,53,17045,53,allow,166,86,80,2,31,1,1
54882,445,0,0,drop,70,70,0,1,0,1,0
52173,44632,6542,44632,allow,156,66,90,2,5,1,1
31281,30188,0,0,deny,62,62,0,1,0,1,0
60603,445,0,0,drop,66,66,0,1,0,1,0
22220,25174,0,0,deny,62,62,0,1,0,1,0
55165,53,30043,53,allow,199,102,97,2,30,1,1
53325,443,60728,443,allow,6988,1214,5774,29,315,13,16
43381,443,3948,443,allow,9551,2173,7378,33,25,17,16
61221,35440,0,0,deny,66,66,0,1,0,1,0
54943,445,0,0,drop,70,70,0,1,0,1,0
5588,5588,0,0,allow,3354,1792,1562,46,192,23,23
56775,53,53871,53,allow,177,94,83,2,30,1,1
59400,22114,0,0,deny,66,66,0,1,0,1,0
56538,53,20855,53,allow,401,95,306,4,57,2,2
53860,33791,1451,33791,allow,492,306,186,8,16,5,3
59586,57470,0,0,deny,66,66,0,1,0,1,0
49656,443,50043,443,allow,11810,2769,9041,29,47,15,14
61480,443,37591,443,allow,5716,1341,4375,29,80,16,13
64276,53,2363,53,allow,354,102,252,2,30,1,1
51619,443,27223,443,allow,13526,2192,11334,32,141,16,16
56843,53,57824,53,allow,177,94,83,2,30,1,1
59957,443,65089,443,allow,8677,2714,5963,21,114,13,8
49233,53,6991,53,allow,819,102,717,2,29,1,1
50583,80,63777,80,allow,2226,1077,1149,13,79,7,6
59401,443,58968,443,allow,3010,1892,1118,16,15,8,8
42366,57470,0,0,deny,66,66,0,1,0,1,0
35065,23,0,0,deny,60,60,0,1,0,1,0
9506,443,29564,443,allow,3614,434,3180,11,15,6,5
63166,443,63166,443,allow,5407,2160,3247,22,38,13,9
63409,445,0,0,drop,70,70,0,1,0,1,0
63525,53,0,0,allow,174,77,97,2,30,1,1
10088,37807,0,0,deny,66,66,0,1,0,1,0
43129,20220,0,0,deny,62,62,0,1,0,1,0
51417,443,60924,443,allow,25865,7151,18714,36,15,19,17
49837,443,60962,443,allow,9634,2232,7402,24,123,12,12
55338,11744,0,0,deny,145,145,0,1,0,1,0
59615,53,32493,53,allow,320,94,226,2,30,1,1
42745,50011,0,0,deny,62,62,0,1,0,1,0
27005,50001,15883,50001,allow,1656,126,1530,4,31,2,2
55413,53,32368,53,allow,216,110,106,2,31,1,1
60415,443,32364,443,allow,7727,2796,4931,36,104,18,18
60311,56205,0,0,deny,66,66,0,1,0,1,0
65352,443,3902,443,allow,12690,1918,10772,39,195,19,20
46774,51050,0,0,deny,146,146,0,1,0,1,0
56039,445,0,0,drop,70,70,0,1,0,1,0
57709,443,55185,443,allow,10392,2789,7603,25,16,13,12
50265,27813,47510,27813,allow,198,198,0,4,1200,4,0
62737,64147,0,0,deny,66,66,0,1,0,1,0
58638,5900,0,0,deny,62,62,0,1,0,1,0
65460,53,30831,53,allow,197,102,95,2,30,1,1
65132,53,11821,53,allow,166,85,81,2,31,1,1
24301,6881,0,0,deny,62,62,0,1,0,1,0
41197,30188,0,0,deny,146,146,0,1,0,1,0
49247,53,4260,53,allow,194,102,92,2,31,1,1
57470,13613,53702,13613,allow,1577,594,983,20,1638,10,10
64455,445,0,0,drop,70,70,0,1,0,1,0
3777,64097,0,0,deny,146,146,0,1,0,1,0
56783,53,31906,53,allow,751,95,656,2,31,1,1
53760,45682,20604,45682,allow,70,70,0,1,4,1,0
51132,445,0,0,drop,66,66,0,1,0,1,0
1042,64147,0,0,deny,145,145,0,1,0,1,0
49178,53,26968,53,allow,199,102,97,2,29,1,1
57173,44847,0,0,deny,62,62,0,1,0,1,0
61674,443,44305,443,allow,6117,1224,4893,21,50,12,9
49867,53,44107,53,allow,170,87,83,2,30,1,1
52043,80,36469,80,allow,4185,3462,723,14,15,7,7
51793,80,57988,80,allow,3960,2330,1630,18,47,11,7
54669,445,0,0,drop,70,70,0,1,0,1,0
49627,53,55437,53,allow,760,97,663,2,30,1,1
52399,445,0,0,drop,66,66,0,1,0,1,0
58632,445,0,0,drop,70,70,0,1,0,1,0
58638,5900,0,0,deny,62,62,0,1,0,1,0
55423,53,61643,53,allow,711,87,624,2,31,1,1
57314,53,61726,53,allow,190,97,93,2,31,1,1
54631,443,8589,443,allow,130,70,60,3,5,2,1
55685,445,0,0,drop,70,70,0,1,0,1,0
59736,51505,0,0,deny,146,146,0,1,0,1,0
58375,445,0,0,drop,66,66,0,1,0,1,0
38891,64147,0,0,deny,145,145,0,1,0,1,0
2695,48817,0,0,deny,62,62,0,1,0,1,0
53817,59216,6687,59216,allow,258,70,188,4,8,2,2
56363,443,61094,443,allow,3734,1750,1984,24,203,12,12
52133,15015,56839,15015,allow,70,70,0,2,8,2,0
65153,38303,0,0,deny,66,66,0,1,0,1,0
63901,445,0,0,drop,66,66,0,1,0,1,0
48817,7131,48817,7131,allow,158,158,0,1,1200,1,0
52410,8604,0,0,deny,66,66,0,1,0,1,0
56532,53,29846,53,allow,291,88,203,4,50,2,2
49256,53,12893,53,allow,177,94,83,2,30,1,1
55027,53,14460,53,allow,177,94,83,2,29,1,1
61624,30317,0,0,deny,66,66,0,1,0,1,0
65168,53,45025,53,allow,749,94,655,2,30,1,1
56155,53,9723,53,allow,199,102,97,2,30,1,1
60890,443,16222,443,allow,5089,4217,872,23,47,13,10
2886,35440,0,0,deny,66,66,0,1,0,1,0
64877,53,41929,53,allow,209,110,99,2,30,1,1
49187,2710,40478,2710,allow,70,70,0,2,7,2,0
49950,443,56465,443,allow,6770,2219,4551,21,89,11,10
21492,51505,0,0,deny,146,146,0,1,0,1,0
35797,53,35797,53,allow,217,90,127,2,30,1,1
64191,44847,0,0,deny,66,66,0,1,0,1,0
58638,5900,0,0,deny,62,62,0,1,0,1,0
51635,50265,0,0,deny,66,66,0,1,0,1,0
28755,80,28755,80,allow,21270,2178,19092,35,29,15,20
56487,53,4784,53,allow,194,102,92,2,30,1,1
49211,443,58097,443,allow,9739,3414,6325,59,928,30,29
1033,35440,0,0,deny,146,146,0,1,0,1,0
51221,9869,40891,9869,allow,870,330,540,12,1298,6,6
56983,53,28765,53,allow,424,108,316,4,55,2,2
48187,443,22685,443,allow,1515,568,947,14,82,6,8
61662,445,0,0,drop,70,70,0,1,0,1,0
64557,53,9245,53,allow,766,102,664,2,30,1,1
50175,53,51711,53,allow,819,102,717,2,30,1,1
5588,5588,0,0,allow,3354,1792,1562,46,192,23,23
50074,53,48010,53,allow,168,86,82,2,30,1,1
63421,53,63421,53,allow,223,86,137,2,30,1,1
50246,445,0,0,drop,66,66,0,1,0,1,0
54986,53,26600,53,allow,214,110,104,2,30,1,1
57931,445,0,0,drop,70,70,0,1,0,1,0
51889,445,0,0,drop,66,66,0,1,0,1,0
59191,445,0,0,drop,70,70,0,1,0,1,0
54588,445,0,0,drop,66,66,0,1,0,1,0
65332,53,1654,53,allow,226,86,140,2,29,1,1
51928,80,8868,80,allow,1357,963,394,10,26,7,3
10151,11888,57602,11888,allow,491,150,341,2,1200,1,1
51744,445,0,0,drop,70,70,0,1,0,1,0
45941,23386,0,0,deny,60,60,0,1,0,1,0
56819,53,59960,53,allow,202,103,99,2,31,1,1
64959,53,50159,53,allow,173,94,79,2,30,1,1
59923,53,7241,53,allow,197,78,119,2,30,1,1
60853,445,0,0,drop,66,66,0,1,0,1,0
64694,53,22388,53,allow,289,82,207,4,46,2,2
60046,445,0,0,drop,66,66,0,1,0,1,0
49900,7000,49900,7000,allow,2958,1567,1391,15,15,8,7
6461,25174,0,0,deny,66,66,0,1,0,1,0
37965,21859,39298,21859,allow,481,150,331,2,1199,1,1
39854,443,9295,443,allow,7903,3497,4406,38,72,22,16
50593,445,0,0,drop,66,66,0,1,0,1,0
50168,445,0,0,drop,66,66,0,1,0,1,0
49743,445,0,0,drop,66,66,0,1,0,1,0
52667,80,52667,80,allow,2011,1422,589,12,48,6,6
49418,27017,43664,27017,allow,259,71,188,2,31,1,1
56169,53,42323,53,allow,204,104,100,2,30,1,1
50347,53,2188,53,allow,756,94,662,2,29,1,1
50938,445,0,0,drop,66,66,0,1,0,1,0
51221,49857,1668,49857,allow,791,266,525,8,1200,4,4
49940,53,16387,53,allow,257,110,147,2,29,1,1
64949,53,23952,53,allow,208,106,102,2,31,1,1
50549,445,0,0,drop,66,66,0,1,0,1,0
11061,4229,0,0,deny,145,145,0,1,0,1,0
58803,443,12977,443,allow,5166,700,4466,16,15,7,9
55613,53,1186,53,allow,177,94,83,2,30,1,1
50996,443,8675,443,allow,3536,2039,1497,22,18,11,11
56127,35440,0,0,deny,62,62,0,1,0,1,0
53262,443,44480,443,allow,7608,1340,6268,27,53,13,14
56568,53,49055,53,allow,206,105,101,2,30,1,1
49320,53,42245,53,allow,331,90,241,4,38,2,2
65251,53,19717,53,allow,819,102,717,2,30,1,1
65281,53,27234,53,allow,216,94,122,2,30,1,1
53130,10168,25089,10168,allow,320,140,180,6,5,3,3
14185,48637,0,0,deny,60,60,0,1,0,1,0
51230,80,14122,80,allow,579418,15579,563839,599,76,219,380
56883,53,10133,53,allow,184,94,90,2,30,1,1
51408,443,60315,443,allow,8774,3355,5419,19,36,11,8
59669,445,0,0,drop,70,70,0,1,0,1,0
53760,80,45731,80,allow,1667,619,1048,10,45,6,4
63577,30188,0,0,deny,66,66,0,1,0,1,0
53427,443,4839,443,allow,9896,2040,7856,34,120,17,17
65382,443,15464,443,allow,15607,5238,10369,36,126,19,17
54021,443,39071,443,allow,7653,1188,6465,21,16,12,9
61784,445,0,0,drop,70,70,0,1,0,1,0
51221,1338,12971,1338,allow,132,132,0,3,1200,3,0
58638,5900,0,0,deny,62,62,0,1,0,1,0
56660,53,34940,53,allow,183,94,89,2,30,1,1
26500,80,26500,80,allow,57276,6978,50298,77,30,34,43
58638,5900,0,0,deny,62,62,0,1,0,1,0
37253,443,5340,443,allow,6840,1556,5284,32,26,17,15
49542,443,22517,443,allow,9824,1839,7985,27,172,13,14
51625,445,0,0,drop,66,66,0,1,0,1,0
55589,53,33223,53,allow,177,94,83,2,29,1,1
57438,53,17355,53,allow,782,105,677,2,30,1,1
51973,44847,0,0,deny,66,66,0,1,0,1,0
55851,53,42151,53,allow,277,110,167,2,30,1,1
49163,445,0,0,drop,70,70,0,1,0,1,0
58062,443,59135,443,allow,2257,1225,1032,15,18,8,7
14445,443,55284,443,allow,2589,1443,1146,18,15,8,10
64819,445,0,0,drop,70,70,0,1,0,1,0
57606,443,30554,443,allow,2614,1689,925,18,22,10,8
41235,443,2013,443,allow,1807,1048,759,16,26,8,8
64193,445,0,0,drop,70,70,0,1,0,1,0
64105,53,18897,53,allow,182,86,96,2,30,1,1
52410,8604,0,0,deny,66,66,0,1,0,1,0
61816,80,7127,80,allow,2058,589,1469,10,45,6,4
443,54507,0,0,deny,82,82,0,1,0,1,0
34391,443,18031,443,allow,80160,3527,76633,98,76,38,60
57394,53,39709,53,allow,193,102,91,2,31,1,1
51213,443,22292,443,allow,6333,2018,4315,25,17,15,10
58425,445,0,0,drop,70,70,0,1,0,1,0
52876,443,52876,443,allow,5045,2187,2858,16,136,8,8
49926,53,63439,53,allow,180,94,86,2,30,1,1
53431,445,0,0,drop,66,66,0,1,0,1,0
52806,445,0,0,drop,70,70,0,1,0,1,0
49237,80,10310,80,allow,1934086,60476,1873610,1754,162,493,1261
20457,51185,0,0,deny,72,72,0,1,0,1,0
64497,445,0,0,drop,70,70,0,1,0,1,0
34244,80,38249,80,allow,656,398,258,11,39,7,4
58933,445,0,0,drop,66,66,0,1,0,1,0
42463,56205,0,0,deny,146,146,0,1,0,1,0
51270,48061,59473,48061,allow,70,70,0,2,8,2,0
1712,23,0,0,deny,60,60,0,1,0,1,0
64357,53,56985,53,allow,183,94,89,2,30,1,1
64580,53,13673,53,allow,199,102,97,2,30,1,1
49351,443,50580,443,allow,11389,1184,10205,22,76,9,13
30697,57866,0,0,deny,62,62,0,1,0,1,0
59739,35253,0,0,deny,62,62,0,1,0,1,0
55722,26192,12187,26192,allow,70,70,0,2,8,2,0
64064,53,52675,53,allow,257,94,163,2,30,1,1
28584,37965,0,0,deny,62,62,0,1,0,1,0
14421,443,39143,443,allow,15204,8747,6457,83,167,44,39
61591,22114,0,0,deny,62,62,0,1,0,1,0
60799,25174,0,0,deny,66,66,0,1,0,1,0
55330,445,0,0,drop,70,70,0,1,0,1,0
56752,80,35742,80,allow,1462,703,759,8,16,5,3
58638,5900,0,0,deny,62,62,0,1,0,1,0
59996,443,60855,443,allow,1641,730,911,14,18,8,6
60368,443,14990,443,allow,10483,4072,6411,20,26,9,11
54460,445,0,0,drop,66,66,0,1,0,1,0
60432,54312,22904,54312,allow,701,455,246,8,15,4,4
58435,64631,0,0,deny,74,74,0,1,0,1,0
56668,53,61814,53,allow,177,94,83,2,29,1,1
62041,445,0,0,drop,70,70,0,1,0,1,0
56139,53,55354,53,allow,306,94,212,2,30,1,1
61430,443,43160,443,allow,7288,1763,5525,22,77,12,10
443,50238,0,0,deny,99,99,0,1,0,1,0
53544,445,0,0,drop,70,70,0,1,0,1,0
55210,53,63664,53,allow,969,86,883,2,30,1,1
55955,53,35067,53,allow,184,94,90,2,31,1,1
5223,1210,0,0,deny,103,103,0,1,0,1,0
17177,64147,0,0,deny,62,62,0,1,0,1,0
64005,445,0,0,drop,66,66,0,1,0,1,0
54969,53,41747,53,allow,199,102,97,2,29,1,1
57595,443,62180,443,allow,291,171,120,4,16,2,2
50046,22114,0,0,deny,66,66,0,1,0,1,0
49952,53,50731,53,allow,190,97,93,2,30,1,1
1024,25174,0,0,deny,62,62,0,1,0,1,0
60602,15503,0,0,deny,62,62,0,1,0,1,0
27005,32039,29138,32039,allow,883,126,757,2,31,1,1
49003,53,49003,53,allow,262,106,156,2,32,1,1
16387,49252,0,0,deny,60,60,0,1,0,1,0
53077,80,56021,80,allow,1352,625,727,8,75,5,3
26900,27017,38585,27017,allow,6466,3520,2946,38,46,21,17
61808,18375,0,0,deny,66,66,0,1,0,1,0
9456,443,36831,443,allow,6096,777,5319,17,25,9,8
53501,445,0,0,drop,66,66,0,1,0,1,0
50946,44847,0,0,deny,66,66,0,1,0,1,0
44924,53,44924,53,allow,235,90,145,2,32,1,1
59153,35440,0,0,deny,62,62,0,1,0,1,0
60781,443,56303,443,allow,5964,3582,2382,17,136,8,9
49347,443,51852,443,allow,611644,29314,582330,793,132,333,460
56812,49600,3950,49600,allow,3060,1569,1491,12,16,7,5
51566,443,47460,443,allow,9451,3719,5732,45,76,25,20
46275,64147,0,0,deny,62,62,0,1,0,1,0
34529,443,32303,443,allow,77395,64623,12772,206,188,116,90
60204,2767,0,0,deny,66,66,0,1,0,1,0
51330,445,0,0,drop,66,66,0,1,0,1,0
52385,53,0,0,allow,138,69,69,2,30,1,1
64437,56205,0,0,deny,66,66,0,1,0,1,0
42903,53,55150,53,allow,168,78,90,2,30,1,1
0,0,0,0,allow,320,320,0,5,0,5,0
40501,443,64068,443,allow,6517,1812,4705,21,255,11,10
56478,53,64286,53,allow,200,102,98,2,30,1,1
41876,80,9169,80,allow,1740,708,1032,19,396,6,13
59549,50584,0,0,deny,66,66,0,1,0,1,0
54742,50584,0,0,deny,66,66,0,1,0,1,0
44052,80,38453,80,allow,282,60,222,5,12,2,3
51350,445,0,0,drop,70,70,0,1,0,1,0
57236,443,10665,443,allow,225524,59002,166522,402,78,192,210
6666,27017,0,0,deny,60,60,0,1,0,1,0
6909,57470,0,0,deny,62,62,0,1,0,1,0
55875,445,0,0,drop,66,66,0,1,0,1,0
31653,53,31653,53,allow,235,90,145,2,34,1,1
53106,445,0,0,drop,70,70,0,1,0,1,0
58871,443,24562,443,allow,405189,13572,391617,446,89,155,291
52867,445,0,0,drop,70,70,0,1,0,1,0
52026,26467,0,0,deny,60,60,0,1,0,1,0
55174,445,0,0,drop,66,66,0,1,0,1,0
62971,44847,0,0,deny,66,66,0,1,0,1,0
62324,445,0,0,drop,70,70,0,1,0,1,0
64188,53,45023,53,allow,194,94,100,2,30,1,1
32648,55108,0,0,deny,145,145,0,1,0,1,0
61082,445,0,0,drop,66,66,0,1,0,1,0
65354,445,0,0,drop,70,70,0,1,0,1,0
59147,51505,0,0,deny,66,66,0,1,0,1,0
443,54507,0,0,deny,82,82,0,1,0,1,0
57027,53,52973,53,allow,170,87,83,2,30,1,1
59673,445,0,0,drop,70,70,0,1,0,1,0
13285,29892,0,0,deny,145,145,0,1,0,1,0
57706,445,0,0,drop,70,70,0,1,0,1,0
58837,3389,58837,3389,allow,4429,2581,1848,21,33,11,10
45941,23386,0,0,deny,60,60,0,1,0,1,0
5588,5588,0,0,allow,3562,1936,1626,48,194,24,24
56983,53,62235,53,allow,221,94,127,2,29,1,1
55457,443,34189,443,allow,130,70,60,3,5,2,1
42894,443,60082,443,allow,448,78,370,6,25,1,5
59724,445,0,0,drop,66,66,0,1,0,1,0
52385,53,0,0,allow,138,69,69,2,30,1,1
49693,53,65326,53,allow,209,110,99,2,30,1,1
65241,53,1849,53,allow,198,102,96,2,30,1,1
21119,31573,0,0,deny,146,146,0,1,0,1,0
56369,443,26395,443,allow,3674,1750,1924,23,203,12,11
59960,443,41281,443,allow,1953,1223,730,16,16,9,7
58716,9694,0,0,deny,62,62,0,1,0,1,0
59680,80,46564,80,allow,5762500,128192,5634308,5613,134,1854,3759
58248,445,0,0,drop,70,70,0,1,0,1,0
60886,443,34294,443,allow,3855,2679,1176,28,45,15,13
26424,27189,0,0,deny,66,66,0,1,0,1,0
65507,53,17701,53,allow,211,102,109,2,30,1,1
64439,53,3142,53,allow,199,102,97,2,30,1,1
52749,64147,0,0,deny,66,66,0,1,0,1,0
50916,80,44611,80,allow,11456216,116932,11339284,9298,139,1683,7615
57022,80,30750,80,allow,77115,5003,72112,110,35,56,54
31132,53,31132,53,allow,227,89,138,2,30,1,1
55019,443,34089,443,allow,12411,7888,4523,33,17,19,14
51532,445,0,0,drop,70,70,0,1,0,1,0
64074,53,30034,53,allow,209,110,99,2,29,1,1
55325,53,53505,53,allow,199,102,97,2,30,1,1
40738,443,14631,443,allow,1656,114,1542,5,120,2,3
64954,445,0,0,drop,66,66,0,1,0,1,0
11816,50584,0,0,deny,66,66,0,1,0,1,0
52533,53,8262,53,allow,242,78,164,2,30,1,1
56369,53,8270,53,allow,186,95,91,2,31,1,1
53652,1900,0,0,deny,139,139,0,1,0,1,0
55040,443,46427,443,allow,62,62,0,1,4,1,0
1176,64147,0,0,deny,62,62,0,1,0,1,0
37572,443,25877,443,allow,499,425,74,4,0,3,1
53199,30188,0,0,deny,66,66,0,1,0,1,0
65451,53,45725,53,allow,178,94,84,2,30,1,1
24040,22114,0,0,deny,62,62,0,1,0,1,0
25009,35440,0,0,deny,66,66,0,1,0,1,0
60506,445,0,0,drop,66,66,0,1,0,1,0
52993,443,64908,443,allow,16229,3316,12913,23,125,9,14
56738,443,56738,443,allow,48740,2961,45779,73,46,33,40
57797,445,0,0,drop,70,70,0,1,0,1,0
53188,445,0,0,drop,70,70,0,1,0,1,0
53507,445,0,0,drop,70,70,0,1,0,1,0
36685,35440,0,0,deny,62,62,0,1,0,1,0
57468,57470,0,0,deny,66,66,0,1,0,1,0
54016,445,0,0,drop,70,70,0,1,0,1,0
55613,53,34338,53,allow,170,87,83,2,30,1,1
4594,35993,0,0,deny,62,62,0,1,0,1,0
64214,25174,0,0,deny,66,66,0,1,0,1,0
50307,80,5299,80,allow,2840,1750,1090,13,82,7,6
49373,443,19953,443,allow,1857,1218,639,18,104,11,7
37626,443,10434,443,allow,7766,1810,5956,24,46,14,10
50973,445,0,0,drop,66,66,0,1,0,1,0
51744,1678,51884,1678,allow,70,70,0,2,8,2,0
63452,445,0,0,drop,66,66,0,1,0,1,0
49484,80,60761,80,allow,318,192,126,6,39,4,2
56479,445,0,0,drop,66,66,0,1,0,1,0
3074,64147,0,0,deny,62,62,0,1,0,1,0
37965,63728,43778,63728,allow,1294,594,700,20,1781,10,10
13743,80,13743,80,allow,724,366,358,11,142,6,5
55593,53,42641,53,allow,193,102,91,2,29,1,1
64204,53,35802,53,allow,193,102,91,2,30,1,1
34382,26314,0,0,deny,143,143,0,1,0,1,0
63003,445,0,0,drop,70,70,0,1,0,1,0
55862,53,15902,53,allow,177,94,83,2,30,1,1
42597,443,21561,443,allow,6131,1399,4732,20,979,10,10
49313,53,30091,53,allow,199,102,97,2,30,1,1
56648,53,49574,53,allow,199,102,97,2,30,1,1
52557,44847,0,0,deny,62,62,0,1,0,1,0
64168,53,53054,53,allow,306,94,212,2,30,1,1
5729,22114,0,0,deny,66,66,0,1,0,1,0
55277,445,0,0,drop,70,70,0,1,0,1,0
53964,24389,41775,24389,allow,1473,842,631,12,15,7,5
5588,5588,0,0,allow,3354,1792,1562,46,194,23,23
45051,53,45051,53,allow,404,259,145,3,32,2,1
26469,26348,0,0,deny,62,62,0,1,0,1,0
35718,20238,0,0,deny,62,62,0,1,0,1,0
52709,443,18513,443,allow,266282,13744,252538,313,374,128,185
63899,445,0,0,drop,70,70,0,1,0,1,0
52189,445,0,0,drop,70,70,0,1,0,1,0
59323,53,1369,53,allow,260,86,174,2,30,1,1
57409,53,41368,53,allow,232,94,138,2,30,1,1
65484,53,10578,53,allow,195,86,109,2,30,1,1
47063,53,47063,53,allow,221,89,132,2,31,1,1
64651,53,19265,53,allow,196,94,102,2,30,1,1
42298,40034,23763,40034,allow,588,86,502,2,30,1,1
53738,25760,39657,25760,allow,2031,1019,1012,11,16,6,5
49740,53,60867,53,allow,341,85,256,4,42,2,2
55693,443,55693,443,allow,23467,2707,20760,45,80,21,24
61345,21247,0,0,deny,62,62,0,1,0,1,0
42608,1,0,0,deny,62,62,0,1,0,1,0
56219,22114,0,0,deny,66,66,0,1,0,1,0
57250,443,30751,443,allow,345315,16365,328950,459,36,206,253
43747,22114,0,0,deny,66,66,0,1,0,1,0
52144,80,16896,80,allow,366,240,126,7,33,5,2
50317,445,0,0,drop,70,70,0,1,0,1,0
64038,445,0,0,drop,66,66,0,1,0,1,0
49901,53,27916,53,allow,349,108,241,4,35,2,2
63527,50584,0,0,deny,62,62,0,1,0,1,0
51783,50584,0,0,deny,66,66,0,1,0,1,0
52216,445,0,0,drop,70,70,0,1,0,1,0
49257,445,0,0,drop,70,70,0,1,0,1,0
56761,443,28881,443,allow,8057,2037,6020,20,15,11,9
50479,445,0,0,drop,66,66,0,1,0,1,0
58457,445,0,0,drop,66,66,0,1,0,1,0
55699,445,0,0,drop,70,70,0,1,0,1,0
45440,25,45440,25,allow,7679,1922,5757,34,17,15,19
65009,53,23695,53,allow,152,78,74,2,30,1,1
60001,443,64771,443,allow,10580,2487,8093,28,16,16,12
65422,26467,0,0,deny,62,62,0,1,0,1,0
9320,443,10901,443,allow,3599,566,3033,15,15,8,7
50674,80,2786,80,allow,3325,598,2727,12,15,6,6
55115,443,23390,443,allow,1348,687,661,14,18,8,6
15561,53,15561,53,allow,199,90,109,2,30,1,1
7992,64147,0,0,deny,62,62,0,1,0,1,0
52106,41632,33294,41632,allow,66,66,0,1,5,1,0
60271,445,0,0,drop,70,70,0,1,0,1,0
51147,443,61160,443,allow,7124,2457,4667,23,120,10,13
55560,53,43077,53,allow,166,86,80,2,30,1,1
52946,445,0,0,drop,70,70,0,1,0,1,0
443,64347,0,0,deny,60,60,0,1,0,1,0
52968,80,9235,80,allow,4004,1347,2657,29,114,15,14
50491,443,32943,443,allow,28729,1634,27095,40,120,16,24
63675,445,0,0,drop,66,66,0,1,0,1,0
53523,445,0,0,drop,70,70,0,1,0,1,0
64368,22114,0,0,deny,66,66,0,1,0,1,0
6666,8443,0,0,deny,60,60,0,1,0,1,0
51000,445,0,0,drop,70,70,0,1,0,1,0
33237,443,28944,443,allow,31065,6730,24335,68,18,37,31
38450,443,40244,443,allow,9299,2445,6854,25,81,14,11
46746,443,46746,443,allow,4427,1520,2907,19,30,11,8
49893,25174,0,0,deny,66,66,0,1,0,1,0
64495,53,28201,53,allow,243,94,149,2,30,1,1
49280,53,63122,53,allow,167,86,81,2,30,1,1
16027,22,0,0,deny,60,60,0,1,0,1,0
25151,58833,0,0,deny,146,146,0,1,0,1,0
55242,443,59852,443,allow,214,140,74,4,15,3,1
56925,53,48692,53,allow,196,102,94,2,30,1,1
1162,57470,0,0,deny,62,62,0,1,0,1,0
58870,443,14754,443,allow,7415,2363,5052,17,120,9,8
61660,64097,0,0,deny,62,62,0,1,0,1,0
54203,443,21798,443,allow,499,425,74,4,0,3,1
63131,445,0,0,drop,66,66,0,1,0,1,0
50294,80,24616,80,allow,1515,481,1034,11,15,6,5
10036,80,8198,80,allow,2058,589,1469,10,46,6,4
55427,445,0,0,drop,66,66,0,1,0,1,0
56433,53,16233,53,allow,204,104,100,2,30,1,1
56548,53,6954,53,allow,198,101,97,2,31,1,1
64772,53,16557,53,allow,416,107,309,4,29,2,2
62731,21247,0,0,deny,62,62,0,1,0,1,0
51948,37965,0,0,deny,62,62,0,1,0,1,0
61816,445,0,0,drop,70,70,0,1,0,1,0
60392,1134,49045,1134,allow,70,70,0,1,5,1,0
61229,445,0,0,drop,70,70,0,1,0,1,0
80,9918,0,0,deny,60,60,0,1,0,1,0
52725,445,0,0,drop,66,66,0,1,0,1,0
49293,80,54518,80,allow,75982,15645,60337,88,158,31,57
49175,53,11847,53,allow,193,102,91,2,29,1,1
0,0,0,0,allow,124,64,60,2,0,1,1
53168,44847,0,0,deny,146,146,0,1,0,1,0
51655,26467,0,0,deny,62,62,0,1,0,1,0
47528,8080,0,0,allow,184,78,106,3,10,2,1
60971,443,28807,443,allow,396507,14667,381840,458,21,171,287
50867,445,0,0,drop,66,66,0,1,0,1,0
12226,37965,0,0,deny,62,62,0,1,0,1,0
38367,15000,50286,15000,allow,130,70,60,2,5,1,1
55864,445,0,0,drop,66,66,0,1,0,1,0
55901,53,32764,53,allow,226,110,116,2,30,1,1
17811,23,0,0,deny,60,60,0,1,0,1,0
51050,445,0,0,drop,66,66,0,1,0,1,0
30580,50265,0,0,deny,66,66,0,1,0,1,0
52980,445,0,0,drop,66,66,0,1,0,1,0
63072,445,0,0,drop,66,66,0,1,0,1,0
43194,32480,0,0,deny,145,145,0,1,0,1,0
52997,443,53080,443,allow,17380,7747,9633,52,121,23,29
39715,35440,0,0,deny,146,146,0,1,0,1,0
55800,53,32257,53,allow,177,94,83,2,30,1,1
64290,53,4374,53,allow,196,102,94,2,30,1,1
55727,445,0,0,drop,70,70,0,1,0,1,0
35207,53,52779,53,allow,168,78,90,2,30,1,1
61461,445,0,0,drop,70,70,0,1,0,1,0
56887,53,19033,53,allow,177,94,83,2,31,1,1
56126,53,43934,53,allow,183,94,89,2,30,1,1
1582,56205,0,0,deny,62,62,0,1,0,1,0
10669,49756,0,0,deny,60,60,0,1,0,1,0
40597,443,45954,443,allow,11101,4498,6603,35,430,20,15
52641,6881,46429,6881,allow,1162,856,306,10,14,5,5
64997,51221,0,0,deny,66,66,0,1,0,1,0
1024,64147,0,0,deny,62,62,0,1,0,1,0
58870,443,34912,443,allow,21207,14062,7145,50,19,28,22
63655,445,0,0,drop,70,70,0,1,0,1,0
62764,445,0,0,drop,70,70,0,1,0,1,0
62610,445,0,0,drop,70,70,0,1,0,1,0
58638,5900,0,0,deny,62,62,0,1,0,1,0
42550,5222,16634,5222,allow,2060,981,1079,21,15,11,10
61030,443,16792,443,allow,109010,37307,71703,152,895,62,90
49570,53,16357,53,allow,196,94,102,2,29,1,1
59733,445,0,0,drop,66,66,0,1,0,1,0
56349,53,14775,53,allow,184,102,82,2,29,1,1
57015,25174,0,0,deny,66,66,0,1,0,1,0
65344,46824,0,0,deny,66,66,0,1,0,1,0
52340,445,0,0,drop,66,66,0,1,0,1,0
43674,80,1697,80,allow,13872,1244,12628,29,19,14,15
55600,53,57524,53,allow,184,94,90,2,30,1,1
56819,37372,7815,37372,allow,70,70,0,1,5,1,0
6881,40783,51733,40783,allow,509,150,359,2,1199,1,1
39839,67,0,0,deny,60,60,0,1,0,1,0
48064,443,60858,443,allow,7358,2661,4697,22,17,11,11
50591,22114,0,0,deny,146,146,0,1,0,1,0
65496,53,42568,53,allow,96,96,0,1,31,1,0
52103,53733,0,0,deny,66,66,0,1,0,1,0
56484,53,12661,53,allow,214,110,104,2,30,1,1
50547,22197,0,0,deny,66,66,0,1,0,1,0
49511,443,49511,443,allow,150713,27113,123600,199,82,104,95
2598,23718,0,0,deny,62,62,0,1,0,1,0
57340,53,50973,53,allow,258,110,148,2,30,1,1
61973,445,0,0,drop,66,66,0,1,0,1,0
61065,445,0,0,drop,66,66,0,1,0,1,0
50056,27018,43222,27018,allow,468,390,78,5,29,4,1
51413,443,36557,443,allow,202,70,132,3,11,1,2
55770,53,9659,53,allow,177,94,83,2,30,1,1
60186,53,47856,53,allow,199,94,105,2,30,1,1
56946,1,0,0,deny,66,66,0,1,0,1,0
50308,80,8289,80,allow,1083,653,430,8,16,5,3
9315,443,40509,443,allow,3649,424,3225,12,15,6,6
123,123,23599,123,allow,184,94,90,2,30,1,1
52981,445,0,0,drop,66,66,0,1,0,1,0
64987,53,8755,53,allow,357,107,250,4,36,2,2
57437,53,57480,53,allow,193,102,91,2,30,1,1
65241,53,22089,53,allow,200,102,98,2,31,1,1
55853,53,55965,53,allow,197,102,95,2,30,1,1
55310,53,16833,53,allow,180,94,86,2,30,1,1
62408,3478,27920,3478,allow,140,140,0,1,30,1,0
55283,443,55908,443,allow,2964,1657,1307,18,47,9,9
60761,51221,0,0,deny,62,62,0,1,0,1,0
59745,25174,0,0,deny,146,146,0,1,0,1,0
26900,27017,35787,27017,allow,422,164,258,6,29,3,3
10060,443,49510,443,allow,293424,16379,277045,410,93,193,217
52126,56057,8315,56057,allow,70,70,0,1,5,1,0
31062,50584,0,0,deny,62,62,0,1,0,1,0
42820,443,41684,443,allow,8155,1999,6156,22,81,13,9
58638,5900,0,0,deny,62,62,0,1,0,1,0
52736,443,12534,443,allow,1217451,39642,1177809,1359,39,539,820
46093,32661,0,0,deny,74,74,0,1,0,1,0
52769,51221,0,0,deny,62,62,0,1,0,1,0
59251,445,0,0,drop,70,70,0,1,0,1,0
49792,53,58447,53,allow,339,110,229,2,30,1,1
60269,443,14941,443,allow,499,425,74,4,0,3,1
58864,443,14029,443,allow,5167,700,4467,16,15,7,9
63955,53,0,0,allow,219,81,138,2,30,1,1
58874,443,12303,443,allow,10630,6981,3649,31,17,17,14
49896,443,43604,443,allow,5996,976,5020,19,35,10,9
61550,5529,0,0,deny,145,145,0,1,0,1,0
51592,51505,0,0,deny,66,66,0,1,0,1,0
64835,53,59630,53,allow,179,94,85,2,30,1,1
52433,445,0,0,drop,66,66,0,1,0,1,0
51443,53,51443,53,allow,217,87,130,2,31,1,1
13462,35440,0,0,deny,66,66,0,1,0,1,0
19882,22114,0,0,deny,62,62,0,1,0,1,0
29363,443,29363,443,allow,29861,6027,23834,65,37,34,31
21606,80,0,0,deny,60,60,0,1,0,1,0
58055,56205,0,0,deny,146,146,0,1,0,1,0
4127,26467,0,0,deny,66,66,0,1,0,1,0
25536,50584,0,0,deny,62,62,0,1,0,1,0
34692,53,2143,53,allow,271,102,169,2,30,1,1
62413,445,0,0,drop,70,70,0,1,0,1,0
55289,445,0,0,drop,70,70,0,1,0,1,0
42128,80,52556,80,allow,1139,506,633,10,15,6,4
0,0,0,0,deny,98,98,0,1,0,1,0
11136,19910,0,0,deny,145,145,0,1,0,1,0
51419,445,0,0,drop,70,70,0,1,0,1,0
35812,1,0,0,deny,146,146,0,1,0,1,0
64047,53,55544,53,allow,604,89,515,4,45,2,2
60970,20541,0,0,deny,66,66,0,1,0,1,0
53663,80,16666,80,allow,149148,7515,141633,197,20,95,102
51116,445,0,0,drop,70,70,0,1,0,1,0
62386,37965,0,0,deny,66,66,0,1,0,1,0
48087,16069,0,0,deny,62,62,0,1,0,1,0
65070,53,45301,53,allow,821,102,719,2,30,1,1
52533,445,0,0,drop,66,66,0,1,0,1,0
1972,57470,0,0,deny,78,78,0,1,0,1,0
45682,37965,0,0,deny,145,145,0,1,0,1,0
50027,21247,0,0,deny,62,62,0,1,0,1,0
56005,64147,0,0,deny,62,62,0,1,0,1,0
57339,57470,0,0,deny,66,66,0,1,0,1,0
49515,53,58908,53,allow,195,102,93,2,29,1,1
55199,53,60419,53,allow,223,78,145,2,30,1,1
50355,443,1395,443,allow,1786,172,1614,7,120,3,4
63405,445,0,0,drop,70,70,0,1,0,1,0
8889,34659,0,0,deny,60,60,0,1,0,1,0
61591,445,0,0,drop,70,70,0,1,0,1,0
56070,445,0,0,drop,70,70,0,1,0,1,0
7561,43890,0,0,deny,66,66,0,1,0,1,0
58802,443,37884,443,allow,8591,2275,6316,37,137,21,16
36230,443,36230,443,allow,4681,1774,2907,19,30,11,8
50235,53,32276,53,allow,768,99,669,2,30,1,1
52236,445,0,0,drop,66,66,0,1,0,1,0
32996,443,27619,443,allow,160,69,91,2,120,1,1
56288,53,30293,53,allow,183,94,89,2,30,1,1
54100,80,44998,80,allow,78,78,0,1,5,1,0
61303,445,0,0,drop,70,70,0,1,0,1,0
55895,445,0,0,drop,70,70,0,1,0,1,0
42285,57470,0,0,deny,62,62,0,1,0,1,0
60403,22114,0,0,deny,66,66,0,1,0,1,0
57325,443,9317,443,allow,5613,733,4880,16,14,9,7
18029,50584,0,0,deny,66,66,0,1,0,1,0
45996,443,45996,443,allow,1494,898,596,12,142,6,6
60883,443,43627,443,allow,5710,1228,4482,21,16,12,9
52602,445,0,0,drop,66,66,0,1,0,1,0
51410,443,38178,443,allow,13187,6736,6451,22,55,12,10
50289,53,1310,53,allow,189,102,87,2,30,1,1
1972,57470,0,0,deny,78,78,0,1,0,1,0
25085,30188,0,0,deny,62,62,0,1,0,1,0
62230,445,0,0,drop,66,66,0,1,0,1,0
59096,57866,0,0,deny,62,62,0,1,0,1,0
55206,22114,0,0,deny,66,66,0,1,0,1,0
50129,445,0,0,drop,70,70,0,1,0,1,0
53632,58037,54997,58037,allow,70,70,0,1,5,1,0
50341,5222,19733,5222,allow,9254,3356,5898,74,444,30,44
64941,445,0,0,drop,70,70,0,1,0,1,0
56489,53,9715,53,allow,172,88,84,2,31,1,1
45756,80,2776,80,allow,41602,9508,32094,72,476,36,36
60406,64337,21894,64337,allow,70,70,0,1,5,1,0
57643,28189,0,0,deny,60,60,0,1,0,1,0
57470,12383,34199,12383,allow,5728,4818,910,87,4485,74,13
57602,445,0,0,drop,66,66,0,1,0,1,0
56684,443,25036,443,allow,8737,1821,6916,23,23,14,9
54045,445,0,0,drop,70,70,0,1,0,1,0
57594,445,0,0,drop,70,70,0,1,0,1,0
52858,443,52858,443,allow,313243,267937,45306,456,5925,210,246
49712,445,0,0,drop,66,66,0,1,0,1,0
56559,53,54246,53,allow,711,87,624,2,31,1,1
54685,53,54685,53,allow,832,106,726,2,30,1,1
56556,443,40496,443,allow,8908,1849,7059,31,105,17,14
4431,32480,0,0,deny,66,66,0,1,0,1,0
57131,35776,0,0,deny,145,145,0,1,0,1,0
61122,445,0,0,drop,70,70,0,1,0,1,0
65229,53,65530,53,allow,443,182,261,6,30,3,3
56967,35440,0,0,deny,66,66,0,1,0,1,0
55198,445,0,0,drop,70,70,0,1,0,1,0
38696,443,18796,443,allow,1069542,21337,1048205,1028,16,310,718
56788,445,0,0,drop,66,66,0,1,0,1,0
61768,445,0,0,drop,66,66,0,1,0,1,0
64835,53,38888,53,allow,179,94,85,2,30,1,1
46865,80,11797,80,allow,662,600,62,12,495,11,1
56409,53,61903,53,allow,199,102,97,2,31,1,1
37582,443,5548,443,allow,15901,7016,8885,37,49,22,15
44182,443,55726,443,allow,8241,1810,6431,25,20,14,11
49587,53,25936,53,allow,229,102,127,2,30,1,1
61784,49903,0,0,deny,66,66,0,1,0,1,0
27005,27015,11118,27015,allow,881,126,755,2,30,1,1
13090,36237,0,0,deny,66,66,0,1,0,1,0
55382,53,44759,53,allow,738,86,652,2,31,1,1
51290,445,0,0,drop,70,70,0,1,0,1,0
64043,53,22374,53,allow,320,94,226,2,29,1,1
49631,53,24676,53,allow,184,102,82,2,30,1,1
58046,443,58046,443,allow,4682,1775,2907,19,29,11,8
51452,443,6945,443,allow,7674,2829,4845,23,31,14,9
55350,53,18566,53,allow,315,95,220,4,50,2,2
55765,443,54125,443,allow,4660,1915,2745,23,120,12,11
53822,443,12016,443,allow,499,425,74,4,0,3,1
15503,23852,58898,23852,allow,10840,6789,4051,143,4379,82,61
50584,49647,42268,49647,allow,523,161,362,2,1200,1,1
51372,445,0,0,drop,70,70,0,1,0,1,0
64353,445,0,0,drop,70,70,0,1,0,1,0
50853,445,0,0,drop,70,70,0,1,0,1,0
59965,36237,0,0,deny,66,66,0,1,0,1,0
60380,55125,53805,55125,allow,70,70,0,2,8,2,0
55314,53,61384,53,allow,279,110,169,2,30,1,1
47727,25174,0,0,deny,62,62,0,1,0,1,0
63457,443,6711,443,allow,606,300,306,11,60,6,5
49346,53,44128,53,allow,164,78,86,2,31,1,1
28839,30188,0,0,deny,62,62,0,1,0,1,0
1187,64147,0,0,deny,66,66,0,1,0,1,0
42337,443,16716,443,allow,4181,998,3183,14,26,7,7
50591,445,0,0,drop,66,66,0,1,0,1,0
59938,445,0,0,drop,70,70,0,1,0,1,0
50102,17546,0,0,deny,66,66,0,1,0,1,0
41914,443,49039,443,allow,466,392,74,4,0,3,1
56257,53,40398,53,allow,177,94,83,2,29,1,1
50351,80,28696,80,allow,1083,653,430,8,15,5,3
49485,11392,0,0,deny,66,66,0,1,0,1,0
49775,80,20586,80,allow,1302,849,453,10,126,6,4
55251,53,16099,53,allow,212,110,102,2,30,1,1
29178,35440,0,0,deny,66,66,0,1,0,1,0
57584,443,14480,443,allow,8937,3934,5003,18,120,9,9
63032,22114,0,0,deny,66,66,0,1,0,1,0
54942,53,0,0,allow,631,74,557,2,30,1,1
59398,445,0,0,drop,66,66,0,1,0,1,0
35340,443,44611,443,allow,7470,1088,6382,21,27,12,9
47910,7461,0,0,deny,60,60,0,1,0,1,0
34768,443,44621,443,allow,21905,3249,18656,38,271,18,20
50728,443,61192,443,allow,34661,17810,16851,89,119,40,49
56168,53,62337,53,allow,745,93,652,2,30,1,1
64064,29856,35804,29856,allow,66,66,0,2,8,2,0
16387,3655,0,0,deny,60,60,0,1,0,1,0
50222,443,25494,443,allow,178347,31093,147254,290,446,140,150
14137,443,14137,443,allow,155070,7155,147915,186,81,74,112
23553,37965,0,0,deny,62,62,0,1,0,1,0
63835,30794,60469,30794,allow,66,66,0,2,8,2,0
63294,443,54054,443,allow,9929,4574,5355,29,134,14,15
0,0,0,0,allow,480,244,236,4,0,2,2
57384,445,0,0,drop,70,70,0,1,0,1,0
63926,445,0,0,drop,66,66,0,1,0,1,0
27005,27126,47087,27126,allow,636020,187240,448780,2701,104,1538,1163
60891,445,0,0,drop,70,70,0,1,0,1,0
55152,53,31927,53,allow,177,94,83,2,30,1,1
62109,443,64847,443,allow,21219,1329,19890,32,122,13,19
60033,443,2482,443,allow,4223,2828,1395,23,28,13,10
26900,27017,49129,27017,allow,422,164,258,6,30,3,3
63023,51505,0,0,deny,62,62,0,1,0,1,0
56783,53,42766,53,allow,199,102,97,2,30,1,1
41002,53,33121,53,allow,164,78,86,2,30,1,1
64194,443,64194,443,allow,27723,5572,22151,59,46,31,28
58369,445,0,0,drop,66,66,0,1,0,1,0
49926,53,15614,53,allow,180,94,86,2,30,1,1
50181,64147,0,0,deny,66,66,0,1,0,1,0
56380,53,35466,53,allow,177,94,83,2,30,1,1
50408,7000,50408,7000,allow,3132,815,2317,14,18,7,7
53409,445,0,0,drop,70,70,0,1,0,1,0
44720,53,0,0,allow,86,86,0,1,29,1,0
48513,44847,0,0,deny,62,62,0,1,0,1,0
50395,443,41606,443,allow,6205,2761,3444,25,28,14,11
51468,80,31366,80,allow,3389,2054,1335,19,25,11,8
64940,445,0,0,drop,70,70,0,1,0,1,0
58638,5900,0,0,deny,62,62,0,1,0,1,0
65526,28793,0,0,deny,66,66,0,1,0,1,0
49502,53,35075,53,allow,179,86,93,2,29,1,1
62331,445,0,0,drop,70,70,0,1,0,1,0
54894,443,28940,443,allow,9829,2313,7516,37,25,19,18
49857,53,44627,53,allow,165,86,79,2,29,1,1
57901,445,0,0,drop,70,70,0,1,0,1,0
49631,53,0,0,allow,82,82,0,1,30,1,0
56037,53,56792,53,allow,168,94,74,2,29,1,1
56471,445,0,0,drop,70,70,0,1,0,1,0
49699,64147,0,0,deny,66,66,0,1,0,1,0
34489,35440,0,0,deny,62,62,0,1,0,1,0
49580,53,4352,53,allow,196,102,94,2,30,1,1
58051,443,3762,443,allow,8930,1529,7401,21,19,9,12
56598,80,2431,80,allow,234,234,0,4,12,4,0
45124,80,4219,80,allow,1808,636,1172,16,16,8,8
50272,53,61330,53,allow,210,110,100,2,30,1,1
55383,53,49153,53,allow,177,94,83,2,29,1,1
59845,15503,0,0,deny,66,66,0,1,0,1,0
47650,443,47650,443,allow,4585,1678,2907,19,28,11,8
55421,53,56436,53,allow,200,102,98,2,30,1,1
49984,53,41486,53,allow,172,88,84,2,30,1,1
61287,445,0,0,drop,70,70,0,1,0,1,0
57654,35440,0,0,deny,66,66,0,1,0,1,0
37597,50584,0,0,deny,66,66,0,1,0,1,0
63129,445,0,0,drop,66,66,0,1,0,1,0
50697,80,65344,80,allow,318,192,126,6,27,4,2
57135,53,40947,53,allow,443,182,261,6,30,3,3
23383,64147,0,0,deny,62,62,0,1,0,1,0
57076,445,0,0,drop,66,66,0,1,0,1,0
27777,80,27777,80,allow,12281469,369857,11911612,13837,31,5536,8301
1100,27540,45452,27540,allow,132,70,62,2,31,1,1
58836,44847,0,0,deny,74,74,0,1,0,1,0
59223,17500,0,0,deny,66,66,0,1,0,1,0
57376,445,0,0,drop,66,66,0,1,0,1,0
52074,53,21333,53,allow,199,94,105,2,30,1,1
2267,53,31811,53,allow,204,118,86,2,31,1,1
60908,445,0,0,drop,70,70,0,1,0,1,0
59576,445,0,0,drop,70,70,0,1,0,1,0
52124,11296,17277,11296,allow,70,70,0,2,8,2,0
49968,445,0,0,drop,66,66,0,1,0,1,0
39937,443,39937,443,allow,4756,1849,2907,19,27,11,8
57096,445,0,0,drop,66,66,0,1,0,1,0
53144,58987,40200,58987,allow,70,70,0,1,5,1,0
50517,445,0,0,drop,70,70,0,1,0,1,0
64556,53,40982,53,allow,195,102,93,2,30,1,1
27005,33111,34326,33111,allow,895,126,769,2,30,1,1
55037,443,6546,443,allow,130,70,60,3,5,2,1
61831,445,0,0,drop,66,66,0,1,0,1,0
5234,28162,61929,28162,allow,449555,320,449235,719,50,6,713
24376,50584,0,0,deny,66,66,0,1,0,1,0
38815,53,38815,53,allow,230,99,131,2,30,1,1
443,41545,0,0,deny,60,60,0,1,0,1,0
55458,445,0,0,drop,70,70,0,1,0,1,0
63080,37965,0,0,deny,66,66,0,1,0,1,0
61898,50584,0,0,deny,66,66,0,1,0,1,0
55637,53,5558,53,allow,209,110,99,2,29,1,1
49695,53,13184,53,allow,772,103,669,2,31,1,1
53150,80,13371,80,allow,2398,2024,374,12,15,6,6
55429,25174,0,0,deny,66,66,0,1,0,1,0
49431,53,39469,53,allow,817,102,715,2,30,1,1
16387,64075,0,0,deny,60,60,0,1,0,1,0
64101,445,0,0,drop,70,70,0,1,0,1,0
60069,443,60069,443,allow,5610,2363,3247,22,40,13,9
51904,445,0,0,drop,70,70,0,1,0,1,0
57519,445,0,0,drop,70,70,0,1,0,1,0
52107,80,35011,80,allow,9902,8772,1130,18,35,10,8
21759,51505,0,0,deny,66,66,0,1,0,1,0
52027,445,0,0,drop,66,66,0,1,0,1,0
65117,53,17216,53,allow,198,102,96,2,30,1,1
43129,443,48108,443,allow,4579,580,3999,13,22,5,8
55251,445,0,0,drop,70,70,0,1,0,1,0
49904,80,22359,80,allow,1647,508,1139,8,138,5,3
443,21745,0,0,deny,66,66,0,1,0,1,0
36026,443,14720,443,allow,7050,984,6066,18,39,12,6
52939,443,34090,443,allow,16053,6801,9252,51,115,26,25
40226,53,63320,53,allow,258,78,180,4,30,2,2
55234,53,5157,53,allow,177,94,83,2,29,1,1
50628,80,46976,80,allow,1658,1247,411,8,14,5,3
47037,1,0,0,deny,62,62,0,1,0,1,0
41857,443,32439,443,allow,1633,1010,623,14,2424,7,7
50518,443,27027,443,allow,1352,691,661,14,47,8,6
54542,25604,0,0,deny,62,62,0,1,0,1,0
55199,53,63151,53,allow,214,110,104,2,30,1,1
55157,7302,0,0,deny,66,66,0,1,0,1,0
55883,53,20281,53,allow,189,102,87,2,30,1,1
53188,443,8819,443,allow,7878,3197,4681,22,18,11,11
55020,443,50900,443,allow,670633,656612,14021,657,146,465,192
58834,445,0,0,drop,70,70,0,1,0,1,0
62721,56205,0,0,deny,66,66,0,1,0,1,0
50076,80,31297,80,allow,1052,612,440,10,15,5,5
51131,445,0,0,drop,70,70,0,1,0,1,0
50325,445,0,0,drop,70,70,0,1,0,1,0
49209,52030,40486,52030,allow,70,70,0,2,8,2,0
53287,80,8055,80,allow,2881,1001,1880,12,52,7,5
64095,53,19951,53,allow,170,87,83,2,30,1,1
62469,445,0,0,drop,70,70,0,1,0,1,0
38211,123,28193,123,allow,184,94,90,2,29,1,1
60308,37965,0,0,deny,66,66,0,1,0,1,0
55289,445,0,0,drop,66,66,0,1,0,1,0
64798,53,18186,53,allow,177,94,83,2,29,1,1
46762,443,18994,443,allow,565251,13665,551586,542,30,173,369
41648,56205,0,0,deny,66,66,0,1,0,1,0
50103,53,41648,53,allow,168,86,82,2,31,1,1
14336,64147,0,0,deny,62,62,0,1,0,1,0
55974,53,19851,53,allow,762,98,664,2,30,1,1
57050,445,0,0,drop,70,70,0,1,0,1,0
51509,443,60240,443,allow,1307,688,619,14,37,8,6
2919,37965,0,0,deny,62,62,0,1,0,1,0
9089,55108,0,0,deny,148,148,0,1,0,1,0
49577,53,54563,53,allow,384,94,290,2,30,1,1
50265,21544,58613,21544,allow,390,266,124,6,1200,4,2
443,9313,0,0,deny,74,74,0,1,0,1,0
51993,443,1370,443,allow,1209,656,553,13,16,8,5
60414,52559,6876,52559,allow,70,70,0,1,5,1,0
15296,37965,0,0,deny,66,66,0,1,0,1,0
10652,57470,0,0,deny,66,66,0,1,0,1,0
60260,22114,0,0,deny,66,66,0,1,0,1,0
6159,53,6159,53,allow,404,259,145,3,32,2,1
51066,445,0,0,drop,66,66,0,1,0,1,0
52895,443,23981,443,allow,18795,10297,8498,56,118,29,27
58569,445,0,0,drop,66,66,0,1,0,1,0
43096,443,6075,443,allow,3063,1813,1250,18,16,8,10
47264,443,35933,443,allow,7201,3870,3331,33,315,17,16
55107,443,57254,443,allow,12000,3846,8154,29,28,17,12
49991,53,12205,53,allow,198,102,96,2,30,1,1
41061,5222,19047,5222,allow,107717,16808,90909,301,618,148,153
52110,445,0,0,drop,70,70,0,1,0,1,0
55998,445,0,0,drop,66,66,0,1,0,1,0
55010,53,42242,53,allow,195,102,93,2,29,1,1
64837,53,36950,53,allow,195,102,93,2,30,1,1
37608,443,50721,443,allow,7866,2680,5186,26,16,14,12
36858,443,39662,443,allow,3789,2373,1416,24,26,14,10
64242,53,3579,53,allow,180,94,86,2,30,1,1
52033,37905,61391,37905,allow,70,70,0,2,8,2,0
27005,27052,57707,27052,allow,1948,378,1570,6,33,4,2
3478,61463,0,0,deny,400,400,0,1,0,1,0
58775,443,62135,443,allow,9017,5865,3152,26,16,14,12
62944,445,0,0,drop,66,66,0,1,0,1,0
47894,443,64449,443,allow,70,70,0,2,5,2,0
15333,60043,0,0,deny,62,62,0,1,0,1,0
53355,23117,0,0,deny,66,66,0,1,0,1,0
30478,53,30478,53,allow,229,89,140,2,30,1,1
49182,53,44027,53,allow,198,101,97,2,30,1,1
52987,445,0,0,drop,70,70,0,1,0,1,0
32888,80,22913,80,allow,1542,831,711,7,16,5,2
49254,53,31955,53,allow,814,110,704,2,30,1,1
43483,443,14734,443,allow,144138,17538,126600,275,300,115,160
58597,35440,0,0,deny,62,62,0,1,0,1,0
51296,445,0,0,drop,66,66,0,1,0,1,0
53177,443,2633,443,allow,6512167,186944,6325223,6347,1216,2089,4258
50637,80,48925,80,allow,1742,589,1153,10,87,6,4
33042,443,44384,443,allow,10328,5341,4987,26,35,13,13
51781,445,0,0,drop,66,66,0,1,0,1,0
57371,53,64674,53,allow,214,110,104,2,30,1,1
26881,25174,0,0,deny,66,66,0,1,0,1,0
55039,443,45987,443,allow,7993,677,7316,16,16,8,8
52998,443,2559,443,allow,190,70,120,4,15,2,2
57228,53,13792,53,allow,199,102,97,2,30,1,1
53442,443,20405,443,allow,10500,2835,7665,34,114,14,20
49500,443,37954,443,allow,1197,620,577,13,27,6,7
39796,443,39796,443,allow,4744,1837,2907,19,27,11,8
46385,53,10375,53,allow,199,94,105,2,30,1,1
63932,53,54885,53,allow,174,89,85,2,31,1,1
58305,51180,0,0,deny,66,66,0,1,0,1,0
51391,443,62057,443,allow,9973,1941,8032,38,121,19,19
50890,80,12548,80,allow,290951,15209,275742,327,141,132,195
62609,445,0,0,drop,70,70,0,1,0,1,0
53504,445,0,0,drop,70,70,0,1,0,1,0
41176,64147,0,0,deny,145,145,0,1,0,1,0
49713,53,41539,53,allow,233,94,139,2,30,1,1
56386,50584,0,0,deny,62,62,0,1,0,1,0
59086,445,0,0,drop,66,66,0,1,0,1,0
55420,53,38783,53,allow,177,94,83,2,30,1,1
56203,53,18895,53,allow,283,102,181,2,29,1,1
64598,53,18969,53,allow,222,94,128,2,29,1,1
55868,53,41641,53,allow,177,94,83,2,29,1,1
45475,161,0,0,allow,41552,20621,20931,212,31,106,106
49974,53,0,0,allow,86,86,0,1,30,1,0
61485,445,0,0,drop,66,66,0,1,0,1,0
42030,25,0,0,deny,74,74,0,1,0,1,0
49323,53,12095,53,allow,790,110,680,2,30,1,1
50137,53,58176,53,allow,183,94,89,2,29,1,1
27005,1105,38006,1105,allow,855,126,729,2,30,1,1
56258,53,50751,53,allow,772,103,669,2,30,1,1
40204,40016,39697,40016,allow,140,78,62,2,30,1,1
6796,50584,0,0,deny,62,62,0,1,0,1,0
48420,54532,0,0,deny,146,146,0,1,0,1,0
56828,53156,57681,53156,allow,70,70,0,2,8,2,0
55831,53,12169,53,allow,182,93,89,2,31,1,1
64573,443,63298,443,allow,29112,2866,26246,53,31,28,25
54959,53,54959,53,allow,230,90,140,2,29,1,1
51095,445,0,0,drop,70,70,0,1,0,1,0
55222,53,19882,53,allow,178,91,87,2,30,1,1
62514,37807,0,0,deny,66,66,0,1,0,1,0
55026,53,39957,53,allow,164,86,78,2,29,1,1
49812,443,57189,443,allow,6503,2037,4466,24,125,13,11
50719,445,0,0,drop,70,70,0,1,0,1,0
63173,36237,0,0,deny,62,62,0,1,0,1,0
61293,445,0,0,drop,66,66,0,1,0,1,0
56559,53,54013,53,allow,177,94,83,2,30,1,1
53826,443,31854,443,allow,499,425,74,4,0,3,1
64198,445,0,0,drop,70,70,0,1,0,1,0
6882,42505,24055,42505,allow,207,118,89,2,1200,1,1
63213,57866,0,0,deny,66,66,0,1,0,1,0
54245,443,40246,443,allow,499,425,74,4,0,3,1
58959,445,0,0,drop,66,66,0,1,0,1,0
27063,25174,0,0,deny,62,62,0,1,0,1,0
443,43990,0,0,deny,74,74,0,1,0,1,0
53172,445,0,0,drop,66,66,0,1,0,1,0
55723,80,12672,80,allow,70,70,0,2,8,2,0
61408,30188,0,0,deny,66,66,0,1,0,1,0
58715,57470,0,0,deny,66,66,0,1,0,1,0
58638,5900,0,0,deny,62,62,0,1,0,1,0
5223,1210,0,0,deny,103,103,0,1,0,1,0
52348,445,0,0,drop,70,70,0,1,0,1,0
57665,52700,0,0,deny,66,66,0,1,0,1,0
64797,53,54337,53,allow,182,93,89,2,30,1,1
17008,35440,0,0,deny,62,62,0,1,0,1,0
59701,44847,0,0,deny,66,66,0,1,0,1,0
14336,64147,0,0,deny,62,62,0,1,0,1,0
22733,26467,0,0,deny,62,62,0,1,0,1,0
56564,9571,0,0,deny,78,78,0,1,0,1,0
54330,445,0,0,drop,66,66,0,1,0,1,0
5894,44847,0,0,deny,66,66,0,1,0,1,0
55511,445,0,0,drop,70,70,0,1,0,1,0
61472,443,58092,443,allow,6211,1132,5079,23,88,13,10
59727,3389,59727,3389,allow,8409,1841,6568,27,20,11,16
55141,53,24444,53,allow,184,94,90,2,30,1,1
40254,25174,0,0,deny,146,146,0,1,0,1,0
50384,445,0,0,drop,70,70,0,1,0,1,0
1666,53,1666,53,allow,217,90,127,2,30,1,1
59763,443,40613,443,allow,304,86,218,2,30,1,1
64811,53,2888,53,allow,186,95,91,2,30,1,1
55688,53,25850,53,allow,184,94,90,2,31,1,1
49577,445,0,0,drop,70,70,0,1,0,1,0
6881,6881,0,0,deny,62,62,0,1,0,1,0
59905,443,11259,443,allow,343,163,180,6,15,3,3
64245,53,16068,53,allow,344,94,250,2,30,1,1
43032,443,42506,443,allow,2940,1721,1219,17,361,9,8
50625,443,48490,443,allow,3090,1707,1383,15,19,9,6
49274,53,51381,53,allow,197,102,95,2,29,1,1
52731,80,58843,80,allow,1029,567,462,10,17,6,4
49429,53,17254,53,allow,210,110,100,2,29,1,1
55078,53,15054,53,allow,246,94,152,2,30,1,1
34166,443,49916,443,allow,8290,2156,6134,24,81,14,10
63852,25174,0,0,deny,62,62,0,1,0,1,0
9265,37965,0,0,deny,62,62,0,1,0,1,0
51652,80,59640,80,allow,454,262,192,8,37,5,3
62556,445,0,0,drop,70,70,0,1,0,1,0
56813,53,9920,53,allow,516,136,380,4,40,2,2
42119,36237,0,0,deny,66,66,0,1,0,1,0
53179,12502,28254,12502,allow,70,70,0,2,7,2,0
29787,37965,0,0,deny,62,62,0,1,0,1,0
63513,445,0,0,drop,66,66,0,1,0,1,0
51788,445,0,0,drop,70,70,0,1,0,1,0
64439,53,36419,53,allow,359,134,225,2,30,1,1
51766,443,63491,443,allow,5462,1305,4157,22,121,10,12
63055,445,0,0,drop,70,70,0,1,0,1,0
47636,53,0,0,allow,86,86,0,1,29,1,0
63282,445,0,0,drop,70,70,0,1,0,1,0
65154,53,12899,53,allow,196,94,102,2,30,1,1
50267,53,48112,53,allow,734,94,640,2,31,1,1
63848,443,19599,443,allow,3182,1568,1614,8,120,4,4
60431,52867,31778,52867,allow,70,70,0,2,8,2,0
53837,15000,29903,15000,allow,130,70,60,2,6,1,1
52697,445,0,0,drop,70,70,0,1,0,1,0
50294,53,34116,53,allow,178,94,84,2,29,1,1
49213,53,21489,53,allow,272,94,178,2,30,1,1
64533,53,56074,53,allow,183,102,81,2,29,1,1
51682,443,60633,443,allow,5060,2867,2193,26,398,9,17
50990,23884,0,0,deny,66,66,0,1,0,1,0
62213,445,0,0,drop,70,70,0,1,0,1,0
54033,443,12852,443,allow,5260,2704,2556,13,121,7,6
53245,445,0,0,drop,70,70,0,1,0,1,0
60193,53,20927,53,allow,214,85,129,2,0,1,1
55197,53,53428,53,allow,701,88,613,2,31,1,1
55478,445,0,0,drop,70,70,0,1,0,1,0
50303,443,16402,443,allow,13459,1604,11855,27,187,14,13
0,0,0,0,deny,98,98,0,1,0,1,0
49418,27020,19032,27020,allow,246,71,175,2,31,1,1
57294,443,36134,443,allow,5614,733,4881,16,15,9,7
12965,37965,0,0,deny,66,66,0,1,0,1,0
54298,48983,0,0,deny,159,159,0,1,0,1,0
16824,11119,0,0,deny,148,148,0,1,0,1,0
48544,44847,0,0,deny,146,146,0,1,0,1,0
58760,443,37477,443,allow,5927,794,5133,17,25,8,9
51790,46839,55080,46839,allow,70,70,0,2,8,2,0
65331,53,63156,53,allow,816,102,714,2,30,1,1
50135,50584,0,0,deny,146,146,0,1,0,1,0
65236,445,0,0,drop,70,70,0,1,0,1,0
43934,443,29568,443,allow,2548,1257,1291,15,416,8,7
60290,443,20487,443,allow,6753,2052,4701,25,15,13,12
64106,64147,0,0,deny,66,66,0,1,0,1,0
49825,445,0,0,drop,66,66,0,1,0,1,0
54657,6881,47052,6881,allow,1682,716,966,12,15,6,6
64591,53,55985,53,allow,179,86,93,2,30,1,1
51976,80,64058,80,allow,366,240,126,7,25,5,2
56145,3389,56145,3389,allow,4286,2261,2025,20,17,11,9
60431,52867,18137,52867,allow,70,70,0,1,5,1,0
57304,53,22240,53,allow,292,110,182,2,30,1,1
57470,5382,65418,5382,allow,2411,1328,1083,19,1200,11,8
50506,80,64243,80,allow,318,192,126,6,25,4,2
54866,37965,0,0,deny,62,62,0,1,0,1,0
55549,53,9583,53,allow,209,110,99,2,30,1,1
27005,30007,41112,30007,allow,890,126,764,2,31,1,1
46660,443,53403,443,allow,13699,2575,11124,30,135,15,15
50798,36237,0,0,deny,62,62,0,1,0,1,0
57072,53,19221,53,allow,195,102,93,2,30,1,1
0,0,0,0,allow,156,156,0,2,0,2,0
56999,25174,0,0,deny,62,62,0,1,0,1,0
56462,445,0,0,drop,70,70,0,1,0,1,0
15503,11731,3627,11731,allow,1188,1188,0,19,2298,19,0
37965,48477,53954,48477,allow,7097,4720,2377,89,3163,55,34
62358,445,0,0,drop,66,66,0,1,0,1,0
58858,443,41294,443,allow,318,192,126,6,26,4,2
56232,445,0,0,drop,70,70,0,1,0,1,0
34677,51185,0,0,deny,60,60,0,1,0,1,0
53090,445,0,0,drop,70,70,0,1,0,1,0
56845,445,0,0,drop,70,70,0,1,0,1,0
52327,445,0,0,drop,66,66,0,1,0,1,0
65209,57866,0,0,deny,66,66,0,1,0,1,0
43260,41615,0,0,deny,145,145,0,1,0,1,0
80,36466,0,0,deny,1514,1514,0,1,0,1,0
54497,443,36894,443,allow,10017,2436,7581,22,138,10,12
49141,443,32844,443,allow,2595,1230,1365,18,16,9,9
50644,5222,32859,5222,allow,11661,4442,7219,87,71,41,46
41474,443,57047,443,allow,2767442,82304,2685138,2961,85,1088,1873
52431,50265,0,0,deny,62,62,0,1,0,1,0
41126,53,30186,53,allow,199,94,105,2,30,1,1
37008,42707,0,0,deny,62,62,0,1,0,1,0
50585,443,60446,443,allow,1594,951,643,15,97,8,7
51948,445,0,0,drop,70,70,0,1,0,1,0
48786,80,30638,80,allow,1834,1520,314,14,15,9,5
61808,445,0,0,drop,70,70,0,1,0,1,0
58791,15503,0,0,deny,66,66,0,1,0,1,0
54693,30188,0,0,deny,66,66,0,1,0,1,0
63808,40608,41042,40608,allow,504,382,122,8,15,6,2
50852,80,1179,80,allow,1118864,18787,1100077,1036,132,280,756
50649,443,16928,443,allow,15295,1755,13540,31,77,15,16
57099,53,12968,53,allow,278,102,176,2,31,1,1
6882,59689,61028,59689,allow,221,111,110,2,1200,1,1
45964,7776,0,0,deny,60,60,0,1,0,1,0
43549,443,50179,443,allow,10316,2303,8013,39,120,20,19
48412,443,30459,443,allow,47703,2616,45087,62,120,24,38
34146,51221,0,0,deny,62,62,0,1,0,1,0
52061,80,7969,80,allow,366,240,126,7,25,5,2
51855,7700,11959,7700,allow,12087,9521,2566,76,32,38,38
45363,23,0,0,deny,60,60,0,1,0,1,0
50680,443,36184,443,allow,2993,866,2127,10,120,5,5
60806,40010,25471,40010,allow,316,136,180,6,6,3,3
62329,53,9486,53,allow,268,86,182,2,30,1,1
38383,51221,0,0,deny,66,66,0,1,0,1,0
64619,53,61367,53,allow,438,89,349,4,44,2,2
65451,53,9414,53,allow,178,94,84,2,30,1,1
56326,53,18129,53,allow,177,94,83,2,29,1,1
65291,53,60855,53,allow,335,97,238,4,31,2,2
64155,60043,0,0,deny,62,62,0,1,0,1,0
38276,443,11817,443,allow,600,156,444,8,25,2,6
65189,27015,36838,27015,allow,257,78,179,2,30,1,1
64200,53,25588,53,allow,193,102,91,2,30,1,1
35833,23,0,0,deny,60,60,0,1,0,1,0
52088,445,0,0,drop,66,66,0,1,0,1,0
58740,445,0,0,drop,70,70,0,1,0,1,0
51806,445,0,0,drop,70,70,0,1,0,1,0
58638,5900,0,0,deny,62,62,0,1,0,1,0
58501,44847,0,0,deny,66,66,0,1,0,1,0
64729,53,36616,53,allow,262,94,168,2,30,1,1
52991,53,52991,53,allow,235,90,145,2,32,1,1
53778,6881,23099,6881,allow,70,70,0,2,8,2,0
52048,44059,7624,44059,allow,160,70,90,2,5,1,1
10533,23,0,0,deny,60,60,0,1,0,1,0
18574,56205,0,0,deny,66,66,0,1,0,1,0
49977,57470,0,0,deny,62,62,0,1,0,1,0
3976,25174,0,0,deny,62,62,0,1,0,1,0
56659,53,59706,53,allow,711,87,624,2,30,1,1
55030,80,10323,80,allow,2954,671,2283,12,15,7,5
65241,53,34581,53,allow,198,102,96,2,30,1,1
56826,53,57035,53,allow,94,94,0,1,29,1,0
59847,445,0,0,drop,70,70,0,1,0,1,0
50562,53,50562,53,allow,216,82,134,2,32,1,1
57033,445,0,0,drop,66,66,0,1,0,1,0
61151,443,65420,443,allow,121129,5559,115570,157,640,51,106
53647,16194,65302,16194,allow,70,70,0,2,8,2,0
51310,445,0,0,drop,66,66,0,1,0,1,0
61460,80,11498,80,allow,1507,1184,323,11,79,7,4
64128,445,0,0,drop,70,70,0,1,0,1,0
50284,80,36535,80,allow,8269,1423,6846,20,75,10,10
56835,35894,0,0,deny,66,66,0,1,0,1,0
49602,53,44779,53,allow,247,102,145,2,30,1,1
54373,26467,0,0,deny,62,62,0,1,0,1,0
57543,445,0,0,drop,70,70,0,1,0,1,0
51812,445,0,0,drop,70,70,0,1,0,1,0
59965,445,0,0,drop,66,66,0,1,0,1,0
37695,443,3343,443,allow,1134364,30994,1103370,1170,175,403,767
56809,53,8718,53,allow,232,94,138,2,30,1,1
50905,445,0,0,drop,70,70,0,1,0,1,0
123,123,7719,123,allow,184,94,90,2,31,1,1
51485,443,20455,443,allow,828,390,438,11,40,4,7
18592,44612,0,0,deny,62,62,0,1,0,1,0
26869,53,19844,53,allow,290,110,180,2,30,1,1
50180,445,0,0,drop,66,66,0,1,0,1,0
1026,64147,0,0,deny,62,62,0,1,0,1,0
64097,53,23639,53,allow,308,91,217,4,56,2,2
64094,443,64094,443,allow,5647,2402,3245,26,159,14,12
42298,40042,61783,40042,allow,273,73,200,4,29,2,2
57440,53,36326,53,allow,198,101,97,2,31,1,1
55325,53,11184,53,allow,210,110,100,2,31,1,1
62009,443,59530,443,allow,5017,1969,3048,14,136,7,7
58516,445,0,0,drop,70,70,0,1,0,1,0
61001,445,0,0,drop,66,66,0,1,0,1,0
63743,445,0,0,drop,70,70,0,1,0,1,0
27679,37965,0,0,deny,62,62,0,1,0,1,0
57162,445,0,0,drop,66,66,0,1,0,1,0
46851,53,12035,53,allow,168,78,90,2,30,1,1
56180,53,56180,53,allow,229,98,131,2,30,1,1
38755,22114,0,0,deny,66,66,0,1,0,1,0
49229,53,18433,53,allow,178,94,84,2,31,1,1
60931,445,0,0,drop,70,70,0,1,0,1,0
65518,5710,0,0,deny,62,62,0,1,0,1,0
38690,443,27226,443,allow,8871,3470,5401,24,123,13,11
52644,6881,4484,6881,allow,719,413,306,10,14,5,5
56758,443,1030,443,allow,8005,1985,6020,20,16,11,9
56452,53,0,0,allow,82,82,0,2,40,2,0
42598,443,46015,443,allow,3134,1983,1151,15,15,8,7
63774,445,0,0,drop,70,70,0,1,0,1,0
50052,53,19645,53,allow,738,86,652,2,30,1,1
9518,3855,0,0,deny,100,100,0,1,0,1,0
50000,53,16568,53,allow,502,115,387,4,52,2,2
58638,5900,0,0,deny,62,62,0,1,0,1,0
64899,53,16096,53,allow,199,102,97,2,30,1,1
56468,53,40699,53,allow,1421,97,1324,4,55,2,2
54758,35993,0,0,deny,62,62,0,1,0,1,0
34885,443,20315,443,allow,80828,20592,60236,124,180,54,70
55708,445,0,0,drop,70,70,0,1,0,1,0
55679,445,0,0,drop,66,66,0,1,0,1,0
61845,11392,0,0,deny,62,62,0,1,0,1,0
38019,443,55149,443,allow,884,464,420,13,28,7,6
48320,80,28314,80,allow,12110,3853,8257,35,1075,13,22
52951,80,38288,80,allow,6266,4430,1836,22,358,13,9
58807,445,0,0,drop,66,66,0,1,0,1,0
52467,443,14984,443,allow,5343,1102,4241,22,152,11,11
49160,59033,0,0,deny,146,146,0,1,0,1,0
55186,443,62291,443,allow,7375,1549,5826,31,353,10,21
50994,35974,0,0,deny,60,60,0,1,0,1,0
60363,443,28558,443,allow,5214,1101,4113,22,123,12,10
443,61686,0,0,deny,642,642,0,1,0,1,0
64678,53,7690,53,allow,758,93,665,2,31,1,1
33352,50584,0,0,deny,146,146,0,1,0,1,0
57131,8055,0,0,deny,145,145,0,1,0,1,0
65008,445,0,0,drop,66,66,0,1,0,1,0
47302,53,19968,53,allow,168,78,90,2,30,1,1
50878,445,0,0,drop,70,70,0,1,0,1,0
57140,445,0,0,drop,70,70,0,1,0,1,0
43654,443,39718,443,allow,8761,2571,6190,24,17,14,10
48954,53,0,0,allow,86,86,0,1,30,1,0
65141,445,0,0,drop,70,70,0,1,0,1,0
52099,445,0,0,drop,66,66,0,1,0,1,0
55856,53,56508,53,allow,265,94,171,2,30,1,1
55068,53,58274,53,allow,192,98,94,2,31,1,1
53553,443,31063,443,allow,3708,1988,1720,20,255,10,10
50296,53,43204,53,allow,183,94,89,2,29,1,1
55076,53,24944,53,allow,183,94,89,2,30,1,1
58969,445,0,0,drop,70,70,0,1,0,1,0
50047,80,4097,80,allow,1455,349,1106,10,15,5,5
68,67,0,0,deny,346,346,0,1,0,1,0
57094,53,61596,53,allow,196,102,94,2,30,1,1
55043,57470,0,0,deny,78,78,0,1,0,1,0
58893,443,9531,443,allow,5107,700,4407,15,15,7,8
55719,13302,2915,13302,allow,70,70,0,1,5,1,0
56113,53,45666,53,allow,211,102,109,2,30,1,1
58643,443,8549,443,allow,4801,2506,2295,12,121,6,6
51687,80,38806,80,allow,1517,481,1036,11,15,6,5
54254,445,0,0,drop,70,70,0,1,0,1,0
60112,23,0,0,deny,60,60,0,1,0,1,0
51467,443,7148,443,allow,20313,6637,13676,45,24,23,22
21133,6085,5257,6085,allow,481,150,331,2,1199,1,1
49226,443,24983,443,allow,532687,14365,518322,560,20,211,349
51977,18504,24364,18504,allow,70,70,0,2,8,2,0
53041,443,62358,443,allow,2881,346,2535,12,120,5,7
61108,445,0,0,drop,66,66,0,1,0,1,0
56457,53,47112,53,allow,731,91,640,2,31,1,1
41848,23,0,0,deny,60,60,0,1,0,1,0
60248,46776,0,0,deny,66,66,0,1,0,1,0
56816,443,16188,443,allow,7956,1967,5989,20,15,11,9
0,0,0,0,deny,98,98,0,1,0,1,0
56801,21916,14491,21916,allow,316,136,180,6,7,3,3
58638,5900,0,0,deny,62,62,0,1,0,1,0
55463,445,0,0,drop,70,70,0,1,0,1,0
56528,64147,0,0,deny,62,62,0,1,0,1,0
51923,22114,0,0,deny,146,146,0,1,0,1,0
44797,53,29838,53,allow,179,86,93,2,29,1,1
49549,443,14886,443,allow,19491,14463,5028,50,224,26,24
59459,37807,0,0,deny,66,66,0,1,0,1,0
43829,443,59022,443,allow,368,160,208,6,33,3,3
50462,443,22628,443,allow,14264,4441,9823,74,386,38,36
49331,445,0,0,drop,66,66,0,1,0,1,0
22680,443,22680,443,allow,18490,7811,10679,47,81,27,20
24144,57470,0,0,deny,62,62,0,1,0,1,0
60746,445,0,0,drop,66,66,0,1,0,1,0
56137,53,23667,53,allow,199,102,97,2,31,1,1
6036,51505,0,0,deny,66,66,0,1,0,1,0
38536,443,1919,443,allow,33980,7386,26594,51,121,22,29
56542,53,53986,53,allow,183,94,89,2,29,1,1
60861,445,0,0,drop,66,66,0,1,0,1,0
57066,445,0,0,drop,70,70,0,1,0,1,0
43732,443,8555,443,allow,19123,2319,16804,39,28,21,18
49708,53,32399,53,allow,178,94,84,2,30,1,1
53828,51354,58095,51354,allow,70,70,0,1,4,1,0
47210,50584,0,0,deny,146,146,0,1,0,1,0
32811,443,18226,443,allow,16652,13777,2875,48,44,27,21
55671,53,24025,53,allow,196,102,94,2,33,1,1
62386,37965,0,0,deny,62,62,0,1,0,1,0
52925,64147,0,0,deny,62,62,0,1,0,1,0
56384,445,0,0,drop,66,66,0,1,0,1,0
6889,25975,0,0,deny,143,143,0,1,0,1,0
59934,35440,0,0,deny,66,66,0,1,0,1,0
49177,53,40047,53,allow,184,94,90,2,31,1,1
61454,443,53913,443,allow,8673,1722,6951,30,125,18,12
59062,445,0,0,drop,70,70,0,1,0,1,0
0,0,0,0,allow,480,244,236,4,0,2,2
6881,52563,53881,52563,allow,228,118,110,2,1199,1,1
57198,80,57198,80,allow,6738,909,5829,14,20,7,7
56937,7150,12270,7150,allow,126,126,0,1,30,1,0
17097,62413,0,0,deny,62,62,0,1,0,1,0
49754,53,54663,53,allow,176,90,86,2,31,1,1
47230,443,43067,443,allow,9930,3002,6928,34,120,17,17
62785,445,0,0,drop,70,70,0,1,0,1,0
64726,53,39418,53,allow,178,94,84,2,30,1,1
61911,15503,0,0,deny,146,146,0,1,0,1,0
49167,80,49167,80,allow,1915,1466,449,10,20,6,4
1024,6881,0,0,deny,146,146,0,1,0,1,0
8999,1,0,0,deny,146,146,0,1,0,1,0
46093,32661,0,0,deny,74,74,0,1,0,1,0
46014,53,46014,53,allow,414,268,146,3,33,2,1
56622,443,37505,443,allow,3575,1079,2496,15,155,7,8
64989,53,9165,53,allow,183,102,81,2,30,1,1
56583,445,0,0,drop,66,66,0,1,0,1,0
60373,445,0,0,drop,66,66,0,1,0,1,0
64237,53,55167,53,allow,199,86,113,2,30,1,1
40919,443,40161,443,allow,12243,6818,5425,30,314,16,14
1074,25174,0,0,deny,146,146,0,1,0,1,0
53551,60444,1391,60444,allow,492,306,186,8,15,5,3
48362,443,23544,443,allow,8075,1766,6309,22,78,13,9
60015,443,28429,443,allow,6340,3788,2552,21,143,10,11
27679,37965,0,0,deny,62,62,0,1,0,1,0
63717,445,0,0,drop,70,70,0,1,0,1,0
26884,37965,0,0,deny,66,66,0,1,0,1,0
54975,445,0,0,drop,70,70,0,1,0,1,0
56582,23718,0,0,deny,66,66,0,1,0,1,0
56435,53,21877,53,allow,193,102,91,2,30,1,1
55245,53,36514,53,allow,209,110,99,2,30,1,1
50376,53,23494,53,allow,166,86,80,2,31,1,1
49419,53,3552,53,allow,343,100,243,4,52,2,2
36515,80,38433,80,allow,51571,48786,2785,74,19,38,36
60894,50584,0,0,deny,66,66,0,1,0,1,0
54106,53,53865,53,allow,164,78,86,2,30,1,1
59477,36829,0,0,deny,66,66,0,1,0,1,0
56330,445,0,0,drop,70,70,0,1,0,1,0
41562,123,0,0,deny,234,234,0,1,0,1,0
63944,30188,0,0,deny,62,62,0,1,0,1,0
16387,35308,0,0,deny,60,60,0,1,0,1,0
50378,53,48801,53,allow,184,94,90,2,30,1,1
33932,443,50545,443,allow,54451,2603,51848,70,16,30,40
43057,80,9462,80,allow,1195,401,794,9,16,5,4
1932,53,37462,53,allow,210,78,132,2,30,1,1
57430,53,32678,53,allow,200,102,98,2,30,1,1
58638,5900,0,0,deny,62,62,0,1,0,1,0
65309,53,6020,53,allow,227,110,117,2,30,1,1
30922,22,0,0,deny,60,60,0,1,0,1,0
46837,57470,0,0,deny,62,62,0,1,0,1,0
63940,445,0,0,drop,70,70,0,1,0,1,0
2849,30188,0,0,deny,62,62,0,1,0,1,0
57172,3389,57172,3389,allow,3347,1458,1889,15,18,8,7
21892,15503,0,0,deny,62,62,0,1,0,1,0
58901,445,0,0,drop,70,70,0,1,0,1,0
54649,445,0,0,drop,70,70,0,1,0,1,0
57810,80,62948,80,allow,104397,8436,95961,122,21,49,73
23122,26296,0,0,deny,159,159,0,1,0,1,0
56785,445,0,0,drop,70,70,0,1,0,1,0
52424,443,16403,443,allow,10070,5084,4986,41,16,24,17
57679,443,35639,443,allow,13034,3324,9710,35,120,15,20
57647,445,0,0,drop,70,70,0,1,0,1,0
48012,443,51500,443,allow,1429,1295,134,10,29,8,2
58638,5900,0,0,deny,62,62,0,1,0,1,0
38295,443,36563,443,allow,5247,3662,1585,21,310,11,10
58638,5900,58638,5900,allow,130,66,64,2,5,1,1
56562,445,0,0,drop,66,66,0,1,0,1,0
56117,53,21155,53,allow,178,94,84,2,30,1,1
56664,443,64784,443,allow,9160636,285656,8874980,9685,189,3160,6525
49175,2710,30746,2710,allow,70,70,0,2,8,2,0
49886,53,25717,53,allow,275,94,181,2,30,1,1
51840,34678,44195,34678,allow,70,70,0,1,5,1,0
55609,53,21760,53,allow,178,94,84,2,30,1,1
64309,445,0,0,drop,70,70,0,1,0,1,0
51518,443,51518,443,allow,15967,3046,12921,39,173,15,24
17129,53,49932,53,allow,225,78,147,2,31,1,1
52162,443,20113,443,allow,1461,924,537,13,31,7,6
58530,445,0,0,drop,66,66,0,1,0,1,0
56176,443,9976,443,allow,1312,651,661,13,185,7,6
52396,443,30033,443,allow,1253628,61672,1191956,1875,220,939,936
52945,445,0,0,drop,70,70,0,1,0,1,0
57148,23,0,0,deny,60,60,0,1,0,1,0
61833,445,0,0,drop,66,66,0,1,0,1,0
53806,37267,20623,37267,allow,70,70,0,1,4,1,0
62904,80,35309,80,allow,1515,481,1034,11,16,6,5
63885,443,2549,443,allow,254829,10396,244433,255,194,64,191
63136,443,35141,443,allow,6781,1289,5492,17,15,9,8
49621,443,59596,443,allow,14888,3555,11333,58,256,23,35
58848,443,23115,443,allow,1362,627,735,14,81,7,7
63968,445,0,0,drop,66,66,0,1,0,1,0
65466,53,32995,53,allow,200,102,98,2,30,1,1
58196,445,0,0,drop,70,70,0,1,0,1,0
60899,25174,0,0,deny,66,66,0,1,0,1,0
60448,443,25494,443,allow,17060,10614,6446,52,132,25,27
54221,57470,0,0,deny,66,66,0,1,0,1,0
25570,35440,0,0,deny,146,146,0,1,0,1,0
56163,53,10376,53,allow,624,188,436,6,60,3,3
63708,25174,0,0,deny,66,66,0,1,0,1,0
52804,445,0,0,drop,70,70,0,1,0,1,0
55394,123,0,0,deny,234,234,0,1,0,1,0
62007,445,0,0,drop,70,70,0,1,0,1,0
64433,53,29795,53,allow,214,102,112,2,30,1,1
49973,445,0,0,drop,70,70,0,1,0,1,0
55040,53,40859,53,allow,762,98,664,2,31,1,1
58506,53,0,0,allow,192,86,106,2,30,1,1
61063,445,0,0,drop,66,66,0,1,0,1,0
52534,445,0,0,drop,70,70,0,1,0,1,0
64985,27037,29129,27037,allow,734,462,272,2,30,1,1
64437,445,0,0,drop,70,70,0,1,0,1,0
56913,53,30099,53,allow,772,103,669,2,31,1,1
52214,445,0,0,drop,66,66,0,1,0,1,0
56622,53,51149,53,allow,757,98,659,2,31,1,1
57936,443,57936,443,allow,18738,1904,16834,33,17,17,16
57386,53,23091,53,allow,193,102,91,2,29,1,1
49182,445,0,0,drop,66,66,0,1,0,1,0
61718,443,31970,443,allow,21125,2413,18712,42,49,20,22
9159,443,37775,443,allow,5727,491,5236,14,15,7,7
43726,443,52371,443,allow,1201,707,494,12,35,7,5
65529,53,6825,53,allow,198,102,96,2,29,1,1
56092,53,34391,53,allow,177,94,83,2,30,1,1
51244,445,0,0,drop,70,70,0,1,0,1,0
57594,443,55656,443,allow,614577,24675,589902,673,149,228,445
51274,24399,41569,24399,allow,70,70,0,2,8,2,0
62411,445,0,0,drop,66,66,0,1,0,1,0
61515,445,0,0,drop,70,70,0,1,0,1,0
57321,53,25115,53,allow,498,204,294,6,29,3,3
56736,443,56736,443,allow,120441,7846,112595,167,61,76,91
43817,53,0,0,allow,82,82,0,2,40,2,0
63683,20299,57737,20299,allow,502,380,122,7,19,5,2
14613,12446,0,0,deny,66,66,0,1,0,1,0
54079,443,34399,443,allow,6931,1974,4957,24,342,11,13
49595,53,9542,53,allow,180,94,86,2,30,1,1
58501,44847,0,0,deny,66,66,0,1,0,1,0
47193,443,47193,443,allow,4555,1648,2907,19,30,11,8
38038,443,62435,443,allow,6180,3550,2630,27,272,13,14
54636,26467,0,0,deny,66,66,0,1,0,1,0
6881,48608,12608,48608,allow,228,118,110,2,1199,1,1
53332,443,6381,443,allow,23215,18990,4225,44,405,24,20
45964,3111,0,0,deny,60,60,0,1,0,1,0
42572,995,0,0,deny,60,60,0,1,0,1,0
65424,53,25204,53,allow,204,104,100,2,31,1,1
10047,443,65295,443,allow,25316,10344,14972,84,170,48,36
49175,53,18016,53,allow,193,102,91,2,30,1,1
58120,25174,0,0,deny,62,62,0,1,0,1,0
43207,26467,0,0,deny,62,62,0,1,0,1,0
6754,443,21695,443,allow,13520,2288,11232,43,192,19,24
56408,443,36804,443,allow,17704,1456,16248,25,123,11,14
56077,445,0,0,drop,70,70,0,1,0,1,0
26502,80,26502,80,allow,184480,11115,173365,239,30,116,123
51566,53,46943,53,allow,239,102,137,2,30,1,1
51956,36995,25588,36995,allow,70,70,0,2,8,2,0
58638,5900,0,0,deny,62,62,0,1,0,1,0
63725,80,55530,80,allow,374,192,182,7,15,4,3
9333,443,63777,443,allow,5200,499,4701,13,15,7,6
37571,443,14290,443,allow,499,425,74,4,0,3,1
59177,53,0,0,allow,619,76,543,2,30,1,1
49904,53,21659,53,allow,749,94,655,2,30,1,1
62108,445,0,0,drop,70,70,0,1,0,1,0
14489,25174,0,0,deny,146,146,0,1,0,1,0
51434,53,0,0,allow,202,93,109,2,30,1,1
7048,25174,0,0,deny,66,66,0,1,0,1,0
49418,27017,22257,27017,allow,271,78,193,2,31,1,1
36893,67,0,0,deny,60,60,0,1,0,1,0
59347,80,59347,80,allow,108790,4633,104157,192,15,66,126
45767,80,42626,80,allow,2768,1722,1046,17,20,8,9
64482,53,36400,53,allow,322,95,227,4,39,2,2
53089,24211,0,0,deny,66,66,0,1,0,1,0
34981,80,29727,80,allow,1658,1344,314,10,15,5,5
56956,53,13948,53,allow,183,94,89,2,30,1,1
60408,445,0,0,drop,70,70,0,1,0,1,0
60370,80,40899,80,allow,1243,769,474,9,123,6,3
55897,53,62688,53,allow,711,87,624,2,31,1,1
20864,51221,0,0,deny,62,62,0,1,0,1,0
56134,53,59241,53,allow,183,94,89,2,29,1,1
34878,53,44059,53,allow,339,94,245,2,30,1,1
56117,53,31292,53,allow,172,88,84,2,31,1,1
38886,53,39118,53,allow,223,78,145,2,30,1,1
53717,445,0,0,drop,70,70,0,1,0,1,0
26499,80,26499,80,allow,168957,11365,157592,202,31,90,112
58638,5900,0,0,deny,62,62,0,1,0,1,0
64290,53,55058,53,allow,192,98,94,2,31,1,1
46662,36237,0,0,deny,62,62,0,1,0,1,0
51984,54606,5412,54606,allow,70,70,0,2,8,2,0
59067,445,0,0,drop,70,70,0,1,0,1,0
65341,53,36456,53,allow,200,102,98,2,31,1,1
62789,445,0,0,drop,70,70,0,1,0,1,0
52097,23279,1789,23279,allow,70,70,0,1,5,1,0
28385,26467,0,0,deny,66,66,0,1,0,1,0
63731,26467,0,0,deny,66,66,0,1,0,1,0
57402,2258,57402,2258,allow,156,156,0,3,8,3,0
53764,6881,51389,6881,allow,1463,821,642,15,15,8,7
52166,57975,14625,57975,allow,70,70,0,2,8,2,0
61660,443,61660,443,allow,18829,1995,16834,33,17,17,16
60500,44739,7471,44739,allow,70,70,0,1,5,1,0
64146,53,33411,53,allow,273,94,179,2,30,1,1
57183,53,27398,53,allow,172,88,84,2,30,1,1
58007,80,40862,80,allow,318,192,126,6,21,4,2
57118,443,64702,443,allow,5133,631,4502,14,15,8,6
40362,443,26484,443,allow,8229,2091,6138,24,361,12,12
56480,53,53765,53,allow,755,94,661,2,31,1,1
64048,53,43496,53,allow,209,110,99,2,29,1,1
40030,80,62413,80,allow,1286,403,883,16,393,4,12
56418,53,62864,53,allow,182,93,89,2,30,1,1
55023,53,43972,53,allow,216,102,114,2,30,1,1
11983,57470,0,0,deny,62,62,0,1,0,1,0
49418,53,11471,53,allow,776,102,674,2,30,1,1
62688,445,0,0,drop,66,66,0,1,0,1,0
51057,445,0,0,drop,66,66,0,1,0,1,0
60426,57470,0,0,deny,62,62,0,1,0,1,0
43092,443,2375,443,allow,7011,2541,4470,19,15,11,8
63242,50584,0,0,deny,62,62,0,1,0,1,0
59377,9319,0,0,deny,62,62,0,1,0,1,0
57363,445,0,0,drop,70,70,0,1,0,1,0
55554,22114,0,0,deny,62,62,0,1,0,1,0
55035,445,0,0,drop,70,70,0,1,0,1,0
57176,53,50437,53,allow,178,94,84,2,29,1,1
22677,25174,0,0,deny,66,66,0,1,0,1,0
56492,53,4383,53,allow,212,102,110,2,30,1,1
52003,44512,0,0,deny,66,66,0,1,0,1,0
7701,23,0,0,deny,60,60,0,1,0,1,0
62225,445,0,0,drop,70,70,0,1,0,1,0
56039,50584,0,0,deny,66,66,0,1,0,1,0
56440,80,38855,80,allow,17008,1379,15629,22,25,7,15
38993,443,34045,443,allow,7089,1290,5799,24,16,12,12
14208,51221,0,0,deny,66,66,0,1,0,1,0
37569,443,45273,443,allow,11226,3029,8197,36,55,18,18
49154,80,61897,80,allow,2438,565,1873,10,75,6,4
47783,50432,0,0,deny,62,62,0,1,0,1,0
64477,53,60345,53,allow,211,102,109,2,29,1,1
65367,53,17484,53,allow,271,94,177,2,30,1,1
12184,56205,0,0,deny,146,146,0,1,0,1,0
45363,443,50809,443,allow,2396,1144,1252,14,982,7,7
49253,53,32297,53,allow,593,188,405,6,59,3,3
50734,80,51242,80,allow,1114,534,580,12,16,7,5
59758,443,17824,443,allow,4114,2557,1557,22,418,9,13
34517,53,34517,53,allow,200,82,118,2,30,1,1
49928,80,49356,80,allow,1270,679,591,13,15,7,6
38795,40042,2140,40042,allow,142,80,62,2,31,1,1
63136,25174,0,0,deny,66,66,0,1,0,1,0
56770,26467,0,0,deny,66,66,0,1,0,1,0
56783,53,7045,53,allow,193,102,91,2,30,1,1
58263,445,0,0,drop,66,66,0,1,0,1,0
50116,22,50116,22,allow,60,60,0,1,5,1,0
58638,5900,0,0,deny,62,62,0,1,0,1,0
55543,53,20770,53,allow,402,118,284,2,30,1,1
49247,53,61621,53,allow,817,102,715,2,30,1,1
37319,80,37445,80,allow,1056,682,374,10,15,6,4
56172,53,39320,53,allow,216,102,114,2,30,1,1
65011,53,59179,53,allow,168,86,82,2,30,1,1
65485,53,57081,53,allow,184,94,90,2,31,1,1
57583,443,11570,443,allow,6150,4180,1970,21,95,13,8
44960,80,44960,80,allow,4372,2093,2279,16,19,10,6
62344,445,0,0,drop,66,66,0,1,0,1,0
63384,445,0,0,drop,66,66,0,1,0,1,0
59914,65473,0,0,deny,145,145,0,1,0,1,0
52059,47363,55015,47363,allow,70,70,0,1,5,1,0
49257,53,43950,53,allow,579,181,398,6,84,3,3
49942,80,49942,80,allow,323714,18296,305418,384,22,165,219
55940,445,0,0,drop,70,70,0,1,0,1,0
50594,80,17201,80,allow,3116,452,2664,18,394,5,13
56296,53,43298,53,allow,216,110,106,2,30,1,1
49163,22114,0,0,deny,62,62,0,1,0,1,0
51327,443,49417,443,allow,8433,3066,5367,21,17,10,11
64078,54561,7261,54561,allow,66,66,0,2,7,2,0
58288,443,58288,443,allow,4661,1754,2907,19,26,11,8
54575,11392,0,0,deny,66,66,0,1,0,1,0
55079,25174,0,0,deny,62,62,0,1,0,1,0
46829,64147,0,0,deny,146,146,0,1,0,1,0
52721,445,0,0,drop,70,70,0,1,0,1,0
54807,445,0,0,drop,66,66,0,1,0,1,0
64151,445,0,0,drop,70,70,0,1,0,1,0
53748,51413,19666,51413,allow,70,70,0,1,5,1,0
55698,445,0,0,drop,70,70,0,1,0,1,0
50510,443,23339,443,allow,2259313,91208,2168105,2847,1409,1118,1729
65147,445,0,0,drop,66,66,0,1,0,1,0
47424,25174,0,0,deny,66,66,0,1,0,1,0
54418,22114,0,0,deny,62,62,0,1,0,1,0
51826,443,55412,443,allow,682,370,312,12,32,7,5
54140,17372,0,0,deny,66,66,0,1,0,1,0
49989,53,64218,53,allow,755,94,661,2,29,1,1
50859,53,0,0,allow,286,79,207,2,30,1,1
62593,7010,62593,7010,allow,4231,2106,2125,15,15,8,7
50308,443,46748,443,allow,44311,4535,39776,55,121,21,34
65219,53,20854,53,allow,197,102,95,2,31,1,1
9687,57470,0,0,deny,78,78,0,1,0,1,0
14350,56205,0,0,deny,62,62,0,1,0,1,0
51910,37965,0,0,deny,62,62,0,1,0,1,0
54196,445,0,0,drop,66,66,0,1,0,1,0
62885,62413,0,0,deny,62,62,0,1,0,1,0
47650,443,28162,443,allow,1056,569,487,10,24,6,4
54956,445,0,0,drop,70,70,0,1,0,1,0
2170,43227,0,0,deny,62,62,0,1,0,1,0
63690,64147,0,0,deny,66,66,0,1,0,1,0
10390,26467,0,0,deny,66,66,0,1,0,1,0
49763,443,64834,443,allow,8439,1840,6599,21,127,11,10
22547,23,0,0,deny,60,60,0,1,0,1,0
60773,20010,34411,20010,allow,70,70,0,2,8,2,0
57166,53,28476,53,allow,177,94,83,2,30,1,1
56803,53,49854,53,allow,195,102,93,2,29,1,1
26835,47993,0,0,deny,62,62,0,1,0,1,0
61008,5555,0,0,deny,60,60,0,1,0,1,0
55161,37807,0,0,deny,66,66,0,1,0,1,0
57461,445,0,0,drop,66,66,0,1,0,1,0
53664,445,0,0,drop,66,66,0,1,0,1,0
55932,53,10932,53,allow,193,102,91,2,29,1,1
40742,2967,0,0,deny,62,62,0,1,0,1,0
53614,445,0,0,drop,70,70,0,1,0,1,0
55570,44847,0,0,deny,66,66,0,1,0,1,0
57412,445,0,0,drop,70,70,0,1,0,1,0
34150,443,7922,443,allow,12564,9272,3292,66,107,31,35
60400,56243,28136,56243,allow,70,70,0,2,8,2,0
53505,445,0,0,drop,70,70,0,1,0,1,0
58638,5900,0,0,deny,62,62,0,1,0,1,0
63708,25174,0,0,deny,66,66,0,1,0,1,0
62061,445,0,0,drop,66,66,0,1,0,1,0
26900,27017,2558,27017,allow,422,164,258,6,30,3,3
52048,80,14488,80,allow,41486,20844,20642,64,37,32,32
55889,53,31264,53,allow,177,94,83,2,29,1,1
49260,53,30297,53,allow,791,85,706,4,57,2,2
63924,53,40615,53,allow,214,102,112,2,30,1,1
63128,445,0,0,drop,66,66,0,1,0,1,0
38728,443,11034,443,allow,560,280,280,9,27,5,4
59118,445,0,0,drop,70,70,0,1,0,1,0
54648,445,0,0,drop,66,66,0,1,0,1,0
49197,30188,0,0,deny,62,62,0,1,0,1,0
65465,445,0,0,drop,70,70,0,1,0,1,0
59191,443,56618,443,allow,4489,2046,2443,23,121,11,12
51813,443,18719,443,allow,130,70,60,3,5,2,1
49677,64147,0,0,deny,62,62,0,1,0,1,0
50579,80,47300,80,allow,1827,989,838,13,78,7,6
15319,51505,0,0,deny,62,62,0,1,0,1,0
64406,53,46788,53,allow,204,204,0,3,46,3,0
39545,443,12909,443,allow,5596,3797,1799,27,96,14,13
56492,53,6474,53,allow,184,94,90,2,30,1,1
49418,27026,25116,27026,allow,71,71,0,1,30,1,0
50664,443,64015,443,allow,7767,1421,6346,20,15,8,12
58638,5900,0,0,deny,62,62,0,1,0,1,0
57051,53,63796,53,allow,783,96,687,2,30,1,1
55490,445,0,0,drop,70,70,0,1,0,1,0
58603,445,0,0,drop,70,70,0,1,0,1,0
51508,4545,51508,4545,allow,156,156,0,3,8,3,0
14885,53,14885,53,allow,220,100,120,2,30,1,1
56837,53,4890,53,allow,195,102,93,2,29,1,1
52750,445,0,0,drop,70,70,0,1,0,1,0
3478,61463,0,0,deny,1162,1162,0,1,0,1,0
58800,445,0,0,drop,70,70,0,1,0,1,0
64813,445,0,0,drop,70,70,0,1,0,1,0
6927,52752,0,0,deny,100,100,0,1,0,1,0
50889,80,11268,80,allow,397616,15684,381932,419,141,157,262
49732,443,33979,443,allow,4414,993,3421,14,25,6,8
53131,443,19273,443,allow,10705,5303,5402,36,650,16,20
55187,53,45900,53,allow,172,94,78,2,29,1,1
50974,11392,0,0,deny,66,66,0,1,0,1,0
65115,53,24765,53,allow,186,95,91,2,30,1,1
64319,53,16100,53,allow,186,95,91,2,30,1,1
64034,17935,37819,17935,allow,66,66,0,1,5,1,0
55392,53,19876,53,allow,195,102,93,2,31,1,1
54647,445,0,0,drop,70,70,0,1,0,1,0
50588,443,8589,443,allow,2460,1267,1193,16,98,9,7
60993,445,0,0,drop,70,70,0,1,0,1,0
55021,445,0,0,drop,70,70,0,1,0,1,0
51926,58664,64074,58664,allow,70,70,0,1,5,1,0
50912,443,13273,443,allow,5159,1080,4079,20,255,10,10
65494,53,0,0,deny,88,88,0,1,0,1,0
3270,35440,0,0,deny,66,66,0,1,0,1,0
56731,53,12750,53,allow,165,86,79,2,30,1,1
59701,44847,0,0,deny,62,62,0,1,0,1,0
5786,53,5786,53,allow,213,87,126,2,31,1,1
49747,53,62194,53,allow,355,102,253,2,30,1,1
24504,37965,0,0,deny,62,62,0,1,0,1,0
43308,443,4843,443,allow,120,120,0,2,5,2,0
52105,1024,36023,1024,allow,70,70,0,2,7,2,0
41432,53,63040,53,allow,202,83,119,2,30,1,1
60164,445,0,0,drop,70,70,0,1,0,1,0
26717,25174,0,0,deny,146,146,0,1,0,1,0
22408,22114,0,0,deny,62,62,0,1,0,1,0
57019,53,54333,53,allow,193,102,91,2,30,1,1
39661,23,0,0,deny,60,60,0,1,0,1,0
56778,35440,0,0,deny,66,66,0,1,0,1,0
55575,445,0,0,drop,70,70,0,1,0,1,0
45304,64147,0,0,deny,72,72,0,1,0,1,0
63945,445,0,0,drop,70,70,0,1,0,1,0
12644,11392,0,0,deny,62,62,0,1,0,1,0
36738,123,0,0,deny,234,234,0,1,0,1,0
55372,53,64639,53,allow,271,93,178,4,43,2,2
56004,53,16480,53,allow,177,94,83,2,30,1,1
17226,35440,0,0,deny,62,62,0,1,0,1,0
50343,445,0,0,drop,66,66,0,1,0,1,0
50191,53,41237,53,allow,182,102,80,2,29,1,1
51987,23136,59906,23136,allow,70,70,0,2,8,2,0
57339,53,58719,53,allow,248,94,154,2,30,1,1
3225,64147,0,0,deny,66,66,0,1,0,1,0
50033,445,0,0,drop,66,66,0,1,0,1,0
20608,28189,0,0,deny,60,60,0,1,0,1,0
53298,445,0,0,drop,66,66,0,1,0,1,0
63711,445,0,0,drop,70,70,0,1,0,1,0
62064,22114,0,0,deny,66,66,0,1,0,1,0
64530,53,55254,53,allow,261,87,174,4,45,2,2
33231,443,11220,443,allow,1067,650,417,10,35,6,4
61064,445,0,0,drop,66,66,0,1,0,1,0
43634,80,30485,80,allow,1151,711,440,10,15,5,5
41779,443,29003,443,allow,618072,8505,609567,523,87,90,433
57416,53,62592,53,allow,186,95,91,2,31,1,1
52855,445,0,0,drop,66,66,0,1,0,1,0
56677,53,36331,53,allow,286,103,183,4,48,2,2
10754,28793,0,0,deny,62,62,0,1,0,1,0
14438,443,5069,443,allow,2556,1470,1086,17,15,8,9
57726,37965,0,0,deny,62,62,0,1,0,1,0
50838,445,0,0,drop,70,70,0,1,0,1,0
56411,80,44029,80,allow,35574,868,34706,36,104,10,26
55748,53,60711,53,allow,194,102,92,2,30,1,1
53853,443,32341,443,allow,1966450,57437,1909013,1885,338,544,1341
54709,445,0,0,drop,66,66,0,1,0,1,0
51221,41939,7547,41939,allow,3917,1584,2333,50,3325,25,25
56793,53,24911,53,allow,196,102,94,2,30,1,1
68,67,0,0,deny,594,594,0,1,0,1,0
64537,53,37078,53,allow,168,86,82,2,30,1,1
42996,53,58544,53,allow,168,78,90,2,30,1,1
50040,445,0,0,drop,70,70,0,1,0,1,0
61779,445,0,0,drop,70,70,0,1,0,1,0
53124,443,13902,443,allow,7459,2962,4497,24,47,14,10
50258,5228,5532,5228,allow,6764,1575,5189,25,157,14,11
55729,53,3835,53,allow,256,96,160,4,42,2,2
64220,445,0,0,drop,66,66,0,1,0,1,0
58992,443,6436,443,allow,3049,1857,1192,20,21,9,11
50944,445,0,0,drop,70,70,0,1,0,1,0
52604,445,0,0,drop,70,70,0,1,0,1,0
55810,53,5823,53,allow,183,94,89,2,31,1,1
56628,443,49515,443,allow,7941,1952,5989,20,15,11,9
63640,445,0,0,drop,70,70,0,1,0,1,0
49333,443,8337,443,allow,50226,4284,45942,76,75,31,45
58638,5900,0,0,deny,62,62,0,1,0,1,0
56004,53,52519,53,allow,178,94,84,2,31,1,1
23131,25174,0,0,deny,146,146,0,1,0,1,0
57669,64147,0,0,deny,66,66,0,1,0,1,0
59343,53,0,0,allow,627,72,555,2,30,1,1
37716,443,28375,443,allow,14009,10561,3448,30,135,16,14
54711,445,0,0,drop,70,70,0,1,0,1,0
25595,2323,0,0,deny,60,60,0,1,0,1,0
64612,53,64612,53,allow,213,87,126,2,30,1,1
64706,27065,4529,27065,allow,924,924,0,3,30,3,0
58638,5900,0,0,deny,62,62,0,1,0,1,0
9163,443,23024,443,allow,5658,501,5157,14,15,7,7
59402,445,0,0,drop,66,66,0,1,0,1,0
6943,21162,0,0,deny,100,100,0,1,0,1,0
59600,445,0,0,drop,66,66,0,1,0,1,0
2427,25174,0,0,deny,62,62,0,1,0,1,0
32804,80,61447,80,allow,7454,2436,5018,26,23,16,10
57470,43836,52896,43836,allow,402,132,270,6,1209,3,3
51780,21130,9712,21130,allow,70,70,0,2,8,2,0
50864,443,25636,443,allow,6391,1285,5106,19,15,10,9
26900,27017,53527,27017,allow,254,82,172,4,30,2,2
64975,445,0,0,deny,66,66,0,1,0,1,0
25436,53,25436,53,allow,235,90,145,2,32,1,1
49234,445,0,0,drop,70,70,0,1,0,1,0
41592,443,47156,443,allow,2913,1752,1161,15,15,9,6
51956,445,0,0,drop,66,66,0,1,0,1,0
63988,50584,0,0,deny,62,62,0,1,0,1,0
57010,445,0,0,drop,70,70,0,1,0,1,0
64417,445,0,0,drop,66,66,0,1,0,1,0
56961,53,64914,53,allow,757,102,655,2,30,1,1
61589,445,0,0,drop,70,70,0,1,0,1,0
26183,22114,0,0,deny,62,62,0,1,0,1,0
65221,53,41318,53,allow,199,102,97,2,30,1,1
63672,22114,0,0,deny,62,62,0,1,0,1,0
55662,53,51499,53,allow,753,93,660,2,31,1,1
59411,37965,0,0,deny,66,66,0,1,0,1,0
51659,80,25484,80,allow,318,192,126,6,37,4,2
54647,445,0,0,drop,66,66,0,1,0,1,0
58280,443,25550,443,allow,1786,172,1614,7,121,3,4
65524,53,37598,53,allow,183,94,89,2,30,1,1
56367,53,38735,53,allow,194,102,92,2,30,1,1
52611,9571,0,0,deny,62,62,0,1,0,1,0
52068,39864,30686,39864,allow,70,70,0,1,5,1,0
56407,445,0,0,drop,70,70,0,1,0,1,0
60204,80,20326,80,allow,70,70,0,2,8,2,0
50328,53,20316,53,allow,783,96,687,2,30,1,1
65260,53,3983,53,allow,199,102,97,2,30,1,1
57264,53,9791,53,allow,214,102,112,2,30,1,1
32296,443,32296,443,allow,5421,2444,2977,20,15,11,9
40803,443,57775,443,allow,1093,662,431,10,46,6,4
56341,443,32673,443,allow,49417,5511,43906,108,439,54,54
49614,53,48973,53,allow,183,94,89,2,29,1,1
56100,53,62385,53,allow,211,102,109,2,30,1,1
61189,445,0,0,drop,70,70,0,1,0,1,0
62544,445,0,0,drop,66,66,0,1,0,1,0
53822,25174,0,0,deny,66,66,0,1,0,1,0
2919,57866,0,0,deny,62,62,0,1,0,1,0
53722,445,0,0,drop,70,70,0,1,0,1,0
53223,443,54102,443,allow,7457,1726,5731,25,65,13,12
49509,443,10156,443,allow,8248,2508,5740,31,271,13,18
49364,53,17404,53,allow,307,307,0,4,60,4,0
22409,55442,0,0,deny,74,74,0,1,0,1,0
49639,443,37506,443,allow,7521,2117,5404,22,89,12,10
49972,80,64274,80,allow,95065,52092,42973,148,259,77,71
51856,62841,45068,62841,allow,136,136,0,3,13,3,0
43882,443,18318,443,allow,10494,2409,8085,21,137,9,12
27005,27057,9296,27057,allow,917,126,791,2,31,1,1
63976,53,50670,53,allow,200,102,98,2,30,1,1
54631,44847,0,0,deny,70,70,0,1,0,1,0
64363,22114,0,0,deny,66,66,0,1,0,1,0
58353,445,0,0,drop,70,70,0,1,0,1,0
50831,443,11343,443,allow,721741,131746,589995,1518,322,787,731
64880,9694,0,0,deny,66,66,0,1,0,1,0
14036,48817,0,0,deny,62,62,0,1,0,1,0
37580,443,41939,443,allow,24810,10597,14213,51,123,22,29
11901,443,11901,443,allow,5599,2459,3140,23,29,14,9
56456,445,0,0,drop,66,66,0,1,0,1,0
49192,53,18280,53,allow,747,93,654,2,30,1,1
52159,80,23650,80,allow,502,310,192,9,31,6,3
50972,3544,44578,3544,allow,409,107,302,4,30,2,2
59225,57587,0,0,deny,66,66,0,1,0,1,0
55295,53,52273,53,allow,779,86,693,2,30,1,1
49379,53,35998,53,allow,199,102,97,2,31,1,1
6666,3389,0,0,deny,60,60,0,1,0,1,0
59274,445,0,0,drop,70,70,0,1,0,1,0
27005,27017,35539,27017,allow,873,126,747,2,31,1,1
50245,44847,0,0,deny,66,66,0,1,0,1,0
59472,445,0,0,drop,70,70,0,1,0,1,0
62481,80,55007,80,allow,890,440,450,10,33,6,4
56986,53,7478,53,allow,259,87,172,4,37,2,2
60415,53,0,0,allow,82,82,0,1,30,1,0
50388,443,13080,443,allow,6734,4301,2433,21,29,12,9
56125,445,0,0,drop,66,66,0,1,0,1,0
58638,5900,0,0,deny,62,62,0,1,0,1,0
65437,53,61379,53,allow,195,102,93,2,31,1,1
60412,12965,9031,12965,allow,70,70,0,1,5,1,0
51197,30188,0,0,deny,66,66,0,1,0,1,0
52037,445,0,0,drop,66,66,0,1,0,1,0
64603,445,0,0,drop,66,66,0,1,0,1,0
64448,445,0,0,drop,66,66,0,1,0,1,0
64825,53,28794,53,allow,184,94,90,2,31,1,1
20167,1550,0,0,deny,104,104,0,1,0,1,0
49433,53,27774,53,allow,173,94,79,2,30,1,1
443,10010,0,0,deny,60,60,0,1,0,1,0
55821,53,65311,53,allow,196,102,94,2,31,1,1
55463,445,0,0,drop,70,70,0,1,0,1,0
56073,445,0,0,drop,70,70,0,1,0,1,0
57987,56125,0,0,deny,90,90,0,1,0,1,0
50095,30188,0,0,deny,66,66,0,1,0,1,0
56494,15503,0,0,deny,146,146,0,1,0,1,0
58638,5900,0,0,deny,62,62,0,1,0,1,0
50052,65010,0,0,deny,60,60,0,1,0,1,0
50621,80,31852,80,allow,11975,10368,1607,27,52,16,11
50201,80,38325,80,allow,5015,2123,2892,25,96,14,11
64839,53,19060,53,allow,208,106,102,2,31,1,1
35078,443,15189,443,allow,7222,1768,5454,22,81,13,9
50637,44847,0,0,deny,66,66,0,1,0,1,0
38968,80,48567,80,allow,1280,586,694,10,15,5,5
20083,6881,0,0,deny,62,62,0,1,0,1,0
56999,25174,0,0,deny,62,62,0,1,0,1,0
55295,3389,55295,3389,allow,4365,2581,1784,20,33,11,9
58638,5900,0,0,deny,62,62,0,1,0,1,0
55744,80,6834,80,allow,5146,3694,1452,20,249,10,10
49280,80,50074,80,allow,200808,6612,194196,217,3669,83,134
34436,80,7684,80,allow,6260,696,5564,17,15,9,8
49531,53,34898,53,allow,183,94,89,2,30,1,1
38402,443,45229,443,allow,3830718,112946,3717772,4353,224,1395,2958
12965,37965,0,0,deny,66,66,0,1,0,1,0
55083,53,43737,53,allow,751,95,656,2,30,1,1
55076,53,14239,53,allow,183,94,89,2,30,1,1
64586,53,31352,53,allow,257,102,155,2,30,1,1
56857,53,63903,53,allow,190,97,93,2,31,1,1
56453,37965,0,0,deny,66,66,0,1,0,1,0
50381,445,0,0,drop,70,70,0,1,0,1,0
33215,37965,0,0,deny,62,62,0,1,0,1,0
23091,11119,0,0,deny,148,148,0,1,0,1,0
2780,23117,0,0,deny,62,62,0,1,0,1,0
64295,26467,0,0,deny,62,62,0,1,0,1,0
53614,8999,9856,8999,allow,928,541,387,8,17,5,3
52498,80,52498,80,allow,15453,911,14542,25,16,11,14
55272,53,17246,53,allow,285,103,182,4,50,2,2
59093,53,0,0,allow,215,77,138,2,31,1,1
55462,53,64670,53,allow,214,110,104,2,29,1,1
57415,443,15579,443,allow,28216,10325,17891,93,23,42,51
63978,53,11123,53,allow,212,108,104,2,31,1,1
56581,445,0,0,drop,70,70,0,1,0,1,0
37121,21247,0,0,deny,66,66,0,1,0,1,0
18086,25174,0,0,deny,146,146,0,1,0,1,0
56364,443,6103,443,allow,3775,1791,1984,24,203,12,12
49837,443,55049,443,allow,4685,2421,2264,10,119,5,5
58877,443,18145,443,allow,2577,1550,1027,15,15,7,8
65377,53,55727,53,allow,207,86,121,2,30,1,1
45783,22114,0,0,deny,62,62,0,1,0,1,0
53471,8118,42759,8118,allow,1745,1091,654,10,31,5,5
52088,443,13388,443,allow,16165,3877,12288,53,186,25,28
61506,443,7741,443,allow,15255,2304,12951,30,31,13,17
37630,443,19874,443,allow,10000,2634,7366,28,46,16,12
62097,57470,0,0,deny,146,146,0,1,0,1,0
53360,445,0,0,drop,70,70,0,1,0,1,0
32928,443,19319,443,allow,1527,940,587,14,90,8,6
36036,443,36036,443,allow,261234,32183,229051,326,212,153,173
49411,443,49244,443,allow,17524,2569,14955,38,124,17,21
63134,80,1605,80,allow,18032,904,17128,22,15,7,15
55168,445,0,0,drop,70,70,0,1,0,1,0
55311,44847,0,0,deny,62,62,0,1,0,1,0
50870,445,0,0,drop,66,66,0,1,0,1,0
49251,53,13051,53,allow,94,94,0,1,30,1,0
56463,443,48725,443,allow,6364,1147,5217,19,24,11,8
38175,443,55489,443,allow,10208,2219,7989,37,125,19,18
49344,443,51198,443,allow,272627,89686,182941,461,149,220,241
55591,53,39527,53,allow,195,102,93,2,31,1,1
12232,41864,0,0,deny,139,139,0,1,0,1,0
50668,58833,0,0,deny,66,66,0,1,0,1,0
60249,80,1265,80,allow,31138,6772,24366,40,149,17,23
53901,445,0,0,drop,66,66,0,1,0,1,0
37637,53,37222,53,allow,168,78,90,2,30,1,1
49580,53,62367,53,allow,196,102,94,2,30,1,1
65452,53,19191,53,allow,196,102,94,2,30,1,1
57176,445,0,0,drop,70,70,0,1,0,1,0
56855,64607,58491,64607,allow,316,136,180,6,6,3,3
38065,443,63899,443,allow,15799,7457,8342,42,98,22,20
53855,445,0,0,drop,70,70,0,1,0,1,0
51710,43069,65147,43069,allow,70,70,0,2,8,2,0
55713,25174,0,0,deny,146,146,0,1,0,1,0
0,0,0,0,deny,98,98,0,1,0,1,0
65507,53,3795,53,allow,166,85,81,2,31,1,1
9122,80,61976,80,allow,98161,5033,93128,125,37,45,80
63599,445,0,0,drop,70,70,0,1,0,1,0
57306,445,0,0,drop,70,70,0,1,0,1,0
51453,64147,0,0,deny,66,66,0,1,0,1,0
50073,443,27421,443,allow,22729,6539,16190,54,93,27,27
51137,445,0,0,drop,66,66,0,1,0,1,0
51880,8000,41455,8000,allow,172,94,78,2,29,1,1
34234,993,0,0,deny,60,60,0,1,0,1,0
42344,48637,0,0,deny,60,60,0,1,0,1,0
56519,53,14326,53,allow,167,86,81,2,29,1,1
46442,80,6730,80,allow,1373,669,704,10,16,5,5
52100,443,42530,443,allow,14433889,278906,14154983,13633,66,4079,9554
35123,443,15419,443,allow,17656,4044,13612,30,122,13,17
18173,25174,0,0,deny,66,66,0,1,0,1,0
57417,443,11340,443,allow,43052,2466,40586,64,18,21,43
49418,27018,26196,27018,allow,71,71,0,1,31,1,0
25469,57470,0,0,deny,62,62,0,1,0,1,0
49749,445,0,0,drop,70,70,0,1,0,1,0
53223,445,0,0,drop,70,70,0,1,0,1,0
58763,443,45079,443,allow,5108,700,4408,15,15,7,8
29577,64147,0,0,deny,62,62,0,1,0,1,0
56609,445,0,0,drop,66,66,0,1,0,1,0
55230,53,6138,53,allow,183,94,89,2,30,1,1
29972,53,62142,53,allow,300,94,206,2,30,1,1
443,20995,0,0,deny,83,83,0,1,0,1,0
54423,21247,0,0,deny,66,66,0,1,0,1,0
57781,445,0,0,drop,70,70,0,1,0,1,0
55352,445,0,0,drop,66,66,0,1,0,1,0
52626,445,0,0,drop,66,66,0,1,0,1,0
50402,8080,50402,8080,allow,378,180,198,7,78,4,3
65153,53,43651,53,allow,168,86,82,2,31,1,1
49502,443,21667,443,allow,26402,2904,23498,56,270,29,27
56546,53,5266,53,allow,177,94,83,2,30,1,1
53669,80,61903,80,allow,1119,665,454,12,15,7,5
60766,445,0,0,drop,70,70,0,1,0,1,0
53635,22383,54338,22383,allow,492,306,186,8,17,5,3
61701,445,0,0,drop,70,70,0,1,0,1,0
49371,445,0,0,drop,70,70,0,1,0,1,0
57891,443,65008,443,allow,1856,1217,639,18,176,11,7
55019,445,0,0,drop,70,70,0,1,0,1,0
8999,50432,0,0,deny,62,62,0,1,0,1,0
55010,53,9213,53,allow,195,102,93,2,31,1,1
28999,37807,0,0,deny,62,62,0,1,0,1,0
58920,80,59955,80,allow,318,192,126,6,37,4,2
49954,53,49870,53,allow,216,110,106,2,30,1,1
27005,27015,58465,27015,allow,881,126,755,2,30,1,1
37893,53,0,0,allow,86,86,0,1,30,1,0
64660,53,61374,53,allow,278,94,184,2,30,1,1
57860,51505,0,0,deny,66,66,0,1,0,1,0
52031,20301,11089,20301,allow,70,70,0,2,8,2,0
20953,53,20953,53,allow,295,90,205,2,30,1,1
49537,53,46669,53,allow,269,96,173,4,59,2,2
1256,50584,0,0,deny,146,146,0,1,0,1,0
49288,443,26857,443,allow,7332,2907,4425,50,122,22,28
64321,53,31319,53,allow,190,97,93,2,31,1,1
50725,445,0,0,drop,66,66,0,1,0,1,0
50388,53,36843,53,allow,177,94,83,2,30,1,1
64389,445,0,0,drop,70,70,0,1,0,1,0
57492,443,47894,443,allow,380975,82011,298964,804,171,343,461
60539,80,60539,80,allow,318,120,198,6,26,3,3
61850,445,0,0,drop,70,70,0,1,0,1,0
49234,53,23533,53,allow,206,97,109,2,30,1,1
64582,53,64118,53,allow,209,110,99,2,30,1,1
29791,53,29791,53,allow,213,87,126,2,31,1,1
52114,64147,0,0,deny,62,62,0,1,0,1,0
56638,445,0,0,drop,66,66,0,1,0,1,0
49560,80,60008,80,allow,318,192,126,6,45,4,2
10049,5222,44592,5222,allow,6103,3081,3022,63,616,34,29
43863,80,21010,80,allow,2025,805,1220,12,46,7,5
49704,443,41533,443,allow,513839,16341,497498,453,210,104,349
61085,445,0,0,drop,70,70,0,1,0,1,0
55439,53,44673,53,allow,177,94,83,2,30,1,1
46901,26672,0,0,deny,60,60,0,1,0,1,0
59326,445,0,0,drop,70,70,0,1,0,1,0
64078,443,31734,443,allow,4458,1569,2889,24,138,10,14
56104,445,0,0,drop,70,70,0,1,0,1,0
49946,445,0,0,drop,70,70,0,1,0,1,0
41429,50584,0,0,deny,66,66,0,1,0,1,0
55997,445,0,0,drop,70,70,0,1,0,1,0
58873,443,27496,443,allow,1855088,42017,1813071,1821,49,531,1290
52258,445,0,0,drop,70,70,0,1,0,1,0
61316,445,0,0,drop,70,70,0,1,0,1,0
10639,11392,0,0,deny,62,62,0,1,0,1,0
42273,443,42273,443,allow,4398,1491,2907,19,26,11,8
50903,80,42549,80,allow,13644327,154437,13489890,11257,134,2201,9056
45510,443,22832,443,allow,130,70,60,2,15,1,1
53373,53,58629,53,allow,242,78,164,2,29,1,1
50782,445,0,0,drop,70,70,0,1,0,1,0
41833,443,22584,443,allow,50425,3972,46453,63,122,25,38
65001,53,54840,53,allow,224,78,146,2,30,1,1
63004,445,0,0,drop,70,70,0,1,0,1,0
35154,42707,0,0,deny,62,62,0,1,0,1,0
49628,35440,0,0,deny,66,66,0,1,0,1,0
64353,53,31104,53,allow,225,102,123,2,29,1,1
60391,445,0,0,drop,70,70,0,1,0,1,0
49930,443,24713,443,allow,16631,7072,9559,50,134,29,21
21332,23,0,0,deny,60,60,0,1,0,1,0
55714,443,18718,443,allow,11626,4173,7453,25,121,12,13
55367,53,8311,53,allow,190,97,93,2,31,1,1
53319,443,19200,443,allow,2246,1396,850,15,117,9,6
55002,53,42728,53,allow,196,102,94,2,31,1,1
50460,53,61853,53,allow,753,96,657,2,31,1,1
56648,53,6533,53,allow,198,101,97,2,31,1,1
57606,443,40796,443,allow,11986,3075,8911,60,4981,31,29
56738,443,13897,443,allow,7863,1874,5989,20,15,11,9
56361,443,32525,443,allow,3775,1791,1984,24,203,12,12
80,53945,0,0,deny,60,60,0,1,0,1,0
58638,5900,0,0,deny,62,62,0,1,0,1,0
13911,57470,0,0,deny,60,60,0,1,0,1,0
53598,40326,41639,40326,allow,70,70,0,2,7,2,0
64962,64147,0,0,deny,66,66,0,1,0,1,0
53843,445,0,0,drop,70,70,0,1,0,1,0
55047,443,3031,443,allow,7069,2512,4557,25,46,14,11
54489,80,6564,80,allow,2828,1710,1118,10,255,6,4
58875,53,56659,53,allow,370,86,284,2,30,1,1
55272,445,0,0,drop,66,66,0,1,0,1,0
54619,445,0,0,drop,70,70,0,1,0,1,0
50499,53,23624,53,allow,718,94,624,2,30,1,1
65453,53,50552,53,allow,242,94,148,2,30,1,1
57470,32348,51610,32348,allow,527,166,361,2,1199,1,1
54188,445,0,0,drop,66,66,0,1,0,1,0
1024,35894,0,0,deny,62,62,0,1,0,1,0
10436,37965,0,0,deny,62,62,0,1,0,1,0
63021,443,34609,443,allow,512,166,346,2,30,1,1
64118,445,0,0,drop,66,66,0,1,0,1,0
51497,443,10165,443,allow,350,210,140,6,14,4,2
56323,53,5698,53,allow,152,78,74,2,30,1,1
64935,53,42263,53,allow,313,94,219,2,29,1,1
54731,443,46644,443,allow,9498,2578,6920,28,19,16,12
57452,57470,0,0,deny,62,62,0,1,0,1,0
55907,445,0,0,drop,70,70,0,1,0,1,0
64414,445,0,0,drop,70,70,0,1,0,1,0
45964,2228,0,0,deny,60,60,0,1,0,1,0
50584,12899,63307,12899,allow,166,166,0,1,1200,1,0
55830,53,38726,53,allow,177,94,83,2,29,1,1
53221,443,43184,443,allow,57706,2486,55220,67,65,23,44
41325,443,55609,443,allow,6015,4418,1597,38,246,22,16
26802,50584,0,0,deny,146,146,0,1,0,1,0
64787,53,58679,53,allow,179,94,85,2,29,1,1
57098,53,51101,53,allow,229,94,135,2,30,1,1
55385,443,7012,443,allow,11771,2624,9147,50,20,25,25
54782,445,0,0,drop,70,70,0,1,0,1,0
57284,443,12442,443,allow,1402,917,485,12,27,7,5
6881,7999,34044,7999,allow,238,118,120,2,1199,1,1
63257,445,0,0,drop,66,66,0,1,0,1,0
58638,5900,0,0,deny,62,62,0,1,0,1,0
56876,30188,0,0,deny,66,66,0,1,0,1,0
65268,53,12409,53,allow,395,107,288,4,46,2,2
62578,53,27363,53,allow,343,168,175,3,30,2,1
63991,53,55633,53,allow,193,102,91,2,29,1,1
38700,443,59895,443,allow,4478,1133,3345,13,27,8,5
36407,443,52772,443,allow,1149,709,440,13,38,8,5
63895,44847,0,0,deny,62,62,0,1,0,1,0
64359,53,39260,53,allow,192,98,94,2,31,1,1
16037,25174,0,0,deny,62,62,0,1,0,1,0
62294,445,0,0,drop,70,70,0,1,0,1,0
51429,443,6993,443,allow,8804,1597,7207,25,50,14,11
50328,22114,0,0,deny,66,66,0,1,0,1,0
61975,445,0,0,drop,70,70,0,1,0,1,0
56637,53,42734,53,allow,711,87,624,2,30,1,1
58369,53,5499,53,allow,174,81,93,2,30,1,1
57596,80,43063,80,allow,1231,726,505,10,18,6,4
20400,64147,0,0,deny,62,62,0,1,0,1,0
58331,445,0,0,drop,70,70,0,1,0,1,0
50442,37807,0,0,deny,66,66,0,1,0,1,0
61603,445,0,0,drop,70,70,0,1,0,1,0
52011,10722,20939,10722,allow,70,70,0,2,7,2,0
56526,443,61934,443,allow,7563,3697,3866,19,15,10,9
53582,40872,7897,40872,allow,492,306,186,8,16,5,3
52847,445,0,0,drop,70,70,0,1,0,1,0
55134,53,55134,53,allow,825,99,726,2,31,1,1
62902,445,0,0,drop,70,70,0,1,0,1,0
56332,53,36197,53,allow,193,102,91,2,31,1,1
55461,53,48907,53,allow,198,110,88,2,31,1,1
56709,445,0,0,drop,66,66,0,1,0,1,0
56092,445,0,0,drop,70,70,0,1,0,1,0
59155,445,0,0,drop,66,66,0,1,0,1,0
64657,53,42843,53,allow,816,102,714,2,30,1,1
64945,53,47640,53,allow,292,126,166,2,29,1,1
59930,80,22245,80,allow,1638,1324,314,10,15,5,5
61162,445,0,0,drop,70,70,0,1,0,1,0
5060,37965,0,0,deny,66,66,0,1,0,1,0
27005,27014,42282,27014,allow,882,126,756,2,30,1,1
57301,53,42748,53,allow,177,94,83,2,29,1,1
61420,445,0,0,drop,66,66,0,1,0,1,0
56757,53,39521,53,allow,167,86,81,2,30,1,1
53833,26467,0,0,deny,66,66,0,1,0,1,0
56663,53,34654,53,allow,178,91,87,2,31,1,1
59587,25174,0,0,deny,62,62,0,1,0,1,0
49825,53,30889,53,allow,336,110,226,2,31,1,1
55580,53,20402,53,allow,195,102,93,2,30,1,1
59575,445,0,0,drop,70,70,0,1,0,1,0
57212,445,0,0,drop,70,70,0,1,0,1,0
50135,445,0,0,drop,70,70,0,1,0,1,0
60630,445,0,0,drop,66,66,0,1,0,1,0
50979,445,0,0,drop,70,70,0,1,0,1,0
64364,445,0,0,drop,66,66,0,1,0,1,0
56738,53,8511,53,allow,264,87,177,4,37,2,2
56244,445,0,0,drop,66,66,0,1,0,1,0
52001,445,0,0,drop,70,70,0,1,0,1,0
57275,53,15169,53,allow,193,102,91,2,30,1,1
26459,80,26459,80,allow,490,264,226,8,32,5,3
47238,443,16760,443,allow,16131,4542,11589,45,139,21,24
51768,80,6690,80,allow,211684,9903,201781,247,27,109,138
29486,53,29486,53,allow,825,99,726,2,31,1,1
62885,443,65198,443,allow,8097,2684,5413,22,248,12,10
56677,53,61027,53,allow,200,102,98,2,30,1,1
36943,443,59404,443,allow,15329,7087,8242,108,310,61,47
23131,25174,0,0,deny,62,62,0,1,0,1,0
65123,53,59199,53,allow,816,102,714,2,29,1,1
57470,6881,64620,6881,allow,577,251,326,4,1200,2,2
52321,443,52321,443,allow,6727,762,5965,15,25,8,7
55786,53,31916,53,allow,102,102,0,1,30,1,0
58638,5900,0,0,deny,62,62,0,1,0,1,0
53708,80,59470,80,allow,2434,516,1918,12,76,6,6
51324,11392,0,0,deny,66,66,0,1,0,1,0
51862,80,9823,80,allow,6106,5420,686,13,30,7,6
64803,53,39873,53,allow,102,102,0,1,30,1,0
50584,1070,63097,1070,allow,161,161,0,2,1200,2,0
30960,45713,7044,45713,allow,330,330,0,6,3610,6,0
56544,445,0,0,drop,70,70,0,1,0,1,0
34964,80,34964,80,allow,2889,1482,1407,10,15,6,4
49429,53,19279,53,allow,210,110,100,2,30,1,1
52166,80,3955,80,allow,2110,1066,1044,12,15,7,5
27785,37965,0,0,deny,66,66,0,1,0,1,0
59819,445,0,0,drop,70,70,0,1,0,1,0
62878,445,0,0,drop,70,70,0,1,0,1,0
65307,445,0,0,drop,70,70,0,1,0,1,0
61502,443,14539,443,allow,580643,7944,572699,475,41,86,389
58346,53,2203,53,allow,209,102,107,2,30,1,1
50573,80,11289,80,allow,318,192,126,6,26,4,2
50927,445,0,0,drop,70,70,0,1,0,1,0
57422,80,40149,80,allow,10454,4931,5523,21,30,10,11
11256,47967,0,0,deny,143,143,0,1,0,1,0
62996,445,0,0,drop,70,70,0,1,0,1,0
62299,445,0,0,drop,70,70,0,1,0,1,0
56758,40000,32207,40000,allow,70,70,0,2,8,2,0
51969,443,9113,443,allow,15609,5649,9960,58,76,31,27
54159,443,24398,443,allow,4723,2593,2130,16,137,8,8
56704,53,2195,53,allow,177,94,83,2,30,1,1
65418,53,64332,53,allow,211,102,109,2,30,1,1
54339,23117,0,0,deny,66,66,0,1,0,1,0
60206,445,0,0,drop,66,66,0,1,0,1,0
60292,7129,0,0,deny,62,62,0,1,0,1,0
12969,55777,0,0,deny,66,66,0,1,0,1,0
49958,36829,0,0,deny,66,66,0,1,0,1,0
60049,443,36353,443,allow,23967,5983,17984,40,142,17,23
64605,53,39152,53,allow,182,93,89,2,30,1,1
48206,53,48206,53,allow,253,99,154,2,30,1,1
57470,31381,16195,31381,allow,792,792,0,13,1200,13,0
50377,53,41134,53,allow,214,110,104,2,30,1,1
52732,80,5693,80,allow,23509,14666,8843,70,553,38,32
56450,53,17647,53,allow,177,94,83,2,29,1,1
52969,44847,0,0,deny,66,66,0,1,0,1,0
62197,22114,0,0,deny,66,66,0,1,0,1,0
59076,25174,0,0,deny,62,62,0,1,0,1,0
37609,15503,0,0,deny,146,146,0,1,0,1,0
55182,53,17791,53,allow,199,102,97,2,30,1,1
64963,53,58073,53,allow,453,186,267,6,30,3,3
64474,445,0,0,drop,66,66,0,1,0,1,0
51970,80,32175,80,allow,366,240,126,7,25,5,2
53716,6881,32283,6881,allow,70,70,0,1,4,1,0
54227,445,0,0,drop,70,70,0,1,0,1,0
58486,57470,0,0,deny,66,66,0,1,0,1,0
58728,443,26266,443,allow,5167,700,4467,16,15,7,9
42813,443,40546,443,allow,1241645,28525,1213120,1200,65,328,872
42216,53,45740,53,allow,199,94,105,2,30,1,1
53459,443,23457,443,allow,88210,4564,83646,115,46,50,65
62486,53,33326,53,allow,303,303,0,4,47,4,0
55024,445,0,0,drop,70,70,0,1,0,1,0
52065,443,43327,443,allow,7851,2487,5364,35,383,16,19
33372,3389,33372,3389,allow,4695,2520,2175,22,19,13,9
38604,53,38604,53,allow,203,82,121,2,30,1,1
63924,445,0,0,drop,70,70,0,1,0,1,0
53161,30013,56221,30013,allow,70,70,0,1,5,1,0
50877,80,27709,80,allow,186520,11545,174975,222,141,96,126
52141,1033,19443,1033,allow,316,136,180,6,7,3,3
34176,51505,0,0,deny,62,62,0,1,0,1,0
7226,50584,0,0,deny,146,146,0,1,0,1,0
55504,53,5700,53,allow,711,87,624,2,30,1,1
42440,443,11681,443,allow,9412,2994,6418,27,48,16,11
19698,502,0,0,deny,60,60,0,1,0,1,0
18904,57470,0,0,deny,62,62,0,1,0,1,0
56725,53,48111,53,allow,180,94,86,2,31,1,1
31214,53,31214,53,allow,216,90,126,2,30,1,1
38117,443,59236,443,allow,8598,3880,4718,23,200,13,10
7210,22114,0,0,deny,66,66,0,1,0,1,0
58077,36653,28921,36653,allow,268,128,140,5,10,3,2
56131,53,25151,53,allow,245,94,151,2,30,1,1
53394,445,0,0,drop,70,70,0,1,0,1,0
53960,30041,0,0,deny,66,66,0,1,0,1,0
43310,80,46970,80,allow,811,671,140,6,32,4,2
56847,443,59529,443,allow,35160,6404,28756,82,196,31,51
30966,44847,0,0,deny,146,146,0,1,0,1,0
55155,2767,0,0,deny,66,66,0,1,0,1,0
42308,443,54120,443,allow,433261,34730,398531,604,279,258,346
56628,80,40916,80,allow,1359,435,924,13,30,7,6
6889,7363,0,0,deny,143,143,0,1,0,1,0
56575,445,0,0,drop,70,70,0,1,0,1,0
58183,445,0,0,drop,66,66,0,1,0,1,0
12644,11392,0,0,deny,66,66,0,1,0,1,0
51667,443,62904,443,allow,1203,703,500,14,42,8,6
51075,445,0,0,drop,70,70,0,1,0,1,0
49982,53,16411,53,allow,211,110,101,2,30,1,1
443,50238,0,0,deny,60,60,0,1,0,1,0
63799,13835,2064,13835,allow,66,66,0,2,8,2,0
52625,25174,0,0,deny,66,66,0,1,0,1,0
54439,443,63339,443,allow,44294,9390,34904,167,319,83,84
57361,445,0,0,drop,66,66,0,1,0,1,0
0,0,0,0,deny,98,98,0,1,0,1,0
37826,23,0,0,deny,60,60,0,1,0,1,0
61592,443,6581,443,allow,19544,8237,11307,29,121,13,16
55176,53,57165,53,allow,195,102,93,2,30,1,1
56316,445,0,0,drop,70,70,0,1,0,1,0
61108,445,0,0,drop,70,70,0,1,0,1,0
62415,53,36183,53,allow,86,86,0,1,30,1,0
55622,33342,17108,33342,allow,70,70,0,1,5,1,0
49869,53,53726,53,allow,202,103,99,2,31,1,1
34285,80,34285,80,allow,424,198,226,7,141,4,3
43027,80,42429,80,allow,1506,1446,60,2,5,1,1
64117,445,0,0,drop,70,70,0,1,0,1,0
34308,3389,34308,3389,allow,4930,2691,2239,24,19,14,10
45872,53,25002,53,allow,199,94,105,2,30,1,1
65465,53,17852,53,allow,755,102,653,2,29,1,1
58250,35440,0,0,deny,66,66,0,1,0,1,0
58143,57866,0,0,deny,66,66,0,1,0,1,0
3478,61463,0,0,deny,164,164,0,1,0,1,0
62758,443,37429,443,allow,22187,14208,7979,52,130,25,27
53031,443,7092,443,allow,16055,5856,10199,97,92,42,55
49945,80,12569,80,allow,4215,620,3595,14,15,7,7
51163,445,0,0,drop,70,70,0,1,0,1,0
57351,53,35105,53,allow,184,94,90,2,30,1,1
58638,5900,0,0,deny,62,62,0,1,0,1,0
9247,80,43064,80,allow,860,794,66,6,17,5,1
61337,443,54439,443,allow,31111,6287,24824,62,247,25,37
63075,53,54531,53,allow,571,166,405,2,29,1,1
55021,53,4080,53,allow,174,89,85,2,31,1,1
56955,53,20294,53,allow,184,86,98,2,29,1,1
49747,443,22101,443,allow,7087,1705,5382,19,128,10,9
63428,445,0,0,drop,70,70,0,1,0,1,0
26699,35253,0,0,deny,62,62,0,1,0,1,0
37581,443,35670,443,allow,499,425,74,4,0,3,1
56535,53,61823,53,allow,200,94,106,2,30,1,1
58069,445,0,0,drop,66,66,0,1,0,1,0
443,14591,0,0,deny,131,131,0,1,0,1,0
49246,53,51289,53,allow,164,86,78,2,31,1,1
57936,445,0,0,drop,70,70,0,1,0,1,0
58460,36237,0,0,deny,66,66,0,1,0,1,0
63041,445,0,0,drop,70,70,0,1,0,1,0
58198,445,0,0,drop,70,70,0,1,0,1,0
443,50238,0,0,deny,331,331,0,1,0,1,0
51675,445,0,0,drop,70,70,0,1,0,1,0
19882,22114,0,0,deny,62,62,0,1,0,1,0
62050,443,9772,443,allow,2139,1140,999,15,124,9,6
56332,53,61425,53,allow,193,102,91,2,31,1,1
37965,6881,34922,6881,allow,448,246,202,4,1199,2,2
6897,48817,0,0,deny,139,139,0,1,0,1,0
52200,42430,1127,42430,allow,70,70,0,1,5,1,0
57334,53,42427,53,allow,184,94,90,2,30,1,1
65260,53,12231,53,allow,184,94,90,2,30,1,1
61392,445,0,0,drop,70,70,0,1,0,1,0
63830,15847,65256,15847,allow,1592,1044,548,15,15,9,6
56259,445,0,0,drop,70,70,0,1,0,1,0
60010,443,42426,443,allow,4795,2875,1920,19,143,10,9
52447,443,48925,443,allow,7980,5952,2028,22,99,12,10
56511,53,19992,53,allow,200,102,98,2,31,1,1
49265,53,28768,53,allow,181,94,87,2,29,1,1
55259,445,0,0,drop,70,70,0,1,0,1,0
53830,443,40467,443,allow,499,425,74,4,0,3,1
50151,53,38506,53,allow,177,94,83,2,30,1,1
62457,7000,62457,7000,allow,3959,1738,2221,15,15,8,7
56031,53,4995,53,allow,177,94,83,2,29,1,1
56676,80,29076,80,allow,78,78,0,2,6,2,0
56767,53,44423,53,allow,177,94,83,2,30,1,1
55280,53,18692,53,allow,258,110,148,2,30,1,1
10216,11392,0,0,deny,66,66,0,1,0,1,0
59051,27520,0,0,deny,62,62,0,1,0,1,0
64631,53,8154,53,allow,193,102,91,2,30,1,1
2991,23,0,0,deny,60,60,0,1,0,1,0
49881,53,28793,53,allow,395,102,293,2,30,1,1
53244,443,63773,443,allow,57649,2489,55160,66,69,23,43
56713,25174,0,0,deny,146,146,0,1,0,1,0
49721,445,0,0,drop,70,70,0,1,0,1,0
49647,53,49647,53,allow,404,259,145,3,32,2,1
60896,445,0,0,drop,66,66,0,1,0,1,0
55268,445,0,0,drop,70,70,0,1,0,1,0
54684,37965,0,0,deny,62,62,0,1,0,1,0
65287,53,32403,53,allow,222,86,136,2,30,1,1
40512,57470,0,0,deny,74,74,0,1,0,1,0
60106,445,0,0,drop,70,70,0,1,0,1,0
62147,445,0,0,drop,70,70,0,1,0,1,0
55439,53,52898,53,allow,209,110,99,2,30,1,1
50388,53,43330,53,allow,94,94,0,1,29,1,0
56612,53,30112,53,allow,274,87,187,4,31,2,2
42034,28189,0,0,deny,62,62,0,1,0,1,0
6712,161,0,0,deny,82,82,0,1,0,1,0
50491,443,13045,443,allow,11995,3850,8145,44,120,23,21
55559,53,59475,53,allow,182,94,88,2,30,1,1
24504,37965,0,0,deny,62,62,0,1,0,1,0
56219,53,21871,53,allow,211,102,109,2,30,1,1
62654,35440,0,0,deny,62,62,0,1,0,1,0
52660,445,0,0,drop,66,66,0,1,0,1,0
53848,43725,33158,43725,allow,552,306,246,9,15,5,4
50287,53,28262,53,allow,781,94,687,2,30,1,1
54243,445,0,0,drop,70,70,0,1,0,1,0
60141,62413,0,0,deny,66,66,0,1,0,1,0
49876,80,23793,80,allow,24764,4454,20310,30,88,12,18
44981,57470,0,0,deny,66,66,0,1,0,1,0
56370,443,11997,443,allow,26040,2148,23892,44,22,21,23
5223,14446,0,0,deny,119,119,0,1,0,1,0
45766,2323,0,0,deny,60,60,0,1,0,1,0
49418,27015,52121,27015,allow,232,71,161,2,31,1,1
33771,53,38746,53,allow,506,316,190,3,30,2,1
51939,34393,16792,34393,allow,70,70,0,1,5,1,0
30729,22114,0,0,deny,66,66,0,1,0,1,0
51628,443,50977,443,allow,5678,3121,2557,39,256,18,21
58424,445,0,0,drop,66,66,0,1,0,1,0
65285,53,31109,53,allow,294,102,192,2,30,1,1
0,0,0,0,allow,320,320,0,5,0,5,0
5588,5588,0,0,allow,3562,1936,1626,48,195,24,24
55038,445,0,0,drop,66,66,0,1,0,1,0
56883,53,62227,53,allow,184,94,90,2,30,1,1
63873,44847,0,0,deny,62,62,0,1,0,1,0
56727,53,26195,53,allow,762,101,661,2,31,1,1
49706,53,17646,53,allow,296,102,194,4,42,2,2
49227,2710,25043,2710,allow,70,70,0,1,5,1,0
51994,443,26093,443,allow,330,190,140,6,15,4,2
56637,53,46210,53,allow,199,102,97,2,30,1,1
33786,23,0,0,deny,60,60,0,1,0,1,0
52903,445,0,0,drop,66,66,0,1,0,1,0
55283,445,0,0,drop,70,70,0,1,0,1,0
48297,443,9986,443,allow,7320,1817,5503,41,106,16,25
64420,53,3880,53,allow,194,102,92,2,30,1,1
54280,3398,0,0,deny,60,60,0,1,0,1,0
52025,445,0,0,drop,66,66,0,1,0,1,0
56734,443,56734,443,allow,373876,52153,321723,424,87,185,239
57474,445,0,0,drop,70,70,0,1,0,1,0
50757,64147,0,0,deny,66,66,0,1,0,1,0
58626,445,0,0,drop,70,70,0,1,0,1,0
56421,53,5669,53,allow,350,94,256,2,30,1,1
57324,443,38455,443,allow,5612,733,4879,16,14,9,7
34783,5222,34830,5222,allow,482,210,272,8,15,4,4
49649,445,0,0,drop,66,66,0,1,0,1,0
63171,445,0,0,drop,70,70,0,1,0,1,0
56427,445,0,0,drop,70,70,0,1,0,1,0
57905,443,45669,443,allow,1851,1152,699,18,169,10,8
54043,36237,0,0,deny,62,62,0,1,0,1,0
24560,25174,0,0,deny,62,62,0,1,0,1,0
62498,445,0,0,drop,70,70,0,1,0,1,0
51113,445,0,0,drop,66,66,0,1,0,1,0
53902,67,0,0,deny,60,60,0,1,0,1,0
55494,53,4891,53,allow,255,102,153,2,30,1,1
6889,47807,0,0,deny,143,143,0,1,0,1,0
49406,443,41618,443,allow,7808,2879,4929,36,186,19,17
56751,80,54705,80,allow,1462,703,759,8,16,5,3
53152,443,33270,443,allow,116790,7062,109728,166,144,85,81
50435,80,28947,80,allow,318,192,126,6,27,4,2
49762,80,8921,80,allow,2114,1182,932,10,127,6,4
61712,443,30612,443,allow,7443,2692,4751,19,76,11,8
59787,443,40007,443,allow,1457,816,641,15,28,7,8
49662,53,31424,53,allow,268,93,175,4,58,2,2
54779,50584,0,0,deny,66,66,0,1,0,1,0
58061,80,39603,80,allow,5571,2637,2934,23,75,12,11
57928,30188,0,0,deny,62,62,0,1,0,1,0
1038,37965,0,0,deny,62,62,0,1,0,1,0
49485,56972,0,0,deny,66,66,0,1,0,1,0
6889,41864,0,0,deny,143,143,0,1,0,1,0
40662,443,40662,443,allow,4624,1717,2907,19,28,11,8
65416,443,30210,443,allow,3219,2242,977,19,25,9,10
51304,445,0,0,drop,70,70,0,1,0,1,0
37234,44847,0,0,deny,66,66,0,1,0,1,0
55229,443,47978,443,allow,3602,1519,2083,18,60,10,8
49825,53,24008,53,allow,814,110,704,2,29,1,1
51500,993,4543,993,allow,14747,5073,9674,109,45,51,58
60646,11392,0,0,deny,66,66,0,1,0,1,0
52385,445,0,0,drop,70,70,0,1,0,1,0
58638,5900,0,0,deny,62,62,0,1,0,1,0
18650,23718,0,0,deny,62,62,0,1,0,1,0
58426,445,0,0,drop,66,66,0,1,0,1,0
35201,25174,0,0,deny,62,62,0,1,0,1,0
50511,445,0,0,drop,70,70,0,1,0,1,0
52003,44512,0,0,deny,66,66,0,1,0,1,0
58793,443,33855,443,allow,40456,12307,28149,114,140,58,56
51785,33253,14709,33253,allow,70,70,0,2,8,2,0
52695,445,0,0,drop,70,70,0,1,0,1,0
55219,53,51728,53,allow,181,94,87,2,32,1,1
50793,443,16791,443,allow,9721,3096,6625,30,122,13,17
49364,80,23008,80,allow,1614,1300,314,10,15,5,5
53286,445,0,0,drop,70,70,0,1,0,1,0
56732,443,23589,443,allow,7855,1866,5989,20,15,11,9
52170,443,6811,443,allow,11716,7393,4323,47,146,21,26
63628,53,35423,53,allow,289,86,203,2,30,1,1
62554,445,0,0,drop,66,66,0,1,0,1,0
64995,27023,24538,27023,allow,1773,924,849,6,30,3,3
58036,443,0,0,deny,1097,1097,0,1,0,1,0
50224,443,62141,443,allow,9530,2104,7426,18,121,9,9
59413,51505,0,0,deny,66,66,0,1,0,1,0
53254,443,6395,443,allow,310549,9420,301129,339,65,122,217
59733,443,53510,443,allow,7165,2077,5088,22,105,12,10
55651,53,6764,53,allow,760,97,663,2,30,1,1
56353,443,16805,443,allow,3775,1791,1984,24,203,12,12
26751,443,19482,443,allow,11513,2842,8671,31,18,15,16
64016,53,18748,53,allow,184,94,90,2,31,1,1
56919,53,40423,53,allow,177,94,83,2,29,1,1
54109,36829,0,0,deny,66,66,0,1,0,1,0
11859,64147,0,0,deny,62,62,0,1,0,1,0
61060,445,0,0,drop,70,70,0,1,0,1,0
64394,445,0,0,drop,70,70,0,1,0,1,0
59789,445,0,0,drop,70,70,0,1,0,1,0
64941,445,0,0,drop,66,66,0,1,0,1,0
58686,445,0,0,drop,70,70,0,1,0,1,0
56901,445,0,0,drop,66,66,0,1,0,1,0
1024,41055,0,0,deny,157,157,0,1,0,1,0
46349,51505,0,0,deny,74,74,0,1,0,1,0
27110,22114,0,0,deny,60,60,0,1,0,1,0
17735,53,27345,53,allow,223,86,137,2,29,1,1
27005,27024,9068,27024,allow,1760,252,1508,5,31,3,2
60702,443,49529,443,allow,13618,5262,8356,54,101,26,28
50172,445,0,0,drop,70,70,0,1,0,1,0
64711,53,23065,53,allow,760,97,663,2,30,1,1
57859,445,0,0,drop,70,70,0,1,0,1,0
52562,445,0,0,drop,70,70,0,1,0,1,0
49372,53,16928,53,allow,210,110,100,2,30,1,1
28236,53,28236,53,allow,235,90,145,2,32,1,1
54009,445,0,0,drop,66,66,0,1,0,1,0
46848,80,53629,80,allow,25162,23336,1826,34,19,21,13
57102,443,24363,443,allow,17207,7111,10096,44,51,23,21
56925,53,7944,53,allow,192,98,94,2,30,1,1
60912,443,25198,443,allow,9959,2430,7529,27,46,16,11
49532,53,4849,53,allow,190,97,93,2,31,1,1
55056,443,30880,443,allow,5233,3384,1849,21,62,11,10
33497,53,21271,53,allow,168,78,90,2,30,1,1
49893,25174,0,0,deny,66,66,0,1,0,1,0
50936,22114,0,0,deny,62,62,0,1,0,1,0
2075,7000,2075,7000,allow,5850,4395,1455,18,15,10,8
28040,64147,0,0,deny,62,62,0,1,0,1,0
53150,445,0,0,drop,70,70,0,1,0,1,0
15503,63425,41497,63425,allow,481,150,331,2,1200,1,1
30188,56962,59522,56962,allow,2746,1487,1259,21,2495,14,7
53803,17637,39254,17637,allow,70,70,0,1,5,1,0
65166,62413,0,0,deny,62,62,0,1,0,1,0
49558,53,29414,53,allow,177,94,83,2,30,1,1
6899,48817,0,0,deny,139,139,0,1,0,1,0
63288,445,0,0,drop,70,70,0,1,0,1,0
53963,6882,44227,6882,allow,70,70,0,2,8,2,0
26802,50584,0,0,deny,62,62,0,1,0,1,0
36983,80,52569,80,allow,130,70,60,2,15,1,1
63931,445,0,0,drop,70,70,0,1,0,1,0
65315,53,25956,53,allow,172,88,84,2,30,1,1
56394,443,33249,443,allow,12371,1344,11027,30,3944,10,20
13826,443,17437,443,allow,7356,1014,6342,20,75,10,10
56880,53,27129,53,allow,209,110,99,2,30,1,1
57545,445,0,0,drop,66,66,0,1,0,1,0
18029,50584,0,0,deny,66,66,0,1,0,1,0
55565,64147,0,0,deny,66,66,0,1,0,1,0
1558,80,1558,80,allow,6377,703,5674,13,15,6,7
50518,443,9409,443,allow,7117,1288,5829,22,84,12,10
64790,445,0,0,drop,66,66,0,1,0,1,0
62887,993,3389,993,allow,8921,4675,4246,77,200,47,30
57344,443,60771,443,allow,3872,1641,2231,14,125,6,8
56149,80,45182,80,allow,1286,403,883,16,400,4,12
60068,443,63784,443,allow,10192,5090,5102,43,15,24,19
42298,51408,45869,51408,allow,725,325,400,12,31,6,6
49941,80,49941,80,allow,493003,23995,469008,578,22,246,332
54539,443,59530,443,allow,4867,1208,3659,16,23,10,6
49356,53,31614,53,allow,209,102,107,2,30,1,1
55784,53,2771,53,allow,184,94,90,2,30,1,1
50885,445,0,0,drop,66,66,0,1,0,1,0
37655,443,41125,443,allow,9811,3415,6396,29,46,17,12
50876,443,55719,443,allow,1786,172,1614,7,120,3,4
64382,44847,0,0,deny,66,66,0,1,0,1,0
63895,44847,0,0,deny,62,62,0,1,0,1,0
39145,443,40241,443,allow,4602,1305,3297,27,183,12,15
58638,5900,0,0,deny,62,62,0,1,0,1,0
52866,80,44619,80,allow,6022,2590,3432,37,131,20,17
61404,52700,0,0,deny,72,72,0,1,0,1,0
64598,53,46493,53,allow,342,142,200,2,30,1,1
62139,445,0,0,drop,70,70,0,1,0,1,0
3478,61463,0,0,deny,451,451,0,1,0,1,0
61427,80,27068,80,allow,214,140,74,4,41,3,1
63089,445,0,0,drop,70,70,0,1,0,1,0
17760,50584,0,0,deny,146,146,0,1,0,1,0
42354,443,60503,443,allow,4181,998,3183,14,27,7,7
37558,16385,3655,16385,allow,432,192,240,8,30,4,4
64846,445,0,0,drop,66,66,0,1,0,1,0
51550,11392,0,0,deny,66,66,0,1,0,1,0
51020,445,0,0,drop,70,70,0,1,0,1,0
60988,443,42425,443,allow,8019,3298,4721,30,40,17,13
63717,445,0,0,drop,70,70,0,1,0,1,0
55808,53,55808,53,allow,257,106,151,2,30,1,1
57083,53,56856,53,allow,755,94,661,2,31,1,1
57061,53,26951,53,allow,711,87,624,2,30,1,1
49538,53,45151,53,allow,748,94,654,2,30,1,1
49709,80,35500,80,allow,128214,4961,123253,134,108,43,91
28021,443,4074,443,allow,5578,1390,4188,19,16,9,10
37911,443,2261,443,allow,466,392,74,4,0,3,1
55286,53,38062,53,allow,194,102,92,2,29,1,1
56176,53,8371,53,allow,194,102,92,2,30,1,1
49706,53,34052,53,allow,296,102,194,4,41,2,2
51827,48432,37555,48432,allow,164,70,94,2,4,1,1
62139,53,5155,53,allow,291,78,213,2,30,1,1
22783,64147,0,0,deny,62,62,0,1,0,1,0
26900,27017,59495,27017,allow,422,164,258,6,30,3,3
53682,20884,39828,20884,allow,70,70,0,2,7,2,0
49330,443,4383,443,allow,7913,2091,5822,23,42,11,12
55044,445,0,0,drop,70,70,0,1,0,1,0
63289,445,0,0,drop,70,70,0,1,0,1,0
57256,5228,53413,5228,allow,7144,1872,5272,36,22,20,16
62257,445,0,0,drop,70,70,0,1,0,1,0
64399,53,50659,53,allow,230,110,120,2,29,1,1
53425,51689,2819,51689,allow,546,306,240,9,142,5,4
49466,53,47860,53,allow,209,110,99,2,30,1,1
55373,53,47253,53,allow,164,86,78,2,31,1,1
57706,64147,0,0,deny,66,66,0,1,0,1,0
57500,37965,0,0,deny,62,62,0,1,0,1,0
63904,445,0,0,drop,66,66,0,1,0,1,0
49700,53,14464,53,allow,165,78,87,2,30,1,1
49880,53,5726,53,allow,194,102,92,2,30,1,1
57189,445,0,0,drop,70,70,0,1,0,1,0
51181,445,0,0,drop,66,66,0,1,0,1,0
29203,26467,0,0,deny,62,62,0,1,0,1,0
56199,53,59192,53,allow,227,110,117,2,30,1,1
60048,445,0,0,drop,66,66,0,1,0,1,0
56375,53,31585,53,allow,177,94,83,2,31,1,1
54260,443,6069,443,allow,5904,1876,4028,18,18,10,8
45232,53,0,0,allow,82,82,0,1,31,1,0
58687,11392,0,0,deny,66,66,0,1,0,1,0
62441,443,36404,443,allow,4651,3116,1535,19,44,10,9
37600,443,40571,443,allow,19917,8751,11166,51,56,32,19
57340,445,0,0,drop,70,70,0,1,0,1,0
63305,62413,0,0,deny,66,66,0,1,0,1,0
39039,443,46475,443,allow,3159,1237,1922,14,19,8,6
10963,53,53121,53,allow,177,86,91,2,30,1,1
63085,53,50123,53,allow,448,166,282,2,30,1,1
49377,445,0,0,drop,70,70,0,1,0,1,0
50367,37965,0,0,deny,66,66,0,1,0,1,0
58486,57470,0,0,deny,66,66,0,1,0,1,0
60372,445,0,0,drop,66,66,0,1,0,1,0
36229,62413,0,0,deny,146,146,0,1,0,1,0
35589,25174,0,0,deny,66,66,0,1,0,1,0
57557,445,0,0,drop,66,66,0,1,0,1,0
51041,445,0,0,drop,70,70,0,1,0,1,0
55488,445,0,0,drop,70,70,0,1,0,1,0
64903,53,16364,53,allow,210,110,100,2,30,1,1
54047,50011,0,0,deny,62,62,0,1,0,1,0
55064,80,48645,80,allow,1646,998,648,13,85,7,6
61420,64097,0,0,deny,66,66,0,1,0,1,0
52755,445,0,0,drop,66,66,0,1,0,1,0
63868,60392,13062,60392,allow,70,70,0,1,4,1,0
52001,12514,64945,12514,allow,70,70,0,2,7,2,0
36042,53,8305,53,allow,168,78,90,2,30,1,1
29025,53,29025,53,allow,235,90,145,2,31,1,1
58638,5900,58638,5900,allow,62,62,0,1,5,1,0
48527,7302,0,0,deny,146,146,0,1,0,1,0
64389,445,0,0,drop,70,70,0,1,0,1,0
59181,445,0,0,drop,70,70,0,1,0,1,0
55135,53,55135,53,allow,220,90,130,2,29,1,1
2885,443,2885,443,allow,28717,3437,25280,45,23,23,22
52548,445,0,0,drop,70,70,0,1,0,1,0
55166,53,19784,53,allow,177,94,83,2,30,1,1
58861,26467,0,0,deny,66,66,0,1,0,1,0
44847,37005,6154,37005,allow,150,150,0,1,1200,1,0
65516,443,35348,443,allow,451899,13130,438769,463,16,162,301
53605,13468,23024,13468,allow,70,70,0,2,7,2,0
56506,53,36137,53,allow,227,102,125,2,30,1,1
64052,38119,11965,38119,allow,312,132,180,6,6,3,3
30135,37965,0,0,deny,62,62,0,1,0,1,0
63341,445,0,0,drop,66,66,0,1,0,1,0
37965,52608,29898,52608,allow,1577,594,983,20,2766,10,10
64685,53,15480,53,allow,199,102,97,2,30,1,1
65501,26467,0,0,deny,66,66,0,1,0,1,0
58638,5900,0,0,deny,62,62,0,1,0,1,0
52144,49344,0,0,deny,62,62,0,1,0,1,0
49478,53,32475,53,allow,551,114,437,4,37,2,2
34500,23,0,0,deny,60,60,0,1,0,1,0
1536,48817,0,0,deny,62,62,0,1,0,1,0
63440,445,0,0,drop,66,66,0,1,0,1,0
63150,443,63150,443,allow,6792,1521,5271,18,28,11,7
63057,445,0,0,drop,66,66,0,1,0,1,0
49846,443,49846,443,allow,4693,1786,2907,19,27,11,8
51734,59825,40402,59825,allow,70,70,0,2,8,2,0
54148,443,30287,443,allow,272587,11910,260677,336,76,140,196
7286,44847,0,0,deny,66,66,0,1,0,1,0
58338,3369,0,0,deny,60,60,0,1,0,1,0
64602,53,19507,53,allow,184,94,90,2,30,1,1
63690,445,0,0,drop,70,70,0,1,0,1,0
59271,443,60275,443,allow,26414,4349,22065,41,149,17,24
50997,445,0,0,drop,70,70,0,1,0,1,0
64415,53,14789,53,allow,228,102,126,2,30,1,1
60762,445,0,0,drop,70,70,0,1,0,1,0
52690,7302,0,0,deny,66,66,0,1,0,1,0
49458,53,15275,53,allow,280,94,186,2,30,1,1
59938,443,3054,443,allow,70,70,0,1,5,1,0
41317,53,41317,53,allow,217,87,130,2,30,1,1
1080,8391,0,0,deny,66,66,0,1,0,1,0
64929,53,8681,53,allow,168,86,82,2,31,1,1
64171,53,42919,53,allow,211,102,109,2,29,1,1
57514,445,0,0,drop,70,70,0,1,0,1,0
33107,443,39338,443,allow,35031,3490,31541,60,363,28,32
57069,445,0,0,drop,70,70,0,1,0,1,0
50006,445,0,0,drop,70,70,0,1,0,1,0
53910,1024,45263,1024,allow,70,70,0,1,4,1,0
47168,15000,16770,15000,allow,130,70,60,2,5,1,1
57258,53,12137,53,allow,757,98,659,2,31,1,1
9195,80,8495,80,allow,2819,541,2278,12,31,6,6
59794,443,46382,443,allow,408,78,330,6,25,1,5
49477,443,62857,443,allow,8416,1247,7169,21,152,10,11
7595,80,7595,80,allow,34707,1796,32911,45,45,20,25
8999,1,0,0,deny,62,62,0,1,0,1,0
53340,445,0,0,drop,70,70,0,1,0,1,0
52531,445,0,0,drop,66,66,0,1,0,1,0
35685,443,31847,443,allow,2967,876,2091,11,120,5,6
53906,37965,0,0,deny,62,62,0,1,0,1,0
54040,445,0,0,drop,70,70,0,1,0,1,0
14924,44847,0,0,deny,66,66,0,1,0,1,0
25237,53,25237,53,allow,216,82,134,2,33,1,1
57837,443,41125,443,allow,17236,1691,15545,19,146,5,14
49853,445,0,0,drop,66,66,0,1,0,1,0
49679,80,26556,80,allow,7256,1682,5574,14,40,6,8
59937,18375,0,0,deny,62,62,0,1,0,1,0
49249,80,49249,80,allow,265842,14126,251716,311,22,136,175
63646,445,0,0,drop,70,70,0,1,0,1,0
53160,443,52369,443,allow,2738,1904,834,18,28,10,8
65107,53,32581,53,allow,266,110,156,2,30,1,1
54419,445,0,0,drop,70,70,0,1,0,1,0
62144,445,0,0,drop,70,70,0,1,0,1,0
46460,443,35545,443,allow,5117,3501,1616,29,80,15,14
4772,37965,0,0,deny,66,66,0,1,0,1,0
31500,34729,0,0,deny,146,146,0,1,0,1,0
63529,445,0,0,drop,70,70,0,1,0,1,0
65135,53,23354,53,allow,312,102,210,2,30,1,1
35106,53,20275,53,allow,271,102,169,2,30,1,1
55966,443,29704,443,allow,214312,69934,144378,612,671,303,309
63615,445,0,0,drop,66,66,0,1,0,1,0
64244,53,1570,53,allow,199,102,97,2,31,1,1
56630,80,55230,80,allow,234,234,0,4,12,4,0
60945,443,60945,443,allow,4680,1773,2907,19,29,11,8
27621,50584,0,0,deny,62,62,0,1,0,1,0
50641,80,49164,80,allow,1658,1247,411,8,15,5,3
52149,445,0,0,drop,66,66,0,1,0,1,0
50988,80,43692,80,allow,5956,1595,4361,17,19,10,7
42389,42873,0,0,deny,74,74,0,1,0,1,0
52714,64147,0,0,deny,66,66,0,1,0,1,0
47370,443,20985,443,allow,350,210,140,6,75,4,2
49622,445,0,0,drop,70,70,0,1,0,1,0
16570,25174,0,0,deny,62,62,0,1,0,1,0
53121,443,1605,443,allow,10893,7149,3744,31,45,18,13
62861,443,20935,443,allow,4777,2262,2515,10,122,5,5
56326,56205,0,0,deny,66,66,0,1,0,1,0
55479,53,40449,53,allow,184,94,90,2,31,1,1
63020,443,53282,443,allow,512,166,346,2,30,1,1
47013,37965,0,0,deny,62,62,0,1,0,1,0
60765,445,0,0,drop,66,66,0,1,0,1,0
56068,53,21388,53,allow,214,102,112,2,30,1,1
63182,445,0,0,drop,70,70,0,1,0,1,0
59931,80,27664,80,allow,1272,786,486,8,31,5,3
61721,445,0,0,drop,66,66,0,1,0,1,0
50981,443,28253,443,allow,8407,3736,4671,19,101,11,8
14692,443,14692,443,allow,95958,6670,89288,139,80,68,71
52323,443,4848,443,allow,454059,23387,430672,602,76,275,327
54413,445,0,0,drop,66,66,0,1,0,1,0
52884,443,37471,443,allow,4466,1914,2552,32,116,18,14
60130,443,10266,443,allow,16291,9102,7189,94,508,42,52
4788,53,4788,53,allow,825,99,726,2,0,1,1
56638,64147,0,0,deny,62,62,0,1,0,1,0
63593,22114,0,0,deny,66,66,0,1,0,1,0
14103,35440,0,0,deny,62,62,0,1,0,1,0
60115,445,0,0,drop,70,70,0,1,0,1,0
50997,443,46270,443,allow,3772,2099,1673,22,18,11,11
49327,443,21395,443,allow,116686,4968,111718,116,53,31,85
53500,1,0,0,deny,66,66,0,1,0,1,0
50738,445,0,0,drop,66,66,0,1,0,1,0
55167,443,39745,443,allow,12946,5235,7711,38,185,21,17
49764,53,50844,53,allow,199,102,97,2,30,1,1
9205,443,26795,443,allow,318,192,126,6,18,4,2
42632,44847,0,0,deny,146,146,0,1,0,1,0
60121,161,0,0,allow,8215,3237,4978,30,30,15,15
52274,443,52274,443,allow,6679,2408,4271,23,20,10,13
60276,80,60276,80,allow,671,313,358,7,75,4,3
57470,46772,63151,46772,allow,528,528,0,9,1201,9,0
12655,30627,0,0,deny,62,62,0,1,0,1,0
27186,53,27186,53,allow,821,97,724,2,30,1,1
60066,445,0,0,drop,70,70,0,1,0,1,0
62242,44512,0,0,deny,66,66,0,1,0,1,0
57839,445,0,0,drop,70,70,0,1,0,1,0
50561,445,0,0,drop,66,66,0,1,0,1,0
7977,25174,0,0,deny,62,62,0,1,0,1,0
26253,53,26253,53,allow,414,268,146,3,33,2,1
45690,60038,0,0,reset-both,62,62,0,1,0,1,0
57346,443,34868,443,allow,1547,960,587,14,22,8,6
56739,42421,49450,42421,allow,2810,1382,1428,12,31,6,6
11842,35440,0,0,deny,66,66,0,1,0,1,0
54788,445,0,0,drop,70,70,0,1,0,1,0
57843,445,0,0,drop,66,66,0,1,0,1,0
24560,25174,0,0,deny,146,146,0,1,0,1,0
62961,445,0,0,drop,70,70,0,1,0,1,0
60117,50934,0,0,deny,66,66,0,1,0,1,0
43880,80,10125,80,allow,2693,841,1852,13,16,8,5
57987,443,16754,443,allow,3264,1175,2089,14,120,7,7
54980,443,53564,443,allow,1541965,48559,1493406,1663,51,623,1040
51426,12447,0,0,deny,100,100,0,1,0,1,0
33525,443,32155,443,allow,8088,2191,5897,28,508,13,15
49780,53,9183,53,allow,183,94,89,2,31,1,1
49800,53,14799,53,allow,183,94,89,2,30,1,1
57500,37965,0,0,deny,62,62,0,1,0,1,0
65379,53,2143,53,allow,126,126,0,1,29,1,0
63977,54486,15705,54486,allow,66,66,0,1,5,1,0
6666,50070,0,0,deny,60,60,0,1,0,1,0
53762,443,60750,443,allow,499,425,74,4,0,3,1
64382,443,26649,443,allow,4017,978,3039,14,53,8,6
50265,18659,34655,18659,allow,481,150,331,2,1200,1,1
51405,80,23596,80,allow,1510,481,1029,11,20,6,5
57797,64147,0,0,deny,66,66,0,1,0,1,0
55741,445,0,0,drop,70,70,0,1,0,1,0
49914,443,10717,443,allow,10915,2554,8361,33,270,17,16
57836,445,0,0,drop,70,70,0,1,0,1,0
38725,80,37134,80,allow,130,70,60,2,15,1,1
61696,443,54803,443,allow,9097,2123,6974,25,16,15,10
58638,5900,58638,5900,allow,130,66,64,2,4,1,1
58246,445,0,0,drop,66,66,0,1,0,1,0
51726,64147,0,0,deny,66,66,0,1,0,1,0
49670,443,5760,443,allow,886,541,345,11,15,6,5
58638,5900,0,0,deny,62,62,0,1,0,1,0
57275,53,22434,53,allow,193,102,91,2,30,1,1
64929,445,0,0,drop,70,70,0,1,0,1,0
55155,53,35899,53,allow,194,102,92,2,31,1,1
50424,443,50613,443,allow,5713,1079,4634,15,26,8,7
49237,53,48024,53,allow,216,110,106,2,30,1,1
34348,22114,0,0,deny,146,146,0,1,0,1,0
63092,53,40692,53,allow,304,86,218,2,30,1,1
58741,445,0,0,drop,66,66,0,1,0,1,0
55075,53,54293,53,allow,181,94,87,2,33,1,1
55827,445,0,0,drop,70,70,0,1,0,1,0
50604,445,0,0,drop,70,70,0,1,0,1,0
64284,53,35627,53,allow,306,94,212,2,29,1,1
63877,53,63877,53,allow,247,98,149,2,32,1,1
65187,53,40747,53,allow,345,101,244,4,53,2,2
56676,53,9987,53,allow,178,94,84,2,30,1,1
56980,53,28670,53,allow,267,87,180,4,38,2,2
36641,25174,0,0,deny,66,66,0,1,0,1,0
52611,445,0,0,drop,70,70,0,1,0,1,0
50045,53,13478,53,allow,168,86,82,2,30,1,1
62920,993,31712,993,allow,7974,4175,3799,65,32,40,25
58638,5900,0,0,deny,62,62,0,1,0,1,0
32837,443,39597,443,allow,3167,1498,1669,19,315,10,9
55286,37965,0,0,deny,66,66,0,1,0,1,0
39487,80,41504,80,allow,1403,651,752,10,15,6,4
33774,443,40240,443,allow,9551,2173,7378,33,27,17,16
57396,53,17014,53,allow,212,102,110,2,30,1,1
64201,53,27931,53,allow,200,94,106,2,29,1,1
0,0,0,0,deny,98,98,0,1,0,1,0
56664,80,24275,80,allow,1056,682,374,10,15,6,4
65300,53,36602,53,allow,758,102,656,2,30,1,1
26900,27017,20527,27017,allow,422,164,258,6,30,3,3
17146,57470,0,0,deny,62,62,0,1,0,1,0
61736,50584,0,0,deny,66,66,0,1,0,1,0
50622,443,10440,443,allow,9215,1795,7420,32,140,16,16
56433,53,24075,53,allow,210,110,100,2,30,1,1
50720,445,0,0,drop,66,66,0,1,0,1,0
63325,445,0,0,drop,66,66,0,1,0,1,0
53377,445,0,0,drop,66,66,0,1,0,1,0
56725,443,7873,443,allow,6481,972,5509,17,52,10,7
50969,445,0,0,drop,70,70,0,1,0,1,0
48745,443,43215,443,allow,229628,10653,218975,263,49,103,160
63535,445,0,0,drop,70,70,0,1,0,1,0
50624,50584,0,0,deny,66,66,0,1,0,1,0
54973,53,61675,53,allow,711,87,624,2,30,1,1
55113,53,62810,53,allow,198,102,96,2,33,1,1
55320,53,54468,53,allow,304,94,210,2,30,1,1
52043,43578,45799,43578,allow,316,136,180,6,6,3,3
61461,443,61461,443,allow,19070,4830,14240,33,18,18,15
56410,53,65347,53,allow,757,98,659,2,30,1,1
55834,53,8445,53,allow,429,94,335,4,52,2,2
38484,48637,0,0,deny,60,60,0,1,0,1,0
54434,445,0,0,drop,70,70,0,1,0,1,0
52563,17235,0,0,deny,74,74,0,1,0,1,0
54846,445,0,0,drop,70,70,0,1,0,1,0
64631,53,29007,53,allow,193,102,91,2,29,1,1
52996,445,0,0,drop,70,70,0,1,0,1,0
65187,53,35953,53,allow,199,102,97,2,29,1,1
44125,53,44125,53,allow,209,79,130,2,30,1,1
49708,443,54037,443,allow,456387,11878,444509,427,81,121,306
49336,25174,0,0,deny,66,66,0,1,0,1,0
55630,43736,23766,43736,allow,70,70,0,2,8,2,0
63924,26328,57332,26328,allow,66,66,0,2,8,2,0
35001,53,37388,53,allow,78,78,0,1,30,1,0
60414,80,46472,80,allow,5124,3499,1625,14,121,8,6
56577,445,0,0,drop,70,70,0,1,0,1,0
49181,2710,52440,2710,allow,66,66,0,1,5,1,0
52000,10491,1794,10491,allow,70,70,0,1,5,1,0
51383,445,0,0,drop,70,70,0,1,0,1,0
63583,37965,0,0,deny,66,66,0,1,0,1,0
56495,53,8652,53,allow,199,102,97,2,30,1,1
9234,80,38036,80,allow,318,192,126,6,26,4,2
56589,53,53742,53,allow,711,87,624,2,30,1,1
18750,57866,0,0,deny,146,146,0,1,0,1,0
56673,53,10759,53,allow,193,102,91,2,30,1,1
60827,445,0,0,drop,70,70,0,1,0,1,0
53813,445,0,0,drop,66,66,0,1,0,1,0
26835,47993,0,0,deny,62,62,0,1,0,1,0
62575,12207,0,0,deny,66,66,0,1,0,1,0
64365,53,32131,53,allow,234,94,140,2,30,1,1
49869,445,0,0,drop,66,66,0,1,0,1,0
34731,22114,0,0,deny,146,146,0,1,0,1,0
55520,53,58665,53,allow,194,102,92,2,29,1,1
55893,45711,0,0,deny,78,78,0,1,0,1,0
64546,53,12738,53,allow,182,93,89,2,31,1,1
11295,40033,39520,40033,allow,213,89,124,4,49,2,2
60015,445,0,0,drop,70,70,0,1,0,1,0
1431,30041,0,0,deny,62,62,0,1,0,1,0
60384,53,44713,53,allow,234,96,138,2,31,1,1
49942,53,42485,53,allow,177,94,83,2,31,1,1
59837,80,33837,80,allow,830733,17622,813111,789,66,245,544
64344,53,14813,53,allow,568,192,376,6,71,3,3
64643,445,0,0,drop,70,70,0,1,0,1,0
52143,33283,63927,33283,allow,70,70,0,2,8,2,0
65159,37965,0,0,deny,74,74,0,1,0,1,0
49203,51050,0,0,deny,62,62,0,1,0,1,0
51779,49525,20031,49525,allow,70,70,0,1,5,1,0
12074,10197,0,0,deny,72,72,0,1,0,1,0
10126,57470,0,0,deny,62,62,0,1,0,1,0
55729,53,3509,53,allow,199,102,97,2,30,1,1
64737,53,22713,53,allow,285,94,191,2,31,1,1
50600,80,50600,80,allow,4262,3329,933,17,19,9,8
52212,51343,7428,51343,allow,70,70,0,1,5,1,0
50584,38578,41911,38578,allow,1377,300,1077,6,1200,3,3
44684,443,12133,443,allow,4728,3417,1311,23,35,12,11
51753,445,0,0,drop,66,66,0,1,0,1,0
52144,445,0,0,drop,70,70,0,1,0,1,0
61669,443,27122,443,allow,12453,3460,8993,43,18,24,19
49853,80,30133,80,allow,15055,6439,8616,26,89,14,12
56803,53,43368,53,allow,182,93,89,2,30,1,1
30783,51505,0,0,deny,62,62,0,1,0,1,0
51416,445,0,0,drop,70,70,0,1,0,1,0
45416,80,25189,80,allow,2713,753,1960,12,15,7,5
10477,44847,0,0,deny,66,66,0,1,0,1,0
56682,445,0,0,drop,70,70,0,1,0,1,0
49754,445,0,0,drop,70,70,0,1,0,1,0
55605,53,56113,53,allow,196,100,96,2,30,1,1
35667,80,40101,80,allow,1638,1324,314,10,15,5,5
49560,443,58104,443,allow,13516,6981,6535,61,2149,34,27
64941,53,51178,53,allow,216,94,122,2,30,1,1
58091,51505,0,0,deny,66,66,0,1,0,1,0
51689,53,28477,53,allow,198,86,112,2,29,1,1
56727,53,56099,53,allow,168,86,82,3,50,2,1
2946,25174,0,0,deny,62,62,0,1,0,1,0
56062,53,16578,53,allow,744,89,655,2,31,1,1
45410,1,0,0,deny,62,62,0,1,0,1,0
63952,53,42119,53,allow,358,105,253,4,44,2,2
55563,53,56094,53,allow,188,96,92,2,31,1,1
50721,445,0,0,drop,66,66,0,1,0,1,0
57711,445,0,0,drop,70,70,0,1,0,1,0
56326,53,54656,53,allow,170,87,83,2,30,1,1
4366,51505,0,0,deny,62,62,0,1,0,1,0
59745,53635,0,0,deny,66,66,0,1,0,1,0
57131,35776,0,0,deny,145,145,0,1,0,1,0
61474,443,20361,443,allow,114674,4457,110217,127,48,46,81
59055,11392,0,0,deny,62,62,0,1,0,1,0
57275,53,1884,53,allow,186,95,91,2,31,1,1
51963,22114,0,0,deny,62,62,0,1,0,1,0
56707,443,22633,443,allow,8005,1985,6020,20,15,11,9
35269,61903,0,0,deny,145,145,0,1,0,1,0
64742,443,6500,443,allow,6372,1582,4790,32,195,15,17
53545,443,54715,443,allow,7330,2295,5035,19,135,9,10
65239,443,50519,443,allow,5780,2572,3208,23,120,11,12
62069,443,28586,443,allow,38455,5252,33203,71,60,41,30
57308,443,32709,443,allow,8837,3033,5804,44,16,24,20
12531,22114,0,0,deny,146,146,0,1,0,1,0
62453,53,64784,53,allow,441,162,279,6,32,3,3
54469,80,59842,80,allow,1466,831,635,10,255,6,4
64877,53,58345,53,allow,182,93,89,2,30,1,1
57248,443,46396,443,allow,4113,1387,2726,15,36,8,7
57134,53,50387,53,allow,1425,97,1328,4,53,2,2
51911,445,0,0,drop,66,66,0,1,0,1,0
51146,23117,0,0,deny,66,66,0,1,0,1,0
37420,44847,0,0,deny,66,66,0,1,0,1,0
64798,53,2925,53,allow,172,88,84,2,30,1,1
50548,443,50022,443,allow,9277,2865,6412,31,200,18,13
37395,443,29125,443,allow,16590,1630,14960,33,199,15,18
57403,53,33479,53,allow,764,99,665,2,31,1,1
56675,80,35224,80,allow,156,156,0,3,8,3,0
62111,443,62044,443,allow,3262,256,3006,9,121,4,5
63957,80,57502,80,allow,314,192,122,6,15,4,2
50581,53,22242,53,allow,177,94,83,2,30,1,1
55525,53,5634,53,allow,214,110,104,2,30,1,1
60311,56205,0,0,deny,66,66,0,1,0,1,0
60885,445,0,0,drop,66,66,0,1,0,1,0
50631,23,0,0,deny,60,60,0,1,0,1,0
50582,80,50582,80,allow,6647,4891,1756,23,21,13,10
60852,445,0,0,drop,70,70,0,1,0,1,0
54726,30041,0,0,deny,62,62,0,1,0,1,0
52885,80,48034,80,allow,5688,2508,3180,36,118,19,17
50994,445,0,0,drop,66,66,0,1,0,1,0
62060,445,0,0,drop,70,70,0,1,0,1,0
56605,443,61768,443,allow,7863,1874,5989,20,15,11,9
60613,443,54092,443,allow,154465,11473,142992,244,212,101,143
56638,80,7412,80,allow,234,234,0,4,11,4,0
64869,443,59977,443,allow,6454,1227,5227,18,122,9,9
63594,445,0,0,drop,70,70,0,1,0,1,0
50668,443,5052,443,allow,2881,642,2239,13,135,6,7
50898,445,0,0,drop,70,70,0,1,0,1,0
57247,443,40506,443,allow,93673,74276,19397,194,67,111,83
22683,39210,0,0,deny,60,60,0,1,0,1,0
49433,53,38840,53,allow,167,86,81,2,30,1,1
50568,443,63503,443,allow,15702,3473,12229,50,70,23,27
36034,35440,0,0,deny,62,62,0,1,0,1,0
54206,445,0,0,drop,66,66,0,1,0,1,0
52515,445,0,0,drop,70,70,0,1,0,1,0
61767,25174,0,0,deny,62,62,0,1,0,1,0
60817,445,0,0,drop,70,70,0,1,0,1,0
64814,16386,26637,16386,allow,432,192,240,8,30,4,4
54575,11392,0,0,deny,66,66,0,1,0,1,0
54220,443,37468,443,allow,499,425,74,4,0,3,1
28378,56205,0,0,deny,146,146,0,1,0,1,0
56675,445,0,0,drop,70,70,0,1,0,1,0
50545,53,44269,53,allow,765,102,663,2,30,1,1
49361,53,49782,53,allow,166,86,80,2,30,1,1
12605,57470,0,0,deny,62,62,0,1,0,1,0
49911,80,3385,80,allow,1519,787,732,10,110,6,4
59413,51505,0,0,deny,66,66,0,1,0,1,0
44334,26467,0,0,deny,62,62,0,1,0,1,0
56917,53,47484,53,allow,188,96,92,2,31,1,1
45423,80,20264,80,allow,2259,1830,429,11,150,6,5
51144,445,0,0,drop,66,66,0,1,0,1,0
55370,445,0,0,drop,70,70,0,1,0,1,0
49418,27015,42209,27015,allow,234,71,163,2,31,1,1
41890,443,5361,443,allow,7014,1958,5056,31,18,19,12
60579,25174,0,0,deny,62,62,0,1,0,1,0
42071,443,52227,443,allow,9366,5830,3536,23,121,12,11
34129,19410,0,0,deny,60,60,0,1,0,1,0
60732,445,0,0,drop,70,70,0,1,0,1,0
25031,25174,0,0,deny,146,146,0,1,0,1,0
64551,53,2637,53,allow,354,94,260,2,30,1,1
36262,53,36262,53,allow,216,90,126,2,30,1,1
24965,53,24965,53,allow,247,98,149,2,32,1,1
56685,443,20018,443,allow,7855,1866,5989,20,15,11,9
57757,445,0,0,drop,70,70,0,1,0,1,0
54977,445,0,0,drop,70,70,0,1,0,1,0
60878,443,38028,443,allow,764899,31427,733472,883,60,368,515
63495,50584,0,0,deny,66,66,0,1,0,1,0
65048,53,7806,53,allow,194,102,92,2,30,1,1
55502,53,25311,53,allow,193,102,91,2,30,1,1
39098,51505,0,0,deny,146,146,0,1,0,1,0
56292,53,4815,53,allow,197,102,95,2,30,1,1
55840,53,36401,53,allow,199,94,105,2,30,1,1
49575,445,0,0,drop,70,70,0,1,0,1,0
53600,8999,29889,8999,allow,492,306,186,8,15,5,3
8191,51221,0,0,deny,62,62,0,1,0,1,0
62348,51221,0,0,deny,72,72,0,1,0,1,0
55560,53,1916,53,allow,164,84,80,2,31,1,1
53787,1,62839,1,allow,320,140,180,6,6,3,3
63691,80,13237,80,allow,314,192,122,6,15,4,2
27005,27017,14487,27017,allow,882,126,756,2,31,1,1
37638,443,24895,443,allow,8134,2717,5417,24,16,15,9
60280,445,0,0,drop,70,70,0,1,0,1,0
52827,25174,0,0,deny,62,62,0,1,0,1,0
42298,40039,50865,40039,allow,602,86,516,2,30,1,1
61489,443,63810,443,allow,4624,1191,3433,23,75,14,9
49984,53,11243,53,allow,373,88,285,4,58,2,2
58859,443,48012,443,allow,39518,2389,37129,54,179,21,33
47075,80,40568,80,allow,1614,1300,314,10,15,5,5
65291,445,0,0,drop,70,70,0,1,0,1,0
50006,53,55896,53,allow,378,94,284,2,30,1,1
49440,443,48823,443,allow,3721809,103604,3618205,3808,156,1281,2527
49498,53,4790,53,allow,245,102,143,2,30,1,1
16057,51050,0,0,deny,62,62,0,1,0,1,0
57040,53,51890,53,allow,236,94,142,2,30,1,1
51629,443,13664,443,allow,19743,2133,17610,32,187,11,21
52729,445,0,0,drop,66,66,0,1,0,1,0
59208,445,0,0,drop,66,66,0,1,0,1,0
51533,44847,0,0,deny,62,62,0,1,0,1,0
55467,445,0,0,drop,70,70,0,1,0,1,0
53797,14550,19741,14550,allow,320,140,180,6,5,3,3
54108,445,0,0,drop,70,70,0,1,0,1,0
58302,443,37691,443,allow,4611,3176,1435,26,30,15,11
52071,57491,38679,57491,allow,70,70,0,1,5,1,0
49418,27015,38539,27015,allow,249,78,171,2,30,1,1
49359,53,28261,53,allow,718,94,624,2,30,1,1
6881,12388,2664,12388,allow,216,118,98,2,1199,1,1
46351,53,46351,53,allow,262,106,156,2,31,1,1
48817,27294,48817,27294,allow,150,150,0,1,1200,1,0
52739,443,43890,443,allow,25048,2850,22198,45,26,23,22
65401,53,57745,53,allow,235,102,133,2,29,1,1
64986,53,27800,53,allow,180,94,86,2,30,1,1
65497,53,19517,53,allow,490,111,379,4,54,2,2
49200,445,0,0,drop,66,66,0,1,0,1,0
60591,53,64106,53,allow,78,78,0,1,29,1,0
57470,51413,19647,51413,allow,740725,699740,40985,1031,1411,616,415
64882,43890,0,0,deny,66,66,0,1,0,1,0
51293,445,0,0,drop,66,66,0,1,0,1,0
60895,445,0,0,drop,66,66,0,1,0,1,0
61792,443,46504,443,allow,12526,7202,5324,28,99,15,13
62934,445,0,0,drop,70,70,0,1,0,1,0
60439,47783,16622,47783,allow,70,70,0,2,8,2,0
58638,5900,0,0,deny,62,62,0,1,0,1,0
44774,22114,0,0,deny,62,62,0,1,0,1,0
50020,443,25948,443,allow,9175,2213,6962,37,121,19,18
40408,443,59569,443,allow,6058,1749,4309,22,201,13,9
22784,9571,0,0,deny,62,62,0,1,0,1,0
53972,59089,19075,59089,allow,70,70,0,1,4,1,0
65404,53,11597,53,allow,182,94,88,2,30,1,1
55542,53,10496,53,allow,177,94,83,2,29,1,1
1114,37965,0,0,deny,62,62,0,1,0,1,0
55489,53,44022,53,allow,185,102,83,2,30,1,1
63461,443,13278,443,allow,622,310,312,11,59,6,5
52593,445,0,0,drop,70,70,0,1,0,1,0
58638,5900,0,0,deny,62,62,0,1,0,1,0
51760,443,1508,443,allow,1569,1044,525,14,94,9,5
50554,443,37415,443,allow,7343,1707,5636,26,134,14,12
53901,44425,38536,44425,allow,1686,890,796,10,15,6,4
37563,443,52126,443,allow,499,425,74,4,0,3,1
55598,41565,26251,41565,allow,70,70,0,2,8,2,0
40701,5223,47765,5223,allow,5723,1105,4618,27,473,10,17
45461,25174,0,0,deny,62,62,0,1,0,1,0
56524,53,52908,53,allow,711,87,624,2,31,1,1
55907,53,49379,53,allow,184,94,90,2,30,1,1
59487,445,0,0,drop,66,66,0,1,0,1,0
59497,64097,0,0,deny,66,66,0,1,0,1,0
63488,22114,0,0,deny,62,62,0,1,0,1,0
58207,51505,0,0,deny,66,66,0,1,0,1,0
49350,80,17216,80,allow,2485,529,1956,12,17,6,6
54951,445,0,0,drop,70,70,0,1,0,1,0
41298,51050,0,0,deny,62,62,0,1,0,1,0
51221,62348,26234,62348,allow,132,132,0,3,1200,3,0
60471,19776,4815,19776,allow,70,70,0,1,5,1,0
53922,445,0,0,drop,70,70,0,1,0,1,0
35980,443,35980,443,allow,4398,1491,2907,19,26,11,8
27038,51505,0,0,deny,62,62,0,1,0,1,0
56068,53,7794,53,allow,152,78,74,2,30,1,1
49326,53,56607,53,allow,193,102,91,2,31,1,1
58857,443,61452,443,allow,674,130,544,11,129,3,8
52225,31985,22878,31985,allow,70,70,0,2,8,2,0
65283,53,11652,53,allow,333,102,231,2,29,1,1
64934,445,0,0,drop,66,66,0,1,0,1,0
64898,53,30399,53,allow,167,86,81,2,29,1,1
37646,443,54992,443,allow,11821,3643,8178,30,45,17,13
57279,445,0,0,drop,66,66,0,1,0,1,0
51314,445,0,0,drop,66,66,0,1,0,1,0
49341,53,42621,53,allow,198,101,97,2,30,1,1
50652,445,0,0,drop,70,70,0,1,0,1,0
55933,53,58575,53,allow,177,94,83,2,30,1,1
61631,443,61631,443,allow,4748,1841,2907,19,26,11,8
50474,445,0,0,drop,66,66,0,1,0,1,0
45566,443,9859,443,allow,570475,25559,544916,712,32,341,371
55986,26467,0,0,deny,62,62,0,1,0,1,0
64685,53,19809,53,allow,535,100,435,4,36,2,2
65384,443,21164,443,allow,8613,1465,7148,22,15,13,9
51074,80,51074,80,allow,168467,7348,161119,184,8,67,117
52059,47363,50172,47363,allow,70,70,0,2,8,2,0
27988,40012,43574,40012,allow,253,190,63,2,30,1,1
38334,53,4428,53,allow,168,78,90,2,31,1,1
53425,443,1934,443,allow,7208,2237,4971,26,32,16,10
27125,51221,0,0,deny,62,62,0,1,0,1,0
58550,21247,0,0,deny,66,66,0,1,0,1,0
65124,53,4615,53,allow,353,118,235,2,30,1,1
2791,7302,0,0,deny,62,62,0,1,0,1,0
53751,53,53289,53,allow,578,286,292,9,16,5,4
60000,80,0,0,deny,60,60,0,1,0,1,0
56994,445,0,0,drop,66,66,0,1,0,1,0
49242,22114,0,0,deny,62,62,0,1,0,1,0
60002,445,0,0,drop,66,66,0,1,0,1,0
50200,44847,0,0,deny,74,74,0,1,0,1,0
49780,53,34638,53,allow,183,94,89,2,29,1,1
32895,443,18670,443,allow,76969,3534,73435,97,34,40,57
65322,53,28599,53,allow,395,102,293,2,30,1,1
57346,445,0,0,drop,66,66,0,1,0,1,0
43105,443,31281,443,allow,3115,1849,1266,18,16,8,10
49498,443,53084,443,allow,4172,1018,3154,16,27,8,8
8949,53,8949,53,allow,832,106,726,2,30,1,1
23936,35440,0,0,deny,62,62,0,1,0,1,0
27005,27015,48748,27015,allow,894,126,768,2,30,1,1
11643,81,0,0,deny,60,60,0,1,0,1,0
56167,53,20756,53,allow,461,94,367,2,30,1,1
57553,443,21487,443,allow,7075,2575,4500,21,30,12,9
55940,53,33630,53,allow,742,88,654,2,30,1,1
60771,80,37890,80,allow,254,128,126,5,15,3,2
56400,53,1687,53,allow,196,102,94,2,30,1,1
54324,27016,3441,27016,allow,924,924,0,3,30,3,0
64247,445,0,0,drop,70,70,0,1,0,1,0
56025,445,0,0,drop,70,70,0,1,0,1,0
55102,53,40717,53,allow,190,97,93,2,30,1,1
21833,22114,0,0,deny,62,62,0,1,0,1,0
57990,445,0,0,drop,66,66,0,1,0,1,0
50077,443,29789,443,allow,8172,1833,6339,25,93,14,11
58151,443,48543,443,allow,6563,1656,4907,22,318,13,9
55677,53,59623,53,allow,177,94,83,2,30,1,1
53125,10693,11015,10693,allow,954,454,500,14,21,8,6
64751,443,49226,443,allow,507753,8795,498958,463,195,122,341
56491,56205,0,0,deny,146,146,0,1,0,1,0
58022,88,0,0,deny,60,60,0,1,0,1,0
34517,443,44047,443,allow,5996,1967,4029,17,99,10,7
63980,4804,25300,4804,allow,70,70,0,1,4,1,0
51771,19103,40132,19103,allow,70,70,0,2,8,2,0
61698,445,0,0,drop,70,70,0,1,0,1,0
51001,443,45191,443,allow,5841,1986,3855,19,18,11,8
53178,26467,0,0,deny,62,62,0,1,0,1,0
45766,35440,0,0,deny,62,62,0,1,0,1,0
45908,33330,0,0,deny,60,60,0,1,0,1,0
41840,50584,0,0,deny,66,66,0,1,0,1,0
61935,443,10080,443,allow,5214,2561,2653,14,136,7,7
60011,443,19677,443,allow,8413,3768,4645,25,143,12,13
64288,53,54415,53,allow,398,103,295,4,41,2,2
20706,37965,0,0,deny,62,62,0,1,0,1,0
64886,445,0,0,drop,70,70,0,1,0,1,0
53157,445,0,0,drop,70,70,0,1,0,1,0
58099,44847,0,0,deny,62,62,0,1,0,1,0
45964,2225,0,0,deny,60,60,0,1,0,1,0
63937,53,8865,53,allow,183,94,89,2,30,1,1
51952,443,19528,443,allow,11367,3820,7547,28,28,16,12
50265,13302,54682,13302,allow,2118,858,1260,28,1267,14,14
35954,443,60270,443,allow,6406,1614,4792,24,17,13,11
56778,445,0,0,drop,66,66,0,1,0,1,0
64323,53,38959,53,allow,190,97,93,2,31,1,1
53750,27352,15975,27352,allow,70,70,0,1,4,1,0
59789,445,0,0,drop,66,66,0,1,0,1,0
60141,62413,0,0,deny,66,66,0,1,0,1,0
50643,443,60929,443,allow,1512,844,668,16,64,9,7
52044,44847,0,0,deny,146,146,0,1,0,1,0
56170,53,19497,53,allow,198,102,96,2,30,1,1
40309,443,48693,443,allow,51588,40242,11346,107,418,53,54
54776,445,0,0,drop,66,66,0,1,0,1,0
54779,50584,0,0,deny,66,66,0,1,0,1,0
55539,57470,0,0,deny,66,66,0,1,0,1,0
38721,443,64394,443,allow,10216,3380,6836,26,120,12,14
57914,443,43452,443,allow,4322,2383,1939,29,124,17,12
30960,45755,44633,45755,allow,462,462,0,8,3631,8,0
56115,53,48441,53,allow,278,96,182,4,54,2,2
29263,50939,0,0,deny,148,148,0,1,0,1,0
50645,443,5664,443,allow,1514,852,662,16,86,9,7
57271,53,58158,53,allow,288,94,194,2,30,1,1
55926,80,55926,80,allow,450,246,204,8,29,5,3
58638,5900,0,0,deny,62,62,0,1,0,1,0
64554,445,0,0,drop,66,66,0,1,0,1,0
65366,53,60695,53,allow,198,101,97,2,31,1,1
61127,445,0,0,drop,70,70,0,1,0,1,0
58761,445,0,0,drop,70,70,0,1,0,1,0
62871,445,0,0,drop,66,66,0,1,0,1,0
55156,53,48355,53,allow,256,87,169,4,37,2,2
55478,53,54641,53,allow,177,94,83,2,30,1,1
58266,445,0,0,drop,70,70,0,1,0,1,0
37701,23,0,0,deny,60,60,0,1,0,1,0
49196,53,15790,53,allow,181,94,87,2,33,1,1
60629,445,0,0,drop,66,66,0,1,0,1,0
57340,53,2776,53,allow,216,110,106,2,30,1,1
55966,57866,0,0,deny,66,66,0,1,0,1,0
53736,37168,63835,37168,allow,70,70,0,1,4,1,0
49818,53,62354,53,allow,751,94,657,2,30,1,1
22683,39210,0,0,deny,60,60,0,1,0,1,0
65189,27015,1984,27015,allow,260,78,182,2,30,1,1
57436,53,11754,53,allow,728,102,626,2,29,1,1
10874,25174,0,0,deny,62,62,0,1,0,1,0
61510,80,61510,80,allow,17105,750,16355,21,15,7,14
58638,5900,0,0,deny,62,62,0,1,0,1,0
49333,25174,0,0,deny,146,146,0,1,0,1,0
50501,80,58618,80,allow,318,192,126,6,25,4,2
52358,30188,0,0,deny,66,66,0,1,0,1,0
62923,445,0,0,drop,66,66,0,1,0,1,0
38058,443,33797,443,allow,22970,12439,10531,61,98,32,29
64109,53,30318,53,allow,225,102,123,2,30,1,1
51494,445,0,0,drop,66,66,0,1,0,1,0
65180,53,28162,53,allow,199,102,97,2,30,1,1
51425,37450,0,0,deny,62,62,0,1,0,1,0
65221,53,62850,53,allow,199,102,97,2,30,1,1
53701,445,0,0,drop,70,70,0,1,0,1,0
51413,25864,0,0,deny,72,72,0,1,0,1,0
50901,26467,0,0,deny,66,66,0,1,0,1,0
54786,445,0,0,drop,70,70,0,1,0,1,0
54280,3385,0,0,deny,60,60,0,1,0,1,0
54196,11392,0,0,deny,66,66,0,1,0,1,0
39959,23117,0,0,deny,62,62,0,1,0,1,0
57473,445,0,0,drop,66,66,0,1,0,1,0
58085,57470,0,0,deny,66,66,0,1,0,1,0
55101,53,47277,53,allow,197,102,95,2,30,1,1
60594,445,0,0,drop,70,70,0,1,0,1,0
0,0,0,0,deny,98,98,0,1,0,1,0
53616,44166,57712,44166,allow,70,70,0,1,5,1,0
54488,443,26044,443,allow,4967,2482,2485,26,271,13,13
52010,23685,49442,23685,allow,316,136,180,6,5,3,3
59352,37965,0,0,deny,66,66,0,1,0,1,0
44903,80,37166,80,allow,918,461,457,9,16,6,3
443,50238,0,0,deny,331,331,0,1,0,1,0
5222,18733,0,0,deny,66,66,0,1,0,1,0
50692,80,35406,80,allow,57678,29714,27964,241,175,120,121
53925,61701,1063,61701,allow,70,70,0,1,4,1,0
59134,80,59134,80,allow,104133,2163,101970,103,15,32,71
56104,53,51847,53,allow,210,110,100,2,31,1,1
62913,993,11946,993,allow,9122,4055,5067,84,67,39,45
53664,13701,26986,13701,allow,70,70,0,1,4,1,0
53892,443,40316,443,allow,9312,4088,5224,23,76,13,10
65279,53,57423,53,allow,183,94,89,2,30,1,1
45964,2225,0,0,deny,60,60,0,1,0,1,0
53816,443,52923,443,allow,499,425,74,4,0,3,1
56542,53,32612,53,allow,183,94,89,2,31,1,1
57308,443,38390,443,allow,36373,15248,21125,172,123,69,103
39890,123,28941,123,allow,184,94,90,2,30,1,1
49785,53,47696,53,allow,211,110,101,2,30,1,1
1380,53,1380,53,allow,235,90,145,2,32,1,1
45941,23388,0,0,deny,60,60,0,1,0,1,0
61007,445,0,0,drop,70,70,0,1,0,1,0
36291,53,42350,53,allow,199,94,105,2,31,1,1
50625,445,0,0,drop,70,70,0,1,0,1,0
34170,53,0,0,allow,82,82,0,2,40,2,0
9444,443,26906,443,allow,7353,1570,5783,22,39,11,11
57200,53,48391,53,allow,711,87,624,2,30,1,1
65147,53,52735,53,allow,323,102,221,2,30,1,1
59605,443,24489,443,allow,4507,1525,2982,24,148,13,11
58638,5900,0,0,deny,62,62,0,1,0,1,0
45144,25174,0,0,deny,62,62,0,1,0,1,0
59400,22114,0,0,deny,66,66,0,1,0,1,0
32727,23,0,0,deny,60,60,0,1,0,1,0
42040,5228,16525,5228,allow,60,60,0,1,5,1,0
49350,80,49350,80,allow,450,246,204,8,142,5,3
9836,22114,0,0,deny,66,66,0,1,0,1,0
60441,5900,0,0,deny,60,60,0,1,0,1,0
62086,445,0,0,drop,66,66,0,1,0,1,0
56941,445,0,0,drop,70,70,0,1,0,1,0
52714,445,0,0,drop,70,70,0,1,0,1,0
49901,53,35015,53,allow,186,95,91,2,31,1,1
46491,50584,0,0,deny,66,66,0,1,0,1,0
64132,53,20663,53,allow,381,102,279,4,42,2,2
37148,53,21111,53,allow,164,78,86,2,30,1,1
51923,11542,38262,11542,allow,70,70,0,2,8,2,0
62071,22114,0,0,deny,62,62,0,1,0,1,0
51007,445,0,0,drop,70,70,0,1,0,1,0
49396,53,18429,53,allow,177,94,83,2,29,1,1
56889,53,27625,53,allow,206,105,101,2,31,1,1
55445,445,0,0,drop,66,66,0,1,0,1,0
60373,445,0,0,drop,70,70,0,1,0,1,0
15503,7750,61935,7750,allow,858,858,0,14,1200,14,0
56109,53,22951,53,allow,177,94,83,2,30,1,1
58638,5900,0,0,deny,62,62,0,1,0,1,0
45525,53,45525,53,allow,86,86,0,1,30,1,0
58842,443,11917,443,allow,8912,1537,7375,27,638,10,17
45964,3111,0,0,deny,60,60,0,1,0,1,0
47040,25174,0,0,deny,62,62,0,1,0,1,0
58414,445,0,0,drop,70,70,0,1,0,1,0
46865,443,9898,443,allow,416,210,206,7,32,4,3
63307,445,0,0,drop,70,70,0,1,0,1,0
59031,25174,0,0,deny,62,62,0,1,0,1,0
39852,53,51714,53,allow,223,78,145,2,30,1,1
52918,445,0,0,drop,70,70,0,1,0,1,0
58021,22114,0,0,deny,66,66,0,1,0,1,0
56247,53,6224,53,allow,215,102,113,2,30,1,1
52829,80,23872,80,allow,2078,726,1352,10,15,5,5
61128,80,61128,80,allow,1382,855,527,11,20,6,5
55147,53,40257,53,allow,776,102,674,2,30,1,1
59527,445,0,0,drop,66,66,0,1,0,1,0
1227,56205,0,0,deny,66,66,0,1,0,1,0
62831,445,0,0,drop,70,70,0,1,0,1,0
37651,443,4131,443,allow,4162,3001,1161,20,25,12,8
55942,53,36132,53,allow,197,102,95,2,30,1,1
49478,443,45550,443,allow,4241,1161,3080,17,152,9,8
64997,53,31899,53,allow,166,86,80,2,30,1,1
60865,443,14969,443,allow,9934,4897,5037,43,15,25,18
53841,8999,55229,8999,allow,70,70,0,2,8,2,0
49584,445,0,0,drop,66,66,0,1,0,1,0
39036,443,62520,443,allow,1768,541,1227,11,20,7,4
58858,445,0,0,drop,70,70,0,1,0,1,0
55427,53,22421,53,allow,200,102,98,2,33,1,1
64628,53,57301,53,allow,198,101,97,2,31,1,1
41474,443,44338,443,allow,190,70,120,4,15,2,2
60224,445,0,0,drop,66,66,0,1,0,1,0
64041,53,42434,53,allow,198,94,104,2,30,1,1
53719,443,17807,443,allow,499,425,74,4,0,3,1
23873,30188,0,0,deny,66,66,0,1,0,1,0
41664,53,40771,53,allow,376,78,298,2,30,1,1
49583,445,0,0,drop,66,66,0,1,0,1,0
3830,26467,0,0,deny,66,66,0,1,0,1,0
49365,443,7020,443,allow,442336,371266,71070,1143,762,651,492
50651,445,0,0,drop,70,70,0,1,0,1,0
57325,37965,0,0,deny,62,62,0,1,0,1,0
52075,37919,58563,37919,allow,70,70,0,2,8,2,0
57470,44919,55339,44919,allow,166,166,0,1,1199,1,0
51859,7700,19893,7700,allow,8425,6015,2410,73,34,37,36
49023,5223,46497,5223,allow,70,70,0,2,5,2,0
65393,443,57467,443,allow,5121,936,4185,17,27,9,8
55727,53,51328,53,allow,190,97,93,2,30,1,1
55889,53,7647,53,allow,199,102,97,2,30,1,1
56663,443,26937,443,allow,1299,730,569,13,25,7,6
47058,443,44896,443,allow,328838,76878,251960,449,243,185,264
52185,13269,32926,13269,allow,70,70,0,2,7,2,0
55105,445,0,0,drop,66,66,0,1,0,1,0
65498,443,58734,443,allow,3874,1587,2287,17,143,9,8
64804,445,0,0,drop,70,70,0,1,0,1,0
49397,53,53029,53,allow,373,98,275,4,43,2,2
50490,80,51282,80,allow,318,192,126,6,25,4,2
64742,53,7062,53,allow,338,110,228,2,30,1,1
26900,443,4352,443,allow,24703,16382,8321,49,21,28,21
54204,443,58891,443,allow,499,425,74,4,0,3,1
443,10010,0,0,deny,60,60,0,1,0,1,0
18357,51180,0,0,deny,62,62,0,1,0,1,0
56740,53,17032,53,allow,716,95,621,2,30,1,1
58207,51505,0,0,deny,66,66,0,1,0,1,0
20804,64147,0,0,deny,145,145,0,1,0,1,0
56349,53,42172,53,allow,216,110,106,2,29,1,1
64775,443,64775,443,allow,4559,1652,2907,19,27,11,8
48706,23393,0,0,deny,60,60,0,1,0,1,0
35754,80,35754,80,allow,141193,10612,130581,165,30,69,96
5222,21212,0,0,deny,66,66,0,1,0,1,0
60075,41705,0,0,deny,66,66,0,1,0,1,0
51039,445,0,0,drop,70,70,0,1,0,1,0
53566,80,56289,80,allow,2270749,47314,2223435,2132,99,651,1481
8884,2323,0,0,deny,60,60,0,1,0,1,0
33257,443,43255,443,allow,19341,4612,14729,38,21,19,19
58638,5900,0,0,deny,62,62,0,1,0,1,0
61706,64147,0,0,deny,62,62,0,1,0,1,0
50023,53,26218,53,allow,166,86,80,2,31,1,1
51263,443,57364,443,allow,162,102,60,2,5,1,1
52641,445,0,0,drop,70,70,0,1,0,1,0
50828,23,0,0,deny,60,60,0,1,0,1,0
38851,443,9016,443,allow,5993,2348,3645,15,120,8,7
59874,22114,0,0,deny,146,146,0,1,0,1,0
56765,53,13979,53,allow,188,96,92,2,31,1,1
49579,80,10648,80,allow,277736,7810,269926,277,65,91,186
42298,40010,41895,40010,allow,1082,86,996,2,31,1,1
59936,443,30573,443,allow,10879,3057,7822,38,32,21,17
55620,53,14188,53,allow,170,87,83,2,30,1,1
50392,443,55310,443,allow,1125,595,530,12,29,6,6
55542,53,62446,53,allow,177,94,83,2,30,1,1
61432,443,52750,443,allow,2959,1819,1140,19,86,10,9
60093,443,46965,443,allow,2090,1218,872,15,140,8,7
63339,445,0,0,drop,66,66,0,1,0,1,0
6843,42873,0,0,deny,62,62,0,1,0,1,0
50688,5222,17560,5222,allow,622,284,338,10,29,5,5
56581,445,0,0,drop,66,66,0,1,0,1,0
50823,443,51509,443,allow,6601,1120,5481,17,115,9,8
56313,53,7170,53,allow,198,102,96,2,29,1,1
54883,60043,0,0,deny,62,62,0,1,0,1,0
6666,5000,0,0,deny,60,60,0,1,0,1,0
30960,45741,31412,45741,allow,330,330,0,6,3609,6,0
51996,35440,0,0,deny,66,66,0,1,0,1,0
56447,53,59083,53,allow,758,96,662,2,31,1,1
3047,50584,0,0,deny,62,62,0,1,0,1,0
56573,443,64654,443,allow,16205,6113,10092,36,110,20,16
40078,44847,0,0,deny,62,62,0,1,0,1,0
53465,80,64691,80,allow,1360,540,820,20,187,10,10
65332,53,55664,53,allow,94,94,0,1,30,1,0
55245,53,61157,53,allow,209,110,99,2,29,1,1
50725,445,0,0,drop,70,70,0,1,0,1,0
58638,5900,0,0,deny,62,62,0,1,0,1,0
55220,53,22108,53,allow,193,102,91,2,30,1,1
1114,37965,0,0,deny,62,62,0,1,0,1,0
42895,443,18411,443,allow,600,156,444,8,25,2,6
44176,443,60900,443,allow,3327,1940,1387,19,22,10,9
37427,443,40807,443,allow,26069,12062,14007,46,123,21,25
44242,5228,42163,5228,allow,10823,1636,9187,32,591,11,21
55487,445,0,0,drop,70,70,0,1,0,1,0
56321,445,0,0,drop,66,66,0,1,0,1,0
50394,445,0,0,drop,70,70,0,1,0,1,0
54280,3396,54280,3396,allow,60,60,0,1,5,1,0
62043,25174,0,0,deny,62,62,0,1,0,1,0
56840,445,0,0,drop,66,66,0,1,0,1,0
56674,443,44964,443,allow,237,177,60,3,5,2,1
56115,53,18486,53,allow,167,86,81,2,30,1,1
49276,51505,0,0,deny,66,66,0,1,0,1,0
9455,443,43647,443,allow,6096,777,5319,17,25,9,8
35601,443,47260,443,allow,6419,995,5424,21,360,11,10
58869,57470,0,0,deny,145,145,0,1,0,1,0
55618,56205,0,0,deny,66,66,0,1,0,1,0
64833,53,14951,53,allow,166,85,81,2,31,1,1
60137,443,42633,443,allow,10407,3966,6441,30,149,18,12
56834,46513,28288,46513,allow,70,70,0,1,5,1,0
57360,53,29113,53,allow,231,110,121,2,30,1,1
41756,56205,0,0,deny,62,62,0,1,0,1,0
1404,51180,0,0,deny,145,145,0,1,0,1,0
55617,53,59978,53,allow,194,102,92,2,30,1,1
55396,443,55396,443,allow,63319,6716,56603,91,19,45,46
49492,53,41002,53,allow,199,102,97,2,31,1,1
65470,53,21136,53,allow,226,94,132,2,30,1,1
32742,53,46400,53,allow,207,86,121,2,30,1,1
63633,445,0,0,drop,70,70,0,1,0,1,0
12700,57470,0,0,deny,145,145,0,1,0,1,0
6712,44818,0,0,deny,66,66,0,1,0,1,0
58922,57470,0,0,deny,66,66,0,1,0,1,0
57263,53,19540,53,allow,167,86,81,2,30,1,1
61912,17546,0,0,deny,62,62,0,1,0,1,0
41950,53,0,0,allow,86,86,0,1,30,1,0
42237,36237,0,0,deny,66,66,0,1,0,1,0
6712,123,0,0,deny,90,90,0,1,0,1,0
55672,45682,1314,45682,allow,70,70,0,1,5,1,0
17760,50584,0,0,deny,62,62,0,1,0,1,0
49593,5228,25502,5228,allow,9720,2717,7003,67,1019,34,33
57225,53,63764,53,allow,177,94,83,2,30,1,1
53758,443,30147,443,allow,499,425,74,4,0,3,1
51622,53,52520,53,allow,260,86,174,2,30,1,1
57355,443,46923,443,allow,36265,3519,32746,55,46,27,28
33099,443,5841,443,allow,11110,1700,9410,33,750,11,22
62914,993,49276,993,allow,9285,4057,5228,80,45,39,41
60063,445,0,0,drop,70,70,0,1,0,1,0
49507,53,65329,53,allow,177,94,83,2,30,1,1
49315,53,15991,53,allow,94,94,0,1,30,1,0
57387,70,0,0,deny,60,60,0,1,0,1,0
52439,445,0,0,drop,70,70,0,1,0,1,0
57846,57866,0,0,deny,66,66,0,1,0,1,0
53517,445,0,0,drop,66,66,0,1,0,1,0
53961,13067,4497,13067,allow,70,70,0,1,5,1,0
51995,443,36323,443,allow,9966,5049,4917,41,15,25,16
65016,37965,0,0,deny,66,66,0,1,0,1,0
50573,445,0,0,drop,70,70,0,1,0,1,0
49229,8112,22492,8112,allow,2049,1276,773,15,15,8,7
59717,443,16330,443,allow,303966,26201,277765,521,167,208,313
5223,44091,0,0,deny,66,66,0,1,0,1,0
51718,445,0,0,drop,70,70,0,1,0,1,0
57698,64147,0,0,deny,66,66,0,1,0,1,0
7889,48817,0,0,deny,146,146,0,1,0,1,0
56832,23900,53161,23900,allow,130,70,60,2,5,1,1
52807,443,39495,443,allow,67984,17257,50727,121,148,50,71
55602,22005,13936,22005,allow,504,318,186,8,15,5,3
30583,25174,0,0,deny,62,62,0,1,0,1,0
57607,21247,0,0,deny,66,66,0,1,0,1,0
59848,443,53182,443,allow,2431,1164,1267,27,46,11,16
57195,53,17608,53,allow,195,102,93,2,30,1,1
39742,80,38417,80,allow,1569,593,976,10,44,6,4
9514,443,6699,443,allow,318,192,126,6,34,4,2
56219,22114,0,0,deny,62,62,0,1,0,1,0
57224,445,0,0,drop,66,66,0,1,0,1,0
25412,23,0,0,deny,60,60,0,1,0,1,0
52101,64162,42746,64162,allow,1200,576,624,8,31,4,4
51880,8000,3169,8000,allow,172,94,78,2,29,1,1
57589,53,7858,53,allow,165,78,87,2,30,1,1
26879,37965,0,0,deny,62,62,0,1,0,1,0
49508,443,20014,443,allow,13719,5017,8702,40,283,20,20
27005,27016,43090,27016,allow,878,126,752,2,30,1,1
55461,443,1970,443,allow,6314,4856,1458,18,120,11,7
48478,49903,0,0,deny,62,62,0,1,0,1,0
33967,5222,10318,5222,allow,74654,9673,64981,221,616,106,115
56643,53,22354,53,allow,190,97,93,2,31,1,1
36908,26467,0,0,deny,62,62,0,1,0,1,0
50577,53,42323,53,allow,819,102,717,2,30,1,1
49861,53,27236,53,allow,198,102,96,2,31,1,1
54955,53,60657,53,allow,177,94,83,2,31,1,1
5588,5588,0,0,allow,3562,1936,1626,48,193,24,24
56281,53,38618,53,allow,177,94,83,2,31,1,1
55840,53,55617,53,allow,177,94,83,2,30,1,1
55786,53,23026,53,allow,177,94,83,2,30,1,1
20147,53,20147,53,allow,219,87,132,2,30,1,1
22346,51505,0,0,deny,62,62,0,1,0,1,0
55254,50584,0,0,deny,66,66,0,1,0,1,0
62349,443,37822,443,allow,3942042,47512,3894530,3167,53,526,2641
50584,6881,63450,6881,allow,1320,300,1020,6,1200,3,3
52461,445,0,0,drop,70,70,0,1,0,1,0
54022,445,0,0,drop,70,70,0,1,0,1,0
53746,36237,0,0,deny,66,66,0,1,0,1,0
51238,445,0,0,drop,70,70,0,1,0,1,0
9145,80,20559,80,allow,318,192,126,6,30,4,2
43735,53,12080,53,allow,168,78,90,2,30,1,1
57253,53,25140,53,allow,199,102,97,2,29,1,1
49289,443,60908,443,allow,3890599,46254,3844345,3173,116,609,2564
50493,15503,0,0,deny,146,146,0,1,0,1,0
56289,25174,0,0,deny,66,66,0,1,0,1,0
61523,37807,0,0,deny,66,66,0,1,0,1,0
52092,443,18467,443,allow,13078,7055,6023,114,162,59,55
49534,53,49440,53,allow,168,86,82,2,30,1,1
37387,443,27821,443,allow,64440,16508,47932,101,142,44,57
51705,59244,12307,59244,allow,66,66,0,1,5,1,0
59018,22114,0,0,deny,146,146,0,1,0,1,0
52838,37965,0,0,deny,66,66,0,1,0,1,0
58849,64147,0,0,deny,62,62,0,1,0,1,0
65245,53,59048,53,allow,193,102,91,2,30,1,1
58091,445,0,0,drop,70,70,0,1,0,1,0
64236,53,6587,53,allow,211,102,109,2,30,1,1
59785,14914,0,0,deny,143,143,0,1,0,1,0
64693,26467,0,0,deny,62,62,0,1,0,1,0
55702,53,21809,53,allow,761,100,661,2,31,1,1
24311,22617,0,0,deny,60,60,0,1,0,1,0
60135,445,0,0,drop,70,70,0,1,0,1,0
43461,35440,0,0,deny,62,62,0,1,0,1,0
57767,445,0,0,drop,70,70,0,1,0,1,0
49931,53,22854,53,allow,594,196,398,6,82,3,3
61387,43890,0,0,deny,62,62,0,1,0,1,0
65513,53,51212,53,allow,216,102,114,2,30,1,1
48634,443,39947,443,allow,448,78,370,6,25,1,5
45726,443,40256,443,allow,130,70,60,3,6,2,1
62562,445,0,0,drop,70,70,0,1,0,1,0
51391,445,0,0,drop,70,70,0,1,0,1,0
50336,443,6025,443,allow,8814,1579,7235,24,41,12,12
62618,443,27342,443,allow,6939,2970,3969,19,144,9,10
64030,24096,24415,24096,allow,442,320,122,7,17,5,2
64825,53,5593,53,allow,728,96,632,2,31,1,1
63768,55755,28718,55755,allow,66,66,0,2,7,2,0
60681,443,60681,443,allow,5667,1393,4274,19,16,9,10
64104,53,1753,53,allow,855,311,544,8,79,4,4
64991,445,0,0,drop,66,66,0,1,0,1,0
54826,443,54826,443,allow,158092,23051,135041,216,21,110,106
56521,443,40583,443,allow,11375,1770,9605,27,55,15,12
53021,445,0,0,drop,70,70,0,1,0,1,0
6881,26296,0,0,deny,146,146,0,1,0,1,0
55408,64147,0,0,deny,66,66,0,1,0,1,0
61255,445,0,0,drop,70,70,0,1,0,1,0
50584,6881,19659,6881,allow,161,161,0,2,1200,2,0
62236,443,62236,443,allow,28126,3114,25012,50,77,22,28
55320,445,0,0,drop,70,70,0,1,0,1,0
57987,445,0,0,drop,66,66,0,1,0,1,0
56100,53,41303,53,allow,177,94,83,2,30,1,1
49781,53,31272,53,allow,194,102,92,2,29,1,1
6712,44818,0,0,deny,66,66,0,1,0,1,0
56543,443,33644,443,allow,8659,1687,6972,30,55,16,14
49663,53,27941,53,allow,168,86,82,2,31,1,1
55159,53,57486,53,allow,168,86,82,2,30,1,1
6881,6881,0,0,deny,146,146,0,1,0,1,0
50607,443,39884,443,allow,25263,2606,22657,41,90,19,22
64815,37965,0,0,deny,62,62,0,1,0,1,0
15499,22114,0,0,deny,62,62,0,1,0,1,0
50994,35974,0,0,deny,60,60,0,1,0,1,0
53894,445,0,0,drop,70,70,0,1,0,1,0
57409,53,7230,53,allow,168,86,82,2,30,1,1
58835,443,42835,443,allow,5166,700,4466,16,15,7,9
51145,80,27456,80,allow,78198970,2041652,76157318,79332,368,28698,50634
45964,3111,0,0,deny,60,60,0,1,0,1,0
42971,3478,49754,3478,allow,312,140,172,4,29,2,2
50280,57470,0,0,deny,78,78,0,1,0,1,0
49866,53,19774,53,allow,225,110,115,2,30,1,1
55650,53,47564,53,allow,174,89,85,2,30,1,1
52693,445,0,0,drop,70,70,0,1,0,1,0
55211,445,0,0,drop,70,70,0,1,0,1,0
61803,445,0,0,drop,70,70,0,1,0,1,0
64053,53,32861,53,allow,276,94,182,4,54,2,2
64059,445,0,0,drop,70,70,0,1,0,1,0
28020,443,11039,443,allow,5576,1388,4188,19,15,9,10
65025,57866,0,0,deny,66,66,0,1,0,1,0
57176,445,0,0,drop,66,66,0,1,0,1,0
50658,445,0,0,drop,70,70,0,1,0,1,0
64323,53,18965,53,allow,195,102,93,2,30,1,1
49836,53,59050,53,allow,327,102,225,2,30,1,1
56743,53,16205,53,allow,202,103,99,2,30,1,1
49766,445,0,0,drop,70,70,0,1,0,1,0
56526,80,57143,80,allow,1056,682,374,10,15,6,4
54973,53,20292,53,allow,181,94,87,2,30,1,1
64940,53,17775,53,allow,758,102,656,2,30,1,1
50822,50584,0,0,deny,66,66,0,1,0,1,0
58074,445,0,0,drop,70,70,0,1,0,1,0
50168,53,56159,53,allow,211,78,133,2,30,1,1
51972,5222,10197,5222,allow,5410,2343,3067,42,53,24,18
53761,445,0,0,drop,70,70,0,1,0,1,0
10151,53,10151,53,allow,220,90,130,2,30,1,1
45908,3383,0,0,deny,60,60,0,1,0,1,0
55060,53,22947,53,allow,195,102,93,2,30,1,1
2939,53,2939,53,allow,200,90,110,2,30,1,1
50442,80,50442,80,allow,52791,4087,48704,66,24,26,40
10169,80,10169,80,allow,450,246,204,8,24,5,3
56004,53,42302,53,allow,172,88,84,2,30,1,1
50710,443,45536,443,allow,1786,172,1614,7,120,3,4
63530,3389,63530,3389,allow,3489,1534,1955,17,19,9,8
52934,445,0,0,drop,70,70,0,1,0,1,0
48632,443,58774,443,allow,12433,4515,7918,32,136,17,15
56739,445,0,0,drop,70,70,0,1,0,1,0
36717,51505,0,0,deny,146,146,0,1,0,1,0
53742,63344,47218,63344,allow,1294,797,497,13,15,7,6
38433,443,38484,443,allow,33344,25806,7538,105,130,56,49
57312,53,15136,53,allow,212,110,102,2,29,1,1
56998,53,31320,53,allow,177,94,83,2,30,1,1
46488,443,7780,443,allow,87129,6924,80205,126,258,49,77
42089,53,62601,53,allow,199,94,105,2,29,1,1
61280,445,0,0,drop,66,66,0,1,0,1,0
59059,80,0,0,deny,62,62,0,1,0,1,0
53574,443,38690,443,allow,117116,5692,111424,153,18,56,97
59690,445,0,0,drop,66,66,0,1,0,1,0
37343,21247,0,0,deny,62,62,0,1,0,1,0
8283,52443,24980,52443,allow,70,70,0,1,30,1,0
26528,51221,0,0,deny,78,78,0,1,0,1,0
56393,53,59869,53,allow,197,94,103,2,30,1,1
21082,53,21082,53,allow,226,90,136,2,30,1,1
36992,25174,0,0,deny,62,62,0,1,0,1,0
59497,64097,0,0,deny,66,66,0,1,0,1,0
51162,445,0,0,drop,70,70,0,1,0,1,0
64780,53,37698,53,allow,627,224,403,6,56,3,3
59325,445,0,0,drop,66,66,0,1,0,1,0
63773,443,33011,443,allow,9693,2010,7683,18,130,9,9
61974,445,0,0,drop,66,66,0,1,0,1,0
55004,445,0,0,drop,70,70,0,1,0,1,0
64748,53,3750,53,allow,168,94,74,2,29,1,1
53912,443,42597,443,allow,499,425,74,4,0,3,1
64928,53,11072,53,allow,762,98,664,2,30,1,1
50865,443,45042,443,allow,6883,1378,5505,19,131,9,10
49418,27018,61835,27018,allow,248,71,177,2,30,1,1
49843,445,0,0,drop,66,66,0,1,0,1,0
51779,49525,24742,49525,allow,70,70,0,2,8,2,0
49851,80,9497,80,allow,11936,2198,9738,22,88,9,13
24606,55783,0,0,deny,72,72,0,1,0,1,0
60132,50584,0,0,deny,66,66,0,1,0,1,0
37988,49152,27635,49152,allow,156,156,0,3,7,3,0
19747,37965,0,0,deny,62,62,0,1,0,1,0
40301,8696,0,0,deny,60,60,0,1,0,1,0
65491,53,7417,53,allow,193,102,91,2,30,1,1
64914,53,32177,53,allow,168,86,82,2,31,1,1
51689,443,47234,443,allow,8488,2174,6314,23,255,12,11
58779,445,0,0,drop,70,70,0,1,0,1,0
51717,63436,12791,63436,allow,70,70,0,2,8,2,0
65114,53,35237,53,allow,192,98,94,2,30,1,1
58638,5900,0,0,deny,62,62,0,1,0,1,0
63208,30975,0,0,deny,148,148,0,1,0,1,0
50889,445,0,0,drop,70,70,0,1,0,1,0
52218,445,0,0,drop,70,70,0,1,0,1,0
53850,445,0,0,drop,70,70,0,1,0,1,0
47088,15000,21651,15000,allow,138,78,60,2,6,1,1
54418,22114,0,0,deny,66,66,0,1,0,1,0
53782,443,62733,443,allow,499,425,74,4,0,3,1
65134,53,31124,53,allow,229,110,119,2,30,1,1
19394,44847,0,0,deny,62,62,0,1,0,1,0
53817,59216,40309,59216,allow,164,70,94,2,5,1,1
57902,443,7313,443,allow,1912,1213,699,19,169,11,8
49418,27017,46358,27017,allow,252,71,181,2,30,1,1
14023,37965,0,0,deny,62,62,0,1,0,1,0
64170,53,8544,53,allow,355,118,237,2,30,1,1
50882,445,0,0,drop,66,66,0,1,0,1,0
52167,61948,3341,61948,allow,70,70,0,1,5,1,0
33502,5529,0,0,deny,143,143,0,1,0,1,0
60472,20273,1767,20273,allow,70,70,0,2,8,2,0
56435,53,33982,53,allow,193,102,91,2,30,1,1
48144,21247,0,0,deny,66,66,0,1,0,1,0
64976,53,35202,53,allow,229,102,127,2,30,1,1
56676,37965,0,0,deny,66,66,0,1,0,1,0
51404,443,29692,443,allow,9076,2650,6426,35,247,15,20
50914,51505,0,0,deny,66,66,0,1,0,1,0
51414,445,0,0,drop,70,70,0,1,0,1,0
55624,53,27462,53,allow,701,88,613,2,30,1,1
51171,443,60392,443,allow,1532,965,567,14,20,7,7
65300,53,17594,53,allow,329,88,241,4,50,2,2
43584,24748,0,0,deny,156,156,0,1,0,1,0
15503,55878,37795,55878,allow,481,150,331,2,1200,1,1
39920,443,36288,443,allow,4552,1255,3297,27,183,12,15
55735,53,42351,53,allow,199,102,97,2,30,1,1
64085,445,0,0,drop,66,66,0,1,0,1,0
53598,40326,59380,40326,allow,70,70,0,1,4,1,0
63963,53,46328,53,allow,262,86,176,4,46,2,2
33886,39127,0,0,deny,162,162,0,1,0,1,0
65496,57470,0,0,deny,146,146,0,1,0,1,0
49441,443,28685,443,allow,2921276,89544,2831732,3090,63,1086,2004
50706,445,0,0,drop,70,70,0,1,0,1,0
20826,53,20826,53,allow,228,90,138,2,32,1,1
45663,53,45663,53,allow,507,129,378,2,30,1,1
48273,15000,43622,15000,allow,130,70,60,2,5,1,1
64520,445,0,0,drop,70,70,0,1,0,1,0
39402,443,48958,443,allow,6417,1255,5162,24,360,12,12
57917,6789,34924,6789,allow,8164,1336,6828,34,18,18,16
50230,445,0,0,drop,66,66,0,1,0,1,0
51549,445,0,0,drop,70,70,0,1,0,1,0
49552,53,39720,53,allow,102,102,0,1,30,1,0
53964,443,36020,443,allow,374,254,120,4,5,2,2
41677,443,61867,443,allow,7292,1489,5803,21,187,11,10
55962,53,7744,53,allow,193,102,91,2,30,1,1
48952,443,47489,443,allow,15944,6988,8956,135,324,72,63
60049,443,35659,443,allow,10124,2145,7979,24,156,11,13
56481,443,31113,443,allow,1853,1214,639,18,134,11,7
52280,44847,0,0,deny,62,62,0,1,0,1,0
65389,26467,0,0,deny,62,62,0,1,0,1,0
53587,3389,53587,3389,allow,3504,1790,1714,17,31,9,8
49840,53,47224,53,allow,463,87,376,4,38,2,2
49948,53,46968,53,allow,177,94,83,2,30,1,1
58959,445,0,0,drop,70,70,0,1,0,1,0
54987,53,61181,53,allow,215,102,113,2,30,1,1
64048,53,15990,53,allow,209,110,99,2,30,1,1
32317,53,32317,53,allow,823,98,725,2,30,1,1
49831,30188,0,0,deny,66,66,0,1,0,1,0
56935,53,51699,53,allow,821,102,719,2,30,1,1
55656,31165,38946,31165,allow,70,70,0,1,5,1,0
49815,443,13935,443,allow,8614049,176366,8437683,7757,202,1608,6149
64797,53,6795,53,allow,183,94,89,2,30,1,1
55074,445,0,0,drop,70,70,0,1,0,1,0
57662,445,0,0,drop,70,70,0,1,0,1,0
59733,443,63033,443,allow,7310,967,6343,18,25,10,8
56102,445,0,0,drop,66,66,0,1,0,1,0
64364,53,34718,53,allow,323,110,213,2,30,1,1
49288,80,52653,80,allow,1056,682,374,10,15,6,4
53028,80,62533,80,allow,70,70,0,1,5,1,0
60869,48817,0,0,deny,62,62,0,1,0,1,0
22677,25174,0,0,deny,66,66,0,1,0,1,0
52034,48856,38527,48856,allow,66,66,0,1,5,1,0
52524,445,0,0,drop,66,66,0,1,0,1,0
60751,20010,54269,20010,allow,70,70,0,2,8,2,0
53459,37807,0,0,deny,62,62,0,1,0,1,0
53740,445,0,0,drop,70,70,0,1,0,1,0
11983,57470,0,0,deny,62,62,0,1,0,1,0
55721,53,26269,53,allow,177,94,83,2,30,1,1
49918,26296,0,0,deny,146,146,0,1,0,1,0
52234,64624,43132,64624,allow,136,136,0,3,14,3,0
51986,80,28001,80,allow,1420,888,532,11,49,7,4
59087,445,0,0,drop,70,70,0,1,0,1,0
9095,22114,0,0,deny,62,62,0,1,0,1,0
65115,53,25677,53,allow,368,95,273,4,61,2,2
38715,443,52129,443,allow,403299,12717,390582,439,16,171,268
28824,44847,0,0,deny,66,66,0,1,0,1,0
52303,445,0,0,drop,66,66,0,1,0,1,0
65233,53,6826,53,allow,448,130,318,4,44,2,2
50533,445,0,0,drop,70,70,0,1,0,1,0
64216,445,0,0,drop,66,66,0,1,0,1,0
57545,445,0,0,drop,70,70,0,1,0,1,0
58946,443,24412,443,allow,3990,2586,1404,17,16,9,8
50077,53,56181,53,allow,261,97,164,4,44,2,2
48817,49490,48817,49490,allow,513,152,361,2,1200,1,1
57470,18634,6347,18634,allow,594,594,0,10,1199,10,0
45717,80,45717,80,allow,2081,1632,449,10,19,6,4
51731,57470,0,0,deny,78,78,0,1,0,1,0
50847,445,0,0,drop,70,70,0,1,0,1,0
5859,11392,0,0,deny,62,62,0,1,0,1,0
63795,52376,52814,52376,allow,70,70,0,1,4,1,0
50592,443,1677,443,allow,9646,3396,6250,23,79,12,11
53707,443,35476,443,allow,350,210,140,6,25,4,2
48980,11119,0,0,deny,146,146,0,1,0,1,0
49749,443,40981,443,allow,7398,1597,5801,20,128,10,10
58912,11392,0,0,deny,66,66,0,1,0,1,0
42640,11119,0,0,deny,148,148,0,1,0,1,0
0,0,0,0,deny,94,94,0,1,0,1,0
65172,53,3984,53,allow,211,102,109,2,30,1,1
53270,443,30676,443,allow,6894,1556,5338,23,3601,13,10
60860,443,28548,443,allow,11687,2565,9122,46,66,25,21
61647,445,0,0,drop,66,66,0,1,0,1,0
10669,49756,0,0,deny,60,60,0,1,0,1,0
44389,443,27883,443,allow,3067,1817,1250,18,16,8,10
56125,53,8463,53,allow,168,86,82,2,31,1,1
51325,443,47264,443,allow,2019,1219,800,15,17,8,7
59275,445,0,0,drop,66,66,0,1,0,1,0
58685,445,0,0,drop,66,66,0,1,0,1,0
43488,443,22133,443,allow,6817,1221,5596,26,285,14,12
39704,53,39704,53,allow,398,255,143,3,33,2,1
23560,53,25867,53,allow,219,86,133,2,30,1,1
30456,36237,0,0,deny,146,146,0,1,0,1,0
55193,53,9970,53,allow,200,102,98,2,30,1,1
62231,445,0,0,drop,70,70,0,1,0,1,0
65520,56330,49409,56330,allow,558,318,240,9,143,5,4
10669,49756,0,0,deny,60,60,0,1,0,1,0
57996,80,13904,80,allow,5411,3618,1793,27,75,14,13
44884,443,1595,443,allow,309,309,0,1,5,1,0
60180,31573,0,0,deny,62,62,0,1,0,1,0
56683,445,0,0,drop,70,70,0,1,0,1,0
59474,445,0,0,drop,70,70,0,1,0,1,0
55679,445,0,0,drop,70,70,0,1,0,1,0
55431,445,0,0,drop,70,70,0,1,0,1,0
60913,80,45601,80,allow,613,539,74,7,15,6,1
23218,62413,0,0,deny,62,62,0,1,0,1,0
49597,80,42235,80,allow,130,70,60,2,15,1,1
65389,445,0,0,drop,66,66,0,1,0,1,0
49828,443,7626,443,allow,1737,1158,579,16,74,10,6
64684,53,7467,53,allow,757,102,655,2,30,1,1
64871,445,0,0,drop,70,70,0,1,0,1,0
6666,16010,0,0,deny,60,60,0,1,0,1,0
18608,11392,0,0,deny,66,66,0,1,0,1,0
58638,5900,0,0,deny,62,62,0,1,0,1,0
58640,443,44043,443,allow,4440,114,4326,7,122,2,5
39095,443,56882,443,allow,310402,12194,298208,374,82,157,217
33399,443,27816,443,allow,3603,2013,1590,21,42,12,9
64840,53,31006,53,allow,186,95,91,2,31,1,1
55454,53,60300,53,allow,168,86,82,2,33,1,1
35708,443,18676,443,allow,8264,1910,6354,21,361,10,11
56282,53,64449,53,allow,751,95,656,2,31,1,1
50644,35440,0,0,deny,66,66,0,1,0,1,0
51071,443,30007,443,allow,13412,5710,7702,50,257,24,26
52273,445,0,0,drop,70,70,0,1,0,1,0
49797,53,51758,53,allow,718,94,624,2,30,1,1
51845,445,0,0,drop,70,70,0,1,0,1,0
0,0,0,0,allow,480,244,236,4,0,2,2
35879,443,58250,443,allow,6108,3916,2192,51,1143,31,20
47773,53,42715,53,allow,236,86,150,2,30,1,1
62648,445,0,0,drop,70,70,0,1,0,1,0
64266,445,0,0,drop,70,70,0,1,0,1,0
58638,5900,0,0,deny,62,62,0,1,0,1,0
59624,443,22456,443,allow,18261,2059,16202,40,31,20,20
26821,57866,0,0,deny,62,62,0,1,0,1,0
59072,445,0,0,drop,66,66,0,1,0,1,0
65417,53,49087,53,allow,402,118,284,2,30,1,1
64677,53,12416,53,allow,172,88,84,2,31,1,1
57929,445,0,0,drop,70,70,0,1,0,1,0
26882,443,64713,443,allow,10633,2672,7961,31,20,16,15
30296,53,30296,53,allow,233,90,143,2,33,1,1
61857,445,0,0,drop,70,70,0,1,0,1,0
42981,44847,0,0,deny,146,146,0,1,0,1,0
57855,445,0,0,drop,70,70,0,1,0,1,0
65115,53,30947,53,allow,170,87,83,2,31,1,1
55620,53,6956,53,allow,178,94,84,2,31,1,1
38174,443,51209,443,allow,7034,1885,5149,28,95,15,13
49592,53,33191,53,allow,177,94,83,2,30,1,1
37555,16385,63752,16385,allow,556,256,300,10,30,5,5
53622,61393,55834,61393,allow,320,140,180,6,7,3,3
31660,35440,0,0,deny,66,66,0,1,0,1,0
56419,53,51375,53,allow,199,102,97,2,30,1,1
63719,445,0,0,drop,70,70,0,1,0,1,0
37575,443,11902,443,allow,11095,3227,7868,30,47,17,13
50398,445,0,0,drop,70,70,0,1,0,1,0
65021,53,29449,53,allow,589,91,498,4,54,2,2
56532,443,14584,443,allow,198167,11702,186465,220,105,84,136
42231,57470,0,0,deny,78,78,0,1,0,1,0
49456,53,42586,53,allow,199,102,97,2,31,1,1
49348,53,24608,53,allow,194,102,92,2,31,1,1
55056,80,26189,80,allow,306,180,126,6,26,4,2
49349,80,23734,80,allow,185645,6753,178892,213,81,89,124
58638,5900,0,0,deny,62,62,0,1,0,1,0
49926,53,10749,53,allow,266,110,156,2,30,1,1
50031,445,0,0,drop,66,66,0,1,0,1,0
56766,53,59139,53,allow,210,110,100,2,30,1,1
55634,53,37153,53,allow,210,110,100,2,30,1,1
51076,25174,0,0,deny,146,146,0,1,0,1,0
23807,44847,0,0,deny,62,62,0,1,0,1,0
49907,53,54297,53,allow,199,102,97,2,29,1,1
58419,445,0,0,drop,70,70,0,1,0,1,0
50557,53,32584,53,allow,758,93,665,2,31,1,1
60965,445,0,0,drop,70,70,0,1,0,1,0
19125,80,19125,80,allow,12650,889,11761,20,16,9,11
55415,445,0,0,drop,66,66,0,1,0,1,0
63449,445,0,0,drop,70,70,0,1,0,1,0
14844,37965,0,0,deny,62,62,0,1,0,1,0
58638,5900,58638,5900,allow,130,66,64,2,5,1,1
56563,53,35411,53,allow,177,94,83,2,29,1,1
22461,34021,0,0,reset-both,62,62,0,1,0,1,0
57632,445,0,0,drop,66,66,0,1,0,1,0
59179,53,29104,53,allow,260,86,174,2,30,1,1
49814,53,29277,53,allow,181,94,87,2,30,1,1
61610,445,0,0,drop,70,70,0,1,0,1,0
55514,53,45295,53,allow,779,86,693,2,29,1,1
58397,445,0,0,drop,70,70,0,1,0,1,0
63590,443,25710,443,allow,6187,933,5254,18,147,10,8
49686,443,60868,443,allow,8475,1661,6814,32,76,14,18
54811,445,0,0,drop,70,70,0,1,0,1,0
56498,53,6287,53,allow,199,102,97,2,30,1,1
49474,445,0,0,drop,70,70,0,1,0,1,0
3559,51050,0,0,deny,146,146,0,1,0,1,0
56540,445,0,0,drop,66,66,0,1,0,1,0
57493,443,46334,443,allow,1778,1219,559,13,27,8,5
49701,53,39669,53,allow,197,102,95,2,31,1,1
59585,36237,0,0,deny,62,62,0,1,0,1,0
59844,80,25773,80,allow,397391,8624,388767,380,49,118,262
45658,443,10440,443,allow,5359,3152,2207,51,2901,28,23
50084,26672,0,0,deny,62,62,0,1,0,1,0
65156,445,0,0,drop,70,70,0,1,0,1,0
60504,443,51319,443,allow,1875,1165,710,13,28,7,6
53704,15000,2505,15000,allow,70,70,0,2,7,2,0
56995,80,29664,80,allow,214,140,74,4,35,3,1
52054,80,49202,80,allow,1682,642,1040,13,54,4,9
65441,80,26203,80,allow,366,180,186,7,28,4,3
58638,5900,0,0,deny,62,62,0,1,0,1,0
12841,37965,0,0,deny,62,62,0,1,0,1,0
61404,445,0,0,drop,70,70,0,1,0,1,0
49331,53,37708,53,allow,182,94,88,2,30,1,1
3478,61463,0,0,deny,928,928,0,1,0,1,0
53815,44847,0,0,deny,66,66,0,1,0,1,0
1024,29892,0,0,deny,145,145,0,1,0,1,0
39434,5228,17809,5228,allow,3505,2006,1499,30,3744,15,15
56552,53,3851,53,allow,195,102,93,2,31,1,1
64391,53,9777,53,allow,209,102,107,2,29,1,1
64137,53,46613,53,allow,276,126,150,2,30,1,1
49418,27015,31380,27015,allow,239,78,161,2,30,1,1
56189,445,0,0,drop,70,70,0,1,0,1,0
55556,53,62239,53,allow,183,94,89,2,29,1,1
51770,80,6696,80,allow,135293,6214,129079,161,24,71,90
29176,7000,29176,7000,allow,4731,2270,2461,18,15,10,8
27677,22114,0,0,deny,146,146,0,1,0,1,0
37994,49152,32893,49152,allow,156,156,0,3,8,3,0
64212,445,0,0,drop,66,66,0,1,0,1,0
9047,443,22557,443,allow,3645,609,3036,13,120,6,7
25589,23,0,0,deny,60,60,0,1,0,1,0
60297,25604,0,0,deny,62,62,0,1,0,1,0
3478,61463,0,0,deny,1049,1049,0,1,0,1,0
8291,23,8291,23,allow,66,66,0,1,4,1,0
29177,44847,0,0,deny,62,62,0,1,0,1,0
41052,80,7228,80,allow,1056,682,374,10,15,6,4
56331,443,61535,443,allow,1786,172,1614,7,121,3,4
55678,53,49821,53,allow,270,88,182,4,54,2,2
49898,443,38870,443,allow,8191,2343,5848,33,394,11,22
50589,445,0,0,drop,66,66,0,1,0,1,0
56255,44847,0,0,deny,62,62,0,1,0,1,0
49913,445,0,0,drop,70,70,0,1,0,1,0
56521,32480,0,0,deny,62,62,0,1,0,1,0
61509,445,0,0,drop,70,70,0,1,0,1,0
62003,445,0,0,drop,66,66,0,1,0,1,0
3375,35253,0,0,deny,62,62,0,1,0,1,0
50366,445,0,0,drop,66,66,0,1,0,1,0
51608,445,0,0,drop,66,66,0,1,0,1,0
65139,53,58108,53,allow,754,94,660,2,31,1,1
21892,15503,0,0,deny,62,62,0,1,0,1,0
6929,53,6929,53,allow,197,90,107,2,30,1,1
52063,80,12503,80,allow,366,240,126,7,26,5,2
38496,5228,27256,5228,allow,3397,1506,1891,26,640,8,18
52072,80,26468,80,allow,482,300,182,9,26,6,3
55835,53,7338,53,allow,176,90,86,2,31,1,1
49874,80,9513,80,allow,9921,2945,6976,19,88,8,11
52173,44632,63328,44632,allow,258,70,188,4,9,2,2
52053,34411,40436,34411,allow,70,70,0,1,4,1,0
51647,80,60876,80,allow,378,192,186,7,38,4,3
52690,445,0,0,drop,66,66,0,1,0,1,0
64872,53,21895,53,allow,166,86,80,2,31,1,1
33053,53,52435,53,allow,164,78,86,2,31,1,1
54132,445,0,0,drop,70,70,0,1,0,1,0
57434,50584,0,0,deny,62,62,0,1,0,1,0
50615,80,48256,80,allow,190675,79205,111470,237,41,104,133
11402,11119,0,0,deny,145,145,0,1,0,1,0
56990,80,57120,80,allow,214,140,74,4,35,3,1
47728,443,8590,443,allow,8404,3653,4751,25,256,14,11
64714,53,62163,53,allow,289,134,155,2,30,1,1
51233,445,0,0,drop,66,66,0,1,0,1,0
48608,443,46175,443,allow,6371,848,5523,20,16,11,9
53376,22114,0,0,deny,62,62,0,1,0,1,0
56233,53,2635,53,allow,399,97,302,4,59,2,2
62849,62413,0,0,deny,66,66,0,1,0,1,0
63841,445,0,0,drop,70,70,0,1,0,1,0
56360,445,0,0,drop,70,70,0,1,0,1,0
54088,445,0,0,drop,70,70,0,1,0,1,0
60445,20555,38160,20555,allow,70,70,0,1,5,1,0
54739,445,0,0,drop,70,70,0,1,0,1,0
64311,53,19538,53,allow,199,102,97,2,30,1,1
55015,53,27863,53,allow,733,94,639,2,30,1,1
51919,10298,57387,10298,allow,70,70,0,1,5,1,0
49920,445,0,0,drop,66,66,0,1,0,1,0
49743,80,24003,80,allow,2981,473,2508,9,16,5,4
49882,445,0,0,drop,70,70,0,1,0,1,0
65048,53,32798,53,allow,194,102,92,2,30,1,1
23984,53,23984,53,allow,216,98,118,2,30,1,1
49615,53,23958,53,allow,199,102,97,2,30,1,1
52853,443,45061,443,allow,130,70,60,2,15,1,1
49547,53,33121,53,allow,193,102,91,2,29,1,1
60714,50584,0,0,deny,66,66,0,1,0,1,0
55554,22114,0,0,deny,146,146,0,1,0,1,0
65337,445,0,0,drop,70,70,0,1,0,1,0
45682,37965,0,0,deny,62,62,0,1,0,1,0
58092,445,0,0,drop,70,70,0,1,0,1,0
58438,445,0,0,drop,70,70,0,1,0,1,0
58638,5900,0,0,deny,62,62,0,1,0,1,0
15503,27645,52952,27645,allow,480,149,331,2,1200,1,1
64052,53,64052,53,allow,198,90,108,2,30,1,1
64587,53,13030,53,allow,167,86,81,2,30,1,1
59507,445,0,0,drop,70,70,0,1,0,1,0
49986,445,0,0,drop,70,70,0,1,0,1,0
49699,64147,0,0,deny,66,66,0,1,0,1,0
51865,14732,14153,14732,allow,70,70,0,1,5,1,0
63333,445,0,0,drop,70,70,0,1,0,1,0
56204,53,35079,53,allow,190,97,93,2,31,1,1
60499,51413,3005,51413,allow,70,70,0,2,8,2,0
51676,445,0,0,drop,70,70,0,1,0,1,0
49341,53,19411,53,allow,199,102,97,2,29,1,1
50216,443,23002,443,allow,6796,1796,5000,26,257,14,12
56120,53,44279,53,allow,177,94,83,2,30,1,1
49866,443,40314,443,allow,2937,717,2220,14,136,6,8
55214,53,41945,53,allow,711,87,624,2,31,1,1
49860,445,0,0,drop,70,70,0,1,0,1,0
37350,53,37350,53,allow,213,87,126,2,30,1,1
51779,31652,0,0,reset-both,62,62,0,1,0,1,0
55456,445,0,0,drop,70,70,0,1,0,1,0
60761,51221,0,0,deny,66,66,0,1,0,1,0
58062,445,0,0,drop,70,70,0,1,0,1,0
55857,53,49437,53,allow,196,102,94,2,30,1,1
49535,53,29045,53,allow,771,102,669,2,30,1,1
53614,443,48622,443,allow,6352,1552,4800,23,17,12,11
65031,53,49062,53,allow,184,94,90,2,31,1,1
50233,53,55519,53,allow,756,95,661,2,31,1,1
50480,80,36021,80,allow,318,192,126,6,25,4,2
56582,53,45398,53,allow,196,102,94,2,33,1,1
63023,51505,0,0,deny,66,66,0,1,0,1,0
47398,7302,0,0,deny,62,62,0,1,0,1,0
21420,44847,0,0,deny,66,66,0,1,0,1,0
54775,445,0,0,drop,66,66,0,1,0,1,0
55690,53,37274,53,allow,183,94,89,2,30,1,1
58163,445,0,0,drop,70,70,0,1,0,1,0
56599,53,21288,53,allow,258,110,148,2,30,1,1
57566,445,0,0,drop,70,70,0,1,0,1,0
55645,18904,52547,18904,allow,320,140,180,6,6,3,3
55749,37965,0,0,deny,66,66,0,1,0,1,0
49201,53,5443,53,allow,200,102,98,2,31,1,1
60246,80,10832,80,allow,17231,6415,10816,26,149,12,14
54256,445,0,0,drop,70,70,0,1,0,1,0
53798,62166,11396,62166,allow,258,70,188,4,7,2,2
13968,29376,0,0,reset-both,62,62,0,1,0,1,0
52763,443,13803,443,allow,256711,14141,242570,367,96,152,215
64221,445,0,0,drop,70,70,0,1,0,1,0
55600,80,5814,80,allow,70,70,0,1,5,1,0
49644,80,40102,80,allow,318,192,126,6,41,4,2
51756,64147,0,0,deny,66,66,0,1,0,1,0
9144,80,51086,80,allow,378,192,186,7,30,4,3
53816,22114,0,0,deny,146,146,0,1,0,1,0
64491,53,54856,53,allow,244,94,150,2,30,1,1
58638,5900,0,0,deny,62,62,0,1,0,1,0
53825,58968,28988,58968,allow,70,70,0,2,7,2,0
38501,53,38501,53,allow,233,91,142,2,31,1,1
55786,53,63117,53,allow,177,94,83,2,29,1,1
53788,445,0,0,deny,70,70,0,1,0,1,0
56431,53,52567,53,allow,323,110,213,2,30,1,1
51979,443,5164,443,allow,11555,2620,8935,45,822,18,27
52518,35440,0,0,deny,66,66,0,1,0,1,0
56311,53,2296,53,allow,311,94,217,2,30,1,1
62469,445,0,0,drop,70,70,0,1,0,1,0
57269,53,43829,53,allow,183,94,89,2,30,1,1
65507,53,47508,53,allow,167,86,81,2,30,1,1
54458,64147,0,0,deny,62,62,0,1,0,1,0
55325,53,2560,53,allow,210,110,100,2,30,1,1
57829,445,0,0,drop,70,70,0,1,0,1,0
24378,5169,24378,5169,deny,507,507,0,1,0,1,0
52471,443,40608,443,allow,41966,23593,18373,89,154,42,47
54572,445,0,0,drop,70,70,0,1,0,1,0
54137,443,45668,443,allow,10046,1394,8652,22,75,13,9
59985,57470,0,0,deny,66,66,0,1,0,1,0
53572,443,49621,443,allow,5935,342,5593,12,120,5,7
58022,5601,0,0,deny,60,60,0,1,0,1,0
57232,443,17235,443,allow,51152,3321,47831,81,100,38,43
52483,443,4472,443,allow,12863,8410,4453,22,31,13,9
56345,445,0,0,drop,70,70,0,1,0,1,0
56996,53,30047,53,allow,177,94,83,2,29,1,1
61482,445,0,0,drop,70,70,0,1,0,1,0
52668,51221,0,0,deny,66,66,0,1,0,1,0
43222,443,24936,443,allow,2088188,38201,2049987,1829,84,404,1425
10333,22114,0,0,deny,62,62,0,1,0,1,0
52102,80,29370,80,allow,22495,1895,20600,33,27,15,18
58362,53,30634,53,allow,167,78,89,2,30,1,1
59787,443,59787,443,allow,5525,2278,3247,22,40,13,9
56102,53,33083,53,allow,199,94,105,2,30,1,1
56422,53,41175,53,allow,199,102,97,2,30,1,1
50357,80,43010,80,allow,764,698,66,6,15,5,1
47814,51505,0,0,deny,66,66,0,1,0,1,0
48817,11373,48817,11373,allow,481,150,331,2,1200,1,1
53754,25306,12188,25306,allow,70,70,0,2,8,2,0
38274,443,9313,443,allow,600,156,444,8,25,2,6
49436,53,51466,53,allow,765,102,663,2,30,1,1
56592,53,8567,53,allow,262,94,168,2,30,1,1
55918,53,15262,53,allow,184,94,90,2,31,1,1
1972,57470,0,0,deny,78,78,0,1,0,1,0
45837,25174,0,0,deny,62,62,0,1,0,1,0
51313,445,0,0,drop,66,66,0,1,0,1,0
56422,53,39106,53,allow,195,102,93,2,30,1,1
63772,35440,0,0,deny,66,66,0,1,0,1,0
49494,445,0,0,drop,66,66,0,1,0,1,0
53518,29500,52778,29500,allow,320,140,180,6,7,3,3
52004,443,64314,443,allow,4804,866,3938,19,26,10,9
57843,443,8573,443,allow,25053,19627,5426,38,76,23,15
58638,5900,0,0,deny,62,62,0,1,0,1,0
55083,53,1182,53,allow,216,110,106,2,30,1,1
64150,22114,0,0,deny,66,66,0,1,0,1,0
57172,53,27478,53,allow,196,102,94,2,31,1,1
65241,53,13968,53,allow,484,102,382,4,36,2,2
49935,53,50105,53,allow,177,94,83,2,30,1,1
60659,443,57729,443,allow,8175,3047,5128,26,165,12,14
64891,22,0,0,deny,60,60,0,1,0,1,0
57964,44847,0,0,deny,62,62,0,1,0,1,0
56663,53,55920,53,allow,181,94,87,2,30,1,1
53928,15503,0,0,deny,62,62,0,1,0,1,0
11967,57470,0,0,deny,62,62,0,1,0,1,0
65110,53,12122,53,allow,754,191,563,6,51,3,3
38705,443,49826,443,allow,1248170,26899,1221271,1212,16,382,830
64531,445,0,0,drop,66,66,0,1,0,1,0
56815,445,0,0,drop,70,70,0,1,0,1,0
60950,443,63675,443,allow,7431,2753,4678,40,18,21,19
55378,445,0,0,drop,66,66,0,1,0,1,0
65413,445,0,0,drop,70,70,0,1,0,1,0
49885,7000,49885,7000,allow,3132,815,2317,14,15,7,7
52152,58114,40189,58114,allow,70,70,0,2,8,2,0
10306,44847,0,0,deny,66,66,0,1,0,1,0
54990,53,17689,53,allow,168,86,82,2,29,1,1
49328,445,0,0,drop,66,66,0,1,0,1,0
52931,80,27397,80,allow,78,78,0,1,4,1,0
62471,445,0,0,drop,66,66,0,1,0,1,0
27005,27019,52593,27019,allow,1007,252,755,4,32,3,1
10480,26467,0,0,deny,62,62,0,1,0,1,0
42090,443,46273,443,allow,5041,817,4224,20,373,8,12
56881,53,21712,53,allow,181,86,95,2,30,1,1
46860,15000,54542,15000,allow,130,70,60,2,6,1,1
54593,51505,0,0,deny,66,66,0,1,0,1,0
61536,445,0,0,drop,70,70,0,1,0,1,0
50396,62413,0,0,deny,66,66,0,1,0,1,0
54125,443,18046,443,allow,170665,9296,161369,227,116,102,125
50257,53,13525,53,allow,199,102,97,2,30,1,1
31602,53,0,0,allow,327,102,225,2,30,1,1
56846,26665,43590,26665,allow,70,70,0,1,5,1,0
62973,51505,0,0,deny,62,62,0,1,0,1,0
49293,53,24281,53,allow,178,94,84,2,30,1,1
44147,64147,0,0,deny,62,62,0,1,0,1,0
56666,443,31326,443,allow,1299,730,569,13,25,7,6
62501,445,0,0,drop,70,70,0,1,0,1,0
53591,443,53591,443,allow,1468,763,705,16,181,8,8
13120,25174,0,0,deny,62,62,0,1,0,1,0
58381,57470,0,0,deny,66,66,0,1,0,1,0
63720,55027,38364,55027,allow,1233,902,331,12,17,8,4
49418,27015,63355,27015,allow,244,78,166,2,30,1,1
59402,443,55166,443,allow,4821,1882,2939,19,15,9,10
30960,45683,56128,45683,allow,330,330,0,6,3609,6,0
62709,57470,0,0,deny,62,62,0,1,0,1,0
63226,445,0,0,drop,70,70,0,1,0,1,0
41340,80,50400,80,allow,2426,1540,886,14,23,8,6
60763,40010,33856,40010,allow,316,136,180,6,6,3,3
54365,64147,0,0,deny,62,62,0,1,0,1,0
53173,25067,40514,25067,allow,70,70,0,1,5,1,0
55323,53,14352,53,allow,172,88,84,2,31,1,1
49892,445,0,0,drop,70,70,0,1,0,1,0
54815,445,0,0,drop,70,70,0,1,0,1,0
60617,64147,0,0,deny,62,62,0,1,0,1,0
55196,445,0,0,drop,70,70,0,1,0,1,0
60796,53,56563,53,allow,296,94,202,2,29,1,1
60127,445,0,0,drop,70,70,0,1,0,1,0
53877,32737,64789,32737,allow,320,140,180,6,7,3,3
56613,53,57106,53,allow,307,134,173,2,30,1,1
49931,53,55078,53,allow,195,102,93,2,30,1,1
57052,53,52166,53,allow,170,87,83,2,31,1,1
64043,445,0,0,drop,70,70,0,1,0,1,0
49939,80,14388,80,allow,1130,613,517,11,15,6,5
48017,443,12876,443,allow,198,78,120,4,6,2,2
55335,445,0,0,drop,70,70,0,1,0,1,0
52134,18470,56970,18470,allow,70,70,0,1,4,1,0
55244,53,26585,53,allow,184,102,82,2,30,1,1
57983,443,38369,443,allow,7966,3102,4864,18,75,10,8
49520,80,52279,80,allow,2011,975,1036,13,70,7,6
64049,1029,38472,1029,allow,66,66,0,2,7,2,0
17262,25174,0,0,deny,62,62,0,1,0,1,0
51756,53,33754,53,allow,168,78,90,2,30,1,1
443,63128,0,0,deny,1514,1514,0,1,0,1,0
13285,29892,0,0,deny,145,145,0,1,0,1,0
56742,443,47140,443,allow,8007,1987,6020,20,15,11,9
55996,53,61146,53,allow,196,86,110,2,30,1,1
49835,53,10267,53,allow,199,94,105,2,31,1,1
51830,42707,0,0,deny,66,66,0,1,0,1,0
65167,443,56897,443,allow,4925,2188,2737,36,360,16,20
65259,445,0,0,drop,66,66,0,1,0,1,0
58264,44847,0,0,deny,66,66,0,1,0,1,0
37927,50265,0,0,deny,66,66,0,1,0,1,0
55691,445,0,0,drop,66,66,0,1,0,1,0
55077,53,32952,53,allow,179,94,85,2,29,1,1
50471,53,24459,53,allow,168,78,90,2,30,1,1
34432,80,52921,80,allow,6260,696,5564,17,16,9,8
52571,80,52571,80,allow,10947,876,10071,21,142,9,12
61929,445,0,0,drop,70,70,0,1,0,1,0
63032,445,0,0,drop,70,70,0,1,0,1,0
57123,445,0,0,drop,70,70,0,1,0,1,0
56115,53,38646,53,allow,278,96,182,4,54,2,2
1912,48817,0,0,deny,62,62,0,1,0,1,0
36278,7000,36278,7000,allow,3578,1967,1611,16,16,8,8
60314,80,12778,80,allow,1498,539,959,10,77,6,4
55985,44847,0,0,deny,146,146,0,1,0,1,0
57398,443,53104,443,allow,1056,569,487,10,24,6,4
55182,445,0,0,drop,70,70,0,1,0,1,0
61257,56448,0,0,deny,146,146,0,1,0,1,0
49104,80,61237,80,allow,1638,1324,314,10,15,5,5
50315,80,20802,80,allow,1030,310,720,11,56,6,5
2226,443,2226,443,allow,46743,4890,41853,69,23,35,34
58452,5228,20449,5228,allow,2855,1780,1075,20,3600,10,10
9459,443,54316,443,allow,5695,505,5190,14,15,7,7
51810,33776,19037,33776,allow,70,70,0,2,8,2,0
49608,53,46552,53,allow,177,94,83,2,30,1,1
55973,53,5208,53,allow,939,678,261,2,30,1,1
45964,2225,0,0,deny,60,60,0,1,0,1,0
51862,27758,32851,27758,allow,70,70,0,2,7,2,0
61415,445,0,0,drop,66,66,0,1,0,1,0
1030,35776,0,0,deny,139,139,0,1,0,1,0
65443,80,29432,80,allow,366,180,186,7,28,4,3
36010,443,44715,443,allow,5689,1505,4184,24,19,13,11
51185,37965,0,0,deny,62,62,0,1,0,1,0
39252,53,39252,53,allow,197,90,107,2,29,1,1
64296,53,31060,53,allow,215,94,121,2,29,1,1
50939,445,0,0,drop,70,70,0,1,0,1,0
60840,53,50587,53,allow,255,86,169,2,31,1,1
48105,53,48105,53,allow,262,106,156,2,33,1,1
59293,445,0,0,drop,70,70,0,1,0,1,0
56119,445,0,0,drop,70,70,0,1,0,1,0
56658,443,31194,443,allow,8007,1987,6020,20,15,11,9
6259,25,6259,25,allow,130,66,64,2,5,1,1
49351,53,12256,53,allow,164,84,80,2,30,1,1
61725,445,0,0,drop,66,66,0,1,0,1,0
64948,445,0,0,drop,70,70,0,1,0,1,0
65224,443,29038,443,allow,18887,8273,10614,42,62,22,20
57604,32480,0,0,deny,62,62,0,1,0,1,0
55146,53,42848,53,allow,181,94,87,2,30,1,1
58638,5900,0,0,deny,62,62,0,1,0,1,0
53062,445,0,0,drop,66,66,0,1,0,1,0
48706,23393,0,0,deny,60,60,0,1,0,1,0
37749,15503,0,0,deny,62,62,0,1,0,1,0
6881,6881,0,0,deny,146,146,0,1,0,1,0
51854,80,4415,80,allow,5438,1822,3616,17,38,11,6
56138,53,22955,53,allow,177,94,83,2,30,1,1
63644,445,0,0,drop,66,66,0,1,0,1,0
58934,445,0,0,drop,70,70,0,1,0,1,0
63214,53,63214,53,allow,261,103,158,2,30,1,1
52459,33890,0,0,deny,60,60,0,1,0,1,0
21759,51505,0,0,deny,66,66,0,1,0,1,0
25434,53,25434,53,allow,231,90,141,2,31,1,1
64588,53,37209,53,allow,186,95,91,2,31,1,1
62265,445,0,0,drop,70,70,0,1,0,1,0
59084,445,0,0,drop,70,70,0,1,0,1,0
14487,38303,0,0,deny,146,146,0,1,0,1,0
56620,53,43601,53,allow,762,98,664,2,30,1,1
57538,23,0,0,deny,60,60,0,1,0,1,0
51898,50677,11184,50677,allow,70,70,0,2,8,2,0
49712,53,29972,53,allow,172,88,84,2,30,1,1
56752,53,3213,53,allow,183,94,89,2,29,1,1
64650,445,0,0,drop,70,70,0,1,0,1,0
53272,443,47485,443,allow,20745,2083,18662,36,322,15,21
62257,2767,0,0,deny,66,66,0,1,0,1,0
10462,25174,0,0,deny,62,62,0,1,0,1,0
65344,53,6284,53,allow,211,102,109,2,30,1,1
55080,80,25795,80,allow,2305712,80795,2224917,2771,52,1293,1478
53160,39001,43902,39001,allow,70,70,0,1,5,1,0
58434,445,0,0,drop,70,70,0,1,0,1,0
65400,36237,0,0,deny,66,66,0,1,0,1,0
61996,445,0,0,drop,70,70,0,1,0,1,0
39328,80,5790,80,allow,78,78,0,1,5,1,0
50374,443,56948,443,allow,5359,705,4654,15,25,8,7
60241,445,0,0,drop,66,66,0,1,0,1,0
49323,53,45688,53,allow,192,98,94,2,30,1,1
32491,15503,0,0,deny,66,66,0,1,0,1,0
54105,443,23340,443,allow,2227,1018,1209,17,16,8,9
27005,27015,55780,27015,allow,873,126,747,3,31,2,1
20939,60461,0,0,deny,60,60,0,1,0,1,0
42917,52952,0,0,deny,62,62,0,1,0,1,0
49435,53,45474,53,allow,720,94,626,2,30,1,1
34316,53,37625,53,allow,168,78,90,2,29,1,1
53373,64147,0,0,deny,62,62,0,1,0,1,0
55327,445,0,0,drop,66,66,0,1,0,1,0
56247,445,0,0,drop,66,66,0,1,0,1,0
61197,445,0,0,drop,70,70,0,1,0,1,0
35371,443,55003,443,allow,304294,8535,295759,302,132,90,212
42298,40028,3543,40028,allow,148,86,62,2,29,1,1
51853,30585,59624,30585,allow,136,136,0,3,14,3,0
58825,443,1318,443,allow,6357,4318,2039,22,16,11,11
52795,445,0,0,drop,66,66,0,1,0,1,0
41901,443,21025,443,allow,5586,1404,4182,17,212,10,7
63988,53,51956,53,allow,195,102,93,2,30,1,1
50424,53,47336,53,allow,195,102,93,2,30,1,1
53366,53,53366,53,allow,237,98,139,2,30,1,1
60498,55100,34970,55100,allow,258,70,188,4,8,2,2
0,0,0,0,deny,82,82,0,1,0,1,0
63334,37807,0,0,deny,66,66,0,1,0,1,0
42241,11392,0,0,deny,66,66,0,1,0,1,0
56620,53,33976,53,allow,216,110,106,2,31,1,1
20953,23,0,0,deny,60,60,0,1,0,1,0
49523,445,0,0,drop,70,70,0,1,0,1,0
55032,62413,0,0,deny,66,66,0,1,0,1,0
60062,53,61702,53,allow,168,78,90,2,30,1,1
57994,80,57049,80,allow,2494,1540,954,21,75,11,10
55821,53,64842,53,allow,192,98,94,2,30,1,1
53166,53,17813,53,allow,168,78,90,2,30,1,1
50977,80,25806,80,allow,1111949,11633,1100316,906,37,173,733
63488,445,0,0,drop,66,66,0,1,0,1,0
65360,53,6269,53,allow,763,102,661,2,30,1,1
49793,53,43171,53,allow,718,94,624,2,30,1,1
54761,445,0,0,drop,66,66,0,1,0,1,0
64320,53,46178,53,allow,199,102,97,2,30,1,1
39313,37965,0,0,deny,62,62,0,1,0,1,0
443,49988,0,0,deny,82,82,0,1,0,1,0
55376,53,48930,53,allow,789,110,679,2,31,1,1
50869,445,0,0,drop,70,70,0,1,0,1,0
34920,53,40562,53,allow,168,78,90,2,31,1,1
37558,16384,22272,16384,allow,556,256,300,10,30,5,5
50183,443,52770,443,allow,6348,1071,5277,18,42,10,8
35833,443,20943,443,allow,5524,1857,3667,27,3652,9,18
58091,51505,0,0,deny,66,66,0,1,0,1,0
58664,64147,0,0,deny,66,66,0,1,0,1,0
65003,445,0,0,drop,70,70,0,1,0,1,0
64403,53,60359,53,allow,198,101,97,2,30,1,1
2572,17546,0,0,deny,66,66,0,1,0,1,0
49312,53,8379,53,allow,216,94,122,2,29,1,1
63938,26204,59342,26204,allow,70,70,0,1,4,1,0
64770,445,0,0,drop,70,70,0,1,0,1,0
56854,445,0,0,drop,70,70,0,1,0,1,0
28194,32468,0,0,deny,62,62,0,1,0,1,0
63965,53,11899,53,allow,180,94,86,2,30,1,1
55910,53,42664,53,allow,183,94,89,2,30,1,1
52101,445,0,0,drop,70,70,0,1,0,1,0
63831,445,0,0,drop,70,70,0,1,0,1,0
58638,5900,0,0,deny,62,62,0,1,0,1,0
57123,53,38680,53,allow,811,94,717,2,30,1,1
55562,53,27476,53,allow,239,94,145,2,29,1,1
58598,50584,0,0,deny,66,66,0,1,0,1,0
55877,62071,53667,62071,allow,481,150,331,2,1200,1,1
49780,80,65003,80,allow,1429,931,498,10,126,6,4
57900,443,44556,443,allow,1798,1159,639,17,170,10,7
11983,57470,0,0,deny,62,62,0,1,0,1,0
37682,5228,19029,5228,allow,5554,755,4799,14,3600,8,6
56737,53,36153,53,allow,817,98,719,2,31,1,1
55727,43736,19578,43736,allow,70,70,0,1,5,1,0
27005,27016,32182,27016,allow,1648,126,1522,4,30,2,2
58638,5900,0,0,deny,62,62,0,1,0,1,0
55712,27816,8971,27816,allow,316,190,126,5,16,3,2
50556,445,0,0,drop,70,70,0,1,0,1,0
65220,53,17734,53,allow,303,94,209,4,32,2,2
51738,7000,51738,7000,allow,3550,1983,1567,15,16,8,7
53563,445,0,0,drop,70,70,0,1,0,1,0
57107,64147,0,0,deny,66,66,0,1,0,1,0
52184,445,0,0,drop,70,70,0,1,0,1,0
64038,28187,34899,28187,allow,66,66,0,2,8,2,0
61701,15503,0,0,deny,62,62,0,1,0,1,0
1090,26296,0,0,deny,159,159,0,1,0,1,0
37660,443,48083,443,allow,3354,2353,1001,18,45,11,7
60354,80,7611,80,allow,644,256,388,8,124,5,3
59899,3389,59899,3389,allow,3504,1790,1714,17,32,9,8
58860,443,58775,443,allow,5594,3484,2110,16,15,8,8
57030,53,7649,53,allow,283,101,182,4,39,2,2
59697,80,58873,80,allow,5326946,116544,5210402,5175,111,1695,3480
49731,443,14153,443,allow,13155,3815,9340,29,24,13,16
51973,12321,46700,12321,allow,1260,636,624,9,30,5,4
50563,37965,0,0,deny,66,66,0,1,0,1,0
24160,37807,0,0,deny,62,62,0,1,0,1,0
65440,80,8468,80,allow,366,180,186,7,28,4,3
46034,53,59880,53,allow,168,78,90,2,30,1,1
56711,25174,0,0,deny,146,146,0,1,0,1,0
57870,7635,57870,7635,allow,138,78,60,2,6,1,1
58685,445,0,0,drop,70,70,0,1,0,1,0
49982,37965,0,0,deny,66,66,0,1,0,1,0
49665,53,35069,53,allow,168,86,82,2,32,1,1
55606,445,0,0,drop,70,70,0,1,0,1,0
57424,2258,57424,2258,allow,156,156,0,3,8,3,0
49418,27017,44700,27017,allow,78,78,0,1,30,1,0
57010,80,42816,80,allow,214,140,74,4,30,3,1
58638,5900,58638,5900,allow,62,62,0,1,5,1,0
49322,443,12551,443,allow,166663,77974,88689,368,2310,123,245
64089,53,37654,53,allow,194,102,92,2,30,1,1
56343,53,46504,53,allow,177,94,83,2,30,1,1
55032,5222,63875,5222,allow,138,64,74,3,5,2,1
60377,443,19236,443,allow,10101,2782,7319,22,78,10,12
53753,443,14141,443,allow,6973,2166,4807,20,15,11,9
55223,443,26672,443,allow,12583,2945,9638,31,47,16,15
64525,53,61457,53,allow,199,102,97,2,30,1,1
60337,7000,60337,7000,allow,2163,676,1487,14,16,7,7
49871,443,47130,443,allow,615040,25597,589443,704,54,245,459
26900,27017,12522,27017,allow,422,164,258,6,30,3,3
59241,62413,0,0,deny,66,66,0,1,0,1,0
50481,445,0,0,drop,66,66,0,1,0,1,0
50334,443,29587,443,allow,3193,346,2847,12,121,5,7
7181,64147,0,0,deny,66,66,0,1,0,1,0
52724,64147,0,0,deny,62,62,0,1,0,1,0
49378,53,33691,53,allow,179,86,93,2,30,1,1
57613,80,57613,80,allow,349583,9149,340434,298,25,62,236
2170,43227,0,0,deny,62,62,0,1,0,1,0
40642,23889,0,0,deny,146,146,0,1,0,1,0
38629,25174,0,0,deny,66,66,0,1,0,1,0
53231,443,2130,443,allow,8906,1533,7373,32,58,16,16
54160,53,34866,53,allow,199,94,105,2,29,1,1
55312,64147,0,0,deny,62,62,0,1,0,1,0
49928,443,36059,443,allow,11646,4774,6872,29,32,18,11
65011,53,28977,53,allow,183,94,89,2,31,1,1
56224,445,0,0,drop,66,66,0,1,0,1,0
55550,445,0,0,drop,70,70,0,1,0,1,0
38901,53,60941,53,allow,168,78,90,2,30,1,1
64767,80,54344,80,allow,3199,988,2211,14,99,7,7
57300,53,43157,53,allow,184,94,90,2,30,1,1
54867,445,0,0,drop,70,70,0,1,0,1,0
55492,53,7520,53,allow,216,110,106,2,29,1,1
49980,53,26131,53,allow,152,78,74,2,30,1,1
53147,26330,24592,26330,allow,70,70,0,1,5,1,0
59786,25174,0,0,deny,66,66,0,1,0,1,0
50264,445,0,0,drop,70,70,0,1,0,1,0
58638,5900,0,0,deny,62,62,0,1,0,1,0
55603,443,55603,443,allow,4684,1777,2907,19,12,11,8
53841,37965,0,0,deny,66,66,0,1,0,1,0
57470,45340,41159,45340,allow,527,166,361,2,1200,1,1
36756,443,3567,443,allow,6112,1553,4559,18,16,10,8
65015,22114,0,0,deny,66,66,0,1,0,1,0
57049,53,52014,53,allow,755,93,662,2,31,1,1
64897,53,12641,53,allow,266,110,156,2,30,1,1
49482,22,0,0,deny,60,60,0,1,0,1,0
50100,53,44319,53,allow,216,110,106,2,30,1,1
36096,51505,0,0,deny,146,146,0,1,0,1,0
61711,443,17336,443,allow,7485,1962,5523,27,95,13,14
58955,80,51848,80,allow,3037,2276,761,12,28,7,5
63239,445,0,0,drop,70,70,0,1,0,1,0
39195,443,6951,443,allow,8991,2438,6553,18,120,8,10
20570,53,52597,53,allow,428,78,350,2,31,1,1
51965,80,11220,80,allow,306,120,186,6,25,3,3
64588,53,5541,53,allow,264,102,162,2,30,1,1
49418,50019,9812,50019,allow,268,78,190,2,30,1,1
64749,3389,64749,3389,allow,3347,1458,1889,15,18,8,7
59920,445,0,0,drop,66,66,0,1,0,1,0
12709,51505,0,0,deny,62,62,0,1,0,1,0
27446,30188,0,0,deny,66,66,0,1,0,1,0
60358,443,56425,443,allow,17547,2695,14852,30,76,14,16
58899,445,0,0,drop,70,70,0,1,0,1,0
50606,445,0,0,drop,66,66,0,1,0,1,0
49558,53,47394,53,allow,184,94,90,2,30,1,1
57982,64147,0,0,deny,66,66,0,1,0,1,0
7892,50584,0,0,deny,62,62,0,1,0,1,0
50515,445,0,0,drop,70,70,0,1,0,1,0
49274,53,43421,53,allow,212,102,110,2,29,1,1
60614,445,0,0,drop,66,66,0,1,0,1,0
63991,443,63991,443,allow,4597,1690,2907,19,28,11,8
64470,445,0,0,drop,66,66,0,1,0,1,0
53827,5889,39241,5889,allow,70,70,0,1,4,1,0
22530,25174,0,0,deny,62,62,0,1,0,1,0
57097,445,0,0,drop,66,66,0,1,0,1,0
46460,36237,0,0,deny,146,146,0,1,0,1,0
50477,445,0,0,drop,66,66,0,1,0,1,0
51026,445,0,0,drop,70,70,0,1,0,1,0
50088,1604,0,0,deny,84,84,0,1,0,1,0
50012,53,43824,53,allow,94,94,0,1,30,1,0
58478,53,13215,53,allow,332,102,230,2,29,1,1
59777,443,22920,443,allow,19311,2432,16879,55,417,24,31
60212,445,0,0,drop,70,70,0,1,0,1,0
49554,443,54292,443,allow,10104,2646,7458,28,186,14,14
54385,53,14777,53,allow,168,78,90,2,30,1,1
50308,445,0,0,drop,66,66,0,1,0,1,0
50292,62413,0,0,deny,62,62,0,1,0,1,0
50895,443,56217,443,allow,6354,1373,4981,18,129,9,9
60225,443,43705,443,allow,8989,3335,5654,65,152,31,34
56717,53,9802,53,allow,711,87,624,2,30,1,1
53626,445,0,0,drop,66,66,0,1,0,1,0
53696,50321,25044,50321,allow,70,70,0,2,7,2,0
37000,443,57961,443,allow,280,140,140,5,130,3,2
50,64147,0,0,deny,66,66,0,1,0,1,0
49192,445,0,0,drop,70,70,0,1,0,1,0
64803,80,9867,80,allow,5518,527,4991,13,75,6,7
47453,443,47453,443,allow,4475,1568,2907,19,28,11,8
50864,445,0,0,drop,66,66,0,1,0,1,0
53957,35440,0,0,deny,62,62,0,1,0,1,0
64333,57470,0,0,deny,78,78,0,1,0,1,0
38783,443,19297,443,allow,584,370,214,9,25,6,3
64204,53,3889,53,allow,186,95,91,2,31,1,1
50969,443,44036,443,allow,7221,2265,4956,16,127,7,9
54280,3396,54280,3396,allow,146,60,86,2,10,1,1
0,0,0,0,deny,185,185,0,1,0,1,0
3478,61463,0,0,deny,1275,1275,0,1,0,1,0
49620,53,9957,53,allow,211,110,101,2,29,1,1
61434,443,24839,443,allow,8005,830,7175,19,27,9,10
39824,51505,0,0,deny,62,62,0,1,0,1,0
57231,53,2071,53,allow,168,86,82,2,31,1,1
56272,53,1689,53,allow,167,86,81,2,30,1,1
49759,53,28731,53,allow,216,110,106,2,30,1,1
50098,445,0,0,drop,66,66,0,1,0,1,0
57305,445,0,0,drop,66,66,0,1,0,1,0
50444,443,13843,443,allow,5593,996,4597,22,127,11,11
52403,445,0,0,drop,66,66,0,1,0,1,0
32860,53,58856,53,allow,168,78,90,2,30,1,1
53777,62955,35330,62955,allow,70,70,0,2,7,2,0
60839,445,0,0,drop,66,66,0,1,0,1,0
55358,53,33999,53,allow,200,94,106,2,29,1,1
37887,22114,0,0,deny,66,66,0,1,0,1,0
54899,445,0,0,drop,70,70,0,1,0,1,0
5826,26467,0,0,deny,62,62,0,1,0,1,0
55363,443,55363,443,allow,5458,2211,3247,22,39,13,9
51975,443,30656,443,allow,4692,2376,2316,30,47,16,14
53867,60272,36955,60272,allow,70,70,0,1,5,1,0
12986,64147,0,0,deny,62,62,0,1,0,1,0
49606,53,55555,53,allow,328,94,234,4,43,2,2
41690,443,19019,443,allow,1478937,62961,1415976,1678,148,649,1029
51963,445,0,0,drop,70,70,0,1,0,1,0
55216,53,32573,53,allow,179,94,85,2,30,1,1
42973,57470,0,0,deny,62,62,0,1,0,1,0
49459,443,42939,443,allow,2572,330,2242,12,135,5,7
55421,57470,0,0,deny,74,74,0,1,0,1,0
19875,30170,0,0,deny,145,145,0,1,0,1,0
12550,37807,0,0,deny,62,62,0,1,0,1,0
56528,443,54144,443,allow,8313,3597,4716,16,119,8,8
64751,53,58884,53,allow,178,94,84,2,31,1,1
53432,53,53432,53,allow,197,76,121,2,31,1,1
50292,22114,0,0,deny,66,66,0,1,0,1,0
62025,445,0,0,drop,70,70,0,1,0,1,0
3478,61463,0,0,deny,164,164,0,1,0,1,0
60499,445,0,0,drop,70,70,0,1,0,1,0
35515,53,6694,53,allow,199,94,105,2,29,1,1
42420,443,29433,443,allow,8616,2683,5933,30,459,15,15
64726,53,25224,53,allow,178,94,84,2,30,1,1
51413,57470,0,0,deny,72,72,0,1,0,1,0
40687,64147,0,0,deny,62,62,0,1,0,1,0
53110,8830,31632,8830,allow,70,70,0,2,8,2,0
53006,443,3727,443,allow,2651,1504,1147,24,68,13,11
47518,53,47518,53,allow,414,268,146,3,32,2,1
54670,443,29364,443,allow,18487,3434,15053,37,80,20,17
64094,1024,11634,1024,allow,66,66,0,2,8,2,0
52194,443,38386,443,allow,12374,1090,11284,27,15,13,14
52182,60769,63523,60769,allow,70,70,0,2,8,2,0
65139,53,54576,53,allow,443,182,261,6,30,3,3
56327,53,60019,53,allow,199,102,97,2,30,1,1
50265,34311,31562,34311,allow,480,149,331,2,1200,1,1
50072,53,48106,53,allow,172,94,78,2,30,1,1
58856,443,29128,443,allow,2881,1766,1115,17,16,9,8
57470,32251,57534,32251,allow,132,132,0,3,1199,3,0
52216,445,0,0,drop,66,66,0,1,0,1,0
58638,5900,0,0,deny,62,62,0,1,0,1,0
58754,53,0,0,allow,627,80,547,2,30,1,1
49628,53,54412,53,allow,168,86,82,2,30,1,1
56456,53,17169,53,allow,195,102,93,2,30,1,1
56562,443,49879,443,allow,8821,3228,5593,25,60,15,10
52147,30265,61743,30265,allow,66,66,0,1,5,1,0
65052,53,65052,53,allow,240,98,142,2,30,1,1
53592,23578,9676,23578,allow,70,70,0,1,4,1,0
49927,445,0,0,drop,66,66,0,1,0,1,0
53764,443,56074,443,allow,499,425,74,4,0,3,1
57114,35440,0,0,deny,62,62,0,1,0,1,0
49859,443,23944,443,allow,6065,1045,5020,20,60,11,9
37997,49152,15013,49152,allow,156,156,0,3,8,3,0
65387,445,0,0,drop,70,70,0,1,0,1,0
123,123,13425,123,allow,184,94,90,2,29,1,1
2464,50584,0,0,deny,62,62,0,1,0,1,0
49418,27400,52679,27400,allow,78,78,0,1,30,1,0
65189,27237,9524,27237,allow,234,78,156,2,30,1,1
56281,53,56281,53,allow,851,114,737,2,30,1,1
1865,25174,0,0,deny,62,62,0,1,0,1,0
58822,445,0,0,drop,70,70,0,1,0,1,0
25565,41288,0,0,deny,60,60,0,1,0,1,0
55881,443,18861,443,allow,25586,4360,21226,57,81,29,28
51444,443,39755,443,allow,3283,951,2332,13,135,6,7
64112,24707,56635,24707,allow,66,66,0,2,8,2,0
57020,53,49369,53,allow,738,86,652,2,31,1,1
42881,443,29777,443,allow,134,60,74,3,4,2,1
50453,80,50453,80,allow,450,246,204,8,30,5,3
17315,11392,0,0,deny,66,66,0,1,0,1,0
42298,40027,29472,40027,allow,144,82,62,2,30,1,1
59790,44847,0,0,deny,66,66,0,1,0,1,0
62217,37807,0,0,deny,62,62,0,1,0,1,0
64539,53,5433,53,allow,170,87,83,2,31,1,1
51519,443,51519,443,allow,8680,2323,6357,31,173,13,18
59783,445,0,0,drop,70,70,0,1,0,1,0
49899,443,2357,443,allow,26284,21857,4427,72,83,39,33
49700,80,44971,80,allow,71320,1026,70294,64,52,12,52
56503,53,37647,53,allow,578,286,292,9,15,5,4
1081,14984,0,0,deny,146,146,0,1,0,1,0
65376,53,60931,53,allow,184,94,90,2,30,1,1
53549,40826,14418,40826,allow,492,306,186,8,14,5,3
58420,443,23233,443,allow,17161,1619,15542,18,149,4,14
52068,445,0,0,drop,70,70,0,1,0,1,0
61333,445,0,0,drop,66,66,0,1,0,1,0
1024,22114,0,0,deny,146,146,0,1,0,1,0
64759,445,0,0,drop,70,70,0,1,0,1,0
50614,80,59659,80,allow,318,192,126,6,25,4,2
50334,80,53374,80,allow,442,250,192,8,47,5,3
51233,445,0,0,drop,70,70,0,1,0,1,0
3478,61463,0,0,deny,1109,1109,0,1,0,1,0
54816,35440,0,0,deny,62,62,0,1,0,1,0
50597,443,31048,443,allow,8031,1915,6116,24,17,12,12
63799,13835,56478,13835,allow,66,66,0,1,5,1,0
50207,445,0,0,drop,70,70,0,1,0,1,0
80,56289,0,0,deny,1090,1090,0,1,0,1,0
49794,53,1835,53,allow,197,102,95,2,30,1,1
58638,5900,0,0,deny,62,62,0,1,0,1,0
55803,445,0,0,drop,66,66,0,1,0,1,0
50928,445,0,0,drop,70,70,0,1,0,1,0
39195,25174,0,0,deny,146,146,0,1,0,1,0
60883,443,40215,443,allow,11586,5435,6151,46,46,25,21
56584,445,0,0,drop,70,70,0,1,0,1,0
56987,53,59227,53,allow,196,102,94,2,30,1,1
50354,53,24829,53,allow,209,110,99,2,30,1,1
22835,51221,0,0,deny,62,62,0,1,0,1,0
55700,26957,33294,26957,allow,70,70,0,2,8,2,0
6881,6881,0,0,deny,62,62,0,1,0,1,0
55209,445,0,0,drop,70,70,0,1,0,1,0
58566,443,36573,443,allow,34405,7602,26803,53,35,24,29
60786,443,40740,443,allow,12106,2192,9914,38,38,19,19
54468,443,26749,443,allow,2402,1444,958,18,81,10,8
11876,22,0,0,deny,60,60,0,1,0,1,0
56177,445,0,0,drop,66,66,0,1,0,1,0
58638,5900,0,0,deny,62,62,0,1,0,1,0
64604,53,45485,53,allow,429,109,320,4,37,2,2
60856,445,0,0,drop,70,70,0,1,0,1,0
49761,53,36428,53,allow,373,99,274,4,41,2,2
50283,49169,0,0,deny,62,62,0,1,0,1,0
46315,443,19188,443,allow,5571,2240,3331,28,87,14,14
50140,445,0,0,drop,70,70,0,1,0,1,0
64894,53,8238,53,allow,195,102,93,2,30,1,1
50983,80,17764,80,allow,7765,2215,5550,20,20,12,8
49496,53,27238,53,allow,194,102,92,2,30,1,1
53076,445,0,0,drop,70,70,0,1,0,1,0
60106,443,61992,443,allow,7243,4797,2446,42,136,23,19
54155,64147,0,0,deny,66,66,0,1,0,1,0
443,60496,0,0,deny,320,320,0,1,0,1,0
49542,80,57907,80,allow,1012,531,481,8,25,5,3
49582,80,30882,80,allow,454222,9730,444492,425,155,119,306
49860,53,46004,53,allow,212,102,110,2,30,1,1
56839,445,0,0,drop,66,66,0,1,0,1,0
63236,443,2158,443,allow,4945,2798,2147,27,141,14,13
46662,36237,0,0,deny,62,62,0,1,0,1,0
52848,443,15385,443,allow,6218,1239,4979,14,133,7,7
49418,27015,60296,27015,allow,253,78,175,2,31,1,1
55934,53,55732,53,allow,192,98,94,2,31,1,1
6881,6882,61481,6882,allow,238,118,120,2,1199,1,1
55545,445,0,0,drop,66,66,0,1,0,1,0
55078,445,0,0,drop,70,70,0,1,0,1,0
64911,53,26816,53,allow,209,110,99,2,31,1,1
56950,443,41087,443,allow,5601,1203,4398,14,60,9,5
51748,15177,40687,15177,allow,70,70,0,2,9,2,0
51861,23919,9665,23919,allow,70,70,0,2,7,2,0
55865,53,64490,53,allow,168,86,82,2,30,1,1
27005,27015,8730,27015,allow,913,126,787,2,30,1,1
8916,443,25420,443,allow,7685,1016,6669,29,413,11,18
58338,3369,0,0,deny,60,60,0,1,0,1,0
10082,64147,0,0,deny,62,62,0,1,0,1,0
56596,53,10703,53,allow,194,102,92,2,31,1,1
55194,53,21353,53,allow,195,102,93,2,29,1,1
50483,443,61825,443,allow,12462,2612,9850,37,80,19,18
56652,53,12784,53,allow,198,102,96,2,30,1,1
65389,53,51653,53,allow,94,94,0,1,30,1,0
56379,53,29859,53,allow,166,86,80,2,31,1,1
50006,53,41506,53,allow,994,86,908,2,29,1,1
57470,6969,61511,6969,allow,37677,7875,29802,115,3342,58,57
50989,445,0,0,drop,66,66,0,1,0,1,0
35263,443,2697,443,allow,22457,12680,9777,65,20,34,31
59582,53,61781,53,allow,256,102,154,2,29,1,1
44545,443,4712,443,allow,546,280,266,9,26,5,4
1035,57470,0,0,deny,72,72,0,1,0,1,0
58311,445,0,0,drop,70,70,0,1,0,1,0
65376,443,34209,443,allow,55500,40540,14960,137,131,72,65
52933,443,60920,443,allow,5582,1388,4194,19,15,9,10
60024,445,0,0,drop,70,70,0,1,0,1,0
53120,25174,0,0,deny,146,146,0,1,0,1,0
61114,445,0,0,drop,70,70,0,1,0,1,0
50521,80,1574,80,allow,454,262,192,8,25,5,3
65271,445,0,0,drop,66,66,0,1,0,1,0
57866,53,0,0,allow,216,80,136,2,30,1,1
56067,53,11884,53,allow,189,102,87,2,31,1,1
54642,445,0,0,drop,70,70,0,1,0,1,0
53980,36153,5182,36153,allow,258,70,188,4,7,2,2
52830,22114,0,0,deny,62,62,0,1,0,1,0
55166,445,0,0,drop,66,66,0,1,0,1,0
28064,36237,0,0,deny,62,62,0,1,0,1,0
64783,53,10599,53,allow,214,94,120,2,30,1,1
57306,53,11858,53,allow,170,87,83,2,31,1,1
57131,31061,0,0,deny,145,145,0,1,0,1,0
53251,443,19794,443,allow,5025,973,4052,19,66,10,9
43175,53,11498,53,allow,194,86,108,2,30,1,1
51222,445,0,0,drop,70,70,0,1,0,1,0
47910,7461,0,0,deny,60,60,0,1,0,1,0
61226,445,0,0,drop,66,66,0,1,0,1,0
55892,445,0,0,drop,70,70,0,1,0,1,0
4782,443,2792,443,allow,1191,692,499,12,39,7,5
55284,53,61340,53,allow,193,102,91,2,30,1,1
53752,443,21616,443,allow,499,425,74,4,0,3,1
46326,443,42575,443,allow,430,152,278,7,32,3,4
55751,53,8390,53,allow,216,94,122,2,30,1,1
49265,53,12727,53,allow,181,94,87,2,31,1,1
56716,443,64304,443,allow,8058,2038,6020,20,15,11,9
1815,22114,0,0,deny,66,66,0,1,0,1,0
22350,25174,0,0,deny,66,66,0,1,0,1,0
55539,57470,0,0,deny,66,66,0,1,0,1,0
53534,40960,13903,40960,allow,320,140,180,6,6,3,3
50149,80,2917,80,allow,11574,901,10673,20,46,11,9
60163,443,11476,443,allow,3041,1745,1296,28,3600,15,13
53575,1025,56604,1025,allow,70,70,0,2,8,2,0
64154,53,29072,53,allow,188,96,92,2,30,1,1
443,62514,0,0,deny,66,66,0,1,0,1,0
61041,443,15332,443,allow,77650,64697,12953,148,902,81,67
27005,32065,28721,32065,allow,877,126,751,2,31,1,1
47438,80,47438,80,allow,2886,1481,1405,10,15,6,4
14183,26467,0,0,deny,62,62,0,1,0,1,0
57024,445,0,0,drop,70,70,0,1,0,1,0
37569,443,25156,443,allow,499,425,74,4,0,3,1
57063,53,34748,53,allow,177,94,83,2,30,1,1
51689,4765,24946,4765,allow,66,66,0,1,5,1,0
53043,51050,0,0,deny,66,66,0,1,0,1,0
40386,443,23622,443,allow,600,156,444,8,25,2,6
60247,443,21929,443,allow,12256,5443,6813,33,437,18,15
53802,443,44070,443,allow,499,425,74,4,0,3,1
25457,25604,0,0,deny,62,62,0,1,0,1,0
62282,445,0,0,drop,70,70,0,1,0,1,0
56782,49135,47020,49135,allow,70,70,0,2,8,2,0
9487,443,35248,443,allow,5179,2934,2245,25,32,13,12
48470,80,20195,80,allow,959,544,415,11,315,6,5
55045,445,0,0,drop,70,70,0,1,0,1,0
64715,53,60812,53,allow,202,103,99,2,31,1,1
49939,445,0,0,drop,70,70,0,1,0,1,0
24560,25174,0,0,deny,62,62,0,1,0,1,0
54698,445,0,0,drop,70,70,0,1,0,1,0
45308,22114,0,0,deny,146,146,0,1,0,1,0
53462,443,47212,443,allow,6384,1091,5293,18,30,10,8
55675,53,21127,53,allow,198,102,96,2,30,1,1
52000,80,36562,80,allow,416,210,206,7,26,4,3
35608,443,39608,443,allow,5007,3053,1954,24,394,8,16
37567,443,17651,443,allow,499,425,74,4,0,3,1
51802,21555,33946,21555,allow,316,136,180,6,6,3,3
61278,56205,0,0,deny,66,66,0,1,0,1,0
51783,445,0,0,drop,66,66,0,1,0,1,0
3549,64147,0,0,deny,62,62,0,1,0,1,0
65058,445,0,0,drop,70,70,0,1,0,1,0
54648,445,0,0,drop,70,70,0,1,0,1,0
18876,44847,0,0,deny,66,66,0,1,0,1,0
54981,53,59429,53,allow,757,102,655,2,29,1,1
41213,25174,0,0,deny,62,62,0,1,0,1,0
51846,80,21384,80,allow,366,240,126,7,31,5,2
44847,42103,11973,42103,allow,502,150,352,2,1200,1,1
49823,53,45548,53,allow,202,103,99,2,31,1,1
44925,443,50958,443,allow,153,93,60,2,5,1,1
52526,445,0,0,drop,70,70,0,1,0,1,0
56307,52700,0,0,deny,66,66,0,1,0,1,0
51491,445,0,0,drop,66,66,0,1,0,1,0
49886,443,23328,443,allow,7488,1598,5890,25,50,13,12
56365,80,15105,80,allow,1636,699,937,10,15,5,5
49976,22114,0,0,deny,66,66,0,1,0,1,0
58715,445,0,0,drop,70,70,0,1,0,1,0
50601,443,53899,443,allow,5035,3194,1841,23,72,12,11
12232,18593,0,0,deny,139,139,0,1,0,1,0
58638,5900,58638,5900,allow,130,66,64,2,4,1,1
45846,443,47275,443,allow,2227,1018,1209,17,15,8,9
58446,445,0,0,drop,66,66,0,1,0,1,0
55997,445,0,0,drop,70,70,0,1,0,1,0
35579,443,65088,443,allow,13136,3596,9540,40,26,21,19
65262,445,0,0,drop,66,66,0,1,0,1,0
35811,443,26946,443,allow,13562,3104,10458,38,201,22,16
54160,443,65221,443,allow,9464,1751,7713,29,48,13,16
26884,37965,0,0,deny,66,66,0,1,0,1,0
58583,445,0,0,drop,66,66,0,1,0,1,0
1530,62413,0,0,deny,62,62,0,1,0,1,0
65287,53,18878,53,allow,180,94,86,2,31,1,1
32768,22,0,0,deny,60,60,0,1,0,1,0
56029,53,2806,53,allow,346,94,252,2,30,1,1
64283,37965,0,0,deny,74,74,0,1,0,1,0
20576,37965,0,0,deny,62,62,0,1,0,1,0
55620,53,11702,53,allow,177,94,83,2,29,1,1
41498,443,27057,443,allow,2733,1555,1178,22,275,11,11
49710,443,57720,443,allow,9772,1954,7818,23,130,12,11
443,60746,0,0,allow,60,60,0,1,90,1,0
56836,445,0,0,drop,70,70,0,1,0,1,0
54817,445,0,0,drop,66,66,0,1,0,1,0
15701,37965,0,0,deny,146,146,0,1,0,1,0
58915,445,0,0,drop,66,66,0,1,0,1,0
10003,40811,32278,40811,allow,292,158,134,2,30,1,1
64614,443,5122,443,allow,5505,3166,2339,22,136,11,11
64745,445,0,0,drop,66,66,0,1,0,1,0
29787,37965,0,0,deny,62,62,0,1,0,1,0
56163,53,27486,53,allow,188,96,92,2,31,1,1
64312,445,0,0,drop,66,66,0,1,0,1,0
63952,53,14655,53,allow,211,110,101,2,30,1,1
53505,8102,48744,8102,allow,1495,843,652,10,30,5,5
63015,445,0,0,drop,70,70,0,1,0,1,0
56216,53,58788,53,allow,177,94,83,2,30,1,1
50986,443,50781,443,allow,67798,17043,50755,202,146,110,92
37138,80,13348,80,allow,1658,1344,314,10,16,5,5
50106,31573,0,0,deny,66,66,0,1,0,1,0
63856,6881,6366,6881,allow,66,66,0,2,8,2,0
39888,53,65133,53,allow,168,78,90,2,30,1,1
51874,43161,26415,43161,allow,66,66,0,1,5,1,0
49654,53,26382,53,allow,184,94,90,2,30,1,1
49410,443,22106,443,allow,87590,6597,80993,129,125,48,81
2839,53,2839,53,allow,229,94,135,2,30,1,1
49544,53,31008,53,allow,226,86,140,2,30,1,1
65315,53,36671,53,allow,300,99,201,4,30,2,2
55340,53,25572,53,allow,324,110,214,2,29,1,1
56782,53,51399,53,allow,197,94,103,2,30,1,1
13285,29892,0,0,deny,145,145,0,1,0,1,0
58638,5900,0,0,deny,62,62,0,1,0,1,0
63964,60705,4477,60705,allow,312,132,180,6,7,3,3
55203,443,52613,443,allow,12947,4309,8638,29,152,15,14
63931,53,21564,53,allow,380,105,275,4,35,2,2
59937,37965,0,0,deny,66,66,0,1,0,1,0
65519,445,0,0,drop,66,66,0,1,0,1,0
22528,48817,0,0,deny,148,148,0,1,0,1,0
56672,53,64193,53,allow,177,94,83,2,30,1,1
62885,445,0,0,drop,70,70,0,1,0,1,0
57109,445,0,0,drop,66,66,0,1,0,1,0
11136,19910,0,0,deny,62,62,0,1,0,1,0
50482,445,0,0,drop,70,70,0,1,0,1,0
6881,6881,40398,6881,allow,238,118,120,2,1199,1,1
61202,35894,0,0,deny,66,66,0,1,0,1,0
39328,80,54036,80,allow,78,78,0,1,5,1,0
55871,53,26416,53,allow,181,94,87,2,29,1,1
61345,21247,0,0,deny,66,66,0,1,0,1,0
52842,445,0,0,drop,70,70,0,1,0,1,0
63899,62015,51023,62015,allow,70,70,0,1,4,1,0
37236,53,35776,53,allow,223,78,145,2,30,1,1
50287,53,45385,53,allow,177,94,83,2,30,1,1
54652,445,0,0,drop,66,66,0,1,0,1,0
50352,445,0,0,drop,70,70,0,1,0,1,0
49913,443,1275,443,allow,4275,2222,2053,24,15,14,10
60556,28678,33348,28678,allow,1806,1806,0,22,224,22,0
40432,443,35104,443,allow,12022,2731,9291,53,20,26,27
62243,445,0,0,drop,70,70,0,1,0,1,0
63582,443,11318,443,allow,6178,1669,4509,19,15,11,8
55238,53,10880,53,allow,168,86,82,2,30,1,1
49300,445,0,0,drop,66,66,0,1,0,1,0
27005,27017,42100,27017,allow,891,126,765,2,30,1,1
64849,53,44145,53,allow,216,102,114,2,29,1,1
51821,443,38521,443,allow,3002,258,2744,9,119,4,5
49864,53,57559,53,allow,193,102,91,2,30,1,1
10003,64147,0,0,deny,62,62,0,1,0,1,0
56624,53,40354,53,allow,199,102,97,2,29,1,1
56037,53,29985,53,allow,168,94,74,2,31,1,1
61471,443,26685,443,allow,18168,2973,15195,46,88,21,25
64962,53,48454,53,allow,226,94,132,2,30,1,1
51974,80,51357,80,allow,426,240,186,8,25,5,3
41031,80,41031,80,allow,2791,1259,1532,13,125,7,6
56744,53,53021,53,allow,274,110,164,2,30,1,1
55204,445,0,0,drop,70,70,0,1,0,1,0
50943,445,0,0,drop,70,70,0,1,0,1,0
9377,80,44297,80,allow,1643,485,1158,10,15,5,5
56979,80,46084,80,allow,214,140,74,4,35,3,1
24931,25174,0,0,deny,62,62,0,1,0,1,0
55079,25174,0,0,deny,66,66,0,1,0,1,0
52354,443,50559,443,allow,10417,5338,5079,22,135,11,11
59926,80,37542,80,allow,2615,830,1785,10,32,6,4
57008,53,37986,53,allow,255,110,145,2,30,1,1
39061,22114,0,0,deny,146,146,0,1,0,1,0
60929,28678,34471,28678,allow,1806,1806,0,22,224,22,0
56596,53,55954,53,allow,199,102,97,2,29,1,1
50681,445,0,0,drop,70,70,0,1,0,1,0
20586,25174,0,0,deny,62,62,0,1,0,1,0
64316,53,46275,53,allow,184,94,90,2,31,1,1
57196,445,0,0,drop,70,70,0,1,0,1,0
64413,445,0,0,drop,70,70,0,1,0,1,0
36499,443,51972,443,allow,1159756,1123031,36725,1206,26,753,453
63080,37965,0,0,deny,66,66,0,1,0,1,0
59117,445,0,0,drop,70,70,0,1,0,1,0
57201,53,17693,53,allow,195,102,93,2,31,1,1
45941,23386,0,0,deny,60,60,0,1,0,1,0
41098,80,34310,80,allow,1937,1193,744,12,16,7,5
55659,37787,47813,37787,allow,70,70,0,2,8,2,0
62916,993,58185,993,allow,8832,3647,5185,77,41,35,42
52973,57470,0,0,deny,74,74,0,1,0,1,0
49272,53,25138,53,allow,168,86,82,3,44,2,1
48204,443,48204,443,allow,4743,1836,2907,19,26,11,8
53779,445,0,0,drop,66,66,0,1,0,1,0
61845,445,0,0,drop,70,70,0,1,0,1,0
53173,25067,13422,25067,allow,70,70,0,2,8,2,0
54401,443,33851,443,allow,11527127,373718,11153409,12286,144,4090,8196
49328,443,48321,443,allow,77821,4380,73441,82,53,23,59
65366,53,44706,53,allow,458,188,270,6,31,3,3
49173,80,62950,80,allow,254,128,126,5,15,3,2
57903,443,52416,443,allow,5465,2653,2812,28,169,14,14
11295,40033,17184,40033,allow,156,94,62,2,30,1,1
50867,443,9876,443,allow,2782,1480,1302,17,15,9,8
51491,443,61886,443,allow,343,163,180,6,15,3,3
57497,445,0,0,drop,66,66,0,1,0,1,0
59732,443,44274,443,allow,34866,3347,31519,55,54,22,33
49366,443,23124,443,allow,14668,3601,11067,34,19,19,15
61352,443,38180,443,allow,14131,5620,8511,38,216,20,18
53863,443,64176,443,allow,13492,3615,9877,42,120,20,22
58638,5900,0,0,deny,62,62,0,1,0,1,0
55563,53,47396,53,allow,177,94,83,2,29,1,1
56720,443,57174,443,allow,7941,1952,5989,20,15,11,9
60786,25174,0,0,deny,66,66,0,1,0,1,0
9394,443,24044,443,allow,3613,433,3180,11,15,6,5
56849,23745,4233,23745,allow,70,70,0,2,8,2,0
49913,53,6290,53,allow,216,110,106,2,30,1,1
61373,445,0,0,drop,66,66,0,1,0,1,0
57265,443,12728,443,allow,9633,4368,5265,32,71,18,14
55510,53,10819,53,allow,578,286,292,9,15,5,4
56535,443,1772,443,allow,185925,12445,173480,210,105,82,128
0,0,0,0,allow,480,244,236,4,0,2,2
61892,445,0,0,drop,70,70,0,1,0,1,0
26502,64147,0,0,deny,62,62,0,1,0,1,0
47500,443,47942,443,allow,7464,2375,5089,15,120,7,8
54218,445,0,0,drop,66,66,0,1,0,1,0
7041,37965,0,0,deny,66,66,0,1,0,1,0
59601,443,24962,443,allow,162,102,60,2,5,1,1
60191,53,31189,53,allow,196,94,102,2,31,1,1
12605,57470,0,0,deny,62,62,0,1,0,1,0
11552,44847,0,0,deny,62,62,0,1,0,1,0
59696,445,0,0,drop,70,70,0,1,0,1,0
0,0,0,0,allow,156,156,0,2,0,2,0
57351,53,48672,53,allow,184,94,90,2,29,1,1
64266,53,43619,53,allow,168,86,82,2,30,1,1
42298,40014,10112,40014,allow,140,78,62,2,31,1,1
51014,445,0,0,drop,66,66,0,1,0,1,0
62431,445,0,0,drop,70,70,0,1,0,1,0
64559,53,24538,53,allow,182,94,88,2,30,1,1
50899,445,0,0,drop,70,70,0,1,0,1,0
56495,53,40690,53,allow,199,102,97,2,30,1,1
59541,445,0,0,drop,70,70,0,1,0,1,0
56893,53,37100,53,allow,170,87,83,2,31,1,1
56636,43890,0,0,deny,66,66,0,1,0,1,0
64781,445,0,0,drop,70,70,0,1,0,1,0
57355,445,0,0,drop,70,70,0,1,0,1,0
50688,80,50688,80,allow,167293,8028,159265,186,26,68,118
62637,42873,0,0,deny,66,66,0,1,0,1,0
55919,445,0,0,drop,66,66,0,1,0,1,0
62311,443,64602,443,allow,598,598,0,8,41,8,0
45941,23386,0,0,deny,60,60,0,1,0,1,0
43671,37965,0,0,deny,62,62,0,1,0,1,0
15701,37965,0,0,deny,146,146,0,1,0,1,0
51743,64147,0,0,deny,62,62,0,1,0,1,0
49908,445,0,0,drop,70,70,0,1,0,1,0
45409,80,10508,80,allow,1155,781,374,10,15,6,4
55539,53,7321,53,allow,814,110,704,2,30,1,1
64966,27051,35392,27051,allow,736,462,274,2,30,1,1
59834,445,0,0,drop,70,70,0,1,0,1,0
26900,27017,60170,27017,allow,422,164,258,6,30,3,3
64449,30188,0,0,deny,66,66,0,1,0,1,0
55820,53,22468,53,allow,184,94,90,2,29,1,1
19747,37965,0,0,deny,62,62,0,1,0,1,0
49256,53,62875,53,allow,179,94,85,2,30,1,1
57188,53,2618,53,allow,744,89,655,2,30,1,1
57821,445,0,0,drop,66,66,0,1,0,1,0
58349,445,0,0,drop,70,70,0,1,0,1,0
57547,445,0,0,drop,66,66,0,1,0,1,0
50570,57470,0,0,deny,66,66,0,1,0,1,0
27005,27017,4986,27017,allow,881,126,755,2,30,1,1
47652,443,53871,443,allow,1058,571,487,10,24,6,4
57073,57470,0,0,deny,62,62,0,1,0,1,0
55272,53,54690,53,allow,198,110,88,2,29,1,1
58276,43890,0,0,deny,66,66,0,1,0,1,0
33003,28543,0,0,deny,62,62,0,1,0,1,0
58172,443,58172,443,allow,4526,1619,2907,19,26,11,8
41772,80,18406,80,allow,738,70,668,12,394,2,10
42892,443,39711,443,allow,448,78,370,6,25,1,5
52321,26467,0,0,deny,62,62,0,1,0,1,0
50176,445,0,0,drop,70,70,0,1,0,1,0
37066,443,21003,443,allow,2386,1423,963,18,169,10,8
10344,80,10344,80,allow,6705,702,6003,13,16,6,7
55462,53,41879,53,allow,194,102,92,2,33,1,1
48483,443,20913,443,allow,60944,9555,51389,71,362,25,46
61804,51505,0,0,deny,66,66,0,1,0,1,0
50691,445,0,0,drop,66,66,0,1,0,1,0
51693,22114,0,0,deny,62,62,0,1,0,1,0
63962,445,0,0,drop,66,66,0,1,0,1,0
56816,11392,0,0,deny,62,62,0,1,0,1,0
53942,28921,35066,28921,allow,320,140,180,6,6,3,3
45837,25174,0,0,deny,146,146,0,1,0,1,0
58034,445,0,0,drop,70,70,0,1,0,1,0
30580,50265,0,0,deny,66,66,0,1,0,1,0
39293,443,5290,443,allow,70,70,0,1,4,1,0
34154,443,26311,443,allow,6107,2012,4095,18,25,10,8
53165,443,53165,443,allow,208,66,142,4,148,2,2
49580,53,43364,53,allow,782,110,672,2,30,1,1
42469,30188,0,0,deny,62,62,0,1,0,1,0
53437,443,53437,443,allow,4198,2498,1700,25,102,12,13
39323,443,25500,443,allow,1394,733,661,14,81,8,6
58638,5900,0,0,deny,62,62,0,1,0,1,0
59504,445,0,0,drop,70,70,0,1,0,1,0
1658,443,1658,443,allow,12030,1282,10748,23,17,9,14
35261,15503,0,0,deny,74,74,0,1,0,1,0
59340,80,59340,80,allow,24437,12718,11719,41,15,16,25
60104,30188,0,0,deny,62,62,0,1,0,1,0
51195,443,30169,443,allow,291595,261981,29614,587,206,339,248
56691,445,0,0,drop,66,66,0,1,0,1,0
35905,443,10061,443,allow,8272,2091,6181,25,331,12,13
62690,445,0,0,drop,70,70,0,1,0,1,0
57424,53,20131,53,allow,170,87,83,2,31,1,1
50604,80,50604,80,allow,1707,1007,700,11,21,6,5
53374,445,0,0,drop,70,70,0,1,0,1,0
56566,443,19189,443,allow,343737,9198,334539,348,80,121,227
50485,443,22667,443,allow,6028,2012,4016,25,16,14,11
56258,445,0,0,drop,66,66,0,1,0,1,0
56810,53,54787,53,allow,170,87,83,2,31,1,1
57262,443,38202,443,allow,43771,18333,25438,105,126,49,56
55604,445,0,0,drop,66,66,0,1,0,1,0
64824,443,53612,443,allow,2442,356,2086,12,120,5,7
47423,80,58553,80,allow,1056,682,374,10,15,6,4
49393,30188,0,0,deny,62,62,0,1,0,1,0
61625,445,0,0,drop,70,70,0,1,0,1,0
51819,80,5456,80,allow,5368,946,4422,16,77,9,7
56143,53,11476,53,allow,214,94,120,2,30,1,1
54800,443,4050,443,allow,9612,4324,5288,31,400,11,20
57296,53,27311,53,allow,771,101,670,2,30,1,1
56799,1,48991,1,allow,316,136,180,6,6,3,3
53807,445,0,0,drop,70,70,0,1,0,1,0
57435,53,43686,53,allow,184,102,82,2,30,1,1
50288,445,0,0,drop,66,66,0,1,0,1,0
49767,445,0,0,drop,70,70,0,1,0,1,0
55959,53,27240,53,allow,216,102,114,2,29,1,1
63994,47013,54250,47013,allow,66,66,0,2,8,2,0
49384,445,0,0,drop,66,66,0,1,0,1,0
49720,443,3612,443,allow,180777,5704,175073,204,105,67,137
53662,55043,16806,55043,allow,320,140,180,6,6,3,3
50578,80,29631,80,allow,1791,900,891,14,79,7,7
62338,50011,0,0,deny,66,66,0,1,0,1,0
63397,26467,0,0,deny,66,66,0,1,0,1,0
55024,445,0,0,drop,70,70,0,1,0,1,0
10416,64147,0,0,deny,62,62,0,1,0,1,0
45941,23388,0,0,deny,60,60,0,1,0,1,0
63170,445,0,0,drop,70,70,0,1,0,1,0
49369,53,12483,53,allow,168,86,82,2,31,1,1
443,48346,0,0,deny,81,81,0,1,0,1,0
58440,22114,0,0,deny,146,146,0,1,0,1,0
57163,53,34170,53,allow,209,110,99,2,30,1,1
51295,445,0,0,drop,66,66,0,1,0,1,0
49526,53,35749,53,allow,272,97,175,4,58,2,2
2434,443,2434,443,allow,8209,1695,6514,21,23,13,8
65259,37965,0,0,deny,66,66,0,1,0,1,0
54024,445,0,0,drop,70,70,0,1,0,1,0
64776,50584,0,0,deny,66,66,0,1,0,1,0
60060,22,60060,22,allow,7974,3469,4505,57,40,28,29
57512,80,20735,80,allow,1377,881,496,12,48,7,5
56991,443,28802,443,allow,20986,10828,10158,35,95,20,15
55838,443,19179,443,allow,7034,2039,4995,37,255,18,19
55786,53,21732,53,allow,170,87,83,2,30,1,1
65265,3389,65265,3389,allow,4213,2429,1784,18,31,9,9
59361,445,0,0,drop,70,70,0,1,0,1,0
54551,445,0,0,drop,66,66,0,1,0,1,0
7000,23117,0,0,deny,66,66,0,1,0,1,0
55088,53,52692,53,allow,170,87,83,2,31,1,1
45461,25174,0,0,deny,146,146,0,1,0,1,0
64092,445,0,0,drop,70,70,0,1,0,1,0
49546,443,43053,443,allow,1346,918,428,10,23,6,4
59112,443,3834,443,allow,7174,1831,5343,31,110,17,14
49331,53,35223,53,allow,182,94,88,2,30,1,1
47783,50432,0,0,deny,62,62,0,1,0,1,0
50385,445,0,0,drop,70,70,0,1,0,1,0
24812,44847,0,0,deny,146,146,0,1,0,1,0
49880,443,51797,443,allow,1087632,32231,1055401,1112,53,334,778
38667,443,44334,443,allow,496852,12216,484636,499,16,167,332
53308,445,0,0,drop,70,70,0,1,0,1,0
6881,38554,27434,38554,allow,221,111,110,2,1200,1,1
61302,445,0,0,drop,70,70,0,1,0,1,0
15806,11392,0,0,deny,66,66,0,1,0,1,0
53206,445,0,0,drop,70,70,0,1,0,1,0
58959,53,45652,53,allow,307,86,221,2,30,1,1
64320,53,48665,53,allow,199,102,97,2,30,1,1
65424,53,57166,53,allow,210,110,100,2,29,1,1
56873,53,25069,53,allow,184,94,90,2,30,1,1
52860,9694,0,0,deny,146,146,0,1,0,1,0
59855,445,0,0,drop,66,66,0,1,0,1,0
44466,443,54385,443,allow,466,392,74,4,0,3,1
50326,80,17692,80,allow,7979,802,7177,17,47,8,9
27005,27025,44976,27025,allow,893,126,767,2,30,1,1
49514,39127,0,0,deny,162,162,0,1,0,1,0
63240,443,14470,443,allow,1433,734,699,18,125,10,8
56248,53,47475,53,allow,767,102,665,2,30,1,1
1100,27540,2700,27540,allow,132,70,62,2,31,1,1
50999,443,57620,443,allow,6765,1108,5657,17,18,10,7
59673,445,0,0,drop,66,66,0,1,0,1,0
59784,443,16677,443,allow,6698,1606,5092,23,19,13,10
49195,8108,53972,8108,allow,70,70,0,1,5,1,0
58638,5900,0,0,deny,62,62,0,1,0,1,0
55407,53,58404,53,allow,195,94,101,2,30,1,1
65287,53,9876,53,allow,176,90,86,2,31,1,1
42238,25174,0,0,deny,66,66,0,1,0,1,0
54163,443,60868,443,allow,2430,1416,1014,18,34,9,9
21133,39263,6580,39263,allow,323,150,173,2,1200,1,1
59871,445,0,0,drop,66,66,0,1,0,1,0
44915,443,17055,443,allow,23886,6994,16892,26,129,12,14
51812,1433,0,0,deny,60,60,0,1,0,1,0
58704,80,26628,80,allow,4115,3452,663,13,15,7,6
49293,53,58522,53,allow,172,88,84,2,31,1,1
56671,80,31736,80,allow,234,234,0,4,12,4,0
61241,22114,0,0,deny,66,66,0,1,0,1,0
55064,53,40731,53,allow,774,101,673,2,31,1,1
54995,53,9641,53,allow,199,102,97,2,30,1,1
49172,445,0,0,drop,66,66,0,1,0,1,0
50935,80,3414,80,allow,8167195,108448,8058747,7107,121,1531,5576
65439,53,55852,53,allow,751,95,656,2,31,1,1
39785,443,37102,443,allow,7967,2261,5706,18,121,8,10
62806,445,0,0,drop,70,70,0,1,0,1,0
64930,53,64696,53,allow,186,95,91,2,31,1,1
56955,53,2081,53,allow,182,93,89,2,31,1,1
65449,53,25371,53,allow,170,87,83,2,31,1,1
63287,44847,0,0,deny,62,62,0,1,0,1,0
64939,53,4454,53,allow,199,94,105,2,29,1,1
53906,17372,0,0,deny,145,145,0,1,0,1,0
59487,443,5005,443,allow,8702,580,8122,17,53,5,12
3541,22114,0,0,deny,62,62,0,1,0,1,0
58638,5900,0,0,deny,62,62,0,1,0,1,0
65224,53,24023,53,allow,994,86,908,2,31,1,1
50280,57470,0,0,deny,78,78,0,1,0,1,0
54159,443,5303,443,allow,10945,2478,8467,39,18,19,20
14255,2767,0,0,deny,62,62,0,1,0,1,0
59563,30188,0,0,deny,66,66,0,1,0,1,0
60132,443,39833,443,allow,350,210,140,6,25,4,2
52696,445,0,0,drop,70,70,0,1,0,1,0
1384,44847,0,0,deny,66,66,0,1,0,1,0
52096,443,12292,443,allow,86745,6260,80485,121,32,58,63
42298,40023,18406,40023,allow,1487,743,744,10,30,5,5
49546,53,28213,53,allow,212,110,102,2,30,1,1
40301,8696,0,0,deny,60,60,0,1,0,1,0
44739,443,37697,443,allow,6220,1790,4430,19,120,10,9
50668,58833,0,0,deny,62,62,0,1,0,1,0
48706,23393,0,0,deny,60,60,0,1,0,1,0
52517,80,63047,80,allow,4297,3719,578,14,15,8,6
64366,443,7841,443,allow,6205,1316,4889,27,301,14,13
53294,443,27871,443,allow,7740,4267,3473,39,97,21,18
49418,27018,36116,27018,allow,256,78,178,2,30,1,1
63915,445,0,0,drop,70,70,0,1,0,1,0
65105,80,65105,80,allow,23382,3770,19612,48,45,24,24
56854,17067,27330,17067,allow,70,70,0,1,5,1,0
42484,443,62904,443,allow,79507,72433,7074,96,415,60,36
27005,27015,14590,27015,allow,901,126,775,2,30,1,1
49711,443,12474,443,allow,18088,1844,16244,34,130,14,20
49889,53,4477,53,allow,338,110,228,2,30,1,1
39743,80,10677,80,allow,1563,570,993,10,16,6,4
61207,445,0,0,drop,70,70,0,1,0,1,0
51398,53,51398,53,allow,197,90,107,2,30,1,1
54280,3359,0,0,deny,60,60,0,1,0,1,0
56857,53,39377,53,allow,195,102,93,2,30,1,1
58173,993,62958,993,allow,430,60,370,7,24,2,5
27988,40027,35628,40027,allow,140,78,62,2,30,1,1
56945,80,24790,80,allow,214,140,74,4,30,3,1
3875,25174,0,0,deny,62,62,0,1,0,1,0
54109,36829,0,0,deny,62,62,0,1,0,1,0
65453,445,0,0,drop,70,70,0,1,0,1,0
62115,57470,0,0,deny,66,66,0,1,0,1,0
56167,53,4828,53,allow,178,94,84,2,30,1,1
53375,443,59892,443,allow,4317,1134,3183,16,26,9,7
60036,53,52040,53,allow,86,86,0,1,30,1,0
51837,37965,0,0,deny,66,66,0,1,0,1,0
36887,443,63451,443,allow,10922,2532,8390,27,28,13,14
65415,443,12568,443,allow,2494,1643,851,17,26,9,8
56863,80,39475,80,allow,13608,783,12825,21,45,9,12
60332,443,37835,443,allow,5413,3344,2069,32,87,16,16
49216,53,26832,53,allow,401,142,259,2,30,1,1
49001,40108,0,0,deny,161,161,0,1,0,1,0
36538,64147,0,0,deny,62,62,0,1,0,1,0
58638,5900,0,0,deny,62,62,0,1,0,1,0
62619,445,0,0,drop,66,66,0,1,0,1,0
55354,53,28658,53,allow,168,94,74,2,30,1,1
49807,443,23954,443,allow,2796,1730,1066,15,126,9,6
39677,443,47798,443,allow,7123,1331,5792,22,81,11,11
64835,445,0,0,drop,66,66,0,1,0,1,0
44791,443,29863,443,allow,3181,1647,1534,18,31,10,8
59543,443,39979,443,allow,7358,2661,4697,22,17,11,11
65194,53,9315,53,allow,265,91,174,4,36,2,2
53526,445,0,0,drop,70,70,0,1,0,1,0
65104,53,20417,53,allow,198,94,104,2,30,1,1
50708,445,0,0,drop,66,66,0,1,0,1,0
55341,445,0,0,drop,66,66,0,1,0,1,0
23379,57866,0,0,deny,146,146,0,1,0,1,0
32704,46824,0,0,deny,66,66,0,1,0,1,0
58739,443,43331,443,allow,22751,17995,4756,67,73,42,25
53539,44847,0,0,deny,66,66,0,1,0,1,0
25600,23684,0,0,deny,159,159,0,1,0,1,0
64801,7000,64801,7000,allow,2269,815,1454,14,15,7,7
46763,443,11187,443,allow,11876848,256539,11620309,11266,74,3584,7682
60123,445,0,0,drop,70,70,0,1,0,1,0
54181,443,63427,443,allow,9283,2154,7129,22,15,12,10
63741,50584,0,0,deny,66,66,0,1,0,1,0
58744,443,37896,443,allow,42954,12409,30545,154,319,67,87
57867,27019,59183,27019,allow,802,472,330,8,30,5,3
61338,443,62752,443,allow,39067,7713,31354,74,247,29,45
55735,53,65479,53,allow,184,94,90,2,31,1,1
27144,25174,0,0,deny,66,66,0,1,0,1,0
55324,445,0,0,drop,70,70,0,1,0,1,0
56353,53,32385,53,allow,216,102,114,2,29,1,1
54252,445,0,0,drop,70,70,0,1,0,1,0
64139,445,0,0,drop,70,70,0,1,0,1,0
14397,37965,0,0,deny,62,62,0,1,0,1,0
51096,63710,0,0,deny,66,66,0,1,0,1,0
55116,7574,0,0,deny,66,66,0,1,0,1,0
27005,27015,5411,27015,allow,887,126,761,2,30,1,1
42385,443,44650,443,allow,26481,1832,24649,40,330,18,22
62714,445,0,0,drop,70,70,0,1,0,1,0
55027,443,27203,443,allow,17167,5192,11975,32,121,17,15
50599,80,50599,80,allow,4228,3295,933,17,19,9,8
9708,53,0,0,allow,304,94,210,2,30,1,1
64546,57470,0,0,deny,66,66,0,1,0,1,0
64138,445,0,0,deny,70,70,0,1,0,1,0
1108,47807,0,0,deny,159,159,0,1,0,1,0
56379,53,59317,53,allow,166,86,80,2,30,1,1
60244,445,0,0,drop,70,70,0,1,0,1,0
26531,37965,0,0,deny,62,62,0,1,0,1,0
50430,80,29932,80,allow,318,192,126,6,26,4,2
49907,53,52196,53,allow,199,102,97,2,30,1,1
43817,53,43817,53,allow,203,82,121,2,30,1,1
59141,445,0,0,drop,66,66,0,1,0,1,0
43920,443,54926,443,allow,12666,4180,8486,37,504,20,17
3478,61463,0,0,deny,68,68,0,1,0,1,0
35486,443,63942,443,allow,4630,2803,1827,29,80,14,15
50334,53,27323,53,allow,216,110,106,2,29,1,1
56646,80,51204,80,allow,234,234,0,4,12,4,0
60584,445,0,0,drop,66,66,0,1,0,1,0
59281,80,59281,80,allow,108922,4633,104289,194,16,66,128
25237,25174,0,0,deny,62,62,0,1,0,1,0
56419,53,45684,53,allow,199,102,97,2,30,1,1
56959,80,53934,80,allow,15752,5736,10016,28,30,14,14
59166,445,0,0,drop,70,70,0,1,0,1,0
50605,80,49790,80,allow,1657,1247,410,8,15,5,3
53482,53,51944,53,allow,168,78,90,2,30,1,1
50171,53,22623,53,allow,211,78,133,2,30,1,1
52453,443,8871,443,allow,6650,950,5700,18,75,9,9
52138,445,0,0,drop,66,66,0,1,0,1,0
51427,80,51427,80,allow,22364,4125,18239,41,26,19,22
57298,8765,45553,8765,allow,2466,1350,1116,37,569,19,18
42889,443,3091,443,allow,3961,1595,2366,21,15,12,9
48839,37807,0,0,deny,146,146,0,1,0,1,0
65346,53,64945,53,allow,183,94,89,2,30,1,1
56765,53,28041,53,allow,194,102,92,2,30,1,1
53517,48019,30847,48019,allow,70,70,0,1,4,1,0
55935,445,0,0,drop,66,66,0,1,0,1,0
56205,51505,0,0,deny,66,66,0,1,0,1,0
5227,50584,0,0,deny,62,62,0,1,0,1,0
16522,26467,0,0,deny,66,66,0,1,0,1,0
35985,443,7017,443,allow,6250,1312,4938,23,28,12,11
57329,445,0,0,drop,70,70,0,1,0,1,0
55422,445,0,0,drop,70,70,0,1,0,1,0
57207,53,1251,53,allow,195,102,93,2,30,1,1
40898,5555,0,0,deny,60,60,0,1,0,1,0
54539,80,58817,80,allow,4162,3455,707,14,15,8,6
51818,37965,0,0,deny,66,66,0,1,0,1,0
57914,443,40977,443,allow,17285,4005,13280,26,120,11,15
64708,53,55981,53,allow,294,134,160,2,30,1,1
55439,53,11568,53,allow,177,94,83,2,30,1,1
59610,53,54271,53,allow,191,78,113,2,30,1,1
49199,445,0,0,drop,66,66,0,1,0,1,0
51970,18752,54925,18752,allow,70,70,0,2,8,2,0
53118,56839,2314,56839,allow,70,70,0,1,4,1,0
55732,53,61011,53,allow,194,102,92,2,30,1,1
49636,443,58848,443,allow,9790,1841,7949,24,136,12,12
45493,5223,26430,5223,allow,4196,1378,2818,21,3002,12,9
51940,26399,39116,26399,allow,70,70,0,2,8,2,0
49467,445,0,0,drop,70,70,0,1,0,1,0
64005,53,59576,53,allow,402,125,277,4,37,2,2
64448,53,46885,53,allow,353,92,261,4,38,2,2
53151,445,0,0,drop,66,66,0,1,0,1,0
43747,22114,0,0,deny,62,62,0,1,0,1,0
42222,53,45931,53,allow,209,86,123,2,30,1,1
46285,443,47233,443,allow,40877,5947,34930,81,56,39,42
55534,53,27868,53,allow,168,86,82,2,29,1,1
26528,51221,0,0,deny,78,78,0,1,0,1,0
52198,12727,17212,12727,allow,70,70,0,1,5,1,0
57538,30188,0,0,deny,66,66,0,1,0,1,0
6824,26467,0,0,deny,62,62,0,1,0,1,0
64540,53,44077,53,allow,352,107,245,4,37,2,2
49611,53,14406,53,allow,184,94,90,2,30,1,1
57470,22838,37190,22838,allow,481,150,331,2,1199,1,1
55404,445,0,0,drop,70,70,0,1,0,1,0
64890,51180,0,0,deny,66,66,0,1,0,1,0
64286,445,0,0,drop,70,70,0,1,0,1,0
64401,53,5392,53,allow,293,94,199,2,30,1,1
65045,53,53307,53,allow,194,99,95,2,30,1,1
16092,50265,0,0,deny,62,62,0,1,0,1,0
55157,7302,0,0,deny,66,66,0,1,0,1,0
64846,53,55957,53,allow,785,110,675,2,30,1,1
50883,80,50883,80,allow,514,246,268,9,42,5,4
49992,5900,0,0,deny,60,60,0,1,0,1,0
58638,5900,0,0,deny,62,62,0,1,0,1,0
53832,56005,63005,56005,allow,70,70,0,1,4,1,0
49617,80,31416,80,allow,314,192,122,6,42,4,2
57558,443,4202,443,allow,42986,7555,35431,69,125,29,40
41632,443,12669,443,allow,7670,2131,5539,30,27,15,15
54189,22114,0,0,deny,66,66,0,1,0,1,0
63042,445,0,0,drop,70,70,0,1,0,1,0
59591,445,0,0,drop,70,70,0,1,0,1,0
60460,54233,13899,54233,allow,70,70,0,1,5,1,0
10371,53,10371,53,allow,404,259,145,3,33,2,1
56942,53,38411,53,allow,177,94,83,2,30,1,1
49168,53,25368,53,allow,196,102,94,2,30,1,1
57583,445,0,0,drop,70,70,0,1,0,1,0
60361,57470,0,0,deny,62,62,0,1,0,1,0
50584,443,50316,443,allow,36457,2308,34149,52,98,23,29
54769,80,54769,80,allow,23168,3380,19788,36,19,18,18
51932,443,23132,443,allow,3207,2430,777,21,26,11,10
34358,80,63755,80,allow,350,210,140,6,16,4,2
64657,53,3237,53,allow,193,102,91,2,30,1,1
57339,50584,0,0,deny,66,66,0,1,0,1,0
17280,22114,0,0,deny,146,146,0,1,0,1,0
64964,27035,57797,27035,allow,996,462,534,4,31,2,2
53762,9587,5160,9587,allow,70,70,0,1,4,1,0
51910,37965,0,0,deny,62,62,0,1,0,1,0
59967,445,0,0,drop,70,70,0,1,0,1,0
51934,36180,0,0,deny,66,66,0,1,0,1,0
63475,445,0,0,drop,70,70,0,1,0,1,0
52245,443,44464,443,allow,7488,2474,5014,23,3600,12,11
49372,53,58789,53,allow,216,110,106,2,30,1,1
49339,443,48962,443,allow,3191,2313,878,17,42,10,7
60964,443,25466,443,allow,2080,1376,704,17,30,9,8
59580,443,31817,443,allow,10200,2180,8020,26,19,15,11
51921,37744,34923,37744,allow,70,70,0,1,5,1,0
1934,53,51604,53,allow,210,78,132,2,30,1,1
63510,445,0,0,drop,70,70,0,1,0,1,0
55930,445,0,0,drop,70,70,0,1,0,1,0
50445,443,50834,443,allow,14431,2090,12341,42,142,20,22
44919,26467,0,0,deny,62,62,0,1,0,1,0
64719,53,54824,53,allow,196,102,94,2,30,1,1
35756,80,35756,80,allow,364170,17670,346500,412,31,170,242
1943,48817,0,0,deny,66,66,0,1,0,1,0
58638,5900,0,0,deny,62,62,0,1,0,1,0
51633,80,4651,80,allow,502,256,246,9,39,5,4
63578,35440,0,0,deny,62,62,0,1,0,1,0
55739,443,29426,443,allow,10875114,348643,10526471,11702,194,3853,7849
44503,1433,44503,1433,allow,150,60,90,2,9,1,1
10627,23117,0,0,deny,66,66,0,1,0,1,0
49522,80,55749,80,allow,6908,1652,5256,26,225,12,14
58638,5900,0,0,deny,62,62,0,1,0,1,0
19204,56448,0,0,deny,78,78,0,1,0,1,0
54262,445,0,0,drop,66,66,0,1,0,1,0
49658,443,46695,443,allow,11880,2839,9041,30,48,16,14
56652,445,0,0,drop,70,70,0,1,0,1,0
49210,53,34070,53,allow,182,93,89,2,31,1,1
49996,443,63041,443,allow,19523,5346,14177,37,87,17,20
57344,53,65328,53,allow,177,94,83,2,30,1,1
56320,53,39261,53,allow,182,93,89,2,31,1,1
65140,53,14760,53,allow,752,110,642,2,30,1,1
62197,443,16977,443,allow,3937,1210,2727,18,134,8,10
64089,20260,49240,20260,allow,66,66,0,2,8,2,0
35217,443,22630,443,allow,4113,2625,1488,25,79,13,12
49273,53,17508,53,allow,342,110,232,2,30,1,1
49965,445,0,0,drop,70,70,0,1,0,1,0
55749,37965,0,0,deny,66,66,0,1,0,1,0
51824,443,65512,443,allow,10841,6594,4247,75,585,37,38
59808,443,39380,443,allow,23950,2135,21815,43,35,16,27
64535,53,33577,53,allow,734,86,648,2,31,1,1
33706,23,0,0,deny,60,60,0,1,0,1,0
64167,445,0,0,drop,66,66,0,1,0,1,0
55417,53,40418,53,allow,179,94,85,2,30,1,1
57986,80,48652,80,allow,1056,682,374,10,15,6,4
63113,445,0,0,drop,70,70,0,1,0,1,0
53123,445,0,0,drop,70,70,0,1,0,1,0
6881,6881,0,0,deny,146,146,0,1,0,1,0
56336,53,34970,53,allow,178,94,84,2,29,1,1
53004,443,34423,443,allow,18064,5135,12929,108,95,44,64
16387,16862,0,0,deny,60,60,0,1,0,1,0
35506,80,16634,80,allow,120,60,60,3,3600,2,1
58638,5900,0,0,deny,62,62,0,1,0,1,0
25565,54864,0,0,deny,60,60,0,1,0,1,0
65082,53,43263,53,allow,183,94,89,2,30,1,1
19678,36237,0,0,deny,146,146,0,1,0,1,0
55826,42771,0,0,deny,62,62,0,1,0,1,0
12694,12446,0,0,deny,62,62,0,1,0,1,0
54965,80,28312,80,allow,3419,2046,1373,12,515,7,5
62833,445,0,0,drop,70,70,0,1,0,1,0
18657,53,18657,53,allow,295,90,205,2,29,1,1
49456,53,27659,53,allow,360,110,250,2,29,1,1
65374,445,0,0,drop,70,70,0,1,0,1,0
64030,445,0,0,drop,70,70,0,1,0,1,0
37526,443,48276,443,allow,10637,4761,5876,30,145,17,13
49993,37965,0,0,deny,66,66,0,1,0,1,0
50402,80,18324,80,allow,5981,3589,2392,15,32,8,7
50278,443,46463,443,allow,6466,2862,3604,21,163,11,10
50282,443,64648,443,allow,15775,3795,11980,48,18,32,16
55452,445,0,0,drop,70,70,0,1,0,1,0
3875,25174,0,0,deny,146,146,0,1,0,1,0
50502,445,0,0,drop,66,66,0,1,0,1,0
64780,445,0,0,drop,70,70,0,1,0,1,0
59315,445,0,0,drop,70,70,0,1,0,1,0
27005,27222,42780,27222,allow,890,126,764,2,30,1,1
19875,30170,0,0,deny,145,145,0,1,0,1,0
61616,23,0,0,deny,60,60,0,1,0,1,0
57141,445,0,0,drop,70,70,0,1,0,1,0
36406,5228,24879,5228,allow,17762,4403,13359,92,616,47,45
55312,53,37351,53,allow,195,102,93,2,29,1,1
64204,53,37090,53,allow,193,102,91,2,31,1,1
33243,443,33380,443,allow,1067,650,417,10,31,6,4
57000,53,6517,53,allow,194,102,92,2,30,1,1
58638,5900,0,0,deny,62,62,0,1,0,1,0
48817,51413,48817,51413,allow,460,150,310,2,1200,1,1
55654,18251,36307,18251,allow,70,70,0,1,5,1,0
62506,445,0,0,drop,66,66,0,1,0,1,0
56543,53,18371,53,allow,756,95,661,2,30,1,1
55635,53,55478,53,allow,177,94,83,2,29,1,1
64639,3389,64639,3389,allow,3409,1454,1955,16,16,8,8
53914,443,31627,443,allow,499,425,74,4,0,3,1
53949,445,0,0,drop,70,70,0,1,0,1,0
62738,443,30177,443,allow,126,60,66,3,10,2,1
53948,7370,61393,7370,allow,70,70,0,2,8,2,0
30584,53,30584,53,allow,241,98,143,2,30,1,1
53000,445,0,0,drop,66,66,0,1,0,1,0
55626,63805,23725,63805,allow,70,70,0,1,5,1,0
57028,445,0,0,drop,70,70,0,1,0,1,0
60217,443,8028,443,allow,6075,3806,2269,18,120,10,8
54712,445,0,0,drop,66,66,0,1,0,1,0
10151,55051,56267,55051,allow,468,149,319,2,1200,1,1
59792,80,59792,80,allow,33435,1694,31741,43,20,18,25
54716,445,0,0,drop,70,70,0,1,0,1,0
49966,445,0,0,drop,70,70,0,1,0,1,0
61185,54532,0,0,deny,62,62,0,1,0,1,0
57065,53,34013,53,allow,272,110,162,2,29,1,1
56298,445,0,0,drop,70,70,0,1,0,1,0
37313,443,31778,443,allow,1364815,60410,1304405,1401,901,341,1060
64833,53,29927,53,allow,167,86,81,2,30,1,1
35744,64147,0,0,deny,66,66,0,1,0,1,0
13911,57470,0,0,deny,60,60,0,1,0,1,0
53252,443,50911,443,allow,6899,2368,4531,27,27,14,13
58638,5900,0,0,deny,62,62,0,1,0,1,0
52476,445,0,0,drop,66,66,0,1,0,1,0
57588,53,31636,53,allow,165,78,87,2,30,1,1
59233,445,0,0,drop,70,70,0,1,0,1,0
53782,445,0,0,drop,66,66,0,1,0,1,0
61412,443,58094,443,allow,4934,771,4163,18,28,8,10
55911,53,54432,53,allow,211,110,101,2,30,1,1
62074,443,56208,443,allow,350,210,140,6,15,4,2
65313,53,7915,53,allow,166,86,80,2,30,1,1
11382,43890,0,0,deny,66,66,0,1,0,1,0
42231,57470,0,0,deny,78,78,0,1,0,1,0
64055,45105,31145,45105,allow,70,70,0,1,4,1,0
64334,53,44519,53,allow,200,94,106,2,31,1,1
56007,53,0,0,allow,86,86,0,1,30,1,0
59576,445,0,0,drop,70,70,0,1,0,1,0
27641,39004,0,0,deny,62,62,0,1,0,1,0
38681,15503,0,0,deny,74,74,0,1,0,1,0
58012,5555,0,0,deny,60,60,0,1,0,1,0
50458,53,25707,53,allow,177,94,83,2,30,1,1
62859,35440,0,0,deny,66,66,0,1,0,1,0
50071,53,62204,53,allow,458,188,270,6,30,3,3
53521,8999,10502,8999,allow,312,186,126,5,15,3,2
57804,445,0,0,drop,66,66,0,1,0,1,0
60293,53,33499,53,allow,312,78,234,2,30,1,1
58886,443,39424,443,allow,3989,2585,1404,17,15,9,8
49558,53,10290,53,allow,193,102,91,2,30,1,1
64410,53,61695,53,allow,196,102,94,2,30,1,1
55262,44847,0,0,deny,62,62,0,1,0,1,0
55759,445,0,0,drop,66,66,0,1,0,1,0
61800,445,0,0,drop,66,66,0,1,0,1,0
55620,20795,23864,20795,allow,70,70,0,2,8,2,0
46851,443,41590,443,allow,3998,1986,2012,20,255,10,10
59734,5900,0,0,deny,60,60,0,1,0,1,0
54478,445,0,0,drop,70,70,0,1,0,1,0
4111,25174,0,0,deny,62,62,0,1,0,1,0
59958,443,39480,443,allow,2303,1334,969,18,16,10,8
49591,53,31886,53,allow,198,94,104,2,30,1,1
52361,23718,0,0,deny,66,66,0,1,0,1,0
61897,445,0,0,drop,66,66,0,1,0,1,0
50353,443,35772,443,allow,7397,1784,5613,27,306,13,14
59772,62413,0,0,deny,62,62,0,1,0,1,0
55720,51610,62012,51610,allow,70,70,0,2,8,2,0
49246,53,17908,53,allow,177,94,83,2,30,1,1
52933,445,0,0,drop,66,66,0,1,0,1,0
38008,443,10885,443,allow,11784,6760,5024,50,247,30,20
54318,445,0,0,drop,66,66,0,1,0,1,0
43100,22114,0,0,deny,146,146,0,1,0,1,0
56645,445,0,0,drop,70,70,0,1,0,1,0
54797,80,8308,80,allow,8957,4075,4882,32,416,17,15
56453,37965,0,0,deny,62,62,0,1,0,1,0
48016,57470,0,0,deny,62,62,0,1,0,1,0
54144,443,15023,443,allow,2227,1018,1209,17,16,8,9
30960,45724,8617,45724,allow,330,330,0,6,3609,6,0
50716,50584,0,0,deny,74,74,0,1,0,1,0
54121,443,19391,443,allow,26357358,863775,25493583,27347,208,8650,18697
60272,26467,0,0,deny,66,66,0,1,0,1,0
63084,64147,0,0,deny,62,62,0,1,0,1,0
5588,5588,0,0,allow,3498,1872,1626,48,199,24,24
52028,53,52028,53,allow,194,87,107,2,31,1,1
24809,52700,0,0,deny,66,66,0,1,0,1,0
56185,443,34268,443,allow,5415,1730,3685,20,120,9,11
50055,445,0,0,drop,70,70,0,1,0,1,0
51807,443,51807,443,allow,1466,856,610,13,27,6,7
52491,443,12140,443,allow,22753,7559,15194,31,16,16,15
60692,445,0,0,drop,66,66,0,1,0,1,0
43864,443,38853,443,allow,4922,2860,2062,25,39,14,11
59288,445,0,0,drop,70,70,0,1,0,1,0
52836,36829,0,0,deny,66,66,0,1,0,1,0
59810,443,33915,443,allow,630054,19786,610268,711,381,261,450
42968,56205,0,0,deny,62,62,0,1,0,1,0
51031,445,0,0,drop,70,70,0,1,0,1,0
63976,53,54161,53,allow,200,102,98,2,33,1,1
60047,443,20320,443,allow,229060,38515,190545,283,135,113,170
55101,53,3206,53,allow,711,87,624,2,30,1,1
41816,443,14209,443,allow,88503,3914,84589,114,80,44,70
46180,1433,0,0,deny,60,60,0,1,0,1,0
64716,53,5161,53,allow,718,94,624,2,30,1,1
63848,48560,32430,48560,allow,70,70,0,1,4,1,0
65155,445,0,0,drop,70,70,0,1,0,1,0
42632,44847,0,0,deny,62,62,0,1,0,1,0
50769,445,0,0,drop,70,70,0,1,0,1,0
51247,445,0,0,drop,66,66,0,1,0,1,0
53903,443,40208,443,allow,499,425,74,4,0,3,1
51675,8245,24099,8245,allow,346,214,132,3,29,1,2
50077,443,40548,443,allow,7976,3333,4643,23,25,12,11
5588,5588,0,0,allow,3562,1936,1626,48,194,24,24
35194,57470,0,0,deny,74,74,0,1,0,1,0
62395,445,0,0,drop,70,70,0,1,0,1,0
56688,53,13604,53,allow,196,102,94,2,29,1,1
49838,53,62523,53,allow,866,221,645,6,56,3,3
55053,445,0,0,drop,70,70,0,1,0,1,0
56947,53,11234,53,allow,239,102,137,2,30,1,1
52478,443,48158,443,allow,9844,3089,6755,21,133,10,11
61357,64147,0,0,deny,62,62,0,1,0,1,0
53083,80,12541,80,allow,5259,1904,3355,30,15,23,7
19302,443,26733,443,allow,2227,1018,1209,17,15,8,9
59957,445,0,0,drop,70,70,0,1,0,1,0
50474,80,43879,80,allow,19357,10244,9113,36,27,19,17
50139,5228,61271,5228,allow,7727,2172,5555,44,104,23,21
45159,443,45159,443,allow,5329,2082,3247,22,40,13,9
55732,53,62249,53,allow,188,96,92,2,31,1,1
49622,50584,0,0,deny,62,62,0,1,0,1,0
53615,867,16773,867,allow,70,70,0,2,7,2,0
53246,445,0,0,drop,70,70,0,1,0,1,0
30879,35440,0,0,deny,146,146,0,1,0,1,0
57470,55000,8797,55000,allow,726,726,0,12,1200,12,0
51535,443,45578,443,allow,202,70,132,3,11,1,2
26900,27017,22476,27017,allow,422,164,258,6,30,3,3
59773,53,31376,53,allow,193,94,99,2,30,1,1
51709,40705,43195,40705,allow,70,70,0,2,8,2,0
56772,53,56028,53,allow,168,86,82,2,30,1,1
60868,445,0,0,drop,70,70,0,1,0,1,0
49418,27015,37107,27015,allow,223,71,152,2,31,1,1
27005,33038,15973,33038,allow,892,126,766,2,31,1,1
59604,445,0,0,drop,70,70,0,1,0,1,0
10262,11392,0,0,deny,62,62,0,1,0,1,0
39435,443,17310,443,allow,2403265,93626,2309639,2795,243,1103,1692
12471,48817,0,0,deny,62,62,0,1,0,1,0
50578,80,50578,80,allow,35580,13335,22245,69,23,38,31
58982,5222,15289,5222,allow,16545,8556,7989,69,69,30,39
35078,443,8054,443,allow,234,234,0,4,12,4,0
15347,55108,0,0,deny,148,148,0,1,0,1,0
53845,445,0,0,drop,70,70,0,1,0,1,0
50811,443,33324,443,allow,2719275,48822,2670453,2459,127,689,1770
39392,80,20430,80,allow,1325,442,883,16,414,4,12
47632,25174,0,0,deny,146,146,0,1,0,1,0
26900,27017,17453,27017,allow,172,86,86,2,29,1,1
0,0,0,0,deny,60,60,0,1,0,1,0
25536,50584,0,0,deny,146,146,0,1,0,1,0
52004,55711,12562,55711,allow,70,70,0,2,7,2,0
55302,445,0,0,drop,70,70,0,1,0,1,0
60096,445,0,0,drop,70,70,0,1,0,1,0
26900,27017,6136,27017,allow,422,164,258,6,30,3,3
55803,53,28022,53,allow,174,89,85,3,36,2,1
3914,37965,0,0,deny,62,62,0,1,0,1,0
49566,80,12827,80,allow,1268,703,565,11,23,6,5
64520,53,59126,53,allow,196,100,96,2,30,1,1
65321,445,0,0,drop,66,66,0,1,0,1,0
1730,37965,0,0,deny,145,145,0,1,0,1,0
56752,43888,19580,43888,allow,70,70,0,1,5,1,0
56724,53,27864,53,allow,182,94,88,2,30,1,1
51090,53,42988,53,allow,164,78,86,2,30,1,1
50171,445,0,0,drop,66,66,0,1,0,1,0
40204,5222,16908,5222,allow,5097,2196,2901,36,25,18,18
55376,445,0,0,drop,70,70,0,1,0,1,0
55918,445,0,0,drop,70,70,0,1,0,1,0
65512,44847,0,0,deny,66,66,0,1,0,1,0
29697,51221,0,0,deny,62,62,0,1,0,1,0
39268,443,60773,443,allow,7691,1999,5692,35,256,18,17
59780,443,27949,443,allow,19224,2358,16866,38,28,15,23
59468,80,3821,80,allow,1594,1280,314,10,15,5,5
53377,445,0,0,drop,70,70,0,1,0,1,0
64926,53,31198,53,allow,309,118,191,2,30,1,1
2083,25174,0,0,deny,62,62,0,1,0,1,0
64320,53,33961,53,allow,198,101,97,2,30,1,1
62588,57470,0,0,deny,146,146,0,1,0,1,0
55517,53,21431,53,allow,174,89,85,2,31,1,1
64982,53,7068,53,allow,321,97,224,4,57,2,2
52139,445,0,0,drop,66,66,0,1,0,1,0
16693,36237,0,0,deny,66,66,0,1,0,1,0
49518,53,63252,53,allow,186,95,91,2,30,1,1
53138,15048,61968,15048,allow,70,70,0,2,7,2,0
58638,5900,0,0,deny,62,62,0,1,0,1,0
50034,53,21368,53,allow,179,94,85,2,30,1,1
34415,443,34473,443,allow,6397,1590,4807,23,315,12,11
54992,53,62120,53,allow,195,102,93,2,30,1,1
2267,53,42274,53,allow,204,118,86,2,31,1,1
52696,21247,0,0,deny,62,62,0,1,0,1,0
49999,445,0,0,drop,70,70,0,1,0,1,0
56745,80,35194,80,allow,214,140,74,4,25,3,1
61133,445,0,0,drop,66,66,0,1,0,1,0
58322,53,48798,53,allow,320,94,226,2,30,1,1
64811,53,57822,53,allow,314,97,217,4,47,2,2
49954,80,59970,80,allow,10841,821,10020,19,15,9,10
49745,443,54598,443,allow,4043,1781,2262,19,128,11,8
64505,53,38734,53,allow,373,126,247,2,30,1,1
64841,6881,0,0,deny,62,62,0,1,0,1,0
51979,25174,0,0,deny,66,66,0,1,0,1,0
33912,25174,0,0,deny,146,146,0,1,0,1,0
56520,53,14015,53,allow,757,98,659,2,30,1,1
49540,53,42804,53,allow,754,94,660,2,31,1,1
51848,443,16596,443,allow,5788,3446,2342,22,135,11,11
50265,45682,34420,45682,allow,330,330,0,6,1200,6,0
56766,53,15187,53,allow,210,110,100,2,30,1,1
8889,47679,0,0,deny,60,60,0,1,0,1,0
32551,51221,0,0,deny,66,66,0,1,0,1,0
22922,35440,0,0,deny,62,62,0,1,0,1,0
1735,80,1735,80,allow,78576,5218,73358,91,95,36,55
443,4205,0,0,deny,320,320,0,1,0,1,0
64573,445,0,0,drop,70,70,0,1,0,1,0
56514,443,14098,443,allow,5084,969,4115,18,32,10,8
60814,443,60814,443,allow,1386,751,635,15,181,8,7
42298,40001,24361,40001,allow,140,78,62,2,31,1,1
49922,53,18616,53,allow,583,105,478,4,42,2,2
45406,80,51652,80,allow,573,499,74,6,15,5,1
56489,53,51415,53,allow,178,94,84,2,30,1,1
0,0,0,0,deny,98,98,0,1,0,1,0
58638,5900,0,0,deny,62,62,0,1,0,1,0
37028,51505,0,0,deny,62,62,0,1,0,1,0
58330,445,0,0,drop,70,70,0,1,0,1,0
50,38211,0,0,deny,66,66,0,1,0,1,0
64321,53,56788,53,allow,195,102,93,2,31,1,1
65371,443,38245,443,allow,34653,2523,32130,65,83,26,39
47910,7454,0,0,deny,60,60,0,1,0,1,0
33886,39127,0,0,deny,162,162,0,1,0,1,0
53090,59356,0,0,deny,66,66,0,1,0,1,0
65219,53,52496,53,allow,197,102,95,2,31,1,1
50482,445,0,0,drop,70,70,0,1,0,1,0
52205,445,0,0,drop,70,70,0,1,0,1,0
53904,1024,57585,1024,allow,70,70,0,2,8,2,0
9067,443,32087,443,allow,11768028,275478,11492550,12305,77,4158,8147
64592,53,31524,53,allow,209,110,99,2,30,1,1
11136,15503,0,0,deny,62,62,0,1,0,1,0
50963,445,0,0,drop,66,66,0,1,0,1,0
58933,445,0,0,drop,70,70,0,1,0,1,0
56258,443,7050,443,allow,3325,1067,2258,13,135,6,7
63398,25174,0,0,deny,66,66,0,1,0,1,0
52699,25174,0,0,deny,66,66,0,1,0,1,0
24463,3389,24463,3389,allow,3910,1805,2105,20,18,12,8
57470,1052,29632,1052,allow,132,132,0,3,1199,3,0
50052,65008,0,0,deny,60,60,0,1,0,1,0
55849,53,18869,53,allow,195,102,93,2,31,1,1
63123,443,2036,443,allow,5530,2343,3187,22,128,10,12
43731,443,32992,443,allow,10930,1759,9171,27,28,13,14
61554,445,0,0,drop,70,70,0,1,0,1,0
64056,53,57608,53,allow,383,94,289,2,30,1,1
52564,445,0,0,drop,70,70,0,1,0,1,0
64013,48970,31452,48970,allow,70,70,0,1,4,1,0
58615,443,30095,443,allow,6796,1541,5255,23,121,11,12
3578,51505,0,0,deny,66,66,0,1,0,1,0
55264,445,0,0,drop,70,70,0,1,0,1,0
50598,80,50598,80,allow,10463,6606,3857,36,27,20,16
56884,53,20649,53,allow,199,102,97,2,29,1,1
47910,7461,0,0,deny,60,60,0,1,0,1,0
53184,443,16399,443,allow,13515,3057,10458,40,21,20,20
49603,53,2204,53,allow,238,110,128,2,30,1,1
46495,4607,0,0,deny,60,60,0,1,0,1,0
63708,25174,0,0,deny,62,62,0,1,0,1,0
57012,445,0,0,drop,66,66,0,1,0,1,0
30188,27772,64348,27772,allow,502,150,352,2,1200,1,1
49418,28002,23648,28002,allow,271,78,193,2,30,1,1
55144,53,13694,53,allow,316,94,222,2,29,1,1
54858,51505,0,0,deny,62,62,0,1,0,1,0
60018,445,0,0,drop,70,70,0,1,0,1,0
49702,443,53414,443,allow,42430,4111,38319,79,130,42,37
16037,25174,0,0,deny,62,62,0,1,0,1,0
54555,25174,0,0,deny,62,62,0,1,0,1,0
50154,53,53091,53,allow,756,95,661,2,30,1,1
51638,80,49602,80,allow,19232,1830,17402,35,49,19,16
61736,50584,0,0,deny,66,66,0,1,0,1,0
49417,38558,0,0,deny,66,66,0,1,0,1,0
64618,53,21647,53,allow,198,102,96,2,30,1,1
3117,37965,0,0,deny,62,62,0,1,0,1,0
58876,443,42159,443,allow,19357,12948,6409,47,18,26,21
1024,64147,0,0,deny,62,62,0,1,0,1,0
57067,53,57189,53,allow,182,93,89,2,30,1,1
61115,445,0,0,drop,70,70,0,1,0,1,0
59634,445,0,0,drop,70,70,0,1,0,1,0
27005,32030,25176,32030,allow,1796,252,1544,5,31,3,2
59480,443,64952,443,allow,5058,2667,2391,25,92,13,12
21147,53,21147,53,allow,1413,688,725,3,30,2,1
65477,53,61765,53,allow,183,94,89,2,30,1,1
63771,445,0,0,drop,66,66,0,1,0,1,0
54649,443,1081,443,allow,355822,186974,168848,1039,1626,433,606
61009,27065,32929,27065,allow,1582,1386,196,6,30,4,2
45908,33330,0,0,deny,60,60,0,1,0,1,0
34306,37965,0,0,deny,62,62,0,1,0,1,0
51857,40561,47310,40561,allow,70,70,0,1,5,1,0
26606,40108,0,0,deny,145,145,0,1,0,1,0
34960,443,6692,443,allow,7029,2223,4806,23,361,12,11
54280,3398,0,0,deny,60,60,0,1,0,1,0
49761,445,0,0,drop,66,66,0,1,0,1,0
49485,56972,0,0,deny,62,62,0,1,0,1,0
59424,443,18512,443,allow,252,70,182,3,120,1,2
53310,443,4749,443,allow,2253,1403,850,15,121,9,6
61571,53,17660,53,allow,211,78,133,2,30,1,1
60863,445,0,0,drop,70,70,0,1,0,1,0
65266,53,28016,53,allow,536,113,423,4,56,2,2
57385,443,20044,443,allow,8747,3323,5424,45,110,25,20
64344,445,0,0,drop,66,66,0,1,0,1,0
63950,53,3217,53,allow,348,102,246,4,39,2,2
64645,445,0,0,drop,70,70,0,1,0,1,0
57103,445,0,0,drop,70,70,0,1,0,1,0
55830,53,64690,53,allow,183,94,89,2,30,1,1
50673,80,12286,80,allow,20265,5748,14517,34,23,16,18
50426,445,0,0,drop,70,70,0,1,0,1,0
53745,445,0,0,drop,70,70,0,1,0,1,0
52802,56205,0,0,deny,62,62,0,1,0,1,0
10051,443,38650,443,allow,11412,1763,9649,27,110,13,14
49784,445,0,0,drop,70,70,0,1,0,1,0
52569,445,0,0,drop,70,70,0,1,0,1,0
55417,53,14562,53,allow,199,102,97,2,30,1,1
61357,64147,0,0,deny,62,62,0,1,0,1,0
9154,443,7257,443,allow,6258,843,5415,19,29,10,9
60969,445,0,0,drop,66,66,0,1,0,1,0
50400,445,0,0,drop,70,70,0,1,0,1,0
55434,53,55434,53,allow,198,90,108,2,30,1,1
37965,7765,33226,7765,allow,460,150,310,2,1199,1,1
57473,23,0,0,deny,60,60,0,1,0,1,0
53746,53,62050,53,allow,164,78,86,2,31,1,1
63346,37965,0,0,deny,66,66,0,1,0,1,0
63228,445,0,0,drop,70,70,0,1,0,1,0
56416,80,36682,80,allow,33755,928,32827,36,104,11,25
65068,53,6356,53,allow,336,111,225,4,29,2,2
33359,30188,0,0,deny,66,66,0,1,0,1,0
64742,53,25545,53,allow,761,102,659,2,29,1,1
58488,3389,58488,3389,allow,3428,1714,1714,16,31,8,8
59647,47993,0,0,deny,66,66,0,1,0,1,0
63855,29799,24538,29799,allow,66,66,0,2,8,2,0
51573,53,28199,53,allow,212,86,126,2,30,1,1
65485,53,20874,53,allow,718,94,624,2,30,1,1
59436,22114,0,0,deny,66,66,0,1,0,1,0
46771,80,6345,80,allow,2066,1369,697,13,84,7,6
55456,53,57964,53,allow,711,87,624,2,30,1,1
33006,80,33006,80,allow,6582,886,5696,15,16,7,8
20741,64147,0,0,deny,62,62,0,1,0,1,0
55677,16588,61905,16588,allow,70,70,0,2,8,2,0
43676,80,43895,80,allow,2132,997,1135,14,20,8,6
52414,80,51546,80,allow,9534,746,8788,18,49,9,9
55294,3389,55294,3389,allow,4470,2381,2089,23,19,13,10
49841,53,53641,53,allow,751,95,656,2,30,1,1
25348,23,0,0,deny,60,60,0,1,0,1,0
49782,53,28643,53,allow,228,86,142,2,30,1,1
38322,443,57596,443,allow,10632,3838,6794,37,256,18,19
50281,443,10698,443,allow,25811,4278,21533,73,100,38,35
56689,53,17079,53,allow,264,91,173,4,38,2,2
4138,55777,0,0,deny,66,66,0,1,0,1,0
57928,445,0,0,drop,66,66,0,1,0,1,0
64365,53,55898,53,allow,196,94,102,2,30,1,1
64873,53,31946,53,allow,195,94,101,2,31,1,1
51480,445,0,0,drop,70,70,0,1,0,1,0
60384,64170,40565,64170,allow,504,318,186,8,16,5,3
36307,80,3965,80,allow,1368,920,448,12,20,7,5
35012,443,7162,443,allow,1461,980,481,11,25,7,4
57676,64147,0,0,deny,70,70,0,1,0,1,0
64330,53,32772,53,allow,186,95,91,2,31,1,1
58379,443,57467,443,allow,24040,4851,19189,86,160,41,45
51858,44647,64567,44647,allow,70,70,0,2,8,2,0
16994,53,0,0,allow,300,90,210,2,30,1,1
54914,51505,0,0,deny,66,66,0,1,0,1,0
63743,46081,59158,46081,allow,66,66,0,2,7,2,0
58835,17372,0,0,deny,66,66,0,1,0,1,0
19594,23117,0,0,deny,66,66,0,1,0,1,0
62670,443,51023,443,allow,6179,3326,2853,26,186,12,14
50112,445,0,0,drop,70,70,0,1,0,1,0
52431,50265,0,0,deny,62,62,0,1,0,1,0
52202,64241,11975,64241,allow,164,70,94,2,4,1,1
50098,53,35550,53,allow,199,102,97,2,31,1,1
56874,67,0,0,deny,60,60,0,1,0,1,0
60527,35440,0,0,deny,66,66,0,1,0,1,0
60410,445,0,0,drop,70,70,0,1,0,1,0
41499,23,0,0,deny,60,60,0,1,0,1,0
44928,443,35200,443,allow,9345,2224,7121,40,112,22,18
49756,53,22675,53,allow,243,118,125,2,30,1,1
52744,443,47091,443,allow,14838,2048,12790,32,25,18,14
33017,443,34545,443,allow,130,70,60,3,4,2,1
65197,53,14120,53,allow,177,86,91,2,30,1,1
27005,33086,32717,33086,allow,877,126,751,2,31,1,1
3478,61463,0,0,deny,68,68,0,1,0,1,0
57470,62314,37389,62314,allow,1188,1188,0,19,2338,19,0
56728,53,11841,53,allow,166,86,80,2,30,1,1
51807,445,0,0,drop,70,70,0,1,0,1,0
61675,443,61675,443,allow,8512,2483,6029,21,18,12,9
63392,445,0,0,drop,70,70,0,1,0,1,0
55125,53,57418,53,allow,170,87,83,2,31,1,1
53470,22114,0,0,deny,66,66,0,1,0,1,0
27988,40040,49340,40040,allow,148,86,62,2,30,1,1
64404,53,27516,53,allow,250,102,148,2,30,1,1
5787,44847,0,0,deny,66,66,0,1,0,1,0
39914,443,20492,443,allow,26779179,169104,26610075,19911,91,1968,17943
49684,445,0,0,drop,66,66,0,1,0,1,0
34085,80,34085,80,allow,490,264,226,8,140,5,3
64922,445,0,0,drop,70,70,0,1,0,1,0
63036,445,0,0,drop,70,70,0,1,0,1,0
21294,57470,0,0,deny,62,62,0,1,0,1,0
52724,445,0,0,drop,66,66,0,1,0,1,0
51221,6889,53258,6889,allow,481,150,331,2,1200,1,1
56692,443,45896,443,allow,7914,1925,5989,20,15,11,9
59413,445,0,0,drop,70,70,0,1,0,1,0
60025,445,0,0,drop,70,70,0,1,0,1,0
36402,80,36402,80,allow,1917,1468,449,10,20,6,4
51522,443,24413,443,allow,8517,2719,5798,24,360,12,12
26979,443,43734,443,allow,7343,2586,4757,23,19,11,12
49615,443,24939,443,allow,48705,7643,41062,146,256,77,69
51046,25174,0,0,deny,66,66,0,1,0,1,0
26690,53,55791,53,allow,197,94,103,2,29,1,1
56604,17372,0,0,deny,66,66,0,1,0,1,0
41230,443,4213,443,allow,234,234,0,4,11,4,0
42986,25174,0,0,deny,66,66,0,1,0,1,0
56824,443,13725,443,allow,18356,13354,5002,47,34,29,18
52110,35411,42303,35411,allow,70,70,0,2,8,2,0
46286,21247,0,0,deny,62,62,0,1,0,1,0
41315,11392,0,0,deny,146,146,0,1,0,1,0
50023,443,17571,443,allow,70,70,0,2,5,2,0
64898,445,0,0,drop,70,70,0,1,0,1,0
49086,443,34505,443,allow,8535,2139,6396,25,394,9,16
56421,53,8309,53,allow,177,94,83,2,30,1,1
49283,445,0,0,drop,66,66,0,1,0,1,0
60911,53,60911,53,allow,216,90,126,2,30,1,1
63211,445,0,0,drop,66,66,0,1,0,1,0
15760,53,32222,53,allow,497,83,414,4,30,2,2
50986,443,39025,443,allow,18156,12850,5306,32,76,19,13
11385,48543,0,0,deny,145,145,0,1,0,1,0
65140,53,14372,53,allow,199,102,97,2,30,1,1
65486,53,53853,53,allow,193,102,91,2,30,1,1
52716,443,35091,443,allow,69951,4941,65010,95,351,45,50
48817,6886,48817,6886,allow,491,150,341,2,1200,1,1
57645,445,0,0,drop,70,70,0,1,0,1,0
60691,445,0,0,drop,66,66,0,1,0,1,0
42657,443,20758,443,allow,10204,2106,8098,37,255,19,18
52340,64147,0,0,deny,66,66,0,1,0,1,0
6881,63963,28408,63963,allow,207,118,89,2,1200,1,1
65291,53,61483,53,allow,190,97,93,2,31,1,1
443,23220,0,0,deny,100,100,0,1,0,1,0
1811,35440,0,0,deny,62,62,0,1,0,1,0
60470,51413,5081,51413,allow,741,435,306,10,16,5,5
52604,25174,0,0,deny,62,62,0,1,0,1,0
34105,443,37693,443,allow,43883,3446,40437,57,122,22,35
56127,37965,0,0,deny,66,66,0,1,0,1,0
59771,443,63690,443,allow,7672,1164,6508,24,30,12,12
50840,445,0,0,drop,70,70,0,1,0,1,0
33761,25174,0,0,deny,62,62,0,1,0,1,0
63984,53,63454,53,allow,264,110,154,2,30,1,1
55035,445,0,0,drop,66,66,0,1,0,1,0
52069,80,30929,80,allow,362,240,122,7,25,5,2
53679,24300,62271,24300,allow,1656,914,742,13,21,9,4
64724,53,50975,53,allow,195,102,93,2,31,1,1
33243,443,3619,443,allow,35991,3996,31995,58,17,26,32
6881,26296,0,0,deny,157,157,0,1,0,1,0
54032,53,0,0,allow,195,79,116,2,31,1,1
52885,445,0,0,drop,70,70,0,1,0,1,0
55538,53,14832,53,allow,195,102,93,2,30,1,1
57949,443,49783,443,allow,19190,13041,6149,64,389,33,31
55640,53,37187,53,allow,797,208,589,6,67,3,3
55535,53,31917,53,allow,198,101,97,2,30,1,1
54719,445,0,0,drop,70,70,0,1,0,1,0
30960,45690,12118,45690,allow,330,330,0,6,3609,6,0
52049,80,61901,80,allow,34695,17472,17223,55,33,28,27
53129,80,16654,80,allow,5318,685,4633,14,15,7,7
64392,25174,0,0,deny,66,66,0,1,0,1,0
63183,445,0,0,drop,70,70,0,1,0,1,0
49342,443,27856,443,allow,6944,2404,4540,21,15,10,11
55875,445,0,0,drop,70,70,0,1,0,1,0
49629,53,59085,53,allow,216,102,114,2,30,1,1
55438,443,39653,443,allow,6686,923,5763,19,15,11,8
51145,445,0,0,drop,70,70,0,1,0,1,0
50037,53,57358,53,allow,190,97,93,2,30,1,1
49817,445,0,0,drop,70,70,0,1,0,1,0
38358,22300,0,0,deny,60,60,0,1,0,1,0
35542,23,35542,23,allow,124,60,64,2,5,1,1
42162,53,42162,53,allow,227,88,139,2,31,1,1
55337,443,21717,443,allow,24341,15170,9171,78,461,39,39
57426,443,14949,443,allow,832,268,564,14,37,5,9
51595,443,49515,443,allow,10614,5312,5302,25,91,14,11
64712,53,32713,53,allow,210,102,108,2,30,1,1
8167,443,8167,443,allow,1474,697,777,18,82,8,10
50903,445,0,0,drop,66,66,0,1,0,1,0
51103,443,36898,443,allow,20280,13177,7103,82,1176,46,36
61887,445,0,0,drop,70,70,0,1,0,1,0
49112,443,21171,443,allow,6319,877,5442,23,396,8,15
55600,22,0,0,deny,60,60,0,1,0,1,0
62731,21247,0,0,deny,66,66,0,1,0,1,0
38957,443,58777,443,allow,7457,1333,6124,18,200,10,8
62297,445,0,0,drop,70,70,0,1,0,1,0
11295,40040,23656,40040,allow,213,89,124,4,31,2,2
58395,445,0,0,drop,70,70,0,1,0,1,0
56589,53,29602,53,allow,199,102,97,2,30,1,1
57382,443,54714,443,allow,5619,927,4692,17,15,10,7
55994,53,14095,53,allow,183,94,89,2,30,1,1
32645,53,32645,53,allow,404,259,145,3,33,2,1
62064,22114,0,0,deny,66,66,0,1,0,1,0
49725,443,45081,443,allow,7162,780,6382,18,50,8,10
61478,443,38710,443,allow,45313,3360,41953,61,47,26,35
53085,445,0,0,drop,70,70,0,1,0,1,0
62343,443,28448,443,allow,13709,1675,12034,25,31,11,14
55715,53,19164,53,allow,168,86,82,2,29,1,1
61681,23,0,0,deny,60,60,0,1,0,1,0
51979,55803,3042,55803,allow,70,70,0,1,4,1,0
38681,443,38681,443,allow,3028,1828,1200,19,21,11,8
64584,443,62186,443,allow,24682,1935,22747,36,19,17,19
58638,5900,0,0,deny,62,62,0,1,0,1,0
64216,53,16244,53,allow,183,94,89,2,30,1,1
59435,445,0,0,drop,70,70,0,1,0,1,0
56820,445,0,0,drop,66,66,0,1,0,1,0
56622,53,54285,53,allow,214,110,104,2,30,1,1
59381,53,5162,53,allow,189,78,111,2,30,1,1
51973,5222,53843,5222,allow,9184,4142,5042,72,53,40,32
58687,12883,0,0,deny,143,143,0,1,0,1,0
61430,80,6930,80,allow,214,140,74,4,41,3,1
63118,7000,63118,7000,allow,3310,1535,1775,15,15,8,7
49420,53,61159,53,allow,183,94,89,2,30,1,1
50583,445,0,0,drop,70,70,0,1,0,1,0
51314,445,0,0,drop,70,70,0,1,0,1,0
52640,64147,0,0,deny,62,62,0,1,0,1,0
30654,51221,0,0,deny,72,72,0,1,0,1,0
43828,44847,0,0,deny,62,62,0,1,0,1,0
33012,50265,0,0,deny,145,145,0,1,0,1,0
38119,443,46487,443,allow,1820,1101,719,18,16,10,8
64482,64147,0,0,deny,66,66,0,1,0,1,0
60524,64147,0,0,deny,66,66,0,1,0,1,0
64715,53,47413,53,allow,209,110,99,2,30,1,1
49418,27015,14560,27015,allow,71,71,0,1,30,1,0
53532,22114,0,0,deny,62,62,0,1,0,1,0
64127,53,25934,53,allow,177,94,83,2,30,1,1
55733,53,46336,53,allow,177,94,83,2,29,1,1
27005,27255,55228,27255,allow,879,126,753,2,30,1,1
57346,53,18432,53,allow,210,110,100,2,29,1,1
56205,51505,0,0,deny,66,66,0,1,0,1,0
60378,11385,17333,11385,allow,1218,774,444,17,26,10,7
52437,445,0,0,drop,70,70,0,1,0,1,0
50441,445,0,0,drop,66,66,0,1,0,1,0
65236,53,45022,53,allow,177,94,83,2,30,1,1
23197,44847,0,0,deny,62,62,0,1,0,1,0
49156,443,29780,443,allow,8569,2165,6404,23,34,12,11
58911,443,55607,443,allow,5168,700,4468,16,16,7,9
14692,25174,0,0,deny,62,62,0,1,0,1,0
49272,53,2689,53,allow,198,102,96,2,29,1,1
49967,445,0,0,drop,70,70,0,1,0,1,0
57195,53,19593,53,allow,195,102,93,2,33,1,1
54403,445,0,0,drop,70,70,0,1,0,1,0
57047,53,31984,53,allow,198,94,104,2,31,1,1
50461,443,13300,443,allow,78333,12774,65559,140,128,59,81
57857,445,0,0,drop,66,66,0,1,0,1,0
48590,443,14073,443,allow,3538,2083,1455,17,256,9,8
55361,445,0,0,drop,70,70,0,1,0,1,0
59440,445,0,0,drop,70,70,0,1,0,1,0
41906,443,20652,443,allow,181961,40579,141382,247,238,101,146
56843,64277,53228,64277,allow,70,70,0,1,5,1,0
54346,44847,0,0,deny,66,66,0,1,0,1,0
7720,44847,0,0,deny,66,66,0,1,0,1,0
50078,445,0,0,drop,70,70,0,1,0,1,0
62874,445,0,0,drop,70,70,0,1,0,1,0
57470,43611,57055,43611,allow,3960,3960,0,61,3411,61,0
61508,445,0,0,drop,70,70,0,1,0,1,0
16944,50584,0,0,deny,62,62,0,1,0,1,0
55022,53,10600,53,allow,190,97,93,2,31,1,1
56912,53,9519,53,allow,198,101,97,2,31,1,1
62077,445,0,0,drop,66,66,0,1,0,1,0
50662,443,44987,443,allow,3306,1714,1592,17,16,9,8
63888,25174,0,0,deny,62,62,0,1,0,1,0
30920,64147,0,0,deny,62,62,0,1,0,1,0
56561,53,2642,53,allow,216,110,106,2,31,1,1
60724,445,0,0,drop,66,66,0,1,0,1,0
54520,445,0,0,drop,70,70,0,1,0,1,0
13985,34159,0,0,deny,62,62,0,1,0,1,0
56735,445,0,0,drop,70,70,0,1,0,1,0
52018,22114,0,0,deny,146,146,0,1,0,1,0
51960,58601,34616,58601,allow,70,70,0,1,5,1,0
56320,53,27969,53,allow,761,100,661,2,30,1,1
58771,53,58771,53,allow,226,106,120,2,30,1,1
54418,445,0,0,drop,70,70,0,1,0,1,0
56658,53,26187,53,allow,193,102,91,2,30,1,1
19004,51505,0,0,deny,66,66,0,1,0,1,0
53216,443,19039,443,allow,26702,3270,23432,40,136,16,24
57470,29633,40389,29633,allow,1660,677,983,20,1595,10,10
56237,445,0,0,drop,70,70,0,1,0,1,0
42252,33303,0,0,deny,60,60,0,1,0,1,0
58638,5900,0,0,deny,62,62,0,1,0,1,0
41440,5228,57433,5228,allow,8866,2015,6851,29,4793,14,15
59807,53,15491,53,allow,263,94,169,2,30,1,1
56377,51505,0,0,deny,66,66,0,1,0,1,0
55856,445,0,0,drop,70,70,0,1,0,1,0
45941,23386,0,0,deny,60,60,0,1,0,1,0
53194,26467,0,0,deny,66,66,0,1,0,1,0
58080,443,57943,443,allow,646,358,288,10,133,6,4
60752,28080,10717,28080,allow,70,70,0,1,5,1,0
49164,25174,0,0,deny,146,146,0,1,0,1,0
51423,80,51423,80,allow,7610,2737,4873,23,26,12,11
55102,445,0,0,drop,70,70,0,1,0,1,0
50708,445,0,0,drop,70,70,0,1,0,1,0
5575,8889,0,0,deny,495,495,0,1,0,1,0
42076,443,12944,443,allow,4295,2123,2172,11,121,6,5
51372,445,0,0,drop,66,66,0,1,0,1,0
57470,37395,27238,37395,allow,1566,332,1234,11,1199,5,6
43537,2323,0,0,deny,60,60,0,1,0,1,0
51661,445,0,0,drop,66,66,0,1,0,1,0
65231,445,0,0,drop,70,70,0,1,0,1,0
55234,443,6100,443,allow,9176,2226,6950,28,31,16,12
63745,39800,55951,39800,allow,504,382,122,8,16,6,2
49923,53,8519,53,allow,702,194,508,6,67,3,3
55808,53,26919,53,allow,179,94,85,2,30,1,1
49383,53,39251,53,allow,758,102,656,2,30,1,1
55236,445,0,0,drop,70,70,0,1,0,1,0
2886,35440,0,0,deny,66,66,0,1,0,1,0
65231,50584,0,0,deny,66,66,0,1,0,1,0
8889,16991,8889,16991,allow,124,60,64,2,31,1,1
61920,445,0,0,drop,70,70,0,1,0,1,0
27005,32028,16656,32028,allow,900,126,774,2,31,1,1
59727,443,28777,443,allow,304,86,218,2,31,1,1
61852,445,0,0,drop,66,66,0,1,0,1,0
23807,44847,0,0,deny,66,66,0,1,0,1,0
49857,53,15096,53,allow,173,94,79,2,30,1,1
32299,40034,44134,40034,allow,253,190,63,2,31,1,1
58307,445,0,0,drop,70,70,0,1,0,1,0
46625,80,46625,80,allow,51574,3466,48108,63,156,23,40
5223,32965,0,0,deny,220,220,0,1,0,1,0
52776,443,19615,443,allow,10091,2314,7777,33,17,18,15
53258,53,63456,53,allow,277,78,199,2,30,1,1
61931,445,0,0,drop,66,66,0,1,0,1,0
3524,25174,0,0,deny,62,62,0,1,0,1,0
57470,49001,13810,49001,allow,166,166,0,1,1200,1,0
65386,53,46279,53,allow,168,86,82,2,29,1,1
51821,28306,23516,28306,allow,316,136,180,6,6,3,3
64802,445,0,0,drop,70,70,0,1,0,1,0
55981,53,55529,53,allow,168,78,90,2,30,1,1
51209,443,1552,443,allow,11983,2674,9309,51,17,29,22
33795,80,33795,80,allow,490,264,226,8,142,5,3
40711,53,40711,53,allow,200,90,110,2,30,1,1
56743,443,40694,443,allow,7789,2275,5514,30,47,16,14
50481,443,48883,443,allow,7653,1188,6465,21,15,12,9
58715,64097,0,0,deny,62,62,0,1,0,1,0
52807,445,0,0,drop,66,66,0,1,0,1,0
33288,53,0,0,allow,86,86,0,1,30,1,0
1537,22114,0,0,deny,62,62,0,1,0,1,0
59275,445,0,0,drop,70,70,0,1,0,1,0
57468,57470,0,0,deny,66,66,0,1,0,1,0
59583,53,59583,53,allow,229,89,140,2,31,1,1
6853,48543,0,0,deny,148,148,0,1,0,1,0
49307,443,35042,443,allow,245382,6838,238544,214,31,44,170
9067,44847,0,0,deny,62,62,0,1,0,1,0
49615,53,49539,53,allow,199,102,97,2,30,1,1
52512,80,4200,80,allow,10889,1117,9772,22,16,12,10
36097,443,29806,443,allow,6131,1384,4747,27,50,15,12
55651,53,31474,53,allow,198,101,97,2,30,1,1
3986,17372,0,0,deny,66,66,0,1,0,1,0
53808,56215,4312,56215,allow,70,70,0,1,4,1,0
57043,53,11137,53,allow,164,84,80,2,31,1,1
50632,443,61474,443,allow,10084,2145,7939,36,120,18,18
53731,443,61889,443,allow,499,425,74,4,0,3,1
49471,80,33120,80,allow,10175,1359,8816,18,78,7,11
42020,80,16578,80,allow,42657,2962,39695,68,38,36,32
55770,445,0,0,drop,70,70,0,1,0,1,0
26799,6881,0,0,deny,146,146,0,1,0,1,0
49739,443,63017,443,allow,3085,1404,1681,15,15,7,8
49708,53,16944,53,allow,178,94,84,2,30,1,1
36228,80,25190,80,allow,1114,540,574,17,191,10,7
63943,445,0,0,drop,66,66,0,1,0,1,0
49580,445,0,0,drop,70,70,0,1,0,1,0
61009,445,0,0,drop,66,66,0,1,0,1,0
57368,7302,0,0,deny,66,66,0,1,0,1,0
33057,80,61093,80,allow,1151,711,440,10,15,5,5
55095,53,54084,53,allow,783,96,687,2,30,1,1
58705,5228,47511,5228,allow,4706,2850,1856,44,6872,25,19
56489,80,59923,80,allow,118508,4979,113529,128,135,48,80
60398,443,27669,443,allow,2847,1797,1050,24,85,13,11
49942,53,17734,53,allow,741,94,647,2,30,1,1
57429,80,55023,80,allow,1056,682,374,10,15,6,4
62885,62413,0,0,deny,66,66,0,1,0,1,0
50708,80,15427,80,allow,3114,1695,1419,15,196,11,4
63992,53,62838,53,allow,199,102,97,2,30,1,1
57590,53,59223,53,allow,260,86,174,2,30,1,1
61698,80,14302,80,allow,7712,4248,3464,23,51,12,11
63083,53,63784,53,allow,303,85,218,2,30,1,1
49415,22114,0,0,deny,66,66,0,1,0,1,0
12471,48817,0,0,deny,62,62,0,1,0,1,0
54926,445,0,0,drop,66,66,0,1,0,1,0
9506,2323,0,0,deny,60,60,0,1,0,1,0
42587,443,6188,443,allow,7733,1203,6530,21,15,12,9
58808,443,58470,443,allow,5167,700,4467,16,15,7,9
62281,445,0,0,drop,66,66,0,1,0,1,0
60266,445,0,0,drop,70,70,0,1,0,1,0
52021,32202,58767,32202,allow,70,70,0,2,8,2,0
63726,445,0,0,drop,66,66,0,1,0,1,0
46640,8880,0,0,deny,60,60,0,1,0,1,0
32910,443,36297,443,allow,2299332,50663,2248669,2117,141,553,1564
36567,443,58934,443,allow,2341,1054,1287,20,299,7,13
46856,25174,0,0,deny,62,62,0,1,0,1,0
37444,53,37444,53,allow,213,79,134,2,32,1,1
50781,445,0,0,drop,70,70,0,1,0,1,0
60077,445,0,0,drop,70,70,0,1,0,1,0
1663,30188,0,0,deny,66,66,0,1,0,1,0
63865,48610,16202,48610,allow,66,66,0,2,8,2,0
51409,443,64493,443,allow,36713,3193,33520,57,623,23,34
64482,64147,0,0,deny,66,66,0,1,0,1,0
58702,80,13752,80,allow,2424,529,1895,11,75,6,5
50128,443,52903,443,allow,15069,5689,9380,51,35,27,24
50078,53,55714,53,allow,177,94,83,2,29,1,1
57045,53,16294,53,allow,177,94,83,2,30,1,1
62131,50584,0,0,deny,62,62,0,1,0,1,0
45944,443,12806,443,allow,4715,1935,2780,24,183,11,13
49704,80,31664,80,allow,217502,6597,210905,211,109,62,149
57131,26296,0,0,deny,145,145,0,1,0,1,0
60443,50284,54263,50284,allow,164,70,94,2,5,1,1
59279,80,59279,80,allow,108786,4563,104223,192,16,65,127
14578,50584,0,0,deny,66,66,0,1,0,1,0
51737,445,0,0,drop,66,66,0,1,0,1,0
62888,23,0,0,deny,60,60,0,1,0,1,0
5617,64147,0,0,deny,62,62,0,1,0,1,0
49890,443,15513,443,allow,5597,1462,4135,21,86,11,10
50284,445,0,0,drop,66,66,0,1,0,1,0
59651,445,0,0,drop,70,70,0,1,0,1,0
64821,445,0,0,drop,70,70,0,1,0,1,0
51283,80,60981,80,allow,1114,534,580,12,16,7,5
57985,26467,0,0,deny,62,62,0,1,0,1,0
55932,53,42862,53,allow,193,102,91,2,30,1,1
59183,53,39038,53,allow,260,86,174,2,30,1,1
49217,53,12085,53,allow,202,103,99,2,31,1,1
53902,55298,56516,55298,allow,70,70,0,1,4,1,0
53790,445,0,0,drop,66,66,0,1,0,1,0
52054,50513,38403,50513,allow,70,70,0,2,9,2,0
8592,35993,0,0,deny,66,66,0,1,0,1,0
57863,443,39260,443,allow,2342,1341,1001,15,19,8,7
40216,50265,0,0,deny,62,62,0,1,0,1,0
50354,445,0,0,drop,70,70,0,1,0,1,0
58033,445,0,0,drop,70,70,0,1,0,1,0
49622,50584,0,0,deny,62,62,0,1,0,1,0
61718,445,0,0,drop,66,66,0,1,0,1,0
34936,30188,0,0,deny,66,66,0,1,0,1,0
65123,53,3182,53,allow,193,102,91,2,29,1,1
65248,53,8659,53,allow,197,94,103,2,30,1,1
10003,443,7102,443,allow,7617,4161,3456,34,332,15,19
41472,443,61400,443,allow,680618,28384,652234,828,84,356,472
54540,445,0,0,drop,66,66,0,1,0,1,0
55252,53,15058,53,allow,212,102,110,2,30,1,1
59341,445,0,0,drop,66,66,0,1,0,1,0
65396,445,0,0,drop,66,66,0,1,0,1,0
58885,443,57111,443,allow,5167,700,4467,16,15,7,9
60900,443,23820,443,allow,134,60,74,3,6,2,1
24270,53,24270,53,allow,825,99,726,2,30,1,1
55684,80,48603,80,allow,70,70,0,1,5,1,0
63400,57470,0,0,deny,66,66,0,1,0,1,0
49634,53,7065,53,allow,257,102,155,2,30,1,1
53098,30840,23341,30840,allow,898,454,444,13,22,8,5
56083,445,0,0,drop,70,70,0,1,0,1,0
56367,44847,0,0,deny,66,66,0,1,0,1,0
11951,45026,0,0,deny,60,60,0,1,0,1,0
33038,443,55545,443,allow,7338,2419,4919,19,35,12,7
51888,42529,42090,42529,allow,316,136,180,6,6,3,3
65306,53,12072,53,allow,244,94,150,2,30,1,1
63083,445,0,0,drop,66,66,0,1,0,1,0
61613,445,0,0,drop,66,66,0,1,0,1,0
50877,30041,0,0,deny,66,66,0,1,0,1,0
46640,55443,0,0,deny,60,60,0,1,0,1,0
16490,25174,0,0,deny,62,62,0,1,0,1,0
55740,8060,53740,8060,allow,70,70,0,1,5,1,0
58264,44847,0,0,deny,66,66,0,1,0,1,0
56669,80,21282,80,allow,234,234,0,4,12,4,0
59422,51221,0,0,deny,62,62,0,1,0,1,0
58035,53,58035,53,allow,237,91,146,2,32,1,1
39358,443,53461,443,allow,9115,6806,2309,37,80,20,17
58468,445,0,0,drop,70,70,0,1,0,1,0
45964,3111,0,0,deny,60,60,0,1,0,1,0
59642,445,0,0,drop,66,66,0,1,0,1,0
9199,80,13955,80,allow,60838,1648,59190,68,27,25,43
64509,9571,0,0,deny,62,62,0,1,0,1,0
51374,30317,0,0,deny,66,66,0,1,0,1,0
53820,7488,54828,7488,allow,70,70,0,1,4,1,0
62102,445,0,0,drop,66,66,0,1,0,1,0
64516,445,0,0,drop,70,70,0,1,0,1,0
50960,80,58959,80,allow,5533225,44880,5488345,4345,78,654,3691
63203,445,0,0,drop,70,70,0,1,0,1,0
58246,445,0,0,drop,70,70,0,1,0,1,0
64577,443,50601,443,allow,24686,1935,22751,36,16,17,19
56500,53,18802,53,allow,775,103,672,2,31,1,1
56041,53,23370,53,allow,183,94,89,2,30,1,1
51717,445,0,0,drop,70,70,0,1,0,1,0
50052,65008,0,0,deny,60,60,0,1,0,1,0
54519,443,53980,443,allow,8413,2503,5910,23,16,13,10
55209,53,7531,53,allow,196,102,94,2,33,1,1
13654,50584,0,0,deny,62,62,0,1,0,1,0
56007,53,28468,53,allow,197,102,95,2,33,1,1
55317,53,59583,53,allow,244,94,150,2,31,1,1
41734,443,42617,443,allow,153,93,60,2,5,1,1
4515,37807,0,0,deny,146,146,0,1,0,1,0
35036,26296,0,0,deny,159,159,0,1,0,1,0
61677,445,0,0,drop,70,70,0,1,0,1,0
3564,57470,0,0,deny,62,62,0,1,0,1,0
31630,53,31630,53,allow,220,90,130,2,30,1,1
65006,26467,0,0,deny,66,66,0,1,0,1,0
49907,443,10260,443,allow,3787,2434,1353,29,72,16,13
49941,53,58431,53,allow,193,102,91,2,30,1,1
57312,53,30289,53,allow,212,110,102,2,31,1,1
55053,80,18063,80,allow,162010,4343,157667,170,98,61,109
34354,443,64555,443,allow,3603,562,3041,10,15,6,4
54627,445,0,0,drop,70,70,0,1,0,1,0
50100,445,0,0,drop,70,70,0,1,0,1,0
8229,22114,0,0,deny,66,66,0,1,0,1,0
59424,443,28784,443,allow,2288,1131,1157,25,119,12,13
53631,43562,1567,43562,allow,492,306,186,8,15,5,3
3436,46783,0,0,deny,62,62,0,1,0,1,0
37633,44847,0,0,deny,62,62,0,1,0,1,0
60771,58414,0,0,deny,62,62,0,1,0,1,0
53323,35253,0,0,deny,62,62,0,1,0,1,0
50007,53,59429,53,allow,216,110,106,2,30,1,1
45304,64147,0,0,deny,72,72,0,1,0,1,0
56212,53,11758,53,allow,168,86,82,2,31,1,1
40547,24051,0,0,deny,74,74,0,1,0,1,0
19068,37965,0,0,deny,62,62,0,1,0,1,0
60882,443,27723,443,allow,4485,794,3691,17,25,9,8
32900,443,53581,443,allow,14739,1296,13443,30,306,9,21
54453,443,45461,443,allow,4227,1086,3141,15,29,8,7
55105,53,18912,53,allow,747,93,654,2,31,1,1
22592,443,22592,443,allow,29021,6752,22269,48,30,29,19
51856,445,0,0,drop,66,66,0,1,0,1,0
41734,57470,0,0,deny,62,62,0,1,0,1,0
58638,5900,0,0,deny,62,62,0,1,0,1,0
52401,443,47720,443,allow,12402,3972,8430,46,138,26,20
54664,443,18558,443,allow,8263,1279,6984,15,136,7,8
52036,5900,0,0,deny,60,60,0,1,0,1,0
14656,36237,0,0,deny,66,66,0,1,0,1,0
51221,6881,38542,6881,allow,469,150,319,2,1200,1,1
50210,53,56208,53,allow,756,94,662,2,29,1,1
49393,30188,0,0,deny,66,66,0,1,0,1,0
36823,80,35585,80,allow,3335,2735,600,12,30,7,5
43584,24748,0,0,deny,156,156,0,1,0,1,0
51236,445,0,0,drop,70,70,0,1,0,1,0
55131,445,0,0,drop,70,70,0,1,0,1,0
26900,27017,50857,27017,allow,254,82,172,4,30,2,2
30365,45991,0,0,deny,60,60,0,1,0,1,0
56357,53,8894,53,allow,168,86,82,2,30,1,1
55931,445,0,0,drop,70,70,0,1,0,1,0
49662,53,29879,53,allow,211,102,109,2,29,1,1
65373,53,2835,53,allow,197,102,95,2,30,1,1
55707,26816,41675,26816,allow,320,140,180,6,6,3,3
62049,443,56388,443,allow,7856,2410,5446,30,17,16,14
54867,445,0,0,drop,70,70,0,1,0,1,0
63626,443,34704,443,allow,15769,1619,14150,17,138,4,13
7364,50584,0,0,deny,66,66,0,1,0,1,0
57775,445,0,0,drop,70,70,0,1,0,1,0
64882,53,29551,53,allow,230,102,128,2,29,1,1
49953,53,27349,53,allow,214,110,104,2,29,1,1
63059,443,42784,443,allow,5772,3849,1923,27,270,14,13
44934,443,47157,443,allow,416,210,206,7,24,4,3
55638,32765,61121,32765,allow,564,318,246,9,15,5,4
60229,443,63035,443,allow,8297,1280,7017,15,135,7,8
57448,53,27842,53,allow,177,94,83,2,29,1,1
52195,50930,43224,50930,allow,70,70,0,2,8,2,0
49884,53,44954,53,allow,232,110,122,2,30,1,1
27368,22114,0,0,deny,62,62,0,1,0,1,0
13279,10387,0,0,deny,159,159,0,1,0,1,0
56406,22114,0,0,deny,62,62,0,1,0,1,0
55024,53,56157,53,allow,168,86,82,2,31,1,1
61740,445,0,0,drop,70,70,0,1,0,1,0
49552,53,40374,53,allow,760,97,663,2,31,1,1
16387,35244,0,0,deny,60,60,0,1,0,1,0
50008,445,0,0,drop,70,70,0,1,0,1,0
9283,57470,0,0,deny,66,66,0,1,0,1,0
53545,27700,24861,27700,allow,320,140,180,6,7,3,3
64628,53,1942,53,allow,199,102,97,2,30,1,1
52485,445,0,0,drop,70,70,0,1,0,1,0
49480,80,65349,80,allow,6811,3791,3020,23,115,13,10
51490,5223,60793,5223,allow,9801,5352,4449,28,473,16,12
55106,53,60018,53,allow,184,94,90,2,29,1,1
55384,53,24803,53,allow,194,102,92,2,30,1,1
65012,2767,0,0,deny,66,66,0,1,0,1,0
6881,8999,10252,8999,allow,502,150,352,2,1199,1,1
60537,80,60537,80,allow,318,120,198,6,25,3,3
50740,443,2714,443,allow,3108,1730,1378,16,16,9,7
47159,443,53350,443,allow,777,432,345,10,15,5,5
40192,443,40192,443,allow,11928,3226,8702,23,160,11,12
51231,443,1331,443,allow,1396,735,661,14,80,8,6
42717,5900,0,0,deny,60,60,0,1,0,1,0
49788,53,44900,53,allow,196,100,96,2,30,1,1
9290,443,4925,443,allow,8041,2882,5159,29,23,16,13
51310,64147,0,0,deny,62,62,0,1,0,1,0
54135,445,0,0,drop,66,66,0,1,0,1,0
49415,22114,0,0,deny,62,62,0,1,0,1,0
10445,46824,0,0,deny,62,62,0,1,0,1,0
50379,443,5364,443,allow,6748,1843,4905,21,29,11,10
65421,443,16177,443,allow,2494,1643,851,17,25,9,8
52151,30692,2893,30692,allow,70,70,0,2,8,2,0
49237,53,49518,53,allow,216,110,106,2,30,1,1
63043,53,52366,53,allow,448,166,282,2,30,1,1
51111,445,0,0,drop,70,70,0,1,0,1,0
10006,64147,0,0,deny,62,62,0,1,0,1,0
65311,53,5309,53,allow,198,94,104,2,30,1,1
17315,11392,0,0,deny,62,62,0,1,0,1,0
49524,445,0,0,drop,70,70,0,1,0,1,0
61585,445,0,0,drop,70,70,0,1,0,1,0
64177,445,0,0,drop,70,70,0,1,0,1,0
55705,53,38579,53,allow,209,110,99,2,29,1,1
64075,53,49394,53,allow,352,86,266,4,36,2,2
60416,443,11714,443,allow,4953,1111,3842,22,104,12,10
53709,445,0,0,drop,70,70,0,1,0,1,0
64126,53,25754,53,allow,255,102,153,2,30,1,1
7041,37965,0,0,deny,62,62,0,1,0,1,0
57680,445,0,0,drop,70,70,0,1,0,1,0
54876,25174,0,0,deny,146,146,0,1,0,1,0
64004,445,0,0,drop,70,70,0,1,0,1,0
64727,443,24002,443,allow,18620,15824,2796,31,129,18,13
63048,445,0,0,drop,66,66,0,1,0,1,0
61788,20000,0,0,deny,60,60,0,1,0,1,0
62194,50584,0,0,deny,66,66,0,1,0,1,0
57918,443,47624,443,allow,38204,3737,34467,77,95,40,37
55699,53,3858,53,allow,271,103,168,4,59,2,2
49957,80,62910,80,allow,6389,690,5699,16,15,8,8
46014,443,8499,443,allow,13661,2246,11415,28,256,14,14
2697,28189,0,0,deny,60,60,0,1,0,1,0
56564,445,0,0,drop,66,66,0,1,0,1,0
56992,80,9421,80,allow,214,140,74,4,35,3,1
53164,445,0,0,drop,66,66,0,1,0,1,0
64671,445,0,0,drop,70,70,0,1,0,1,0
56119,37965,0,0,deny,62,62,0,1,0,1,0
13743,33720,0,0,deny,159,159,0,1,0,1,0
64580,445,0,0,drop,70,70,0,1,0,1,0
9687,57470,0,0,deny,78,78,0,1,0,1,0
62744,445,0,0,drop,66,66,0,1,0,1,0
63852,25174,0,0,deny,146,146,0,1,0,1,0
42231,57470,0,0,deny,78,78,0,1,0,1,0
50176,443,54312,443,allow,6081,844,5237,17,15,9,8
8449,80,8449,80,allow,48320,1685,46635,57,126,22,35
56704,445,0,0,drop,70,70,0,1,0,1,0
45900,443,8565,443,allow,1277649,37293,1240356,1337,303,459,878
60903,443,18682,443,allow,333062,18123,314939,420,88,182,238
58537,445,0,0,drop,70,70,0,1,0,1,0
55083,53,56476,53,allow,216,110,106,2,30,1,1
58841,443,62984,443,allow,5168,700,4468,16,15,7,9
65235,53,42179,53,allow,209,110,99,2,30,1,1
60100,445,0,0,drop,66,66,0,1,0,1,0
51822,445,0,0,drop,70,70,0,1,0,1,0
53833,26467,0,0,deny,62,62,0,1,0,1,0
61688,445,0,0,drop,70,70,0,1,0,1,0
59883,445,0,0,drop,70,70,0,1,0,1,0
55127,445,0,0,drop,70,70,0,1,0,1,0
27005,27016,17194,27016,allow,878,126,752,2,30,1,1
63742,445,0,0,drop,70,70,0,1,0,1,0
56239,53,14198,53,allow,180,94,86,2,30,1,1
49477,53,25866,53,allow,183,86,97,2,30,1,1
51946,445,0,0,drop,70,70,0,1,0,1,0
56271,53,40470,53,allow,195,102,93,2,30,1,1
55592,53,16143,53,allow,817,98,719,2,30,1,1
65154,443,37170,443,allow,5753,3034,2719,52,281,25,27
59534,445,0,0,drop,66,66,0,1,0,1,0
47073,7275,39561,7275,allow,416,210,206,7,15,4,3
57987,56125,0,0,deny,90,90,0,1,0,1,0
55890,53,44710,53,allow,193,102,91,2,31,1,1
53301,445,0,0,drop,66,66,0,1,0,1,0
57333,53,36710,53,allow,167,86,81,2,31,1,1
59177,53,0,0,allow,426,152,274,4,30,2,2
80,65095,0,0,deny,66,66,0,1,0,1,0
55233,443,14491,443,allow,10226,3230,6996,28,47,16,12
60129,55442,0,0,deny,62,62,0,1,0,1,0
51995,50031,29706,50031,allow,70,70,0,1,5,1,0
50604,80,39550,80,allow,1658,1247,411,8,15,5,3
55312,443,20877,443,allow,7952,3638,4314,36,149,17,19
53542,9192,0,0,deny,148,148,0,1,0,1,0
60701,445,0,0,drop,70,70,0,1,0,1,0
64580,53,18330,53,allow,180,94,86,2,30,1,1
58638,5900,0,0,deny,62,62,0,1,0,1,0
53508,80,33768,80,allow,16965052,382638,16582414,16619,61,5458,11161
49424,53,11040,53,allow,198,102,96,2,33,1,1
55379,53,3403,53,allow,358,102,256,2,30,1,1
49715,53,39049,53,allow,807,94,713,2,30,1,1
50116,22,50116,22,allow,152,66,86,2,10,1,1
64035,25174,0,0,deny,146,146,0,1,0,1,0
56424,80,11869,80,allow,17135,1507,15628,24,22,9,15
58206,445,0,0,drop,66,66,0,1,0,1,0
61650,445,0,0,drop,70,70,0,1,0,1,0
15503,42638,40530,42638,allow,1367,664,703,16,1200,9,7
65451,445,0,0,drop,66,66,0,1,0,1,0
49628,35440,0,0,deny,66,66,0,1,0,1,0
50810,443,16412,443,allow,10682,4653,6029,28,33,15,13
49637,445,0,0,drop,66,66,0,1,0,1,0
64449,30188,0,0,deny,62,62,0,1,0,1,0
80,34539,80,34539,allow,1468,1468,0,1,5,1,0
42065,53,0,0,allow,86,86,0,1,30,1,0
31845,55777,0,0,deny,62,62,0,1,0,1,0
17781,50265,0,0,deny,62,62,0,1,0,1,0
49272,53,51922,53,allow,266,94,172,2,30,1,1
55293,53,0,0,allow,166,73,93,2,30,1,1
50067,53,31624,53,allow,177,94,83,2,30,1,1
55196,445,0,0,drop,70,70,0,1,0,1,0
60213,80,54393,80,allow,47483,13980,33503,69,151,35,34
33856,443,15413,443,allow,8171028,105740,8065288,6637,149,745,5892
64249,53,29634,53,allow,178,91,87,2,30,1,1
65025,443,1842,443,allow,2227,1018,1209,17,16,8,9
50513,80,33823,80,allow,318,192,126,6,25,4,2
63202,445,0,0,drop,66,66,0,1,0,1,0
64329,445,0,0,drop,66,66,0,1,0,1,0
64583,53,34573,53,allow,179,94,85,2,30,1,1
57319,53,20750,53,allow,180,94,86,2,29,1,1
57590,443,26107,443,allow,2614,1689,925,18,19,10,8
54590,445,0,0,drop,70,70,0,1,0,1,0
55825,445,0,0,drop,70,70,0,1,0,1,0
50233,445,0,0,drop,70,70,0,1,0,1,0
60514,39004,0,0,deny,62,62,0,1,0,1,0
22677,25174,0,0,deny,66,66,0,1,0,1,0
64673,6881,0,0,deny,66,66,0,1,0,1,0
12457,57866,0,0,deny,62,62,0,1,0,1,0
39057,53,39057,53,allow,222,90,132,2,30,1,1
57451,443,58507,443,allow,19175423,168230,19007193,15129,313,2298,12831
59404,443,36010,443,allow,11018,5022,5996,84,588,43,41
57387,445,0,0,drop,70,70,0,1,0,1,0
50151,53,44129,53,allow,168,94,74,2,30,1,1
59718,445,0,0,drop,70,70,0,1,0,1,0
21213,23,0,0,deny,60,60,0,1,0,1,0
44013,53,44013,53,allow,197,76,121,2,30,1,1
54011,44847,0,0,deny,66,66,0,1,0,1,0
57577,80,57577,80,allow,172548,4355,168193,172,148,53,119
443,2629,0,0,deny,135,135,0,1,0,1,0
60774,443,14767,443,allow,29739,1164,28575,40,120,15,25
38557,443,3043,443,allow,70,70,0,1,5,1,0
58638,5900,0,0,deny,62,62,0,1,0,1,0
50475,445,0,0,drop,66,66,0,1,0,1,0
54820,443,53134,443,allow,16366,4160,12206,41,55,20,21
48286,443,48286,443,allow,4621,1714,2907,19,26,11,8
21179,44847,0,0,deny,62,62,0,1,0,1,0
49675,5900,49675,5900,allow,124,60,64,2,5,1,1
37616,443,4256,443,allow,18611,3046,15565,41,362,20,21
57131,35776,0,0,deny,145,145,0,1,0,1,0
2547,53,2547,53,allow,194,87,107,2,30,1,1
61045,445,0,0,drop,70,70,0,1,0,1,0
47166,15000,45851,15000,allow,130,70,60,2,5,1,1
32971,443,64078,443,allow,12597,6029,6568,36,267,15,21
51777,445,0,0,drop,70,70,0,1,0,1,0
38592,57209,0,0,deny,62,62,0,1,0,1,0
55089,53,6638,53,allow,199,102,97,2,30,1,1
57239,53,14403,53,allow,193,102,91,2,31,1,1
54559,445,0,0,drop,66,66,0,1,0,1,0
51216,22,51216,22,allow,5806,2153,3653,33,24,18,15
56845,53,40181,53,allow,730,102,628,2,30,1,1
55546,445,0,0,drop,70,70,0,1,0,1,0
56783,53,44833,53,allow,193,102,91,2,30,1,1
53643,445,0,0,drop,70,70,0,1,0,1,0
59448,445,0,0,drop,70,70,0,1,0,1,0
64965,53,42321,53,allow,200,94,106,2,31,1,1
62460,443,33310,443,allow,4608,3133,1475,18,35,10,8
51951,443,56049,443,allow,6633,3485,3148,34,197,19,15
44847,6881,3314,6881,allow,501,150,351,2,1200,1,1
52741,443,63085,443,allow,85011,4398,80613,113,26,52,61
57629,443,51109,443,allow,14555,5048,9507,82,134,33,49
49418,33058,55897,33058,allow,244,78,166,2,30,1,1
57331,53,38724,53,allow,166,86,80,2,30,1,1
58004,80,58289,80,allow,14922,10566,4356,39,75,20,19
65491,443,49902,443,allow,452013,13200,438813,465,16,163,302
60602,15503,0,0,deny,66,66,0,1,0,1,0
55730,8060,61259,8060,allow,70,70,0,1,4,1,0
55555,53,24469,53,allow,194,102,92,2,30,1,1
60744,40010,53059,40010,allow,316,136,180,6,5,3,3
59792,445,0,0,drop,70,70,0,1,0,1,0
56941,53,42543,53,allow,196,102,94,2,30,1,1
63116,53,14772,53,allow,578,286,292,9,15,5,4
65361,53,22669,53,allow,249,94,155,2,30,1,1
58855,80,59829,80,allow,1601,902,699,8,387,5,3
54961,53,55140,53,allow,375,99,276,4,54,2,2
51534,443,19846,443,allow,262,70,192,5,21,2,3
55782,53,22320,53,allow,245,94,151,2,29,1,1
26408,64147,0,0,deny,66,66,0,1,0,1,0
32346,53,32346,53,allow,200,90,110,2,30,1,1
443,62732,0,0,deny,332,332,0,1,0,1,0
59718,445,0,0,drop,66,66,0,1,0,1,0
9430,443,49322,443,allow,6094,771,5323,17,26,9,8
57150,53,61382,53,allow,166,86,80,2,31,1,1
38706,443,10577,443,allow,90545,3481,87064,96,16,31,65
48144,443,29490,443,allow,16198,9822,6376,54,35,28,26
60960,49049,0,0,deny,66,66,0,1,0,1,0
63427,443,12602,443,allow,15135,12791,2344,43,81,22,21
16376,35440,0,0,deny,62,62,0,1,0,1,0
60245,25174,0,0,deny,62,62,0,1,0,1,0
45941,23386,0,0,deny,60,60,0,1,0,1,0
7104,23,0,0,deny,60,60,0,1,0,1,0
60417,55100,30057,55100,allow,258,70,188,4,8,2,2
52342,445,0,0,drop,66,66,0,1,0,1,0
53250,443,16467,443,allow,70319,5815,64504,146,67,52,94
50485,445,0,0,drop,70,70,0,1,0,1,0
64878,26467,0,0,deny,62,62,0,1,0,1,0
60023,443,8218,443,allow,9660,4678,4982,30,144,15,15
45941,23388,0,0,deny,60,60,0,1,0,1,0
58987,443,9430,443,allow,3730,2378,1352,23,28,12,11
49242,53,36950,53,allow,183,94,89,2,30,1,1
46479,443,13902,443,allow,5241,2026,3215,50,6660,18,32
55934,445,0,0,drop,66,66,0,1,0,1,0
51728,55504,11641,55504,allow,316,136,180,6,6,3,3
56481,53,28182,53,allow,816,102,714,2,30,1,1
37306,53,55019,53,allow,168,78,90,2,30,1,1
62005,80,62005,80,allow,11822,1162,10660,22,20,11,11
49035,443,36911,443,allow,4299,2327,1972,23,315,11,12
56743,53,5034,53,allow,209,110,99,2,30,1,1
59559,443,17669,443,allow,6328,1536,4792,23,17,12,11
55862,445,0,0,drop,70,70,0,1,0,1,0
37855,443,39398,443,allow,25928,15100,10828,59,39,37,22
63778,445,0,0,drop,66,66,0,1,0,1,0
7105,25174,0,0,deny,66,66,0,1,0,1,0
53556,1024,53867,1024,allow,70,70,0,2,8,2,0
57325,37965,0,0,deny,62,62,0,1,0,1,0
64634,53,6012,53,allow,211,102,109,2,29,1,1
53235,443,2490,443,allow,11111,1014,10097,24,37,10,14
39422,443,26393,443,allow,557795,16003,541792,528,76,139,389
64883,53,2709,53,allow,184,94,90,2,30,1,1
63917,57826,24551,57826,allow,66,66,0,2,7,2,0
2995,26467,0,0,deny,62,62,0,1,0,1,0
56654,53,36546,53,allow,209,110,99,2,30,1,1
57750,15000,45543,15000,allow,130,70,60,2,5,1,1
55688,53,32958,53,allow,182,93,89,2,30,1,1
38663,15000,54810,15000,allow,138,78,60,2,5,1,1
58096,445,0,0,drop,70,70,0,1,0,1,0
56168,445,0,0,drop,70,70,0,1,0,1,0
56623,443,54121,443,allow,7982,1962,6020,20,15,11,9
57202,445,0,0,drop,66,66,0,1,0,1,0
56490,445,0,0,drop,70,70,0,1,0,1,0
64490,445,0,0,drop,70,70,0,1,0,1,0
56896,80,32594,80,allow,2684,2550,134,7,16,5,2
56235,80,56235,80,allow,44756,824,43932,45,15,12,33
58638,5900,58638,5900,allow,66,66,0,1,4,1,0
61800,3389,61800,3389,allow,3429,1474,1955,16,16,8,8
49963,53,54838,53,allow,279,96,183,4,59,2,2
64472,53,59070,53,allow,183,94,89,2,31,1,1
60011,443,31949,443,allow,6053,2582,3471,30,80,15,15
56737,445,0,0,drop,66,66,0,1,0,1,0
14615,57866,0,0,deny,66,66,0,1,0,1,0
32962,443,9560,443,allow,3935,1010,2925,20,165,9,11
53733,40599,57099,40599,allow,70,70,0,2,7,2,0
42298,40023,34639,40023,allow,1188,567,621,6,31,3,3
59162,445,0,0,drop,66,66,0,1,0,1,0
62153,445,0,0,drop,66,66,0,1,0,1,0
29011,32468,0,0,deny,62,62,0,1,0,1,0
59792,445,0,0,drop,66,66,0,1,0,1,0
5213,44847,0,0,deny,66,66,0,1,0,1,0
49876,53,33233,53,allow,199,102,97,2,30,1,1
54223,445,0,0,drop,66,66,0,1,0,1,0
49177,54532,0,0,deny,60,60,0,1,0,1,0
39617,50584,0,0,deny,62,62,0,1,0,1,0
49933,80,49306,80,allow,1130,613,517,11,15,6,5
60022,80,60022,80,allow,2959,1505,1454,10,15,6,4
50604,443,50604,443,allow,4716,1809,2907,19,30,11,8
55869,445,0,0,drop,66,66,0,1,0,1,0
49466,53,63344,53,allow,807,94,713,2,30,1,1
993,16279,0,0,deny,129,129,0,1,0,1,0
11006,23117,0,0,deny,146,146,0,1,0,1,0
65114,443,65114,443,allow,4480,1573,2907,19,30,11,8
50089,443,20398,443,allow,292,172,120,4,15,2,2
63937,445,0,0,drop,70,70,0,1,0,1,0
37622,443,52437,443,allow,12542,2527,10015,31,48,18,13
54001,445,0,0,drop,70,70,0,1,0,1,0
56593,443,58940,443,allow,1165,662,503,11,25,6,5
58638,5900,0,0,deny,62,62,0,1,0,1,0
51004,445,0,0,drop,66,66,0,1,0,1,0
53233,51221,0,0,deny,66,66,0,1,0,1,0
54819,443,51937,443,allow,9035,1873,7162,28,124,14,14
59055,11392,0,0,deny,66,66,0,1,0,1,0
55367,53,46146,53,allow,195,102,93,2,31,1,1
8903,23,0,0,deny,60,60,0,1,0,1,0
2278,25174,0,0,deny,146,146,0,1,0,1,0
61527,51050,0,0,deny,66,66,0,1,0,1,0
64963,27037,16564,27037,allow,741,462,279,2,31,1,1
58079,50584,0,0,deny,62,62,0,1,0,1,0
64991,443,64991,443,allow,9107,1499,7608,20,75,11,9
51769,51505,0,0,deny,62,62,0,1,0,1,0
53207,50584,0,0,deny,66,66,0,1,0,1,0
9515,443,54612,443,allow,318,192,126,6,34,4,2
49313,53,49710,53,allow,199,102,97,2,30,1,1
56621,53,63745,53,allow,177,94,83,2,29,1,1
56569,53,65375,53,allow,91,91,0,1,31,1,0
49824,53,9699,53,allow,172,88,84,2,31,1,1
51832,40607,33466,40607,allow,66,66,0,1,5,1,0
51464,23,0,0,deny,60,60,0,1,0,1,0
44796,443,34897,443,allow,8158,2927,5231,25,85,15,10
49846,445,0,0,drop,66,66,0,1,0,1,0
33539,53,23280,53,allow,336,231,105,3,30,2,1
37635,443,29591,443,allow,4266,1768,2498,18,121,8,10
61155,443,61155,443,allow,4575,1668,2907,19,27,11,8
7286,44847,0,0,deny,66,66,0,1,0,1,0
33912,25174,0,0,deny,62,62,0,1,0,1,0
65040,53,10817,53,allow,180,94,86,2,31,1,1
56900,445,0,0,drop,66,66,0,1,0,1,0
64385,443,64385,443,allow,18895,2061,16834,34,18,18,16
46778,53,46778,53,allow,214,82,132,2,30,1,1
3478,61463,0,0,deny,1163,1163,0,1,0,1,0
52474,123,6683,123,allow,184,94,90,2,30,1,1
6881,6881,56597,6881,allow,231,111,120,2,1200,1,1
55332,53,34862,53,allow,211,110,101,2,30,1,1
58819,443,22154,443,allow,5168,700,4468,16,14,7,9
56494,53,64995,53,allow,793,101,692,2,31,1,1
55425,5222,24173,5222,allow,9151,4417,4734,84,77,44,40
2278,25174,0,0,deny,62,62,0,1,0,1,0
50484,445,0,0,drop,70,70,0,1,0,1,0
54913,445,0,0,drop,70,70,0,1,0,1,0
56978,53,58165,53,allow,774,101,673,2,30,1,1
57604,53,48752,53,allow,290,86,204,2,29,1,1
52006,49849,11177,49849,allow,70,70,0,2,7,2,0
57252,443,17744,443,allow,12683,4753,7930,59,36,33,26
55313,53,12662,53,allow,168,78,90,2,29,1,1
65194,53,61837,53,allow,402,142,260,2,31,1,1
47771,25174,0,0,deny,146,146,0,1,0,1,0
16760,10214,0,0,deny,62,62,0,1,0,1,0
64655,443,35493,443,allow,8903,2857,6046,22,135,10,12
56876,11392,0,0,deny,66,66,0,1,0,1,0
49940,443,15585,443,allow,4363,1298,3065,17,127,8,9
65350,53,19451,53,allow,75,75,0,1,30,1,0
53165,445,0,0,drop,70,70,0,1,0,1,0
46275,64147,0,0,deny,62,62,0,1,0,1,0
57109,53,44560,53,allow,711,87,624,2,31,1,1
62549,445,0,0,drop,70,70,0,1,0,1,0
49828,53,40540,53,allow,578,286,292,9,15,5,4
65072,80,65072,80,allow,250600,11390,239210,268,23,98,170
57034,445,0,0,drop,66,66,0,1,0,1,0
64271,53,22789,53,allow,198,94,104,2,30,1,1
57038,53,18909,53,allow,194,102,92,2,33,1,1
50589,445,0,0,drop,70,70,0,1,0,1,0
57937,22114,0,0,deny,146,146,0,1,0,1,0
49529,21247,0,0,deny,62,62,0,1,0,1,0
37008,42707,0,0,deny,62,62,0,1,0,1,0
61566,44847,0,0,deny,66,66,0,1,0,1,0
48488,50584,0,0,deny,62,62,0,1,0,1,0
38774,80,38774,80,allow,369073,4523,364550,316,142,59,257
62914,11392,0,0,deny,62,62,0,1,0,1,0
53901,443,43794,443,allow,499,425,74,4,0,3,1
58576,445,0,0,drop,70,70,0,1,0,1,0
46654,80,33249,80,allow,1518,954,564,14,320,8,6
20,64488,20,50706,allow,624666,17676,606990,671,14,267,404
56907,53,11065,53,allow,193,102,91,2,31,1,1
51958,51322,52514,51322,allow,70,70,0,2,7,2,0
55001,445,0,0,drop,70,70,0,1,0,1,0
51773,445,0,0,drop,66,66,0,1,0,1,0
28124,37965,0,0,deny,62,62,0,1,0,1,0
52189,53,52189,53,allow,825,99,726,2,30,1,1
49555,53,60187,53,allow,578,286,292,9,15,5,4
65003,27046,30438,27046,allow,1749,924,825,6,31,3,3
50477,80,59736,80,allow,648,256,392,8,25,5,3
51388,443,47694,443,allow,4209,1570,2639,14,136,7,7
57169,53,55765,53,allow,458,188,270,6,31,3,3
60416,37965,0,0,deny,66,66,0,1,0,1,0
51172,44847,0,0,deny,66,66,0,1,0,1,0
47661,443,40195,443,allow,3718,420,3298,13,120,6,7
48706,23393,0,0,deny,60,60,0,1,0,1,0
56852,49677,39171,49677,allow,130,70,60,2,5,1,1
3375,35253,0,0,deny,66,66,0,1,0,1,0
55958,53,17152,53,allow,177,94,83,2,30,1,1
62810,445,0,0,drop,66,66,0,1,0,1,0
52608,445,0,0,drop,70,70,0,1,0,1,0
59066,445,0,0,drop,66,66,0,1,0,1,0
63086,445,0,0,drop,70,70,0,1,0,1,0
51505,17372,0,0,deny,66,66,0,1,0,1,0
26458,80,26458,80,allow,490,264,226,8,32,5,3
55002,445,0,0,drop,70,70,0,1,0,1,0
40865,8100,38607,8100,allow,234,234,0,4,11,4,0
54077,445,0,0,drop,70,70,0,1,0,1,0
24692,53,24692,53,allow,235,90,145,2,32,1,1
57382,53,16095,53,allow,184,94,90,2,31,1,1
16647,53,16647,53,allow,233,91,142,2,30,1,1
54486,443,15577,443,allow,3170,1036,2134,13,135,6,7
57333,53,60768,53,allow,167,86,81,2,30,1,1
14740,26467,0,0,deny,62,62,0,1,0,1,0
55454,53,25468,53,allow,209,110,99,2,30,1,1
9745,26467,0,0,deny,62,62,0,1,0,1,0
37598,443,64510,443,allow,8102,2685,5417,24,17,15,9
63533,445,0,0,drop,70,70,0,1,0,1,0
53741,43800,30138,43800,allow,70,70,0,1,5,1,0
65323,53,53376,53,allow,247,118,129,2,30,1,1
64621,53,52780,53,allow,387,134,253,2,29,1,1
38861,443,38861,443,allow,90303,5838,84465,140,103,68,72
59079,445,0,0,drop,66,66,0,1,0,1,0
57837,64147,0,0,deny,66,66,0,1,0,1,0
50691,80,17442,80,allow,55050,28089,26961,228,175,112,116
45292,443,27457,443,allow,26444,2671,23773,52,363,25,27
51042,22114,0,0,deny,66,66,0,1,0,1,0
62316,445,0,0,drop,70,70,0,1,0,1,0
55113,53,22722,53,allow,177,94,83,2,30,1,1
64697,37965,0,0,deny,66,66,0,1,0,1,0
50847,445,0,0,drop,66,66,0,1,0,1,0
49983,53,17295,53,allow,211,110,101,2,31,1,1
49996,53,8571,53,allow,183,94,89,2,30,1,1
58628,445,0,0,drop,70,70,0,1,0,1,0
61280,26467,0,0,deny,66,66,0,1,0,1,0
42555,443,40081,443,allow,14262,5874,8388,31,138,15,16
51964,443,11131,443,allow,5363,2713,2650,26,53,14,12
51015,80,51015,80,allow,1905,1456,449,10,20,6,4
56770,53,31600,53,allow,779,86,693,2,30,1,1
54774,445,0,0,drop,66,66,0,1,0,1,0
61141,445,0,0,drop,70,70,0,1,0,1,0
56626,443,37778,443,allow,45304,28614,16690,82,41,45,37
50440,53,52778,53,allow,458,188,270,6,29,3,3
57834,80,57834,80,allow,2106,1657,449,10,20,6,4
63497,445,0,0,drop,66,66,0,1,0,1,0
64714,53,5629,53,allow,250,86,164,4,36,2,2
62345,443,13195,443,allow,6343025,74037,6268988,5018,58,765,4253
65289,25174,0,0,deny,66,66,0,1,0,1,0
52946,445,0,0,drop,70,70,0,1,0,1,0
58453,443,9103,443,allow,9972,2138,7834,39,130,19,20
1733,65448,0,0,deny,66,66,0,1,0,1,0
60383,16881,9133,16881,allow,564,318,246,9,18,5,4
51109,11392,0,0,deny,66,66,0,1,0,1,0
51760,50584,0,0,deny,62,62,0,1,0,1,0
55643,53,39402,53,allow,182,93,89,2,0,1,1
56166,53,54206,53,allow,193,102,91,2,29,1,1
52650,44847,0,0,deny,66,66,0,1,0,1,0
37965,6881,15418,6881,allow,1534,248,1286,4,1200,2,2
58238,23,0,0,deny,60,60,0,1,0,1,0
51925,29587,19217,29587,allow,70,70,0,1,5,1,0
35291,44847,0,0,deny,66,66,0,1,0,1,0
50475,80,50475,80,allow,26023,3118,22905,38,24,18,20
63708,445,0,0,drop,66,66,0,1,0,1,0
55598,53,62889,53,allow,186,102,84,2,30,1,1
53278,445,0,0,drop,70,70,0,1,0,1,0
49341,53,21121,53,allow,392,86,306,2,29,1,1
65285,44847,0,0,deny,62,62,0,1,0,1,0
55898,53,25351,53,allow,757,102,655,2,30,1,1
36548,25174,0,0,deny,146,146,0,1,0,1,0
49285,6881,35710,6881,allow,411,225,186,6,16,3,3
58392,445,0,0,drop,66,66,0,1,0,1,0
64796,53,48263,53,allow,184,94,90,2,31,1,1
29512,30188,0,0,deny,66,66,0,1,0,1,0
65276,445,0,0,drop,66,66,0,1,0,1,0
31750,53,31750,53,allow,200,90,110,2,30,1,1
55749,445,0,0,drop,66,66,0,1,0,1,0
61925,51505,0,0,deny,62,62,0,1,0,1,0
14260,36829,0,0,deny,62,62,0,1,0,1,0
35196,8635,35196,8635,allow,138,78,60,2,5,1,1
48550,80,64861,80,allow,811,671,140,6,22,4,2
56337,53,7280,53,allow,268,89,179,4,44,2,2
14447,25174,0,0,deny,62,62,0,1,0,1,0
56586,53,7181,53,allow,177,94,83,2,30,1,1
55332,53,16316,53,allow,206,105,101,2,31,1,1
56242,445,0,0,drop,70,70,0,1,0,1,0
49590,445,0,0,drop,66,66,0,1,0,1,0
44119,53,25337,53,allow,168,78,90,2,30,1,1
49208,6881,5366,6881,allow,66,66,0,1,5,1,0
56427,53,1277,53,allow,178,94,84,2,30,1,1
63460,55160,0,0,deny,66,66,0,1,0,1,0
27005,1106,55769,1106,allow,903,126,777,2,30,1,1
1831,53,1831,53,allow,194,87,107,2,30,1,1
3937,36829,0,0,deny,62,62,0,1,0,1,0
30188,1381,10671,1381,allow,324,150,174,2,1200,1,1
63850,6881,54520,6881,allow,66,66,0,2,7,2,0
55080,53,11951,53,allow,173,94,79,2,29,1,1
63239,445,0,0,drop,70,70,0,1,0,1,0
49638,53,6600,53,allow,210,110,100,2,30,1,1
37923,443,39242,443,allow,2593394,70243,2523151,2678,303,908,1770
56645,443,46847,443,allow,7914,1925,5989,20,15,11,9
50464,80,5838,80,allow,26020,2247,23773,47,18,23,24
55436,53,43899,53,allow,774,101,673,2,30,1,1
56991,445,0,0,drop,66,66,0,1,0,1,0
49971,53,63730,53,allow,198,102,96,2,30,1,1
52093,40828,29609,40828,allow,160,70,90,2,5,1,1
49968,53,43611,53,allow,751,94,657,2,30,1,1
55629,36190,12886,36190,allow,504,318,186,8,16,5,3
51592,51505,0,0,deny,62,62,0,1,0,1,0
59381,53,57847,53,allow,189,78,111,2,30,1,1
38685,443,17432,443,allow,749731,23099,726632,823,16,326,497
63857,445,0,0,drop,70,70,0,1,0,1,0
65419,53,45268,53,allow,199,102,97,2,30,1,1
65011,53,37444,53,allow,183,94,89,2,31,1,1
48388,44847,0,0,deny,62,62,0,1,0,1,0
53224,445,0,0,drop,66,66,0,1,0,1,0
56556,53,18816,53,allow,184,94,90,2,31,1,1
50820,443,50820,443,allow,37757,4416,33341,44,32,17,27
54797,445,0,0,drop,70,70,0,1,0,1,0
53419,445,0,0,drop,66,66,0,1,0,1,0
27988,40002,58461,40002,allow,144,82,62,2,31,1,1
40877,443,50860,443,allow,6451,1003,5448,21,360,11,10
64510,443,61997,443,allow,18370,2434,15936,26,120,11,15
37606,443,47206,443,allow,6277,1868,4409,22,45,13,9
59549,445,0,0,drop,70,70,0,1,0,1,0
49518,53,40851,53,allow,167,86,81,2,30,1,1
43104,26467,0,0,deny,62,62,0,1,0,1,0
56522,53,51170,53,allow,177,94,83,2,30,1,1
50569,443,18328,443,allow,5941,1856,4085,22,81,13,9
27323,23117,0,0,deny,146,146,0,1,0,1,0
49548,53,36556,53,allow,198,94,104,2,29,1,1
55807,445,0,0,drop,70,70,0,1,0,1,0
6882,46440,39998,46440,allow,324,150,174,2,1200,1,1
57470,20014,49843,20014,allow,528,528,0,9,1200,9,0
53544,22051,5386,22051,allow,70,70,0,1,5,1,0
61392,50584,0,0,deny,146,146,0,1,0,1,0
30960,45738,57653,45738,allow,396,396,0,7,3615,7,0
49668,53,59883,53,allow,200,94,106,2,29,1,1
59755,443,15018,443,allow,448,166,282,2,30,1,1
14717,64147,0,0,deny,66,66,0,1,0,1,0
61388,80,19899,80,allow,14158,1392,12766,26,255,14,12
64299,445,0,0,drop,70,70,0,1,0,1,0
61898,445,0,0,drop,70,70,0,1,0,1,0
44059,23,0,0,deny,60,60,0,1,0,1,0
49939,53,35576,53,allow,229,102,127,2,30,1,1
65232,53,42020,53,allow,311,94,217,2,30,1,1
53872,443,4533,443,allow,11541,4181,7360,62,283,27,35
49904,53,31561,53,allow,217,94,123,2,29,1,1
6057,51221,0,0,deny,78,78,0,1,0,1,0
57108,53,22880,53,allow,186,95,91,2,30,1,1
54904,445,0,0,drop,70,70,0,1,0,1,0
57493,445,0,0,drop,70,70,0,1,0,1,0
38852,443,38852,443,allow,4747,1840,2907,19,28,11,8
61250,42873,0,0,deny,66,66,0,1,0,1,0
65234,53,58797,53,allow,193,102,91,2,31,1,1
64146,445,0,0,drop,66,66,0,1,0,1,0
29682,44847,0,0,deny,62,62,0,1,0,1,0
52088,445,0,0,drop,70,70,0,1,0,1,0
58191,445,0,0,drop,70,70,0,1,0,1,0
53126,47035,16520,47035,allow,70,70,0,2,8,2,0
54625,53,52244,53,allow,168,78,90,2,30,1,1
52827,445,0,0,drop,70,70,0,1,0,1,0
43757,3389,43757,3389,allow,3910,1805,2105,20,18,12,8
20724,19750,0,0,deny,78,78,0,1,0,1,0
11562,30188,0,0,deny,62,62,0,1,0,1,0
56873,445,0,0,drop,70,70,0,1,0,1,0
55006,53,7313,53,allow,711,87,624,2,30,1,1
9175,443,52821,443,allow,6331,837,5494,19,28,10,9
30784,30975,0,0,deny,159,159,0,1,0,1,0
56544,443,50945,443,allow,3413,1537,1876,19,7,10,9
50629,443,47938,443,allow,6553,1034,5519,23,87,12,11
55879,53,59038,53,allow,184,94,90,2,30,1,1
64566,53,50358,53,allow,347,107,240,4,42,2,2
54950,445,0,0,drop,70,70,0,1,0,1,0
56785,28902,1768,28902,allow,70,70,0,2,8,2,0
44847,43154,42931,43154,allow,150,150,0,1,1200,1,0
50677,445,0,0,drop,70,70,0,1,0,1,0
14247,53,14247,53,allow,197,90,107,2,30,1,1
61440,443,7179,443,allow,7896,1207,6689,20,26,10,10
51397,445,0,0,drop,70,70,0,1,0,1,0
16693,53,16693,53,allow,217,87,130,2,31,1,1
53530,53,6923,53,allow,164,78,86,2,30,1,1
52230,50265,0,0,deny,66,66,0,1,0,1,0
56395,445,0,0,drop,70,70,0,1,0,1,0
65099,53,58455,53,allow,199,102,97,2,30,1,1
34784,53,61391,53,allow,168,78,90,2,30,1,1
57255,443,53541,443,allow,4769,2622,2147,14,135,7,7
55707,53,54526,53,allow,811,94,717,2,30,1,1
27005,49000,16886,49000,allow,887,126,761,2,31,1,1
59649,443,47146,443,allow,11784,7785,3999,55,120,28,27
8411,8411,36899,8411,allow,66,66,0,1,30,1,0
51770,37237,29637,37237,allow,316,136,180,6,6,3,3
49250,445,0,0,drop,66,66,0,1,0,1,0
50470,61463,0,0,deny,86,86,0,1,0,1,0
55908,53,13210,53,allow,389,110,279,2,30,1,1
50128,80,27649,80,allow,20575,11455,9120,92,966,47,45
52914,37965,0,0,deny,66,66,0,1,0,1,0
49778,445,0,0,drop,66,66,0,1,0,1,0
34656,443,55937,443,allow,3521,516,3005,12,15,6,6
47357,50584,0,0,deny,66,66,0,1,0,1,0
64647,53,15086,53,allow,718,94,624,2,30,1,1
65460,53,40464,53,allow,197,102,95,2,30,1,1
39583,37965,0,0,deny,66,66,0,1,0,1,0
27005,27015,48788,27015,allow,913,126,787,2,30,1,1
53724,443,35083,443,allow,7759,1476,6283,24,19,14,10
57177,53,17706,53,allow,179,94,85,2,31,1,1
39277,443,14513,443,allow,6891,1421,5470,20,127,12,8
46557,57866,0,0,deny,66,66,0,1,0,1,0
52111,80,49500,80,allow,1582,866,716,11,20,7,4
65491,53,31323,53,allow,193,102,91,2,33,1,1
59599,62413,0,0,deny,62,62,0,1,0,1,0
56561,53,31365,53,allow,216,110,106,2,31,1,1
56919,53,23336,53,allow,193,102,91,2,30,1,1
62872,50584,0,0,deny,66,66,0,1,0,1,0
26900,27017,59839,27017,allow,422,164,258,6,30,3,3
65064,53,46432,53,allow,198,102,96,2,30,1,1
20108,64147,0,0,deny,62,62,0,1,0,1,0
56964,443,49041,443,allow,8085,2164,5921,22,86,12,10
57470,8621,39581,8621,allow,469,150,319,2,1199,1,1
50455,443,11561,443,allow,107749,6262,101487,142,138,58,84
65121,445,0,0,drop,66,66,0,1,0,1,0
57176,53,54360,53,allow,178,94,84,2,29,1,1
50480,443,52040,443,allow,14848,6716,8132,32,30,17,15
53652,57503,44187,57503,allow,492,306,186,8,15,5,3
61141,443,38623,443,allow,383052,17263,365789,396,132,119,277
6943,59353,0,0,deny,100,100,0,1,0,1,0
49432,53,5253,53,allow,177,94,83,2,31,1,1
18655,50584,0,0,deny,62,62,0,1,0,1,0
52130,1035,4806,1035,allow,70,70,0,2,8,2,0
55169,53,40051,53,allow,199,102,97,2,30,1,1
64175,56502,0,0,deny,66,66,0,1,0,1,0
65488,53,3940,53,allow,266,110,156,2,30,1,1
64357,53,57507,53,allow,271,85,186,4,30,2,2
38269,80,33887,80,allow,190,70,120,4,14,2,2
60778,40010,59381,40010,allow,316,136,180,6,6,3,3
20939,60461,0,0,deny,60,60,0,1,0,1,0
58638,5900,0,0,deny,62,62,0,1,0,1,0
57389,53,59363,53,allow,186,95,91,2,30,1,1
55600,22,0,0,deny,60,60,0,1,0,1,0
53464,3389,53464,3389,allow,4245,2461,1784,18,31,9,9
36109,443,56907,443,allow,26538,7971,18567,70,128,38,32
55970,53,19238,53,allow,760,97,663,2,31,1,1
49281,53,58920,53,allow,345,110,235,2,29,1,1
50072,53,22723,53,allow,779,86,693,2,30,1,1
58702,445,0,0,drop,66,66,0,1,0,1,0
65339,53,24574,53,allow,193,102,91,2,30,1,1
63895,44847,0,0,deny,62,62,0,1,0,1,0
3064,44847,0,0,deny,62,62,0,1,0,1,0
2543,25174,0,0,deny,66,66,0,1,0,1,0
55255,445,0,0,drop,70,70,0,1,0,1,0
56994,53,65507,53,allow,170,87,83,2,30,1,1
52442,445,0,0,drop,70,70,0,1,0,1,0
42298,40005,19733,40005,allow,148,86,62,2,30,1,1
6881,6881,0,0,deny,146,146,0,1,0,1,0
38338,443,60739,443,allow,499,425,74,4,0,3,1
35828,8970,0,0,reset-both,146,146,0,1,0,1,0
51973,80,59636,80,allow,21570,1613,19957,33,54,16,17
2267,53,21811,53,allow,204,118,86,2,30,1,1
50665,443,26812,443,allow,374,192,182,7,28,4,3
49418,27015,41865,27015,allow,242,71,171,2,31,1,1
51244,1,0,0,deny,100,100,0,1,0,1,0
63023,443,14505,443,allow,382,164,218,2,30,1,1
49501,80,23659,80,allow,183116,16652,166464,279,486,59,220
60241,443,3002,443,allow,92975,3289,89686,107,316,40,67
64567,53,15933,53,allow,198,101,97,2,30,1,1
49618,80,5688,80,allow,314,192,122,6,42,4,2
49654,53,58330,53,allow,184,94,90,2,31,1,1
10007,40005,19403,40005,allow,148,86,62,2,31,1,1
55504,445,0,0,drop,70,70,0,1,0,1,0
61981,445,0,0,drop,70,70,0,1,0,1,0
59401,445,0,0,drop,66,66,0,1,0,1,0
60246,44612,0,0,deny,66,66,0,1,0,1,0
54989,80,38298,80,allow,8159037,271621,7887416,9644,214,4424,5220
53354,80,22791,80,allow,2722,1530,1192,12,316,7,5
27005,27018,12355,27018,allow,879,126,753,2,30,1,1
55830,53,60660,53,allow,182,93,89,2,31,1,1
27005,27016,41906,27016,allow,882,126,756,2,30,1,1
54973,53,14051,53,allow,181,94,87,2,30,1,1
52514,445,0,0,drop,70,70,0,1,0,1,0
44047,443,38951,443,allow,6750,4410,2340,19,120,9,10
49505,443,25913,443,allow,6318,2030,4288,25,270,12,13
50627,443,16215,443,allow,8256,1674,6582,31,75,15,16
26461,80,26461,80,allow,490,264,226,8,32,5,3
6889,55108,0,0,deny,143,143,0,1,0,1,0
50615,445,0,0,drop,70,70,0,1,0,1,0
53967,54589,61471,54589,allow,70,70,0,1,5,1,0
55450,53,2536,53,allow,102,102,0,1,30,1,0
64274,53,57250,53,allow,104,104,0,2,35,2,0
61191,443,24135,443,allow,569471,20976,548495,666,333,273,393
58638,5900,0,0,deny,62,62,0,1,0,1,0
53986,54070,39036,54070,allow,70,70,0,1,5,1,0
55022,53,45433,53,allow,195,102,93,2,30,1,1
38009,443,41561,443,allow,130,70,60,3,5,2,1
65501,443,33887,443,allow,416348,12360,403988,429,16,151,278
55330,53,64550,53,allow,194,102,92,2,31,1,1
54700,445,0,0,drop,70,70,0,1,0,1,0
49256,445,0,0,drop,70,70,0,1,0,1,0
19473,35726,44271,35726,allow,481,150,331,2,1200,1,1
49832,445,0,0,drop,70,70,0,1,0,1,0
50764,445,0,0,drop,70,70,0,1,0,1,0
55992,80,41926,80,allow,57401,3150,54251,84,109,43,41
8878,80,27996,80,allow,1220,403,817,15,414,4,11
53608,1024,52758,1024,allow,70,70,0,2,8,2,0
56523,53,57340,53,allow,168,86,82,2,30,1,1
56289,53,22157,53,allow,351,110,241,2,29,1,1
58638,5900,0,0,deny,62,62,0,1,0,1,0
54683,445,0,0,drop,70,70,0,1,0,1,0
60223,445,0,0,drop,70,70,0,1,0,1,0
56427,53,59591,53,allow,166,86,80,2,30,1,1
56667,53,19814,53,allow,244,94,150,2,30,1,1
9259,80,48036,80,allow,318,192,126,6,26,4,2
60842,445,0,0,drop,66,66,0,1,0,1,0
60438,53,9919,53,allow,77,77,0,2,31,2,0
57410,37965,0,0,deny,66,66,0,1,0,1,0
59513,445,0,0,drop,66,66,0,1,0,1,0
51209,445,0,0,drop,66,66,0,1,0,1,0
5223,13602,0,0,deny,66,66,0,1,0,1,0
49418,30010,58880,30010,allow,238,71,167,2,30,1,1
40481,22114,0,0,deny,66,66,0,1,0,1,0
52986,443,58135,443,allow,280,140,140,5,130,3,2
56994,80,47420,80,allow,214,140,74,4,35,3,1
56973,53,12553,53,allow,186,95,91,2,31,1,1
52475,445,0,0,drop,66,66,0,1,0,1,0
50429,80,32057,80,allow,318,192,126,6,26,4,2
53448,445,0,0,drop,70,70,0,1,0,1,0
45400,80,25751,80,allow,574,500,74,6,15,5,1
47326,443,40388,443,allow,6318,1025,5293,17,33,9,8
58638,5900,0,0,deny,62,62,0,1,0,1,0
48847,443,57026,443,allow,2478246,45190,2433056,2175,27,520,1655
61315,445,0,0,drop,70,70,0,1,0,1,0
51252,443,8705,443,allow,9600,4628,4972,41,16,24,17
54947,445,0,0,drop,70,70,0,1,0,1,0
55199,53,62103,53,allow,196,94,102,2,30,1,1
60779,445,0,0,drop,70,70,0,1,0,1,0
58472,53,5380,53,allow,86,86,0,1,30,1,0
55007,443,50452,443,allow,9726,4743,4983,41,15,24,17
64310,53,12682,53,allow,404,102,302,2,30,1,1
64085,53,40904,53,allow,195,94,101,2,31,1,1
2332,35440,0,0,deny,66,66,0,1,0,1,0
61642,445,0,0,drop,70,70,0,1,0,1,0
33563,14037,0,0,deny,78,78,0,1,0,1,0
57472,44847,0,0,deny,62,62,0,1,0,1,0
21534,42246,0,0,deny,66,66,0,1,0,1,0
57470,39608,19893,39608,allow,330,330,0,6,1199,6,0
56362,443,29740,443,allow,12746,7725,5021,39,234,24,15
57020,36237,0,0,deny,66,66,0,1,0,1,0
22904,56205,0,0,deny,146,146,0,1,0,1,0
65473,443,51323,443,allow,91831,4379,87452,101,15,37,64
63385,25174,0,0,deny,66,66,0,1,0,1,0
65138,53,7886,53,allow,418,94,324,2,30,1,1
41249,443,56931,443,allow,2080,1126,954,17,150,10,7
1024,44847,0,0,deny,146,146,0,1,0,1,0
49888,53,54251,53,allow,196,100,96,2,30,1,1
59223,17500,0,0,deny,66,66,0,1,0,1,0
6881,6881,0,0,deny,146,146,0,1,0,1,0
57507,7000,57507,7000,allow,3562,1995,1567,16,15,9,7
49845,53,59006,53,allow,168,86,82,2,30,1,1
56317,445,0,0,drop,70,70,0,1,0,1,0
56699,80,7390,80,allow,64386,3122,61264,79,64,35,44
49338,53,20545,53,allow,368,94,274,2,30,1,1
51709,445,0,0,drop,70,70,0,1,0,1,0
51975,80,44833,80,allow,426,240,186,8,25,5,3
32395,30188,0,0,deny,146,146,0,1,0,1,0
30697,57866,0,0,deny,62,62,0,1,0,1,0
37572,443,26829,443,allow,30365,21942,8423,58,50,32,26
50025,53,43960,53,allow,536,120,416,4,59,2,2
53419,28189,0,0,deny,60,60,0,1,0,1,0
56396,53,60964,53,allow,183,94,89,2,30,1,1
48258,37965,0,0,deny,62,62,0,1,0,1,0
59462,445,0,0,drop,70,70,0,1,0,1,0
57578,80,57578,80,allow,55886,2728,53158,68,148,25,43
49766,80,16081,80,allow,254,128,126,5,15,3,2
40215,443,50672,443,allow,5656,1009,4647,24,87,10,14
60021,445,0,0,drop,70,70,0,1,0,1,0
3478,61463,0,0,deny,328,328,0,1,0,1,0
32997,22,0,0,deny,60,60,0,1,0,1,0
65264,53,8238,53,allow,256,88,168,4,35,2,2
49786,25174,0,0,deny,66,66,0,1,0,1,0
51938,445,0,0,drop,70,70,0,1,0,1,0
33931,50584,0,0,deny,146,146,0,1,0,1,0
63934,53,38044,53,allow,209,110,99,2,30,1,1
65316,53,39745,53,allow,225,110,115,2,30,1,1
56450,53,31149,53,allow,177,94,83,2,30,1,1
64789,53,3910,53,allow,198,101,97,2,30,1,1
55063,5223,9362,5223,allow,4336,1518,2818,23,3002,14,9
46554,5228,16651,5228,allow,4520,2520,2000,40,3961,20,20
45964,2666,0,0,deny,60,60,0,1,0,1,0
51676,445,0,0,drop,70,70,0,1,0,1,0
39599,443,45420,443,allow,1352,691,661,14,18,8,6
60392,1134,52281,1134,allow,70,70,0,2,8,2,0
64595,53,55733,53,allow,167,86,81,2,30,1,1
62246,443,21397,443,allow,117314,4775,112539,144,120,51,93
27005,27111,16900,27111,allow,913,126,787,2,31,1,1
56728,53,35265,53,allow,164,84,80,2,31,1,1
42030,25,0,0,deny,74,74,0,1,0,1,0
55138,53,34483,53,allow,173,94,79,2,30,1,1
53601,30160,62732,30160,allow,70,70,0,1,4,1,0
62929,445,0,0,drop,66,66,0,1,0,1,0
60473,8765,34134,8765,allow,199,75,124,4,59,2,2
54315,445,0,0,drop,70,70,0,1,0,1,0
52023,80,55578,80,allow,366,240,126,7,24,5,2
52434,53,49925,53,allow,183,86,97,2,30,1,1
64737,445,0,0,drop,66,66,0,1,0,1,0
50550,80,15717,80,allow,374,192,182,7,26,4,3
57359,53,20340,53,allow,458,188,270,6,31,3,3
55867,53,58666,53,allow,172,88,84,2,30,1,1
59986,445,0,0,drop,66,66,0,1,0,1,0
62716,445,0,0,drop,70,70,0,1,0,1,0
26900,27017,14698,27017,allow,422,164,258,6,29,3,3
55595,443,57179,443,allow,448,166,282,2,30,1,1
55356,53,43051,53,allow,756,95,661,2,31,1,1
31748,56205,0,0,deny,62,62,0,1,0,1,0
61173,445,0,0,drop,70,70,0,1,0,1,0
55043,53,56264,53,allow,274,110,164,2,30,1,1
51226,445,0,0,drop,70,70,0,1,0,1,0
58676,443,61726,443,allow,6144,939,5205,18,70,9,9
33505,80,10878,80,allow,130,70,60,2,15,1,1
61230,445,0,0,drop,70,70,0,1,0,1,0
57442,445,0,0,drop,70,70,0,1,0,1,0
59736,51505,0,0,deny,62,62,0,1,0,1,0
57906,443,24320,443,allow,2725,1564,1161,19,124,10,9
51711,445,0,0,drop,70,70,0,1,0,1,0
56651,443,21328,443,allow,8058,2038,6020,20,15,11,9
49429,53,51638,53,allow,199,102,97,2,29,1,1
60774,445,0,0,drop,66,66,0,1,0,1,0
65001,445,0,0,drop,70,70,0,1,0,1,0
4702,53,4702,53,allow,220,90,130,2,29,1,1
60475,445,0,0,drop,70,70,0,1,0,1,0
53779,37965,0,0,deny,66,66,0,1,0,1,0
56138,53,42749,53,allow,259,86,173,2,30,1,1
49046,5222,3706,5222,allow,6910,3381,3529,50,323,26,24
64011,53,28636,53,allow,288,94,194,2,29,1,1
27348,22114,0,0,deny,66,66,0,1,0,1,0
60226,445,0,0,drop,66,66,0,1,0,1,0
57083,53,55638,53,allow,198,102,96,2,30,1,1
51859,35365,47948,35365,allow,70,70,0,2,7,2,0
58638,5900,0,0,deny,62,62,0,1,0,1,0
8108,47807,0,0,deny,157,157,0,1,0,1,0
59116,445,0,0,drop,66,66,0,1,0,1,0
64583,53,5543,53,allow,426,89,337,4,58,2,2
53804,443,53478,443,allow,499,425,74,4,0,3,1
64392,25174,0,0,deny,66,66,0,1,0,1,0
25010,30188,0,0,deny,146,146,0,1,0,1,0
62900,445,0,0,drop,70,70,0,1,0,1,0
36226,60038,0,0,allow,66,66,0,1,91,1,0
63049,445,0,0,drop,70,70,0,1,0,1,0
55733,51505,0,0,deny,66,66,0,1,0,1,0
61999,445,0,0,drop,70,70,0,1,0,1,0
26795,443,14434,443,allow,21804,16558,5246,43,21,24,19
60420,445,0,0,drop,70,70,0,1,0,1,0
54300,22114,0,0,deny,62,62,0,1,0,1,0
25457,25604,0,0,deny,62,62,0,1,0,1,0
50141,445,0,0,drop,70,70,0,1,0,1,0
56749,80,24129,80,allow,194,128,66,4,25,3,1
56802,443,7219,443,allow,8072,2052,6020,20,15,11,9
3410,17372,0,0,deny,145,145,0,1,0,1,0
54225,443,6300,443,allow,499,425,74,4,0,3,1
49597,80,58897,80,allow,372,192,180,7,41,4,3
60900,53,31593,53,allow,181,86,95,2,30,1,1
50843,445,0,0,drop,70,70,0,1,0,1,0
49566,445,0,0,drop,70,70,0,1,0,1,0
28370,35440,0,0,deny,66,66,0,1,0,1,0
24376,50584,0,0,deny,66,66,0,1,0,1,0
49531,80,27250,80,allow,78,78,0,2,8,2,0
61273,443,61273,443,allow,8480,2451,6029,21,17,12,9
59733,445,0,0,drop,70,70,0,1,0,1,0
60363,443,34155,443,allow,2962,796,2166,10,120,5,5
52919,445,0,0,drop,70,70,0,1,0,1,0
63142,443,9605,443,allow,4994,379,4615,9,15,4,5
50151,80,25475,80,allow,1915831,46544,1869287,1569,166,311,1258
53298,26467,0,0,deny,66,66,0,1,0,1,0
29080,50265,0,0,deny,62,62,0,1,0,1,0
54826,444,0,0,deny,60,60,0,1,0,1,0
56688,443,60189,443,allow,7942,1953,5989,20,15,11,9
53763,443,53593,443,allow,499,425,74,4,0,3,1
64557,445,0,0,drop,70,70,0,1,0,1,0
52282,80,3560,80,allow,7603,1651,5952,24,16,13,11
50325,445,0,0,drop,66,66,0,1,0,1,0
45673,30188,0,0,deny,62,62,0,1,0,1,0
14997,57470,0,0,deny,72,72,0,1,0,1,0
62775,445,0,0,drop,70,70,0,1,0,1,0
56191,53,1757,53,allow,177,94,83,2,30,1,1
43817,443,47281,443,allow,5911,1666,4245,27,18,15,12
57612,28793,0,0,deny,66,66,0,1,0,1,0
58638,5900,0,0,deny,62,62,0,1,0,1,0
60406,80,16333,80,allow,1370,704,666,23,105,12,11
54957,53,54042,53,allow,197,102,95,2,35,1,1
56943,80,45580,80,allow,2817,2024,793,12,75,7,5
26081,53,4535,53,allow,243667,236247,7420,2897,90,2851,46
53376,22114,0,0,deny,62,62,0,1,0,1,0
56009,53,46044,53,allow,178,94,84,2,30,1,1
49516,53,31257,53,allow,183,94,89,2,29,1,1
59888,443,28259,443,allow,1401,864,537,12,28,6,6
59146,445,0,0,drop,70,70,0,1,0,1,0
123,123,8340,123,allow,184,94,90,2,29,1,1
56872,21247,0,0,deny,74,74,0,1,0,1,0
11020,62413,0,0,deny,62,62,0,1,0,1,0
56668,80,5597,80,allow,234,234,0,4,12,4,0
49456,445,0,0,drop,66,66,0,1,0,1,0
57262,53,44073,53,allow,176,90,86,2,30,1,1
51503,443,42971,443,allow,9239,4472,4767,37,39,21,16
49445,445,0,0,drop,70,70,0,1,0,1,0
22541,64147,0,0,deny,62,62,0,1,0,1,0
53924,45212,17906,45212,allow,70,70,0,1,5,1,0
51609,37807,0,0,deny,62,62,0,1,0,1,0
29203,26467,0,0,deny,62,62,0,1,0,1,0
64489,53,32733,53,allow,215,102,113,2,30,1,1
64065,53,56733,53,allow,264,94,170,2,29,1,1
56448,53,9031,53,allow,200,102,98,2,30,1,1
51896,445,0,0,drop,66,66,0,1,0,1,0
27005,27018,26444,27018,allow,1634,126,1508,4,30,2,2
42898,43890,0,0,deny,62,62,0,1,0,1,0
56856,47715,25916,47715,allow,66,66,0,1,5,1,0
55001,443,43698,443,allow,8182,3793,4389,27,37,16,11
63027,445,0,0,drop,70,70,0,1,0,1,0
45993,443,45993,443,allow,1494,898,596,12,142,6,6
60376,443,40016,443,allow,6608,1843,4765,44,120,23,21
57366,53,36112,53,allow,711,87,624,2,31,1,1
51322,443,58671,443,allow,6250,1422,4828,20,17,10,10
49257,53,6745,53,allow,199,102,97,2,30,1,1
55896,53,44537,53,allow,184,94,90,2,30,1,1
50291,53,32259,53,allow,86,86,0,1,30,1,0
56410,445,0,0,drop,66,66,0,1,0,1,0
64976,53,29065,53,allow,193,102,91,2,29,1,1
57825,445,0,0,drop,70,70,0,1,0,1,0
65418,443,32664,443,allow,2494,1643,851,17,26,9,8
46031,443,52828,443,allow,12395,2182,10213,21,122,10,11
25871,53,25871,53,allow,266,72,194,2,30,1,1
30945,53,30945,53,allow,237,91,146,2,32,1,1
64538,53,37074,53,allow,194,102,92,2,30,1,1
53706,59208,42614,59208,allow,164,70,94,2,8,1,1
63967,53,22995,53,allow,195,102,93,2,33,1,1
50677,445,0,0,drop,66,66,0,1,0,1,0
23873,30188,0,0,deny,66,66,0,1,0,1,0
64973,445,0,0,drop,70,70,0,1,0,1,0
60609,445,0,0,drop,70,70,0,1,0,1,0
41974,443,41974,443,allow,214163,29159,185004,242,20,108,134
16387,7205,0,0,deny,60,60,0,1,0,1,0
54983,80,49933,80,allow,27816,7362,20454,69,240,41,28
51641,445,0,0,drop,66,66,0,1,0,1,0
49909,53,17902,53,allow,1410,95,1315,4,57,2,2
53156,445,0,0,drop,70,70,0,1,0,1,0
52572,80,52572,80,allow,1899,1310,589,12,48,6,6
33107,443,4785,443,allow,3820081,140348,3679733,4457,136,1736,2721
38891,443,20514,443,allow,3489,636,2853,16,143,7,9
55659,37787,37419,37787,allow,70,70,0,1,5,1,0
56115,53,55783,53,allow,278,96,182,4,54,2,2
50893,80,33062,80,allow,149442,8423,141019,177,140,76,101
57477,445,0,0,drop,66,66,0,1,0,1,0
39681,37965,0,0,deny,66,66,0,1,0,1,0
50306,53,23964,53,allow,814,110,704,2,30,1,1
50584,54741,14563,54741,allow,868,150,718,4,1200,2,2
60444,47094,7095,47094,allow,320,140,180,6,7,3,3
49948,445,0,0,drop,70,70,0,1,0,1,0
49564,53,61434,53,allow,193,102,91,2,30,1,1
51617,21247,0,0,deny,66,66,0,1,0,1,0
65127,53,53558,53,allow,194,102,92,2,29,1,1
56673,443,23897,443,allow,6693,1072,5621,18,26,10,8
49519,443,49519,443,allow,15064,2611,12453,43,76,23,20
57419,53,26611,53,allow,196,102,94,2,30,1,1
37671,53,37671,53,allow,180,82,98,2,30,1,1
19944,22114,0,0,deny,62,62,0,1,0,1,0
56312,53,11008,53,allow,190,97,93,2,31,1,1
9150,443,24673,443,allow,16023,3677,12346,42,37,21,21
64123,443,56759,443,allow,1411,852,559,13,25,7,6
63019,53,40745,53,allow,512,166,346,2,29,1,1
35672,443,33861,443,allow,938,576,362,14,27,9,5
45342,443,2921,443,allow,2378,1382,996,20,21,11,9
58003,1433,0,0,deny,60,60,0,1,0,1,0
53752,35446,60472,35446,allow,492,306,186,8,15,5,3
49997,53,41448,53,allow,284,94,190,2,29,1,1
52881,445,0,0,drop,70,70,0,1,0,1,0
443,54154,0,0,deny,60,60,0,1,0,1,0
49713,53,39823,53,allow,184,94,90,2,30,1,1
49472,53,22827,53,allow,751,95,656,2,31,1,1
45964,55559,0,0,deny,60,60,0,1,0,1,0
6889,9074,0,0,deny,143,143,0,1,0,1,0
53398,443,48527,443,allow,5196,2308,2888,34,137,16,18
35738,80,42244,80,allow,1151,711,440,10,16,5,5
52862,445,0,0,drop,70,70,0,1,0,1,0
49539,80,49460,80,allow,378,192,186,7,42,4,3
64095,53,63030,53,allow,177,94,83,2,29,1,1
54539,26467,0,0,deny,62,62,0,1,0,1,0
55229,445,0,0,drop,66,66,0,1,0,1,0
57606,445,0,0,drop,70,70,0,1,0,1,0
48676,53392,0,0,deny,60,60,0,1,0,1,0
36158,443,62102,443,allow,7848,2137,5711,23,25,13,10
65462,53,18628,53,allow,98,98,0,1,30,1,0
49969,53,31598,53,allow,199,102,97,2,30,1,1
55200,53,19754,53,allow,209,110,99,2,30,1,1
33538,80,33538,80,allow,424,198,226,7,141,4,3
2531,30188,0,0,deny,62,62,0,1,0,1,0
46404,53,18296,53,allow,240,86,154,2,30,1,1
56814,56255,27834,56255,allow,70,70,0,1,5,1,0
40001,53,40001,53,allow,218,90,128,2,30,1,1
64719,53,59437,53,allow,192,98,94,2,30,1,1
64814,53,63374,53,allow,212,102,110,2,30,1,1
49386,64147,0,0,deny,62,62,0,1,0,1,0
42408,443,51647,443,allow,13108,2630,10478,26,120,12,14
56715,53,50292,53,allow,807,94,713,2,30,1,1
64255,53,12895,53,allow,200,94,106,2,29,1,1
65462,443,5746,443,allow,92384,4519,87865,105,15,39,66
36674,443,40100,443,allow,11882,3450,8432,39,120,19,20
63213,35440,0,0,deny,62,62,0,1,0,1,0
26180,35440,0,0,deny,62,62,0,1,0,1,0
3717,25174,0,0,deny,62,62,0,1,0,1,0
16477,37807,0,0,deny,66,66,0,1,0,1,0
64703,53,13570,53,allow,214,102,112,2,30,1,1
443,35385,0,0,deny,161,161,0,1,0,1,0
64573,53,51074,53,allow,184,94,90,2,30,1,1
57439,443,32851,443,allow,5502,1543,3959,17,20,9,8
56672,53,24787,53,allow,199,102,97,2,29,1,1
57470,17984,5691,17984,allow,402,132,270,6,1209,3,3
50929,80,17624,80,allow,9630744,98097,9532647,7804,123,1387,6417
60035,445,0,0,drop,70,70,0,1,0,1,0
55672,445,0,0,drop,70,70,0,1,0,1,0
59625,443,5961,443,allow,6703,1307,5396,28,18,14,14
61327,445,0,0,drop,70,70,0,1,0,1,0
60780,28080,48359,28080,allow,70,70,0,1,5,1,0
51073,443,23186,443,allow,7343,2672,4671,20,76,12,8
6980,48543,0,0,deny,139,139,0,1,0,1,0
26717,25174,0,0,deny,62,62,0,1,0,1,0
55731,36432,38455,36432,allow,70,70,0,2,8,2,0
57241,443,46273,443,allow,1167125,49170,1117955,1459,92,635,824
60155,23718,0,0,deny,66,66,0,1,0,1,0
49253,53,0,0,allow,218,78,140,2,30,1,1
56086,445,0,0,drop,70,70,0,1,0,1,0
58248,445,0,0,drop,66,66,0,1,0,1,0
64146,53,50563,53,allow,308,99,209,4,39,2,2
65518,53,19504,53,allow,701,88,613,2,30,1,1
65110,445,0,0,drop,70,70,0,1,0,1,0
65505,53,12322,53,allow,164,84,80,2,31,1,1
52870,22197,0,0,deny,62,62,0,1,0,1,0
50567,443,27568,443,allow,198,120,78,4,15,3,1
51743,64147,0,0,deny,62,62,0,1,0,1,0
49502,53,58398,53,allow,193,102,91,2,30,1,1
64128,53,37051,53,allow,193,102,91,2,30,1,1
64958,53,42023,53,allow,197,102,95,2,31,1,1
15503,61284,64885,61284,allow,16553,6930,9623,212,6269,106,106
49835,53,23738,53,allow,168,86,82,2,30,1,1
49732,80,4505,80,allow,2052,711,1341,10,130,6,4
62954,445,0,0,drop,70,70,0,1,0,1,0
1025,50584,0,0,deny,146,146,0,1,0,1,0
63662,445,0,0,drop,70,70,0,1,0,1,0
40428,53,46586,53,allow,168,78,90,2,30,1,1
64632,53,26914,53,allow,224,94,130,2,30,1,1
50328,445,0,0,drop,70,70,0,1,0,1,0
11464,37965,0,0,deny,62,62,0,1,0,1,0
53334,445,0,0,drop,70,70,0,1,0,1,0
56872,445,0,0,drop,66,66,0,1,0,1,0
63960,53,31296,53,allow,178,94,84,2,30,1,1
63779,26467,0,0,deny,66,66,0,1,0,1,0
38358,80,53485,80,allow,409,289,120,5,15,3,2
27005,27269,13554,27269,allow,886,126,760,2,30,1,1
52060,29868,16909,29868,allow,70,70,0,2,8,2,0
36933,23117,0,0,deny,66,66,0,1,0,1,0
49356,50584,0,0,deny,62,62,0,1,0,1,0
61038,445,0,0,drop,66,66,0,1,0,1,0
53083,445,0,0,drop,70,70,0,1,0,1,0
60462,47967,0,0,deny,148,148,0,1,0,1,0
56385,53,62602,53,allow,402,142,260,2,30,1,1
57470,6887,18117,6887,allow,471,269,202,4,1199,2,2
55044,80,26880,80,allow,306,180,126,6,34,4,2
1024,64147,0,0,deny,62,62,0,1,0,1,0
2404,35440,0,0,deny,146,146,0,1,0,1,0
55215,53,18031,53,allow,315,126,189,2,29,1,1
3341,23117,0,0,deny,62,62,0,1,0,1,0
51621,445,0,0,drop,70,70,0,1,0,1,0
55547,53,56945,53,allow,738,86,652,2,30,1,1
56344,443,64957,443,allow,8111,1413,6698,21,28,12,9
42433,443,64701,443,allow,6381,3801,2580,19,135,10,9
26229,80,26229,80,allow,7372,954,6418,17,18,9,8
49891,53,62229,53,allow,822,102,720,2,30,1,1
60824,445,0,0,drop,66,66,0,1,0,1,0
57007,53,19153,53,allow,183,94,89,2,31,1,1
59733,445,0,0,drop,70,70,0,1,0,1,0
65374,445,0,0,drop,70,70,0,1,0,1,0
43224,443,58496,443,allow,2027060,31188,1995872,1708,77,321,1387
51851,48605,8820,48605,allow,136,136,0,3,14,3,0
57045,53,27906,53,allow,170,87,83,2,30,1,1
45558,443,51093,443,allow,6450,1003,5447,21,360,11,10
57417,53,46711,53,allow,199,102,97,2,30,1,1
62973,51505,0,0,deny,62,62,0,1,0,1,0
62748,445,0,0,drop,66,66,0,1,0,1,0
49703,53,48424,53,allow,198,86,112,2,30,1,1
53884,48754,60851,48754,allow,70,70,0,2,7,2,0
4910,2149,0,0,deny,62,62,0,1,0,1,0
52544,19000,32388,19000,allow,492,216,276,2,31,1,1
52100,443,14481,443,allow,7711,1717,5994,26,361,13,13
56375,53,4140,53,allow,322,110,212,4,30,2,2
62337,44847,0,0,deny,66,66,0,1,0,1,0
49689,22114,0,0,deny,62,62,0,1,0,1,0
64001,53,4323,53,allow,183,94,89,2,30,1,1
65234,53,47492,53,allow,193,102,91,2,31,1,1
60377,443,34261,443,allow,8678,2974,5704,50,123,27,23
64574,53,64558,53,allow,388,95,293,4,32,2,2
53419,28189,0,0,deny,60,60,0,1,0,1,0
63631,443,40886,443,allow,8640,5157,3483,17,120,10,7
38306,51221,0,0,deny,62,62,0,1,0,1,0
7524,23,0,0,deny,60,60,0,1,0,1,0
64095,53,40106,53,allow,177,94,83,2,30,1,1
56585,443,49312,443,allow,7157,2183,4974,22,16,12,10
49665,53,45405,53,allow,197,102,95,2,30,1,1
6666,8530,0,0,deny,60,60,0,1,0,1,0
28192,50584,0,0,deny,66,66,0,1,0,1,0
53846,443,62098,443,allow,499,425,74,4,0,3,1
64765,53,34365,53,allow,195,94,101,2,30,1,1
56661,53,3079,53,allow,297,102,195,4,34,2,2
58394,53,41554,53,allow,274,94,180,2,30,1,1
62296,445,0,0,drop,70,70,0,1,0,1,0
57343,53,26142,53,allow,178,91,87,2,31,1,1
45484,443,14429,443,allow,5766,1575,4191,24,589,13,11
55874,64147,0,0,deny,66,66,0,1,0,1,0
55524,53,46955,53,allow,413,170,243,6,30,3,3
49224,80,15279,80,allow,2999,2271,728,11,15,6,5
19698,502,0,0,deny,60,60,0,1,0,1,0
56944,80,48541,80,allow,214,140,74,4,30,3,1
58847,443,11614,443,allow,7014,1630,5384,20,120,10,10
57132,443,41283,443,allow,6489,1065,5424,22,255,12,10
57679,443,27474,443,allow,6568,2770,3798,20,121,10,10
54839,445,0,0,drop,66,66,0,1,0,1,0
65201,53,42204,53,allow,216,110,106,2,30,1,1
57872,443,43316,443,allow,183325,10358,172967,289,227,95,194
54818,3389,54818,3389,allow,3409,1454,1955,16,16,8,8
49736,445,0,0,drop,70,70,0,1,0,1,0
15503,52798,43633,52798,allow,28448,16525,11923,253,3696,148,105
57325,60043,0,0,deny,62,62,0,1,0,1,0
51925,29587,42996,29587,allow,70,70,0,2,8,2,0
64380,53,9655,53,allow,196,102,94,2,33,1,1
57415,445,0,0,drop,70,70,0,1,0,1,0
50692,80,30484,80,allow,5727,3584,2143,15,31,8,7
64387,37965,0,0,deny,66,66,0,1,0,1,0
59802,445,0,0,drop,70,70,0,1,0,1,0
64359,53,62943,53,allow,196,102,94,2,30,1,1
59616,445,0,0,drop,66,66,0,1,0,1,0
65506,53,16583,53,allow,197,102,95,2,30,1,1
64036,23718,0,0,deny,66,66,0,1,0,1,0
59887,445,0,0,drop,70,70,0,1,0,1,0
2432,11392,0,0,deny,146,146,0,1,0,1,0
59077,445,0,0,drop,70,70,0,1,0,1,0
50694,80,5032,80,allow,54760,27837,26923,229,175,114,115
60213,445,0,0,drop,70,70,0,1,0,1,0
65480,445,0,0,drop,66,66,0,1,0,1,0
50343,80,37536,80,allow,1192,658,534,11,41,6,5
57470,45561,33811,45561,allow,792,792,0,13,1201,13,0
65189,27015,25952,27015,allow,281,78,203,2,30,1,1
63103,53,6941,53,allow,222,86,136,2,30,1,1
60111,445,0,0,drop,66,66,0,1,0,1,0
51948,17372,0,0,deny,62,62,0,1,0,1,0
64431,53,6973,53,allow,177,94,83,2,30,1,1
51834,35440,0,0,deny,66,66,0,1,0,1,0
55430,445,0,0,drop,70,70,0,1,0,1,0
27005,27018,14110,27018,allow,881,126,755,2,30,1,1
9263,80,41010,80,allow,318,192,126,6,26,4,2
55375,445,0,0,drop,70,70,0,1,0,1,0
49879,445,0,0,drop,70,70,0,1,0,1,0
59488,80,65175,80,allow,1114,534,580,12,16,7,5
58054,25,23956,25,allow,1370,496,874,16,16,8,8
6881,6881,0,0,deny,146,146,0,1,0,1,0
64396,53,16886,53,allow,231,102,129,2,30,1,1
7099,51505,0,0,deny,62,62,0,1,0,1,0
55022,53,30402,53,allow,772,103,669,2,30,1,1
57830,7635,57830,7635,allow,138,78,60,2,5,1,1
56737,80,46127,80,allow,194,128,66,4,25,3,1
65460,53,26483,53,allow,197,102,95,2,30,1,1
12663,62413,0,0,deny,66,66,0,1,0,1,0
54446,445,0,0,drop,70,70,0,1,0,1,0
58638,5900,0,0,deny,62,62,0,1,0,1,0
39995,443,36730,443,allow,4160,2228,1932,25,159,13,12
52361,23718,0,0,deny,66,66,0,1,0,1,0
1024,64147,0,0,deny,62,62,0,1,0,1,0
63062,11392,0,0,deny,66,66,0,1,0,1,0
22036,44847,0,0,deny,146,146,0,1,0,1,0
37959,3855,0,0,deny,72,72,0,1,0,1,0
53126,443,10677,443,allow,6668,2026,4642,15,120,8,7
39573,443,27028,443,allow,29226,2150,27076,44,30,19,25
59799,443,7688,443,allow,10642,1102,9540,25,27,11,14
55039,53,9278,53,allow,177,94,83,2,30,1,1
64171,53,19883,53,allow,174,89,85,2,30,1,1
49268,53,5165,53,allow,353,118,235,2,30,1,1
54711,443,40588,443,allow,3663,1136,2527,13,136,6,7
59214,57866,0,0,deny,66,66,0,1,0,1,0
49788,53,17656,53,allow,198,102,96,2,32,1,1
55938,445,0,0,drop,70,70,0,1,0,1,0
61583,445,0,0,drop,70,70,0,1,0,1,0
48966,53,48747,53,allow,168,78,90,2,30,1,1
63943,53,16297,53,allow,258,90,168,4,56,2,2
56014,445,0,0,drop,70,70,0,1,0,1,0
51606,443,52418,443,allow,3013,1661,1352,14,20,8,6
63569,62413,0,0,deny,62,62,0,1,0,1,0
56724,53,15012,53,allow,749,89,660,2,31,1,1
0,0,0,0,allow,320,320,0,5,0,5,0
4019,50584,0,0,deny,66,66,0,1,0,1,0
35357,53,47462,53,allow,291,86,205,2,29,1,1
61002,37965,0,0,deny,145,145,0,1,0,1,0
50741,445,0,0,drop,70,70,0,1,0,1,0
53234,48817,0,0,deny,148,148,0,1,0,1,0
55912,53,49501,53,allow,198,101,97,2,31,1,1
16382,17500,0,0,deny,62,62,0,1,0,1,0
56534,53,14913,53,allow,177,94,83,2,29,1,1
43326,443,42679,443,allow,10063,2126,7937,36,120,18,18
27005,27268,57130,27268,allow,884,126,758,2,30,1,1
65340,53,2059,53,allow,313,110,203,4,32,2,2
59549,50584,0,0,deny,66,66,0,1,0,1,0
39287,53,1937,53,allow,198,93,105,2,30,1,1
5588,5588,0,0,allow,3498,1872,1626,48,204,24,24
53131,44021,31517,44021,allow,698,320,378,10,16,6,4
14656,36237,0,0,deny,62,62,0,1,0,1,0
61960,445,0,0,drop,70,70,0,1,0,1,0
49286,23,0,0,deny,60,60,0,1,0,1,0
55704,53,11582,53,allow,260,102,158,2,30,1,1
53122,29070,40660,29070,allow,758,320,438,11,16,6,5
60290,53,25533,53,allow,199,94,105,2,29,1,1
20388,53,20388,53,allow,217,90,127,2,30,1,1
56773,53,53330,53,allow,183,94,89,2,29,1,1
58399,56205,0,0,deny,66,66,0,1,0,1,0
65169,80,56657,80,allow,1516,481,1035,11,15,6,5
52144,15208,25879,15208,allow,70,70,0,2,8,2,0
64605,35993,0,0,deny,66,66,0,1,0,1,0
64260,53,40725,53,allow,230,86,144,2,30,1,1
52788,53,56727,53,allow,196,94,102,2,30,1,1
55742,53,11069,53,allow,193,102,91,2,31,1,1
57338,80,37762,80,allow,1420,715,705,12,16,7,5
62776,62413,0,0,deny,62,62,0,1,0,1,0
51084,445,0,0,drop,70,70,0,1,0,1,0
62983,445,0,0,drop,66,66,0,1,0,1,0
49712,53,30095,53,allow,178,94,84,2,29,1,1
52892,443,17240,443,allow,41925,30922,11003,68,186,38,30
18461,19473,0,0,deny,66,66,0,1,0,1,0
49447,443,57996,443,allow,11281,5398,5883,21,125,11,10
56664,80,50394,80,allow,234,234,0,4,11,4,0
64007,445,0,0,drop,70,70,0,1,0,1,0
55921,53,30522,53,allow,711,87,624,2,30,1,1
58909,443,25795,443,allow,7671,4890,2781,25,17,13,12
52126,445,0,0,drop,70,70,0,1,0,1,0
52431,445,0,0,drop,70,70,0,1,0,1,0
46751,53,46751,53,allow,220,90,130,2,30,1,1
62364,445,0,0,drop,70,70,0,1,0,1,0
64525,53,31849,53,allow,198,101,97,2,31,1,1
49156,53,27997,53,allow,304,118,186,2,30,1,1
32609,64097,0,0,deny,66,66,0,1,0,1,0
6842,42873,0,0,deny,66,66,0,1,0,1,0
56126,53,16372,53,allow,774,101,673,2,31,1,1
53749,445,0,0,drop,70,70,0,1,0,1,0
55943,53,5113,53,allow,1415,94,1321,4,31,2,2
65136,53,56790,53,allow,335,84,251,4,32,2,2
43918,5228,35546,5228,allow,2276,1356,920,15,3601,7,8
21975,3389,21975,3389,allow,3910,1805,2105,20,19,12,8
55031,445,0,0,drop,70,70,0,1,0,1,0
63790,445,0,0,drop,70,70,0,1,0,1,0
60161,445,0,0,drop,70,70,0,1,0,1,0
60398,46776,0,0,deny,74,74,0,1,0,1,0
64016,53,54219,53,allow,184,94,90,2,31,1,1
54818,443,9214,443,allow,13069,6969,6100,37,164,23,14
40492,1488,40492,1488,allow,156,156,0,3,8,3,0
60914,53,60914,53,allow,220,100,120,2,31,1,1
60440,53830,1700,53830,allow,320,140,180,6,6,3,3
50002,443,45848,443,allow,25358,6778,18580,31,16,13,18
56428,30317,0,0,deny,66,66,0,1,0,1,0
50287,80,60290,80,allow,3325,607,2718,11,45,6,5
42281,443,42281,443,allow,1530,817,713,17,68,9,8
65270,53,38040,53,allow,226,110,116,2,30,1,1
17750,51965,19962,51965,allow,150,150,0,1,1200,1,0
51732,50584,0,0,deny,146,146,0,1,0,1,0
51551,53,57627,53,allow,304,86,218,2,30,1,1
53961,445,0,0,drop,66,66,0,1,0,1,0
54997,445,0,0,drop,70,70,0,1,0,1,0
55752,53,65323,53,allow,177,94,83,2,30,1,1
64284,445,0,0,drop,70,70,0,1,0,1,0
50605,443,19181,443,allow,13409,3033,10376,29,124,15,14
46491,50584,0,0,deny,66,66,0,1,0,1,0
55427,53,28517,53,allow,772,103,669,2,30,1,1
64205,53,47320,53,allow,178,94,84,2,31,1,1
24041,55783,0,0,deny,62,62,0,1,0,1,0
49393,445,0,0,drop,70,70,0,1,0,1,0
50396,80,52675,80,allow,487,180,307,6,26,4,2
63062,53,18913,53,allow,70,70,0,1,30,1,0
10477,44847,0,0,deny,62,62,0,1,0,1,0
60286,80,21753,80,allow,5836,2829,3007,19,164,14,5
19161,26296,0,0,deny,159,159,0,1,0,1,0
53125,443,2099,443,allow,7738,2230,5508,24,45,14,10
59789,443,31655,443,allow,5520,1212,4308,18,28,9,9
1080,8391,0,0,deny,66,66,0,1,0,1,0
56439,53,38034,53,allow,196,100,96,2,31,1,1
53621,445,0,0,drop,66,66,0,1,0,1,0
65043,53,7870,53,allow,213,94,119,2,29,1,1
40926,53,16373,53,allow,168,78,90,2,30,1,1
49346,443,21624,443,allow,4312,2524,1788,34,132,19,15
45205,25174,0,0,deny,146,146,0,1,0,1,0
56783,443,28364,443,allow,7904,1915,5989,20,16,11,9
6943,1970,0,0,deny,100,100,0,1,0,1,0
52119,443,11235,443,allow,10583,3353,7230,32,83,16,16
55934,53,48489,53,allow,196,102,94,2,30,1,1
49845,443,54304,443,allow,8518,2260,6258,32,806,12,20
65019,53,42326,53,allow,190,97,93,2,31,1,1
57284,53,21102,53,allow,214,110,104,2,31,1,1
54300,22114,0,0,deny,66,66,0,1,0,1,0
62126,445,0,0,drop,70,70,0,1,0,1,0
56529,445,0,0,drop,66,66,0,1,0,1,0
64462,53,60220,53,allow,329,94,235,4,31,2,2
27110,22114,0,0,deny,62,62,0,1,0,1,0
56519,80,41989,80,allow,370,222,148,6,32,4,2
19270,56448,0,0,deny,78,78,0,1,0,1,0
51535,64147,0,0,deny,62,62,0,1,0,1,0
52309,445,0,0,drop,70,70,0,1,0,1,0
5685,35440,0,0,deny,66,66,0,1,0,1,0
27005,27017,27810,27017,allow,890,126,764,2,30,1,1
56868,53,63238,53,allow,752,93,659,2,30,1,1
49230,53,36534,53,allow,351,94,257,2,30,1,1
60582,53,13685,53,allow,180,86,94,2,30,1,1
49547,445,0,0,drop,70,70,0,1,0,1,0
56640,443,54047,443,allow,8735,1819,6916,23,30,14,9
56769,53,51571,53,allow,183,94,89,2,31,1,1
56128,445,0,0,drop,70,70,0,1,0,1,0
58824,445,0,0,drop,70,70,0,1,0,1,0
38677,443,24014,443,allow,89883,3417,86466,94,15,30,64
56640,445,0,0,drop,66,66,0,1,0,1,0
51943,445,0,0,drop,66,66,0,1,0,1,0
56712,46824,0,0,deny,62,62,0,1,0,1,0
56131,37807,0,0,deny,62,62,0,1,0,1,0
56183,53,46991,53,allow,174,89,85,2,31,1,1
56587,445,0,0,drop,70,70,0,1,0,1,0
60617,445,0,0,drop,70,70,0,1,0,1,0
60793,40010,33213,40010,allow,316,136,180,6,6,3,3
65469,443,41637,443,allow,92958,4869,88089,109,15,44,65
53803,445,0,0,drop,70,70,0,1,0,1,0
64238,53,7198,53,allow,211,102,109,2,29,1,1
65318,445,0,0,drop,70,70,0,1,0,1,0
54267,445,0,0,drop,66,66,0,1,0,1,0
65292,53,23690,53,allow,190,97,93,2,31,1,1
63230,445,0,0,drop,66,66,0,1,0,1,0
27005,30000,27515,30000,allow,913,126,787,2,31,1,1
49174,53,10035,53,allow,264,110,154,2,30,1,1
47040,25174,0,0,deny,62,62,0,1,0,1,0
47445,443,40456,443,allow,8710,2009,6701,30,395,10,20
50263,53,58515,53,allow,771,102,669,2,30,1,1
52064,43273,64418,43273,allow,70,70,0,1,5,1,0
51999,80,34655,80,allow,20433,10970,9463,34,42,19,15
45941,23388,0,0,deny,60,60,0,1,0,1,0
45908,33330,0,0,deny,60,60,0,1,0,1,0
57910,445,0,0,drop,66,66,0,1,0,1,0
63259,445,0,0,drop,66,66,0,1,0,1,0
54968,53,59116,53,allow,199,102,97,2,30,1,1
53567,64147,0,0,deny,66,66,0,1,0,1,0
56352,53,18136,53,allow,177,94,83,2,30,1,1
38384,443,38384,443,allow,4609,1702,2907,19,29,11,8
55719,8060,46962,8060,allow,70,70,0,1,4,1,0
63587,22114,0,0,deny,62,62,0,1,0,1,0
65189,30015,16566,30015,allow,276,78,198,2,30,1,1
56313,53,27206,53,allow,198,102,96,2,30,1,1
49296,443,32357,443,allow,50454,5259,45195,52,105,17,35
49628,53,16334,53,allow,168,86,82,2,31,1,1
62635,445,0,0,drop,66,66,0,1,0,1,0
56022,53,29566,53,allow,728,102,626,2,30,1,1
42228,51050,0,0,deny,66,66,0,1,0,1,0
57336,443,14468,443,allow,6956,2856,4100,28,16,16,12
80,56289,0,0,deny,578,578,0,1,0,1,0
60536,80,60536,80,allow,318,120,198,6,25,3,3
56770,26467,0,0,deny,66,66,0,1,0,1,0
57301,53,33321,53,allow,170,87,83,2,31,1,1
58118,22114,0,0,deny,66,66,0,1,0,1,0
6587,22114,0,0,deny,146,146,0,1,0,1,0
4760,44847,0,0,deny,62,62,0,1,0,1,0
63271,52752,0,0,deny,78,78,0,1,0,1,0
57505,445,0,0,drop,70,70,0,1,0,1,0
64514,53,39075,53,allow,437,88,349,4,41,2,2
55019,53,16750,53,allow,299,110,189,4,31,2,2
62148,37965,0,0,deny,62,62,0,1,0,1,0
28124,37965,0,0,deny,62,62,0,1,0,1,0
59523,37965,0,0,deny,62,62,0,1,0,1,0
23478,1433,0,0,deny,60,60,0,1,0,1,0
64891,445,0,0,drop,70,70,0,1,0,1,0
27005,27015,49303,27015,allow,868,126,742,2,30,1,1
56275,53,15148,53,allow,164,84,80,2,31,1,1
49650,53,24810,53,allow,216,110,106,2,29,1,1
53894,443,60349,443,allow,6375,1019,5356,21,16,11,10
64686,53,47974,53,allow,214,102,112,2,29,1,1
49948,80,2205,80,allow,19740,993,18747,28,15,12,16
17027,1,0,0,deny,62,62,0,1,0,1,0
55893,53,45153,53,allow,267,94,173,4,56,2,2
55196,53,52555,53,allow,711,87,624,2,30,1,1
56076,443,18045,443,allow,1786,172,1614,7,120,3,4
57174,53,49887,53,allow,293,86,207,2,29,1,1
65481,443,11803,443,allow,138507,5990,132517,156,16,60,96
65363,53,16393,53,allow,747,93,654,2,30,1,1
36714,80,19257,80,allow,1792,703,1089,12,16,7,5
54526,44847,0,0,deny,66,66,0,1,0,1,0
53628,50514,36687,50514,allow,70,70,0,1,4,1,0
49365,53,34232,53,allow,199,94,105,2,31,1,1
5819,53,5819,53,allow,197,90,107,2,30,1,1
27005,27016,56293,27016,allow,1640,126,1514,4,31,2,2
63192,445,0,0,drop,66,66,0,1,0,1,0
56719,37807,0,0,deny,66,66,0,1,0,1,0
58562,57587,0,0,deny,66,66,0,1,0,1,0
27005,27017,13207,27017,allow,890,126,764,2,30,1,1
64249,53,6288,53,allow,181,94,87,2,33,1,1
49798,53,8655,53,allow,196,102,94,2,30,1,1
59481,30975,0,0,deny,146,146,0,1,0,1,0
43688,22114,0,0,deny,66,66,0,1,0,1,0
53115,445,0,0,drop,70,70,0,1,0,1,0
50329,443,35211,443,allow,12026,3494,8532,28,82,14,14
65048,53,15306,53,allow,297,96,201,4,42,2,2
52425,80,64946,80,allow,1630,918,712,12,16,7,5
60375,80,60375,80,allow,172473,8713,163760,205,33,91,114
65378,53,29573,53,allow,476,121,355,4,40,2,2
58200,445,0,0,drop,70,70,0,1,0,1,0
51196,445,0,0,drop,70,70,0,1,0,1,0
26792,37965,0,0,deny,62,62,0,1,0,1,0
55485,53,55524,53,allow,720,94,626,2,29,1,1
38766,53,38766,53,allow,371,237,134,3,32,2,1
56544,53,62437,53,allow,760,97,663,2,31,1,1
58919,443,29317,443,allow,5166,700,4466,16,15,7,9
51682,80,11682,80,allow,59786,3488,56298,119,55,45,74
56596,53,38999,53,allow,188,96,92,2,31,1,1
57208,53,46583,53,allow,183,94,89,2,31,1,1
55508,64147,0,0,deny,62,62,0,1,0,1,0
52647,445,0,0,drop,70,70,0,1,0,1,0
21034,50265,0,0,deny,66,66,0,1,0,1,0
10307,53,10307,53,allow,213,87,126,2,30,1,1
57602,443,23488,443,allow,2614,1689,925,18,20,10,8
57586,443,39129,443,allow,3724,1963,1761,24,95,13,11
28036,443,58065,443,allow,5780,4574,1206,20,16,11,9
55084,53,9496,53,allow,177,94,83,2,31,1,1
65205,445,0,0,drop,70,70,0,1,0,1,0
58743,35894,0,0,deny,66,66,0,1,0,1,0
8889,2117,0,0,deny,60,60,0,1,0,1,0
65387,53,9016,53,allow,221,94,127,2,30,1,1
54677,5228,25400,5228,allow,6679,2730,3949,43,4309,23,20
52994,445,0,0,drop,70,70,0,1,0,1,0
47822,80,47822,80,allow,1435,1293,142,5,15,3,2
43390,53,0,0,allow,184,86,98,2,30,1,1
55329,443,60850,443,allow,18284,2468,15816,42,26,22,20
63461,51505,0,0,deny,66,66,0,1,0,1,0
64171,53,17588,53,allow,179,94,85,2,30,1,1
56138,53,23162,53,allow,177,94,83,2,30,1,1
59513,53,0,0,allow,82,82,0,1,31,1,0
63830,445,0,0,drop,66,66,0,1,0,1,0
60881,443,31300,443,allow,31109,2922,28187,54,52,26,28
6882,51505,0,0,deny,66,66,0,1,0,1,0
56626,53,22670,53,allow,710,89,621,2,31,1,1
3730,17372,0,0,deny,62,62,0,1,0,1,0
51125,445,0,0,drop,66,66,0,1,0,1,0
6666,401,0,0,deny,60,60,0,1,0,1,0
0,0,0,0,deny,156,156,0,2,0,2,0
61185,54532,0,0,deny,145,145,0,1,0,1,0
65363,53,10698,53,allow,181,94,87,2,30,1,1
61250,42873,0,0,deny,66,66,0,1,0,1,0
56975,53,16815,53,allow,413,170,243,6,31,3,3
59046,443,4447,443,allow,8279,2876,5403,22,155,9,13
12116,53,12116,53,allow,214,82,132,2,33,1,1
58103,10197,0,0,deny,66,66,0,1,0,1,0
55217,53,28752,53,allow,189,102,87,2,30,1,1
49656,53,55066,53,allow,193,102,91,2,30,1,1
55808,53,45901,53,allow,738,86,652,2,31,1,1
21542,57470,0,0,deny,74,74,0,1,0,1,0
50996,445,0,0,drop,66,66,0,1,0,1,0
53141,445,0,0,drop,66,66,0,1,0,1,0
48839,443,60350,443,allow,111590,17663,93927,212,115,93,119
40906,443,50326,443,allow,8138,2333,5805,26,106,14,12
41184,53,29887,53,allow,168,78,90,2,30,1,1
34936,30188,0,0,deny,62,62,0,1,0,1,0
58678,445,0,0,drop,70,70,0,1,0,1,0
53497,445,0,0,drop,66,66,0,1,0,1,0
51843,45702,23719,45702,allow,1261,637,624,9,30,5,4
37664,443,11325,443,allow,3338,2337,1001,18,45,11,7
61760,445,0,0,drop,70,70,0,1,0,1,0
40299,443,53474,443,allow,9574,2600,6974,29,136,16,13
49398,53,12765,53,allow,226,86,140,2,31,1,1
64705,53,6395,53,allow,213,102,111,2,30,1,1
30960,45754,34064,45754,allow,396,396,0,7,3615,7,0
45344,443,7513,443,allow,2593,1394,1199,20,13,11,9
56306,15503,0,0,deny,146,146,0,1,0,1,0
37368,80,60512,80,allow,554,258,296,9,13,5,4
49882,80,49056,80,allow,2560,599,1961,13,75,7,6
46330,56205,0,0,deny,146,146,0,1,0,1,0
53178,26467,0,0,deny,62,62,0,1,0,1,0
65460,445,0,0,drop,70,70,0,1,0,1,0
62303,445,0,0,drop,70,70,0,1,0,1,0
50280,38558,0,0,deny,62,62,0,1,0,1,0
62796,37807,0,0,deny,62,62,0,1,0,1,0
51805,15298,5839,15298,allow,70,70,0,1,5,1,0
45822,443,11470,443,allow,4201,2089,2112,11,120,6,5
18203,23,0,0,deny,60,60,0,1,0,1,0
50299,80,31739,80,allow,2316,1206,1110,16,81,9,7
60477,30889,23604,30889,allow,70,70,0,1,5,1,0
44411,37965,0,0,deny,62,62,0,1,0,1,0
44285,25174,0,0,deny,146,146,0,1,0,1,0
53957,35440,0,0,deny,146,146,0,1,0,1,0
32132,25174,0,0,deny,66,66,0,1,0,1,0
59382,445,0,0,drop,70,70,0,1,0,1,0
60603,445,0,0,drop,70,70,0,1,0,1,0
52643,6881,27552,6881,allow,719,413,306,10,14,5,5
41447,64147,0,0,deny,62,62,0,1,0,1,0
61443,443,44561,443,allow,7832,1143,6689,19,26,9,10
19623,25174,0,0,deny,62,62,0,1,0,1,0
52071,57491,41650,57491,allow,70,70,0,2,8,2,0
23333,53,23333,53,allow,215,80,135,2,33,1,1
56260,445,0,0,drop,70,70,0,1,0,1,0
50596,445,0,0,drop,70,70,0,1,0,1,0
58950,445,0,0,drop,70,70,0,1,0,1,0
56832,53,34537,53,allow,214,102,112,2,29,1,1
55538,53,2707,53,allow,168,86,82,2,30,1,1
56342,53,27382,53,allow,733,93,640,2,31,1,1
64562,53,22327,53,allow,371,94,277,2,30,1,1
49742,80,32579,80,allow,103346,1476,101870,87,17,16,71
53597,445,0,0,drop,70,70,0,1,0,1,0
49593,445,0,0,drop,70,70,0,1,0,1,0
36679,443,65477,443,allow,466,392,74,4,0,3,1
36258,443,41571,443,allow,1128432,47396,1081036,1242,142,458,784
55562,50584,0,0,deny,66,66,0,1,0,1,0
53337,445,0,0,drop,70,70,0,1,0,1,0
50613,443,53382,443,allow,1512,850,662,16,93,9,7
17982,11392,0,0,deny,62,62,0,1,0,1,0
51318,443,40980,443,allow,11191,4657,6534,32,129,14,18
49263,53,22784,53,allow,172,88,84,2,31,1,1
27005,32038,32589,32038,allow,868,126,742,2,31,1,1
55821,53,13953,53,allow,196,102,94,2,29,1,1
55846,53,27827,53,allow,198,102,96,2,30,1,1
37455,50584,0,0,deny,66,66,0,1,0,1,0
57933,445,0,0,drop,66,66,0,1,0,1,0
56636,443,16823,443,allow,8865,1819,7046,24,30,14,10
61997,445,0,0,drop,66,66,0,1,0,1,0
64938,53,18539,53,allow,210,102,108,2,30,1,1
65280,53,4153,53,allow,164,84,80,2,31,1,1
53716,443,47470,443,allow,70,70,0,2,8,2,0
55754,53,35474,53,allow,177,94,83,2,30,1,1
52046,80,15183,80,allow,27904,14100,13804,46,34,24,22
55635,38649,44116,38649,allow,70,70,0,1,5,1,0
22587,30188,0,0,deny,66,66,0,1,0,1,0
443,44683,0,0,deny,83,83,0,1,0,1,0
53920,443,44819,443,allow,499,425,74,4,0,3,1
55912,53,3506,53,allow,184,94,90,2,30,1,1
49741,53,17465,53,allow,177,94,83,2,30,1,1
52023,41791,57379,41791,allow,70,70,0,1,5,1,0
62533,445,0,0,drop,70,70,0,1,0,1,0
65228,53,0,0,deny,88,88,0,1,0,1,0
56816,53,22918,53,allow,233,94,139,2,30,1,1
60426,25988,33152,25988,allow,70,70,0,1,5,1,0
49329,443,27397,443,allow,460,394,66,4,0,3,1
49563,53,41117,53,allow,200,102,98,2,29,1,1
51716,57137,20087,57137,allow,70,70,0,1,5,1,0
45551,80,20742,80,allow,694,350,344,11,27,6,5
50693,443,50693,443,allow,19125,2345,16780,37,128,15,22
49446,53,1735,53,allow,403,142,261,2,30,1,1
65186,445,0,0,drop,70,70,0,1,0,1,0
56442,53,53594,53,allow,167,86,81,2,30,1,1
59828,445,0,0,drop,70,70,0,1,0,1,0
63902,22928,21119,22928,allow,504,382,122,8,15,6,2
14446,443,21708,443,allow,2616,1470,1146,18,16,8,10
53166,61600,0,0,deny,66,66,0,1,0,1,0
56326,53,1837,53,allow,177,94,83,2,29,1,1
63518,445,0,0,drop,66,66,0,1,0,1,0
56477,53,18413,53,allow,386,101,285,4,31,2,2
44521,443,14957,443,allow,6502,1347,5155,31,1195,10,21
63569,62413,0,0,deny,66,66,0,1,0,1,0
443,4205,0,0,deny,320,320,0,1,0,1,0
64992,53,63333,53,allow,170,87,83,2,30,1,1
27005,27017,51500,27017,allow,901,126,775,2,30,1,1
50466,53,18896,53,allow,199,102,97,2,30,1,1
49535,80,31379,80,allow,1548,847,701,10,16,5,5
59845,445,0,0,drop,70,70,0,1,0,1,0
27005,27020,51720,27020,allow,1626,126,1500,4,30,2,2
56952,22114,0,0,deny,146,146,0,1,0,1,0
50559,445,0,0,drop,70,70,0,1,0,1,0
64174,53,49823,53,allow,176,90,86,2,31,1,1
49001,48983,0,0,deny,161,161,0,1,0,1,0
63775,445,0,0,drop,66,66,0,1,0,1,0
50629,445,0,0,drop,66,66,0,1,0,1,0
53941,53739,11665,53739,allow,70,70,0,2,8,2,0
56612,53,64503,53,allow,184,94,90,2,31,1,1
62284,443,22217,443,allow,3419,1275,2144,13,135,6,7
53072,443,53072,443,allow,49826,37097,12729,66,163,40,26
60550,50584,0,0,deny,146,146,0,1,0,1,0
49211,15576,30482,15576,allow,70,70,0,1,5,1,0
14923,51505,0,0,deny,62,62,0,1,0,1,0
56263,53,57632,53,allow,214,110,104,2,31,1,1
61301,445,0,0,drop,70,70,0,1,0,1,0
52067,445,0,0,drop,70,70,0,1,0,1,0
55967,53,30635,53,allow,209,110,99,2,30,1,1
51874,443,24684,443,allow,1852,1103,749,16,31,9,7
50652,445,0,0,drop,70,70,0,1,0,1,0
993,4281,0,0,deny,66,66,0,1,0,1,0
60219,80,48945,80,allow,1987,1593,394,10,151,6,4
56225,53,16256,53,allow,188,96,92,2,30,1,1
54140,43890,0,0,deny,62,62,0,1,0,1,0
16262,80,16262,80,allow,14671,951,13720,23,16,10,13
49941,445,0,0,drop,70,70,0,1,0,1,0
36566,37965,0,0,deny,62,62,0,1,0,1,0
53806,443,60221,443,allow,12788,2594,10194,40,17,20,20
60655,445,0,0,drop,70,70,0,1,0,1,0
19427,23,0,0,deny,60,60,0,1,0,1,0
51114,443,50404,443,allow,10301,4593,5708,21,121,10,11
56229,445,0,0,drop,70,70,0,1,0,1,0
6666,80,0,0,deny,60,60,0,1,0,1,0
50446,443,25780,443,allow,5471,2089,3382,17,121,8,9
36767,53,36767,53,allow,237,93,144,2,31,1,1
55629,42873,0,0,deny,74,74,0,1,0,1,0
22,51051,22,51051,allow,109,109,0,1,5,1,0
56988,80,5679,80,allow,214,140,74,4,35,3,1
63066,443,9445,443,allow,448,166,282,2,30,1,1
443,10010,0,0,deny,60,60,0,1,0,1,0
55945,53,49702,53,allow,177,94,83,2,31,1,1
49767,80,10412,80,allow,70,70,0,1,4,1,0
61868,445,0,0,drop,70,70,0,1,0,1,0
54021,445,0,0,drop,66,66,0,1,0,1,0
44885,443,34599,443,allow,296,78,218,4,19,1,3
10012,40009,21244,40009,allow,253,190,63,2,30,1,1
51414,22,0,0,deny,60,60,0,1,0,1,0
55723,445,0,0,drop,70,70,0,1,0,1,0
56625,53,47756,53,allow,193,102,91,2,30,1,1
49321,53,16825,53,allow,184,94,90,2,31,1,1
57755,445,0,0,drop,70,70,0,1,0,1,0
57343,443,46945,443,allow,1607664,53945,1553719,1792,39,700,1092
53206,80,36804,80,allow,2622,1074,1548,14,282,8,6
48095,53,40439,53,allow,199,94,105,2,30,1,1
55002,80,41422,80,allow,10872190,337459,10534731,12500,208,5532,6968
55179,53,63963,53,allow,194,102,92,2,30,1,1
55965,53,22177,53,allow,184,94,90,2,30,1,1
55443,53,14959,53,allow,194,102,92,2,30,1,1
55336,53,7329,53,allow,199,102,97,2,30,1,1
53483,443,14059,443,allow,8333,2292,6041,27,360,15,12
50710,80,11292,80,allow,708,384,324,12,195,7,5
55165,53,51406,53,allow,193,102,91,2,30,1,1
25296,51505,0,0,deny,66,66,0,1,0,1,0
55300,53,49492,53,allow,308,94,214,2,30,1,1
56077,80,50993,80,allow,5302,704,4598,14,18,8,6
44588,443,64745,443,allow,8850,2551,6299,32,369,16,16
50400,53,9416,53,allow,177,94,83,2,30,1,1
57470,41013,23995,41013,allow,2128,875,1253,26,1980,13,13
59824,445,0,0,drop,70,70,0,1,0,1,0
57325,37965,0,0,deny,62,62,0,1,0,1,0
63403,445,0,0,drop,70,70,0,1,0,1,0
65146,53,65321,53,allow,335,102,233,2,30,1,1
56887,53,51812,53,allow,177,94,83,2,30,1,1
57761,15503,0,0,deny,62,62,0,1,0,1,0
27005,27015,8409,27015,allow,897,126,771,2,30,1,1
64537,53,60663,53,allow,168,86,82,2,29,1,1
49960,445,0,0,drop,70,70,0,1,0,1,0
46557,57866,0,0,deny,66,66,0,1,0,1,0
60213,80,45825,80,allow,70,70,0,1,4,1,0
63399,445,0,0,drop,70,70,0,1,0,1,0
50749,443,38979,443,allow,4749,1897,2852,16,124,8,8
58742,443,35475,443,allow,5166,700,4466,16,15,7,9
49806,53,64642,53,allow,331,102,229,2,30,1,1
51989,80,9142,80,allow,1344,899,445,8,15,6,2
65463,445,0,0,drop,70,70,0,1,0,1,0
47910,7454,0,0,deny,60,60,0,1,0,1,0
23934,41615,0,0,deny,145,145,0,1,0,1,0
53928,443,61918,443,allow,499,425,74,4,0,3,1
64437,445,0,0,drop,66,66,0,1,0,1,0
64730,445,0,0,drop,66,66,0,1,0,1,0
56637,53,47556,53,allow,214,110,104,2,31,1,1
57007,80,33678,80,allow,214,140,74,4,31,3,1
50871,80,63200,80,allow,94083,6192,87891,121,139,57,64
50810,445,0,0,drop,70,70,0,1,0,1,0
50288,53,0,0,allow,82,82,0,1,30,1,0
50985,445,0,0,drop,66,66,0,1,0,1,0
65126,443,41319,443,allow,958,384,574,14,34,7,7
49240,445,0,0,drop,70,70,0,1,0,1,0
55747,53,47798,53,allow,199,94,105,2,29,1,1
60629,445,0,0,drop,70,70,0,1,0,1,0
49785,445,0,0,drop,66,66,0,1,0,1,0
37611,443,31494,443,allow,3936,1618,2318,26,146,14,12
56648,443,26064,443,allow,8007,1987,6020,20,15,11,9
63325,445,0,0,drop,70,70,0,1,0,1,0
53038,445,0,0,drop,70,70,0,1,0,1,0
53737,51456,15956,51456,allow,70,70,0,2,8,2,0
56727,53,4531,53,allow,250,86,164,4,46,2,2
50038,443,53552,443,allow,2652,1566,1086,15,86,9,6
64384,53,2219,53,allow,333,94,239,2,30,1,1
51774,29434,0,0,deny,146,146,0,1,0,1,0
51605,443,22416,443,allow,2013,1363,650,12,134,7,5
65111,445,0,0,drop,70,70,0,1,0,1,0
64566,53,26350,53,allow,194,102,92,2,29,1,1
28509,80,28509,80,allow,10145,1446,8699,23,29,11,12
59882,53,29947,53,allow,244,86,158,2,29,1,1
53318,22114,0,0,deny,66,66,0,1,0,1,0
65532,53,6977,53,allow,255,102,153,2,29,1,1
57478,7302,0,0,deny,66,66,0,1,0,1,0
39861,80,23505,80,allow,1056,682,374,10,15,6,4
50402,445,0,0,drop,70,70,0,1,0,1,0
51830,32787,57258,32787,allow,70,70,0,1,5,1,0
49701,445,0,0,drop,70,70,0,1,0,1,0
65178,53,0,0,allow,190,85,105,2,30,1,1
11112,43890,0,0,deny,66,66,0,1,0,1,0
53951,8999,52530,8999,allow,70,70,0,1,4,1,0
49852,445,0,0,drop,70,70,0,1,0,1,0
42865,55839,0,0,deny,137,137,0,1,0,1,0
59747,445,0,0,drop,70,70,0,1,0,1,0
56734,53,17479,53,allow,751,95,656,2,30,1,1
63920,443,64654,443,allow,3192,633,2559,17,135,7,10
54000,53,38105,53,allow,294,86,208,2,30,1,1
58831,443,40650,443,allow,9378,2858,6520,48,196,21,27
28742,53,28742,53,allow,365,233,132,3,32,2,1
57788,443,31761,443,allow,6400,1327,5073,21,21,13,8
53685,53,0,0,allow,547,97,450,4,40,2,2
11023,51505,0,0,deny,66,66,0,1,0,1,0
55820,445,0,0,drop,66,66,0,1,0,1,0
42285,57470,0,0,deny,62,62,0,1,0,1,0
57965,443,27190,443,allow,8366,2018,6348,32,104,17,15
53688,17106,21939,17106,allow,70,70,0,2,8,2,0
49920,443,59929,443,allow,6489,2137,4352,28,143,14,14
38866,443,54319,443,allow,16577,10269,6308,33,17,20,13
52245,445,0,0,drop,66,66,0,1,0,1,0
51836,445,0,0,drop,70,70,0,1,0,1,0
52096,55854,62191,55854,allow,70,70,0,1,5,1,0
51789,40800,21058,40800,allow,70,70,0,2,8,2,0
37805,443,7210,443,allow,9481,3482,5999,58,16,29,29
62541,445,0,0,drop,70,70,0,1,0,1,0
57298,443,20012,443,allow,8313,2850,5463,42,15,24,18
59773,445,0,0,drop,66,66,0,1,0,1,0
46568,443,33630,443,allow,6407,984,5423,21,360,11,10
31691,50584,0,0,deny,62,62,0,1,0,1,0
38892,443,57044,443,allow,83444,15305,68139,121,148,51,70
21750,39004,0,0,deny,62,62,0,1,0,1,0
48681,11392,0,0,deny,62,62,0,1,0,1,0
49964,53,9082,53,allow,760,97,663,2,30,1,1
57260,51221,0,0,deny,66,66,0,1,0,1,0
56938,9600,62767,9600,allow,86,86,0,1,30,1,0
64055,53,3603,53,allow,233,94,139,2,30,1,1
51313,25174,0,0,deny,66,66,0,1,0,1,0
56835,53,48670,53,allow,177,94,83,2,30,1,1
60886,445,0,0,drop,70,70,0,1,0,1,0
56963,53,63248,53,allow,210,110,100,2,30,1,1
50031,53,53719,53,allow,178,91,87,2,31,1,1
62624,445,0,0,drop,70,70,0,1,0,1,0
39303,80,19010,80,allow,3198,1493,1705,18,80,11,7
40236,443,44776,443,allow,4945,1401,3544,21,25,11,10
52914,443,10656,443,allow,70,70,0,1,5,1,0
53081,443,13924,443,allow,16157,6478,9679,46,83,23,23
50282,445,0,0,drop,70,70,0,1,0,1,0
64748,53,54658,53,allow,212,102,110,2,30,1,1
59658,445,0,0,drop,70,70,0,1,0,1,0
27988,40022,50196,40022,allow,146,84,62,2,30,1,1
12830,25174,0,0,deny,62,62,0,1,0,1,0
39423,80,38195,80,allow,78,78,0,1,4,1,0
65039,53,20269,53,allow,258,94,164,2,31,1,1
51244,59353,0,0,deny,100,100,0,1,0,1,0
53665,80,59537,80,allow,4417,3685,732,16,15,10,6
58896,443,22104,443,allow,5168,700,4468,16,15,7,9
6355,25174,0,0,deny,62,62,0,1,0,1,0
61935,445,0,0,drop,70,70,0,1,0,1,0
23066,443,23066,443,allow,5573,2434,3139,21,25,12,9
64381,53,47350,53,allow,196,100,96,2,30,1,1
58116,445,0,0,drop,66,66,0,1,0,1,0
44885,443,54078,443,allow,1849,1130,719,17,38,9,8
57599,80,28045,80,allow,808,485,323,8,75,5,3
48817,58518,48817,58518,allow,580,121,459,4,1199,2,2
56216,53,54561,53,allow,177,94,83,2,30,1,1
56509,53,49839,53,allow,1165,94,1071,2,30,1,1
22300,51505,0,0,deny,66,66,0,1,0,1,0
49880,445,0,0,drop,70,70,0,1,0,1,0
64298,53,48284,53,allow,311,118,193,2,30,1,1
54942,53,0,0,allow,168,74,94,2,30,1,1
53964,443,1978,443,allow,152,78,74,2,5,1,1
51042,22114,0,0,deny,66,66,0,1,0,1,0
27038,51505,0,0,deny,62,62,0,1,0,1,0
64449,53,61840,53,allow,197,94,103,2,30,1,1
53147,26330,14316,26330,allow,70,70,0,2,8,2,0
64525,53,63463,53,allow,199,102,97,2,30,1,1
51685,445,0,0,drop,66,66,0,1,0,1,0
22733,26467,0,0,deny,62,62,0,1,0,1,0
49760,1443,52471,1443,allow,626,352,274,10,15,6,4
64950,53,10318,53,allow,765,102,663,2,30,1,1
443,14591,0,0,deny,60,60,0,1,0,1,0
39840,443,35916,443,allow,6097,1540,4557,25,191,13,12
49697,53,43942,53,allow,195,94,101,2,30,1,1
59972,443,22705,443,allow,7152,1299,5853,22,16,12,10
49418,27016,58886,27016,allow,242,78,164,2,30,1,1
58638,5900,0,0,deny,62,62,0,1,0,1,0
57326,53,9216,53,allow,180,94,86,2,35,1,1
11136,15503,0,0,deny,62,62,0,1,0,1,0
52099,28401,35047,28401,allow,70,70,0,1,5,1,0
52247,53,24197,53,allow,216,86,130,2,30,1,1
1027,44847,0,0,deny,62,62,0,1,0,1,0
55473,445,0,0,drop,66,66,0,1,0,1,0
50191,53,9113,53,allow,734,94,640,2,30,1,1
51453,80,39611,80,allow,214,140,74,4,15,3,1
56025,445,0,0,drop,66,66,0,1,0,1,0
59874,445,0,0,drop,66,66,0,1,0,1,0
52907,80,17763,80,allow,1659,653,1006,10,16,6,4
65115,53,52563,53,allow,193,102,91,2,30,1,1
39839,22114,0,0,deny,146,146,0,1,0,1,0
51567,445,0,0,drop,70,70,0,1,0,1,0
60944,443,23317,443,allow,8264,4269,3995,17,31,9,8
51848,80,47789,80,allow,12009,5364,6645,23,31,12,11
60889,443,46801,443,allow,9959,2430,7529,27,46,16,11
54633,445,0,0,drop,66,66,0,1,0,1,0
60976,22114,0,0,deny,66,66,0,1,0,1,0
3270,35440,0,0,deny,66,66,0,1,0,1,0
32648,55108,0,0,deny,145,145,0,1,0,1,0
56699,445,0,0,drop,70,70,0,1,0,1,0
39844,443,3106,443,allow,2042,1022,1020,17,80,9,8
49952,53,43225,53,allow,196,94,102,2,30,1,1
58638,5900,0,0,deny,62,62,0,1,0,1,0
64323,445,0,0,drop,70,70,0,1,0,1,0
49622,53,45379,53,allow,185,102,83,2,30,1,1
54427,443,64059,443,allow,2878,1252,1626,16,361,9,7
55254,53,23493,53,allow,195,102,93,2,30,1,1
50584,11830,62858,11830,allow,2118,900,1218,14,4232,7,7
50665,443,30090,443,allow,22544,1481,21063,31,16,9,22
60722,445,0,0,drop,70,70,0,1,0,1,0
56880,53,14600,53,allow,216,102,114,2,30,1,1
55869,445,0,0,drop,70,70,0,1,0,1,0
65153,38303,0,0,deny,66,66,0,1,0,1,0
65234,53,55204,53,allow,248,110,138,2,29,1,1
51963,443,38927,443,allow,14602,6734,7868,46,56,26,20
57387,53,39674,53,allow,178,94,84,2,30,1,1
49443,445,0,0,drop,70,70,0,1,0,1,0
49961,443,64983,443,allow,16890,7125,9765,33,98,19,14
55889,53,44791,53,allow,199,102,97,2,30,1,1
44361,443,44674,443,allow,424,210,214,7,132,4,3
55066,53,23255,53,allow,180,94,86,2,31,1,1
49718,445,0,0,drop,66,66,0,1,0,1,0
49982,445,0,0,drop,66,66,0,1,0,1,0
55307,53,50101,53,allow,1415,101,1314,4,51,2,2
1030,64147,0,0,deny,62,62,0,1,0,1,0
43129,20220,0,0,deny,62,62,0,1,0,1,0
64651,445,0,0,drop,66,66,0,1,0,1,0
49483,80,60356,80,allow,318,192,126,6,40,4,2
58555,443,6848,443,allow,15546,2361,13185,39,123,18,21
30315,57470,0,0,deny,145,145,0,1,0,1,0
55984,445,0,0,drop,66,66,0,1,0,1,0
37014,25174,0,0,deny,66,66,0,1,0,1,0
10701,11392,0,0,deny,146,146,0,1,0,1,0
58749,443,22893,443,allow,6246,4267,1979,21,16,11,10
58983,53,44611,53,allow,168,78,90,2,29,1,1
57015,25174,0,0,deny,66,66,0,1,0,1,0
45964,2225,0,0,deny,60,60,0,1,0,1,0
50517,80,5050,80,allow,502,256,246,9,25,5,4
33826,443,52979,443,allow,416,210,206,7,57,4,3
51800,443,3294,443,allow,36048,2364,33684,54,28,23,31
52167,61948,12539,61948,allow,70,70,0,2,8,2,0
65485,53,34553,53,allow,184,94,90,2,31,1,1
58002,80,62017,80,allow,2362,1608,754,22,80,12,10
49277,445,0,0,drop,70,70,0,1,0,1,0
54794,445,0,0,drop,70,70,0,1,0,1,0
34752,3389,34752,3389,allow,3910,1805,2105,20,18,12,8
56467,445,0,0,drop,70,70,0,1,0,1,0
64067,445,0,0,drop,70,70,0,1,0,1,0
27869,51221,0,0,deny,66,66,0,1,0,1,0
55042,445,0,0,drop,70,70,0,1,0,1,0
56494,15503,0,0,deny,146,146,0,1,0,1,0
54021,445,0,0,drop,70,70,0,1,0,1,0
63488,445,0,0,drop,70,70,0,1,0,1,0
54917,60043,0,0,deny,66,66,0,1,0,1,0
55649,445,0,0,drop,70,70,0,1,0,1,0
63536,445,0,0,drop,66,66,0,1,0,1,0
62160,445,0,0,drop,66,66,0,1,0,1,0
17861,443,17861,443,allow,1155,728,427,11,26,7,4
63867,64147,0,0,deny,62,62,0,1,0,1,0
56935,53,38764,53,allow,179,94,85,2,30,1,1
49279,53,50429,53,allow,199,102,97,2,29,1,1
38629,443,15765,443,allow,9198,2279,6919,18,18,9,9
50689,80,50689,80,allow,450,246,204,8,25,5,3
54539,445,0,0,drop,70,70,0,1,0,1,0
58888,23718,0,0,deny,66,66,0,1,0,1,0
55246,443,12271,443,allow,6144,1810,4334,18,45,11,7
33965,443,58848,443,allow,31008,10449,20559,69,130,31,38
61954,445,0,0,drop,70,70,0,1,0,1,0
58918,443,16774,443,allow,5166,700,4466,16,16,7,9
49286,53,40508,53,allow,184,94,90,2,29,1,1
55222,53,4063,53,allow,181,94,87,2,30,1,1
57419,445,0,0,drop,66,66,0,1,0,1,0
54814,445,0,0,drop,70,70,0,1,0,1,0
27005,27015,56171,27015,allow,858,126,732,2,31,1,1
51638,443,56586,443,allow,8176,2082,6094,26,360,12,14
56998,53,58740,53,allow,177,94,83,2,29,1,1
59747,443,56102,443,allow,1991,1190,801,21,32,11,10
443,29326,0,0,deny,82,82,0,1,0,1,0
27318,443,31101,443,allow,16040,2126,13914,40,50,21,19
57035,53,19895,53,allow,198,101,97,2,31,1,1
58511,50584,0,0,deny,146,146,0,1,0,1,0
33886,52255,0,0,deny,162,162,0,1,0,1,0
58096,443,10840,443,allow,7252,1150,6102,22,199,11,11
53987,57470,0,0,deny,66,66,0,1,0,1,0
62484,445,0,0,drop,70,70,0,1,0,1,0
64191,53,17402,53,allow,264,110,154,2,30,1,1
27005,27444,51395,27444,allow,893,126,767,2,30,1,1
51845,11201,33761,11201,allow,316,136,180,6,6,3,3
65275,53,14086,53,allow,168,86,82,2,31,1,1
53102,443,27329,443,allow,983,496,487,9,16,5,4
57496,25174,0,0,deny,62,62,0,1,0,1,0
50730,445,0,0,drop,70,70,0,1,0,1,0
56327,53,49632,53,allow,172,88,84,2,31,1,1
51950,80,61236,80,allow,3648,1775,1873,13,26,7,6
49376,53,53542,53,allow,209,110,99,2,30,1,1
49891,53,34490,53,allow,166,86,80,2,30,1,1
49352,53,48466,53,allow,214,94,120,2,30,1,1
443,50238,0,0,deny,331,331,0,1,0,1,0
44948,443,65427,443,allow,4792,3072,1720,31,80,16,15
56686,445,0,0,drop,70,70,0,1,0,1,0
51794,53911,18093,53911,allow,70,70,0,1,5,1,0
17070,48817,0,0,deny,140,140,0,1,0,1,0
34983,26543,0,0,deny,145,145,0,1,0,1,0
50165,80,3536,80,allow,17387,9304,8083,30,56,19,11
64421,53,34149,53,allow,178,94,84,2,30,1,1
57385,53,56308,53,allow,197,102,95,2,30,1,1
63385,445,0,0,drop,66,66,0,1,0,1,0
5223,59023,0,0,deny,66,66,0,1,0,1,0
64766,53,59121,53,allow,212,108,104,2,31,1,1
52026,26467,0,0,deny,60,60,0,1,0,1,0
57479,56205,0,0,deny,66,66,0,1,0,1,0
16387,56995,0,0,deny,60,60,0,1,0,1,0
59658,443,33900,443,allow,5433,925,4508,19,360,10,9
55918,53,15697,53,allow,184,94,90,2,31,1,1
54600,445,0,0,drop,66,66,0,1,0,1,0
39548,8696,0,0,deny,60,60,0,1,0,1,0
49502,80,22198,80,allow,2300864,53111,2247753,2242,18,755,1487
59967,445,0,0,drop,70,70,0,1,0,1,0
52214,443,59996,443,allow,10898,3170,7728,33,331,14,19
53017,443,37363,443,allow,15038,4142,10896,48,108,24,24
58673,443,8091,443,allow,3330,737,2593,10,121,5,5
52089,16543,15795,16543,allow,70,70,0,1,5,1,0
49809,445,0,0,drop,70,70,0,1,0,1,0
9129,53,56648,53,allow,205,86,119,2,30,1,1
65231,53,37315,53,allow,200,102,98,2,31,1,1
50640,80,59027,80,allow,2374,936,1438,13,45,7,6
7539,30317,0,0,deny,62,62,0,1,0,1,0
61721,443,43568,443,allow,9676,2327,7349,25,16,15,10
53264,443,22628,443,allow,7424,1825,5599,25,18,13,12
54828,443,1359,443,allow,150,150,0,1,5,1,0
62783,443,22003,443,allow,28847,16957,11890,144,293,60,84
52887,37807,0,0,deny,62,62,0,1,0,1,0
56768,10880,3397,10880,allow,70,70,0,1,5,1,0
56094,445,0,0,drop,66,66,0,1,0,1,0
60380,445,0,0,drop,70,70,0,1,0,1,0
39287,57470,0,0,deny,62,62,0,1,0,1,0
0,0,0,0,deny,156,156,0,2,0,2,0
55701,445,0,0,drop,70,70,0,1,0,1,0
55693,53,60577,53,allow,748,95,653,2,31,1,1
64982,50584,0,0,deny,146,146,0,1,0,1,0
35291,44847,0,0,deny,62,62,0,1,0,1,0
61865,35440,0,0,deny,66,66,0,1,0,1,0
19473,6881,30849,6881,allow,491,150,341,2,1200,1,1
54075,445,0,0,drop,66,66,0,1,0,1,0
8802,80,39611,80,allow,4999,1313,3686,36,667,8,28
65251,53,39893,53,allow,179,94,85,2,31,1,1
60246,44612,0,0,deny,66,66,0,1,0,1,0
54201,445,0,0,drop,70,70,0,1,0,1,0
40418,25174,0,0,deny,66,66,0,1,0,1,0
51389,445,0,0,drop,66,66,0,1,0,1,0
27005,27333,2413,27333,allow,890,126,764,2,30,1,1
57297,51221,0,0,deny,66,66,0,1,0,1,0
55567,445,0,0,drop,70,70,0,1,0,1,0
55228,445,0,0,drop,66,66,0,1,0,1,0
49636,53,21781,53,allow,176,90,86,2,31,1,1
37961,443,30943,443,allow,10229,2777,7452,30,361,15,15
55013,53,33517,53,allow,821,102,719,2,30,1,1
1939,53,33288,53,allow,210,78,132,2,30,1,1
59038,53,59038,53,allow,832,106,726,2,30,1,1
50047,445,0,0,drop,66,66,0,1,0,1,0
443,14591,0,0,deny,131,131,0,1,0,1,0
52166,26467,0,0,deny,66,66,0,1,0,1,0
55790,53,39330,53,allow,177,94,83,2,30,1,1
62487,443,47119,443,allow,14840,3978,10862,32,33,15,17
49487,445,0,0,drop,70,70,0,1,0,1,0
64793,445,0,0,drop,70,70,0,1,0,1,0
54644,443,43384,443,allow,4679,3387,1292,18,304,10,8
64154,53,27741,53,allow,194,102,92,2,31,1,1
56336,53,52213,53,allow,196,102,94,2,35,1,1
52177,443,57914,443,allow,7659,3234,4425,35,288,17,18
48706,23393,0,0,deny,60,60,0,1,0,1,0
54262,443,59350,443,allow,11356,5509,5847,84,544,44,40
23218,62413,0,0,deny,66,66,0,1,0,1,0
14185,48637,0,0,deny,60,60,0,1,0,1,0
62267,445,0,0,drop,70,70,0,1,0,1,0
65099,445,0,0,drop,70,70,0,1,0,1,0
57122,53,57720,53,allow,199,102,97,2,29,1,1
52067,46837,12452,46837,allow,70,70,0,2,8,2,0
49837,53,42825,53,allow,214,110,104,2,30,1,1
58884,445,0,0,drop,66,66,0,1,0,1,0
35654,80,35654,80,allow,7040,5744,1296,16,158,9,7
56041,445,0,0,drop,70,70,0,1,0,1,0
49913,53,61333,53,allow,177,94,83,2,29,1,1
56646,53,30377,53,allow,177,94,83,2,30,1,1
62721,443,47170,443,allow,5718309,117049,5601260,5287,155,1390,3897
60645,35440,0,0,deny,62,62,0,1,0,1,0
40151,443,46330,443,allow,80789,5008,75781,92,128,33,59
53128,29593,28307,29593,allow,70,70,0,2,9,2,0
53682,20884,50647,20884,allow,70,70,0,1,4,1,0
24271,52700,0,0,deny,66,66,0,1,0,1,0
64724,53,10875,53,allow,190,97,93,2,31,1,1
54957,53,32234,53,allow,102,102,0,1,30,1,0
51091,53,51091,53,allow,243,96,147,2,30,1,1
57636,445,0,0,drop,70,70,0,1,0,1,0
28032,443,27743,443,allow,6756,2587,4169,19,16,10,9
49282,53,64879,53,allow,178,94,84,2,30,1,1
58638,5900,0,0,deny,62,62,0,1,0,1,0
65216,53,8359,53,allow,775,102,673,2,30,1,1
14042,22114,0,0,deny,62,62,0,1,0,1,0
55988,445,0,0,drop,66,66,0,1,0,1,0
64016,53,52366,53,allow,184,94,90,2,30,1,1
63031,443,4313,443,allow,304,86,218,2,29,1,1
48098,80,19717,80,allow,1638,1324,314,10,15,5,5
62577,445,0,0,drop,70,70,0,1,0,1,0
12107,22114,0,0,deny,62,62,0,1,0,1,0
65506,53,15371,53,allow,197,102,95,2,30,1,1
55179,53,7582,53,allow,194,102,92,2,33,1,1
56811,443,16024,443,allow,8020,2000,6020,20,15,11,9
59675,80,26404,80,allow,3437462,77916,3359546,3384,134,1140,2244
49314,53,60410,53,allow,214,94,120,2,30,1,1
52265,53,0,0,allow,233,89,144,2,30,1,1
44514,443,59227,443,allow,448741,15805,432936,491,109,181,310
50089,53,56216,53,allow,718,94,624,2,30,1,1
53685,445,0,0,drop,70,70,0,1,0,1,0
49246,80,49246,80,allow,133699,9415,124284,169,23,77,92
49483,53,48622,53,allow,178,94,84,2,30,1,1
60374,80,60374,80,allow,118413,7486,110927,151,33,70,81
65385,445,0,0,drop,70,70,0,1,0,1,0
56165,445,0,0,drop,70,70,0,1,0,1,0
49418,27017,15205,27017,allow,252,78,174,2,30,1,1
19286,25174,0,0,deny,146,146,0,1,0,1,0
41210,23,0,0,deny,60,60,0,1,0,1,0
48913,443,1076,443,allow,6922,1618,5304,23,35,12,11
52669,443,6202,443,allow,18814,2623,16191,54,25,26,28
49300,53,25911,53,allow,232,86,146,2,30,1,1
53674,445,0,0,drop,70,70,0,1,0,1,0
49420,443,10802,443,allow,4932,1046,3886,21,173,10,11
34810,25174,0,0,deny,62,62,0,1,0,1,0
52038,50584,0,0,deny,66,66,0,1,0,1,0
64964,53,28757,53,allow,197,102,95,2,31,1,1
41420,443,4151,443,allow,4858,855,4003,16,64,9,7
22274,53,9607,53,allow,278,78,200,2,30,1,1
56374,53,20604,53,allow,177,94,83,2,29,1,1
40705,443,7502,443,allow,5721,3240,2481,35,147,14,21
6881,6881,38378,6881,allow,231,111,120,2,1200,1,1
63357,445,0,0,drop,66,66,0,1,0,1,0
58638,5900,0,0,deny,62,62,0,1,0,1,0
47747,443,43132,443,allow,4187,1350,2837,18,321,8,10
61204,445,0,0,drop,70,70,0,1,0,1,0
49540,53,16812,53,allow,279,94,185,2,30,1,1
65284,445,0,0,drop,70,70,0,1,0,1,0
42298,40028,40095,40028,allow,563,86,477,2,30,1,1
56906,445,0,0,drop,70,70,0,1,0,1,0
55441,53,33231,53,allow,216,110,106,2,30,1,1
58638,5900,0,0,deny,62,62,0,1,0,1,0
53692,44512,0,0,deny,66,66,0,1,0,1,0
59951,445,0,0,drop,70,70,0,1,0,1,0
56963,53,56853,53,allow,198,101,97,2,31,1,1
51617,21247,0,0,deny,66,66,0,1,0,1,0
52358,30188,0,0,deny,66,66,0,1,0,1,0
62964,53,62964,53,allow,404,259,145,3,33,2,1
50179,80,50179,80,allow,1473,920,553,9,137,6,3
57802,445,0,0,drop,70,70,0,1,0,1,0
16387,16862,0,0,deny,60,60,0,1,0,1,0
51541,3389,51541,3389,allow,3609,1654,1955,19,18,11,8
51612,443,45282,443,allow,6777,3431,3346,27,15,14,13
3436,46783,0,0,deny,62,62,0,1,0,1,0
56135,53,30728,53,allow,258,118,140,2,30,1,1
56812,53,46886,53,allow,767,102,665,2,30,1,1
49263,53,10892,53,allow,731,85,646,2,31,1,1
50159,53,16650,53,allow,94,94,0,1,29,1,0
41246,443,27215,443,allow,234,234,0,4,12,4,0
56122,53,50294,53,allow,731,91,640,2,30,1,1
52050,80,59091,80,allow,20868,10484,10384,34,32,17,17
35657,48637,0,0,deny,62,62,0,1,0,1,0
53277,445,0,0,drop,70,70,0,1,0,1,0
35494,22114,0,0,deny,66,66,0,1,0,1,0
6122,23,0,0,deny,60,60,0,1,0,1,0
45964,55559,0,0,deny,60,60,0,1,0,1,0
55806,80,22467,80,allow,1248,755,493,7,81,5,2
56728,53,8699,53,allow,166,86,80,2,31,1,1
51621,443,45721,443,allow,5964,1007,4957,18,16,11,7
52454,445,0,0,drop,70,70,0,1,0,1,0
51560,445,0,0,drop,70,70,0,1,0,1,0
62982,445,0,0,drop,70,70,0,1,0,1,0
21496,50265,0,0,deny,62,62,0,1,0,1,0
61288,445,0,0,drop,70,70,0,1,0,1,0
53102,445,0,0,drop,70,70,0,1,0,1,0
56142,53,56422,53,allow,194,102,92,2,31,1,1
65081,26467,0,0,deny,66,66,0,1,0,1,0
52378,445,0,0,drop,70,70,0,1,0,1,0
63755,445,0,0,drop,66,66,0,1,0,1,0
37992,49152,18454,49152,allow,156,156,0,3,7,3,0
56767,53,17852,53,allow,170,87,83,2,31,1,1
51207,443,64631,443,allow,12171,2763,9408,53,17,30,23
52513,443,40002,443,allow,5096,810,4286,15,15,8,7
19617,39004,0,0,deny,62,62,0,1,0,1,0
60869,445,0,0,drop,70,70,0,1,0,1,0
65412,445,0,0,drop,70,70,0,1,0,1,0
27824,51505,0,0,deny,62,62,0,1,0,1,0
49452,443,8798,443,allow,16012,6573,9439,43,175,20,23
21594,22448,0,0,allow,62,62,0,1,61,1,0
49448,443,34233,443,allow,1574,921,653,14,15,7,7
49837,53,47456,53,allow,214,110,104,2,30,1,1
62737,443,7478,443,allow,35936,2741,33195,62,15,30,32
57152,53,56256,53,allow,720,94,626,2,30,1,1
55422,445,0,0,drop,66,66,0,1,0,1,0
46582,80,45383,80,allow,540,540,0,10,194,10,0
61741,445,0,0,drop,70,70,0,1,0,1,0
61367,445,0,0,drop,70,70,0,1,0,1,0
6882,64147,0,0,deny,146,146,0,1,0,1,0
60007,443,8441,443,allow,7040,1933,5107,32,110,19,13
50482,80,36252,80,allow,314,192,122,6,25,4,2
61977,445,0,0,drop,66,66,0,1,0,1,0
9250,443,1319,443,allow,6331,837,5494,19,26,10,9
59473,445,0,0,drop,70,70,0,1,0,1,0
39446,443,32219,443,allow,1647482,62713,1584769,1898,219,744,1154
44732,80,44732,80,allow,369759,9557,360202,388,22,137,251
49842,80,44778,80,allow,70094,1629,68465,63,89,16,47
47871,443,47202,443,allow,70,70,0,1,5,1,0
24144,57470,0,0,deny,62,62,0,1,0,1,0
1284,50584,0,0,deny,62,62,0,1,0,1,0
49641,443,54383,443,allow,5776,1079,4697,15,53,8,7
49574,53,41987,53,allow,193,102,91,2,29,1,1
50169,53,12431,53,allow,211,78,133,2,30,1,1
14696,42707,0,0,deny,62,62,0,1,0,1,0
55762,445,0,0,drop,70,70,0,1,0,1,0
56149,53,56149,53,allow,832,106,726,2,30,1,1
55489,80,62350,80,allow,180504,12712,167792,229,32,105,124
53250,443,53250,443,allow,1464,757,707,18,121,9,9
41439,443,30443,443,allow,4370,1148,3222,17,26,9,8
52483,445,0,0,drop,70,70,0,1,0,1,0
55010,53,35689,53,allow,195,102,93,2,29,1,1
51414,22,0,0,deny,60,60,0,1,0,1,0
1024,64147,0,0,deny,109,109,0,1,0,1,0
53844,22114,0,0,deny,66,66,0,1,0,1,0
55111,39004,0,0,deny,66,66,0,1,0,1,0
52998,443,44367,443,allow,22480,2705,19775,49,109,22,27
60341,80,24741,80,allow,2005,1094,911,11,87,6,5
65058,445,0,0,drop,70,70,0,1,0,1,0
10319,42707,0,0,deny,62,62,0,1,0,1,0
56782,53,60829,53,allow,227,94,133,2,29,1,1
50472,443,48641,443,allow,251744,9600,242144,302,23,129,173
53063,445,0,0,drop,70,70,0,1,0,1,0
48841,51221,0,0,deny,62,62,0,1,0,1,0
57090,445,0,0,drop,66,66,0,1,0,1,0
12614,22,0,0,deny,60,60,0,1,0,1,0
56810,53,31641,53,allow,177,94,83,2,30,1,1
64862,53,5762,53,allow,211,110,101,2,30,1,1
56857,53,30246,53,allow,711,87,624,2,30,1,1
56738,53,36120,53,allow,264,87,177,4,37,2,2
25067,50265,0,0,deny,145,145,0,1,0,1,0
45109,443,1117,443,allow,11156,3899,7257,31,234,17,14
49891,53,30480,53,allow,788,108,680,2,31,1,1
57146,53,13566,53,allow,199,102,97,2,29,1,1
37267,443,16640,443,allow,3296,1636,1660,17,255,9,8
50573,22114,0,0,deny,62,62,0,1,0,1,0
64252,53,63394,53,allow,381,101,280,4,43,2,2
51920,32678,28612,32678,allow,70,70,0,1,5,1,0
51095,445,0,0,drop,66,66,0,1,0,1,0
3478,61463,0,0,deny,214,214,0,1,0,1,0
44065,443,13980,443,allow,6114,862,5252,17,71,9,8
51581,17546,0,0,deny,66,66,0,1,0,1,0
63388,445,0,0,drop,66,66,0,1,0,1,0
49801,443,19605,443,allow,44380,1589,42791,48,126,14,34
49869,53,64308,53,allow,209,110,99,2,30,1,1
52164,42271,32377,42271,allow,70,70,0,1,5,1,0
60434,445,0,0,drop,70,70,0,1,0,1,0
54111,62609,0,0,deny,148,148,0,1,0,1,0
21459,23,0,0,deny,60,60,0,1,0,1,0
50369,53,17923,53,allow,166,86,80,2,29,1,1
49546,53,2512,53,allow,357,106,251,4,36,2,2
34662,443,60147,443,allow,50100,46087,4013,73,121,43,30
6999,2310,0,0,deny,143,143,0,1,0,1,0
53160,39001,22070,39001,allow,70,70,0,2,8,2,0
64774,445,0,0,drop,70,70,0,1,0,1,0
57894,80,58107,80,allow,9800,2228,7572,23,24,12,11
35957,51185,0,0,deny,60,60,0,1,0,1,0
65443,53,21010,53,allow,164,86,78,2,30,1,1
38484,48637,0,0,deny,60,60,0,1,0,1,0
57427,445,0,0,drop,70,70,0,1,0,1,0
52137,1026,43020,1026,allow,196,136,60,4,8,3,1
55577,53,26571,53,allow,199,102,97,2,30,1,1
64060,53,33741,53,allow,258,110,148,2,30,1,1
50013,53,8122,53,allow,662,195,467,6,39,3,3
53764,443,39809,443,allow,8115,1962,6153,24,18,14,10
53162,443,22912,443,allow,23929,10333,13596,51,43,25,26
25583,2323,0,0,deny,60,60,0,1,0,1,0
53105,445,0,0,drop,70,70,0,1,0,1,0
46984,443,45323,443,allow,416,210,206,7,35,4,3
26467,6969,47386,6969,allow,192,192,0,4,1200,4,0
31410,25174,0,0,deny,146,146,0,1,0,1,0
57210,8525,57210,8525,allow,138,78,60,2,5,1,1
50978,80,46474,80,allow,1442,700,742,12,35,6,6
55888,445,0,0,drop,66,66,0,1,0,1,0
56256,62413,0,0,deny,62,62,0,1,0,1,0
49568,53,53479,53,allow,184,102,82,2,29,1,1
63100,445,0,0,drop,70,70,0,1,0,1,0
58060,445,0,0,drop,66,66,0,1,0,1,0
54984,443,11572,443,allow,68519,3801,64718,93,31,40,53
49381,445,0,0,drop,66,66,0,1,0,1,0
49238,53,61405,53,allow,274,94,180,2,30,1,1
51102,80,48661,80,allow,254,128,126,5,16,3,2
64530,53,39688,53,allow,261,87,174,4,46,2,2
55417,53,30758,53,allow,196,100,96,2,30,1,1
41840,50584,0,0,deny,66,66,0,1,0,1,0
60449,443,18490,443,allow,26571,2432,24139,42,30,21,21
63941,445,0,0,drop,70,70,0,1,0,1,0
56658,53,1646,53,allow,170,87,83,2,30,1,1
58743,443,4487,443,allow,5167,700,4467,16,15,7,9
49418,27015,58093,27015,allow,78,78,0,1,30,1,0
64135,445,0,0,drop,70,70,0,1,0,1,0
7975,53,7975,53,allow,237,91,146,2,33,1,1
23276,443,23276,443,allow,4668,1745,2923,21,76,12,9
49158,443,3923,443,allow,23613,13099,10514,79,1341,36,43
53233,445,0,0,drop,70,70,0,1,0,1,0
52769,445,0,0,drop,70,70,0,1,0,1,0
10436,37965,0,0,deny,62,62,0,1,0,1,0
56962,53,9303,53,allow,177,94,83,2,30,1,1
51451,445,0,0,drop,70,70,0,1,0,1,0
63425,445,0,0,drop,70,70,0,1,0,1,0
26906,22114,0,0,deny,66,66,0,1,0,1,0
58443,443,26143,443,allow,12060,3749,8311,42,17,23,19
61387,43890,0,0,deny,66,66,0,1,0,1,0
43732,443,60967,443,allow,5719,1339,4380,19,361,9,10
55219,443,55870,443,allow,6528,1918,4610,23,45,13,10
19068,37965,0,0,deny,62,62,0,1,0,1,0
57260,51221,0,0,deny,66,66,0,1,0,1,0
59875,443,49654,443,allow,6922,2214,4708,32,136,20,12
64530,53,46090,53,allow,211,102,109,2,30,1,1
65429,53,14191,53,allow,200,94,106,2,30,1,1
56986,53,50579,53,allow,259,87,172,4,37,2,2
49293,53,34843,53,allow,382,95,287,4,48,2,2
56031,53,65070,53,allow,177,94,83,2,30,1,1
55889,53,49760,53,allow,198,101,97,2,31,1,1
53591,35889,63951,35889,allow,320,140,180,6,6,3,3
56620,80,60684,80,allow,234,234,0,4,12,4,0
55887,53,35825,53,allow,339,98,241,4,47,2,2
58196,53,55117,53,allow,578,286,292,9,16,5,4
27969,25174,0,0,deny,66,66,0,1,0,1,0
65516,53,26116,53,allow,202,103,99,2,31,1,1
46902,123,43333,123,allow,184,94,90,2,30,1,1
57148,445,0,0,drop,70,70,0,1,0,1,0
64540,53,29410,53,allow,94,94,0,1,30,1,0
59505,53733,0,0,deny,66,66,0,1,0,1,0
58891,445,0,0,drop,70,70,0,1,0,1,0
63760,445,0,0,drop,70,70,0,1,0,1,0
10775,35440,0,0,deny,62,62,0,1,0,1,0
55643,53,52326,53,allow,183,94,89,2,29,1,1
56788,53,30869,53,allow,199,102,97,2,30,1,1
56586,445,0,0,drop,70,70,0,1,0,1,0
58638,5900,0,0,deny,62,62,0,1,0,1,0
35354,443,9498,443,allow,2392,917,1475,16,224,8,8
57252,53,46137,53,allow,182,93,89,2,31,1,1
53544,21247,0,0,deny,66,66,0,1,0,1,0
65184,445,0,0,drop,70,70,0,1,0,1,0
80,37649,0,0,deny,60,60,0,1,0,1,0
58638,5900,0,0,deny,62,62,0,1,0,1,0
51558,37965,0,0,deny,72,72,0,1,0,1,0
49621,445,0,0,drop,70,70,0,1,0,1,0
44884,443,49689,443,allow,296,78,218,4,19,1,3
52020,80,57766,80,allow,426,240,186,8,24,5,3
65236,53,21854,53,allow,177,94,83,2,30,1,1
55046,443,8809,443,allow,23425,10763,12662,57,48,31,26
51986,443,52647,443,allow,7567,3038,4529,35,15,21,14
10477,44847,0,0,deny,66,66,0,1,0,1,0
54434,445,0,0,drop,70,70,0,1,0,1,0
443,24425,0,0,deny,151,151,0,1,0,1,0
51221,51413,6783,51413,allow,459,149,310,2,1201,1,1
4257,35440,0,0,deny,62,62,0,1,0,1,0
49931,443,64224,443,allow,92352,5699,86653,105,134,35,70
52020,28704,45681,28704,allow,70,70,0,2,9,2,0
58638,5900,0,0,deny,62,62,0,1,0,1,0
57587,443,4519,443,allow,15613,1408,14205,32,125,15,17
56103,53,56052,53,allow,279,94,185,2,30,1,1
55123,53,56989,53,allow,198,102,96,2,30,1,1
54470,80,58006,80,allow,16896,1514,15382,30,255,16,14
18116,37807,0,0,deny,66,66,0,1,0,1,0
61187,445,0,0,drop,70,70,0,1,0,1,0
33908,48983,0,0,deny,145,145,0,1,0,1,0
30960,45761,37537,45761,allow,462,462,0,8,3632,8,0
18745,64147,0,0,deny,66,66,0,1,0,1,0
59467,445,0,0,drop,66,66,0,1,0,1,0
57985,80,36501,80,allow,3703,2068,1635,17,33,10,7
64850,53,49939,53,allow,196,102,94,2,30,1,1
50118,445,0,0,drop,70,70,0,1,0,1,0
49203,51050,0,0,deny,62,62,0,1,0,1,0
38432,53,33848,53,allow,336,231,105,3,30,2,1
57603,80,57603,80,allow,4373,2985,1388,21,37,11,10
10319,42707,0,0,deny,62,62,0,1,0,1,0
50991,445,0,0,drop,66,66,0,1,0,1,0
55370,445,0,0,drop,66,66,0,1,0,1,0
52230,47803,46448,47803,allow,136,136,0,3,14,3,0
61332,23,0,0,deny,60,60,0,1,0,1,0
59742,53,55013,53,allow,448,166,282,2,30,1,1
39607,443,22667,443,allow,559339,545011,14328,595,316,388,207
54673,443,44962,443,allow,10244,2295,7949,38,121,20,18
60701,445,0,0,drop,70,70,0,1,0,1,0
42770,443,4955,443,allow,8820,2996,5824,27,95,14,13
25187,31573,0,0,deny,62,62,0,1,0,1,0
50566,445,0,0,drop,70,70,0,1,0,1,0
49514,39127,0,0,deny,162,162,0,1,0,1,0
65346,53,45745,53,allow,182,93,89,2,31,1,1
52148,445,0,0,drop,66,66,0,1,0,1,0
30304,64147,0,0,deny,66,66,0,1,0,1,0
64055,45105,11907,45105,allow,66,66,0,2,7,2,0
37248,80,37248,80,allow,7850,1208,6642,16,20,8,8
64124,53,26589,53,allow,182,93,89,2,31,1,1
58887,445,0,0,drop,70,70,0,1,0,1,0
37260,21247,0,0,deny,66,66,0,1,0,1,0
37965,31483,54456,31483,allow,4530,2856,1674,62,2421,35,27
63731,26467,0,0,deny,66,66,0,1,0,1,0
65315,53,30606,53,allow,216,110,106,2,30,1,1
40202,5222,32011,5222,allow,5958,2420,3538,40,25,20,20
26900,27017,1315,27017,allow,422,164,258,6,30,3,3
50378,53,37644,53,allow,167,78,89,2,30,1,1
65460,53,48122,53,allow,177,94,83,2,30,1,1
35617,443,43217,443,allow,2981,1719,1262,17,79,10,7
65341,53,19741,53,allow,200,102,98,2,29,1,1
63937,53,56505,53,allow,182,93,89,2,30,1,1
64729,445,0,0,drop,70,70,0,1,0,1,0
65501,53,61730,53,allow,774,102,672,2,30,1,1
55830,53,13004,53,allow,177,94,83,2,30,1,1
63752,445,0,0,drop,70,70,0,1,0,1,0
22971,50584,0,0,deny,62,62,0,1,0,1,0
50056,27018,50062,27018,allow,546,390,156,6,30,4,2
26722,11446,0,0,deny,66,66,0,1,0,1,0
53621,443,63130,443,allow,2005,1100,905,16,17,9,7
32090,43890,0,0,deny,146,146,0,1,0,1,0
55628,445,0,0,drop,70,70,0,1,0,1,0
59301,445,0,0,drop,70,70,0,1,0,1,0
62510,445,0,0,drop,70,70,0,1,0,1,0
1035,26467,0,0,deny,62,62,0,1,0,1,0
64001,13051,20049,13051,allow,66,66,0,2,7,2,0
57992,445,0,0,drop,66,66,0,1,0,1,0
51961,40373,22472,40373,allow,70,70,0,1,5,1,0
53940,53,37682,53,allow,70,70,0,1,30,1,0
52213,56682,21348,56682,allow,70,70,0,2,6,2,0
44879,443,44879,443,allow,7123,1020,6103,19,151,11,8
57232,445,0,0,drop,70,70,0,1,0,1,0
37965,17336,18530,17336,allow,481,150,331,2,1199,1,1
57798,445,0,0,drop,70,70,0,1,0,1,0
50270,445,0,0,drop,70,70,0,1,0,1,0
64812,16384,57833,16384,allow,556,256,300,10,30,5,5
33861,443,34883,443,allow,8084,2638,5446,26,20,14,12
50735,445,0,0,drop,66,66,0,1,0,1,0
34365,443,34038,443,allow,223826,45909,177917,356,44,176,180
58577,445,0,0,drop,70,70,0,1,0,1,0
54093,5228,31167,5228,allow,7608,1824,5784,34,171,19,15
28192,50584,0,0,deny,66,66,0,1,0,1,0
20957,53,20957,53,allow,216,90,126,2,30,1,1
24271,52700,0,0,deny,66,66,0,1,0,1,0
57765,2767,0,0,deny,146,146,0,1,0,1,0
61030,21247,0,0,deny,66,66,0,1,0,1,0
49576,445,0,0,drop,70,70,0,1,0,1,0
48274,15000,32911,15000,allow,130,70,60,2,6,1,1
51952,80,54561,80,allow,1263,640,623,12,45,7,5
22542,30188,0,0,deny,146,146,0,1,0,1,0
65003,57470,0,0,deny,78,78,0,1,0,1,0
60760,445,0,0,drop,70,70,0,1,0,1,0
60507,53830,57450,53830,allow,320,140,180,6,6,3,3
65367,445,0,0,drop,70,70,0,1,0,1,0
64580,53,3526,53,allow,180,94,86,2,30,1,1
7307,23,0,0,deny,60,60,0,1,0,1,0
56973,53,50381,53,allow,193,102,91,2,30,1,1
64200,53,27722,53,allow,193,102,91,2,30,1,1
34697,443,10528,443,allow,15997,3015,12982,31,18,16,15
55060,123,26864,123,allow,184,94,90,2,30,1,1
57100,53,13292,53,allow,402,118,284,2,30,1,1
64368,22114,0,0,deny,62,62,0,1,0,1,0
58638,5900,0,0,deny,62,62,0,1,0,1,0
58990,53,6423,53,allow,168,78,90,2,30,1,1
44919,26467,0,0,deny,62,62,0,1,0,1,0
65428,80,59063,80,allow,366,180,186,7,29,4,3
57218,445,0,0,drop,66,66,0,1,0,1,0
54970,443,62898,443,allow,251620,16028,235592,353,371,159,194
29291,62609,0,0,deny,150,150,0,1,0,1,0
39932,443,25651,443,allow,8309,4385,3924,26,121,12,14
49242,445,0,0,drop,70,70,0,1,0,1,0
63101,445,0,0,drop,66,66,0,1,0,1,0
51672,445,0,0,drop,70,70,0,1,0,1,0
50516,53,48548,53,allow,772,100,672,2,31,1,1
58439,445,0,0,drop,70,70,0,1,0,1,0
25453,35776,0,0,deny,145,145,0,1,0,1,0
11382,43890,0,0,deny,62,62,0,1,0,1,0
60740,445,0,0,drop,70,70,0,1,0,1,0
64143,53,3333,53,allow,179,94,85,2,30,1,1
61730,25320,0,0,deny,66,66,0,1,0,1,0
64877,53,52528,53,allow,94,94,0,1,30,1,0
64883,53,48996,53,allow,184,94,90,2,30,1,1
57604,32480,0,0,deny,62,62,0,1,0,1,0
60312,57470,0,0,deny,74,74,0,1,0,1,0
65092,445,0,0,drop,70,70,0,1,0,1,0
10967,3389,10967,3389,reset-both,293,223,70,4,1,3,1
62509,445,0,0,drop,70,70,0,1,0,1,0
58564,50432,0,0,deny,66,66,0,1,0,1,0
49099,53,46349,53,allow,238,94,144,2,30,1,1
37475,443,1375,443,allow,4403,2160,2243,14,136,7,7
21133,6889,63864,6889,allow,481,150,331,2,1199,1,1
59442,445,0,0,drop,70,70,0,1,0,1,0
52143,37807,0,0,deny,66,66,0,1,0,1,0
60774,40010,46436,40010,allow,316,136,180,6,7,3,3
40312,55442,0,0,deny,62,62,0,1,0,1,0
49422,445,0,0,drop,70,70,0,1,0,1,0
52606,53,0,0,allow,223,91,132,2,30,1,1
62066,443,55561,443,allow,11816,3175,8641,32,46,16,16
50521,445,0,0,drop,70,70,0,1,0,1,0
50350,445,0,0,drop,70,70,0,1,0,1,0
58611,445,0,0,drop,66,66,0,1,0,1,0
59393,443,45183,443,allow,1664,914,750,15,275,7,8
60151,445,0,0,drop,70,70,0,1,0,1,0
0,0,0,0,allow,320,320,0,5,0,5,0
54678,445,0,0,drop,70,70,0,1,0,1,0
58638,5900,0,0,deny,62,62,0,1,0,1,0
63228,443,36281,443,allow,3749,2597,1152,25,134,15,10
49207,443,63518,443,allow,19566,12185,7381,89,176,42,47
33896,57470,0,0,deny,74,74,0,1,0,1,0
39629,53,0,0,allow,82,82,0,1,30,1,0
50889,445,0,0,drop,70,70,0,1,0,1,0
49305,53,59053,53,allow,177,94,83,2,29,1,1
64922,26296,0,0,deny,148,148,0,1,0,1,0
35716,53,38842,53,allow,168,78,90,2,30,1,1
27005,27212,63313,27212,allow,889,126,763,2,30,1,1
14914,443,14914,443,allow,16960,1347,15613,28,17,10,18
55690,443,36462,443,allow,914,444,470,14,29,7,7
49494,445,0,0,drop,70,70,0,1,0,1,0
64289,445,0,0,drop,66,66,0,1,0,1,0
44649,443,58778,443,allow,7013,1092,5921,21,31,12,9
46486,53,46486,53,allow,414,268,146,3,34,2,1
42664,80,62788,80,allow,63654,7979,55675,90,91,49,41
2707,37,0,0,deny,60,60,0,1,0,1,0
56339,443,15948,443,allow,8991,1756,7235,28,26,15,13
64146,53,63495,53,allow,197,102,95,2,30,1,1
34947,53,51809,53,allow,168,78,90,2,30,1,1
10348,25604,0,0,deny,66,66,0,1,0,1,0
50542,443,2915,443,allow,6787,1846,4941,24,361,11,13
57418,445,0,0,drop,66,66,0,1,0,1,0
62331,61689,0,0,deny,62,62,0,1,0,1,0
61550,5529,0,0,deny,145,145,0,1,0,1,0
52015,25487,58605,25487,allow,70,70,0,2,8,2,0
49966,53,5626,53,allow,168,78,90,2,30,1,1
49182,21247,0,0,deny,66,66,0,1,0,1,0
64094,1024,62040,1024,allow,70,70,0,1,5,1,0
49740,53,35003,53,allow,167,86,81,2,30,1,1
20336,53,20336,53,allow,233,91,142,2,31,1,1
65117,53,1871,53,allow,198,102,96,2,30,1,1
63331,445,0,0,drop,66,66,0,1,0,1,0
56612,53,25011,53,allow,274,87,187,4,31,2,2
57169,445,0,0,drop,66,66,0,1,0,1,0
56415,53,51829,53,allow,179,94,85,2,30,1,1
51268,47662,19145,47662,allow,70,70,0,1,5,1,0
50378,53,11083,53,allow,199,102,97,2,29,1,1
60306,53,57588,53,allow,168,78,90,2,29,1,1
37654,443,34226,443,allow,12531,5566,6965,34,46,20,14
64120,443,47176,443,allow,3767437,87322,3680115,3675,52,1230,2445
56677,53,7912,53,allow,200,102,98,2,30,1,1
14042,22114,0,0,deny,62,62,0,1,0,1,0
56719,443,65516,443,allow,7888,1899,5989,20,15,11,9
14489,25174,0,0,deny,62,62,0,1,0,1,0
65240,53,39958,53,allow,199,94,105,2,30,1,1
42951,22114,0,0,deny,66,66,0,1,0,1,0
16384,443,23910,443,allow,2227,1018,1209,17,16,8,9
57808,53,57808,53,allow,222,90,132,2,30,1,1
56728,443,11785,443,allow,8652,2148,6504,20,15,11,9
52001,12514,13607,12514,allow,66,66,0,1,5,1,0
63741,36776,34457,36776,allow,66,66,0,2,8,2,0
60527,35440,0,0,deny,66,66,0,1,0,1,0
25880,44847,0,0,deny,146,146,0,1,0,1,0
55318,53,29370,53,allow,215,102,113,2,30,1,1
52649,445,0,0,drop,66,66,0,1,0,1,0
52526,30188,0,0,deny,66,66,0,1,0,1,0
52072,443,62613,443,allow,7737,6531,1206,21,16,12,9
49411,53,16636,53,allow,190,97,93,2,31,1,1
19634,64147,0,0,deny,62,62,0,1,0,1,0
53237,443,24814,443,allow,33472,16066,17406,57,48,29,28
57761,15503,0,0,deny,66,66,0,1,0,1,0
54619,80,53235,80,allow,2269,1579,690,10,77,6,4
47888,2310,0,0,deny,145,145,0,1,0,1,0
49917,445,0,0,drop,70,70,0,1,0,1,0
64569,53,4728,53,allow,413,170,243,6,30,3,3
55514,53,44502,53,allow,783,96,687,2,30,1,1
59916,445,0,0,drop,70,70,0,1,0,1,0
49420,443,13090,443,allow,5241,1194,4047,19,40,9,10
55269,53,20584,53,allow,186,95,91,2,31,1,1
58738,445,0,0,drop,66,66,0,1,0,1,0
56503,445,0,0,drop,66,66,0,1,0,1,0
53890,23310,38031,23310,allow,70,70,0,1,4,1,0
56431,80,21703,80,allow,17248,1619,15629,26,25,11,15
53792,53,47522,53,allow,224,86,138,2,30,1,1
57860,51505,0,0,deny,62,62,0,1,0,1,0
49182,53,3761,53,allow,199,102,97,2,29,1,1
54977,80,22361,80,allow,4259,1114,3145,12,18,8,4
49976,5900,0,0,deny,60,60,0,1,0,1,0
55055,445,0,0,drop,70,70,0,1,0,1,0
50160,445,0,0,drop,70,70,0,1,0,1,0
50198,443,55477,443,allow,29124,1724,27400,41,160,16,25
21133,17068,30422,17068,allow,481,150,331,2,1199,1,1
49655,53,32746,53,allow,209,110,99,2,30,1,1
49490,53,6765,53,allow,364,92,272,4,38,2,2
61624,445,0,0,drop,70,70,0,1,0,1,0
56285,53,40728,53,allow,711,87,624,2,30,1,1
51698,80,35267,80,allow,15609,1298,14311,26,75,14,12
56242,53,30808,53,allow,231,86,145,2,30,1,1
52010,443,6265,443,allow,7722,2568,5154,26,63,15,11
53746,36237,0,0,deny,66,66,0,1,0,1,0
53531,48908,54109,48908,allow,70,70,0,2,7,2,0
59822,445,0,0,drop,70,70,0,1,0,1,0
54270,443,64669,443,allow,29945,19086,10859,98,736,50,48
41586,1900,0,0,deny,139,139,0,1,0,1,0
51793,12210,40752,12210,allow,70,70,0,2,8,2,0
55036,443,33915,443,allow,36364,9639,26725,62,53,31,31
64745,53,11106,53,allow,196,94,102,2,31,1,1
49437,53,49111,53,allow,498,204,294,6,30,3,3
62348,48817,0,0,deny,145,145,0,1,0,1,0
15922,44847,0,0,deny,66,66,0,1,0,1,0
9265,80,10244,80,allow,318,192,126,6,26,4,2
56186,53,13478,53,allow,198,102,96,2,31,1,1
49670,53,15548,53,allow,168,86,82,2,31,1,1
61000,15503,0,0,deny,146,146,0,1,0,1,0
50293,445,0,0,drop,66,66,0,1,0,1,0
60075,41705,0,0,deny,66,66,0,1,0,1,0
57239,53,5025,53,allow,193,102,91,2,30,1,1
50914,445,0,0,drop,70,70,0,1,0,1,0
55889,53,19175,53,allow,177,94,83,2,29,1,1
40736,443,40736,443,allow,4380,1473,2907,19,26,11,8
65289,53,55084,53,allow,174,89,85,2,31,1,1
59197,445,0,0,drop,70,70,0,1,0,1,0
49334,53,5617,53,allow,300,99,201,4,38,2,2
57890,445,0,0,drop,66,66,0,1,0,1,0
53858,53,53858,53,allow,832,106,726,2,30,1,1
51862,22,51862,22,allow,7902,3301,4601,56,40,26,30
62694,445,0,0,drop,66,66,0,1,0,1,0
49934,53,18444,53,allow,478,107,371,4,39,2,2
19367,35440,0,0,deny,146,146,0,1,0,1,0
35408,53,57895,53,allow,168,78,90,2,30,1,1
62352,445,0,0,drop,70,70,0,1,0,1,0
60855,445,0,0,drop,70,70,0,1,0,1,0
29989,26467,0,0,deny,62,62,0,1,0,1,0
53530,8999,38471,8999,allow,70,70,0,2,7,2,0
50316,53,39379,53,allow,193,102,91,2,30,1,1
50799,37807,0,0,deny,62,62,0,1,0,1,0
55786,53,25615,53,allow,816,102,714,2,29,1,1
53593,32022,37169,32022,allow,320,140,180,6,6,3,3
55473,53,63957,53,allow,186,102,84,2,30,1,1
16387,35244,0,0,deny,60,60,0,1,0,1,0
52333,445,0,0,drop,70,70,0,1,0,1,0
55962,53,28186,53,allow,193,102,91,2,30,1,1
37629,443,33990,443,allow,172,172,0,2,5,2,0
27300,36237,0,0,deny,146,146,0,1,0,1,0
61892,445,0,0,drop,70,70,0,1,0,1,0
53298,443,53298,443,allow,4348,1441,2907,19,29,11,8
57241,53,11880,53,allow,760,97,663,2,31,1,1
42252,33303,0,0,deny,60,60,0,1,0,1,0
58719,443,6983,443,allow,18880,7831,11049,37,18,19,18
57536,53,46039,53,allow,199,94,105,2,30,1,1
43347,443,49384,443,allow,9118,1699,7419,24,131,14,10
60746,40010,7294,40010,allow,316,136,180,6,6,3,3
59347,445,0,0,drop,70,70,0,1,0,1,0
54979,53,3280,53,allow,97,97,0,1,61,1,0
56905,443,19184,443,allow,7537,2310,5227,19,142,8,11
50682,445,0,0,drop,66,66,0,1,0,1,0
65515,53,22832,53,allow,338,107,231,4,39,2,2
56309,22114,0,0,deny,62,62,0,1,0,1,0
65516,53,26663,53,allow,290,94,196,4,40,2,2
64041,80,63585,80,allow,314,192,122,6,15,4,2
61748,445,0,0,drop,70,70,0,1,0,1,0
14259,53,14259,53,allow,247,98,149,2,33,1,1
58902,445,0,0,drop,70,70,0,1,0,1,0
61462,445,0,0,drop,70,70,0,1,0,1,0
50524,53,52843,53,allow,816,102,714,2,29,1,1
64887,445,0,0,drop,70,70,0,1,0,1,0
56561,53,63189,53,allow,167,86,81,2,30,1,1
63980,445,0,0,drop,70,70,0,1,0,1,0
1266,57470,0,0,deny,146,146,0,1,0,1,0
65440,53,2075,53,allow,189,102,87,2,30,1,1
53476,443,9051,443,allow,3182,1568,1614,8,121,4,4
53373,64147,0,0,deny,66,66,0,1,0,1,0
37658,16386,64660,16386,allow,130,70,60,2,29,1,1
59668,50584,0,0,deny,62,62,0,1,0,1,0
57963,445,0,0,drop,70,70,0,1,0,1,0
57509,445,0,0,drop,70,70,0,1,0,1,0
57169,53,45860,53,allow,177,94,83,2,31,1,1
61537,57866,0,0,deny,66,66,0,1,0,1,0
55735,53,59032,53,allow,256,93,163,2,30,1,1
44145,443,29432,443,allow,8746,2844,5902,26,315,13,13
28275,80,28275,80,allow,303421,10894,292527,324,26,116,208
44129,64147,0,0,deny,145,145,0,1,0,1,0
51036,80,2227,80,allow,1514,480,1034,11,16,6,5
65235,53,33492,53,allow,209,110,99,2,31,1,1
0,0,0,0,allow,134,64,70,2,0,1,1
53132,445,0,0,drop,70,70,0,1,0,1,0
61236,445,0,0,drop,70,70,0,1,0,1,0
46673,80,11851,80,allow,1151,711,440,10,15,5,5
60074,445,0,0,drop,70,70,0,1,0,1,0
54275,445,0,0,drop,70,70,0,1,0,1,0
49907,443,5295,443,allow,6754,2219,4535,21,76,11,10
51690,993,38356,993,allow,15022,5202,9820,113,36,53,60
57296,53,48552,53,allow,200,102,98,2,30,1,1
27147,22114,0,0,deny,62,62,0,1,0,1,0
64297,445,0,0,drop,70,70,0,1,0,1,0
54976,2273,0,0,deny,60,60,0,1,0,1,0
27922,25174,0,0,deny,62,62,0,1,0,1,0
64564,53,49143,53,allow,273,94,179,2,30,1,1
49023,5223,36604,5223,allow,139,139,0,1,5,1,0
21478,53,21478,53,allow,625,79,546,2,30,1,1
51293,445,0,0,drop,70,70,0,1,0,1,0
58627,25174,0,0,deny,62,62,0,1,0,1,0
61420,64097,0,0,deny,62,62,0,1,0,1,0
49337,443,47623,443,allow,5483,2770,2713,30,361,15,15
60047,80,39100,80,allow,2634,1780,854,14,142,8,6
40826,443,36041,443,allow,4125,2847,1278,18,255,10,8
58762,445,0,0,drop,70,70,0,1,0,1,0
30303,56301,0,0,deny,169,169,0,1,0,1,0
58501,44847,0,0,deny,62,62,0,1,0,1,0
54670,445,0,0,drop,66,66,0,1,0,1,0
49901,443,3004,443,allow,4949,1047,3902,22,33,11,11
33857,123,20930,123,allow,184,94,90,2,30,1,1
64788,53,8538,53,allow,749,94,655,2,31,1,1
58060,445,0,0,drop,70,70,0,1,0,1,0
1025,50584,0,0,deny,62,62,0,1,0,1,0
63339,445,0,0,drop,70,70,0,1,0,1,0
65511,53,46791,53,allow,214,102,112,2,30,1,1
45607,53,29195,53,allow,168,78,90,2,30,1,1
38011,443,55120,443,allow,6732,885,5847,24,368,7,17
55050,443,4346,443,allow,7372,2875,4497,23,61,13,10
60957,445,0,0,drop,70,70,0,1,0,1,0
58922,57470,0,0,deny,66,66,0,1,0,1,0
21133,51413,31456,51413,allow,459,149,310,2,1200,1,1
56045,53,44616,53,allow,754,94,660,2,31,1,1
62946,445,0,0,drop,70,70,0,1,0,1,0
9743,23,0,0,deny,60,60,0,1,0,1,0
53765,443,24226,443,allow,16482,9312,7170,39,141,19,20
49410,53,54828,53,allow,178,94,84,2,30,1,1
35589,25174,0,0,deny,66,66,0,1,0,1,0
29988,44847,0,0,deny,66,66,0,1,0,1,0
54020,443,45905,443,allow,17529,8138,9391,39,31,17,22
63080,37965,0,0,deny,66,66,0,1,0,1,0
3964,51505,0,0,deny,62,62,0,1,0,1,0
50987,445,0,0,drop,66,66,0,1,0,1,0
35526,443,57074,443,allow,4566,3317,1249,21,23,12,9
63638,53,10182,53,allow,286,78,208,2,30,1,1
57216,445,0,0,drop,70,70,0,1,0,1,0
35642,80,28559,80,allow,1849,1015,834,11,150,6,5
42298,40015,12335,40015,allow,140,78,62,2,31,1,1
53816,22114,0,0,deny,62,62,0,1,0,1,0
34499,8497,0,0,deny,148,148,0,1,0,1,0
42128,54532,0,0,deny,60,60,0,1,0,1,0
56704,443,41939,443,allow,8125,2039,6086,21,15,11,10
56548,53,28244,53,allow,199,102,97,2,31,1,1
52135,46475,11599,46475,allow,70,70,0,1,5,1,0
62568,445,0,0,drop,70,70,0,1,0,1,0
3851,53,3851,53,allow,235,90,145,2,33,1,1
56624,443,34630,443,allow,7940,1951,5989,20,16,11,9
59402,53,5852,53,allow,203,86,117,2,30,1,1
50714,443,52657,443,allow,9477,1950,7527,31,181,14,17
9103,443,27886,443,allow,7876,1511,6365,29,42,14,15
51511,443,55401,443,allow,213140,10321,202819,260,33,108,152
57838,53,1470,53,allow,70,70,0,1,29,1,0
60453,24369,18318,24369,allow,70,70,0,1,5,1,0
36560,3142,36560,3142,allow,138,78,60,2,5,1,1
62306,445,0,0,drop,70,70,0,1,0,1,0
25565,13556,0,0,deny,60,60,0,1,0,1,0
58764,445,0,0,drop,70,70,0,1,0,1,0
56982,53,27888,53,allow,177,94,83,2,31,1,1
65221,445,0,0,drop,66,66,0,1,0,1,0
65063,53,59913,53,allow,340,94,246,2,30,1,1
57152,53,57152,53,allow,241,98,143,2,30,1,1
55735,53,20718,53,allow,184,94,90,2,30,1,1
65056,53,16740,53,allow,168,94,74,2,30,1,1
9340,443,64311,443,allow,3835,501,3334,14,15,7,7
61813,445,0,0,drop,70,70,0,1,0,1,0
51164,64147,0,0,deny,62,62,0,1,0,1,0
59478,443,44670,443,allow,9310,2994,6316,25,122,11,14
59604,445,0,0,drop,70,70,0,1,0,1,0
58944,445,0,0,drop,70,70,0,1,0,1,0
62900,445,0,0,drop,66,66,0,1,0,1,0
55276,53,62860,53,allow,177,94,83,2,30,1,1
50410,443,7615,443,allow,14049,602,13447,19,35,6,13
62971,44847,0,0,deny,62,62,0,1,0,1,0
52018,53,53682,53,allow,164,78,86,2,30,1,1
55470,53,60625,53,allow,310,94,216,2,30,1,1
44388,63874,0,0,deny,62,62,0,1,0,1,0
51246,445,0,0,drop,70,70,0,1,0,1,0
53064,443,10926,443,allow,8095,2586,5509,38,90,19,19
53244,445,0,0,drop,70,70,0,1,0,1,0
57344,445,0,0,drop,70,70,0,1,0,1,0
50249,445,0,0,drop,70,70,0,1,0,1,0
64403,53,35591,53,allow,186,95,91,2,31,1,1
43220,443,18756,443,allow,3178535,62767,3115768,2800,83,626,2174
64091,53,16270,53,allow,178,94,84,2,30,1,1
51780,21130,19007,21130,allow,66,66,0,1,5,1,0
65451,53,6208,53,allow,188,96,92,2,31,1,1
4780,443,25705,443,allow,1191,692,499,12,40,7,5
52127,44198,61078,44198,allow,70,70,0,1,5,1,0
52472,51221,0,0,deny,74,74,0,1,0,1,0
36841,443,36841,443,allow,4401,1494,2907,19,27,11,8
9144,3389,9144,3389,reset-both,293,223,70,4,1,3,1
49250,53,20588,53,allow,731,85,646,2,30,1,1
65048,53,26939,53,allow,188,96,92,2,31,1,1
57248,443,32420,443,allow,1021056,38101,982955,1183,64,501,682
49749,53,2042,53,allow,200,102,98,2,30,1,1
64063,37832,22712,37832,allow,70,70,0,1,4,1,0
63907,54218,37939,54218,allow,696,452,244,11,21,7,4
58638,5900,0,0,deny,62,62,0,1,0,1,0
51363,445,0,0,drop,66,66,0,1,0,1,0
62616,443,35713,443,allow,32504,1730,30774,44,122,17,27
49198,53,53619,53,allow,308,118,190,2,30,1,1
49800,53,17712,53,allow,87,87,0,1,30,1,0
53836,15000,1937,15000,allow,130,70,60,2,5,1,1
53177,8595,28264,8595,allow,70,70,0,2,9,2,0
64643,443,21220,443,allow,3433,1192,2241,13,136,6,7
50446,80,5062,80,allow,318,192,126,6,27,4,2
48071,25174,0,0,deny,62,62,0,1,0,1,0
50319,53,41804,53,allow,188,96,92,2,31,1,1
49197,2710,30685,2710,allow,70,70,0,1,4,1,0
30575,11119,0,0,deny,148,148,0,1,0,1,0
49348,53,64482,53,allow,214,94,120,2,31,1,1
59384,445,0,0,drop,66,66,0,1,0,1,0
61400,64147,0,0,deny,66,66,0,1,0,1,0
40780,80,6352,80,allow,1155,781,374,10,16,6,4
27005,27017,61483,27017,allow,878,126,752,2,30,1,1
53721,443,43069,443,allow,70,70,0,2,7,2,0
61399,80,3299,80,allow,5518,527,4991,13,75,6,7
55874,64147,0,0,deny,66,66,0,1,0,1,0
49230,445,0,0,drop,66,66,0,1,0,1,0
56618,443,44259,443,allow,22938,14436,8502,43,41,23,20
49207,58751,38431,58751,allow,70,70,0,1,5,1,0
62356,445,0,0,drop,70,70,0,1,0,1,0
60233,445,0,0,drop,70,70,0,1,0,1,0
53791,443,9232,443,allow,499,425,74,4,0,3,1
52024,80,44508,80,allow,422,240,182,8,25,5,3
37902,23718,0,0,deny,62,62,0,1,0,1,0
42601,443,52311,443,allow,3238,2021,1217,16,16,8,8
62558,20170,0,0,deny,145,145,0,1,0,1,0
64231,443,45459,443,allow,2227,1018,1209,17,16,8,9
57093,53,32863,53,allow,711,87,624,2,30,1,1
46746,443,33868,443,allow,7002,4142,2860,46,1485,29,17
55917,53,56529,53,allow,170,87,83,2,31,1,1
56594,53,5143,53,allow,173,94,79,2,30,1,1
50608,445,0,0,drop,66,66,0,1,0,1,0
64257,53,50451,53,allow,168,86,82,2,31,1,1
49668,53,14674,53,allow,214,102,112,2,29,1,1
51968,443,63060,443,allow,5315,3154,2161,56,47,32,24
57689,445,0,0,drop,70,70,0,1,0,1,0
23710,41615,0,0,deny,145,145,0,1,0,1,0
60020,443,30222,443,allow,495428,22440,472988,692,106,316,376
54600,6881,0,0,deny,66,66,0,1,0,1,0
50116,22,0,0,allow,60,60,0,1,90,1,0
56764,445,0,0,drop,66,66,0,1,0,1,0
3478,61463,0,0,deny,364,364,0,1,0,1,0
59443,445,0,0,drop,70,70,0,1,0,1,0
55336,443,52055,443,allow,209596,37190,172406,378,79,184,194
55469,53,3156,53,allow,193,102,91,2,30,1,1
16387,56995,0,0,deny,60,60,0,1,0,1,0
59181,53,28620,53,allow,260,86,174,2,29,1,1
54365,443,56544,443,allow,3970,1726,2244,13,134,6,7
61808,443,61318,443,allow,8189,3146,5043,26,30,14,12
37566,443,23464,443,allow,499,425,74,4,0,3,1
45238,44847,0,0,deny,66,66,0,1,0,1,0
62439,443,26291,443,allow,16246,11056,5190,37,45,21,16
51041,80,59300,80,allow,1514,480,1034,11,15,6,5
65159,53,25271,53,allow,286,103,183,4,52,2,2
51212,443,57861,443,allow,18745,11713,7032,67,77,37,30
58638,5900,0,0,deny,62,62,0,1,0,1,0
37034,25174,0,0,deny,62,62,0,1,0,1,0
59618,46824,0,0,deny,66,66,0,1,0,1,0
51653,80,24193,80,allow,454,262,192,8,37,5,3
61024,445,0,0,drop,66,66,0,1,0,1,0
33896,57470,0,0,deny,74,74,0,1,0,1,0
443,43775,0,0,deny,97,97,0,1,0,1,0
65131,53,39663,53,allow,168,86,82,2,31,1,1
52861,443,16498,443,allow,3633587,34615,3598972,2964,137,514,2450
60557,23117,0,0,deny,66,66,0,1,0,1,0
63837,14023,10553,14023,allow,66,66,0,2,8,2,0
52339,443,45302,443,allow,4362,1266,3096,26,129,11,15
443,10010,0,0,deny,60,60,0,1,0,1,0
58638,5900,0,0,deny,62,62,0,1,0,1,0
23079,9694,0,0,deny,62,62,0,1,0,1,0
30188,31063,61312,31063,allow,502,150,352,2,1200,1,1
64388,53,48927,53,allow,248,102,146,2,30,1,1
24037,443,24037,443,allow,3611,2177,1434,24,17,13,11
56830,53,56847,53,allow,195,102,93,2,30,1,1
41744,37965,0,0,deny,62,62,0,1,0,1,0
56754,53,54310,53,allow,182,93,89,2,31,1,1
56341,445,0,0,drop,66,66,0,1,0,1,0
53460,443,38830,443,allow,25079,5739,19340,39,337,18,21
52136,42939,50885,42939,allow,70,70,0,2,8,2,0
56445,53,19322,53,allow,374,94,280,2,30,1,1
65313,445,0,0,drop,70,70,0,1,0,1,0
59586,57470,0,0,deny,66,66,0,1,0,1,0
58638,5900,0,0,deny,62,62,0,1,0,1,0
17453,35440,0,0,deny,66,66,0,1,0,1,0
56345,53,18764,53,allow,199,94,105,2,30,1,1
57323,53,27696,53,allow,194,102,92,2,30,1,1
49166,443,48248,443,allow,9022,1416,7606,25,31,11,14
2064,22114,0,0,deny,146,146,0,1,0,1,0
41270,443,43404,443,allow,14659,5023,9636,46,400,14,32
52930,443,20378,443,allow,5584,1390,4194,19,15,9,10
50030,53,18076,53,allow,209,110,99,2,30,1,1
59957,25,59957,25,allow,1721,681,1040,22,17,10,12
57196,53,50893,53,allow,182,93,89,2,30,1,1
56461,53,50926,53,allow,760,96,664,2,31,1,1
61017,445,0,0,drop,70,70,0,1,0,1,0
10406,35440,0,0,deny,146,146,0,1,0,1,0
64396,53,52154,53,allow,349,91,258,2,30,1,1
56296,53,37666,53,allow,216,110,106,2,30,1,1
49891,443,42695,443,allow,8211,3683,4528,27,623,14,13
14993,50584,0,0,deny,62,62,0,1,0,1,0
57243,53,28936,53,allow,168,78,90,2,30,1,1
52094,22114,0,0,deny,146,146,0,1,0,1,0
65478,443,30120,443,allow,92279,4799,87480,107,16,43,64
1323,64147,0,0,deny,66,66,0,1,0,1,0
53437,6057,55735,6057,allow,245,245,0,2,30,2,0
56809,53,9821,53,allow,167,86,81,2,30,1,1
59781,56205,0,0,deny,66,66,0,1,0,1,0
55046,80,55074,80,allow,1056,682,374,10,16,6,4
63065,445,0,0,drop,66,66,0,1,0,1,0
56932,80,33047,80,allow,8325,5642,2683,16,28,9,7
55454,53,34563,53,allow,321,105,216,4,40,2,2
9394,51505,0,0,deny,62,62,0,1,0,1,0
51996,57470,0,0,deny,66,66,0,1,0,1,0
64039,445,0,0,drop,66,66,0,1,0,1,0
46271,7700,56460,7700,allow,1440,956,484,15,36,8,7
39540,80,37629,80,allow,130,70,60,2,15,1,1
49418,27018,39364,27018,allow,247,78,169,2,30,1,1
52401,445,0,0,drop,70,70,0,1,0,1,0
60849,443,12589,443,allow,3364,1737,1627,15,360,8,7
58245,445,0,0,drop,70,70,0,1,0,1,0
56893,53,50861,53,allow,177,94,83,2,30,1,1
50507,445,0,0,drop,70,70,0,1,0,1,0
55622,53,55622,53,allow,235,98,137,2,30,1,1
55792,53,52460,53,allow,199,102,97,2,29,1,1
13413,44847,0,0,deny,66,66,0,1,0,1,0
63904,18268,47003,18268,allow,66,66,0,2,7,2,0
53676,35974,0,0,deny,60,60,0,1,0,1,0
55665,445,0,0,drop,70,70,0,1,0,1,0
33801,62413,0,0,deny,66,66,0,1,0,1,0
57792,53,57792,53,allow,215,87,128,2,31,1,1
5497,53,2342,53,allow,208,78,130,2,30,1,1
52869,445,0,0,drop,70,70,0,1,0,1,0
52828,445,0,0,drop,70,70,0,1,0,1,0
49285,53,48057,53,allow,168,78,90,2,30,1,1
41101,443,39031,443,allow,7067,2430,4637,18,17,8,10
61146,445,0,0,drop,70,70,0,1,0,1,0
57342,80,40590,80,allow,1056,682,374,10,15,6,4
27005,29999,22693,29999,allow,876,126,750,2,31,1,1
27005,1103,52058,1103,allow,822,126,696,2,29,1,1
54988,443,63071,443,allow,69664,6958,62706,98,23,46,52
50139,443,27090,443,allow,72523,5814,66709,125,255,61,64
0,0,0,0,deny,98,98,0,1,0,1,0
51807,10920,61477,10920,allow,70,70,0,1,5,1,0
55248,445,0,0,drop,70,70,0,1,0,1,0
55396,26467,0,0,deny,62,62,0,1,0,1,0
65445,53,5000,53,allow,718,94,624,2,30,1,1
40512,57470,0,0,deny,74,74,0,1,0,1,0
49563,53,57038,53,allow,199,94,105,2,29,1,1
61523,37807,0,0,deny,66,66,0,1,0,1,0
53266,443,13911,443,allow,12822,4426,8396,42,18,24,18
58638,5900,0,0,deny,62,62,0,1,0,1,0
49446,443,57880,443,allow,1280822,27768,1253054,1241,40,365,876
19875,30170,0,0,deny,145,145,0,1,0,1,0
23900,64147,0,0,deny,62,62,0,1,0,1,0
54700,445,0,0,drop,66,66,0,1,0,1,0
52142,54954,50454,54954,allow,70,70,0,2,8,2,0
53167,22083,32129,22083,allow,70,70,0,1,4,1,0
58396,80,29243,80,allow,1088,599,489,13,315,7,6
55113,53,29716,53,allow,196,100,96,2,31,1,1
63009,443,26712,443,allow,304,86,218,2,29,1,1
21892,15503,0,0,deny,62,62,0,1,0,1,0
58994,443,40125,443,allow,4989,1014,3975,16,27,9,7
64603,53,6564,53,allow,258,102,156,2,30,1,1
54731,445,0,0,drop,66,66,0,1,0,1,0
57154,445,0,0,drop,70,70,0,1,0,1,0
51295,80,40456,80,allow,6702,5879,823,19,135,10,9
14165,51050,0,0,deny,146,146,0,1,0,1,0
49418,27016,3773,27016,allow,242,78,164,2,30,1,1
63943,53,44134,53,allow,196,94,102,2,30,1,1
53748,445,0,0,drop,70,70,0,1,0,1,0
63208,445,0,0,drop,66,66,0,1,0,1,0
49388,445,0,0,drop,70,70,0,1,0,1,0
56837,445,0,0,drop,66,66,0,1,0,1,0
43539,53,26606,53,allow,168,78,90,2,30,1,1
49951,80,49951,80,allow,24361943,451235,23910708,22804,63,6533,16271
50266,443,41683,443,allow,49981,15486,34495,269,138,136,133
53563,35440,0,0,deny,66,66,0,1,0,1,0
50441,80,50441,80,allow,79227,5480,73747,89,19,32,57
51903,26467,0,0,deny,62,62,0,1,0,1,0
54269,53,35881,53,allow,86,86,0,1,30,1,0
59399,445,0,0,drop,66,66,0,1,0,1,0
6881,55085,23823,55085,allow,509,150,359,2,1199,1,1
59068,49813,0,0,deny,74,74,0,1,0,1,0
57307,53,57558,53,allow,170,87,83,2,31,1,1
51985,445,0,0,drop,70,70,0,1,0,1,0
49718,443,50184,443,allow,7644833,215496,7429337,8664,135,2509,6155
56719,53,59269,53,allow,185,102,83,2,30,1,1
51596,445,0,0,drop,70,70,0,1,0,1,0
38629,25174,0,0,deny,62,62,0,1,0,1,0
53560,443,34440,443,allow,10823,1626,9197,27,28,15,12
55896,53,31620,53,allow,168,86,82,2,30,1,1
57867,27019,27516,27019,allow,468,390,78,5,30,4,1
54234,443,2984,443,allow,499,425,74,4,0,3,1
55154,445,0,0,drop,70,70,0,1,0,1,0
57470,51413,34007,51413,allow,460,150,310,2,1199,1,1
56423,443,49453,443,allow,6294,1494,4800,22,17,11,11
56527,445,0,0,drop,70,70,0,1,0,1,0
53878,55950,58060,55950,allow,70,70,0,2,8,2,0
65189,28515,39536,28515,allow,266,78,188,2,30,1,1
55706,443,29687,443,allow,5259,1203,4056,19,41,10,9
33896,57470,0,0,deny,74,74,0,1,0,1,0
43412,80,13841,80,allow,78,78,0,1,4,1,0
37319,443,50657,443,allow,70,70,0,1,5,1,0
20743,23,0,0,deny,60,60,0,1,0,1,0
50951,445,0,0,drop,70,70,0,1,0,1,0
23475,25174,0,0,deny,146,146,0,1,0,1,0
52459,33899,52459,33899,allow,66,66,0,1,5,1,0
64485,445,0,0,drop,70,70,0,1,0,1,0
58113,445,0,0,drop,70,70,0,1,0,1,0
62595,445,0,0,drop,70,70,0,1,0,1,0
55095,53,28399,53,allow,194,102,92,2,30,1,1
44889,443,7395,443,allow,9982,2062,7920,37,120,19,18
64722,443,16301,443,allow,61890,2830,59060,73,120,27,46
58170,443,59368,443,allow,12391,6068,6323,52,133,24,28
51171,445,0,0,drop,70,70,0,1,0,1,0
52412,443,22141,443,allow,11565,5557,6008,52,16,27,25
53093,445,0,0,drop,66,66,0,1,0,1,0
52726,56205,0,0,deny,66,66,0,1,0,1,0
56385,445,0,0,drop,70,70,0,1,0,1,0
50820,80,16954,80,allow,550,476,74,6,15,5,1
56920,53,48525,53,allow,184,78,106,2,30,1,1
57500,23,0,0,deny,60,60,0,1,0,1,0
19455,25174,0,0,deny,146,146,0,1,0,1,0
56834,53,36228,53,allow,172,88,84,2,30,1,1
49568,445,0,0,drop,70,70,0,1,0,1,0
39583,37965,0,0,deny,66,66,0,1,0,1,0
26085,51221,0,0,deny,72,72,0,1,0,1,0
59317,445,0,0,drop,70,70,0,1,0,1,0
45414,80,30413,80,allow,2873,753,2120,12,15,7,5
57002,80,6505,80,allow,214,140,74,4,35,3,1
44127,30188,0,0,deny,146,146,0,1,0,1,0
2076,7000,2076,7000,allow,5194,3739,1455,18,15,10,8
46516,57470,0,0,deny,62,62,0,1,0,1,0
61465,445,0,0,drop,66,66,0,1,0,1,0
45540,8100,64668,8100,allow,78,78,0,1,4,1,0
17489,50584,0,0,deny,146,146,0,1,0,1,0
54021,25174,0,0,deny,62,62,0,1,0,1,0
50358,445,0,0,drop,66,66,0,1,0,1,0
58638,5900,0,0,deny,62,62,0,1,0,1,0
58455,445,0,0,drop,66,66,0,1,0,1,0
50584,61867,27152,61867,allow,166,166,0,1,1200,1,0
50147,443,13714,443,allow,9915,1833,8082,22,46,13,9
6881,45378,0,0,deny,146,146,0,1,0,1,0
123,123,26903,123,allow,826,376,450,10,34,5,5
54336,443,1774,443,allow,172701,6397,166304,202,246,72,130
58386,443,54159,443,allow,17470103,920642,16549461,18410,181,6438,11972
27005,27015,62179,27015,allow,889,126,763,2,30,1,1
52989,51505,0,0,deny,66,66,0,1,0,1,0
57188,8525,57188,8525,allow,138,78,60,2,6,1,1
54388,445,0,0,drop,70,70,0,1,0,1,0
45619,80,13038,80,allow,1052,612,440,10,15,5,5
54314,53,25378,53,allow,284,79,205,2,30,1,1
52282,37965,0,0,deny,66,66,0,1,0,1,0
49349,53,29426,53,allow,182,93,89,2,31,1,1
34671,53,40615,53,allow,168,78,90,2,30,1,1
18194,53,18194,53,allow,225,87,138,2,31,1,1
57096,53,50734,53,allow,177,94,83,2,29,1,1
55454,53,60200,53,allow,202,103,99,2,31,1,1
54491,445,0,0,drop,70,70,0,1,0,1,0
30960,45751,20805,45751,allow,66,66,0,1,3600,1,0
64403,53,33316,53,allow,193,102,91,2,30,1,1
60644,5222,7350,5222,allow,9852,2665,7187,60,360,25,35
64550,53,62266,53,allow,221,94,127,2,29,1,1
58718,443,59357,443,allow,1129,599,530,12,25,6,6
56613,443,45386,443,allow,4378,1140,3238,14,26,9,5
63320,445,0,0,drop,70,70,0,1,0,1,0
10319,42707,0,0,deny,62,62,0,1,0,1,0
56858,32330,62382,32330,allow,70,70,0,2,8,2,0
64785,80,45125,80,allow,2107,1131,976,13,97,7,6
56273,53,59580,53,allow,182,93,89,2,30,1,1
43906,443,43906,443,allow,4792,2767,2025,38,255,20,18
54339,445,0,0,drop,70,70,0,1,0,1,0
52092,80,44323,80,allow,426,240,186,8,25,5,3
60762,40010,40997,40010,allow,316,136,180,6,6,3,3
17004,64147,0,0,deny,66,66,0,1,0,1,0
18088,23,0,0,deny,60,60,0,1,0,1,0
49967,53,25418,53,allow,193,102,91,2,31,1,1
52361,443,27364,443,allow,7488,2474,5014,23,3600,12,11
49196,25174,0,0,deny,66,66,0,1,0,1,0
56739,80,48782,80,allow,1462,703,759,8,16,5,3
50031,53,36003,53,allow,386,134,252,2,30,1,1
61518,445,0,0,drop,66,66,0,1,0,1,0
59356,445,0,0,drop,70,70,0,1,0,1,0
15641,26467,0,0,deny,62,62,0,1,0,1,0
55673,53,34197,53,allow,179,94,85,2,31,1,1
64117,53,35902,53,allow,350,94,256,2,29,1,1
65194,53,28428,53,allow,196,94,102,2,29,1,1
49509,53,2190,53,allow,339,110,229,2,30,1,1
63654,443,35757,443,allow,9152483,314975,8837508,9599,206,3195,6404
49317,53,16697,53,allow,166,86,80,2,31,1,1
64257,445,0,0,drop,70,70,0,1,0,1,0
2918,37965,0,0,deny,62,62,0,1,0,1,0
65507,53,7082,53,allow,229,102,127,2,30,1,1
64698,53,15508,53,allow,763,102,661,2,30,1,1
51960,443,28367,443,allow,2648,1797,851,19,23,11,8
24127,56205,0,0,deny,66,66,0,1,0,1,0
3478,61463,0,0,deny,1305,1305,0,1,0,1,0
11574,51505,0,0,deny,62,62,0,1,0,1,0
51914,445,0,0,drop,70,70,0,1,0,1,0
50603,80,50603,80,allow,1706,1006,700,11,21,6,5
50460,445,0,0,drop,70,70,0,1,0,1,0
59949,44847,0,0,deny,66,66,0,1,0,1,0
53817,443,41947,443,allow,499,425,74,4,0,3,1
63666,445,0,0,drop,66,66,0,1,0,1,0
50827,445,0,0,drop,70,70,0,1,0,1,0
57884,443,2033,443,allow,3981,1811,2170,26,177,14,12
63151,445,0,0,drop,70,70,0,1,0,1,0
54525,443,38089,443,allow,3766,1654,2112,10,120,5,5
60948,445,0,0,drop,70,70,0,1,0,1,0
63966,445,0,0,drop,70,70,0,1,0,1,0
57054,80,1820,80,allow,25138,16043,9095,79,2410,53,26
50281,53,4430,53,allow,767,102,665,2,30,1,1
49418,27016,5778,27016,allow,263,78,185,2,29,1,1
52157,23002,39596,23002,allow,70,70,0,2,7,2,0
37582,443,52781,443,allow,499,425,74,4,0,3,1
55392,445,0,0,drop,70,70,0,1,0,1,0
50530,445,0,0,drop,70,70,0,1,0,1,0
63301,445,0,0,drop,70,70,0,1,0,1,0
57031,445,0,0,drop,70,70,0,1,0,1,0
49384,53,17338,53,allow,181,94,87,2,31,1,1
60677,445,0,0,drop,70,70,0,1,0,1,0
49869,80,37142,80,allow,2125,1041,1084,11,87,6,5
53692,445,0,0,drop,66,66,0,1,0,1,0
63994,47013,15711,47013,allow,70,70,0,1,4,1,0
16013,35253,0,0,deny,66,66,0,1,0,1,0
55736,53,0,0,allow,623,70,553,2,30,1,1
44116,123,64380,123,allow,184,94,90,2,30,1,1
54959,53,14757,53,allow,211,110,101,2,30,1,1
50393,80,25546,80,allow,366,180,186,7,26,4,3
64999,27034,10678,27034,allow,735,462,273,2,29,1,1
56572,443,48876,443,allow,10325,2594,7731,28,27,16,12
55628,53,3702,53,allow,198,102,96,2,30,1,1
41502,443,22197,443,allow,1053,566,487,10,48,6,4
57015,80,24329,80,allow,214,140,74,4,31,3,1
30496,57470,0,0,deny,62,62,0,1,0,1,0
59411,37965,0,0,deny,66,66,0,1,0,1,0
58591,445,0,0,drop,70,70,0,1,0,1,0
53887,6881,31498,6881,allow,552,306,246,9,15,5,4
55688,53,48185,53,allow,183,94,89,2,31,1,1
60188,15503,0,0,deny,66,66,0,1,0,1,0
50169,25174,0,0,deny,62,62,0,1,0,1,0
56474,445,0,0,drop,70,70,0,1,0,1,0
443,45940,0,0,deny,85,85,0,1,0,1,0
54219,443,4628,443,allow,499,425,74,4,0,3,1
1025,35447,0,0,deny,62,62,0,1,0,1,0
6666,8888,0,0,deny,60,60,0,1,0,1,0
50065,44847,0,0,deny,62,62,0,1,0,1,0
65349,445,0,0,drop,70,70,0,1,0,1,0
38755,22114,0,0,deny,66,66,0,1,0,1,0
55004,443,35617,443,allow,27629,9041,18588,88,271,46,42
56533,443,15782,443,allow,306579,19447,287132,335,105,129,206
52821,445,0,0,drop,70,70,0,1,0,1,0
58021,17,0,0,deny,60,60,0,1,0,1,0
65368,445,0,0,drop,70,70,0,1,0,1,0
55293,445,0,0,drop,66,66,0,1,0,1,0
39224,53,62138,53,allow,168,78,90,2,29,1,1
46140,443,48726,443,allow,172,172,0,2,5,2,0
51652,80,52729,80,allow,32942,2548,30394,58,255,28,30
45964,3111,0,0,deny,60,60,0,1,0,1,0
28385,50584,0,0,deny,62,62,0,1,0,1,0
42438,443,37580,443,allow,7747,1737,6010,27,316,13,14
60184,37965,0,0,deny,66,66,0,1,0,1,0
57028,53,32039,53,allow,776,102,674,2,31,1,1
53328,53,0,0,allow,418,154,264,4,33,2,2
58564,445,0,0,drop,66,66,0,1,0,1,0
53626,33194,41822,33194,allow,70,70,0,2,7,2,0
58395,53,61283,53,allow,307,86,221,2,30,1,1
55367,443,46972,443,allow,101466,17775,83691,225,74,112,113
55090,53,59676,53,allow,196,102,94,2,29,1,1
37658,16385,25619,16385,allow,130,70,60,2,30,1,1
23763,23,0,0,deny,60,60,0,1,0,1,0
54091,445,0,0,drop,66,66,0,1,0,1,0
51965,80,35850,80,allow,106904,5958,100946,139,66,62,77
60163,445,0,0,drop,70,70,0,1,0,1,0
52453,445,0,0,drop,66,66,0,1,0,1,0
59977,443,64573,443,allow,7971,2647,5324,38,15,24,14
59685,445,0,0,drop,70,70,0,1,0,1,0
61766,44847,0,0,deny,66,66,0,1,0,1,0
64986,53,51778,53,allow,734,94,640,2,29,1,1
61154,445,0,0,drop,66,66,0,1,0,1,0
50469,443,24709,443,allow,3049,1569,1480,17,19,10,7
60374,445,0,0,drop,70,70,0,1,0,1,0
51166,445,0,0,drop,66,66,0,1,0,1,0
18577,25174,0,0,deny,62,62,0,1,0,1,0
58825,44847,0,0,deny,146,146,0,1,0,1,0
53674,31724,6450,31724,allow,70,70,0,1,4,1,0
58851,445,0,0,drop,70,70,0,1,0,1,0
13178,37965,0,0,deny,62,62,0,1,0,1,0
52075,37919,16771,37919,allow,70,70,0,1,4,1,0
60012,443,29771,443,allow,6438,2599,3839,21,144,10,11
54051,28793,0,0,deny,66,66,0,1,0,1,0
34531,80,18192,80,allow,467664,17895,449769,610,355,265,345
34670,53,34670,53,allow,257,106,151,2,30,1,1
63974,53,33864,53,allow,618,111,507,4,30,2,2
5924,53,5924,53,allow,220,90,130,2,30,1,1
53096,445,0,0,drop,66,66,0,1,0,1,0
51869,25355,56016,25355,allow,70,70,0,1,5,1,0
9518,57587,0,0,deny,100,100,0,1,0,1,0
58638,5900,0,0,deny,62,62,0,1,0,1,0
41322,443,7553,443,allow,153,93,60,2,5,1,1
17052,53,17052,53,allow,235,90,145,2,32,1,1
27563,443,27563,443,allow,1181,722,459,10,147,6,4
10532,26672,0,0,deny,60,60,0,1,0,1,0
41885,25174,0,0,deny,62,62,0,1,0,1,0
52801,443,38731,443,allow,8308,3201,5107,36,1401,19,17
2849,30188,0,0,deny,66,66,0,1,0,1,0
59934,35440,0,0,deny,62,62,0,1,0,1,0
54813,443,48795,443,allow,1633,819,814,16,40,8,8
58638,5900,0,0,deny,62,62,0,1,0,1,0
57196,53,25390,53,allow,183,94,89,2,30,1,1
61903,445,0,0,drop,66,66,0,1,0,1,0
56951,53,25030,53,allow,168,86,82,2,29,1,1
30598,46824,0,0,deny,62,62,0,1,0,1,0
55912,53,4881,53,allow,199,102,97,2,31,1,1
57159,53,30985,53,allow,292,94,198,2,30,1,1
55932,53,16236,53,allow,202,103,99,2,31,1,1
53609,38060,54791,38060,allow,70,70,0,1,5,1,0
55072,53,45639,53,allow,170,87,83,2,31,1,1
49418,27054,42342,27054,allow,272,78,194,2,30,1,1
51798,443,51798,443,allow,14904,6448,8456,33,30,18,15
62774,445,0,0,drop,70,70,0,1,0,1,0
51754,445,0,0,drop,70,70,0,1,0,1,0
49334,53,34104,53,allow,194,102,92,2,30,1,1
23310,22114,0,0,deny,66,66,0,1,0,1,0
60843,445,0,0,drop,70,70,0,1,0,1,0
64416,445,0,0,drop,70,70,0,1,0,1,0
60754,40010,30483,40010,allow,316,136,180,6,6,3,3
52233,80,14705,80,allow,1674,708,966,18,392,6,12
64279,53,29219,53,allow,177,94,83,2,29,1,1
65365,53,10909,53,allow,196,102,94,2,29,1,1
45174,443,32047,443,allow,6196,1417,4779,21,665,11,10
64249,53,32881,53,allow,181,94,87,2,30,1,1
51604,443,33369,443,allow,19611,6865,12746,46,37,24,22
0,0,0,0,allow,124,64,60,2,0,1,1
62468,445,0,0,drop,70,70,0,1,0,1,0
56227,53,8068,53,allow,188,96,92,2,30,1,1
52313,443,33219,443,allow,52235,4973,47262,81,179,39,42
22856,22114,0,0,deny,66,66,0,1,0,1,0
51221,32329,23850,32329,allow,870,330,540,12,1316,6,6
54455,445,0,0,drop,70,70,0,1,0,1,0
37837,37965,0,0,deny,62,62,0,1,0,1,0
48839,37807,0,0,deny,62,62,0,1,0,1,0
56725,443,10503,443,allow,7889,1900,5989,20,15,11,9
55489,445,0,0,drop,66,66,0,1,0,1,0
50420,80,36435,80,allow,5048,4344,704,11,26,6,5
55228,445,0,0,drop,70,70,0,1,0,1,0
54742,50584,0,0,deny,66,66,0,1,0,1,0
50222,445,0,0,drop,70,70,0,1,0,1,0
49621,80,15641,80,allow,318,192,126,6,42,4,2
49452,445,0,0,drop,70,70,0,1,0,1,0
56719,80,46763,80,allow,1462,703,759,8,16,5,3
55587,32217,8141,32217,allow,320,140,180,6,6,3,3
49206,12242,47287,12242,allow,70,70,0,1,5,1,0
55348,53,14185,53,allow,332,94,238,2,29,1,1
50614,445,0,0,drop,66,66,0,1,0,1,0
37567,443,42814,443,allow,214,140,74,4,15,3,1
60029,443,40871,443,allow,1057,590,467,11,142,6,5
54979,53,30018,53,allow,207,97,110,3,64,2,1
56559,443,41687,443,allow,2723,1564,1159,15,17,9,6
39776,443,45893,443,allow,6283,1439,4844,25,316,13,12
50993,445,0,0,drop,66,66,0,1,0,1,0
61643,22114,0,0,deny,62,62,0,1,0,1,0
57143,53,42791,53,allow,184,94,90,2,30,1,1
51974,443,51489,443,allow,11486,5080,6406,24,121,12,12
56941,53,56687,53,allow,193,102,91,2,30,1,1
55154,53,33060,53,allow,184,94,90,2,30,1,1
57331,53,27996,53,allow,164,86,78,2,30,1,1
54464,56205,0,0,deny,62,62,0,1,0,1,0
52000,10491,3122,10491,allow,70,70,0,2,8,2,0
64279,23718,0,0,deny,146,146,0,1,0,1,0
37082,443,41934,443,allow,2419,1461,958,18,170,10,8
65328,53,29572,53,allow,182,102,80,2,31,1,1
56440,56205,0,0,deny,62,62,0,1,0,1,0
58021,22114,0,0,deny,62,62,0,1,0,1,0
52250,443,52250,443,allow,162355,8745,153610,178,22,66,112
52713,443,22767,443,allow,26235,2216,24019,39,318,17,22
64528,53,42814,53,allow,353,118,235,2,30,1,1
6889,60888,0,0,deny,139,139,0,1,0,1,0
54194,443,38493,443,allow,195229,13204,182025,270,124,102,168
58638,5900,0,0,deny,62,62,0,1,0,1,0
49706,80,39061,80,allow,118813,4128,114685,122,108,38,84
1048,25174,0,0,deny,62,62,0,1,0,1,0
64932,445,0,0,drop,70,70,0,1,0,1,0
58638,5900,0,0,deny,62,62,0,1,0,1,0
57029,53,63160,53,allow,246,94,152,2,30,1,1
64886,53,27053,53,allow,295,101,194,4,31,2,2
63148,445,0,0,drop,70,70,0,1,0,1,0
54016,42707,0,0,deny,66,66,0,1,0,1,0
50411,8080,50411,8080,allow,1626,798,828,11,61,6,5
55722,445,0,0,drop,70,70,0,1,0,1,0
50936,445,0,0,drop,66,66,0,1,0,1,0
48817,51634,48817,51634,allow,480,149,331,2,1200,1,1
64283,53,44589,53,allow,193,102,91,2,29,1,1
55526,80,37218,80,allow,78,78,0,2,8,2,0
52916,80,53748,80,allow,4266,1776,2490,20,367,11,9
6881,6881,38605,6881,allow,502,150,352,2,1199,1,1
57994,30188,0,0,deny,62,62,0,1,0,1,0
64856,445,0,0,drop,66,66,0,1,0,1,0
49690,53,14782,53,allow,790,110,680,2,29,1,1
60932,445,0,0,drop,70,70,0,1,0,1,0
60430,51413,49908,51413,allow,70,70,0,1,5,1,0
53741,445,0,0,drop,70,70,0,1,0,1,0
55792,53,55035,53,allow,199,102,97,2,30,1,1
49885,445,0,0,drop,70,70,0,1,0,1,0
55024,445,0,0,drop,70,70,0,1,0,1,0
45602,443,17240,443,allow,4417,3084,1333,17,361,9,8
56965,53,44831,53,allow,183,94,89,2,30,1,1
56800,445,0,0,drop,70,70,0,1,0,1,0
55193,53,2306,53,allow,177,94,83,2,30,1,1
59409,443,2486,443,allow,7775,3174,4601,25,16,11,14
64191,443,64191,443,allow,18608,1844,16764,31,16,16,15
50166,53,40117,53,allow,211,78,133,2,30,1,1
64600,445,0,0,drop,70,70,0,1,0,1,0
57967,445,0,0,drop,70,70,0,1,0,1,0
57418,53,1554,53,allow,165,86,79,2,31,1,1
49683,53,44598,53,allow,262,94,168,2,29,1,1
1480,12447,0,0,deny,62,62,0,1,0,1,0
49351,53,13338,53,allow,166,86,80,2,30,1,1
19632,37965,0,0,deny,62,62,0,1,0,1,0
58812,443,22392,443,allow,5167,700,4467,16,15,7,9
52118,33515,33825,33515,allow,70,70,0,1,5,1,0
64027,53,2870,53,allow,360,97,263,4,38,2,2
56276,443,23651,443,allow,154,94,60,2,4,1,1
52057,34664,13510,34664,allow,70,70,0,2,8,2,0
51245,443,54725,443,allow,9847,4746,5101,43,16,24,19
56655,443,7969,443,allow,1272,876,396,10,26,6,4
56000,53,18353,53,allow,177,94,83,2,29,1,1
50826,445,0,0,drop,70,70,0,1,0,1,0
58638,5900,0,0,deny,62,62,0,1,0,1,0
50031,53,6210,53,allow,181,94,87,2,30,1,1
52629,53,0,0,allow,232,77,155,2,33,1,1
63974,445,0,0,drop,70,70,0,1,0,1,0
50458,80,53639,80,allow,1426,865,561,9,15,5,4
53692,445,0,0,drop,70,70,0,1,0,1,0
26408,64147,0,0,deny,66,66,0,1,0,1,0
52513,80,64881,80,allow,39793,2026,37767,55,16,27,28
27005,33051,7331,33051,allow,887,126,761,2,31,1,1
60911,443,41186,443,allow,3862,2679,1183,28,46,15,13
55495,53,27673,53,allow,210,110,100,2,30,1,1
55077,53,42307,53,allow,179,94,85,2,30,1,1
2541,51505,0,0,deny,62,62,0,1,0,1,0
55387,445,0,0,drop,70,70,0,1,0,1,0
65432,53,2736,53,allow,254,94,160,2,30,1,1
62575,445,0,0,drop,70,70,0,1,0,1,0
33825,443,41237,443,allow,9407,2233,7174,38,96,16,22
55614,445,0,0,drop,66,66,0,1,0,1,0
30111,2323,0,0,deny,60,60,0,1,0,1,0
59424,445,0,0,drop,70,70,0,1,0,1,0
41868,443,44888,443,allow,6204,1328,4876,21,139,12,9
61041,53,61041,53,allow,214,90,124,2,29,1,1
58247,445,0,0,drop,66,66,0,1,0,1,0
51414,22,0,0,deny,60,60,0,1,0,1,0
57307,443,21158,443,allow,8407,3013,5394,43,15,24,19
50522,443,6531,443,allow,1579,988,591,13,45,7,6
57362,53,9411,53,allow,346,102,244,2,31,1,1
56288,53,47353,53,allow,200,102,98,2,30,1,1
63975,445,0,0,drop,70,70,0,1,0,1,0
61336,445,0,0,drop,70,70,0,1,0,1,0
61405,445,0,0,drop,70,70,0,1,0,1,0
52859,53,16412,53,allow,164,78,86,2,30,1,1
57496,25174,0,0,deny,66,66,0,1,0,1,0
53868,53,38630,53,allow,164,78,86,2,30,1,1
50477,443,26806,443,allow,55388,4069,51319,94,240,46,48
59857,443,40076,443,allow,2118,1093,1025,22,44,9,13
61170,445,0,0,drop,70,70,0,1,0,1,0
60259,443,51277,443,allow,3285,2009,1276,26,150,16,10
57664,445,0,0,drop,70,70,0,1,0,1,0
64811,53,63660,53,allow,446,93,353,4,55,2,2
3730,17372,0,0,deny,62,62,0,1,0,1,0
59453,445,0,0,drop,70,70,0,1,0,1,0
50174,445,0,0,drop,66,66,0,1,0,1,0
64735,445,0,0,drop,70,70,0,1,0,1,0
36151,443,3051,443,allow,22856,2980,19876,43,116,19,24
56103,21247,0,0,deny,66,66,0,1,0,1,0
49310,53,42489,53,allow,816,102,714,2,30,1,1
50622,53,42098,53,allow,202,83,119,2,30,1,1
52726,56205,0,0,deny,62,62,0,1,0,1,0
57820,32753,0,0,deny,361,361,0,1,0,1,0
56754,53,26868,53,allow,182,93,89,2,31,1,1
56934,53,42274,53,allow,216,110,106,2,31,1,1
44059,443,60027,443,allow,9730,1613,8117,24,170,11,13
53243,443,50839,443,allow,242426,7999,234427,277,70,100,177
56790,53,5516,53,allow,747,92,655,2,31,1,1
53771,64351,48425,64351,allow,70,70,0,1,5,1,0
65015,22114,0,0,deny,66,66,0,1,0,1,0
15235,36237,0,0,deny,62,62,0,1,0,1,0
55256,443,41393,443,allow,3524,2973,551,15,16,9,6
49367,53,52320,53,allow,718,94,624,2,30,1,1
23531,31573,0,0,deny,146,146,0,1,0,1,0
40749,5222,28403,5222,allow,3474,915,2559,34,685,10,24
56501,53,62547,53,allow,711,87,624,2,31,1,1
56260,53,19443,53,allow,177,94,83,2,30,1,1
56765,53,6433,53,allow,194,102,92,2,30,1,1
56558,443,2694,443,allow,7702,2155,5547,19,39,11,8
17453,35440,0,0,deny,62,62,0,1,0,1,0
50563,53,11644,53,allow,718,94,624,2,30,1,1
50209,53,30899,53,allow,749,94,655,2,30,1,1
15981,23117,0,0,deny,146,146,0,1,0,1,0
27528,35440,0,0,deny,66,66,0,1,0,1,0
27393,53,7301,53,allow,168,78,90,2,30,1,1
55773,53,51846,53,allow,102,102,0,1,60,1,0
64174,53,11186,53,allow,180,94,86,2,31,1,1
53916,23505,33630,23505,allow,70,70,0,2,7,2,0
61326,445,0,0,deny,70,70,0,1,0,1,0
49864,443,13446,443,allow,5930,910,5020,18,56,9,9
34495,80,62171,80,allow,1026,417,609,7,19,5,2
62812,445,0,0,drop,70,70,0,1,0,1,0
48817,6881,48817,6881,allow,494,152,342,2,1200,1,1
60909,445,0,0,drop,70,70,0,1,0,1,0
51773,80,63744,80,allow,40993,2984,38009,57,24,28,29
65238,53,22542,53,allow,168,86,82,2,29,1,1
58634,445,0,0,drop,70,70,0,1,0,1,0
55484,25174,0,0,deny,62,62,0,1,0,1,0
55033,53,44325,53,allow,182,94,88,2,30,1,1
64567,53,38980,53,allow,199,102,97,2,30,1,1
51804,53,51804,53,allow,247,98,149,2,33,1,1
61533,445,0,0,drop,70,70,0,1,0,1,0
443,11266,0,0,deny,124,124,0,1,0,1,0
51875,443,48033,443,allow,1852,1103,749,16,31,9,7
55223,53,54493,53,allow,168,86,82,2,31,1,1
57239,53,64762,53,allow,193,102,91,2,31,1,1
53240,443,16717,443,allow,1296713,27754,1268959,1253,118,366,887
31613,23,0,0,deny,60,60,0,1,0,1,0
64543,53,58923,53,allow,761,100,661,2,31,1,1
64314,53,48605,53,allow,264,110,154,2,30,1,1
55258,445,0,0,drop,70,70,0,1,0,1,0
52276,80,52276,80,allow,222010,7236,214774,216,28,66,150
50263,53,23939,53,allow,172,94,78,2,30,1,1
62838,44847,0,0,deny,66,66,0,1,0,1,0
65066,80,65066,80,allow,874843,22526,852317,878,44,304,574
53233,445,0,0,drop,70,70,0,1,0,1,0
55739,443,5145,443,allow,47102,3841,43261,59,121,25,34
37877,80,30834,80,allow,991,483,508,9,181,5,4
50802,443,32989,443,allow,207859,77557,130302,849,753,312,537
49651,37965,0,0,deny,74,74,0,1,0,1,0
43093,53,41079,53,allow,242,78,164,2,30,1,1
56387,445,0,0,drop,70,70,0,1,0,1,0
41282,53,19391,53,allow,168,78,90,2,30,1,1
2691,64147,0,0,deny,62,62,0,1,0,1,0
50326,53,27014,53,allow,720,94,626,2,31,1,1
40040,5223,48273,5223,allow,5386,1100,4286,27,686,10,17
64743,53,57022,53,allow,210,102,108,2,30,1,1
50124,443,10944,443,allow,48860,5749,43111,91,147,47,44
58883,443,6061,443,allow,5476,3102,2374,42,132,23,19
53895,36849,56387,36849,allow,70,70,0,2,7,2,0
50254,44847,0,0,deny,62,62,0,1,0,1,0
47013,44512,0,0,deny,62,62,0,1,0,1,0
56202,15503,0,0,deny,146,146,0,1,0,1,0
27005,27017,7063,27017,allow,877,126,751,3,31,2,1
56657,443,37201,443,allow,1342,918,424,10,25,6,4
49300,443,63188,443,allow,6101,848,5253,17,21,9,8
56416,53,14432,53,allow,193,102,91,2,30,1,1
443,51160,0,0,deny,102,102,0,1,0,1,0
10427,32480,0,0,deny,62,62,0,1,0,1,0
60044,445,0,0,drop,66,66,0,1,0,1,0
61340,445,0,0,drop,66,66,0,1,0,1,0
65239,53,46235,53,allow,198,101,97,2,31,1,1
50233,53,42089,53,allow,748,94,654,2,30,1,1
63474,48817,0,0,deny,66,66,0,1,0,1,0
50941,443,22406,443,allow,12831,2277,10554,37,145,17,20
43584,24748,0,0,deny,156,156,0,1,0,1,0
58776,443,11042,443,allow,7259,842,6417,27,290,9,18
48020,53,48020,53,allow,404,259,145,3,33,2,1
56195,53,54925,53,allow,811,94,717,2,30,1,1
59455,53,0,0,allow,221,81,140,2,31,1,1
64776,53,33019,53,allow,935,334,601,8,62,4,4
36022,443,7743,443,allow,7257,1619,5638,22,275,11,11
62796,37807,0,0,deny,66,66,0,1,0,1,0
62528,445,0,0,drop,70,70,0,1,0,1,0
54194,443,16208,443,allow,499,425,74,4,0,3,1
49705,443,51038,443,allow,156357,6403,149954,155,81,44,111
27005,32055,20958,32055,allow,878,126,752,2,31,1,1
1025,64147,0,0,deny,62,62,0,1,0,1,0
33894,80,31956,80,allow,1376,788,588,10,35,6,4
27005,27015,56487,27015,allow,892,126,766,2,30,1,1
51066,445,0,0,drop,66,66,0,1,0,1,0
56906,443,9378,443,allow,1712418,88847,1623571,2014,149,715,1299
34822,31573,0,0,deny,62,62,0,1,0,1,0
61508,445,0,0,drop,70,70,0,1,0,1,0
56752,443,27500,443,allow,11771,2624,9147,50,20,25,25
60113,22114,0,0,deny,66,66,0,1,0,1,0
59932,443,3310,443,allow,6065,1772,4293,27,1587,15,12
65319,53,30506,53,allow,285,103,182,4,44,2,2
52647,445,0,0,drop,66,66,0,1,0,1,0
12183,22114,0,0,deny,62,62,0,1,0,1,0
64005,26467,0,0,deny,66,66,0,1,0,1,0
60398,46776,0,0,deny,74,74,0,1,0,1,0
58945,443,49273,443,allow,5168,700,4468,16,15,7,9
41426,443,52242,443,allow,3396,1964,1432,16,361,8,8
50479,443,28335,443,allow,1654,1011,643,16,82,9,7
52227,64147,0,0,deny,66,66,0,1,0,1,0
58869,445,0,0,drop,70,70,0,1,0,1,0
44235,50265,0,0,deny,145,145,0,1,0,1,0
63711,47951,19949,47951,allow,70,70,0,1,4,1,0
50764,445,0,0,drop,66,66,0,1,0,1,0
51745,2572,3211,2572,allow,66,66,0,1,5,1,0
54743,443,47896,443,allow,166136,7244,158892,202,149,76,126
58501,445,0,0,drop,70,70,0,1,0,1,0
64767,51221,0,0,deny,62,62,0,1,0,1,0
43578,15503,0,0,deny,74,74,0,1,0,1,0
60574,445,0,0,drop,70,70,0,1,0,1,0
0,0,0,0,allow,320,320,0,5,0,5,0
55592,445,0,0,drop,70,70,0,1,0,1,0
64877,53,24531,53,allow,309,110,199,2,30,1,1
13179,57866,0,0,deny,62,62,0,1,0,1,0
53822,18716,19485,18716,allow,70,70,0,1,4,1,0
49713,53,20450,53,allow,821,102,719,2,30,1,1
57470,31373,26422,31373,allow,1386,1386,0,22,1798,22,0
51691,445,0,0,drop,70,70,0,1,0,1,0
50335,80,17897,80,allow,3855,828,3027,11,15,5,6
51175,443,19417,443,allow,2132473,55149,2077324,2144,63,731,1413
63116,22114,0,0,deny,62,62,0,1,0,1,0
51607,53,46424,53,allow,322,102,220,2,29,1,1
19156,3846,0,0,deny,145,145,0,1,0,1,0
50850,445,0,0,drop,66,66,0,1,0,1,0
53120,80,53120,80,allow,26927,1133,25794,36,15,16,20
57968,443,57498,443,allow,6254,1581,4673,21,190,12,9
43109,80,31634,80,allow,7607,3563,4044,18,20,9,9
50052,65008,0,0,deny,60,60,0,1,0,1,0
64054,53,33800,53,allow,183,94,89,2,31,1,1
64321,445,0,0,drop,66,66,0,1,0,1,0
62769,25174,0,0,deny,146,146,0,1,0,1,0
19875,30170,0,0,deny,145,145,0,1,0,1,0
60894,50584,0,0,deny,62,62,0,1,0,1,0
50915,53,63317,53,allow,168,78,90,2,30,1,1
58995,443,49054,443,allow,8826,2860,5966,21,9,10,11
57807,443,57807,443,allow,4434,1527,2907,19,29,11,8
49415,22114,0,0,deny,66,66,0,1,0,1,0
55544,445,0,0,drop,66,66,0,1,0,1,0
64915,53,33891,53,allow,170,87,83,2,31,1,1
58022,5560,0,0,deny,60,60,0,1,0,1,0
60914,53,60914,53,allow,180,82,98,2,29,1,1
56272,53,13597,53,allow,193,102,91,2,31,1,1
59282,123,52231,123,allow,184,94,90,2,30,1,1
18725,35440,0,0,deny,62,62,0,1,0,1,0
28897,35440,0,0,deny,66,66,0,1,0,1,0
52102,443,38740,443,allow,6903,3076,3827,20,136,10,10
35897,443,1439,443,allow,6692,1642,5050,24,275,11,13
60196,53,0,0,deny,88,88,0,1,0,1,0
40878,443,41466,443,allow,6517,1003,5514,22,360,11,11
49938,57470,0,0,deny,66,66,0,1,0,1,0
27176,53,64798,53,allow,396,257,139,3,30,2,1
58251,36237,0,0,deny,62,62,0,1,0,1,0
52827,25174,0,0,deny,62,62,0,1,0,1,0
53192,443,46060,443,allow,35788,2073,33715,54,21,20,34
27005,33084,40774,33084,allow,906,126,780,2,31,1,1
60955,445,0,0,drop,66,66,0,1,0,1,0
19747,37965,0,0,deny,62,62,0,1,0,1,0
49532,53,18389,53,allow,443,182,261,6,31,3,3
55182,445,0,0,drop,66,66,0,1,0,1,0
443,48346,0,0,deny,81,81,0,1,0,1,0
16387,57833,0,0,allow,60,60,0,1,60,1,0
57603,445,0,0,drop,70,70,0,1,0,1,0
62525,7080,62525,7080,allow,2960,432,2528,11,15,6,5
53758,445,0,0,drop,70,70,0,1,0,1,0
43098,443,63074,443,allow,3133,1883,1250,19,16,9,10
56845,443,17798,443,allow,16207,6355,9852,84,195,43,41
51184,445,0,0,drop,70,70,0,1,0,1,0
13090,36237,0,0,deny,62,62,0,1,0,1,0
64346,51505,0,0,deny,66,66,0,1,0,1,0
63913,445,0,0,drop,70,70,0,1,0,1,0
443,60496,0,0,deny,187,187,0,1,0,1,0
49337,53,52249,53,allow,199,102,97,2,30,1,1
49903,443,11070,443,allow,355761,14847,340914,423,33,183,240
24560,51050,0,0,deny,146,146,0,1,0,1,0
55616,445,0,0,drop,70,70,0,1,0,1,0
56946,53,14578,53,allow,732,89,643,2,31,1,1
55467,53,17631,53,allow,193,102,91,2,29,1,1
60899,25174,0,0,deny,66,66,0,1,0,1,0
55955,445,0,0,drop,66,66,0,1,0,1,0
39852,80,39852,80,allow,576,272,304,9,142,5,4
57938,443,57938,443,allow,27787,5566,22221,60,47,31,29
60793,53733,0,0,deny,66,66,0,1,0,1,0
65209,53,6472,53,allow,164,84,80,2,31,1,1
65359,53,29324,53,allow,186,95,91,2,30,1,1
44417,53,0,0,allow,82,82,0,2,40,2,0
58589,80,4699,80,allow,1360,900,460,10,515,6,4
65476,443,36901,443,allow,93073,4939,88134,111,16,45,66
59101,53,46129,53,allow,195,94,101,2,30,1,1
65075,53,3072,53,allow,278,100,178,4,31,2,2
57406,53,10288,53,allow,194,102,92,2,30,1,1
49372,53,57735,53,allow,210,110,100,2,30,1,1
7947,50584,0,0,deny,62,62,0,1,0,1,0
47722,80,12273,80,allow,1720,1406,314,10,15,5,5
51766,48169,62941,48169,allow,70,70,0,2,7,2,0
59155,39004,0,0,deny,74,74,0,1,0,1,0
29016,25174,0,0,deny,62,62,0,1,0,1,0
50879,80,6049,80,allow,15453,3281,12172,29,140,16,13
51878,443,1905,443,allow,7241,1972,5269,28,68,16,12
55188,445,0,0,drop,66,66,0,1,0,1,0
56624,53,13351,53,allow,198,101,97,2,31,1,1
57173,53,12903,53,allow,216,110,106,2,31,1,1
5228,3434,0,0,deny,1093,1093,0,1,0,1,0
47595,33439,0,0,allow,106,106,0,1,60,1,0
49854,80,32743,80,allow,14603,5117,9486,24,89,12,12
27005,33035,34801,33035,allow,864,126,738,2,31,1,1
50509,80,1536,80,allow,49872,11098,38774,65,24,27,38
59662,445,0,0,drop,70,70,0,1,0,1,0
32282,8604,0,0,deny,66,66,0,1,0,1,0
64245,53,47905,53,allow,199,102,97,2,30,1,1
50442,37807,0,0,deny,62,62,0,1,0,1,0
56126,53,59441,53,allow,336,110,226,2,29,1,1
60441,443,36416,443,allow,3211,1964,1247,25,263,13,12
56345,443,39296,443,allow,39990,1989,38001,50,147,17,33
26900,27017,63917,27017,allow,422,164,258,6,30,3,3
23770,50584,0,0,deny,66,66,0,1,0,1,0
6943,1,0,0,deny,100,100,0,1,0,1,0
55540,445,0,0,drop,70,70,0,1,0,1,0
62056,443,37684,443,allow,13784,6865,6919,38,47,21,17
27988,40013,46561,40013,allow,148,86,62,2,30,1,1
27005,32073,48886,32073,allow,884,126,758,2,31,1,1
6881,6881,0,0,deny,62,62,0,1,0,1,0
53798,443,32162,443,allow,499,425,74,4,0,3,1
53667,56205,0,0,deny,62,62,0,1,0,1,0
53233,51221,0,0,deny,66,66,0,1,0,1,0
58758,445,0,0,drop,66,66,0,1,0,1,0
52822,445,0,0,drop,70,70,0,1,0,1,0
56656,445,0,0,drop,66,66,0,1,0,1,0
50584,51413,31560,51413,allow,800,150,650,4,1200,2,2
25,55987,25,55987,allow,118,118,0,1,120,1,0
65381,445,0,0,drop,70,70,0,1,0,1,0
50280,57470,0,0,deny,78,78,0,1,0,1,0
60222,445,0,0,drop,70,70,0,1,0,1,0
55586,23,0,0,deny,60,60,0,1,0,1,0
49419,443,41592,443,allow,318,192,126,6,15,4,2
55484,53,28906,53,allow,711,87,624,2,30,1,1
45682,1,0,0,deny,62,62,0,1,0,1,0
50806,51505,0,0,deny,66,66,0,1,0,1,0
1262,23,0,0,deny,60,60,0,1,0,1,0
64037,53,2722,53,allow,215,94,121,2,29,1,1
55161,37807,0,0,deny,66,66,0,1,0,1,0
50393,53,2809,53,allow,759,94,665,2,29,1,1
54836,443,5754,443,allow,119863,100823,19040,322,229,183,139
54643,445,0,0,drop,70,70,0,1,0,1,0
57244,53,57244,53,allow,240,98,142,2,30,1,1
7000,23117,0,0,deny,62,62,0,1,0,1,0
49414,443,6061,443,allow,3427,2159,1268,20,17,11,9
57470,80,24424,80,allow,230,82,148,4,1199,2,2
57382,53,10173,53,allow,184,94,90,2,29,1,1
10467,25174,0,0,deny,62,62,0,1,0,1,0
48335,25174,0,0,deny,146,146,0,1,0,1,0
53766,51505,0,0,deny,66,66,0,1,0,1,0
49673,80,41313,80,allow,318,192,126,6,41,4,2
57131,8055,0,0,deny,145,145,0,1,0,1,0
50953,445,0,0,drop,66,66,0,1,0,1,0
57761,445,0,0,drop,70,70,0,1,0,1,0
55725,14704,2998,14704,allow,70,70,0,2,8,2,0
55015,445,0,0,drop,66,66,0,1,0,1,0
41836,23,0,0,deny,60,60,0,1,0,1,0
41164,443,62496,443,allow,8582,4759,3823,29,135,14,15
60770,40010,17084,40010,allow,316,136,180,6,6,3,3
55221,445,0,0,drop,70,70,0,1,0,1,0
64970,27055,4626,27055,allow,735,462,273,2,31,1,1
54679,445,0,0,drop,70,70,0,1,0,1,0
52720,35894,0,0,deny,62,62,0,1,0,1,0
51977,80,44699,80,allow,4305,699,3606,13,46,7,6
39839,443,5588,443,allow,5829,1408,4421,21,188,11,10
43155,35440,0,0,deny,62,62,0,1,0,1,0
62075,443,48853,443,allow,9318,3002,6316,28,46,16,12
52569,445,0,0,drop,70,70,0,1,0,1,0
55199,21247,0,0,deny,66,66,0,1,0,1,0
49404,53,23314,53,allow,200,94,106,2,30,1,1
55458,445,0,0,drop,70,70,0,1,0,1,0
56629,53,45116,53,allow,183,94,89,2,29,1,1
33459,80,37833,80,allow,1658,1344,314,10,14,5,5
53125,443,24442,443,allow,3358,1952,1406,16,360,8,8
35814,443,57995,443,allow,9126,3975,5151,21,15,11,10
30960,45703,22089,45703,allow,330,330,0,6,3609,6,0
52098,80,42506,80,allow,1955,913,1042,10,15,6,4
51124,445,0,0,drop,66,66,0,1,0,1,0
55620,53,48166,53,allow,177,94,83,2,30,1,1
42030,25,0,0,deny,74,74,0,1,0,1,0
56404,80,13755,80,allow,17376,1687,15689,28,40,12,16
21944,53,21944,53,allow,217,82,135,2,32,1,1
56308,53,17371,53,allow,814,110,704,2,30,1,1
56675,443,33305,443,allow,7941,1952,5989,20,15,11,9
59737,445,0,0,drop,70,70,0,1,0,1,0
50017,445,0,0,drop,70,70,0,1,0,1,0
56711,53,31656,53,allow,202,103,99,2,31,1,1
56809,53,56809,53,allow,404,259,145,3,33,2,1
56803,53,3207,53,allow,429,93,336,4,44,2,2
65179,53,52575,53,allow,184,94,90,2,30,1,1
10669,49756,0,0,deny,60,60,0,1,0,1,0
52264,445,0,0,drop,70,70,0,1,0,1,0
52961,443,6824,443,allow,925322,25097,900225,971,113,287,684
65062,445,0,0,drop,70,70,0,1,0,1,0
51448,80,39374,80,allow,214,140,74,4,15,3,1
40709,443,9964,443,allow,5565,1382,4183,22,158,11,11
57523,25174,0,0,deny,146,146,0,1,0,1,0
65414,53,10727,53,allow,197,102,95,2,31,1,1
32388,26467,0,0,deny,66,66,0,1,0,1,0
443,20550,0,0,deny,97,97,0,1,0,1,0
56202,15503,0,0,deny,146,146,0,1,0,1,0
55716,36989,39721,36989,allow,320,140,180,6,6,3,3
49301,443,34200,443,allow,7616,3064,4552,14,120,6,8
54578,64147,0,0,deny,66,66,0,1,0,1,0
54504,445,0,0,drop,66,66,0,1,0,1,0
52609,18081,52609,18081,allow,66,66,0,1,5,1,0
44173,53,9700,53,allow,168,78,90,2,30,1,1
41447,64147,0,0,deny,62,62,0,1,0,1,0
6886,45378,0,0,deny,139,139,0,1,0,1,0
50584,16453,1503,16453,allow,161,161,0,2,1200,2,0
64451,445,0,0,deny,70,70,0,1,0,1,0
56997,53,62280,53,allow,86,86,0,1,30,1,0
51946,443,39002,443,allow,8670,1805,6865,28,26,15,13
55064,443,12029,443,allow,12611,3681,8930,26,61,15,11
60705,443,45671,443,allow,24145,5933,18212,55,549,27,28
52266,53,15275,53,allow,168,78,90,2,30,1,1
50038,53,0,0,allow,275,85,190,2,31,1,1
57263,53,12000,53,allow,167,86,81,2,30,1,1
55808,53,32888,53,allow,183,94,89,2,30,1,1
58035,80,30742,80,allow,100364,4917,95447,133,241,67,66
36301,443,2134,443,allow,7316,1933,5383,27,15,15,12
38733,443,28389,443,allow,9058,1542,7516,25,50,13,12
48305,443,59833,443,allow,572565,17274,555291,546,147,124,422
65206,53,7977,53,allow,167,86,81,2,30,1,1
64592,53,65035,53,allow,209,110,99,2,31,1,1
37887,22114,0,0,deny,66,66,0,1,0,1,0
52251,445,0,0,drop,70,70,0,1,0,1,0
53038,445,0,0,drop,66,66,0,1,0,1,0
57476,443,16400,443,allow,10068,3304,6764,28,36,17,11
55155,2767,0,0,deny,66,66,0,1,0,1,0
47582,443,49001,443,allow,6214,1733,4481,13,120,6,7
64835,53,56147,53,allow,200,102,98,2,31,1,1
33827,443,18177,443,allow,696,152,544,11,48,3,8
54143,7000,54143,7000,allow,770727,19843,750884,802,16,295,507
34436,443,8261,443,allow,9083,2087,6996,28,18,16,12
50588,80,47890,80,allow,9116,7610,1506,22,78,12,10
54280,3385,0,0,deny,60,60,0,1,0,1,0
49162,53,28701,53,allow,183,94,89,2,30,1,1
25497,44847,0,0,deny,62,62,0,1,0,1,0
62303,445,0,0,drop,66,66,0,1,0,1,0
58888,443,9606,443,allow,5166,700,4466,16,14,7,9
53547,445,0,0,drop,66,66,0,1,0,1,0
63041,50584,0,0,deny,62,62,0,1,0,1,0
52077,51638,8361,51638,allow,70,70,0,1,4,1,0
55250,25174,0,0,deny,146,146,0,1,0,1,0
49604,80,21319,80,allow,454,262,192,8,41,5,3
55742,445,0,0,drop,70,70,0,1,0,1,0
52062,60388,22555,60388,allow,70,70,0,1,5,1,0
9393,51505,0,0,deny,66,66,0,1,0,1,0
56808,443,31717,443,allow,7981,1961,6020,20,15,11,9
51855,443,29819,443,allow,11894,2661,9233,32,32,18,14
65007,53,25899,53,allow,165,86,79,2,30,1,1
57647,53,15724,53,allow,265,78,187,2,30,1,1
31978,57470,0,0,deny,60,60,0,1,0,1,0
49402,80,31803,80,allow,405,285,120,5,15,3,2
50548,80,23213,80,allow,378,192,186,7,21,4,3
36688,443,58971,443,allow,178,118,60,2,15,1,1
50077,443,55619,443,allow,1786,172,1614,7,0,3,4
54677,443,22432,443,allow,10029,4115,5914,31,61,17,14
56387,443,8980,443,allow,9569,2225,7344,28,15,15,13
54973,1433,0,0,deny,60,60,0,1,0,1,0
65025,53,23591,53,allow,347,94,253,2,30,1,1
46072,443,46479,443,allow,16656,3094,13562,29,271,14,15
80,7597,0,0,deny,66,66,0,1,0,1,0
53043,443,3283,443,allow,11020,3760,7260,56,92,25,31
42034,28189,0,0,deny,62,62,0,1,0,1,0
55686,445,0,0,drop,70,70,0,1,0,1,0
59166,443,40050,443,allow,130458,7920,122538,199,359,94,105
56495,53,29192,53,allow,198,101,97,2,30,1,1
46202,443,10482,443,allow,19149,2846,16303,41,25,20,21
49174,53,10014,53,allow,323,107,216,4,47,2,2
51797,80,9284,80,allow,1929,796,1133,21,135,11,10
27302,443,50050,443,allow,9046,1414,7632,25,84,10,15
59772,80,1176,80,allow,5558,3386,2172,29,36,15,14
53722,443,52101,443,allow,327838,13327,314511,355,127,121,234
50837,445,0,0,drop,66,66,0,1,0,1,0
51582,5223,65291,5223,allow,4183,1283,2900,23,163,13,10
34038,5222,46652,5222,allow,2853,1289,1564,30,1555,12,18
55057,53,28590,53,allow,188,80,108,2,31,1,1
57207,53,1667,53,allow,195,102,93,2,29,1,1
59966,37965,0,0,deny,66,66,0,1,0,1,0
35749,18375,0,0,deny,146,146,0,1,0,1,0
34129,11045,0,0,deny,62,62,0,1,0,1,0
41542,23,41542,23,allow,66,66,0,1,5,1,0
54350,443,59930,443,allow,15567,5964,9603,27,21,14,13
44147,64147,0,0,deny,62,62,0,1,0,1,0
64587,43890,0,0,deny,66,66,0,1,0,1,0
51932,445,0,0,drop,70,70,0,1,0,1,0
53037,445,0,0,drop,70,70,0,1,0,1,0
56673,443,49966,443,allow,5726,1474,4252,22,81,13,9
65422,53,10168,53,allow,753,96,657,2,30,1,1
5661,37965,0,0,deny,62,62,0,1,0,1,0
56957,443,26018,443,allow,4359,924,3435,15,59,9,6
58638,5900,0,0,deny,62,62,0,1,0,1,0
60297,80,29320,80,allow,1463,865,598,11,144,6,5
65315,53,23256,53,allow,178,94,84,2,30,1,1
53167,22083,1777,22083,allow,70,70,0,2,8,2,0
61017,64147,0,0,deny,66,66,0,1,0,1,0
57734,445,0,0,drop,70,70,0,1,0,1,0
63433,57866,0,0,deny,62,62,0,1,0,1,0
50257,53,50801,53,allow,199,102,97,2,29,1,1
64665,53,12742,53,allow,181,94,87,2,32,1,1
64626,50584,0,0,deny,62,62,0,1,0,1,0
64431,53,52524,53,allow,170,87,83,2,31,1,1
60516,445,0,0,drop,66,66,0,1,0,1,0
60529,445,0,0,drop,70,70,0,1,0,1,0
62939,445,0,0,drop,66,66,0,1,0,1,0
37052,53,37052,53,allow,259,104,155,2,30,1,1
42745,50011,0,0,deny,62,62,0,1,0,1,0
12545,25174,0,0,deny,146,146,0,1,0,1,0
48381,53,16694,53,allow,221,75,146,2,30,1,1
55130,53,20364,53,allow,216,110,106,2,30,1,1
64190,2767,0,0,deny,66,66,0,1,0,1,0
56262,53,63670,53,allow,177,94,83,2,30,1,1
57261,445,0,0,drop,70,70,0,1,0,1,0
46744,53,46744,53,allow,404,259,145,3,32,2,1
50698,5900,50698,5900,allow,130,66,64,2,5,1,1
57273,445,0,0,drop,66,66,0,1,0,1,0
53857,22796,40353,22796,allow,492,306,186,8,15,5,3
64993,445,0,0,drop,66,66,0,1,0,1,0
56002,53,4276,53,allow,771,101,670,2,31,1,1
53823,25291,38093,25291,allow,320,140,180,6,6,3,3
63042,443,30142,443,allow,512,166,346,2,30,1,1
53100,443,46629,443,allow,8571,1789,6782,20,326,10,10
16387,22272,0,0,deny,60,60,0,1,0,1,0
17101,25174,0,0,deny,66,66,0,1,0,1,0
57470,24907,9136,24907,allow,1386,1386,0,22,1544,22,0
63589,44847,0,0,deny,62,62,0,1,0,1,0
63539,445,0,0,drop,70,70,0,1,0,1,0
58857,443,13362,443,allow,3439647,103607,3336040,3670,452,1291,2379
50419,80,40888,80,allow,3664,1440,2224,12,23,6,6
33812,443,2950,443,allow,16120,8754,7366,36,327,21,15
53753,443,5988,443,allow,499,425,74,4,0,3,1
43807,80,36292,80,allow,138,78,60,2,4,1,1
54932,445,0,0,drop,70,70,0,1,0,1,0
49472,80,16724,80,allow,318,192,126,6,28,4,2
49996,53,62453,53,allow,183,94,89,2,30,1,1
50266,443,13343,443,allow,6344,2063,4281,26,21,12,14
53806,37267,15309,37267,allow,70,70,0,2,8,2,0
53823,445,0,0,drop,66,66,0,1,0,1,0
57452,53,57452,53,allow,203,82,121,2,30,1,1
17532,23,0,0,deny,60,60,0,1,0,1,0
19875,30170,0,0,deny,145,145,0,1,0,1,0
56777,42486,21252,42486,allow,70,70,0,1,5,1,0
55311,53,38927,53,allow,298,101,197,4,31,2,2
64085,53,10076,53,allow,351,102,249,4,43,2,2
57070,443,3388,443,allow,18227,6731,11496,63,18,34,29
53835,62413,0,0,deny,146,146,0,1,0,1,0
57192,53,38984,53,allow,177,94,83,2,30,1,1
50525,445,0,0,drop,70,70,0,1,0,1,0
11236,53,11236,53,allow,197,90,107,2,30,1,1
52141,445,0,0,drop,66,66,0,1,0,1,0
65116,445,0,0,drop,66,66,0,1,0,1,0
65438,443,60459,443,allow,572,320,252,10,28,6,4
50067,64147,0,0,deny,66,66,0,1,0,1,0
60018,445,0,0,drop,70,70,0,1,0,1,0
58638,5900,0,0,deny,62,62,0,1,0,1,0
25009,35440,0,0,deny,66,66,0,1,0,1,0
58767,443,20066,443,allow,5167,700,4467,16,15,7,9
37191,48817,0,0,deny,159,159,0,1,0,1,0
64150,22114,0,0,deny,66,66,0,1,0,1,0
55272,53,11966,53,allow,285,103,182,4,51,2,2
65003,53,32396,53,allow,94,94,0,1,30,1,0
51221,55497,24312,55497,allow,330,330,0,6,1200,6,0
53141,8595,63363,8595,allow,70,70,0,2,8,2,0
50639,443,28987,443,allow,15714,2748,12966,58,21,23,35
49919,443,15575,443,allow,16012,2097,13915,33,16,15,18
49549,443,52947,443,allow,7896,1770,6126,26,171,13,13
53578,34129,19410,34129,allow,70,70,0,1,5,1,0
60982,445,0,0,drop,70,70,0,1,0,1,0
22574,44847,0,0,deny,62,62,0,1,0,1,0
54935,445,0,0,drop,70,70,0,1,0,1,0
49773,80,31365,80,allow,70,70,0,1,5,1,0
52233,443,57646,443,allow,5479,929,4550,20,360,10,10
65189,27015,42181,27015,allow,262,78,184,2,29,1,1
55903,53,64113,53,allow,177,94,83,2,29,1,1
55074,53,55407,53,allow,770,101,669,2,0,1,1
62172,445,0,0,drop,66,66,0,1,0,1,0
50767,445,0,0,drop,66,66,0,1,0,1,0
59180,443,21871,443,allow,2592,1486,1106,20,275,10,10
51715,80,53478,80,allow,3309,2152,1157,18,150,10,8
13021,25174,0,0,deny,146,146,0,1,0,1,0
16319,44847,0,0,deny,62,62,0,1,0,1,0
23725,80,23725,80,allow,1100980,31101,1069879,1210,19,462,748
56253,445,0,0,drop,66,66,0,1,0,1,0
1523,22,0,0,deny,60,60,0,1,0,1,0
22678,443,22678,443,allow,18172,3573,14599,39,26,20,19
50684,445,0,0,drop,70,70,0,1,0,1,0
56788,443,35911,443,allow,22508,1965,20543,32,17,13,19
55938,445,0,0,drop,66,66,0,1,0,1,0
52204,445,0,0,drop,70,70,0,1,0,1,0
61761,44847,0,0,deny,66,66,0,1,0,1,0
49781,53,21515,53,allow,194,102,92,2,30,1,1
58638,5900,0,0,deny,62,62,0,1,0,1,0
36886,443,32940,443,allow,2907,1637,1270,20,364,11,9
2440,37807,0,0,deny,66,66,0,1,0,1,0
37437,443,24632,443,allow,4809,818,3991,15,15,8,7
56148,37965,0,0,deny,66,66,0,1,0,1,0
38149,53,54452,53,allow,199,94,105,2,31,1,1
55928,80,55928,80,allow,17982,2112,15870,35,28,18,17
65518,5710,0,0,deny,62,62,0,1,0,1,0
49737,443,56529,443,allow,5566,1444,4122,17,129,10,7
65329,445,0,0,drop,70,70,0,1,0,1,0
55214,443,10396,443,allow,10048,2128,7920,44,118,24,20
57263,53,62100,53,allow,166,85,81,2,30,1,1
59923,53,59923,53,allow,365,233,132,3,33,2,1
44850,443,60943,443,allow,4502,895,3607,15,25,9,6
49418,30000,55086,30000,allow,280,78,202,2,30,1,1
58638,5900,0,0,deny,62,62,0,1,0,1,0
39378,443,56513,443,allow,494,342,152,4,5,2,2
1873,37965,0,0,deny,62,62,0,1,0,1,0
53766,443,46858,443,allow,499,425,74,4,0,3,1
64245,445,0,0,drop,70,70,0,1,0,1,0
60318,123,6592,123,allow,184,94,90,2,30,1,1
49257,53,65016,53,allow,164,84,80,2,30,1,1
49635,80,43715,80,allow,318,192,126,6,42,4,2
55710,445,0,0,drop,70,70,0,1,0,1,0
34600,80,41483,80,allow,3089,775,2314,15,16,9,6
49685,443,41646,443,allow,8435,1687,6748,30,76,14,16
23001,64147,0,0,deny,62,62,0,1,0,1,0
54101,445,0,0,drop,70,70,0,1,0,1,0
61885,445,0,0,drop,66,66,0,1,0,1,0
54231,445,0,0,drop,70,70,0,1,0,1,0
57396,445,0,0,drop,66,66,0,1,0,1,0
51307,445,0,0,drop,70,70,0,1,0,1,0
62071,443,12103,443,allow,134,60,74,3,4,2,1
54858,51505,0,0,deny,66,66,0,1,0,1,0
49863,443,31339,443,allow,6057,1038,5019,20,56,11,9
52711,37965,0,0,deny,62,62,0,1,0,1,0
51987,23136,41339,23136,allow,70,70,0,1,5,1,0
55884,53,55884,53,allow,197,90,107,2,30,1,1
52039,80,39126,80,allow,366,240,126,7,25,5,2
50135,50584,0,0,deny,62,62,0,1,0,1,0
38664,37965,0,0,deny,145,145,0,1,0,1,0
55097,445,0,0,drop,66,66,0,1,0,1,0
53462,445,0,0,drop,70,70,0,1,0,1,0
45603,35894,0,0,deny,145,145,0,1,0,1,0
56104,445,0,0,drop,70,70,0,1,0,1,0
56151,53,18710,53,allow,194,102,92,2,30,1,1
64944,53,44996,53,allow,749,89,660,2,30,1,1
6881,6881,0,0,deny,62,62,0,1,0,1,0
50634,80,58631,80,allow,25670,13514,12156,46,36,21,25
55418,53,32806,53,allow,168,86,82,2,30,1,1
64045,7426,33466,7426,allow,70,70,0,1,4,1,0
58638,5900,0,0,deny,62,62,0,1,0,1,0
65099,53,63994,53,allow,198,101,97,2,31,1,1
37846,443,26954,443,allow,30620,20855,9765,91,112,45,46
60794,443,17248,443,allow,796772,27151,769621,878,137,302,576
33911,53,0,0,allow,82,82,0,1,30,1,0
59415,445,0,0,drop,70,70,0,1,0,1,0
55052,53,42687,53,allow,198,102,96,2,30,1,1
63331,51221,0,0,deny,62,62,0,1,0,1,0
57074,53,22735,53,allow,195,102,93,2,30,1,1
50807,445,0,0,drop,66,66,0,1,0,1,0
35868,123,20404,123,allow,184,94,90,2,30,1,1
57918,445,0,0,drop,66,66,0,1,0,1,0
50968,443,1299,443,allow,10759,3158,7601,29,75,16,13
34294,53,17102,53,allow,168,78,90,2,30,1,1
65246,53,9355,53,allow,179,94,85,2,29,1,1
53245,443,1855,443,allow,28206,2737,25469,45,323,18,27
27272,64147,0,0,deny,66,66,0,1,0,1,0
65064,53,48752,53,allow,821,102,719,2,29,1,1
55342,445,0,0,drop,70,70,0,1,0,1,0
40709,443,57804,443,allow,256802,11839,244963,329,173,136,193
19875,30170,0,0,deny,145,145,0,1,0,1,0
49430,443,49430,443,allow,4377,1470,2907,19,30,11,8
51725,56205,0,0,deny,62,62,0,1,0,1,0
58895,443,48917,443,allow,13440,8354,5086,39,20,20,19
56753,44847,0,0,deny,62,62,0,1,0,1,0
52179,445,0,0,drop,70,70,0,1,0,1,0
65103,445,0,0,drop,66,66,0,1,0,1,0
53478,443,15802,443,allow,7692,2183,5509,24,224,14,10
5685,35440,0,0,deny,66,66,0,1,0,1,0
20487,50584,0,0,deny,66,66,0,1,0,1,0
50474,80,50474,80,allow,4994,855,4139,14,21,7,7
62173,445,0,0,drop,66,66,0,1,0,1,0
33317,53,33317,53,allow,231,88,143,2,32,1,1
63979,49547,9568,49547,allow,312,132,180,6,6,3,3
59032,25174,0,0,deny,66,66,0,1,0,1,0
56009,53,7541,53,allow,172,88,84,2,31,1,1
65404,443,46166,443,allow,63040,3063,59977,78,129,30,48
5588,5588,0,0,allow,3354,1792,1562,46,195,23,23
55199,53,8107,53,allow,214,110,104,2,30,1,1
30188,33285,47903,33285,allow,502,150,352,2,1200,1,1
47740,443,62722,443,allow,6234,4369,1865,25,316,12,13
53323,35253,0,0,deny,66,66,0,1,0,1,0
55646,53,3427,53,allow,183,94,89,2,30,1,1
58954,443,36028,443,allow,5166,700,4466,16,15,7,9
53170,20259,44123,20259,allow,70,70,0,2,8,2,0
59660,445,0,0,drop,66,66,0,1,0,1,0
65377,53,64134,53,allow,404,95,309,4,49,2,2
26717,25174,0,0,deny,62,62,0,1,0,1,0
50008,53,29808,53,allow,186,95,91,2,30,1,1
31845,55777,0,0,deny,62,62,0,1,0,1,0
51221,27417,45430,27417,allow,481,150,331,2,1200,1,1
64815,123,8798,123,allow,184,94,90,2,31,1,1
6666,5000,0,0,deny,60,60,0,1,0,1,0
50426,53,48591,53,allow,889,404,485,10,30,5,5
50717,80,38874,80,allow,3317,2376,941,17,165,9,8
58606,445,0,0,drop,70,70,0,1,0,1,0
59900,445,0,0,drop,66,66,0,1,0,1,0
55606,21802,21715,21802,allow,320,140,180,6,5,3,3
51678,445,0,0,drop,70,70,0,1,0,1,0
49224,53,33872,53,allow,198,101,97,2,30,1,1
50663,443,7277,443,allow,7136,1421,5715,18,15,8,10
51497,443,14907,443,allow,8939,3462,5477,25,263,12,13
50031,53,40045,53,allow,181,94,87,2,30,1,1
49501,443,9020,443,allow,15456,2581,12875,28,31,10,18
55010,445,0,0,drop,70,70,0,1,0,1,0
55330,53,61986,53,allow,194,102,92,2,31,1,1
64740,445,0,0,drop,70,70,0,1,0,1,0
60297,25604,0,0,deny,62,62,0,1,0,1,0
52997,5900,0,0,deny,60,60,0,1,0,1,0
56681,443,56377,443,allow,8654,2150,6504,20,15,11,9
64567,443,24686,443,allow,24984,2042,22942,41,32,19,22
55267,445,0,0,drop,70,70,0,1,0,1,0
58638,5900,0,0,deny,62,62,0,1,0,1,0
38142,53,38142,53,allow,404,259,145,3,32,2,1
57452,53,53868,53,allow,776,102,674,2,30,1,1
55373,1,0,0,deny,66,66,0,1,0,1,0
54505,445,0,0,drop,66,66,0,1,0,1,0
38280,80,34023,80,allow,748,459,289,8,254,5,3
58638,5900,0,0,deny,62,62,0,1,0,1,0
57641,80,57641,80,allow,35197,3040,32157,40,32,14,26
49650,53,49396,53,allow,776,102,674,2,31,1,1
37965,11102,8568,11102,allow,132,132,0,3,1200,3,0
64871,53,62774,53,allow,263,94,169,2,31,1,1
56519,53,63557,53,allow,166,85,81,2,31,1,1
53421,445,0,0,drop,66,66,0,1,0,1,0
57441,445,0,0,drop,70,70,0,1,0,1,0
34979,80,8756,80,allow,1150,465,685,14,268,5,9
50584,6889,59579,6889,allow,161,161,0,2,1200,2,0
37769,80,60461,80,allow,1213,471,742,10,255,6,4
60248,30188,0,0,deny,66,66,0,1,0,1,0
3406,17372,0,0,deny,66,66,0,1,0,1,0
65484,443,65484,443,allow,4640,1733,2907,19,27,11,8
54455,443,48160,443,allow,282,148,134,5,27,3,2
60271,445,0,0,drop,70,70,0,1,0,1,0
7482,57470,0,0,deny,66,66,0,1,0,1,0
55877,53546,37144,53546,allow,481,150,331,2,1200,1,1
55000,443,17337,443,allow,134,60,74,3,10,2,1
49295,445,0,0,drop,70,70,0,1,0,1,0
65386,53,49656,53,allow,197,102,95,2,33,1,1
49681,443,29652,443,allow,7074,2016,5058,26,187,13,13
56360,53,50871,53,allow,814,110,704,2,30,1,1
57366,53,63370,53,allow,745,93,652,2,31,1,1
30542,25174,0,0,deny,62,62,0,1,0,1,0
13970,42873,0,0,deny,66,66,0,1,0,1,0
53799,6881,10719,6881,allow,70,70,0,1,4,1,0
64581,443,64560,443,allow,9221,2109,7112,28,32,15,13
64415,445,0,0,drop,70,70,0,1,0,1,0
50145,445,0,0,drop,70,70,0,1,0,1,0
54184,443,12378,443,allow,2786,1537,1249,17,16,8,9
40710,5228,9746,5228,allow,4065,2585,1480,28,40,14,14
8999,57470,0,0,deny,146,146,0,1,0,1,0
44037,443,25209,443,allow,5839,3664,2175,13,120,8,5
64560,53,40808,53,allow,578,179,399,6,56,3,3
48753,80,48753,80,allow,19937,2162,17775,36,24,19,17
59994,11446,0,0,deny,66,66,0,1,0,1,0
60959,445,0,0,drop,70,70,0,1,0,1,0
45238,44847,0,0,deny,66,66,0,1,0,1,0
58757,5222,20717,5222,allow,3815,2065,1750,37,309,19,18
57930,445,0,0,drop,70,70,0,1,0,1,0
49644,30188,0,0,deny,66,66,0,1,0,1,0
50253,53,9014,53,allow,756,95,661,2,30,1,1
19875,30170,0,0,deny,145,145,0,1,0,1,0
25251,53,25251,53,allow,231,90,141,2,30,1,1
6580,443,39397,443,allow,2227,1018,1209,17,16,8,9
27005,27017,29678,27017,allow,917,126,791,2,30,1,1
57224,53,20310,53,allow,532,198,334,6,50,3,3
52170,45144,10407,45144,allow,66,66,0,1,5,1,0
49891,80,47196,80,allow,1376,946,430,8,86,5,3
51964,1103,52197,1103,allow,70,70,0,2,8,2,0
56328,36237,0,0,deny,66,66,0,1,0,1,0
53061,445,0,0,drop,70,70,0,1,0,1,0
31859,33909,0,0,deny,66,66,0,1,0,1,0
64976,53,53844,53,allow,193,102,91,2,29,1,1
55580,53,22194,53,allow,788,108,680,2,30,1,1
64344,53,51510,53,allow,286,102,184,4,45,2,2
5228,3434,0,0,deny,345,345,0,1,0,1,0
63007,445,0,0,drop,70,70,0,1,0,1,0
50265,445,0,0,drop,70,70,0,1,0,1,0
50877,30041,0,0,deny,62,62,0,1,0,1,0
57288,53,46993,53,allow,177,94,83,2,30,1,1
64877,37450,0,0,deny,66,66,0,1,0,1,0
59664,445,0,0,drop,66,66,0,1,0,1,0
27005,28002,27297,28002,allow,918,126,792,2,31,1,1
49210,53,10205,53,allow,183,94,89,2,30,1,1
56963,53,8410,53,allow,199,102,97,2,31,1,1
5222,64493,0,0,deny,1514,1514,0,1,0,1,0
51578,44847,0,0,deny,66,66,0,1,0,1,0
5588,5588,0,0,allow,3562,1936,1626,48,191,24,24
39351,23,0,0,deny,60,60,0,1,0,1,0
40329,80,42227,80,allow,2128,798,1330,14,46,7,7
57243,443,49244,443,allow,27444,3840,23604,58,161,28,30
41321,443,41856,443,allow,9168,1596,7572,22,186,11,11
60174,445,0,0,drop,70,70,0,1,0,1,0
54962,53,15807,53,allow,194,102,92,2,30,1,1
38049,80,38049,80,allow,2180,1555,625,9,86,6,3
57001,445,0,0,drop,70,70,0,1,0,1,0
53152,443,44569,443,allow,16706,6162,10544,39,29,19,20
59524,25174,0,0,deny,66,66,0,1,0,1,0
62413,445,0,0,drop,66,66,0,1,0,1,0
56637,443,17039,443,allow,8865,1819,7046,24,30,14,10
64831,53,30238,53,allow,216,110,106,2,31,1,1
59159,445,0,0,drop,70,70,0,1,0,1,0
54121,25174,0,0,deny,66,66,0,1,0,1,0
62830,445,0,0,drop,66,66,0,1,0,1,0
51926,58664,36241,58664,allow,70,70,0,2,8,2,0
57375,53,63119,53,allow,198,102,96,2,30,1,1
51235,80,15389,80,allow,3588,2362,1226,24,87,13,11
65396,53,55502,53,allow,186,102,84,2,29,1,1
61626,445,0,0,drop,70,70,0,1,0,1,0
22767,53,22767,53,allow,226,106,120,2,30,1,1
52970,443,47039,443,allow,19221,5366,13855,88,113,36,52
55616,42929,13566,42929,allow,70,70,0,1,5,1,0
50697,80,44763,80,allow,54775,28230,26545,230,175,115,115
34155,443,22614,443,allow,11294,2234,9060,23,139,12,11
28237,443,25955,443,allow,7876,1540,6336,21,124,10,11
38631,443,46548,443,allow,6231,1151,5080,23,109,13,10
5223,61002,0,0,deny,161,161,0,1,0,1,0
47000,53,0,0,allow,82,82,0,1,31,1,0
51751,55855,62891,55855,allow,66,66,0,1,5,1,0
16762,61689,0,0,deny,62,62,0,1,0,1,0
54773,50584,0,0,deny,66,66,0,1,0,1,0
62324,443,62324,443,allow,2882,1622,1260,20,86,10,10
64585,53,51194,53,allow,210,110,100,2,30,1,1
1024,64147,0,0,deny,62,62,0,1,0,1,0
50635,80,60349,80,allow,3722,1504,2218,13,20,7,6
48692,57470,0,0,deny,62,62,0,1,0,1,0
63855,29799,41914,29799,allow,66,66,0,1,5,1,0
64012,40642,7765,40642,allow,70,70,0,1,5,1,0
45941,23388,0,0,deny,60,60,0,1,0,1,0
10151,51413,40673,51413,allow,460,150,310,2,1200,1,1
33240,443,43731,443,allow,7375,4769,2606,24,16,14,10
50396,445,0,0,drop,70,70,0,1,0,1,0
56272,443,56272,443,allow,4550,1643,2907,19,28,11,8
49736,443,65019,443,allow,52574,2783,49791,61,129,19,42
62945,445,0,0,drop,66,66,0,1,0,1,0
2049,32480,0,0,deny,62,62,0,1,0,1,0
50270,443,45158,443,allow,9998,2237,7761,38,121,21,17
54129,445,0,0,drop,70,70,0,1,0,1,0
58266,443,20650,443,allow,5619,1387,4232,18,205,10,8
55004,443,32429,443,allow,1334906,33112,1301794,1315,35,446,869
62217,37807,0,0,deny,66,66,0,1,0,1,0
53829,443,25937,443,allow,499,425,74,4,0,3,1
64813,53,44563,53,allow,180,94,86,2,30,1,1
57002,445,0,0,drop,66,66,0,1,0,1,0
56469,53,24320,53,allow,177,94,83,2,30,1,1
60788,40010,33720,40010,allow,316,136,180,6,5,3,3
56713,443,15450,443,allow,8006,1986,6020,20,15,11,9
57268,53,42841,53,allow,205,94,111,2,30,1,1
56063,53,65199,53,allow,192,98,94,2,31,1,1
40161,443,23210,443,allow,13459,1604,11855,27,66,14,13
49940,443,49940,443,allow,13342,2357,10985,25,18,14,11
58601,53,45683,53,allow,198,86,112,2,30,1,1
59841,445,0,0,drop,70,70,0,1,0,1,0
52638,445,0,0,drop,66,66,0,1,0,1,0
52014,20524,7082,20524,allow,70,70,0,1,5,1,0
60856,443,12085,443,allow,8201,2795,5406,43,18,26,17
1025,35447,0,0,deny,62,62,0,1,0,1,0
58753,443,55994,443,allow,5167,700,4467,16,14,7,9
49450,53,42470,53,allow,330,118,212,2,30,1,1
33842,53,33842,53,allow,1415,689,726,3,31,2,1
49501,11392,0,0,deny,66,66,0,1,0,1,0
50573,443,20479,443,allow,6575,1995,4580,26,100,13,13
53262,443,5546,443,allow,242149,7606,234543,260,150,92,168
19473,44929,9531,44929,allow,481,150,331,2,1200,1,1
53064,445,0,0,drop,66,66,0,1,0,1,0
45205,443,55089,443,allow,7221,3151,4070,20,162,9,11
48110,443,9219,443,allow,537031,23421,513610,622,43,258,364
61841,445,0,0,drop,70,70,0,1,0,1,0
22263,30188,0,0,deny,66,66,0,1,0,1,0
55489,53,35095,53,allow,177,94,83,2,30,1,1
53563,17355,37621,17355,allow,320,140,180,6,5,3,3
32171,50265,0,0,deny,145,145,0,1,0,1,0
55815,443,3642,443,allow,8602,1050,7552,16,120,7,9
65403,445,0,0,drop,66,66,0,1,0,1,0
53404,445,0,0,drop,70,70,0,1,0,1,0
37874,19000,47411,19000,allow,602,174,428,2,31,1,1
62459,445,0,0,drop,70,70,0,1,0,1,0
57892,80,46739,80,allow,6519,1210,5309,15,17,8,7
52956,443,14626,443,allow,15659,3294,12365,60,114,25,35
52238,26467,0,0,deny,62,62,0,1,0,1,0
58290,445,0,0,drop,70,70,0,1,0,1,0
64733,35440,0,0,deny,66,66,0,1,0,1,0
2464,50584,0,0,deny,66,66,0,1,0,1,0
60872,445,0,0,drop,66,66,0,1,0,1,0
21585,443,21585,443,allow,14344,1146,13198,25,19,11,14
58643,445,0,0,drop,70,70,0,1,0,1,0
51463,445,0,0,drop,70,70,0,1,0,1,0
37371,5228,12391,5228,allow,3277,1954,1323,27,3600,14,13
51655,26467,0,0,deny,62,62,0,1,0,1,0
59937,443,12788,443,allow,70,70,0,1,5,1,0
59364,44847,0,0,deny,66,66,0,1,0,1,0
26497,64147,0,0,deny,66,66,0,1,0,1,0
58137,445,0,0,drop,70,70,0,1,0,1,0
49539,53,44717,53,allow,170,87,83,2,31,1,1
63474,48817,0,0,deny,66,66,0,1,0,1,0
54040,445,0,0,drop,70,70,0,1,0,1,0
49673,5223,52043,5223,allow,4266,1448,2818,22,3088,13,9
56581,80,13177,80,allow,1630,918,712,12,17,7,5
60947,445,0,0,drop,70,70,0,1,0,1,0
51374,445,0,0,drop,70,70,0,1,0,1,0
38041,10104,0,0,deny,146,146,0,1,0,1,0
49385,443,8821,443,allow,16316,7445,8871,49,237,23,26
0,0,0,0,allow,320,320,0,5,0,5,0
64379,37965,0,0,deny,66,66,0,1,0,1,0
5588,5588,0,0,allow,3562,1936,1626,48,195,24,24
57602,443,32129,443,allow,7527,1788,5739,23,20,13,10
50624,26467,0,0,deny,66,66,0,1,0,1,0
53191,445,0,0,drop,70,70,0,1,0,1,0
60345,80,36242,80,allow,2124,1158,966,13,87,7,6
27450,443,32260,443,allow,10099,1635,8464,31,83,14,17
45937,53,13210,53,allow,241,78,163,2,30,1,1
49667,53,38974,53,allow,261,94,167,2,30,1,1
56802,80,23332,80,allow,1559,762,797,14,30,7,7
65501,53,1213,53,allow,226,94,132,2,29,1,1
10669,49756,0,0,deny,60,60,0,1,0,1,0
52060,80,41226,80,allow,366,240,126,7,25,5,2
55378,53,28719,53,allow,277,102,175,2,30,1,1
49516,35894,0,0,deny,62,62,0,1,0,1,0
53077,445,0,0,drop,70,70,0,1,0,1,0
35414,53,44913,53,allow,168,78,90,2,30,1,1
50151,53,17420,53,allow,152,78,74,2,30,1,1
12031,36237,0,0,deny,66,66,0,1,0,1,0
34499,443,29656,443,allow,19518,11774,7744,46,168,26,20
64815,53,31191,53,allow,214,110,104,2,30,1,1
49659,445,0,0,drop,66,66,0,1,0,1,0
49558,53,30601,53,allow,184,94,90,2,30,1,1
53543,51819,47777,51819,allow,70,70,0,1,4,1,0
2932,44847,0,0,deny,66,66,0,1,0,1,0
55314,445,0,0,drop,70,70,0,1,0,1,0
64968,445,0,0,drop,70,70,0,1,0,1,0
57076,5222,34364,5222,allow,15600,7789,7811,155,169,82,73
27005,52013,29857,52013,allow,252,252,0,3,32,3,0
50265,28520,23958,28520,allow,132,132,0,3,1200,3,0
40196,443,61662,443,allow,24750,1845,22905,39,171,17,22
57372,53,54871,53,allow,177,94,83,2,30,1,1
55644,53,55094,53,allow,184,94,90,2,30,1,1
6892,36949,0,0,deny,159,159,0,1,0,1,0
59828,445,0,0,drop,70,70,0,1,0,1,0
53217,443,21683,443,allow,6058,1038,5020,20,66,11,9
53548,443,53548,443,allow,1386,751,635,15,181,8,7
55423,53,64857,53,allow,177,94,83,2,30,1,1
60750,42707,0,0,deny,66,66,0,1,0,1,0
35111,22114,0,0,deny,66,66,0,1,0,1,0
59592,37965,0,0,deny,62,62,0,1,0,1,0
50304,445,0,0,drop,70,70,0,1,0,1,0
55684,53,19288,53,allow,193,102,91,2,29,1,1
64509,53,38948,53,allow,385,134,251,2,30,1,1
54211,53,7944,53,allow,339,94,245,2,30,1,1
62811,445,0,0,drop,66,66,0,1,0,1,0
54977,53,39208,53,allow,275,93,182,4,31,2,2
55632,445,0,0,drop,70,70,0,1,0,1,0
41139,443,57233,443,allow,9152383,160511,8991872,8428,252,2261,6167
55050,443,45507,443,allow,1480,1029,451,11,151,6,5
53402,443,53402,443,allow,4582,1675,2907,19,29,11,8
54363,443,18639,443,allow,23766,10707,13059,80,42,41,39
51775,57887,60310,57887,allow,70,70,0,2,8,2,0
61718,445,0,0,drop,70,70,0,1,0,1,0
42075,36237,0,0,deny,62,62,0,1,0,1,0
51745,57470,0,0,deny,62,62,0,1,0,1,0
50073,445,0,0,drop,70,70,0,1,0,1,0
64252,53,36702,53,allow,198,101,97,2,31,1,1
19372,443,19372,443,allow,10461,1417,9044,23,16,10,13
55774,443,58031,443,allow,6092,3093,2999,16,120,8,8
55992,445,0,0,drop,70,70,0,1,0,1,0
53652,445,0,0,drop,66,66,0,1,0,1,0
55830,53,20748,53,allow,177,94,83,2,30,1,1
43570,53,0,0,allow,86,86,0,1,30,1,0
57226,53,25603,53,allow,178,94,84,2,30,1,1
57368,53,40892,53,allow,167,86,81,2,30,1,1
18574,56205,0,0,deny,62,62,0,1,0,1,0
52485,443,22795,443,allow,22817,7615,15202,30,16,16,14
54593,445,0,0,drop,70,70,0,1,0,1,0
38444,443,18273,443,allow,3547,955,2592,13,120,6,7
57094,443,45074,443,allow,8180,2643,5537,19,121,9,10
59638,53,40619,53,allow,714,454,260,2,30,1,1
47119,5228,18356,5228,allow,3630,2427,1203,21,3601,11,10
18166,53,18166,53,allow,825,99,726,2,30,1,1
56930,445,0,0,drop,70,70,0,1,0,1,0
49837,53,16345,53,allow,214,110,104,2,30,1,1
50817,445,0,0,drop,70,70,0,1,0,1,0
48706,23393,0,0,deny,60,60,0,1,0,1,0
49676,53,9085,53,allow,200,94,106,2,30,1,1
49262,80,49262,80,allow,515211,10976,504235,506,49,169,337
49929,53,57396,53,allow,212,108,104,2,31,1,1
41328,53,51462,53,allow,198,93,105,2,30,1,1
10754,28793,0,0,deny,66,66,0,1,0,1,0
47725,443,52489,443,allow,502,250,252,9,32,5,4
65107,53,31681,53,allow,193,102,91,2,31,1,1
50049,443,21285,443,allow,7912,3269,4643,23,96,12,11
56983,445,0,0,drop,66,66,0,1,0,1,0
65472,53,45041,53,allow,209,110,99,2,30,1,1
65211,53,49175,53,allow,216,102,114,2,30,1,1
64867,53,27823,53,allow,765,102,663,2,30,1,1
58999,443,40792,443,allow,9569,2606,6963,22,135,11,11
49314,443,60912,443,allow,8599,4862,3737,47,195,26,21
6889,8497,0,0,deny,143,143,0,1,0,1,0
57134,53,48452,53,allow,178,94,84,2,30,1,1
61976,445,0,0,drop,70,70,0,1,0,1,0
25063,64147,0,0,deny,62,62,0,1,0,1,0
50241,53,32622,53,allow,184,102,82,2,30,1,1
58638,5900,0,0,deny,62,62,0,1,0,1,0
58638,5900,0,0,deny,62,62,0,1,0,1,0
60750,42707,0,0,deny,66,66,0,1,0,1,0
55867,53,60176,53,allow,178,94,84,2,31,1,1
10480,26467,0,0,deny,62,62,0,1,0,1,0
61230,22114,0,0,deny,62,62,0,1,0,1,0
50997,445,0,0,drop,66,66,0,1,0,1,0
56358,53,42887,53,allow,210,110,100,2,33,1,1
50681,80,59849,80,allow,318,192,126,6,26,4,2
60299,445,0,0,drop,70,70,0,1,0,1,0
60044,445,0,0,drop,70,70,0,1,0,1,0
64588,443,57526,443,allow,9156,2109,7047,27,32,15,12
39536,80,4904,80,allow,2749,1732,1017,21,361,12,9
1054,15503,0,0,deny,62,62,0,1,0,1,0
55388,445,0,0,drop,70,70,0,1,0,1,0
53153,17639,25846,17639,allow,698,320,378,10,18,6,4
43032,443,31725,443,allow,6792,3009,3783,20,46,12,8
60195,80,59592,80,allow,70,70,0,1,5,1,0
56006,53,57116,53,allow,183,102,81,2,29,1,1
10002,40012,52638,40012,allow,261,198,63,2,29,1,1
59476,443,42006,443,allow,4697,923,3774,13,120,6,7
64495,443,32988,443,allow,1786,172,1614,7,120,3,4
55955,53,59557,53,allow,184,94,90,2,30,1,1
60495,6882,21325,6882,allow,70,70,0,1,5,1,0
49819,53,24234,53,allow,94,94,0,1,30,1,0
23277,53733,0,0,deny,62,62,0,1,0,1,0
56400,35440,0,0,deny,66,66,0,1,0,1,0
55812,53,55812,53,allow,235,90,145,2,32,1,1
57292,443,37855,443,allow,18591,5839,12752,78,18,44,34
59196,34962,0,0,deny,148,148,0,1,0,1,0
49740,53,20655,53,allow,793,101,692,2,31,1,1
60374,445,0,0,drop,70,70,0,1,0,1,0
5912,22114,0,0,deny,62,62,0,1,0,1,0
47910,7454,0,0,deny,60,60,0,1,0,1,0
56505,445,0,0,drop,66,66,0,1,0,1,0
58599,445,0,0,drop,66,66,0,1,0,1,0
55274,445,0,0,drop,66,66,0,1,0,1,0
56212,445,0,0,drop,70,70,0,1,0,1,0
54827,445,0,0,drop,70,70,0,1,0,1,0
52093,80,65106,80,allow,366,240,126,7,26,5,2
38692,443,1550,443,allow,1188751,17817,1170934,1053,16,255,798
5688,44847,0,0,deny,66,66,0,1,0,1,0
35558,15503,0,0,deny,66,66,0,1,0,1,0
443,28553,0,0,deny,74,74,0,1,0,1,0
64717,445,0,0,drop,70,70,0,1,0,1,0
49983,53,51189,53,allow,749,89,660,2,30,1,1
52103,53733,0,0,deny,66,66,0,1,0,1,0
50290,443,41228,443,allow,6662,3336,3326,37,142,17,20
49901,53,49901,53,allow,194,87,107,2,30,1,1
25901,50265,0,0,deny,62,62,0,1,0,1,0
58036,443,9162,443,allow,12752,5123,7629,39,90,18,21
64707,445,0,0,drop,70,70,0,1,0,1,0
58788,443,39752,443,allow,5166,700,4466,16,15,7,9
56746,443,25716,443,allow,8006,1986,6020,20,15,11,9
49270,53,44798,53,allow,216,110,106,2,30,1,1
49642,53,3732,53,allow,302,110,192,2,30,1,1
64795,445,0,0,drop,70,70,0,1,0,1,0
54280,3385,0,0,deny,60,60,0,1,0,1,0
51093,57470,0,0,deny,66,66,0,1,0,1,0
49771,53,57877,53,allow,177,94,83,2,29,1,1
58427,5223,31205,5223,allow,13841,6601,7240,42,622,19,23
57949,5228,62651,5228,allow,2655,1540,1115,19,3601,9,10
50236,25174,0,0,deny,66,66,0,1,0,1,0
6881,25649,11591,25649,allow,509,150,359,2,1200,1,1
57251,37965,0,0,deny,62,62,0,1,0,1,0
30598,37965,0,0,deny,62,62,0,1,0,1,0
59334,445,0,0,drop,70,70,0,1,0,1,0
64022,60918,37297,60918,allow,66,66,0,2,7,2,0
48019,22114,0,0,deny,66,66,0,1,0,1,0
57243,53,20159,53,allow,173,94,79,2,30,1,1
47894,443,29583,443,allow,295475,14093,281382,413,469,162,251
64251,53,6102,53,allow,177,94,83,2,30,1,1
58638,5900,0,0,deny,62,62,0,1,0,1,0
61013,41705,0,0,deny,66,66,0,1,0,1,0
61717,445,0,0,drop,70,70,0,1,0,1,0
62792,53,0,0,deny,88,88,0,1,0,1,0
61711,35440,0,0,deny,62,62,0,1,0,1,0
28345,11392,0,0,deny,62,62,0,1,0,1,0
50487,80,64502,80,allow,13796,627,13169,20,30,8,12
44884,443,19838,443,allow,36435,28844,7591,65,396,35,30
56546,443,13186,443,allow,19236,2292,16944,45,55,23,22
58939,443,28561,443,allow,6403,4065,2338,22,16,11,11
65451,53,3084,53,allow,728,234,494,6,67,3,3
62277,445,0,0,drop,70,70,0,1,0,1,0
65115,53,63102,53,allow,301,95,206,4,36,2,2
53263,443,23949,443,allow,11175,1078,10097,25,41,11,14
44246,5228,57956,5228,allow,19678,4762,14916,98,9851,54,44
52386,445,0,0,drop,70,70,0,1,0,1,0
43677,443,7474,443,allow,7698,2373,5325,21,159,12,9
59029,445,0,0,drop,70,70,0,1,0,1,0
52501,53,50653,53,allow,201,80,121,2,30,1,1
9458,443,4963,443,allow,5695,505,5190,14,15,7,7
50333,445,0,0,drop,66,66,0,1,0,1,0
65133,53,1707,53,allow,339,100,239,4,51,2,2
56509,53,37473,53,allow,1165,94,1071,2,30,1,1
59191,35440,0,0,deny,66,66,0,1,0,1,0
57944,445,0,0,drop,70,70,0,1,0,1,0
57888,445,0,0,drop,70,70,0,1,0,1,0
56504,53,45710,53,allow,102,102,0,1,30,1,0
55600,22,0,0,deny,60,60,0,1,0,1,0
56824,3389,56824,3389,allow,3910,1805,2105,20,18,12,8
57714,53,57714,53,allow,233,90,143,2,32,1,1
52346,445,0,0,drop,70,70,0,1,0,1,0
64407,53,18646,53,allow,232,110,122,2,29,1,1
50265,44822,26867,44822,allow,149,149,0,1,1200,1,0
59982,445,0,0,drop,66,66,0,1,0,1,0
45742,443,8175,443,allow,8471,3275,5196,21,120,11,10
43382,53,39674,53,allow,86,86,0,1,30,1,0
52315,443,14653,443,allow,24304,2974,21330,57,34,31,26
50210,443,12154,443,allow,6444,1320,5124,31,727,10,21
9605,57470,0,0,deny,62,62,0,1,0,1,0
53108,445,0,0,drop,70,70,0,1,0,1,0
56548,443,12998,443,allow,4145,1069,3076,14,25,8,6
64122,445,0,0,drop,70,70,0,1,0,1,0
62924,993,52929,993,allow,9376,4359,5017,86,19,44,42
26698,57470,0,0,deny,62,62,0,1,0,1,0
57589,443,3632,443,allow,2614,1689,925,18,23,10,8
54995,443,62942,443,allow,23418,2454,20964,56,197,26,30
0,0,0,0,deny,98,98,0,1,0,1,0
64276,445,0,0,drop,66,66,0,1,0,1,0
17947,36237,0,0,deny,62,62,0,1,0,1,0
52270,3708,62556,3708,allow,316,136,180,6,6,3,3
56361,80,32552,80,allow,9997,1306,8691,17,25,8,9
56636,53,35098,53,allow,372,86,286,4,54,2,2
52332,443,52332,443,allow,960,539,421,9,52,5,4
64380,53,47265,53,allow,193,102,91,2,30,1,1
65095,445,0,0,drop,70,70,0,1,0,1,0
46893,443,27910,443,allow,622,70,552,10,180,2,8
63380,443,31712,443,allow,4704,2139,2565,13,119,7,6
10005,40022,7541,40022,allow,151,89,62,2,30,1,1
45964,5333,0,0,deny,60,60,0,1,0,1,0
45987,123,19536,123,allow,184,94,90,2,30,1,1
48817,63838,48817,63838,allow,513,152,361,2,1200,1,1
52923,445,0,0,drop,66,66,0,1,0,1,0
64626,50584,0,0,deny,66,66,0,1,0,1,0
57208,53,19470,53,allow,183,94,89,2,30,1,1
48778,80,16126,80,allow,130,70,60,2,15,1,1
53776,37650,38223,37650,allow,70,70,0,1,4,1,0
54576,443,43696,443,allow,5670,3091,2579,16,121,8,8
53841,37965,0,0,deny,66,66,0,1,0,1,0
26900,27017,5951,27017,allow,422,164,258,6,30,3,3
61865,445,0,0,drop,70,70,0,1,0,1,0
65518,443,8967,443,allow,92157,4519,87638,105,15,39,66
55020,445,0,0,drop,70,70,0,1,0,1,0
55897,53,23504,53,allow,770,102,668,2,30,1,1
56380,80,20906,80,allow,1466,729,737,12,16,7,5
60440,445,0,0,drop,66,66,0,1,0,1,0
2815,62413,0,0,deny,66,66,0,1,0,1,0
4083,443,26942,443,allow,2227,1018,1209,17,16,8,9
41923,53,17859,53,allow,168,78,90,2,30,1,1
52218,80,52218,80,allow,1921,1472,449,10,20,6,4
8560,50584,0,0,deny,66,66,0,1,0,1,0
64854,53,19682,53,allow,178,94,84,2,31,1,1
49717,57470,0,0,deny,62,62,0,1,0,1,0
64115,80,27951,80,allow,2575,635,1940,12,36,7,5
57096,53,39504,53,allow,198,102,96,2,30,1,1
13589,22114,0,0,deny,146,146,0,1,0,1,0
52710,445,0,0,drop,66,66,0,1,0,1,0
50209,445,0,0,drop,70,70,0,1,0,1,0
19328,53,26253,53,allow,236,86,150,2,29,1,1
64174,53,10238,53,allow,180,94,86,2,31,1,1
14023,37965,0,0,deny,62,62,0,1,0,1,0
45992,443,45992,443,allow,1494,898,596,12,142,6,6
52452,80,35444,80,allow,5582,591,4991,14,75,7,7
33148,443,29475,443,allow,7639,948,6691,25,395,9,16
33979,23,0,0,deny,60,60,0,1,0,1,0
55508,64147,0,0,deny,62,62,0,1,0,1,0
50650,445,0,0,drop,70,70,0,1,0,1,0
60342,445,0,0,drop,66,66,0,1,0,1,0
32707,11392,0,0,deny,62,62,0,1,0,1,0
34788,443,32056,443,allow,8230,2275,5955,18,135,8,10
58638,5900,0,0,deny,62,62,0,1,0,1,0
58745,30188,0,0,deny,66,66,0,1,0,1,0
5588,5588,0,0,allow,3354,1792,1562,46,195,23,23
33892,53,0,0,allow,86,86,0,1,30,1,0
59755,44512,0,0,deny,66,66,0,1,0,1,0
61208,445,0,0,drop,66,66,0,1,0,1,0
64140,53,48538,53,allow,184,94,90,2,30,1,1
51393,443,1567,443,allow,4721,2724,1997,35,130,19,16
55012,25174,0,0,deny,66,66,0,1,0,1,0
46701,1433,0,0,deny,60,60,0,1,0,1,0
13285,29892,0,0,deny,145,145,0,1,0,1,0
10390,26467,0,0,deny,62,62,0,1,0,1,0
63963,445,0,0,drop,70,70,0,1,0,1,0
42767,443,1762,443,allow,8995,2498,6497,40,256,19,21
38387,80,17970,80,allow,2008,810,1198,20,394,7,13
56925,80,48459,80,allow,214,140,74,4,25,3,1
53903,51339,10537,51339,allow,70,70,0,1,4,1,0
37586,443,60521,443,allow,499,425,74,4,0,3,1
56240,53,1263,53,allow,226,94,132,2,29,1,1
62463,443,34613,443,allow,4203,2748,1455,18,33,10,8
56078,53,23353,53,allow,168,86,82,2,30,1,1
53833,26467,0,0,deny,66,66,0,1,0,1,0
46331,53,26643,53,allow,199,94,105,2,30,1,1
59116,443,24457,443,allow,48923,5417,43506,61,122,25,36
65469,53,36424,53,allow,308,110,198,2,30,1,1
64940,26467,0,0,deny,62,62,0,1,0,1,0
64769,53,55242,53,allow,418,150,268,2,30,1,1
57385,53,34809,53,allow,197,102,95,2,30,1,1
58638,5900,58638,5900,allow,156,62,94,2,10,1,1
54221,443,30270,443,allow,8327,4890,3437,23,316,12,11
49701,53,45217,53,allow,523,92,431,4,48,2,2
6882,5406,43769,5406,allow,654,150,504,3,1200,1,2
65115,53,14088,53,allow,167,86,81,2,30,1,1
54631,443,52521,443,allow,2352,1394,958,17,275,9,8
55128,53,34503,53,allow,711,87,624,2,31,1,1
40768,443,17418,443,allow,3287,2049,1238,12,32,7,5
51800,63796,36885,63796,allow,70,70,0,2,8,2,0
45374,80,46773,80,allow,806,463,343,9,15,6,3
65239,53,65239,53,allow,231,90,141,2,30,1,1
62306,445,0,0,drop,66,66,0,1,0,1,0
39110,50584,0,0,deny,62,62,0,1,0,1,0
51700,80,43241,80,allow,30853,2456,28397,48,78,25,23
49418,27017,6721,27017,allow,300,78,222,2,30,1,1
64658,53,30936,53,allow,785,110,675,2,30,1,1
43333,50584,0,0,deny,146,146,0,1,0,1,0
65237,445,0,0,drop,70,70,0,1,0,1,0
42463,56205,0,0,deny,62,62,0,1,0,1,0
61078,57470,0,0,deny,62,62,0,1,0,1,0
59886,64147,0,0,deny,72,72,0,1,0,1,0
44378,995,0,0,deny,60,60,0,1,0,1,0
55362,53,23060,53,allow,374,97,277,4,32,2,2
55394,53,55394,53,allow,197,76,121,2,30,1,1
50688,5222,59884,5222,allow,402,342,60,2,15,1,1
46550,443,33261,443,allow,7330,4420,2910,31,316,16,15
57384,443,57610,443,allow,1054,567,487,10,38,6,4
56341,53,28637,53,allow,213,102,111,2,29,1,1
58638,5900,0,0,deny,62,62,0,1,0,1,0
65318,53,16200,53,allow,395,102,293,2,30,1,1
65220,53,41846,53,allow,184,94,90,2,30,1,1
55523,445,0,0,drop,70,70,0,1,0,1,0
65331,53,36726,53,allow,193,102,91,2,30,1,1
27328,21247,0,0,deny,66,66,0,1,0,1,0
60129,80,34372,80,allow,2910,1439,1471,12,31,7,5
56357,53,52220,53,allow,172,88,84,2,30,1,1
45908,33330,0,0,deny,60,60,0,1,0,1,0
9161,443,17981,443,allow,5658,501,5157,14,15,7,7
49186,53,49186,53,allow,257,101,156,2,32,1,1
55335,53,8773,53,allow,754,94,660,2,30,1,1
51430,25174,0,0,deny,146,146,0,1,0,1,0
45816,443,45816,443,allow,4430,1523,2907,19,27,11,8
45394,53,64814,53,allow,199,94,105,2,30,1,1
53324,44847,0,0,deny,66,66,0,1,0,1,0
35201,443,64123,443,allow,291,171,120,4,15,2,2
57067,53,18004,53,allow,183,94,89,2,29,1,1
56050,53,62054,53,allow,178,94,84,2,30,1,1
17101,25174,0,0,deny,62,62,0,1,0,1,0
49516,53,27772,53,allow,182,93,89,2,31,1,1
49482,7000,49482,7000,allow,3098,1611,1487,16,15,9,7
55176,445,0,0,drop,70,70,0,1,0,1,0
24853,39828,0,0,deny,60,60,0,1,0,1,0
38306,443,65032,443,allow,4580,1210,3370,17,28,10,7
64667,53,24129,53,allow,353,118,235,2,30,1,1
55599,53,58938,53,allow,258,118,140,2,30,1,1
38612,443,17131,443,allow,20651533,655694,19995839,24885,362,8746,16139
45109,443,9498,443,allow,190,70,120,4,15,2,2
21133,26760,14164,26760,allow,480,149,331,2,1200,1,1
49597,53,40368,53,allow,86,86,0,1,30,1,0
63400,57470,0,0,deny,66,66,0,1,0,1,0
49242,53,1581,53,allow,167,86,81,2,29,1,1
36672,53,36672,53,allow,234,93,141,2,30,1,1
63672,443,63672,443,allow,4398,1491,2907,19,27,11,8
41764,53,7946,53,allow,168,78,90,2,29,1,1
3478,61463,0,0,deny,780,780,0,1,0,1,0
31845,55777,0,0,deny,62,62,0,1,0,1,0
56534,53,47047,53,allow,177,94,83,2,29,1,1
59735,443,11468,443,allow,7310,967,6343,18,25,10,8
34348,22114,0,0,deny,62,62,0,1,0,1,0
40709,53,32661,53,allow,221,75,146,2,30,1,1
47037,1,0,0,deny,62,62,0,1,0,1,0
63096,44847,0,0,deny,66,66,0,1,0,1,0
54651,445,0,0,drop,70,70,0,1,0,1,0
51990,42127,1528,42127,allow,66,66,0,1,5,1,0
56937,53,62951,53,allow,181,94,87,2,30,1,1
49855,53,48096,53,allow,177,94,83,2,30,1,1
51286,445,0,0,drop,70,70,0,1,0,1,0
52537,57866,0,0,deny,66,66,0,1,0,1,0
56757,445,0,0,drop,66,66,0,1,0,1,0
55738,53,4750,53,allow,309,94,215,2,30,1,1
56083,53,60591,53,allow,711,87,624,2,30,1,1
54305,39004,0,0,deny,62,62,0,1,0,1,0
55403,445,0,0,drop,70,70,0,1,0,1,0
52698,80,54306,80,allow,8280,5678,2602,25,111,14,11
64674,53,13295,53,allow,183,94,89,2,29,1,1
39714,443,60107,443,allow,922046,41258,880788,1106,218,498,608
56429,443,13104,443,allow,227145,7409,219736,252,146,86,166
39681,37965,0,0,deny,62,62,0,1,0,1,0
50828,123,0,0,deny,234,234,0,1,0,1,0
54347,443,29019,443,allow,9976,3230,6746,22,58,13,9
58118,445,0,0,drop,70,70,0,1,0,1,0
63810,443,22948,443,allow,8243,4867,3376,33,137,16,17
59679,445,0,0,drop,70,70,0,1,0,1,0
51388,443,52372,443,allow,20351,3359,16992,52,103,27,25
49865,443,26140,443,allow,5708,1025,4683,16,35,9,7
55563,53,20716,53,allow,290,118,172,2,30,1,1
49418,27016,14268,27016,allow,236,71,165,2,30,1,1
61860,10443,7961,10443,allow,10811,2571,8240,27,48,15,12
10627,23117,0,0,deny,66,66,0,1,0,1,0
56898,445,0,0,drop,70,70,0,1,0,1,0
2422,62507,0,0,deny,62,62,0,1,0,1,0
49664,37965,0,0,deny,66,66,0,1,0,1,0
65314,53,60905,53,allow,402,118,284,2,30,1,1
38380,80,38380,80,allow,5397,713,4684,14,16,8,6
49545,443,43829,443,allow,6606,936,5670,17,23,9,8
65453,445,0,0,drop,66,66,0,1,0,1,0
60885,443,21890,443,allow,3855,2679,1176,28,45,15,13
55883,53,56307,53,allow,181,94,87,2,31,1,1
56387,53,9036,53,allow,182,93,89,2,31,1,1
57122,53,58221,53,allow,198,94,104,2,30,1,1
11919,53,11919,53,allow,213,79,134,2,32,1,1
54346,44847,0,0,deny,66,66,0,1,0,1,0
60470,445,0,0,drop,70,70,0,1,0,1,0
54892,443,40724,443,allow,602278,26008,576270,748,396,317,431
57689,443,27070,443,allow,10855,1786,9069,32,180,15,17
29787,37965,0,0,deny,62,62,0,1,0,1,0
47910,7461,0,0,deny,60,60,0,1,0,1,0
12107,22114,0,0,deny,66,66,0,1,0,1,0
58638,5900,0,0,deny,62,62,0,1,0,1,0
1025,35447,0,0,deny,62,62,0,1,0,1,0
1025,35447,0,0,deny,62,62,0,1,0,1,0
64387,37965,0,0,deny,66,66,0,1,0,1,0
53986,53,63410,53,allow,306,306,0,4,47,4,0
5831,22114,0,0,deny,62,62,0,1,0,1,0
63857,445,0,0,drop,70,70,0,1,0,1,0
60291,53,5136,53,allow,78,78,0,1,30,1,0
52973,57470,0,0,deny,74,74,0,1,0,1,0
51544,4545,51544,4545,allow,156,156,0,3,8,3,0
64414,53,13029,53,allow,183,94,89,2,29,1,1
55989,53,49458,53,allow,205,86,119,2,30,1,1
64862,53,53283,53,allow,211,110,101,2,30,1,1
61030,445,0,0,drop,66,66,0,1,0,1,0
54774,445,0,0,drop,70,70,0,1,0,1,0
45832,51050,0,0,deny,66,66,0,1,0,1,0
57657,445,0,0,drop,66,66,0,1,0,1,0
51045,445,0,0,drop,70,70,0,1,0,1,0
53367,445,0,0,drop,66,66,0,1,0,1,0
47342,36237,0,0,deny,62,62,0,1,0,1,0
49966,53,59809,53,allow,166,86,80,2,30,1,1
55485,53,64726,53,allow,212,102,110,2,30,1,1
40204,40014,35119,40014,allow,141,79,62,2,31,1,1
45535,25174,0,0,deny,66,66,0,1,0,1,0
49718,53,39555,53,allow,793,101,692,2,30,1,1
50050,53,17602,53,allow,253,87,166,4,52,2,2
38723,37838,0,0,deny,146,146,0,1,0,1,0
64020,53,31935,53,allow,196,102,94,2,29,1,1
52935,443,46702,443,allow,1769338,65258,1704080,1935,1200,735,1200
63469,64147,0,0,deny,62,62,0,1,0,1,0
64636,53,17069,53,allow,166,86,80,2,31,1,1
58013,80,34784,80,allow,3877,2069,1808,15,26,9,6
0,0,0,0,allow,600,306,294,6,0,3,3
50552,445,0,0,drop,70,70,0,1,0,1,0
56948,53,61880,53,allow,183,94,89,2,30,1,1
56754,445,0,0,drop,70,70,0,1,0,1,0
62051,11392,0,0,deny,62,62,0,1,0,1,0
65009,53,56985,53,allow,737,94,643,2,30,1,1
53910,445,0,0,drop,70,70,0,1,0,1,0
48817,1722,48817,1722,allow,158,158,0,1,1200,1,0
19270,56448,0,0,deny,78,78,0,1,0,1,0
26450,80,26450,80,allow,642,338,304,10,32,6,4
60165,80,45319,80,allow,1982,692,1290,8,15,5,3
53736,443,20137,443,allow,499,425,74,4,0,3,1
40631,53,40631,53,allow,262,107,155,2,30,1,1
48006,443,61488,443,allow,1429,1295,134,10,30,8,2
50584,8569,42866,8569,allow,1356,300,1056,6,1200,3,3
3996,57470,0,0,deny,62,62,0,1,0,1,0
10688,25174,0,0,deny,62,62,0,1,0,1,0
59436,22114,0,0,deny,66,66,0,1,0,1,0
61827,445,0,0,drop,70,70,0,1,0,1,0
4910,2149,0,0,deny,66,66,0,1,0,1,0
50288,53,30921,53,allow,764,102,662,2,30,1,1
56798,9571,0,0,deny,62,62,0,1,0,1,0
63542,15503,0,0,deny,62,62,0,1,0,1,0
53788,1,42504,1,allow,70,70,0,1,5,1,0
28668,8696,0,0,deny,60,60,0,1,0,1,0
4232,50584,0,0,deny,66,66,0,1,0,1,0
51879,38564,56529,38564,allow,70,70,0,1,5,1,0
49411,53,17691,53,allow,195,102,93,2,31,1,1
60483,445,0,0,drop,70,70,0,1,0,1,0
55123,445,0,0,drop,70,70,0,1,0,1,0
49231,445,0,0,drop,70,70,0,1,0,1,0
51652,445,0,0,drop,70,70,0,1,0,1,0
58944,443,12374,443,allow,5166,700,4466,16,15,7,9
38785,443,33251,443,allow,5206,3832,1374,23,25,13,10
60599,445,0,0,drop,70,70,0,1,0,1,0
443,48346,0,0,deny,81,81,0,1,0,1,0
52714,64147,0,0,deny,66,66,0,1,0,1,0
64716,53,1067,53,allow,195,102,93,2,30,1,1
36843,443,62939,443,allow,1988,1348,640,16,30,9,7
65266,53,21692,53,allow,216,110,106,2,30,1,1
37042,53,37042,53,allow,237,98,139,2,30,1,1
38383,51221,0,0,deny,62,62,0,1,0,1,0
55183,53,52172,53,allow,177,94,83,2,30,1,1
64389,53,21920,53,allow,244,94,150,2,30,1,1
53577,35894,0,0,deny,62,62,0,1,0,1,0
63073,53,51318,53,allow,304,86,218,2,30,1,1
65216,53,59898,53,allow,244,94,150,2,30,1,1
62277,445,0,0,drop,70,70,0,1,0,1,0
50073,443,21032,443,allow,9873,2384,7489,25,242,14,11
62214,445,0,0,drop,66,66,0,1,0,1,0
40685,80,25851,80,allow,1278,774,504,12,360,7,5
58031,443,14165,443,allow,1314,653,661,13,185,7,6
58424,52700,0,0,deny,66,66,0,1,0,1,0
60344,445,0,0,drop,70,70,0,1,0,1,0
56737,445,0,0,drop,70,70,0,1,0,1,0
62774,445,0,0,drop,66,66,0,1,0,1,0
50296,445,0,0,drop,66,66,0,1,0,1,0
59032,25174,0,0,deny,66,66,0,1,0,1,0
64956,53,26166,53,allow,196,102,94,2,30,1,1
59920,443,55787,443,allow,3063,1068,1995,12,134,6,6
47091,443,36299,443,allow,6326,4367,1959,31,144,17,14
63978,53,60357,53,allow,214,110,104,2,30,1,1
23331,53,23331,53,allow,242,98,144,2,30,1,1
48817,26484,48817,26484,allow,513,152,361,2,1200,1,1
65130,445,0,0,drop,70,70,0,1,0,1,0
56950,53,2496,53,allow,183,94,89,2,30,1,1
49845,53,47352,53,allow,194,102,92,2,30,1,1
46641,8100,62793,8100,allow,234,234,0,4,11,4,0
56688,443,37544,443,allow,32780,6864,25916,142,345,57,85
57853,64147,0,0,deny,66,66,0,1,0,1,0
49616,80,21429,80,allow,314,192,122,6,42,4,2
60571,443,5687,443,allow,8728,4031,4697,23,17,12,11
64776,25174,0,0,deny,66,66,0,1,0,1,0
55577,53,47306,53,allow,199,102,97,2,30,1,1
49902,443,13295,443,allow,7456,1591,5865,32,54,15,17
53469,36237,0,0,deny,62,62,0,1,0,1,0
62922,445,0,0,drop,66,66,0,1,0,1,0
53737,445,0,0,drop,70,70,0,1,0,1,0
65356,443,39597,443,allow,3122508,193850,2928658,4050,681,1740,2310
42574,53,42574,53,allow,262,106,156,2,32,1,1
57470,52339,38751,52339,allow,594,594,0,10,1199,10,0
5955,55160,0,0,deny,74,74,0,1,0,1,0
49418,27015,37811,27015,allow,236,78,158,2,30,1,1
49567,443,12074,443,allow,6260,3089,3171,27,142,13,14
39039,443,4727,443,allow,572,292,280,9,32,5,4
56468,53,1634,53,allow,180,94,86,2,30,1,1
51262,35440,0,0,deny,62,62,0,1,0,1,0
63233,443,64284,443,allow,1373,734,639,17,125,10,7
54693,445,0,0,drop,70,70,0,1,0,1,0
18950,50584,0,0,deny,62,62,0,1,0,1,0
46270,7700,51894,7700,allow,1440,956,484,15,35,8,7
9957,32480,0,0,deny,66,66,0,1,0,1,0
52641,445,0,0,drop,70,70,0,1,0,1,0
5228,3434,0,0,deny,1093,1093,0,1,0,1,0
61099,445,0,0,drop,70,70,0,1,0,1,0
51177,445,0,0,drop,70,70,0,1,0,1,0
53252,443,33448,443,allow,41435,6615,34820,85,193,46,39
16387,35583,0,0,deny,60,60,0,1,0,1,0
34687,443,63653,443,allow,3120,1862,1258,18,15,11,7
56181,445,0,0,drop,70,70,0,1,0,1,0
61410,80,27494,80,allow,297783,19995,277788,543,158,229,314
50265,57799,36521,57799,allow,1450,747,703,16,1200,9,7
56344,53,2417,53,allow,199,102,97,2,30,1,1
50169,445,0,0,drop,70,70,0,1,0,1,0
50487,3389,50487,3389,allow,6312,2620,3692,25,24,12,13
39646,44847,0,0,deny,146,146,0,1,0,1,0
54118,6004,0,0,deny,66,66,0,1,0,1,0
49885,443,30250,443,allow,4626083,113708,4512375,4382,213,1198,3184
50686,443,65474,443,allow,6586,1807,4779,23,360,12,11
50483,80,35746,80,allow,374,192,182,7,25,4,3
52936,445,0,0,drop,66,66,0,1,0,1,0
49929,443,35482,443,allow,2484,330,2154,12,136,5,7
20170,23,0,0,deny,60,60,0,1,0,1,0
57870,443,40542,443,allow,1373,734,639,17,125,10,7
56827,63710,0,0,deny,62,62,0,1,0,1,0
55842,80,22065,80,allow,1151,711,440,10,15,5,5
57731,445,0,0,drop,70,70,0,1,0,1,0
13423,56205,0,0,deny,62,62,0,1,0,1,0
53424,443,24039,443,allow,9953,1605,8348,35,18,19,16
64285,445,0,0,drop,70,70,0,1,0,1,0
57125,53,40271,53,allow,745,93,652,2,30,1,1
21173,37965,0,0,deny,145,145,0,1,0,1,0
64723,56205,0,0,deny,62,62,0,1,0,1,0
55570,44847,0,0,deny,62,62,0,1,0,1,0
46052,443,47336,443,allow,9815,5382,4433,51,237,20,31
51235,445,0,0,drop,70,70,0,1,0,1,0
63670,64097,0,0,deny,66,66,0,1,0,1,0
53735,443,34476,443,allow,499,425,74,4,0,3,1
48692,57470,0,0,deny,62,62,0,1,0,1,0
60004,445,0,0,drop,70,70,0,1,0,1,0
49850,443,7132,443,allow,7371,1564,5807,18,89,9,9
45908,33330,0,0,deny,60,60,0,1,0,1,0
65409,53,26325,53,allow,753,93,660,2,31,1,1
55351,53,4702,53,allow,1497,108,1389,4,53,2,2
60219,53,60219,53,allow,414,268,146,3,32,2,1
54440,26467,0,0,deny,66,66,0,1,0,1,0
54373,26467,0,0,deny,62,62,0,1,0,1,0
54443,445,0,0,drop,66,66,0,1,0,1,0
55281,53,62349,53,allow,94,94,0,1,30,1,0
49337,53,4969,53,allow,303,97,206,4,56,2,2
64332,53,6045,53,allow,167,86,81,2,30,1,1
64494,53,62617,53,allow,402,118,284,2,30,1,1
56980,53,43925,53,allow,701,88,613,2,30,1,1
49623,443,17482,443,allow,3972,2532,1440,18,80,10,8
6703,21247,0,0,deny,62,62,0,1,0,1,0
55967,53,41577,53,allow,209,110,99,2,30,1,1
47817,443,11040,443,allow,18158,2080,16078,34,122,19,15
49499,445,0,0,drop,70,70,0,1,0,1,0
55515,445,0,0,drop,70,70,0,1,0,1,0
55656,53,48878,53,allow,212,108,104,2,31,1,1
58836,44847,0,0,deny,70,70,0,1,0,1,0
45706,443,50703,443,allow,512213,34626,477587,741,147,283,458
59670,443,52276,443,allow,11549,6152,5397,28,156,16,12
51606,443,26654,443,allow,2895,2046,849,14,134,8,6
55358,445,0,0,drop,70,70,0,1,0,1,0
49346,53,23031,53,allow,228,110,118,2,30,1,1
57849,50584,0,0,deny,66,66,0,1,0,1,0
41541,25174,0,0,deny,66,66,0,1,0,1,0
54701,445,0,0,drop,66,66,0,1,0,1,0
56519,445,0,0,drop,70,70,0,1,0,1,0
56553,53,46585,53,allow,199,102,97,2,30,1,1
56006,53,22097,53,allow,200,102,98,2,30,1,1
57343,53,25885,53,allow,181,94,87,2,30,1,1
61609,25174,0,0,deny,146,146,0,1,0,1,0
64711,53,30437,53,allow,179,86,93,2,30,1,1
52092,445,0,0,drop,66,66,0,1,0,1,0
57252,53,53666,53,allow,183,94,89,2,30,1,1
65331,53,20706,53,allow,767,102,665,2,29,1,1
20198,17372,0,0,deny,62,62,0,1,0,1,0
63127,445,0,0,drop,66,66,0,1,0,1,0
51965,443,54764,443,allow,12738,5385,7353,37,67,21,16
40180,443,53378,443,allow,1310,649,661,13,184,7,6
1114,46824,0,0,deny,62,62,0,1,0,1,0
56884,53,27069,53,allow,177,94,83,2,30,1,1
38663,443,44632,443,allow,16002,4305,11697,60,138,29,31
60715,443,1663,443,allow,1716,1136,580,15,30,9,6
54012,445,0,0,drop,66,66,0,1,0,1,0
62103,443,43175,443,allow,6345,3495,2850,18,120,9,9
57389,445,0,0,drop,70,70,0,1,0,1,0
56015,53,29304,53,allow,195,102,93,2,30,1,1
1024,57470,0,0,deny,72,72,0,1,0,1,0
56986,53,34763,53,allow,259,87,172,4,36,2,2
49509,443,19603,443,allow,4091,1015,3076,15,27,8,7
65127,53,45861,53,allow,194,102,92,2,30,1,1
52238,445,0,0,drop,70,70,0,1,0,1,0
60191,445,0,0,drop,70,70,0,1,0,1,0
58692,445,0,0,drop,66,66,0,1,0,1,0
51705,22114,0,0,deny,62,62,0,1,0,1,0
42891,53,42891,53,allow,224,88,136,2,30,1,1
62044,445,0,0,drop,70,70,0,1,0,1,0
54355,445,0,0,drop,70,70,0,1,0,1,0
60402,47094,53695,47094,allow,320,140,180,6,7,3,3
62597,445,0,0,drop,70,70,0,1,0,1,0
47664,3389,47664,3389,allow,4575,2400,2175,20,19,11,9
53768,443,3588,443,allow,499,425,74,4,0,3,1
49868,445,0,0,drop,70,70,0,1,0,1,0
57127,53,64638,53,allow,193,102,91,2,30,1,1
58042,445,0,0,drop,66,66,0,1,0,1,0
58638,5900,0,0,deny,62,62,0,1,0,1,0
64502,53,21170,53,allow,199,102,97,2,30,1,1
52557,44847,0,0,deny,66,66,0,1,0,1,0
53113,443,2940,443,allow,11030,4292,6738,32,61,17,15
10088,37807,0,0,deny,66,66,0,1,0,1,0
6842,42873,0,0,deny,62,62,0,1,0,1,0
53599,47783,42378,47783,allow,618,432,186,9,17,6,3
2252,443,2252,443,allow,11489,1827,9662,25,23,15,10
0,0,0,0,deny,98,98,0,1,0,1,0
56383,445,0,0,drop,66,66,0,1,0,1,0
10002,80,8568,80,allow,3759,741,3018,15,45,8,7
59944,80,15920,80,allow,1052,612,440,10,15,5,5
59037,28370,0,0,deny,62,62,0,1,0,1,0
49665,53,12263,53,allow,194,99,95,2,30,1,1
26435,39004,0,0,deny,62,62,0,1,0,1,0
51890,31122,40957,31122,allow,70,70,0,2,8,2,0
53901,445,0,0,drop,70,70,0,1,0,1,0
55041,80,12804,80,allow,486,240,246,9,35,5,4
57260,51221,0,0,deny,66,66,0,1,0,1,0
32520,47993,0,0,deny,62,62,0,1,0,1,0
58035,80,7543,80,allow,4168,2906,1262,11,15,6,5
51479,25174,0,0,deny,66,66,0,1,0,1,0
61000,15503,0,0,deny,146,146,0,1,0,1,0
39453,15503,0,0,deny,74,74,0,1,0,1,0
64636,3389,64636,3389,allow,3424,1710,1714,16,32,8,8
59970,443,18481,443,allow,6720,1166,5554,22,360,11,11
6881,12999,32088,12999,allow,622,356,266,4,1201,2,2
13285,29892,0,0,deny,145,145,0,1,0,1,0
57288,53,1558,53,allow,354,94,260,2,30,1,1
10639,11392,0,0,deny,62,62,0,1,0,1,0
65507,443,3045,443,allow,453047,13340,439707,469,16,165,304
56944,35894,0,0,deny,62,62,0,1,0,1,0
51911,443,51829,443,allow,4456,2972,1484,38,211,20,18
56355,53,43280,53,allow,184,94,90,2,31,1,1
50004,443,10108,443,allow,8745,2603,6142,19,15,11,8
49234,8080,49234,8080,allow,2604,848,1756,13,136,7,6
60091,445,0,0,drop,70,70,0,1,0,1,0
51840,80,51840,80,allow,525257,17273,507984,531,26,183,348
56279,53,33232,53,allow,228,110,118,2,30,1,1
2437,23117,0,0,deny,62,62,0,1,0,1,0
46415,53,46415,53,allow,211,80,131,2,30,1,1
27005,27015,1536,27015,allow,883,126,757,2,30,1,1
36663,22114,0,0,deny,62,62,0,1,0,1,0
49713,53,16907,53,allow,184,94,90,2,30,1,1
35156,8635,35156,8635,allow,138,78,60,2,5,1,1
63367,445,0,0,drop,70,70,0,1,0,1,0
64483,445,0,0,drop,66,66,0,1,0,1,0
64758,53,44548,53,allow,311,102,209,2,30,1,1
58879,443,43164,443,allow,10439,1785,8654,25,85,10,15
53621,445,0,0,drop,70,70,0,1,0,1,0
63330,445,0,0,drop,66,66,0,1,0,1,0
49472,443,5541,443,allow,3897,1306,2591,17,158,9,8
49304,443,13306,443,allow,12436,7656,4780,41,17,23,18
55735,50584,0,0,deny,62,62,0,1,0,1,0
49554,445,0,0,drop,70,70,0,1,0,1,0
56104,53,19874,53,allow,210,110,100,2,30,1,1
62443,445,0,0,drop,70,70,0,1,0,1,0
1865,25174,0,0,deny,146,146,0,1,0,1,0
42460,443,50577,443,allow,2907,1719,1188,17,361,9,8
65417,443,43584,443,allow,2494,1643,851,17,25,9,8
51944,56205,0,0,deny,62,62,0,1,0,1,0
45964,55559,0,0,deny,60,60,0,1,0,1,0
45210,443,36516,443,allow,1699,1038,661,16,276,9,7
53130,443,53130,443,allow,3121,1764,1357,19,181,10,9
57344,53,11119,53,allow,969,86,883,2,30,1,1
50378,445,0,0,drop,70,70,0,1,0,1,0
58721,51505,0,0,deny,66,66,0,1,0,1,0
62233,445,0,0,drop,70,70,0,1,0,1,0
37075,3389,37075,3389,reset-both,293,223,70,4,1,3,1
64850,53,13429,53,allow,166,85,81,2,31,1,1
54485,80,18876,80,allow,130,70,60,2,15,1,1
7655,23,0,0,deny,60,60,0,1,0,1,0
38905,53,58412,53,allow,86,86,0,1,30,1,0
49355,53,6777,53,allow,168,86,82,2,29,1,1
53821,7788,40501,7788,allow,70,70,0,1,5,1,0
55855,445,0,0,drop,70,70,0,1,0,1,0
5926,25174,0,0,deny,62,62,0,1,0,1,0
59685,443,5373,443,allow,2316,1353,963,17,276,9,8
56647,80,55289,80,allow,234,234,0,4,12,4,0
57908,443,7958,443,allow,1648,1017,631,18,124,10,8
57236,445,0,0,drop,70,70,0,1,0,1,0
54966,53,59029,53,allow,255,88,167,4,32,2,2
53667,49160,27701,49160,allow,320,140,180,6,7,3,3
64700,53,35656,53,allow,239,86,153,2,29,1,1
49768,80,40790,80,allow,254,128,126,5,15,3,2
21133,54508,26359,54508,allow,323,150,173,2,1199,1,1
52056,50328,41814,50328,allow,70,70,0,1,4,1,0
64366,53,57312,53,allow,234,94,140,2,30,1,1
61153,445,0,0,drop,66,66,0,1,0,1,0
56313,53,15835,53,allow,196,100,96,2,30,1,1
26791,443,23053,443,allow,21391,16334,5057,38,20,21,17
58699,445,0,0,drop,70,70,0,1,0,1,0
62854,445,0,0,drop,70,70,0,1,0,1,0
57170,53,47776,53,allow,200,102,98,2,30,1,1
58459,445,0,0,drop,70,70,0,1,0,1,0
27005,49000,39068,49000,allow,887,126,761,2,30,1,1
49418,53,51153,53,allow,379,93,286,4,37,2,2
50759,53,62224,53,allow,578,286,292,9,16,5,4
56627,445,0,0,drop,70,70,0,1,0,1,0
50348,80,25254,80,allow,4929,2773,2156,17,42,9,8
55661,445,0,0,drop,66,66,0,1,0,1,0
49845,53,6637,53,allow,188,96,92,2,31,1,1
51811,445,0,0,drop,70,70,0,1,0,1,0
65167,53,26450,53,allow,212,102,110,2,29,1,1
56343,53,26376,53,allow,194,102,92,2,29,1,1
54013,445,0,0,drop,70,70,0,1,0,1,0
51692,25565,11654,25565,allow,66,66,0,1,5,1,0
51827,445,0,0,drop,66,66,0,1,0,1,0
58149,445,0,0,drop,70,70,0,1,0,1,0
59303,21247,0,0,deny,66,66,0,1,0,1,0
57470,1337,52453,1337,allow,594,594,0,10,1199,10,0
62041,443,33913,443,allow,29329,6712,22617,54,60,23,31
62339,25174,0,0,deny,62,62,0,1,0,1,0
60743,445,0,0,drop,66,66,0,1,0,1,0
63832,6969,32926,6969,allow,70,70,0,1,5,1,0
60058,11392,0,0,deny,66,66,0,1,0,1,0
49777,53,60241,53,allow,272,84,188,4,60,2,2
52626,44847,0,0,deny,66,66,0,1,0,1,0
61414,445,0,0,drop,70,70,0,1,0,1,0
35626,22114,0,0,deny,66,66,0,1,0,1,0
28286,22114,0,0,deny,62,62,0,1,0,1,0
58638,5900,0,0,deny,62,62,0,1,0,1,0
56706,80,18045,80,allow,214,140,74,4,25,3,1
58638,5900,0,0,deny,62,62,0,1,0,1,0
51836,443,36494,443,allow,4927,986,3941,21,31,12,9
51953,37965,0,0,deny,66,66,0,1,0,1,0
61858,10443,43005,10443,allow,10747,2507,8240,26,48,14,12
52763,53,0,0,allow,641,87,554,2,30,1,1
55288,53,5668,53,allow,196,102,94,2,30,1,1
45941,23386,0,0,deny,60,60,0,1,0,1,0
56553,443,45538,443,allow,116577,6817,109760,137,62,54,83
49418,27015,12957,27015,allow,271,78,193,2,31,1,1
53711,443,24841,443,allow,499,425,74,4,0,3,1
57167,53,27604,53,allow,195,102,93,2,30,1,1
49727,443,58320,443,allow,4116,972,3144,15,50,8,7
49469,443,43348,443,allow,8779,3672,5107,17,119,8,9
35461,44847,0,0,deny,146,146,0,1,0,1,0
56423,53,27855,53,allow,184,102,82,2,30,1,1
50672,80,28058,80,allow,1515,481,1034,11,16,6,5
58145,1433,58145,1433,allow,60,60,0,2,5,2,0
42981,44847,0,0,deny,62,62,0,1,0,1,0
57031,53,9800,53,allow,170,87,83,2,31,1,1
65530,53,21720,53,allow,167,86,81,2,30,1,1
57964,44847,0,0,deny,62,62,0,1,0,1,0
60510,445,0,0,drop,70,70,0,1,0,1,0
49812,443,22276,443,allow,6128,1356,4772,20,978,10,10
51439,445,0,0,drop,66,66,0,1,0,1,0
53035,443,43721,443,allow,3473,881,2592,13,121,6,7
62175,445,0,0,drop,70,70,0,1,0,1,0
56973,53,45728,53,allow,193,102,91,2,30,1,1
57470,16721,16664,16721,allow,163,163,0,1,1200,1,0
50579,53,23674,53,allow,179,94,85,2,30,1,1
52745,25174,0,0,deny,66,66,0,1,0,1,0
43639,443,43639,443,allow,4683,1776,2907,19,29,11,8
55651,53,20940,53,allow,199,102,97,2,30,1,1
42298,40035,3337,40035,allow,207,85,122,4,30,2,2
54023,443,2526,443,allow,7653,1188,6465,21,16,12,9
27008,443,27008,443,allow,1251,722,529,11,147,6,5
51393,445,0,0,drop,66,66,0,1,0,1,0
50286,443,3120,443,allow,8773,1538,7235,25,15,14,11
49718,443,25229,443,allow,4524,779,3745,13,52,6,7
56982,53,26329,53,allow,193,94,99,2,30,1,1
60435,80,6093,80,allow,1155,781,374,10,15,6,4
41741,443,53387,443,allow,5379,1424,3955,19,507,11,8
45079,31573,0,0,deny,66,66,0,1,0,1,0
44079,10387,0,0,deny,145,145,0,1,0,1,0
37715,53,37715,53,allow,235,90,145,2,32,1,1
49455,443,62985,443,allow,12386,1821,10565,23,33,11,12
55859,53,35635,53,allow,778,103,675,2,31,1,1
49390,53,24759,53,allow,204,104,100,2,31,1,1
60575,80,18847,80,allow,9034,1860,7174,17,16,8,9
45964,7776,0,0,deny,60,60,0,1,0,1,0
51698,63846,26436,63846,allow,66,66,0,1,5,1,0
50748,445,0,0,drop,70,70,0,1,0,1,0
61306,445,0,0,drop,70,70,0,1,0,1,0
51097,445,0,0,drop,70,70,0,1,0,1,0
59799,443,59799,443,allow,4666,1759,2907,19,28,11,8
37176,80,24453,80,allow,941,526,415,11,315,6,5
45340,443,58208,443,allow,2504,1442,1062,22,29,12,10
47876,443,34439,443,allow,996037,37114,958923,1187,271,459,728
40290,53,7159,53,allow,168,78,90,2,30,1,1
62824,37807,0,0,deny,66,66,0,1,0,1,0
55175,80,55175,80,allow,7452,1052,6400,20,22,11,9
59863,443,41870,443,allow,622,310,312,11,28,6,5
49914,53,39261,53,allow,815,95,720,2,30,1,1
56343,53,26546,53,allow,170,87,83,2,30,1,1
56687,53,1087,53,allow,225,110,115,2,30,1,1
40349,443,1831,443,allow,7128,1336,5792,22,83,11,11
59735,443,11235,443,allow,512,166,346,2,29,1,1
57470,1028,19810,1028,allow,350,163,187,2,1200,1,1
53977,443,23449,443,allow,3330,1694,1636,15,30,8,7
2394,55108,0,0,deny,159,159,0,1,0,1,0
19885,64147,0,0,deny,62,62,0,1,0,1,0
52815,80,10358,80,allow,1152,712,440,10,15,5,5
49181,53,64897,53,allow,168,86,82,2,30,1,1
49651,80,24642,80,allow,318,192,126,6,41,4,2
42510,53,42510,53,allow,237,91,146,2,32,1,1
58725,7302,0,0,deny,66,66,0,1,0,1,0
53734,445,0,0,drop,66,66,0,1,0,1,0
52373,445,0,0,drop,70,70,0,1,0,1,0
50752,445,0,0,drop,70,70,0,1,0,1,0
42034,28189,0,0,deny,62,62,0,1,0,1,0
0,0,0,0,allow,274,274,0,2,0,2,0
23226,53,23226,53,allow,217,82,135,2,33,1,1
53304,80,56632,80,allow,130,64,66,3,4,2,1
62780,35440,0,0,deny,66,66,0,1,0,1,0
63888,445,0,0,drop,70,70,0,1,0,1,0
62490,443,60258,443,allow,7206,4320,2886,16,120,8,8
53733,40599,48603,40599,allow,70,70,0,1,4,1,0
61143,443,58972,443,allow,6391,3788,2603,14,121,7,7
54271,80,5783,80,allow,6006,861,5145,18,19,10,8
49761,445,0,0,drop,70,70,0,1,0,1,0
49863,8100,2379,8100,allow,78,78,0,1,4,1,0
56717,53,46335,53,allow,178,94,84,2,31,1,1
56889,53,22522,53,allow,211,110,101,2,30,1,1
61425,80,54723,80,allow,214,140,74,4,41,3,1
2440,37807,0,0,deny,66,66,0,1,0,1,0
64898,53,46183,53,allow,209,94,115,2,29,1,1
27164,53,27164,53,allow,208,94,114,2,30,1,1
49511,445,0,0,drop,70,70,0,1,0,1,0
57760,445,0,0,drop,66,66,0,1,0,1,0
42298,40033,43978,40033,allow,245,182,63,2,30,1,1
54050,445,0,0,drop,70,70,0,1,0,1,0
50293,53,25447,53,allow,740,93,647,2,31,1,1
52425,443,26865,443,allow,6527,1142,5385,23,32,13,10
55851,53,26107,53,allow,167,86,81,2,31,1,1
58409,445,0,0,drop,66,66,0,1,0,1,0
59763,25604,0,0,deny,66,66,0,1,0,1,0
55743,53,57939,53,allow,165,86,79,2,30,1,1
2864,25174,0,0,deny,66,66,0,1,0,1,0
57668,445,0,0,drop,66,66,0,1,0,1,0
58638,5900,0,0,deny,62,62,0,1,0,1,0
55470,53,12953,53,allow,197,102,95,2,33,1,1
56858,445,0,0,drop,70,70,0,1,0,1,0
54104,445,0,0,drop,70,70,0,1,0,1,0
49218,443,54857,443,allow,590577,16239,574338,610,23,222,388
35616,21247,0,0,deny,146,146,0,1,0,1,0
53851,23650,26484,23650,allow,320,140,180,6,5,3,3
50252,53,7370,53,allow,165,86,79,2,30,1,1
64264,445,0,0,drop,70,70,0,1,0,1,0
55066,53,18793,53,allow,176,90,86,2,31,1,1
55344,445,0,0,drop,70,70,0,1,0,1,0
51489,445,0,0,drop,70,70,0,1,0,1,0
45941,23386,0,0,deny,60,60,0,1,0,1,0
38977,53,0,0,allow,82,82,0,2,40,2,0
64425,53,23618,53,allow,289,134,155,2,30,1,1
55308,53,65535,53,allow,194,94,100,2,30,1,1
3052,7302,0,0,deny,66,66,0,1,0,1,0
57204,53,13761,53,allow,183,94,89,2,30,1,1
27005,27237,41184,27237,allow,891,126,765,2,30,1,1
65497,443,27033,443,allow,392197,11800,380397,406,16,143,263
49464,445,0,0,drop,70,70,0,1,0,1,0
62390,445,0,0,drop,66,66,0,1,0,1,0
53707,445,0,0,drop,66,66,0,1,0,1,0
63914,32805,13245,32805,allow,70,70,0,1,4,1,0
57329,443,20931,443,allow,7472,2014,5458,29,16,16,13
44612,25174,0,0,deny,66,66,0,1,0,1,0
60370,443,62763,443,allow,6045,1834,4211,21,82,10,11
33292,50584,0,0,deny,66,66,0,1,0,1,0
10151,31964,38746,31964,allow,481,150,331,2,1200,1,1
62678,53,62678,53,allow,216,90,126,2,30,1,1
36835,443,45000,443,allow,9115,1269,7846,21,31,12,9
51081,443,32211,443,allow,6653,3225,3428,18,135,9,9
56963,53,36385,53,allow,199,102,97,2,30,1,1
36536,53,36536,53,allow,414,268,146,3,32,2,1
56956,443,35896,443,allow,4359,924,3435,15,59,9,6
38922,80,38922,80,allow,20984,1380,19604,34,15,18,16
55243,443,31338,443,allow,36501,26194,10307,76,71,47,29
52179,443,47721,443,allow,414,140,274,7,25,3,4
56750,53,56750,53,allow,217,87,130,2,30,1,1
43310,443,13938,443,allow,60,60,0,1,5,1,0
11951,45026,0,0,deny,60,60,0,1,0,1,0
56184,53,63317,53,allow,215,94,121,2,30,1,1
64698,53,34866,53,allow,211,102,109,2,30,1,1
49978,53,13448,53,allow,190,97,93,2,30,1,1
52167,445,0,0,drop,66,66,0,1,0,1,0
21482,22114,0,0,deny,62,62,0,1,0,1,0
58638,5900,0,0,deny,62,62,0,1,0,1,0
52143,37807,0,0,deny,66,66,0,1,0,1,0
43762,443,5128,443,allow,7775,1963,5812,22,77,13,9
36025,443,36025,443,allow,4585,1678,2907,19,29,11,8
58638,5900,0,0,deny,62,62,0,1,0,1,0
36387,443,45505,443,allow,7139,1751,5388,32,1372,10,22
63322,445,0,0,drop,70,70,0,1,0,1,0
36277,443,45497,443,allow,14212,8194,6018,38,104,21,17
47087,15000,40073,15000,allow,138,78,60,2,5,1,1
55386,37965,0,0,deny,66,66,0,1,0,1,0
40342,53,32234,53,allow,168,78,90,2,29,1,1
49283,445,0,0,drop,70,70,0,1,0,1,0
59262,80,59262,80,allow,94514,14468,80046,152,15,41,111
64813,53,27372,53,allow,176,90,86,2,30,1,1
58376,445,0,0,drop,70,70,0,1,0,1,0
38360,53,56266,53,allow,168,78,90,2,30,1,1
41246,443,49001,443,allow,78,78,0,1,5,1,0
56365,443,42336,443,allow,4850,2997,1853,20,234,12,8
64677,53,11788,53,allow,334,93,241,4,50,2,2
53834,15000,23428,15000,allow,130,70,60,2,6,1,1
65065,53,58024,53,allow,209,110,99,2,30,1,1
55566,443,9542,443,allow,8426,4752,3674,37,122,18,19
60288,445,0,0,drop,70,70,0,1,0,1,0
49808,445,0,0,drop,70,70,0,1,0,1,0
65003,57470,0,0,deny,78,78,0,1,0,1,0
50319,53,28862,53,allow,756,95,661,2,30,1,1
52084,30863,5581,30863,allow,70,70,0,1,5,1,0
56603,53,39210,53,allow,168,86,82,2,30,1,1
30923,12883,0,0,deny,157,157,0,1,0,1,0
56747,53,24796,53,allow,172,94,78,2,30,1,1
55739,53,43741,53,allow,215,102,113,2,30,1,1
16327,55442,0,0,deny,66,66,0,1,0,1,0
57382,53,23125,53,allow,184,94,90,2,29,1,1
57829,443,7967,443,allow,981499,39775,941724,1109,291,439,670
60079,445,0,0,drop,70,70,0,1,0,1,0
53213,443,51742,443,allow,8451,2320,6131,25,104,13,12
52190,80,11921,80,allow,3223,843,2380,12,30,7,5
45052,80,23641,80,allow,1539,553,986,10,14,6,4
56718,443,49535,443,allow,7940,1951,5989,20,15,11,9
45935,25,35960,25,allow,511,191,320,9,60,4,5
53268,445,0,0,drop,70,70,0,1,0,1,0
58444,445,0,0,drop,70,70,0,1,0,1,0
64968,53,21697,53,allow,250,102,148,2,31,1,1
60026,443,10175,443,allow,8382,2454,5928,44,86,26,18
15499,22114,0,0,deny,62,62,0,1,0,1,0
44455,53,21066,53,allow,221,75,146,2,30,1,1
59037,51505,0,0,deny,62,62,0,1,0,1,0
52248,9323,44483,9323,allow,210,70,140,4,8,2,2
61413,80,4426,80,allow,283970,23419,260551,574,158,255,319
57245,443,39703,443,allow,170452,9659,160793,224,68,97,127
55239,53,38143,53,allow,272,94,178,2,30,1,1
64850,53,42650,53,allow,192,98,94,2,31,1,1
34758,5228,2453,5228,allow,10206,2218,7988,36,4265,18,18
55828,53,3503,53,allow,178,91,87,2,30,1,1
64288,53,3103,53,allow,183,94,89,2,31,1,1
59454,53,0,0,allow,86,86,0,1,30,1,0
56592,445,0,0,drop,70,70,0,1,0,1,0
16387,20045,0,0,deny,60,60,0,1,0,1,0
52469,443,22069,443,allow,29896,14149,15747,61,209,35,26
61533,445,0,0,drop,70,70,0,1,0,1,0
62597,53,18771,53,allow,102,102,0,1,30,1,0
2267,53,1779,53,allow,204,118,86,2,31,1,1
65013,53,26292,53,allow,473,105,368,4,30,2,2
57286,443,36985,443,allow,134,60,74,3,10,2,1
56433,53,56287,53,allow,177,94,83,2,30,1,1
64742,53,40488,53,allow,194,94,100,2,31,1,1
12503,25174,0,0,deny,146,146,0,1,0,1,0
18950,50584,0,0,deny,62,62,0,1,0,1,0
52175,1101,27107,1101,allow,70,70,0,1,5,1,0
6931,55108,0,0,deny,139,139,0,1,0,1,0
51117,445,0,0,drop,66,66,0,1,0,1,0
53873,443,46663,443,allow,499,425,74,4,1,3,1
49631,53,64330,53,allow,198,102,96,2,33,1,1
55454,445,0,0,drop,66,66,0,1,0,1,0
32520,47993,0,0,deny,66,66,0,1,0,1,0
58638,5900,0,0,deny,62,62,0,1,0,1,0
62812,445,0,0,drop,66,66,0,1,0,1,0
58638,5900,58638,5900,allow,130,66,64,2,5,1,1
56939,80,26245,80,allow,194,128,66,4,31,3,1
48706,23393,0,0,deny,60,60,0,1,0,1,0
56489,445,0,0,drop,70,70,0,1,0,1,0
62873,445,0,0,drop,70,70,0,1,0,1,0
65117,53,25899,53,allow,230,94,136,2,30,1,1
57416,53,2716,53,allow,193,102,91,2,30,1,1
41508,53,41508,53,allow,244,98,146,2,32,1,1
53260,443,64697,443,allow,6136,1916,4220,28,15,16,12
55495,53,24897,53,allow,305,94,211,2,30,1,1
58152,445,0,0,drop,70,70,0,1,0,1,0
55155,53,64785,53,allow,183,94,89,2,29,1,1
65049,53,41682,53,allow,184,94,90,2,29,1,1
55035,443,8425,443,allow,5653,2347,3306,33,361,18,15
60431,443,1098,443,allow,3260,1646,1614,9,120,5,4
42595,443,30091,443,allow,190565,9979,180586,272,244,140,132
37569,443,62296,443,allow,97539,6936,90603,160,597,74,86
51944,445,0,0,drop,70,70,0,1,0,1,0
54283,445,0,0,drop,70,70,0,1,0,1,0
39359,15503,0,0,deny,74,74,0,1,0,1,0
57470,24409,44348,24409,allow,870,330,540,12,1501,6,6
55477,80,28863,80,allow,498,280,218,8,26,5,3
30188,49786,29335,49786,allow,502,150,352,2,1200,1,1
51311,22,51311,22,allow,5624,2099,3525,30,23,17,13
55934,53,0,0,allow,86,86,0,1,30,1,0
64835,53,41380,53,allow,179,94,85,2,30,1,1
10910,57866,0,0,deny,62,62,0,1,0,1,0
35460,35440,0,0,deny,62,62,0,1,0,1,0
56400,35440,0,0,deny,66,66,0,1,0,1,0
55346,443,44978,443,allow,13181,6041,7140,60,410,27,33
56406,53,15140,53,allow,213,102,111,2,30,1,1
59570,445,0,0,drop,70,70,0,1,0,1,0
64482,53,10257,53,allow,192,98,94,2,31,1,1
55633,54638,31495,54638,allow,504,318,186,8,15,5,3
60757,445,0,0,drop,66,66,0,1,0,1,0
54277,445,0,0,drop,70,70,0,1,0,1,0
60392,445,0,0,drop,70,70,0,1,0,1,0
61275,445,0,0,drop,66,66,0,1,0,1,0
52706,53,0,0,allow,82,82,0,2,40,2,0
55569,445,0,0,drop,70,70,0,1,0,1,0
42601,443,30864,443,allow,10845900,123386,10722514,8862,139,1081,7781
56601,53,16656,53,allow,239,94,145,2,31,1,1
52781,57470,0,0,deny,66,66,0,1,0,1,0
64135,53,40678,53,allow,196,102,94,2,30,1,1
57288,53,62463,53,allow,770,101,669,2,30,1,1
65250,22114,0,0,deny,66,66,0,1,0,1,0
60312,57470,0,0,deny,74,74,0,1,0,1,0
60806,51050,0,0,deny,62,62,0,1,0,1,0
38602,443,28302,443,allow,130,70,60,3,5,2,1
64052,445,0,0,drop,70,70,0,1,0,1,0
56449,445,0,0,drop,70,70,0,1,0,1,0
52212,80,6091,80,allow,366,246,120,6,34,4,2
47381,8305,0,0,deny,159,159,0,1,0,1,0
49278,53,60636,53,allow,200,94,106,2,30,1,1
50625,445,0,0,drop,70,70,0,1,0,1,0
64281,53,44626,53,allow,214,110,104,2,30,1,1
62699,445,0,0,drop,66,66,0,1,0,1,0
34936,30188,0,0,deny,66,66,0,1,0,1,0
58638,5900,0,0,deny,62,62,0,1,0,1,0
5222,7493,0,0,deny,66,66,0,1,0,1,0
56491,53,1431,53,allow,711,87,624,2,30,1,1
49408,445,0,0,drop,70,70,0,1,0,1,0
57851,445,0,0,drop,70,70,0,1,0,1,0
44856,51505,0,0,deny,62,62,0,1,0,1,0
61548,445,0,0,drop,70,70,0,1,0,1,0
52180,20121,7972,20121,allow,70,70,0,1,5,1,0
59587,445,0,0,drop,66,66,0,1,0,1,0
15503,48319,24114,48319,allow,481,150,331,2,1199,1,1
57023,445,0,0,drop,66,66,0,1,0,1,0
11136,15503,0,0,deny,62,62,0,1,0,1,0
56719,37807,0,0,deny,62,62,0,1,0,1,0
54106,80,38158,80,allow,78,78,0,1,5,1,0
53545,445,0,0,drop,66,66,0,1,0,1,0
64546,53,63352,53,allow,889,404,485,10,30,5,5
65012,32468,0,0,deny,66,66,0,1,0,1,0
63057,53,17577,53,allow,304,86,218,2,30,1,1
56178,443,35008,443,allow,12283477,390003,11893474,13073,164,4327,8746
55543,445,0,0,drop,66,66,0,1,0,1,0
55237,53,28991,53,allow,193,102,91,2,30,1,1
56046,53,40264,53,allow,193,102,91,2,30,1,1
26889,50265,0,0,deny,66,66,0,1,0,1,0
58949,445,0,0,drop,70,70,0,1,0,1,0
63750,63343,14942,63343,allow,66,66,0,1,5,1,0
46844,53,0,0,allow,82,82,0,1,31,1,0
39063,44847,0,0,deny,66,66,0,1,0,1,0
6712,123,0,0,deny,90,90,0,1,0,1,0
44354,80,44354,80,allow,250076,10158,239918,315,24,146,169
52093,443,48994,443,allow,3687037,41923,3645114,3002,34,534,2468
53458,443,20818,443,allow,7584,7094,490,14,123,7,7
51963,445,0,0,deny,66,66,0,1,0,1,0
49201,17852,9879,17852,allow,70,70,0,2,8,2,0
57337,443,40846,443,allow,1169,616,553,12,16,7,5
62225,445,0,0,drop,70,70,0,1,0,1,0
62454,443,55667,443,allow,18884,4117,14767,37,25,16,21
52383,445,0,0,drop,66,66,0,1,0,1,0
51957,445,0,0,drop,70,70,0,1,0,1,0
54053,443,54053,443,allow,1468,763,705,16,181,8,8
49632,53,3027,53,allow,199,102,97,2,31,1,1
59826,443,57652,443,allow,7284,1079,6205,29,53,13,16
48980,15000,3233,15000,allow,130,70,60,2,5,1,1
16376,35440,0,0,deny,146,146,0,1,0,1,0
65517,443,57866,443,allow,92117,4799,87318,107,15,43,64
55840,53,8081,53,allow,177,94,83,2,30,1,1
56433,80,35239,80,allow,17188,1559,15629,25,25,10,15
50749,445,0,0,drop,66,66,0,1,0,1,0
80,53945,0,0,deny,60,60,0,1,0,1,0
37234,44847,0,0,deny,66,66,0,1,0,1,0
54149,445,0,0,drop,66,66,0,1,0,1,0
63583,37965,0,0,deny,66,66,0,1,0,1,0
43916,21,0,0,deny,60,60,0,1,0,1,0
0,0,0,0,deny,156,156,0,2,0,2,0
49262,53,13310,53,allow,168,86,82,2,29,1,1
59411,37965,0,0,deny,62,62,0,1,0,1,0
56114,53,59313,53,allow,216,110,106,2,30,1,1
42135,443,55299,443,allow,6531,1249,5282,24,286,13,11
52944,53,19420,53,allow,168,78,90,2,30,1,1
41694,443,48276,443,allow,16107,3200,12907,35,362,17,18
55146,53,47576,53,allow,277,110,167,2,30,1,1
56381,53,46735,53,allow,196,102,94,2,31,1,1
45908,33330,45908,33330,allow,124,60,64,3,5,2,1
56971,53,47465,53,allow,195,102,93,2,30,1,1
50069,53,5416,53,allow,174,89,85,2,30,1,1
64036,53,28611,53,allow,360,93,267,4,57,2,2
46155,443,27543,443,allow,206090,6478,199612,211,170,69,142
51887,445,0,0,drop,66,66,0,1,0,1,0
49326,445,0,0,drop,70,70,0,1,0,1,0
49979,53,49459,53,allow,197,94,103,2,30,1,1
64741,53,21274,53,allow,198,86,112,2,29,1,1
64034,53,27312,53,allow,194,102,92,2,30,1,1
57235,53,3428,53,allow,212,102,110,2,30,1,1
63391,445,0,0,drop,70,70,0,1,0,1,0
52734,445,0,0,drop,70,70,0,1,0,1,0
54815,3389,54815,3389,allow,3424,1710,1714,16,31,8,8
38135,443,62915,443,allow,2568507,98538,2469969,2956,65,1228,1728
52957,445,0,0,drop,70,70,0,1,0,1,0
64216,53,1409,53,allow,183,94,89,2,30,1,1
56431,53,36582,53,allow,778,103,675,2,31,1,1
9280,443,36215,443,allow,4612,830,3782,16,27,9,7
50313,445,0,0,drop,66,66,0,1,0,1,0
50034,53,9396,53,allow,174,89,85,2,30,1,1
44208,26467,0,0,deny,62,62,0,1,0,1,0
64171,53,30410,53,allow,94,94,0,1,30,1,0
51685,57470,0,0,deny,62,62,0,1,0,1,0
25619,25174,0,0,deny,146,146,0,1,0,1,0
11842,35440,0,0,deny,62,62,0,1,0,1,0
56389,53,30370,53,allow,279,93,186,4,31,2,2
40590,443,36504,443,allow,2965,1650,1315,24,275,12,12
5588,5588,0,0,allow,3354,1792,1562,46,192,23,23
40453,443,6651,443,allow,5655,1614,4041,22,30,11,11
58839,445,0,0,drop,70,70,0,1,0,1,0
51441,443,28224,443,allow,322,66,256,6,16,2,4
60126,35440,0,0,deny,66,66,0,1,0,1,0
54380,60038,0,0,allow,66,66,0,1,90,1,0
63554,445,0,0,drop,70,70,0,1,0,1,0
19136,64147,0,0,deny,62,62,0,1,0,1,0
55428,443,63993,443,allow,74784,4781,70003,122,171,55,67
49717,443,12194,443,allow,20576,8959,11617,42,130,24,18
56459,53,5237,53,allow,177,94,83,2,30,1,1
62506,443,7984,443,allow,1326,876,450,11,32,6,5
53432,445,0,0,drop,66,66,0,1,0,1,0
55463,53,21645,53,allow,216,110,106,2,30,1,1
54955,445,0,0,drop,70,70,0,1,0,1,0
46287,443,19273,443,allow,7071,2628,4443,32,23,16,16
61520,23718,0,0,deny,66,66,0,1,0,1,0
49501,53,46075,53,allow,343,92,251,4,32,2,2
56492,443,53818,443,allow,6066,1016,5050,20,26,11,9
36225,443,18751,443,allow,638,350,288,10,26,6,4
64569,53,52034,53,allow,258,102,156,2,30,1,1
49420,53,3179,53,allow,170,87,83,2,31,1,1
64987,53,27930,53,allow,198,102,96,2,29,1,1
49633,53,11968,53,allow,168,86,82,2,30,1,1
52151,53,52151,53,allow,198,89,109,2,31,1,1
53142,47933,51357,47933,allow,698,320,378,10,17,6,4
58638,5900,0,0,deny,62,62,0,1,0,1,0
65070,80,65070,80,allow,145038,9857,135181,162,23,62,100
60476,55100,21039,55100,allow,70,70,0,2,8,2,0
62288,443,20087,443,allow,1638,776,862,22,120,11,11
58831,443,26619,443,allow,5167,700,4467,16,15,7,9
56703,443,53583,443,allow,8006,1986,6020,20,15,11,9
61856,443,61856,443,allow,4918,1626,3292,17,17,10,7
28009,36237,0,0,deny,146,146,0,1,0,1,0
41486,443,65300,443,allow,204,70,134,4,26,2,2
12909,47807,0,0,deny,148,148,0,1,0,1,0
57913,80,64220,80,allow,6515,1210,5305,15,23,8,7
59148,445,0,0,drop,66,66,0,1,0,1,0
64937,53,29678,53,allow,210,110,100,2,29,1,1
55192,53,5787,53,allow,178,94,84,2,31,1,1
55113,53,62881,53,allow,198,102,96,2,33,1,1
50017,53,58091,53,allow,195,102,93,2,31,1,1
60409,443,2686,443,allow,7925,1878,6047,26,66,12,14
63384,53,63384,53,allow,198,90,108,2,30,1,1
56869,17637,0,0,deny,66,66,0,1,0,1,0
55567,53,51894,53,allow,184,80,104,2,0,1,1
56661,53,9185,53,allow,297,102,195,4,34,2,2
56397,26467,0,0,deny,66,66,0,1,0,1,0
56954,445,0,0,drop,70,70,0,1,0,1,0
34424,53,34424,53,allow,235,90,145,2,33,1,1
49247,53,64384,53,allow,776,283,493,8,82,4,4
64105,6363,30786,6363,allow,66,66,0,2,8,2,0
57358,445,0,0,drop,70,70,0,1,0,1,0
36754,443,35340,443,allow,1320,822,498,16,41,9,7
57752,445,0,0,drop,70,70,0,1,0,1,0
46872,80,56165,80,allow,29218,27458,1760,36,22,24,12
54106,445,0,0,drop,70,70,0,1,0,1,0
56752,53,15313,53,allow,183,94,89,2,31,1,1
54752,31573,0,0,deny,66,66,0,1,0,1,0
48706,23393,0,0,deny,60,60,0,1,0,1,0
22220,25174,0,0,deny,62,62,0,1,0,1,0
9251,443,22776,443,allow,6132,767,5365,17,26,9,8
56020,53,29198,53,allow,711,87,624,2,30,1,1
2705,37,0,0,deny,60,60,0,1,0,1,0
49539,445,0,0,drop,70,70,0,1,0,1,0
42478,80,42478,80,allow,1913,1464,449,10,19,6,4
64805,445,0,0,drop,66,66,0,1,0,1,0
55531,445,0,0,drop,66,66,0,1,0,1,0
49483,53,49626,53,allow,172,88,84,2,30,1,1
57986,445,0,0,drop,66,66,0,1,0,1,0
60970,80,26224,80,allow,912,472,440,8,15,3,5
55072,53,31850,53,allow,168,86,82,2,31,1,1
64279,53,4406,53,allow,177,94,83,2,30,1,1
52080,80,40918,80,allow,27100,21684,5416,39,38,25,14
63981,53,13175,53,allow,199,102,97,2,29,1,1
65248,53,32569,53,allow,779,86,693,2,30,1,1
55019,53,59602,53,allow,299,110,189,4,31,2,2
55735,53,13880,53,allow,198,101,97,2,31,1,1
63855,80,40243,80,allow,4529,1221,3308,14,75,8,6
65385,53,9523,53,allow,227,110,117,2,30,1,1
58638,5900,0,0,deny,62,62,0,1,0,1,0
22240,22114,0,0,deny,62,62,0,1,0,1,0
65516,53,16518,53,allow,209,110,99,2,31,1,1
56753,44847,0,0,deny,146,146,0,1,0,1,0
55617,53,58686,53,allow,196,94,102,2,30,1,1
55193,53,10853,53,allow,177,94,83,2,29,1,1
36936,443,13188,443,allow,490,210,280,8,131,4,4
36366,443,13851,443,allow,6147,910,5237,18,16,10,8
5222,32859,0,0,deny,66,66,0,1,0,1,0
50934,443,50934,443,allow,5661,2414,3247,22,37,13,9
1039,53,1039,53,allow,644,90,554,2,30,1,1
56373,53,1027,53,allow,181,98,83,2,31,1,1
50921,443,40184,443,allow,9516,1896,7620,21,127,11,10
58638,5900,0,0,deny,62,62,0,1,0,1,0
58769,22114,0,0,deny,146,146,0,1,0,1,0
54922,445,0,0,drop,70,70,0,1,0,1,0
51282,445,0,0,drop,70,70,0,1,0,1,0
64801,445,0,0,drop,70,70,0,1,0,1,0
55745,53,56029,53,allow,199,102,97,2,30,1,1
49804,445,0,0,drop,70,70,0,1,0,1,0
5462,21247,0,0,deny,66,66,0,1,0,1,0
58638,5900,0,0,deny,62,62,0,1,0,1,0
34317,53,53292,53,allow,168,78,90,2,29,1,1
56322,53,24189,53,allow,209,110,99,2,30,1,1
43564,53,37702,53,allow,199,94,105,2,30,1,1
33215,37965,0,0,deny,62,62,0,1,0,1,0
55423,53,51640,53,allow,177,94,83,2,30,1,1
53536,443,47086,443,allow,7901,3483,4418,24,30,13,11
48790,443,60676,443,allow,7298,2661,4637,21,19,11,10
65060,35440,0,0,deny,62,62,0,1,0,1,0
65498,53,49564,53,allow,749,94,655,2,30,1,1
28618,53,13005,53,allow,236,86,150,2,30,1,1
56149,53,12166,53,allow,174,89,85,2,30,1,1
55227,53,15557,53,allow,183,102,81,2,31,1,1
53782,445,0,0,drop,70,70,0,1,0,1,0
57948,443,32601,443,allow,5914,1514,4400,23,15,12,11
51474,14914,0,0,deny,139,139,0,1,0,1,0
53200,443,25558,443,allow,1462,965,497,13,18,7,6
50951,80,50951,80,allow,514,246,268,9,42,5,4
45908,443,37140,443,allow,507235,15454,491781,534,136,188,346
57088,445,0,0,drop,70,70,0,1,0,1,0
64671,445,0,0,drop,70,70,0,1,0,1,0
55649,443,18027,443,allow,7045,2145,4900,18,136,8,10
52132,55014,54625,55014,allow,70,70,0,2,7,2,0
50681,443,36673,443,allow,6888,1380,5508,19,171,9,10
60421,6882,64164,6882,allow,70,70,0,2,8,2,0
65297,53,52505,53,allow,241,118,123,2,30,1,1
33405,37965,0,0,deny,62,62,0,1,0,1,0
57470,58125,57009,58125,allow,1572,664,908,14,1200,9,5
42731,23,0,0,deny,60,60,0,1,0,1,0
49290,53,14935,53,allow,184,94,90,2,31,1,1
60232,53,0,0,allow,202,86,116,2,29,1,1
32071,51221,0,0,deny,66,66,0,1,0,1,0
55512,23718,0,0,deny,66,66,0,1,0,1,0
42298,40013,37939,40013,allow,205,83,122,4,30,2,2
46383,443,46383,443,allow,4661,1754,2907,19,30,11,8
47342,36237,0,0,deny,66,66,0,1,0,1,0
54424,50584,0,0,deny,146,146,0,1,0,1,0
60087,443,43883,443,allow,5470,3223,2247,43,172,22,21
49628,443,14591,443,allow,12843,3808,9035,26,81,13,13
56510,445,0,0,drop,70,70,0,1,0,1,0
8933,56205,0,0,deny,62,62,0,1,0,1,0
57585,51221,0,0,deny,62,62,0,1,0,1,0
64964,53,59512,53,allow,197,102,95,2,31,1,1
50652,80,2519,80,allow,97934,5018,92916,124,20,55,69
65410,53,40006,53,allow,229,110,119,2,31,1,1
40967,1433,0,0,deny,60,60,0,1,0,1,0
36631,443,36631,443,allow,4568,1661,2907,19,29,11,8
54998,53,2972,53,allow,196,100,96,2,31,1,1
49530,53,54763,53,allow,265,102,163,2,30,1,1
58638,5900,0,0,deny,62,62,0,1,0,1,0
0,0,0,0,deny,156,156,0,2,0,2,0
63899,62015,4677,62015,allow,66,66,0,2,8,2,0
34413,443,27966,443,allow,8107,2200,5907,34,255,16,18
55991,53,41227,53,allow,183,94,89,2,30,1,1
8896,123,46598,123,allow,94,94,0,1,30,1,0
51910,60443,64340,60443,allow,70,70,0,2,8,2,0
49326,445,0,0,drop,66,66,0,1,0,1,0
52004,80,9207,80,allow,84657,4275,80382,105,19,45,60
6881,6881,0,0,deny,146,146,0,1,0,1,0
63027,35440,0,0,deny,62,62,0,1,0,1,0
55939,53,43027,53,allow,193,102,91,2,30,1,1
34932,38608,0,0,deny,62,62,0,1,0,1,0
56787,443,7195,443,allow,7877,1888,5989,20,15,11,9
53938,15926,50841,15926,allow,492,306,186,8,15,5,3
54976,15503,0,0,deny,66,66,0,1,0,1,0
51778,60565,25061,60565,allow,70,70,0,2,8,2,0
55593,445,0,0,drop,70,70,0,1,0,1,0
56004,53,34719,53,allow,177,94,83,2,30,1,1
47376,443,12829,443,allow,2944,778,2166,10,120,5,5
61793,445,0,0,drop,66,66,0,1,0,1,0
56586,53,39065,53,allow,177,94,83,2,30,1,1
3615,53,3615,53,allow,231,90,141,2,30,1,1
55598,41565,5694,41565,allow,70,70,0,1,5,1,0
62480,443,56428,443,allow,1326,876,450,11,26,6,5
60133,1,0,0,deny,66,66,0,1,0,1,0
21064,25174,0,0,deny,62,62,0,1,0,1,0
53648,31637,17348,31637,allow,70,70,0,2,7,2,0
46417,443,30278,443,allow,359878,6703,353175,325,36,88,237
64379,53,64379,53,allow,235,90,145,2,33,1,1
54916,445,0,0,drop,70,70,0,1,0,1,0
39065,443,4463,443,allow,3589,1251,2338,15,20,9,6
60878,443,39667,443,allow,31315,6036,25279,65,49,32,33
55289,53,47764,53,allow,446,94,352,4,44,2,2
60155,23718,0,0,deny,66,66,0,1,0,1,0
60287,53,28366,53,allow,168,78,90,2,29,1,1
55479,53,49461,53,allow,232,94,138,2,30,1,1
54772,445,0,0,drop,70,70,0,1,0,1,0
56843,53,63293,53,allow,177,94,83,2,30,1,1
39895,26467,0,0,deny,62,62,0,1,0,1,0
50338,445,0,0,drop,66,66,0,1,0,1,0
49797,53,57522,53,allow,306,94,212,2,30,1,1
50637,44847,0,0,deny,62,62,0,1,0,1,0
65131,445,0,0,drop,66,66,0,1,0,1,0
50178,53,59652,53,allow,178,94,84,2,29,1,1
17750,6881,35389,6881,allow,150,150,0,1,1200,1,0
49570,443,32958,443,allow,6360,2483,3877,20,16,10,10
65514,53,61722,53,allow,291,98,193,4,33,2,2
5588,5588,0,0,allow,3354,1792,1562,46,193,23,23
58253,445,0,0,drop,70,70,0,1,0,1,0
49567,80,10114,80,allow,2855,1388,1467,12,44,7,5
27860,23,0,0,deny,60,60,0,1,0,1,0
50045,53,44466,53,allow,168,86,82,2,31,1,1
36011,25174,0,0,deny,66,66,0,1,0,1,0
50311,443,2014,443,allow,133674,20935,112739,206,350,105,101
80,53945,0,0,deny,60,60,0,1,0,1,0
56837,445,0,0,drop,70,70,0,1,0,1,0
62424,37965,0,0,deny,66,66,0,1,0,1,0
53662,443,56042,443,allow,7471,2800,4671,21,76,13,8
52002,53,64717,53,allow,289,86,203,2,30,1,1
62298,445,0,0,drop,66,66,0,1,0,1,0
55830,53,59149,53,allow,164,84,80,2,31,1,1
41210,443,11454,443,allow,234,234,0,4,11,4,0
58962,80,58962,80,allow,22844,1529,21315,39,28,20,19
55171,53,40871,53,allow,199,102,97,2,30,1,1
59617,445,0,0,drop,70,70,0,1,0,1,0
58818,445,0,0,drop,70,70,0,1,0,1,0
44543,443,30865,443,allow,13478,2683,10795,36,104,19,17
64460,53,62568,53,allow,192,98,94,2,31,1,1
61447,445,0,0,drop,70,70,0,1,0,1,0
4323,64147,0,0,deny,66,66,0,1,0,1,0
55615,13826,16063,13826,allow,70,70,0,2,8,2,0
41980,443,47669,443,allow,11377,7703,3674,26,162,19,7
50827,80,8180,80,allow,35970,11674,24296,108,265,55,53
47342,36237,0,0,deny,66,66,0,1,0,1,0
64983,53,38581,53,allow,777,87,690,2,31,1,1
46093,32661,0,0,deny,74,74,0,1,0,1,0
61701,80,22637,80,allow,1495,954,541,13,47,8,5
58499,445,0,0,drop,70,70,0,1,0,1,0
50564,443,39683,443,allow,8182,1488,6694,23,133,13,10
65492,2323,0,0,deny,60,60,0,1,0,1,0
47975,443,46443,443,allow,8301,2172,6129,25,255,12,13
51576,443,46569,443,allow,400,70,330,6,25,1,5
50599,80,5247,80,allow,8601,6265,2336,18,26,10,8
4772,37965,0,0,deny,66,66,0,1,0,1,0
64708,445,0,0,drop,66,66,0,1,0,1,0
80,8562,0,0,deny,74,74,0,1,0,1,0
65469,53,29881,53,allow,195,102,93,2,31,1,1
27005,32036,64099,32036,allow,876,126,750,2,31,1,1
6881,35156,27681,35156,allow,509,150,359,2,1199,1,1
6889,48817,0,0,deny,143,143,0,1,0,1,0
60548,445,0,0,drop,70,70,0,1,0,1,0
5578,53,5578,53,allow,288,83,205,2,31,1,1
62425,445,0,0,drop,66,66,0,1,0,1,0
58329,62413,0,0,deny,62,62,0,1,0,1,0
32679,37965,0,0,deny,62,62,0,1,0,1,0
49384,53,31275,53,allow,178,91,87,2,31,1,1
32215,22114,0,0,deny,66,66,0,1,0,1,0
64351,445,0,0,drop,70,70,0,1,0,1,0
2267,53,43002,53,allow,204,118,86,2,30,1,1
61275,445,0,0,drop,70,70,0,1,0,1,0
57396,53,39255,53,allow,358,102,256,2,30,1,1
49418,27015,34985,27015,allow,239,71,168,2,31,1,1
60487,445,0,0,drop,66,66,0,1,0,1,0
60764,445,0,0,drop,66,66,0,1,0,1,0
123,123,46819,123,allow,184,94,90,2,29,1,1
45964,2225,0,0,deny,60,60,0,1,0,1,0
64950,53,55366,53,allow,183,94,89,2,30,1,1
65312,445,0,0,drop,70,70,0,1,0,1,0
56319,445,0,0,drop,66,66,0,1,0,1,0
55545,53,1793,53,allow,821,102,719,2,30,1,1
56705,445,0,0,drop,66,66,0,1,0,1,0
19473,61397,60276,61397,allow,323,150,173,2,1200,1,1
35556,53,63282,53,allow,168,78,90,2,30,1,1
1038,37965,0,0,deny,62,62,0,1,0,1,0
1903,43890,0,0,deny,66,66,0,1,0,1,0
64072,80,14418,80,allow,314,192,122,6,15,4,2
54085,443,49010,443,allow,4128,1929,2199,38,48,21,17
48070,443,9695,443,allow,10240,2295,7945,38,121,20,18
57103,53,61295,53,allow,193,102,91,2,29,1,1
45550,80,42274,80,allow,890,420,470,14,27,7,7
36731,80,36731,80,allow,514,246,268,9,75,5,4
53660,443,62189,443,allow,2955,864,2091,11,119,5,6
60797,28080,55300,28080,allow,70,70,0,1,5,1,0
59985,445,0,0,drop,70,70,0,1,0,1,0
55680,53,53324,53,allow,198,94,104,2,30,1,1
55635,53,13643,53,allow,177,94,83,2,30,1,1
64748,53,6781,53,allow,183,94,89,2,30,1,1
50385,80,53379,80,allow,28942,2526,26416,39,25,16,23
54657,443,15364,443,allow,7070,1030,6040,19,33,11,8
49386,64147,0,0,deny,62,62,0,1,0,1,0
62780,35440,0,0,deny,66,66,0,1,0,1,0
58255,50584,0,0,deny,62,62,0,1,0,1,0
64232,445,0,0,drop,66,66,0,1,0,1,0
50772,35440,0,0,deny,62,62,0,1,0,1,0
38710,80,33174,80,allow,190,70,120,4,17,2,2
50208,1688,43148,1688,allow,70,70,0,1,5,1,0
13794,3389,13794,3389,allow,3910,1805,2105,20,19,12,8
58900,5223,13059,5223,allow,160,86,74,2,6,1,1
59153,35440,0,0,deny,66,66,0,1,0,1,0
11967,57470,0,0,deny,62,62,0,1,0,1,0
55365,53,10129,53,allow,184,94,90,2,29,1,1
58343,23718,0,0,deny,66,66,0,1,0,1,0
34901,443,15952,443,allow,70,70,0,1,5,1,0
64881,445,0,0,drop,66,66,0,1,0,1,0
55025,53,14358,53,allow,183,94,89,2,31,1,1
50194,445,0,0,drop,70,70,0,1,0,1,0
49418,27015,56301,27015,allow,258,71,187,2,30,1,1
49966,53,36472,53,allow,182,102,80,2,30,1,1
57071,53,59373,53,allow,166,86,80,2,30,1,1
49798,53,23227,53,allow,196,102,94,2,30,1,1
52075,443,32298,443,allow,18579,9266,9313,49,198,25,24
8180,53,8180,53,allow,220,90,130,2,30,1,1
52206,59077,23195,59077,allow,316,136,180,6,9,3,3
61522,64147,0,0,deny,66,66,0,1,0,1,0
57220,445,0,0,drop,66,66,0,1,0,1,0
53876,445,0,0,drop,70,70,0,1,0,1,0
56619,445,0,0,drop,70,70,0,1,0,1,0
38980,17,0,0,deny,60,60,0,1,0,1,0
49629,53,2341,53,allow,198,102,96,2,29,1,1
10312,23117,0,0,deny,62,62,0,1,0,1,0
56467,445,0,0,drop,70,70,0,1,0,1,0
58901,445,0,0,drop,70,70,0,1,0,1,0
64123,53,16597,53,allow,325,102,223,2,30,1,1
27005,27015,45773,27015,allow,899,126,773,2,30,1,1
57484,30317,0,0,deny,62,62,0,1,0,1,0
38386,80,38386,80,allow,6261,833,5428,15,20,8,7
3478,61463,0,0,deny,967,967,0,1,0,1,0
58638,5900,58638,5900,allow,130,66,64,2,4,1,1
54533,445,0,0,drop,70,70,0,1,0,1,0
63900,42641,18797,42641,allow,504,382,122,8,16,6,2
56962,53,33318,53,allow,210,102,108,2,30,1,1
46707,443,23817,443,allow,9723,1780,7943,35,120,17,18
53980,445,0,0,drop,70,70,0,1,0,1,0
38941,443,59649,443,allow,13623,2693,10930,22,123,10,12
37578,443,36969,443,allow,7534,2392,5142,25,25,14,11
42046,443,15950,443,allow,10195,2175,8020,25,187,14,11
8168,443,8168,443,allow,10130,4701,5429,34,82,18,16
51822,445,0,0,drop,70,70,0,1,0,1,0
53779,37965,0,0,deny,66,66,0,1,0,1,0
63816,2073,29145,2073,allow,66,66,0,2,7,2,0
52026,12523,4758,12523,allow,70,70,0,1,4,1,0
41033,443,54265,443,allow,4974,2311,2663,29,79,15,14
57470,36670,48397,36670,allow,3570,1126,2444,28,1465,16,12
64036,23718,0,0,deny,62,62,0,1,0,1,0
64907,53,65054,53,allow,168,86,82,2,29,1,1
57061,53,24920,53,allow,197,94,103,2,29,1,1
49505,53,42199,53,allow,225,110,115,2,30,1,1
60439,53,58321,53,allow,70,70,0,1,30,1,0
65398,53,27490,53,allow,214,110,104,2,30,1,1
52037,80,5136,80,allow,366,240,126,7,25,5,2
57071,53,6792,53,allow,166,86,80,2,30,1,1
58972,57866,0,0,deny,62,62,0,1,0,1,0
62062,443,17723,443,allow,13499,2333,11166,24,137,10,14
51463,53,6551,53,allow,417,86,331,2,31,1,1
13372,50584,0,0,deny,66,66,0,1,0,1,0
62326,443,62326,443,allow,1210,637,573,14,51,7,7
52322,443,52322,443,allow,6926,828,6098,17,26,9,8
42722,56448,0,0,deny,70,70,0,1,0,1,0
53751,445,0,0,drop,70,70,0,1,0,1,0
55705,53,6400,53,allow,281,101,180,4,60,2,2
49558,445,0,0,drop,66,66,0,1,0,1,0
16387,63752,0,0,deny,60,60,0,1,0,1,0
52209,443,18180,443,allow,502469,15202,487267,580,97,193,387
53957,29970,1762,29970,allow,552,366,186,9,17,6,3
56307,52700,0,0,deny,66,66,0,1,0,1,0
65064,30188,0,0,deny,66,66,0,1,0,1,0
53209,445,0,0,drop,70,70,0,1,0,1,0
53757,445,0,0,drop,66,66,0,1,0,1,0
53605,443,11722,443,allow,8738,2628,6110,23,154,11,12
28009,36237,0,0,deny,62,62,0,1,0,1,0
41296,80,53379,80,allow,1056,682,374,10,15,6,4
58638,5900,0,0,deny,62,62,0,1,0,1,0
56237,80,56237,80,allow,44949,1017,43932,48,15,15,33
56820,19562,44411,19562,allow,316,136,180,6,6,3,3
54573,445,0,0,drop,66,66,0,1,0,1,0
64190,2767,0,0,deny,66,66,0,1,0,1,0
63092,46776,0,0,deny,78,78,0,1,0,1,0
61190,21247,0,0,deny,62,62,0,1,0,1,0
51734,59825,48074,59825,allow,70,70,0,1,5,1,0
62949,37965,0,0,deny,62,62,0,1,0,1,0
55089,53,1796,53,allow,199,102,97,2,30,1,1
60380,443,29465,443,allow,70,70,0,1,5,1,0
49784,445,0,0,drop,70,70,0,1,0,1,0
57165,34101,0,0,deny,62,62,0,1,0,1,0
0,0,0,0,allow,600,306,294,6,0,3,3
20706,37965,0,0,deny,62,62,0,1,0,1,0
55513,53,1888,53,allow,184,94,90,2,30,1,1
33849,53,34954,53,allow,336,231,105,3,30,2,1
1663,30188,0,0,deny,62,62,0,1,0,1,0
3800,5223,0,0,deny,146,146,0,1,0,1,0
52758,445,0,0,drop,70,70,0,1,0,1,0
50549,80,64687,80,allow,378,192,186,7,21,4,3
61043,57470,0,0,deny,78,78,0,1,0,1,0
64004,48339,7779,48339,allow,66,66,0,2,7,2,0
58638,5900,0,0,deny,62,62,0,1,0,1,0
56413,51221,0,0,deny,66,66,0,1,0,1,0
64546,53,29110,53,allow,183,94,89,2,30,1,1
64931,53,5623,53,allow,179,94,85,2,30,1,1
57595,80,64244,80,allow,2769,1396,1373,11,29,7,4
55666,53,45375,53,allow,211,102,109,2,30,1,1
7588,1962,0,0,deny,60,60,0,1,0,1,0
63314,57470,0,0,deny,66,66,0,1,0,1,0
29291,48983,0,0,deny,150,150,0,1,0,1,0
64449,53,62626,53,allow,249,94,155,2,30,1,1
55200,53,19804,53,allow,202,103,99,2,31,1,1
65346,53,42988,53,allow,183,94,89,2,29,1,1
56262,53,64499,53,allow,170,87,83,2,31,1,1
45214,443,34615,443,allow,6641,4617,2024,34,80,18,16
61911,1,0,0,deny,146,146,0,1,0,1,0
51108,53,64155,53,allow,168,78,90,2,30,1,1
60617,64147,0,0,deny,62,62,0,1,0,1,0
50376,445,0,0,drop,70,70,0,1,0,1,0
63464,443,53137,443,allow,5614,2964,2650,19,120,9,10
22924,25174,0,0,deny,146,146,0,1,0,1,0
65018,53,37688,53,allow,152,78,74,2,30,1,1
50448,443,27905,443,allow,10382,3262,7120,30,142,16,14
64877,53,24917,53,allow,182,93,89,2,31,1,1
51492,445,0,0,drop,70,70,0,1,0,1,0
55454,53,64127,53,allow,168,86,82,2,32,1,1
50664,445,0,0,drop,70,70,0,1,0,1,0
48186,51050,0,0,deny,62,62,0,1,0,1,0
21909,53,21909,53,allow,197,90,107,2,30,1,1
45472,8168,0,0,deny,62,62,0,1,0,1,0
63962,10115,10126,10115,allow,66,66,0,2,8,2,0
53508,445,0,0,drop,70,70,0,1,0,1,0
30960,45676,24387,45676,allow,396,396,0,7,3616,7,0
51468,445,0,0,drop,70,70,0,1,0,1,0
21772,443,21772,443,allow,17221,1314,15907,31,44,16,15
14397,37965,0,0,deny,62,62,0,1,0,1,0
55790,53,54535,53,allow,177,94,83,2,30,1,1
64794,80,22092,80,allow,22646,1660,20986,29,135,10,19
55637,53,12301,53,allow,209,110,99,2,30,1,1
56388,53,28613,53,allow,186,95,91,3,46,2,1
53871,443,15841,443,allow,7797,1807,5990,15,135,7,8
65524,445,0,0,drop,66,66,0,1,0,1,0
30960,45714,65388,45714,allow,330,330,0,6,3609,6,0
17344,62413,0,0,deny,62,62,0,1,0,1,0
37961,443,21395,443,allow,153,93,60,2,5,1,1
56596,53,43071,53,allow,194,102,92,2,30,1,1
53461,443,61462,443,allow,52988,3128,49860,67,48,26,41
64707,53,28396,53,allow,757,98,659,2,31,1,1
57240,53,1415,53,allow,180,94,86,2,30,1,1
10273,21247,0,0,deny,66,66,0,1,0,1,0
65130,53,25428,53,allow,646,200,446,6,62,3,3
49304,443,52179,443,allow,932965,16289,916676,768,65,148,620
56552,53,47161,53,allow,195,102,93,2,29,1,1
35485,443,29586,443,allow,1633,1038,595,14,34,8,6
41813,443,58792,443,allow,33072,3479,29593,71,98,38,33
60863,443,21124,443,allow,24452,12758,11694,39,129,23,16
49444,53,22362,53,allow,212,102,110,2,30,1,1
53406,50584,0,0,deny,66,66,0,1,0,1,0
60358,445,0,0,drop,70,70,0,1,0,1,0
9731,64147,0,0,deny,62,62,0,1,0,1,0
53550,1,56985,1,allow,70,70,0,2,8,2,0
37936,443,26226,443,allow,5463,1378,4085,16,145,10,6
57161,53,42229,53,allow,224,102,122,2,29,1,1
55503,53,13265,53,allow,200,102,98,2,30,1,1
20012,8443,0,0,deny,60,60,0,1,0,1,0
50584,51413,41920,51413,allow,475,150,325,2,1200,1,1
60767,443,60767,443,allow,2406,1218,1188,21,16,11,10
57013,53,17393,53,allow,178,94,84,2,30,1,1
64266,53,49573,53,allow,168,86,82,2,31,1,1
51612,443,60658,443,allow,5677,918,4759,18,15,10,8
56696,53,25639,53,allow,757,98,659,2,31,1,1
51014,445,0,0,drop,70,70,0,1,0,1,0
50324,53,1643,53,allow,754,94,660,2,31,1,1
57397,53,24712,53,allow,183,94,89,2,30,1,1
64716,53,33097,53,allow,385,134,251,2,30,1,1
56864,53,8861,53,allow,200,102,98,2,30,1,1
30188,63853,28721,63853,allow,502,150,352,2,1200,1,1
51879,443,43940,443,allow,4418,1116,3302,17,30,10,7
51418,53,32808,53,allow,168,78,90,2,30,1,1
55393,44512,0,0,deny,66,66,0,1,0,1,0
49493,445,0,0,drop,70,70,0,1,0,1,0
49914,443,22293,443,allow,12190,2075,10115,28,16,14,14
55156,53,47566,53,allow,256,87,169,4,37,2,2
9377,56205,0,0,deny,66,66,0,1,0,1,0
57621,445,0,0,drop,70,70,0,1,0,1,0
27110,22114,0,0,deny,60,60,0,1,0,1,0
55652,443,55652,443,allow,141647,19296,122351,203,55,102,101
38671,443,7350,443,allow,7897,3562,4335,19,16,10,9
27464,53,27464,53,allow,233,90,143,2,32,1,1
56172,53,12622,53,allow,253,87,166,4,29,2,2
53246,443,31450,443,allow,6066,1046,5020,20,69,11,9
63004,445,0,0,drop,66,66,0,1,0,1,0
55786,53,64576,53,allow,193,102,91,2,29,1,1
44320,443,12809,443,allow,7244,1861,5383,26,330,14,12
54672,443,53803,443,allow,7210,2267,4943,22,15,12,10
55006,445,0,0,drop,70,70,0,1,0,1,0
49807,53,0,0,allow,218,77,141,2,30,1,1
51614,443,28714,443,allow,3833,867,2966,14,16,9,5
57496,25174,0,0,deny,66,66,0,1,0,1,0
58638,5900,0,0,deny,62,62,0,1,0,1,0
56406,443,10804,443,allow,8328,1391,6937,18,123,10,8
46129,443,13770,443,allow,6255,1125,5130,26,413,9,17
58040,80,24098,80,allow,9984,5333,4651,21,25,10,11
56272,53,59359,53,allow,167,86,81,2,31,1,1
9226,57470,0,0,deny,66,66,0,1,0,1,0
50422,53,50422,53,allow,194,87,107,2,30,1,1
64683,53,49305,53,allow,821,102,719,2,29,1,1
80,9918,0,0,deny,60,60,0,1,0,1,0
49287,53,21721,53,allow,405,90,315,4,59,2,2
49254,445,0,0,drop,66,66,0,1,0,1,0
57840,53,57840,53,allow,183,82,101,2,30,1,1
58409,445,0,0,drop,70,70,0,1,0,1,0
64728,443,31234,443,allow,25423484,377367,25046117,21027,1082,2865,18162
56131,53,31536,53,allow,245,94,151,2,30,1,1
57363,53,32810,53,allow,178,94,84,2,30,1,1
2954,443,2954,443,allow,6915,882,6033,16,149,9,7
54755,445,0,0,drop,70,70,0,1,0,1,0
24375,12809,0,0,deny,60,60,0,1,0,1,0
53265,443,57484,443,allow,4995,1414,3581,21,15,12,9
55722,53,10365,53,allow,229,110,119,2,30,1,1
50804,443,11310,443,allow,6337,1378,4959,19,140,9,10
56569,53,5839,53,allow,181,94,87,2,32,1,1
49438,443,63285,443,allow,18773,1492,17281,38,94,11,27
50950,80,33535,80,allow,942,527,415,11,342,6,5
26843,53,26843,53,allow,209,77,132,2,33,1,1
58535,30317,0,0,deny,62,62,0,1,0,1,0
61974,445,0,0,drop,70,70,0,1,0,1,0
49936,53,6002,53,allow,216,110,106,2,31,1,1
55933,64097,0,0,deny,62,62,0,1,0,1,0
24412,53,24412,53,allow,200,90,110,2,30,1,1
62330,445,0,0,drop,70,70,0,1,0,1,0
59523,37965,0,0,deny,62,62,0,1,0,1,0
60880,443,53335,443,allow,12278,1931,10347,32,56,18,14
37420,443,37420,443,allow,4624,1717,2907,19,27,11,8
57625,443,18316,443,allow,4751,909,3842,15,16,9,6
2837,25174,0,0,deny,66,66,0,1,0,1,0
443,45788,0,0,deny,332,332,0,1,0,1,0
49192,80,39568,80,allow,2807,587,2220,13,16,7,6
41197,30188,0,0,deny,62,62,0,1,0,1,0
38772,53,26700,53,allow,168,78,90,2,30,1,1
6880,31359,0,0,deny,107,107,0,1,0,1,0
56851,445,0,0,drop,70,70,0,1,0,1,0
58638,5900,0,0,deny,62,62,0,1,0,1,0
57642,80,57642,80,allow,220515,3488,217027,180,31,31,149
49987,53,51873,53,allow,253,86,167,2,30,1,1
61405,443,43963,443,allow,4810,2361,2449,34,80,16,18
51939,34393,42807,34393,allow,70,70,0,2,8,2,0
65511,443,62661,443,allow,430254,12640,417614,442,16,155,287
57331,53,30032,53,allow,172,94,78,2,30,1,1
53140,51221,0,0,deny,74,74,0,1,0,1,0
33087,443,44739,443,allow,13265,1924,11341,33,201,17,16
61482,443,17696,443,allow,49181,3553,45628,65,46,29,36
55829,53,27683,53,allow,177,94,83,2,29,1,1
20741,64147,0,0,deny,62,62,0,1,0,1,0
64074,34067,2832,34067,allow,312,132,180,6,6,3,3
53529,17130,52813,17130,allow,492,306,186,8,15,5,3
33845,80,39303,80,allow,424,210,214,7,27,4,3
63972,53,35839,53,allow,193,102,91,2,30,1,1
60797,445,0,0,drop,70,70,0,1,0,1,0
4025,53,4025,53,allow,230,90,140,2,30,1,1
60873,443,46332,443,allow,4265,1678,2587,21,142,10,11
52206,443,46301,443,allow,6278,682,5596,17,20,8,9
60387,32087,24462,32087,allow,320,140,180,6,7,3,3
49567,53,58916,53,allow,244,94,150,2,29,1,1
56515,53,36823,53,allow,177,94,83,2,30,1,1
51222,35440,0,0,deny,66,66,0,1,0,1,0
53013,445,0,0,drop,66,66,0,1,0,1,0
43479,443,6073,443,allow,6990,2019,4971,29,20,16,13
60037,443,34987,443,allow,376301,13445,362856,452,102,198,254
34165,443,5648,443,allow,8208,2080,6128,24,81,14,10
55776,53,40395,53,allow,216,110,106,2,29,1,1
27005,27020,4875,27020,allow,898,126,772,2,30,1,1
50894,80,58930,80,allow,5900,751,5149,15,130,7,8
55125,53,47085,53,allow,177,94,83,2,30,1,1
18113,22114,0,0,deny,62,62,0,1,0,1,0
52245,445,0,0,drop,70,70,0,1,0,1,0
64883,53,45539,53,allow,292,94,198,4,57,2,2
50710,443,41434,443,allow,6141,1268,4873,22,18,12,10
65185,27126,57830,27126,allow,268,78,190,2,30,1,1
6881,35045,1586,35045,allow,475,150,325,2,1200,1,1
59355,445,0,0,drop,66,66,0,1,0,1,0
55069,443,55069,443,allow,4517,1610,2907,19,27,11,8
49765,53,24395,53,allow,194,102,92,2,31,1,1
52236,25174,0,0,deny,66,66,0,1,0,1,0
63139,53,41966,53,allow,78,78,0,1,30,1,0
55288,445,0,0,drop,70,70,0,1,0,1,0
55847,445,0,0,drop,70,70,0,1,0,1,0
61495,37965,0,0,deny,66,66,0,1,0,1,0
55318,53,46114,53,allow,711,87,624,2,31,1,1
50445,445,0,0,drop,70,70,0,1,0,1,0
27005,27016,25142,27016,allow,883,126,757,2,30,1,1
49715,53,16817,53,allow,184,94,90,2,30,1,1
39684,443,56331,443,allow,5150,853,4297,16,34,9,7
49708,53,46475,53,allow,193,102,91,2,30,1,1
52560,445,0,0,drop,66,66,0,1,0,1,0
56760,443,12477,443,allow,8006,1986,6020,20,15,11,9
3234,80,3234,80,allow,12425,835,11590,19,17,8,11
55984,53,2333,53,allow,216,102,114,2,30,1,1
42566,53,42566,53,allow,216,98,118,2,30,1,1
56439,53,22707,53,allow,177,94,83,2,29,1,1
50672,445,0,0,deny,70,70,0,1,0,1,0
49941,443,34505,443,allow,8754,2895,5859,26,16,15,11
64117,80,61513,80,allow,5827,773,5054,16,73,9,7
54778,22114,0,0,deny,66,66,0,1,0,1,0
58384,445,0,0,drop,70,70,0,1,0,1,0
23274,50584,0,0,deny,62,62,0,1,0,1,0
12986,64147,0,0,deny,62,62,0,1,0,1,0
53202,443,56977,443,allow,23323,1589,21734,27,85,10,17
27869,51221,0,0,deny,66,66,0,1,0,1,0
443,60496,0,0,deny,320,320,0,1,0,1,0
59977,445,0,0,drop,70,70,0,1,0,1,0
49475,7000,49475,7000,allow,3546,2043,1503,16,15,9,7
49418,32036,34122,32036,allow,243,78,165,2,30,1,1
52010,53,28769,53,allow,218,85,133,2,30,1,1
49324,445,0,0,drop,70,70,0,1,0,1,0
53971,55442,0,0,deny,66,66,0,1,0,1,0
56420,443,5096,443,allow,9876,5607,4269,66,122,35,31
51673,445,0,0,drop,70,70,0,1,0,1,0
55418,445,0,0,drop,70,70,0,1,0,1,0
55353,53,1525,53,allow,168,86,82,2,30,1,1
53270,443,48173,443,allow,21684,2143,19541,38,322,16,22
50519,443,37665,443,allow,7967,1647,6320,25,85,14,11
51767,445,0,0,drop,70,70,0,1,0,1,0
51972,445,0,0,drop,70,70,0,1,0,1,0
52109,80,35580,80,allow,422,240,182,8,26,5,3
62053,445,0,0,drop,66,66,0,1,0,1,0
51993,25174,0,0,deny,66,66,0,1,0,1,0
58638,5900,0,0,deny,62,62,0,1,0,1,0
9248,80,12948,80,allow,844,778,66,6,15,5,1
55721,53,57546,53,allow,170,87,83,2,31,1,1
36065,443,10379,443,allow,3171,1490,1681,22,21,12,10
65498,53,36093,53,allow,202,103,99,2,31,1,1
60433,6881,42209,6881,allow,70,70,0,2,8,2,0
63878,445,0,0,drop,70,70,0,1,0,1,0
53709,15000,7812,15000,allow,320,140,180,6,7,3,3
45908,3383,0,0,deny,60,60,0,1,0,1,0
49688,443,44354,443,allow,318,192,126,6,53,4,2
62413,6881,56796,6881,allow,311,311,0,3,1200,3,0
57047,53,47290,53,allow,1426,98,1328,4,53,2,2
49305,57470,0,0,deny,66,66,0,1,0,1,0
64555,445,0,0,drop,70,70,0,1,0,1,0
61200,445,0,0,drop,70,70,0,1,0,1,0
52324,443,52324,443,allow,6727,762,5965,15,26,8,7
64847,445,0,0,drop,70,70,0,1,0,1,0
64531,53,60188,53,allow,183,94,89,2,30,1,1
52860,445,0,0,drop,66,66,0,1,0,1,0
60698,445,0,0,drop,70,70,0,1,0,1,0
50580,80,18240,80,allow,1513,694,819,10,15,5,5
50726,445,0,0,drop,70,70,0,1,0,1,0
53527,445,0,0,drop,70,70,0,1,0,1,0
62579,57866,0,0,deny,62,62,0,1,0,1,0
48706,23394,0,0,deny,60,60,0,1,0,1,0
53719,443,48486,443,allow,70,70,0,2,8,2,0
53819,445,0,0,drop,66,66,0,1,0,1,0
56403,53,56403,53,allow,244,98,146,2,32,1,1
58862,443,26650,443,allow,5167,700,4467,16,15,7,9
60049,25174,0,0,deny,66,66,0,1,0,1,0
49167,19750,0,0,deny,66,66,0,1,0,1,0
50265,443,33031,443,allow,23684,13193,10491,84,63,44,40
62099,445,0,0,drop,70,70,0,1,0,1,0
53498,3389,53498,3389,allow,3549,1594,1955,18,18,10,8
52496,445,0,0,drop,70,70,0,1,0,1,0
63921,23758,6337,23758,allow,312,132,180,6,7,3,3
46683,443,6885,443,allow,234,234,0,4,12,4,0
49734,80,8310,80,allow,88983,2379,86604,92,129,30,62
46587,443,46587,443,allow,30701,1538,29163,40,16,14,26
50596,443,51132,443,allow,9573,1963,7610,25,72,12,13
55222,443,38278,443,allow,5312,1510,3802,18,45,11,7
59062,445,0,0,drop,70,70,0,1,0,1,0
52223,11979,36766,11979,allow,70,70,0,2,9,2,0
59038,445,0,0,drop,70,70,0,1,0,1,0
55049,443,34090,443,allow,13661,4451,9210,32,46,18,14
49480,443,58193,443,allow,1160,638,522,13,113,7,6
64145,53,55779,53,allow,170,87,83,2,30,1,1
50201,53,18513,53,allow,751,95,656,2,31,1,1
62463,445,0,0,drop,70,70,0,1,0,1,0
52017,445,0,0,drop,66,66,0,1,0,1,0
0,0,0,0,deny,98,98,0,1,0,1,0
51939,53,4042,53,allow,222,94,128,2,30,1,1
44203,8055,0,0,deny,159,159,0,1,0,1,0
64924,53,49056,53,allow,292,126,166,2,30,1,1
60369,80,60369,80,allow,266818,12375,254443,285,34,107,178
50508,443,58389,443,allow,7588,1850,5738,19,25,10,9
50705,21,33829,21,allow,2222,983,1239,27,18,13,14
50142,445,0,0,drop,70,70,0,1,0,1,0
63200,445,0,0,drop,66,66,0,1,0,1,0
50689,445,0,0,drop,66,66,0,1,0,1,0
62486,443,21615,443,allow,10390,7057,3333,27,33,15,12
61221,35440,0,0,deny,66,66,0,1,0,1,0
51464,443,29786,443,allow,575,326,249,10,15,6,4
63527,445,0,0,drop,66,66,0,1,0,1,0
56098,64147,0,0,deny,66,66,0,1,0,1,0
58455,80,58455,80,allow,348,132,216,6,15,3,3
55095,445,0,0,drop,70,70,0,1,0,1,0
63853,10659,8048,10659,allow,70,70,0,1,4,1,0
27005,27018,49128,27018,allow,879,126,753,2,30,1,1
51117,60038,0,0,allow,66,66,0,1,90,1,0
56833,445,0,0,drop,70,70,0,1,0,1,0
57982,64147,0,0,deny,66,66,0,1,0,1,0
29016,25174,0,0,deny,146,146,0,1,0,1,0
56705,443,63668,443,allow,8007,1987,6020,20,15,11,9
50021,80,33696,80,allow,10026538,185017,9841521,9515,195,2989,6526
63823,445,0,0,drop,66,66,0,1,0,1,0
60675,445,0,0,drop,66,66,0,1,0,1,0
55310,445,0,0,drop,66,66,0,1,0,1,0
55962,53,37019,53,allow,193,102,91,2,30,1,1
45941,23386,0,0,deny,60,60,0,1,0,1,0
59745,25174,0,0,deny,62,62,0,1,0,1,0
23283,53,47679,53,allow,344,78,266,2,30,1,1
50119,443,16718,443,allow,15168,5689,9479,51,34,27,24
46259,80,22858,80,allow,3574,1669,1905,17,186,10,7
63807,445,0,0,drop,70,70,0,1,0,1,0
55068,445,0,0,drop,70,70,0,1,0,1,0
42286,443,57060,443,allow,6021,1249,4772,20,23,11,9
22390,19473,0,0,deny,66,66,0,1,0,1,0
51458,445,0,0,drop,70,70,0,1,0,1,0
35061,80,46318,80,allow,15651782,355118,15296664,15172,45,5065,10107
43348,443,43348,443,allow,46356,1595,44761,52,17,15,37
50089,53,38993,53,allow,752,93,659,2,31,1,1
57987,56125,0,0,deny,90,90,0,1,0,1,0
49407,80,43999,80,allow,4878,1570,3308,19,165,10,9
54020,53,54020,53,allow,233,90,143,2,32,1,1
62592,443,27957,443,allow,11741,7040,4701,40,172,22,18
49913,445,0,0,drop,70,70,0,1,0,1,0
46440,443,14076,443,allow,8465,3202,5263,23,120,10,13
52791,25174,0,0,deny,66,66,0,1,0,1,0
51558,443,41569,443,allow,254,70,184,5,22,2,3
58638,5900,0,0,deny,62,62,0,1,0,1,0
50584,6881,59238,6881,allow,901,166,735,2,1200,1,1
60594,445,0,0,drop,70,70,0,1,0,1,0
60067,443,11544,443,allow,14085,1879,12206,27,141,12,15
11585,56205,0,0,deny,66,66,0,1,0,1,0
13938,64147,0,0,deny,145,145,0,1,0,1,0
17750,6992,50842,6992,allow,150,150,0,1,1200,1,0
42951,443,65078,443,allow,6513,1609,4904,26,303,14,12
57183,53,5484,53,allow,199,94,105,2,29,1,1
49515,53,61596,53,allow,195,102,93,2,31,1,1
443,61686,0,0,deny,1484,1484,0,1,0,1,0
64900,53,45787,53,allow,197,102,95,2,30,1,1
64300,445,0,0,drop,70,70,0,1,0,1,0
6224,37965,0,0,deny,62,62,0,1,0,1,0
59810,445,0,0,drop,70,70,0,1,0,1,0
19875,30170,0,0,deny,145,145,0,1,0,1,0
53290,443,5427,443,allow,494,288,206,8,26,5,3
56393,443,8306,443,allow,25779,3436,22343,42,109,19,23
39483,443,14932,443,allow,3884,1859,2025,20,255,10,10
62112,443,63604,443,allow,4655,1649,3006,10,120,5,5
45941,23386,0,0,deny,60,60,0,1,0,1,0
55784,53,64875,53,allow,330,94,236,4,48,2,2
51109,11392,0,0,deny,62,62,0,1,0,1,0
23553,37965,0,0,deny,62,62,0,1,0,1,0
38077,80,35599,80,allow,1484,601,883,9,44,6,3
64891,53,17816,53,allow,211,102,109,2,30,1,1
7968,2767,0,0,deny,62,62,0,1,0,1,0
53378,443,65278,443,allow,5090,1692,3398,19,82,11,8
65446,445,0,0,drop,70,70,0,1,0,1,0
55791,53,26721,53,allow,770,101,669,2,30,1,1
56820,53,17754,53,allow,199,94,105,2,30,1,1
51868,30305,49639,30305,allow,70,70,0,2,8,2,0
63070,53,63583,53,allow,446,164,282,2,30,1,1
58286,20,58286,20,allow,100132,17467,82665,325,619,168,157
42066,443,21363,443,allow,377544,10569,366975,414,221,152,262
61163,443,25794,443,allow,8637,5348,3289,37,738,15,22
50365,445,0,0,drop,66,66,0,1,0,1,0
7877,22114,0,0,deny,66,66,0,1,0,1,0
46292,42873,0,0,deny,72,72,0,1,0,1,0
3093,62413,0,0,deny,62,62,0,1,0,1,0
53770,58120,33681,58120,allow,684,432,252,10,19,6,4
21145,11392,0,0,deny,146,146,0,1,0,1,0
59043,35440,0,0,deny,66,66,0,1,0,1,0
41210,443,59857,443,allow,78,78,0,1,5,1,0
64812,445,0,0,drop,66,66,0,1,0,1,0
51753,7000,51753,7000,allow,3638,2087,1551,17,15,10,7
60051,445,0,0,drop,66,66,0,1,0,1,0
46641,8100,13057,8100,allow,78,78,0,1,4,1,0
60868,445,0,0,drop,70,70,0,1,0,1,0
54985,443,28045,443,allow,23913,3495,20418,50,48,24,26
49777,53,52771,53,allow,216,110,106,2,30,1,1
50211,445,0,0,drop,70,70,0,1,0,1,0
56617,53,38232,53,allow,228,110,118,2,30,1,1
58482,445,0,0,drop,70,70,0,1,0,1,0
51203,445,0,0,drop,70,70,0,1,0,1,0
44519,443,58426,443,allow,716,428,288,11,26,7,4
63924,26328,47247,26328,allow,70,70,0,1,4,1,0
50806,445,0,0,drop,70,70,0,1,0,1,0
28007,443,40494,443,allow,31586,15587,15999,213,884,105,108
55896,53,29667,53,allow,733,94,639,2,30,1,1
26180,53,26180,53,allow,245,98,147,2,30,1,1
64072,53,31241,53,allow,292,110,182,2,30,1,1
62497,445,0,0,drop,70,70,0,1,0,1,0
62845,445,0,0,drop,66,66,0,1,0,1,0
14869,44847,0,0,deny,62,62,0,1,0,1,0
42644,443,8391,443,allow,8384,2161,6223,24,255,12,12
0,0,0,0,allow,320,320,0,5,0,5,0
55012,445,0,0,drop,70,70,0,1,0,1,0
50229,445,0,0,drop,66,66,0,1,0,1,0
54030,443,52354,443,allow,249900,26024,223876,450,167,183,267
60074,443,12733,443,allow,3465,818,2647,11,122,5,6
26082,26296,0,0,deny,159,159,0,1,0,1,0
46713,53,46713,53,allow,217,87,130,2,31,1,1
49771,53,64611,53,allow,272,110,162,2,30,1,1
45941,23386,0,0,deny,60,60,0,1,0,1,0
25857,57354,0,0,deny,145,145,0,1,0,1,0
56711,25174,0,0,deny,62,62,0,1,0,1,0
57879,445,0,0,drop,66,66,0,1,0,1,0
59725,443,21996,443,allow,304,86,218,2,31,1,1
49428,445,0,0,drop,66,66,0,1,0,1,0
53902,443,2298,443,allow,499,425,74,4,0,3,1
53626,30317,0,0,deny,66,66,0,1,0,1,0
49996,53,3311,53,allow,458,188,270,6,31,3,3
64888,60038,0,0,allow,66,66,0,1,91,1,0
51886,35965,55520,35965,allow,66,66,0,1,5,1,0
52503,50584,0,0,deny,66,66,0,1,0,1,0
51841,445,0,0,drop,70,70,0,1,0,1,0
7286,44847,0,0,deny,66,66,0,1,0,1,0
60410,80,39027,80,allow,186,64,122,4,27,2,2
64279,445,0,0,drop,70,70,0,1,0,1,0
57305,443,15646,443,allow,1574,1089,485,13,15,8,5
54418,22114,0,0,deny,66,66,0,1,0,1,0
58632,445,0,0,drop,66,66,0,1,0,1,0
40971,1433,0,0,deny,60,60,0,1,0,1,0
58638,5900,0,0,deny,62,62,0,1,0,1,0
44454,443,1457,443,allow,7092,1495,5597,22,31,12,10
50920,60182,0,0,deny,62,62,0,1,0,1,0
49160,57470,0,0,deny,146,146,0,1,0,1,0
50636,443,49176,443,allow,7332,1611,5721,17,15,9,8
37965,44056,39211,44056,allow,158,158,0,1,1199,1,0
46887,443,50848,443,allow,118,118,0,1,30,1,0
1025,50584,0,0,deny,62,62,0,1,0,1,0
49623,80,12161,80,allow,454,262,192,8,42,5,3
61896,34021,0,0,allow,66,66,0,1,91,1,0
37732,5007,0,0,deny,60,60,0,1,0,1,0
42686,443,38351,443,allow,190,70,120,4,15,2,2
65188,445,0,0,drop,70,70,0,1,0,1,0
9017,6881,0,0,deny,62,62,0,1,0,1,0
65417,44847,0,0,deny,66,66,0,1,0,1,0
24260,50584,0,0,deny,62,62,0,1,0,1,0
59618,46824,0,0,deny,66,66,0,1,0,1,0
54516,445,0,0,drop,70,70,0,1,0,1,0
59275,443,56019,443,allow,242735602,5306961,237428641,238334,3604,81340,156994
50292,80,5743,80,allow,442,250,192,8,44,5,3
59779,443,64471,443,allow,70,70,0,1,5,1,0
58179,443,33593,443,allow,7883,1768,6115,30,36,14,16
63966,42532,2551,42532,allow,70,70,0,1,4,1,0
57972,445,0,0,drop,66,66,0,1,0,1,0
25901,50265,0,0,deny,62,62,0,1,0,1,0
57186,53,42967,53,allow,177,94,83,2,30,1,1
64053,53,64715,53,allow,276,94,182,4,55,2,2
443,48346,0,0,deny,81,81,0,1,0,1,0
57351,53,34146,53,allow,184,94,90,2,30,1,1
37965,25180,40858,25180,allow,858,858,0,14,1199,14,0
49236,445,0,0,drop,70,70,0,1,0,1,0
62529,445,0,0,drop,70,70,0,1,0,1,0
50488,443,22994,443,allow,9765,2106,7659,27,83,14,13
56607,443,1098,443,allow,7862,1873,5989,20,15,11,9
55070,53,2161,53,allow,190,97,93,2,31,1,1
65153,53,10346,53,allow,241,118,123,2,30,1,1
52920,445,0,0,drop,66,66,0,1,0,1,0
49875,53,45365,53,allow,445,94,351,2,30,1,1
41625,15000,38798,15000,allow,130,70,60,2,5,1,1
36414,80,15964,80,allow,5046,4132,914,31,15,16,15
56442,445,0,0,drop,70,70,0,1,0,1,0
64856,53,10911,53,allow,755,93,662,2,31,1,1
59371,22114,0,0,deny,62,62,0,1,0,1,0
52314,443,46456,443,allow,3448,1612,1836,31,36,17,14
50478,80,37121,80,allow,2869,1173,1696,11,21,6,5
40923,53,40923,53,allow,200,90,110,2,29,1,1
56104,53,22926,53,allow,197,102,95,2,30,1,1
27005,30002,14816,30002,allow,1652,126,1526,4,31,2,2
52193,33027,51097,33027,allow,70,70,0,1,5,1,0
49477,53,35970,53,allow,172,88,84,2,30,1,1
51971,80,13099,80,allow,60753,2612,58141,76,46,34,42
49575,53,59647,53,allow,244,102,142,2,29,1,1
52698,445,0,0,drop,70,70,0,1,0,1,0
65026,445,0,0,drop,70,70,0,1,0,1,0
56169,53,21391,53,allow,210,110,100,2,30,1,1
55981,445,0,0,drop,70,70,0,1,0,1,0
53614,443,10121,443,allow,8347,1979,6368,32,19,17,15
49418,27015,22086,27015,allow,78,78,0,1,30,1,0
49418,27015,20912,27015,allow,302,78,224,2,30,1,1
56714,443,11426,443,allow,579769,15036,564733,578,61,199,379
55375,53,46240,53,allow,711,87,624,2,31,1,1
51236,443,52300,443,allow,7950,2502,5448,38,15,22,16
53171,445,0,0,drop,66,66,0,1,0,1,0
50041,443,6754,443,allow,17237,1717,15520,36,152,16,20
28809,50584,0,0,deny,66,66,0,1,0,1,0
23349,30188,0,0,deny,62,62,0,1,0,1,0
57076,53,47154,53,allow,184,94,90,2,30,1,1
40603,80,57176,80,allow,1104,475,629,10,15,6,4
50455,53,22933,53,allow,756,95,661,2,30,1,1
52514,23,0,0,deny,60,60,0,1,0,1,0
49629,26467,0,0,deny,66,66,0,1,0,1,0
49708,445,0,0,drop,70,70,0,1,0,1,0
57410,37965,0,0,deny,66,66,0,1,0,1,0
37578,443,38222,443,allow,499,425,74,4,0,3,1
41247,80,52056,80,allow,234,234,0,4,12,4,0
45941,23386,0,0,deny,60,60,0,1,0,1,0
57470,6881,62748,6881,allow,525,166,359,2,1200,1,1
61323,23117,0,0,deny,146,146,0,1,0,1,0
40242,443,42973,443,allow,7407,2516,4891,37,32,19,18
55021,53,44725,53,allow,179,94,85,2,30,1,1
58660,445,0,0,drop,70,70,0,1,0,1,0
55116,7574,0,0,deny,66,66,0,1,0,1,0
36369,51505,0,0,deny,66,66,0,1,0,1,0
26054,80,26054,80,allow,1798,540,1258,10,15,6,4
52211,56648,57880,56648,allow,70,70,0,2,8,2,0
56578,25174,0,0,deny,62,62,0,1,0,1,0
51833,47388,62543,47388,allow,70,70,0,1,5,1,0
65222,53,38822,53,allow,197,94,103,2,29,1,1
49395,53,16625,53,allow,315,90,225,4,32,2,2
53256,443,33969,443,allow,6181,1040,5141,22,65,11,11
60786,51505,0,0,deny,66,66,0,1,0,1,0
55217,445,0,0,drop,66,66,0,1,0,1,0
56748,35148,18439,35148,allow,66,66,0,1,5,1,0
49995,53,30507,53,allow,197,102,95,2,33,1,1
64516,53,8350,53,allow,216,110,106,2,30,1,1
53043,51050,0,0,deny,66,66,0,1,0,1,0
53260,53,10585,53,allow,199,94,105,2,30,1,1
49349,445,0,0,drop,66,66,0,1,0,1,0
50685,445,0,0,drop,70,70,0,1,0,1,0
54653,53,54653,53,allow,231,90,141,2,30,1,1
65257,445,0,0,drop,66,66,0,1,0,1,0
50343,80,49722,80,allow,22233,10123,12110,37,28,16,21
50235,5900,0,0,deny,60,60,0,1,0,1,0
53259,443,63565,443,allow,27501,3878,23623,57,54,24,33
64319,53,34050,53,allow,193,102,91,2,31,1,1
50584,18047,33742,18047,allow,851,369,482,5,1200,3,2
33651,36237,0,0,deny,146,146,0,1,0,1,0
58562,3389,58562,3389,allow,5387,1909,3478,22,21,10,12
12311,6881,0,0,deny,62,62,0,1,0,1,0
57057,445,0,0,drop,70,70,0,1,0,1,0
51999,34619,15741,34619,allow,70,70,0,1,5,1,0
27005,27016,36126,27016,allow,883,126,757,2,30,1,1
19052,7000,19052,7000,allow,2205,815,1390,13,16,7,6
55571,53,22113,53,allow,70,70,0,1,29,1,0
54316,445,0,0,drop,70,70,0,1,0,1,0
43016,53,43016,53,allow,235,90,145,2,32,1,1
45941,23386,0,0,deny,60,60,0,1,0,1,0
49477,53,20665,53,allow,178,94,84,2,30,1,1
36011,25174,0,0,deny,66,66,0,1,0,1,0
50933,80,44380,80,allow,9932735,85391,9847344,7875,123,1237,6638
51505,445,0,0,drop,66,66,0,1,0,1,0
56560,53,15895,53,allow,164,86,78,2,29,1,1
65060,53,21160,53,allow,324,97,227,4,52,2,2
50265,35344,29716,35344,allow,1386,1386,0,22,2342,22,0
39310,53,33057,53,allow,199,94,105,2,30,1,1
52166,26467,0,0,deny,66,66,0,1,0,1,0
64563,445,0,0,drop,70,70,0,1,0,1,0
51089,80,45189,80,allow,6240,4510,1730,40,131,22,18
45019,53,52189,53,allow,168,78,90,2,30,1,1
18754,30188,0,0,deny,66,66,0,1,0,1,0
56362,53,49796,53,allow,190,97,93,2,31,1,1
9289,443,57036,443,allow,9051,3480,5571,31,23,17,14
56214,53,47113,53,allow,200,102,98,2,33,1,1
32520,50265,0,0,deny,145,145,0,1,0,1,0
45189,443,22726,443,allow,10789,5723,5066,36,136,17,19
54134,64147,0,0,deny,66,66,0,1,0,1,0
59659,445,0,0,drop,70,70,0,1,0,1,0
56214,53,47362,53,allow,200,102,98,2,30,1,1
50729,443,32293,443,allow,10440,3521,6919,42,119,20,22
5060,37965,0,0,deny,66,66,0,1,0,1,0
57360,18375,0,0,deny,66,66,0,1,0,1,0
56067,25174,0,0,deny,146,146,0,1,0,1,0
49742,443,32248,443,allow,4490,750,3740,16,128,8,8
45944,44847,0,0,deny,62,62,0,1,0,1,0
42172,443,15822,443,allow,7071,1908,5163,29,944,14,15
52849,445,0,0,drop,70,70,0,1,0,1,0
57101,445,0,0,drop,70,70,0,1,0,1,0
11582,41599,27860,41599,allow,70,70,0,2,8,2,0
65028,53,41163,53,allow,265,94,171,2,30,1,1
53747,21698,30276,21698,allow,320,140,180,6,7,3,3
56154,53,34116,53,allow,291,94,197,2,29,1,1
57348,445,0,0,drop,66,66,0,1,0,1,0
58638,5900,0,0,deny,62,62,0,1,0,1,0
48557,37965,0,0,deny,62,62,0,1,0,1,0
49160,6889,59737,6889,allow,834,150,684,4,1200,2,2
55357,53,12869,53,allow,754,94,660,2,31,1,1
64559,445,0,0,drop,70,70,0,1,0,1,0
55650,18073,23998,18073,allow,504,318,186,8,15,5,3
59352,37965,0,0,deny,66,66,0,1,0,1,0
44496,57470,0,0,deny,66,66,0,1,0,1,0
33313,443,29395,443,allow,9675,2389,7286,43,143,21,22
56064,53,20414,53,allow,710,89,621,2,30,1,1
57917,44847,0,0,deny,66,66,0,1,0,1,0
53513,56205,0,0,deny,146,146,0,1,0,1,0
36099,443,35934,443,allow,5901,1324,4577,25,50,14,11
52184,443,13267,443,allow,13902,3253,10649,26,135,14,12
62156,445,0,0,drop,66,66,0,1,0,1,0
57392,443,58743,443,allow,12347,6378,5969,39,208,20,19
63923,59177,7249,59177,allow,66,66,0,2,7,2,0
13062,52274,0,0,deny,66,66,0,1,0,1,0
23131,25174,0,0,deny,62,62,0,1,0,1,0
49773,53,17034,53,allow,199,94,105,2,30,1,1
55639,53,59060,53,allow,196,102,94,2,30,1,1
65041,445,0,0,drop,70,70,0,1,0,1,0
64631,443,8739,443,allow,8701,3408,5293,48,256,22,26
65263,53,26647,53,allow,356,88,268,4,55,2,2
58427,53,30619,53,allow,197,94,103,2,30,1,1
52089,445,0,0,drop,70,70,0,1,0,1,0
0,0,0,0,deny,82,82,0,1,0,1,0
36327,80,6199,80,allow,1348,844,504,13,255,8,5
58996,445,0,0,drop,66,66,0,1,0,1,0
52838,445,0,0,drop,66,66,0,1,0,1,0
58398,44847,0,0,deny,66,66,0,1,0,1,0
61280,26467,0,0,deny,66,66,0,1,0,1,0
55372,53,44494,53,allow,199,102,97,2,30,1,1
37538,443,35991,443,allow,14826,7220,7606,53,94,29,24
50236,25174,0,0,deny,62,62,0,1,0,1,0
58244,445,0,0,drop,66,66,0,1,0,1,0
49495,443,44088,443,allow,9037,3596,5441,36,321,19,17
50264,445,0,0,drop,70,70,0,1,0,1,0
50798,36237,0,0,deny,146,146,0,1,0,1,0
55890,53,50894,53,allow,186,95,91,2,31,1,1
53318,22114,0,0,deny,66,66,0,1,0,1,0
54188,6004,0,0,deny,78,78,0,1,0,1,0
56037,53,8318,53,allow,246,102,144,2,30,1,1
57312,443,4774,443,allow,134,60,74,3,5,2,1
65405,53,50341,53,allow,560,104,456,4,43,2,2
49790,53,8407,53,allow,229,110,119,2,30,1,1
54447,443,59840,443,allow,9818,2008,7810,23,317,12,11
19699,48817,0,0,deny,143,143,0,1,0,1,0
39774,443,8618,443,allow,69542,11991,57551,139,157,60,79
55836,53,17150,53,allow,181,94,87,2,33,1,1
27005,27016,42584,27016,allow,1010,252,758,4,33,3,1
51880,51880,39901,51880,allow,582,270,312,8,32,4,4
6882,43825,33329,43825,allow,200,111,89,2,1200,1,1
52652,443,42861,443,allow,283768,16167,267601,384,116,148,236
64585,53,5921,53,allow,198,102,96,2,30,1,1
53532,445,0,0,drop,70,70,0,1,0,1,0
65176,53,13076,53,allow,299,103,196,4,51,2,2
53232,443,62934,443,allow,102629,3555,99074,114,58,40,74
8464,3389,8464,3389,allow,3910,1805,2105,20,18,12,8
53282,443,19856,443,allow,13300,1695,11605,27,321,12,15
49529,21247,0,0,deny,62,62,0,1,0,1,0
35790,443,59845,443,allow,6777,1527,5250,24,201,13,11
21502,44847,0,0,deny,66,66,0,1,0,1,0
37965,61282,39357,61282,allow,402,132,270,6,1208,3,3
50974,80,38911,80,allow,181877,8980,172897,207,22,87,120
64367,53,24939,53,allow,257,110,147,2,30,1,1
49214,443,4327,443,allow,17273,11238,6035,73,919,36,37
53693,26515,57249,26515,allow,70,70,0,1,4,1,0
54990,53,46533,53,allow,166,86,80,2,31,1,1
34782,443,56417,443,allow,15321,1796,13525,26,326,11,15
62059,443,14919,443,allow,11903,6327,5576,48,15,27,21
58638,5900,0,0,deny,62,62,0,1,0,1,0
53234,445,0,0,drop,70,70,0,1,0,1,0
57654,35440,0,0,deny,66,66,0,1,0,1,0
49733,443,61095,443,allow,204,70,134,4,26,2,2
55678,32468,0,0,deny,66,66,0,1,0,1,0
56298,445,0,0,drop,70,70,0,1,0,1,0
62854,445,0,0,drop,70,70,0,1,0,1,0
55220,80,9309,80,allow,1146,606,540,8,45,5,3
53135,14297,49248,14297,allow,70,70,0,1,5,1,0
46769,80,58026,80,allow,3589,2432,1157,17,86,9,8
59091,445,0,0,drop,70,70,0,1,0,1,0
56567,53,21156,53,allow,194,102,92,2,30,1,1
54820,445,0,0,drop,70,70,0,1,0,1,0
49418,27015,7927,27015,allow,295,78,217,2,31,1,1
59156,50584,0,0,deny,66,66,0,1,0,1,0
59394,443,52019,443,allow,5993,1987,4006,17,26,9,8
65116,53,4360,53,allow,214,110,104,2,30,1,1
62084,445,0,0,drop,70,70,0,1,0,1,0
63741,36776,9191,36776,allow,70,70,0,1,4,1,0
50609,445,0,0,drop,66,66,0,1,0,1,0
58638,5900,0,0,deny,62,62,0,1,0,1,0
50269,443,40163,443,allow,7543,2533,5010,26,55,14,12
443,52504,0,0,deny,97,97,0,1,0,1,0
63091,445,0,0,drop,70,70,0,1,0,1,0
49641,445,0,0,drop,70,70,0,1,0,1,0
51103,5223,3221,5223,allow,4968,1304,3664,26,1190,13,13
62232,80,47630,80,allow,1511,517,994,8,15,5,3
54897,445,0,0,drop,70,70,0,1,0,1,0
55701,55777,0,0,deny,62,62,0,1,0,1,0
50048,443,29440,443,allow,6887,2473,4414,20,15,11,9
44947,443,36944,443,allow,6359,4441,1918,33,80,17,16
58638,5900,0,0,deny,62,62,0,1,0,1,0
54166,25174,0,0,deny,62,62,0,1,0,1,0
51933,80,57196,80,allow,717,651,66,7,15,6,1
52707,443,49592,443,allow,39551,4663,34888,60,357,27,33
27480,443,15079,443,allow,11716,1007,10709,42,383,11,31
39208,53,0,0,allow,86,86,0,1,30,1,0
57473,445,0,0,drop,70,70,0,1,0,1,0
42922,80,60551,80,allow,78,78,0,1,4,1,0
59842,443,63853,443,allow,1307,666,641,15,46,7,8
40086,22114,0,0,deny,62,62,0,1,0,1,0
53871,43266,33475,43266,allow,70,70,0,2,7,2,0
30654,51221,0,0,deny,72,72,0,1,0,1,0
60978,443,39156,443,allow,1004246,35992,968254,1127,90,451,676
65486,53,8619,53,allow,193,102,91,2,30,1,1
34155,443,36605,443,allow,154,94,60,2,5,1,1
11761,443,11761,443,allow,5626,2487,3139,23,29,14,9
52115,445,0,0,drop,66,66,0,1,0,1,0
46193,53,56530,53,allow,311,86,225,2,30,1,1
64679,53,32723,53,allow,328,88,240,4,32,2,2
56982,80,63526,80,allow,214,140,74,4,35,3,1
64052,445,0,0,drop,66,66,0,1,0,1,0
45727,443,38522,443,allow,1625,1038,587,14,29,8,6
49853,445,0,0,drop,70,70,0,1,0,1,0
55851,445,0,0,drop,70,70,0,1,0,1,0
39119,44847,0,0,deny,62,62,0,1,0,1,0
51148,443,35605,443,allow,4332,1907,2425,18,136,8,10
50267,80,27570,80,allow,12364,548,11816,17,46,6,11
9087,37965,0,0,deny,62,62,0,1,0,1,0
55659,445,0,0,drop,70,70,0,1,0,1,0
61416,80,26249,80,allow,2366,764,1602,10,137,5,5
48817,1049,48817,1049,allow,334,158,176,2,1199,1,1
32282,8604,0,0,deny,62,62,0,1,0,1,0
64181,53,25731,53,allow,188,96,92,2,31,1,1
25010,30188,0,0,deny,62,62,0,1,0,1,0
62451,445,0,0,drop,70,70,0,1,0,1,0
51361,445,0,0,drop,70,70,0,1,0,1,0
56667,80,26674,80,allow,234,234,0,4,12,4,0
53660,445,0,0,drop,70,70,0,1,0,1,0
50613,445,0,0,drop,70,70,0,1,0,1,0
33305,54532,0,0,deny,60,60,0,1,0,1,0
64815,37965,0,0,deny,66,66,0,1,0,1,0
55328,445,0,0,drop,70,70,0,1,0,1,0
53104,445,0,0,drop,70,70,0,1,0,1,0
65220,53,42472,53,allow,245,94,151,2,30,1,1
63050,445,0,0,drop,66,66,0,1,0,1,0
61661,53,61661,53,allow,235,90,145,2,33,1,1
53537,34901,47127,34901,allow,672,426,246,11,21,7,4
50512,24748,0,0,deny,145,145,0,1,0,1,0
64065,445,0,0,drop,70,70,0,1,0,1,0
59021,443,44226,443,allow,4596,1442,3154,24,154,11,13
62306,53,46053,53,allow,387,94,293,2,30,1,1
61962,53733,0,0,deny,66,66,0,1,0,1,0
56379,53,17881,53,allow,94,94,0,1,29,1,0
55590,445,0,0,drop,70,70,0,1,0,1,0
55988,53,26621,53,allow,353,94,259,2,30,1,1
64642,53,25504,53,allow,718,94,624,2,30,1,1
57202,53,54278,53,allow,293,94,199,4,43,2,2
51244,14984,0,0,deny,100,100,0,1,0,1,0
30580,50265,0,0,deny,62,62,0,1,0,1,0
49771,80,10429,80,allow,254,128,126,5,16,3,2
18091,23,0,0,deny,60,60,0,1,0,1,0
56144,53,15210,53,allow,177,94,83,2,30,1,1
54136,445,0,0,drop,66,66,0,1,0,1,0
58229,445,0,0,drop,66,66,0,1,0,1,0
58440,445,0,0,drop,70,70,0,1,0,1,0
40994,443,58076,443,allow,1396,735,661,14,80,8,6
51617,445,0,0,drop,70,70,0,1,0,1,0
51829,46209,37314,46209,allow,70,70,0,2,6,2,0
61829,443,61829,443,allow,280243,73972,206271,309,206,142,167
64393,53,13343,53,allow,183,94,89,2,31,1,1
51092,80,39250,80,allow,3974,2713,1261,34,131,19,15
54374,443,53616,443,allow,7402,1350,6052,24,16,13,11
50010,53,28513,53,allow,330,126,204,2,31,1,1
60891,443,59680,443,allow,4895,3822,1073,24,49,13,11
55745,445,0,0,drop,70,70,0,1,0,1,0
56131,53,17639,53,allow,238,87,151,2,30,1,1
52853,443,21647,443,allow,9582,3906,5676,21,135,10,11
35117,443,10765,443,allow,8866,4928,3938,26,121,13,13
57664,53,41830,53,allow,168,78,90,2,30,1,1
42417,22114,0,0,deny,62,62,0,1,0,1,0
63795,52376,47084,52376,allow,66,66,0,2,8,2,0
50497,443,60901,443,allow,1322,725,597,14,78,7,7
48817,61613,48817,61613,allow,490,149,341,2,1200,1,1
37790,443,42788,443,allow,448,78,370,6,25,1,5
57352,53,35059,53,allow,816,102,714,2,30,1,1
41908,1433,0,0,deny,60,60,0,1,0,1,0
53870,445,0,0,drop,70,70,0,1,0,1,0
3478,61463,0,0,deny,1292,1292,0,1,0,1,0
27005,52013,10619,52013,allow,901,126,775,2,31,1,1
54330,443,28162,443,allow,7329,3011,4318,30,127,14,16
53292,443,45740,443,allow,4028,2584,1444,18,80,10,8
54976,15503,0,0,deny,62,62,0,1,0,1,0
56168,445,0,0,drop,70,70,0,1,0,1,0
43314,443,48162,443,allow,6102,782,5320,17,67,8,9
50238,53,16273,53,allow,164,78,86,2,29,1,1
49810,445,0,0,drop,70,70,0,1,0,1,0
27005,37569,24806,37569,allow,892,126,766,2,30,1,1
47910,7461,0,0,deny,60,60,0,1,0,1,0
39192,80,42667,80,allow,62592,60966,1626,63,16,47,16
59180,445,0,0,drop,70,70,0,1,0,1,0
64755,31573,0,0,deny,62,62,0,1,0,1,0
60249,445,0,0,drop,66,66,0,1,0,1,0
40772,15503,0,0,deny,74,74,0,1,0,1,0
56912,445,0,0,drop,70,70,0,1,0,1,0
60904,443,17681,443,allow,2356,1309,1047,16,31,9,7
58638,5900,0,0,deny,62,62,0,1,0,1,0
41313,53,41313,53,allow,404,259,145,3,32,2,1
56255,445,0,0,drop,70,70,0,1,0,1,0
50270,445,0,0,drop,66,66,0,1,0,1,0
65292,53,4110,53,allow,195,102,93,2,30,1,1
51734,445,0,0,drop,70,70,0,1,0,1,0
52091,80,64640,80,allow,2825,716,2109,12,22,7,5
58638,5900,0,0,deny,62,62,0,1,0,1,0
53994,16605,15809,16605,allow,70,70,0,2,8,2,0
64899,53,12836,53,allow,199,102,97,2,29,1,1
55315,53,41500,53,allow,192,98,94,2,31,1,1
55990,445,0,0,drop,70,70,0,1,0,1,0
40099,23,0,0,deny,60,60,0,1,0,1,0
56219,53,32903,53,allow,762,101,661,2,31,1,1
51926,445,0,0,drop,70,70,0,1,0,1,0
55030,53,46316,53,allow,177,94,83,2,30,1,1
59155,445,0,0,drop,70,70,0,1,0,1,0
27005,1401,26580,1401,allow,864,126,738,2,30,1,1
58374,445,0,0,drop,70,70,0,1,0,1,0
51490,17500,0,0,deny,100,100,0,1,0,1,0
49610,53,48262,53,allow,241,94,147,2,30,1,1
65491,53,39082,53,allow,186,95,91,2,30,1,1
56703,80,22325,80,allow,41915,4128,37787,59,64,29,30
65246,53,13640,53,allow,767,102,665,2,30,1,1
52194,80,42397,80,allow,1151,711,440,10,15,5,5
62172,445,0,0,drop,70,70,0,1,0,1,0
39834,53,46672,53,allow,199,94,105,2,30,1,1
52451,56205,0,0,deny,66,66,0,1,0,1,0
64974,27054,45428,27054,allow,3142,1386,1756,8,31,4,4
60489,53151,64380,53151,allow,70,70,0,2,8,2,0
9166,53,9166,53,allow,244,98,146,2,32,1,1
53138,15048,65155,15048,allow,70,70,0,1,4,1,0
49657,80,55424,80,allow,1278,774,504,12,361,7,5
9203,443,1918,443,allow,318,192,126,6,17,4,2
59267,445,0,0,drop,70,70,0,1,0,1,0
59745,25174,0,0,deny,62,62,0,1,0,1,0
56115,445,0,0,drop,70,70,0,1,0,1,0
56468,53,3693,53,allow,180,94,86,2,30,1,1
64730,53,52714,53,allow,1152,86,1066,2,29,1,1
53874,443,50535,443,allow,499,425,74,4,1,3,1
50579,80,50579,80,allow,32612,18106,14506,83,24,47,36
50606,445,0,0,drop,66,66,0,1,0,1,0
51164,443,28609,443,allow,5040,2743,2297,34,185,18,16
58422,445,0,0,drop,66,66,0,1,0,1,0
57342,53,19842,53,allow,167,86,81,2,30,1,1
46116,51505,0,0,deny,62,62,0,1,0,1,0
49219,51237,3510,51237,allow,624,318,306,10,15,5,5
56091,53,32743,53,allow,738,86,652,2,31,1,1
60745,123,31928,123,allow,184,94,90,2,30,1,1
51754,18375,0,0,deny,66,66,0,1,0,1,0
50068,445,0,0,drop,66,66,0,1,0,1,0
64818,53,5282,53,allow,174,89,85,2,30,1,1
59546,445,0,0,drop,70,70,0,1,0,1,0
49989,53,14607,53,allow,778,103,675,2,30,1,1
27448,5222,60213,5222,allow,8039,1649,6390,41,357,13,28
56199,53,15227,53,allow,256,93,163,2,31,1,1
993,4264,0,0,deny,66,66,0,1,0,1,0
52089,443,56891,443,allow,4408,801,3607,16,34,8,8
54710,443,54710,443,allow,32709,8467,24242,54,20,29,25
50061,443,34942,443,allow,4819,2004,2815,22,80,11,11
443,38956,0,0,deny,82,82,0,1,0,1,0
54202,445,0,0,drop,66,66,0,1,0,1,0
59310,445,0,0,drop,66,66,0,1,0,1,0
57341,443,25399,443,allow,7551,2807,4744,42,26,22,20
56307,53,64603,53,allow,168,78,90,2,30,1,1
62150,23718,0,0,deny,66,66,0,1,0,1,0
52819,15503,0,0,deny,66,66,0,1,0,1,0
55497,53,23337,53,allow,184,102,82,2,29,1,1
10521,15503,0,0,deny,146,146,0,1,0,1,0
52643,15941,0,0,deny,66,66,0,1,0,1,0
65384,53,58692,53,allow,194,99,95,2,30,1,1
55678,5618,0,0,reset-both,145,145,0,1,0,1,0
21133,51413,43233,51413,allow,460,150,310,2,1200,1,1
49775,80,50741,80,allow,254,128,126,5,16,3,2
1024,25174,0,0,deny,62,62,0,1,0,1,0
53127,443,49935,443,allow,68982,15774,53208,113,45,42,71
58701,27030,9286,27030,allow,70,70,0,1,5,1,0
51806,445,0,0,drop,70,70,0,1,0,1,0
62373,445,0,0,drop,66,66,0,1,0,1,0
61731,445,0,0,drop,70,70,0,1,0,1,0
64230,445,0,0,drop,70,70,0,1,0,1,0
28795,37965,0,0,deny,62,62,0,1,0,1,0
61406,443,61406,443,allow,4529,1622,2907,19,27,11,8
53875,443,27415,443,allow,499,425,74,4,1,3,1
56187,445,0,0,drop,70,70,0,1,0,1,0
56628,53,54812,53,allow,789,110,679,2,30,1,1
64845,445,0,0,drop,70,70,0,1,0,1,0
49487,60043,0,0,deny,62,62,0,1,0,1,0
50179,445,0,0,drop,70,70,0,1,0,1,0
52949,445,0,0,drop,70,70,0,1,0,1,0
51191,26467,0,0,deny,66,66,0,1,0,1,0
6882,4443,56989,4443,allow,600,600,0,5,1200,5,0
42117,80,40456,80,allow,1056,682,374,10,15,6,4
56782,49135,53247,49135,allow,70,70,0,1,5,1,0
49518,53,65191,53,allow,167,86,81,2,30,1,1
49294,53,7678,53,allow,287,94,193,2,30,1,1
27005,27018,56521,27018,allow,1672,126,1546,4,30,2,2
2267,53,46205,53,allow,204,118,86,2,31,1,1
53799,53,39316,53,allow,213,78,135,2,30,1,1
55211,53,36249,53,allow,183,94,89,2,30,1,1
36145,443,14544,443,allow,1439,878,561,15,17,10,5
64216,53,64216,53,allow,220,100,120,2,30,1,1
64132,445,0,0,drop,66,66,0,1,0,1,0
55671,53,32686,53,allow,98,98,0,1,30,1,0
0,0,0,0,deny,98,98,0,1,0,1,0
14036,48817,0,0,deny,66,66,0,1,0,1,0
58661,443,49876,443,allow,2956,790,2166,10,120,5,5
56242,80,56242,80,allow,101354,1343,100011,89,15,19,70
56477,53,34733,53,allow,198,101,97,2,31,1,1
26435,39004,0,0,deny,62,62,0,1,0,1,0
54828,53,54828,53,allow,404,259,145,3,33,2,1
49369,53,17790,53,allow,246,94,152,2,30,1,1
45614,123,42191,123,allow,184,94,90,2,30,1,1
65244,53,43768,53,allow,170,87,83,2,30,1,1
60362,445,0,0,drop,70,70,0,1,0,1,0
49731,443,10101,443,allow,4484,1063,3421,15,25,7,8
49388,53,27609,53,allow,215,102,113,2,30,1,1
49421,443,54717,443,allow,5422,801,4621,21,173,9,12
2267,53,32602,53,allow,204,118,86,2,30,1,1
53155,445,0,0,drop,70,70,0,1,0,1,0
8194,21247,0,0,deny,62,62,0,1,0,1,0
54365,64147,0,0,deny,62,62,0,1,0,1,0
52125,49224,18364,49224,allow,70,70,0,2,8,2,0
58926,80,29286,80,allow,1291,887,404,8,89,5,3
56298,53,17699,53,allow,173,94,79,2,30,1,1
65049,53,32515,53,allow,204,104,100,2,31,1,1
64457,445,0,0,drop,70,70,0,1,0,1,0
59775,443,26264,443,allow,5024,2538,2486,23,15,13,10
58916,21247,0,0,deny,146,146,0,1,0,1,0
37485,161,0,0,allow,6435,2535,3900,22,30,11,11
51411,443,26944,443,allow,509,329,180,6,8,3,3
57087,445,0,0,drop,70,70,0,1,0,1,0
56729,53,56729,53,allow,229,89,140,2,31,1,1
45964,14444,0,0,deny,60,60,0,1,0,1,0
36682,443,16201,443,allow,4590,3104,1486,25,95,14,11
56395,443,25199,443,allow,7018,2751,4267,24,39,11,13
6057,51221,0,0,deny,78,78,0,1,0,1,0
57737,443,13855,443,allow,15625,4662,10963,25,123,11,14
51969,37558,33450,37558,allow,70,70,0,1,4,1,0
50912,443,28892,443,allow,8527,2387,6140,21,31,11,10
58424,52700,0,0,deny,66,66,0,1,0,1,0
18218,30349,0,0,deny,148,148,0,1,0,1,0
55180,445,0,0,drop,70,70,0,1,0,1,0
55647,53,47322,53,allow,711,87,624,2,30,1,1
53801,47933,40487,47933,allow,320,140,180,6,6,3,3
53127,443,41153,443,allow,13914,7812,6102,52,69,28,24
56078,53,11255,53,allow,168,86,82,2,30,1,1
49449,443,30580,443,allow,1574,921,653,14,15,7,7
49555,443,34197,443,allow,740109,22948,717161,800,54,311,489
51916,24596,6622,24596,allow,70,70,0,2,8,2,0
64935,53,15324,53,allow,193,102,91,2,31,1,1
52523,80,47280,80,allow,4302,3722,580,14,15,8,6
35466,443,44428,443,allow,7409,1702,5707,23,20,13,10
55276,53,58176,53,allow,177,94,83,2,30,1,1
53567,43167,28309,43167,allow,492,306,186,8,16,5,3
56613,443,29986,443,allow,7981,1961,6020,20,16,11,9
49518,445,0,0,drop,70,70,0,1,0,1,0
55867,53,63583,53,allow,184,94,90,2,31,1,1
61308,443,22375,443,allow,44341,5858,38483,102,195,42,60
59397,443,43163,443,allow,3218,1700,1518,16,15,8,8
50546,445,0,0,drop,66,66,0,1,0,1,0
65219,443,28202,443,allow,4748,2193,2555,14,135,7,7
5955,55160,0,0,deny,74,74,0,1,0,1,0
49907,53,29279,53,allow,308,92,216,2,30,1,1
64952,445,0,0,drop,70,70,0,1,0,1,0
62301,445,0,0,drop,70,70,0,1,0,1,0
59215,445,0,0,drop,70,70,0,1,0,1,0
54827,50432,0,0,deny,109,109,0,1,0,1,0
58900,443,22833,443,allow,8547,5209,3338,30,19,15,15
63945,53,52680,53,allow,216,110,106,2,31,1,1
56142,53,19071,53,allow,194,102,92,2,29,1,1
49785,53,52317,53,allow,211,110,101,2,30,1,1
60962,64147,0,0,deny,66,66,0,1,0,1,0
59882,443,38875,443,allow,10017,3031,6986,30,45,17,13
15296,37965,0,0,deny,62,62,0,1,0,1,0
53558,445,0,0,drop,66,66,0,1,0,1,0
5588,5588,0,0,allow,3498,1872,1626,48,201,24,24
54314,445,0,0,drop,70,70,0,1,0,1,0
443,5920,0,0,deny,66,66,0,1,0,1,0
49611,53,5356,53,allow,177,94,83,2,30,1,1
55053,443,17178,443,allow,6906,1283,5623,29,248,14,15
0,0,0,0,allow,480,244,236,4,0,2,2
49369,53,21146,53,allow,183,94,89,2,30,1,1
65528,53,44314,53,allow,168,86,82,2,30,1,1
443,10120,443,10120,allow,64,64,0,1,5,1,0
62466,53,62466,53,allow,194,87,107,2,30,1,1
50182,443,50182,443,allow,12509,1447,11062,28,122,16,12
64524,53,42733,53,allow,184,94,90,2,31,1,1
57015,25174,0,0,deny,66,66,0,1,0,1,0
56303,445,0,0,drop,70,70,0,1,0,1,0
64849,53,57025,53,allow,340,110,230,2,29,1,1
54519,445,0,0,drop,66,66,0,1,0,1,0
17777,30188,0,0,deny,62,62,0,1,0,1,0
56686,443,39990,443,allow,7941,1952,5989,20,16,11,9
30303,30303,0,0,deny,181,181,0,1,0,1,0
52599,445,0,0,drop,66,66,0,1,0,1,0
56962,53,9664,53,allow,177,94,83,2,30,1,1
59456,445,0,0,drop,66,66,0,1,0,1,0
34351,53,57036,53,allow,202,83,119,2,31,1,1
64650,53,46019,53,allow,193,94,99,2,30,1,1
47510,443,50202,443,allow,5149,852,4297,16,15,9,7
37208,443,37628,443,allow,9621,7389,2232,33,256,14,19
49835,53,19938,53,allow,194,102,92,2,30,1,1
59899,443,64399,443,allow,1401,864,537,12,30,6,6
57173,53,42104,53,allow,216,110,106,2,31,1,1
18652,64147,0,0,deny,62,62,0,1,0,1,0
57042,445,0,0,drop,70,70,0,1,0,1,0
56896,53,58642,53,allow,177,94,83,2,30,1,1
35051,80,55027,80,allow,350,210,140,6,30,4,2
55237,53,51535,53,allow,259,87,172,4,56,2,2
49659,53,53164,53,allow,730,102,628,2,30,1,1
33811,443,49179,443,allow,17406,8237,9169,53,165,21,32
37058,80,51116,80,allow,1056,682,374,10,15,6,4
56689,53,4538,53,allow,177,91,86,3,38,2,1
3478,61463,0,0,deny,942,942,0,1,0,1,0
49843,53,43292,53,allow,193,102,91,2,30,1,1
60104,30188,0,0,deny,66,66,0,1,0,1,0
54639,445,0,0,drop,70,70,0,1,0,1,0
443,45788,0,0,deny,199,199,0,1,0,1,0
57018,53,62434,53,allow,209,110,99,2,29,1,1
55926,53,60455,53,allow,184,94,90,2,30,1,1
50052,65008,0,0,deny,60,60,0,1,0,1,0
64685,445,0,0,drop,70,70,0,1,0,1,0
53827,443,32061,443,allow,499,425,74,4,0,3,1
53521,443,40751,443,allow,130,70,60,2,14,1,1
48991,80,63971,80,allow,121475,5644,115831,163,145,81,82
35558,15503,0,0,deny,66,66,0,1,0,1,0
59583,445,0,0,drop,70,70,0,1,0,1,0
49844,53,19437,53,allow,734,102,632,2,30,1,1
49995,53,4642,53,allow,99,99,0,1,30,1,0
50745,80,27446,80,allow,2977,680,2297,11,161,6,5
58638,5900,58638,5900,allow,126,62,64,2,5,1,1
49710,53,1886,53,allow,183,102,81,2,30,1,1
49456,443,8615,443,allow,10956,1757,9199,21,37,10,11
57748,15000,46693,15000,allow,130,70,60,2,5,1,1
59218,445,0,0,drop,70,70,0,1,0,1,0
58638,5900,0,0,deny,62,62,0,1,0,1,0
61637,53,32273,53,allow,82,82,0,2,31,2,0
51237,443,50232,443,allow,9668,4698,4970,42,16,25,17
62768,445,0,0,drop,70,70,0,1,0,1,0
443,3846,0,0,deny,100,100,0,1,0,1,0
44847,18659,47289,18659,allow,150,150,0,1,1200,1,0
55317,53,22104,53,allow,94,94,0,1,30,1,0
65057,53,8165,53,allow,211,94,117,2,30,1,1
64381,53,35709,53,allow,168,86,82,2,32,1,1
14993,50584,0,0,deny,62,62,0,1,0,1,0
64181,53,17159,53,allow,194,102,92,2,31,1,1
50655,80,2422,80,allow,2108,1167,941,10,20,6,4
53654,445,0,0,drop,66,66,0,1,0,1,0
64854,53,12372,53,allow,1431,101,1330,4,50,2,2
64266,53,53096,53,allow,1026,383,643,10,84,5,5
10430,22114,0,0,deny,146,146,0,1,0,1,0
56793,56205,0,0,deny,66,66,0,1,0,1,0
13484,37965,0,0,deny,66,66,0,1,0,1,0
64833,53,62978,53,allow,167,86,81,2,30,1,1
62616,445,0,0,drop,66,66,0,1,0,1,0
64669,53,24998,53,allow,198,94,104,2,30,1,1
50682,445,0,0,drop,70,70,0,1,0,1,0
62202,445,0,0,drop,70,70,0,1,0,1,0
49158,443,4149,443,allow,3655,1807,1848,17,15,9,8
64980,53,51851,53,allow,180,94,86,2,30,1,1
57258,53,33746,53,allow,215,102,113,2,30,1,1
60280,443,7130,443,allow,46713,2661,44052,55,120,21,34
51288,445,0,0,drop,70,70,0,1,0,1,0
44411,37965,0,0,deny,62,62,0,1,0,1,0
59080,445,0,0,drop,70,70,0,1,0,1,0
53389,23,0,0,deny,60,60,0,1,0,1,0
64489,445,0,0,drop,70,70,0,1,0,1,0
65038,53,49241,53,allow,173,94,79,2,31,1,1
63875,43485,59709,43485,allow,312,132,180,6,6,3,3
25523,35974,0,0,deny,62,62,0,1,0,1,0
49429,53,36318,53,allow,210,110,100,2,30,1,1
55945,53,48545,53,allow,177,94,83,2,30,1,1
57246,53,12706,53,allow,752,93,659,2,31,1,1
50282,445,0,0,drop,66,66,0,1,0,1,0
59589,445,0,0,drop,70,70,0,1,0,1,0
56259,53,56259,53,allow,244,98,146,2,32,1,1
60221,80,44120,80,allow,17981,13577,4404,41,151,26,15
55276,80,42794,80,allow,1594,1280,314,10,15,5,5
46262,123,34977,123,allow,184,94,90,2,30,1,1
28370,35440,0,0,deny,66,66,0,1,0,1,0
58689,123,57350,123,allow,184,94,90,2,30,1,1
17280,22114,0,0,deny,62,62,0,1,0,1,0
50362,445,0,0,drop,70,70,0,1,0,1,0
36542,443,35325,443,allow,31814,26657,5157,52,212,32,20
37927,50265,0,0,deny,66,66,0,1,0,1,0
49184,445,0,0,drop,66,66,0,1,0,1,0
30303,22530,0,0,deny,169,169,0,1,0,1,0
55850,53,22849,53,allow,711,87,624,2,31,1,1
49603,53,17814,53,allow,766,102,664,2,30,1,1
65127,53,26912,53,allow,188,96,92,2,31,1,1
59282,51050,0,0,deny,66,66,0,1,0,1,0
59131,53,59747,53,allow,70,70,0,1,30,1,0
56943,44847,0,0,deny,62,62,0,1,0,1,0
53697,6224,21795,6224,allow,70,70,0,2,8,2,0
58071,445,0,0,drop,70,70,0,1,0,1,0
25031,25174,0,0,deny,62,62,0,1,0,1,0
37066,443,58040,443,allow,9705,4332,5373,32,321,17,15
59977,445,0,0,drop,70,70,0,1,0,1,0
51535,64147,0,0,deny,66,66,0,1,0,1,0
58638,5900,0,0,deny,62,62,0,1,0,1,0
58927,443,34485,443,allow,5168,700,4468,16,15,7,9
59668,51505,0,0,deny,66,66,0,1,0,1,0
51903,26467,0,0,deny,62,62,0,1,0,1,0
49665,53,61260,53,allow,361,118,243,4,33,2,2
58180,445,0,0,drop,66,66,0,1,0,1,0
55844,445,0,0,drop,66,66,0,1,0,1,0
56622,53,20942,53,allow,174,89,85,2,31,1,1
58795,445,0,0,drop,70,70,0,1,0,1,0
54735,445,0,0,drop,70,70,0,1,0,1,0
57288,443,50391,443,allow,840,420,420,14,39,7,7
56314,53,22045,53,allow,183,94,89,2,30,1,1
14614,25174,0,0,deny,66,66,0,1,0,1,0
55592,443,17919,443,allow,8049,1560,6489,19,150,9,10
65386,445,0,0,drop,66,66,0,1,0,1,0
52201,443,3597,443,allow,5681,1441,4240,21,51,11,10
27005,27017,58319,27017,allow,883,126,757,2,30,1,1
43608,53,16507,53,allow,199,94,105,2,30,1,1
53976,443,65435,443,allow,9921,2236,7685,35,32,17,18
51244,57099,0,0,deny,100,100,0,1,0,1,0
43056,443,9640,443,allow,31297,21354,9943,55,363,28,27
20726,2767,0,0,deny,66,66,0,1,0,1,0
19610,9571,0,0,deny,62,62,0,1,0,1,0
58395,445,0,0,drop,70,70,0,1,0,1,0
39442,123,6602,123,allow,184,94,90,2,30,1,1
49297,53,48060,53,allow,183,94,89,2,30,1,1
53134,42369,37708,42369,allow,70,70,0,1,5,1,0
50202,443,56858,443,allow,8415,3119,5296,26,73,9,17
52103,7172,64684,7172,allow,70,70,0,2,7,2,0
51221,6881,43660,6881,allow,479,150,329,2,1200,1,1
52237,443,52237,443,allow,7718,2030,5688,23,20,11,12
49861,443,11860,443,allow,5995,974,5021,19,56,10,9
53707,443,35739,443,allow,7272,930,6342,19,75,9,10
55620,53,36114,53,allow,178,94,84,2,31,1,1
7482,57470,0,0,deny,66,66,0,1,0,1,0
59964,443,21876,443,allow,1346200,44765,1301435,1428,128,479,949
58372,445,0,0,drop,70,70,0,1,0,1,0
62449,443,11939,443,allow,9977,4364,5613,19,121,9,10
46413,443,45352,443,allow,8106,4839,3267,61,449,32,29
443,46382,0,0,deny,66,66,0,1,0,1,0
49336,80,14005,80,allow,3060,1219,1841,11,19,7,4
15105,25174,0,0,deny,146,146,0,1,0,1,0
49523,53,10736,53,allow,728,96,632,2,30,1,1
54826,56205,0,0,deny,62,62,0,1,0,1,0
56003,445,0,0,drop,70,70,0,1,0,1,0
49971,53,55758,53,allow,198,102,96,2,30,1,1
51731,39392,29228,39392,allow,66,66,0,1,5,1,0
56472,53,54930,53,allow,167,86,81,2,30,1,1
51634,80,59507,80,allow,378,192,186,7,39,4,3
51882,15733,3672,15733,allow,70,70,0,1,5,1,0
55122,443,57128,443,allow,17936,14273,3663,59,122,33,26
64827,53,64827,53,allow,288,83,205,2,30,1,1
58638,5900,0,0,deny,62,62,0,1,0,1,0
51286,445,0,0,drop,70,70,0,1,0,1,0
53864,443,39351,443,allow,499,425,74,4,1,3,1
55893,443,18162,443,allow,6176,908,5268,17,15,8,9
56657,443,53403,443,allow,8059,2039,6020,20,15,11,9
54783,445,0,0,drop,70,70,0,1,0,1,0
53760,443,58528,443,allow,13059,3730,9329,73,3729,32,41
63221,53436,0,0,deny,62,62,0,1,0,1,0
53249,443,53249,443,allow,1404,697,707,17,121,8,9
50870,5228,4125,5228,allow,7069,1804,5265,20,3602,11,9
49774,53,49900,53,allow,225,110,115,2,30,1,1
21604,50201,0,0,deny,66,66,0,1,0,1,0
55937,53,58356,53,allow,179,94,85,2,30,1,1
64493,53,56892,53,allow,280,97,183,4,58,2,2
53536,34200,55165,34200,allow,70,70,0,1,4,1,0
43208,443,45939,443,allow,4296557,96359,4200198,3781,143,838,2943
36889,80,51153,80,allow,1584,1130,454,15,39,10,5
55596,53,37319,53,allow,188,96,92,2,31,1,1
55674,48870,19113,48870,allow,70,70,0,2,8,2,0
37558,16386,20045,16386,allow,432,192,240,8,30,4,4
57987,56125,0,0,deny,90,90,0,1,0,1,0
65357,53,38110,53,allow,194,102,92,2,29,1,1
0,0,0,0,deny,60,60,0,1,0,1,0
61924,80,25773,80,allow,2170,472,1698,10,125,6,4
27005,27015,27978,27015,allow,888,126,762,2,31,1,1
62430,445,0,0,drop,70,70,0,1,0,1,0
60782,20010,60186,20010,allow,70,70,0,2,8,2,0
50195,445,0,0,drop,70,70,0,1,0,1,0
15793,64147,0,0,deny,66,66,0,1,0,1,0
62073,443,18581,443,allow,7989,4098,3891,34,136,15,19
49191,51253,24345,51253,allow,504,318,186,8,15,5,3
59240,53,59240,53,allow,194,87,107,2,30,1,1
30960,45752,44974,45752,allow,462,462,0,8,3631,8,0
6881,21162,0,0,deny,146,146,0,1,0,1,0
55401,445,0,0,drop,66,66,0,1,0,1,0
37587,443,50576,443,allow,499,425,74,4,0,3,1
53382,445,0,0,drop,70,70,0,1,0,1,0
53225,443,9099,443,allow,6597,1798,4799,28,80,12,16
53897,443,3893,443,allow,10781,3635,7146,27,221,15,12
38759,443,24886,443,allow,7878,1531,6347,36,257,16,20
49989,443,4666,443,allow,300,168,132,4,6,2,2
64517,445,0,0,drop,70,70,0,1,0,1,0
60761,53,45233,53,allow,198,86,112,2,29,1,1
41882,443,10450,443,allow,7218,4166,3052,38,133,19,19
50684,443,36548,443,allow,6909,2495,4414,20,15,11,9
61740,443,6060,443,allow,92202,65396,26806,193,3454,68,125
54442,445,0,0,drop,66,66,0,1,0,1,0
57809,53,57809,53,allow,213,79,134,2,33,1,1
63870,6881,25073,6881,allow,70,70,0,1,5,1,0
51575,9694,0,0,deny,66,66,0,1,0,1,0
65144,53,52237,53,allow,204,104,100,2,31,1,1
49811,443,7864,443,allow,7551,2453,5098,22,126,12,10
49331,53,38875,53,allow,200,94,106,2,29,1,1
54988,445,0,0,drop,66,66,0,1,0,1,0
56929,53,47625,53,allow,177,94,83,2,30,1,1
61651,123,29529,123,allow,184,94,90,2,30,1,1
59271,445,0,0,drop,70,70,0,1,0,1,0
51317,443,51634,443,allow,59889,7472,52417,83,145,32,51
59112,445,0,0,drop,70,70,0,1,0,1,0
45941,23386,0,0,deny,60,60,0,1,0,1,0
65373,53,10645,53,allow,197,102,95,2,29,1,1
57058,53,29046,53,allow,167,86,81,2,30,1,1
57631,443,50238,443,allow,16277,3466,12811,46,1801,22,24
49456,443,44613,443,allow,939,547,392,11,27,5,6
51820,80,11900,80,allow,366,240,126,7,25,5,2
65496,53,50374,53,allow,183,94,89,2,30,1,1
44512,443,54023,443,allow,1101393,30310,1071083,1137,109,381,756
57677,57470,0,0,deny,62,62,0,1,0,1,0
53186,443,23298,443,allow,10332,2735,7597,36,21,17,19
52778,445,0,0,drop,70,70,0,1,0,1,0
64194,445,0,0,drop,70,70,0,1,0,1,0
34999,25864,0,0,deny,74,74,0,1,0,1,0
45964,3111,0,0,deny,60,60,0,1,0,1,0
50510,445,0,0,drop,70,70,0,1,0,1,0
57237,443,44952,443,allow,3283,1030,2253,16,136,8,8
3585,64147,0,0,deny,62,62,0,1,0,1,0
10348,25604,0,0,deny,62,62,0,1,0,1,0
56846,53,23614,53,allow,192,98,94,2,31,1,1
55706,53,42379,53,allow,209,110,99,2,30,1,1
55049,5228,10544,5228,allow,9193,2770,6423,51,5193,28,23
52957,443,8095,443,allow,38149,4388,33761,68,113,26,42
56928,80,39650,80,allow,526,304,222,8,35,5,3
36357,443,35351,443,allow,14614,1935,12679,36,16,20,16
52275,445,0,0,drop,70,70,0,1,0,1,0
46495,4607,0,0,deny,60,60,0,1,0,1,0
57886,80,60119,80,allow,6526,1210,5316,15,17,8,7
55934,53,17194,53,allow,182,102,80,2,30,1,1
46627,36237,0,0,deny,62,62,0,1,0,1,0
60340,445,0,0,drop,70,70,0,1,0,1,0
61723,445,0,0,drop,70,70,0,1,0,1,0
60453,22114,0,0,deny,146,146,0,1,0,1,0
57083,53,27580,53,allow,198,102,96,2,30,1,1
41714,443,33432,443,allow,4590,3026,1564,28,80,15,13
41484,443,11902,443,allow,10024,6237,3787,22,27,11,11
52740,445,0,0,drop,70,70,0,1,0,1,0
63971,445,0,0,drop,66,66,0,1,0,1,0
27005,27057,3516,27057,allow,917,126,791,2,31,1,1
52112,443,29903,443,allow,59796,4486,55310,92,48,45,47
58507,80,58507,80,allow,348,132,216,6,26,3,3
52375,80,39641,80,allow,78,78,0,1,5,1,0
59235,52700,0,0,deny,145,145,0,1,0,1,0
443,60496,0,0,deny,320,320,0,1,0,1,0
48008,443,47118,443,allow,10665,3059,7606,28,17,16,12
45813,5222,28803,5222,allow,5723,3023,2700,58,548,32,26
58152,443,52749,443,allow,5584,1168,4416,19,17,11,8
39353,9339,55496,9339,allow,170706,9877,160829,260,46,110,150
7889,48817,0,0,deny,146,146,0,1,0,1,0
57334,53,60234,53,allow,184,94,90,2,31,1,1
34360,25174,0,0,deny,66,66,0,1,0,1,0
0,0,0,0,deny,70,70,0,1,0,1,0
52146,80,44068,80,allow,366,240,126,7,33,5,2
54438,62413,0,0,deny,66,66,0,1,0,1,0
11066,50584,0,0,deny,66,66,0,1,0,1,0
10669,49756,0,0,deny,60,60,0,1,0,1,0
57604,32480,0,0,deny,62,62,0,1,0,1,0
57131,35776,0,0,deny,145,145,0,1,0,1,0
59139,445,0,0,drop,70,70,0,1,0,1,0
53902,445,0,0,drop,70,70,0,1,0,1,0
61898,50584,0,0,deny,66,66,0,1,0,1,0
55370,53,23288,53,allow,711,87,624,2,30,1,1
41882,53,0,0,allow,86,86,0,1,29,1,0
56477,443,27592,443,allow,5638,2934,2704,15,120,7,8
11136,57587,0,0,deny,62,62,0,1,0,1,0
53910,1024,52372,1024,allow,70,70,0,2,8,2,0
27038,63836,0,0,deny,145,145,0,1,0,1,0
55911,445,0,0,drop,70,70,0,1,0,1,0
47020,443,34656,443,allow,3545,1817,1728,22,95,11,11
0,0,0,0,deny,98,98,0,1,0,1,0
37999,443,54290,443,allow,1650,815,835,17,186,9,8
50187,443,52959,443,allow,6363,1073,5290,18,38,10,8
1100,27540,53473,27540,allow,132,70,62,2,30,1,1
60350,51505,0,0,deny,66,66,0,1,0,1,0
56431,53,62997,53,allow,170,87,83,2,30,1,1
51459,443,47605,443,allow,379,259,120,4,16,2,2
58234,445,0,0,drop,70,70,0,1,0,1,0
52000,80,35679,80,allow,3604,2064,1540,15,40,10,5
49781,53,35337,53,allow,254,102,152,2,29,1,1
55630,53,11814,53,allow,197,102,95,2,30,1,1
52178,443,8092,443,allow,414,140,274,7,26,3,4
61927,445,0,0,drop,66,66,0,1,0,1,0
49163,443,41945,443,allow,2529,1230,1299,17,16,9,8
8536,37965,0,0,deny,62,62,0,1,0,1,0
49760,445,0,0,drop,70,70,0,1,0,1,0
53760,443,44529,443,allow,499,425,74,4,0,3,1
49308,53,20210,53,allow,190,97,93,2,30,1,1
56772,443,38284,443,allow,7889,1900,5989,20,15,11,9
55185,443,43469,443,allow,6389,1163,5226,19,25,11,8
49954,53,59869,53,allow,753,94,659,2,30,1,1
65506,445,0,0,drop,66,66,0,1,0,1,0
33262,443,40811,443,allow,4067,2672,1395,23,23,14,9
58426,445,0,0,drop,70,70,0,1,0,1,0
58741,443,39394,443,allow,5168,700,4468,16,15,7,9
49365,80,10585,80,allow,2361,1586,775,11,166,7,4
57987,56125,0,0,deny,90,90,0,1,0,1,0
59929,445,0,0,drop,70,70,0,1,0,1,0
56976,80,37703,80,allow,214,140,74,4,35,3,1
65204,53,23706,53,allow,183,94,89,2,30,1,1
64827,53,50756,53,allow,291,86,205,2,30,1,1
12011,443,12011,443,allow,6981,948,6033,17,27,10,7
52003,18150,42315,18150,allow,70,70,0,2,7,2,0
64991,53,31407,53,allow,196,94,102,2,29,1,1
64339,18375,0,0,deny,62,62,0,1,0,1,0
56533,53,11547,53,allow,498,204,294,6,30,3,3
56423,80,12556,80,allow,33937,628,33309,31,104,6,25
57393,48983,0,0,deny,146,146,0,1,0,1,0
38283,443,38283,443,allow,6981,948,6033,17,54,10,7
51172,443,45149,443,allow,1472,965,507,13,20,7,6
57644,445,0,0,drop,70,70,0,1,0,1,0
63853,10659,14752,10659,allow,66,66,0,2,8,2,0
60031,443,5116,443,allow,350,210,140,6,15,4,2
39232,53,39232,53,allow,215,80,135,2,32,1,1
52944,443,11890,443,allow,58499,47163,11336,106,115,59,47
57987,56125,0,0,deny,90,90,0,1,0,1,0
65008,445,0,0,drop,70,70,0,1,0,1,0
50580,443,63411,443,allow,2604,1413,1191,15,98,9,6
36604,443,8659,443,allow,6506,1532,4974,28,16,14,14
52865,443,62658,443,allow,120290,2988,117302,123,132,32,91
57075,53,34299,53,allow,212,102,110,2,30,1,1
37965,27261,16872,27261,allow,150,150,0,1,1199,1,0
65516,53,21286,53,allow,209,110,99,2,30,1,1
36677,443,38465,443,allow,712,374,338,11,26,6,5
59250,443,54786,443,allow,12632,3678,8954,42,27,23,19
65275,53,60428,53,allow,807,94,713,2,30,1,1
49664,445,0,0,drop,70,70,0,1,0,1,0
49905,53,43598,53,allow,176,90,86,2,31,1,1
58430,445,0,0,drop,66,66,0,1,0,1,0
26651,25174,0,0,deny,146,146,0,1,0,1,0
50550,443,50550,443,allow,5642,2395,3247,22,38,13,9
52129,55550,34471,55550,allow,66,66,0,1,5,1,0
55756,53,41764,53,allow,747,90,657,2,30,1,1
44097,80,3259,80,allow,36152,2792,33360,55,19,29,26
54133,445,0,0,drop,66,66,0,1,0,1,0
50817,443,46052,443,allow,17161,1619,15542,18,153,4,14
56403,51505,0,0,deny,66,66,0,1,0,1,0
42379,443,33462,443,allow,1622,1137,485,11,26,7,4
56200,53,42161,53,allow,211,110,101,2,30,1,1
49674,443,19357,443,allow,5917,1570,4347,20,53,10,10
65526,445,0,0,drop,70,70,0,1,0,1,0
41876,443,3381,443,allow,55975,2553,53422,72,105,29,43
9073,443,37513,443,allow,4187235,99258,4087977,4375,28,1464,2911
49675,53,53697,53,allow,199,102,97,2,30,1,1
26900,27017,37818,27017,allow,422,164,258,6,30,3,3
56388,53,23027,53,allow,186,95,91,3,34,2,1
50059,443,43913,443,allow,8205,2989,5216,42,115,21,21
63387,445,0,0,drop,70,70,0,1,0,1,0
31172,22114,0,0,deny,62,62,0,1,0,1,0
49882,443,5946,443,allow,5019,1424,3595,15,87,9,6
43916,21,0,0,deny,60,60,0,1,0,1,0
56387,25174,0,0,deny,62,62,0,1,0,1,0
49569,53,65331,53,allow,181,94,87,2,32,1,1
1987,26467,0,0,deny,62,62,0,1,0,1,0
59483,23,0,0,deny,60,60,0,1,0,1,0
53209,443,56508,443,allow,11086,2564,8522,42,186,21,21
59989,445,0,0,drop,70,70,0,1,0,1,0
49369,53,65002,53,allow,168,86,82,2,30,1,1
0,0,0,0,allow,124,64,60,2,0,1,1
35915,443,57098,443,allow,1786,172,1614,7,120,3,4
64811,51221,0,0,deny,66,66,0,1,0,1,0
50968,443,5698,443,allow,7532,3051,4481,13,120,6,7
64431,53,35945,53,allow,177,94,83,2,31,1,1
53305,50584,0,0,deny,66,66,0,1,0,1,0
54213,443,30339,443,allow,7498,2799,4699,24,17,13,11
49228,443,26216,443,allow,13758,6577,7181,66,918,34,32
40656,443,51290,443,allow,10293,1331,8962,22,255,12,10
54260,445,0,0,drop,70,70,0,1,0,1,0
61465,443,63826,443,allow,9619,879,8740,19,135,8,11
19875,30170,0,0,deny,145,145,0,1,0,1,0
38320,53,38320,53,allow,260,106,154,2,32,1,1
56684,53,5087,53,allow,194,94,100,2,30,1,1
49702,445,0,0,drop,70,70,0,1,0,1,0
64265,53,25534,53,allow,550,133,417,4,47,2,2
55427,64147,0,0,deny,66,66,0,1,0,1,0
56500,53,41129,53,allow,199,102,97,2,30,1,1
57006,53,13462,53,allow,196,102,94,2,29,1,1
52643,15941,0,0,deny,62,62,0,1,0,1,0
53917,35885,30826,35885,allow,70,70,0,2,8,2,0
64054,53,34990,53,allow,183,94,89,2,30,1,1
64928,445,0,0,drop,70,70,0,1,0,1,0
52181,1038,36423,1038,allow,66,66,0,1,5,1,0
49569,53,55862,53,allow,181,94,87,2,31,1,1
34814,53,64232,53,allow,168,78,90,2,30,1,1
56451,995,0,0,deny,60,60,0,1,0,1,0
3478,61463,0,0,deny,68,68,0,1,0,1,0
55022,443,12848,443,allow,14634,1801,12833,28,46,14,14
64897,2323,0,0,deny,60,60,0,1,0,1,0
55260,445,0,0,drop,70,70,0,1,0,1,0
61586,445,0,0,drop,70,70,0,1,0,1,0
65116,53,7436,53,allow,220,94,126,2,29,1,1
56660,53,55953,53,allow,183,94,89,2,31,1,1
59651,60038,0,0,allow,66,66,0,1,90,1,0
56268,443,24537,443,allow,10226,4435,5791,50,256,24,26
52231,50934,0,0,deny,62,62,0,1,0,1,0
37965,51413,62222,51413,allow,158,158,0,1,1200,1,0
60561,445,0,0,drop,66,66,0,1,0,1,0
61838,443,61838,443,allow,36811,5190,31621,60,150,24,36
34331,443,11872,443,allow,120,60,60,3,4,2,1
63988,53,36168,53,allow,195,102,93,2,30,1,1
0,0,0,0,deny,82,82,0,1,0,1,0
55923,53,7980,53,allow,177,94,83,2,30,1,1
63814,12906,14738,12906,allow,70,70,0,1,5,1,0
45184,5228,38008,5228,allow,9107,2358,6749,24,3600,13,11
53863,443,62778,443,allow,499,425,74,4,1,3,1
56190,53,16437,53,allow,196,94,102,2,30,1,1
53227,443,7377,443,allow,16336,3219,13117,46,59,21,25
54088,445,0,0,drop,70,70,0,1,0,1,0
55850,445,0,0,drop,70,70,0,1,0,1,0
58789,443,17140,443,allow,14261,9361,4900,35,16,19,16
55095,53,63653,53,allow,194,102,92,2,29,1,1
67,68,0,0,deny,346,346,0,1,0,1,0
61750,445,0,0,drop,66,66,0,1,0,1,0
9471,23,0,0,deny,60,60,0,1,0,1,0
18655,50584,0,0,deny,62,62,0,1,0,1,0
51544,445,0,0,drop,70,70,0,1,0,1,0
50355,445,0,0,drop,66,66,0,1,0,1,0
8889,53670,0,0,deny,60,60,0,1,0,1,0
55183,445,0,0,drop,70,70,0,1,0,1,0
51439,443,28008,443,allow,10119,1855,8264,26,28,15,11
64589,53,29733,53,allow,742,88,654,2,30,1,1
41583,443,3597,443,allow,4168,2503,1665,20,255,11,9
49954,53,53212,53,allow,216,110,106,2,29,1,1
62170,443,62170,443,allow,28026,5723,22303,62,20,32,30
52239,1172,16970,1172,allow,256,136,120,5,5,3,2
33242,443,38172,443,allow,14244,2907,11337,33,17,17,16
58183,445,0,0,drop,70,70,0,1,0,1,0
55163,53,35742,53,allow,194,99,95,2,31,1,1
49512,443,31852,443,allow,7626,1741,5885,35,256,17,18
62014,445,0,0,drop,70,70,0,1,0,1,0
50995,53,51013,53,allow,168,78,90,2,30,1,1
64332,53,24629,53,allow,374,96,278,4,55,2,2
56758,40000,5881,40000,allow,70,70,0,1,5,1,0
64305,53,21382,53,allow,598,196,402,6,71,3,3
54592,80,24898,80,allow,1113,534,579,12,16,7,5
64895,53,61625,53,allow,199,102,97,2,30,1,1
54787,443,54787,443,allow,18160,6539,11621,37,19,22,15
56641,80,60111,80,allow,234,234,0,4,12,4,0
64842,443,46917,443,allow,5467,2738,2729,23,137,11,12
58101,445,0,0,drop,66,66,0,1,0,1,0
51954,12380,41427,12380,allow,70,70,0,1,5,1,0
63176,445,0,0,drop,70,70,0,1,0,1,0
49650,53,58699,53,allow,539,97,442,4,58,2,2
59908,445,0,0,drop,70,70,0,1,0,1,0
51976,11816,61215,11816,allow,70,70,0,2,8,2,0
54975,443,15865,443,allow,441892,86941,354951,716,73,343,373
9246,35440,0,0,deny,66,66,0,1,0,1,0
53764,445,0,0,drop,70,70,0,1,0,1,0
50096,53,56974,53,allow,733,94,639,2,30,1,1
51097,445,0,0,drop,70,70,0,1,0,1,0
57441,53,9760,53,allow,177,94,83,2,29,1,1
56550,53,48765,53,allow,183,94,89,2,29,1,1
58638,5900,0,0,deny,62,62,0,1,0,1,0
25067,22114,0,0,deny,146,146,0,1,0,1,0
5223,14446,0,0,deny,220,220,0,1,0,1,0
36762,443,46444,443,allow,560,280,280,9,25,5,4
54367,445,0,0,drop,70,70,0,1,0,1,0
51954,443,51642,443,allow,2995,1894,1101,20,46,11,9
64041,53,24835,53,allow,200,102,98,2,29,1,1
60405,5900,0,0,deny,60,60,0,1,0,1,0
59649,445,0,0,drop,70,70,0,1,0,1,0
49606,445,0,0,drop,66,66,0,1,0,1,0
54015,445,0,0,drop,70,70,0,1,0,1,0
60475,443,46189,443,allow,5888,1175,4713,19,43,11,8
49245,445,0,0,drop,70,70,0,1,0,1,0
63480,445,0,0,drop,70,70,0,1,0,1,0
53602,12395,26422,12395,allow,70,70,0,2,7,2,0
58541,28678,6280,28678,allow,1806,1806,0,22,224,22,0
46720,53,0,0,allow,82,82,0,1,30,1,0
56335,53,48756,53,allow,816,102,714,2,30,1,1
42753,56205,0,0,deny,62,62,0,1,0,1,0
64503,445,0,0,drop,70,70,0,1,0,1,0
51829,36134,0,0,deny,66,66,0,1,0,1,0
55711,26467,0,0,deny,62,62,0,1,0,1,0
50513,443,44199,443,allow,9766,1810,7956,30,86,16,14
51356,22114,0,0,deny,66,66,0,1,0,1,0
64569,443,62686,443,allow,9157,2109,7048,27,32,15,12
57121,53,54174,53,allow,257,110,147,2,30,1,1
48016,57470,0,0,deny,62,62,0,1,0,1,0
56562,53,4746,53,allow,183,94,89,2,29,1,1
65425,53,21278,53,allow,473,94,379,4,36,2,2
50325,80,35970,80,allow,2535,783,1752,13,48,7,6
53234,443,53501,443,allow,6059,1040,5019,20,58,11,9
59587,25174,0,0,deny,62,62,0,1,0,1,0
55372,53,41205,53,allow,271,93,178,4,43,2,2
38645,51221,0,0,deny,62,62,0,1,0,1,0
55597,7485,34248,7485,allow,70,70,0,1,5,1,0
57498,443,57498,443,allow,4546,1639,2907,19,27,11,8
64329,53,19539,53,allow,281,110,171,2,30,1,1
48643,80,57942,80,allow,1912,1464,448,14,16,7,7
60338,445,0,0,drop,70,70,0,1,0,1,0
64684,53,23170,53,allow,199,94,105,2,30,1,1
56834,53,25406,53,allow,178,94,84,2,30,1,1
49611,53,24146,53,allow,177,94,83,2,30,1,1
50265,41071,33048,41071,allow,1716,1716,0,27,2188,27,0
65304,53,2754,53,allow,202,103,99,2,31,1,1
42925,443,37247,443,allow,5617,1559,4058,22,138,13,9
55443,443,53890,443,allow,12806,2828,9978,55,2983,24,31
49604,53,29008,53,allow,969,86,883,2,30,1,1
50647,445,0,0,drop,66,66,0,1,0,1,0
56901,445,0,0,drop,70,70,0,1,0,1,0
31845,55777,0,0,deny,62,62,0,1,0,1,0
35688,53,49808,53,allow,199,94,105,2,30,1,1
16393,22114,0,0,deny,66,66,0,1,0,1,0
49866,445,0,0,drop,70,70,0,1,0,1,0
49376,53,15412,53,allow,391,134,257,2,30,1,1
49418,27015,25961,27015,allow,234,78,156,2,30,1,1
50584,61421,62887,61421,allow,166,166,0,1,1199,1,0
9473,443,29099,443,allow,6100,777,5323,17,26,9,8
56433,53,47561,53,allow,210,110,100,2,30,1,1
61571,445,0,0,drop,70,70,0,1,0,1,0
55265,53,19057,53,allow,740,93,647,2,31,1,1
35261,15503,0,0,deny,74,74,0,1,0,1,0
50931,80,59351,80,allow,7978844,97517,7881327,6752,120,1393,5359
50659,53,45075,53,allow,168,78,90,2,30,1,1
56365,53,14208,53,allow,199,102,97,2,30,1,1
61550,5529,0,0,deny,145,145,0,1,0,1,0
62490,445,0,0,drop,70,70,0,1,0,1,0
51688,47961,35098,47961,allow,66,66,0,1,5,1,0
49540,53,39432,53,allow,198,110,88,2,31,1,1
15513,25174,0,0,deny,62,62,0,1,0,1,0
59951,445,0,0,drop,70,70,0,1,0,1,0
56113,53,57844,53,allow,194,102,92,2,30,1,1
42298,40008,62209,40008,allow,148,86,62,2,30,1,1
49994,80,9515,80,allow,2618,591,2027,11,16,6,5
62566,35993,0,0,deny,62,62,0,1,0,1,0
57585,19750,0,0,deny,66,66,0,1,0,1,0
5431,53,64205,53,allow,220,78,142,2,30,1,1
63081,53,24594,53,allow,304,86,218,2,30,1,1
57893,443,16617,443,allow,1867,1228,639,18,176,11,7
48420,48637,0,0,deny,146,146,0,1,0,1,0
53284,443,5586,443,allow,4579,2245,2334,12,122,6,6
27005,33055,20199,33055,allow,888,126,762,2,31,1,1
443,45788,0,0,deny,332,332,0,1,0,1,0
39983,80,39983,80,allow,6416,997,5419,17,30,8,9
28025,443,15107,443,allow,5578,1390,4188,19,15,9,10
63379,443,51286,443,allow,2649,330,2319,12,134,5,7
59079,445,0,0,drop,70,70,0,1,0,1,0
49640,443,55755,443,allow,2809,1729,1080,18,80,10,8
55439,37965,0,0,deny,66,66,0,1,0,1,0
57204,53,25182,53,allow,190,97,93,2,30,1,1
58638,5900,0,0,deny,62,62,0,1,0,1,0
49421,53,15245,53,allow,744,89,655,2,31,1,1
57068,445,0,0,drop,70,70,0,1,0,1,0
51951,65387,56923,65387,allow,70,70,0,2,8,2,0
64257,53,2954,53,allow,168,86,82,2,30,1,1
50584,53,20103,53,allow,179,94,85,2,30,1,1
55722,53,19688,53,allow,226,110,116,2,30,1,1
62187,445,0,0,drop,70,70,0,1,0,1,0
64422,445,0,0,drop,66,66,0,1,0,1,0
51183,445,0,0,drop,70,70,0,1,0,1,0
59061,443,25060,443,allow,5464,3984,1480,35,221,20,15
50286,443,48730,443,allow,6414386,102255,6312131,5812,182,1634,4178
52706,445,0,0,drop,70,70,0,1,0,1,0
56707,445,0,0,drop,70,70,0,1,0,1,0
54837,445,0,0,drop,66,66,0,1,0,1,0
59498,445,0,0,drop,70,70,0,1,0,1,0
55245,443,43023,443,allow,7725129,126824,7598305,6259,607,740,5519
51265,63960,52529,63960,allow,70,70,0,2,8,2,0
27824,51505,0,0,deny,146,146,0,1,0,1,0
50050,445,0,0,drop,70,70,0,1,0,1,0
48513,44847,0,0,deny,146,146,0,1,0,1,0
19099,56205,0,0,deny,62,62,0,1,0,1,0
15819,3389,0,0,deny,60,60,0,1,0,1,0
49575,80,43723,80,allow,318,192,126,6,43,4,2
64870,65473,0,0,deny,148,148,0,1,0,1,0
52358,443,40970,443,allow,4145,2738,1407,29,27,16,13
52739,445,0,0,drop,70,70,0,1,0,1,0
50095,445,0,0,drop,70,70,0,1,0,1,0
51112,80,46143,80,allow,2433,1280,1153,11,20,7,4
49203,53,46082,53,allow,168,86,82,2,31,1,1
60310,445,0,0,drop,66,66,0,1,0,1,0
56512,53,17535,53,allow,166,86,80,2,30,1,1
52340,22114,0,0,deny,62,62,0,1,0,1,0
26872,44847,0,0,deny,62,62,0,1,0,1,0
54076,53,54076,53,allow,243,94,149,2,32,1,1
56272,53,49117,53,allow,235,86,149,2,30,1,1
55084,53,64405,53,allow,177,94,83,2,29,1,1
58638,5900,0,0,deny,62,62,0,1,0,1,0
9260,80,58390,80,allow,318,192,126,6,26,4,2
52732,445,0,0,drop,70,70,0,1,0,1,0
58638,5900,0,0,deny,62,62,0,1,0,1,0
58638,5900,0,0,deny,62,62,0,1,0,1,0
9186,80,65016,80,allow,17643,1063,16580,26,35,11,15
27721,53,27721,53,allow,404,259,145,3,32,2,1
27005,37569,24512,37569,allow,880,126,754,2,30,1,1
61899,445,0,0,drop,66,66,0,1,0,1,0
49834,445,0,0,drop,70,70,0,1,0,1,0
56071,53,41864,53,allow,186,95,91,2,31,1,1
29300,35440,0,0,deny,146,146,0,1,0,1,0
42566,443,31210,443,allow,10127,4193,5934,30,24,17,13
49752,53,44269,53,allow,182,94,88,2,29,1,1
64633,445,0,0,drop,66,66,0,1,0,1,0
62232,445,0,0,drop,70,70,0,1,0,1,0
52590,445,0,0,drop,70,70,0,1,0,1,0
51749,1408,51950,1408,allow,70,70,0,1,5,1,0
55776,53,24282,53,allow,168,78,90,2,30,1,1
51733,445,0,0,drop,70,70,0,1,0,1,0
50486,56205,0,0,deny,62,62,0,1,0,1,0
53487,445,0,0,drop,70,70,0,1,0,1,0
443,49689,0,0,deny,60,60,0,1,0,1,0
55101,445,0,0,drop,70,70,0,1,0,1,0
46441,443,33380,443,allow,416,210,206,7,28,4,3
58570,445,0,0,drop,66,66,0,1,0,1,0
50063,53,17752,53,allow,173,94,79,2,29,1,1
64045,7426,45943,7426,allow,66,66,0,2,7,2,0
64814,53,5615,53,allow,243,94,149,2,30,1,1
36369,51505,0,0,deny,66,66,0,1,0,1,0
59390,53,43106,53,allow,184,86,98,2,31,1,1
33351,43890,0,0,deny,146,146,0,1,0,1,0
59148,445,0,0,drop,70,70,0,1,0,1,0
48728,443,2946,443,allow,2437,1321,1116,15,83,9,6
59459,445,0,0,drop,70,70,0,1,0,1,0
49359,53,64327,53,allow,412,122,290,4,45,2,2
53152,27367,49089,27367,allow,758,320,438,11,20,6,5
59019,53,48512,53,allow,179,86,93,2,30,1,1
57340,3333,57340,3333,allow,24544,10921,13623,171,1095,89,82
49260,53,23458,53,allow,199,86,113,2,30,1,1
56620,443,2901,443,allow,1327,918,409,10,25,6,4
57444,53,13400,53,allow,198,94,104,2,29,1,1
8917,443,55362,443,allow,7308,864,6444,26,394,9,17
56732,445,0,0,drop,70,70,0,1,0,1,0
53519,64147,0,0,deny,66,66,0,1,0,1,0
62973,445,0,0,drop,70,70,0,1,0,1,0
59598,445,0,0,drop,70,70,0,1,0,1,0
65224,53,18679,53,allow,197,102,95,2,30,1,1
50479,445,0,0,drop,66,66,0,1,0,1,0
51990,42127,13506,42127,allow,70,70,0,2,8,2,0
53650,53,49968,53,allow,199,94,105,2,29,1,1
65129,53,16453,53,allow,324,110,214,2,30,1,1
9042,443,33866,443,allow,15177,5713,9464,37,120,17,20
63065,53,14429,53,allow,448,166,282,2,30,1,1
44538,50584,0,0,deny,62,62,0,1,0,1,0
46318,443,20839,443,allow,6373,1744,4629,22,15,13,9
53541,59939,18832,59939,allow,70,70,0,1,5,1,0
59790,44847,0,0,deny,66,66,0,1,0,1,0
56973,443,44291,443,allow,7481,2264,5217,22,135,10,12
54022,443,20800,443,allow,121935,7839,114096,175,255,82,93
61002,37965,0,0,deny,145,145,0,1,0,1,0
50584,63015,51175,63015,allow,166,166,0,1,1200,1,0
38065,443,63801,443,allow,911697,74083,837614,1247,343,459,788
57226,51505,0,0,deny,66,66,0,1,0,1,0
49938,445,0,0,drop,70,70,0,1,0,1,0
52047,42805,9664,42805,allow,164,70,94,3,7,2,1
57096,53,51826,53,allow,177,94,83,2,30,1,1
59383,80,59383,80,allow,1915,1466,449,10,19,6,4
55838,443,50460,443,allow,11446,4102,7344,32,20,16,16
50622,445,0,0,drop,70,70,0,1,0,1,0
50915,80,27954,80,allow,10548172,142265,10405907,9105,134,1982,7123
51861,23919,4159,23919,allow,70,70,0,1,5,1,0
40102,443,45271,443,allow,29714,2090,27624,43,97,17,26
57342,53,55197,53,allow,167,86,81,2,31,1,1
64776,53,62229,53,allow,198,94,104,2,30,1,1
54703,23,0,0,deny,60,60,0,1,0,1,0
51940,80,62105,80,allow,278312,9722,268590,323,61,135,188
54267,53,33061,53,allow,86,86,0,1,30,1,0
62888,53,0,0,allow,193,78,115,2,30,1,1
49518,443,29100,443,allow,6602,1573,5029,25,271,11,14
60292,8630,2625,8630,allow,324,250,74,5,3605,4,1
56995,53,18611,53,allow,168,86,82,2,30,1,1
52965,443,12004,443,allow,8602,1050,7552,16,120,7,9
51194,445,0,0,drop,66,66,0,1,0,1,0
54749,445,0,0,drop,70,70,0,1,0,1,0
55457,53,12461,53,allow,177,94,83,2,30,1,1
56864,445,0,0,drop,70,70,0,1,0,1,0
63592,443,55191,443,allow,6485,1871,4614,27,140,14,13
65179,53,63378,53,allow,184,94,90,2,31,1,1
52090,80,61372,80,allow,2774,703,2071,12,22,7,5
26124,56205,0,0,deny,146,146,0,1,0,1,0
60351,50584,0,0,deny,62,62,0,1,0,1,0
59583,445,0,0,drop,70,70,0,1,0,1,0
64617,53,10590,53,allow,301,102,199,2,30,1,1
55172,443,53179,443,allow,25605,3359,22246,47,82,26,21
42898,43890,0,0,deny,62,62,0,1,0,1,0
18423,51505,0,0,deny,66,66,0,1,0,1,0
19858,64147,0,0,deny,62,62,0,1,0,1,0
50127,80,7047,80,allow,164773,6196,158577,200,135,83,117
53596,56732,58606,56732,allow,70,70,0,2,7,2,0
59488,443,37367,443,allow,6100,580,5520,17,53,5,12
59765,445,0,0,drop,70,70,0,1,0,1,0
52741,24211,0,0,deny,66,66,0,1,0,1,0
58997,443,39971,443,allow,3576,2319,1257,21,23,11,10
49545,53,14394,53,allow,195,102,93,2,29,1,1
40220,443,35161,443,allow,5448,989,4459,22,84,10,12
59735,443,59735,443,allow,4730,1823,2907,19,28,11,8
10390,26467,0,0,deny,66,66,0,1,0,1,0
49660,53,56463,53,allow,193,102,91,2,31,1,1
55383,443,17690,443,allow,40612,4090,36522,71,150,31,40
49573,53,33204,53,allow,738,86,652,2,30,1,1
50075,443,63297,443,allow,4701,2758,1943,41,93,22,19
44815,36829,0,0,deny,62,62,0,1,0,1,0
49323,445,0,0,drop,70,70,0,1,0,1,0
51233,43890,0,0,deny,66,66,0,1,0,1,0
19204,57866,0,0,deny,66,66,0,1,0,1,0
51866,23431,38401,23431,allow,70,70,0,2,8,2,0
64746,445,0,0,drop,70,70,0,1,0,1,0
57360,18375,0,0,deny,66,66,0,1,0,1,0
65228,53,53617,53,allow,212,86,126,2,30,1,1
54745,445,0,0,drop,70,70,0,1,0,1,0
52257,6712,42589,6712,allow,70,70,0,2,8,2,0
50362,80,15549,80,allow,3907,880,3027,11,15,5,6
54490,445,0,0,drop,70,70,0,1,0,1,0
58835,17372,0,0,deny,66,66,0,1,0,1,0
40742,2967,0,0,deny,62,62,0,1,0,1,0
64339,18375,0,0,deny,66,66,0,1,0,1,0
2938,64147,0,0,deny,62,62,0,1,0,1,0
55534,53,6633,53,allow,86,86,0,1,30,1,0
58638,5900,58638,5900,allow,62,62,0,1,5,1,0
50523,53,7142,53,allow,168,86,82,2,31,1,1
48817,13073,48817,13073,allow,787,296,491,4,1200,2,2
63818,19291,56455,19291,allow,66,66,0,2,7,2,0
56788,53,32214,53,allow,199,102,97,2,30,1,1
62884,5223,41292,5223,allow,11427,6608,4819,37,248,21,16
51120,445,0,0,drop,66,66,0,1,0,1,0
56964,445,0,0,drop,70,70,0,1,0,1,0
38666,443,18669,443,allow,94827,3328,91499,97,16,30,67
65204,53,43316,53,allow,183,94,89,2,30,1,1
59994,11446,0,0,deny,66,66,0,1,0,1,0
64553,445,0,0,drop,66,66,0,1,0,1,0
53835,62413,0,0,deny,62,62,0,1,0,1,0
64816,123,36690,123,allow,184,94,90,2,30,1,1
65279,53,39619,53,allow,183,94,89,2,30,1,1
63925,18912,12626,18912,allow,70,70,0,1,4,1,0
27005,27272,38443,27272,allow,887,126,761,2,30,1,1
63811,443,59225,443,allow,25707,7559,18148,53,121,24,29
38018,443,11782,443,allow,1851,1222,629,16,27,10,6
58728,445,0,0,drop,66,66,0,1,0,1,0
49899,53,23402,53,allow,718,94,624,2,30,1,1
50419,80,4719,80,allow,350,350,0,1,120,1,0
51414,22,0,0,deny,60,60,0,1,0,1,0
56540,443,45404,443,allow,103117,6206,96911,127,106,54,73
27005,27015,53679,27015,allow,894,126,768,2,30,1,1
19885,64147,0,0,deny,145,145,0,1,0,1,0
64472,53,45709,53,allow,183,94,89,2,30,1,1
64410,53,3799,53,allow,196,102,94,2,35,1,1
14023,37965,0,0,deny,62,62,0,1,0,1,0
41047,443,9579,443,allow,6423,744,5679,16,16,9,7
65274,53,37017,53,allow,295,101,194,4,31,2,2
52212,51343,6977,51343,allow,70,70,0,2,6,2,0
47788,1879,0,0,deny,146,146,0,1,0,1,0
57858,445,0,0,drop,70,70,0,1,0,1,0
51753,15038,53015,15038,allow,66,66,0,1,5,1,0
50338,80,24125,80,allow,2475,723,1752,12,41,6,6
49248,53,8891,53,allow,211,102,109,2,30,1,1
56268,44847,0,0,deny,66,66,0,1,0,1,0
42050,53,28616,53,allow,168,78,90,2,30,1,1
52921,445,0,0,drop,70,70,0,1,0,1,0
16660,55783,0,0,deny,62,62,0,1,0,1,0
65129,443,48258,443,allow,1765,1126,639,17,125,10,7
15319,51505,0,0,deny,66,66,0,1,0,1,0
60187,443,37474,443,allow,5656,1936,3720,23,57,11,12
55033,443,57495,443,allow,19846,10062,9784,42,47,22,20
57266,445,0,0,drop,70,70,0,1,0,1,0
49748,53,20050,53,allow,763,102,661,2,30,1,1
50405,53,20541,53,allow,200,102,98,2,29,1,1
63710,445,0,0,drop,70,70,0,1,0,1,0
27841,35894,0,0,deny,62,62,0,1,0,1,0
65007,53,49517,53,allow,330,94,236,4,55,2,2
51425,53,0,0,allow,194,87,107,2,30,1,1
37584,443,21310,443,allow,499,425,74,4,0,3,1
55830,53,49103,53,allow,184,94,90,2,29,1,1
37854,443,37854,443,allow,1452,817,635,16,20,9,7
26531,37965,0,0,deny,62,62,0,1,0,1,0
62983,445,0,0,drop,70,70,0,1,0,1,0
32137,44512,0,0,deny,62,62,0,1,0,1,0
55152,445,0,0,drop,70,70,0,1,0,1,0
61948,53,63047,53,allow,205,86,119,2,30,1,1
49891,80,30734,80,allow,1694,666,1028,10,75,6,4
53512,53,23746,53,allow,168,78,90,2,30,1,1
60398,46776,0,0,deny,74,74,0,1,0,1,0
56622,80,24066,80,allow,234,234,0,4,12,4,0
20706,37965,0,0,deny,62,62,0,1,0,1,0
53202,443,64942,443,allow,3655,2344,1311,18,17,9,9
29884,25174,0,0,deny,62,62,0,1,0,1,0
62365,445,0,0,drop,66,66,0,1,0,1,0
60475,443,52273,443,allow,585392,18731,566661,623,119,209,414
49398,80,11997,80,allow,3651,2020,1631,16,65,9,7
49862,53,25145,53,allow,176,90,86,2,30,1,1
56112,53,3199,53,allow,198,101,97,2,31,1,1
55611,53,41439,53,allow,768,200,568,6,53,3,3
58756,443,10542,443,allow,5168,700,4468,16,15,7,9
16883,22,0,0,deny,60,60,0,1,0,1,0
65070,445,0,0,drop,66,66,0,1,0,1,0
50646,445,0,0,drop,70,70,0,1,0,1,0
65507,53,22060,53,allow,167,86,81,2,29,1,1
56846,445,0,0,drop,66,66,0,1,0,1,0
63467,37807,0,0,deny,62,62,0,1,0,1,0
36770,56205,0,0,deny,62,62,0,1,0,1,0
57896,46783,0,0,deny,100,100,0,1,0,1,0
58638,5900,0,0,deny,62,62,0,1,0,1,0
57341,53,32411,53,allow,184,94,90,2,31,1,1
60716,443,27537,443,allow,31452,6667,24785,54,32,29,25
53116,32014,29630,32014,allow,698,320,378,10,17,6,4
58058,443,59293,443,allow,560,280,280,9,28,5,4
51466,443,4846,443,allow,1878,1050,828,9,16,5,4
49879,445,0,0,drop,70,70,0,1,0,1,0
50254,2323,0,0,deny,60,60,0,1,0,1,0
55254,443,18308,443,allow,8431,2584,5847,25,46,14,11
53829,445,0,0,drop,66,66,0,1,0,1,0
51031,445,0,0,drop,70,70,0,1,0,1,0
63672,445,0,0,drop,66,66,0,1,0,1,0
55665,443,34619,443,allow,6291,1499,4792,22,17,11,11
49993,443,14877,443,allow,14857,1138,13719,26,17,10,16
61787,445,0,0,drop,70,70,0,1,0,1,0
65009,53,11589,53,allow,152,78,74,2,30,1,1
64073,53,51133,53,allow,361,86,275,2,30,1,1
55649,53,62328,53,allow,216,110,106,2,30,1,1
65389,26467,0,0,deny,62,62,0,1,0,1,0
40204,40018,24038,40018,allow,566,86,480,2,30,1,1
50674,443,55479,443,allow,8709,1708,7001,22,19,11,11
59413,51505,0,0,deny,62,62,0,1,0,1,0
28583,22114,0,0,deny,146,146,0,1,0,1,0
61507,445,0,0,drop,70,70,0,1,0,1,0
59918,445,0,0,drop,70,70,0,1,0,1,0
33936,443,61935,443,allow,9880,2011,7869,38,256,17,21
58638,5900,0,0,deny,62,62,0,1,0,1,0
62316,445,0,0,drop,66,66,0,1,0,1,0
64791,53,16107,53,allow,184,94,90,2,29,1,1
59743,445,0,0,drop,66,66,0,1,0,1,0
52902,443,33545,443,allow,13263,7381,5882,51,118,26,25
48019,22114,0,0,deny,66,66,0,1,0,1,0
54379,80,23086,80,allow,1466,729,737,12,16,7,5
58638,5900,0,0,deny,62,62,0,1,0,1,0
52034,80,60212,80,allow,366,240,126,7,25,5,2
59272,445,0,0,drop,66,66,0,1,0,1,0
57506,443,36392,443,allow,2696,1695,1001,24,105,13,11
38211,443,38211,443,allow,4653,1746,2907,19,26,11,8
31675,19473,0,0,deny,62,62,0,1,0,1,0
34352,53,34352,53,allow,240,98,142,2,30,1,1
49245,53,23757,53,allow,195,102,93,2,30,1,1
60591,80,30981,80,allow,1364,860,504,13,17,8,5
57491,445,0,0,drop,66,66,0,1,0,1,0
60292,7129,0,0,deny,62,62,0,1,0,1,0
50599,443,63618,443,allow,11301,5604,5697,29,139,17,12
43057,443,23412,443,allow,7725,1980,5745,25,20,14,11
49714,53,21823,53,allow,767,102,665,2,30,1,1
56354,53,25392,53,allow,753,93,660,2,30,1,1
53800,445,0,0,drop,66,66,0,1,0,1,0
39328,80,62636,80,allow,234,234,0,4,12,4,0
50584,49376,27285,49376,allow,1320,300,1020,6,1200,3,3
58638,5900,0,0,deny,62,62,0,1,0,1,0
2267,53,36345,53,allow,468,320,148,5,49,3,2
64385,53,21883,53,allow,307,105,202,4,47,2,2
65131,53,28562,53,allow,443,98,345,4,57,2,2
55799,53,31223,53,allow,752,93,659,2,31,1,1
10532,26672,0,0,deny,60,60,0,1,0,1,0
51006,445,0,0,drop,66,66,0,1,0,1,0
54832,445,0,0,drop,66,66,0,1,0,1,0
50550,445,0,0,drop,70,70,0,1,0,1,0
50873,443,21465,443,allow,6889,1381,5508,19,129,9,10
57354,53,26026,53,allow,177,94,83,2,29,1,1
49993,80,30030,80,allow,21812,900,20912,27,26,9,18
57479,445,0,0,drop,66,66,0,1,0,1,0
52050,445,0,0,drop,66,66,0,1,0,1,0
18750,57866,0,0,deny,62,62,0,1,0,1,0
7423,22114,0,0,deny,146,146,0,1,0,1,0
61524,23,0,0,deny,60,60,0,1,0,1,0
60098,445,0,0,drop,66,66,0,1,0,1,0
57470,10714,2677,10714,allow,132,132,0,3,1199,3,0
6126,25174,0,0,deny,66,66,0,1,0,1,0
52297,443,5562,443,allow,3055,1931,1124,16,16,9,7
58638,5900,58638,5900,allow,156,62,94,2,10,1,1
53759,42873,0,0,deny,74,74,0,1,0,1,0
64219,51050,0,0,deny,66,66,0,1,0,1,0
63976,25725,46114,25725,allow,66,66,0,2,8,2,0
55235,53,18331,53,allow,178,94,84,2,29,1,1
41719,50584,0,0,deny,146,146,0,1,0,1,0
53017,80,55649,80,allow,1658,1344,314,10,15,5,5
7968,53,7968,53,allow,407,261,146,3,32,2,1
49177,53,33754,53,allow,184,94,90,2,31,1,1
49212,53,34127,53,allow,1188,94,1094,2,29,1,1
64593,53,46361,53,allow,258,102,156,2,30,1,1
9223,443,33719,443,allow,4081,443,3638,12,15,6,6
49661,443,62284,443,allow,6950,2484,4466,20,53,11,9
50914,51505,0,0,deny,66,66,0,1,0,1,0
64647,53,58835,53,allow,575,193,382,6,80,3,3
37247,443,37247,443,allow,4401,1494,2907,19,25,11,8
55104,53,12993,53,allow,733,85,648,2,31,1,1
25309,53,25309,53,allow,371,237,134,3,33,2,1
65229,53,24708,53,allow,195,102,93,2,30,1,1
14360,64147,0,0,deny,62,62,0,1,0,1,0
49941,53,34590,53,allow,186,95,91,2,31,1,1
62438,445,0,0,drop,70,70,0,1,0,1,0
27005,37569,6063,37569,allow,880,126,754,2,31,1,1
55062,80,41792,80,allow,486,240,246,9,28,5,4
62272,445,0,0,drop,70,70,0,1,0,1,0
60838,445,0,0,drop,70,70,0,1,0,1,0
55383,445,0,0,drop,70,70,0,1,0,1,0
59915,42707,0,0,deny,145,145,0,1,0,1,0
56409,443,57180,443,allow,25302,1733,23569,35,121,16,19
58638,5900,0,0,deny,62,62,0,1,0,1,0
58777,445,0,0,drop,70,70,0,1,0,1,0
56562,44847,0,0,deny,62,62,0,1,0,1,0
54502,34729,0,0,deny,66,66,0,1,0,1,0
65013,445,0,0,drop,70,70,0,1,0,1,0
57294,53,58964,53,allow,387,134,253,2,30,1,1
12348,50265,0,0,deny,62,62,0,1,0,1,0
30129,37965,0,0,deny,72,72,0,1,0,1,0
57428,443,23700,443,allow,6277,1727,4550,16,75,9,7
42777,443,6253,443,allow,4353,687,3666,14,25,8,6
53559,445,0,0,drop,66,66,0,1,0,1,0
46167,80,23731,80,allow,234,234,0,4,11,4,0
60369,445,0,0,drop,66,66,0,1,0,1,0
49308,53,0,0,allow,180,80,100,2,30,1,1
58638,5900,0,0,deny,62,62,0,1,0,1,0
55811,445,0,0,drop,66,66,0,1,0,1,0
50396,62413,0,0,deny,66,66,0,1,0,1,0
39062,443,32900,443,allow,11360,8326,3034,36,22,19,17
12608,21247,0,0,deny,66,66,0,1,0,1,0
42867,443,28433,443,allow,15769,1619,14150,17,137,4,13
57131,31061,0,0,deny,145,145,0,1,0,1,0
55674,48870,28202,48870,allow,70,70,0,1,5,1,0
51959,445,0,0,drop,70,70,0,1,0,1,0
49262,53,27998,53,allow,168,86,82,2,31,1,1
59701,44847,0,0,deny,66,66,0,1,0,1,0
27401,37965,0,0,deny,66,66,0,1,0,1,0
56565,53,34463,53,allow,164,86,78,2,30,1,1
51724,25807,54569,25807,allow,70,70,0,2,8,2,0
58007,62413,0,0,deny,66,66,0,1,0,1,0
57470,51413,17602,51413,allow,330,330,0,6,1199,6,0
6355,25174,0,0,deny,62,62,0,1,0,1,0
10448,14914,0,0,deny,143,143,0,1,0,1,0
54189,22114,0,0,deny,66,66,0,1,0,1,0
16387,25523,0,0,allow,60,60,0,1,61,1,0
55692,18319,26451,18319,allow,320,140,180,6,7,3,3
61785,64147,0,0,deny,66,66,0,1,0,1,0
53106,59478,22060,59478,allow,70,70,0,1,5,1,0
49569,53,26958,53,allow,821,102,719,2,30,1,1
49877,80,36716,80,allow,28450,4547,23903,34,88,13,21
49905,443,56801,443,allow,4712,908,3804,18,77,9,9
49334,53,23056,53,allow,184,94,90,2,31,1,1
57312,53,57312,53,allow,208,94,114,2,30,1,1
56747,443,61148,443,allow,8059,2039,6020,20,16,11,9
13441,57470,0,0,deny,62,62,0,1,0,1,0
64719,53,8538,53,allow,381,98,283,4,51,2,2
58140,53,58140,53,allow,262,106,156,2,34,1,1
56803,52421,20663,52421,allow,164,70,94,2,5,1,1
54305,26467,0,0,deny,66,66,0,1,0,1,0
52959,80,37640,80,allow,122572,3630,118942,128,358,46,82
49711,445,0,0,drop,66,66,0,1,0,1,0
60830,50584,0,0,deny,62,62,0,1,0,1,0
54962,445,0,0,drop,66,66,0,1,0,1,0
65082,53,15912,53,allow,182,93,89,2,31,1,1
56643,443,54840,443,allow,7914,1925,5989,20,15,11,9
41611,80,9523,80,allow,1860,712,1148,8,15,5,3
55538,53,6885,53,allow,168,86,82,2,30,1,1
49584,445,0,0,drop,70,70,0,1,0,1,0
55437,443,56917,443,allow,24415,1491,22924,34,131,14,20
56655,443,40290,443,allow,8058,2038,6020,20,15,11,9
53275,21247,0,0,deny,66,66,0,1,0,1,0
56342,443,42448,443,allow,1463,988,475,12,27,7,5
55372,53,7749,53,allow,271,93,178,4,43,2,2
56161,53,4993,53,allow,817,102,715,2,30,1,1
53981,53,31166,53,allow,199,94,105,2,31,1,1
51866,23431,28853,23431,allow,70,70,0,1,5,1,0
55123,64097,0,0,deny,66,66,0,1,0,1,0
50731,445,0,0,drop,66,66,0,1,0,1,0
53983,40500,9041,40500,allow,70,70,0,1,4,1,0
50012,7000,50012,7000,allow,3132,815,2317,14,16,7,7
49787,53,40556,53,allow,258,110,148,2,29,1,1
1025,57470,0,0,deny,62,62,0,1,0,1,0
53713,26085,43109,26085,allow,70,70,0,2,7,2,0
60557,23117,0,0,deny,62,62,0,1,0,1,0
62701,445,0,0,drop,70,70,0,1,0,1,0
57038,53,31637,53,allow,194,102,92,2,30,1,1
58175,445,0,0,drop,70,70,0,1,0,1,0
443,9863,0,0,deny,60,60,0,1,0,1,0
57470,14435,56762,14435,allow,1035,253,782,4,1200,2,2
49928,53,49928,53,allow,229,90,139,2,30,1,1
49242,53,38872,53,allow,167,86,81,2,29,1,1
63398,25174,0,0,deny,66,66,0,1,0,1,0
64573,53,7328,53,allow,184,94,90,2,31,1,1
50520,53,48841,53,allow,183,94,89,2,30,1,1
56599,443,36954,443,allow,348780,9144,339636,358,32,123,235
48265,443,59042,443,allow,4138,2416,1722,31,80,16,15
9447,443,13084,443,allow,5691,503,5188,14,15,7,7
55034,443,64856,443,allow,45487,4986,40501,74,47,36,38
52236,15313,56383,15313,allow,70,70,0,2,5,2,0
65114,53,14258,53,allow,177,94,83,2,29,1,1
64879,53,23535,53,allow,173,94,79,2,30,1,1
23353,25174,0,0,deny,62,62,0,1,0,1,0
49878,445,0,0,drop,70,70,0,1,0,1,0
54666,36237,0,0,deny,62,62,0,1,0,1,0
54249,445,0,0,drop,70,70,0,1,0,1,0
3478,61463,0,0,deny,1302,1302,0,1,0,1,0
56304,53,19681,53,allow,184,94,90,2,30,1,1
49651,37965,0,0,deny,74,74,0,1,0,1,0
51254,445,0,0,drop,66,66,0,1,0,1,0
57226,53,4215,53,allow,88,88,0,1,30,1,0
65068,445,0,0,drop,66,66,0,1,0,1,0
61088,445,0,0,drop,70,70,0,1,0,1,0
64515,53,64413,53,allow,231,86,145,2,30,1,1
63771,7426,20150,7426,allow,70,70,0,1,5,1,0
56113,53,19299,53,allow,817,102,715,2,30,1,1
57737,53,57737,53,allow,374,240,134,3,32,2,1
65315,53,36625,53,allow,94,94,0,1,30,1,0
50265,12348,24050,12348,allow,858,858,0,14,1200,14,0
60038,445,0,0,drop,70,70,0,1,0,1,0
57368,443,57368,443,allow,4401,1494,2907,19,28,11,8
51839,80,51839,80,allow,951054,20747,930307,902,26,276,626
42298,40030,5035,40030,allow,146,84,62,2,31,1,1
53013,80,53013,80,allow,258732,4788,253944,268,25,71,197
51637,443,21678,443,allow,3110,1049,2061,14,136,7,7
52650,445,0,0,drop,70,70,0,1,0,1,0
60380,55125,31447,55125,allow,70,70,0,1,5,1,0
46349,51505,0,0,deny,70,70,0,1,0,1,0
56281,53,50630,53,allow,170,87,83,2,31,1,1
32704,46824,0,0,deny,66,66,0,1,0,1,0
58638,5900,0,0,deny,62,62,0,1,0,1,0
55018,443,29845,443,allow,7232,2925,4307,27,16,16,11
23277,53733,0,0,deny,66,66,0,1,0,1,0
55272,53,55902,53,allow,198,110,88,2,30,1,1
49894,80,26822,80,allow,1409,735,674,12,17,5,7
61631,445,0,0,drop,70,70,0,1,0,1,0
55620,30188,0,0,deny,66,66,0,1,0,1,0
49804,53,30225,53,allow,209,102,107,2,30,1,1
58754,53,0,0,allow,258,80,178,2,30,1,1
64913,53,27699,53,allow,182,93,89,2,31,1,1
53969,13156,38324,13156,allow,70,70,0,2,7,2,0
62991,51221,0,0,deny,66,66,0,1,0,1,0
53863,8999,63067,8999,allow,70,70,0,1,5,1,0
50209,53,45881,53,allow,780,104,676,2,31,1,1
57115,53,15026,53,allow,756,95,661,2,30,1,1
47092,15000,12405,15000,allow,138,78,60,2,5,1,1
51394,445,0,0,drop,70,70,0,1,0,1,0
64847,22114,0,0,deny,66,66,0,1,0,1,0
56373,53,9472,53,allow,200,102,98,2,30,1,1
49369,443,29095,443,allow,7165,1099,6066,16,15,9,7
60952,445,0,0,drop,66,66,0,1,0,1,0
36256,443,43168,443,allow,3871,2466,1405,22,95,12,10
23683,53,23683,53,allow,338,225,113,3,30,2,1
50334,443,44789,443,allow,8863,1567,7296,24,41,12,12
56278,445,0,0,drop,70,70,0,1,0,1,0
60825,445,0,0,drop,70,70,0,1,0,1,0
51908,80,63314,80,allow,4542,2962,1580,13,28,8,5
57011,53,6103,53,allow,770,101,669,2,30,1,1
50567,443,13850,443,allow,1202,720,482,12,139,7,5
64825,53,52627,53,allow,184,94,90,2,30,1,1
60560,445,0,0,drop,70,70,0,1,0,1,0
58683,445,0,0,drop,70,70,0,1,0,1,0
49354,443,37956,443,allow,22643,7456,15187,32,15,17,15
65299,53,37280,53,allow,177,94,83,2,30,1,1
50563,445,0,0,drop,70,70,0,1,0,1,0
57181,445,0,0,drop,70,70,0,1,0,1,0
56660,445,0,0,drop,66,66,0,1,0,1,0
49998,443,24613,443,allow,24410,6698,17712,32,16,13,19
27005,27015,30434,27015,allow,877,126,751,2,30,1,1
57349,53,0,0,allow,222,86,136,2,30,1,1
60512,6881,33887,6881,allow,320,140,180,6,6,3,3
64677,53,6467,53,allow,195,102,93,2,30,1,1
62414,50584,0,0,deny,66,66,0,1,0,1,0
63941,53,9002,53,allow,228,94,134,2,30,1,1
65078,53,50659,53,allow,177,94,83,2,30,1,1
57862,445,0,0,drop,66,66,0,1,0,1,0
46866,80,59082,80,allow,662,600,62,12,495,11,1
14717,64147,0,0,deny,66,66,0,1,0,1,0
13699,53,13699,53,allow,194,87,107,2,30,1,1
52459,5555,0,0,deny,60,60,0,1,0,1,0
56730,53,51057,53,allow,733,86,647,2,30,1,1
80,13743,80,13743,allow,70,70,0,1,5,1,0
27005,27016,54195,27016,allow,876,126,750,2,30,1,1
51351,445,0,0,drop,70,70,0,1,0,1,0
49709,80,19787,80,allow,1702,1388,314,10,15,5,5
52094,55986,33027,55986,allow,66,66,0,1,5,1,0
55679,1024,59914,1024,allow,70,70,0,2,8,2,0
37959,3855,0,0,deny,72,72,0,1,0,1,0
50991,443,38073,443,allow,6448,2376,4072,22,2,10,12
60391,47212,11970,47212,allow,164,70,94,2,5,1,1
63716,23,0,0,deny,60,60,0,1,0,1,0
49310,53,61139,53,allow,186,95,91,3,33,2,1
53000,80,5659,80,allow,1991,686,1305,10,335,6,4
47348,23,0,0,deny,60,60,0,1,0,1,0
41936,443,58038,443,allow,7118,2386,4732,18,133,10,8
63822,14037,0,0,deny,145,145,0,1,0,1,0
58638,5900,0,0,deny,62,62,0,1,0,1,0
62813,445,0,0,drop,66,66,0,1,0,1,0
65239,53,57855,53,allow,489,185,304,6,73,3,3
443,61686,0,0,deny,78,78,0,1,0,1,0
52019,445,0,0,drop,70,70,0,1,0,1,0
42414,50939,0,0,deny,148,148,0,1,0,1,0
49770,80,9129,80,allow,254,128,126,5,15,3,2
48817,51413,48817,51413,allow,460,150,310,2,1200,1,1
50064,80,16215,80,allow,186,64,122,4,25,2,2
64788,53,23511,53,allow,168,86,82,2,30,1,1
27321,25174,0,0,deny,146,146,0,1,0,1,0
26900,27017,12136,27017,allow,422,164,258,6,30,3,3
22357,6004,0,0,deny,62,62,0,1,0,1,0
55070,445,0,0,drop,66,66,0,1,0,1,0
62941,445,0,0,drop,66,66,0,1,0,1,0
8380,80,8380,80,allow,25613,1592,24021,32,22,9,23
56804,443,56989,443,allow,8074,2054,6020,20,15,11,9
31404,36778,0,0,deny,100,100,0,1,0,1,0
27348,22114,0,0,deny,66,66,0,1,0,1,0
56818,45179,49960,45179,allow,70,70,0,1,5,1,0
56532,53,51264,53,allow,186,95,91,2,31,1,1
55288,443,7334,443,allow,15679,1532,14147,16,139,3,13
60898,443,32262,443,allow,10104,1643,8461,28,46,15,13
64797,53,38007,53,allow,183,94,89,2,30,1,1
56111,445,0,0,drop,70,70,0,1,0,1,0
52494,36237,0,0,deny,62,62,0,1,0,1,0
55973,25174,0,0,deny,62,62,0,1,0,1,0
56539,443,36962,443,allow,8335,2802,5533,26,567,14,12
49633,53,21391,53,allow,168,86,82,2,30,1,1
56351,53,2881,53,allow,195,102,93,2,30,1,1
51071,445,0,0,drop,70,70,0,1,0,1,0
443,59493,0,0,deny,60,60,0,1,0,1,0
9160,443,28992,443,allow,5727,491,5236,14,15,7,7
60311,30627,0,0,deny,66,66,0,1,0,1,0
61692,443,18049,443,allow,126,60,66,3,10,2,1
59060,50584,0,0,deny,66,66,0,1,0,1,0
50433,445,0,0,drop,70,70,0,1,0,1,0
52280,5228,18366,5228,allow,2147,1315,832,14,3601,7,7
49514,52255,0,0,deny,162,162,0,1,0,1,0
64885,53,4392,53,allow,166,86,80,2,29,1,1
61261,445,0,0,drop,66,66,0,1,0,1,0
55233,445,0,0,drop,66,66,0,1,0,1,0
35610,37965,0,0,deny,62,62,0,1,0,1,0
49160,52011,11430,52011,allow,800,150,650,4,1200,2,2
56245,80,56245,80,allow,101179,1296,99883,88,15,18,70
64986,53,47302,53,allow,176,90,86,2,31,1,1
47552,443,59060,443,allow,6268,1904,4364,30,119,16,14
49786,25174,0,0,deny,66,66,0,1,0,1,0
55596,445,0,0,drop,70,70,0,1,0,1,0
27005,12345,8943,12345,allow,898,126,772,2,31,1,1
52211,80,22459,80,allow,8559,5109,3450,23,160,12,11
64438,53,4120,53,allow,184,94,90,2,30,1,1
57048,445,0,0,drop,70,70,0,1,0,1,0
11592,80,11592,80,allow,6967,765,6202,15,16,7,8
33960,22,33960,22,allow,5468,1991,3477,27,34,15,12
52018,2425,15478,2425,allow,70,70,0,2,9,2,0
59192,25174,0,0,deny,66,66,0,1,0,1,0
53660,18599,61340,18599,allow,492,306,186,8,16,5,3
19455,25174,0,0,deny,62,62,0,1,0,1,0
56815,443,53722,443,allow,7903,1914,5989,20,15,11,9
51837,80,11115,80,allow,242,120,122,5,31,3,2
53616,44166,16410,44166,allow,70,70,0,2,7,2,0
27507,25174,0,0,deny,62,62,0,1,0,1,0
58435,445,0,0,drop,70,70,0,1,0,1,0
25448,36827,0,0,deny,62,62,0,1,0,1,0
60222,80,61233,80,allow,1989,1365,624,11,151,6,5
23916,53,23916,53,allow,224,88,136,2,30,1,1
64579,53,56844,53,allow,178,94,84,2,30,1,1
56728,53,16534,53,allow,166,86,80,2,30,1,1
48908,53,48908,53,allow,398,255,143,3,32,2,1
62420,445,0,0,drop,70,70,0,1,0,1,0
61093,445,0,0,drop,70,70,0,1,0,1,0
54458,64147,0,0,deny,62,62,0,1,0,1,0
60180,445,0,0,drop,66,66,0,1,0,1,0
52462,25174,0,0,deny,62,62,0,1,0,1,0
13525,51505,0,0,deny,62,62,0,1,0,1,0
56706,445,0,0,drop,66,66,0,1,0,1,0
51606,443,25122,443,allow,5188,1096,4092,21,95,12,9
37611,443,44824,443,allow,499,425,74,4,0,3,1
443,6793,0,0,allow,169,169,0,2,90,2,0
55689,37558,21710,37558,allow,70,70,0,2,8,2,0
55902,445,0,0,drop,70,70,0,1,0,1,0
63814,12906,64380,12906,allow,66,66,0,2,7,2,0
56926,53,27418,53,allow,711,87,624,2,30,1,1
54633,445,0,0,drop,70,70,0,1,0,1,0
59888,443,25489,443,allow,4350,2061,2289,18,47,10,8
16994,57866,0,0,deny,146,146,0,1,0,1,0
55663,44847,0,0,deny,62,62,0,1,0,1,0
49513,53,36009,53,allow,200,102,98,2,30,1,1
49864,80,42240,80,allow,5205,1474,3731,9,88,5,4
55932,53,12204,53,allow,193,102,91,2,29,1,1
50017,53,65009,53,allow,741,94,647,2,30,1,1
64730,445,0,0,drop,70,70,0,1,0,1,0
54268,445,0,0,drop,70,70,0,1,0,1,0
55891,445,0,0,drop,66,66,0,1,0,1,0
23379,57866,0,0,deny,62,62,0,1,0,1,0
42213,443,21488,443,allow,4622,926,3696,18,255,10,8
46822,3389,46822,3389,allow,3457,1568,1889,17,21,10,7
50821,445,0,0,drop,66,66,0,1,0,1,0
2394,43890,0,0,deny,62,62,0,1,0,1,0
49986,53,37815,53,allow,312,93,219,4,37,2,2
52762,445,0,0,drop,70,70,0,1,0,1,0
31978,57470,0,0,deny,60,60,0,1,0,1,0
65482,443,24363,443,allow,92212,4799,87413,107,16,43,64
45354,443,16907,443,allow,81504,6111,75393,108,20,53,55
26867,443,1450,443,allow,11115,3034,8081,35,19,18,17
46948,443,43691,443,allow,6374,2446,3928,26,217,13,13
51897,445,0,0,drop,66,66,0,1,0,1,0
17481,64097,0,0,deny,146,146,0,1,0,1,0
32707,11392,0,0,deny,146,146,0,1,0,1,0
54532,445,0,0,drop,70,70,0,1,0,1,0
58076,21247,0,0,deny,66,66,0,1,0,1,0
51503,443,40605,443,allow,4801,702,4099,13,16,8,5
61395,445,0,0,drop,70,70,0,1,0,1,0
61865,35440,0,0,deny,66,66,0,1,0,1,0
27988,40034,46189,40034,allow,141,79,62,2,31,1,1
57283,53,20762,53,allow,185,102,83,2,29,1,1
49839,443,14297,443,allow,5026,973,4053,19,72,10,9
56892,53,6597,53,allow,199,102,97,2,30,1,1
37570,443,49846,443,allow,499,425,74,4,0,3,1
49748,445,0,0,drop,70,70,0,1,0,1,0
57424,53,34696,53,allow,177,94,83,2,30,1,1
49410,53,65177,53,allow,172,88,84,2,31,1,1
53710,27935,34512,27935,allow,70,70,0,1,4,1,0
42298,40008,56571,40008,allow,206,84,122,4,31,2,2
42344,48637,0,0,deny,60,60,0,1,0,1,0
30046,15503,0,0,deny,62,62,0,1,0,1,0
29682,44847,0,0,deny,62,62,0,1,0,1,0
56261,53,65402,53,allow,199,94,105,2,30,1,1
38689,443,13215,443,allow,1264333,25315,1239018,1197,16,355,842
49183,443,49342,443,allow,473744,13158,460586,495,20,183,312
50765,22114,0,0,deny,66,66,0,1,0,1,0
36400,443,31590,443,allow,53365,28404,24961,565,753,302,263
51221,47391,14393,47391,allow,323,150,173,2,1203,1,1
50393,443,41486,443,allow,7356,1014,6342,20,75,10,10
50052,65008,0,0,deny,60,60,0,1,0,1,0
58553,445,0,0,drop,66,66,0,1,0,1,0
55678,32468,0,0,deny,66,66,0,1,0,1,0
65184,53,30460,53,allow,225,102,123,2,30,1,1
44258,443,15237,443,allow,14478,1815,12663,30,170,14,16
49486,443,60567,443,allow,4160,1015,3145,16,28,8,8
51472,445,0,0,drop,70,70,0,1,0,1,0
53288,443,63225,443,allow,4448,1654,2794,13,121,6,7
64243,53,51060,53,allow,258,102,156,2,30,1,1
60911,53,23878,53,allow,335,78,257,2,29,1,1
35832,443,34150,443,allow,9276,1884,7392,23,32,13,10
26778,443,2994,443,allow,7407,2650,4757,24,20,12,12
50524,80,58944,80,allow,102242,12176,90066,149,156,68,81
6881,6882,46322,6882,allow,324,150,174,2,1200,1,1
55956,445,0,0,drop,70,70,0,1,0,1,0
65012,445,0,0,drop,70,70,0,1,0,1,0
51991,80,57002,80,allow,482,300,182,9,25,6,3
52005,80,9480,80,allow,46046,2705,43341,60,15,29,31
59563,56205,0,0,deny,66,66,0,1,0,1,0
443,14591,0,0,deny,60,60,0,1,0,1,0
5938,47512,0,0,allow,60,60,0,1,90,1,0
23843,26467,0,0,deny,62,62,0,1,0,1,0
57009,53,8536,53,allow,177,94,83,2,30,1,1
56754,53,1275,53,allow,751,95,656,2,30,1,1
51941,445,0,0,drop,70,70,0,1,0,1,0
63615,23,0,0,deny,60,60,0,1,0,1,0
51377,443,25439,443,allow,2838,944,1894,12,135,7,5
26900,27017,25827,27017,allow,172,86,86,2,29,1,1
59508,65348,0,0,deny,148,148,0,1,0,1,0
53779,37965,0,0,deny,66,66,0,1,0,1,0
49572,443,30462,443,allow,7538,4953,2585,21,54,12,9
57546,443,50936,443,allow,34428,22220,12208,84,122,41,43
7992,64147,0,0,deny,62,62,0,1,0,1,0
39474,443,60202,443,allow,9766,2050,7716,23,15,12,11
63389,3389,63389,3389,reset-both,293,223,70,4,0,3,1
50178,445,0,0,drop,70,70,0,1,0,1,0
50999,445,0,0,drop,70,70,0,1,0,1,0
56522,443,50354,443,allow,5212,1037,4175,20,115,10,10
53603,53796,63183,53796,allow,70,70,0,2,7,2,0
56128,53,30035,53,allow,744,89,655,2,31,1,1
63887,80,15748,80,allow,314,192,122,6,15,4,2
49297,80,62329,80,allow,16249,1328,14921,28,45,14,14
51241,445,0,0,drop,66,66,0,1,0,1,0
52472,443,52472,443,allow,4400,1493,2907,19,31,11,8
63346,37965,0,0,deny,66,66,0,1,0,1,0
59298,80,59298,80,allow,85989,14398,71591,143,15,40,103
60184,443,52371,443,allow,26293,7740,18553,55,121,26,29
58418,443,64364,443,allow,15305,3334,11971,45,198,21,24
57387,53,49331,53,allow,178,94,84,2,30,1,1
51533,44847,0,0,deny,66,66,0,1,0,1,0
60006,443,38577,443,allow,185169,75281,109888,426,111,209,217
55835,445,0,0,drop,70,70,0,1,0,1,0
58970,443,57205,443,allow,3715,1958,1757,23,21,12,11
55037,443,19621,443,allow,10640,3171,7469,28,45,15,13
55396,53,1903,53,allow,778,103,675,2,30,1,1
65383,53,42198,53,allow,267,94,173,2,30,1,1
63786,25174,0,0,deny,62,62,0,1,0,1,0
26698,57470,0,0,deny,62,62,0,1,0,1,0
38126,3389,38126,3389,reset-both,293,223,70,4,1,3,1
3229,53,3229,53,allow,244,98,146,2,31,1,1
21542,57470,0,0,deny,74,74,0,1,0,1,0
56913,53,62016,53,allow,247,94,153,2,30,1,1
53499,445,0,0,drop,70,70,0,1,0,1,0
4041,23,0,0,deny,60,60,0,1,0,1,0
49903,443,42458,443,allow,8078,1511,6567,30,54,14,16
51818,43942,37942,43942,allow,258,70,188,4,8,2,2
56871,53,27631,53,allow,198,86,112,2,30,1,1
28221,37965,0,0,deny,62,62,0,1,0,1,0
49432,445,0,0,drop,70,70,0,1,0,1,0
55351,445,0,0,drop,70,70,0,1,0,1,0
49760,80,15959,80,allow,2113,1181,932,10,127,6,4
55777,53,11730,53,allow,200,94,106,2,30,1,1
51328,30228,0,0,deny,109,109,0,1,0,1,0
55107,53,52328,53,allow,214,102,112,2,30,1,1
57396,443,25332,443,allow,9318,3350,5968,31,140,14,17
54631,445,0,0,drop,66,66,0,1,0,1,0
60597,53,0,0,allow,344,94,250,2,29,1,1
3478,61463,0,0,deny,156,156,0,1,0,1,0
44009,443,15754,443,allow,1392,731,661,14,80,8,6
53894,2944,4121,2944,allow,70,70,0,2,8,2,0
50390,80,49086,80,allow,360,180,180,7,26,4,3
54935,445,0,0,drop,66,66,0,1,0,1,0
49440,443,59866,443,allow,5141,896,4245,17,69,8,9
57034,44847,0,0,deny,66,66,0,1,0,1,0
51960,443,7003,443,allow,8830,1950,6880,27,25,14,13
43361,80,14228,80,allow,630,630,0,10,217,10,0
42008,53,0,0,allow,82,82,0,1,30,1,0
54452,445,0,0,drop,66,66,0,1,0,1,0
37435,53,37435,53,allow,414,268,146,3,32,2,1
42558,64147,0,0,deny,62,62,0,1,0,1,0
57172,53,55364,53,allow,192,98,94,2,31,1,1
62173,445,0,0,drop,70,70,0,1,0,1,0
55388,53,1153,53,allow,177,94,83,2,30,1,1
58079,445,0,0,drop,66,66,0,1,0,1,0
51822,80,12401,80,allow,3709,1390,2319,17,19,10,7
65189,27015,46211,27015,allow,267,78,189,2,30,1,1
54199,445,0,0,drop,66,66,0,1,0,1,0
49226,53,3367,53,allow,194,102,92,2,30,1,1
37321,443,3162,443,allow,70,70,0,1,5,1,0
5405,53,5405,53,allow,645,90,555,2,30,1,1
49857,443,36785,443,allow,4221,1038,3183,19,59,11,8
51882,445,0,0,drop,70,70,0,1,0,1,0
37965,16153,40075,16153,allow,1320,1320,0,21,1682,21,0
58652,445,0,0,drop,70,70,0,1,0,1,0
27005,27207,59346,27207,allow,875,126,749,2,29,1,1
25565,27942,0,0,deny,60,60,0,1,0,1,0
45694,80,47472,80,allow,154671,9533,145138,227,38,121,106
21213,23,0,0,deny,60,60,0,1,0,1,0
56373,53,9374,53,allow,177,94,83,2,30,1,1
51564,50584,0,0,deny,66,66,0,1,0,1,0
55377,53,19699,53,allow,1428,103,1325,4,32,2,2
35085,443,56294,443,allow,1617,1062,555,13,45,8,5
39272,443,24238,443,allow,7134,1963,5171,22,284,11,11
49791,53,37520,53,allow,412,90,322,4,34,2,2
55605,27274,9607,27274,allow,130,70,60,2,4,1,1
55024,53,59987,53,allow,179,94,85,2,30,1,1
60339,80,1887,80,allow,35136,7862,27274,53,124,26,27
55681,31948,3131,31948,allow,70,70,0,2,8,2,0
50635,443,12337,443,allow,8252,1702,6550,26,72,13,13
57082,80,34844,80,allow,2944,1074,1870,12,75,7,5
57007,53,36349,53,allow,183,94,89,2,31,1,1
51307,80,27411,80,allow,5912,5182,730,15,23,9,6
56799,443,34365,443,allow,5057,880,4177,16,70,8,8
50184,445,0,0,drop,70,70,0,1,0,1,0
55498,53,0,0,allow,86,86,0,1,30,1,0
55391,53,33139,53,allow,210,110,100,2,30,1,1
65477,53,57278,53,allow,183,94,89,2,30,1,1
55285,53,16025,53,allow,268,95,173,4,47,2,2
55663,19994,59885,19994,allow,70,70,0,2,8,2,0
6224,37965,0,0,deny,62,62,0,1,0,1,0
37653,5223,53311,5223,allow,70,70,0,1,5,1,0
62424,445,0,0,drop,70,70,0,1,0,1,0
55066,445,0,0,drop,70,70,0,1,0,1,0
53852,14099,17770,14099,allow,320,140,180,6,6,3,3
64987,445,0,0,drop,66,66,0,1,0,1,0
54530,35440,0,0,deny,66,66,0,1,0,1,0
60750,40010,25363,40010,allow,316,136,180,6,6,3,3
58320,53,15987,53,allow,331,86,245,2,30,1,1
49710,445,0,0,drop,70,70,0,1,0,1,0
65493,51221,0,0,deny,62,62,0,1,0,1,0
34400,39004,0,0,deny,74,74,0,1,0,1,0
57033,443,35994,443,allow,1092898,42451,1050447,1213,155,423,790
50011,53,7545,53,allow,766,102,664,2,30,1,1
50409,445,0,0,drop,66,66,0,1,0,1,0
63749,445,0,0,drop,70,70,0,1,0,1,0
49935,53,2977,53,allow,370,94,276,2,30,1,1
47009,53,0,0,allow,86,86,0,1,30,1,0
21544,41599,31043,41599,allow,70,70,0,1,5,1,0
37352,80,54268,80,allow,1115,562,553,13,362,6,7
49331,443,35944,443,allow,78663,4968,73695,85,47,24,61
50360,37965,0,0,deny,66,66,0,1,0,1,0
49295,53,60133,53,allow,194,102,92,2,32,1,1
64380,53,5955,53,allow,193,102,91,2,30,1,1
46516,57470,0,0,deny,62,62,0,1,0,1,0
59133,443,44471,443,allow,2863,1501,1362,20,315,10,10
62189,64147,0,0,deny,145,145,0,1,0,1,0
61298,445,0,0,drop,70,70,0,1,0,1,0
56614,25174,0,0,deny,66,66,0,1,0,1,0
53899,445,0,0,drop,70,70,0,1,0,1,0
59535,25174,0,0,deny,62,62,0,1,0,1,0
61477,57470,0,0,deny,66,66,0,1,0,1,0
49893,443,25504,443,allow,617481,41514,575967,856,221,381,475
43814,34476,0,0,deny,146,146,0,1,0,1,0
53968,17904,18186,17904,allow,320,140,180,6,7,3,3
12737,35440,0,0,deny,62,62,0,1,0,1,0
29972,50584,0,0,deny,62,62,0,1,0,1,0
49900,443,28761,443,allow,1820,1101,719,18,73,10,8
49708,53,19621,53,allow,212,94,118,2,29,1,1
44011,443,64228,443,allow,1056,569,487,10,78,6,4
55311,53,15716,53,allow,298,101,197,4,31,2,2
63459,443,63459,443,allow,4506,1599,2907,19,28,11,8
64908,445,0,0,drop,66,66,0,1,0,1,0
58582,50584,0,0,deny,62,62,0,1,0,1,0
56645,443,24912,443,allow,37030,24937,12093,83,1286,30,53
40050,53,42804,53,allow,168,78,90,2,30,1,1
56680,443,53449,443,allow,7889,1900,5989,20,15,11,9
50882,445,0,0,drop,70,70,0,1,0,1,0
13441,57470,0,0,deny,62,62,0,1,0,1,0
57174,57470,0,0,deny,66,66,0,1,0,1,0
65010,53,7971,53,allow,758,102,656,2,29,1,1
64603,53,49089,53,allow,269,110,159,2,30,1,1
26900,27017,15818,27017,allow,422,164,258,6,30,3,3
49554,53,46723,53,allow,541,201,340,6,64,3,3
2919,37965,0,0,deny,62,62,0,1,0,1,0
55555,53,26797,53,allow,194,102,92,2,30,1,1
58393,445,0,0,drop,70,70,0,1,0,1,0
58311,445,0,0,drop,70,70,0,1,0,1,0
53910,443,14287,443,allow,499,425,74,4,0,3,1
39380,49903,0,0,deny,146,146,0,1,0,1,0
45896,443,32975,443,allow,1160457,45088,1115369,1320,315,518,802
64556,445,0,0,drop,70,70,0,1,0,1,0
65157,53,24624,53,allow,209,102,107,2,31,1,1
44363,443,4525,443,allow,10667,2992,7675,32,560,17,15
38082,443,14308,443,allow,284,164,120,4,15,2,2
64281,53,41166,53,allow,492,90,402,4,45,2,2
49976,22114,0,0,deny,66,66,0,1,0,1,0
51588,445,0,0,drop,70,70,0,1,0,1,0
34960,443,12324,443,allow,190,70,120,4,15,2,2
57904,80,60274,80,allow,6453,1210,5243,14,23,8,6
52136,42939,1692,42939,allow,70,70,0,1,5,1,0
49859,80,31286,80,allow,1529,677,852,11,89,6,5
53639,445,0,0,drop,66,66,0,1,0,1,0
13980,23,0,0,deny,60,60,0,1,0,1,0
49845,80,64041,80,allow,31466,852,30614,32,89,9,23
55209,53,33482,53,allow,196,102,94,2,33,1,1
41093,53,34774,53,allow,78,78,0,1,30,1,0
16387,35244,0,0,deny,60,60,0,1,0,1,0
49888,53,58972,53,allow,363,97,266,4,34,2,2
49598,80,65095,80,allow,400,70,330,6,24,1,5
37577,443,55436,443,allow,499,425,74,4,0,3,1
51544,34476,0,0,deny,137,137,0,1,0,1,0
14272,53,14272,53,allow,1415,689,726,3,31,2,1
53831,80,61237,80,allow,5774,1483,4291,14,162,8,6
64292,53,10616,53,allow,387,94,293,4,51,2,2
52087,52766,15525,52766,allow,136,136,0,3,14,3,0
27988,40029,26130,40029,allow,140,78,62,2,30,1,1
56422,53,18940,53,allow,199,102,97,2,30,1,1
33948,50432,0,0,deny,146,146,0,1,0,1,0
53530,8999,1234,8999,allow,70,70,0,1,5,1,0
54058,445,0,0,drop,70,70,0,1,0,1,0
65294,53,37568,53,allow,168,86,82,2,30,1,1
43394,53,50886,53,allow,168,78,90,2,31,1,1
51930,57470,0,0,deny,66,66,0,1,0,1,0
31593,53,31593,53,allow,832,106,726,2,30,1,1
60255,445,0,0,drop,70,70,0,1,0,1,0
49501,53,44593,53,allow,186,95,91,2,31,1,1
24929,53,24929,53,allow,217,87,130,2,31,1,1
51877,443,15246,443,allow,1852,1103,749,16,31,9,7
49935,53,10954,53,allow,75,75,0,1,30,1,0
57987,56125,0,0,deny,90,90,0,1,0,1,0
56730,53,53565,53,allow,210,110,100,2,30,1,1
46056,443,52673,443,allow,80200,69062,11138,193,89,100,93
50008,53,2633,53,allow,232,94,138,2,29,1,1
53031,445,0,0,drop,66,66,0,1,0,1,0
32967,443,43142,443,allow,5327,963,4364,19,15,11,8
53415,445,0,0,drop,70,70,0,1,0,1,0
64420,53,21949,53,allow,362,94,268,2,30,1,1
57634,5228,55639,5228,allow,165,105,60,2,5,1,1
55560,53,7666,53,allow,166,86,80,2,30,1,1
53947,867,6908,867,allow,70,70,0,1,5,1,0
59303,21247,0,0,deny,66,66,0,1,0,1,0
25457,25604,0,0,deny,62,62,0,1,0,1,0
60351,50584,0,0,deny,66,66,0,1,0,1,0
49824,25174,0,0,deny,146,146,0,1,0,1,0
18091,32480,0,0,deny,66,66,0,1,0,1,0
57470,44046,49985,44046,allow,166,166,0,1,1199,1,0
56828,53,33245,53,allow,211,102,109,2,30,1,1
3478,61463,0,0,deny,1306,1306,0,1,0,1,0
57499,80,57499,80,allow,343853,13570,330283,445,3,223,222
58856,80,5930,80,allow,1614,1300,314,10,15,5,5
52169,80,44471,80,allow,362,240,122,7,17,5,2
50727,57470,0,0,deny,78,78,0,1,0,1,0
49570,443,47382,443,allow,162268,121343,40925,316,6101,108,208
59846,443,17762,443,allow,23856,3218,20638,40,18,16,24
56418,53,6346,53,allow,183,94,89,2,29,1,1
42792,443,30288,443,allow,7102,1857,5245,28,95,15,13
55492,53,34032,53,allow,216,110,106,2,29,1,1
10036,44847,0,0,deny,66,66,0,1,0,1,0
57470,24276,41676,24276,allow,132,132,0,3,1200,3,0
39630,443,32291,443,allow,70,70,0,1,5,1,0
57356,443,8609,443,allow,7644,3087,4557,26,46,15,11
58977,37965,0,0,deny,66,66,0,1,0,1,0
49911,445,0,0,drop,70,70,0,1,0,1,0
49371,445,0,0,drop,70,70,0,1,0,1,0
52147,30265,24438,30265,allow,70,70,0,2,8,2,0
50451,80,26551,80,allow,378,192,186,7,28,4,3
60444,445,0,0,drop,70,70,0,1,0,1,0
57259,53,43490,53,allow,167,86,81,2,29,1,1
55673,53,33131,53,allow,174,89,85,2,31,1,1
50084,80,12971,80,allow,2173,616,1557,10,15,6,4
9095,22114,0,0,deny,62,62,0,1,0,1,0
54827,445,0,0,drop,66,66,0,1,0,1,0
59964,445,0,0,drop,70,70,0,1,0,1,0
64618,445,0,0,drop,66,66,0,1,0,1,0
57350,53,37868,53,allow,177,94,83,2,30,1,1
58809,443,38293,443,allow,4055,1295,2760,11,121,6,5
0,0,0,0,deny,98,98,0,1,0,1,0
64818,445,0,0,drop,70,70,0,1,0,1,0
1024,37450,0,0,deny,62,62,0,1,0,1,0
52790,445,0,0,drop,66,66,0,1,0,1,0
56369,53,3077,53,allow,193,102,91,2,31,1,1
49654,53,49736,53,allow,184,94,90,2,30,1,1
59431,443,29795,443,allow,12756,3596,9160,31,299,16,15
56211,445,0,0,drop,70,70,0,1,0,1,0
56578,25174,0,0,deny,66,66,0,1,0,1,0
59782,445,0,0,drop,70,70,0,1,0,1,0
52139,38259,57318,38259,allow,70,70,0,2,7,2,0
55376,53,7206,53,allow,199,102,97,2,31,1,1
23997,53,23997,53,allow,230,90,140,2,30,1,1
64051,53,30405,53,allow,1114,468,646,12,67,6,6
58692,53,28574,53,allow,199,94,105,2,30,1,1
59189,53,53487,53,allow,222,94,128,2,30,1,1
56360,443,15487,443,allow,3734,1750,1984,24,203,12,12
57364,445,0,0,drop,70,70,0,1,0,1,0
26406,37965,0,0,deny,66,66,0,1,0,1,0
61622,80,61622,80,allow,48702,2799,45903,74,110,38,36
10552,25174,0,0,deny,62,62,0,1,0,1,0
49333,445,0,0,drop,66,66,0,1,0,1,0
58855,443,45547,443,allow,5168,700,4468,16,14,7,9
56364,443,28728,443,allow,10427,6311,4116,33,234,20,13
8889,19777,0,0,deny,60,60,0,1,0,1,0
55582,53,34252,53,allow,168,86,82,2,30,1,1
61544,445,0,0,drop,66,66,0,1,0,1,0
62297,445,0,0,drop,66,66,0,1,0,1,0
56972,53,24503,53,allow,177,94,83,2,30,1,1
60566,445,0,0,drop,66,66,0,1,0,1,0
51463,53,0,0,allow,82,82,0,1,30,1,0
55450,443,1835,443,allow,4275,2479,1796,22,316,11,11
49516,53,40491,53,allow,183,94,89,2,30,1,1
22094,23,0,0,deny,60,60,0,1,0,1,0
46758,123,10814,123,allow,184,94,90,2,30,1,1
36951,443,31916,443,allow,70,70,0,1,5,1,0
63910,44847,0,0,deny,66,66,0,1,0,1,0
57901,443,18752,443,allow,3924,1906,2018,26,170,14,12
51772,59814,9968,59814,allow,66,66,0,1,5,1,0
15629,53,15629,53,allow,209,77,132,2,32,1,1
58827,445,0,0,drop,66,66,0,1,0,1,0
64661,53,48759,53,allow,216,102,114,2,30,1,1
53670,32016,15273,32016,allow,70,70,0,2,8,2,0
52206,80,42642,80,allow,372,246,126,6,27,4,2
57475,445,0,0,drop,66,66,0,1,0,1,0
49228,53,7287,53,allow,193,102,91,2,30,1,1
49852,80,47954,80,allow,8868,3774,5094,20,89,10,10
49651,445,0,0,drop,70,70,0,1,0,1,0
39186,53,39186,53,allow,371,237,134,3,33,2,1
49195,445,0,0,drop,70,70,0,1,0,1,0
7087,23,0,0,deny,60,60,0,1,0,1,0
27005,27021,42135,27021,allow,1708,126,1582,4,31,2,2
65057,53,20625,53,allow,397,102,295,2,30,1,1
52221,443,62267,443,allow,4567,717,3850,17,148,7,10
63694,445,0,0,drop,66,66,0,1,0,1,0
42298,40019,18664,40019,allow,597,79,518,2,31,1,1
56564,9571,0,0,deny,78,78,0,1,0,1,0
56389,53,11725,53,allow,774,101,673,2,31,1,1
3549,64147,0,0,deny,62,62,0,1,0,1,0
49518,53,16482,53,allow,193,102,91,2,30,1,1
56905,445,0,0,drop,66,66,0,1,0,1,0
40583,80,60376,80,allow,898,543,355,10,255,6,4
443,62732,0,0,deny,332,332,0,1,0,1,0
39200,443,57759,443,allow,8918,2361,6557,35,255,18,17
57309,53,8457,53,allow,197,102,95,2,30,1,1
64865,53,41424,53,allow,423,102,321,2,30,1,1
50850,445,0,0,drop,66,66,0,1,0,1,0
56445,53,29245,53,allow,199,102,97,2,30,1,1
56375,53,7555,53,allow,216,110,106,2,31,1,1
45941,23386,0,0,deny,60,60,0,1,0,1,0
21133,18719,1173,18719,allow,150,150,0,1,1200,1,0
64493,53,24989,53,allow,280,97,183,4,59,2,2
59627,53,32997,53,allow,290,102,188,2,30,1,1
51810,443,51810,443,allow,1536,856,680,14,27,6,8
443,44683,0,0,deny,83,83,0,1,0,1,0
58638,5900,0,0,deny,62,62,0,1,0,1,0
49068,443,40796,443,allow,8664,2567,6097,20,120,10,10
28040,64147,0,0,deny,66,66,0,1,0,1,0
39161,17,0,0,deny,60,60,0,1,0,1,0
50284,443,42928,443,allow,13168,2875,10293,48,99,27,21
59530,53,58720,53,allow,578,286,292,9,15,5,4
58638,5900,0,0,deny,62,62,0,1,0,1,0
53442,445,0,0,drop,70,70,0,1,0,1,0
49191,35440,0,0,deny,66,66,0,1,0,1,0
27947,26467,0,0,deny,66,66,0,1,0,1,0
58472,445,0,0,drop,66,66,0,1,0,1,0
49830,443,7649,443,allow,6131,1960,4171,18,15,10,8
57363,53,20262,53,allow,178,94,84,2,29,1,1
49598,80,32079,80,allow,372,192,180,7,41,4,3
42298,443,10335,443,allow,64,64,0,1,31,1,0
55016,1113,36871,1113,allow,6723,1881,4842,25,16,15,10
25565,52284,0,0,deny,60,60,0,1,0,1,0
64128,53,2686,53,allow,193,102,91,2,30,1,1
49752,50584,0,0,deny,62,62,0,1,0,1,0
36531,443,53488,443,allow,123782,10685,113097,157,180,65,92
49668,443,23437,443,allow,7978,2204,5774,20,58,10,10
50923,445,0,0,drop,66,66,0,1,0,1,0
53249,443,44486,443,allow,11150,2012,9138,29,67,14,15
42947,443,14067,443,allow,11377,7703,3674,26,161,19,7
49448,53,38995,53,allow,195,94,101,2,30,1,1
55594,53,28823,53,allow,168,78,90,2,30,1,1
60678,445,0,0,drop,66,66,0,1,0,1,0
42960,443,37505,443,allow,5057,2448,2609,27,544,12,15
60785,40010,47744,40010,allow,316,136,180,6,5,3,3
59278,53,0,0,allow,86,86,0,1,30,1,0
33498,443,13950,443,allow,3672,1802,1870,25,129,10,15
56476,53,12813,53,allow,94,94,0,1,30,1,0
52395,445,0,0,drop,70,70,0,1,0,1,0
65176,445,0,0,drop,66,66,0,1,0,1,0
33289,50584,0,0,deny,62,62,0,1,0,1,0
56117,53,10364,53,allow,757,98,659,2,30,1,1
57398,53,40796,53,allow,196,94,102,2,31,1,1
56612,53,46131,53,allow,184,94,90,2,29,1,1
43578,15503,0,0,deny,74,74,0,1,0,1,0
50683,443,31278,443,allow,12362,1650,10712,33,300,14,19
49835,443,51050,443,allow,8754,2616,6138,34,96,19,15
49855,36180,0,0,deny,62,62,0,1,0,1,0
60143,445,0,0,drop,70,70,0,1,0,1,0
52584,445,0,0,drop,70,70,0,1,0,1,0
50824,445,0,0,drop,66,66,0,1,0,1,0
64561,53,25485,53,allow,270,94,176,2,30,1,1
52431,443,19671,443,allow,7396,3677,3719,16,120,8,8
46365,53413,0,0,deny,71,71,0,1,0,1,0
59819,443,17243,443,allow,1401,864,537,12,29,6,6
63728,11785,51708,11785,allow,66,66,0,1,5,1,0
33973,50265,0,0,deny,62,62,0,1,0,1,0
55201,26467,0,0,deny,62,62,0,1,0,1,0
55630,43736,8013,43736,allow,70,70,0,1,5,1,0
59186,445,0,0,drop,70,70,0,1,0,1,0
5588,5588,0,0,allow,3498,1872,1626,48,195,24,24
63455,445,0,0,drop,66,66,0,1,0,1,0
57618,80,57618,80,allow,265909,7294,258615,235,25,55,180
15333,60043,0,0,deny,62,62,0,1,0,1,0
55675,53,47376,53,allow,198,102,96,2,30,1,1
62640,53,62640,53,allow,414,268,146,3,32,2,1
51443,443,10966,443,allow,1048,1048,0,9,16,9,0
54777,445,0,0,drop,70,70,0,1,0,1,0
65064,30188,0,0,deny,66,66,0,1,0,1,0
59928,53,57258,53,allow,320,94,226,2,29,1,1
58521,445,0,0,drop,70,70,0,1,0,1,0
54993,53,49299,53,allow,410,109,301,4,32,2,2
59782,53,21953,53,allow,168,78,90,2,30,1,1
55104,443,37071,443,allow,10470,3626,6844,20,131,9,11
55896,53,45886,53,allow,184,94,90,2,31,1,1
56667,53,18172,53,allow,199,102,97,2,30,1,1
53158,443,6890,443,allow,7427,1517,5910,22,323,11,11
55786,53,43858,53,allow,177,94,83,2,31,1,1
60730,443,25640,443,allow,5518,1221,4297,16,90,10,6
44206,53,19423,53,allow,202,83,119,2,30,1,1
1066,16464,0,0,deny,60,60,0,1,0,1,0
56356,2710,17176,2710,allow,1222,747,475,10,23,5,5
33543,44847,0,0,deny,66,66,0,1,0,1,0
55226,443,25011,443,allow,711879,19394,692485,724,98,238,486
49290,443,44950,443,allow,4783,2366,2417,16,203,8,8
56387,25174,0,0,deny,66,66,0,1,0,1,0
63834,27037,35809,27037,allow,1130,924,206,5,30,3,2
49719,443,9783,443,allow,40332,2476,37856,57,130,26,31
9588,37965,0,0,deny,66,66,0,1,0,1,0
51866,22114,0,0,deny,66,66,0,1,0,1,0
51430,25174,0,0,deny,62,62,0,1,0,1,0
27005,27015,44800,27015,allow,858,126,732,2,30,1,1
65104,445,0,0,drop,70,70,0,1,0,1,0
7992,64147,0,0,deny,62,62,0,1,0,1,0
0,0,0,0,allow,2000,1020,980,20,0,10,10
57515,445,0,0,drop,70,70,0,1,0,1,0
20608,28189,0,0,deny,60,60,0,1,0,1,0
56424,53,24013,53,allow,711,87,624,2,0,1,1
64257,53,1307,53,allow,168,86,82,2,30,1,1
56724,445,0,0,drop,70,70,0,1,0,1,0
65176,53,19712,53,allow,299,99,200,4,45,2,2
63982,25174,0,0,deny,66,66,0,1,0,1,0
38703,443,53775,443,allow,90561,3481,87080,96,16,31,65
0,0,0,0,allow,320,320,0,5,0,5,0
7946,23,7946,23,allow,130,66,64,2,5,1,1
443,20995,0,0,deny,83,83,0,1,0,1,0
49664,80,19625,80,allow,7561,3181,4380,16,41,8,8
50279,443,56387,443,allow,1786,172,1614,7,119,3,4
54339,23117,0,0,deny,66,66,0,1,0,1,0
56372,53,7936,53,allow,172,94,78,2,30,1,1
55031,53,63225,53,allow,756,95,661,2,31,1,1
56899,53,4081,53,allow,258,102,156,2,30,1,1
49163,53,13314,53,allow,167,86,81,2,29,1,1
1025,51221,0,0,deny,62,62,0,1,0,1,0
64772,64147,0,0,deny,66,66,0,1,0,1,0
49933,53,13874,53,allow,186,102,84,2,30,1,1
35844,443,58126,443,allow,5196,1875,3321,45,5922,12,33
56096,443,56096,443,allow,5493,2246,3247,22,39,13,9
50204,445,0,0,drop,70,70,0,1,0,1,0
62941,445,0,0,drop,70,70,0,1,0,1,0
52472,7302,0,0,deny,62,62,0,1,0,1,0
55842,64147,0,0,deny,66,66,0,1,0,1,0
55386,32480,0,0,deny,66,66,0,1,0,1,0
56013,445,0,0,drop,70,70,0,1,0,1,0
58773,445,0,0,drop,66,66,0,1,0,1,0
443,45788,0,0,deny,199,199,0,1,0,1,0
57860,445,0,0,drop,66,66,0,1,0,1,0
49825,53,42990,53,allow,168,86,82,2,30,1,1
50198,445,0,0,drop,70,70,0,1,0,1,0
57064,443,57064,443,allow,4378,1471,2907,19,29,11,8
51609,445,0,0,drop,70,70,0,1,0,1,0
53112,29258,11040,29258,allow,70,70,0,2,8,2,0
51906,443,34093,443,allow,5685,1179,4506,18,29,10,8
53800,445,0,0,drop,70,70,0,1,0,1,0
57053,53,53183,53,allow,173,94,79,2,31,1,1
35821,80,40158,80,allow,34712,2489,32223,52,19,27,25
49909,445,0,0,deny,70,70,0,1,0,1,0
35460,35440,0,0,deny,62,62,0,1,0,1,0
10965,22114,0,0,deny,62,62,0,1,0,1,0
56864,53,5721,53,allow,200,102,98,2,30,1,1
57035,53,3817,53,allow,199,102,97,2,30,1,1
56220,53,22417,53,allow,772,103,669,2,31,1,1
50188,443,57063,443,allow,6357,1079,5278,18,32,10,8
55040,443,2837,443,allow,8558,1869,6689,31,236,14,17
52120,445,0,0,drop,70,70,0,1,0,1,0
57614,443,56701,443,allow,25824,14215,11609,65,757,32,33
49690,53,35001,53,allow,216,110,106,2,30,1,1
53135,14297,19034,14297,allow,70,70,0,2,8,2,0
64257,53,61085,53,allow,211,78,133,2,30,1,1
47166,443,47166,443,allow,4567,1660,2907,19,28,11,8
14872,23,0,0,deny,60,60,0,1,0,1,0
58791,15503,0,0,deny,66,66,0,1,0,1,0
51745,30188,0,0,deny,66,66,0,1,0,1,0
56117,53,20260,53,allow,178,94,84,2,30,1,1
64878,445,0,0,drop,66,66,0,1,0,1,0
52013,35185,52958,35185,allow,70,70,0,2,9,2,0
63074,443,53301,443,allow,384,166,218,2,29,1,1
60504,445,0,0,drop,70,70,0,1,0,1,0
51822,12637,54729,12637,allow,136,136,0,3,14,3,0
64031,25933,32039,25933,allow,436,254,182,7,14,4,3
9451,443,45125,443,allow,5699,505,5194,14,15,7,7
54199,443,31908,443,allow,499,425,74,4,0,3,1
56375,53,32161,53,allow,216,110,106,2,31,1,1
64841,445,0,0,drop,70,70,0,1,0,1,0
56029,445,0,0,drop,70,70,0,1,0,1,0
57929,445,0,0,drop,66,66,0,1,0,1,0
53899,45682,35205,45682,allow,70,70,0,1,4,1,0
48893,443,17087,443,allow,16227,2037,14190,40,109,19,21
59889,443,40054,443,allow,8305,2325,5980,24,46,13,11
62639,445,0,0,drop,70,70,0,1,0,1,0
61229,443,47952,443,allow,12708,2798,9910,36,258,13,23
60824,53,60824,53,allow,220,90,130,2,30,1,1
25234,1,0,0,reset-both,62,62,0,1,0,1,0
65228,53,0,0,deny,88,88,0,1,0,1,0
27446,30188,0,0,deny,66,66,0,1,0,1,0
58638,5900,0,0,deny,62,62,0,1,0,1,0
52128,21294,46936,21294,allow,70,70,0,2,8,2,0
51439,445,0,0,drop,70,70,0,1,0,1,0
56718,80,40668,80,allow,1462,703,759,8,15,5,3
55865,53,34168,53,allow,807,94,713,2,30,1,1
49921,53,38148,53,allow,212,108,104,2,31,1,1
64149,53,35596,53,allow,301,108,193,4,50,2,2
49705,80,19257,80,allow,2733,591,2142,11,45,6,5
52677,53,52677,53,allow,233,91,142,2,31,1,1
49534,53,53329,53,allow,168,86,82,2,30,1,1
54990,53,35409,53,allow,168,86,82,2,31,1,1
5588,5588,0,0,allow,3498,1872,1626,48,205,24,24
62408,50584,0,0,deny,62,62,0,1,0,1,0
56298,53,16841,53,allow,173,94,79,2,29,1,1
63593,443,12181,443,allow,36819,3967,32852,59,152,30,29
62079,30188,0,0,deny,62,62,0,1,0,1,0
8430,53,21349,53,allow,80361,77433,2928,946,89,930,16
37614,80,61486,80,allow,1399,406,993,15,43,5,10
49633,445,0,0,drop,70,70,0,1,0,1,0
53728,445,0,0,drop,70,70,0,1,0,1,0
10860,55108,0,0,deny,148,148,0,1,0,1,0
3478,61463,0,0,deny,804,804,0,1,0,1,0
57808,445,0,0,drop,70,70,0,1,0,1,0
52903,445,0,0,drop,70,70,0,1,0,1,0
53851,443,36931,443,allow,11779,3603,8176,42,142,21,21
64164,445,0,0,drop,70,70,0,1,0,1,0
64573,53,58393,53,allow,558,104,454,4,49,2,2
65404,36237,0,0,deny,62,62,0,1,0,1,0
443,20995,0,0,deny,83,83,0,1,0,1,0
51675,53,24941,53,allow,168,78,90,2,29,1,1
46093,32661,0,0,deny,74,74,0,1,0,1,0
59030,445,0,0,drop,70,70,0,1,0,1,0
51985,38904,27850,38904,allow,70,70,0,2,8,2,0
46258,80,9234,80,allow,3711,1806,1905,17,186,10,7
49157,53,4191,53,allow,184,94,90,2,30,1,1
55158,53,42446,53,allow,239,102,137,2,30,1,1
49782,80,45830,80,allow,130,70,60,2,15,1,1
10532,26672,0,0,deny,60,60,0,1,0,1,0
57300,53,58923,53,allow,184,94,90,2,31,1,1
64318,445,0,0,drop,66,66,0,1,0,1,0
45099,57470,0,0,deny,62,62,0,1,0,1,0
51823,445,0,0,drop,70,70,0,1,0,1,0
58819,445,0,0,drop,66,66,0,1,0,1,0
39996,23,0,0,deny,60,60,0,1,0,1,0
53012,80,53012,80,allow,278027,5087,272940,288,22,76,212
61427,443,64293,443,allow,7288,1763,5525,22,77,12,10
16425,15503,0,0,deny,62,62,0,1,0,1,0
51685,57470,0,0,deny,66,66,0,1,0,1,0
54130,53,45665,53,allow,168,78,90,2,30,1,1
49615,80,42615,80,allow,374,192,182,7,41,4,3
56292,53,5398,53,allow,197,102,95,2,29,1,1
25015,64147,0,0,deny,66,66,0,1,0,1,0
58638,5900,0,0,deny,62,62,0,1,0,1,0
57367,53,51549,53,allow,177,94,83,2,29,1,1
53060,445,0,0,drop,70,70,0,1,0,1,0
54849,22448,0,0,allow,66,66,0,1,90,1,0
65307,445,0,0,drop,70,70,0,1,0,1,0
51882,445,0,0,drop,66,66,0,1,0,1,0
49218,53,40400,53,allow,195,102,93,2,30,1,1
58638,5900,0,0,deny,62,62,0,1,0,1,0
51413,1,0,0,deny,72,72,0,1,0,1,0
58687,11392,0,0,deny,66,66,0,1,0,1,0
63599,445,0,0,drop,70,70,0,1,0,1,0
42034,28189,0,0,deny,62,62,0,1,0,1,0
56424,53,8677,53,allow,177,94,83,2,29,1,1
50713,80,55082,80,allow,708,384,324,12,195,7,5
50910,80,20207,80,allow,14877069,179445,14697624,12450,135,2531,9919
49756,53,16127,53,allow,396,94,302,4,41,2,2
20706,23718,0,0,deny,62,62,0,1,0,1,0
50254,44847,0,0,deny,66,66,0,1,0,1,0
51844,12471,17127,12471,allow,70,70,0,2,8,2,0
43076,23,0,0,deny,60,60,0,1,0,1,0
40842,80,63836,80,allow,1712,786,926,12,17,7,5
51456,45680,0,0,deny,139,139,0,1,0,1,0
51617,21247,0,0,deny,66,66,0,1,0,1,0
64144,53,4671,53,allow,193,102,91,2,29,1,1
58390,53,44510,53,allow,240,76,164,2,31,1,1
60032,445,0,0,drop,66,66,0,1,0,1,0
40772,15503,0,0,deny,74,74,0,1,0,1,0
34493,443,37498,443,allow,11771,2624,9147,50,20,25,25
49966,80,31375,80,allow,1210,788,422,9,33,5,4
57097,445,0,0,drop,70,70,0,1,0,1,0
49689,443,55526,443,allow,1179,655,524,13,56,7,6
56569,53,42369,53,allow,183,94,89,2,30,1,1
49227,2710,36226,2710,allow,70,70,0,2,8,2,0
49364,53,61056,53,allow,779,86,693,2,30,1,1
55669,53,38123,53,allow,177,94,83,2,30,1,1
64655,53,25772,53,allow,225,102,123,2,30,1,1
53429,445,0,0,drop,66,66,0,1,0,1,0
52483,1433,0,0,deny,60,60,0,1,0,1,0
55552,53,60195,53,allow,211,102,109,2,30,1,1
48817,6889,48817,6889,allow,480,149,331,2,1200,1,1
45941,23386,0,0,deny,60,60,0,1,0,1,0
62442,445,0,0,drop,66,66,0,1,0,1,0
28176,35440,0,0,deny,146,146,0,1,0,1,0
42228,51050,0,0,deny,66,66,0,1,0,1,0
64381,53,3642,53,allow,198,102,96,2,30,1,1
12348,50265,0,0,deny,62,62,0,1,0,1,0
64937,445,0,0,drop,66,66,0,1,0,1,0
51355,445,0,0,drop,70,70,0,1,0,1,0
38802,53,38802,53,allow,216,90,126,2,30,1,1
58629,445,0,0,drop,66,66,0,1,0,1,0
52095,56079,0,0,deny,66,66,0,1,0,1,0
57339,443,47908,443,allow,1495,768,727,16,26,9,7
13334,41615,0,0,deny,145,145,0,1,0,1,0
55963,53,19959,53,allow,316,94,222,2,30,1,1
59748,443,39145,443,allow,8789,1592,7197,25,75,13,12
63195,445,0,0,drop,66,66,0,1,0,1,0
55910,53,26815,53,allow,183,94,89,2,30,1,1
38001,443,11115,443,allow,1652,817,835,17,186,9,8
47063,15503,0,0,deny,62,62,0,1,0,1,0
65132,445,0,0,drop,70,70,0,1,0,1,0
50901,80,56736,80,allow,11091,2772,8319,22,154,12,10
57503,445,0,0,drop,66,66,0,1,0,1,0
61790,445,0,0,drop,70,70,0,1,0,1,0
17008,35440,0,0,deny,62,62,0,1,0,1,0
49418,37579,44074,37579,allow,239,71,168,2,30,1,1
51270,443,53083,443,allow,190,70,120,4,15,2,2
27046,51505,0,0,deny,66,66,0,1,0,1,0
64790,53,58871,53,allow,88,88,0,1,30,1,0
55806,53,2252,53,allow,200,102,98,2,30,1,1
61051,445,0,0,drop,70,70,0,1,0,1,0
56885,445,0,0,drop,70,70,0,1,0,1,0
64720,53,3807,53,allow,216,102,114,2,30,1,1
9339,443,39172,443,allow,3614,434,3180,11,15,6,5
17777,30188,0,0,deny,62,62,0,1,0,1,0
35261,15503,0,0,deny,74,74,0,1,0,1,0
35437,443,7147,443,allow,53756,46525,7231,82,275,51,31
59729,53,2967,53,allow,303,85,218,2,30,1,1
47910,7461,0,0,deny,60,60,0,1,0,1,0
54444,443,57397,443,allow,9802,2594,7208,25,360,10,15
56748,53,43623,53,allow,184,94,90,2,31,1,1
55368,443,50740,443,allow,8551,2955,5596,28,423,15,13
38926,37965,0,0,deny,62,62,0,1,0,1,0
32474,48817,0,0,deny,148,148,0,1,0,1,0
54523,445,0,0,drop,66,66,0,1,0,1,0
20576,37965,0,0,deny,62,62,0,1,0,1,0
59696,57470,0,0,deny,62,62,0,1,0,1,0
58903,443,20018,443,allow,6033,770,5263,18,15,8,10
62798,445,0,0,drop,66,66,0,1,0,1,0
64200,445,0,0,drop,66,66,0,1,0,1,0
52701,445,0,0,drop,70,70,0,1,0,1,0
58025,80,19163,80,allow,708,384,324,12,23,7,5
65026,53,61151,53,allow,194,102,92,2,29,1,1
28176,34021,0,0,allow,66,66,0,1,90,1,0
53105,42707,0,0,deny,66,66,0,1,0,1,0
65478,445,0,0,drop,66,66,0,1,0,1,0
4544,3478,63036,3478,allow,338,110,228,2,299,1,1
60971,445,0,0,drop,70,70,0,1,0,1,0
55261,53,52324,53,allow,183,94,89,2,29,1,1
64417,53,10923,53,allow,231,102,129,2,30,1,1
59918,445,0,0,drop,66,66,0,1,0,1,0
54717,443,54717,443,allow,4608,1701,2907,19,27,11,8
57284,22114,0,0,deny,66,66,0,1,0,1,0
47264,80,26226,80,allow,1737,796,941,12,16,7,5
9460,80,52623,80,allow,1641,483,1158,10,15,5,5
57470,51413,20990,51413,allow,132,132,0,3,1199,3,0
56506,53,3362,53,allow,184,94,90,2,30,1,1
56161,53,11132,53,allow,199,94,105,2,30,1,1
63067,445,0,0,drop,66,66,0,1,0,1,0
2919,57866,0,0,deny,66,66,0,1,0,1,0
50869,445,0,0,drop,66,66,0,1,0,1,0
49961,445,0,0,drop,70,70,0,1,0,1,0
65384,53,4009,53,allow,443,182,261,6,30,3,3
9092,26672,0,0,deny,60,60,0,1,0,1,0
46123,443,37747,443,allow,5161,3826,1335,16,137,9,7
36586,3142,36586,3142,allow,138,78,60,2,6,1,1
61820,445,0,0,drop,70,70,0,1,0,1,0
56661,53,53473,53,allow,297,102,195,4,34,2,2
50982,443,1681,443,allow,5552,1179,4373,24,80,13,11
65434,445,0,0,drop,66,66,0,1,0,1,0
59740,445,0,0,drop,70,70,0,1,0,1,0
53948,7370,62549,7370,allow,70,70,0,1,5,1,0
27321,25174,0,0,deny,62,62,0,1,0,1,0
56942,53,55677,53,allow,177,94,83,2,30,1,1
58812,445,0,0,drop,70,70,0,1,0,1,0
59842,62413,0,0,deny,62,62,0,1,0,1,0
62458,445,0,0,drop,70,70,0,1,0,1,0
51145,80,51145,80,allow,33072,3959,29113,40,46,14,26
26872,44847,0,0,deny,62,62,0,1,0,1,0
56663,53,28501,53,allow,215,102,113,2,30,1,1
63503,42707,0,0,deny,66,66,0,1,0,1,0
49719,53,33096,53,allow,209,110,99,2,30,1,1
54693,443,58435,443,allow,5220,922,4298,17,100,10,7
49741,80,28243,80,allow,1149,412,737,8,17,5,3
24662,26467,0,0,deny,66,66,0,1,0,1,0
64892,53,23593,53,allow,772,102,670,2,30,1,1
36548,25174,0,0,deny,62,62,0,1,0,1,0
43155,35440,0,0,deny,66,66,0,1,0,1,0
51986,41982,47346,41982,allow,70,70,0,2,8,2,0
48347,443,29830,443,allow,8415,883,7532,23,54,8,15
65191,53,21889,53,allow,196,94,102,2,29,1,1
49374,53,36144,53,allow,193,102,91,2,30,1,1
64371,53,21841,53,allow,181,86,95,2,30,1,1
55250,53,30475,53,allow,416,102,314,2,30,1,1
49558,80,45042,80,allow,39679,7315,32364,45,24,17,28
57444,53,54223,53,allow,177,94,83,2,30,1,1
26048,21,0,0,deny,60,60,0,1,0,1,0
58213,37807,0,0,deny,66,66,0,1,0,1,0
22390,19473,0,0,deny,62,62,0,1,0,1,0
48817,57451,48817,57451,allow,152,152,0,1,1200,1,0
993,38356,0,0,deny,66,66,0,1,0,1,0
62336,445,0,0,drop,70,70,0,1,0,1,0
65216,35440,0,0,deny,66,66,0,1,0,1,0
56426,445,0,0,drop,70,70,0,1,0,1,0
53898,12172,38766,12172,allow,70,70,0,1,4,1,0
53423,445,0,0,drop,70,70,0,1,0,1,0
57470,58973,26085,58973,allow,330,330,0,6,1200,6,0
49341,443,40823,443,allow,484,210,274,8,135,4,4
46838,443,19080,443,allow,10876,3774,7102,12,145,5,7
5223,32965,0,0,deny,66,66,0,1,0,1,0
59863,443,54710,443,allow,12809,7765,5044,95,84,55,40
41346,30188,0,0,deny,62,62,0,1,0,1,0
56316,53,62474,53,allow,733,93,640,2,31,1,1
50280,57470,0,0,deny,78,78,0,1,0,1,0
50602,445,0,0,drop,66,66,0,1,0,1,0
64095,53,51473,53,allow,269,110,159,2,30,1,1
52020,445,0,0,drop,66,66,0,1,0,1,0
55855,53,55855,53,allow,221,89,132,2,31,1,1
60748,445,0,0,drop,70,70,0,1,0,1,0
60356,443,15398,443,allow,8079,2282,5797,26,17,15,11
56326,53,34552,53,allow,177,94,83,2,30,1,1
58638,5900,0,0,deny,62,62,0,1,0,1,0
56703,53,53438,53,allow,199,102,97,2,30,1,1
61616,23,0,0,deny,60,60,0,1,0,1,0
49761,443,53360,443,allow,36615,5107,31508,108,125,49,59
50491,443,45806,443,allow,1304,878,426,12,78,7,5
7842,23,0,0,deny,60,60,0,1,0,1,0
36419,50584,0,0,deny,62,62,0,1,0,1,0
54956,53,35292,53,allow,711,87,624,2,31,1,1
56856,47715,33664,47715,allow,70,70,0,2,8,2,0
55244,53,11760,53,allow,168,78,90,2,30,1,1
57131,8055,0,0,deny,145,145,0,1,0,1,0
58961,445,0,0,drop,70,70,0,1,0,1,0
51836,53,49755,53,allow,168,78,90,2,30,1,1
49933,53,6937,53,allow,178,94,84,2,31,1,1
54998,53,35657,53,allow,174,89,85,2,31,1,1
55643,53,36774,53,allow,183,94,89,2,30,1,1
57212,53,19775,53,allow,780,104,676,2,31,1,1
50302,80,5947,80,allow,5100,1620,3480,17,114,10,7
65246,53,1802,53,allow,209,102,107,2,30,1,1
56611,53,17951,53,allow,177,94,83,2,29,1,1
57419,443,3080,443,allow,9224,2381,6843,29,19,14,15
43374,443,52439,443,allow,10176,2162,8014,25,186,14,11
3410,17372,0,0,deny,62,62,0,1,0,1,0
55975,53,49618,53,allow,711,87,624,2,30,1,1
25565,51337,0,0,deny,60,60,0,1,0,1,0
58566,445,0,0,drop,70,70,0,1,0,1,0
3212,22114,0,0,deny,62,62,0,1,0,1,0
37168,443,5501,443,allow,4871,923,3948,19,360,10,9
56465,443,52483,443,allow,6081,844,5237,17,15,9,8
64032,12343,46737,12343,allow,630,508,122,9,15,7,2
55012,443,47170,443,allow,3388,2236,1152,28,904,16,12
34671,443,52492,443,allow,8904,1058,7846,18,31,9,9
55646,53,12583,53,allow,780,93,687,2,30,1,1
30960,45682,63379,45682,allow,330,330,0,6,3609,6,0
52317,445,0,0,drop,70,70,0,1,0,1,0
49852,53,14933,53,allow,230,102,128,2,31,1,1
56297,53,44253,53,allow,168,86,82,2,30,1,1
53520,445,0,0,drop,70,70,0,1,0,1,0
57987,56125,0,0,deny,90,90,0,1,0,1,0
60401,445,0,0,drop,70,70,0,1,0,1,0
48706,23393,0,0,deny,60,60,0,1,0,1,0
56312,443,54503,443,allow,564,292,272,9,25,5,4
27005,27018,40971,27018,allow,882,126,756,2,30,1,1
5912,22114,0,0,deny,62,62,0,1,0,1,0
65241,53,55089,53,allow,200,102,98,2,31,1,1
53282,443,30859,443,allow,1786,172,1614,7,119,3,4
64582,53,17757,53,allow,209,110,99,2,30,1,1
56998,443,56998,443,allow,4577,1670,2907,19,26,11,8
58503,445,0,0,drop,66,66,0,1,0,1,0
50030,445,0,0,drop,70,70,0,1,0,1,0
50652,443,65076,443,allow,2477,1505,972,15,20,9,6
53297,443,55944,443,allow,5600,1187,4413,24,80,13,11
63272,445,0,0,drop,70,70,0,1,0,1,0
57122,53,16456,53,allow,199,102,97,2,29,1,1
53117,37529,38733,37529,allow,70,70,0,1,5,1,0
55094,53,26727,53,allow,754,94,660,2,31,1,1
56241,445,0,0,drop,70,70,0,1,0,1,0
63034,443,35751,443,allow,304,86,218,2,30,1,1
45001,443,55898,443,allow,570,318,252,10,20,6,4
15113,25174,0,0,deny,62,62,0,1,0,1,0
49977,53,37356,53,allow,212,94,118,2,30,1,1
58801,445,0,0,drop,70,70,0,1,0,1,0
54869,445,0,0,drop,70,70,0,1,0,1,0
9151,443,63028,443,allow,6128,763,5365,17,29,9,8
55147,53,9806,53,allow,184,94,90,2,30,1,1
57328,443,39932,443,allow,134,60,74,3,4,2,1
56127,443,17365,443,allow,6103,2710,3393,58,212,28,30
31974,51505,0,0,deny,66,66,0,1,0,1,0
52014,445,0,0,drop,70,70,0,1,0,1,0
64926,445,0,0,drop,70,70,0,1,0,1,0
16403,16384,56995,16384,allow,556,256,300,10,31,5,5
52569,30188,0,0,deny,66,66,0,1,0,1,0
57470,27232,13855,27232,allow,4212,2724,1488,57,2411,33,24
50702,80,54989,80,allow,55224,28254,26970,230,174,114,116
59220,445,0,0,drop,70,70,0,1,0,1,0
50871,445,0,0,drop,70,70,0,1,0,1,0
56265,53,56216,53,allow,213,94,119,2,30,1,1
53717,445,0,0,drop,70,70,0,1,0,1,0
65275,53,52488,53,allow,184,102,82,2,29,1,1
9433,443,31139,443,allow,3299,441,2858,11,15,6,5
55854,54369,0,0,deny,74,74,0,1,0,1,0
49360,443,11814,443,allow,5782,1008,4774,17,16,8,9
57128,53,45410,53,allow,755,93,662,2,31,1,1
52973,57470,0,0,deny,74,74,0,1,0,1,0
50525,445,0,0,drop,70,70,0,1,0,1,0
60520,53,60520,53,allow,248,106,142,2,29,1,1
27402,37628,0,0,deny,62,62,0,1,0,1,0
60516,445,0,0,drop,70,70,0,1,0,1,0
65175,53,18597,53,allow,269,94,175,2,30,1,1
57450,53,43406,53,allow,916,86,830,2,31,1,1
51620,56205,0,0,deny,62,62,0,1,0,1,0
61071,1053,14234,1053,allow,1139,878,261,2,30,1,1
55839,56535,0,0,deny,62,62,0,1,0,1,0
45152,80,61047,80,allow,2865,2000,865,12,18,7,5
58946,445,0,0,drop,70,70,0,1,0,1,0
39265,443,4436,443,allow,46879,2864,44015,74,179,34,40
55843,53,63569,53,allow,177,94,83,2,30,1,1
43888,64147,0,0,deny,62,62,0,1,0,1,0
49969,53,54536,53,allow,356,105,251,4,49,2,2
64828,445,0,0,drop,66,66,0,1,0,1,0
30332,48817,0,0,deny,145,145,0,1,0,1,0
56494,1,0,0,deny,146,146,0,1,0,1,0
53878,443,30400,443,allow,499,425,74,4,1,3,1
52417,443,14213,443,allow,8376,6877,1499,27,31,15,12
64172,445,0,0,drop,70,70,0,1,0,1,0
56442,11392,0,0,deny,66,66,0,1,0,1,0
63563,445,0,0,drop,70,70,0,1,0,1,0
49165,53,19244,53,allow,379,94,285,2,30,1,1
50069,53,45809,53,allow,764,102,662,2,29,1,1
49135,443,9255,443,allow,2529,1230,1299,17,16,9,8
57470,51745,40205,51745,allow,3214,1260,1954,33,1371,17,16
56468,53,49469,53,allow,209,110,99,2,30,1,1
50620,50584,0,0,deny,66,66,0,1,0,1,0
43086,443,19069,443,allow,6496,2026,4470,20,16,12,8
64798,53,32594,53,allow,303,88,215,4,40,2,2
56775,445,0,0,drop,70,70,0,1,0,1,0
54692,445,0,0,drop,70,70,0,1,0,1,0
49609,53,45961,53,allow,177,94,83,2,31,1,1
56603,53,28698,53,allow,179,94,85,2,30,1,1
57687,445,0,0,drop,66,66,0,1,0,1,0
37738,443,1957,443,allow,6470,1931,4539,27,32,14,13
63389,445,0,0,drop,66,66,0,1,0,1,0
49364,53,40148,53,allow,182,94,88,2,30,1,1
55944,53,48983,53,allow,762,98,664,2,30,1,1
53132,443,53588,443,allow,7271,2540,4731,32,20,18,14
52055,445,0,0,drop,70,70,0,1,0,1,0
10216,11392,0,0,deny,66,66,0,1,0,1,0
51063,445,0,0,drop,66,66,0,1,0,1,0
53103,445,0,0,drop,70,70,0,1,0,1,0
65203,30188,0,0,deny,66,66,0,1,0,1,0
49476,445,0,0,drop,66,66,0,1,0,1,0
50161,53,38218,53,allow,165,86,79,2,30,1,1
60976,22114,0,0,deny,62,62,0,1,0,1,0
1940,53,23603,53,allow,210,78,132,2,30,1,1
62983,445,0,0,drop,70,70,0,1,0,1,0
53774,51505,0,0,deny,66,66,0,1,0,1,0
27005,27001,35440,27001,allow,887,126,761,2,31,1,1
56103,21247,0,0,deny,66,66,0,1,0,1,0
38011,443,43234,443,allow,6900,4387,2513,37,98,19,18
49342,53,61829,53,allow,402,118,284,2,30,1,1
52131,445,0,0,drop,70,70,0,1,0,1,0
52671,445,0,0,drop,70,70,0,1,0,1,0
26333,23,0,0,deny,60,60,0,1,0,1,0
58399,445,0,0,drop,66,66,0,1,0,1,0
56940,443,15296,443,allow,4184,2787,1397,19,345,10,9
55440,443,52938,443,allow,6622,859,5763,18,15,10,8
55601,53,41824,53,allow,815,95,720,2,30,1,1
55720,51610,5460,51610,allow,70,70,0,1,5,1,0
55890,53,43973,53,allow,193,102,91,2,30,1,1
50458,53,16491,53,allow,458,188,270,6,30,3,3
65314,445,0,0,drop,70,70,0,1,0,1,0
27005,27015,32826,27015,allow,880,126,754,2,30,1,1
49505,443,2441,443,allow,35158,5065,30093,53,42,18,35
10627,36829,0,0,deny,146,146,0,1,0,1,0
57426,66,63838,66,allow,70,70,0,1,5,1,0
51547,443,55970,443,allow,642,582,60,2,5,1,1
50422,445,0,0,drop,66,66,0,1,0,1,0
52640,443,13563,443,allow,70,70,0,1,5,1,0
65040,53,64566,53,allow,180,94,86,2,29,1,1
64357,53,46898,53,allow,182,93,89,2,30,1,1
53479,80,7819,80,allow,3307,937,2370,17,16,10,7
0,0,0,0,deny,98,98,0,1,0,1,0
50535,445,0,0,drop,70,70,0,1,0,1,0
9520,443,43478,443,allow,3614,434,3180,11,15,6,5
55431,53,52036,53,allow,196,102,94,2,29,1,1
443,30054,0,0,allow,60,60,0,1,91,1,0
64726,53,24139,53,allow,178,94,84,2,30,1,1
62654,35440,0,0,deny,62,62,0,1,0,1,0
5223,34403,0,0,deny,220,220,0,1,0,1,0
55559,53,26431,53,allow,180,92,88,2,30,1,1
54256,123,0,0,deny,234,234,0,1,0,1,0
39717,443,63809,443,allow,10921,3102,7819,25,217,13,12
62254,445,0,0,drop,70,70,0,1,0,1,0
21492,51505,0,0,deny,62,62,0,1,0,1,0
55725,445,0,0,drop,70,70,0,1,0,1,0
62685,445,0,0,drop,70,70,0,1,0,1,0
64050,53,59472,53,allow,389,94,295,2,30,1,1
13237,53,13237,53,allow,823,98,725,2,30,1,1
49662,443,52708,443,allow,4353,1145,3208,17,25,9,8
52033,443,12817,443,allow,9609,3239,6370,25,143,12,13
45540,8100,31556,8100,allow,78,78,0,1,4,1,0
36013,53,23635,53,allow,86,86,0,1,30,1,0
53841,445,0,0,drop,66,66,0,1,0,1,0
64308,53,11059,53,allow,258,102,156,2,29,1,1
53369,445,0,0,drop,66,66,0,1,0,1,0
33933,80,56054,80,allow,1988,1072,916,12,515,7,5
49620,53,16282,53,allow,198,110,88,2,29,1,1
55601,44049,44869,44049,allow,504,318,186,8,15,5,3
55054,80,54288,80,allow,67750,4451,63299,78,60,32,46
56661,443,57675,443,allow,334,70,264,5,17,1,4
57628,445,0,0,drop,70,70,0,1,0,1,0
59535,445,0,0,drop,70,70,0,1,0,1,0
56186,53,56186,53,allow,233,98,135,2,30,1,1
61055,445,0,0,drop,70,70,0,1,0,1,0
20487,50584,0,0,deny,66,66,0,1,0,1,0
51510,443,23309,443,allow,1047,560,487,10,16,6,4
55440,53,49182,53,allow,752,93,659,2,31,1,1
65011,53,42934,53,allow,168,86,82,2,30,1,1
51975,443,63500,443,allow,35746,4732,31014,68,67,33,35
45237,53,45237,53,allow,235,90,145,2,33,1,1
56980,80,6065,80,allow,214,140,74,4,35,3,1
49852,53,8412,53,allow,94,94,0,1,29,1,0
57470,43576,31912,43576,allow,545,166,379,2,1200,1,1
53984,57077,2292,57077,allow,70,70,0,1,5,1,0
17002,22114,0,0,deny,62,62,0,1,0,1,0
50686,443,4744,443,allow,1199,618,581,13,29,6,7
2180,63710,0,0,deny,66,66,0,1,0,1,0
9134,80,9239,80,allow,318,192,126,6,29,4,2
56651,443,36673,443,allow,4628,1035,3593,19,25,11,8
65365,53,13159,53,allow,196,102,94,2,30,1,1
56494,80,51723,80,allow,44136,2908,41228,56,135,25,31
46726,53,27470,53,allow,168,78,90,2,30,1,1
10669,49756,0,0,deny,60,60,0,1,0,1,0
6882,6881,62031,6881,allow,238,118,120,2,1200,1,1
27005,27015,42995,27015,allow,1758,252,1506,5,32,3,2
49342,53,62127,53,allow,200,102,98,2,30,1,1
62502,445,0,0,drop,70,70,0,1,0,1,0
59668,50584,0,0,deny,66,66,0,1,0,1,0
49196,445,0,0,drop,66,66,0,1,0,1,0
58484,445,0,0,drop,66,66,0,1,0,1,0
37587,5228,8359,5228,allow,5509,2203,3306,22,3600,10,12
53246,443,53246,443,allow,1419,788,631,15,121,8,7
27005,27058,35794,27058,allow,908,126,782,2,30,1,1
62970,44847,0,0,deny,62,62,0,1,0,1,0
42164,80,6790,80,allow,1658,1344,314,10,15,5,5
53794,443,48669,443,allow,499,425,74,4,0,3,1
58543,445,0,0,drop,70,70,0,1,0,1,0
55087,53,44618,53,allow,344,110,234,2,30,1,1
58381,57470,0,0,deny,66,66,0,1,0,1,0
53015,64147,0,0,deny,62,62,0,1,0,1,0
33725,53,33725,53,allow,216,90,126,2,30,1,1
49155,443,35211,443,allow,8941,1776,7165,22,136,12,10
64790,443,36803,443,allow,53280,3270,50010,78,142,31,47
26900,27017,32451,27017,allow,422,164,258,6,30,3,3
57470,24260,9692,24260,allow,806,163,643,2,1201,1,1
54996,445,0,0,drop,66,66,0,1,0,1,0
56006,53,30347,53,allow,200,102,98,2,30,1,1
15189,25174,0,0,deny,146,146,0,1,0,1,0
2572,35440,0,0,deny,66,66,0,1,0,1,0
49293,5223,22335,5223,allow,202,142,60,2,15,1,1
55123,53,24178,53,allow,295,86,209,2,30,1,1
443,38956,0,0,deny,82,82,0,1,0,1,0
32053,443,32053,443,allow,28195,6044,22151,58,17,30,28
63179,445,0,0,drop,70,70,0,1,0,1,0
56332,53,50254,53,allow,186,95,91,2,30,1,1
50982,443,30343,443,allow,8227,3496,4731,20,82,11,9
59851,445,0,0,drop,66,66,0,1,0,1,0
52852,445,0,0,drop,66,66,0,1,0,1,0
60699,445,0,0,drop,66,66,0,1,0,1,0
49821,445,0,0,drop,70,70,0,1,0,1,0
32282,8604,0,0,deny,66,66,0,1,0,1,0
58638,5900,0,0,deny,62,62,0,1,0,1,0
52425,443,14303,443,allow,64135,3588,60547,88,40,38,50
51771,80,34714,80,allow,76066,3663,72403,92,24,40,52
56288,53,56709,53,allow,182,93,89,2,31,1,1
52244,58774,2211,58774,allow,70,70,0,1,5,1,0
63602,445,0,0,drop,70,70,0,1,0,1,0
48268,443,29893,443,allow,18462,11672,6790,47,63,26,21
58952,445,0,0,drop,66,66,0,1,0,1,0
63929,53,15311,53,allow,195,94,101,2,30,1,1
49953,445,0,0,drop,66,66,0,1,0,1,0
61005,50584,0,0,deny,146,146,0,1,0,1,0
65472,53,43093,53,allow,209,110,99,2,30,1,1
55641,53,24406,53,allow,184,94,90,2,31,1,1
64438,53,59049,53,allow,184,94,90,2,30,1,1
57083,53,19689,53,allow,198,102,96,2,30,1,1
23022,443,23022,443,allow,10943,5186,5757,32,25,18,14
45908,33330,0,0,deny,60,60,0,1,0,1,0
63755,53,63755,53,allow,223,92,131,2,31,1,1
64608,53,13914,53,allow,208,106,102,2,31,1,1
56792,42155,2470,42155,allow,70,70,0,2,8,2,0
64884,53,48287,53,allow,239,110,129,2,30,1,1
51032,30188,0,0,deny,66,66,0,1,0,1,0
55471,445,0,0,drop,70,70,0,1,0,1,0
36505,443,41059,443,allow,6293,1501,4792,22,16,11,11
52695,443,43213,443,allow,34402,2328,32074,55,153,23,32
53732,443,58255,443,allow,499,425,74,4,0,3,1
63764,12343,45903,12343,allow,504,382,122,8,15,6,2
58638,5900,0,0,deny,62,62,0,1,0,1,0
61438,443,9604,443,allow,4933,771,4162,18,28,8,10
52090,445,0,0,drop,66,66,0,1,0,1,0
41298,443,14805,443,allow,2974,1378,1596,28,34,15,13
13643,22114,0,0,deny,146,146,0,1,0,1,0
8889,9806,0,0,deny,60,60,0,1,0,1,0
52503,50584,0,0,deny,62,62,0,1,0,1,0
44136,53,62801,53,allow,220,78,142,2,30,1,1
56960,53,21026,53,allow,196,102,94,2,31,1,1
49496,443,45834,443,allow,15404,11220,4184,29,27,16,13
50701,443,1473,443,allow,45394,5743,39651,133,233,49,84
57890,443,58945,443,allow,3588,1991,1597,27,176,14,13
60499,51413,63354,51413,allow,70,70,0,1,5,1,0
50424,55777,0,0,deny,62,62,0,1,0,1,0
54778,22114,0,0,deny,66,66,0,1,0,1,0
41000,443,2288,443,allow,6237,1811,4426,22,22,12,10
52174,43106,3385,43106,allow,160,70,90,2,8,1,1
49240,53,18179,53,allow,199,102,97,2,30,1,1
54580,445,0,0,drop,66,66,0,1,0,1,0
12465,11392,0,0,deny,62,62,0,1,0,1,0
64734,53,19737,53,allow,383,90,293,4,43,2,2
55621,28144,63708,28144,allow,70,70,0,1,5,1,0
55516,445,0,0,drop,70,70,0,1,0,1,0
58771,443,23708,443,allow,5167,700,4467,16,15,7,9
56692,443,32743,443,allow,3932,2581,1351,18,18,10,8
62029,445,0,0,drop,66,66,0,1,0,1,0
63847,443,57992,443,allow,8012,4410,3602,20,135,10,10
54178,445,0,0,drop,70,70,0,1,0,1,0
62870,445,0,0,drop,66,66,0,1,0,1,0
50106,31573,0,0,deny,62,62,0,1,0,1,0
52603,445,0,0,drop,66,66,0,1,0,1,0
55229,53,60362,53,allow,720,94,626,2,30,1,1
1373,22114,0,0,deny,66,66,0,1,0,1,0
36903,56205,0,0,deny,62,62,0,1,0,1,0
50556,445,0,0,drop,70,70,0,1,0,1,0
50500,53,25369,53,allow,166,86,80,2,30,1,1
64857,445,0,0,drop,70,70,0,1,0,1,0
58638,5900,0,0,deny,62,62,0,1,0,1,0
8933,56205,0,0,deny,62,62,0,1,0,1,0
55559,53,16251,53,allow,182,94,88,2,30,1,1
55877,1049,50494,1049,allow,323,150,173,2,1200,1,1
60116,443,14734,443,allow,9454,2307,7147,40,19,17,23
50553,80,13843,80,allow,378,192,186,7,26,4,3
52261,53,8647,53,allow,578,286,292,9,15,5,4
56040,53,54233,53,allow,761,100,661,2,30,1,1
53917,445,0,0,drop,70,70,0,1,0,1,0
56997,80,45711,80,allow,214,140,74,4,35,3,1
64930,443,64930,443,allow,4596,1689,2907,19,27,11,8
62872,50584,0,0,deny,66,66,0,1,0,1,0
52057,80,6987,80,allow,422,240,182,8,25,5,3
53880,61393,8542,61393,allow,320,140,180,6,6,3,3
53623,445,0,0,drop,70,70,0,1,0,1,0
53603,53796,21410,53796,allow,70,70,0,1,4,1,0
40185,64147,0,0,deny,62,62,0,1,0,1,0
49650,53,63255,53,allow,322,110,212,4,30,2,2
51232,23,0,0,deny,60,60,0,1,0,1,0
55967,445,0,0,drop,70,70,0,1,0,1,0
57470,13613,11885,13613,allow,1577,594,983,20,1601,10,10
65386,53,35268,53,allow,197,102,95,2,33,1,1
55095,53,40942,53,allow,194,102,92,2,30,1,1
53863,8999,11307,8999,allow,70,70,0,2,7,2,0
55621,445,0,0,drop,70,70,0,1,0,1,0
14252,35993,0,0,deny,62,62,0,1,0,1,0
50698,443,13372,443,allow,24575,6565,18010,86,275,32,54
52015,445,0,0,drop,70,70,0,1,0,1,0
45941,23388,0,0,deny,60,60,0,1,0,1,0
29363,36237,0,0,deny,146,146,0,1,0,1,0
50318,80,21534,80,allow,3855,828,3027,11,15,5,6
55666,35440,0,0,deny,66,66,0,1,0,1,0
29623,37807,0,0,deny,62,62,0,1,0,1,0
64715,53,61600,53,allow,209,110,99,2,30,1,1
56273,53,28560,53,allow,183,94,89,2,30,1,1
51023,443,24793,443,allow,26189,8238,17951,72,18,39,33
64966,53,61255,53,allow,347,100,247,4,49,2,2
40680,5228,59129,5228,allow,234,174,60,2,4,1,1
61750,445,0,0,drop,70,70,0,1,0,1,0
62438,37807,0,0,deny,66,66,0,1,0,1,0
55824,53,12441,53,allow,196,102,94,2,30,1,1
49365,53,39023,53,allow,195,102,93,2,30,1,1
3478,61463,0,0,deny,935,935,0,1,0,1,0
56875,53,43240,53,allow,167,86,81,2,30,1,1
50284,53,6888,53,allow,168,78,90,2,30,1,1
37565,123,4980,123,allow,184,94,90,2,30,1,1
49734,53,21745,53,allow,216,110,106,2,30,1,1
57470,20220,32069,20220,allow,870,330,540,12,2308,6,6
62339,25174,0,0,deny,66,66,0,1,0,1,0
52553,445,0,0,drop,70,70,0,1,0,1,0
56578,53,41828,53,allow,219,86,133,2,31,1,1
52102,19604,31294,19604,allow,66,66,0,1,5,1,0
56702,443,53688,443,allow,8058,2038,6020,20,15,11,9
57871,445,0,0,drop,70,70,0,1,0,1,0
53602,445,0,0,drop,70,70,0,1,0,1,0
8239,37965,0,0,deny,146,146,0,1,0,1,0
51758,31009,29940,31009,allow,70,70,0,1,5,1,0
50450,80,49757,80,allow,26924,4418,22506,34,25,13,21
49795,53,44891,53,allow,263,94,169,2,30,1,1
18577,25174,0,0,deny,62,62,0,1,0,1,0
15403,51505,0,0,deny,66,66,0,1,0,1,0
27005,27015,8192,27015,allow,912,126,786,2,31,1,1
62461,443,18805,443,allow,14832,3978,10854,32,34,15,17
54214,443,38557,443,allow,499,425,74,4,0,3,1
56396,53,37010,53,allow,183,94,89,2,30,1,1
50644,35440,0,0,deny,66,66,0,1,0,1,0
65122,443,26133,443,allow,5500,1277,4223,17,180,8,9
50255,53,26984,53,allow,199,102,97,2,30,1,1
50127,64147,0,0,deny,66,66,0,1,0,1,0
51471,445,0,0,drop,70,70,0,1,0,1,0
51632,445,0,0,drop,70,70,0,1,0,1,0
49280,53,8666,53,allow,167,86,81,2,30,1,1
47910,7454,0,0,deny,60,60,0,1,0,1,0
54841,445,0,0,drop,70,70,0,1,0,1,0
54166,25174,0,0,deny,66,66,0,1,0,1,0
60399,123,27117,123,allow,184,94,90,2,30,1,1
65469,53,49560,53,allow,195,102,93,2,30,1,1
55445,53,56296,53,allow,711,87,624,2,30,1,1
10003,64147,0,0,deny,62,62,0,1,0,1,0
6832,51505,0,0,deny,66,66,0,1,0,1,0
49509,443,14742,443,allow,17660,7465,10195,44,201,23,21
57143,53,34750,53,allow,184,94,90,2,31,1,1
2422,50584,0,0,deny,66,66,0,1,0,1,0
55877,56148,26245,56148,allow,481,150,331,2,1200,1,1
51000,443,31109,443,allow,41713,34380,7333,67,333,38,29
55048,443,61386,443,allow,1600,1089,511,13,151,7,6
63240,445,0,0,drop,66,66,0,1,0,1,0
52469,445,0,0,drop,66,66,0,1,0,1,0
59728,53,43809,53,allow,304,86,218,2,30,1,1
50700,80,20685,80,allow,55825,28792,27033,234,174,117,117
58263,445,0,0,drop,70,70,0,1,0,1,0
41317,443,52322,443,allow,4555,2276,2279,27,244,9,18
52791,80,25328,80,allow,82430,3774,78656,108,67,49,59
60916,445,0,0,drop,70,70,0,1,0,1,0
56307,52700,0,0,deny,66,66,0,1,0,1,0
53911,1025,45349,1025,allow,130,70,60,3,6,2,1
64277,53,1694,53,allow,337,110,227,2,30,1,1
60478,30889,28285,30889,allow,1303,903,400,12,16,7,5
45364,443,12194,443,allow,9276,2422,6854,25,186,14,11
52746,443,40862,443,allow,104383,5038,99345,135,25,62,73
56562,44847,0,0,deny,66,66,0,1,0,1,0
49514,53,50895,53,allow,780,93,687,2,30,1,1
59933,80,6671,80,allow,582,138,444,9,25,3,6
64799,445,0,0,drop,70,70,0,1,0,1,0
57320,53,17715,53,allow,802,104,698,2,30,1,1
58638,5900,0,0,deny,62,62,0,1,0,1,0
51535,443,59853,443,allow,122,62,60,2,16,1,1
46000,443,62571,443,allow,2583,334,2249,7,90,3,4
31021,35440,0,0,deny,62,62,0,1,0,1,0
56599,80,32983,80,allow,234,234,0,4,12,4,0
55045,445,0,0,drop,70,70,0,1,0,1,0
1038,37965,0,0,deny,62,62,0,1,0,1,0
59324,445,0,0,drop,66,66,0,1,0,1,0
51045,25174,0,0,deny,62,62,0,1,0,1,0
51001,445,0,0,drop,70,70,0,1,0,1,0
56743,445,0,0,drop,70,70,0,1,0,1,0
49243,80,49243,80,allow,378,180,198,7,53,4,3
1660,8696,0,0,deny,62,62,0,1,0,1,0
53520,37553,50212,37553,allow,70,70,0,2,7,2,0
56526,443,31407,443,allow,5082,973,4109,18,60,9,9
11692,25174,0,0,deny,66,66,0,1,0,1,0
36883,80,30047,80,allow,114410,3755,110655,128,38,47,81
53794,53,8818,53,allow,260,86,174,2,30,1,1
50376,53,42212,53,allow,819,102,717,2,30,1,1
38641,443,31615,443,allow,318,192,126,6,14,4,2
57306,53,20608,53,allow,573,186,387,6,71,3,3
60526,443,60526,443,allow,1462,863,599,15,37,9,6
59052,53,10639,53,allow,504,110,394,2,30,1,1
55654,445,0,0,drop,70,70,0,1,0,1,0
64554,53,30164,53,allow,94,94,0,1,29,1,0
36497,80,36497,80,allow,7594,863,6731,18,21,8,10
53500,445,0,0,drop,66,66,0,1,0,1,0
55675,53,10351,53,allow,195,102,93,2,30,1,1
50566,443,28525,443,allow,7367,1149,6218,18,27,9,9
56007,53,3946,53,allow,99,99,0,1,30,1,0
58015,445,0,0,drop,70,70,0,1,0,1,0
53619,445,0,0,drop,70,70,0,1,0,1,0
27005,27015,20017,27015,allow,882,126,756,2,30,1,1
55363,445,0,0,drop,70,70,0,1,0,1,0
0,0,0,0,allow,2000,1020,980,20,0,10,10
53183,445,0,0,drop,66,66,0,1,0,1,0
26192,23,0,0,deny,60,60,0,1,0,1,0
65107,53,44757,53,allow,266,87,179,4,33,2,2
51847,53,49805,53,allow,164,78,86,2,31,1,1
56085,53,59161,53,allow,166,85,81,2,31,1,1
64609,53,7201,53,allow,168,86,82,2,30,1,1
65059,53,30320,53,allow,168,86,82,2,31,1,1
26211,1433,0,0,deny,60,60,0,1,0,1,0
13462,35440,0,0,deny,66,66,0,1,0,1,0
55026,53,51536,53,allow,164,86,78,2,30,1,1
65374,443,10199,443,allow,629017,29841,599176,758,162,331,427
50734,37965,0,0,deny,62,62,0,1,0,1,0
25054,36827,0,0,deny,66,66,0,1,0,1,0
49190,443,44351,443,allow,568536,16389,552147,598,19,224,374
41064,80,41064,80,allow,2118,1493,625,9,82,6,3
31112,50584,0,0,deny,66,66,0,1,0,1,0
51950,445,0,0,drop,70,70,0,1,0,1,0
52993,53,60182,53,allow,70,70,0,1,29,1,0
56485,80,57235,80,allow,46400,3639,42761,59,135,25,34
51244,52290,0,0,deny,100,100,0,1,0,1,0
61292,445,0,0,drop,70,70,0,1,0,1,0
63965,53,1139,53,allow,214,102,112,2,30,1,1
57442,2258,57442,2258,allow,156,156,0,3,8,3,0
50036,53,50623,53,allow,353,118,235,2,31,1,1
443,64347,0,0,deny,131,131,0,1,0,1,0
58638,5900,0,0,deny,62,62,0,1,0,1,0
57579,445,0,0,drop,70,70,0,1,0,1,0
46839,51050,0,0,deny,146,146,0,1,0,1,0
58638,5900,0,0,deny,62,62,0,1,0,1,0
51922,18413,51851,18413,allow,70,70,0,1,5,1,0
6881,50239,58874,50239,allow,3514,1874,1640,15,1200,8,7
6881,61404,13734,61404,allow,228,118,110,2,1200,1,1
52128,37807,0,0,deny,62,62,0,1,0,1,0
55451,56205,0,0,deny,66,66,0,1,0,1,0
39724,443,26600,443,allow,6128,1344,4784,19,87,12,7
36368,80,54133,80,allow,78,78,0,1,5,1,0
62335,443,30924,443,allow,73341,3336,70005,85,48,27,58
56924,53,7241,53,allow,216,110,106,2,30,1,1
54767,445,0,0,drop,70,70,0,1,0,1,0
50038,53,65055,53,allow,286,87,199,4,59,2,2
63410,445,0,0,drop,70,70,0,1,0,1,0
10053,443,28179,443,allow,1832,1113,719,18,110,10,8
42298,40009,56378,40009,allow,148,86,62,2,29,1,1
52904,443,65264,443,allow,17521,6560,10961,55,117,28,27
37903,23,0,0,deny,60,60,0,1,0,1,0
50662,443,50298,443,allow,4190,1882,2308,17,19,10,7
59787,443,61520,443,allow,20036,2088,17948,51,334,21,30
51788,445,0,0,drop,66,66,0,1,0,1,0
51498,443,13741,443,allow,134,60,74,3,4,2,1
48978,25174,0,0,deny,66,66,0,1,0,1,0
62257,2767,0,0,deny,66,66,0,1,0,1,0
54377,56205,0,0,deny,66,66,0,1,0,1,0
64020,53,46952,53,allow,302,118,184,2,29,1,1
17750,7579,37146,7579,allow,490,149,341,2,1200,1,1
52733,443,22448,443,allow,613606,29392,584214,757,42,337,420
49293,53,18352,53,allow,294,88,206,4,57,2,2
53172,56013,19244,56013,allow,70,70,0,2,8,2,0
52041,445,0,0,drop,66,66,0,1,0,1,0
40151,5228,21276,5228,allow,19172,3089,16083,43,3601,20,23
51769,445,0,0,drop,66,66,0,1,0,1,0
61099,443,1871,443,allow,82,82,0,1,5,1,0
50592,443,18630,443,allow,1304,878,426,12,96,7,5
18113,22114,0,0,deny,146,146,0,1,0,1,0
11878,37807,0,0,deny,146,146,0,1,0,1,0
65036,53,38858,53,allow,214,110,104,2,29,1,1
56366,51221,0,0,deny,66,66,0,1,0,1,0
55579,53,12007,53,allow,178,94,84,2,30,1,1
62741,445,0,0,drop,66,66,0,1,0,1,0
57303,443,1835,443,allow,5612,733,4879,16,15,9,7
58638,5900,58638,5900,allow,156,62,94,2,10,1,1
39571,443,44587,443,allow,580560,15724,564836,583,30,187,396
65280,53,19530,53,allow,166,86,80,2,31,1,1
53119,53,39459,53,allow,326,102,224,2,29,1,1
27005,23333,15007,23333,allow,890,126,764,2,30,1,1
54902,445,0,0,drop,70,70,0,1,0,1,0
58638,5900,0,0,deny,62,62,0,1,0,1,0
17270,44847,0,0,deny,146,146,0,1,0,1,0
65518,53,59686,53,allow,211,102,109,2,30,1,1
59200,445,0,0,drop,70,70,0,1,0,1,0
51976,443,51253,443,allow,14912,9611,5301,36,57,21,15
58815,443,6132,443,allow,11773,7687,4086,31,17,16,15
38551,53,14191,53,allow,168,78,90,2,30,1,1
27005,29999,13147,29999,allow,876,126,750,2,31,1,1
35099,53,35099,53,allow,225,106,119,2,30,1,1
50928,445,0,0,drop,70,70,0,1,0,1,0
56762,53,42811,53,allow,168,86,82,2,30,1,1
48720,53,0,0,allow,82,82,0,1,30,1,0
22409,55442,0,0,deny,74,74,0,1,0,1,0
45121,15000,17487,15000,allow,130,70,60,2,5,1,1
63084,64147,0,0,deny,62,62,0,1,0,1,0
57470,52217,58146,52217,allow,1969,730,1239,19,1199,10,9
50164,443,9375,443,allow,3312,1098,2214,19,137,10,9
16693,36237,0,0,deny,62,62,0,1,0,1,0
61455,445,0,0,drop,70,70,0,1,0,1,0
47832,443,4961,443,allow,130090,7064,123026,184,200,92,92
56743,53,62302,53,allow,209,110,99,2,31,1,1
28012,443,23129,443,allow,6388,1112,5276,18,75,9,9
55689,37965,0,0,deny,66,66,0,1,0,1,0
52371,445,0,0,drop,70,70,0,1,0,1,0
40772,15503,0,0,deny,74,74,0,1,0,1,0
47674,53,47674,53,allow,200,90,110,2,30,1,1
55896,53,48962,53,allow,168,86,82,2,30,1,1
56008,445,0,0,drop,66,66,0,1,0,1,0
55614,29731,26252,29731,allow,70,70,0,1,5,1,0
60037,443,12655,443,allow,6194,1289,4905,23,66,12,11
43934,53,43934,53,allow,310,94,216,2,30,1,1
58382,445,0,0,drop,70,70,0,1,0,1,0
37213,36237,0,0,deny,66,66,0,1,0,1,0
27005,27015,49738,27015,allow,893,126,767,2,30,1,1
45964,3111,0,0,deny,60,60,0,1,0,1,0
55825,52700,0,0,deny,66,66,0,1,0,1,0
60336,443,57486,443,allow,6613,4394,2219,50,122,29,21
56672,53,28355,53,allow,198,101,97,2,31,1,1
52532,445,0,0,drop,66,66,0,1,0,1,0
49961,445,0,0,drop,70,70,0,1,0,1,0
54492,445,0,0,drop,70,70,0,1,0,1,0
49605,445,0,0,drop,70,70,0,1,0,1,0
57802,80,24943,80,allow,2762,2628,134,8,17,6,2
50994,35974,0,0,deny,60,60,0,1,0,1,0
56769,443,25443,443,allow,7941,1952,5989,20,15,11,9
49943,53,23345,53,allow,596,90,506,4,59,2,2
51884,445,0,0,drop,66,66,0,1,0,1,0
64103,50265,0,0,deny,66,66,0,1,0,1,0
27005,27001,28367,27001,allow,883,126,757,2,30,1,1
49380,445,0,0,drop,70,70,0,1,0,1,0
53161,51221,0,0,deny,66,66,0,1,0,1,0
57420,445,0,0,drop,70,70,0,1,0,1,0
63217,445,0,0,drop,70,70,0,1,0,1,0
34360,25174,0,0,deny,62,62,0,1,0,1,0
49762,443,52270,443,allow,7479,2226,5253,29,151,15,14
50608,443,24048,443,allow,4758,2811,1947,22,140,12,10
10166,44847,0,0,deny,62,62,0,1,0,1,0
53260,36237,0,0,deny,62,62,0,1,0,1,0
60703,443,30992,443,allow,66716,4091,62625,98,278,43,55
38852,37965,0,0,deny,62,62,0,1,0,1,0
59296,445,0,0,drop,70,70,0,1,0,1,0
55224,53,59301,53,allow,180,92,88,2,31,1,1
64898,35993,0,0,deny,74,74,0,1,0,1,0
55114,445,0,0,drop,66,66,0,1,0,1,0
56446,445,0,0,drop,70,70,0,1,0,1,0
52795,443,61686,443,allow,7203,2188,5015,23,186,11,12
56009,53,38515,53,allow,178,94,84,2,30,1,1
64576,53,5234,53,allow,194,102,92,2,31,1,1
53722,6881,24173,6881,allow,552,306,246,9,15,5,4
6722,80,6722,80,allow,326,186,140,6,29,4,2
55942,53,46906,53,allow,194,99,95,2,31,1,1
10001,443,23014,443,allow,8370,2798,5572,31,315,15,16
64586,53,21236,53,allow,173,94,79,2,30,1,1
46484,22,46484,22,allow,7922,3413,4509,55,38,26,29
63832,25174,0,0,deny,66,66,0,1,0,1,0
55921,43890,0,0,deny,66,66,0,1,0,1,0
61730,25320,0,0,deny,66,66,0,1,0,1,0
62571,445,0,0,drop,70,70,0,1,0,1,0
57364,53,64164,53,allow,177,94,83,2,30,1,1
59671,445,0,0,drop,70,70,0,1,0,1,0
57723,445,0,0,drop,70,70,0,1,0,1,0
26900,27017,46394,27017,allow,422,164,258,6,30,3,3
56220,445,0,0,drop,70,70,0,1,0,1,0
26758,443,6342,443,allow,20851,15854,4997,36,20,20,16
50112,123,33230,123,allow,184,94,90,2,30,1,1
53934,443,47963,443,allow,360,360,0,7,4,7,0
64275,53,2712,53,allow,644,198,446,6,48,3,3
24073,22114,0,0,deny,62,62,0,1,0,1,0
53630,64745,36069,64745,allow,70,70,0,1,4,1,0
62535,445,0,0,drop,70,70,0,1,0,1,0
41693,443,28921,443,allow,27069,3064,24005,44,178,19,25
50754,445,0,0,drop,70,70,0,1,0,1,0
56405,443,34557,443,allow,6202,1212,4990,27,1197,8,19
46495,4607,0,0,deny,60,60,0,1,0,1,0
55056,53,51122,53,allow,209,110,99,2,30,1,1
49608,53,63046,53,allow,198,110,88,2,31,1,1
46275,64147,0,0,deny,62,62,0,1,0,1,0
31176,53,31176,53,allow,414,268,146,3,32,2,1
33197,443,9055,443,allow,1067,650,417,10,27,6,4
60957,443,56619,443,allow,68539,4175,64364,98,32,46,52
11044,443,11044,443,allow,6981,948,6033,17,27,10,7
39537,8245,49028,8245,allow,280,214,66,2,30,1,1
47461,50584,0,0,deny,62,62,0,1,0,1,0
49296,53,29013,53,allow,186,95,91,2,31,1,1
56193,445,0,0,drop,66,66,0,1,0,1,0
51648,445,0,0,drop,70,70,0,1,0,1,0
42618,443,18541,443,allow,4694,2432,2262,34,81,16,18
65228,53,34659,53,allow,267,93,174,4,46,2,2
52085,29894,54507,29894,allow,136,136,0,3,14,3,0
50761,445,0,0,drop,70,70,0,1,0,1,0
50574,443,9752,443,allow,9191,2003,7188,25,100,13,12
25523,35974,0,0,deny,62,62,0,1,0,1,0
56667,53,23608,53,allow,168,86,82,2,31,1,1
48817,33028,48817,33028,allow,152,152,0,1,1200,1,0
63206,445,0,0,drop,70,70,0,1,0,1,0
1024,64147,0,0,deny,62,62,0,1,0,1,0
49410,53,12703,53,allow,178,94,84,2,30,1,1
64484,53,55455,53,allow,168,86,82,2,31,1,1
56014,445,0,0,drop,70,70,0,1,0,1,0
10006,80,62598,80,allow,1142,636,506,10,45,6,4
15274,19473,0,0,deny,62,62,0,1,0,1,0
53275,21247,0,0,deny,62,62,0,1,0,1,0
49249,443,43033,443,allow,35406,17785,17621,79,141,40,39
57345,443,32367,443,allow,55537,4477,51060,81,22,38,43
64614,53,60972,53,allow,168,86,82,2,31,1,1
65001,53,27011,53,allow,200,78,122,2,30,1,1
65000,445,0,0,drop,70,70,0,1,0,1,0
11404,64147,0,0,deny,62,62,0,1,0,1,0
0,0,0,0,deny,156,156,0,2,0,2,0
50278,443,27147,443,allow,259911,11421,248490,336,92,144,192
58638,5900,0,0,deny,62,62,0,1,0,1,0
60711,443,38043,443,allow,12258,1451,10807,27,360,13,14
8358,80,8358,80,allow,1875,567,1308,11,31,6,5
51967,12110,50176,12110,allow,70,70,0,2,7,2,0
49812,53,48839,53,allow,392,101,291,4,39,2,2
48706,23393,0,0,deny,60,60,0,1,0,1,0
49894,1433,0,0,deny,60,60,0,1,0,1,0
64375,445,0,0,drop,70,70,0,1,0,1,0
26254,56205,0,0,deny,66,66,0,1,0,1,0
64056,51266,62758,51266,allow,66,66,0,2,8,2,0
50713,57470,0,0,deny,66,66,0,1,0,1,0
63012,443,56934,443,allow,3707,1245,2462,11,119,6,5
49331,53,64999,53,allow,180,92,88,2,31,1,1
55462,53,36387,53,allow,579,88,491,4,35,2,2
63836,14791,37606,14791,allow,70,70,0,1,4,1,0
53245,80,62504,80,allow,2071,1305,766,10,256,6,4
60540,445,0,0,drop,70,70,0,1,0,1,0
59915,445,0,0,drop,70,70,0,1,0,1,0
55325,53,47399,53,allow,199,102,97,2,29,1,1
51999,37965,0,0,deny,62,62,0,1,0,1,0
3891,53,3891,53,allow,235,90,145,2,32,1,1
51945,443,60723,443,allow,8830,1950,6880,27,25,14,13
56496,53,56369,53,allow,193,102,91,2,30,1,1
49418,26169,6616,26169,allow,78,78,0,1,30,1,0
49868,443,19461,443,allow,11578,2375,9203,47,55,22,25
50690,80,20479,80,allow,4805,3639,1166,16,31,9,7
58475,11392,0,0,deny,66,66,0,1,0,1,0
50405,8080,50405,8080,allow,3985,2010,1975,17,51,10,7
52705,42873,0,0,deny,66,66,0,1,0,1,0
50337,445,0,0,drop,66,66,0,1,0,1,0
53674,31724,4834,31724,allow,70,70,0,2,7,2,0
41624,15000,41127,15000,allow,130,70,60,2,5,1,1
53071,25174,0,0,deny,66,66,0,1,0,1,0
64188,53,49847,53,allow,216,94,122,2,29,1,1
48016,443,47269,443,allow,138,78,60,2,5,1,1
56795,53,37529,53,allow,776,102,674,2,30,1,1
55958,53,30538,53,allow,275,86,189,2,29,1,1
56784,445,0,0,drop,66,66,0,1,0,1,0
35864,44847,0,0,deny,78,78,0,1,0,1,0
63288,52848,0,0,deny,66,66,0,1,0,1,0
62149,22114,0,0,deny,66,66,0,1,0,1,0
59951,53,55881,53,allow,237,86,151,2,30,1,1
58824,53,47620,53,allow,358,96,262,4,50,2,2
65518,5710,0,0,deny,62,62,0,1,0,1,0
1873,37965,0,0,deny,62,62,0,1,0,1,0
40480,30317,0,0,deny,146,146,0,1,0,1,0
50433,443,11749,443,allow,134,60,74,3,10,2,1
13027,64147,0,0,deny,62,62,0,1,0,1,0
49274,53,26954,53,allow,560,199,361,6,82,3,3
27005,27018,42247,27018,allow,881,126,755,2,30,1,1
49303,443,12405,443,allow,10844,5117,5727,42,17,25,17
64837,53,23710,53,allow,196,94,102,2,30,1,1
42295,443,63348,443,allow,9164,2473,6691,22,17,13,9
49589,53,16073,53,allow,214,102,112,2,31,1,1
49519,443,20384,443,allow,7086,1913,5173,29,270,16,13
63777,445,0,0,drop,66,66,0,1,0,1,0
57385,53,16664,53,allow,177,94,83,2,30,1,1
60206,443,52179,443,allow,4706,2475,2231,13,120,7,6
56026,51505,0,0,deny,146,146,0,1,0,1,0
53404,443,43178,443,allow,4972,1547,3425,22,149,10,12
49920,443,51438,443,allow,10526,811,9715,20,135,8,12
58818,445,0,0,drop,66,66,0,1,0,1,0
60788,445,0,0,drop,70,70,0,1,0,1,0
37581,443,19620,443,allow,13435,2441,10994,30,26,16,14
33461,443,33205,443,allow,8366,3900,4466,19,120,10,9
60991,443,12084,443,allow,15561,8186,7375,44,47,26,18
58242,445,0,0,drop,66,66,0,1,0,1,0
54844,445,0,0,drop,70,70,0,1,0,1,0
64160,445,0,0,drop,66,66,0,1,0,1,0
53194,443,6156,443,allow,1478,918,560,12,44,6,6
51844,443,37014,443,allow,6752,1387,5365,21,115,10,11
34134,30188,0,0,deny,62,62,0,1,0,1,0
56576,9000,0,0,deny,60,60,0,1,0,1,0
0,0,0,0,allow,480,244,236,4,0,2,2
56935,53,62999,53,allow,198,102,96,2,30,1,1
53470,22114,0,0,deny,66,66,0,1,0,1,0
57289,443,13366,443,allow,2693,1361,1332,17,19,10,7
50119,445,0,0,drop,70,70,0,1,0,1,0
49208,53,8830,53,allow,216,94,122,2,29,1,1
17579,57470,0,0,deny,62,62,0,1,0,1,0
22679,2323,0,0,deny,60,60,0,1,0,1,0
49165,53,42494,53,allow,257,126,131,2,30,1,1
55477,53,62006,53,allow,183,94,89,2,30,1,1
37998,26467,0,0,deny,66,66,0,1,0,1,0
39730,17372,0,0,deny,66,66,0,1,0,1,0
33405,37965,0,0,deny,62,62,0,1,0,1,0
27005,1307,27385,1307,allow,857,126,731,2,30,1,1
53759,443,57982,443,allow,499,425,74,4,0,3,1
63590,445,0,0,drop,70,70,0,1,0,1,0
56479,80,1802,80,allow,460182,11717,448465,462,135,162,300
22346,51505,0,0,deny,62,62,0,1,0,1,0
51847,32112,38487,32112,allow,70,70,0,2,9,2,0
33809,80,12746,80,allow,1052,612,440,10,15,5,5
65499,53,27799,53,allow,167,86,81,2,30,1,1
51603,443,62273,443,allow,2927,2062,865,14,134,8,6
52793,445,0,0,drop,70,70,0,1,0,1,0
60743,40010,9730,40010,allow,316,136,180,6,6,3,3
56972,53,28054,53,allow,177,94,83,2,30,1,1
56281,445,0,0,drop,66,66,0,1,0,1,0
26900,27017,26279,27017,allow,422,164,258,6,30,3,3
63399,445,0,0,drop,70,70,0,1,0,1,0
44223,443,7488,443,allow,63895,4604,59291,80,276,34,46
52040,2524,48292,2524,allow,70,70,0,1,5,1,0
65189,27015,61124,27015,allow,250,78,172,2,30,1,1
60923,49903,0,0,deny,66,66,0,1,0,1,0
61384,445,0,0,drop,70,70,0,1,0,1,0
31627,64147,0,0,deny,62,62,0,1,0,1,0
64783,53,41526,53,allow,561,99,462,4,38,2,2
55932,445,0,0,drop,70,70,0,1,0,1,0
50945,445,0,0,drop,66,66,0,1,0,1,0
42753,443,38036,443,allow,10114,3154,6960,27,20,16,11
52691,445,0,0,drop,70,70,0,1,0,1,0
60628,445,0,0,drop,70,70,0,1,0,1,0
60955,443,4042,443,allow,40105,2847,37258,61,17,28,33
60380,443,36908,443,allow,24243,17180,7063,52,97,33,19
59943,37807,0,0,deny,146,146,0,1,0,1,0
63546,445,0,0,drop,66,66,0,1,0,1,0
9325,443,25037,443,allow,3616,429,3187,11,15,6,5
56501,80,5186,80,allow,300370,14101,286269,313,63,116,197
55551,53,29205,53,allow,176,90,86,2,30,1,1
50730,443,12545,443,allow,3514,1609,1905,30,51,16,14
64217,53,23995,53,allow,193,102,91,2,30,1,1
51196,443,64591,443,allow,346,140,206,6,130,3,3
49812,53,26847,53,allow,193,102,91,2,31,1,1
30127,53,30127,53,allow,197,90,107,2,30,1,1
64180,53,33989,53,allow,296,91,205,4,55,2,2
53895,36849,47178,36849,allow,70,70,0,1,4,1,0
55598,445,0,0,drop,66,66,0,1,0,1,0
50662,443,10724,443,allow,6518,1200,5318,17,16,8,9
63826,445,0,0,drop,66,66,0,1,0,1,0
50305,53,8454,53,allow,209,110,99,2,30,1,1
56887,445,0,0,drop,66,66,0,1,0,1,0
55809,445,0,0,drop,66,66,0,1,0,1,0
51494,443,60286,443,allow,8140,5384,2756,15,122,8,7
64810,53,33589,53,allow,272,93,179,4,33,2,2
51720,51388,35731,51388,allow,70,70,0,1,5,1,0
49295,53,60068,53,allow,172,94,78,2,30,1,1
58638,5900,0,0,deny,62,62,0,1,0,1,0
37965,34591,32228,34591,allow,820,152,668,4,1199,2,2
57136,53,3723,53,allow,177,94,83,2,30,1,1
58481,15503,0,0,deny,146,146,0,1,0,1,0
59889,30188,0,0,deny,62,62,0,1,0,1,0
49809,443,59332,443,allow,83683,2747,80936,92,125,32,60
3478,61463,0,0,deny,1248,1248,0,1,0,1,0
63992,443,1306,443,allow,4360,2142,2218,15,120,7,8
58701,445,0,0,drop,70,70,0,1,0,1,0
58638,5900,0,0,deny,62,62,0,1,0,1,0
57418,53,27035,53,allow,758,96,662,2,31,1,1
18238,53,18238,53,allow,240,96,144,2,30,1,1
59833,48817,0,0,deny,107,107,0,1,0,1,0
49954,53,40035,53,allow,211,102,109,2,31,1,1
54535,443,39884,443,allow,9859,3252,6607,24,74,12,12
25565,2216,0,0,deny,60,60,0,1,0,1,0
50022,53,5739,53,allow,179,94,85,2,31,1,1
49710,53,26259,53,allow,89,89,0,1,30,1,0
51424,30188,0,0,deny,66,66,0,1,0,1,0
55155,53,55155,53,allow,240,98,142,2,30,1,1
48857,50584,0,0,deny,66,66,0,1,0,1,0
63963,53,56258,53,allow,262,86,176,4,46,2,2
36679,41864,0,0,deny,148,148,0,1,0,1,0
64569,53,30065,53,allow,183,94,89,2,30,1,1
38508,443,38508,443,allow,279067,22871,256196,327,90,145,182
58638,5900,0,0,deny,62,62,0,1,0,1,0
54980,53,25043,53,allow,763,101,662,2,30,1,1
38728,53,38728,53,allow,414,268,146,3,33,2,1
55106,53,22662,53,allow,184,94,90,2,30,1,1
50487,445,0,0,drop,70,70,0,1,0,1,0
41750,443,14251,443,allow,4636,792,3844,16,15,8,8
36448,53,11652,53,allow,199,94,105,2,30,1,1
53893,11344,38662,11344,allow,70,70,0,1,5,1,0
49722,443,49212,443,allow,28376,3058,25318,42,63,17,25
62149,22114,0,0,deny,66,66,0,1,0,1,0
64758,443,35347,443,allow,5066,2558,2508,26,127,13,13
55087,53,55975,53,allow,182,93,89,2,31,1,1
64561,53,50313,53,allow,209,110,99,2,30,1,1
49305,53,42044,53,allow,177,94,83,2,30,1,1
56236,53,43042,53,allow,241,94,147,2,30,1,1
28385,50584,0,0,deny,62,62,0,1,0,1,0
63779,12226,36658,12226,allow,66,66,0,2,7,2,0
56673,445,0,0,drop,70,70,0,1,0,1,0
41650,443,33832,443,allow,6356,1857,4499,48,229,20,28
5223,44091,0,0,deny,220,220,0,1,0,1,0
51210,443,30801,443,allow,8248,2460,5788,45,17,26,19
47325,2323,0,0,deny,60,60,0,1,0,1,0
49927,53,25486,53,allow,763,102,661,2,30,1,1
43931,53,36161,53,allow,168,78,90,2,31,1,1
57765,445,0,0,drop,70,70,0,1,0,1,0
64035,25174,0,0,deny,62,62,0,1,0,1,0
59222,445,0,0,drop,66,66,0,1,0,1,0
49790,53,24988,53,allow,190,97,93,2,30,1,1
52151,30692,49782,30692,allow,66,66,0,1,5,1,0
56872,445,0,0,drop,70,70,0,1,0,1,0
65067,53,58003,53,allow,214,110,104,2,30,1,1
57200,53,22685,53,allow,770,102,668,2,31,1,1
53030,56205,0,0,deny,66,66,0,1,0,1,0
56355,443,33571,443,allow,3734,1750,1984,24,203,12,12
50005,53,14000,53,allow,199,102,97,2,30,1,1
53447,44847,0,0,deny,66,66,0,1,0,1,0
13907,57470,0,0,deny,66,66,0,1,0,1,0
54548,7000,54548,7000,allow,4487,2090,2397,15,15,8,7
42075,36237,0,0,deny,146,146,0,1,0,1,0
48817,48489,48817,48489,allow,480,149,331,2,1200,1,1
58994,443,55812,443,allow,3284,1878,1406,20,27,11,9
38770,443,52968,443,allow,140155,6367,133788,173,145,62,111
49805,6881,0,0,deny,62,62,0,1,0,1,0
55588,53,19559,53,allow,168,86,82,2,30,1,1
58905,443,1469,443,allow,6370,706,5664,19,16,7,12
45359,443,22644,443,allow,10480,4949,5531,22,15,12,10
56711,443,22373,443,allow,1207531,28695,1178836,1184,45,400,784
45941,23388,0,0,deny,60,60,0,1,0,1,0
52220,65128,43562,65128,allow,70,70,0,2,8,2,0
42995,26467,0,0,deny,62,62,0,1,0,1,0
61319,445,0,0,drop,66,66,0,1,0,1,0
19875,30170,0,0,deny,145,145,0,1,0,1,0
62835,445,0,0,drop,70,70,0,1,0,1,0
33421,443,28800,443,allow,9917,3184,6733,30,91,12,18
57831,443,53060,443,allow,1320606,47731,1272875,1454,294,552,902
39941,995,0,0,deny,60,60,0,1,0,1,0
49277,51505,0,0,deny,66,66,0,1,0,1,0
30456,36237,0,0,deny,62,62,0,1,0,1,0
51481,53,20508,53,allow,168,78,90,2,30,1,1
54343,445,0,0,drop,70,70,0,1,0,1,0
56789,443,8502,443,allow,7877,1888,5989,20,15,11,9
63922,32305,41561,32305,allow,312,132,180,6,6,3,3
63927,50265,0,0,deny,62,62,0,1,0,1,0
64219,51050,0,0,deny,66,66,0,1,0,1,0
55582,26957,64555,26957,allow,70,70,0,1,5,1,0
17643,50584,0,0,deny,146,146,0,1,0,1,0
27005,26258,35412,26258,allow,886,126,760,2,30,1,1
14436,443,7159,443,allow,2601,1455,1146,18,15,8,10
44408,57470,0,0,deny,62,62,0,1,0,1,0
30599,46824,0,0,deny,66,66,0,1,0,1,0
38976,46824,0,0,deny,62,62,0,1,0,1,0
57452,57470,0,0,deny,62,62,0,1,0,1,0
39473,443,25041,443,allow,11226,3340,7886,28,16,16,12
62663,445,0,0,drop,70,70,0,1,0,1,0
57409,53,63027,53,allow,168,86,82,2,30,1,1
49690,53,31414,53,allow,216,110,106,2,30,1,1
52838,53,22296,53,allow,168,78,90,2,30,1,1
53708,23280,6417,23280,allow,1903,968,935,16,16,9,7
63062,443,18661,443,allow,26697,7168,19529,74,213,39,35
7222,57470,0,0,deny,62,62,0,1,0,1,0
64005,445,0,0,drop,70,70,0,1,0,1,0
0,0,0,0,deny,98,98,0,1,0,1,0
44854,26467,0,0,deny,62,62,0,1,0,1,0
38959,25174,0,0,deny,62,62,0,1,0,1,0
15503,51413,47539,51413,allow,459,149,310,2,1200,1,1
64613,53,11249,53,allow,212,102,110,2,30,1,1
55972,53,29588,53,allow,262,126,136,2,30,1,1
65451,53,7550,53,allow,178,94,84,2,31,1,1
50878,53733,0,0,deny,62,62,0,1,0,1,0
1024,21854,0,0,reset-both,157,157,0,1,0,1,0
58468,37965,0,0,deny,66,66,0,1,0,1,0
38436,5222,53562,5222,allow,7338,3611,3727,74,616,37,37
65404,53,13922,53,allow,256,94,162,2,30,1,1
50460,443,36423,443,allow,5572,4252,1320,18,34,11,7
58744,53,27095,53,allow,368,86,282,2,30,1,1
50843,443,54645,443,allow,6337,1378,4959,19,135,9,10
55580,445,0,0,drop,70,70,0,1,0,1,0
54137,445,0,0,drop,70,70,0,1,0,1,0
64153,53,64829,53,allow,340,134,206,2,30,1,1
54963,445,0,0,drop,70,70,0,1,0,1,0
49314,443,47530,443,allow,3185,2263,922,18,25,9,9
55487,53,20467,53,allow,198,101,97,2,31,1,1
59227,11392,0,0,deny,62,62,0,1,0,1,0
10006,40025,40345,40025,allow,284,190,94,2,29,1,1
57276,445,0,0,drop,70,70,0,1,0,1,0
64358,445,0,0,drop,70,70,0,1,0,1,0
55352,53,46162,53,allow,216,110,106,2,30,1,1
61483,445,0,0,drop,70,70,0,1,0,1,0
20004,48817,0,0,deny,146,146,0,1,0,1,0
34698,443,50104,443,allow,16164,3053,13111,31,18,16,15
57470,18531,64727,18531,allow,166,166,0,1,1200,1,0
57132,53,52410,53,allow,216,110,106,2,31,1,1
50915,445,0,0,drop,66,66,0,1,0,1,0
58811,443,3266,443,allow,10704,7055,3649,29,17,15,14
49625,445,0,0,drop,70,70,0,1,0,1,0
56395,53,26847,53,allow,177,94,83,2,29,1,1
32796,37965,0,0,deny,62,62,0,1,0,1,0
51620,443,24957,443,allow,3330,2281,1049,17,16,9,8
56119,53,4548,53,allow,199,102,97,2,30,1,1
25085,30188,0,0,deny,66,66,0,1,0,1,0
49698,53,53512,53,allow,184,102,82,2,30,1,1
49593,53,21447,53,allow,762,98,664,2,31,1,1
51259,1433,0,0,deny,60,60,0,1,0,1,0
59787,445,0,0,drop,66,66,0,1,0,1,0
62194,50584,0,0,deny,66,66,0,1,0,1,0
41577,53,41577,53,allow,265,111,154,2,0,1,1
52291,445,0,0,drop,70,70,0,1,0,1,0
47910,7464,0,0,deny,60,60,0,1,0,1,0
56266,53,6584,53,allow,245,102,143,2,30,1,1
64680,445,0,0,drop,66,66,0,1,0,1,0
56639,445,0,0,drop,70,70,0,1,0,1,0
49574,53,12004,53,allow,337,110,227,2,30,1,1
9193,443,3894,443,allow,5043,432,4611,12,16,6,6
9687,57470,0,0,deny,78,78,0,1,0,1,0
49663,53,4720,53,allow,195,102,93,2,29,1,1
63556,445,0,0,drop,70,70,0,1,0,1,0
56850,53,62960,53,allow,763,101,662,2,31,1,1
38999,443,34634,443,allow,12742,1983,10759,47,123,14,33
65285,445,0,0,drop,70,70,0,1,0,1,0
40742,2967,0,0,deny,62,62,0,1,0,1,0
53302,445,0,0,drop,70,70,0,1,0,1,0
50277,80,19151,80,allow,12764,7749,5015,28,84,14,14
49923,443,51816,443,allow,466,392,74,4,1,3,1
17750,25326,52113,25326,allow,491,150,341,2,1200,1,1
42615,443,10393,443,allow,117381,60398,56983,518,4126,256,262
49590,53,5842,53,allow,458,188,270,6,30,3,3
49413,443,21606,443,allow,7849,1104,6745,23,123,12,11
57089,53,62761,53,allow,226,110,116,2,30,1,1
64294,445,0,0,drop,66,66,0,1,0,1,0
49501,443,35522,443,allow,13077,4380,8697,34,1881,17,17
54869,35440,0,0,deny,146,146,0,1,0,1,0
49622,443,38378,443,allow,11139,3031,8108,30,176,14,16
49863,443,52855,443,allow,7280,1441,5839,17,89,9,8
3986,17372,0,0,deny,66,66,0,1,0,1,0
54742,37965,0,0,deny,66,66,0,1,0,1,0
65419,26467,0,0,deny,62,62,0,1,0,1,0
20057,44847,0,0,deny,62,62,0,1,0,1,0
56837,46790,59586,46790,allow,70,70,0,1,5,1,0
61428,445,0,0,drop,70,70,0,1,0,1,0
57957,445,0,0,drop,70,70,0,1,0,1,0
63823,51558,31200,51558,allow,1518,1396,122,12,45,10,2
60793,53733,0,0,deny,66,66,0,1,0,1,0
58977,37965,0,0,deny,66,66,0,1,0,1,0
58190,445,0,0,drop,66,66,0,1,0,1,0
46190,80,10092,80,allow,5443,2529,2914,14,515,8,6
26805,443,51812,443,allow,7343,2586,4757,23,20,11,12
65277,53,40483,53,allow,167,86,81,2,30,1,1
43972,80,64832,80,allow,1894,1520,374,15,15,9,6
40814,53,40814,53,allow,213,87,126,2,31,1,1
56680,8100,18544,8100,allow,78,78,0,1,4,1,0
7686,25174,0,0,deny,146,146,0,1,0,1,0
51176,445,0,0,drop,70,70,0,1,0,1,0
59983,80,41468,80,allow,1745,779,966,12,144,7,5
30960,45679,3682,45679,allow,396,396,0,7,3615,7,0
53532,53,52838,53,allow,329,102,227,2,30,1,1
34245,443,35232,443,allow,11441,6765,4676,40,792,19,21
3978,35440,0,0,deny,62,62,0,1,0,1,0
18125,53,18125,53,allow,235,90,145,2,33,1,1
49485,53,58732,53,allow,752,93,659,2,31,1,1
62781,445,0,0,drop,66,66,0,1,0,1,0
58638,5900,0,0,deny,62,62,0,1,0,1,0
42115,53,42115,53,allow,262,106,156,2,32,1,1
50392,8080,50392,8080,allow,8962,4731,4231,26,75,14,12
44274,53,0,0,allow,82,82,0,1,31,1,0
64819,445,0,0,drop,70,70,0,1,0,1,0
60905,445,0,0,drop,70,70,0,1,0,1,0
56872,53,25005,53,allow,443,182,261,6,29,3,3
56308,53,13825,53,allow,184,94,90,2,30,1,1
50637,36237,0,0,deny,66,66,0,1,0,1,0
54677,443,30863,443,allow,72676,12694,59982,144,127,64,80
54161,443,65319,443,allow,3157,1827,1330,23,15,11,12
57026,445,0,0,drop,70,70,0,1,0,1,0
49188,8108,9022,8108,allow,1788,1016,772,15,15,8,7
55533,53,56018,53,allow,182,93,89,2,31,1,1
64191,53,5419,53,allow,197,94,103,2,30,1,1
443,39947,0,0,deny,74,74,0,1,0,1,0
65304,53,37771,53,allow,190,97,93,2,30,1,1
52412,445,0,0,drop,66,66,0,1,0,1,0
17579,57470,0,0,deny,62,62,0,1,0,1,0
54977,445,0,0,drop,66,66,0,1,0,1,0
53434,443,53434,443,allow,2511,1464,1047,21,102,10,11
50475,443,44824,443,allow,3893,1910,1983,36,255,17,19
58027,445,0,0,drop,70,70,0,1,0,1,0
11228,23,0,0,deny,60,60,0,1,0,1,0
58128,44847,0,0,deny,146,146,0,1,0,1,0
55223,445,0,0,drop,66,66,0,1,0,1,0
61561,445,0,0,drop,70,70,0,1,0,1,0
49146,443,26817,443,allow,47589,17003,30586,283,238,128,155
45218,25174,0,0,deny,62,62,0,1,0,1,0
53317,445,0,0,drop,66,66,0,1,0,1,0
52828,51221,0,0,deny,66,66,0,1,0,1,0
58046,443,22923,443,allow,1536,1089,447,11,56,7,4
50451,80,13158,80,allow,2673,564,2109,11,125,6,5
49418,37569,8517,37569,allow,246,78,168,2,30,1,1
56163,53,9366,53,allow,194,102,92,2,30,1,1
64959,53,64959,53,allow,398,255,143,3,33,2,1
18904,57470,0,0,deny,62,62,0,1,0,1,0
64303,53,3497,53,allow,212,102,110,2,30,1,1
11450,57470,0,0,deny,62,62,0,1,0,1,0
64895,53,65185,53,allow,199,102,97,2,30,1,1
57235,445,0,0,drop,66,66,0,1,0,1,0
56967,35440,0,0,deny,66,66,0,1,0,1,0
9104,26296,0,0,deny,157,157,0,1,0,1,0
57272,53,3406,53,allow,373,107,266,4,45,2,2
49757,445,0,0,drop,70,70,0,1,0,1,0
49917,53,46665,53,allow,168,78,90,2,29,1,1
56666,445,0,0,drop,70,70,0,1,0,1,0
34165,443,24288,443,allow,14923,1978,12945,32,49,17,15
7110,25174,0,0,deny,66,66,0,1,0,1,0
46945,64147,0,0,deny,62,62,0,1,0,1,0
49484,7000,49484,7000,allow,2958,1567,1391,15,15,8,7
56827,53,18397,53,allow,195,102,93,2,30,1,1
64901,445,0,0,drop,70,70,0,1,0,1,0
64684,53,47246,53,allow,184,94,90,2,30,1,1
52112,53559,37444,53559,allow,316,136,180,6,6,3,3
60960,445,0,0,drop,70,70,0,1,0,1,0
63838,445,0,0,drop,66,66,0,1,0,1,0
51320,37965,0,0,deny,62,62,0,1,0,1,0
46102,80,6915,80,allow,70,70,0,2,5,2,0
61270,445,0,0,drop,70,70,0,1,0,1,0
55071,53,59621,53,allow,177,94,83,2,30,1,1
8191,51221,0,0,deny,62,62,0,1,0,1,0
50944,443,36385,443,allow,9517,1898,7619,21,85,11,10
65514,443,30386,443,allow,92638,4519,88119,105,15,39,66
43591,443,23363,443,allow,4680,2835,1845,33,80,16,17
60768,445,0,0,drop,66,66,0,1,0,1,0
51155,443,21340,443,allow,54411,4588,49823,74,131,30,44
55746,53,54887,53,allow,216,110,106,2,30,1,1
54034,443,22227,443,allow,43491,8521,34970,69,50,34,35
60984,445,0,0,drop,70,70,0,1,0,1,0
27005,27015,45199,27015,allow,892,126,766,2,30,1,1
58120,445,0,0,drop,70,70,0,1,0,1,0
58638,5900,0,0,deny,62,62,0,1,0,1,0
50392,445,0,0,drop,70,70,0,1,0,1,0
59021,445,0,0,drop,70,70,0,1,0,1,0
52917,443,43916,443,allow,7148,2358,4790,40,116,18,22
63826,80,41744,80,allow,314,192,122,6,15,4,2
49489,53,23234,53,allow,241,118,123,2,30,1,1
52022,53657,53149,53657,allow,66,66,0,1,5,1,0
52474,445,0,0,drop,70,70,0,1,0,1,0
38592,57209,0,0,deny,62,62,0,1,0,1,0
53111,80,26592,80,allow,45904,3904,42000,65,16,33,32
8889,3808,0,0,deny,60,60,0,1,0,1,0
55183,53,35427,53,allow,177,94,83,2,29,1,1
55787,445,0,0,drop,70,70,0,1,0,1,0
50670,80,2254,80,allow,1658,1247,411,8,15,5,3
55093,445,0,0,drop,66,66,0,1,0,1,0
53155,28206,56023,28206,allow,70,70,0,1,5,1,0
61431,80,8546,80,allow,214,140,74,4,41,3,1
50439,64147,0,0,deny,66,66,0,1,0,1,0
56694,443,1542,443,allow,8058,2038,6020,20,15,11,9
55691,443,55691,443,allow,165616,8760,156856,199,82,79,120
55454,53,12163,53,allow,168,86,82,2,32,1,1
52326,443,20319,443,allow,4939,2553,2386,51,72,28,23
56773,445,0,0,drop,70,70,0,1,0,1,0
49820,53,16935,53,allow,193,102,91,2,29,1,1
58638,5900,0,0,deny,62,62,0,1,0,1,0
54500,445,0,0,drop,70,70,0,1,0,1,0
57150,53,42037,53,allow,166,86,80,2,29,1,1
50602,443,61178,443,allow,3901,1858,2043,19,23,11,8
61594,53,61594,53,allow,235,90,145,2,33,1,1
38700,443,57335,443,allow,90113,3417,86696,95,16,30,65
11228,25174,0,0,deny,66,66,0,1,0,1,0
51142,445,0,0,drop,70,70,0,1,0,1,0
55754,53,39478,53,allow,177,94,83,2,30,1,1
51126,445,0,0,drop,70,70,0,1,0,1,0
38675,443,44099,443,allow,90810,3417,87393,94,16,30,64
59449,445,0,0,drop,70,70,0,1,0,1,0
49214,58485,53751,58485,allow,70,70,0,2,8,2,0
26301,22114,0,0,deny,62,62,0,1,0,1,0
65037,53,14259,53,allow,243,94,149,2,30,1,1
64609,53,8196,53,allow,404,95,309,4,43,2,2
57606,445,0,0,drop,66,66,0,1,0,1,0
51441,443,56551,443,allow,642,582,60,2,15,1,1
55763,8060,47887,8060,allow,70,70,0,1,5,1,0
50106,30317,0,0,deny,62,62,0,1,0,1,0
65389,26467,0,0,deny,62,62,0,1,0,1,0
58638,5900,0,0,deny,62,62,0,1,0,1,0
56594,53,29488,53,allow,167,86,81,2,30,1,1
57357,53,10860,53,allow,231,94,137,2,30,1,1
57470,51413,59920,51413,allow,528,528,0,9,1199,9,0
65298,53,43096,53,allow,246,102,144,2,30,1,1
55460,445,0,0,drop,70,70,0,1,0,1,0
24351,57470,0,0,deny,62,62,0,1,0,1,0
55600,53,4581,53,allow,209,110,99,2,30,1,1
53700,45682,9190,45682,allow,492,306,186,8,15,5,3
53108,22114,0,0,deny,146,146,0,1,0,1,0
51501,993,18732,993,allow,12667,4060,8607,87,32,39,48
10166,44847,0,0,deny,62,62,0,1,0,1,0
65228,53,0,0,deny,88,88,0,1,0,1,0
50984,445,0,0,drop,70,70,0,1,0,1,0
63542,15503,0,0,deny,66,66,0,1,0,1,0
64056,445,0,0,drop,70,70,0,1,0,1,0
55926,53,47769,53,allow,184,94,90,2,29,1,1
48219,55442,0,0,deny,62,62,0,1,0,1,0
32007,1212,0,0,deny,145,145,0,1,0,1,0
25565,62144,0,0,deny,60,60,0,1,0,1,0
64815,37965,0,0,deny,66,66,0,1,0,1,0
50408,8080,50408,8080,allow,378,180,198,7,32,4,3
36074,80,23733,80,allow,1158,792,366,10,17,6,4
56964,53,51072,53,allow,174,89,85,2,31,1,1
50576,80,30685,80,allow,4189,1691,2498,16,24,9,7
53212,443,62292,443,allow,81114,4708,76406,108,66,39,69
49888,443,12324,443,allow,1072526,64733,1007793,1501,232,690,811
54400,445,0,0,drop,70,70,0,1,0,1,0
65176,53,35365,53,allow,182,93,89,2,30,1,1
61599,445,0,0,drop,70,70,0,1,0,1,0
49573,443,16183,443,allow,7332,2197,5135,18,135,8,10
32051,37965,0,0,deny,62,62,0,1,0,1,0
65305,445,0,0,drop,66,66,0,1,0,1,0
56616,80,15252,80,allow,234,234,0,4,12,4,0
6890,34729,0,0,deny,146,146,0,1,0,1,0
64870,53,1765,53,allow,200,102,98,2,33,1,1
59952,80,58096,80,allow,440081,8465,431616,424,24,137,287
33254,443,31595,443,allow,4838,2974,1864,21,17,13,8
57132,53,36267,53,allow,177,94,83,2,30,1,1
53272,443,50136,443,allow,5544,1703,3841,19,31,11,8
59668,51505,0,0,deny,62,62,0,1,0,1,0
64542,53,47604,53,allow,234,94,140,2,29,1,1
22714,30188,0,0,deny,62,62,0,1,0,1,0
57655,56205,0,0,deny,62,62,0,1,0,1,0
13188,35440,0,0,deny,66,66,0,1,0,1,0
53609,445,0,0,drop,70,70,0,1,0,1,0
60501,40829,11084,40829,allow,70,70,0,2,8,2,0
63245,26296,0,0,deny,159,159,0,1,0,1,0
443,4205,0,0,deny,320,320,0,1,0,1,0
57256,443,52300,443,allow,47762,39522,8240,77,332,43,34
53521,443,20457,443,allow,280,140,140,5,129,3,2
55797,53,14709,53,allow,735,88,647,2,30,1,1
55855,443,32782,443,allow,11485,3525,7960,32,33,18,14
37098,443,22843,443,allow,1835,1190,645,17,26,10,7
57913,443,45296,443,allow,9578079,276384,9301695,9817,153,2984,6833
56828,445,0,0,drop,70,70,0,1,0,1,0
56688,25174,0,0,deny,66,66,0,1,0,1,0
62736,445,0,0,drop,70,70,0,1,0,1,0
50698,80,42687,80,allow,54871,28320,26551,231,174,116,115
51980,45478,12123,45478,allow,70,70,0,2,7,2,0
57450,445,0,0,drop,70,70,0,1,0,1,0
60401,30046,28995,30046,allow,70,70,0,2,8,2,0
59326,445,0,0,drop,66,66,0,1,0,1,0
60000,443,1189,443,allow,34450,1943,32507,47,144,16,31
36483,80,36483,80,allow,1015966,37923,978043,1167,205,468,699
53245,443,53245,443,allow,1220,659,561,13,120,7,6
27401,37965,0,0,deny,66,66,0,1,0,1,0
50965,445,0,0,drop,70,70,0,1,0,1,0
56993,53,49057,53,allow,168,86,82,2,30,1,1
64299,53,26079,53,allow,268,84,184,4,42,2,2
10586,37965,0,0,deny,62,62,0,1,0,1,0
54167,50584,0,0,deny,62,62,0,1,0,1,0
38082,443,40503,443,allow,9037,1851,7186,26,180,14,12
62795,445,0,0,drop,66,66,0,1,0,1,0
63782,6969,33183,6969,allow,66,66,0,2,8,2,0
61248,445,0,0,drop,70,70,0,1,0,1,0
56912,53,5094,53,allow,199,102,97,2,29,1,1
52107,443,6381,443,allow,12091,3135,8956,30,49,16,14
61358,3389,61358,3389,allow,3488,1774,1714,17,33,9,8
51909,6881,0,0,deny,62,62,0,1,0,1,0
63343,53,0,0,deny,74,74,0,1,0,1,0
56629,443,57154,443,allow,7889,1900,5989,20,15,11,9
64124,25174,0,0,deny,62,62,0,1,0,1,0
64812,445,0,0,drop,70,70,0,1,0,1,0
51097,80,51452,80,allow,3374,1914,1460,33,131,18,15
54118,443,28446,443,allow,115373,6904,108469,171,117,87,84
49169,53,65143,53,allow,184,94,90,2,30,1,1
52657,80,31996,80,allow,26073,2868,23205,41,110,17,24
58638,5900,58638,5900,allow,126,62,64,2,5,1,1
18398,21247,0,0,deny,66,66,0,1,0,1,0
54578,26467,0,0,deny,66,66,0,1,0,1,0
60053,53,50009,53,allow,199,94,105,2,30,1,1
40410,443,37656,443,allow,2975,719,2256,14,136,7,7
57416,53,53137,53,allow,193,102,91,2,29,1,1
49895,443,62049,443,allow,493316,12157,481159,470,94,122,348
52489,53,54304,53,allow,302,78,224,2,29,1,1
49884,445,0,0,drop,70,70,0,1,0,1,0
49418,27015,10652,27015,allow,224,78,146,2,30,1,1
50340,53,41286,53,allow,181,94,87,2,29,1,1
6036,51505,0,0,deny,66,66,0,1,0,1,0
49650,53,21786,53,allow,216,110,106,2,30,1,1
58638,5900,0,0,deny,62,62,0,1,0,1,0
64424,53,30245,53,allow,211,102,109,2,30,1,1
56428,445,0,0,drop,70,70,0,1,0,1,0
52528,445,0,0,drop,66,66,0,1,0,1,0
19875,30170,0,0,deny,145,145,0,1,0,1,0
49955,80,63565,80,allow,9810,819,8991,19,15,9,10
27005,27015,31472,27015,allow,888,126,762,2,30,1,1
33065,443,50330,443,allow,6746,2826,3920,19,399,11,8
64677,57470,0,0,deny,66,66,0,1,0,1,0
37093,53,37093,53,allow,645,90,555,2,29,1,1
26658,25174,0,0,deny,146,146,0,1,0,1,0
54061,445,0,0,drop,66,66,0,1,0,1,0
33151,53,41502,53,allow,168,78,90,2,30,1,1
50340,80,53882,80,allow,8924,872,8052,19,41,9,10
65050,445,0,0,drop,66,66,0,1,0,1,0
53642,39344,30760,39344,allow,612,306,306,10,15,5,5
36812,53,60347,53,allow,168,78,90,2,31,1,1
49640,445,0,0,drop,66,66,0,1,0,1,0
59523,445,0,0,drop,70,70,0,1,0,1,0
34485,81,0,0,deny,60,60,0,1,0,1,0
56970,80,14502,80,allow,1783,841,942,10,20,6,4
41734,57470,0,0,deny,62,62,0,1,0,1,0
50183,445,0,0,drop,70,70,0,1,0,1,0
50670,443,29531,443,allow,11940,3585,8355,43,16,24,19
53579,59332,37605,59332,allow,70,70,0,2,8,2,0
27005,27016,57250,27016,allow,1784,252,1532,5,31,3,2
57870,445,0,0,drop,70,70,0,1,0,1,0
27005,27015,3156,27015,allow,878,126,752,2,30,1,1
50191,53,52829,53,allow,182,102,80,2,30,1,1
54698,445,0,0,drop,66,66,0,1,0,1,0
35567,443,35567,443,allow,5413,2166,3247,22,39,13,9
53595,28976,64230,28976,allow,492,306,186,8,15,5,3
61455,443,28409,443,allow,8947,1130,7817,28,124,13,15
64539,445,0,0,drop,70,70,0,1,0,1,0
46881,53,46881,53,allow,197,90,107,2,30,1,1
53729,443,15910,443,allow,499,425,74,4,0,3,1
42318,53,4117,53,allow,164,78,86,2,30,1,1
37531,443,49565,443,allow,17284,5197,12087,46,48,25,21
57134,53,29907,53,allow,178,94,84,2,30,1,1
48817,29614,48817,29614,allow,506,152,354,2,1201,1,1
48308,443,61860,443,allow,4654,2499,2155,17,31,9,8
64615,53,13915,53,allow,386,134,252,2,30,1,1
55802,443,44281,443,allow,30007,2755,27252,41,136,16,25
39343,443,19498,443,allow,8562,1634,6928,27,26,13,14
61398,80,61398,80,allow,1917,1468,449,10,19,6,4
26601,22114,0,0,deny,66,66,0,1,0,1,0
64751,53,33597,53,allow,178,94,84,2,30,1,1
56863,53,12002,53,allow,177,94,83,2,31,1,1
53678,443,40421,443,allow,6697,1606,5091,23,24,13,10
49262,443,12479,443,allow,4353,1227,3126,12,135,6,6
58925,25174,0,0,deny,66,66,0,1,0,1,0
65189,27255,47951,27255,allow,278,71,207,2,30,1,1
51772,80,5918,80,allow,93693,4469,89224,115,24,53,62
63260,445,0,0,drop,70,70,0,1,0,1,0
50569,80,5164,80,allow,318,192,126,6,26,4,2
65487,53,62444,53,allow,184,94,90,2,30,1,1
49599,445,0,0,drop,70,70,0,1,0,1,0
47293,443,64269,443,allow,6318,1025,5293,17,31,9,8
49280,445,0,0,drop,70,70,0,1,0,1,0
64809,53,47769,53,allow,312,78,234,2,30,1,1
47310,443,33854,443,allow,3541,616,2925,19,165,8,11
12290,22114,0,0,deny,66,66,0,1,0,1,0
56134,53,7161,53,allow,167,86,81,2,30,1,1
27321,25174,0,0,deny,62,62,0,1,0,1,0
50816,445,0,0,drop,66,66,0,1,0,1,0
57575,443,3355,443,allow,707158,36853,670305,902,148,310,592
53624,7370,56004,7370,allow,70,70,0,1,5,1,0
49484,80,9940,80,allow,3333,672,2661,12,15,7,5
60095,445,0,0,drop,66,66,0,1,0,1,0
50412,80,11804,80,allow,22200,11865,10335,38,86,24,14
63311,445,0,0,drop,66,66,0,1,0,1,0
63921,445,0,0,drop,70,70,0,1,0,1,0
49446,445,0,0,drop,70,70,0,1,0,1,0
50346,443,6974,443,allow,1385,868,517,12,30,6,6
15986,8000,55850,8000,allow,212,150,62,2,30,1,1
49144,443,40050,443,allow,130,70,60,3,5,2,1
55009,1114,14128,1114,allow,6562,1873,4689,25,16,15,10
55485,445,0,0,drop,66,66,0,1,0,1,0
50436,445,0,0,drop,70,70,0,1,0,1,0
34418,443,25762,443,allow,6402,1595,4807,23,316,12,11
51081,443,34616,443,allow,8192,2781,5411,22,374,12,10
34059,80,37168,80,allow,1151,711,440,10,15,5,5
49578,443,49511,443,allow,6947,833,6114,20,54,9,11
53267,445,0,0,drop,66,66,0,1,0,1,0
60098,443,41490,443,allow,1011,568,443,11,139,6,5
54061,443,17849,443,allow,126027,103934,22093,380,239,237,143
63341,53,0,0,deny,77,77,0,1,0,1,0
64102,445,0,0,drop,70,70,0,1,0,1,0
64997,51221,0,0,deny,66,66,0,1,0,1,0
60145,445,0,0,drop,70,70,0,1,0,1,0
55535,53,2360,53,allow,199,102,97,2,31,1,1
52083,26607,58147,26607,allow,70,70,0,1,4,1,0
56568,53,34489,53,allow,102,102,0,1,30,1,0
61150,11392,0,0,deny,62,62,0,1,0,1,0
50711,443,37437,443,allow,2952,1548,1404,18,16,9,9
35229,443,14508,443,allow,9488,4114,5374,27,363,14,13
59402,445,0,0,drop,70,70,0,1,0,1,0
33651,53,33651,53,allow,197,90,107,2,30,1,1
42278,443,42278,443,allow,1916,1121,795,19,69,10,9
48706,23393,0,0,deny,60,60,0,1,0,1,0
9227,9000,0,0,deny,60,60,0,1,0,1,0
54144,7000,54144,7000,allow,3018,1627,1391,16,15,9,7
63543,445,0,0,drop,66,66,0,1,0,1,0
60633,445,0,0,drop,66,66,0,1,0,1,0
40571,26467,0,0,deny,62,62,0,1,0,1,0
49532,53,13697,53,allow,195,102,93,2,30,1,1
59419,443,5544,443,allow,2854,1732,1122,16,15,8,8
55041,53,58764,53,allow,234,94,140,2,30,1,1
50346,445,0,0,drop,70,70,0,1,0,1,0
53715,445,0,0,drop,70,70,0,1,0,1,0
59994,53,59994,53,allow,462,158,304,4,31,2,2
6832,51505,0,0,deny,62,62,0,1,0,1,0
12136,53,12136,53,allow,198,90,108,2,30,1,1
48706,23393,0,0,deny,60,60,0,1,0,1,0
64708,445,0,0,drop,70,70,0,1,0,1,0
65270,3855,0,0,deny,78,78,0,1,0,1,0
26900,27017,18578,27017,allow,422,164,258,6,30,3,3
55407,445,0,0,drop,70,70,0,1,0,1,0
52123,46261,34015,46261,allow,70,70,0,2,7,2,0
57134,53,41374,53,allow,195,102,93,2,30,1,1
52162,15104,33803,15104,allow,70,70,0,2,7,2,0
53960,30041,0,0,deny,66,66,0,1,0,1,0
51689,80,35961,80,allow,16205,2525,13680,31,139,15,16
50995,443,19177,443,allow,3115,1849,1266,18,16,8,10
61336,443,63223,443,allow,34919,6979,27940,68,247,27,41
27005,27017,59484,27017,allow,882,126,756,2,30,1,1
40418,25174,0,0,deny,62,62,0,1,0,1,0
56090,53,62587,53,allow,195,94,101,2,30,1,1
65028,445,0,0,drop,70,70,0,1,0,1,0
65275,53,62237,53,allow,184,94,90,2,30,1,1
64680,53,32256,53,allow,768,99,669,2,30,1,1
51811,20740,15988,20740,allow,66,66,0,1,5,1,0
49602,53,63187,53,allow,178,94,84,2,30,1,1
50584,18066,56366,18066,allow,1705,536,1169,5,1200,4,1
27005,33026,18106,33026,allow,879,126,753,2,31,1,1
51790,80,59266,80,allow,1936,1085,851,9,15,5,4
53533,22642,24303,22642,allow,612,306,306,10,16,5,5
3382,53,3382,53,allow,220,100,120,2,31,1,1
53203,445,0,0,drop,70,70,0,1,0,1,0
64381,53,44937,53,allow,952,291,661,8,68,4,4
3478,61463,0,0,deny,1004,1004,0,1,0,1,0
37889,53,32762,53,allow,199,94,105,2,30,1,1
56081,53,27644,53,allow,186,102,84,2,29,1,1
37096,443,16174,443,allow,130,70,60,2,15,1,1
38948,53,19233,53,allow,242,78,164,2,29,1,1
23061,23,0,0,deny,60,60,0,1,0,1,0
56769,53,50586,53,allow,195,102,93,2,30,1,1
59533,443,28553,443,allow,448,78,370,6,24,1,5
49837,445,0,0,drop,70,70,0,1,0,1,0
56425,445,0,0,drop,70,70,0,1,0,1,0
61494,445,0,0,drop,66,66,0,1,0,1,0
27651,53,46551,53,allow,225,78,147,2,30,1,1
65481,53,28484,53,allow,168,86,82,2,31,1,1
48992,80,47525,80,allow,1114,534,580,12,16,7,5
59955,80,59955,80,allow,16324,808,15516,25,59,11,14
52938,64097,0,0,deny,66,66,0,1,0,1,0
51769,19165,52583,19165,allow,70,70,0,1,5,1,0
49462,445,0,0,drop,66,66,0,1,0,1,0
55075,53,41245,53,allow,181,94,87,2,33,1,1
57432,53,57432,53,allow,247,98,149,2,34,1,1
50803,443,27237,443,allow,25297,10467,14830,51,362,27,24
50065,80,29478,80,allow,4709,4006,703,11,25,6,5
27005,27018,60808,27018,allow,881,126,755,2,31,1,1
50544,53,44871,53,allow,969,86,883,2,30,1,1
56152,56205,0,0,deny,66,66,0,1,0,1,0
30794,37965,0,0,deny,62,62,0,1,0,1,0
50291,445,0,0,drop,70,70,0,1,0,1,0
50425,443,27749,443,allow,4600,667,3933,14,17,7,7
50850,445,0,0,drop,70,70,0,1,0,1,0
58638,5900,0,0,deny,62,62,0,1,0,1,0
50341,37965,0,0,deny,62,62,0,1,0,1,0
61209,445,0,0,drop,66,66,0,1,0,1,0
58638,5900,0,0,deny,62,62,0,1,0,1,0
51294,443,42258,443,allow,162,102,60,2,5,1,1
52134,443,44449,443,allow,473832,22822,451010,464,109,139,325
41815,5228,54746,5228,allow,7701,2155,5546,30,611,17,13
64547,53,28372,53,allow,367,102,265,2,31,1,1
443,61686,0,0,deny,90,90,0,1,0,1,0
60915,445,0,0,drop,70,70,0,1,0,1,0
65176,53,35354,53,allow,511,195,316,6,56,3,3
54530,443,34587,443,allow,6202,3033,3169,28,167,13,15
63110,445,0,0,drop,70,70,0,1,0,1,0
60809,40010,63910,40010,allow,316,136,180,6,6,3,3
61138,445,0,0,drop,66,66,0,1,0,1,0
45941,23386,0,0,deny,60,60,0,1,0,1,0
49913,443,65032,443,allow,976,589,387,10,76,6,4
58638,5900,0,0,deny,62,62,0,1,0,1,0
57504,445,0,0,drop,70,70,0,1,0,1,0
43269,50584,0,0,deny,66,66,0,1,0,1,0
27537,25198,0,0,deny,148,148,0,1,0,1,0
65445,53,31304,53,allow,199,102,97,2,30,1,1
54555,25174,0,0,deny,66,66,0,1,0,1,0
53735,58869,2598,58869,allow,70,70,0,2,7,2,0
50772,35440,0,0,deny,66,66,0,1,0,1,0
40215,443,8042,443,allow,6423,1543,4880,21,191,12,9
55208,80,41287,80,allow,1638,1324,314,10,15,5,5
33405,37965,0,0,deny,62,62,0,1,0,1,0
61078,123,41282,123,allow,184,94,90,2,30,1,1
51104,80,56002,80,allow,1524,1028,496,10,21,7,3
37571,53,19977,53,allow,164,78,86,2,30,1,1
6881,12676,29408,12676,allow,509,150,359,2,1199,1,1
63903,56016,63323,56016,allow,312,132,180,6,6,3,3
57367,443,57367,443,allow,4381,1474,2907,19,29,11,8
49900,445,0,0,drop,70,70,0,1,0,1,0
64149,53,17311,53,allow,301,108,193,4,49,2,2
41254,443,60907,443,allow,12757,4053,8704,39,522,14,25
19253,53,19253,53,allow,414,268,146,3,32,2,1
28024,443,28708,443,allow,5516,1388,4128,18,15,9,9
48706,23393,0,0,deny,60,60,0,1,0,1,0
54224,443,19866,443,allow,499,425,74,4,0,3,1
80,5101,0,0,deny,78,78,0,1,0,1,0
11574,51505,0,0,deny,66,66,0,1,0,1,0
57265,53,15033,53,allow,200,102,98,2,30,1,1
52324,443,60831,443,allow,295493,16052,279441,394,68,186,208
55728,53,39278,53,allow,190,97,93,2,31,1,1
58858,443,56785,443,allow,7413235,214811,7198424,7869,344,2785,5084
19747,37965,0,0,deny,62,62,0,1,0,1,0
50584,38496,45984,38496,allow,166,166,0,1,1200,1,0
50928,443,1946,443,allow,3347,2025,1322,31,34,18,13
34113,443,8238,443,allow,70,70,0,1,5,1,0
25602,64147,0,0,deny,62,62,0,1,0,1,0
6943,52290,0,0,deny,100,100,0,1,0,1,0
55315,53,15960,53,allow,196,102,94,2,30,1,1
41776,443,6550,443,allow,32434,15588,16846,164,1128,83,81
54598,37965,0,0,deny,62,62,0,1,0,1,0
21859,53,21859,53,allow,242,98,144,2,30,1,1
34911,443,4016,443,allow,414843,13933,400910,459,136,160,299
51566,443,53596,443,allow,3051,990,2061,14,135,7,7
50925,445,0,0,drop,66,66,0,1,0,1,0
63852,445,0,0,drop,70,70,0,1,0,1,0
56799,443,47229,443,allow,8021,2001,6020,20,15,11,9
1059,44847,0,0,deny,62,62,0,1,0,1,0
57653,445,0,0,drop,70,70,0,1,0,1,0
50565,443,52646,443,allow,1313,876,437,11,27,6,5
37748,80,57196,80,allow,1090,609,481,13,329,7,6
62164,445,0,0,drop,70,70,0,1,0,1,0
53554,1433,0,0,deny,60,60,0,1,0,1,0
49443,80,19440,80,allow,3642,1460,2182,23,143,12,11
27005,27015,38392,27015,allow,878,126,752,2,30,1,1
9171,80,16073,80,allow,318,192,126,6,29,4,2
50211,51050,0,0,deny,66,66,0,1,0,1,0
43495,5223,54062,5223,allow,139,139,0,2,6,2,0
49510,443,46546,443,allow,1012,495,517,10,26,4,6
55517,53,14797,53,allow,179,94,85,2,31,1,1
58638,5900,0,0,deny,62,62,0,1,0,1,0
57297,443,9892,443,allow,5614,733,4881,16,15,9,7
60176,445,0,0,drop,66,66,0,1,0,1,0
52027,80,10157,80,allow,9732,8170,1562,18,38,10,8
54054,443,22271,443,allow,12268,7082,5186,26,85,15,11
56590,25174,0,0,deny,66,66,0,1,0,1,0
61595,445,0,0,drop,66,66,0,1,0,1,0
12290,22114,0,0,deny,66,66,0,1,0,1,0
64519,53,14591,53,allow,195,102,93,2,29,1,1
50920,60182,0,0,deny,66,66,0,1,0,1,0
14950,53,14950,53,allow,414,268,146,3,32,2,1
52247,51505,0,0,deny,146,146,0,1,0,1,0
59198,445,0,0,drop,66,66,0,1,0,1,0
50680,443,16561,443,allow,7066,1129,5937,19,172,9,10
50913,80,46319,80,allow,12767608,157856,12609752,11936,135,2227,9709
0,0,0,0,allow,244,244,0,2,0,2,0
42157,443,25655,443,allow,4819,2903,1916,29,81,15,14
51616,445,0,0,drop,70,70,0,1,0,1,0
65258,53,48935,53,allow,193,102,91,2,30,1,1
16944,50584,0,0,deny,146,146,0,1,0,1,0
54649,445,0,0,drop,66,66,0,1,0,1,0
56608,445,0,0,drop,70,70,0,1,0,1,0
1441,51221,0,0,deny,62,62,0,1,0,1,0
65403,53,26978,53,allow,178,94,84,2,30,1,1
60322,443,12700,443,allow,1743,1164,579,16,25,10,6
61113,443,60052,443,allow,23915,14776,9139,66,136,35,31
63765,51221,0,0,deny,62,62,0,1,0,1,0
993,18732,0,0,deny,129,129,0,1,0,1,0
59679,37807,0,0,deny,66,66,0,1,0,1,0
50708,22114,0,0,deny,146,146,0,1,0,1,0
36405,53,36515,53,allow,199,94,105,2,30,1,1
40254,25174,0,0,deny,62,62,0,1,0,1,0
37658,16384,24782,16384,allow,130,70,60,2,30,1,1
50089,443,48630,443,allow,12446,2347,10099,44,190,23,21
51723,10622,28735,10622,allow,70,70,0,1,5,1,0
55957,53,35891,53,allow,178,94,84,2,29,1,1
49463,445,0,0,drop,70,70,0,1,0,1,0
57131,35776,0,0,deny,145,145,0,1,0,1,0
34357,443,37129,443,allow,17372,10352,7020,91,422,52,39
61265,445,0,0,drop,70,70,0,1,0,1,0
33941,37807,0,0,deny,62,62,0,1,0,1,0
35154,42707,0,0,deny,62,62,0,1,0,1,0
3819,80,3819,80,allow,9399,632,8767,15,15,7,8
49677,53,61420,53,allow,373,126,247,2,29,1,1
16293,57470,0,0,deny,62,62,0,1,0,1,0
64752,53,22741,53,allow,178,94,84,2,29,1,1
1594,44847,0,0,deny,62,62,0,1,0,1,0
55635,53,55876,53,allow,177,94,83,2,30,1,1
56092,445,0,0,drop,66,66,0,1,0,1,0
52087,80,10358,80,allow,2757,648,2109,12,23,7,5
49418,27015,63577,27015,allow,71,71,0,1,30,1,0
53758,63975,2179,63975,allow,2016,1076,940,14,17,8,6
51192,15503,0,0,deny,66,66,0,1,0,1,0
55624,53,62232,53,allow,244,94,150,2,29,1,1
9756,26467,0,0,deny,62,62,0,1,0,1,0
49412,443,12912,443,allow,9266,2595,6671,35,123,18,17
51880,8001,48278,8001,allow,86,86,0,1,29,1,0
36566,37965,0,0,deny,62,62,0,1,0,1,0
57251,37965,0,0,deny,62,62,0,1,0,1,0
50111,443,14390,443,allow,60978,3794,57184,73,137,26,47
65225,443,9124,443,allow,3350,2037,1313,25,95,14,11
49369,53,3787,53,allow,182,93,89,2,31,1,1
65199,445,0,0,drop,70,70,0,1,0,1,0
10151,27715,29644,27715,allow,460,150,310,2,1200,1,1
9463,443,40374,443,allow,8952,5576,3376,35,38,21,14
52435,445,0,0,drop,70,70,0,1,0,1,0
52207,445,0,0,drop,70,70,0,1,0,1,0
55275,53,25486,53,allow,213,94,119,2,30,1,1
60775,443,60775,443,allow,4652,1745,2907,19,29,11,8
49671,53,50695,53,allow,335,117,218,4,36,2,2
63942,53,65464,53,allow,214,102,112,2,30,1,1
56742,445,0,0,drop,70,70,0,1,0,1,0
51002,443,58115,443,allow,3536,2198,1338,18,332,9,9
58157,445,0,0,drop,70,70,0,1,0,1,0
65260,445,0,0,drop,70,70,0,1,0,1,0
6881,6881,55325,6881,allow,853,355,498,4,1200,2,2
57411,53,35330,53,allow,196,102,94,2,30,1,1
57619,443,40662,443,allow,9315,2153,7162,23,127,6,17
50428,80,50756,80,allow,312,192,120,6,27,4,2
56747,53,24392,53,allow,172,94,78,2,30,1,1
55721,53,41720,53,allow,177,94,83,2,30,1,1
53237,445,0,0,drop,70,70,0,1,0,1,0
56987,53,30832,53,allow,192,98,94,2,31,1,1
65077,445,0,0,drop,70,70,0,1,0,1,0
35515,53,35515,53,allow,235,98,137,2,30,1,1
61278,56205,0,0,deny,62,62,0,1,0,1,0
49947,53,36871,53,allow,264,102,162,2,30,1,1
50400,53,28411,53,allow,177,94,83,2,30,1,1
52501,80,52501,80,allow,79714,5592,74122,102,23,45,57
49971,53,19251,53,allow,779,110,669,2,30,1,1
49176,443,46832,443,allow,2802,1902,900,22,1118,12,10
65139,53,19988,53,allow,216,110,106,2,31,1,1
27005,27999,8243,27999,allow,913,126,787,2,31,1,1
53791,16881,62073,16881,allow,70,70,0,2,8,2,0
54533,443,7224,443,allow,2638,330,2308,12,135,5,7
56819,53,17305,53,allow,209,110,99,2,31,1,1
64965,445,0,0,drop,70,70,0,1,0,1,0
64559,53,14656,53,allow,816,102,714,2,29,1,1
2598,23718,0,0,deny,66,66,0,1,0,1,0
48174,443,2102,443,allow,3889,1992,1897,19,255,10,9
45682,25604,0,0,deny,62,62,0,1,0,1,0
27005,27015,11588,27015,allow,1019,252,767,4,32,3,1
49181,53,15171,53,allow,491,98,393,4,40,2,2
60406,445,0,0,drop,66,66,0,1,0,1,0
49924,443,9177,443,allow,13502,2331,11171,42,194,19,23
61976,445,0,0,drop,66,66,0,1,0,1,0
33822,57470,0,0,deny,66,66,0,1,0,1,0
49831,30188,0,0,deny,66,66,0,1,0,1,0
52106,41632,7529,41632,allow,70,70,0,2,9,2,0
51879,445,0,0,drop,70,70,0,1,0,1,0
64755,53,11546,53,allow,339,134,205,2,30,1,1
123,123,44322,123,allow,184,94,90,2,29,1,1
49442,53,12597,53,allow,326,110,216,2,30,1,1
57263,443,6071,443,allow,7748,3859,3889,20,148,10,10
52149,80,41444,80,allow,1638,1324,314,10,15,5,5
55646,53,7208,53,allow,216,94,122,2,30,1,1
46858,15000,17792,15000,allow,130,70,60,2,5,1,1
17004,64147,0,0,deny,66,66,0,1,0,1,0
51724,445,0,0,drop,70,70,0,1,0,1,0
55275,53,41187,53,allow,770,101,669,2,30,1,1
41073,53,41073,53,allow,197,90,107,2,30,1,1
49734,443,18197,443,allow,7548,1543,6005,22,18,12,10
56418,53,19002,53,allow,183,94,89,2,30,1,1
37647,443,55661,443,allow,697381,19797,677584,725,106,247,478
63879,80,50871,80,allow,314,192,122,6,15,4,2
50677,80,32544,80,allow,3664,1440,2224,12,20,6,6
41490,25174,0,0,deny,146,146,0,1,0,1,0
56416,53,30154,53,allow,816,102,714,2,30,1,1
57470,26247,60262,26247,allow,1320,1320,0,21,1624,21,0
49406,80,24541,80,allow,32206,1049,31157,37,89,11,26
63465,56205,0,0,deny,66,66,0,1,0,1,0
58996,445,0,0,drop,70,70,0,1,0,1,0
64546,53,39505,53,allow,183,94,89,2,31,1,1
59728,445,0,0,drop,70,70,0,1,0,1,0
35120,26467,0,0,deny,62,62,0,1,0,1,0
49224,53,25602,53,allow,199,102,97,2,30,1,1
45313,64147,0,0,deny,62,62,0,1,0,1,0
56055,53,2822,53,allow,168,86,82,2,31,1,1
44691,53,43758,53,allow,199,94,105,2,30,1,1
53986,53,15974,53,allow,102,102,0,1,30,1,0
18767,35440,0,0,deny,146,146,0,1,0,1,0
49880,53,16831,53,allow,817,102,715,2,30,1,1
63336,445,0,0,drop,66,66,0,1,0,1,0
60855,443,10736,443,allow,598135,40549,557586,873,251,326,547
33748,443,24979,443,allow,70,70,0,2,5,2,0
443,54507,0,0,deny,82,82,0,1,0,1,0
22194,31573,0,0,deny,146,146,0,1,0,1,0
50407,62413,0,0,deny,62,62,0,1,0,1,0
1024,64147,0,0,deny,62,62,0,1,0,1,0
22220,25174,0,0,deny,146,146,0,1,0,1,0
27005,27216,33781,27216,allow,872,126,746,2,30,1,1
51769,51505,0,0,deny,66,66,0,1,0,1,0
50263,53,61533,53,allow,753,96,657,2,30,1,1
22636,30188,0,0,deny,62,62,0,1,0,1,0
56835,53,43767,53,allow,213,102,111,2,30,1,1
41207,5900,0,0,deny,60,60,0,1,0,1,0
60432,445,0,0,drop,70,70,0,1,0,1,0
25570,35440,0,0,deny,62,62,0,1,0,1,0
58570,445,0,0,drop,70,70,0,1,0,1,0
22275,51505,0,0,deny,62,62,0,1,0,1,0
51098,60043,0,0,deny,62,62,0,1,0,1,0
54233,443,10183,443,allow,499,425,74,4,0,3,1
49606,53,17957,53,allow,258,110,148,2,30,1,1
64360,445,0,0,drop,70,70,0,1,0,1,0
55166,53,22324,53,allow,177,94,83,2,30,1,1
61477,443,48304,443,allow,30516,3311,27205,49,47,25,24
56996,445,0,0,drop,70,70,0,1,0,1,0
1262,23,0,0,deny,60,60,0,1,0,1,0
49265,53,25625,53,allow,211,102,109,2,30,1,1
63962,53,22978,53,allow,274,93,181,4,64,2,2
33990,443,59264,443,allow,11404,1948,9456,30,81,15,15
64089,53,3452,53,allow,194,102,92,2,31,1,1
50014,80,33183,80,allow,810,670,140,6,34,4,2
57208,53,43799,53,allow,184,86,98,2,30,1,1
9170,80,30007,80,allow,318,192,126,6,29,4,2
60371,445,0,0,drop,66,66,0,1,0,1,0
57470,6969,5895,6969,allow,132,132,0,3,1199,3,0
54635,53,0,0,allow,197,86,111,2,29,1,1
22131,53,22131,53,allow,172,76,96,2,31,1,1
55120,445,0,0,drop,70,70,0,1,0,1,0
18837,53,18837,53,allow,233,90,143,2,32,1,1
55808,53,53764,53,allow,730,102,628,2,30,1,1
10822,48817,0,0,deny,140,140,0,1,0,1,0
57676,445,0,0,drop,66,66,0,1,0,1,0
60243,445,0,0,drop,70,70,0,1,0,1,0
53858,443,59816,443,allow,499,425,74,4,1,3,1
1930,80,62505,80,allow,214,140,74,4,15,3,1
54659,443,56106,443,allow,1773,1038,735,17,278,9,8
55766,36237,0,0,deny,62,62,0,1,0,1,0
63542,15503,0,0,deny,66,66,0,1,0,1,0
30960,45691,5004,45691,allow,330,330,0,6,3609,6,0
64240,50584,0,0,deny,66,66,0,1,0,1,0
49451,53,64804,53,allow,211,102,109,2,30,1,1
48420,26672,0,0,deny,146,146,0,1,0,1,0
443,28215,0,0,deny,60,60,0,1,0,1,0
52182,443,4685,443,allow,237151,13019,224132,251,42,90,161
55553,53,13806,53,allow,199,94,105,2,29,1,1
64944,53,42030,53,allow,228,94,134,2,30,1,1
41025,38191,0,0,deny,157,157,0,1,0,1,0
34922,443,21368,443,allow,8093,2068,6025,23,360,11,12
62283,445,0,0,drop,66,66,0,1,0,1,0
54540,443,17427,443,allow,6680,3784,2896,18,135,9,9
57243,53,64536,53,allow,165,86,79,2,31,1,1
57379,445,0,0,drop,70,70,0,1,0,1,0
39042,443,16986,443,allow,19733,3606,16127,43,16,22,21
55953,445,0,0,drop,70,70,0,1,0,1,0
49431,53,38249,53,allow,767,102,665,2,30,1,1
59338,445,0,0,drop,66,66,0,1,0,1,0
50557,445,0,0,drop,70,70,0,1,0,1,0
60805,443,29197,443,allow,7983,4398,3585,17,121,8,9
55818,445,0,0,drop,70,70,0,1,0,1,0
55608,445,0,0,drop,66,66,0,1,0,1,0
58638,5900,0,0,deny,62,62,0,1,0,1,0
57157,53,17035,53,allow,755,94,661,2,31,1,1
17378,44847,0,0,deny,66,66,0,1,0,1,0
5588,5588,0,0,allow,3498,1872,1626,48,197,24,24
63383,53,63383,53,allow,235,90,145,2,33,1,1
49972,53,10685,53,allow,216,110,106,2,31,1,1
56964,53,61136,53,allow,267,87,180,4,59,2,2
55033,53,37383,53,allow,182,94,88,2,31,1,1
55853,53,62979,53,allow,228,110,118,2,30,1,1
54354,443,10906,443,allow,18848,10436,8412,42,33,20,22
55808,445,0,0,drop,66,66,0,1,0,1,0
61000,15503,0,0,deny,146,146,0,1,0,1,0
14360,64147,0,0,deny,62,62,0,1,0,1,0
55581,53,6275,53,allow,167,86,81,2,30,1,1
36712,53,0,0,allow,139,70,69,2,30,1,1
26881,25174,0,0,deny,66,66,0,1,0,1,0
62873,443,13983,443,allow,3049,988,2061,14,135,7,7
60046,445,0,0,drop,70,70,0,1,0,1,0
41580,443,42075,443,allow,4354,2166,2188,14,136,7,7
55820,53,24388,53,allow,188,96,92,2,31,1,1
51328,443,46063,443,allow,6021,1981,4040,21,15,9,12
57470,6881,51127,6881,allow,594,594,0,10,1200,10,0
57155,53,11661,53,allow,396,102,294,2,30,1,1
53884,445,0,0,drop,66,66,0,1,0,1,0
57051,53,56096,53,allow,185,102,83,2,30,1,1
50568,80,17182,80,allow,318,192,126,6,26,4,2
1024,57470,0,0,deny,62,62,0,1,0,1,0
50439,64147,0,0,deny,66,66,0,1,0,1,0
59049,445,0,0,drop,70,70,0,1,0,1,0
50199,443,58943,443,allow,8641,2459,6182,22,16,12,10
63401,445,0,0,drop,70,70,0,1,0,1,0
51221,33295,49216,33295,allow,528,528,0,9,1200,9,0
54374,443,44819,443,allow,9131,3499,5632,39,24,21,18
53029,445,0,0,drop,70,70,0,1,0,1,0
47674,443,2134,443,allow,7576,2983,4593,33,42,18,15
55594,53,22728,53,allow,167,86,81,2,30,1,1
65416,53,16237,53,allow,213,102,111,2,30,1,1
53548,23310,59949,23310,allow,70,70,0,1,4,1,0
54996,53,14810,53,allow,168,86,82,2,31,1,1
50405,53,35754,53,allow,200,102,98,2,30,1,1
43268,443,16959,443,allow,8954,2755,6199,23,143,10,13
54010,445,0,0,drop,66,66,0,1,0,1,0
52271,445,0,0,drop,70,70,0,1,0,1,0
56971,53,24481,53,allow,195,102,93,2,30,1,1
55608,445,0,0,drop,70,70,0,1,0,1,0
64615,53,10268,53,allow,195,102,93,2,30,1,1
55399,53,4452,53,allow,405,99,306,4,41,2,2
57455,445,0,0,drop,70,70,0,1,0,1,0
443,62451,0,0,deny,199,199,0,1,0,1,0
50288,445,0,0,drop,66,66,0,1,0,1,0
47762,36180,0,0,deny,146,146,0,1,0,1,0
49778,53,15143,53,allow,255,102,153,2,29,1,1
37621,80,10654,80,allow,350,210,140,6,15,4,2
54464,56205,0,0,deny,66,66,0,1,0,1,0
20954,53,64122,53,allow,223,78,145,2,30,1,1
48606,443,28779,443,allow,4160,2675,1485,25,95,14,11
48840,50584,0,0,deny,62,62,0,1,0,1,0
0,0,0,0,deny,98,98,0,1,0,1,0
34392,443,49266,443,allow,1820,1101,719,18,76,10,8
64907,53,25739,53,allow,168,86,82,2,30,1,1
443,28417,0,0,deny,82,82,0,1,0,1,0
49418,27015,54748,27015,allow,78,78,0,1,29,1,0
43571,26467,0,0,deny,62,62,0,1,0,1,0
63130,445,0,0,drop,70,70,0,1,0,1,0
61510,37965,0,0,deny,66,66,0,1,0,1,0
26921,57470,0,0,deny,62,62,0,1,0,1,0
52671,445,0,0,drop,66,66,0,1,0,1,0
0,0,0,0,deny,110,110,0,1,0,1,0
50620,80,32710,80,allow,16709,10372,6337,31,52,16,15
62684,445,0,0,drop,66,66,0,1,0,1,0
56841,29753,27881,29753,allow,70,70,0,2,8,2,0
50718,80,3998,80,allow,620,320,300,11,166,6,5
64030,53,64891,53,allow,222,78,144,2,30,1,1
60466,445,0,0,drop,66,66,0,1,0,1,0
59585,445,0,0,drop,66,66,0,1,0,1,0
4545,1900,0,0,deny,136,136,0,1,0,1,0
53765,16178,2985,16178,allow,70,70,0,1,5,1,0
35347,20238,0,0,deny,66,66,0,1,0,1,0
53709,443,33210,443,allow,7356,1014,6342,20,75,10,10
50037,53,12005,53,allow,195,102,93,2,30,1,1
49950,80,40840,80,allow,51651,48866,2785,74,20,38,36
36499,53,58408,53,allow,302,208,94,3,30,2,1
63229,443,6765,443,allow,1373,734,639,17,134,10,7
63852,25174,0,0,deny,62,62,0,1,0,1,0
36520,3142,36520,3142,allow,138,78,60,2,5,1,1
13285,29892,0,0,deny,145,145,0,1,0,1,0
50584,32808,19666,32808,allow,166,166,0,1,1199,1,0
48929,62609,0,0,deny,148,148,0,1,0,1,0
61643,445,0,0,drop,70,70,0,1,0,1,0
33610,443,59796,443,allow,9490,1158,8332,24,257,13,11
36541,443,3197,443,allow,4322,797,3525,14,64,8,6
64089,53,20449,53,allow,197,94,103,2,30,1,1
63593,22114,0,0,deny,66,66,0,1,0,1,0
64683,53,44457,53,allow,370,126,244,2,30,1,1
54924,3478,47718,3478,allow,312,140,172,4,30,2,2
56085,53,39673,53,allow,167,86,81,2,31,1,1
54062,31573,0,0,deny,66,66,0,1,0,1,0
55921,43890,0,0,deny,62,62,0,1,0,1,0
64135,53,37160,53,allow,196,102,94,2,30,1,1
62927,445,0,0,drop,70,70,0,1,0,1,0
52501,445,0,0,drop,66,66,0,1,0,1,0
55291,53,55867,53,allow,243,94,149,2,31,1,1
34787,443,34308,443,allow,13074,2439,10635,46,279,22,24
53004,445,0,0,drop,70,70,0,1,0,1,0
56621,53,19745,53,allow,177,94,83,2,30,1,1
63846,445,0,0,drop,70,70,0,1,0,1,0
37965,14259,39595,14259,allow,150,150,0,1,1199,1,0
56226,53,49033,53,allow,200,102,98,2,30,1,1
50557,445,0,0,drop,70,70,0,1,0,1,0
38504,443,56099,443,allow,2227,1018,1209,17,15,8,9
50239,53,26724,53,allow,183,94,89,2,30,1,1
2371,53,52292,53,allow,164,86,78,2,31,1,1
49888,445,0,0,drop,70,70,0,1,0,1,0
61840,25174,0,0,deny,66,66,0,1,0,1,0
8999,48817,0,0,deny,146,146,0,1,0,1,0
39233,53,39233,53,allow,235,90,145,2,33,1,1
59051,445,0,0,drop,70,70,0,1,0,1,0
55850,443,57703,443,allow,4344,2189,2155,15,126,7,8
48854,443,38265,443,allow,2497156,63601,2433555,2465,17,852,1613
50653,80,33144,80,allow,124643,7017,117626,163,21,75,88
58638,5900,0,0,deny,62,62,0,1,0,1,0
2323,23117,0,0,deny,62,62,0,1,0,1,0
59937,18375,0,0,deny,66,66,0,1,0,1,0
49482,80,62281,80,allow,378,192,186,7,39,4,3
55868,53,18445,53,allow,177,94,83,2,30,1,1
64595,53,8174,53,allow,305,94,211,4,60,2,2
9522,443,6233,443,allow,6146,709,5437,18,29,8,10
51945,445,0,0,drop,70,70,0,1,0,1,0
58681,123,50487,123,allow,184,94,90,2,30,1,1
56655,80,36577,80,allow,234,234,0,4,12,4,0
56720,53,57762,53,allow,916,86,830,2,31,1,1
53210,80,7510,80,allow,1726,940,786,8,51,5,3
0,0,0,0,deny,70,70,0,1,0,1,0
65269,445,0,0,drop,70,70,0,1,0,1,0
59273,445,0,0,drop,70,70,0,1,0,1,0
62044,443,20776,443,allow,10530,2001,8529,29,47,14,15
58891,443,55777,443,allow,7641,5165,2476,25,18,13,12
55836,443,16714,443,allow,3538,2015,1523,28,323,14,14
56610,443,4585,443,allow,8035,2015,6020,20,16,11,9
49590,57470,0,0,deny,78,78,0,1,0,1,0
38160,443,38160,443,allow,11290,5394,5896,37,80,21,16
46779,5228,25730,5228,allow,3775,2029,1746,30,3637,13,17
11552,44847,0,0,deny,146,146,0,1,0,1,0
49954,53,47734,53,allow,228,110,118,2,30,1,1
33245,443,3684,443,allow,7279,2884,4395,28,16,16,12
21133,8535,17822,8535,allow,490,149,341,2,1200,1,1
58638,5900,0,0,deny,62,62,0,1,0,1,0
55056,56205,0,0,deny,66,66,0,1,0,1,0
55265,445,0,0,drop,70,70,0,1,0,1,0
47042,443,19544,443,allow,2809,1884,925,19,25,11,8
61181,445,0,0,drop,70,70,0,1,0,1,0
59037,51505,0,0,deny,66,66,0,1,0,1,0
27005,27240,14670,27240,allow,868,126,742,2,31,1,1
50000,445,0,0,drop,70,70,0,1,0,1,0
60408,55557,8506,55557,allow,70,70,0,1,5,1,0
35866,80,8550,80,allow,1114,534,580,12,15,7,5
59893,80,45322,80,allow,130,70,60,2,15,1,1
56126,53,32815,53,allow,183,94,89,2,30,1,1
62896,993,54480,993,allow,178,118,60,2,15,1,1
58638,5900,0,0,deny,62,62,0,1,0,1,0
55380,53,36013,53,allow,289,97,192,4,45,2,2
56975,53,38883,53,allow,197,102,95,2,29,1,1
53560,445,0,0,drop,66,66,0,1,0,1,0
62150,23718,0,0,deny,66,66,0,1,0,1,0
57330,53,61035,53,allow,177,94,83,2,30,1,1
64106,445,0,0,drop,66,66,0,1,0,1,0
54234,80,54234,80,allow,2334,1575,759,11,148,6,5
50658,80,54358,80,allow,5018,4314,704,11,30,6,5
17378,44847,0,0,deny,66,66,0,1,0,1,0
55951,30188,0,0,deny,66,66,0,1,0,1,0
64853,53,20952,53,allow,199,102,97,2,31,1,1
64608,53,19709,53,allow,718,94,624,2,30,1,1
52938,64097,0,0,deny,66,66,0,1,0,1,0
46822,443,53756,443,allow,71073,4403,66670,99,116,41,58
64260,53,38791,53,allow,211,78,133,2,30,1,1
65020,53,8823,53,allow,184,94,90,2,31,1,1
51412,53,4036,53,allow,252,78,174,2,30,1,1
49423,445,0,0,drop,70,70,0,1,0,1,0
63775,445,0,0,drop,70,70,0,1,0,1,0
58638,5900,0,0,deny,62,62,0,1,0,1,0
62089,8604,0,0,deny,66,66,0,1,0,1,0
52459,3399,0,0,deny,60,60,0,1,0,1,0
53564,445,0,0,drop,70,70,0,1,0,1,0
56788,53,36118,53,allow,198,101,97,2,30,1,1
61720,445,0,0,drop,66,66,0,1,0,1,0
53767,443,6984,443,allow,499,425,74,4,0,3,1
49576,80,3769,80,allow,318,192,126,6,43,4,2
49942,445,0,0,drop,70,70,0,1,0,1,0
58638,5900,0,0,deny,62,62,0,1,0,1,0
53541,443,39871,443,allow,10583,1889,8694,28,251,10,18
64458,53,4904,53,allow,292,102,190,2,30,1,1
50838,445,0,0,drop,70,70,0,1,0,1,0
57825,13014,0,0,deny,74,74,0,1,0,1,0
57322,53,59513,53,allow,196,102,94,2,30,1,1
55629,53,49009,53,allow,208,94,114,2,30,1,1
52811,44847,0,0,deny,66,66,0,1,0,1,0
55224,53,2332,53,allow,182,94,88,2,30,1,1
55007,53,10621,53,allow,164,84,80,2,31,1,1
64089,53,25036,53,allow,188,96,92,2,31,1,1
51130,61689,0,0,deny,66,66,0,1,0,1,0
57032,445,0,0,drop,70,70,0,1,0,1,0
55072,53,52370,53,allow,168,86,82,2,30,1,1
52903,443,57569,443,allow,253281,6271,247010,276,117,66,210
65377,53,42499,53,allow,186,95,91,2,31,1,1
63002,22114,0,0,deny,66,66,0,1,0,1,0
65027,53,8113,53,allow,758,96,662,2,30,1,1
15998,36829,0,0,deny,62,62,0,1,0,1,0
44949,443,55206,443,allow,190,70,120,4,15,2,2
49418,27015,5163,27015,allow,265,78,187,2,31,1,1
55684,53,54861,53,allow,193,102,91,2,31,1,1
56643,445,0,0,drop,66,66,0,1,0,1,0
58802,443,8176,443,allow,5167,700,4467,16,15,7,9
55830,443,44368,443,allow,62,62,0,1,5,1,0
27005,33052,31448,33052,allow,873,126,747,2,30,1,1
1054,57470,0,0,deny,62,62,0,1,0,1,0
6881,39927,58260,39927,allow,228,118,110,2,1199,1,1
49820,53,34423,53,allow,193,102,91,2,30,1,1
30015,36237,0,0,deny,66,66,0,1,0,1,0
57706,445,0,0,drop,70,70,0,1,0,1,0
45119,443,36541,443,allow,5082,969,4113,18,30,10,8
56437,53,21787,53,allow,731,91,640,2,31,1,1
52532,445,0,0,drop,70,70,0,1,0,1,0
64432,53,45713,53,allow,168,86,82,2,30,1,1
50371,443,40015,443,allow,456,390,66,4,0,3,1
53646,445,0,0,drop,70,70,0,1,0,1,0
46972,443,1778,443,allow,45264,4281,40983,59,120,24,35
54483,445,0,0,drop,70,70,0,1,0,1,0
25031,25174,0,0,deny,62,62,0,1,0,1,0
62433,445,0,0,drop,66,66,0,1,0,1,0
52246,445,0,0,drop,70,70,0,1,0,1,0
54651,445,0,0,drop,66,66,0,1,0,1,0
50612,445,0,0,drop,66,66,0,1,0,1,0
2705,37,0,0,deny,60,60,0,1,0,1,0
58638,5900,0,0,deny,62,62,0,1,0,1,0
55220,53,13554,53,allow,193,102,91,2,30,1,1
57100,53,41347,53,allow,192,90,102,2,31,1,1
49878,443,52783,443,allow,5997,978,5019,19,53,10,9
50581,445,0,0,drop,70,70,0,1,0,1,0
61676,445,0,0,drop,66,66,0,1,0,1,0
50128,445,0,0,drop,70,70,0,1,0,1,0
54830,445,0,0,drop,66,66,0,1,0,1,0
53779,24874,26263,24874,allow,70,70,0,2,8,2,0
65112,445,0,0,drop,70,70,0,1,0,1,0
59997,443,42772,443,allow,1571,660,911,13,18,7,6
38425,443,45581,443,allow,103112,8212,94900,165,55,80,85
57339,443,64003,443,allow,1778020,204978,1573042,2589,987,1006,1583
50228,53,36486,53,allow,173,94,79,2,30,1,1
60951,443,8364,443,allow,11464,5499,5965,54,15,29,25
45964,9666,0,0,deny,60,60,0,1,0,1,0
48817,6881,48817,6881,allow,506,152,354,2,1200,1,1
56522,443,44815,443,allow,43823,7381,36442,84,38,42,42
47962,16069,0,0,deny,62,62,0,1,0,1,0
56673,443,15225,443,allow,7941,1952,5989,20,15,11,9
20894,51505,0,0,deny,62,62,0,1,0,1,0
60434,11339,49665,11339,allow,70,70,0,2,8,2,0
33387,80,58397,80,allow,9105,1930,7175,18,16,9,9
64093,443,64093,443,allow,5663,2416,3247,26,159,14,12
49587,35776,0,0,deny,157,157,0,1,0,1,0
50359,445,0,0,drop,70,70,0,1,0,1,0
57276,445,0,0,drop,70,70,0,1,0,1,0
49407,53,19099,53,allow,209,102,107,2,30,1,1
9087,53,9087,53,allow,178,82,96,2,30,1,1
51106,80,64772,80,allow,14616,6227,8389,32,31,16,16
56670,80,44971,80,allow,234,234,0,4,12,4,0
61819,445,0,0,drop,66,66,0,1,0,1,0
51923,443,5090,443,allow,8964,6357,2607,44,163,23,21
36665,23,0,0,deny,60,60,0,1,0,1,0
59018,22114,0,0,deny,62,62,0,1,0,1,0
443,20995,0,0,deny,83,83,0,1,0,1,0
56582,37965,0,0,deny,66,66,0,1,0,1,0
50656,443,61533,443,allow,3815,1772,2043,18,16,10,8
47873,443,44942,443,allow,12813,5036,7777,40,383,20,20
4366,51505,0,0,deny,62,62,0,1,0,1,0
56186,57470,0,0,deny,62,62,0,1,0,1,0
65262,53,62763,53,allow,216,110,106,2,30,1,1
59290,445,0,0,drop,66,66,0,1,0,1,0
11136,15503,0,0,deny,145,145,0,1,0,1,0
56766,443,55432,443,allow,7888,1899,5989,20,15,11,9
50483,445,0,0,drop,70,70,0,1,0,1,0
37780,443,60477,443,allow,134,60,74,3,5,2,1
27005,27091,19292,27091,allow,883,126,757,2,31,1,1
52265,32078,35097,32078,allow,70,70,0,2,7,2,0
58848,443,16146,443,allow,2109,420,1689,11,121,6,5
49360,53,51221,53,allow,321,102,219,2,30,1,1
49594,22114,0,0,deny,66,66,0,1,0,1,0
64666,445,0,0,drop,70,70,0,1,0,1,0
50463,445,0,0,drop,66,66,0,1,0,1,0
3608,25773,0,0,reset-both,146,146,0,1,0,1,0
40998,80,36819,80,allow,103213,8726,94487,178,38,109,69
56126,53,21706,53,allow,177,94,83,2,30,1,1
52050,445,0,0,drop,70,70,0,1,0,1,0
11826,53,11826,53,allow,237,91,146,2,33,1,1
58326,50584,0,0,deny,62,62,0,1,0,1,0
63574,445,0,0,drop,70,70,0,1,0,1,0
50017,53,24863,53,allow,300,97,203,4,36,2,2
5688,44847,0,0,deny,66,66,0,1,0,1,0
16319,44847,0,0,deny,146,146,0,1,0,1,0
56687,443,11163,443,allow,21086,2515,18571,42,25,21,21
49561,80,28691,80,allow,57215,680,56535,47,135,7,40
62006,445,0,0,drop,66,66,0,1,0,1,0
59444,53,35195,53,allow,489,114,375,2,31,1,1
53898,443,56204,443,allow,499,425,74,4,0,3,1
56927,53,57127,53,allow,183,94,89,2,30,1,1
58386,443,63968,443,allow,15705,3421,12284,53,360,23,30
49164,25174,0,0,deny,62,62,0,1,0,1,0
59336,445,0,0,drop,66,66,0,1,0,1,0
49436,443,51591,443,allow,784271,38715,745556,1017,183,465,552
35242,8635,35242,8635,allow,138,78,60,2,6,1,1
64619,53,39601,53,allow,179,94,85,2,31,1,1
51887,16514,22575,16514,allow,70,70,0,2,8,2,0
49438,443,47897,443,allow,135574,9426,126148,201,183,102,99
49905,53,25136,53,allow,180,94,86,2,30,1,1
49206,53,3418,53,allow,448,184,264,6,30,3,3
65040,53,62726,53,allow,176,90,86,2,31,1,1
61030,53,15331,53,allow,167,78,89,2,30,1,1
52219,445,0,0,drop,66,66,0,1,0,1,0
55703,13836,63794,13836,allow,70,70,0,1,5,1,0
55125,53,57865,53,allow,177,94,83,2,29,1,1
57455,445,0,0,drop,70,70,0,1,0,1,0
53469,44847,0,0,deny,66,66,0,1,0,1,0
50972,3544,40157,3544,allow,409,107,302,4,30,2,2
41267,8245,14045,8245,allow,280,214,66,2,30,1,1
53836,443,61812,443,allow,499,425,74,4,0,3,1
49267,445,0,0,drop,66,66,0,1,0,1,0
57470,49294,38558,49294,allow,132,132,0,3,1199,3,0
60018,64147,0,0,deny,62,62,0,1,0,1,0
43260,41615,0,0,deny,145,145,0,1,0,1,0
60222,22114,0,0,deny,62,62,0,1,0,1,0
52025,80,59666,80,allow,87927,9680,78247,101,37,40,61
25679,27189,0,0,deny,62,62,0,1,0,1,0
15403,51505,0,0,deny,66,66,0,1,0,1,0
41037,80,6510,80,allow,613,539,74,7,15,6,1
60079,445,0,0,drop,70,70,0,1,0,1,0
49343,53,21551,53,allow,209,110,99,2,30,1,1
30782,36237,0,0,deny,146,146,0,1,0,1,0
54370,445,0,0,drop,70,70,0,1,0,1,0
46531,53,8725,53,allow,209,86,123,2,30,1,1
55567,445,0,0,drop,66,66,0,1,0,1,0
443,62451,0,0,deny,60,60,0,1,0,1,0
57582,80,30299,80,allow,370,222,148,6,48,4,2
57283,53,15261,53,allow,185,102,83,2,30,1,1
12465,11392,0,0,deny,146,146,0,1,0,1,0
45964,2225,0,0,deny,60,60,0,1,0,1,0
47668,443,3195,443,allow,69732,65832,3900,104,316,55,49
21903,443,21903,443,allow,29203,1859,27344,37,18,14,23
55605,53,47383,53,allow,772,103,669,2,31,1,1
50298,80,48126,80,allow,166956,16834,150122,187,161,72,115
53398,445,0,0,drop,70,70,0,1,0,1,0
5223,7851,0,0,deny,66,66,0,1,0,1,0
54016,42707,0,0,deny,62,62,0,1,0,1,0
27005,27016,8684,27016,allow,898,126,772,2,31,1,1
26921,37965,0,0,deny,62,62,0,1,0,1,0
63139,12311,39911,12311,allow,70,70,0,1,5,1,0
49240,8080,49240,8080,allow,22799,6835,15964,35,56,20,15
35047,53,53594,53,allow,70657,70002,655,845,88,839,6
50964,80,13485,80,allow,4680740,67312,4613428,4675,77,985,3690
57114,445,0,0,drop,70,70,0,1,0,1,0
61766,44847,0,0,deny,66,66,0,1,0,1,0
56081,445,0,0,drop,70,70,0,1,0,1,0
58638,5900,0,0,deny,62,62,0,1,0,1,0
64256,53,36499,53,allow,211,78,133,2,29,1,1
55171,53,4183,53,allow,79,79,0,2,34,2,0
52386,445,0,0,drop,70,70,0,1,0,1,0
57556,443,34647,443,allow,7087,2587,4500,21,30,12,9
56424,53,11596,53,allow,170,87,83,2,31,1,1
60376,445,0,0,drop,70,70,0,1,0,1,0
50052,65008,0,0,deny,60,60,0,1,0,1,0
52332,445,0,0,drop,70,70,0,1,0,1,0
36776,80,31947,80,allow,16274,9170,7104,34,32,19,15
57470,41071,64833,41071,allow,1716,1716,0,27,1598,27,0
58734,443,48413,443,allow,1413,876,537,12,26,6,6
54981,445,0,0,drop,70,70,0,1,0,1,0
49166,445,0,0,drop,70,70,0,1,0,1,0
1024,25174,0,0,deny,146,146,0,1,0,1,0
55222,53,63142,53,allow,181,94,87,2,29,1,1
57020,445,0,0,drop,70,70,0,1,0,1,0
59772,62413,0,0,deny,66,66,0,1,0,1,0
52007,37732,15176,37732,allow,70,70,0,2,8,2,0
55008,443,6262,443,allow,7679,2605,5074,26,45,15,11
64737,53,9334,53,allow,269,110,159,2,30,1,1
54389,28543,0,0,deny,66,66,0,1,0,1,0
64995,53,32873,53,allow,210,110,100,2,31,1,1
55877,27906,5770,27906,allow,480,149,331,2,1200,1,1
50626,43890,0,0,deny,62,62,0,1,0,1,0
2083,25174,0,0,deny,62,62,0,1,0,1,0
3090,1,0,0,deny,66,66,0,1,0,1,0
60405,443,60867,443,allow,6570,1988,4582,19,57,10,9
36357,25174,0,0,deny,66,66,0,1,0,1,0
54880,445,0,0,drop,70,70,0,1,0,1,0
56500,53,34519,53,allow,198,101,97,2,31,1,1
44414,23718,0,0,deny,62,62,0,1,0,1,0
38660,443,61188,443,allow,7031,1824,5207,23,60,12,11
54549,445,0,0,drop,66,66,0,1,0,1,0
53844,16925,27697,16925,allow,940,502,438,14,18,7,7
60620,80,60620,80,allow,1916,1467,449,10,19,6,4
53771,443,40823,443,allow,499,425,74,4,0,3,1
51918,80,52022,80,allow,426,240,186,8,29,5,3
63545,445,0,0,drop,70,70,0,1,0,1,0
49418,27015,51226,27015,allow,274,78,196,2,30,1,1
40312,55442,0,0,deny,62,62,0,1,0,1,0
57685,53,47518,53,allow,275,86,189,2,30,1,1
62746,445,0,0,drop,70,70,0,1,0,1,0
49156,53,49438,53,allow,195,102,93,2,30,1,1
55444,53,54146,53,allow,193,102,91,2,30,1,1
55999,443,53262,443,allow,45632,2078,43554,58,120,22,36
47657,443,24927,443,allow,502,140,362,8,140,3,5
27005,27015,18205,27015,allow,888,126,762,3,32,2,1
53521,443,39860,443,allow,710,350,360,12,33,6,6
55100,53,57209,53,allow,711,87,624,2,30,1,1
56935,80,54520,80,allow,1482,878,604,10,75,6,4
65461,443,11386,443,allow,396698,11870,384828,409,16,144,265
53828,2323,0,0,deny,60,60,0,1,0,1,0
37997,80,37997,80,allow,3581,2902,679,13,23,8,5
49497,443,3660,443,allow,8816,4876,3940,23,31,12,11
60191,445,0,0,drop,70,70,0,1,0,1,0
56172,53,35826,53,allow,253,87,166,4,30,2,2
34616,53,34616,53,allow,197,90,107,2,30,1,1
6881,64422,29110,64422,allow,219,111,108,2,1201,1,1
30598,37965,0,0,deny,62,62,0,1,0,1,0
8486,56205,0,0,deny,62,62,0,1,0,1,0
55520,53,61056,53,allow,194,102,92,2,29,1,1
55770,53,35170,53,allow,166,85,81,2,30,1,1
57539,44847,0,0,deny,62,62,0,1,0,1,0
60483,57723,53854,57723,allow,320,140,180,6,6,3,3
56642,443,62625,443,allow,7890,1901,5989,20,15,11,9
9137,80,35596,80,allow,908,842,66,7,18,6,1
61711,35440,0,0,deny,66,66,0,1,0,1,0
60555,445,0,0,drop,70,70,0,1,0,1,0
59366,35440,0,0,deny,66,66,0,1,0,1,0
64426,53,6048,53,allow,289,101,188,4,50,2,2
65144,53,10538,53,allow,210,110,100,2,30,1,1
55225,11392,0,0,deny,66,66,0,1,0,1,0
50377,53,58981,53,allow,214,110,104,2,30,1,1
58278,443,36015,443,allow,3581,1045,2536,10,122,5,5
49418,27013,52057,27013,allow,230,71,159,2,31,1,1
50584,80,50584,80,allow,6706,4950,1756,23,20,13,10
59617,443,31345,443,allow,5682,1565,4117,23,66,13,10
63928,61494,31292,61494,allow,1691,446,1245,10,15,7,3
64677,53,61310,53,allow,183,94,89,2,31,1,1
59982,443,1995,443,allow,1467,880,587,13,21,7,6
50866,443,31244,443,allow,9517,1897,7620,21,130,11,10
59965,36237,0,0,deny,66,66,0,1,0,1,0
49952,445,0,0,drop,66,66,0,1,0,1,0
30046,15503,0,0,deny,62,62,0,1,0,1,0
56693,443,44446,443,allow,3886,2545,1341,18,18,10,8
0,0,0,0,allow,320,320,0,5,0,5,0
49501,53,63385,53,allow,193,102,91,2,31,1,1
55069,53,8912,53,allow,190,97,93,2,31,1,1
50291,443,61794,443,allow,11617,4358,7259,48,86,26,22
56594,53,50396,53,allow,165,86,79,2,29,1,1
43840,50265,0,0,deny,72,72,0,1,0,1,0
50018,53,44491,53,allow,270,102,168,2,30,1,1
61597,445,0,0,drop,66,66,0,1,0,1,0
53721,62413,0,0,deny,62,62,0,1,0,1,0
59843,443,50473,443,allow,1427,726,701,17,46,8,9
49708,443,3133,443,allow,7772,2563,5209,18,121,9,9
54611,445,0,0,drop,70,70,0,1,0,1,0
56668,53,54886,53,allow,177,94,83,2,29,1,1
49216,445,0,0,drop,66,66,0,1,0,1,0
11754,25174,0,0,deny,62,62,0,1,0,1,0
37646,53,37646,53,allow,832,106,726,2,30,1,1
51372,445,0,0,drop,70,70,0,1,0,1,0
56669,443,3032,443,allow,7458,4186,3272,24,102,14,10
61984,445,0,0,drop,70,70,0,1,0,1,0
49495,53,39798,53,allow,758,102,656,2,31,1,1
62707,445,0,0,drop,70,70,0,1,0,1,0
60194,443,58489,443,allow,8894,1633,7261,18,16,9,9
54994,53,46934,53,allow,747,90,657,2,30,1,1
64912,53,63953,53,allow,356,118,238,2,30,1,1
43129,15503,0,0,deny,62,62,0,1,0,1,0
50609,2323,0,0,deny,60,60,0,1,0,1,0
55848,53,3289,53,allow,387,134,253,2,30,1,1
60222,22114,0,0,deny,66,66,0,1,0,1,0
60084,445,0,0,drop,70,70,0,1,0,1,0
38169,443,2048,443,allow,7841,2301,5540,18,135,8,10
56232,443,31381,443,allow,9920,3980,5940,24,40,12,12
48553,443,14731,443,allow,49428,2702,46726,70,136,30,40
65201,445,0,0,drop,70,70,0,1,0,1,0
47561,26467,0,0,deny,62,62,0,1,0,1,0
60719,443,32077,443,allow,71523,19991,51532,112,41,59,53
55246,445,0,0,drop,70,70,0,1,0,1,0
50653,445,0,0,drop,66,66,0,1,0,1,0
58638,5900,0,0,deny,62,62,0,1,0,1,0
59528,445,0,0,drop,66,66,0,1,0,1,0
56695,53,2838,53,allow,183,94,89,2,30,1,1
49513,445,0,0,drop,66,66,0,1,0,1,0
65512,53,60205,53,allow,744,95,649,2,31,1,1
59035,445,0,0,drop,66,66,0,1,0,1,0
55815,445,0,0,drop,70,70,0,1,0,1,0
65455,3389,65455,3389,allow,4350,2261,2089,21,17,11,10
64534,53,43156,53,allow,212,108,104,2,31,1,1
53640,25174,0,0,deny,62,62,0,1,0,1,0
123,123,44210,123,allow,184,94,90,2,30,1,1
0,0,0,0,deny,156,156,0,2,0,2,0
43206,443,34471,443,allow,4550611,95139,4455472,4046,217,935,3111
57302,53,18711,53,allow,770,102,668,2,31,1,1
49160,31652,0,0,reset-both,146,146,0,1,0,1,0
53949,42301,56593,42301,allow,1396,719,677,15,15,8,7
28878,51505,0,0,deny,62,62,0,1,0,1,0
62362,445,0,0,drop,66,66,0,1,0,1,0
50559,53,61943,53,allow,216,110,106,2,30,1,1
2697,28189,0,0,deny,60,60,0,1,0,1,0
27005,30000,59167,30000,allow,913,126,787,2,30,1,1
50093,445,0,0,drop,70,70,0,1,0,1,0
61238,445,0,0,drop,66,66,0,1,0,1,0
64573,53,39960,53,allow,184,94,90,2,30,1,1
58638,5900,0,0,deny,62,62,0,1,0,1,0
60590,443,17721,443,allow,41114,1554,39560,49,120,18,31
2791,7302,0,0,deny,62,62,0,1,0,1,0
49918,53,41805,53,allow,198,102,96,2,30,1,1
49228,53,52033,53,allow,209,110,99,2,30,1,1
43228,443,18463,443,allow,1527,940,587,14,22,8,6
49888,443,29885,443,allow,117085,3435,113650,123,87,43,80
51644,80,3834,80,allow,499,192,307,6,38,4,2
55854,443,29147,443,allow,3387,1672,1715,24,270,11,13
17840,53,17840,53,allow,414,268,146,3,32,2,1
52119,49239,52121,49239,allow,160,70,90,2,5,1,1
49182,53,44371,53,allow,211,102,109,2,30,1,1
51203,443,62126,443,allow,5737,1829,3908,22,18,13,9
63232,443,26677,443,allow,4496,2346,2150,28,124,15,13
55451,56205,0,0,deny,66,66,0,1,0,1,0
57372,53,20962,53,allow,177,94,83,2,30,1,1
59396,445,0,0,drop,70,70,0,1,0,1,0
64093,64828,53558,64828,allow,70,70,0,1,4,1,0
49546,443,3244,443,allow,5519,945,4574,15,23,8,7
39771,443,64614,443,allow,6903,1273,5630,25,255,13,12
51517,443,20075,443,allow,590874,19818,571056,669,42,271,398
60380,445,0,0,drop,66,66,0,1,0,1,0
57880,53,57880,53,allow,231,97,134,2,30,1,1
49352,53,51513,53,allow,216,102,114,2,29,1,1
19267,5555,0,0,deny,60,60,0,1,0,1,0
59375,445,0,0,drop,70,70,0,1,0,1,0
56304,53,49255,53,allow,184,94,90,2,30,1,1
12632,25174,0,0,deny,146,146,0,1,0,1,0
48729,443,23852,443,allow,8504354,221135,8283219,8447,196,2721,5726
56511,445,0,0,drop,70,70,0,1,0,1,0
43666,443,10694,443,allow,13212,9431,3781,41,238,21,20
49621,53,49621,53,allow,231,90,141,2,31,1,1
56948,53,22387,53,allow,183,94,89,2,30,1,1
56541,53,2371,53,allow,294,142,152,2,30,1,1
49578,53,60840,53,allow,212,102,110,2,29,1,1
60419,445,0,0,drop,70,70,0,1,0,1,0
53720,443,24279,443,allow,499,425,74,4,0,3,1
58994,443,24369,443,allow,204,70,134,4,25,2,2
49631,53,31277,53,allow,196,100,96,2,31,1,1
53074,445,0,0,drop,70,70,0,1,0,1,0
33027,161,0,0,allow,15505,6180,9325,50,30,25,25
58131,15503,0,0,deny,146,146,0,1,0,1,0
59786,25174,0,0,deny,66,66,0,1,0,1,0
58923,445,0,0,drop,70,70,0,1,0,1,0
7905,48817,0,0,deny,146,146,0,1,0,1,0
61057,25174,0,0,deny,62,62,0,1,0,1,0
51574,443,25990,443,allow,3021,960,2061,14,135,7,7
52020,28704,61808,28704,allow,70,70,0,1,5,1,0
10348,25604,0,0,deny,66,66,0,1,0,1,0
58504,445,0,0,drop,70,70,0,1,0,1,0
51902,445,0,0,drop,70,70,0,1,0,1,0
52020,445,0,0,drop,70,70,0,1,0,1,0
49372,53,4796,53,allow,527,208,319,6,64,3,3
52187,445,0,0,drop,70,70,0,1,0,1,0
62167,445,0,0,drop,66,66,0,1,0,1,0
46906,25604,0,0,deny,100,100,0,1,0,1,0
60222,443,18964,443,allow,4308,1658,2650,14,16,7,7
52682,22114,0,0,deny,66,66,0,1,0,1,0
55097,53,3886,53,allow,324,102,222,4,42,2,2
57173,53,19613,53,allow,216,110,106,2,31,1,1
49844,53,30878,53,allow,755,102,653,2,30,1,1
50135,445,0,0,drop,66,66,0,1,0,1,0
58658,53,27150,53,allow,260,86,174,2,30,1,1
42971,3478,56626,3478,allow,452,280,172,5,30,3,2
52649,443,45569,443,allow,6292,1492,4800,22,17,11,11
56632,80,25180,80,allow,234,234,0,4,12,4,0
65347,445,0,0,drop,70,70,0,1,0,1,0
26053,33720,0,0,deny,160,160,0,1,0,1,0
56928,53,51278,53,allow,178,94,84,2,30,1,1
43611,61903,0,0,deny,148,148,0,1,0,1,0
55478,445,0,0,drop,66,66,0,1,0,1,0
57793,37807,0,0,deny,66,66,0,1,0,1,0
57470,47099,22688,47099,allow,330,330,0,6,1199,6,0
53779,51505,0,0,deny,66,66,0,1,0,1,0
62215,445,0,0,drop,66,66,0,1,0,1,0
5588,5588,0,0,allow,3562,1936,1626,48,193,24,24
56102,443,1329,443,allow,8577,3450,5127,23,30,13,10
64407,53,28727,53,allow,291,94,197,2,30,1,1
55028,443,57444,443,allow,7196,2834,4362,28,17,16,12
61337,445,0,0,drop,66,66,0,1,0,1,0
34811,56205,0,0,deny,66,66,0,1,0,1,0
59078,445,0,0,drop,66,66,0,1,0,1,0
50368,53,63672,53,allow,763,102,661,2,30,1,1
52270,443,52270,443,allow,1615,941,674,15,20,7,8
61555,445,0,0,drop,70,70,0,1,0,1,0
55617,53,46139,53,allow,214,110,104,2,30,1,1
62152,56205,0,0,deny,66,66,0,1,0,1,0
53714,443,14989,443,allow,9842,4572,5270,22,76,12,10
57043,53,58233,53,allow,166,86,80,2,30,1,1
55838,445,0,0,drop,70,70,0,1,0,1,0
37568,443,2020,443,allow,499,425,74,4,0,3,1
9120,80,19755,80,allow,326320,11951,314369,346,36,122,224
61369,64147,0,0,deny,66,66,0,1,0,1,0
56552,53,34046,53,allow,195,102,93,2,30,1,1
65530,53,49295,53,allow,381,88,293,4,31,2,2
55404,443,57333,443,allow,2352,1394,958,17,275,9,8
58638,5900,0,0,deny,62,62,0,1,0,1,0
34737,443,45602,443,allow,5586,1338,4248,17,109,9,8
9277,443,3010,443,allow,4230,760,3470,14,27,8,6
1027,65473,0,0,deny,159,159,0,1,0,1,0
65237,53,38520,53,allow,733,86,647,2,30,1,1
59889,445,0,0,drop,66,66,0,1,0,1,0
57768,37965,0,0,deny,66,66,0,1,0,1,0
18655,44847,0,0,deny,66,66,0,1,0,1,0
62743,445,0,0,drop,70,70,0,1,0,1,0
61945,48817,0,0,deny,66,66,0,1,0,1,0
57879,80,31290,80,allow,318,192,126,6,27,4,2
51912,45007,7239,45007,allow,1345,679,666,9,30,5,4
49993,53,48809,53,allow,212,102,110,2,30,1,1
55167,445,0,0,drop,70,70,0,1,0,1,0
61400,64147,0,0,deny,66,66,0,1,0,1,0
10166,80,10166,80,allow,450,246,204,8,24,5,3
50280,57470,0,0,deny,78,78,0,1,0,1,0
22345,80,22345,80,allow,490,264,226,8,30,5,3
63032,22114,0,0,deny,66,66,0,1,0,1,0
50621,443,42155,443,allow,3171,1473,1698,15,93,9,6
443,14591,0,0,deny,85,85,0,1,0,1,0
56550,53,60039,53,allow,182,93,89,2,31,1,1
50186,443,39007,443,allow,6440,1603,4837,23,361,11,12
35347,20238,0,0,deny,62,62,0,1,0,1,0
60990,443,42071,443,allow,212824,12881,199943,244,49,101,143
35343,80,43757,80,allow,953,538,415,11,318,6,5
11136,57587,0,0,deny,62,62,0,1,0,1,0
60262,443,35496,443,allow,6627,1780,4847,23,149,13,10
27005,27016,18981,27016,allow,884,126,758,2,30,1,1
51021,445,0,0,drop,66,66,0,1,0,1,0
65317,51221,0,0,deny,78,78,0,1,0,1,0
23843,26467,0,0,deny,62,62,0,1,0,1,0
56127,37965,0,0,deny,66,66,0,1,0,1,0
62148,37965,0,0,deny,62,62,0,1,0,1,0
64538,53,28152,53,allow,188,96,92,2,31,1,1
30765,56205,0,0,deny,66,66,0,1,0,1,0
60059,445,0,0,drop,66,66,0,1,0,1,0
37027,53,20580,53,allow,168,78,90,2,30,1,1
65127,53,38412,53,allow,194,102,92,2,30,1,1
65233,23117,0,0,deny,66,66,0,1,0,1,0
64519,53,52190,53,allow,184,94,90,2,30,1,1
51499,445,0,0,drop,70,70,0,1,0,1,0
50362,53,31941,53,allow,181,98,83,2,31,1,1
27005,27015,22346,27015,allow,869,126,743,2,30,1,1
63578,35440,0,0,deny,66,66,0,1,0,1,0
39758,53,26339,53,allow,86,86,0,1,30,1,0
56386,50584,0,0,deny,66,66,0,1,0,1,0
63136,42873,0,0,deny,66,66,0,1,0,1,0
56825,445,0,0,drop,70,70,0,1,0,1,0
9308,443,57827,443,allow,3837,488,3349,15,15,7,8
51437,80,35977,80,allow,1703,538,1165,8,177,5,3
49988,443,49988,443,allow,1466,696,770,20,120,10,10
64094,445,0,0,drop,70,70,0,1,0,1,0
9092,26672,0,0,deny,60,60,0,1,0,1,0
49881,445,0,0,drop,70,70,0,1,0,1,0
63358,445,0,0,drop,70,70,0,1,0,1,0
16057,56205,0,0,deny,66,66,0,1,0,1,0
50068,53,50068,53,allow,240,96,144,2,30,1,1
56376,53,65133,53,allow,198,102,96,2,30,1,1
30188,14991,3855,14991,allow,501,150,351,2,1200,1,1
62725,445,0,0,drop,70,70,0,1,0,1,0
56568,5228,36431,5228,allow,2387,1435,952,16,3600,8,8
57943,445,0,0,drop,70,70,0,1,0,1,0
55706,445,0,0,drop,66,66,0,1,0,1,0
12226,37965,0,0,deny,62,62,0,1,0,1,0
57281,445,0,0,drop,66,66,0,1,0,1,0
47357,443,6177,443,allow,153,93,60,2,5,1,1
49848,53,31476,53,allow,167,86,81,2,30,1,1
60052,37965,0,0,deny,66,66,0,1,0,1,0
59099,445,0,0,drop,66,66,0,1,0,1,0
56800,1,6191,1,allow,70,70,0,2,8,2,0
43578,15503,0,0,deny,74,74,0,1,0,1,0
57470,53250,48963,53250,allow,491,150,341,2,1199,1,1
64102,445,0,0,drop,66,66,0,1,0,1,0
50273,53,27219,53,allow,718,94,624,2,30,1,1
58638,5900,0,0,deny,62,62,0,1,0,1,0
17453,35440,0,0,deny,66,66,0,1,0,1,0
60649,445,0,0,drop,66,66,0,1,0,1,0
60502,61473,62296,61473,allow,1628,1037,591,14,16,8,6
6666,2222,0,0,deny,60,60,0,1,0,1,0
45019,443,10530,443,allow,33865,6559,27306,67,67,34,33
62759,445,0,0,drop,70,70,0,1,0,1,0
58971,445,0,0,drop,66,66,0,1,0,1,0
52120,443,51831,443,allow,305183,9715,295468,312,44,107,205
50360,37965,0,0,deny,62,62,0,1,0,1,0
51740,37965,0,0,deny,66,66,0,1,0,1,0
41350,80,41350,80,allow,1914,1465,449,10,19,6,4
55343,445,0,0,drop,66,66,0,1,0,1,0
57231,53,16422,53,allow,168,86,82,2,31,1,1
50884,443,50884,443,allow,187790,7733,180057,229,128,90,139
49699,53,17835,53,allow,266,89,177,4,58,2,2
51890,31122,11914,31122,allow,70,70,0,1,5,1,0
58780,443,38511,443,allow,5971,706,5265,17,15,7,10
47123,443,37885,443,allow,1053,566,487,10,43,6,4
51309,445,0,0,drop,66,66,0,1,0,1,0
56439,53,22467,53,allow,751,95,656,2,30,1,1
58828,53,32002,53,allow,215,102,113,2,30,1,1
56676,53,50057,53,allow,178,94,84,2,30,1,1
7978,50584,0,0,deny,66,66,0,1,0,1,0
61620,445,0,0,drop,70,70,0,1,0,1,0
60335,7010,60335,7010,allow,6127,4018,2109,19,17,11,8
51592,51505,0,0,deny,66,66,0,1,0,1,0
50804,1,0,0,deny,62,62,0,1,0,1,0
53289,445,0,0,drop,70,70,0,1,0,1,0
57476,445,0,0,drop,70,70,0,1,0,1,0
45995,443,45995,443,allow,1494,898,596,12,142,6,6
63266,445,0,0,drop,70,70,0,1,0,1,0
51889,44348,37588,44348,allow,70,70,0,1,5,1,0
55108,445,0,0,drop,70,70,0,1,0,1,0
55937,53,13424,53,allow,177,94,83,2,30,1,1
60403,443,3192,443,allow,5567,1589,3978,20,80,11,9
56745,53,50042,53,allow,900,110,790,2,30,1,1
64423,445,0,0,drop,66,66,0,1,0,1,0
53683,443,41886,443,allow,9880,1687,8193,23,15,12,11
37645,443,51983,443,allow,23266,18300,4966,56,27,33,23
63806,443,63806,443,allow,4651,1744,2907,19,30,11,8
4793,50584,0,0,deny,66,66,0,1,0,1,0
60416,37965,0,0,deny,66,66,0,1,0,1,0
53720,443,39047,443,allow,11338,7078,4260,19,16,12,7
63846,80,10554,80,allow,314,192,122,6,15,4,2
58249,443,38085,443,allow,4192,2267,1925,12,120,6,6
34028,443,47575,443,allow,7804,1583,6221,26,981,13,13
51325,445,0,0,drop,66,66,0,1,0,1,0
55786,53,33325,53,allow,177,94,83,2,30,1,1
56655,53,54773,53,allow,86,86,0,1,29,1,0
62359,445,0,0,drop,70,70,0,1,0,1,0
50023,445,0,0,drop,66,66,0,1,0,1,0
55076,53,44619,53,allow,760,97,663,2,30,1,1
56312,53,52964,53,allow,195,102,93,2,31,1,1
58638,5900,0,0,deny,62,62,0,1,0,1,0
45427,80,37690,80,allow,350,210,140,6,28,4,2
55199,443,3846,443,allow,18132,8636,9496,40,176,23,17
11136,19910,0,0,deny,62,62,0,1,0,1,0
53811,443,28685,443,allow,499,425,74,4,0,3,1
57325,37965,0,0,deny,62,62,0,1,0,1,0
8889,52294,0,0,deny,60,60,0,1,0,1,0
50584,6881,18955,6881,allow,502,150,352,2,1200,1,1
56464,53,12940,53,allow,170,87,83,2,31,1,1
49929,53,53934,53,allow,214,110,104,2,30,1,1
64824,36829,0,0,deny,66,66,0,1,0,1,0
33556,25174,0,0,deny,146,146,0,1,0,1,0
46216,443,9972,443,allow,161,101,60,2,5,1,1
49843,53,13877,53,allow,193,102,91,2,30,1,1
26884,37965,0,0,deny,66,66,0,1,0,1,0
40731,2323,0,0,deny,60,60,0,1,0,1,0
49433,53,51324,53,allow,278,94,184,2,30,1,1
63390,445,0,0,drop,70,70,0,1,0,1,0
51806,49530,21191,49530,allow,70,70,0,2,8,2,0
51192,15503,0,0,deny,66,66,0,1,0,1,0
52100,443,47301,443,allow,298527,11814,286713,310,37,107,203
61419,443,15902,443,allow,6661,862,5799,18,28,9,9
62075,445,0,0,drop,70,70,0,1,0,1,0
52856,443,43323,443,allow,5495,1303,4192,17,15,9,8
35377,443,51737,443,allow,15771,2037,13734,39,187,20,19
38001,49152,63633,49152,allow,156,156,0,3,8,3,0
46349,51505,0,0,deny,74,74,0,1,0,1,0
55155,53,2864,53,allow,183,94,89,2,29,1,1
59922,445,0,0,drop,66,66,0,1,0,1,0
53255,445,0,0,drop,70,70,0,1,0,1,0
6817,23,0,0,deny,60,60,0,1,0,1,0
57734,445,0,0,drop,70,70,0,1,0,1,0
64279,23718,0,0,deny,62,62,0,1,0,1,0
50367,443,43632,443,allow,1630,916,714,12,25,7,5
48018,443,52238,443,allow,1429,1295,134,10,29,8,2
65115,50584,0,0,deny,66,66,0,1,0,1,0
60687,445,0,0,drop,70,70,0,1,0,1,0
64987,53,57288,53,allow,196,102,94,2,31,1,1
42289,443,63031,443,allow,6827,1776,5051,26,121,13,13
49949,443,7206,443,allow,4712,908,3804,18,89,9,9
56479,443,37707,443,allow,3041,1995,1046,17,16,8,9
53097,25174,0,0,deny,62,62,0,1,0,1,0
65410,53,23769,53,allow,216,94,122,2,30,1,1
37008,42707,0,0,deny,62,62,0,1,0,1,0
42389,42873,0,0,deny,74,74,0,1,0,1,0
52007,445,0,0,drop,66,66,0,1,0,1,0
55556,53,8408,53,allow,183,94,89,2,30,1,1
63108,443,56013,443,allow,4609,2177,2432,11,120,6,5
49570,443,15727,443,allow,8058,1806,6252,22,15,12,10
61193,445,0,0,drop,66,66,0,1,0,1,0
57604,445,0,0,drop,70,70,0,1,0,1,0
1027,44847,0,0,deny,62,62,0,1,0,1,0
38101,443,19198,443,allow,350,210,140,6,15,4,2
44822,40108,0,0,deny,145,145,0,1,0,1,0
65261,53,11148,53,allow,313,97,216,4,56,2,2
64710,53,45310,53,allow,195,102,93,2,31,1,1
57700,445,0,0,drop,70,70,0,1,0,1,0
40512,57470,0,0,deny,74,74,0,1,0,1,0
51789,80,62386,80,allow,28433,1668,26765,39,20,18,21
6980,25604,0,0,deny,100,100,0,1,0,1,0
34471,53,34471,53,allow,253,99,154,2,32,1,1
63214,445,0,0,drop,70,70,0,1,0,1,0
64824,36829,0,0,deny,62,62,0,1,0,1,0
16518,64147,0,0,deny,145,145,0,1,0,1,0
56112,53,18781,53,allow,199,102,97,2,30,1,1
64484,53,32900,53,allow,732,239,493,6,51,3,3
53774,51505,0,0,deny,62,62,0,1,0,1,0
51503,445,0,0,drop,70,70,0,1,0,1,0
65275,53,12888,53,allow,370,126,244,2,30,1,1
26852,443,37860,443,allow,6701,2064,4637,19,19,9,10
11295,40018,13039,40018,allow,156,94,62,2,30,1,1
59175,53,63239,53,allow,168,78,90,2,30,1,1
40204,40010,8959,40010,allow,148,86,62,2,29,1,1
53899,443,57181,443,allow,499,425,74,4,0,3,1
60476,55100,33461,55100,allow,70,70,0,1,5,1,0
55082,25174,0,0,deny,62,62,0,1,0,1,0
55921,53,32858,53,allow,177,94,83,2,30,1,1
59786,445,0,0,drop,66,66,0,1,0,1,0
62579,57866,0,0,deny,66,66,0,1,0,1,0
52690,7302,0,0,deny,66,66,0,1,0,1,0
64882,53,62094,53,allow,343,134,209,2,30,1,1
49482,53,59102,53,allow,196,94,102,2,30,1,1
56442,11392,0,0,deny,62,62,0,1,0,1,0
56792,42155,44462,42155,allow,70,70,0,1,5,1,0
58638,5900,0,0,deny,62,62,0,1,0,1,0
55229,53,33453,53,allow,173,94,79,2,30,1,1
49916,443,14101,443,allow,2970,1793,1177,20,15,12,8
59403,445,0,0,drop,70,70,0,1,0,1,0
5222,21212,0,0,deny,66,66,0,1,0,1,0
54620,445,0,0,deny,70,70,0,1,0,1,0
21173,37965,0,0,deny,62,62,0,1,0,1,0
50869,80,23647,80,allow,28291,3346,24945,46,144,25,21
20112,64147,0,0,deny,62,62,0,1,0,1,0
47819,443,19809,443,allow,6258,956,5302,20,16,11,9
63027,443,10834,443,allow,384,166,218,2,30,1,1
48706,23393,0,0,deny,60,60,0,1,0,1,0
62035,445,0,0,drop,70,70,0,1,0,1,0
49629,53,36000,53,allow,196,100,96,2,31,1,1
55050,445,0,0,drop,70,70,0,1,0,1,0
7664,2149,0,0,deny,66,66,0,1,0,1,0
51706,30673,17118,30673,allow,70,70,0,1,5,1,0
50194,443,13497,443,allow,50338,5239,45099,54,165,19,35
57978,5228,59102,5228,allow,2725,1610,1115,20,3600,10,10
55791,445,0,0,drop,66,66,0,1,0,1,0
51651,80,41220,80,allow,8100,4781,3319,23,166,12,11
24292,48817,0,0,deny,148,148,0,1,0,1,0
49361,53,45475,53,allow,184,94,90,2,31,1,1
36008,443,16915,443,allow,5378,1423,3955,19,56,11,8
61758,445,0,0,drop,70,70,0,1,0,1,0
62645,445,0,0,drop,70,70,0,1,0,1,0
37420,44847,0,0,deny,62,62,0,1,0,1,0
56239,53,30874,53,allow,180,94,86,2,31,1,1
51922,44847,0,0,deny,66,66,0,1,0,1,0
37134,53,0,0,allow,82,82,0,1,30,1,0
49413,443,7382,443,allow,44505,6962,37543,64,48,21,43
49701,53,24977,53,allow,197,102,95,2,30,1,1
50015,53,57649,53,allow,287,94,193,2,29,1,1
55877,12187,8942,12187,allow,150,150,0,1,1200,1,0
42317,443,11761,443,allow,416,210,206,7,27,4,3
13281,51050,0,0,deny,66,66,0,1,0,1,0
57044,53,13631,53,allow,177,94,83,2,29,1,1
64226,53,54672,53,allow,245,94,151,2,30,1,1
60913,445,0,0,drop,70,70,0,1,0,1,0
55126,53,61612,53,allow,193,102,91,2,29,1,1
65142,53,52457,53,allow,167,86,81,2,30,1,1
47105,64147,0,0,deny,62,62,0,1,0,1,0
64676,445,0,0,drop,70,70,0,1,0,1,0
51951,80,24462,80,allow,1265,642,623,12,45,7,5
16948,990,0,0,deny,60,60,0,1,0,1,0
50792,443,51398,443,allow,144115,19017,125098,229,400,112,117
65518,445,0,0,drop,66,66,0,1,0,1,0
55736,445,0,0,drop,70,70,0,1,0,1,0
64403,53,9122,53,allow,199,102,97,2,31,1,1
65189,27207,3306,27207,allow,230,78,152,2,30,1,1
17676,23,0,0,deny,60,60,0,1,0,1,0
64887,53,53065,53,allow,209,110,99,2,30,1,1
61771,445,0,0,drop,70,70,0,1,0,1,0
64976,53,22301,53,allow,186,95,91,2,31,1,1
57386,53,39494,53,allow,193,102,91,2,30,1,1
60022,443,54871,443,allow,4962,2551,2411,19,144,10,9
53022,25174,0,0,deny,62,62,0,1,0,1,0
61351,445,0,0,drop,70,70,0,1,0,1,0
5,47993,0,0,deny,62,62,0,1,0,1,0
59088,445,0,0,drop,66,66,0,1,0,1,0
55990,53,40258,53,allow,182,93,89,2,30,1,1
55106,53,36714,53,allow,314,94,220,4,33,2,2
64190,2767,0,0,deny,62,62,0,1,0,1,0
51606,443,32165,443,allow,9979,4380,5599,26,256,12,14
58910,445,0,0,drop,70,70,0,1,0,1,0
52151,80,38473,80,allow,546,300,246,10,32,6,4
53799,445,0,0,drop,70,70,0,1,0,1,0
55950,443,51183,443,allow,6490,1789,4701,30,95,16,14
51164,443,40341,443,allow,7569,2113,5456,26,361,14,12
40074,443,9837,443,allow,412322,17503,394819,466,140,167,299
56209,445,0,0,drop,70,70,0,1,0,1,0
26420,25174,0,0,deny,66,66,0,1,0,1,0
53769,8999,35608,8999,allow,70,70,0,2,8,2,0
50728,27029,42888,27029,allow,269,78,191,2,31,1,1
49328,443,21805,443,allow,74569,3173,71396,97,80,36,61
50434,80,31890,80,allow,318,192,126,6,26,4,2
64714,53,41976,53,allow,212,102,110,2,30,1,1
53654,8100,3351,8100,allow,70,70,0,2,8,2,0
60192,35440,0,0,deny,62,62,0,1,0,1,0
50401,443,36442,443,allow,1124,594,530,12,26,6,6
51457,443,1251,443,allow,334,70,264,5,17,1,4
56912,53,8353,53,allow,199,102,97,2,30,1,1
56079,53,14640,53,allow,199,102,97,2,31,1,1
57874,26467,0,0,deny,62,62,0,1,0,1,0
55107,53,13262,53,allow,184,94,90,2,30,1,1
17702,6881,0,0,deny,62,62,0,1,0,1,0
36099,443,40194,443,allow,48494,10293,38201,71,129,26,45
35810,443,44672,443,allow,13706,3115,10591,40,201,22,18
55742,53,41755,53,allow,186,95,91,2,31,1,1
56501,53,9977,53,allow,216,94,122,2,31,1,1
443,44683,0,0,deny,83,83,0,1,0,1,0
23753,25174,0,0,deny,62,62,0,1,0,1,0
60428,25174,0,0,deny,66,66,0,1,0,1,0
27005,27015,49049,27015,allow,1610,126,1484,4,30,2,2
55249,443,62038,443,allow,3056958,73055,2983903,3016,43,1023,1993
55262,53,4967,53,allow,193,102,91,2,30,1,1
49612,80,44677,80,allow,378,192,186,7,41,4,3
65140,53,46396,53,allow,199,102,97,2,29,1,1
53702,51413,55761,51413,allow,70,70,0,1,5,1,0
53172,56013,23634,56013,allow,70,70,0,1,5,1,0
13120,25174,0,0,deny,146,146,0,1,0,1,0
50265,24387,44902,24387,allow,330,330,0,6,1200,6,0
41610,443,48992,443,allow,9488,2196,7292,25,26,14,11
40956,443,7227,443,allow,10836,1733,9103,34,180,15,19
64890,51180,0,0,deny,62,62,0,1,0,1,0
58703,445,0,0,drop,70,70,0,1,0,1,0
52012,63475,43517,63475,allow,316,136,180,6,7,3,3
65477,53,60369,53,allow,182,93,89,2,31,1,1
49847,443,53706,443,allow,6117,976,5141,21,72,10,11
59399,443,48462,443,allow,66108,6145,59963,93,16,41,52
63027,445,0,0,drop,66,66,0,1,0,1,0
56142,445,0,0,drop,70,70,0,1,0,1,0
50418,80,62798,80,allow,12920,6875,6045,25,27,13,12
55631,443,58192,443,allow,6897,2509,4388,16,121,8,8
47258,443,16882,443,allow,50898,2733,48165,73,218,33,40
65321,53,58472,53,allow,167,86,81,2,29,1,1
49686,44847,0,0,deny,66,66,0,1,0,1,0
61461,50584,0,0,deny,66,66,0,1,0,1,0
43584,24748,0,0,deny,156,156,0,1,0,1,0
57425,443,11895,443,allow,16413,6367,10046,60,17,28,32
51803,445,0,0,drop,70,70,0,1,0,1,0
56925,443,10686,443,allow,33095,18485,14610,73,185,43,30
56415,80,5751,80,allow,38339,808,37531,37,104,9,28
50977,56205,0,0,deny,66,66,0,1,0,1,0
49527,445,0,0,drop,66,66,0,1,0,1,0
49563,53,27987,53,allow,200,102,98,2,31,1,1
49876,53,41654,53,allow,199,102,97,2,30,1,1
51909,443,57663,443,allow,8801,2032,6769,28,361,14,14
24931,25174,0,0,deny,146,146,0,1,0,1,0
19473,14168,34740,14168,allow,491,150,341,2,1200,1,1
42108,80,8576,80,allow,8370,1025,7345,18,80,10,8
32346,53,32346,53,allow,194,87,107,2,30,1,1
65258,53,31384,53,allow,193,102,91,2,31,1,1
57398,53,44535,53,allow,202,86,116,2,30,1,1
55587,43890,0,0,deny,62,62,0,1,0,1,0
57306,53,15056,53,allow,177,94,83,2,31,1,1
53785,33324,8660,33324,allow,70,70,0,1,4,1,0
55645,443,7018,443,allow,9213,3751,5462,17,121,8,9
65339,53,4097,53,allow,775,102,673,2,30,1,1
11801,443,11801,443,allow,19187,5127,14060,38,22,23,15
22916,25174,0,0,deny,62,62,0,1,0,1,0
45259,53,45259,53,allow,176,78,98,2,30,1,1
64993,53,50463,53,allow,748,95,653,2,30,1,1
51159,443,36632,443,allow,6405463,157088,6248375,6383,90,2146,4237
62323,443,8004,443,allow,6383,2838,3545,17,135,9,8
61589,21247,0,0,deny,66,66,0,1,0,1,0
46719,443,39379,443,allow,7261,3272,3989,22,45,13,9
47879,443,13971,443,allow,37598,2397,35201,53,239,22,31
52255,445,0,0,drop,66,66,0,1,0,1,0
56334,53,34646,53,allow,177,94,83,2,30,1,1
443,35385,0,0,deny,66,66,0,1,0,1,0
56721,53,12920,53,allow,711,87,624,2,30,1,1
41554,53,50330,53,allow,199,94,105,2,30,1,1
15635,41182,0,0,deny,66,66,0,1,0,1,0
25297,11530,0,0,deny,145,145,0,1,0,1,0
58863,443,30901,443,allow,4546411,95150,4451261,4312,109,1197,3115
56319,445,0,0,drop,70,70,0,1,0,1,0
55839,56535,0,0,deny,62,62,0,1,0,1,0
57732,445,0,0,drop,70,70,0,1,0,1,0
50178,53,23159,53,allow,758,96,662,2,31,1,1
55190,53,57289,53,allow,311,94,217,2,30,1,1
60999,53,14276,53,allow,578,286,292,9,16,5,4
56020,53,51205,53,allow,199,102,97,2,32,1,1
64263,445,0,0,drop,70,70,0,1,0,1,0
56127,53,58620,53,allow,167,86,81,2,29,1,1
56796,443,60351,443,allow,8074,2054,6020,20,15,11,9
54092,445,0,0,drop,70,70,0,1,0,1,0
40977,21247,0,0,deny,66,66,0,1,0,1,0
50744,443,22315,443,allow,6854,1380,5474,18,161,9,9
49750,445,0,0,drop,66,66,0,1,0,1,0
35229,32468,0,0,deny,62,62,0,1,0,1,0
49168,57470,0,0,deny,66,66,0,1,0,1,0
50246,445,0,0,drop,70,70,0,1,0,1,0
52236,25174,0,0,deny,62,62,0,1,0,1,0
50584,51651,64737,51651,allow,166,166,0,1,1200,1,0
50286,443,30253,443,allow,10203,2365,7838,40,86,22,18
65026,53,32654,53,allow,186,95,91,2,30,1,1
50159,445,0,0,drop,70,70,0,1,0,1,0
58638,5900,0,0,deny,62,62,0,1,0,1,0
49636,53,15924,53,allow,180,94,86,2,31,1,1
50720,445,0,0,drop,66,66,0,1,0,1,0
64875,53,51837,53,allow,211,102,109,2,30,1,1
64792,53,34890,53,allow,338,110,228,2,30,1,1
6455,80,6455,80,allow,326,186,140,6,29,4,2
51425,37450,0,0,deny,66,66,0,1,0,1,0
53371,445,0,0,drop,66,66,0,1,0,1,0
54074,445,0,0,drop,70,70,0,1,0,1,0
59938,443,27868,443,allow,1820,1303,517,13,26,7,6
49636,443,28958,443,allow,50297,4871,45426,86,31,40,46
47673,443,27427,443,allow,10372,4341,6031,28,319,15,13
54614,37807,0,0,deny,62,62,0,1,0,1,0
65277,53,55975,53,allow,167,86,81,2,30,1,1
27005,27015,55025,27015,allow,1624,126,1498,4,31,2,2
59395,443,39581,443,allow,5817,1995,3822,19,16,10,9
2522,64147,0,0,deny,62,62,0,1,0,1,0
57000,53,25419,53,allow,188,96,92,2,31,1,1
49608,53,10158,53,allow,170,87,83,2,31,1,1
56397,26467,0,0,deny,66,66,0,1,0,1,0
38538,22,0,0,deny,60,60,0,1,0,1,0
56718,50584,0,0,deny,66,66,0,1,0,1,0
53800,59950,39242,59950,allow,1973,1021,952,10,15,6,4
60019,443,11836,443,allow,76774,9184,67590,104,143,41,63
55075,53,27475,53,allow,168,78,90,2,30,1,1
65446,53,21925,53,allow,210,110,100,2,30,1,1
48962,161,0,0,allow,8507,3320,5187,28,30,14,14
60461,443,30128,443,allow,18515,2899,15616,32,148,15,17
55172,80,55172,80,allow,268230,8528,259702,292,231,106,186
3023,40108,0,0,deny,148,148,0,1,0,1,0
55786,53,42852,53,allow,200,102,98,2,30,1,1
62914,445,0,0,drop,70,70,0,1,0,1,0
50354,56205,0,0,deny,66,66,0,1,0,1,0
13168,35440,0,0,deny,62,62,0,1,0,1,0
54411,445,0,0,drop,70,70,0,1,0,1,0
49183,53,24061,53,allow,209,110,99,2,31,1,1
63732,40642,2876,40642,allow,70,70,0,1,5,1,0
55191,445,0,0,drop,70,70,0,1,0,1,0
38448,443,13312,443,allow,18512,3109,15403,45,48,22,23
64342,445,0,0,drop,66,66,0,1,0,1,0
51436,445,0,0,drop,70,70,0,1,0,1,0
26758,50584,0,0,deny,66,66,0,1,0,1,0
57003,80,40780,80,allow,526,304,222,8,35,5,3
54912,80,63649,80,allow,1992,1350,642,10,15,5,5
30960,45721,23609,45721,allow,66,66,0,1,3600,1,0
10151,54168,22661,54168,allow,479,150,329,2,1200,1,1
64706,53,4952,53,allow,174,89,85,2,30,1,1
56859,32185,46564,32185,allow,70,70,0,1,5,1,0
36811,53,36811,53,allow,227,90,137,2,29,1,1
49880,445,0,0,drop,70,70,0,1,0,1,0
64659,445,0,0,drop,70,70,0,1,0,1,0
53408,50243,0,0,deny,145,145,0,1,0,1,0
41700,443,15367,443,allow,167721,6935,160786,185,77,68,117
58638,5900,0,0,deny,62,62,0,1,0,1,0
60287,80,11423,80,allow,130,70,60,2,15,1,1
26531,37965,0,0,deny,62,62,0,1,0,1,0
44258,25,0,0,deny,74,74,0,1,0,1,0
58638,5900,0,0,deny,62,62,0,1,0,1,0
55609,445,0,0,drop,66,66,0,1,0,1,0
65326,445,0,0,drop,66,66,0,1,0,1,0
56496,53,41605,53,allow,193,102,91,2,30,1,1
52045,16853,65490,16853,allow,70,70,0,2,8,2,0
48448,48817,0,0,deny,66,66,0,1,0,1,0
52007,80,41883,80,allow,83736,4405,79331,114,19,48,66
60180,31573,0,0,deny,62,62,0,1,0,1,0
11136,19910,0,0,deny,62,62,0,1,0,1,0
26921,26467,0,0,deny,62,62,0,1,0,1,0
56131,445,0,0,drop,66,66,0,1,0,1,0
57578,51221,0,0,deny,66,66,0,1,0,1,0
63999,53,43877,53,allow,186,95,91,2,30,1,1
51266,445,0,0,drop,66,66,0,1,0,1,0
3478,61463,0,0,deny,164,164,0,1,0,1,0
55871,53,54072,53,allow,189,102,87,2,30,1,1
52975,23718,0,0,deny,66,66,0,1,0,1,0
55678,53,55305,53,allow,270,88,182,4,54,2,2
61818,445,0,0,drop,70,70,0,1,0,1,0
20005,37965,0,0,deny,62,62,0,1,0,1,0
39345,80,26537,80,allow,918,461,457,9,16,6,3
50080,445,0,0,drop,70,70,0,1,0,1,0
52649,445,0,0,drop,70,70,0,1,0,1,0
50050,445,0,0,drop,70,70,0,1,0,1,0
62126,445,0,0,drop,70,70,0,1,0,1,0
53832,443,1159,443,allow,499,425,74,4,0,3,1
60853,443,17952,443,allow,126,60,66,3,4,2,1
63652,445,0,0,drop,70,70,0,1,0,1,0
61305,443,56273,443,allow,5399,2711,2688,13,120,7,6
57007,5333,59200,5333,allow,7194101,1949033,5245068,50585,1008,24913,25672
54315,445,0,0,drop,66,66,0,1,0,1,0
58867,445,0,0,drop,66,66,0,1,0,1,0
49906,443,16050,443,allow,6754,2219,4535,21,77,11,10
49152,53,17272,53,allow,307,105,202,4,31,2,2
49834,445,0,0,drop,70,70,0,1,0,1,0
58350,445,0,0,drop,70,70,0,1,0,1,0
58799,443,29874,443,allow,7899,5184,2715,24,16,13,11
52730,443,26039,443,allow,8040,2587,5453,39,16,23,16
60329,80,45049,80,allow,374,192,182,7,61,4,3
50918,80,48461,80,allow,9643,812,8831,18,128,8,10
57236,53733,0,0,deny,62,62,0,1,0,1,0
57561,445,0,0,drop,70,70,0,1,0,1,0
39648,443,15824,443,allow,5663,4227,1436,27,47,16,11
53028,445,0,0,drop,70,70,0,1,0,1,0
34319,443,65277,443,allow,15358,11148,4210,93,423,51,42
35494,22114,0,0,deny,62,62,0,1,0,1,0
55720,443,32771,443,allow,2494,719,1775,9,120,5,4
57993,445,0,0,drop,66,66,0,1,0,1,0
57904,445,0,0,drop,70,70,0,1,0,1,0
65402,53,33102,53,allow,297,110,187,2,30,1,1
50983,443,64084,443,allow,11897,6250,5647,27,81,14,13
50873,443,51953,443,allow,350,210,140,6,26,4,2
60438,17148,35885,17148,allow,70,70,0,1,5,1,0
63205,9571,0,0,deny,66,66,0,1,0,1,0
50584,56221,62822,56221,allow,166,166,0,1,1199,1,0
58638,5900,0,0,deny,62,62,0,1,0,1,0
32051,37965,0,0,deny,62,62,0,1,0,1,0
58666,53,58666,53,allow,235,90,145,2,32,1,1
51825,445,0,0,drop,70,70,0,1,0,1,0
37390,80,53231,80,allow,78,78,0,1,5,1,0
50236,443,16316,443,allow,4954,1768,3186,18,143,9,9
1373,22114,0,0,deny,66,66,0,1,0,1,0
57991,22114,0,0,deny,66,66,0,1,0,1,0
52605,443,40382,443,allow,3523,518,3005,12,15,6,6
49721,80,41494,80,allow,340,140,200,6,15,3,3
58463,11392,0,0,deny,66,66,0,1,0,1,0
55043,57470,0,0,deny,78,78,0,1,0,1,0
50198,3389,50198,3389,allow,3343,1454,1889,15,16,8,7
26058,1433,0,0,deny,60,60,0,1,0,1,0
57413,445,0,0,drop,70,70,0,1,0,1,0
55958,53,62913,53,allow,177,94,83,2,29,1,1
51543,53,3333,53,allow,78,78,0,1,30,1,0
52808,57470,0,0,deny,146,146,0,1,0,1,0
443,35556,443,35556,allow,70,70,0,1,4,1,0
63419,53,63419,53,allow,216,90,126,2,30,1,1
52326,443,52326,443,allow,5433,2251,3182,23,86,12,11
3068,36237,0,0,deny,62,62,0,1,0,1,0
57554,443,18344,443,allow,7323,2654,4669,23,30,13,10
50584,28020,62483,28020,allow,1302,300,1002,6,1200,3,3
57884,443,11734,443,allow,7668,2540,5128,22,155,12,10
50491,80,59883,80,allow,318,192,126,6,25,4,2
53976,443,52741,443,allow,1591,1004,587,15,125,8,7
49164,53,4974,53,allow,212,94,118,2,30,1,1
47513,23,0,0,deny,60,60,0,1,0,1,0
18398,21247,0,0,deny,66,66,0,1,0,1,0
44164,443,64667,443,allow,280,140,140,5,130,3,2
65209,53,43414,53,allow,585,206,379,6,79,3,3
55605,53,12415,53,allow,300,88,212,4,51,2,2
27005,30010,6041,30010,allow,887,126,761,2,31,1,1
54962,53,25167,53,allow,194,102,92,2,30,1,1
51941,19333,28791,19333,allow,70,70,0,2,8,2,0
56588,443,17428,443,allow,15450,6149,9301,106,177,47,59
50020,445,0,0,drop,70,70,0,1,0,1,0
49503,53,8833,53,allow,167,86,81,2,30,1,1
27005,32078,44538,32078,allow,871,126,745,2,31,1,1
54999,445,0,0,drop,70,70,0,1,0,1,0
53759,80,20494,80,allow,997,582,415,11,315,6,5
51143,445,0,0,drop,70,70,0,1,0,1,0
64904,53,43718,53,allow,199,102,97,2,30,1,1
54646,445,0,0,drop,70,70,0,1,0,1,0
54776,443,51403,443,allow,9501,1502,7999,24,29,13,11
55059,80,26318,80,allow,306,180,126,6,26,4,2
51923,80,55461,80,allow,60441,6260,54181,79,29,35,44
64918,445,0,0,drop,66,66,0,1,0,1,0
40977,21247,0,0,deny,62,62,0,1,0,1,0
35637,443,59473,443,allow,5611,1559,4052,22,648,13,9
57386,53,13419,53,allow,193,102,91,2,31,1,1
56997,53,45686,53,allow,168,86,82,2,30,1,1
57429,445,0,0,drop,66,66,0,1,0,1,0
63948,53,52448,53,allow,366,102,264,4,60,2,2
52378,445,0,0,drop,70,70,0,1,0,1,0
34709,443,21963,443,allow,2119,1310,809,21,27,12,9
57074,53,64644,53,allow,195,102,93,2,30,1,1
9519,443,34920,443,allow,3910,370,3540,16,34,5,11
49410,53,29049,53,allow,177,94,83,2,31,1,1
52426,443,20298,443,allow,8760,1218,7542,25,15,14,11
65454,61600,0,0,deny,66,66,0,1,0,1,0
65450,445,0,0,drop,66,66,0,1,0,1,0
54692,443,45906,443,allow,5907,2630,3277,21,147,10,11
56600,445,0,0,drop,70,70,0,1,0,1,0
61335,443,41509,443,allow,42437,8035,34402,79,247,30,49
64739,445,0,0,drop,70,70,0,1,0,1,0
49235,53,6024,53,allow,164,86,78,2,31,1,1
38645,51221,0,0,deny,62,62,0,1,0,1,0
59830,443,56581,443,allow,82533,15815,66718,124,131,50,74
45055,443,37161,443,allow,1392,731,661,14,80,8,6
443,18177,0,0,deny,66,66,0,1,0,1,0
57885,80,59656,80,allow,32460,9354,23106,67,71,40,27
54990,80,38273,80,allow,9054746,285623,8769123,10474,214,4673,5801
60184,443,60184,443,allow,4574,1667,2907,19,26,11,8
57568,53,57568,53,allow,235,98,137,2,30,1,1
49321,53,38287,53,allow,184,94,90,2,29,1,1
9132,80,49560,80,allow,318,192,126,6,30,4,2
55355,445,0,0,drop,66,66,0,1,0,1,0
53623,50093,42211,50093,allow,552,306,246,9,38,5,4
49154,443,24167,443,allow,3163100,158133,3004967,3863,264,1464,2399
50399,80,19756,80,allow,318,192,126,6,26,4,2
55620,20795,41932,20795,allow,70,70,0,1,5,1,0
47483,53,19312,53,allow,164,78,86,2,30,1,1
48408,443,3268,443,allow,115036,11567,103469,189,103,92,97
44421,443,9990,443,allow,2548,1565,983,20,330,11,9
50559,53,33553,53,allow,178,94,84,2,29,1,1
55507,445,0,0,drop,70,70,0,1,0,1,0
55255,37965,0,0,deny,146,146,0,1,0,1,0
53226,80,34049,80,allow,1054,602,452,10,20,5,5
35105,5222,32302,5222,allow,1964,919,1045,20,16,10,10
60195,80,26973,80,allow,3059,1869,1190,17,105,13,4
49396,445,0,0,drop,70,70,0,1,0,1,0
50263,443,33451,443,allow,35817,18303,17514,160,138,85,75
44680,80,65456,80,allow,1658,922,736,10,17,6,4
43129,15503,0,0,deny,62,62,0,1,0,1,0
27402,37628,0,0,deny,62,62,0,1,0,1,0
63385,443,63385,443,allow,4659,1752,2907,19,30,11,8
15503,63684,7728,63684,allow,481,150,331,2,1200,1,1
55926,53,35022,53,allow,184,94,90,2,30,1,1
54889,445,0,0,drop,66,66,0,1,0,1,0
53051,44847,0,0,deny,62,62,0,1,0,1,0
54990,443,49240,443,allow,20961,10306,10655,49,48,25,24
63789,443,32462,443,allow,4407024,140001,4267023,4628,124,1546,3082
50475,53,26369,53,allow,772,100,672,2,31,1,1
64252,53,63103,53,allow,350,94,256,2,29,1,1
53979,443,21511,443,allow,3566,871,2695,11,120,5,6
55261,53,52795,53,allow,183,94,89,2,30,1,1
60875,56205,0,0,deny,66,66,0,1,0,1,0
55952,443,28479,443,allow,24272,12428,11844,70,213,32,38
65437,53,48894,53,allow,1386,85,1301,4,53,2,2
57052,53,21671,53,allow,177,94,83,2,30,1,1
55997,445,0,0,drop,66,66,0,1,0,1,0
56717,445,0,0,drop,70,70,0,1,0,1,0
65277,53,17756,53,allow,819,102,717,2,31,1,1
57348,443,25316,443,allow,13048,4976,8072,40,140,18,22
62325,443,62325,443,allow,1210,637,573,14,51,7,7
43688,22114,0,0,deny,62,62,0,1,0,1,0
62746,445,0,0,drop,66,66,0,1,0,1,0
2731,25174,0,0,deny,146,146,0,1,0,1,0
58564,50432,0,0,deny,66,66,0,1,0,1,0
18113,22114,0,0,deny,62,62,0,1,0,1,0
60561,53,50880,53,allow,343,86,257,2,30,1,1
50441,80,60802,80,allow,318,192,126,6,26,4,2
48409,443,36994,443,allow,5993,1261,4732,18,982,8,10
63459,445,0,0,drop,66,66,0,1,0,1,0
56979,53,3476,53,allow,180,94,86,2,30,1,1
61735,443,32889,443,allow,57467,4506,52961,86,30,42,44
54327,445,0,0,drop,70,70,0,1,0,1,0
50655,80,4984,80,allow,91198,3990,87208,113,19,49,64
50966,443,50616,443,allow,17161,1619,15542,18,143,4,14
62487,445,0,0,drop,70,70,0,1,0,1,0
55579,53,62219,53,allow,178,94,84,2,30,1,1
39823,36237,0,0,deny,66,66,0,1,0,1,0
54779,445,0,0,drop,66,66,0,1,0,1,0
63130,55860,38620,55860,allow,1426,964,462,7,15,4,3
5238,36298,39762,36298,allow,179518,128,179390,173,37,3,170
60016,443,40510,443,allow,134,60,74,3,6,2,1
49213,53,0,0,allow,333,102,231,2,30,1,1
52410,443,38111,443,allow,128802,48896,79906,237,24,121,116
55090,53,34414,53,allow,196,102,94,2,29,1,1
49563,80,12092,80,allow,318,192,126,6,45,4,2
53683,30218,33662,30218,allow,492,306,186,8,15,5,3
53356,445,0,0,drop,70,70,0,1,0,1,0
55058,53,43398,53,allow,216,110,106,2,31,1,1
49646,80,33279,80,allow,318,192,126,6,42,4,2
41670,80,41670,80,allow,3571,2892,679,13,23,8,5
57157,53,58237,53,allow,458,188,270,6,30,3,3
1694,30188,0,0,deny,62,62,0,1,0,1,0
46945,64147,0,0,deny,62,62,0,1,0,1,0
49944,53,58340,53,allow,334,90,244,4,38,2,2
53722,445,0,0,drop,70,70,0,1,0,1,0
34430,80,5069,80,allow,2913,633,2280,15,15,8,7
55481,445,0,0,drop,70,70,0,1,0,1,0
36108,8245,12106,8245,allow,280,214,66,2,29,1,1
56149,53,1500,53,allow,179,94,85,2,30,1,1
64306,64147,0,0,deny,66,66,0,1,0,1,0
33706,80,48762,80,allow,1265,473,792,8,15,5,3
8160,80,8160,80,allow,1670,1044,626,15,84,8,7
64683,53,62247,53,allow,198,102,96,2,29,1,1
56197,445,0,0,drop,66,66,0,1,0,1,0
22168,25174,0,0,deny,146,146,0,1,0,1,0
59900,3389,59900,3389,allow,3489,1534,1955,17,18,9,8
64210,445,0,0,drop,70,70,0,1,0,1,0
51220,443,53814,443,allow,7647,1917,5730,22,80,13,9
51152,443,11725,443,allow,44048,4441,39607,97,317,43,54
48071,25174,0,0,deny,146,146,0,1,0,1,0
0,0,0,0,allow,600,306,294,6,0,3,3
47120,443,47120,443,allow,4380,1473,2907,19,29,11,8
65229,53,50271,53,allow,195,102,93,2,30,1,1
57189,53,13765,53,allow,78,78,0,1,30,1,0
53886,443,35805,443,allow,6074,1579,4495,18,125,11,7
50841,443,31504,443,allow,10475,1518,8957,24,139,11,13
52189,443,16564,443,allow,36007,4328,31679,65,217,33,32
52860,445,0,0,drop,70,70,0,1,0,1,0
29049,23,0,0,deny,60,60,0,1,0,1,0
49742,53,64012,53,allow,731,91,640,2,30,1,1
55411,445,0,0,drop,70,70,0,1,0,1,0
53389,23,0,0,deny,60,60,0,1,0,1,0
42430,443,21880,443,allow,3927,1425,2502,18,121,8,10
54280,3385,0,0,deny,60,60,0,1,0,1,0
51221,15886,64989,15886,allow,481,150,331,2,1200,1,1
57434,50584,0,0,deny,62,62,0,1,0,1,0
59987,445,0,0,drop,70,70,0,1,0,1,0
50245,44847,0,0,deny,66,66,0,1,0,1,0
51140,445,0,0,drop,70,70,0,1,0,1,0
54898,445,0,0,drop,70,70,0,1,0,1,0
33948,1375,0,0,deny,146,146,0,1,0,1,0
55502,53,12440,53,allow,817,102,715,2,30,1,1
54323,27016,29153,27016,allow,924,924,0,3,30,3,0
49217,53,2129,53,allow,209,110,99,2,31,1,1
58826,445,0,0,drop,66,66,0,1,0,1,0
56755,53,26920,53,allow,184,94,90,2,31,1,1
52195,443,42007,443,allow,3470,1776,1694,20,48,10,10
39098,51505,0,0,deny,62,62,0,1,0,1,0
36588,5223,46105,5223,allow,4336,1518,2818,23,3005,14,9
47845,53,47845,53,allow,243,94,149,2,32,1,1
51800,445,0,0,drop,70,70,0,1,0,1,0
53126,47035,20200,47035,allow,70,70,0,1,5,1,0
56536,445,0,0,drop,66,66,0,1,0,1,0
64716,53,37975,53,allow,190,97,93,2,31,1,1
58638,5900,0,0,deny,62,62,0,1,0,1,0
49642,443,30931,443,allow,17163,6197,10966,44,43,22,22
55835,62413,0,0,deny,66,66,0,1,0,1,0
37965,33622,23125,33622,allow,132,132,0,3,1199,3,0
53351,445,0,0,drop,66,66,0,1,0,1,0
63673,445,0,0,drop,70,70,0,1,0,1,0
52951,443,13326,443,allow,628801,19603,609198,708,114,227,481
42153,443,25509,443,allow,12306,2097,10209,31,360,15,16
59320,443,31815,443,allow,4573,2614,1959,25,80,13,12
64216,53,11505,53,allow,182,93,89,2,30,1,1
47365,10387,0,0,deny,159,159,0,1,0,1,0
50512,1212,0,0,deny,145,145,0,1,0,1,0
1053,2310,0,0,deny,148,148,0,1,0,1,0
50011,53,47474,53,allow,1398,98,1300,4,31,2,2
44847,46972,13667,46972,allow,150,150,0,1,1200,1,0
47495,443,53611,443,allow,490,210,280,8,28,4,4
60780,28080,29726,28080,allow,70,70,0,2,8,2,0
64951,53,46883,53,allow,224,86,138,2,30,1,1
30629,46783,0,0,deny,145,145,0,1,0,1,0
13285,29892,0,0,deny,145,145,0,1,0,1,0
56641,445,0,0,drop,66,66,0,1,0,1,0
52087,445,0,0,drop,66,66,0,1,0,1,0
7634,80,7634,80,allow,1845,523,1322,10,15,6,4
49418,27017,63792,27017,allow,256,71,185,2,30,1,1
56256,62413,0,0,deny,66,66,0,1,0,1,0
49997,53,1711,53,allow,209,110,99,2,30,1,1
49512,80,18348,80,allow,2225,1649,576,10,38,6,4
58638,5900,0,0,deny,62,62,0,1,0,1,0
56625,80,20338,80,allow,234,234,0,4,11,4,0
49589,53,21247,53,allow,198,94,104,2,30,1,1
43129,20220,0,0,deny,62,62,0,1,0,1,0
54819,443,59534,443,allow,3429,1188,2241,13,134,6,7
11907,57470,0,0,deny,66,66,0,1,0,1,0
49756,80,38066,80,allow,20926,3231,17695,37,51,17,20
65492,53,44506,53,allow,822,102,720,2,30,1,1
56001,445,0,0,drop,70,70,0,1,0,1,0
62134,445,0,0,drop,66,66,0,1,0,1,0
58638,5900,0,0,deny,62,62,0,1,0,1,0
23519,25174,0,0,deny,62,62,0,1,0,1,0
39244,36829,0,0,deny,62,62,0,1,0,1,0
64244,53,29357,53,allow,198,101,97,2,30,1,1
64678,53,43744,53,allow,289,102,187,2,30,1,1
12531,22114,0,0,deny,62,62,0,1,0,1,0
51221,51413,15223,51413,allow,460,150,310,2,1200,1,1
49337,53,51649,53,allow,258,126,132,2,30,1,1
51641,443,16546,443,allow,7419,2682,4737,26,66,13,13
49215,52611,46200,52611,allow,70,70,0,2,8,2,0
49263,53,43703,53,allow,178,94,84,2,30,1,1
55584,53,38540,53,allow,177,94,83,2,29,1,1
61062,445,0,0,drop,70,70,0,1,0,1,0
64811,53,37013,53,allow,193,102,91,2,29,1,1
50196,53,48778,53,allow,756,95,661,2,31,1,1
53502,445,0,0,drop,70,70,0,1,0,1,0
64361,53,32766,53,allow,228,110,118,2,30,1,1
57914,445,0,0,drop,66,66,0,1,0,1,0
65482,53,40607,53,allow,174,89,85,2,31,1,1
57065,53,13982,53,allow,182,102,80,2,29,1,1
52058,8329,7251,8329,allow,66,66,0,1,5,1,0
64162,53,14611,53,allow,225,110,115,2,30,1,1
37851,443,37851,443,allow,4691,1784,2907,19,27,11,8
64023,53,59287,53,allow,174,89,85,2,30,1,1
5588,5588,0,0,allow,3562,1936,1626,48,194,24,24
27005,27013,28763,27013,allow,1628,126,1502,4,31,2,2
65218,53,51807,53,allow,186,95,91,2,30,1,1
60580,53,20280,53,allow,181,86,95,2,30,1,1
51055,445,0,0,drop,66,66,0,1,0,1,0
52280,445,0,0,drop,66,66,0,1,0,1,0
54280,3398,0,0,deny,60,60,0,1,0,1,0
19473,12345,64156,12345,allow,478,149,329,2,1200,1,1
40648,443,10699,443,allow,130,70,60,3,5,2,1
49506,53,12143,53,allow,200,102,98,2,30,1,1
50980,445,0,0,drop,70,70,0,1,0,1,0
55609,53,6401,53,allow,178,94,84,2,30,1,1
42542,25174,0,0,deny,62,62,0,1,0,1,0
49842,445,0,0,drop,66,66,0,1,0,1,0
62549,64147,0,0,deny,62,62,0,1,0,1,0
54325,445,0,0,drop,66,66,0,1,0,1,0
65363,53,1138,53,allow,181,94,87,2,31,1,1
60769,443,60769,443,allow,13423,1386,12037,33,17,14,19
53203,443,27595,443,allow,3656,2345,1311,18,17,9,9
49657,443,35292,443,allow,2800,1557,1243,33,53,19,14
61808,443,43689,443,allow,4625,2292,2333,14,135,7,7
50223,53,61828,53,allow,173,94,79,2,30,1,1
53450,443,34036,443,allow,10139,3656,6483,29,128,14,15
49972,445,0,0,drop,66,66,0,1,0,1,0
50567,443,16036,443,allow,5866,1781,4085,21,81,12,9
51764,33432,6081,33432,allow,70,70,0,1,5,1,0
49710,53,28433,53,allow,480,93,387,4,50,2,2
36685,35440,0,0,deny,62,62,0,1,0,1,0
65348,53,2839,53,allow,177,94,83,2,30,1,1
59918,44847,0,0,deny,66,66,0,1,0,1,0
57401,53,48123,53,allow,179,94,85,2,30,1,1
51172,445,0,0,drop,70,70,0,1,0,1,0
64078,54561,14823,54561,allow,70,70,0,1,4,1,0
39324,64147,0,0,deny,62,62,0,1,0,1,0
51713,445,0,0,drop,66,66,0,1,0,1,0
57804,443,57804,443,allow,4378,1471,2907,19,26,11,8
27824,51505,0,0,deny,62,62,0,1,0,1,0
59569,445,0,0,drop,70,70,0,1,0,1,0
63618,445,0,0,drop,70,70,0,1,0,1,0
57267,443,26309,443,allow,126,60,66,3,6,2,1
56902,53,41488,53,allow,768,99,669,2,30,1,1
50467,53,38713,53,allow,758,93,665,2,31,1,1
56611,80,8801,80,allow,1114,534,580,12,16,7,5
50502,123,48233,123,allow,184,94,90,2,30,1,1
55769,445,0,0,drop,66,66,0,1,0,1,0
3717,25174,0,0,deny,62,62,0,1,0,1,0
56376,44847,0,0,deny,66,66,0,1,0,1,0
46087,123,1853,123,allow,184,94,90,2,30,1,1
56927,64147,0,0,deny,145,145,0,1,0,1,0
123,123,14772,123,allow,184,94,90,2,29,1,1
6881,13487,50124,13487,allow,228,118,110,2,1199,1,1
53330,443,46161,443,allow,3701,1232,2469,13,136,6,7
60883,445,0,0,drop,70,70,0,1,0,1,0
61798,35440,0,0,deny,66,66,0,1,0,1,0
40687,64147,0,0,deny,62,62,0,1,0,1,0
58217,445,0,0,drop,70,70,0,1,0,1,0
51959,443,18601,443,allow,20648,4726,15922,40,48,19,21
53906,37965,0,0,deny,62,62,0,1,0,1,0
55483,445,0,0,drop,70,70,0,1,0,1,0
47256,37807,0,0,deny,146,146,0,1,0,1,0
52470,445,0,0,drop,66,66,0,1,0,1,0
57176,53,30899,53,allow,172,88,84,2,30,1,1
55746,445,0,0,drop,70,70,0,1,0,1,0
60501,445,0,0,drop,70,70,0,1,0,1,0
58402,445,0,0,drop,66,66,0,1,0,1,0
6881,29517,0,0,deny,146,146,0,1,0,1,0
6881,6881,29502,6881,allow,231,111,120,2,1200,1,1
56825,16648,32548,16648,allow,164,70,94,2,7,1,1
64457,445,0,0,drop,66,66,0,1,0,1,0
56624,53,50985,53,allow,196,102,94,2,30,1,1
60447,36396,16095,36396,allow,70,70,0,2,8,2,0
53046,445,0,0,drop,66,66,0,1,0,1,0
64739,53,44159,53,allow,172,88,84,2,30,1,1
50040,53,62872,53,allow,322,102,220,2,30,1,1
55521,53,16753,53,allow,711,87,624,2,30,1,1
56564,9571,0,0,deny,78,78,0,1,0,1,0
53781,37965,0,0,deny,66,66,0,1,0,1,0
57643,28189,0,0,deny,60,60,0,1,0,1,0
64765,445,0,0,drop,66,66,0,1,0,1,0
56388,53,30178,53,allow,165,86,79,2,30,1,1
65386,53,26119,53,allow,1160,392,768,10,66,5,5
58707,80,41124,80,allow,2542,1879,663,12,14,6,6
63773,445,0,0,drop,70,70,0,1,0,1,0
59082,445,0,0,drop,66,66,0,1,0,1,0
58446,445,0,0,drop,70,70,0,1,0,1,0
49762,53,15647,53,allow,195,94,101,2,30,1,1
50051,443,1683,443,allow,7912,3269,4643,23,96,12,11
13907,57470,0,0,deny,66,66,0,1,0,1,0
57148,445,0,0,drop,66,66,0,1,0,1,0
55747,53,60258,53,allow,186,95,91,2,30,1,1
63955,445,0,0,drop,70,70,0,1,0,1,0
48676,53395,0,0,deny,60,60,0,1,0,1,0
53629,51413,42166,51413,allow,70,70,0,1,4,1,0
57240,53,57240,53,allow,198,89,109,2,30,1,1
61717,80,65373,80,allow,6160,2912,3248,17,18,9,8
18655,44847,0,0,deny,66,66,0,1,0,1,0
59749,443,34617,443,allow,304,86,218,2,29,1,1
56477,80,20829,80,allow,95037,3407,91630,103,135,38,65
57607,21247,0,0,deny,66,66,0,1,0,1,0
39387,443,57166,443,allow,204,70,134,4,26,2,2
40848,8434,40848,8434,allow,156,156,0,3,8,3,0
60892,445,0,0,drop,70,70,0,1,0,1,0
54262,445,0,0,drop,70,70,0,1,0,1,0
32796,37965,0,0,deny,66,66,0,1,0,1,0
64531,53,56972,53,allow,183,94,89,2,29,1,1
50257,443,7570,443,allow,249660,21361,228299,416,141,191,225
10736,6112,0,0,deny,60,60,0,1,0,1,0
56703,53,61350,53,allow,198,101,97,2,31,1,1
56453,445,0,0,drop,66,66,0,1,0,1,0
63544,445,0,0,drop,70,70,0,1,0,1,0
29009,25174,0,0,deny,146,146,0,1,0,1,0
64454,3389,64454,3389,allow,4350,2261,2089,21,18,11,10
62096,445,0,0,drop,70,70,0,1,0,1,0
44847,51365,14892,51365,allow,509,150,359,2,1200,1,1
63788,445,0,0,drop,70,70,0,1,0,1,0
27081,10197,0,0,deny,62,62,0,1,0,1,0
51928,52520,11257,52520,allow,70,70,0,1,5,1,0
54121,445,0,0,drop,66,66,0,1,0,1,0
52416,445,0,0,drop,70,70,0,1,0,1,0
53190,80,50867,80,allow,1873,713,1160,10,15,5,5
52766,445,0,0,drop,66,66,0,1,0,1,0
49408,445,0,0,drop,66,66,0,1,0,1,0
63205,443,63205,443,allow,9324,4240,5084,24,16,13,11
58744,443,58147,443,allow,14878,4225,10653,83,330,41,42
52116,445,0,0,drop,70,70,0,1,0,1,0
56745,56518,23267,56518,allow,1556,588,968,11,16,6,5
35461,5228,26150,5228,allow,8648,2111,6537,40,7038,21,19
58357,62413,0,0,deny,146,146,0,1,0,1,0
55545,53,10302,53,allow,170,87,83,2,30,1,1
56273,53,26440,53,allow,182,93,89,2,31,1,1
54242,445,0,0,drop,70,70,0,1,0,1,0
29159,39004,0,0,deny,62,62,0,1,0,1,0
53871,43266,32431,43266,allow,70,70,0,1,5,1,0
3103,50584,0,0,deny,62,62,0,1,0,1,0
64942,53,36365,53,allow,284,102,182,4,38,2,2
45855,25174,0,0,deny,62,62,0,1,0,1,0
26900,27017,50644,27017,allow,422,164,258,6,30,3,3
57096,53,11827,53,allow,198,102,96,2,30,1,1
63981,53,39748,53,allow,329,86,243,4,42,2,2
53879,445,0,0,drop,70,70,0,1,0,1,0
443,61686,0,0,deny,1484,1484,0,1,0,1,0
39926,443,4012,443,allow,40820,4400,36420,81,81,42,39
51705,445,0,0,drop,66,66,0,1,0,1,0
51800,63796,15243,63796,allow,70,70,0,1,5,1,0
62013,445,0,0,drop,66,66,0,1,0,1,0
45701,80,26870,80,allow,1579,1217,362,8,15,5,3
49848,445,0,0,drop,70,70,0,1,0,1,0
63964,53,46604,53,allow,190,97,93,2,31,1,1
57139,53,12753,53,allow,816,102,714,2,30,1,1
17206,53,17206,53,allow,240,98,142,2,29,1,1
34408,443,19414,443,allow,9649,3714,5935,47,340,24,23
30599,46824,0,0,deny,66,66,0,1,0,1,0
12794,35440,0,0,deny,146,146,0,1,0,1,0
56125,53,3352,53,allow,168,86,82,2,30,1,1
30783,51505,0,0,deny,62,62,0,1,0,1,0
17579,57470,0,0,deny,62,62,0,1,0,1,0
57946,445,0,0,drop,70,70,0,1,0,1,0
48676,53395,0,0,deny,60,60,0,1,0,1,0
25772,7302,0,0,deny,62,62,0,1,0,1,0
33022,443,32074,443,allow,162,102,60,2,5,1,1
35888,443,35888,443,allow,4481,1574,2907,19,26,11,8
53801,445,0,0,drop,70,70,0,1,0,1,0
57867,27019,40046,27019,allow,2338,634,1704,10,30,6,4
38464,443,38464,443,allow,33734,3007,30727,53,90,29,24
64531,53,13391,53,allow,754,94,660,2,30,1,1
27442,44847,0,0,deny,62,62,0,1,0,1,0
63848,48560,48756,48560,allow,66,66,0,2,7,2,0
53755,445,0,0,drop,66,66,0,1,0,1,0
9219,32480,0,0,deny,72,72,0,1,0,1,0
64726,53,22205,53,allow,231,94,137,2,30,1,1
58638,5900,0,0,deny,62,62,0,1,0,1,0
61338,445,0,0,drop,70,70,0,1,0,1,0
54769,50584,0,0,deny,62,62,0,1,0,1,0
56751,443,1821,443,allow,8059,2039,6020,20,15,11,9
53447,80,56181,80,allow,1517,481,1036,11,15,6,5
58862,443,37549,443,allow,1068717,27931,1040786,1093,45,351,742
57038,53,63930,53,allow,194,102,92,2,33,1,1
51765,443,19120,443,allow,3026,965,2061,14,135,7,7
44285,25174,0,0,deny,62,62,0,1,0,1,0
41801,53,41801,53,allow,213,87,126,2,30,1,1
55412,445,0,0,drop,70,70,0,1,0,1,0
57436,53,1607,53,allow,183,94,89,2,30,1,1
60239,445,0,0,drop,66,66,0,1,0,1,0
64507,445,0,0,drop,66,66,0,1,0,1,0
17916,23,0,0,deny,60,60,0,1,0,1,0
65199,53,15810,53,allow,215,94,121,2,30,1,1
64049,1029,15442,1029,allow,70,70,0,1,5,1,0
39097,443,24428,443,allow,6747,2827,3920,19,399,11,8
52133,15015,35766,15015,allow,66,66,0,1,5,1,0
7310,44847,0,0,deny,66,66,0,1,0,1,0
51599,445,0,0,drop,70,70,0,1,0,1,0
64606,53,40619,53,allow,278,118,160,2,30,1,1
63133,445,0,0,drop,70,70,0,1,0,1,0
59186,445,0,0,drop,70,70,0,1,0,1,0
53552,53,3574,53,allow,168,78,90,2,29,1,1
24285,26467,0,0,deny,62,62,0,1,0,1,0
47913,25174,0,0,deny,62,62,0,1,0,1,0
42465,57470,0,0,deny,60,60,0,1,0,1,0
59017,445,0,0,drop,70,70,0,1,0,1,0
55837,443,59967,443,allow,39628,2279,37349,63,255,23,40
41463,20005,0,0,deny,60,60,0,1,0,1,0
50095,50584,0,0,deny,66,66,0,1,0,1,0
53453,2767,0,0,deny,66,66,0,1,0,1,0
51221,55497,56542,55497,allow,528,528,0,9,1200,9,0
58714,53,58714,53,allow,197,76,121,2,30,1,1
57425,53,32563,53,allow,168,86,82,2,30,1,1
60619,445,0,0,drop,66,66,0,1,0,1,0
1024,6881,0,0,deny,146,146,0,1,0,1,0
52253,445,0,0,drop,70,70,0,1,0,1,0
57257,53,41032,53,allow,173,94,79,2,29,1,1
55086,53,37200,53,allow,328,90,238,4,37,2,2
46026,443,9317,443,allow,8908,3897,5011,19,135,9,10
1156,53,45394,53,allow,278,86,192,2,29,1,1
55627,53,18188,53,allow,240,110,130,2,30,1,1
53974,26108,3464,26108,allow,70,70,0,2,8,2,0
58980,445,0,0,drop,70,70,0,1,0,1,0
52086,27156,8001,27156,allow,136,136,0,3,14,3,0
59611,56205,0,0,deny,66,66,0,1,0,1,0
55144,30188,0,0,deny,66,66,0,1,0,1,0
59977,30188,0,0,deny,66,66,0,1,0,1,0
55360,445,0,0,drop,70,70,0,1,0,1,0
56643,53,25715,53,allow,195,102,93,2,31,1,1
54805,80,8562,80,allow,448,78,370,6,24,1,5
56367,445,0,0,drop,70,70,0,1,0,1,0
49558,53,38507,53,allow,193,102,91,2,29,1,1
65449,53,42820,53,allow,723,102,621,2,30,1,1
15959,56205,0,0,deny,62,62,0,1,0,1,0
56950,53,38998,53,allow,183,86,97,2,29,1,1
62235,443,62235,443,allow,16675,2296,14379,37,78,17,20
50713,57470,0,0,deny,66,66,0,1,0,1,0
58210,443,60868,443,allow,14898,12644,2254,32,316,18,14
64057,445,0,0,drop,70,70,0,1,0,1,0
16474,50584,0,0,deny,146,146,0,1,0,1,0
64359,445,0,0,drop,70,70,0,1,0,1,0
64947,445,0,0,drop,70,70,0,1,0,1,0
7749,36237,0,0,deny,66,66,0,1,0,1,0
58118,445,0,0,drop,66,66,0,1,0,1,0
44060,443,59243,443,allow,9734,1614,8120,24,170,11,13
55641,443,52887,443,allow,6133,1655,4478,12,119,5,7
61279,443,14356,443,allow,7424,3871,3553,26,160,12,14
46090,50584,0,0,deny,62,62,0,1,0,1,0
60965,445,0,0,drop,70,70,0,1,0,1,0
55966,35440,0,0,deny,66,66,0,1,0,1,0
31126,53,31126,53,allow,240,98,142,2,30,1,1
63445,64631,0,0,deny,66,66,0,1,0,1,0
49447,443,42024,443,allow,790501,27378,763123,858,86,322,536
58897,443,22242,443,allow,5167,700,4467,16,14,7,9
65526,28793,0,0,deny,66,66,0,1,0,1,0
50584,55727,63781,55727,allow,2268,1050,1218,15,5442,8,7
60951,53,52563,53,allow,164,78,86,2,29,1,1
60073,80,45095,80,allow,10676,6719,3957,23,141,12,11
42934,443,24809,443,allow,232,172,60,3,5,2,1
18754,30188,0,0,deny,62,62,0,1,0,1,0
52006,445,0,0,drop,70,70,0,1,0,1,0
49635,53,59666,53,allow,210,110,100,2,30,1,1
52549,445,0,0,drop,66,66,0,1,0,1,0
42429,22114,0,0,deny,62,62,0,1,0,1,0
54682,445,0,0,drop,70,70,0,1,0,1,0
56916,443,36796,443,allow,13829,2472,11357,30,243,13,17
49645,80,12574,80,allow,318,192,126,6,41,4,2
51985,445,0,0,drop,70,70,0,1,0,1,0
58638,5900,0,0,deny,62,62,0,1,0,1,0
42358,80,63133,80,allow,1081,641,440,9,14,4,5
53192,445,0,0,drop,70,70,0,1,0,1,0
50290,53,2460,53,allow,211,110,101,2,30,1,1
56375,80,51111,80,allow,1609,919,690,15,72,8,7
49687,53,60160,53,allow,197,102,95,2,31,1,1
56982,80,33665,80,allow,3817,829,2988,11,16,7,4
7356,25174,0,0,deny,62,62,0,1,0,1,0
53430,443,50940,443,allow,4383,2064,2319,11,120,6,5
1912,48817,0,0,deny,62,62,0,1,0,1,0
49964,53,64934,53,allow,749,94,655,2,30,1,1
51785,33253,63010,33253,allow,70,70,0,1,5,1,0
57356,53,56372,53,allow,815,95,720,2,30,1,1
50313,445,0,0,drop,70,70,0,1,0,1,0
60803,80,16464,80,allow,254,128,126,5,15,3,2
51137,443,57006,443,allow,9269,5449,3820,70,460,33,37
62407,445,0,0,drop,70,70,0,1,0,1,0
50547,53,45838,53,allow,210,110,100,2,30,1,1
56000,53,42944,53,allow,177,94,83,2,30,1,1
52941,443,58388,443,allow,14630,5941,8689,52,115,26,26
64706,443,64706,443,allow,274,132,142,5,76,3,2
57241,53,26543,53,allow,224,102,122,2,30,1,1
59947,445,0,0,drop,70,70,0,1,0,1,0
16522,26467,0,0,deny,66,66,0,1,0,1,0
22240,22114,0,0,deny,146,146,0,1,0,1,0
37898,53,37898,53,allow,244,98,146,2,33,1,1
36120,57470,0,0,deny,145,145,0,1,0,1,0
37611,53,57023,53,allow,199,94,105,2,30,1,1
53725,57418,1375,57418,allow,70,70,0,2,8,2,0
35421,30188,0,0,deny,146,146,0,1,0,1,0
49711,14984,0,0,deny,66,66,0,1,0,1,0
56464,53,12026,53,allow,177,94,83,2,30,1,1
65325,445,0,0,drop,66,66,0,1,0,1,0
48706,23393,0,0,deny,60,60,0,1,0,1,0
10447,30317,0,0,deny,146,146,0,1,0,1,0
60855,35440,0,0,deny,66,66,0,1,0,1,0
51441,445,0,0,drop,66,66,0,1,0,1,0
56576,443,12093,443,allow,6971,1510,5461,21,80,11,10
49228,53,30182,53,allow,193,102,91,2,30,1,1
50990,23884,0,0,deny,62,62,0,1,0,1,0
65418,53,5528,53,allow,197,94,103,2,30,1,1
49220,22,0,0,deny,60,60,0,1,0,1,0
53249,443,22744,443,allow,12082,5745,6337,32,61,16,16
62872,50584,0,0,deny,62,62,0,1,0,1,0
57862,443,61289,443,allow,448344,11729,436615,474,157,128,346
49888,53,39344,53,allow,198,102,96,2,30,1,1
58785,53,54759,53,allow,211,86,125,2,30,1,1
60405,445,0,0,drop,70,70,0,1,0,1,0
64808,445,0,0,drop,66,66,0,1,0,1,0
62620,445,0,0,drop,70,70,0,1,0,1,0
49710,443,63933,443,allow,7691,1797,5894,22,137,12,10
49418,53,2882,53,allow,165,86,79,2,30,1,1
50320,80,20341,80,allow,50565,32661,17904,77,167,39,38
56518,53,9121,53,allow,177,94,83,2,30,1,1
37579,443,43995,443,allow,499,425,74,4,0,3,1
50384,443,12155,443,allow,6147,911,5236,18,16,10,8
51704,9266,12391,9266,allow,66,66,0,1,5,1,0
39472,443,61496,443,allow,9767,2138,7629,22,16,12,10
61214,445,0,0,drop,70,70,0,1,0,1,0
55127,53,55127,53,allow,220,100,120,2,31,1,1
51449,443,58167,443,allow,21779,7983,13796,44,97,25,19
50390,443,34358,443,allow,1328,876,452,11,29,6,5
65229,53,52095,53,allow,193,102,91,2,30,1,1
27005,27001,28063,27001,allow,887,126,761,2,31,1,1
56059,80,49532,80,allow,1151,711,440,10,15,5,5
38945,443,48637,443,allow,20511,4206,16305,24,134,7,17
27288,53,2459,53,allow,199,94,105,2,30,1,1
45941,23386,0,0,deny,60,60,0,1,0,1,0
49572,443,43054,443,allow,1820,1101,719,18,18,10,8
57257,445,0,0,drop,70,70,0,1,0,1,0
45032,53,45032,53,allow,216,82,134,2,33,1,1
64033,29834,57709,29834,allow,66,66,0,2,8,2,0
61738,2767,0,0,deny,62,62,0,1,0,1,0
57589,445,0,0,drop,66,66,0,1,0,1,0
50285,445,0,0,drop,66,66,0,1,0,1,0
58059,445,0,0,drop,66,66,0,1,0,1,0
54605,445,0,0,drop,66,66,0,1,0,1,0
34477,5900,34477,5900,allow,60,60,0,1,5,1,0
56738,53,38791,53,allow,821,102,719,2,30,1,1
55276,53,33496,53,allow,170,87,83,2,31,1,1
60849,80,64699,80,allow,9729,876,8853,21,45,11,10
49480,53,47457,53,allow,184,94,90,2,30,1,1
49157,443,64620,443,allow,2529,1230,1299,17,16,9,8
52148,80,27900,80,allow,366,240,126,7,33,5,2
25565,62979,0,0,deny,60,60,0,1,0,1,0
47013,44512,0,0,deny,62,62,0,1,0,1,0
64946,53,45329,53,allow,210,102,108,2,30,1,1
62769,25174,0,0,deny,62,62,0,1,0,1,0
32710,22114,0,0,deny,62,62,0,1,0,1,0
30610,41615,0,0,deny,145,145,0,1,0,1,0
57655,56205,0,0,deny,66,66,0,1,0,1,0
55503,53,54842,53,allow,200,102,98,2,30,1,1
65488,53,4906,53,allow,232,110,122,2,29,1,1
65221,53,38871,53,allow,258,102,156,2,29,1,1
54995,53,57538,53,allow,199,102,97,2,30,1,1
60530,445,0,0,drop,70,70,0,1,0,1,0
51189,53,6847,53,allow,312,78,234,2,30,1,1
53127,30467,24380,30467,allow,314,128,186,6,18,3,3
65014,53,57511,53,allow,193,102,91,2,30,1,1
56587,53,8172,53,allow,184,94,90,2,31,1,1
51973,44847,0,0,deny,66,66,0,1,0,1,0
57319,53,9103,53,allow,189,102,87,2,30,1,1
62972,445,0,0,drop,66,66,0,1,0,1,0
37428,53,37182,53,allow,168,78,90,2,30,1,1
37619,443,7866,443,allow,6169,4980,1189,28,16,15,13
22114,4789,50813,4789,allow,70,70,0,1,30,1,0
50022,53,26770,53,allow,179,94,85,2,31,1,1
63614,445,0,0,drop,70,70,0,1,0,1,0
51847,80,28250,80,allow,366,240,126,7,31,5,2
64368,445,0,0,drop,70,70,0,1,0,1,0
42457,5222,64493,5222,allow,35380,2898,32482,63,227,22,41
62984,445,0,0,drop,66,66,0,1,0,1,0
20508,57470,0,0,deny,62,62,0,1,0,1,0
62061,445,0,0,drop,70,70,0,1,0,1,0
51796,80,13753,80,allow,2188,1282,906,13,47,8,5
64004,48339,32132,48339,allow,70,70,0,1,4,1,0
12183,22114,0,0,deny,62,62,0,1,0,1,0
62625,37965,0,0,deny,66,66,0,1,0,1,0
29577,64147,0,0,deny,62,62,0,1,0,1,0
62625,37965,0,0,deny,62,62,0,1,0,1,0
57470,50321,60490,50321,allow,5231,5231,0,79,5173,79,0
50241,53,50241,53,allow,260,106,154,2,32,1,1
36628,80,34664,80,allow,78,78,0,1,4,1,0
14997,57470,0,0,deny,72,72,0,1,0,1,0
55033,445,0,0,drop,66,66,0,1,0,1,0
53624,445,0,0,drop,66,66,0,1,0,1,0
49757,53,9163,53,allow,177,94,83,2,30,1,1
56511,53,32498,53,allow,200,102,98,2,30,1,1
60804,445,0,0,drop,70,70,0,1,0,1,0
10834,50584,0,0,deny,66,66,0,1,0,1,0
37472,443,30492,443,allow,17764,5080,12684,46,121,22,24
49792,443,3776,443,allow,6089,799,5290,16,126,8,8
65501,57470,0,0,deny,72,72,0,1,0,1,0
49275,53,59894,53,allow,190,97,93,2,31,1,1
48283,42873,0,0,deny,66,66,0,1,0,1,0
56497,53,37841,53,allow,177,94,83,2,30,1,1
51892,80,28935,80,allow,15867,8841,7026,29,26,16,13
18204,55160,0,0,deny,146,146,0,1,0,1,0
49815,53,0,0,allow,166,73,93,2,30,1,1
49961,53,46234,53,allow,216,110,106,2,31,1,1
65428,443,7165,443,allow,14203,1525,12678,13,143,2,11
52193,33027,31412,33027,allow,70,70,0,2,8,2,0
65059,53,35510,53,allow,168,86,82,2,30,1,1
8915,443,26790,443,allow,7182,1016,6166,28,412,11,17
61315,48817,0,0,deny,62,62,0,1,0,1,0
57343,53,32639,53,allow,181,94,87,2,31,1,1
55306,53,23236,53,allow,170,87,83,2,0,1,1
57127,53,41259,53,allow,195,102,93,2,30,1,1
60479,25174,0,0,deny,62,62,0,1,0,1,0
64768,80,26612,80,allow,18045,3544,14501,28,156,12,16
52887,37807,0,0,deny,66,66,0,1,0,1,0
55835,62413,0,0,deny,62,62,0,1,0,1,0
26480,64147,0,0,deny,62,62,0,1,0,1,0
41886,53,64973,53,allow,168,78,90,2,31,1,1
53528,20485,28809,20485,allow,70,70,0,1,5,1,0
57139,53,26096,53,allow,181,86,95,2,30,1,1
41688,443,15969,443,allow,626036,38764,587272,713,191,245,468
63088,443,45061,443,allow,512,166,346,2,30,1,1
43679,44847,0,0,deny,62,62,0,1,0,1,0
55774,8060,26633,8060,allow,70,70,0,2,8,2,0
59829,443,18743,443,allow,182,60,122,4,26,2,2
3478,61463,0,0,deny,982,982,0,1,0,1,0
53211,445,0,0,drop,70,70,0,1,0,1,0
49275,53,55214,53,allow,283,97,186,4,30,2,2
63630,53,44818,53,allow,278,94,184,2,30,1,1
52007,445,0,0,drop,70,70,0,1,0,1,0
51414,50584,0,0,deny,66,66,0,1,0,1,0
56414,53,12496,53,allow,178,94,84,2,29,1,1
65490,443,45608,443,allow,405489,12010,393479,416,16,146,270
56431,53,28557,53,allow,177,94,83,2,31,1,1
38873,443,28510,443,allow,10209,2574,7635,39,917,18,21
49521,443,49521,443,allow,25081,3001,22080,55,75,29,26
61729,445,0,0,drop,70,70,0,1,0,1,0
52596,17372,0,0,deny,66,66,0,1,0,1,0
63773,445,0,0,drop,66,66,0,1,0,1,0
57333,53,41487,53,allow,258,110,148,2,31,1,1
58077,36653,11744,36653,allow,204,64,140,4,11,2,2
55133,53,55133,53,allow,228,90,138,2,30,1,1
63963,53,44790,53,allow,212,102,110,2,30,1,1
10000,10214,0,0,deny,62,62,0,1,0,1,0
35587,123,5043,123,allow,184,94,90,2,30,1,1
49849,80,56031,80,allow,9581,2352,7229,14,89,7,7
44695,443,65027,443,allow,4419,3179,1240,17,17,10,7
65442,53,27260,53,allow,760,97,663,2,31,1,1
65024,53,47698,53,allow,179,94,85,2,30,1,1
53012,51050,0,0,deny,62,62,0,1,0,1,0
54952,5228,14099,5228,allow,12140,3028,9112,54,4653,28,26
65030,53,52927,53,allow,785,110,675,2,30,1,1
40042,80,40042,80,allow,1919,1470,449,10,20,6,4
51828,445,0,0,drop,66,66,0,1,0,1,0
57603,443,1218,443,allow,2614,1689,925,18,23,10,8
42429,22114,0,0,deny,146,146,0,1,0,1,0
64951,53,60545,53,allow,230,102,128,2,30,1,1
50840,443,34565,443,allow,8057,1135,6922,19,139,9,10
50799,445,0,0,drop,66,66,0,1,0,1,0
62586,445,0,0,drop,66,66,0,1,0,1,0
64627,53,12613,53,allow,184,102,82,2,31,1,1
55862,62413,0,0,deny,66,66,0,1,0,1,0
57107,445,0,0,drop,70,70,0,1,0,1,0
63421,44847,0,0,deny,66,66,0,1,0,1,0
63668,445,0,0,drop,70,70,0,1,0,1,0
43584,24748,0,0,deny,156,156,0,1,0,1,0
58638,5900,0,0,deny,62,62,0,1,0,1,0
43347,7275,22003,7275,allow,3299,665,2634,18,16,10,8
42298,40002,11642,40002,allow,724,550,174,4,30,2,2
64557,445,0,0,drop,70,70,0,1,0,1,0
45313,64147,0,0,deny,62,62,0,1,0,1,0
56724,53,41138,53,allow,195,102,93,2,29,1,1
31683,35440,0,0,deny,146,146,0,1,0,1,0
50279,443,26201,443,allow,1128,654,474,17,18,10,7
60805,20010,5973,20010,allow,70,70,0,1,5,1,0
54062,49813,0,0,deny,62,62,0,1,0,1,0
25602,64147,0,0,deny,62,62,0,1,0,1,0
52432,50265,0,0,deny,66,66,0,1,0,1,0
57131,35776,0,0,deny,145,145,0,1,0,1,0
48847,443,1416,443,allow,2523,1483,1040,19,276,10,9
65520,53,2299,53,allow,379,94,285,2,30,1,1
62854,445,0,0,drop,66,66,0,1,0,1,0
64592,53,18733,53,allow,177,94,83,2,30,1,1
44849,46478,0,0,deny,74,74,0,1,0,1,0
15605,50265,0,0,deny,62,62,0,1,0,1,0
5588,5588,0,0,allow,3354,1792,1562,46,194,23,23
3591,53,3591,53,allow,235,90,145,2,32,1,1
42379,443,23985,443,allow,499,425,74,4,0,3,1
45218,443,18311,443,allow,16297,12965,3332,54,193,30,24
58758,443,49380,443,allow,4889,1079,3810,15,25,8,7
50509,443,29330,443,allow,9535,1246,8289,29,77,15,14
55042,443,48187,443,allow,5409,1471,3938,21,17,12,9
53106,445,0,0,drop,70,70,0,1,0,1,0
33196,443,16510,443,allow,6989,5073,1916,24,111,14,10
50214,53,34671,53,allow,789,110,679,2,31,1,1
38477,5900,0,0,deny,60,60,0,1,0,1,0
57918,445,0,0,drop,70,70,0,1,0,1,0
49570,5900,0,0,deny,60,60,0,1,0,1,0
64956,53,25279,53,allow,192,98,94,2,30,1,1
51083,5223,18916,5223,allow,4070,1456,2614,26,2889,15,11
56304,445,0,0,drop,66,66,0,1,0,1,0
49418,37569,43147,37569,allow,237,71,166,2,30,1,1
47013,37965,0,0,deny,62,62,0,1,0,1,0
55027,53,65292,53,allow,343,86,257,4,58,2,2
55979,53,16779,53,allow,184,102,82,2,29,1,1
61334,445,0,0,drop,66,66,0,1,0,1,0
64947,445,0,0,drop,70,70,0,1,0,1,0
3478,61463,0,0,deny,1275,1275,0,1,0,1,0
1903,43890,0,0,deny,62,62,0,1,0,1,0
65159,53,20643,53,allow,286,103,183,4,51,2,2
62026,445,0,0,drop,70,70,0,1,0,1,0
56663,443,26392,443,allow,9691,2221,7470,16,120,8,8
57095,53,1337,53,allow,211,110,101,2,29,1,1
40054,62413,0,0,deny,62,62,0,1,0,1,0
25187,31573,0,0,deny,62,62,0,1,0,1,0
47795,443,48531,443,allow,8708,3949,4759,22,21,11,11
15986,8000,14701,8000,allow,274,150,124,4,61,2,2
56872,21247,0,0,deny,70,70,0,1,0,1,0
53846,445,0,0,drop,70,70,0,1,0,1,0
60045,445,0,0,drop,70,70,0,1,0,1,0
59736,51505,0,0,deny,62,62,0,1,0,1,0
51945,1587,2517,1587,allow,66,66,0,1,5,1,0
57629,445,0,0,drop,70,70,0,1,0,1,0
62234,443,62234,443,allow,187597,6822,180775,203,92,67,136
60342,7000,60342,7000,allow,3114,1659,1455,17,15,9,8
49386,64147,0,0,deny,62,62,0,1,0,1,0
55733,445,0,0,drop,66,66,0,1,0,1,0
63812,445,0,0,drop,70,70,0,1,0,1,0
1955,35974,0,0,deny,60,60,0,1,0,1,0
49602,80,16412,80,allow,378,192,186,7,41,4,3
65313,53,62981,53,allow,166,86,80,2,30,1,1
52951,445,0,0,drop,70,70,0,1,0,1,0
57132,53,39108,53,allow,216,110,106,2,30,1,1
63813,53455,10491,53455,allow,70,70,0,1,5,1,0
50265,7205,64572,7205,allow,1488,930,558,21,1200,12,9
55000,53,36007,53,allow,193,102,91,2,31,1,1
19520,7000,19520,7000,allow,4579,2182,2397,16,17,9,7
49687,53,24599,53,allow,775,103,672,2,31,1,1
50293,445,0,0,drop,70,70,0,1,0,1,0
61449,445,0,0,drop,66,66,0,1,0,1,0
42298,40007,10253,40007,allow,273,73,200,4,29,2,2
50389,8080,50389,8080,allow,5724,1509,4215,18,55,10,8
46734,50265,0,0,deny,74,74,0,1,0,1,0
5223,44091,0,0,deny,66,66,0,1,0,1,0
49259,53,28989,53,allow,168,86,82,2,30,1,1
52013,443,52013,443,allow,43964,6675,37289,60,49,25,35
63027,35440,0,0,deny,66,66,0,1,0,1,0
60419,33709,17912,33709,allow,504,318,186,8,16,5,3
1024,44847,0,0,deny,62,62,0,1,0,1,0
56765,53,64406,53,allow,194,102,92,2,29,1,1
65355,53,46648,53,allow,592,105,487,4,50,2,2
45682,8055,0,0,deny,159,159,0,1,0,1,0
64695,53,52435,53,allow,193,102,91,2,30,1,1
44870,80,28005,80,allow,1119,1045,74,7,14,6,1
57903,445,0,0,drop,70,70,0,1,0,1,0
61735,445,0,0,drop,66,66,0,1,0,1,0
54448,443,65424,443,allow,1786,172,1614,7,120,3,4
56018,53,52062,53,allow,762,97,665,2,30,1,1
51803,33973,12809,33973,allow,70,70,0,2,8,2,0
55866,443,45291,443,allow,53845,7300,46545,80,31,38,42
60760,53,0,0,allow,86,86,0,1,30,1,0
60389,445,0,0,drop,70,70,0,1,0,1,0
13947,37965,0,0,deny,145,145,0,1,0,1,0
25061,53,25061,53,allow,214,82,132,2,32,1,1
52743,15503,0,0,deny,66,66,0,1,0,1,0
64303,53,57962,53,allow,177,94,83,2,29,1,1
58638,5900,0,0,deny,62,62,0,1,0,1,0
59701,443,37154,443,allow,6155,1819,4336,18,181,8,10
21447,53,55331,53,allow,245648,213726,31922,2763,89,2579,184
65519,53,27344,53,allow,321,102,219,2,30,1,1
35055,80,30586,80,allow,3650999,83941,3567058,3541,21,1184,2357
30574,64147,0,0,deny,62,62,0,1,0,1,0
51701,445,0,0,drop,66,66,0,1,0,1,0
49396,53,32920,53,allow,177,94,83,2,29,1,1
60958,443,2953,443,allow,1547,960,587,14,17,8,6
57284,22114,0,0,deny,62,62,0,1,0,1,0
42356,443,3759,443,allow,276,70,206,5,26,2,3
65047,53,45819,53,allow,206,91,115,2,30,1,1
53872,24710,13948,24710,allow,70,70,0,1,5,1,0
40611,9571,0,0,deny,72,72,0,1,0,1,0
58582,50584,0,0,deny,66,66,0,1,0,1,0
64248,445,0,0,drop,66,66,0,1,0,1,0
63714,48477,18811,48477,allow,70,70,0,1,4,1,0
52944,23,0,0,deny,60,60,0,1,0,1,0
27773,56205,0,0,deny,62,62,0,1,0,1,0
1827,64147,0,0,deny,66,66,0,1,0,1,0
63866,17623,35380,17623,allow,66,66,0,2,8,2,0
56719,53,51859,53,allow,185,102,83,2,30,1,1
49654,445,0,0,drop,66,66,0,1,0,1,0
53376,22114,0,0,deny,146,146,0,1,0,1,0
19394,44847,0,0,deny,66,66,0,1,0,1,0
49867,53,28958,53,allow,232,110,122,2,30,1,1
58638,5900,0,0,deny,62,62,0,1,0,1,0
63989,53,19416,53,allow,259,110,149,2,30,1,1
50922,80,57250,80,allow,9219616,105865,9113751,7687,120,1487,6200
50707,445,0,0,drop,70,70,0,1,0,1,0
56195,53,13348,53,allow,194,94,100,2,30,1,1
65229,53,45181,53,allow,195,102,93,2,31,1,1
61252,445,0,0,drop,70,70,0,1,0,1,0
64276,53,63257,53,allow,398,105,293,4,46,2,2
63316,445,0,0,drop,70,70,0,1,0,1,0
38660,15000,20760,15000,allow,138,78,60,2,5,1,1
54542,25604,0,0,deny,66,66,0,1,0,1,0
64880,445,0,0,drop,70,70,0,1,0,1,0
54472,443,49806,443,allow,6732,2308,4424,21,141,9,12
51164,445,0,0,drop,70,70,0,1,0,1,0
64490,53,23595,53,allow,280,118,162,2,30,1,1
28832,36237,0,0,deny,62,62,0,1,0,1,0
49496,53,24067,53,allow,194,102,92,2,30,1,1
20508,57470,0,0,deny,62,62,0,1,0,1,0
64483,445,0,0,drop,70,70,0,1,0,1,0
59234,21247,0,0,deny,62,62,0,1,0,1,0
57035,53,11215,53,allow,1414,95,1319,4,41,2,2
64077,20208,16294,20208,allow,66,66,0,2,8,2,0
49418,27055,11921,27055,allow,269,78,191,2,30,1,1
56205,53,15763,53,allow,240,110,130,2,30,1,1
59191,35440,0,0,deny,62,62,0,1,0,1,0
50332,53,15195,53,allow,193,102,91,2,29,1,1
46663,53,46663,53,allow,209,83,126,2,30,1,1
50468,443,35607,443,allow,227265,6450,220815,225,124,63,162
54390,445,0,0,drop,70,70,0,1,0,1,0
41898,22114,0,0,deny,146,146,0,1,0,1,0
57991,22114,0,0,deny,66,66,0,1,0,1,0
52740,443,65500,443,allow,168753,7954,160799,212,26,95,117
56521,32480,0,0,deny,62,62,0,1,0,1,0
64540,53,58172,53,allow,174,89,85,2,30,1,1
57411,53,32246,53,allow,196,102,94,2,29,1,1
64806,53,37126,53,allow,211,102,109,2,29,1,1
54306,445,0,0,drop,70,70,0,1,0,1,0
56648,80,59981,80,allow,234,234,0,4,12,4,0
58638,5900,0,0,deny,62,62,0,1,0,1,0
55320,53,12991,53,allow,239,102,137,2,30,1,1
60728,445,0,0,drop,70,70,0,1,0,1,0
58874,443,39745,443,allow,21478,2212,19266,47,86,19,28
56041,53,26244,53,allow,179,94,85,2,30,1,1
49855,53,11171,53,allow,290,102,188,2,30,1,1
47682,64147,0,0,deny,66,66,0,1,0,1,0
48629,63131,0,0,deny,74,74,0,1,0,1,0
64463,53,17671,53,allow,183,94,89,2,30,1,1
55347,443,36174,443,allow,3811,2320,1491,33,735,18,15
49494,443,9142,443,allow,4168,1018,3150,16,27,8,8
63950,53,13148,53,allow,200,102,98,2,31,1,1
47969,53,59484,53,allow,199,94,105,2,30,1,1
64332,53,46508,53,allow,167,86,81,2,30,1,1
53845,445,0,0,drop,70,70,0,1,0,1,0
55057,53,53863,53,allow,211,110,101,2,30,1,1
22835,51221,0,0,deny,62,62,0,1,0,1,0
56624,53,60055,53,allow,328,87,241,4,52,2,2
53290,445,0,0,drop,66,66,0,1,0,1,0
52010,445,0,0,drop,66,66,0,1,0,1,0
56758,53,35324,53,allow,173,94,79,2,31,1,1
51962,445,0,0,drop,66,66,0,1,0,1,0
63970,53,14367,53,allow,200,94,106,2,30,1,1
50116,22,0,0,deny,60,60,0,1,0,1,0
62995,3389,62995,3389,allow,4213,2429,1784,18,32,9,9
26795,6881,0,0,deny,146,146,0,1,0,1,0
49660,53,59057,53,allow,193,102,91,2,29,1,1
60390,56494,54167,56494,allow,70,70,0,1,5,1,0
46670,51505,0,0,deny,62,62,0,1,0,1,0
64104,445,0,0,drop,70,70,0,1,0,1,0
50228,445,0,0,drop,70,70,0,1,0,1,0
60604,445,0,0,drop,70,70,0,1,0,1,0
27005,27018,47150,27018,allow,1898,378,1520,6,31,4,2
7166,64147,0,0,deny,66,66,0,1,0,1,0
48025,44847,0,0,deny,146,146,0,1,0,1,0
42241,11392,0,0,deny,66,66,0,1,0,1,0
20586,25174,0,0,deny,62,62,0,1,0,1,0
56755,31774,8678,31774,allow,378,192,186,7,15,4,3
21456,53,21456,53,allow,240,98,142,2,30,1,1
60711,53,53816,53,allow,211,78,133,2,30,1,1
55100,53,1559,53,allow,178,94,84,2,30,1,1
39626,443,37265,443,allow,5518,1323,4195,25,271,14,11
13285,29892,0,0,deny,145,145,0,1,0,1,0
63813,26467,0,0,deny,66,66,0,1,0,1,0
58638,5900,0,0,deny,62,62,0,1,0,1,0
57624,445,0,0,drop,70,70,0,1,0,1,0
50523,53,31491,53,allow,199,102,97,2,30,1,1
52930,443,25439,443,allow,4596,1029,3567,15,26,9,6
49588,443,55419,443,allow,5879,870,5009,18,53,9,9
64683,53,6623,53,allow,168,78,90,2,30,1,1
54618,53,15831,53,allow,263,86,177,2,30,1,1
60471,445,0,0,drop,70,70,0,1,0,1,0
52089,443,15915,443,allow,6032,3616,2416,39,187,20,19
37633,44847,0,0,deny,62,62,0,1,0,1,0
65378,53,49018,53,allow,212,102,110,2,30,1,1
55644,53,33807,53,allow,184,94,90,2,31,1,1
56468,53,30389,53,allow,180,94,86,2,30,1,1
54976,2273,0,0,deny,60,60,0,1,0,1,0
60214,80,20902,80,allow,8317,6126,2191,23,151,14,9
47125,8055,0,0,deny,159,159,0,1,0,1,0
59597,443,2305,443,allow,10310,2469,7841,35,255,18,17
55312,64147,0,0,deny,66,66,0,1,0,1,0
45132,443,57235,443,allow,5398,3277,2121,30,80,16,14
56146,445,0,0,drop,70,70,0,1,0,1,0
46694,443,30947,443,allow,3680,1777,1903,18,34,8,10
58303,22114,0,0,deny,62,62,0,1,0,1,0
49524,445,0,0,drop,66,66,0,1,0,1,0
56144,53,58343,53,allow,176,90,86,2,31,1,1
35601,80,28025,80,allow,1151,711,440,10,15,5,5
58129,80,58129,80,allow,23462,3780,19682,49,47,24,25
56622,53,31873,53,allow,214,110,104,2,30,1,1
50854,445,0,0,drop,66,66,0,1,0,1,0
55926,53,56818,53,allow,184,94,90,2,29,1,1
37633,443,4674,443,allow,8493,2314,6179,33,16,18,15
443,62451,0,0,deny,199,199,0,1,0,1,0
27005,33056,50628,33056,allow,885,126,759,2,31,1,1
63334,37807,0,0,deny,66,66,0,1,0,1,0
53952,26973,7961,26973,allow,70,70,0,1,4,1,0
50584,58516,43586,58516,allow,161,161,0,1,1200,1,0
65065,53,49362,53,allow,754,94,660,2,31,1,1
56414,53,33736,53,allow,178,94,84,2,31,1,1
35423,443,35423,443,allow,4555,1648,2907,20,29,12,8
55616,56205,0,0,deny,62,62,0,1,0,1,0
49892,443,65121,443,allow,1820,1101,719,18,73,10,8
60714,445,0,0,drop,66,66,0,1,0,1,0
53113,445,0,0,drop,66,66,0,1,0,1,0
53207,50584,0,0,deny,66,66,0,1,0,1,0
57356,53,26396,53,allow,199,102,97,2,30,1,1
46492,80,56877,80,allow,1967,1133,834,12,45,7,5
9257,443,25692,443,allow,6327,833,5494,19,26,10,9
49777,53,49271,53,allow,168,78,90,2,31,1,1
61414,443,14574,443,allow,5020,860,4160,18,28,9,9
64180,53,4267,53,allow,180,94,86,2,30,1,1
50512,80,4579,80,allow,318,192,126,6,25,4,2
53805,443,64828,443,allow,499,425,74,4,0,3,1
57114,35440,0,0,deny,146,146,0,1,0,1,0
61494,445,0,0,drop,70,70,0,1,0,1,0
51992,22670,60663,22670,allow,70,70,0,2,7,2,0
52121,58933,17101,58933,allow,70,70,0,2,8,2,0
56748,80,43315,80,allow,194,128,66,4,25,3,1
50584,49001,36650,49001,allow,1290,300,990,6,1200,3,3
30303,19391,0,0,deny,181,181,0,1,0,1,0
54268,445,0,0,drop,66,66,0,1,0,1,0
64959,53,12342,53,allow,209,110,99,2,30,1,1
46767,443,3623,443,allow,8376,2231,6145,25,330,12,13
443,64347,0,0,deny,131,131,0,1,0,1,0
45896,443,44655,443,allow,211720,46699,165021,332,109,152,180
64169,53,50395,53,allow,209,102,107,2,30,1,1
56952,53,53652,53,allow,487,136,351,4,46,2,2
55067,443,14245,443,allow,1146,360,786,20,75,7,13
55755,445,0,0,drop,66,66,0,1,0,1,0
49418,27015,50232,27015,allow,286,78,208,2,31,1,1
51988,32239,6773,32239,allow,70,70,0,2,8,2,0
56088,53,17141,53,allow,774,101,673,2,30,1,1
61550,5529,0,0,deny,145,145,0,1,0,1,0
54241,443,12202,443,allow,499,425,74,4,0,3,1
62651,445,0,0,drop,70,70,0,1,0,1,0
21268,62609,0,0,deny,146,146,0,1,0,1,0
50669,53,9177,53,allow,578,286,292,9,16,5,4
55985,53,10494,53,allow,711,87,624,2,30,1,1
56955,53,1466,53,allow,183,94,89,2,30,1,1
57617,445,0,0,drop,70,70,0,1,0,1,0
34914,26467,0,0,deny,62,62,0,1,0,1,0
60428,25174,0,0,deny,66,66,0,1,0,1,0
58250,35440,0,0,deny,62,62,0,1,0,1,0
34980,443,26995,443,allow,8211,2165,6046,25,361,13,12
33524,10387,0,0,deny,159,159,0,1,0,1,0
62230,443,62230,443,allow,119850,11021,108829,134,95,50,84
56770,443,17971,443,allow,7889,1900,5989,20,15,11,9
55911,53,35640,53,allow,211,110,101,2,30,1,1
53248,443,8243,443,allow,5995,974,5021,19,66,10,9
49364,53,62830,53,allow,180,92,88,2,31,1,1
51989,80,41304,80,allow,4166,1708,2458,14,16,7,7
53022,25174,0,0,deny,66,66,0,1,0,1,0
52235,48910,47820,48910,allow,136,136,0,3,14,3,0
24351,57470,0,0,deny,62,62,0,1,0,1,0
58255,50584,0,0,deny,62,62,0,1,0,1,0
51884,22828,1526,22828,allow,70,70,0,1,5,1,0
58026,445,0,0,drop,66,66,0,1,0,1,0
50454,80,50454,80,allow,450,246,204,8,33,5,3
49983,53,2734,53,allow,211,110,101,2,30,1,1
56773,443,51568,443,allow,7941,1952,5989,20,15,11,9
34756,8055,0,0,deny,159,159,0,1,0,1,0
55286,53,22881,53,allow,268,87,181,4,35,2,2
58922,443,2924,443,allow,14553,9653,4900,38,19,22,16
63442,445,0,0,drop,66,66,0,1,0,1,0
65507,53,44287,53,allow,199,102,97,2,30,1,1
52870,445,0,0,drop,66,66,0,1,0,1,0
61033,445,0,0,drop,70,70,0,1,0,1,0
55346,53,15239,53,allow,199,94,105,2,30,1,1
61640,445,0,0,drop,66,66,0,1,0,1,0
50526,445,0,0,drop,66,66,0,1,0,1,0
51805,15298,11456,15298,allow,70,70,0,2,8,2,0
31738,51505,0,0,deny,62,62,0,1,0,1,0
52139,38259,26811,38259,allow,70,70,0,1,4,1,0
59630,445,0,0,drop,66,66,0,1,0,1,0
57855,443,34807,443,allow,4370,3370,1000,19,187,10,9
57107,64147,0,0,deny,62,62,0,1,0,1,0
59444,445,0,0,drop,70,70,0,1,0,1,0
53844,443,56188,443,allow,499,425,74,4,0,3,1
56846,53,43478,53,allow,196,102,94,2,30,1,1
65344,46824,0,0,deny,66,66,0,1,0,1,0
60288,445,0,0,drop,66,66,0,1,0,1,0
50369,80,41191,80,allow,318,192,126,6,28,4,2
55965,53,4442,53,allow,184,94,90,2,30,1,1
50481,443,29111,443,allow,16160,13969,2191,42,80,23,19
56679,53,5371,53,allow,216,102,114,2,30,1,1
49812,53,4769,53,allow,166,86,80,2,30,1,1
35957,51185,0,0,deny,60,60,0,1,0,1,0
62465,445,0,0,drop,70,70,0,1,0,1,0
53164,48198,7411,48198,allow,320,140,180,6,7,3,3
57054,53,38199,53,allow,164,78,86,2,30,1,1
50395,445,0,0,drop,66,66,0,1,0,1,0
49203,53,1575,53,allow,195,102,93,2,30,1,1
3478,61463,0,0,deny,174,174,0,1,0,1,0
63513,53,63513,53,allow,236,94,142,2,30,1,1
53737,51456,42714,51456,allow,70,70,0,1,5,1,0
50430,53,3410,53,allow,789,102,687,2,30,1,1
56691,443,29213,443,allow,7862,1873,5989,20,15,11,9
52095,443,5865,443,allow,3023,2045,978,15,15,9,6
49971,445,0,0,drop,66,66,0,1,0,1,0
41959,443,65186,443,allow,5838,1840,3998,20,80,12,8
61287,445,0,0,drop,66,66,0,1,0,1,0
57231,445,0,0,drop,70,70,0,1,0,1,0
35319,51505,0,0,deny,62,62,0,1,0,1,0
54996,53,39612,53,allow,168,86,82,2,35,1,1
53133,34853,20354,34853,allow,758,320,438,11,16,6,5
5228,3434,0,0,deny,345,345,0,1,0,1,0
5357,32468,0,0,deny,66,66,0,1,0,1,0
57581,443,57581,443,allow,2512,1465,1047,21,87,10,11
50703,80,3596,80,allow,54304,27807,26497,227,175,113,114
24768,22114,0,0,deny,146,146,0,1,0,1,0
10115,52700,0,0,deny,62,62,0,1,0,1,0
64215,445,0,0,drop,70,70,0,1,0,1,0
38723,15503,0,0,deny,146,146,0,1,0,1,0
55674,5900,0,0,deny,60,60,0,1,0,1,0
36357,25174,0,0,deny,66,66,0,1,0,1,0
51139,80,1947,80,allow,124,64,60,2,15,1,1
64074,53,19017,53,allow,209,110,99,2,30,1,1
56909,53,4449,53,allow,260,86,174,2,30,1,1
65300,53,18303,53,allow,195,102,93,2,31,1,1
49166,53,17612,53,allow,322,102,220,2,30,1,1
61099,443,33626,443,allow,492,492,0,7,15,7,0
62867,445,0,0,drop,70,70,0,1,0,1,0
15465,64147,0,0,deny,66,66,0,1,0,1,0
49414,443,32360,443,allow,11485,3381,8104,39,124,23,16
40203,80,61605,80,allow,28577,1878,26699,47,31,23,24
51814,445,0,0,drop,66,66,0,1,0,1,0
50746,443,34629,443,allow,8422,1676,6746,25,16,13,12
49765,443,44439,443,allow,17982,2337,15645,34,127,16,18
64693,53,28781,53,allow,248,102,146,2,30,1,1
63076,445,0,0,drop,70,70,0,1,0,1,0
5222,48709,0,0,deny,66,66,0,1,0,1,0
50100,53,23176,53,allow,216,110,106,2,30,1,1
63557,445,0,0,drop,70,70,0,1,0,1,0
62191,445,0,0,drop,70,70,0,1,0,1,0
56588,53,28936,53,allow,194,99,95,2,30,1,1
49948,53,31917,53,allow,177,94,83,2,30,1,1
50478,445,0,0,drop,70,70,0,1,0,1,0
55673,53,34311,53,allow,179,94,85,2,31,1,1
7231,53,7231,53,allow,215,80,135,2,33,1,1
49572,443,38388,443,allow,11583,4967,6616,31,47,17,14
64780,53,56336,53,allow,203,86,117,2,29,1,1
55730,8060,62180,8060,allow,70,70,0,2,7,2,0
53178,26467,0,0,deny,62,62,0,1,0,1,0
50682,445,0,0,drop,70,70,0,1,0,1,0
1865,25174,0,0,deny,62,62,0,1,0,1,0
62458,53,43371,53,allow,429,102,327,2,31,1,1
49621,53,59180,53,allow,287,93,194,4,56,2,2
44847,31105,50353,31105,allow,324,150,174,2,1200,1,1
61463,445,0,0,drop,66,66,0,1,0,1,0
57030,53,42325,53,allow,283,101,182,4,37,2,2
49317,53,41699,53,allow,168,78,90,2,30,1,1
50210,1688,19159,1688,allow,70,70,0,2,8,2,0
51716,445,0,0,drop,70,70,0,1,0,1,0
56546,443,24280,443,allow,134,60,74,3,5,2,1
58555,445,0,0,drop,70,70,0,1,0,1,0
10151,60419,62503,60419,allow,479,150,329,2,1200,1,1
57987,3478,22536,3478,allow,312,140,172,4,30,2,2
53140,51221,0,0,deny,74,74,0,1,0,1,0
64853,53,20032,53,allow,199,102,97,2,30,1,1
64332,53,12232,53,allow,195,102,93,2,30,1,1
50982,445,0,0,drop,70,70,0,1,0,1,0
48713,80,47813,80,allow,1767,751,1016,10,15,6,4
53929,60741,10876,60741,allow,320,140,180,6,6,3,3
52552,445,0,0,drop,66,66,0,1,0,1,0
54057,445,0,0,drop,70,70,0,1,0,1,0
59876,44847,0,0,deny,66,66,0,1,0,1,0
40204,40018,64999,40018,allow,150,88,62,2,30,1,1
59847,443,26253,443,allow,11950,1590,10360,33,90,16,17
55359,445,0,0,drop,70,70,0,1,0,1,0
56006,53,56453,53,allow,200,102,98,2,30,1,1
60021,443,37470,443,allow,346221,14712,331509,474,107,211,263
56834,53,24622,53,allow,178,94,84,2,29,1,1
65138,445,0,0,drop,66,66,0,1,0,1,0
56014,53,32746,53,allow,711,87,624,2,30,1,1
52926,443,36627,443,allow,5458,1390,4068,17,15,9,8
39981,57470,0,0,deny,62,62,0,1,0,1,0
64068,445,0,0,drop,70,70,0,1,0,1,0
50899,80,61517,80,allow,130,70,60,2,15,1,1
63226,443,50931,443,allow,4462,2023,2439,33,125,17,16
58854,443,61370,443,allow,19134,6811,12323,39,83,18,21
60504,445,0,0,drop,66,66,0,1,0,1,0
20012,311,0,0,deny,60,60,0,1,0,1,0
55816,53,60578,53,allow,214,110,104,2,31,1,1
40626,443,40626,443,allow,7772,2569,5203,23,148,13,10
47046,80,21371,80,allow,1114,534,580,12,15,7,5
53546,46824,0,0,deny,66,66,0,1,0,1,0
50810,445,0,0,drop,70,70,0,1,0,1,0
55334,445,0,0,drop,70,70,0,1,0,1,0
58988,443,31183,443,allow,4330,1777,2553,18,122,9,9
64535,37965,0,0,deny,66,66,0,1,0,1,0
23383,64147,0,0,deny,62,62,0,1,0,1,0
27898,52700,0,0,deny,62,62,0,1,0,1,0
51861,445,0,0,drop,70,70,0,1,0,1,0
56386,53,13942,53,allow,170,87,83,2,31,1,1
63112,443,43251,443,allow,3695,2713,982,21,82,12,9
49774,443,35552,443,allow,26623,5756,20867,42,126,18,24
26531,25174,0,0,deny,62,62,0,1,0,1,0
51820,53738,51101,53738,allow,66,66,0,2,8,2,0
50976,445,0,0,drop,66,66,0,1,0,1,0
59743,445,0,0,drop,70,70,0,1,0,1,0
9225,443,21069,443,allow,5510,901,4609,15,25,8,7
3497,53,3497,53,allow,222,90,132,2,30,1,1
5222,1504,0,0,deny,66,66,0,1,0,1,0
26961,443,26961,443,allow,1251,722,529,11,147,6,5
64092,14447,29856,14447,allow,66,66,0,1,5,1,0
50258,445,0,0,drop,70,70,0,1,0,1,0
57959,21247,0,0,deny,66,66,0,1,0,1,0
52543,445,0,0,drop,66,66,0,1,0,1,0
65318,53,63246,53,allow,294,94,200,4,51,2,2
53766,3596,6099,3596,allow,70,70,0,1,4,1,0
61973,53,11068,53,allow,222,94,128,2,30,1,1
55711,53,2553,53,allow,728,96,632,2,30,1,1
9155,443,45491,443,allow,5734,498,5236,14,15,7,7
42819,443,36580,443,allow,10837,3411,7426,34,272,17,17
16330,50584,0,0,deny,146,146,0,1,0,1,0
53637,443,7341,443,allow,8473,1099,7374,20,119,9,11
23770,50584,0,0,deny,62,62,0,1,0,1,0
65179,53,56146,53,allow,184,94,90,2,30,1,1
20487,50584,0,0,deny,62,62,0,1,0,1,0
51886,445,0,0,drop,70,70,0,1,0,1,0
52407,443,53495,443,allow,100194,6406,93788,171,24,85,86
62579,445,0,0,drop,70,70,0,1,0,1,0
54805,443,42817,443,allow,19635,9923,9712,165,588,72,93
38445,443,60732,443,allow,23571,4700,18871,60,48,30,30
65290,53,6842,53,allow,181,94,87,2,29,1,1
9381,53,9381,53,allow,200,90,110,2,30,1,1
49874,445,0,0,drop,70,70,0,1,0,1,0
56935,53,37247,53,allow,174,89,85,2,31,1,1
30129,37965,0,0,deny,72,72,0,1,0,1,0
49295,53,61148,53,allow,164,86,78,2,29,1,1
55768,443,42706,443,allow,5263,2534,2729,16,120,8,8
36452,53,36452,53,allow,226,106,120,2,29,1,1
49862,53,40662,53,allow,180,94,86,2,30,1,1
53026,445,0,0,drop,70,70,0,1,0,1,0
55596,14795,19064,14795,allow,630,444,186,9,16,6,3
36419,50584,0,0,deny,62,62,0,1,0,1,0
46438,53,32231,53,allow,222,78,144,2,30,1,1
27005,27015,45042,27015,allow,878,126,752,2,30,1,1
54992,53,53080,53,allow,195,102,93,2,29,1,1
53462,445,0,0,drop,70,70,0,1,0,1,0
56853,443,46609,443,allow,7092,1795,5297,25,32,14,11
49364,53,15202,53,allow,182,94,88,2,30,1,1
60553,443,11360,443,allow,7981,1867,6114,32,313,17,15
47396,23,0,0,deny,60,60,0,1,0,1,0
54262,53,54262,53,allow,216,82,134,2,33,1,1
50464,445,0,0,drop,70,70,0,1,0,1,0
49516,80,21754,80,allow,1256,746,510,11,70,6,5
48817,51417,48817,51417,allow,485,158,327,2,1200,1,1
63456,37965,0,0,deny,62,62,0,1,0,1,0
64155,53,47794,53,allow,182,93,89,2,31,1,1
53314,64097,0,0,deny,62,62,0,1,0,1,0
58924,443,40571,443,allow,5168,700,4468,16,15,7,9
65246,53,35369,53,allow,179,94,85,2,30,1,1
50023,53,49657,53,allow,166,86,80,2,29,1,1
35112,443,57886,443,allow,3242,1248,1994,26,362,7,19
56730,53,28037,53,allow,177,94,83,2,30,1,1
49363,53,19246,53,allow,212,110,102,2,29,1,1
48768,443,48768,443,allow,4398,1491,2907,19,27,11,8
60550,50584,0,0,deny,62,62,0,1,0,1,0
51961,443,54912,443,allow,2600,1396,1204,18,48,10,8
61702,445,0,0,drop,70,70,0,1,0,1,0
57164,443,51715,443,allow,522,78,444,8,22,2,6
60240,443,63324,443,allow,4310,2523,1787,42,120,24,18
53626,33194,63366,33194,allow,70,70,0,1,4,1,0
52410,8604,0,0,deny,66,66,0,1,0,1,0
49758,443,14307,443,allow,17412,6917,10495,38,63,20,18
64787,53,24820,53,allow,740,93,647,2,31,1,1
61826,443,61826,443,allow,95212,17857,77355,119,175,53,66
37522,22114,0,0,deny,62,62,0,1,0,1,0
10701,11392,0,0,deny,62,62,0,1,0,1,0
31745,2323,0,0,deny,60,60,0,1,0,1,0
2487,53,2487,53,allow,235,90,145,2,33,1,1
55651,445,0,0,drop,70,70,0,1,0,1,0
58832,445,0,0,drop,70,70,0,1,0,1,0
59792,443,33674,443,allow,12836,2016,10820,48,361,20,28
26900,27017,61520,27017,allow,422,164,258,6,31,3,3
57324,445,0,0,drop,70,70,0,1,0,1,0
61295,445,0,0,drop,70,70,0,1,0,1,0
20005,37965,0,0,deny,62,62,0,1,0,1,0
53446,445,0,0,drop,70,70,0,1,0,1,0
60823,25174,0,0,deny,62,62,0,1,0,1,0
56628,80,40894,80,allow,234,234,0,4,11,4,0
62991,51221,0,0,deny,66,66,0,1,0,1,0
49537,80,13843,80,allow,5514,3156,2358,21,66,15,6
11716,37965,0,0,deny,62,62,0,1,0,1,0
50437,80,64833,80,allow,314,192,122,6,26,4,2
51221,57274,16024,57274,allow,528,528,0,9,1201,9,0
55920,445,0,0,drop,66,66,0,1,0,1,0
45979,80,24142,80,allow,1638,1324,314,10,15,5,5
24219,1900,0,0,deny,60,60,0,1,0,1,0
38275,443,49031,443,allow,448,78,370,6,25,1,5
48656,80,8880,80,allow,1114,534,580,12,15,7,5
33949,80,17456,80,allow,1360,540,820,20,191,10,10
58638,5900,0,0,deny,62,62,0,1,0,1,0
55810,53,11576,53,allow,183,94,89,2,29,1,1
63987,58476,60558,58476,allow,504,382,122,8,16,6,2
63616,443,48346,443,allow,1296,612,684,18,120,9,9
61707,80,47062,80,allow,134,60,74,3,4,2,1
60407,443,16001,443,allow,7298,1737,5561,21,79,11,10
4111,25174,0,0,deny,146,146,0,1,0,1,0
59458,445,0,0,drop,66,66,0,1,0,1,0
40009,443,48154,443,allow,21785,5577,16208,35,362,16,19
62400,445,0,0,drop,70,70,0,1,0,1,0
58314,445,0,0,drop,66,66,0,1,0,1,0
54695,445,0,0,drop,70,70,0,1,0,1,0
60169,445,0,0,drop,70,70,0,1,0,1,0
10736,35440,0,0,deny,66,66,0,1,0,1,0
26847,443,30937,443,allow,10585,3919,6666,33,80,16,17
50124,445,0,0,drop,70,70,0,1,0,1,0
40204,40007,54780,40007,allow,140,78,62,2,31,1,1
60666,445,0,0,drop,70,70,0,1,0,1,0
53009,80,53009,80,allow,378,180,198,7,17,4,3
64819,53,53319,53,allow,198,94,104,2,30,1,1
49290,53,29478,53,allow,184,94,90,2,30,1,1
60890,443,40246,443,allow,15081,6817,8264,31,34,14,17
55210,445,0,0,drop,66,66,0,1,0,1,0
55965,53,59955,53,allow,184,94,90,2,29,1,1
57421,80,60577,80,allow,4507,2978,1529,13,15,6,7
47821,443,31829,443,allow,71624,60795,10829,194,131,110,84
58148,43890,0,0,deny,66,66,0,1,0,1,0
60148,445,0,0,drop,70,70,0,1,0,1,0
49418,27014,18652,27014,allow,249,78,171,2,31,1,1
50631,80,34721,80,allow,14784,7048,7736,31,27,18,13
60069,443,38195,443,allow,3045,1340,1705,16,141,8,8
59937,18375,0,0,deny,66,66,0,1,0,1,0
54960,443,1507,443,allow,17670,2044,15626,53,316,21,32
37339,443,37972,443,allow,130,70,60,3,5,2,1
62512,445,0,0,drop,70,70,0,1,0,1,0
62821,445,0,0,drop,66,66,0,1,0,1,0
57955,44847,0,0,deny,62,62,0,1,0,1,0
64841,53,21377,53,allow,173,94,79,2,30,1,1
62393,445,0,0,drop,70,70,0,1,0,1,0
59845,443,19704,443,allow,14702,1976,12726,28,18,10,18
55609,443,14768,443,allow,13039,4388,8651,93,1191,47,46
6881,6881,0,0,deny,62,62,0,1,0,1,0
62415,53,11045,53,allow,86,86,0,2,31,2,0
59032,25174,0,0,deny,66,66,0,1,0,1,0
20844,64147,0,0,deny,66,66,0,1,0,1,0
38369,15000,42954,15000,allow,130,70,60,2,6,1,1
54329,443,26217,443,allow,5850,1617,4233,28,127,13,15
30960,45744,39744,45744,allow,330,330,0,6,3609,6,0
56825,53,56167,53,allow,177,94,83,2,30,1,1
60921,443,60921,443,allow,4886,1530,3356,17,17,10,7
56246,53,30677,53,allow,209,110,99,2,30,1,1
55825,52700,0,0,deny,66,66,0,1,0,1,0
42090,443,42090,443,allow,3509,1693,1816,21,96,10,11
56997,53,24700,53,allow,337,107,230,4,34,2,2
55271,445,0,0,drop,66,66,0,1,0,1,0
62562,445,0,0,drop,66,66,0,1,0,1,0
35666,22114,0,0,deny,62,62,0,1,0,1,0
47808,53,24079,53,allow,168,78,90,2,30,1,1
57015,42707,0,0,deny,62,62,0,1,0,1,0
29177,44847,0,0,deny,66,66,0,1,0,1,0
44256,3389,44256,3389,allow,4145,1976,2169,22,18,13,9
59843,445,0,0,drop,70,70,0,1,0,1,0
33832,55108,0,0,deny,148,148,0,1,0,1,0
57340,53,41414,53,allow,711,87,624,2,30,1,1
52655,15503,0,0,deny,146,146,0,1,0,1,0
64576,443,9952,443,allow,7069,1210,5859,13,120,6,7
59015,445,0,0,drop,66,66,0,1,0,1,0
38635,443,21019,443,allow,4089,1965,2124,25,83,13,12
56568,53,6901,53,allow,365,105,260,4,47,2,2
49738,53,2728,53,allow,215,102,113,2,30,1,1
16403,16386,51369,16386,allow,122,62,60,2,29,1,1
65513,53,29862,53,allow,195,102,93,2,31,1,1
59511,445,0,0,drop,70,70,0,1,0,1,0
40471,80,40471,80,allow,1917,1468,449,10,20,6,4
54817,443,47884,443,allow,12861,6761,6100,34,164,20,14
62930,21247,0,0,deny,66,66,0,1,0,1,0
64974,53,31114,53,allow,214,110,104,2,30,1,1
43601,443,18392,443,allow,10274,3806,6468,26,413,14,12
64306,445,0,0,drop,70,70,0,1,0,1,0
53496,443,54389,443,allow,3155,2234,921,15,16,8,7
57282,443,46130,443,allow,11721,2230,9491,39,31,22,17
58638,5900,0,0,deny,62,62,0,1,0,1,0
52633,30188,0,0,deny,66,66,0,1,0,1,0
53640,28937,48559,28937,allow,70,70,0,2,8,2,0
65421,445,0,0,drop,66,66,0,1,0,1,0
50265,48982,51729,48982,allow,480,149,331,2,1200,1,1
64097,445,0,0,drop,70,70,0,1,0,1,0
42727,443,63558,443,allow,4813,970,3843,12,135,6,6
40231,443,30990,443,allow,10401,3375,7026,33,22,17,16
55375,53,8307,53,allow,214,110,104,2,30,1,1
59451,50584,0,0,deny,66,66,0,1,0,1,0
49418,33098,30068,33098,allow,78,78,0,1,30,1,0
55201,53,9810,53,allow,168,78,90,2,30,1,1
50437,3389,50437,3389,allow,3444,1730,1714,16,31,8,8
64483,53,39103,53,allow,168,86,82,2,29,1,1
53854,445,0,0,drop,70,70,0,1,0,1,0
54956,445,0,0,drop,70,70,0,1,0,1,0
50079,443,34341,443,allow,7274,2208,5066,26,255,14,12
51507,443,1531,443,allow,584465,23057,561408,694,36,303,391
39895,26467,0,0,deny,62,62,0,1,0,1,0
49812,53,34841,53,allow,193,102,91,2,30,1,1
51971,20347,9863,20347,allow,70,70,0,2,8,2,0
50560,443,29461,443,allow,408090,25873,382217,748,137,354,394
59930,443,17395,443,allow,58431,5847,52584,55,120,10,45
53171,443,14871,443,allow,3220,2010,1210,20,19,10,10
0,0,0,0,allow,198,128,70,3,0,2,1
49175,53,59846,53,allow,186,95,91,2,30,1,1
30149,23,0,0,deny,60,60,0,1,0,1,0
63670,11648,33474,11648,allow,4501,3174,1327,26,61,16,10
63820,27441,36322,27441,allow,66,66,0,2,7,2,0
55024,443,7164,443,allow,6986,1578,5408,26,25,15,11
50759,53,50759,53,allow,225,106,119,2,30,1,1
56892,53,40383,53,allow,210,102,108,2,30,1,1
56428,30317,0,0,deny,66,66,0,1,0,1,0
56509,53,41875,53,allow,747,90,657,2,31,1,1
51963,22114,0,0,deny,66,66,0,1,0,1,0
61665,443,16320,443,allow,6279,1859,4420,25,16,14,11
63996,45759,55251,45759,allow,66,66,0,2,8,2,0
1176,64147,0,0,deny,62,62,0,1,0,1,0
33661,53,33661,53,allow,643,88,555,2,30,1,1
1030,35776,0,0,deny,139,139,0,1,0,1,0
64115,2767,0,0,deny,66,66,0,1,0,1,0
65527,53,57886,53,allow,194,94,100,2,30,1,1
52285,995,52285,995,allow,146,82,64,2,5,1,1
55452,53,61292,53,allow,184,94,90,2,30,1,1
1480,12447,0,0,deny,66,66,0,1,0,1,0
65100,53,16934,53,allow,199,102,97,2,30,1,1
51910,37965,0,0,deny,62,62,0,1,0,1,0
49491,53,15104,53,allow,492,94,398,4,45,2,2
53147,37965,0,0,deny,62,62,0,1,0,1,0
65262,80,27207,80,allow,8814,4800,4014,52,629,27,25
65067,53,22984,53,allow,327,102,225,2,30,1,1
53868,53,29458,53,allow,86,86,0,1,30,1,0
56611,53,54936,53,allow,170,87,83,2,31,1,1
55125,53,32465,53,allow,177,94,83,2,31,1,1
55212,445,0,0,drop,70,70,0,1,0,1,0
33156,3478,41500,3478,allow,338,110,228,2,300,1,1
65262,53,47231,53,allow,216,110,106,2,30,1,1
56691,443,56691,443,allow,4378,1471,2907,19,29,11,8
16570,25174,0,0,deny,62,62,0,1,0,1,0
9341,443,61165,443,allow,3835,501,3334,14,15,7,7
55423,53,31871,53,allow,177,94,83,2,31,1,1
61581,443,25669,443,allow,5103,2363,2740,11,120,6,5
49564,53,57263,53,allow,168,78,90,2,30,1,1
49791,443,35792,443,allow,20149,14507,5642,40,355,24,16
39920,22114,0,0,deny,62,62,0,1,0,1,0
37833,80,26930,80,allow,2087,729,1358,10,15,5,5
44780,80,17326,80,allow,120,120,0,3,122,3,0
64575,53,7510,53,allow,182,102,80,2,30,1,1
443,64347,0,0,deny,131,131,0,1,0,1,0
64250,53,22733,53,allow,314,102,212,2,29,1,1
20400,64147,0,0,deny,62,62,0,1,0,1,0
55379,53,30186,53,allow,256,93,163,2,31,1,1
65020,443,45828,443,allow,5507,3397,2110,13,120,7,6
60422,443,51829,443,allow,7274,1925,5349,24,138,12,12
51739,62163,31026,62163,allow,70,70,0,2,8,2,0
55606,445,0,0,drop,66,66,0,1,0,1,0
11337,15503,0,0,deny,62,62,0,1,0,1,0
53664,80,23809,80,allow,3741,3008,733,16,15,10,6
55430,445,0,0,drop,70,70,0,1,0,1,0
58770,53,51678,53,allow,168,78,90,2,31,1,1
60635,445,0,0,drop,70,70,0,1,0,1,0
49224,443,16302,443,allow,93540,22718,70822,155,918,65,90
55024,53,31814,53,allow,179,94,85,2,30,1,1
45589,53,45589,53,allow,225,106,119,2,30,1,1
56020,53,48606,53,allow,168,86,82,2,31,1,1
49713,53,44635,53,allow,177,94,83,2,30,1,1
26879,37965,0,0,deny,62,62,0,1,0,1,0
12260,51505,0,0,deny,62,62,0,1,0,1,0
56738,53,53123,53,allow,242,110,132,2,29,1,1
54993,443,50582,443,allow,38985,4250,34735,58,19,27,31
32866,443,34870,443,allow,23467,16522,6945,51,161,29,22
56512,53,52518,53,allow,889,404,485,10,31,5,5
64275,53,47758,53,allow,192,90,102,2,31,1,1
52022,445,0,0,drop,66,66,0,1,0,1,0
65319,53,38266,53,allow,285,103,182,4,43,2,2
55058,53,41146,53,allow,216,110,106,2,31,1,1
13406,22114,0,0,deny,62,62,0,1,0,1,0
63888,25174,0,0,deny,66,66,0,1,0,1,0
65249,53,14438,53,allow,1579,94,1485,4,36,2,2
49953,53,38496,53,allow,757,98,659,2,31,1,1
51916,24596,60319,24596,allow,70,70,0,1,5,1,0
65494,53,0,0,deny,88,88,0,1,0,1,0
37002,443,19218,443,allow,6646,2747,3899,20,134,10,10
63504,445,0,0,drop,70,70,0,1,0,1,0
56560,53,4551,53,allow,199,102,97,2,30,1,1
51502,443,41545,443,allow,7211,823,6388,16,15,10,6
51204,123,19622,123,allow,184,94,90,2,30,1,1
65124,53,53068,53,allow,243,102,141,2,30,1,1
59720,443,13294,443,allow,3346,1219,2127,15,136,7,8
64257,53,54453,53,allow,168,86,82,2,31,1,1
65252,445,0,0,drop,70,70,0,1,0,1,0
56296,53,27962,53,allow,216,110,106,2,30,1,1
55286,53,58993,53,allow,194,102,92,2,29,1,1
53015,64147,0,0,deny,62,62,0,1,0,1,0
56625,443,54912,443,allow,6734,2065,4669,21,16,11,10
41895,443,48920,443,allow,282,60,222,5,14,2,3
49982,53,15818,53,allow,322,94,228,4,49,2,2
49781,443,43148,443,allow,7877,1949,5928,24,126,12,12
1091,37965,0,0,deny,62,62,0,1,0,1,0
61205,445,0,0,drop,66,66,0,1,0,1,0
57221,445,0,0,drop,66,66,0,1,0,1,0
50590,80,16341,80,allow,1507,951,556,13,78,7,6
57945,445,0,0,drop,70,70,0,1,0,1,0
56258,53,24780,53,allow,167,86,81,2,30,1,1
49326,53,16602,53,allow,186,95,91,2,30,1,1
57470,6881,28610,6881,allow,396,396,0,7,1200,7,0
65228,53,63836,53,allow,267,93,174,4,46,2,2
56662,445,0,0,drop,66,66,0,1,0,1,0
54348,445,0,0,drop,70,70,0,1,0,1,0
59778,443,33771,443,allow,6723,1014,5709,19,29,10,9
53277,80,34172,80,allow,4374,1724,2650,16,150,9,7
48822,53,49162,53,allow,168,78,90,2,30,1,1
64163,445,0,0,drop,66,66,0,1,0,1,0
58703,443,1950,443,allow,15202,6356,8846,40,119,22,18
64726,53,58493,53,allow,352,94,258,2,30,1,1
11859,64147,0,0,deny,62,62,0,1,0,1,0
60432,443,46333,443,allow,4355,2135,2220,15,136,7,8
55757,53,46754,53,allow,170,87,83,2,30,1,1
51052,50584,0,0,deny,66,66,0,1,0,1,0
22983,443,22983,443,allow,205941,20753,185188,264,30,129,135
49931,53,19319,53,allow,190,97,93,2,31,1,1
56653,22114,0,0,deny,66,66,0,1,0,1,0
26854,53,44108,53,allow,222,86,136,2,30,1,1
64380,53,44055,53,allow,98,98,0,1,30,1,0
60252,443,61357,443,allow,5169,790,4379,16,72,8,8
3478,61463,0,0,deny,1063,1063,0,1,0,1,0
54955,445,0,0,drop,70,70,0,1,0,1,0
62213,445,0,0,drop,70,70,0,1,0,1,0
56101,53,64581,53,allow,194,102,92,2,30,1,1
64053,53,35360,53,allow,193,102,91,2,29,1,1
46570,443,45902,443,allow,8897,2184,6713,24,516,13,11
31201,53,38511,53,allow,197,78,119,2,30,1,1
57909,80,13139,80,allow,6510,1210,5300,15,18,8,7
49227,443,49227,443,allow,155471,20626,134845,193,95,92,101
42608,1,0,0,deny,62,62,0,1,0,1,0
62084,445,0,0,drop,70,70,0,1,0,1,0
64273,445,0,0,drop,66,66,0,1,0,1,0
25469,81,0,0,deny,60,60,0,1,0,1,0
55651,53,17505,53,allow,199,102,97,2,30,1,1
64872,53,24466,53,allow,730,102,628,2,29,1,1
56419,53,8331,53,allow,198,101,97,2,30,1,1
63797,47784,12377,47784,allow,66,66,0,2,8,2,0
50134,53,55373,53,allow,748,106,642,2,30,1,1
52406,443,12118,443,allow,11463,850,10613,23,25,7,16
52526,30188,0,0,deny,66,66,0,1,0,1,0
39297,443,18589,443,allow,21690,2882,18808,59,197,30,29
65224,53,46834,53,allow,197,102,95,2,30,1,1
50425,445,0,0,drop,66,66,0,1,0,1,0
54986,445,0,0,drop,70,70,0,1,0,1,0
62068,64147,0,0,deny,66,66,0,1,0,1,0
25797,30188,0,0,deny,146,146,0,1,0,1,0
52252,46314,0,0,deny,62,62,0,1,0,1,0
53539,44847,0,0,deny,66,66,0,1,0,1,0
63895,43729,42252,43729,allow,66,66,0,2,7,2,0
56778,35440,0,0,deny,62,62,0,1,0,1,0
52887,37807,0,0,deny,66,66,0,1,0,1,0
443,44683,0,0,deny,83,83,0,1,0,1,0
64245,53,8045,53,allow,198,101,97,2,31,1,1
58370,443,50234,443,allow,6277528,124223,6153305,5970,160,1890,4080
63883,445,0,0,drop,70,70,0,1,0,1,0
56516,445,0,0,drop,66,66,0,1,0,1,0
60301,443,3566,443,allow,7515,2022,5493,21,144,11,10
58638,5900,0,0,deny,62,62,0,1,0,1,0
55887,53,55834,53,allow,166,86,80,2,30,1,1
27005,27016,51582,27016,allow,1626,126,1500,4,30,2,2
35240,443,35240,443,allow,24155,3115,21040,55,98,27,28
51900,48817,0,0,deny,146,146,0,1,0,1,0
58638,5900,0,0,deny,62,62,0,1,0,1,0
53251,443,22293,443,allow,24116,2677,21439,42,323,17,25
58638,5900,0,0,deny,62,62,0,1,0,1,0
57034,443,8240,443,allow,30645,2719,27926,60,153,25,35
52621,443,59205,443,allow,190,70,120,4,15,2,2
64670,53,9827,53,allow,183,86,97,2,30,1,1
49631,53,32416,53,allow,323,102,221,2,30,1,1
60829,445,0,0,drop,70,70,0,1,0,1,0
50535,53,65134,53,allow,210,110,100,2,29,1,1
33424,53,33424,53,allow,233,91,142,2,30,1,1
65244,53,58540,53,allow,378,99,279,4,45,2,2
43435,5228,26335,5228,allow,6668,1369,5299,20,3600,10,10
61666,443,28189,443,allow,1786,172,1614,7,120,3,4
63971,53,59567,53,allow,358,94,264,4,45,2,2
56421,80,51921,80,allow,34300,868,33432,35,104,10,25
49998,53,44432,53,allow,94,94,0,1,30,1,0
59699,445,0,0,drop,70,70,0,1,0,1,0
48728,80,37214,80,allow,3524,2698,826,14,16,8,6
56938,80,50995,80,allow,1403,841,562,10,75,6,4
63952,53,35871,53,allow,289,102,187,2,30,1,1
65307,53,63090,53,allow,184,94,90,2,30,1,1
63677,15503,0,0,deny,66,66,0,1,0,1,0
64231,445,0,0,drop,70,70,0,1,0,1,0
56215,53,9049,53,allow,165,86,79,2,30,1,1
60126,35440,0,0,deny,62,62,0,1,0,1,0
55849,53,21168,53,allow,190,97,93,2,31,1,1
57470,6881,14174,6881,allow,490,163,327,2,1200,1,1
65102,53,16634,53,allow,210,102,108,2,30,1,1
51666,443,12470,443,allow,30210,2106,28104,46,201,17,29
59861,443,36199,443,allow,2128,828,1300,19,40,8,11
65194,53,43835,53,allow,181,94,87,2,29,1,1
64056,51266,3673,51266,allow,66,66,0,1,5,1,0
60246,44612,0,0,deny,62,62,0,1,0,1,0
6881,34190,52438,34190,allow,509,150,359,2,1200,1,1
64652,443,64652,443,allow,6792,1521,5271,18,26,11,7
55244,53,5418,53,allow,186,102,84,2,29,1,1
57225,53,35274,53,allow,177,94,83,2,30,1,1
64029,53,40003,53,allow,180,94,86,2,30,1,1
61920,53,61920,53,allow,298,114,184,2,30,1,1
50285,443,10190,443,allow,18009,7378,10631,58,62,33,25
50603,443,4652,443,allow,3443,2189,1254,23,72,13,10
53226,445,0,0,drop,70,70,0,1,0,1,0
65004,53,23515,53,allow,323,94,229,2,30,1,1
49514,443,49514,443,allow,234110,36300,197810,309,66,160,149
54489,53,0,0,allow,232,77,155,2,2,1,1
3064,44847,0,0,deny,62,62,0,1,0,1,0
0,0,0,0,deny,210,210,0,3,0,3,0
48817,45919,48817,45919,allow,334,158,176,2,1200,1,1
58685,443,52844,443,allow,165763,5072,160691,181,120,61,120
56752,53,39858,53,allow,701,88,613,2,30,1,1
59654,53,16319,53,allow,199,94,105,2,30,1,1
56733,53,13870,53,allow,170,87,83,2,30,1,1
55268,53,12955,53,allow,193,102,91,2,29,1,1
50545,445,0,0,drop,66,66,0,1,0,1,0
60007,443,50307,443,allow,2798,1652,1146,15,143,8,7
55377,53,45027,53,allow,195,102,93,2,30,1,1
17320,14914,0,0,deny,148,148,0,1,0,1,0
38859,22114,0,0,deny,66,66,0,1,0,1,0
49907,53,22787,53,allow,199,102,97,2,30,1,1
44971,443,53632,443,allow,6861,2809,4052,33,407,11,22
65442,53,44743,53,allow,262,102,160,2,29,1,1
62235,445,0,0,drop,66,66,0,1,0,1,0
65266,53,41690,53,allow,216,110,106,2,31,1,1
53844,445,0,0,drop,70,70,0,1,0,1,0
58638,5900,0,0,deny,62,62,0,1,0,1,0
65045,53,38314,53,allow,339,105,234,4,53,2,2
49449,80,5830,80,allow,1948,912,1036,13,56,7,6
55036,445,0,0,drop,66,66,0,1,0,1,0
53872,53,43483,53,allow,70,70,0,1,30,1,0
50595,443,49114,443,allow,2862,1587,1275,15,95,9,6
53241,445,0,0,drop,66,66,0,1,0,1,0
38564,443,56432,443,allow,1312,651,661,13,185,7,6
27005,27015,13591,27015,allow,880,126,754,2,30,1,1
63901,445,0,0,drop,70,70,0,1,0,1,0
20650,26467,0,0,deny,66,66,0,1,0,1,0
54854,443,6189,443,allow,32544,28348,4196,63,332,31,32
443,50238,0,0,deny,331,331,0,1,0,1,0
54280,3398,0,0,deny,60,60,0,1,0,1,0
33830,443,20220,443,allow,130,70,60,2,15,1,1
56892,53,51389,53,allow,199,102,97,2,31,1,1
39888,443,38398,443,allow,1964,1171,793,20,25,11,9
40379,53,38675,53,allow,168,78,90,2,30,1,1
51413,32480,0,0,deny,72,72,0,1,0,1,0
52391,445,0,0,drop,66,66,0,1,0,1,0
57987,3478,44464,3478,allow,312,140,172,4,30,2,2
65138,53,38637,53,allow,765,102,663,2,30,1,1
55040,443,30969,443,allow,15722,5108,10614,39,16,22,17
34873,443,26122,443,allow,236097,12185,223912,307,32,125,182
57051,443,6628,443,allow,594793,518081,76712,1350,1004,781,569
58936,443,15489,443,allow,10014,6664,3350,28,17,14,14
60192,35440,0,0,deny,62,62,0,1,0,1,0
4793,50584,0,0,deny,66,66,0,1,0,1,0
25523,35974,0,0,deny,62,62,0,1,0,1,0
57477,53,0,0,allow,186,83,103,2,30,1,1
57289,445,0,0,drop,70,70,0,1,0,1,0
53747,445,0,0,drop,70,70,0,1,0,1,0
60569,443,44105,443,allow,10385,4932,5453,21,135,9,12
34301,21247,0,0,deny,62,62,0,1,0,1,0
63990,53,19922,53,allow,270,94,176,2,30,1,1
60527,35440,0,0,deny,66,66,0,1,0,1,0
55828,53,29834,53,allow,181,94,87,2,31,1,1
39992,443,33603,443,allow,3470,1045,2425,13,121,6,7
52370,443,22287,443,allow,7058,2421,4637,21,17,11,10
58989,445,0,0,drop,70,70,0,1,0,1,0
2062,35440,0,0,deny,66,66,0,1,0,1,0
37594,443,15585,443,allow,60339,4689,55650,79,47,35,44
15585,64147,0,0,deny,66,66,0,1,0,1,0
65019,53,46989,53,allow,195,102,93,2,31,1,1
63158,445,0,0,drop,66,66,0,1,0,1,0
57011,49813,0,0,deny,66,66,0,1,0,1,0
9528,44847,0,0,deny,62,62,0,1,0,1,0
34400,39004,0,0,deny,74,74,0,1,0,1,0
46448,30170,0,0,deny,159,159,0,1,0,1,0
40204,40025,3762,40025,allow,148,86,62,2,30,1,1
59365,42873,0,0,deny,74,74,0,1,0,1,0
57369,16881,7618,16881,allow,564,318,246,9,15,5,4
6960,53,6960,53,allow,186,83,103,2,30,1,1
46215,443,1828,443,allow,161,101,60,2,5,1,1
62038,445,0,0,drop,66,66,0,1,0,1,0
56070,53,23575,53,allow,193,102,91,2,30,1,1
64708,53,37304,53,allow,437,89,348,4,48,2,2
56636,53,49408,53,allow,168,86,82,2,30,1,1
55738,445,0,0,drop,66,66,0,1,0,1,0
64914,443,15488,443,allow,6120028,157580,5962448,6108,75,2083,4025
57001,53,50963,53,allow,210,110,100,2,30,1,1
49890,443,37248,443,allow,9545,2433,7112,24,142,10,14
65291,53,24701,53,allow,195,102,93,2,30,1,1
56317,53,15827,53,allow,183,94,89,2,30,1,1
65085,53,47896,53,allow,196,94,102,2,30,1,1
47387,443,50220,443,allow,3930,392,3538,9,15,4,5
56583,53,7154,53,allow,177,94,83,2,30,1,1
58887,445,0,0,drop,66,66,0,1,0,1,0
58638,5900,0,0,deny,62,62,0,1,0,1,0
42105,53,20788,53,allow,168,78,90,2,30,1,1
64939,445,0,0,drop,70,70,0,1,0,1,0
35041,443,38147,443,allow,16010,4754,11256,47,130,20,27
54119,445,0,0,drop,66,66,0,1,0,1,0
61762,443,14583,443,allow,5975,2713,3262,24,125,12,12
64055,53,63061,53,allow,178,91,87,2,31,1,1
56478,53,62940,53,allow,200,102,98,2,30,1,1
46297,80,56497,80,allow,1155,781,374,10,15,6,4
23770,50584,0,0,deny,66,66,0,1,0,1,0
60994,443,7195,443,allow,13145,6129,7016,37,34,19,18
44228,443,22389,443,allow,2754856,125760,2629096,3115,32,1340,1775
33453,64147,0,0,deny,62,62,0,1,0,1,0
55991,445,0,0,drop,66,66,0,1,0,1,0
56568,443,49242,443,allow,1277,705,572,13,25,7,6
27005,27237,36473,27237,allow,876,126,750,2,30,1,1
40400,22114,0,0,deny,62,62,0,1,0,1,0
42963,443,15595,443,allow,7681,4711,2970,36,28,17,19
5416,53,5416,53,allow,213,79,134,2,33,1,1
52745,443,60430,443,allow,19919,2270,17649,38,26,21,17
58225,443,29188,443,allow,2484,330,2154,12,135,5,7
56672,80,18882,80,allow,234,234,0,4,11,4,0
56041,53,5205,53,allow,183,94,89,2,30,1,1
43853,443,27275,443,allow,6156,4764,1392,17,231,11,6
12965,37965,0,0,deny,66,66,0,1,0,1,0
64349,445,0,0,drop,70,70,0,1,0,1,0
65487,445,0,0,drop,70,70,0,1,0,1,0
64426,53,20042,53,allow,289,101,188,4,51,2,2
64746,445,0,0,drop,66,66,0,1,0,1,0
58638,5900,0,0,deny,62,62,0,1,0,1,0
51123,445,0,0,drop,66,66,0,1,0,1,0
55154,53,45659,53,allow,184,94,90,2,30,1,1
19747,37965,0,0,deny,62,62,0,1,0,1,0
65487,445,0,0,drop,66,66,0,1,0,1,0
37902,23718,0,0,deny,62,62,0,1,0,1,0
28424,35440,0,0,deny,66,66,0,1,0,1,0
56376,53,35947,53,allow,198,102,96,2,30,1,1
50495,53,55393,53,allow,166,86,80,2,30,1,1
57102,53,62083,53,allow,761,100,661,2,31,1,1
49754,80,3257,80,allow,1793,634,1159,11,15,6,5
57003,443,38569,443,allow,8592,3700,4892,39,108,21,18
53218,56205,0,0,deny,66,66,0,1,0,1,0
49874,53,62950,53,allow,196,94,102,2,30,1,1
55843,53,38678,53,allow,177,94,83,2,30,1,1
49414,53,16481,53,allow,770,102,668,2,31,1,1
52786,443,34018,443,allow,8160,2216,5944,22,38,14,8
53265,445,0,0,drop,70,70,0,1,0,1,0
52196,25336,19782,25336,allow,316,136,180,6,6,3,3
65189,53,21618,53,allow,734,94,640,2,29,1,1
56684,53,21413,53,allow,301,94,207,2,31,1,1
55540,53,5728,53,allow,757,98,659,2,31,1,1
31090,53,31090,53,allow,365,233,132,3,34,2,1
51841,443,41534,443,allow,1686,984,702,15,32,8,7
49001,22114,0,0,deny,62,62,0,1,0,1,0
52040,80,54028,80,allow,366,240,126,7,24,5,2
56841,443,47510,443,allow,156805,44621,112184,289,215,137,152
59403,445,0,0,drop,66,66,0,1,0,1,0
43718,53,43718,53,allow,209,77,132,2,34,1,1
57239,161,0,0,deny,85,85,0,1,0,1,0
443,56513,0,0,deny,78,78,0,1,0,1,0
7561,43890,0,0,deny,66,66,0,1,0,1,0
50717,9571,0,0,deny,62,62,0,1,0,1,0
64406,50584,0,0,deny,66,66,0,1,0,1,0
50280,445,0,0,drop,66,66,0,1,0,1,0
58638,5900,0,0,deny,62,62,0,1,0,1,0
56668,53,31919,53,allow,198,101,97,2,31,1,1
49842,7302,0,0,deny,66,66,0,1,0,1,0
60104,30188,0,0,deny,66,66,0,1,0,1,0
52328,445,0,0,drop,66,66,0,1,0,1,0
57110,445,0,0,drop,70,70,0,1,0,1,0
49194,443,50497,443,allow,159850,5338,154512,179,200,64,115
38634,443,16123,443,allow,9096,1676,7420,20,18,10,10
65128,445,0,0,drop,66,66,0,1,0,1,0
65448,53,13119,53,allow,209,110,99,2,30,1,1
65056,53,13429,53,allow,168,94,74,2,30,1,1
53728,445,0,0,drop,70,70,0,1,0,1,0
62666,445,0,0,drop,66,66,0,1,0,1,0
51744,1678,56992,1678,allow,66,66,0,1,5,1,0
58968,445,0,0,drop,70,70,0,1,0,1,0
54678,443,37690,443,allow,84066,79714,4352,98,125,66,32
54930,443,22759,443,allow,2349,258,2091,10,120,4,6
54410,443,16745,443,allow,7256,1669,5587,27,318,15,12
40100,17,0,0,deny,60,60,0,1,0,1,0
50564,445,0,0,drop,70,70,0,1,0,1,0
39540,37965,0,0,deny,66,66,0,1,0,1,0
64770,53,5158,53,allow,360,93,267,3,37,2,1
51431,445,0,0,drop,70,70,0,1,0,1,0
49292,443,18411,443,allow,80199,66182,14017,134,163,87,47
27005,33038,17485,33038,allow,892,126,766,2,30,1,1
48371,53,57320,53,allow,198,93,105,2,30,1,1
58440,53,59026,53,allow,305,102,203,2,31,1,1
41156,53,41156,53,allow,216,82,134,2,31,1,1
57325,445,0,0,drop,70,70,0,1,0,1,0
59214,443,59214,443,allow,27659,5508,22151,59,47,31,28
40474,23117,0,0,deny,146,146,0,1,0,1,0
55095,445,0,0,drop,66,66,0,1,0,1,0
56355,53,30971,53,allow,184,94,90,2,31,1,1
57148,443,64280,443,allow,12000,9252,2748,34,273,17,17
57835,443,21443,443,allow,9125,3736,5389,19,120,10,9
50148,80,44851,80,allow,17314,6865,10449,50,79,24,26
50325,80,28914,80,allow,19438,12019,7419,53,312,30,23
56603,53,47573,53,allow,168,86,82,2,29,1,1
58638,5900,0,0,deny,62,62,0,1,0,1,0
38687,443,37401,443,allow,13923,1728,12195,24,16,10,14
28754,50584,0,0,deny,66,66,0,1,0,1,0
50425,53,24348,53,allow,199,102,97,2,30,1,1
62787,51221,0,0,deny,66,66,0,1,0,1,0
50131,443,16533,443,allow,12716,2575,10141,55,141,27,28
52235,443,52235,443,allow,4892,844,4048,19,21,9,10
60870,443,18926,443,allow,8219,2676,5543,40,15,24,16
49392,445,0,0,drop,66,66,0,1,0,1,0
60621,445,0,0,drop,66,66,0,1,0,1,0
65493,443,24258,443,allow,7975,423,7552,15,120,6,9
443,36576,0,0,deny,60,60,0,1,0,1,0
56684,443,53117,443,allow,7907,1918,5989,20,15,11,9
57092,53,43166,53,allow,270,102,168,2,30,1,1
64070,445,0,0,drop,70,70,0,1,0,1,0
52851,445,0,0,drop,70,70,0,1,0,1,0
39683,443,12229,443,allow,101895,6430,95465,152,175,66,86
47330,443,38110,443,allow,9297,2727,6570,27,80,15,12
59784,42246,0,0,deny,62,62,0,1,0,1,0
35212,443,26645,443,allow,4477,2350,2127,16,135,8,8
56608,443,21691,443,allow,10062,1631,8431,25,19,14,11
49744,53,4877,53,allow,211,102,109,2,30,1,1
59592,37965,0,0,deny,62,62,0,1,0,1,0
41249,50584,0,0,deny,66,66,0,1,0,1,0
57470,22468,25297,22468,allow,726,726,0,12,1200,12,0
62337,44847,0,0,deny,66,66,0,1,0,1,0
27005,30006,22484,30006,allow,890,126,764,2,31,1,1
44117,6881,0,0,deny,62,62,0,1,0,1,0
46507,443,10914,443,allow,7068,2016,5052,32,18,17,15
50630,53,12018,53,allow,209,110,99,2,29,1,1
58574,21247,0,0,deny,66,66,0,1,0,1,0
64089,20260,49392,20260,allow,66,66,0,1,5,1,0
60671,445,0,0,drop,70,70,0,1,0,1,0
56191,53,27279,53,allow,177,94,83,2,30,1,1
58638,5900,0,0,deny,62,62,0,1,0,1,0
31539,37965,0,0,deny,62,62,0,1,0,1,0
49226,53,53578,53,allow,765,102,663,2,30,1,1
59030,445,0,0,drop,70,70,0,1,0,1,0
60193,443,30919,443,allow,677029,102078,574951,1152,455,559,593
60921,443,34285,443,allow,9869,2448,7421,61,1253,24,37
61879,445,0,0,drop,70,70,0,1,0,1,0
56791,445,0,0,drop,70,70,0,1,0,1,0
9189,80,9189,80,allow,13456,880,12576,21,16,9,12
1537,22114,0,0,deny,62,62,0,1,0,1,0
58392,53,58392,53,allow,404,259,145,3,33,2,1
55395,445,0,0,drop,70,70,0,1,0,1,0
27331,443,27331,443,allow,1251,722,529,11,147,6,5
49608,53,63386,53,allow,198,110,88,2,29,1,1
58831,443,5275,443,allow,8004,2236,5768,41,18,23,18
44956,443,44956,443,allow,5220,1973,3247,22,38,13,9
50376,53,65518,53,allow,164,84,80,2,31,1,1
48756,80,48756,80,allow,560,264,296,9,44,5,4
52204,36387,46788,36387,allow,136,136,0,3,13,3,0
52150,39109,0,0,deny,66,66,0,1,0,1,0
60895,443,6009,443,allow,9387,2961,6426,38,18,23,15
58259,53,23484,53,allow,168,78,90,2,30,1,1
49698,53,38054,53,allow,184,102,82,2,30,1,1
60102,445,0,0,drop,70,70,0,1,0,1,0
16689,53,15770,53,allow,199,94,105,2,30,1,1
58614,53,27966,53,allow,168,78,90,2,30,1,1
56979,53,46725,53,allow,209,110,99,2,29,1,1
54973,53,46622,53,allow,178,91,87,2,31,1,1
52096,80,38227,80,allow,366,240,126,7,25,5,2
1873,37965,0,0,deny,62,62,0,1,0,1,0
45339,443,35795,443,allow,2312,1382,930,19,34,11,8
64444,53,10743,53,allow,183,94,89,2,30,1,1
27005,50019,16642,50019,allow,877,126,751,2,30,1,1
24566,53,24566,53,allow,216,90,126,2,30,1,1
46342,53,46342,53,allow,233,90,143,2,32,1,1
55975,53,27530,53,allow,939,678,261,2,30,1,1
49913,53,16997,53,allow,216,110,106,2,31,1,1
53349,445,0,0,drop,66,66,0,1,0,1,0
55429,25174,0,0,deny,66,66,0,1,0,1,0
58933,80,48784,80,allow,2055,1651,404,8,76,5,3
27005,27015,8670,27015,allow,877,126,751,2,30,1,1
64116,53,50037,53,allow,184,94,90,2,31,1,1
10151,6881,7271,6881,allow,490,150,340,2,1200,1,1
33948,15503,0,0,deny,146,146,0,1,0,1,0
63138,51452,48571,51452,allow,70,70,0,2,8,2,0
2938,64147,0,0,deny,62,62,0,1,0,1,0
51094,35440,0,0,deny,66,66,0,1,0,1,0
61428,80,48945,80,allow,214,140,74,4,41,3,1
65371,53,17018,53,allow,199,102,97,2,30,1,1
55752,53,44697,53,allow,200,102,98,2,30,1,1
27005,33058,7981,33058,allow,884,126,758,2,31,1,1
56844,445,0,0,drop,70,70,0,1,0,1,0
54564,445,0,0,drop,70,70,0,1,0,1,0
2267,53,13385,53,allow,204,118,86,2,31,1,1
63916,445,0,0,drop,70,70,0,1,0,1,0
64233,53,2922,53,allow,257,126,131,2,29,1,1
51690,80,52942,80,allow,21064,2772,18292,38,175,18,20
56023,445,0,0,drop,70,70,0,1,0,1,0
49359,80,26843,80,allow,60,60,0,2,154,2,0
49531,53,39343,53,allow,289,94,195,4,31,2,2
15732,53,15732,53,allow,414,268,146,3,32,2,1
64406,25174,0,0,deny,62,62,0,1,0,1,0
60174,80,16526,80,allow,1564,990,574,15,24,8,7
53983,443,37079,443,allow,2571,330,2241,12,135,5,7
59328,80,59328,80,allow,24437,12718,11719,41,15,16,25
56104,53,55768,53,allow,210,110,100,2,30,1,1
62947,53,18275,53,allow,213,86,127,2,30,1,1
32914,80,9670,80,allow,1542,831,711,7,15,5,2
57220,26467,0,0,deny,66,66,0,1,0,1,0
53725,64147,0,0,deny,66,66,0,1,0,1,0
49894,445,0,0,drop,66,66,0,1,0,1,0
1646,23,0,0,deny,60,60,0,1,0,1,0
45547,53,15973,53,allow,199,94,105,2,30,1,1
49369,443,63066,443,allow,6277395,184853,6092542,6543,317,2262,4281
52232,35126,13178,35126,allow,70,70,0,1,5,1,0
52207,443,22846,443,allow,74711,8646,66065,150,89,70,80
38704,443,15370,443,allow,90097,3289,86808,93,15,28,65
56773,53,31138,53,allow,183,94,89,2,30,1,1
50230,80,20217,80,allow,2384,952,1432,15,75,8,7
56638,445,0,0,drop,70,70,0,1,0,1,0
11541,40108,0,0,deny,148,148,0,1,0,1,0
11458,2767,0,0,deny,62,62,0,1,0,1,0
62971,44847,0,0,deny,66,66,0,1,0,1,0
49277,80,55324,80,allow,254,128,126,5,16,3,2
64565,445,0,0,drop,70,70,0,1,0,1,0
55140,445,0,0,drop,70,70,0,1,0,1,0
63554,44847,0,0,deny,66,66,0,1,0,1,0
44293,443,16772,443,allow,5880,2280,3600,31,76,14,17
53743,23915,28798,23915,allow,70,70,0,2,8,2,0
56771,53,26360,53,allow,193,102,91,2,31,1,1
55254,53,12306,53,allow,195,102,93,2,30,1,1
56292,53,41121,53,allow,194,99,95,2,30,1,1
56101,53,38415,53,allow,194,102,92,2,31,1,1
51197,57470,0,0,deny,62,62,0,1,0,1,0
65497,53,26978,53,allow,197,102,95,2,30,1,1
50632,80,1606,80,allow,1559,1107,452,9,22,5,4
49456,53,3975,53,allow,199,102,97,2,30,1,1
56200,445,0,0,drop,70,70,0,1,0,1,0
56249,55442,0,0,deny,66,66,0,1,0,1,0
53342,443,18889,443,allow,82909,70964,11945,139,283,71,68
18771,35440,0,0,deny,66,66,0,1,0,1,0
63106,443,7897,443,allow,8712,3748,4964,51,255,23,28
61128,445,0,0,drop,66,66,0,1,0,1,0
57234,21247,0,0,deny,66,66,0,1,0,1,0
49636,44847,0,0,deny,62,62,0,1,0,1,0
59763,25604,0,0,deny,66,66,0,1,0,1,0
63861,445,0,0,drop,70,70,0,1,0,1,0
55027,443,20215,443,allow,19367,11346,8021,47,19,26,21
50767,80,50767,80,allow,30767,854,29913,38,15,13,25
64475,443,53340,443,allow,251092,8989,242103,282,123,98,184
49891,443,20308,443,allow,1820,1101,719,18,73,10,8
46478,443,23649,443,allow,493,280,213,8,97,5,3
55254,443,12972,443,allow,3257,782,2475,17,140,8,9
57140,53,58402,53,allow,177,94,83,2,29,1,1
54666,36237,0,0,deny,66,66,0,1,0,1,0
49478,53,58294,53,allow,164,86,78,2,31,1,1
45099,57470,0,0,deny,62,62,0,1,0,1,0
57987,3478,61463,3478,allow,60483,25857,34626,136,47,63,73
55072,53,28531,53,allow,177,94,83,2,30,1,1
50542,53,12388,53,allow,782,110,672,2,30,1,1
65106,53,42197,53,allow,193,102,91,2,30,1,1
65165,53,54019,53,allow,200,102,98,2,31,1,1
58638,5900,0,0,deny,62,62,0,1,0,1,0
48834,443,52235,443,allow,655052,13866,641186,599,31,150,449
43862,443,61828,443,allow,6600,1174,5426,23,62,13,10
65258,443,17337,443,allow,6043,1568,4475,11,120,4,7
53088,443,43774,443,allow,161938,137946,23992,412,384,227,185
9461,443,60064,443,allow,2581,1602,979,17,20,9,8
55520,53,61502,53,allow,194,102,92,2,30,1,1
55071,53,30463,53,allow,356,118,238,2,29,1,1
64738,53,34025,53,allow,402,118,284,2,30,1,1
63683,445,0,0,drop,66,66,0,1,0,1,0
62051,11392,0,0,deny,66,66,0,1,0,1,0
55534,53,10719,53,allow,168,86,82,2,29,1,1
60217,80,16783,80,allow,4050,2838,1212,14,16,7,7
56308,53,54603,53,allow,184,94,90,2,31,1,1
58735,443,63211,443,allow,1413,876,537,12,26,6,6
63925,445,0,0,drop,70,70,0,1,0,1,0
27005,27016,5470,27016,allow,879,126,753,2,30,1,1
33627,36237,0,0,deny,66,66,0,1,0,1,0
50461,445,0,0,drop,66,66,0,1,0,1,0
58038,51505,0,0,deny,146,146,0,1,0,1,0
60239,23,0,0,deny,60,60,0,1,0,1,0
53746,7546,3408,7546,allow,70,70,0,2,7,2,0
8889,29421,0,0,deny,60,60,0,1,0,1,0
49764,53,33834,53,allow,198,101,97,2,31,1,1
59509,64147,0,0,deny,62,62,0,1,0,1,0
57237,53,56776,53,allow,701,88,613,2,30,1,1
10333,22114,0,0,deny,62,62,0,1,0,1,0
0,0,0,0,deny,70,70,0,1,0,1,0
64414,53,29559,53,allow,193,102,91,2,31,1,1
64617,53,31755,53,allow,389,102,287,4,33,2,2
49670,445,0,0,drop,66,66,0,1,0,1,0
59210,50584,0,0,deny,66,66,0,1,0,1,0
44147,64147,0,0,deny,62,62,0,1,0,1,0
17719,49153,0,0,deny,145,145,0,1,0,1,0
57573,445,0,0,drop,70,70,0,1,0,1,0
49923,443,47836,443,allow,7759,2264,5495,19,120,9,10
49507,53,33142,53,allow,177,94,83,2,30,1,1
55660,445,0,0,drop,70,70,0,1,0,1,0
49505,445,0,0,drop,66,66,0,1,0,1,0
15899,37807,0,0,deny,62,62,0,1,0,1,0
36841,443,46092,443,allow,7293,1544,5749,22,256,11,11
49424,53,36639,53,allow,210,102,108,2,30,1,1
62792,53,0,0,deny,88,88,0,1,0,1,0
49767,80,33888,80,allow,70,70,0,2,8,2,0
48817,32897,48817,32897,allow,152,152,0,1,1200,1,0
13168,35440,0,0,deny,66,66,0,1,0,1,0
56265,53,18284,53,allow,733,85,648,2,30,1,1
33292,50584,0,0,deny,66,66,0,1,0,1,0
10248,21247,0,0,deny,62,62,0,1,0,1,0
55199,21247,0,0,deny,62,62,0,1,0,1,0
50269,80,46714,80,allow,1606,823,783,12,121,7,5
56174,443,38355,443,allow,18931,4924,14007,46,139,20,26
43398,25604,0,0,deny,146,146,0,1,0,1,0
54136,443,48147,443,allow,18716,8002,10714,100,945,51,49
52852,80,35656,80,allow,7572,3232,4340,42,140,23,19
22530,23718,0,0,deny,66,66,0,1,0,1,0
49543,53,52836,53,allow,200,102,98,2,30,1,1
62015,445,0,0,drop,70,70,0,1,0,1,0
36061,53,36061,53,allow,220,100,120,2,30,1,1
50098,53,37375,53,allow,199,102,97,2,30,1,1
43704,37965,0,0,deny,66,66,0,1,0,1,0
41906,80,41906,80,allow,127215,3221,123994,137,3685,42,95
26900,27017,1081,27017,allow,422,164,258,6,29,3,3
45832,51050,0,0,deny,62,62,0,1,0,1,0
57019,53,31067,53,allow,193,102,91,2,31,1,1
57529,445,0,0,drop,66,66,0,1,0,1,0
56391,445,0,0,drop,66,66,0,1,0,1,0
1369,48817,0,0,deny,145,145,0,1,0,1,0
56677,53,20003,53,allow,200,102,98,2,31,1,1
9555,80,9555,80,allow,6893,704,6189,14,15,6,8
61747,445,0,0,drop,66,66,0,1,0,1,0
33003,28543,0,0,deny,62,62,0,1,0,1,0
52754,26467,0,0,deny,66,66,0,1,0,1,0
36445,443,53718,443,allow,78,78,0,1,5,1,0
36668,443,55888,443,allow,142299,120615,21684,348,336,180,168
54742,50584,0,0,deny,66,66,0,1,0,1,0
65313,53,33070,53,allow,193,102,91,2,30,1,1
50438,53,55322,53,allow,199,102,97,2,31,1,1
55273,53,29948,53,allow,167,86,81,2,30,1,1
42307,443,58231,443,allow,101673,5966,95707,121,178,47,74
43671,17372,0,0,deny,62,62,0,1,0,1,0
9731,64147,0,0,deny,62,62,0,1,0,1,0
27005,27015,8429,27015,allow,882,126,756,2,30,1,1
49423,445,0,0,drop,70,70,0,1,0,1,0
57824,443,57824,443,allow,4669,1762,2907,19,30,11,8
443,23220,0,0,deny,100,100,0,1,0,1,0
54007,50265,0,0,deny,66,66,0,1,0,1,0
59565,445,0,0,drop,70,70,0,1,0,1,0
51667,80,5248,80,allow,20457,4742,15715,37,139,20,17
49944,53,39307,53,allow,196,102,94,2,31,1,1
63447,44847,0,0,deny,66,66,0,1,0,1,0
55996,443,19878,443,allow,5323,2482,2841,31,19,15,16
60504,445,0,0,drop,70,70,0,1,0,1,0
51348,25174,0,0,deny,66,66,0,1,0,1,0
36502,53,33412,53,allow,168,78,90,2,30,1,1
64420,445,0,0,drop,70,70,0,1,0,1,0
49351,53,56042,53,allow,166,86,80,2,29,1,1
55717,445,0,0,drop,70,70,0,1,0,1,0
50941,445,0,0,drop,70,70,0,1,0,1,0
1035,26467,0,0,deny,62,62,0,1,0,1,0
56724,443,8554,443,allow,14956,2081,12875,30,20,16,14
55240,445,0,0,drop,70,70,0,1,0,1,0
49949,53,18474,53,allow,193,102,91,2,30,1,1
52125,49224,3384,49224,allow,70,70,0,1,5,1,0
53583,15354,6378,15354,allow,70,70,0,2,7,2,0
41389,443,45580,443,allow,280,140,140,5,131,3,2
64029,53,26038,53,allow,180,94,86,2,30,1,1
56273,53,48350,53,allow,197,102,95,2,33,1,1
63573,445,0,0,drop,70,70,0,1,0,1,0
17415,25174,0,0,deny,62,62,0,1,0,1,0
51076,445,0,0,drop,66,66,0,1,0,1,0
25679,27189,0,0,deny,62,62,0,1,0,1,0
55857,53,56112,53,allow,199,102,97,2,31,1,1
50424,53,64071,53,allow,195,102,93,2,29,1,1
51502,443,28500,443,allow,10204,5034,5170,45,16,25,20
49558,53,61665,53,allow,423,104,319,4,39,2,2
54757,445,0,0,drop,70,70,0,1,0,1,0
55085,443,57915,443,allow,5803,4960,843,19,124,11,8
54833,443,46650,443,allow,3894,969,2925,20,153,9,11
59147,51505,0,0,deny,66,66,0,1,0,1,0
55267,53,45498,53,allow,168,78,90,2,29,1,1
36838,443,43654,443,allow,9381,1457,7924,21,31,11,10
26800,22,0,0,deny,60,60,0,1,0,1,0
59227,11392,0,0,deny,62,62,0,1,0,1,0
53880,443,53880,443,allow,4686,1779,2907,19,30,11,8
62956,445,0,0,drop,70,70,0,1,0,1,0
5223,7851,0,0,deny,66,66,0,1,0,1,0
61528,443,29665,443,allow,138544,7073,131471,165,144,59,106
55691,16410,58376,16410,allow,70,70,0,2,8,2,0
61423,80,2681,80,allow,214,140,74,4,41,3,1
58999,443,30350,443,allow,2687,1593,1094,20,20,11,9
2402,7000,2402,7000,allow,1236,676,560,13,22,7,6
52886,445,0,0,drop,70,70,0,1,0,1,0
65513,53,35186,53,allow,190,97,93,2,31,1,1
63589,44847,0,0,deny,66,66,0,1,0,1,0
58440,445,0,0,drop,66,66,0,1,0,1,0
0,0,0,0,allow,156,156,0,2,0,2,0
54994,53,3788,53,allow,209,110,99,2,30,1,1
34330,443,44282,443,allow,1717,1153,564,13,26,7,6
63923,59177,22656,59177,allow,70,70,0,1,4,1,0
26900,27017,31530,27017,allow,168,82,86,2,30,1,1
57470,44172,25895,44172,allow,353,166,187,2,1199,1,1
14459,11848,0,0,reset-both,148,148,0,1,0,1,0
56643,53,48653,53,allow,195,102,93,2,30,1,1
60857,61689,0,0,deny,146,146,0,1,0,1,0
39213,25174,0,0,deny,62,62,0,1,0,1,0
47803,64147,0,0,deny,145,145,0,1,0,1,0
59911,445,0,0,drop,70,70,0,1,0,1,0
59886,445,0,0,drop,70,70,0,1,0,1,0
54874,445,0,0,drop,70,70,0,1,0,1,0
64205,53,12061,53,allow,172,88,84,2,30,1,1
65007,53,25080,53,allow,180,86,94,2,30,1,1
41677,57470,0,0,deny,62,62,0,1,0,1,0
30227,3386,30227,3386,allow,146,60,86,2,30,1,1
56058,445,0,0,drop,70,70,0,1,0,1,0
35015,17,0,0,deny,60,60,0,1,0,1,0
58638,5900,0,0,deny,62,62,0,1,0,1,0
61059,80,61059,80,allow,16824,810,16014,22,15,8,14
49743,443,50508,443,allow,2372,1143,1229,21,82,10,11
55770,443,27394,443,allow,40169,4646,35523,61,122,24,37
39617,50584,0,0,deny,62,62,0,1,0,1,0
53718,443,3459,443,allow,499,425,74,4,0,3,1
50986,80,14169,80,allow,8074,2261,5813,22,19,13,9
58029,80,1723,80,allow,374,192,182,7,21,4,3
51079,80,14506,80,allow,19699,2094,17605,32,229,14,18
47785,443,12110,443,allow,9224,2055,7169,37,41,19,18
59928,80,12349,80,allow,5755,3943,1812,24,31,13,11
49662,53,37093,53,allow,268,93,175,4,59,2,2
28839,30188,0,0,deny,146,146,0,1,0,1,0
50486,56205,0,0,deny,66,66,0,1,0,1,0
57150,53,55226,53,allow,164,84,80,2,30,1,1
53338,53,53532,53,allow,168,78,90,2,30,1,1
42465,57470,0,0,deny,60,60,0,1,0,1,0
56182,80,62619,80,allow,2085,797,1288,10,15,6,4
56941,53,63824,53,allow,196,102,94,2,30,1,1
27010,64147,0,0,deny,62,62,0,1,0,1,0
53809,445,0,0,drop,66,66,0,1,0,1,0
1024,50265,0,0,deny,62,62,0,1,0,1,0
59523,37965,0,0,deny,62,62,0,1,0,1,0
52016,445,0,0,drop,70,70,0,1,0,1,0
54684,37965,0,0,deny,62,62,0,1,0,1,0
56035,443,61035,443,allow,10622,4094,6528,29,514,16,13
54880,445,0,0,drop,70,70,0,1,0,1,0
50622,80,45334,80,allow,11907,10409,1498,28,52,16,12
65289,53,7871,53,allow,179,94,85,2,31,1,1
56425,53,17413,53,allow,760,97,663,2,30,1,1
58726,53,60102,53,allow,247,102,145,2,30,1,1
54588,445,0,0,drop,70,70,0,1,0,1,0
55597,445,0,0,drop,70,70,0,1,0,1,0
54131,57866,0,0,deny,66,66,0,1,0,1,0
51564,443,53413,443,allow,2888,1566,1322,17,18,9,8
27005,27015,51372,27015,allow,884,126,758,2,30,1,1
5151,50584,0,0,deny,62,62,0,1,0,1,0
9337,443,53921,443,allow,428,128,300,8,47,3,5
65452,53,31972,53,allow,365,102,263,2,30,1,1
59587,25174,0,0,deny,146,146,0,1,0,1,0
53934,445,0,0,drop,70,70,0,1,0,1,0
55259,445,0,0,drop,70,70,0,1,0,1,0
50178,443,40731,443,allow,6353,1075,5278,18,26,10,8
50080,5223,34413,5223,allow,10876,5991,4885,39,93,22,17
56877,445,0,0,drop,70,70,0,1,0,1,0
3478,61463,0,0,deny,301,301,0,1,0,1,0
50409,443,27908,443,allow,5386,4374,1012,18,34,11,7
58058,445,0,0,drop,70,70,0,1,0,1,0
57334,53,10038,53,allow,184,94,90,2,30,1,1
43584,24748,0,0,deny,156,156,0,1,0,1,0
55160,445,0,0,drop,70,70,0,1,0,1,0
56744,443,47935,443,allow,6205,986,5219,16,32,10,6
64837,445,0,0,drop,70,70,0,1,0,1,0
14667,443,14667,443,allow,20280,2078,18202,35,17,19,16
27005,27016,26467,27016,allow,885,126,759,2,30,1,1
65198,53,6063,53,allow,448,94,354,4,49,2,2
50866,445,0,0,drop,66,66,0,1,0,1,0
49205,53,36921,53,allow,194,102,92,2,30,1,1
45941,23386,0,0,deny,60,60,0,1,0,1,0
52146,443,52659,443,allow,774806,25835,748971,772,52,253,519
34488,443,33891,443,allow,8363,1573,6790,24,49,14,10
49842,443,41562,443,allow,5309,1043,4266,22,72,11,11
33044,443,11890,443,allow,9695,5259,4436,24,35,12,12
50543,445,0,0,drop,66,66,0,1,0,1,0
42112,443,17056,443,allow,11459,2165,9294,29,259,11,18
46292,42873,0,0,deny,72,72,0,1,0,1,0
50265,64304,32485,64304,allow,970,598,372,14,1201,8,6
63925,37965,0,0,deny,62,62,0,1,0,1,0
64373,445,0,0,drop,70,70,0,1,0,1,0
52843,445,0,0,drop,70,70,0,1,0,1,0
51287,445,0,0,drop,70,70,0,1,0,1,0
37965,51719,40903,51719,allow,481,150,331,2,1199,1,1
64723,53,29424,53,allow,165,86,79,2,31,1,1
49418,27018,42742,27018,allow,274,78,196,2,31,1,1
49610,80,55235,80,allow,378,192,186,7,41,4,3
63172,445,0,0,drop,70,70,0,1,0,1,0
64994,53,18089,53,allow,216,102,114,2,30,1,1
27005,28515,30330,28515,allow,1660,126,1534,4,30,2,2
41165,443,56150,443,allow,8949,1938,7011,21,17,12,9
57613,445,0,0,drop,70,70,0,1,0,1,0
61443,445,0,0,drop,70,70,0,1,0,1,0
48817,63615,48817,63615,allow,765,296,469,4,1200,2,2
43063,57470,0,0,deny,62,62,0,1,0,1,0
65315,445,0,0,drop,70,70,0,1,0,1,0
46495,4607,0,0,deny,60,60,0,1,0,1,0
65336,53,30958,53,allow,771,101,670,2,31,1,1
65365,53,42836,53,allow,196,102,94,2,31,1,1
443,31353,0,0,deny,97,97,0,1,0,1,0
58301,53,36478,53,allow,233,102,131,2,30,1,1
57288,53,40155,53,allow,170,87,83,2,30,1,1
47884,443,47884,443,allow,4672,1765,2907,18,28,10,8
57655,445,0,0,drop,66,66,0,1,0,1,0
63582,445,0,0,drop,70,70,0,1,0,1,0
44846,53,44846,53,allow,86,86,0,1,30,1,0
60344,80,63030,80,allow,2005,1094,911,11,87,6,5
64792,53,58723,53,allow,768,99,669,2,31,1,1
52210,51505,0,0,deny,66,66,0,1,0,1,0
59563,30188,0,0,deny,66,66,0,1,0,1,0
54889,53,54889,53,allow,832,106,726,2,30,1,1
34548,443,60764,443,allow,11549,3378,8171,33,196,16,17
59124,445,0,0,drop,70,70,0,1,0,1,0
54636,26467,0,0,deny,66,66,0,1,0,1,0
46215,443,63410,443,allow,4182,2874,1308,17,361,9,8
65486,443,40088,443,allow,375786,11380,364406,388,16,137,251
38678,443,31559,443,allow,484,210,274,8,26,4,4
61514,445,0,0,drop,70,70,0,1,0,1,0
62344,80,50382,80,allow,1892,583,1309,12,16,6,6
58325,53,35330,53,allow,251,79,172,2,30,1,1
58740,443,9858,443,allow,5228,700,4528,17,14,7,10
12616,23,0,0,deny,60,60,0,1,0,1,0
48826,25174,0,0,deny,66,66,0,1,0,1,0
55272,53,40097,53,allow,599,198,401,6,50,3,3
64476,445,0,0,drop,66,66,0,1,0,1,0
65274,53,10401,53,allow,295,101,194,4,32,2,2
57397,53,3449,53,allow,183,94,89,2,30,1,1
64733,35440,0,0,deny,62,62,0,1,0,1,0
59192,25174,0,0,deny,66,66,0,1,0,1,0
48872,443,20108,443,allow,8143,3033,5110,26,18,14,12
56304,53,54200,53,allow,184,94,90,2,31,1,1
39217,31573,0,0,deny,146,146,0,1,0,1,0
43230,80,43230,80,allow,6776,692,6084,16,20,8,8
47655,53,46246,53,allow,168,78,90,2,29,1,1
57899,34317,0,0,deny,145,145,0,1,0,1,0
57301,445,0,0,drop,70,70,0,1,0,1,0
55829,53,23534,53,allow,168,78,90,2,30,1,1
63941,80,15778,80,allow,314,192,122,6,15,4,2
49508,445,0,0,drop,66,66,0,1,0,1,0
49187,80,38831,80,allow,1213,471,742,10,111,6,4
55931,53,41701,53,allow,294,118,176,2,29,1,1
52204,445,0,0,drop,70,70,0,1,0,1,0
5588,5588,0,0,allow,3354,1792,1562,46,193,23,23
48067,443,48553,443,allow,12648,5285,7363,58,32,27,31
36351,80,36351,80,allow,1920,1471,449,10,20,6,4
52472,51221,0,0,deny,74,74,0,1,0,1,0
55646,53,39790,53,allow,760,97,663,2,31,1,1
49915,35440,0,0,deny,62,62,0,1,0,1,0
44847,30066,30079,30066,allow,150,150,0,1,1200,1,0
20894,51505,0,0,deny,62,62,0,1,0,1,0
64684,53,48311,53,allow,184,94,90,2,30,1,1
58504,445,0,0,drop,66,66,0,1,0,1,0
13287,16933,0,0,deny,62,62,0,1,0,1,0
47037,1,0,0,deny,62,62,0,1,0,1,0
51997,14398,36359,14398,allow,130,70,60,2,5,1,1
63273,445,0,0,drop,70,70,0,1,0,1,0
27727,53,27727,53,allow,407,261,146,3,32,2,1
52537,57866,0,0,deny,66,66,0,1,0,1,0
53948,445,0,0,drop,66,66,0,1,0,1,0
64099,55470,50878,55470,allow,66,66,0,1,5,1,0
50577,53,36248,53,allow,196,102,94,2,30,1,1
63957,53,57529,53,allow,211,102,109,2,30,1,1
47045,53,20106,53,allow,225,78,147,2,30,1,1
58142,445,0,0,drop,70,70,0,1,0,1,0
53838,36829,0,0,deny,62,62,0,1,0,1,0
55835,53,39257,53,allow,180,94,86,2,30,1,1
20641,53,20641,53,allow,240,98,142,2,29,1,1
56161,80,10423,80,allow,2670,799,1871,13,46,8,5
56751,53,10691,53,allow,177,94,83,2,30,1,1
55836,443,63316,443,allow,320,140,180,6,15,3,3
52413,443,50762,443,allow,2114,1152,962,14,15,8,6
49255,80,49255,80,allow,8453,961,7492,18,20,9,9
65493,53,48274,53,allow,266,110,156,2,30,1,1
10165,80,10165,80,allow,6714,929,5785,17,33,8,9
52555,445,0,0,drop,66,66,0,1,0,1,0
56562,53,48636,53,allow,182,93,89,2,31,1,1
26729,57470,0,0,deny,66,66,0,1,0,1,0
58230,443,58230,443,allow,4465,1558,2907,19,27,11,8
50969,445,0,0,drop,70,70,0,1,0,1,0
52487,443,29392,443,allow,13734,3206,10528,26,150,13,13
34902,443,35566,443,allow,70,70,0,1,5,1,0
56916,445,0,0,drop,66,66,0,1,0,1,0
51792,80,21440,80,allow,3840,2265,1575,16,47,10,6
47632,25174,0,0,deny,62,62,0,1,0,1,0
4127,26467,0,0,deny,66,66,0,1,0,1,0
52282,445,0,0,drop,66,66,0,1,0,1,0
56958,53,40535,53,allow,193,102,91,2,30,1,1
65439,53,2036,53,allow,168,86,82,2,29,1,1
57470,34590,16143,34590,allow,527,166,361,2,1200,1,1
15503,36501,26789,36501,allow,323,150,173,2,1201,1,1
65443,53,23920,53,allow,172,94,78,2,30,1,1
54836,445,0,0,drop,70,70,0,1,0,1,0
37983,443,26799,443,allow,15668921,169545,15499376,12539,161,1284,11255
60435,443,42755,443,allow,38888447,473172,38415275,31568,128,5708,25860
60815,445,0,0,drop,70,70,0,1,0,1,0
61120,445,0,0,drop,70,70,0,1,0,1,0
65251,53,30637,53,allow,196,102,94,2,30,1,1
50132,443,60688,443,allow,8162,1364,6798,22,16,11,11
41648,56205,0,0,deny,66,66,0,1,0,1,0
64620,53,58577,53,allow,166,86,80,2,30,1,1
59988,445,0,0,drop,70,70,0,1,0,1,0
58748,443,31963,443,allow,5167,700,4467,16,15,7,9
26425,22114,0,0,deny,62,62,0,1,0,1,0
23589,53,23589,53,allow,220,90,130,2,30,1,1
22971,50584,0,0,deny,62,62,0,1,0,1,0
2083,7000,2083,7000,allow,3374,1535,1839,16,15,8,8
56166,53,15904,53,allow,186,95,91,2,30,1,1
6881,1707,0,0,deny,146,146,0,1,0,1,0
48219,55442,0,0,deny,66,66,0,1,0,1,0
54086,445,0,0,drop,66,66,0,1,0,1,0
64485,53,11274,53,allow,183,94,89,2,30,1,1
58638,5900,0,0,deny,62,62,0,1,0,1,0
43376,443,45691,443,allow,7123,1331,5792,22,81,11,11
63785,445,0,0,drop,70,70,0,1,0,1,0
50095,50584,0,0,deny,66,66,0,1,0,1,0
56388,53,20730,53,allow,275,95,180,4,44,2,2
45941,23388,0,0,deny,60,60,0,1,0,1,0
60944,443,6650,443,allow,59999,8737,51262,95,18,43,52
49186,443,54954,443,allow,508520,13734,494786,527,18,192,335
49197,445,0,0,drop,70,70,0,1,0,1,0
54376,445,0,0,drop,66,66,0,1,0,1,0
60675,443,27643,443,allow,1871,1235,636,13,31,8,5
61323,23117,0,0,deny,62,62,0,1,0,1,0
43747,22114,0,0,deny,66,66,0,1,0,1,0
58825,445,0,0,drop,66,66,0,1,0,1,0
56589,53,12890,53,allow,199,102,97,2,31,1,1
34297,443,14287,443,allow,65853,31390,34463,203,694,105,98
14469,443,14469,443,allow,274,132,142,5,15,3,2
60455,65054,62710,65054,allow,624,318,306,10,16,5,5
56812,445,0,0,drop,70,70,0,1,0,1,0
10978,8443,10978,8443,allow,66,66,0,1,5,1,0
55776,53,11095,53,allow,272,110,162,2,29,1,1
49872,445,0,0,drop,70,70,0,1,0,1,0
63585,443,56391,443,allow,123421,11745,111676,267,125,108,159
50272,443,15445,443,allow,8456,2502,5954,32,120,19,13
64904,53,63887,53,allow,199,102,97,2,30,1,1
58909,445,0,0,drop,70,70,0,1,0,1,0
53218,56205,0,0,deny,62,62,0,1,0,1,0
58421,30188,0,0,deny,66,66,0,1,0,1,0
54259,445,0,0,drop,70,70,0,1,0,1,0
56094,445,0,0,drop,70,70,0,1,0,1,0
50422,50584,0,0,deny,66,66,0,1,0,1,0
30188,13384,3738,13384,allow,501,150,351,2,1200,1,1
57356,53,43032,53,allow,780,93,687,2,30,1,1
44922,57470,0,0,deny,74,74,0,1,0,1,0
64534,53,37006,53,allow,214,110,104,2,30,1,1
52001,80,20376,80,allow,8117874,148550,7969324,7318,25,2033,5285
55387,443,54944,443,allow,3997,1374,2623,14,136,7,7
27005,1403,18731,1403,allow,857,126,731,2,30,1,1
49177,443,40595,443,allow,840,700,140,13,59,11,2
19617,39004,0,0,deny,62,62,0,1,0,1,0
58530,53,0,0,allow,188,84,104,2,30,1,1
56322,53,7412,53,allow,202,103,99,2,31,1,1
58638,5900,58638,5900,allow,66,66,0,1,4,1,0
50012,53,27557,53,allow,212,110,102,2,30,1,1
49985,443,2510,443,allow,10737,3664,7073,20,137,10,10
8592,35993,0,0,deny,66,66,0,1,0,1,0
58971,443,47268,443,allow,2702,1593,1109,21,23,11,10
59592,37965,0,0,deny,62,62,0,1,0,1,0
54914,51505,0,0,deny,66,66,0,1,0,1,0
51026,37450,0,0,deny,62,62,0,1,0,1,0
49402,53,15984,53,allow,185,102,83,2,31,1,1
46273,5228,19288,5228,allow,5239,1558,3681,27,4020,9,18
50605,443,56643,443,allow,1766,975,791,15,71,9,6
60370,445,0,0,drop,66,66,0,1,0,1,0
55239,443,1727,443,allow,9352,2524,6828,27,46,14,13
64697,445,0,0,drop,70,70,0,1,0,1,0
53128,443,36411,443,allow,72734,14614,58120,112,44,39,73
49762,53,23081,53,allow,760,97,663,2,30,1,1
23758,44847,0,0,deny,62,62,0,1,0,1,0
61859,445,0,0,drop,70,70,0,1,0,1,0
55098,53,8835,53,allow,176,90,86,2,30,1,1
53229,443,53229,443,allow,1402,856,546,12,34,6,6
59128,44847,0,0,deny,62,62,0,1,0,1,0
64016,25174,0,0,deny,62,62,0,1,0,1,0
49233,443,34014,443,allow,9622,3524,6098,59,916,29,30
49817,443,20632,443,allow,4504,839,3665,16,125,8,8
43580,57470,0,0,deny,145,145,0,1,0,1,0
6666,16010,0,0,deny,60,60,0,1,0,1,0
39338,443,58557,443,allow,4362,1145,3217,17,26,9,8
64482,53,15277,53,allow,196,102,94,2,30,1,1
58488,37965,0,0,deny,62,62,0,1,0,1,0
0,0,0,0,allow,124,64,60,2,0,1,1
2543,25174,0,0,deny,66,66,0,1,0,1,0
58014,443,11079,443,allow,5528,3392,2136,31,80,16,15
58638,5900,0,0,deny,62,62,0,1,0,1,0
50265,15402,25420,15402,allow,1450,747,703,16,1200,9,7
51737,53,3505,53,allow,231,78,153,2,30,1,1
1183,53,1183,53,allow,213,79,134,2,33,1,1
63859,80,37247,80,allow,314,192,122,6,15,4,2
6881,7560,34838,7560,allow,509,150,359,2,1199,1,1
56023,53,18673,53,allow,195,102,93,2,30,1,1
40204,40031,12730,40031,allow,245,182,63,2,30,1,1
55318,53,12855,53,allow,167,86,81,2,30,1,1
63988,50584,0,0,deny,66,66,0,1,0,1,0
11136,15503,0,0,deny,62,62,0,1,0,1,0
51959,42269,57888,42269,allow,70,70,0,2,8,2,0
55699,443,1921,443,allow,4170,1901,2269,14,120,7,7
45402,443,57057,443,allow,7710,3375,4335,32,131,18,14
56811,53,1928,53,allow,762,97,665,2,30,1,1
23228,443,23228,443,allow,20540,5514,15026,52,76,29,23
49297,53,13905,53,allow,182,93,89,2,31,1,1
40369,57470,0,0,deny,62,62,0,1,0,1,0
49677,80,37951,80,allow,1977,921,1056,9,16,5,4
36710,443,45580,443,allow,6786,1795,4991,18,16,11,7
11464,37965,0,0,deny,62,62,0,1,0,1,0
58504,57470,0,0,deny,62,62,0,1,0,1,0
5588,5588,0,0,allow,3354,1792,1562,46,194,23,23
40404,443,18265,443,allow,280,140,140,5,130,3,2
51130,61689,0,0,deny,62,62,0,1,0,1,0
34340,443,16904,443,allow,3497,1845,1652,18,16,9,9
64860,445,0,0,drop,70,70,0,1,0,1,0
50661,445,0,0,drop,70,70,0,1,0,1,0
3478,61463,0,0,deny,68,68,0,1,0,1,0
49269,53,5251,53,allow,198,110,88,2,29,1,1
54346,44847,0,0,deny,62,62,0,1,0,1,0
54048,445,0,0,drop,70,70,0,1,0,1,0
53833,445,0,0,drop,66,66,0,1,0,1,0
31675,23,0,0,deny,60,60,0,1,0,1,0
32609,64097,0,0,deny,62,62,0,1,0,1,0
49508,443,35365,443,allow,4151,1015,3136,16,27,8,8
52962,35440,0,0,deny,66,66,0,1,0,1,0
54035,443,14205,443,allow,4454,2001,2453,11,120,6,5
56784,445,0,0,drop,70,70,0,1,0,1,0
30859,53,30859,53,allow,213,79,134,2,32,1,1
12260,51505,0,0,deny,62,62,0,1,0,1,0
64949,44847,0,0,deny,66,66,0,1,0,1,0
55748,443,39721,443,allow,21446,1599,19847,35,154,16,19
52629,445,0,0,drop,70,70,0,1,0,1,0
56830,17793,18491,17793,allow,564,318,246,9,15,5,4
55943,53,30420,53,allow,448,184,264,6,29,3,3
50059,53,45752,53,allow,718,94,624,2,30,1,1
60657,445,0,0,drop,70,70,0,1,0,1,0
63985,43081,52828,43081,allow,70,70,0,1,5,1,0
61788,445,0,0,drop,66,66,0,1,0,1,0
55201,26467,0,0,deny,66,66,0,1,0,1,0
54453,443,34094,443,allow,257837,37453,220384,446,952,175,271
50035,445,0,0,drop,66,66,0,1,0,1,0
50442,80,8641,80,allow,378,192,186,7,19,4,3
53377,443,17654,443,allow,4814,1207,3607,17,75,10,7
58759,445,0,0,drop,70,70,0,1,0,1,0
50319,445,0,0,drop,70,70,0,1,0,1,0
59357,445,0,0,drop,70,70,0,1,0,1,0
11030,37965,0,0,deny,62,62,0,1,0,1,0
65238,443,5223,443,allow,26538,8416,18122,54,121,25,29
26943,443,22865,443,allow,21275,16156,5119,41,22,23,18
60412,80,59747,80,allow,958,543,415,11,315,6,5
57273,53,15438,53,allow,177,94,83,2,30,1,1
64324,37807,0,0,deny,146,146,0,1,0,1,0
46492,443,13641,443,allow,11163,3642,7521,25,30,14,11
50659,443,57690,443,allow,7128,2589,4539,25,37,15,10
33183,23,0,0,deny,60,60,0,1,0,1,0
46859,50584,0,0,deny,62,62,0,1,0,1,0
49161,53,1492,53,allow,385,102,283,2,30,1,1
65330,53,32414,53,allow,733,94,639,2,30,1,1
56275,53,11893,53,allow,170,87,83,2,30,1,1
50584,50901,9302,50901,allow,166,166,0,1,1199,1,0
54172,445,0,0,drop,70,70,0,1,0,1,0
50814,53,0,0,allow,82,82,0,1,30,1,0
48009,443,46874,443,allow,4015,1813,2202,17,256,9,8
58381,53,27908,53,allow,199,94,105,2,31,1,1
25608,53,25608,53,allow,823,98,725,2,30,1,1
59629,80,40534,80,allow,1652,1264,388,10,17,4,6
61496,443,4674,443,allow,27232,3841,23391,42,38,17,25
51926,80,62359,80,allow,36720,3404,33316,51,25,22,29
60449,28260,32141,28260,allow,70,70,0,1,5,1,0
51856,445,0,0,drop,70,70,0,1,0,1,0
59099,443,44771,443,allow,7066,1861,5205,32,1262,17,15
50562,445,0,0,drop,66,66,0,1,0,1,0
57150,53,24486,53,allow,170,87,83,2,30,1,1
56314,53,2805,53,allow,182,93,89,2,30,1,1
55813,443,20333,443,allow,15097,2888,12209,40,28,20,20
42993,443,2255,443,allow,14451,3012,11439,33,32,18,15
49433,53,5828,53,allow,167,86,81,2,29,1,1
49456,53,39013,53,allow,198,101,97,2,31,1,1
54906,445,0,0,drop,66,66,0,1,0,1,0
55505,53,61786,53,allow,198,101,97,2,1,1,1
30417,51505,0,0,deny,146,146,0,1,0,1,0
41981,80,51523,80,allow,1556,1236,320,10,15,5,5
53235,443,53235,443,allow,1270,697,573,15,33,8,7
55146,1433,0,0,deny,60,60,0,1,0,1,0
57017,53,22107,53,allow,177,94,83,2,30,1,1
56262,53,55550,53,allow,177,94,83,2,31,1,1
5588,5588,0,0,allow,3354,1792,1562,46,193,23,23
64270,443,64270,443,allow,4747,1840,2907,19,27,11,8
49932,443,32840,443,allow,8428,1889,6539,25,16,13,12
56376,53,45759,53,allow,196,100,96,2,30,1,1
33775,80,33775,80,allow,424,198,226,7,142,4,3
56186,53,3994,53,allow,198,102,96,2,29,1,1
50717,445,0,0,drop,66,66,0,1,0,1,0
50862,443,25283,443,allow,1501,590,911,12,26,6,6
63547,37965,0,0,deny,66,66,0,1,0,1,0
44805,3389,44805,3389,allow,4870,2631,2239,23,19,13,10
61855,445,0,0,drop,70,70,0,1,0,1,0
34170,80,4419,80,allow,2865,2000,865,12,16,7,5
45154,53,45154,53,allow,236,108,128,2,31,1,1
35149,53,35149,53,allow,235,90,145,2,32,1,1
34306,53,34306,53,allow,241,98,143,2,30,1,1
46232,53,46232,53,allow,216,90,126,2,30,1,1
47783,50432,0,0,deny,62,62,0,1,0,1,0
51666,443,15224,443,allow,3256,2213,1043,16,15,8,8
47200,443,56772,443,allow,11003,3821,7182,35,257,14,21
53287,445,0,0,drop,70,70,0,1,0,1,0
9707,3389,9707,3389,allow,3441,1552,1889,17,21,10,7
55161,53,9497,53,allow,732,89,643,2,30,1,1
49384,53,28867,53,allow,305,93,212,4,48,2,2
52144,49344,0,0,deny,62,62,0,1,0,1,0
58638,5900,0,0,deny,62,62,0,1,0,1,0
33445,53,19899,53,allow,168,78,90,2,29,1,1
53257,443,20854,443,allow,7422,1563,5859,32,53,15,17
56765,53,25229,53,allow,194,102,92,2,29,1,1
53971,80,16324,80,allow,662,448,214,10,15,7,3
53227,64097,0,0,deny,66,66,0,1,0,1,0
31609,25174,0,0,deny,62,62,0,1,0,1,0
52791,445,0,0,drop,66,66,0,1,0,1,0
37522,22114,0,0,deny,62,62,0,1,0,1,0
64145,445,0,0,drop,66,66,0,1,0,1,0
50949,45960,0,0,deny,62,62,0,1,0,1,0
56569,53,53689,53,allow,183,94,89,2,30,1,1
8080,37965,0,0,deny,62,62,0,1,0,1,0
65159,53,58481,53,allow,500,204,296,6,75,3,3
37858,443,14705,443,allow,10281,2251,8030,25,17,14,11
54189,445,0,0,drop,66,66,0,1,0,1,0
34211,23,0,0,deny,60,60,0,1,0,1,0
58771,80,60976,80,allow,3312,1569,1743,12,135,7,5
62929,443,8515,443,allow,46033,7524,38509,103,141,49,54
49451,443,37319,443,allow,1855625,57182,1798443,1981,70,703,1278
50149,80,19755,80,allow,78701,4331,74370,77,75,21,56
58638,5900,0,0,deny,62,62,0,1,0,1,0
63079,443,63360,443,allow,304,86,218,2,30,1,1
56995,53,58865,53,allow,168,86,82,2,31,1,1
56651,80,31520,80,allow,11855,7269,4586,28,115,15,13
43350,58414,0,0,deny,66,66,0,1,0,1,0
60720,23718,0,0,deny,62,62,0,1,0,1,0
51754,1182,24029,1182,allow,70,70,0,1,5,1,0
57432,53,10564,53,allow,193,102,91,2,31,1,1
42291,53,6078,53,allow,168,78,90,2,30,1,1
56601,443,9573,443,allow,7889,1900,5989,20,15,11,9
49829,443,43793,443,allow,3026,1775,1251,23,74,14,9
63626,445,0,0,drop,66,66,0,1,0,1,0
63243,53,40178,53,allow,330,228,102,3,33,2,1
65455,445,0,0,drop,70,70,0,1,0,1,0
37896,443,37896,443,allow,4704,1797,2907,19,30,11,8
64067,53,52701,53,allow,329,94,235,2,29,1,1
58729,445,0,0,drop,70,70,0,1,0,1,0
55589,53,12456,53,allow,177,94,83,2,30,1,1
64267,445,0,0,drop,70,70,0,1,0,1,0
65082,53,20499,53,allow,183,94,89,2,31,1,1
49430,53,18362,53,allow,279,94,185,2,30,1,1
52705,80,52705,80,allow,7237,2578,4659,19,16,9,10
63060,53,7236,53,allow,304,86,218,2,30,1,1
44967,53,51774,53,allow,198,93,105,2,31,1,1
43747,22114,0,0,deny,62,62,0,1,0,1,0
43879,443,28850,443,allow,71822,4809,67013,112,241,54,58
26752,64147,0,0,deny,62,62,0,1,0,1,0
56646,48817,0,0,deny,62,62,0,1,0,1,0
51812,15279,9004,15279,allow,70,70,0,2,8,2,0
0,0,0,0,deny,70,70,0,1,0,1,0
24891,53,42889,53,allow,168,78,90,2,30,1,1
63340,53,0,0,deny,84,84,0,1,0,1,0
58969,80,39801,80,allow,1431,783,648,10,75,6,4
49418,27017,12752,27017,allow,283,71,212,2,31,1,1
56472,53,22766,53,allow,177,94,83,2,30,1,1
47944,50584,0,0,deny,62,62,0,1,0,1,0
64739,53,12107,53,allow,172,94,78,2,30,1,1
55415,445,0,0,drop,70,70,0,1,0,1,0
51604,445,0,0,drop,70,70,0,1,0,1,0
26900,27017,31665,27017,allow,254,82,172,4,30,2,2
61375,445,0,0,drop,70,70,0,1,0,1,0
3792,52700,0,0,deny,62,62,0,1,0,1,0
50026,445,0,0,drop,70,70,0,1,0,1,0
51057,445,0,0,drop,66,66,0,1,0,1,0
54539,445,0,0,drop,66,66,0,1,0,1,0
443,18411,0,0,deny,74,74,0,1,0,1,0
49163,36069,48102,36069,allow,5990,5698,292,17,51,14,3
37555,16386,23177,16386,allow,130,70,60,2,30,1,1
52614,44847,0,0,deny,62,62,0,1,0,1,0
63153,445,0,0,drop,70,70,0,1,0,1,0
42128,54532,0,0,deny,60,60,0,1,0,1,0
40865,8100,52976,8100,allow,78,78,0,1,5,1,0
55225,11392,0,0,deny,66,66,0,1,0,1,0
38653,21247,0,0,deny,62,62,0,1,0,1,0
65165,53,53498,53,allow,200,102,98,2,30,1,1
27997,53,0,0,allow,223,86,137,2,30,1,1
49619,443,17429,443,allow,46202,8086,38116,131,243,69,62
52943,443,54392,443,allow,14640,5951,8689,52,115,26,26
55184,53,59449,53,allow,183,94,89,2,30,1,1
50353,445,0,0,drop,70,70,0,1,0,1,0
65357,53,31464,53,allow,256,93,163,2,30,1,1
40885,443,32340,443,allow,4014,1592,2422,17,147,9,8
56107,53,24230,53,allow,194,102,92,2,30,1,1
44491,50584,0,0,deny,62,62,0,1,0,1,0
52988,445,0,0,drop,70,70,0,1,0,1,0
50584,15926,55734,15926,allow,1377,300,1077,6,1200,3,3
55068,445,0,0,drop,70,70,0,1,0,1,0
65339,445,0,0,drop,70,70,0,1,0,1,0
28085,36237,0,0,deny,66,66,0,1,0,1,0
64608,53,18292,53,allow,212,110,102,2,30,1,1
56560,443,46506,443,allow,84111,3300,80811,104,54,41,63
63174,445,0,0,drop,70,70,0,1,0,1,0
26425,22114,0,0,deny,146,146,0,1,0,1,0
54402,445,0,0,drop,70,70,0,1,0,1,0
54529,445,0,0,drop,70,70,0,1,0,1,0
63898,445,0,0,drop,70,70,0,1,0,1,0
58638,5900,0,0,deny,62,62,0,1,0,1,0
46211,443,8239,443,allow,9805,1642,8163,24,362,12,12
18683,26467,0,0,deny,62,62,0,1,0,1,0
58041,445,0,0,drop,70,70,0,1,0,1,0
57240,53,32655,53,allow,180,94,86,2,29,1,1
51947,80,31823,80,allow,1582,866,716,11,27,7,4
56100,53,6720,53,allow,216,110,106,2,30,1,1
52938,443,4484,443,allow,14896,6021,8875,56,115,27,29
56910,53,59135,53,allow,211,78,133,2,30,1,1
57348,443,22476,443,allow,6250,1312,4938,23,315,12,11
56815,50510,55664,50510,allow,70,70,0,1,5,1,0
53002,80,19802,80,allow,1601,761,840,10,334,6,4
64989,53,29167,53,allow,214,94,120,2,31,1,1
8999,15503,0,0,deny,146,146,0,1,0,1,0
55065,53,19490,53,allow,711,87,624,2,30,1,1
49041,443,30685,443,allow,5144,847,4297,16,132,9,7
55045,53,21912,53,allow,261,102,159,2,30,1,1
61312,445,0,0,drop,70,70,0,1,0,1,0
33304,443,15471,443,allow,1067,650,417,10,73,6,4
26906,22114,0,0,deny,62,62,0,1,0,1,0
61781,445,0,0,drop,70,70,0,1,0,1,0
60312,57470,0,0,deny,74,74,0,1,0,1,0
64949,53,48447,53,allow,212,110,102,2,31,1,1
57015,53,61760,53,allow,279,94,185,2,30,1,1
56639,48817,0,0,deny,66,66,0,1,0,1,0
50265,56845,47720,56845,allow,480,149,331,2,1200,1,1
51320,37965,0,0,deny,62,62,0,1,0,1,0
61753,445,0,0,drop,70,70,0,1,0,1,0
53777,443,29327,443,allow,495,421,74,4,0,3,1
41561,23,0,0,deny,60,60,0,1,0,1,0
6333,53,6333,53,allow,216,90,126,2,30,1,1
3688,80,37150,80,allow,7072,1145,5927,20,105,12,8
51385,161,51385,161,allow,2315,979,1336,10,30,5,5
55230,445,0,0,drop,70,70,0,1,0,1,0
57665,5228,43757,5228,allow,2391,1434,957,16,3601,8,8
37075,80,59950,80,allow,1597,783,814,10,15,5,5
49959,80,5453,80,allow,9763,749,9014,17,15,8,9
49662,445,0,0,drop,70,70,0,1,0,1,0
10019,443,53412,443,allow,1497912,26236,1471676,1321,121,299,1022
55443,53,31894,53,allow,751,95,656,2,31,1,1
55285,53,18984,53,allow,268,95,173,4,46,2,2
61925,80,57280,80,allow,2418,495,1923,11,125,6,5
56562,53,8442,53,allow,726,85,641,2,30,1,1
50745,445,0,0,drop,70,70,0,1,0,1,0
38885,21247,0,0,deny,62,62,0,1,0,1,0
63982,25174,0,0,deny,66,66,0,1,0,1,0
56051,53,2559,53,allow,249,102,147,2,29,1,1
64956,53,40414,53,allow,402,118,284,2,29,1,1
44319,443,43736,443,allow,13919,3349,10570,46,120,25,21
50584,26433,35868,26433,allow,166,166,0,1,1200,1,0
57307,53,15696,53,allow,177,94,83,2,30,1,1
38753,443,17390,443,allow,29887852,586245,29301607,27419,299,7975,19444
49883,53,42017,53,allow,177,94,83,2,30,1,1
65379,53,64746,53,allow,376,126,250,2,30,1,1
51104,445,0,0,drop,66,66,0,1,0,1,0
64045,445,0,0,drop,70,70,0,1,0,1,0
58638,5900,0,0,deny,62,62,0,1,0,1,0
57425,443,33540,443,allow,130,70,60,2,15,1,1
46512,63836,0,0,deny,148,148,0,1,0,1,0
58389,445,0,0,drop,70,70,0,1,0,1,0
58580,445,0,0,drop,66,66,0,1,0,1,0
59161,445,0,0,drop,70,70,0,1,0,1,0
56131,53,35553,53,allow,199,94,105,2,29,1,1
21108,25174,0,0,deny,62,62,0,1,0,1,0
64106,53,22227,53,allow,309,102,207,4,53,2,2
27005,32028,64745,32028,allow,900,126,774,2,31,1,1
51932,36498,31404,36498,allow,70,70,0,2,8,2,0
37009,53,17382,53,allow,78,78,0,1,30,1,0
64414,53,36942,53,allow,183,94,89,2,29,1,1
60307,443,42783,443,allow,5574,1200,4374,26,80,13,13
49964,445,0,0,drop,70,70,0,1,0,1,0
64607,443,37548,443,allow,3182,1568,1614,8,120,4,4
63734,28221,28610,28221,allow,70,70,0,1,4,1,0
63117,7000,63117,7000,allow,4067,1750,2317,16,15,9,7
60383,445,0,0,drop,66,66,0,1,0,1,0
56579,445,0,0,drop,66,66,0,1,0,1,0
26408,64147,0,0,deny,66,66,0,1,0,1,0
55030,53,38017,53,allow,185,102,83,2,30,1,1
54688,445,0,0,drop,70,70,0,1,0,1,0
20544,5223,0,0,deny,148,148,0,1,0,1,0
42310,443,52115,443,allow,6673,2151,4522,27,125,13,14
61013,41705,0,0,deny,66,66,0,1,0,1,0
63598,64147,0,0,deny,66,66,0,1,0,1,0
27005,27018,42119,27018,allow,881,126,755,2,30,1,1
51304,443,20155,443,allow,7134,3081,4053,24,121,11,13
52188,13182,48724,13182,allow,70,70,0,2,9,2,0
55068,443,46144,443,allow,5611,3720,1891,28,54,16,12
48676,53395,48676,53395,allow,124,60,64,3,5,2,1
54538,445,0,0,drop,70,70,0,1,0,1,0
53672,20380,47465,20380,allow,70,70,0,1,4,1,0
22409,55442,0,0,deny,74,74,0,1,0,1,0
6712,161,0,0,deny,82,82,0,1,0,1,0
60075,443,54321,443,allow,6300,1427,4873,20,141,9,11
9528,44847,0,0,deny,146,146,0,1,0,1,0
37965,51413,23143,51413,allow,2020,1090,930,18,1200,15,3
56794,445,0,0,drop,70,70,0,1,0,1,0
64942,53,24439,53,allow,522,190,332,5,48,3,2
4607,6004,0,0,deny,70,70,0,1,0,1,0
55155,53,23280,53,allow,194,102,92,2,30,1,1
53289,445,0,0,drop,66,66,0,1,0,1,0
63043,445,0,0,drop,70,70,0,1,0,1,0
62405,445,0,0,drop,70,70,0,1,0,1,0
3478,61463,0,0,deny,164,164,0,1,0,1,0
56589,53,43560,53,allow,166,86,80,2,31,1,1
65516,53,41111,53,allow,290,94,196,4,40,2,2
52176,443,52176,443,allow,126525,6370,120155,147,22,56,91
27005,27019,64712,27019,allow,1624,126,1498,4,31,2,2
28584,37965,0,0,deny,62,62,0,1,0,1,0
51500,443,57250,443,allow,7211,823,6388,16,15,10,6
35207,22114,0,0,deny,146,146,0,1,0,1,0
24227,48817,0,0,deny,160,160,0,1,0,1,0
53964,445,0,0,drop,70,70,0,1,0,1,0
58806,443,62353,443,allow,10442,6793,3649,30,17,16,14
46516,57470,0,0,deny,62,62,0,1,0,1,0
27841,35894,0,0,deny,62,62,0,1,0,1,0
65251,53,48559,53,allow,198,101,97,2,30,1,1
59031,80,8208,80,allow,4119,611,3508,12,18,4,8
52717,53,4391,53,allow,277,94,183,2,30,1,1
56950,53,63422,53,allow,211,102,109,2,30,1,1
58804,443,5956,443,allow,5167,700,4467,16,15,7,9
50052,65008,0,0,deny,60,60,0,1,0,1,0
46985,443,26507,443,allow,4957,3488,1469,25,51,15,10
52415,445,0,0,drop,66,66,0,1,0,1,0
41756,56205,0,0,deny,62,62,0,1,0,1,0
65306,443,3584,443,allow,5756,1781,3975,23,136,11,12
59781,443,23445,443,allow,546,180,366,10,28,4,6
49835,53,35014,53,allow,168,86,82,2,30,1,1
51346,51221,0,0,deny,74,74,0,1,0,1,0
53161,445,0,0,drop,66,66,0,1,0,1,0
65183,27126,22289,27126,allow,268,78,190,2,30,1,1
65339,53,13346,53,allow,949,285,664,8,39,4,4
53781,37965,0,0,deny,62,62,0,1,0,1,0
51811,443,57601,443,allow,18108,1782,16326,31,215,15,16
62077,443,1621,443,allow,17761,7207,10554,44,46,25,19
55734,445,0,0,drop,70,70,0,1,0,1,0
53234,443,19776,443,allow,21571,8604,12967,38,34,19,19
56604,3389,56604,3389,allow,3424,1710,1714,16,31,8,8
58344,445,0,0,drop,66,66,0,1,0,1,0
26085,51221,0,0,deny,72,72,0,1,0,1,0
57555,35440,0,0,deny,66,66,0,1,0,1,0
60263,445,0,0,drop,66,66,0,1,0,1,0
50457,445,0,0,drop,70,70,0,1,0,1,0
57007,53,62995,53,allow,183,94,89,2,31,1,1
55640,54435,42654,54435,allow,70,70,0,1,5,1,0
53782,42855,41001,42855,allow,70,70,0,2,8,2,0
51846,445,0,0,drop,70,70,0,1,0,1,0
56344,53,47952,53,allow,199,102,97,2,30,1,1
10436,37965,0,0,deny,62,62,0,1,0,1,0
61961,11392,0,0,deny,66,66,0,1,0,1,0
55126,53,10895,53,allow,193,102,91,2,31,1,1
36946,123,44700,123,allow,184,94,90,2,30,1,1
4544,41599,1547,41599,allow,710,710,0,6,302,6,0
59501,445,0,0,drop,70,70,0,1,0,1,0
64624,445,0,0,drop,70,70,0,1,0,1,0
64981,27068,50495,27068,allow,1680,1386,294,7,30,4,3
49481,53,5935,53,allow,232,102,130,2,30,1,1
60092,51505,0,0,deny,62,62,0,1,0,1,0
37028,51505,0,0,deny,62,62,0,1,0,1,0
27448,22114,0,0,deny,62,62,0,1,0,1,0
52092,443,50536,443,allow,4642,3496,1146,18,16,10,8
49594,22114,0,0,deny,66,66,0,1,0,1,0
50115,445,0,0,drop,70,70,0,1,0,1,0
42520,443,59710,443,allow,6795,2090,4705,27,21,15,12
63868,60392,39941,60392,allow,66,66,0,2,7,2,0
56804,53,22833,53,allow,760,96,664,2,31,1,1
55228,445,0,0,drop,70,70,0,1,0,1,0
49797,53,55138,53,allow,767,102,665,2,31,1,1
27691,53,27691,53,allow,235,90,145,2,32,1,1
47039,443,29901,443,allow,2809,1884,925,19,25,11,8
54773,50584,0,0,deny,62,62,0,1,0,1,0
57464,80,18705,80,allow,78,78,0,1,5,1,0
0,0,0,0,deny,156,156,0,2,0,2,0
50601,53,58017,53,allow,760,97,663,2,30,1,1
56945,445,0,0,drop,70,70,0,1,0,1,0
52950,445,0,0,drop,70,70,0,1,0,1,0
56100,53,43759,53,allow,701,88,613,2,30,1,1
34572,443,63392,443,allow,52330,13948,38382,131,129,71,60
60589,445,0,0,drop,70,70,0,1,0,1,0
49997,53,42386,53,allow,264,102,162,2,30,1,1
50661,443,13443,443,allow,298067,6719,291348,307,17,98,209
59618,46824,0,0,deny,66,66,0,1,0,1,0
50357,445,0,0,drop,66,66,0,1,0,1,0
57605,443,60913,443,allow,2614,1689,925,18,20,10,8
50222,42873,0,0,deny,66,66,0,1,0,1,0
57880,80,31507,80,allow,13028,3246,9782,29,30,16,13
56511,445,0,0,drop,66,66,0,1,0,1,0
57912,443,23938,443,allow,7953,5153,2800,33,142,19,14
57434,443,22130,443,allow,9237,2447,6790,30,16,14,16
52286,995,52286,995,allow,146,82,64,2,5,1,1
61891,445,0,0,drop,70,70,0,1,0,1,0
62505,443,46992,443,allow,14891,3970,10921,32,33,15,17
58638,5900,58638,5900,allow,126,62,64,2,5,1,1
50742,445,0,0,drop,66,66,0,1,0,1,0
57103,53,56809,53,allow,193,102,91,2,30,1,1
64112,53,32226,53,allow,281,94,187,2,30,1,1
50037,53,65320,53,allow,195,102,93,2,31,1,1
64100,445,0,0,drop,66,66,0,1,0,1,0
56911,53,36658,53,allow,177,94,83,2,31,1,1
3478,61463,0,0,deny,1162,1162,0,1,0,1,0
50708,445,0,0,drop,66,66,0,1,0,1,0
56088,53,23327,53,allow,256,93,163,2,31,1,1
51806,443,40388,443,allow,3182,1568,1614,8,121,4,4
49516,445,0,0,drop,70,70,0,1,0,1,0
36034,35440,0,0,deny,146,146,0,1,0,1,0
55345,53,38199,53,allow,255,102,153,2,30,1,1
59001,445,0,0,drop,70,70,0,1,0,1,0
24127,23,0,0,deny,60,60,0,1,0,1,0
56594,80,5980,80,allow,234,234,0,4,11,4,0
0,0,0,0,allow,156,156,0,2,0,2,0
56607,443,26886,443,allow,133596,5859,127737,148,120,51,97
50316,53,18070,53,allow,816,102,714,2,30,1,1
52082,14804,9932,14804,allow,70,70,0,2,8,2,0
21674,28189,0,0,deny,60,60,0,1,0,1,0
52465,445,0,0,drop,70,70,0,1,0,1,0
41197,30188,0,0,deny,62,62,0,1,0,1,0
64713,445,0,0,drop,70,70,0,1,0,1,0
9141,80,1670,80,allow,378,192,186,7,29,4,3
51934,443,39970,443,allow,9735,2891,6844,36,82,17,19
44984,443,57604,443,allow,4499,2807,1692,24,95,13,11
58563,53,4425,53,allow,312,78,234,2,29,1,1
7222,57470,0,0,deny,62,62,0,1,0,1,0
54373,443,3920,443,allow,16029,6377,9652,46,37,24,22
54530,35440,0,0,deny,66,66,0,1,0,1,0
60385,59696,28455,59696,allow,70,70,0,2,8,2,0
53527,45626,48951,45626,allow,70,70,0,2,7,2,0
55123,53,57840,53,allow,198,102,96,2,31,1,1
49906,53,24653,53,allow,200,94,106,2,29,1,1
55542,53,5716,53,allow,170,87,83,2,30,1,1
57464,80,36285,80,allow,234,234,0,4,11,4,0
39809,23,0,0,deny,60,60,0,1,0,1,0
60194,80,35341,80,allow,70,70,0,2,8,2,0
59779,443,65358,443,allow,18360,1734,16626,32,28,13,19
51695,37590,12016,37590,allow,70,70,0,1,5,1,0
49418,27018,53537,27018,allow,256,78,178,2,30,1,1
57349,445,0,0,drop,70,70,0,1,0,1,0
58302,443,57426,443,allow,4568,2059,2509,17,33,9,8
58058,80,25761,80,allow,318,192,126,6,21,4,2
41543,443,50786,443,allow,78,78,0,1,5,1,0
64950,53,11191,53,allow,326,88,238,4,52,2,2
61078,57470,0,0,deny,145,145,0,1,0,1,0
60413,43555,44163,43555,allow,70,70,0,2,8,2,0
60917,445,0,0,drop,70,70,0,1,0,1,0
24624,443,24624,443,allow,5198,2221,2977,19,16,10,9
50584,54157,4800,54157,allow,1377,300,1077,6,1200,3,3
28832,36237,0,0,deny,66,66,0,1,0,1,0
51401,443,31981,443,allow,6537,3702,2835,34,170,17,17
64429,445,0,0,drop,70,70,0,1,0,1,0
63046,445,0,0,drop,70,70,0,1,0,1,0
49798,445,0,0,drop,70,70,0,1,0,1,0
63966,53,6914,53,allow,214,102,112,2,30,1,1
26229,21247,0,0,deny,62,62,0,1,0,1,0
49708,53,19029,53,allow,186,95,91,2,31,1,1
59982,80,63868,80,allow,207418,4580,202838,194,143,50,144
17232,22114,0,0,deny,62,62,0,1,0,1,0
46857,443,55410,443,allow,280,140,140,5,129,3,2
56067,25174,0,0,deny,62,62,0,1,0,1,0
55231,443,25575,443,allow,10684454,328574,10355880,11599,77,3693,7906
55933,53,42992,53,allow,182,94,88,2,30,1,1
57007,53,22184,53,allow,182,93,89,2,31,1,1
41284,443,45151,443,allow,7252,2147,5105,18,136,8,10
55550,445,0,0,drop,66,66,0,1,0,1,0
49418,27015,10254,27015,allow,78,78,0,1,30,1,0
27005,27017,49884,27017,allow,877,126,751,2,31,1,1
51339,50584,0,0,deny,62,62,0,1,0,1,0
55377,53,33641,53,allow,195,102,93,2,30,1,1
49267,53,55947,53,allow,184,94,90,2,30,1,1
64656,53,38366,53,allow,718,94,624,2,30,1,1
57442,66,49848,66,allow,70,70,0,2,8,2,0
64283,53,39891,53,allow,337,110,227,2,29,1,1
62681,445,0,0,drop,66,66,0,1,0,1,0
18650,23718,0,0,deny,62,62,0,1,0,1,0
63853,443,40585,443,allow,3182,1568,1614,8,120,4,4
64746,53,35675,53,allow,193,102,91,2,30,1,1
58795,443,24808,443,allow,10273,2573,7700,24,305,8,16
34107,443,34100,443,allow,11976,5066,6910,83,2475,43,40
56854,17067,53674,17067,allow,70,70,0,2,8,2,0
49769,445,0,0,drop,70,70,0,1,0,1,0
55079,25174,0,0,deny,66,66,0,1,0,1,0
64689,53,47457,53,allow,763,102,661,2,30,1,1
42982,443,14998,443,allow,7467,1522,5945,26,16,14,12
31609,25174,0,0,deny,62,62,0,1,0,1,0
39336,443,13653,443,allow,4362,1145,3217,17,25,9,8
54134,64147,0,0,deny,66,66,0,1,0,1,0
51174,80,58764,80,allow,1658,1344,314,10,15,5,5
56987,53,21347,53,allow,196,102,94,2,30,1,1
59912,53,38804,53,allow,168,78,90,2,30,1,1
63727,445,0,0,drop,70,70,0,1,0,1,0
65319,445,0,0,drop,66,66,0,1,0,1,0
50726,443,17287,443,allow,6464,2707,3757,39,151,18,21
22528,25174,0,0,deny,146,146,0,1,0,1,0
57885,445,0,0,drop,70,70,0,1,0,1,0
64514,445,0,0,drop,70,70,0,1,0,1,0
49540,443,8159,443,allow,7454,2377,5077,33,130,15,18
65025,57866,0,0,deny,66,66,0,1,0,1,0
50646,80,29942,80,allow,1328,917,411,10,25,6,4
52837,35440,0,0,deny,66,66,0,1,0,1,0
52718,445,0,0,drop,70,70,0,1,0,1,0
53107,445,0,0,drop,70,70,0,1,0,1,0
64746,53,10441,53,allow,260,86,174,2,30,1,1
51646,80,56559,80,allow,378,192,186,7,38,4,3
51414,22,0,0,deny,60,60,0,1,0,1,0
56006,53,33224,53,allow,183,102,81,2,30,1,1
41902,443,1832,443,allow,6511,1866,4645,21,17,12,9
57804,445,0,0,drop,70,70,0,1,0,1,0
65350,53,14923,53,allow,212,102,110,2,31,1,1
60018,443,59209,443,allow,117023,8825,108198,138,143,49,89
59277,53,14948,53,allow,164,78,86,2,29,1,1
33970,443,28633,443,allow,2586,832,1754,14,15,7,7
49663,80,43225,80,allow,8935,3175,5760,17,41,8,9
53577,35894,0,0,deny,66,66,0,1,0,1,0
39814,53,58386,53,allow,168,78,90,2,30,1,1
53917,80,62681,80,allow,1829,755,1074,10,15,6,4
65294,53,10566,53,allow,165,86,79,2,30,1,1
50799,445,0,0,drop,66,66,0,1,0,1,0
56987,80,45961,80,allow,214,140,74,4,35,3,1
64985,445,0,0,drop,66,66,0,1,0,1,0
56330,53,40178,53,allow,271,95,176,4,48,2,2
0,0,0,0,deny,102,102,0,1,0,1,0
55699,21063,32423,21063,allow,70,70,0,2,8,2,0
56003,445,0,0,drop,66,66,0,1,0,1,0
26439,37965,0,0,deny,66,66,0,1,0,1,0
58716,445,0,0,drop,70,70,0,1,0,1,0
65270,3855,0,0,deny,78,78,0,1,0,1,0
49012,443,59626,443,allow,44584,2838,41746,66,31,31,35
37651,443,37651,443,allow,4659,1752,2907,19,30,11,8
64938,445,0,0,drop,66,66,0,1,0,1,0
64129,445,0,0,drop,70,70,0,1,0,1,0
42441,123,34753,123,allow,184,94,90,2,30,1,1
55934,53,23725,53,allow,182,102,80,2,30,1,1
63915,23225,23322,23225,allow,564,382,182,9,15,6,3
16387,51369,0,0,deny,60,60,0,1,0,1,0
55382,53,39381,53,allow,226,110,116,2,30,1,1
56362,53,52775,53,allow,453,186,267,6,30,3,3
6881,50321,43265,50321,allow,238,118,120,2,1199,1,1
53752,445,0,0,drop,66,66,0,1,0,1,0
55189,53,54191,53,allow,211,102,109,2,30,1,1
27005,27016,20035,27016,allow,903,126,777,2,31,1,1
51417,445,0,0,drop,70,70,0,1,0,1,0
54894,9571,0,0,deny,66,66,0,1,0,1,0
19412,53,19412,53,allow,229,98,131,2,30,1,1
57470,39541,8082,39541,allow,792,792,0,13,1200,13,0
56266,53,14847,53,allow,186,95,91,2,31,1,1
46544,443,31614,443,allow,332590,15084,317506,341,139,89,252
51132,445,0,0,drop,70,70,0,1,0,1,0
50360,35440,0,0,deny,66,66,0,1,0,1,0
50823,80,36399,80,allow,35970,11674,24296,108,265,55,53
51184,445,0,0,drop,66,66,0,1,0,1,0
62448,445,0,0,drop,70,70,0,1,0,1,0
51404,445,0,0,drop,70,70,0,1,0,1,0
59030,443,52271,443,allow,10079,2210,7869,36,120,19,17
54309,80,4585,80,allow,552,280,272,9,30,5,4
58638,5900,0,0,deny,62,62,0,1,0,1,0
59293,445,0,0,drop,66,66,0,1,0,1,0
52648,443,16992,443,allow,64748,15327,49421,87,273,39,48
65524,53,51364,53,allow,182,93,89,2,31,1,1
1024,64147,0,0,deny,62,62,0,1,0,1,0
62145,445,0,0,drop,70,70,0,1,0,1,0
53003,11392,0,0,deny,66,66,0,1,0,1,0
56518,53,42205,53,allow,177,94,83,2,29,1,1
50558,53,44600,53,allow,733,94,639,2,30,1,1
64987,53,19027,53,allow,196,100,96,2,30,1,1
56822,39352,35185,39352,allow,70,70,0,1,5,1,0
64406,50584,0,0,deny,62,62,0,1,0,1,0
12465,11392,0,0,deny,62,62,0,1,0,1,0
11716,37965,0,0,deny,62,62,0,1,0,1,0
38610,443,57889,443,allow,19092095,654744,18437351,24079,407,8531,15548
63516,445,0,0,drop,70,70,0,1,0,1,0
50568,443,35404,443,allow,5877,1792,4085,21,81,12,9
61437,443,53093,443,allow,4872,771,4101,17,28,8,9
53950,32057,38888,32057,allow,70,70,0,2,7,2,0
56458,53,9119,53,allow,196,102,94,2,31,1,1
45654,67,0,0,deny,60,60,0,1,0,1,0
61544,53,18551,53,allow,325,86,239,2,30,1,1
63025,443,40805,443,allow,304,86,218,2,30,1,1
51953,37965,0,0,deny,66,66,0,1,0,1,0
55865,53,14766,53,allow,325,98,227,4,40,2,2
53558,30815,59383,30815,allow,492,306,186,8,16,5,3
38608,443,19892,443,allow,17473899,604274,16869625,22165,408,7731,14434
57573,443,57573,443,allow,775362,32338,743024,683,180,169,514
55179,53,20932,53,allow,194,102,92,2,35,1,1
55491,80,9905,80,allow,204936,10932,194004,277,31,140,137
54031,443,8430,443,allow,350,210,140,6,25,4,2
64017,53,64345,53,allow,325,103,222,4,45,2,2
60710,53,32625,53,allow,211,78,133,2,30,1,1
62492,445,0,0,drop,70,70,0,1,0,1,0
57417,53,7685,53,allow,199,102,97,2,30,1,1
62089,445,0,0,drop,70,70,0,1,0,1,0
54293,445,0,0,drop,70,70,0,1,0,1,0
16387,26637,0,0,allow,60,60,0,1,61,1,0
33215,37965,0,0,deny,62,62,0,1,0,1,0
54940,445,0,0,drop,70,70,0,1,0,1,0
13559,57866,0,0,deny,66,66,0,1,0,1,0
52189,24190,3693,24190,allow,70,70,0,2,9,2,0
62034,53,62034,53,allow,216,90,126,2,30,1,1
54974,443,56766,443,allow,8670,2248,6422,36,90,21,15
49432,80,52783,80,allow,2231,899,1332,15,92,8,7
27005,23333,41916,23333,allow,890,126,764,3,32,2,1
43724,35440,0,0,deny,146,146,0,1,0,1,0
11228,25174,0,0,deny,66,66,0,1,0,1,0
49325,443,64992,443,allow,6141,949,5192,17,21,9,8
58894,443,36068,443,allow,5168,700,4468,16,15,7,9
49566,443,56246,443,allow,2888,1389,1499,18,15,9,9
62167,445,0,0,drop,70,70,0,1,0,1,0
62148,37965,0,0,deny,62,62,0,1,0,1,0
49524,443,52573,443,allow,52864,3584,49280,86,95,39,47
53808,56215,39390,56215,allow,70,70,0,2,7,2,0
58638,5900,0,0,deny,62,62,0,1,0,1,0
56728,445,0,0,drop,70,70,0,1,0,1,0
36302,25174,0,0,deny,146,146,0,1,0,1,0
20057,44847,0,0,deny,62,62,0,1,0,1,0
51619,443,5811,443,allow,3894,863,3031,15,16,9,6
64499,445,0,0,drop,70,70,0,1,0,1,0
49741,53,44929,53,allow,177,94,83,2,30,1,1
39831,443,37659,443,allow,7656,4286,3370,38,86,19,19
56829,53,48980,53,allow,199,102,97,2,30,1,1
9057,443,55377,443,allow,7769,3958,3811,17,121,9,8
50684,80,37949,80,allow,66772,4924,61848,110,19,60,50
55549,53,55549,53,allow,228,90,138,2,30,1,1
49126,443,33194,443,allow,3800867,77753,3723114,3263,625,478,2785
58497,39004,0,0,deny,66,66,0,1,0,1,0
57156,445,0,0,drop,70,70,0,1,0,1,0
65492,53,43623,53,allow,199,102,97,2,30,1,1
58238,445,0,0,drop,70,70,0,1,0,1,0
61504,443,15507,443,allow,16708,2331,14377,31,21,14,17
52004,55711,7662,55711,allow,70,70,0,1,5,1,0
64294,64147,0,0,deny,146,146,0,1,0,1,0
44411,37965,0,0,deny,62,62,0,1,0,1,0
26900,27017,45404,27017,allow,422,164,258,6,30,3,3
49783,445,0,0,drop,70,70,0,1,0,1,0
58562,445,0,0,drop,70,70,0,1,0,1,0
63903,445,0,0,drop,70,70,0,1,0,1,0
65515,53,18334,53,allow,195,102,93,2,29,1,1
50288,443,59061,443,allow,8207,2558,5649,41,80,23,18
64082,53,61850,53,allow,329,102,227,2,30,1,1
58318,15503,0,0,deny,66,66,0,1,0,1,0
28033,443,38606,443,allow,6305,2124,4181,20,16,10,10
58676,445,0,0,drop,66,66,0,1,0,1,0
58278,445,0,0,drop,70,70,0,1,0,1,0
56625,53,59531,53,allow,186,95,91,2,31,1,1
64294,64147,0,0,deny,62,62,0,1,0,1,0
57288,443,16066,443,allow,7427,2084,5343,24,361,12,12
60749,40010,57224,40010,allow,316,136,180,6,5,3,3
63197,445,0,0,drop,66,66,0,1,0,1,0
47910,7454,0,0,deny,60,60,0,1,0,1,0
49235,80,47953,80,allow,1783342,58977,1724365,1613,162,445,1168
50349,443,62395,443,allow,1385,868,517,12,30,6,6
58638,5900,0,0,deny,62,62,0,1,0,1,0
52107,11191,10065,11191,allow,70,70,0,1,4,1,0
64801,53,57986,53,allow,211,102,109,2,29,1,1
24285,26467,0,0,deny,62,62,0,1,0,1,0
61959,445,0,0,drop,66,66,0,1,0,1,0
40294,28680,0,0,deny,145,145,0,1,0,1,0
49554,443,18292,443,allow,7540,1840,5700,18,15,10,8
48979,15000,58069,15000,allow,130,70,60,2,5,1,1
59366,53,31679,53,allow,242,78,164,2,30,1,1
61343,445,0,0,drop,70,70,0,1,0,1,0
49960,445,0,0,drop,70,70,0,1,0,1,0
55653,443,8699,443,allow,7267,2312,4955,16,120,7,9
41954,2323,0,0,deny,60,60,0,1,0,1,0
17177,64147,0,0,deny,62,62,0,1,0,1,0
11139,443,11139,443,allow,6981,948,6033,17,27,10,7
27773,56205,0,0,deny,62,62,0,1,0,1,0
13020,26467,0,0,deny,66,66,0,1,0,1,0
62067,445,0,0,drop,70,70,0,1,0,1,0
56536,53,9836,53,allow,202,103,99,2,31,1,1
55404,53,35517,53,allow,326,102,224,2,29,1,1
23296,23,0,0,deny,60,60,0,1,0,1,0
49835,53,4123,53,allow,250,86,164,4,30,2,2
64486,445,0,0,drop,70,70,0,1,0,1,0
45898,443,17048,443,allow,814431,31637,782794,913,315,346,567
54739,445,0,0,drop,66,66,0,1,0,1,0
63213,57866,0,0,deny,62,62,0,1,0,1,0
62945,445,0,0,drop,70,70,0,1,0,1,0
57729,445,0,0,drop,70,70,0,1,0,1,0
50380,80,4994,80,allow,3190,980,2210,13,30,7,6
51930,57470,0,0,deny,66,66,0,1,0,1,0
61329,51505,0,0,deny,62,62,0,1,0,1,0
53527,45626,13998,45626,allow,70,70,0,1,5,1,0
736,23,0,0,deny,60,60,0,1,0,1,0
39869,53,19258,53,allow,394,80,314,4,29,2,2
59950,53,51206,53,allow,395,115,280,2,30,1,1
37842,443,37842,443,allow,109189,6692,102497,151,80,69,82
49919,53,2531,53,allow,225,102,123,2,30,1,1
49652,80,41270,80,allow,1854,945,909,13,106,7,6
53640,28937,28393,28937,allow,70,70,0,1,5,1,0
51576,443,13071,443,allow,9753,2821,6932,39,201,22,17
53629,443,53629,443,allow,4620,1713,2907,19,30,11,8
57447,443,54490,443,allow,12192,3788,8404,36,18,18,18
52731,443,19807,443,allow,10819,5326,5493,45,16,27,18
54436,445,0,0,drop,70,70,0,1,0,1,0
62845,445,0,0,drop,70,70,0,1,0,1,0
37965,48167,49022,48167,allow,490,149,341,3,1199,2,1
54121,25174,0,0,deny,62,62,0,1,0,1,0
51944,80,27996,80,allow,2120,1080,1040,17,55,10,7
43584,24748,0,0,deny,156,156,0,1,0,1,0
58771,443,59212,443,allow,5750,1163,4587,25,258,13,12
51135,443,24290,443,allow,6678,1212,5466,22,256,12,10
50774,443,17270,443,allow,4521,2256,2265,15,135,7,8
53403,445,0,0,drop,70,70,0,1,0,1,0
44131,443,6596,443,allow,6582,1943,4639,14,122,7,7
6890,27520,0,0,deny,146,146,0,1,0,1,0
64808,62413,0,0,deny,66,66,0,1,0,1,0
33651,36237,0,0,deny,62,62,0,1,0,1,0
60879,443,57510,443,allow,15774,5540,10234,48,48,26,22
58481,37838,0,0,deny,146,146,0,1,0,1,0
52461,445,0,0,drop,70,70,0,1,0,1,0
60922,445,0,0,drop,66,66,0,1,0,1,0
49886,7000,49886,7000,allow,1236,676,560,13,15,7,6
54650,445,0,0,drop,66,66,0,1,0,1,0
56059,445,0,0,drop,70,70,0,1,0,1,0
65159,53,15273,53,allow,286,103,183,4,52,2,2
64975,445,0,0,drop,70,70,0,1,0,1,0
55525,443,64786,443,allow,5200,2825,2375,18,155,9,9
63135,443,47015,443,allow,7127,1737,5390,18,16,10,8
53161,51221,0,0,deny,66,66,0,1,0,1,0
50438,19426,0,0,deny,62,62,0,1,0,1,0
51763,80,41535,80,allow,3830,2255,1575,16,74,10,6
53156,443,62340,443,allow,3814,2664,1150,22,28,12,10
64749,53,21766,53,allow,227,110,117,2,30,1,1
61490,443,7323,443,allow,4561,1129,3432,22,109,13,9
51505,443,22811,443,allow,7211,823,6388,16,15,10,6
56557,53,41528,53,allow,214,110,104,2,30,1,1
56769,53,53195,53,allow,183,94,89,2,30,1,1
53584,62974,25990,62974,allow,70,70,0,2,8,2,0
53202,443,37949,443,allow,6043,1568,4475,11,120,4,7
49418,29999,18255,29999,allow,239,78,161,2,30,1,1
65481,53,60374,53,allow,168,86,82,2,30,1,1
49418,27016,26183,27016,allow,262,78,184,2,30,1,1
64958,53,33266,53,allow,395,102,293,2,30,1,1
51310,64147,0,0,deny,66,66,0,1,0,1,0
34787,80,1192,80,allow,2989,813,2176,15,166,8,7
62408,3478,24308,3478,allow,140,140,0,1,30,1,0
56421,53,57015,53,allow,177,94,83,2,30,1,1
58638,5900,0,0,deny,62,62,0,1,0,1,0
54369,443,44287,443,allow,11876,2769,9107,30,77,15,15
56612,443,14658,443,allow,4378,1140,3238,14,26,9,5
50750,445,0,0,drop,70,70,0,1,0,1,0
51502,443,63032,443,allow,6559,2158,4401,30,17,16,14
57676,445,0,0,drop,70,70,0,1,0,1,0
64742,53,28467,53,allow,173,94,79,2,29,1,1
53972,59089,65256,59089,allow,70,70,0,2,7,2,0
64987,53,36862,53,allow,410,100,310,4,55,2,2
42995,26467,0,0,deny,62,62,0,1,0,1,0
7664,2149,0,0,deny,62,62,0,1,0,1,0
55874,445,0,0,drop,70,70,0,1,0,1,0
42298,40026,9867,40026,allow,212,90,122,4,30,2,2
58743,35894,0,0,deny,62,62,0,1,0,1,0
30280,37965,0,0,deny,66,66,0,1,0,1,0
59326,57470,0,0,deny,74,74,0,1,0,1,0
32796,37965,0,0,deny,66,66,0,1,0,1,0
58120,445,0,0,drop,66,66,0,1,0,1,0
38100,53,30457,53,allow,168,78,90,2,30,1,1
65529,53,50654,53,allow,821,102,719,2,30,1,1
48744,443,35880,443,allow,2098,1239,859,22,20,12,10
60948,443,3715,443,allow,1373,712,661,14,18,8,6
64900,53,55374,53,allow,778,103,675,2,30,1,1
59523,445,0,0,drop,70,70,0,1,0,1,0
63772,445,0,0,drop,66,66,0,1,0,1,0
56127,53,8590,53,allow,166,85,81,2,31,1,1
21133,54322,33050,54322,allow,480,149,331,2,1200,1,1
27844,52700,0,0,deny,70,70,0,1,0,1,0
37998,49152,32246,49152,allow,156,156,0,3,8,3,0
54894,9571,0,0,deny,66,66,0,1,0,1,0
57151,39004,0,0,deny,66,66,0,1,0,1,0
61234,443,50660,443,allow,1786,172,1614,7,120,3,4
64944,443,63703,443,allow,48856,4158,44698,65,120,26,39
50797,445,0,0,drop,66,66,0,1,0,1,0
49789,445,0,0,drop,70,70,0,1,0,1,0
60783,40010,46411,40010,allow,316,136,180,6,6,3,3
56621,53,42291,53,allow,170,87,83,2,30,1,1
55678,52879,22607,52879,allow,70,70,0,1,5,1,0
49311,445,0,0,drop,66,66,0,1,0,1,0
65371,53,39965,53,allow,198,101,97,2,31,1,1
63980,53,48933,53,allow,225,102,123,2,30,1,1
56629,80,58427,80,allow,234,234,0,4,12,4,0
51910,60443,42638,60443,allow,66,66,0,1,5,1,0
50148,445,0,0,drop,66,66,0,1,0,1,0
35247,80,59441,80,allow,1614,1300,314,10,15,5,5
35207,22114,0,0,deny,62,62,0,1,0,1,0
35088,443,54099,443,allow,800,452,348,12,94,7,5
55617,53,20605,53,allow,214,110,104,2,30,1,1
27005,27015,43819,27015,allow,868,126,742,2,30,1,1
55084,445,0,0,drop,70,70,0,1,0,1,0
43324,22,43324,22,allow,8157,3445,4712,59,43,28,31
2267,53,56692,53,allow,204,118,86,2,30,1,1
18333,53,18333,53,allow,215,98,117,2,30,1,1
49723,53,39151,53,allow,427,90,337,4,41,2,2
50207,53,41164,53,allow,189,102,87,2,30,1,1
53358,445,0,0,drop,70,70,0,1,0,1,0
5938,35844,0,0,allow,60,60,0,1,91,1,0
40243,443,64916,443,allow,284,164,120,4,15,2,2
33568,443,55064,443,allow,9180,2197,6983,36,34,20,16
57828,445,0,0,drop,70,70,0,1,0,1,0
53111,50809,36816,50809,allow,70,70,0,2,8,2,0
55106,53,41822,53,allow,177,94,83,2,30,1,1
55043,445,0,0,drop,66,66,0,1,0,1,0
59168,39004,0,0,deny,62,62,0,1,0,1,0
57056,445,0,0,drop,70,70,0,1,0,1,0
49178,2710,40497,2710,allow,70,70,0,1,5,1,0
43033,443,43033,443,allow,10239,2017,8222,23,18,14,9
58869,443,7982,443,allow,4052,2588,1464,18,16,9,9
52185,13269,13389,13269,allow,70,70,0,1,4,1,0
443,45788,0,0,deny,332,332,0,1,0,1,0
58533,445,0,0,drop,70,70,0,1,0,1,0
63949,53,59282,53,allow,190,97,93,2,31,1,1
56830,53,57872,53,allow,190,97,93,2,31,1,1
45317,53,22055,53,allow,86,86,0,1,30,1,0
49619,53,50189,53,allow,789,110,679,2,30,1,1
19698,502,19698,502,allow,60,60,0,1,5,1,0
52929,43890,0,0,deny,66,66,0,1,0,1,0
54526,443,1853,443,allow,33625519,489773,33135746,29877,243,6803,23074
50372,445,0,0,drop,66,66,0,1,0,1,0
57431,53,35038,53,allow,392,134,258,2,30,1,1
62799,445,0,0,drop,70,70,0,1,0,1,0
51550,11392,0,0,deny,66,66,0,1,0,1,0
27005,27015,9880,27015,allow,937,126,811,2,30,1,1
62844,445,0,0,drop,70,70,0,1,0,1,0
64051,53,51013,53,allow,430,172,258,6,61,3,3
51987,445,0,0,drop,70,70,0,1,0,1,0
30960,45705,10345,45705,allow,396,396,0,7,3617,7,0
2946,25174,0,0,deny,146,146,0,1,0,1,0
55600,22,0,0,deny,60,60,0,1,0,1,0
44554,5900,0,0,deny,60,60,0,1,0,1,0
55745,53,20797,53,allow,199,102,97,2,30,1,1
26969,29434,0,0,deny,146,146,0,1,0,1,0
61609,445,0,0,drop,70,70,0,1,0,1,0
14032,53,14032,53,allow,235,90,145,2,32,1,1
43025,443,51895,443,allow,25223,13115,12108,63,116,33,30
45404,80,36835,80,allow,574,500,74,6,15,5,1
48840,443,52863,443,allow,3297,2327,970,22,51,11,11
39051,443,15445,443,allow,7082,4527,2555,31,31,16,15
57431,53,12541,53,allow,181,94,87,2,29,1,1
61455,64147,0,0,deny,66,66,0,1,0,1,0
55728,53,52425,53,allow,195,102,93,2,30,1,1
50001,53,34185,53,allow,239,94,145,2,29,1,1
49911,53,3623,53,allow,200,94,106,2,30,1,1
58730,443,58122,443,allow,5110,950,4160,21,48,10,11
61508,443,13468,443,allow,215490,8471,207019,194,45,45,149
59574,445,0,0,drop,70,70,0,1,0,1,0
50707,445,0,0,drop,70,70,0,1,0,1,0
64694,445,0,0,drop,70,70,0,1,0,1,0
52519,445,0,0,drop,66,66,0,1,0,1,0
52993,443,38783,443,allow,10754,4129,6625,42,112,20,22
58862,445,0,0,drop,70,70,0,1,0,1,0
53015,64147,0,0,deny,62,62,0,1,0,1,0
62671,445,0,0,drop,70,70,0,1,0,1,0
56406,445,0,0,drop,66,66,0,1,0,1,0
65018,7302,0,0,deny,146,146,0,1,0,1,0
57640,80,57640,80,allow,64437,2630,61807,64,31,18,46
57037,443,39402,443,allow,6847,1658,5189,21,25,12,9
52035,80,21577,80,allow,426,240,186,8,24,5,3
60205,53,4372,53,allow,491,115,376,2,31,1,1
20280,30188,0,0,deny,146,146,0,1,0,1,0
34313,53,0,0,allow,184,86,98,2,30,1,1
63355,443,59950,443,allow,2870,343,2527,11,120,5,6
59836,443,35828,443,allow,1394,733,661,14,80,8,6
56110,53,15545,53,allow,508,102,406,2,30,1,1
56234,80,56234,80,allow,44817,885,43932,46,15,13,33
60055,445,0,0,drop,70,70,0,1,0,1,0
58638,5900,0,0,deny,62,62,0,1,0,1,0
14023,37965,0,0,deny,62,62,0,1,0,1,0
63765,51221,0,0,deny,62,62,0,1,0,1,0
49896,443,39739,443,allow,151170,17408,133762,256,130,118,138
50351,445,0,0,drop,70,70,0,1,0,1,0
55053,53,47870,53,allow,216,102,114,2,30,1,1
14567,37965,0,0,deny,62,62,0,1,0,1,0
49418,27015,40892,27015,allow,250,78,172,2,30,1,1
60934,445,0,0,drop,66,66,0,1,0,1,0
53159,445,0,0,drop,66,66,0,1,0,1,0
54296,445,0,0,drop,70,70,0,1,0,1,0
60319,53,31437,53,allow,316,80,236,2,31,1,1
54389,28543,0,0,deny,66,66,0,1,0,1,0
58638,5900,0,0,deny,62,62,0,1,0,1,0
60013,443,65408,443,allow,145369,7769,137600,224,21,106,118
62320,445,0,0,drop,70,70,0,1,0,1,0
56876,53,26048,53,allow,283,110,173,2,29,1,1
55475,443,50971,443,allow,8714,1456,7258,25,32,13,12
54910,445,0,0,drop,70,70,0,1,0,1,0
54216,64147,0,0,deny,66,66,0,1,0,1,0
60117,445,0,0,drop,70,70,0,1,0,1,0
36656,64147,0,0,deny,62,62,0,1,0,1,0
20576,37965,0,0,deny,62,62,0,1,0,1,0
55551,53,53923,53,allow,180,94,86,2,30,1,1
54376,445,0,0,drop,70,70,0,1,0,1,0
50457,443,62733,443,allow,3091,1708,1383,15,21,9,6
49702,80,20428,80,allow,2014,1216,798,13,130,8,5
37751,53,37751,53,allow,194,87,107,2,30,1,1
58036,445,0,0,drop,70,70,0,1,0,1,0
52028,80,63717,80,allow,422,240,182,8,24,5,3
51920,443,50819,443,allow,98155,20830,77325,151,103,70,81
64053,53,64602,53,allow,276,94,182,4,55,2,2
42298,40022,27294,40022,allow,156,94,62,2,30,1,1
57894,44847,0,0,deny,62,62,0,1,0,1,0
63762,123,63358,123,allow,184,94,90,2,29,1,1
49872,53,15358,53,allow,216,94,122,2,30,1,1
49431,53,23067,53,allow,353,94,259,2,30,1,1
44682,443,42842,443,allow,2750,1891,859,17,25,10,7
63772,35440,0,0,deny,62,62,0,1,0,1,0
64644,445,0,0,drop,70,70,0,1,0,1,0
54707,443,60614,443,allow,5826,1199,4627,21,42,11,10
59723,443,54726,443,allow,8380,1882,6498,29,396,9,20
60387,445,0,0,drop,66,66,0,1,0,1,0
49322,443,25281,443,allow,3005,2082,923,18,28,9,9
56523,443,55087,443,allow,8130,2093,6037,17,120,9,8
49563,80,54340,80,allow,1515,481,1034,11,15,6,5
57470,17984,29715,17984,allow,870,330,540,12,1496,6,6
62877,445,0,0,drop,66,66,0,1,0,1,0
53560,42459,25720,42459,allow,552,306,246,9,17,5,4
55435,25174,0,0,deny,62,62,0,1,0,1,0
65130,80,61798,80,allow,2500,531,1969,11,76,6,5
2691,64147,0,0,deny,62,62,0,1,0,1,0
3584,25174,0,0,deny,146,146,0,1,0,1,0
55031,5222,39174,5222,allow,6192,3767,2425,53,64,29,24
64664,53,7997,53,allow,168,86,82,2,32,1,1
53453,2767,0,0,deny,66,66,0,1,0,1,0
60036,445,0,0,drop,70,70,0,1,0,1,0
50178,53,43275,53,allow,172,88,84,2,31,1,1
50137,445,0,0,drop,70,70,0,1,0,1,0
34837,80,34635,80,allow,7794,1470,6324,18,151,9,9
56277,445,0,0,drop,66,66,0,1,0,1,0
51750,54567,18193,54567,allow,70,70,0,2,7,2,0
16387,63752,0,0,deny,60,60,0,1,0,1,0
57150,445,0,0,drop,70,70,0,1,0,1,0
53871,37965,0,0,deny,66,66,0,1,0,1,0
51833,445,0,0,drop,66,66,0,1,0,1,0
55071,53,10472,53,allow,170,87,83,2,31,1,1
58934,445,0,0,drop,70,70,0,1,0,1,0
57057,53,64992,53,allow,194,102,92,2,31,1,1
52880,443,45002,443,allow,1695880,25777,1670103,1423,118,264,1159
64891,53,61433,53,allow,320,97,223,4,34,2,2
47652,51505,0,0,deny,62,62,0,1,0,1,0
6975,26543,0,0,deny,139,139,0,1,0,1,0
53853,443,38658,443,allow,499,425,74,4,0,3,1
55875,53,25979,53,allow,296,110,186,2,30,1,1
37264,443,41734,443,allow,130,70,60,3,5,2,1
51465,80,10875,80,allow,913,410,503,10,15,5,5
62779,445,0,0,drop,70,70,0,1,0,1,0
57337,64147,0,0,deny,66,66,0,1,0,1,0
34798,53,14935,53,allow,199,94,105,2,30,1,1
49294,53,26484,53,allow,723,102,621,2,30,1,1
27005,30003,56044,30003,allow,1640,126,1514,4,30,2,2
62732,443,28854,443,allow,50000,36438,13562,98,336,61,37
56206,445,0,0,drop,70,70,0,1,0,1,0
56639,48817,0,0,deny,66,66,0,1,0,1,0
64088,445,0,0,drop,66,66,0,1,0,1,0
55452,53,7661,53,allow,184,94,90,2,30,1,1
64997,53,25843,53,allow,166,86,80,2,30,1,1
18415,37965,0,0,deny,62,62,0,1,0,1,0
37965,6224,9493,6224,allow,38098,12284,25814,207,2433,100,107
46740,55108,0,0,deny,148,148,0,1,0,1,0
0,0,0,0,deny,98,98,0,1,0,1,0
50386,445,0,0,drop,70,70,0,1,0,1,0
56604,443,22617,443,allow,2904,662,2242,13,135,6,7
56687,445,0,0,drop,70,70,0,1,0,1,0
0,0,0,0,allow,200,102,98,2,0,1,1
9156,443,14551,443,allow,5734,498,5236,14,15,7,7
59694,50584,0,0,deny,66,66,0,1,0,1,0
59366,443,63784,443,allow,59122,7352,51770,85,322,41,44
65323,27047,12346,27047,allow,1233,924,309,6,31,3,3
57342,53,37406,53,allow,166,85,81,2,31,1,1
27005,27018,58513,27018,allow,888,126,762,2,30,1,1
58848,443,1963,443,allow,5168,700,4468,16,15,7,9
49672,53,36267,53,allow,761,100,661,2,30,1,1
62819,56205,0,0,deny,62,62,0,1,0,1,0
61569,445,0,0,drop,70,70,0,1,0,1,0
63840,36829,0,0,deny,62,62,0,1,0,1,0
52775,123,25733,123,allow,184,94,90,2,30,1,1
57308,53,39831,53,allow,302,110,192,2,30,1,1
45682,37965,0,0,deny,62,62,0,1,0,1,0
47832,80,56253,80,allow,1151,711,440,10,15,5,5
26239,25174,0,0,deny,62,62,0,1,0,1,0
56829,53,58561,53,allow,170,87,83,2,30,1,1
40146,443,31443,443,allow,280,140,140,5,130,3,2
64567,53,8117,53,allow,193,102,91,2,29,1,1
57117,53,8258,53,allow,209,102,107,2,31,1,1
56577,53,47746,53,allow,198,110,88,2,30,1,1
64046,53,35754,53,allow,259,110,149,2,29,1,1
49855,53,34570,53,allow,177,94,83,2,30,1,1
55745,53,2082,53,allow,198,101,97,2,30,1,1
4000,44847,0,0,deny,66,66,0,1,0,1,0
14420,80,14420,80,allow,4591,3155,1436,22,45,13,9
56112,53,63106,53,allow,199,102,97,2,30,1,1
13164,39033,0,0,deny,145,145,0,1,0,1,0
32968,43890,0,0,deny,146,146,0,1,0,1,0
57867,27019,34880,27019,allow,468,390,78,5,30,4,1
49323,53,40976,53,allow,196,102,94,2,31,1,1
61777,445,0,0,drop,66,66,0,1,0,1,0
56704,53,8695,53,allow,194,102,92,2,31,1,1
49256,53,11555,53,allow,179,94,85,2,30,1,1
50321,53,23352,53,allow,438,180,258,6,30,3,3
57454,443,10249,443,allow,4881,1817,3064,30,135,16,14
3181,53567,0,0,deny,66,66,0,1,0,1,0
61000,50432,0,0,deny,146,146,0,1,0,1,0
9067,44847,0,0,deny,62,62,0,1,0,1,0
45523,443,20387,443,allow,8636,1914,6722,31,95,16,15
64251,53,51222,53,allow,170,87,83,2,31,1,1
57625,445,0,0,drop,70,70,0,1,0,1,0
50313,53,2331,53,allow,744,95,649,2,30,1,1
55176,53,15853,53,allow,181,94,87,2,30,1,1
51936,17650,3009,17650,allow,70,70,0,2,8,2,0
49742,443,14299,443,allow,16041,1805,14236,30,20,14,16
49817,53,35154,53,allow,286,110,176,2,30,1,1
64460,53,29713,53,allow,196,102,94,2,30,1,1
55374,25,55374,25,allow,130,66,64,2,5,1,1
50283,80,41911,80,allow,5689,1015,4674,16,45,8,8
52703,443,1986,443,allow,7843,2397,5446,23,256,12,11
61742,445,0,0,drop,70,70,0,1,0,1,0
57944,80,62722,80,allow,1718,1404,314,11,15,6,5
51101,445,0,0,drop,70,70,0,1,0,1,0
55237,53,13670,53,allow,259,87,172,4,56,2,2
49795,53,1877,53,allow,211,102,109,2,30,1,1
53501,443,53501,443,allow,960,539,421,9,36,5,4
55634,58846,18331,58846,allow,70,70,0,2,8,2,0
47091,15000,23609,15000,allow,138,78,60,2,6,1,1
56771,53,7291,53,allow,270,95,175,4,60,2,2
56490,53,61381,53,allow,744,89,655,2,31,1,1
8080,37965,0,0,deny,62,62,0,1,0,1,0
37583,443,36088,443,allow,499,425,74,4,0,3,1
49347,80,49347,80,allow,450,246,204,8,141,5,3
54954,445,0,0,drop,70,70,0,1,0,1,0
63854,16437,39591,16437,allow,66,66,0,2,7,2,0
54350,443,6406,443,allow,2402,1444,958,18,167,10,8
27328,443,23617,443,allow,3751,1007,2744,35,473,11,24
56735,53283,31023,53283,allow,4188,1648,2540,17,19,9,8
53019,443,6559,443,allow,30012,3461,26551,72,93,28,44
65496,53,50300,53,allow,183,94,89,2,30,1,1
52971,445,0,0,drop,70,70,0,1,0,1,0
1046,48817,0,0,deny,62,62,0,1,0,1,0
64926,53,45252,53,allow,257,102,155,2,30,1,1
49854,443,20438,443,allow,5578,2780,2798,14,120,7,7
58638,5900,0,0,deny,62,62,0,1,0,1,0
58828,443,9559,443,allow,5166,700,4466,16,15,7,9
4961,62741,0,0,deny,66,66,0,1,0,1,0
11692,25174,0,0,deny,62,62,0,1,0,1,0
63326,445,0,0,drop,70,70,0,1,0,1,0
33356,80,44491,80,allow,1658,1344,314,10,15,5,5
35370,443,45689,443,allow,87183,4177,83006,104,126,34,70
50537,445,0,0,drop,66,66,0,1,0,1,0
53465,57470,0,0,deny,62,62,0,1,0,1,0
47932,443,21603,443,allow,9467,2741,6726,24,20,15,9
57367,443,24702,443,allow,7498,2799,4699,24,17,13,11
61116,445,0,0,drop,70,70,0,1,0,1,0
62039,443,46235,443,allow,356,60,296,6,18,2,4
63742,443,58789,443,allow,7444,1915,5529,28,16,16,12
46714,80,46714,80,allow,83777,2610,81167,90,155,27,63
60796,80,60796,80,allow,13869,3749,10120,28,26,15,13
58638,5900,0,0,deny,62,62,0,1,0,1,0
40651,443,45721,443,allow,41517,28432,13085,89,601,47,42
57040,53,4133,53,allow,810,108,702,2,31,1,1
59198,445,0,0,drop,70,70,0,1,0,1,0
56082,53,27828,53,allow,182,94,88,2,30,1,1
53614,445,0,0,drop,70,70,0,1,0,1,0
52097,80,35130,80,allow,1621,896,725,11,19,7,4
17213,22114,0,0,deny,62,62,0,1,0,1,0
64980,53,3433,53,allow,200,102,98,2,30,1,1
49247,80,49247,80,allow,378,180,198,7,53,4,3
40273,53,38821,53,allow,164,78,86,2,30,1,1
41462,443,16265,443,allow,3467,2269,1198,21,82,11,10
57018,53,4073,53,allow,209,110,99,2,30,1,1
65081,26467,0,0,deny,66,66,0,1,0,1,0
56633,53,17988,53,allow,194,99,95,2,31,1,1
26900,27017,40342,27017,allow,422,164,258,6,30,3,3
51996,80,49659,80,allow,6518746,206365,6312381,6886,22,2687,4199
55639,62954,47207,62954,allow,504,318,186,8,15,5,3
43536,443,9827,443,allow,13710,4975,8735,22,121,9,13
55428,445,0,0,drop,70,70,0,1,0,1,0
58610,443,32629,443,allow,6345,1545,4800,23,18,12,11
64622,445,0,0,drop,66,66,0,1,0,1,0
49901,53,59612,53,allow,193,102,91,2,31,1,1
55060,53,16844,53,allow,195,102,93,2,30,1,1
55559,53,14649,53,allow,1026,292,734,8,50,4,4
58132,445,0,0,drop,70,70,0,1,0,1,0
64230,445,0,0,drop,70,70,0,1,0,1,0
56715,53,5613,53,allow,1384,88,1296,4,32,2,2
50789,445,0,0,drop,66,66,0,1,0,1,0
49816,80,56471,80,allow,130,70,60,2,15,1,1
59813,53,59813,53,allow,228,97,131,2,30,1,1
49418,27025,2656,27025,allow,250,78,172,2,30,1,1
60216,80,20321,80,allow,3606,2572,1034,14,151,8,6
56239,80,56239,80,allow,101707,1824,99883,96,15,26,70
60018,64147,0,0,deny,62,62,0,1,0,1,0
55776,53,26753,53,allow,271,93,178,4,30,2,2
11906,53,11906,53,allow,220,90,130,2,30,1,1
56649,53,31076,53,allow,168,94,74,2,30,1,1
51905,65253,44295,65253,allow,66,66,0,1,5,1,0
65428,53,65157,53,allow,516,86,430,4,32,2,2
52462,445,0,0,drop,70,70,0,1,0,1,0
49734,53,34033,53,allow,216,110,106,2,30,1,1
55840,53,28820,53,allow,177,94,83,2,30,1,1
58638,5900,58638,5900,allow,66,66,0,1,4,1,0
26480,64147,0,0,deny,62,62,0,1,0,1,0
49610,53,51833,53,allow,212,102,110,2,30,1,1
51088,445,0,0,drop,70,70,0,1,0,1,0
50564,443,57456,443,allow,1313,876,437,11,26,6,5
58638,5900,0,0,deny,62,62,0,1,0,1,0
49859,443,46970,443,allow,18811,1868,16943,22,142,7,15
52140,53155,1111,53155,allow,70,70,0,2,8,2,0
58289,445,0,0,drop,70,70,0,1,0,1,0
63988,53,39055,53,allow,190,97,93,2,30,1,1
47132,1433,0,0,deny,60,60,0,1,0,1,0
49317,53,61249,53,allow,164,84,80,2,31,1,1
29017,2222,0,0,deny,60,60,0,1,0,1,0
51894,26116,8093,26116,allow,70,70,0,1,5,1,0
48478,49903,0,0,deny,62,62,0,1,0,1,0
44724,443,7111,443,allow,4383,2829,1554,27,80,14,13
49563,443,54610,443,allow,6462,2102,4360,18,180,8,10
61716,80,3411,80,allow,9323,5142,4181,23,20,12,11
55700,443,30597,443,allow,10286,1326,8960,25,1017,8,17
59609,445,0,0,drop,70,70,0,1,0,1,0
57095,53,33152,53,allow,177,94,83,2,30,1,1
53208,18375,0,0,deny,62,62,0,1,0,1,0
27005,27111,65327,27111,allow,913,126,787,2,30,1,1
60240,445,0,0,drop,66,66,0,1,0,1,0
49308,53,30302,53,allow,195,102,93,2,31,1,1
56674,53,8365,53,allow,183,94,89,2,30,1,1
43286,80,30144,80,allow,1638,1324,314,10,15,5,5
49841,445,0,0,drop,66,66,0,1,0,1,0
51183,445,0,0,drop,66,66,0,1,0,1,0
53847,443,28382,443,allow,499,425,74,4,0,3,1
50584,64027,41636,64027,allow,166,166,0,1,1199,1,0
51977,80,40997,80,allow,366,240,126,7,25,5,2
65418,445,0,0,drop,70,70,0,1,0,1,0
43104,443,41004,443,allow,3067,1817,1250,18,15,8,10
59355,51505,0,0,deny,66,66,0,1,0,1,0
56301,445,0,0,drop,70,70,0,1,0,1,0
61315,48817,0,0,deny,62,62,0,1,0,1,0
60936,445,0,0,drop,66,66,0,1,0,1,0
52989,51505,0,0,deny,66,66,0,1,0,1,0
56056,53,42855,53,allow,164,86,78,2,29,1,1
55774,8060,21425,8060,allow,70,70,0,1,5,1,0
60441,445,0,0,drop,70,70,0,1,0,1,0
55531,53,35408,53,allow,772,100,672,2,31,1,1
55750,53,45785,53,allow,211,110,101,2,29,1,1
55548,53,25199,53,allow,194,99,95,2,30,1,1
57555,35440,0,0,deny,62,62,0,1,0,1,0
50432,5222,28391,5222,allow,28281,9813,18468,196,608,100,96
52812,25174,0,0,deny,62,62,0,1,0,1,0
43686,443,17205,443,allow,6804,914,5890,22,257,10,12
52045,16853,9076,16853,allow,66,66,0,1,5,1,0
54810,445,0,0,drop,70,70,0,1,0,1,0
53012,51050,0,0,deny,66,66,0,1,0,1,0
50875,53,15135,53,allow,234,234,0,4,47,4,0
56917,53,8537,53,allow,424,104,320,4,30,2,2
61858,445,0,0,drop,70,70,0,1,0,1,0
52690,445,0,0,drop,70,70,0,1,0,1,0
51062,1433,0,0,deny,60,60,0,1,0,1,0
56343,445,0,0,drop,70,70,0,1,0,1,0
56321,443,18769,443,allow,4704,2423,2281,16,135,8,8
56041,53,27459,53,allow,174,89,85,2,31,1,1
51699,445,0,0,drop,66,66,0,1,0,1,0
34930,20005,0,0,deny,60,60,0,1,0,1,0
63760,37264,26706,37264,allow,504,382,122,8,16,6,2
55893,45711,0,0,deny,78,78,0,1,0,1,0
62438,37807,0,0,deny,62,62,0,1,0,1,0
65349,445,0,0,drop,66,66,0,1,0,1,0
49608,80,59432,80,allow,145752,3240,142512,128,61,23,105
52480,443,40106,443,allow,7103,2432,4671,18,76,10,8
57256,445,0,0,drop,70,70,0,1,0,1,0
37694,5228,64819,5228,allow,6930,1665,5265,18,3601,9,9
53724,64923,63918,64923,allow,70,70,0,1,5,1,0
18876,44847,0,0,deny,66,66,0,1,0,1,0
56176,53,13645,53,allow,177,94,83,2,30,1,1
49767,53,48677,53,allow,200,102,98,2,30,1,1
64980,53,5647,53,allow,200,102,98,2,31,1,1
53550,445,0,0,drop,70,70,0,1,0,1,0
49196,53,18490,53,allow,230,91,139,3,47,2,1
42934,443,36835,443,allow,4514,1928,2586,17,241,8,9
55519,53,8879,53,allow,186,95,91,2,30,1,1
51378,445,0,0,drop,66,66,0,1,0,1,0
64789,443,4787,443,allow,1786,172,1614,7,121,3,4
60099,445,0,0,drop,70,70,0,1,0,1,0
9511,443,26929,443,allow,318,192,126,6,34,4,2
55508,53,1825,53,allow,814,110,704,2,30,1,1
51200,445,0,0,drop,70,70,0,1,0,1,0
7356,25174,0,0,deny,66,66,0,1,0,1,0
60105,445,0,0,drop,70,70,0,1,0,1,0
27005,27017,40940,27017,allow,600,126,474,2,31,1,1
64967,445,0,0,drop,70,70,0,1,0,1,0
35203,443,62498,443,allow,232,172,60,3,5,2,1
31574,53,31574,53,allow,213,90,123,2,29,1,1
10947,53,10947,53,allow,197,90,107,2,29,1,1
59511,21247,0,0,deny,62,62,0,1,0,1,0
49609,53,44498,53,allow,177,94,83,2,30,1,1
28476,25174,0,0,deny,146,146,0,1,0,1,0
56735,80,63370,80,allow,194,128,66,4,25,3,1
50378,53,9266,53,allow,199,102,97,2,29,1,1
47814,51505,0,0,deny,66,66,0,1,0,1,0
60501,445,0,0,drop,70,70,0,1,0,1,0
52339,445,0,0,drop,70,70,0,1,0,1,0
50641,445,0,0,drop,70,70,0,1,0,1,0
60482,445,0,0,drop,70,70,0,1,0,1,0
56759,53,10512,53,allow,177,94,83,2,30,1,1
35509,3389,35509,3389,allow,4224,2055,2169,22,21,13,9
61559,23,0,0,deny,60,60,0,1,0,1,0
16387,35308,0,0,deny,60,60,0,1,0,1,0
49419,53,29016,53,allow,252,102,150,2,30,1,1
51860,53854,28127,53854,allow,70,70,0,2,7,2,0
1811,35440,0,0,deny,62,62,0,1,0,1,0
55735,53,9793,53,allow,199,102,97,2,30,1,1
45964,3111,0,0,deny,60,60,0,1,0,1,0
50806,51505,0,0,deny,66,66,0,1,0,1,0
48985,15000,20199,15000,allow,130,70,60,2,5,1,1
50362,53,33305,53,allow,214,110,104,2,29,1,1
46167,80,10521,80,allow,78,78,0,1,5,1,0
36992,25174,0,0,deny,146,146,0,1,0,1,0
53097,25174,0,0,deny,66,66,0,1,0,1,0
55618,56205,0,0,deny,62,62,0,1,0,1,0
35164,443,44026,443,allow,5505,995,4510,20,255,11,9
64885,53,64870,53,allow,753,93,660,2,31,1,1
59831,53,14617,53,allow,198,93,105,2,30,1,1
57090,51505,0,0,deny,62,62,0,1,0,1,0
53818,15337,22779,15337,allow,258,70,188,4,8,2,2
64796,53,58063,53,allow,184,94,90,2,30,1,1
51887,445,0,0,drop,70,70,0,1,0,1,0
33624,443,6639,443,allow,247438,52606,194832,305,237,124,181
39531,19473,0,0,deny,62,62,0,1,0,1,0
55012,25174,0,0,deny,66,66,0,1,0,1,0
53087,443,59846,443,allow,408922,10621,398301,421,121,145,276
53804,445,0,0,drop,66,66,0,1,0,1,0
49665,80,5154,80,allow,2237,508,1729,10,125,6,4
19875,30170,0,0,deny,145,145,0,1,0,1,0
56145,445,0,0,drop,70,70,0,1,0,1,0
49924,53,19826,53,allow,718,94,624,2,30,1,1
49266,53,11642,53,allow,330,97,233,4,33,2,2
60797,28080,22385,28080,allow,70,70,0,2,8,2,0
49869,443,47117,443,allow,7910,1967,5943,30,55,15,15
49826,445,0,0,drop,70,70,0,1,0,1,0
51324,11392,0,0,deny,66,66,0,1,0,1,0
58638,5900,0,0,deny,62,62,0,1,0,1,0
34220,80,10366,80,allow,672,300,372,12,30,6,6
61738,2767,0,0,deny,66,66,0,1,0,1,0
14148,1,0,0,deny,62,62,0,1,0,1,0
55444,443,59927,443,allow,1455177,56285,1398892,1600,31,632,968
50900,80,42676,80,allow,26867,2743,24124,45,140,23,22
57172,53,34011,53,allow,196,102,94,2,31,1,1
55036,53,7624,53,allow,177,94,83,2,30,1,1
1594,44847,0,0,deny,62,62,0,1,0,1,0
53737,443,33568,443,allow,12192,3674,8518,53,454,26,27
54995,445,0,0,drop,70,70,0,1,0,1,0
62439,443,62439,443,allow,4507,1600,2907,19,26,11,8
58172,80,64584,80,allow,12618,1038,11580,28,50,13,15
55217,443,42611,443,allow,8690,4119,4571,26,31,14,12
62101,445,0,0,drop,70,70,0,1,0,1,0
60701,443,27691,443,allow,5166,1989,3177,15,122,7,8
5588,5588,0,0,allow,3354,1792,1562,46,192,23,23
43235,23,0,0,deny,60,60,0,1,0,1,0
52098,443,38562,443,allow,3015,2037,978,15,15,9,6
50443,53,37606,53,allow,788,108,680,2,31,1,1
56293,53,53120,53,allow,164,84,80,2,31,1,1
34416,443,50099,443,allow,6396,1589,4807,23,315,12,11
10594,25174,0,0,deny,146,146,0,1,0,1,0
56774,445,0,0,drop,66,66,0,1,0,1,0
58638,5900,0,0,deny,62,62,0,1,0,1,0
60193,445,0,0,drop,66,66,0,1,0,1,0
51918,445,0,0,drop,70,70,0,1,0,1,0
51791,80,21497,80,allow,1934,1083,851,9,15,5,4
50861,445,0,0,drop,66,66,0,1,0,1,0
49919,445,0,0,drop,70,70,0,1,0,1,0
56148,445,0,0,drop,70,70,0,1,0,1,0
50444,445,0,0,drop,70,70,0,1,0,1,0
51244,443,19950,443,allow,8024,2572,5452,39,15,23,16
53147,37965,0,0,deny,62,62,0,1,0,1,0
54242,443,22470,443,allow,499,425,74,4,0,3,1
61135,50265,0,0,deny,62,62,0,1,0,1,0
62571,445,0,0,drop,70,70,0,1,0,1,0
64722,53,36705,53,allow,214,110,104,2,30,1,1
60077,445,0,0,drop,66,66,0,1,0,1,0
51451,80,37614,80,allow,214,140,74,4,15,3,1
7356,25174,0,0,deny,66,66,0,1,0,1,0
64279,53,42792,53,allow,177,94,83,2,30,1,1
52267,445,0,0,drop,66,66,0,1,0,1,0
53875,445,0,0,drop,70,70,0,1,0,1,0
49420,53,64966,53,allow,183,94,89,2,31,1,1
35735,80,48997,80,allow,1155,781,374,10,15,6,4
57915,445,0,0,drop,70,70,0,1,0,1,0
49835,53,4982,53,allow,146,75,71,2,30,1,1
50789,445,0,0,drop,70,70,0,1,0,1,0
6843,42873,0,0,deny,62,62,0,1,0,1,0
52328,44847,0,0,deny,62,62,0,1,0,1,0
55060,445,0,0,drop,70,70,0,1,0,1,0
65283,445,0,0,drop,70,70,0,1,0,1,0
51012,445,0,0,drop,70,70,0,1,0,1,0
59744,445,0,0,drop,66,66,0,1,0,1,0
51085,56205,0,0,deny,66,66,0,1,0,1,0
47063,15503,0,0,deny,146,146,0,1,0,1,0
49171,443,51614,443,allow,7966,2735,5231,22,120,10,12
58638,5900,0,0,deny,62,62,0,1,0,1,0
61639,37965,0,0,deny,66,66,0,1,0,1,0
59867,443,26148,443,allow,6197,843,5354,21,27,10,11
65112,53,26607,53,allow,209,110,99,2,30,1,1
54473,37807,0,0,deny,66,66,0,1,0,1,0
57074,53,2955,53,allow,195,102,93,2,30,1,1
56853,13203,65279,13203,allow,316,136,180,6,6,3,3
9529,26467,0,0,deny,62,62,0,1,0,1,0
57018,53,23896,53,allow,177,94,83,2,31,1,1
57470,47004,40280,47004,allow,152,152,0,2,1200,2,0
52636,445,0,0,drop,70,70,0,1,0,1,0
55406,25174,0,0,deny,62,62,0,1,0,1,0
63795,445,0,0,drop,70,70,0,1,0,1,0
27005,27015,3616,27015,allow,887,126,761,2,30,1,1
55862,53,22118,53,allow,177,94,83,2,30,1,1
57954,48817,0,0,deny,78,78,0,1,0,1,0
57428,445,0,0,drop,66,66,0,1,0,1,0
58093,445,0,0,drop,70,70,0,1,0,1,0
53160,80,36074,80,allow,1213,725,488,10,323,6,4
58017,445,0,0,drop,70,70,0,1,0,1,0
63974,53,39548,53,allow,212,102,110,2,29,1,1
53539,443,34866,443,allow,2385,1462,923,18,200,10,8
50337,53,56473,53,allow,762,97,665,2,30,1,1
64205,53,1901,53,allow,178,94,84,2,30,1,1
64976,53,40742,53,allow,193,102,91,2,31,1,1
48817,37028,48817,37028,allow,513,152,361,2,1200,1,1
63900,445,0,0,drop,66,66,0,1,0,1,0
5283,56205,0,0,deny,146,146,0,1,0,1,0
56580,443,8692,443,allow,20897,11903,8994,52,49,30,22
49699,53,28371,53,allow,209,110,99,2,31,1,1
32299,40019,4671,40019,allow,148,86,62,2,30,1,1
1821,64147,0,0,deny,66,66,0,1,0,1,0
49218,53,62258,53,allow,190,97,93,2,31,1,1
53070,53,0,0,allow,168,74,94,2,29,1,1
64029,445,0,0,drop,70,70,0,1,0,1,0
52944,445,0,0,drop,66,66,0,1,0,1,0
24144,57470,0,0,deny,62,62,0,1,0,1,0
51862,27758,53526,27758,allow,70,70,0,1,5,1,0
53892,443,6388,443,allow,499,425,74,4,0,3,1
56912,53,37939,53,allow,753,96,657,2,31,1,1
55581,53,6182,53,allow,166,85,81,2,30,1,1
57966,445,0,0,drop,70,70,0,1,0,1,0
52781,443,23345,443,allow,1581,924,657,15,125,7,8
63892,8080,57373,8080,allow,1269,548,721,10,15,6,4
46531,123,21322,123,allow,184,94,90,2,30,1,1
61847,445,0,0,drop,70,70,0,1,0,1,0
59965,36237,0,0,deny,66,66,0,1,0,1,0
49267,445,0,0,drop,70,70,0,1,0,1,0
56786,443,44559,443,allow,9096,4394,4702,26,256,15,11
43391,80,44561,80,allow,1560,684,876,10,15,5,5
59244,445,0,0,drop,70,70,0,1,0,1,0
64989,53,60666,53,allow,214,102,112,2,30,1,1
41003,5000,0,0,deny,60,60,0,1,0,1,0
49855,443,64909,443,allow,28887,9850,19037,96,60,41,55
35065,443,35065,443,allow,5537,2290,3247,22,39,13,9
45682,37965,0,0,deny,62,62,0,1,0,1,0
49504,443,14991,443,allow,18746,2976,15770,32,32,12,20
52186,57609,20882,57609,allow,70,70,0,2,9,2,0
50470,61463,0,0,deny,86,86,0,1,0,1,0
6194,80,6194,80,allow,3058,774,2284,11,16,6,5
58520,443,24680,443,allow,9429,3621,5808,60,80,26,34
51806,443,31513,443,allow,19093,3390,15703,26,126,10,16
56561,53,57177,53,allow,183,94,89,2,30,1,1
59486,80,17490,80,allow,882,527,355,10,255,6,4
1165,53,1165,53,allow,196,88,108,2,30,1,1
64016,445,0,0,drop,66,66,0,1,0,1,0
51423,445,0,0,drop,66,66,0,1,0,1,0
55533,53,30263,53,allow,816,97,719,2,31,1,1
55704,53,43154,53,allow,177,94,83,2,30,1,1
58021,22114,0,0,deny,66,66,0,1,0,1,0
13285,29892,0,0,deny,145,145,0,1,0,1,0
49972,53,57217,53,allow,216,110,106,2,31,1,1
61552,443,61552,443,allow,38146,3555,34591,57,16,28,29
51989,29736,40433,29736,allow,258,70,188,4,8,2,2
53915,443,3997,443,allow,499,425,74,4,0,3,1
57170,38303,0,0,deny,66,66,0,1,0,1,0
49742,53,16673,53,allow,216,110,106,2,30,1,1
50547,80,14282,80,allow,378,192,186,7,21,4,3
54246,445,0,0,drop,66,66,0,1,0,1,0
49579,443,1881,443,allow,6629,827,5802,19,53,9,10
41030,80,41030,80,allow,80261,4766,75495,91,126,35,56
54103,445,0,0,drop,70,70,0,1,0,1,0
56550,53,19597,53,allow,166,86,80,2,29,1,1
35311,80,30298,80,allow,947,376,571,8,14,5,3
60466,64337,52523,64337,allow,70,70,0,2,8,2,0
65158,53,9153,53,allow,728,102,626,2,30,1,1
5450,23,0,0,deny,60,60,0,1,0,1,0
50435,80,14382,80,allow,672,70,602,11,392,2,9
52999,80,62826,80,allow,1991,686,1305,10,335,6,4
56382,53,40376,53,allow,195,102,93,2,29,1,1
55563,53,57917,53,allow,763,101,662,2,30,1,1
50230,445,0,0,drop,70,70,0,1,0,1,0
49610,53,9285,53,allow,168,78,90,2,30,1,1
56696,445,0,0,drop,70,70,0,1,0,1,0
11136,19910,0,0,deny,62,62,0,1,0,1,0
56213,53,25430,53,allow,168,78,90,2,30,1,1
49608,80,48854,80,allow,318,192,126,6,41,4,2
61190,21247,0,0,deny,66,66,0,1,0,1,0
64103,445,0,0,drop,66,66,0,1,0,1,0
51953,37965,0,0,deny,66,66,0,1,0,1,0
24110,23,0,0,deny,60,60,0,1,0,1,0
54998,53,21655,53,allow,198,102,96,2,31,1,1
60435,80,13780,80,allow,5518,527,4991,13,75,6,7
61382,25174,0,0,deny,66,66,0,1,0,1,0
50779,445,0,0,drop,66,66,0,1,0,1,0
55664,53,60480,53,allow,177,94,83,2,29,1,1
65229,53,55495,53,allow,186,95,91,2,30,1,1
53675,445,0,0,drop,66,66,0,1,0,1,0
55636,25569,50876,25569,allow,320,140,180,6,6,3,3
64706,27065,37449,27065,allow,924,924,0,3,30,3,0
64784,53,28832,53,allow,195,102,93,2,29,1,1
55192,53,45038,53,allow,172,88,84,2,30,1,1
38554,443,64744,443,allow,5021,1030,3991,16,30,9,7
57850,3389,57850,3389,allow,3347,1458,1889,15,18,8,7
53080,445,0,0,drop,70,70,0,1,0,1,0
52720,35894,0,0,deny,62,62,0,1,0,1,0
52420,445,0,0,drop,70,70,0,1,0,1,0
56414,53,17231,53,allow,88,88,0,1,30,1,0
50920,445,0,0,drop,66,66,0,1,0,1,0
52770,445,0,0,drop,70,70,0,1,0,1,0
64882,43890,0,0,deny,66,66,0,1,0,1,0
64615,53,57777,53,allow,195,102,93,2,31,1,1
42238,25174,0,0,deny,62,62,0,1,0,1,0
1866,51505,0,0,deny,66,66,0,1,0,1,0
56109,53,49882,53,allow,177,94,83,2,29,1,1
55402,445,0,0,drop,70,70,0,1,0,1,0
64177,44847,0,0,deny,62,62,0,1,0,1,0
55985,44847,0,0,deny,62,62,0,1,0,1,0
57849,443,35072,443,allow,11893,6064,5829,29,92,15,14
57632,445,0,0,drop,70,70,0,1,0,1,0
53762,53,52593,53,allow,168,78,90,2,30,1,1
61494,443,60069,443,allow,14558,2653,11905,33,27,18,15
49611,53,14294,53,allow,184,94,90,2,30,1,1
49786,25174,0,0,deny,66,66,0,1,0,1,0
52096,443,15286,443,allow,283,163,120,4,15,2,2
15605,50265,0,0,deny,62,62,0,1,0,1,0
60133,1,0,0,deny,62,62,0,1,0,1,0
60873,443,24507,443,allow,10707,2969,7738,32,47,18,14
52809,56205,0,0,deny,146,146,0,1,0,1,0
63621,30188,0,0,deny,62,62,0,1,0,1,0
2531,30188,0,0,deny,66,66,0,1,0,1,0
62912,26467,0,0,deny,62,62,0,1,0,1,0
55007,53,23960,53,allow,166,86,80,2,29,1,1
49453,445,0,0,drop,70,70,0,1,0,1,0
19204,41864,0,0,deny,159,159,0,1,0,1,0
65382,445,0,0,drop,70,70,0,1,0,1,0
50906,445,0,0,drop,70,70,0,1,0,1,0
57189,53,16894,53,allow,179,94,85,2,30,1,1
51944,56205,0,0,deny,66,66,0,1,0,1,0
64868,53,56069,53,allow,216,102,114,2,30,1,1
63098,35440,0,0,deny,66,66,0,1,0,1,0
38581,22114,0,0,deny,62,62,0,1,0,1,0
38768,443,45644,443,allow,7380,3474,3906,18,16,10,8
37316,443,11978,443,allow,19840,6479,13361,57,127,32,25
50052,65008,0,0,deny,60,60,0,1,0,1,0
40576,443,40576,443,allow,4433,1526,2907,19,27,11,8
55968,56205,0,0,deny,66,66,0,1,0,1,0
54232,445,0,0,drop,70,70,0,1,0,1,0
52104,51756,27820,51756,allow,70,70,0,2,8,2,0
7561,43890,0,0,deny,62,62,0,1,0,1,0
2267,53,10522,53,allow,204,118,86,2,30,1,1
64986,445,0,0,drop,70,70,0,1,0,1,0
64613,53,60043,53,allow,179,94,85,2,30,1,1
65134,445,0,0,drop,70,70,0,1,0,1,0
52828,51221,0,0,deny,66,66,0,1,0,1,0
49514,65504,0,0,deny,162,162,0,1,0,1,0
56803,53,20372,53,allow,195,102,93,2,31,1,1
55965,53,49770,53,allow,184,94,90,2,30,1,1
50355,43890,0,0,deny,66,66,0,1,0,1,0
61146,443,19937,443,allow,8580941,269463,8311478,9202,122,3016,6186
58638,5900,0,0,deny,62,62,0,1,0,1,0
22408,22114,0,0,deny,66,66,0,1,0,1,0
57278,443,35481,443,allow,8960,2949,6011,21,122,10,11
48020,7484,0,0,deny,60,60,0,1,0,1,0
49986,443,61933,443,allow,25918,2247,23671,53,124,26,27
54029,445,0,0,drop,66,66,0,1,0,1,0
51965,445,0,0,drop,70,70,0,1,0,1,0
49749,443,51214,443,allow,54416,3219,51197,76,240,30,46
54769,50584,0,0,deny,146,146,0,1,0,1,0
56628,443,13354,443,allow,8240,3521,4719,25,18,15,10
27005,27015,60094,27015,allow,876,126,750,2,31,1,1
48676,53399,0,0,deny,60,60,0,1,0,1,0
57667,445,0,0,drop,66,66,0,1,0,1,0
64979,53,62369,53,allow,754,94,660,2,30,1,1
49719,445,0,0,drop,70,70,0,1,0,1,0
58638,5900,0,0,deny,62,62,0,1,0,1,0
40204,40002,65519,40002,allow,148,86,62,2,30,1,1
53283,443,51039,443,allow,3369,1036,2333,11,121,5,6
57093,445,0,0,drop,66,66,0,1,0,1,0
52184,22114,0,0,deny,66,66,0,1,0,1,0
53261,443,49163,443,allow,12912,4288,8624,43,20,22,21
54299,28081,0,0,deny,143,143,0,1,0,1,0
65411,53,35148,53,allow,771,101,670,2,30,1,1
40232,53,19769,53,allow,205,86,119,2,29,1,1
53194,443,63620,443,allow,1462,965,497,13,18,7,6
65445,53,12722,53,allow,254,102,152,2,30,1,1
55021,443,43787,443,allow,6724,3642,3082,18,133,10,8
53780,47132,52557,47132,allow,70,70,0,1,5,1,0
64989,50265,0,0,deny,66,66,0,1,0,1,0
80,9918,0,0,deny,60,60,0,1,0,1,0
64835,53,1399,53,allow,200,102,98,2,30,1,1
55684,445,0,0,drop,70,70,0,1,0,1,0
65145,445,0,0,drop,70,70,0,1,0,1,0
1660,8696,0,0,deny,145,145,0,1,0,1,0
56638,64147,0,0,deny,62,62,0,1,0,1,0
53024,123,1742,123,allow,184,94,90,2,30,1,1
34932,38608,0,0,deny,62,62,0,1,0,1,0
52497,47967,0,0,deny,143,143,0,1,0,1,0
55078,80,14305,80,allow,265275,25834,239441,366,101,182,184
56726,443,29318,443,allow,7941,1952,5989,20,15,11,9
60346,53,60346,53,allow,241,98,143,2,30,1,1
50374,445,0,0,drop,66,66,0,1,0,1,0
64332,53,28123,53,allow,166,85,81,2,31,1,1
51411,443,6428,443,allow,5550,1177,4373,24,80,13,11
50490,443,43169,443,allow,1353,903,450,12,78,7,5
56250,53,20280,53,allow,802,104,698,2,31,1,1
52065,80,44925,80,allow,692,300,392,9,26,6,3
63838,80,51652,80,allow,314,192,122,6,15,4,2
49418,23333,56641,23333,allow,244,71,173,2,30,1,1
42300,53,40798,53,allow,168,78,90,2,29,1,1
55602,443,15216,443,allow,7360,2298,5062,22,255,12,10
61786,445,0,0,drop,66,66,0,1,0,1,0
64287,53,27313,53,allow,497,90,407,4,33,2,2
64989,50265,0,0,deny,66,66,0,1,0,1,0
48371,443,24225,443,allow,3908,630,3278,12,17,7,5
50316,80,40877,80,allow,2062,872,1190,13,83,7,6
50102,53,50102,53,allow,216,90,126,2,29,1,1
50309,443,46447,443,allow,5955,1619,4336,23,15,13,10
27005,27015,12555,27015,allow,887,126,761,2,30,1,1
65526,28793,0,0,deny,62,62,0,1,0,1,0
56524,443,60258,443,allow,759397,22470,736927,766,108,270,496
65352,445,0,0,drop,66,66,0,1,0,1,0
53453,2767,0,0,deny,62,62,0,1,0,1,0
64290,53,18678,53,allow,196,102,94,2,31,1,1
38136,443,41208,443,allow,3919,1099,2820,35,627,9,26
33822,57470,0,0,deny,66,66,0,1,0,1,0
0,0,0,0,deny,156,156,0,2,0,2,0
60429,46854,52028,46854,allow,70,70,0,2,8,2,0
55877,55153,7894,55153,allow,481,150,331,2,1200,1,1
52238,48996,6858,48996,allow,70,70,0,2,4,2,0
49941,53,57941,53,allow,193,102,91,2,31,1,1
54880,445,0,0,drop,70,70,0,1,0,1,0
64524,53,53824,53,allow,235,102,133,2,30,1,1
36908,26467,0,0,deny,62,62,0,1,0,1,0
62029,36237,0,0,deny,62,62,0,1,0,1,0
59936,80,54096,80,allow,1281,399,882,10,16,6,4
46266,53,15636,53,allow,308,118,190,2,30,1,1
33405,37965,0,0,deny,62,62,0,1,0,1,0
60911,445,0,0,drop,70,70,0,1,0,1,0
55713,25174,0,0,deny,62,62,0,1,0,1,0
9270,80,20221,80,allow,318,192,126,6,26,4,2
60254,445,0,0,drop,70,70,0,1,0,1,0
54807,53,14408,53,allow,206,86,120,2,30,1,1
56855,443,28597,443,allow,8114,2511,5603,19,135,9,10
56038,53,33876,53,allow,177,94,83,2,30,1,1
49202,31719,26471,31719,allow,70,70,0,1,5,1,0
56668,53,30534,53,allow,199,102,97,2,30,1,1
65221,53,13826,53,allow,168,86,82,2,30,1,1
64297,53,43105,53,allow,364,94,270,4,49,2,2
49646,445,0,0,drop,70,70,0,1,0,1,0
57869,443,47551,443,allow,11947,2436,9511,19,121,9,10
55492,53,58378,53,allow,760,96,664,2,31,1,1
51003,445,0,0,drop,70,70,0,1,0,1,0
61911,445,0,0,drop,66,66,0,1,0,1,0
49827,443,4607,443,allow,21625,7638,13987,45,48,24,21
51966,80,56206,80,allow,83302,3780,79522,105,66,47,58
49787,53,19694,53,allow,193,102,91,2,30,1,1
59476,445,0,0,drop,70,70,0,1,0,1,0
25237,57470,0,0,deny,62,62,0,1,0,1,0
64980,27047,61209,27047,allow,735,462,273,2,30,1,1
53124,443,9153,443,allow,64407,55712,8695,92,364,58,34
53713,80,58765,80,allow,5778,661,5117,17,75,8,9
58638,5900,0,0,deny,62,62,0,1,0,1,0
19876,53,19876,53,allow,209,77,132,2,33,1,1
59481,445,0,0,drop,70,70,0,1,0,1,0
49250,53,39996,53,allow,225,110,115,2,29,1,1
37335,443,52361,443,allow,4734755,152171,4582584,5334,405,2083,3251
59595,80,6644,80,allow,1052,612,440,10,15,5,5
56367,44847,0,0,deny,62,62,0,1,0,1,0
64733,445,0,0,drop,66,66,0,1,0,1,0
49305,53,20734,53,allow,571,181,390,6,73,3,3
55774,445,0,0,drop,70,70,0,1,0,1,0
51065,445,0,0,drop,70,70,0,1,0,1,0
64912,53,22829,53,allow,258,102,156,2,30,1,1
51372,80,40252,80,allow,882,527,355,10,255,6,4
65047,53,53893,53,allow,196,86,110,2,30,1,1
51560,46783,0,0,deny,66,66,0,1,0,1,0
61000,1,0,0,deny,146,146,0,1,0,1,0
44385,53,19261,53,allow,212,78,134,2,30,1,1
64493,53,17644,53,allow,280,97,183,4,60,2,2
63365,445,0,0,drop,70,70,0,1,0,1,0
2081,7000,2081,7000,allow,5914,4395,1519,19,15,10,9
54132,445,0,0,drop,70,70,0,1,0,1,0
65294,445,0,0,drop,70,70,0,1,0,1,0
57060,50584,0,0,deny,62,62,0,1,0,1,0
41320,443,41281,443,allow,1743946,54876,1689070,1870,360,678,1192
65530,53,53494,53,allow,194,102,92,2,30,1,1
1933,53,18812,53,allow,210,78,132,2,29,1,1
51348,25174,0,0,deny,66,66,0,1,0,1,0
64087,443,64087,443,allow,150808,48110,102698,173,173,82,91
50306,443,42473,443,allow,2474,735,1739,11,120,6,5
23512,57354,0,0,deny,145,145,0,1,0,1,0
51891,23238,29444,23238,allow,70,70,0,1,5,1,0
33228,443,46001,443,allow,2567,1173,1394,19,179,8,11
60134,445,0,0,drop,66,66,0,1,0,1,0
65023,53,44980,53,allow,761,102,659,2,30,1,1
36628,80,65040,80,allow,78,78,0,1,5,1,0
62362,445,0,0,drop,70,70,0,1,0,1,0
54959,53,55132,53,allow,211,110,101,2,31,1,1
52744,25174,0,0,deny,62,62,0,1,0,1,0
50005,80,43332,80,allow,2088,1160,928,10,86,6,4
51266,16103,36869,16103,allow,70,70,0,1,5,1,0
28413,64147,0,0,deny,66,66,0,1,0,1,0
54352,443,38196,443,allow,12594,5098,7496,32,34,17,15
62489,23117,0,0,deny,62,62,0,1,0,1,0
31991,23,0,0,deny,60,60,0,1,0,1,0
56004,53,27325,53,allow,177,94,83,2,29,1,1
45571,443,60221,443,allow,3974,2015,1959,21,345,10,11
49170,445,0,0,drop,70,70,0,1,0,1,0
64274,53,5372,53,allow,197,102,95,2,32,1,1
55830,53,50350,53,allow,166,86,80,2,30,1,1
53916,445,0,0,drop,70,70,0,1,0,1,0
56757,53,3651,53,allow,783,96,687,2,31,1,1
55653,23,0,0,deny,60,60,0,1,0,1,0
49929,443,10803,443,allow,7069,2667,4402,22,28,13,9
49634,53,43147,53,allow,344,126,218,2,30,1,1
55044,443,54771,443,allow,5549,2777,2772,24,16,14,10
49605,80,22223,80,allow,454,262,192,8,41,5,3
38545,443,54573,443,allow,4961,2148,2813,30,90,13,17
49817,53,12075,53,allow,167,86,81,2,30,1,1
55739,53,37345,53,allow,458,188,270,6,29,3,3
49326,443,20775,443,allow,9303,2551,6752,33,16,18,15
53884,445,0,0,drop,70,70,0,1,0,1,0
51514,445,0,0,drop,66,66,0,1,0,1,0
56413,80,48301,80,allow,31432,748,30684,32,104,8,24
65376,53,45808,53,allow,184,94,90,2,31,1,1
10834,50584,0,0,deny,66,66,0,1,0,1,0
29895,23,0,0,deny,60,60,0,1,0,1,0
19096,64147,0,0,deny,62,62,0,1,0,1,0
63001,445,0,0,drop,70,70,0,1,0,1,0
50927,44847,0,0,deny,62,62,0,1,0,1,0
4706,36237,0,0,deny,146,146,0,1,0,1,0
51787,35661,9669,35661,allow,70,70,0,1,5,1,0
17640,55442,0,0,deny,66,66,0,1,0,1,0
42041,443,41646,443,allow,2351,1546,805,20,54,11,9
56952,53,29584,53,allow,193,102,91,2,30,1,1
50729,445,0,0,drop,70,70,0,1,0,1,0
51769,17,0,0,deny,60,60,0,1,0,1,0
50680,80,61821,80,allow,23386,2375,21011,30,21,12,18
56984,445,0,0,drop,70,70,0,1,0,1,0
64539,53,38642,53,allow,276,126,150,2,30,1,1
52245,443,52245,443,allow,1615,941,674,15,21,7,8
49418,27016,34441,27016,allow,263,78,185,2,29,1,1
3478,61463,0,0,deny,1012,1012,0,1,0,1,0
64828,53,47016,53,allow,881,243,638,6,39,3,3
58840,445,0,0,drop,70,70,0,1,0,1,0
34217,443,35043,443,allow,6650,1556,5094,23,18,13,10
50749,443,31608,443,allow,70,70,0,2,171,2,0
50333,80,53972,80,allow,442,250,192,8,47,5,3
55618,45341,56428,45341,allow,70,70,0,1,5,1,0
55317,443,24510,443,allow,5692,1239,4453,23,16,13,10
55619,53,44719,53,allow,183,94,89,2,29,1,1
35498,80,39354,80,allow,1270,387,883,16,392,4,12
45057,443,6642,443,allow,7536,1915,5621,31,20,17,14
51015,64147,0,0,deny,62,62,0,1,0,1,0
63446,445,0,0,drop,70,70,0,1,0,1,0
49591,80,27431,80,allow,314,128,186,6,27,3,3
56134,53,39668,53,allow,93,93,0,1,30,1,0
55627,53,60150,53,allow,193,102,91,2,30,1,1
62203,445,0,0,drop,70,70,0,1,0,1,0
62737,64147,0,0,deny,66,66,0,1,0,1,0
8508,23,0,0,deny,60,60,0,1,0,1,0
55830,53,41012,53,allow,184,94,90,2,30,1,1
56434,53,6758,53,allow,701,88,613,2,31,1,1
52118,33515,33207,33515,allow,70,70,0,2,7,2,0
57430,53,14392,53,allow,200,102,98,2,29,1,1
56842,24233,12414,24233,allow,70,70,0,2,8,2,0
49603,443,57719,443,allow,11841,1700,10141,37,195,16,21
20741,64147,0,0,deny,62,62,0,1,0,1,0
53670,80,8760,80,allow,950,502,448,12,15,7,5
55450,53,10732,53,allow,193,102,91,2,29,1,1
56411,53,48736,53,allow,184,94,90,2,31,1,1
53191,80,63359,80,allow,1871,712,1159,10,15,5,5
61887,445,0,0,drop,70,70,0,1,0,1,0
58667,445,0,0,drop,70,70,0,1,0,1,0
14252,35993,0,0,deny,66,66,0,1,0,1,0
56280,53,50135,53,allow,1335,87,1248,4,59,2,2
50159,445,0,0,drop,66,66,0,1,0,1,0
49696,53,25941,53,allow,178,94,84,2,31,1,1
26722,11446,0,0,deny,62,62,0,1,0,1,0
36762,443,56086,443,allow,13119,3359,9760,39,120,19,20
56793,443,4192,443,allow,8022,2002,6020,20,16,11,9
10248,21247,0,0,deny,62,62,0,1,0,1,0
55715,53,57381,53,allow,168,86,82,2,30,1,1
59549,445,0,0,drop,70,70,0,1,0,1,0
57582,443,57582,443,allow,2506,1461,1045,21,88,10,11
62970,44847,0,0,deny,62,62,0,1,0,1,0
34489,443,45344,443,allow,8363,1573,6790,24,49,14,10
56771,443,16357,443,allow,7941,1952,5989,20,15,11,9
54816,3389,54816,3389,allow,3413,1458,1955,16,17,8,8
37097,443,17597,443,allow,1835,1190,645,17,26,10,7
61190,445,0,0,drop,66,66,0,1,0,1,0
64573,53,28615,53,allow,380,110,270,2,30,1,1
58638,5900,0,0,deny,62,62,0,1,0,1,0
27005,27017,47971,27017,allow,1616,126,1490,4,30,2,2
55942,53,15569,53,allow,197,102,95,2,30,1,1
50632,443,47511,443,allow,4158,1021,3137,15,26,8,7
43584,24748,0,0,deny,156,156,0,1,0,1,0
26053,33720,0,0,deny,160,160,0,1,0,1,0
1025,40108,0,0,deny,146,146,0,1,0,1,0
58574,445,0,0,drop,70,70,0,1,0,1,0
56448,53,62354,53,allow,200,102,98,2,29,1,1
54957,80,50979,80,allow,416,210,206,7,15,4,3
26053,33720,0,0,deny,160,160,0,1,0,1,0
54005,443,23305,443,allow,4253,726,3527,13,15,7,6
27679,37965,0,0,deny,62,62,0,1,0,1,0
62400,35993,0,0,deny,62,62,0,1,0,1,0
36788,443,36788,443,allow,4555,1648,2907,19,29,11,8
64092,443,64092,443,allow,5643,2397,3246,26,159,14,12
65112,53,6227,53,allow,209,110,99,2,31,1,1
9448,57866,0,0,deny,146,146,0,1,0,1,0
9128,80,3849,80,allow,318,192,126,6,30,4,2
27005,27016,2493,27016,allow,895,126,769,2,30,1,1
47913,25174,0,0,deny,62,62,0,1,0,1,0
52625,445,0,0,drop,70,70,0,1,0,1,0
59657,445,0,0,drop,70,70,0,1,0,1,0
36390,443,36390,443,allow,4563,1656,2907,19,28,11,8
65247,445,0,0,drop,70,70,0,1,0,1,0
56749,443,28025,443,allow,8058,2038,6020,20,15,11,9
50600,80,53751,80,allow,1658,1247,411,8,15,5,3
64731,53,27701,53,allow,403,142,261,2,30,1,1
53889,443,11378,443,allow,499,425,74,4,0,3,1
36166,80,26343,80,allow,1614,1300,314,10,15,5,5
52120,80,3357,80,allow,366,240,126,7,26,5,2
65254,53,46437,53,allow,459,94,365,4,45,2,2
60248,30188,0,0,deny,66,66,0,1,0,1,0
49168,445,0,0,drop,70,70,0,1,0,1,0
50877,35776,0,0,deny,159,159,0,1,0,1,0
49591,53,7578,53,allow,168,86,82,2,32,1,1
56260,53,39887,53,allow,170,87,83,2,31,1,1
60864,5223,21557,5223,allow,6278,2408,3870,27,3600,15,12
3541,22114,0,0,deny,62,62,0,1,0,1,0
58743,443,24933,443,allow,14819,3993,10826,80,330,36,44
57177,53,13049,53,allow,179,94,85,2,30,1,1
57086,53,16252,53,allow,711,87,624,2,30,1,1
64486,445,0,0,drop,66,66,0,1,0,1,0
37484,443,55128,443,allow,59233,7514,51719,70,122,27,43
63920,64147,0,0,deny,66,66,0,1,0,1,0
50143,445,0,0,drop,70,70,0,1,0,1,0
55871,53,4127,53,allow,177,94,83,2,30,1,1
64568,443,63585,443,allow,25404,2462,22942,47,32,25,22
58849,64147,0,0,deny,66,66,0,1,0,1,0
56117,53,32150,53,allow,178,94,84,2,31,1,1
49551,80,48076,80,allow,1769,873,896,11,15,6,5
38586,3855,0,0,deny,145,145,0,1,0,1,0
50682,80,52857,80,allow,5237,680,4557,12,170,6,6
49849,53,37502,53,allow,196,102,94,2,31,1,1
56897,11446,0,0,deny,66,66,0,1,0,1,0
56658,53,34980,53,allow,458,188,270,6,30,3,3
56236,443,26673,443,allow,9597,2488,7109,32,287,16,16
40204,40001,61401,40001,allow,244,181,63,2,31,1,1
55288,53,47176,53,allow,192,98,94,2,31,1,1
49418,27019,50504,27019,allow,71,71,0,1,30,1,0
55759,5900,0,0,deny,60,60,0,1,0,1,0
64122,53,40984,53,allow,214,110,104,2,30,1,1
49704,80,54649,80,allow,2058,589,1469,10,44,6,4
5223,14446,0,0,deny,220,220,0,1,0,1,0
58600,443,58600,443,allow,4396,1489,2907,19,26,11,8
63137,47117,19060,47117,allow,574,448,126,10,25,8,2
52319,443,62232,443,allow,569666,25343,544323,721,46,320,401
5180,57866,0,0,deny,62,62,0,1,0,1,0
57038,53,2434,53,allow,186,102,84,2,30,1,1
52177,443,52177,443,allow,38013,6855,31158,58,21,25,33
15241,53,62094,53,allow,215,86,129,2,30,1,1
7000,23117,0,0,deny,66,66,0,1,0,1,0
5683,44847,0,0,deny,66,66,0,1,0,1,0
65147,53,63811,53,allow,194,102,92,2,31,1,1
64362,35253,0,0,deny,146,146,0,1,0,1,0
60538,80,60538,80,allow,318,120,198,6,26,3,3
53465,443,55749,443,allow,3166,2245,921,15,15,8,7
57452,443,52384,443,allow,6990,2193,4797,15,120,7,8
58554,443,5045,443,allow,8626,2156,6470,24,81,14,10
5223,14446,0,0,deny,167,167,0,1,0,1,0
62696,50584,0,0,deny,66,66,0,1,0,1,0
57324,445,0,0,drop,70,70,0,1,0,1,0
51001,53,26424,53,allow,183,86,97,2,30,1,1
37320,443,60186,443,allow,70,70,0,1,5,1,0
63508,62413,0,0,deny,66,66,0,1,0,1,0
53124,80,20707,80,allow,4198,3534,664,13,19,8,5
49670,53,59914,53,allow,168,86,82,2,31,1,1
39385,443,14896,443,allow,89229,6918,82311,131,33,63,68
51413,54751,0,0,deny,136,136,0,1,0,1,0
18623,1,0,0,deny,66,66,0,1,0,1,0
56927,80,6442,80,allow,214,140,74,4,35,3,1
13907,57470,0,0,deny,62,62,0,1,0,1,0
50707,53,59770,53,allow,181,86,95,2,30,1,1
52264,43015,38341,43015,allow,70,70,0,2,7,2,0
37460,443,43570,443,allow,5674,3900,1774,29,80,15,14
56590,53,27360,53,allow,760,97,663,2,30,1,1
62257,2767,0,0,deny,66,66,0,1,0,1,0
49001,40108,0,0,deny,161,161,0,1,0,1,0
23119,41615,0,0,deny,148,148,0,1,0,1,0
1987,26467,0,0,deny,62,62,0,1,0,1,0
63305,62413,0,0,deny,62,62,0,1,0,1,0
52047,42805,53752,42805,allow,70,70,0,1,4,1,0
50930,445,0,0,drop,66,66,0,1,0,1,0
65504,443,39358,443,allow,92275,4799,87476,107,16,43,64
50418,53,58072,53,allow,185,102,83,2,30,1,1
34225,443,33698,443,allow,256793,17776,239017,327,23,146,181
60399,443,57774,443,allow,8061,1926,6135,24,361,11,13
18623,1,0,0,deny,66,66,0,1,0,1,0
53022,443,29069,443,allow,15099,7828,7271,45,92,24,21
9687,35440,0,0,deny,66,66,0,1,0,1,0
39426,443,8694,443,allow,903603,21528,882075,858,57,234,624
55034,443,13403,443,allow,7969,4870,3099,36,360,20,16
49553,443,65490,443,allow,6074,865,5209,16,15,9,7
50779,443,64325,443,allow,3247,1630,1617,8,120,4,4
48742,443,35072,443,allow,5378,1423,3955,19,49,11,8
50713,57470,0,0,deny,62,62,0,1,0,1,0
53759,40826,3442,40826,allow,492,306,186,8,15,5,3
56273,53,37875,53,allow,330,126,204,2,30,1,1
49327,443,33965,443,allow,54335,2550,51785,74,42,29,45
36516,443,59096,443,allow,70,70,0,1,4,1,0
49289,53,50733,53,allow,322,118,204,2,30,1,1
58483,445,0,0,drop,66,66,0,1,0,1,0
65042,53,41893,53,allow,182,93,89,2,31,1,1
56643,443,24007,443,allow,1560,988,572,13,21,7,6
60868,443,49136,443,allow,9660,2402,7258,27,46,15,12
53976,52534,6002,52534,allow,70,70,0,1,5,1,0
49634,445,0,0,drop,66,66,0,1,0,1,0
56696,443,57667,443,allow,8059,2039,6020,20,15,11,9
59374,51505,0,0,deny,62,62,0,1,0,1,0
65082,53,4469,53,allow,718,94,624,2,29,1,1
45766,35440,0,0,deny,62,62,0,1,0,1,0
53437,6057,38097,6057,allow,245,245,0,2,30,2,0
12060,37965,0,0,deny,66,66,0,1,0,1,0
38320,51505,0,0,deny,66,66,0,1,0,1,0
55586,445,0,0,drop,70,70,0,1,0,1,0
50744,443,51827,443,allow,6811,1923,4888,21,15,11,10
53227,53,11040,53,allow,78,78,0,1,29,1,0
49381,53,64109,53,allow,230,102,128,2,29,1,1
54998,53,51168,53,allow,195,102,93,2,30,1,1
55075,445,0,0,drop,70,70,0,1,0,1,0
58169,443,39268,443,allow,30845,9943,20902,172,133,73,99
57078,443,63821,443,allow,4730,2569,2161,16,135,8,8
60404,37869,1264,37869,allow,164,70,94,2,5,1,1
62452,21247,0,0,deny,66,66,0,1,0,1,0
39207,80,48256,80,allow,234,234,0,4,12,4,0
50094,445,0,0,drop,70,70,0,1,0,1,0
64975,53,43514,53,allow,198,94,104,2,30,1,1
55111,39004,0,0,deny,66,66,0,1,0,1,0
60688,445,0,0,drop,70,70,0,1,0,1,0
49300,443,11217,443,allow,26747,8027,18720,58,92,25,33
64941,53,17276,53,allow,199,102,97,2,30,1,1
52711,37965,0,0,deny,62,62,0,1,0,1,0
34989,80,37174,80,allow,350,210,140,6,28,4,2
63646,445,0,0,drop,66,66,0,1,0,1,0
57323,53,57323,53,allow,216,98,118,2,30,1,1
58682,445,0,0,drop,66,66,0,1,0,1,0
64524,53,34078,53,allow,184,94,90,2,31,1,1
59700,445,0,0,drop,70,70,0,1,0,1,0
59860,443,59422,443,allow,2165,987,1178,17,40,8,9
57405,443,36790,443,allow,5734,1543,4191,24,26,13,11
55288,53,34566,53,allow,196,102,94,2,30,1,1
52408,443,37575,443,allow,1043,556,487,10,16,6,4
51829,80,1041,80,allow,1484,928,556,13,76,8,5
48755,443,25931,443,allow,6423,1145,5278,19,33,11,8
58926,25174,0,0,deny,146,146,0,1,0,1,0
37907,443,63465,443,allow,9227,2999,6228,64,616,35,29
49978,53,54478,53,allow,760,97,663,2,31,1,1
1238,51505,0,0,deny,62,62,0,1,0,1,0
58035,80,60635,80,allow,130,70,60,2,15,1,1
16387,23177,0,0,deny,60,60,0,1,0,1,0
52108,20175,5769,20175,allow,70,70,0,2,8,2,0
50265,2710,57990,2710,allow,320,320,0,6,1200,6,0
56207,53,7940,53,allow,761,100,661,2,31,1,1
49713,53,37729,53,allow,177,94,83,2,30,1,1
46576,23718,0,0,deny,62,62,0,1,0,1,0
49689,22114,0,0,deny,62,62,0,1,0,1,0
42783,53,31772,53,allow,199,94,105,2,30,1,1
64266,53,27142,53,allow,168,86,82,2,30,1,1
58574,443,3429,443,allow,3447,788,2659,13,135,6,7
55116,7574,0,0,deny,62,62,0,1,0,1,0
59985,57470,0,0,deny,62,62,0,1,0,1,0
35141,53,35141,53,allow,288,83,205,2,31,1,1
54631,44847,0,0,deny,74,74,0,1,0,1,0
52904,445,0,0,drop,70,70,0,1,0,1,0
64554,53,27674,53,allow,199,102,97,2,30,1,1
55337,53,8844,53,allow,198,102,96,2,31,1,1
57604,80,57604,80,allow,16101,4026,12075,35,38,16,19
56380,53,55619,53,allow,170,87,83,2,31,1,1
51601,445,0,0,drop,66,66,0,1,0,1,0
55056,53,12643,53,allow,202,103,99,2,31,1,1
5938,6987,0,0,allow,60,60,0,1,90,1,0
44482,443,20797,443,allow,7464,1869,5595,29,409,11,18
57346,53,4986,53,allow,204,104,100,2,31,1,1
34344,443,5583,443,allow,9167,2205,6962,37,120,19,18
49713,53,3397,53,allow,198,102,96,2,30,1,1
65189,53,27284,53,allow,180,94,86,2,30,1,1
49532,53,40570,53,allow,195,102,93,2,30,1,1
60720,23718,0,0,deny,66,66,0,1,0,1,0
50403,53,33399,53,allow,168,86,82,2,30,1,1
4328,7302,0,0,deny,66,66,0,1,0,1,0
12550,37807,0,0,deny,146,146,0,1,0,1,0
52676,445,0,0,drop,70,70,0,1,0,1,0
54730,445,0,0,drop,70,70,0,1,0,1,0
50795,443,7705,443,allow,18444,12288,6156,36,149,20,16
63740,445,0,0,drop,70,70,0,1,0,1,0
60304,445,0,0,drop,70,70,0,1,0,1,0
59032,53,50252,53,allow,295,86,209,2,30,1,1
43368,80,43368,80,allow,232198,9152,223046,290,21,134,156
42305,443,8617,443,allow,1262512,53286,1209226,1457,280,548,909
50152,445,0,0,drop,70,70,0,1,0,1,0
49678,445,0,0,drop,70,70,0,1,0,1,0
55425,37965,0,0,deny,66,66,0,1,0,1,0
61635,37965,0,0,deny,66,66,0,1,0,1,0
44117,6881,0,0,deny,146,146,0,1,0,1,0
28413,64147,0,0,deny,62,62,0,1,0,1,0
49860,53,48565,53,allow,168,86,82,2,31,1,1
52077,53,26834,53,allow,199,94,105,2,30,1,1
57470,17690,10017,17690,allow,1818,1188,630,26,2804,19,7
58638,5900,58638,5900,allow,66,66,0,1,4,1,0
28743,53,28743,53,allow,197,76,121,2,30,1,1
52427,445,0,0,drop,66,66,0,1,0,1,0
54332,445,0,0,drop,70,70,0,1,0,1,0
50142,443,40604,443,allow,9040,2349,6691,22,64,13,9
47910,7454,0,0,deny,60,60,0,1,0,1,0
62461,445,0,0,drop,70,70,0,1,0,1,0
41820,80,9493,80,allow,1056,362,694,10,49,6,4
55467,53,15072,53,allow,186,95,91,2,30,1,1
56531,445,0,0,drop,70,70,0,1,0,1,0
53589,3389,53589,3389,allow,3407,1518,1889,16,16,9,7
62348,50584,0,0,deny,62,62,0,1,0,1,0
65114,53,27541,53,allow,196,102,94,2,31,1,1
44169,443,53615,443,allow,12098,5328,6770,25,121,12,13
52230,50265,0,0,deny,66,66,0,1,0,1,0
63747,80,64940,80,allow,314,192,122,6,15,4,2
58131,53,58131,53,allow,194,87,107,2,30,1,1
50438,3389,50438,3389,allow,3429,1474,1955,16,16,8,8
59013,445,0,0,drop,70,70,0,1,0,1,0
62810,445,0,0,drop,70,70,0,1,0,1,0
55664,53,52942,53,allow,711,87,624,2,31,1,1
52063,7886,55344,7886,allow,70,70,0,2,8,2,0
50949,45960,0,0,deny,62,62,0,1,0,1,0
12107,22114,0,0,deny,66,66,0,1,0,1,0
64048,44918,64560,44918,allow,66,66,0,2,8,2,0
59855,445,0,0,drop,70,70,0,1,0,1,0
56986,80,18351,80,allow,214,140,74,4,35,3,1
52326,445,0,0,drop,66,66,0,1,0,1,0
17408,8497,0,0,deny,148,148,0,1,0,1,0
53131,80,64503,80,allow,2957,619,2338,12,15,6,6
51499,443,1743,443,allow,6848,769,6079,17,15,9,8
15345,36829,0,0,deny,62,62,0,1,0,1,0
56640,445,0,0,drop,70,70,0,1,0,1,0
64516,53,21568,53,allow,215,94,121,2,30,1,1
62250,23117,0,0,deny,66,66,0,1,0,1,0
50298,443,51193,443,allow,11984,6772,5212,52,222,30,22
57140,53,16030,53,allow,170,87,83,2,30,1,1
57136,53,51914,53,allow,202,103,99,2,31,1,1
62080,54532,0,0,deny,60,60,0,1,0,1,0
33115,443,15120,443,allow,75816,2178,73638,72,16,20,52
50399,445,0,0,drop,70,70,0,1,0,1,0
14430,443,35759,443,allow,2629,1470,1159,18,15,8,10
53773,445,0,0,drop,66,66,0,1,0,1,0
56215,53,5017,53,allow,216,110,106,2,30,1,1
55002,443,31651,443,allow,469783,461079,8704,444,167,329,115
49611,80,38044,80,allow,378,192,186,7,41,4,3
51961,445,0,0,drop,66,66,0,1,0,1,0
55567,53,55567,53,allow,216,90,126,2,30,1,1
46898,53,46898,53,allow,194,87,107,2,30,1,1
65513,53,15039,53,allow,195,102,93,2,31,1,1
63929,445,0,0,drop,70,70,0,1,0,1,0
55166,445,0,0,drop,70,70,0,1,0,1,0
53115,40693,57479,40693,allow,70,70,0,1,5,1,0
9222,443,6216,443,allow,6676,1097,5579,21,26,11,10
14205,53,14205,53,allow,233,91,142,2,31,1,1
55618,56205,0,0,deny,66,66,0,1,0,1,0
35702,443,51381,443,allow,13428,5815,7613,42,995,22,20
55025,443,34661,443,allow,7654,2110,5544,21,46,13,8
48931,53,2346,53,allow,168,78,90,2,30,1,1
55423,445,0,0,drop,70,70,0,1,0,1,0
58638,5900,0,0,deny,62,62,0,1,0,1,0
59402,53,59402,53,allow,216,90,126,2,29,1,1
993,54748,0,0,deny,66,66,0,1,0,1,0
57782,57470,0,0,deny,66,66,0,1,0,1,0
51413,443,51090,443,allow,63766,32148,31618,103,42,51,52
27888,53,27888,53,allow,240,96,144,2,31,1,1
59818,443,31542,443,allow,1401,864,537,12,29,6,6
49726,445,0,0,drop,70,70,0,1,0,1,0
49581,80,58944,80,allow,2339,1107,1232,11,21,6,5
49418,27025,19302,27025,allow,71,71,0,1,30,1,0
59977,53,61405,53,allow,168,78,90,2,30,1,1
43546,443,49269,443,allow,5948,1664,4284,21,247,12,9
58813,80,56191,80,allow,2393,551,1842,10,21,6,4
58162,445,0,0,drop,70,70,0,1,0,1,0
64327,53,59589,53,allow,214,102,112,2,29,1,1
58638,5900,0,0,deny,62,62,0,1,0,1,0
51212,445,0,0,drop,66,66,0,1,0,1,0
56601,53,17234,53,allow,177,94,83,2,30,1,1
58402,445,0,0,drop,70,70,0,1,0,1,0
65317,53,60723,53,allow,195,102,93,2,29,1,1
5588,5588,0,0,allow,3354,1792,1562,46,194,23,23
58924,445,0,0,drop,70,70,0,1,0,1,0
57470,29137,36773,29137,allow,1386,1386,0,22,1610,22,0
36821,443,62805,443,allow,6164,3172,2992,28,141,12,16
56992,53,30426,53,allow,355,102,253,2,30,1,1
57937,445,0,0,drop,66,66,0,1,0,1,0
49624,53,59918,53,allow,293,126,167,2,30,1,1
50078,443,13152,443,allow,12035,9784,2251,41,92,22,19
41036,443,13628,443,allow,153,93,60,2,5,1,1
50603,445,0,0,drop,66,66,0,1,0,1,0
34704,443,48562,443,allow,10207,3126,7081,26,24,14,12
14082,50584,0,0,deny,66,66,0,1,0,1,0
35353,443,65162,443,allow,1833,991,842,14,224,7,7
50013,53,57171,53,allow,258,102,156,2,30,1,1
50014,445,0,0,drop,70,70,0,1,0,1,0
61902,22114,0,0,deny,66,66,0,1,0,1,0
1024,25174,0,0,deny,62,62,0,1,0,1,0
58638,5900,0,0,deny,62,62,0,1,0,1,0
53302,445,0,0,drop,66,66,0,1,0,1,0
49202,53,57613,53,allow,226,86,140,2,30,1,1
61840,25174,0,0,deny,66,66,0,1,0,1,0
63939,53,40762,53,allow,226,110,116,2,30,1,1
56143,53,50780,53,allow,177,94,83,2,30,1,1
56480,445,0,0,drop,70,70,0,1,0,1,0
58228,53733,0,0,deny,66,66,0,1,0,1,0
57487,443,43988,443,allow,1786,172,1614,7,121,3,4
59149,445,0,0,drop,70,70,0,1,0,1,0
63951,53,53032,53,allow,345,106,239,4,38,2,2
56717,443,27833,443,allow,8006,1986,6020,20,15,11,9
50403,53,23748,53,allow,168,86,82,2,31,1,1
58751,51221,0,0,deny,62,62,0,1,0,1,0
57825,13014,0,0,deny,74,74,0,1,0,1,0
56590,25174,0,0,deny,66,66,0,1,0,1,0
56072,80,56072,80,allow,23248,1600,21648,35,31,17,18
49458,445,0,0,drop,66,66,0,1,0,1,0
56733,443,4067,443,allow,7941,1952,5989,20,15,11,9
56553,53,20095,53,allow,701,88,613,2,30,1,1
59042,445,0,0,drop,70,70,0,1,0,1,0
50047,443,50047,443,allow,4534,1627,2907,19,27,11,8
50470,61463,0,0,deny,86,86,0,1,0,1,0
55548,53,2209,53,allow,197,102,95,2,29,1,1
58638,5900,0,0,deny,62,62,0,1,0,1,0
64954,53,8799,53,allow,94,94,0,1,30,1,0
63965,11785,30846,11785,allow,66,66,0,1,5,1,0
55514,1604,0,0,deny,84,84,0,1,0,1,0
45941,23386,0,0,deny,60,60,0,1,0,1,0
50535,51505,0,0,deny,66,66,0,1,0,1,0
47661,80,24519,80,allow,2865,2000,865,12,15,7,5
54141,445,0,0,drop,70,70,0,1,0,1,0
64739,53,37126,53,allow,193,102,91,2,30,1,1
26900,27017,43419,27017,allow,422,164,258,6,30,3,3
50813,445,0,0,drop,70,70,0,1,0,1,0
443,21255,0,0,deny,66,66,0,1,0,1,0
56418,41615,0,0,deny,143,143,0,1,0,1,0
49847,80,28928,80,allow,4135,2587,1548,10,89,7,3
37611,443,45731,443,allow,11038,3875,7163,33,16,18,15
26601,22114,0,0,deny,62,62,0,1,0,1,0
65109,445,0,0,drop,70,70,0,1,0,1,0
57779,22114,0,0,deny,146,146,0,1,0,1,0
26900,27017,26989,27017,allow,422,164,258,6,30,3,3
64086,443,16892,443,allow,3289,1031,2258,13,121,6,7
49581,445,0,0,drop,70,70,0,1,0,1,0
58814,443,65401,443,allow,6508,4230,2278,22,16,12,10
53473,445,0,0,drop,70,70,0,1,0,1,0
57414,53,33094,53,allow,214,102,112,2,29,1,1
50384,80,18722,80,allow,2537,783,1754,13,20,7,6
58488,37965,0,0,deny,62,62,0,1,0,1,0
50787,445,0,0,drop,66,66,0,1,0,1,0
53546,46824,0,0,deny,66,66,0,1,0,1,0
50693,443,1637,443,allow,306,120,186,6,23,3,3
49488,445,0,0,drop,70,70,0,1,0,1,0
26799,50584,0,0,deny,146,146,0,1,0,1,0
39287,57470,0,0,deny,62,62,0,1,0,1,0
63998,11372,44405,11372,allow,504,382,122,8,16,6,2
58873,53,50618,53,allow,168,78,90,2,30,1,1
50542,443,10876,443,allow,86426,3497,82929,102,170,38,64
55877,56299,54578,56299,allow,481,150,331,2,1200,1,1
56421,53,23965,53,allow,170,87,83,2,30,1,1
52277,445,0,0,drop,66,66,0,1,0,1,0
44984,80,44984,80,allow,7061,2943,4118,16,23,9,7
56231,80,56231,80,allow,44747,815,43932,45,15,12,33
43113,443,54317,443,allow,3083,1817,1266,18,15,8,10
64593,53,5715,53,allow,602,93,509,4,42,2,2
60786,80,13349,80,allow,1638,1324,314,10,15,5,5
57776,445,0,0,drop,70,70,0,1,0,1,0
30960,45743,2927,45743,allow,330,330,0,6,3609,6,0
12951,50584,0,0,deny,66,66,0,1,0,1,0
59105,443,52375,443,allow,8742,3785,4957,21,16,12,9
54909,445,0,0,drop,70,70,0,1,0,1,0
52229,54711,46262,54711,allow,136,136,0,3,14,3,0
61902,22114,0,0,deny,66,66,0,1,0,1,0
19270,56448,0,0,deny,78,78,0,1,0,1,0
37595,443,31654,443,allow,34423,3999,30424,52,46,24,28
55535,80,6697,80,allow,18450,1862,16588,29,17,15,14
56169,53,27417,53,allow,210,110,100,2,29,1,1
55447,53,22356,53,allow,194,102,92,2,29,1,1
49684,53,44986,53,allow,265,110,155,2,30,1,1
63573,445,0,0,drop,66,66,0,1,0,1,0
49629,53,65217,53,allow,198,102,96,2,31,1,1
52003,80,9765,80,allow,88807,5957,82850,113,15,54,59
51390,53,51390,53,allow,398,255,143,3,31,2,1
19366,53,39850,53,allow,300,209,91,3,30,2,1
35132,53,35132,53,allow,469,165,304,4,31,2,2
49160,6881,22368,6881,allow,490,150,340,2,1200,1,1
60053,443,33088,443,allow,3190,1599,1591,17,142,9,8
62415,57470,0,0,deny,66,66,0,1,0,1,0
53189,445,0,0,drop,66,66,0,1,0,1,0
3381,44847,0,0,deny,78,78,0,1,0,1,0
9323,443,4707,443,allow,26959,1764,25195,42,48,18,24
50401,53,50401,53,allow,200,90,110,2,30,1,1
49302,53,61464,53,allow,234,94,140,2,30,1,1
53353,26467,0,0,deny,62,62,0,1,0,1,0
57309,53,41723,53,allow,316,110,206,2,30,1,1
54319,445,0,0,drop,70,70,0,1,0,1,0
993,11946,0,0,deny,66,66,0,1,0,1,0
64947,53,12228,53,allow,402,118,284,2,29,1,1
49615,53,57263,53,allow,199,102,97,2,30,1,1
63975,24874,47562,24874,allow,70,70,0,1,5,1,0
8889,42210,0,0,deny,60,60,0,1,0,1,0
62832,445,0,0,drop,70,70,0,1,0,1,0
53766,51505,0,0,deny,66,66,0,1,0,1,0
56568,445,0,0,drop,70,70,0,1,0,1,0
49354,53,16501,53,allow,196,102,94,2,30,1,1
64091,53,62313,53,allow,178,94,84,2,30,1,1
64143,53,3615,53,allow,179,94,85,2,30,1,1
64576,445,0,0,drop,66,66,0,1,0,1,0
55429,443,25959,443,allow,6292,4834,1458,18,129,11,7
17532,53,17532,53,allow,233,90,143,2,31,1,1
64177,44847,0,0,deny,66,66,0,1,0,1,0
60709,53,36089,53,allow,260,86,174,2,30,1,1
56278,52752,0,0,deny,62,62,0,1,0,1,0
56733,53,5825,53,allow,177,94,83,2,29,1,1
51965,445,0,0,drop,70,70,0,1,0,1,0
57535,445,0,0,drop,70,70,0,1,0,1,0
50026,53,4265,53,allow,395,99,296,4,57,2,2
56774,443,5880,443,allow,7889,1900,5989,20,15,11,9
58792,443,15545,443,allow,9278,6126,3152,27,16,15,12
64482,64147,0,0,deny,62,62,0,1,0,1,0
53450,443,18001,443,allow,5931,1750,4181,24,48,14,10
36339,443,4245,443,allow,7295,1830,5465,23,316,13,10
55164,53,26323,53,allow,177,94,83,2,30,1,1
56645,443,5860,443,allow,32966,3481,29485,49,80,21,28
45952,22114,0,0,deny,62,62,0,1,0,1,0
52969,44847,0,0,deny,62,62,0,1,0,1,0
20844,64147,0,0,deny,66,66,0,1,0,1,0
48191,5223,34035,5223,allow,4164,1264,2900,23,1140,13,10
57790,443,8937,443,allow,117653,21783,95870,251,556,93,158
50013,53,7317,53,allow,199,102,97,2,30,1,1
9431,443,45231,443,allow,8693,2545,6148,26,34,13,13
56940,53,36969,53,allow,200,102,98,2,31,1,1
56897,445,0,0,drop,66,66,0,1,0,1,0
57401,53,56934,53,allow,179,94,85,2,31,1,1
59785,445,0,0,drop,66,66,0,1,0,1,0
59377,9319,0,0,deny,62,62,0,1,0,1,0
55540,443,32830,443,allow,10458,5272,5186,24,76,13,11
54461,443,55522,443,allow,7548,2583,4965,26,362,12,14
443,4205,0,0,deny,320,320,0,1,0,1,0
50549,43890,0,0,deny,62,62,0,1,0,1,0
57256,53,42871,53,allow,771,101,670,2,31,1,1
46812,80,23325,80,allow,1137,679,458,10,15,6,4
9167,443,11467,443,allow,4072,434,3638,12,15,6,6
4110,35440,0,0,deny,66,66,0,1,0,1,0
34470,57470,0,0,deny,66,66,0,1,0,1,0
49672,80,61052,80,allow,3874260,98179,3776081,4003,1072,1479,2524
34396,443,45872,443,allow,6214,1750,4464,24,316,12,12
43112,443,57880,443,allow,7192,1772,5420,25,305,13,12
38049,53,38049,53,allow,213,87,126,2,31,1,1
59930,445,0,0,drop,70,70,0,1,0,1,0
52673,80,57831,80,allow,23776,1372,22404,35,112,15,20
56755,445,0,0,drop,70,70,0,1,0,1,0
58665,53,16877,53,allow,260,86,174,2,30,1,1
55923,53,53051,53,allow,177,94,83,2,30,1,1
60933,445,0,0,drop,66,66,0,1,0,1,0
53252,443,20191,443,allow,6053,974,5079,20,66,10,10
52434,445,0,0,drop,70,70,0,1,0,1,0
56760,48386,9485,48386,allow,268,70,198,4,19,1,3
65500,445,0,0,drop,66,66,0,1,0,1,0
49848,443,21903,443,allow,5997,976,5021,19,72,10,9
62682,23,0,0,deny,60,60,0,1,0,1,0
52261,53,10393,53,allow,195,94,101,2,29,1,1
59856,445,0,0,drop,70,70,0,1,0,1,0
52269,443,52269,443,allow,1615,941,674,15,20,7,8
49410,53,14771,53,allow,167,86,81,2,30,1,1
49467,443,18409,443,allow,4564,2466,2098,20,119,11,9
49935,53,57757,53,allow,775,102,673,2,30,1,1
53635,445,0,0,drop,70,70,0,1,0,1,0
64612,445,0,0,drop,70,70,0,1,0,1,0
45565,443,30523,443,allow,1784491,72960,1711531,1872,113,687,1185
56487,53,61282,53,allow,194,102,92,2,31,1,1
61549,445,0,0,drop,70,70,0,1,0,1,0
56433,53,27409,53,allow,170,87,83,2,31,1,1
51921,80,46796,80,allow,35092,3319,31773,48,31,21,27
58913,445,0,0,drop,66,66,0,1,0,1,0
27272,64147,0,0,deny,62,62,0,1,0,1,0
51429,22114,0,0,deny,62,62,0,1,0,1,0
51809,52528,62433,52528,allow,70,70,0,2,8,2,0
56732,443,47503,443,allow,6205,986,5219,16,48,10,6
34228,45129,0,0,deny,148,148,0,1,0,1,0
50289,445,0,0,drop,66,66,0,1,0,1,0
57254,443,23704,443,allow,6000,1578,4422,22,36,12,10
63938,26204,5698,26204,allow,66,66,0,2,7,2,0
51996,443,3596,443,allow,2648,1797,851,19,22,11,8
61002,37965,0,0,deny,145,145,0,1,0,1,0
56636,53,8907,53,allow,168,86,82,2,30,1,1
51234,80,58624,80,allow,6798,4486,2312,42,107,22,20
57608,445,0,0,drop,70,70,0,1,0,1,0
65512,44847,0,0,deny,62,62,0,1,0,1,0
52977,445,0,0,drop,70,70,0,1,0,1,0
39009,443,34628,443,allow,12197,2338,9859,34,122,14,20
54872,53,11458,53,allow,578,286,292,9,15,5,4
55695,53,3075,53,allow,177,94,83,2,29,1,1
58638,5900,0,0,deny,62,62,0,1,0,1,0
60334,7080,60334,7080,allow,2960,432,2528,11,15,6,5
65373,445,0,0,drop,66,66,0,1,0,1,0
57165,34101,0,0,deny,66,66,0,1,0,1,0
52955,443,58633,443,allow,23572,2063,21509,46,114,20,26
57334,53,51470,53,allow,184,94,90,2,29,1,1
9687,57470,0,0,deny,78,78,0,1,0,1,0
58049,80,61142,80,allow,378,192,186,7,19,4,3
62691,445,0,0,drop,70,70,0,1,0,1,0
52174,445,0,0,drop,66,66,0,1,0,1,0
65359,53,4725,53,allow,443,182,261,6,30,3,3
64365,53,27467,53,allow,341,110,231,2,29,1,1
63288,52848,0,0,deny,66,66,0,1,0,1,0
36928,53,43446,53,allow,241,78,163,2,30,1,1
49215,53,25508,53,allow,214,102,112,2,30,1,1
65139,53,1458,53,allow,216,110,106,2,30,1,1
51032,30188,0,0,deny,62,62,0,1,0,1,0
44467,53,44467,53,allow,211,80,131,2,30,1,1
59790,44847,0,0,deny,62,62,0,1,0,1,0
61559,53,9585,53,allow,376,86,290,2,29,1,1
49869,53,29655,53,allow,209,110,99,2,30,1,1
50767,57470,0,0,deny,66,66,0,1,0,1,0
54392,445,0,0,drop,66,66,0,1,0,1,0
22367,50584,0,0,deny,146,146,0,1,0,1,0
51406,443,38367,443,allow,8186,2146,6040,29,33,16,13
59055,445,0,0,drop,70,70,0,1,0,1,0
50018,3389,50018,3389,allow,3413,1458,1955,16,18,8,8
58638,5900,0,0,deny,62,62,0,1,0,1,0
49874,443,3516,443,allow,6058,1037,5021,20,54,11,9
12604,80,0,0,deny,60,60,0,1,0,1,0
56816,11392,0,0,deny,66,66,0,1,0,1,0
57526,445,0,0,drop,66,66,0,1,0,1,0
53870,24535,42849,24535,allow,70,70,0,2,8,2,0
52959,445,0,0,drop,70,70,0,1,0,1,0
60415,40829,35259,40829,allow,70,70,0,2,8,2,0
61990,445,0,0,drop,70,70,0,1,0,1,0
63818,19291,22268,19291,allow,70,70,0,1,4,1,0
14925,57470,0,0,deny,145,145,0,1,0,1,0
53078,445,0,0,drop,70,70,0,1,0,1,0
49131,443,28166,443,allow,6150,914,5236,18,97,10,8
50653,445,0,0,drop,70,70,0,1,0,1,0
52556,443,21958,443,allow,5696,2392,3304,23,135,10,13
58774,443,43846,443,allow,5167,700,4467,16,15,7,9
56432,53,38041,53,allow,195,102,93,2,30,1,1
55678,53,29354,53,allow,270,88,182,4,53,2,2
64927,445,0,0,drop,70,70,0,1,0,1,0
62512,25174,0,0,deny,62,62,0,1,0,1,0
49872,53,49872,53,allow,218,90,128,2,29,1,1
49653,443,56043,443,allow,8915,2193,6722,22,46,13,9
57275,53,32208,53,allow,177,94,83,2,31,1,1
51425,37450,0,0,deny,66,66,0,1,0,1,0
51414,22,0,0,deny,60,60,0,1,0,1,0
27992,443,34351,443,allow,7775,3104,4671,18,76,10,8
26900,27017,44088,27017,allow,250,164,86,4,30,3,1
56216,53,35008,53,allow,177,94,83,2,29,1,1
9755,53,9755,53,allow,244,98,146,2,33,1,1
49418,33071,57943,33071,allow,78,78,0,1,30,1,0
49810,53,13654,53,allow,244,94,150,2,30,1,1
50987,10086,44124,10086,allow,217,157,60,2,5,1,1
61075,53,61075,53,allow,244,98,146,2,32,1,1
50463,80,10843,80,allow,287874,13215,274659,346,204,136,210
52084,445,0,0,drop,66,66,0,1,0,1,0
50545,443,13694,443,allow,10127,1872,8255,26,27,13,13
49932,53,43257,53,allow,195,102,93,2,30,1,1
60942,443,40230,443,allow,5081,896,4185,16,70,8,8
64658,53,8151,53,allow,195,102,93,2,30,1,1
54066,443,63244,443,allow,307208,13249,293959,367,202,153,214
49378,53,56071,53,allow,268,94,174,2,30,1,1
47643,443,8942,443,allow,11108,3774,7334,28,230,13,15
53695,443,14454,443,allow,4045,439,3606,11,15,5,6
41004,5000,0,0,deny,60,60,0,1,0,1,0
443,35385,0,0,deny,161,161,0,1,0,1,0
51192,15503,0,0,deny,66,66,0,1,0,1,0
58306,443,35402,443,allow,5995,3536,2459,31,20,17,14
52741,24211,0,0,deny,66,66,0,1,0,1,0
44798,443,42874,443,allow,3239,2220,1019,16,15,9,7
52183,445,0,0,drop,70,70,0,1,0,1,0
63404,445,0,0,drop,70,70,0,1,0,1,0
49418,27015,33694,27015,allow,246,78,168,2,31,1,1
12596,53,12596,53,allow,197,90,107,2,30,1,1
55551,53,64054,53,allow,180,94,86,2,29,1,1
47002,53,47002,53,allow,244,98,146,2,31,1,1
37202,53,37202,53,allow,216,90,126,2,30,1,1
30654,51221,0,0,deny,72,72,0,1,0,1,0
49349,80,16332,80,allow,2391,532,1859,11,76,6,5
61397,80,22347,80,allow,2500,531,1969,11,75,6,5
53887,445,0,0,drop,70,70,0,1,0,1,0
50584,6881,26330,6881,allow,502,150,352,2,1200,1,1
51120,587,51120,587,allow,320,128,192,6,6,3,3
50774,445,0,0,drop,70,70,0,1,0,1,0
51811,445,0,0,drop,70,70,0,1,0,1,0
53134,42369,45499,42369,allow,70,70,0,2,8,2,0
53248,443,27776,443,allow,41125,3625,37500,62,323,25,37
49696,53,54642,53,allow,172,88,84,2,30,1,1
56127,445,0,0,drop,66,66,0,1,0,1,0
55920,53,34293,53,allow,810,108,702,2,31,1,1
64912,53,47656,53,allow,183,94,89,2,30,1,1
27005,28115,50771,28115,allow,910,126,784,2,30,1,1
61891,445,0,0,drop,70,70,0,1,0,1,0
55114,445,0,0,drop,70,70,0,1,0,1,0
46116,57470,0,0,deny,74,74,0,1,0,1,0
56396,53,42377,53,allow,183,94,89,2,30,1,1
55069,53,13593,53,allow,195,102,93,2,31,1,1
62464,41090,36975,41090,allow,454923,271912,183011,516,549,295,221
22547,48817,0,0,deny,72,72,0,1,0,1,0
53985,26515,42482,26515,allow,70,70,0,1,4,1,0
52036,80,8626,80,allow,366,240,126,7,24,5,2
56582,53,45513,53,allow,98,98,0,1,30,1,0
19473,53813,59984,53813,allow,481,150,331,2,1200,1,1
38060,443,63699,443,allow,27679,15839,11840,75,103,39,36
49640,443,44264,443,allow,12619,3258,9361,33,47,19,14
55190,445,0,0,drop,70,70,0,1,0,1,0
57523,445,0,0,drop,70,70,0,1,0,1,0
49886,53,51424,53,allow,311,102,209,2,30,1,1
9421,443,1496,443,allow,5699,505,5194,14,15,7,7
62569,44847,0,0,deny,66,66,0,1,0,1,0
55686,443,35273,443,allow,319563,13365,306198,344,123,119,225
56938,445,0,0,drop,70,70,0,1,0,1,0
54730,443,29479,443,allow,20465,3839,16626,43,229,22,21
51137,80,51137,80,allow,66992,5462,61530,79,26,30,49
57689,445,0,0,drop,70,70,0,1,0,1,0
10910,57866,0,0,deny,62,62,0,1,0,1,0
53982,24226,55007,24226,allow,70,70,0,1,4,1,0
55209,53,9446,53,allow,98,98,0,1,30,1,0
37540,443,32914,443,allow,6749,2315,4434,24,46,14,10
55216,53,52646,53,allow,179,94,85,2,30,1,1
51467,443,51893,443,allow,194,70,124,3,11,1,2
49487,445,0,0,drop,66,66,0,1,0,1,0
65189,27015,60711,27015,allow,278,78,200,2,29,1,1
56755,53,8890,53,allow,663,212,451,6,63,3,3
55678,52879,10322,52879,allow,70,70,0,2,8,2,0
62237,445,0,0,drop,66,66,0,1,0,1,0
58381,57470,0,0,deny,66,66,0,1,0,1,0
55692,53,9187,53,allow,198,102,96,2,31,1,1
44871,53,32671,53,allow,168,78,90,2,30,1,1
57447,445,0,0,drop,70,70,0,1,0,1,0
39029,53,55192,53,allow,198,93,105,2,31,1,1
56312,53,29568,53,allow,195,102,93,2,29,1,1
56857,43237,16433,43237,allow,70,70,0,2,8,2,0
55393,44512,0,0,deny,66,66,0,1,0,1,0
64475,53,57543,53,allow,314,99,215,4,39,2,2
64945,53,35387,53,allow,240,86,154,2,30,1,1
10151,40231,24979,40231,allow,481,150,331,2,1200,1,1
57379,443,26122,443,allow,7211,823,6388,16,15,10,6
58638,5900,0,0,deny,62,62,0,1,0,1,0
60281,80,39760,80,allow,1151,711,440,10,16,5,5
65300,53,37068,53,allow,190,97,93,2,31,1,1
137,137,54849,137,allow,96,96,0,2,31,2,0
52447,43890,0,0,deny,66,66,0,1,0,1,0
62066,443,9765,443,allow,3150,831,2319,13,135,6,7
59208,445,0,0,drop,70,70,0,1,0,1,0
58638,5900,0,0,deny,62,62,0,1,0,1,0
54859,443,24991,443,allow,6677,1006,5671,19,26,11,8
52632,443,52632,443,allow,4351,1444,2907,19,28,11,8
55107,53,25498,53,allow,184,94,90,2,30,1,1
64820,53,31810,53,allow,195,102,93,2,30,1,1
50920,443,1716,443,allow,24070,16123,7947,82,6308,42,40
59891,443,7306,443,allow,1813,1004,809,16,28,8,8
61079,445,0,0,drop,66,66,0,1,0,1,0
60297,445,0,0,drop,70,70,0,1,0,1,0
53954,57868,29520,57868,allow,70,70,0,1,5,1,0
45964,2666,0,0,deny,60,60,0,1,0,1,0
55337,53,41001,53,allow,198,102,96,2,29,1,1
49104,443,34299,443,allow,7424,2381,5043,24,18,13,11
52405,445,0,0,drop,66,66,0,1,0,1,0
53093,443,27460,443,allow,6774,3651,3123,35,80,18,17
39118,443,64547,443,allow,206769,6309,200460,215,27,77,138
56131,53,29991,53,allow,245,94,151,2,30,1,1
64024,57825,29804,57825,allow,312,132,180,6,6,3,3
45439,443,28530,443,allow,24785,17234,7551,68,421,36,32
50150,80,7592,80,allow,73454,5461,67993,74,79,22,52
59692,57470,0,0,deny,78,78,0,1,0,1,0
50327,80,7970,80,allow,366,180,186,7,47,4,3
21424,53,21424,53,allow,225,90,135,2,29,1,1
11821,64147,0,0,deny,146,146,0,1,0,1,0
62009,445,0,0,drop,70,70,0,1,0,1,0
59201,51221,0,0,deny,66,66,0,1,0,1,0
40488,443,48919,443,allow,3635,2114,1521,22,515,13,9
56620,445,0,0,drop,70,70,0,1,0,1,0
65424,53,39053,53,allow,210,110,100,2,31,1,1
55808,53,41787,53,allow,183,94,89,2,30,1,1
19361,37965,0,0,deny,66,66,0,1,0,1,0
55638,53,61828,53,allow,184,86,98,2,30,1,1
60610,58414,0,0,deny,62,62,0,1,0,1,0
60141,30188,0,0,deny,66,66,0,1,0,1,0
65115,53,32763,53,allow,167,86,81,2,30,1,1
43791,443,3031,443,allow,6933,1677,5256,22,305,12,10
56453,37965,0,0,deny,66,66,0,1,0,1,0
54021,25174,0,0,deny,62,62,0,1,0,1,0
52447,43890,0,0,deny,66,66,0,1,0,1,0
49715,53,2852,53,allow,734,94,640,2,30,1,1
64780,53,50803,53,allow,193,102,91,2,29,1,1
56962,53,40705,53,allow,177,94,83,2,31,1,1
60163,26467,0,0,deny,66,66,0,1,0,1,0
4438,23,0,0,deny,60,60,0,1,0,1,0
20961,35440,0,0,deny,62,62,0,1,0,1,0
60874,443,51364,443,allow,1706,169,1537,6,121,3,3
53749,445,0,0,drop,66,66,0,1,0,1,0
53905,50130,9021,50130,allow,552,306,246,9,16,5,4
56476,80,31067,80,allow,5342,1304,4038,14,134,8,6
55705,53,9254,53,allow,281,101,180,4,58,2,2
63994,53,4398,53,allow,225,110,115,2,30,1,1
56837,53,12687,53,allow,180,94,86,2,30,1,1
64735,53,3296,53,allow,730,102,628,2,30,1,1
42732,57470,0,0,deny,62,62,0,1,0,1,0
53840,443,34687,443,allow,499,425,74,4,0,3,1
65274,53,29709,53,allow,295,101,194,4,31,2,2
64041,53,11407,53,allow,200,102,98,2,31,1,1
515,10214,0,0,deny,66,66,0,1,0,1,0
0,0,0,0,deny,70,70,0,1,0,1,0
49701,80,63516,80,allow,70321,956,69365,62,52,11,51
47020,2323,0,0,deny,60,60,0,1,0,1,0
50949,45960,0,0,deny,62,62,0,1,0,1,0
56437,53,9819,53,allow,749,94,655,2,30,1,1
59107,25174,0,0,deny,66,66,0,1,0,1,0
49300,443,11326,443,allow,10704,4094,6610,52,47,29,23
52076,44847,0,0,deny,66,66,0,1,0,1,0
59861,445,0,0,drop,70,70,0,1,0,1,0
64578,53,53350,53,allow,186,95,91,2,31,1,1
7003,53,7003,53,allow,229,90,139,2,30,1,1
46641,8100,2386,8100,allow,78,78,0,1,4,1,0
53661,443,31154,443,allow,8267,1779,6488,23,150,13,10
52003,443,46194,443,allow,18400,6207,12193,60,212,32,28
2850,64147,0,0,deny,62,62,0,1,0,1,0
49402,53,62978,53,allow,214,110,104,2,30,1,1
49885,53,17170,53,allow,760,97,663,2,31,1,1
64999,53,33322,53,allow,178,94,84,2,29,1,1
52077,445,0,0,drop,70,70,0,1,0,1,0
52116,64692,3805,64692,allow,70,70,0,1,5,1,0
56527,53,0,0,allow,206,83,123,2,31,1,1
9021,53,9021,53,allow,216,90,126,2,30,1,1
32997,50584,0,0,deny,62,62,0,1,0,1,0
57331,443,8045,443,allow,7468,2225,5243,27,16,15,12
55736,445,0,0,drop,66,66,0,1,0,1,0
27005,28315,51531,28315,allow,875,126,749,2,30,1,1
17232,22114,0,0,deny,62,62,0,1,0,1,0
50584,53,19282,53,allow,738,86,652,2,30,1,1
61425,443,50113,443,allow,9380,3315,6065,26,93,14,12
54782,443,13415,443,allow,9487,2103,7384,32,24,16,16
51414,22,0,0,deny,60,60,0,1,0,1,0
64781,53,27529,53,allow,209,102,107,2,30,1,1
50279,445,0,0,drop,66,66,0,1,0,1,0
60230,445,0,0,drop,70,70,0,1,0,1,0
56674,80,12315,80,allow,156,156,0,3,8,3,0
53835,7000,53835,7000,allow,2099,676,1423,13,15,7,6
37095,443,45405,443,allow,1835,1190,645,17,26,10,7
49777,445,0,0,drop,70,70,0,1,0,1,0
43332,81,0,0,deny,60,60,0,1,0,1,0
50633,445,0,0,drop,70,70,0,1,0,1,0
55541,53,64093,53,allow,177,94,83,2,30,1,1
56176,53,54476,53,allow,177,94,83,2,30,1,1
26330,26348,0,0,deny,62,62,0,1,0,1,0
61457,445,0,0,drop,70,70,0,1,0,1,0
28973,30188,0,0,deny,66,66,0,1,0,1,0
50577,80,17204,80,allow,2350,896,1454,13,25,7,6
49277,53,14856,53,allow,230,102,128,2,30,1,1
40571,26467,0,0,deny,62,62,0,1,0,1,0
123,123,35980,123,allow,184,94,90,2,30,1,1
15018,37965,0,0,deny,62,62,0,1,0,1,0
52050,443,62804,443,allow,9896,3586,6310,27,134,13,14
17947,36237,0,0,deny,62,62,0,1,0,1,0
47640,443,10100,443,allow,1058,571,487,10,38,6,4
58638,5900,0,0,deny,62,62,0,1,0,1,0
65528,53,30567,53,allow,168,86,82,2,31,1,1
48345,443,50795,443,allow,940826,59470,881356,1101,190,412,689
49242,443,26105,443,allow,4528,803,3725,14,15,8,6
16693,36237,0,0,deny,66,66,0,1,0,1,0
12545,43890,0,0,deny,146,146,0,1,0,1,0
59077,445,0,0,drop,66,66,0,1,0,1,0
50549,43890,0,0,deny,66,66,0,1,0,1,0
56735,443,32808,443,allow,7942,1953,5989,20,15,11,9
57338,443,27463,443,allow,8126,1887,6239,32,732,17,15
7068,53,7068,53,allow,197,90,107,2,30,1,1
58972,57866,0,0,deny,66,66,0,1,0,1,0
55265,53,47317,53,allow,198,101,97,2,31,1,1
49906,443,34595,443,allow,159116,5586,153530,191,47,77,114
54201,443,42354,443,allow,6500,1064,5436,22,255,12,10
62112,443,29747,443,allow,505589,13504,492085,462,345,91,371
58627,64097,0,0,deny,66,66,0,1,0,1,0
43129,15503,0,0,deny,62,62,0,1,0,1,0
41914,123,34175,123,allow,184,94,90,2,30,1,1
54028,443,7656,443,allow,11123,4258,6865,48,197,27,21
56013,443,56013,443,allow,4599,1692,2907,19,26,11,8
49616,445,0,0,drop,70,70,0,1,0,1,0
57013,80,33223,80,allow,526,304,222,8,30,5,3
64725,445,0,0,drop,70,70,0,1,0,1,0
55174,53,1640,53,allow,774,101,673,2,0,1,1
56160,53,39836,53,allow,195,102,93,2,30,1,1
49534,445,0,0,drop,70,70,0,1,0,1,0
54939,443,24418,443,allow,13018,3066,9952,65,361,33,32
26940,53,26940,53,allow,197,90,107,2,30,1,1
49156,53,13189,53,allow,199,94,105,2,29,1,1
60436,56687,61011,56687,allow,564,318,246,9,16,5,4
50172,443,42288,443,allow,152228,30166,122062,215,153,92,123
36790,80,59682,80,allow,191737,8302,183435,205,31,79,126
52411,443,20618,443,allow,9428,3770,5658,54,24,28,26
55462,53,6708,53,allow,194,102,92,2,30,1,1
44250,443,49251,443,allow,3374,2106,1268,19,15,10,9
51607,53,31322,53,allow,296,94,202,2,30,1,1
53238,443,61389,443,allow,13597,1371,12226,26,323,11,15
49724,443,21055,443,allow,4139,511,3628,12,15,6,6
59486,445,0,0,drop,66,66,0,1,0,1,0
59405,445,0,0,drop,66,66,0,1,0,1,0
64322,53,46348,53,allow,273,90,183,4,32,2,2
63749,13219,47890,13219,allow,504,382,122,8,15,6,2
50136,443,32292,443,allow,23193,8487,14706,57,55,28,29
50080,443,5025,443,allow,15595,3264,12331,26,35,14,12
65515,53,3298,53,allow,210,110,100,2,30,1,1
59168,39004,0,0,deny,62,62,0,1,0,1,0
2427,25174,0,0,deny,62,62,0,1,0,1,0
56464,443,4268,443,allow,5058,913,4145,17,25,10,7
58760,445,0,0,drop,66,66,0,1,0,1,0
57588,443,16925,443,allow,9109,2044,7065,25,22,14,11
35785,80,12900,80,allow,1594,1280,314,10,15,5,5
53118,56839,5832,56839,allow,70,70,0,2,8,2,0
53580,48066,12026,48066,allow,70,70,0,1,5,1,0
27005,27015,45197,27015,allow,881,126,755,2,30,1,1
57218,53,55252,53,allow,789,110,679,2,31,1,1
50500,443,60385,443,allow,12556,1134,11422,28,78,13,15
55726,32463,19971,32463,allow,70,70,0,1,5,1,0
64073,53,53984,53,allow,304,101,203,4,37,2,2
49274,445,0,0,drop,70,70,0,1,0,1,0
57919,443,32808,443,allow,21293,7315,13978,85,188,37,48
17781,50265,0,0,deny,62,62,0,1,0,1,0
46964,80,54750,80,allow,1687,951,736,10,93,6,4
59405,443,60870,443,allow,9052,2120,6932,28,23,14,14
57470,64919,63117,64919,allow,594,594,0,10,1199,10,0
56602,53,21237,53,allow,197,102,95,2,30,1,1
65433,445,0,0,drop,66,66,0,1,0,1,0
64340,445,0,0,drop,66,66,0,1,0,1,0
43176,53,34266,53,allow,168,78,90,2,30,1,1
58734,445,0,0,drop,70,70,0,1,0,1,0
49751,80,48363,80,allow,1876,998,878,12,15,7,5
65436,53,49533,53,allow,286,90,196,4,55,2,2
45144,25174,0,0,deny,146,146,0,1,0,1,0
65355,53,22974,53,allow,321,102,219,2,30,1,1
51617,15000,54264,15000,allow,130,70,60,2,5,1,1
58048,80,12048,80,allow,5171,3018,2153,16,30,8,8
60927,445,0,0,drop,70,70,0,1,0,1,0
56857,53,28297,53,allow,195,102,93,2,30,1,1
60805,445,0,0,drop,66,66,0,1,0,1,0
25565,18855,0,0,deny,60,60,0,1,0,1,0
61736,50584,0,0,deny,66,66,0,1,0,1,0
55233,53,15536,53,allow,215,102,113,2,30,1,1
49686,80,54142,80,allow,2611,1811,800,13,15,7,6
56732,53,32710,53,allow,701,88,613,2,30,1,1
42022,80,12678,80,allow,31196,607,30589,29,500,5,24
21419,23,0,0,deny,60,60,0,1,0,1,0
54450,445,0,0,drop,70,70,0,1,0,1,0
63139,53,20764,53,allow,234,234,0,4,47,4,0
56646,48817,0,0,deny,62,62,0,1,0,1,0
40175,80,8302,80,allow,130,70,60,2,15,1,1
42025,443,50486,443,allow,70,70,0,1,5,1,0
62768,443,53717,443,allow,30902,6307,24595,86,269,36,50
53069,443,18651,443,allow,13074,8472,4602,31,135,16,15
38693,443,23499,443,allow,16959,8920,8039,46,33,24,22
50040,445,0,0,drop,70,70,0,1,0,1,0
53677,445,0,0,drop,66,66,0,1,0,1,0
60996,443,58632,443,allow,6043,1568,4475,11,120,4,7
60324,445,0,0,drop,70,70,0,1,0,1,0
64907,53,16767,53,allow,211,102,109,2,30,1,1
58371,445,0,0,drop,66,66,0,1,0,1,0
55968,53,21608,53,allow,243,94,149,2,30,1,1
51973,80,57539,80,allow,426,240,186,8,26,5,3
49317,53,7671,53,allow,657,187,470,6,72,3,3
55826,53,22161,53,allow,168,86,82,2,30,1,1
50784,52952,0,0,deny,66,66,0,1,0,1,0
64074,53,3754,53,allow,202,103,99,2,31,1,1
52070,445,0,0,drop,66,66,0,1,0,1,0
55877,54210,39473,54210,allow,490,149,341,2,1200,1,1
53902,55298,4313,55298,allow,70,70,0,2,8,2,0
39175,80,7841,80,allow,1712,1324,388,11,16,5,6
55669,53,24694,53,allow,195,94,101,2,30,1,1
60438,53,27899,53,allow,154,154,0,3,46,3,0
65055,445,0,0,drop,70,70,0,1,0,1,0
49903,445,0,0,drop,70,70,0,1,0,1,0
56907,53,55203,53,allow,193,102,91,2,30,1,1
3399,25174,0,0,deny,66,66,0,1,0,1,0
5588,5588,0,0,allow,3498,1872,1626,48,200,24,24
55762,53,54612,53,allow,184,102,82,2,29,1,1
54452,443,13624,443,allow,4227,1086,3141,15,28,8,7
39154,80,25294,80,allow,1504,926,578,15,36,9,6
50222,42873,0,0,deny,66,66,0,1,0,1,0
55893,45711,0,0,deny,78,78,0,1,0,1,0
50438,53,48155,53,allow,295,101,194,4,31,2,2
55254,53,52828,53,allow,287,102,185,2,30,1,1
56938,53,41054,53,allow,198,101,97,2,30,1,1
60707,80,12418,80,allow,144,78,66,2,5,1,1
51462,3027,51462,3027,allow,156,156,0,3,8,3,0
58638,5900,0,0,deny,62,62,0,1,0,1,0
52273,445,0,0,drop,66,66,0,1,0,1,0
57340,53,43547,53,allow,370,94,276,2,30,1,1
34273,36829,0,0,deny,146,146,0,1,0,1,0
58638,5900,0,0,deny,62,62,0,1,0,1,0
53770,64147,0,0,deny,66,66,0,1,0,1,0
65261,53,13380,53,allow,168,86,82,2,30,1,1
55072,445,0,0,drop,70,70,0,1,0,1,0
49849,53,14013,53,allow,192,98,94,2,31,1,1
53796,48019,63153,48019,allow,70,70,0,1,5,1,0
64356,445,0,0,drop,70,70,0,1,0,1,0
56306,53,41144,53,allow,228,94,134,2,30,1,1
56862,80,27370,80,allow,2058,589,1469,10,45,6,4
50250,53,63565,53,allow,178,94,84,2,31,1,1
49721,443,34964,443,allow,65732,3951,61781,102,65,40,62
35087,443,32747,443,allow,6053,3586,2467,17,135,8,9
38645,51221,0,0,deny,62,62,0,1,0,1,0
49180,53,27807,53,allow,359,118,241,2,30,1,1
60962,64147,0,0,deny,66,66,0,1,0,1,0
52738,445,0,0,drop,70,70,0,1,0,1,0
61764,445,0,0,drop,70,70,0,1,0,1,0
61046,443,61046,443,allow,5830,2583,3247,22,40,13,9
51004,53,15547,53,allow,194,94,100,2,30,1,1
38914,443,38914,443,allow,4644,1737,2907,19,28,11,8
57470,50321,43161,50321,allow,9414,7249,2165,91,3838,76,15
52321,26467,0,0,deny,62,62,0,1,0,1,0
59920,445,0,0,drop,70,70,0,1,0,1,0
13973,50584,0,0,deny,146,146,0,1,0,1,0
58636,445,0,0,drop,70,70,0,1,0,1,0
58638,5900,0,0,deny,62,62,0,1,0,1,0
58853,445,0,0,drop,70,70,0,1,0,1,0
63030,445,0,0,drop,66,66,0,1,0,1,0
59966,37965,0,0,deny,66,66,0,1,0,1,0
5588,5588,0,0,allow,3354,1792,1562,46,194,23,23
54742,37965,0,0,deny,66,66,0,1,0,1,0
27005,1102,43095,1102,allow,867,126,741,2,30,1,1
60271,443,5474,443,allow,10324,8406,1918,44,87,26,18
43916,21,0,0,deny,60,60,0,1,0,1,0
51658,445,0,0,drop,70,70,0,1,0,1,0
40290,22,40290,22,allow,66,66,0,1,5,1,0
55976,445,0,0,drop,70,70,0,1,0,1,0
61549,445,0,0,drop,66,66,0,1,0,1,0
10011,443,63236,443,allow,14565,3464,11101,59,151,31,28
57470,6881,12266,6881,allow,453,251,202,4,1199,2,2
1025,35447,0,0,deny,62,62,0,1,0,1,0
50584,60395,46252,60395,allow,166,166,0,1,1200,1,0
60423,35440,0,0,deny,62,62,0,1,0,1,0
53166,39564,63800,39564,allow,70,70,0,1,5,1,0
56654,53,47578,53,allow,102,102,0,1,30,1,0
65370,53,60115,53,allow,186,95,91,2,31,1,1
63930,44330,64385,44330,allow,66,66,0,2,7,2,0
56152,53,5986,53,allow,195,102,93,2,31,1,1
36776,443,7923,443,allow,2866,1674,1192,14,15,8,6
58638,5900,0,0,deny,62,62,0,1,0,1,0
65207,445,0,0,drop,66,66,0,1,0,1,0
54100,37965,0,0,deny,62,62,0,1,0,1,0
57470,6881,5972,6881,allow,755,275,480,4,1200,2,2
1035,26467,0,0,deny,62,62,0,1,0,1,0
51240,443,5101,443,allow,9668,4688,4980,42,16,25,17
62673,34159,0,0,deny,66,66,0,1,0,1,0
48798,443,34647,443,allow,55560,11338,44222,90,23,41,49
37555,16384,61049,16384,allow,130,70,60,2,30,1,1
61645,445,0,0,drop,66,66,0,1,0,1,0
58638,5900,0,0,deny,62,62,0,1,0,1,0
57564,56205,0,0,deny,66,66,0,1,0,1,0
49953,53,46343,53,allow,214,110,104,2,30,1,1
57271,53,1300,53,allow,228,102,126,2,30,1,1
26900,27017,64029,27017,allow,422,164,258,6,30,3,3
64560,53,23612,53,allow,802,104,698,2,30,1,1
49484,53,47845,53,allow,742,88,654,2,31,1,1
43457,31573,0,0,deny,146,146,0,1,0,1,0
64771,53,10938,53,allow,228,110,118,2,30,1,1
54941,80,51171,80,allow,2513,567,1946,10,75,6,4
55389,445,0,0,drop,70,70,0,1,0,1,0
60776,445,0,0,drop,70,70,0,1,0,1,0
65152,53,13700,53,allow,177,94,83,2,30,1,1
52867,443,11328,443,allow,15730,2196,13534,32,436,17,15
58550,445,0,0,drop,66,66,0,1,0,1,0
59048,57470,0,0,deny,66,66,0,1,0,1,0
53147,37965,0,0,deny,62,62,0,1,0,1,0
55610,53,9648,53,allow,265,91,174,4,36,2,2
1956,53,1956,53,allow,240,98,142,2,30,1,1
43576,80,43576,80,allow,44566,6675,37891,58,23,27,31
37011,25174,0,0,deny,62,62,0,1,0,1,0
1081,64910,0,0,deny,146,146,0,1,0,1,0
50535,80,30581,80,allow,62768,25796,36972,75,34,33,42
64896,53,10637,53,allow,716,95,621,2,31,1,1
30782,36237,0,0,deny,62,62,0,1,0,1,0
65187,27126,30981,27126,allow,268,78,190,2,30,1,1
49234,53,59585,53,allow,177,94,83,2,30,1,1
56888,443,59232,443,allow,10384,2236,8148,28,186,15,13
64958,53,14759,53,allow,197,102,95,2,30,1,1
57470,58210,46855,58210,allow,2118,858,1260,28,1261,14,14
57406,53,8433,53,allow,194,102,92,2,31,1,1
56330,53,48273,53,allow,199,102,97,2,30,1,1
41151,443,41151,443,allow,4713,1806,2907,19,30,11,8
5637,37965,0,0,deny,62,62,0,1,0,1,0
53608,39004,0,0,deny,66,66,0,1,0,1,0
55353,53,65240,53,allow,168,86,82,2,30,1,1
58638,5900,0,0,deny,62,62,0,1,0,1,0
55516,445,0,0,drop,70,70,0,1,0,1,0
39060,443,26337,443,allow,8554,2353,6201,29,138,14,15
37675,53,37675,53,allow,197,90,107,2,30,1,1
42578,443,22827,443,allow,68806,2442,66364,71,215,19,52
40510,1488,40510,1488,allow,156,156,0,3,7,3,0
46831,53,55820,53,allow,391,102,289,2,30,1,1
50807,445,0,0,drop,70,70,0,1,0,1,0
50584,50545,46451,50545,allow,166,166,0,1,1199,1,0
53350,80,3605,80,allow,1712,913,799,12,273,7,5
56771,53,26482,53,allow,166,86,80,2,30,1,1
55688,443,55688,443,allow,115875,6637,109238,158,80,71,87
52891,445,0,0,drop,70,70,0,1,0,1,0
1036,64147,0,0,deny,145,145,0,1,0,1,0
55713,445,0,0,drop,70,70,0,1,0,1,0
54051,53,54051,53,allow,617,67,550,2,30,1,1
36471,443,15597,443,allow,83203,3599,79604,101,138,41,60
56911,445,0,0,drop,70,70,0,1,0,1,0
64133,445,0,0,drop,70,70,0,1,0,1,0
54280,3398,0,0,deny,60,60,0,1,0,1,0
53749,53572,44841,53572,allow,492,306,186,8,15,5,3
5223,21557,0,0,deny,60,60,0,1,0,1,0
52044,445,0,0,drop,70,70,0,1,0,1,0
51522,445,0,0,drop,66,66,0,1,0,1,0
53196,443,1285,443,allow,4371,1115,3256,19,19,9,10
50682,80,30834,80,allow,5036,4332,704,11,25,6,5
49267,443,42451,443,allow,19851,15702,4149,63,109,34,29
55829,53,51099,53,allow,177,94,83,2,30,1,1
56407,53,58288,53,allow,216,102,114,2,29,1,1
63895,43729,7105,43729,allow,70,70,0,1,4,1,0
64066,23718,0,0,deny,66,66,0,1,0,1,0
60400,445,0,0,drop,70,70,0,1,0,1,0
64282,445,0,0,drop,70,70,0,1,0,1,0
49695,53,29724,53,allow,240,102,138,2,30,1,1
61355,445,0,0,drop,66,66,0,1,0,1,0
51923,445,0,0,drop,70,70,0,1,0,1,0
57470,58753,38248,58753,allow,166,166,0,1,1199,1,0
58785,443,24870,443,allow,11873,7787,4086,32,16,17,15
39086,53733,0,0,deny,146,146,0,1,0,1,0
58960,445,0,0,drop,70,70,0,1,0,1,0
65463,53,23022,53,allow,177,94,83,2,30,1,1
62944,445,0,0,drop,70,70,0,1,0,1,0
37513,443,37513,443,allow,4347,1440,2907,19,30,11,8
46899,443,58934,443,allow,9085,2222,6863,39,125,19,20
49480,53,49480,53,allow,213,79,134,2,32,1,1
52883,53,22567,53,allow,339,94,245,2,30,1,1
56662,443,60423,443,allow,1233,730,503,12,25,7,5
58022,1471,0,0,deny,60,60,0,1,0,1,0
54596,443,49824,443,allow,4510,2210,2300,14,136,7,7
63030,2222,0,0,deny,66,66,0,1,0,1,0
53881,445,0,0,drop,66,66,0,1,0,1,0
58906,443,27261,443,allow,2896,1492,1404,17,17,9,8
44679,80,35749,80,allow,3180,2317,863,12,11,7,5
51807,10920,47874,10920,allow,70,70,0,2,8,2,0
63831,31539,8065,31539,allow,312,132,180,6,7,3,3
50224,445,0,0,drop,70,70,0,1,0,1,0
52428,80,60172,80,allow,2516,1929,587,15,16,9,6
65439,53,54009,53,allow,168,86,82,2,30,1,1
49386,443,47173,443,allow,6250,1765,4485,22,15,12,10
16012,53,16012,53,allow,235,90,145,2,32,1,1
49449,53,11737,53,allow,216,110,106,2,30,1,1
51833,445,0,0,drop,70,70,0,1,0,1,0
37965,35771,32766,35771,allow,481,150,331,2,1199,1,1
55271,53,11910,53,allow,754,94,660,2,30,1,1
49162,53,33354,53,allow,183,94,89,2,30,1,1
26742,53,26742,53,allow,237,91,146,2,33,1,1
57470,6889,19938,6889,allow,546,166,380,2,1200,1,1
65132,53,27212,53,allow,167,86,81,2,30,1,1
51964,443,28760,443,allow,54794,16744,38050,82,71,42,40
49160,9703,22798,9703,allow,842,150,692,4,1200,2,2
49426,57470,0,0,deny,62,62,0,1,0,1,0
64053,53,7121,53,allow,186,95,91,2,31,1,1
50463,80,50463,80,allow,210639,12949,197690,287,23,147,140
8560,50584,0,0,deny,66,66,0,1,0,1,0
58875,443,10382,443,allow,5168,700,4468,16,15,7,9
443,43775,0,0,deny,97,97,0,1,0,1,0
50594,25174,0,0,deny,66,66,0,1,0,1,0
59117,443,59117,443,allow,4659,1752,2907,19,30,11,8
63856,6881,31846,6881,allow,66,66,0,1,5,1,0
43361,443,8514,443,allow,13275,10536,2739,50,101,27,23
64624,53,46919,53,allow,228,94,134,2,30,1,1
63866,17623,15201,17623,allow,66,66,0,1,5,1,0
61688,443,16509,443,allow,14462,3625,10837,31,63,16,15
55321,443,9589,443,allow,9462,2297,7165,23,15,13,10
64739,53,35789,53,allow,164,86,78,2,31,1,1
50022,53,51786,53,allow,179,94,85,2,30,1,1
64748,445,0,0,drop,66,66,0,1,0,1,0
63811,445,0,0,drop,66,66,0,1,0,1,0
58610,445,0,0,drop,70,70,0,1,0,1,0
23353,25174,0,0,deny,146,146,0,1,0,1,0
55459,50584,0,0,deny,62,62,0,1,0,1,0
57375,53,58111,53,allow,247,102,145,2,30,1,1
63730,445,0,0,drop,70,70,0,1,0,1,0
49753,80,62550,80,allow,32910,18450,14460,143,1647,75,68
52091,4789,61902,4789,allow,70,70,0,1,5,1,0
60959,443,46440,443,allow,17149,2543,14606,40,46,22,18
56602,80,9300,80,allow,234,234,0,4,11,4,0
49420,53,26234,53,allow,364,102,262,2,30,1,1
56694,443,2147,443,allow,3723,2372,1351,18,18,10,8
27005,27015,27381,27015,allow,887,126,761,2,30,1,1
58638,5900,0,0,deny,62,62,0,1,0,1,0
50848,445,0,0,drop,66,66,0,1,0,1,0
52105,1024,64532,1024,allow,70,70,0,1,4,1,0
64530,53,18888,53,allow,261,87,174,4,45,2,2
7288,25174,0,0,deny,62,62,0,1,0,1,0
56609,3389,56609,3389,allow,3327,1438,1889,15,16,8,7
49840,443,9507,443,allow,58656,12994,45662,148,71,64,84
44395,443,50721,443,allow,18921,10848,8073,49,401,20,29
60904,445,0,0,drop,66,66,0,1,0,1,0
50887,80,30027,80,allow,256649,11414,245235,280,141,111,169
37556,16385,7205,16385,allow,432,192,240,8,30,4,4
56947,443,19771,443,allow,5601,1203,4398,14,60,9,5
7308,50584,0,0,deny,62,62,0,1,0,1,0
57470,6885,1463,6885,allow,616,414,202,5,1200,3,2
57165,34101,0,0,deny,66,66,0,1,0,1,0
65436,53,35308,53,allow,332,98,234,3,58,2,1
64839,53,42360,53,allow,212,110,102,2,30,1,1
32395,30188,0,0,deny,62,62,0,1,0,1,0
9329,2323,0,0,deny,60,60,0,1,0,1,0
50355,445,0,0,drop,70,70,0,1,0,1,0
65268,445,0,0,drop,66,66,0,1,0,1,0
56127,37965,0,0,deny,66,66,0,1,0,1,0
65245,53,50630,53,allow,193,102,91,2,30,1,1
55790,53,27986,53,allow,177,94,83,2,30,1,1
64898,53,64087,53,allow,487,201,286,6,39,3,3
50584,61467,32483,61467,allow,1377,300,1077,6,1200,3,3
65040,53,64754,53,allow,749,94,655,2,30,1,1
53279,443,22916,443,allow,36459,6736,29723,54,29,24,30
63436,445,0,0,drop,66,66,0,1,0,1,0
51946,443,31314,443,allow,2666,1542,1124,17,17,9,8
53608,39004,0,0,deny,66,66,0,1,0,1,0
26351,22114,0,0,deny,62,62,0,1,0,1,0
53710,443,55386,443,allow,499,425,74,4,0,3,1
57700,53,0,0,allow,300,90,210,2,30,1,1
52129,55550,12680,55550,allow,70,70,0,2,8,2,0
37984,443,32167,443,allow,3149,1829,1320,22,315,12,10
52788,443,21903,443,allow,1550,834,716,19,141,10,9
54440,26467,0,0,deny,62,62,0,1,0,1,0
3521,6881,0,0,deny,66,66,0,1,0,1,0
56310,53,55159,53,allow,760,97,663,2,31,1,1
57117,443,28755,443,allow,8997,1155,7842,19,76,11,8
56806,443,15010,443,allow,8072,2052,6020,20,15,11,9
65046,53,1859,53,allow,211,94,117,2,31,1,1
51289,445,0,0,drop,70,70,0,1,0,1,0
38503,25,0,0,deny,60,60,0,1,0,1,0
55605,445,0,0,drop,70,70,0,1,0,1,0
55109,53,12323,53,allow,711,87,624,2,30,1,1
40193,443,57432,443,allow,1462,735,727,15,185,8,7
64986,53,30082,53,allow,180,94,86,2,30,1,1
27005,1101,40896,1101,allow,902,126,776,2,30,1,1
56050,53,44342,53,allow,178,94,84,2,30,1,1
22029,50584,0,0,deny,66,66,0,1,0,1,0
61417,445,0,0,drop,70,70,0,1,0,1,0
55232,53,12562,53,allow,177,94,83,2,29,1,1
65463,53,27388,53,allow,210,102,108,2,30,1,1
51575,9694,0,0,deny,62,62,0,1,0,1,0
55106,53,52896,53,allow,184,94,90,2,31,1,1
52105,80,43976,80,allow,422,240,182,8,26,5,3
50919,445,0,0,drop,66,66,0,1,0,1,0
63584,443,24147,443,allow,3182,1568,1614,8,120,4,4
25363,22114,0,0,deny,66,66,0,1,0,1,0
64585,443,46353,443,allow,24686,1935,22751,36,18,17,19
2531,30188,0,0,deny,66,66,0,1,0,1,0
53950,445,0,0,drop,70,70,0,1,0,1,0
50436,443,10408,443,allow,18959,3307,15652,33,19,16,17
25009,35440,0,0,deny,62,62,0,1,0,1,0
6881,6881,26370,6881,allow,502,150,352,2,1200,1,1
56334,53,41390,53,allow,767,102,665,2,31,1,1
54746,445,0,0,drop,70,70,0,1,0,1,0
55913,53,2700,53,allow,177,94,83,2,30,1,1
53697,6224,22057,6224,allow,70,70,0,1,4,1,0
13840,37965,0,0,deny,146,146,0,1,0,1,0
58131,445,0,0,drop,70,70,0,1,0,1,0
53597,53,0,0,allow,233,85,148,2,30,1,1
60079,80,9698,80,allow,31418,1784,29634,37,126,14,23
62109,44847,0,0,deny,62,62,0,1,0,1,0
52163,14181,24095,14181,allow,70,70,0,2,8,2,0
53075,53,27228,53,allow,168,78,90,2,30,1,1
50940,445,0,0,drop,70,70,0,1,0,1,0
52330,445,0,0,drop,70,70,0,1,0,1,0
36839,80,35799,80,allow,10345,6823,3522,25,25,14,11
61376,443,37067,443,allow,31612,3374,28238,59,271,29,30
56667,53,25410,53,allow,250,86,164,4,29,2,2
53810,23,0,0,deny,60,60,0,1,0,1,0
50424,445,0,0,drop,66,66,0,1,0,1,0
22922,35440,0,0,deny,66,66,0,1,0,1,0
50312,80,15679,80,allow,17102,1099,16003,19,16,5,14
51876,443,3089,443,allow,1852,1103,749,16,32,9,7
3559,30188,0,0,deny,66,66,0,1,0,1,0
49808,443,22176,443,allow,1101,654,447,12,126,7,5
57253,53,58310,53,allow,199,102,97,2,30,1,1
57993,443,27022,443,allow,8647,1990,6657,23,26,14,9
60377,65054,58961,65054,allow,624,318,306,10,15,5,5
51120,80,28128,80,allow,366,240,126,7,21,5,2
50971,80,41640,80,allow,1094437,6233,1088204,817,36,92,725
56101,57470,0,0,deny,66,66,0,1,0,1,0
49839,53,21176,53,allow,315,102,213,2,30,1,1
65523,53,26977,53,allow,228,94,134,2,30,1,1
54136,80,22556,80,allow,25148,5233,19915,39,71,21,18
55745,53,9375,53,allow,199,102,97,2,29,1,1
65265,55067,0,0,deny,66,66,0,1,0,1,0
49442,53,40025,53,allow,198,94,104,2,31,1,1
57123,445,0,0,drop,70,70,0,1,0,1,0
55892,80,55892,80,allow,1917,1468,449,10,20,6,4
64369,445,0,0,drop,70,70,0,1,0,1,0
56521,53,59104,53,allow,310,126,184,2,30,1,1
52215,80,59875,80,allow,1009,506,503,10,16,5,5
8881,443,2247,443,allow,27459,19126,8333,67,402,30,37
56639,53,47791,53,allow,168,86,82,2,32,1,1
53769,8999,60336,8999,allow,70,70,0,1,5,1,0
57069,53,40804,53,allow,1335,87,1248,4,32,2,2
41321,443,40754,443,allow,6989232,188564,6800668,7110,288,2412,4698
55893,45711,0,0,deny,78,78,0,1,0,1,0
46263,7700,25323,7700,allow,1440,956,484,15,35,8,7
33289,50584,0,0,deny,146,146,0,1,0,1,0
55321,53,4307,53,allow,193,102,91,2,31,1,1
33534,443,30363,443,allow,4640,1416,3224,18,121,9,9
2636,11392,0,0,deny,62,62,0,1,0,1,0
41475,443,20491,443,allow,1251209,30056,1221153,1238,85,386,852
64420,445,0,0,drop,66,66,0,1,0,1,0
63959,53,54075,53,allow,246,102,144,2,31,1,1
55072,53,59629,53,allow,177,94,83,2,30,1,1
57669,443,51063,443,allow,12569,8228,4341,28,256,16,12
65127,443,50841,443,allow,48029,4540,43489,91,120,40,51
54964,443,18537,443,allow,24232,10141,14091,74,76,39,35
27005,27015,28770,27015,allow,879,126,753,2,29,1,1
60502,443,31971,443,allow,416,210,206,7,28,4,3
22547,48817,0,0,deny,72,72,0,1,0,1,0
58638,5900,0,0,deny,62,62,0,1,0,1,0
25463,53,62402,53,allow,827,91,736,4,29,2,2
60812,443,60812,443,allow,2871,1671,1200,17,179,9,8
53869,17089,38908,17089,allow,70,70,0,1,4,1,0
52126,80,5898,80,allow,3592,2098,1494,26,417,14,12
52980,445,0,0,drop,70,70,0,1,0,1,0
50707,80,44331,80,allow,16427,3830,12597,28,25,12,16
56588,443,28580,443,allow,10615,5909,4706,28,42,14,14
61130,445,0,0,drop,66,66,0,1,0,1,0
57142,53,22612,53,allow,165,86,79,2,31,1,1
45941,23386,0,0,deny,60,60,0,1,0,1,0
64605,445,0,0,drop,66,66,0,1,0,1,0
50015,443,26548,443,allow,59858,24345,35513,148,612,78,70
64823,53,49719,53,allow,754,94,660,2,30,1,1
62029,36237,0,0,deny,66,66,0,1,0,1,0
52439,35894,0,0,deny,70,70,0,1,0,1,0
36682,80,24588,80,allow,130,70,60,2,15,1,1
50939,443,38504,443,allow,8058,1136,6922,19,126,9,10
63689,445,0,0,drop,70,70,0,1,0,1,0
28897,35440,0,0,deny,66,66,0,1,0,1,0
51955,443,64636,443,allow,8390,1525,6865,24,26,11,13
49762,53,6291,53,allow,196,102,94,2,29,1,1
57771,445,0,0,drop,70,70,0,1,0,1,0
61085,37965,0,0,deny,62,62,0,1,0,1,0
30303,30303,0,0,deny,181,181,0,1,0,1,0
56710,80,31559,80,allow,30614,1926,28688,44,45,23,21
53461,445,0,0,drop,70,70,0,1,0,1,0
63517,445,0,0,drop,70,70,0,1,0,1,0
61642,445,0,0,drop,66,66,0,1,0,1,0
56249,445,0,0,drop,70,70,0,1,0,1,0
15701,37965,0,0,deny,146,146,0,1,0,1,0
46492,50584,0,0,deny,62,62,0,1,0,1,0
54377,56205,0,0,deny,62,62,0,1,0,1,0
60385,59696,6029,59696,allow,70,70,0,1,5,1,0
56601,445,0,0,drop,70,70,0,1,0,1,0
53259,443,6892,443,allow,5513,929,4584,20,360,10,10
52115,445,0,0,drop,70,70,0,1,0,1,0
58085,57470,0,0,deny,62,62,0,1,0,1,0
56717,53,51715,53,allow,172,88,84,2,31,1,1
36339,50584,0,0,deny,62,62,0,1,0,1,0
49364,80,47748,80,allow,2168,1031,1137,8,166,5,3
50033,445,0,0,drop,70,70,0,1,0,1,0
37902,23718,0,0,deny,146,146,0,1,0,1,0
45981,51505,0,0,deny,62,62,0,1,0,1,0
50179,443,33699,443,allow,5419,1080,4339,17,42,10,7
61081,445,0,0,drop,66,66,0,1,0,1,0
59124,443,18887,443,allow,9612,1720,7892,32,130,15,17
58638,5900,0,0,deny,62,62,0,1,0,1,0
50391,445,0,0,drop,66,66,0,1,0,1,0
55948,5223,3545,5223,allow,10038,5272,4766,36,196,20,16
65307,53,59322,53,allow,184,94,90,2,29,1,1
47643,80,39174,80,allow,3524,2698,826,14,16,8,6
64554,53,57103,53,allow,498,204,294,6,30,3,3
55900,445,0,0,drop,70,70,0,1,0,1,0
41547,80,41547,80,allow,120443,1965,118478,108,20,21,87
1734,80,1734,80,allow,318813,10418,308395,314,95,102,212
55816,53,3790,53,allow,214,110,104,2,31,1,1
58759,443,21160,443,allow,6012,873,5139,18,25,9,9
53618,1025,19237,1025,allow,320,140,180,6,7,3,3
34353,53,34353,53,allow,213,79,134,2,33,1,1
64376,443,64376,443,allow,4592,1685,2907,19,29,11,8
64095,443,63841,443,allow,9895,2094,7801,52,262,23,29
63589,44847,0,0,deny,66,66,0,1,0,1,0
58953,443,9937,443,allow,4051,2587,1464,18,16,9,9
42611,443,22505,443,allow,5559,1639,3920,21,186,12,9
9331,443,37171,443,allow,3616,429,3187,11,15,6,5
61362,443,23026,443,allow,7653,1226,6427,24,18,14,10
1536,50584,0,0,deny,146,146,0,1,0,1,0
58785,443,2616,443,allow,37165,2164,35001,58,29,28,30
48817,23456,48817,23456,allow,485,158,327,2,1200,1,1
63980,443,5737,443,allow,5237,2844,2393,14,135,7,7
61148,445,0,0,drop,66,66,0,1,0,1,0
56534,443,31456,443,allow,3055,993,2062,10,120,5,5
56793,53,43867,53,allow,196,102,94,2,30,1,1
60343,443,27332,443,allow,36547,3840,32707,88,241,43,45
56006,53,14148,53,allow,200,102,98,2,30,1,1
45726,64147,0,0,deny,62,62,0,1,0,1,0
55575,31948,50458,31948,allow,70,70,0,1,5,1,0
65111,53,60409,53,allow,198,94,104,2,29,1,1
56451,445,0,0,drop,66,66,0,1,0,1,0
53633,445,0,0,drop,70,70,0,1,0,1,0
54423,21247,0,0,deny,62,62,0,1,0,1,0
55907,445,0,0,drop,70,70,0,1,0,1,0
58638,5900,0,0,deny,62,62,0,1,0,1,0
54028,37965,0,0,deny,66,66,0,1,0,1,0
13508,15503,0,0,deny,66,66,0,1,0,1,0
60362,445,0,0,drop,70,70,0,1,0,1,0
52859,445,0,0,drop,70,70,0,1,0,1,0
57236,53733,0,0,deny,66,66,0,1,0,1,0
55858,445,0,0,drop,66,66,0,1,0,1,0
52020,80,52020,80,allow,6764,5555,1209,20,28,12,8
56661,443,32722,443,allow,8059,2039,6020,20,15,11,9
49958,80,11985,80,allow,11173,821,10352,19,15,9,10
26642,57470,0,0,deny,62,62,0,1,0,1,0
59838,443,12869,443,allow,5520,3416,2104,27,22,13,14
57986,445,0,0,drop,70,70,0,1,0,1,0
55610,53,39164,53,allow,199,102,97,2,30,1,1
53243,445,0,0,drop,66,66,0,1,0,1,0
65496,123,10878,123,allow,184,94,90,2,30,1,1
1027,25174,0,0,deny,62,62,0,1,0,1,0
50661,445,0,0,drop,70,70,0,1,0,1,0
64588,53,41773,53,allow,173,94,79,2,31,1,1
64017,53,52336,53,allow,209,110,99,2,30,1,1
52172,80,27126,80,allow,362,240,122,7,17,5,2
46002,53,40286,53,allow,168,78,90,2,30,1,1
47910,7454,0,0,deny,60,60,0,1,0,1,0
49714,80,42166,80,allow,2096,1011,1085,11,130,6,5
55015,443,30029,443,allow,8133,2402,5731,35,255,17,18
54371,80,58322,80,allow,3623,1718,1905,17,186,10,7
55690,445,0,0,drop,70,70,0,1,0,1,0
64040,12226,50739,12226,allow,70,70,0,1,4,1,0
3559,30188,0,0,deny,66,66,0,1,0,1,0
53676,35974,0,0,deny,60,60,0,1,0,1,0
61420,64097,0,0,deny,66,66,0,1,0,1,0
53543,445,0,0,drop,70,70,0,1,0,1,0
48287,443,53104,443,allow,416,210,206,7,96,4,3
51766,48169,32212,48169,allow,70,70,0,1,5,1,0
63855,25174,0,0,deny,62,62,0,1,0,1,0
56960,53,26282,53,allow,196,102,94,2,30,1,1
49767,53,47243,53,allow,185,102,83,2,30,1,1
49603,53,34411,53,allow,326,126,200,2,30,1,1
59802,53,61597,53,allow,168,78,90,2,30,1,1
39422,80,48610,80,allow,1057,683,374,10,15,6,4
58813,445,0,0,drop,66,66,0,1,0,1,0
41234,443,28858,443,allow,1741,1048,693,15,25,8,7
9119,80,62063,80,allow,8732,2438,6294,23,36,11,12
60438,53,64563,53,allow,78,78,0,1,30,1,0
50031,44847,0,0,deny,70,70,0,1,0,1,0
20371,35440,0,0,deny,62,62,0,1,0,1,0
55157,53,58441,53,allow,711,87,624,2,30,1,1
50425,443,34304,443,allow,5653,1079,4574,14,26,8,6
58850,53,58850,53,allow,231,90,141,2,29,1,1
60384,443,14731,443,allow,130,70,60,2,15,1,1
64787,53,4166,53,allow,174,89,85,2,31,1,1
43937,123,21193,123,allow,184,94,90,2,30,1,1
49946,80,45099,80,allow,31517,1203,30314,38,15,15,23
49507,443,13013,443,allow,4151,1015,3136,16,27,8,8
65133,53,56873,53,allow,196,100,96,2,31,1,1
56108,53,60144,53,allow,298,92,206,4,41,2,2
53554,8999,45352,8999,allow,130,70,60,2,5,1,1
53143,50584,0,0,deny,66,66,0,1,0,1,0
60875,50584,0,0,deny,66,66,0,1,0,1,0
64393,53,12221,53,allow,183,94,89,2,31,1,1
63178,445,0,0,drop,66,66,0,1,0,1,0
55184,53,63377,53,allow,183,94,89,2,30,1,1
55433,443,16673,443,allow,72759,18547,54212,120,137,49,71
51883,16325,58501,16325,allow,316,136,180,6,6,3,3
53481,445,0,0,drop,70,70,0,1,0,1,0
56246,53,33774,53,allow,209,110,99,2,30,1,1
62388,39004,0,0,deny,62,62,0,1,0,1,0
60646,11392,0,0,deny,66,66,0,1,0,1,0
60393,443,31011,443,allow,8049,1805,6244,23,81,12,11
51523,443,27460,443,allow,4045,765,3280,11,45,5,6
33684,443,39270,443,allow,6829,1261,5568,21,197,11,10
49375,445,0,0,drop,70,70,0,1,0,1,0
62687,445,0,0,drop,70,70,0,1,0,1,0
58630,445,0,0,drop,66,66,0,1,0,1,0
33640,53,0,0,allow,139,70,69,2,30,1,1
65164,53,35312,53,allow,262,94,168,2,30,1,1
50478,80,50478,80,allow,28032,3868,24164,47,24,23,24
54488,445,0,0,drop,70,70,0,1,0,1,0
60260,445,0,0,drop,66,66,0,1,0,1,0
12709,51505,0,0,deny,62,62,0,1,0,1,0
51134,445,0,0,drop,66,66,0,1,0,1,0
65189,53,20195,53,allow,176,90,86,2,31,1,1
49332,445,0,0,drop,66,66,0,1,0,1,0
54653,445,0,0,drop,66,66,0,1,0,1,0
50492,445,0,0,drop,70,70,0,1,0,1,0
60900,445,0,0,drop,66,66,0,1,0,1,0
57296,53,58059,53,allow,200,102,98,2,29,1,1
49229,53,47924,53,allow,183,94,89,2,30,1,1
56427,443,19838,443,allow,9901,1298,8603,19,79,10,9
51738,47483,28405,47483,allow,70,70,0,2,8,2,0
52263,16350,50284,16350,allow,70,70,0,2,8,2,0
60596,53,45720,53,allow,300,86,214,2,31,1,1
57576,445,0,0,drop,70,70,0,1,0,1,0
2432,11392,0,0,deny,62,62,0,1,0,1,0
48983,15000,51295,15000,allow,130,70,60,2,6,1,1
64756,11392,0,0,deny,62,62,0,1,0,1,0
50731,27029,22129,27029,allow,269,78,191,2,31,1,1
45099,123,62953,123,allow,184,94,90,2,30,1,1
50064,443,33198,443,allow,6376,2499,3877,20,16,10,10
52498,445,0,0,drop,66,66,0,1,0,1,0
55936,53,60791,53,allow,177,94,83,2,30,1,1
45042,48817,0,0,deny,109,109,0,1,0,1,0
60423,445,0,0,drop,70,70,0,1,0,1,0
62247,445,0,0,drop,70,70,0,1,0,1,0
55594,53,15652,53,allow,202,83,119,2,31,1,1
50838,53,8440,53,allow,70,70,0,1,30,1,0
64595,53,56793,53,allow,182,93,89,2,30,1,1
49001,65473,0,0,deny,174,174,0,1,0,1,0
33359,30188,0,0,deny,66,66,0,1,0,1,0
50940,443,27136,443,allow,29500,27698,1802,51,17,29,22
64452,53,37833,53,allow,322,102,220,2,29,1,1
36241,443,45879,443,allow,7768,3776,3992,21,132,11,10
6437,53,6437,53,allow,229,90,139,2,30,1,1
58497,445,0,0,drop,70,70,0,1,0,1,0
41460,443,23165,443,allow,13890,5926,7964,36,84,20,16
58192,443,58192,443,allow,4381,1474,2907,19,29,11,8
65498,53,39980,53,allow,209,110,99,2,30,1,1
56157,50584,0,0,deny,66,66,0,1,0,1,0
51835,29778,4690,29778,allow,70,70,0,2,7,2,0
16948,990,0,0,deny,60,60,0,1,0,1,0
63745,445,0,0,drop,66,66,0,1,0,1,0
50822,50584,0,0,deny,66,66,0,1,0,1,0
58486,57470,0,0,deny,66,66,0,1,0,1,0
53844,22114,0,0,deny,66,66,0,1,0,1,0
52735,443,43904,443,allow,41870,3567,38303,68,15,34,34
54928,8245,11083,8245,allow,280,214,66,2,30,1,1
55670,31056,18384,31056,allow,70,70,0,2,8,2,0
65234,53,64779,53,allow,186,95,91,2,31,1,1
10151,6881,1638,6881,allow,460,150,310,2,1200,1,1
63782,6969,48433,6969,allow,70,70,0,1,5,1,0
28317,35776,0,0,deny,146,146,0,1,0,1,0
45941,23386,0,0,deny,60,60,0,1,0,1,0
53211,22114,0,0,deny,66,66,0,1,0,1,0
57601,445,0,0,drop,70,70,0,1,0,1,0
49395,53,40831,53,allow,390,111,279,4,53,2,2
11585,56205,0,0,deny,66,66,0,1,0,1,0
49886,445,0,0,drop,70,70,0,1,0,1,0
60625,445,0,0,drop,70,70,0,1,0,1,0
64524,445,0,0,drop,70,70,0,1,0,1,0
15854,50584,0,0,deny,62,62,0,1,0,1,0
58638,5900,0,0,deny,62,62,0,1,0,1,0
55655,53,48004,53,allow,304,110,194,4,35,2,2
55771,53,21538,53,allow,283,98,185,4,52,2,2
49518,53,34385,53,allow,299,90,209,4,49,2,2
57555,35440,0,0,deny,66,66,0,1,0,1,0
443,47582,0,0,deny,100,100,0,1,0,1,0
56653,443,22218,443,allow,1272,876,396,10,25,6,4
54367,443,60704,443,allow,5892088,193411,5698677,6287,213,2098,4189
34275,443,58408,443,allow,4880,3216,1664,29,79,15,14
53143,50584,0,0,deny,66,66,0,1,0,1,0
55801,53,42672,53,allow,222,102,120,2,30,1,1
52934,35776,0,0,deny,159,159,0,1,0,1,0
34152,11119,0,0,deny,148,148,0,1,0,1,0
6881,33969,15980,33969,allow,509,150,359,2,1200,1,1
57073,53,17930,53,allow,197,102,95,2,35,1,1
46404,53,46404,53,allow,237,91,146,2,32,1,1
53157,445,0,0,drop,70,70,0,1,0,1,0
52303,445,0,0,drop,70,70,0,1,0,1,0
60239,443,31265,443,allow,3149,1969,1180,19,150,11,8
8194,21247,0,0,deny,146,146,0,1,0,1,0
64844,53,45693,53,allow,733,86,647,2,29,1,1
54043,36237,0,0,deny,66,66,0,1,0,1,0
56673,53,13818,53,allow,186,95,91,2,31,1,1
9121,80,6298,80,allow,318,192,126,6,29,4,2
60337,30188,0,0,deny,66,66,0,1,0,1,0
53174,41442,6472,41442,allow,70,70,0,2,8,2,0
49662,443,55920,443,allow,9534,4029,5505,22,59,12,10
53930,445,0,0,drop,66,66,0,1,0,1,0
38549,22114,0,0,deny,62,62,0,1,0,1,0
53112,445,0,0,drop,66,66,0,1,0,1,0
53927,37828,58314,37828,allow,552,306,246,9,16,5,4
63772,35440,0,0,deny,66,66,0,1,0,1,0
51892,443,20369,443,allow,5671,1556,4115,23,274,13,10
53257,37450,0,0,deny,66,66,0,1,0,1,0
59982,443,10585,443,allow,3640,870,2770,13,120,6,7
56951,53,31350,53,allow,199,102,97,2,30,1,1
62888,993,63963,993,allow,8786,4118,4668,80,200,41,39
45682,25604,0,0,deny,62,62,0,1,0,1,0
50134,53,12196,53,allow,768,99,669,2,30,1,1
52759,445,0,0,drop,70,70,0,1,0,1,0
35949,31573,0,0,deny,146,146,0,1,0,1,0
50170,445,0,0,drop,70,70,0,1,0,1,0
53721,8999,32848,8999,allow,320,140,180,6,6,3,3
43827,443,64958,443,allow,130,70,60,2,14,1,1
6355,25174,0,0,deny,146,146,0,1,0,1,0
39823,36237,0,0,deny,66,66,0,1,0,1,0
12668,42707,0,0,deny,62,62,0,1,0,1,0
56621,443,45506,443,allow,7981,1961,6020,20,15,11,9
60398,80,57820,80,allow,378,192,186,7,122,4,3
20400,64147,0,0,deny,62,62,0,1,0,1,0
64966,53,51667,53,allow,458,188,270,6,31,3,3
63872,445,0,0,drop,70,70,0,1,0,1,0
65143,53,7897,53,allow,184,94,90,2,30,1,1
49297,443,47840,443,allow,5341,3636,1705,30,76,16,14
49857,443,44578,443,allow,18811,1868,16943,22,139,7,15
35973,443,21497,443,allow,4665045,113088,4551957,4511,421,1285,3226
54776,445,0,0,drop,70,70,0,1,0,1,0
59086,53,59086,53,allow,235,90,145,2,32,1,1
63468,445,0,0,drop,66,66,0,1,0,1,0
63265,445,0,0,drop,70,70,0,1,0,1,0
50378,443,14135,443,allow,7738,879,6859,19,27,10,9
6057,51221,0,0,deny,78,78,0,1,0,1,0
17561,52700,0,0,deny,62,62,0,1,0,1,0
53255,443,13217,443,allow,6244,1104,5140,23,65,12,11
50710,50584,0,0,deny,146,146,0,1,0,1,0
51907,80,10230,80,allow,9189,3144,6045,19,28,11,8
9206,443,23255,443,allow,5043,432,4611,12,15,6,6
49348,445,0,0,drop,70,70,0,1,0,1,0
64731,53,48863,53,allow,779,86,693,2,30,1,1
62693,445,0,0,drop,70,70,0,1,0,1,0
64961,53,7551,53,allow,243,110,133,2,30,1,1
65144,53,2841,53,allow,210,110,100,2,29,1,1
57333,445,0,0,drop,66,66,0,1,0,1,0
60636,445,0,0,drop,66,66,0,1,0,1,0
50482,443,33515,443,allow,6904692,144860,6759832,6483,140,1783,4700
41940,443,2811,443,allow,26974,22004,4970,80,216,42,38
48817,51413,48817,51413,allow,479,152,327,2,1200,1,1
50818,445,0,0,drop,66,66,0,1,0,1,0
55375,53,47639,53,allow,214,110,104,2,30,1,1
64715,53,60767,53,allow,315,98,217,4,58,2,2
34430,443,8333,443,allow,1701,1048,653,15,38,8,7
64596,53,7572,53,allow,237,110,127,2,30,1,1
51210,50584,0,0,deny,146,146,0,1,0,1,0
50822,80,16918,80,allow,550,476,74,6,15,5,1
60730,445,0,0,drop,70,70,0,1,0,1,0
56430,443,45343,443,allow,10956,4863,6093,47,82,22,25
63084,445,0,0,drop,70,70,0,1,0,1,0
64569,53,45660,53,allow,183,94,89,2,30,1,1
65372,53,29268,53,allow,198,102,96,2,30,1,1
64813,53,49645,53,allow,177,94,83,2,30,1,1
53915,1026,52746,1026,allow,70,70,0,2,8,2,0
53678,31592,21651,31592,allow,70,70,0,1,5,1,0
49219,80,41190,80,allow,2010,664,1346,11,84,7,4
63851,445,0,0,drop,70,70,0,1,0,1,0
55259,443,24007,443,allow,4523,3044,1479,17,64,10,7
62493,445,0,0,drop,66,66,0,1,0,1,0
35176,80,37365,80,allow,1987,1329,658,10,136,6,4
64572,37965,0,0,deny,66,66,0,1,0,1,0
64552,53,41507,53,allow,754,94,660,2,30,1,1
51183,56205,0,0,deny,66,66,0,1,0,1,0
56785,39004,0,0,deny,145,145,0,1,0,1,0
57994,30188,0,0,deny,62,62,0,1,0,1,0
55079,445,0,0,drop,70,70,0,1,0,1,0
55167,48817,0,0,deny,66,66,0,1,0,1,0
40511,80,1880,80,allow,1680,950,730,12,15,6,6
51135,80,18450,80,allow,254,128,126,5,15,3,2
56899,443,29729,443,allow,29904,3111,26793,68,164,35,33
55369,53,62193,53,allow,376,94,282,2,30,1,1
6882,55839,0,0,deny,146,146,0,1,0,1,0
62792,445,0,0,drop,66,66,0,1,0,1,0
33556,25174,0,0,deny,62,62,0,1,0,1,0
51878,445,0,0,drop,66,66,0,1,0,1,0
57014,80,25497,80,allow,214,140,74,4,30,3,1
63492,445,0,0,drop,70,70,0,1,0,1,0
63902,445,0,0,drop,70,70,0,1,0,1,0
1431,30041,0,0,deny,62,62,0,1,0,1,0
35128,443,23671,443,allow,9120,5103,4017,38,587,22,16
64493,53,11797,53,allow,199,102,97,2,30,1,1
65080,53,41733,53,allow,193,102,91,2,29,1,1
59070,445,0,0,drop,70,70,0,1,0,1,0
65090,53,63161,53,allow,230,102,128,2,31,1,1
26198,64147,0,0,deny,62,62,0,1,0,1,0
61515,445,0,0,drop,66,66,0,1,0,1,0
56767,443,38617,443,allow,7941,1952,5989,20,15,11,9
53055,445,0,0,drop,66,66,0,1,0,1,0
58741,445,0,0,drop,70,70,0,1,0,1,0
50630,445,0,0,drop,70,70,0,1,0,1,0
52459,33890,0,0,deny,60,60,0,1,0,1,0
53332,80,59740,80,allow,9094,5469,3625,22,166,12,10
4232,50584,0,0,deny,62,62,0,1,0,1,0
54498,443,44231,443,allow,8060,2001,6059,24,19,14,10
50967,443,6506,443,allow,612314,25589,586725,676,127,234,442
53695,21965,20178,21965,allow,2044,1143,901,19,16,9,10
63732,40642,31051,40642,allow,66,66,0,2,7,2,0
41885,25174,0,0,deny,66,66,0,1,0,1,0
58817,443,7616,443,allow,1413,876,537,12,25,6,6
68,67,0,0,deny,594,594,0,1,0,1,0
56377,445,0,0,drop,70,70,0,1,0,1,0
51581,445,0,0,drop,70,70,0,1,0,1,0
51221,57073,10928,57073,allow,481,150,331,2,1200,1,1
54752,31573,0,0,deny,66,66,0,1,0,1,0
61596,445,0,0,drop,66,66,0,1,0,1,0
59090,443,47184,443,allow,1469,702,767,20,120,10,10
45169,443,45169,443,allow,282,140,142,5,152,3,2
51338,445,0,0,drop,66,66,0,1,0,1,0
57321,445,0,0,drop,70,70,0,1,0,1,0
55634,53,46753,53,allow,308,102,206,2,30,1,1
34914,25604,0,0,deny,145,145,0,1,0,1,0
65132,53,40938,53,allow,167,86,81,2,31,1,1
59139,445,0,0,drop,70,70,0,1,0,1,0
49761,445,0,0,drop,70,70,0,1,0,1,0
55362,53,39798,53,allow,195,102,93,2,30,1,1
57013,53,1233,53,allow,178,94,84,2,30,1,1
5575,8889,5575,8889,deny,498,498,0,1,0,1,0
37087,443,26551,443,allow,9710,2136,7574,26,363,11,15
49604,53,53151,53,allow,179,94,85,2,30,1,1
50767,57470,0,0,deny,66,66,0,1,0,1,0
57311,53,52829,53,allow,768,99,669,2,31,1,1
52676,53733,0,0,deny,62,62,0,1,0,1,0
56363,53,52930,53,allow,212,102,110,2,30,1,1
57015,42707,0,0,deny,62,62,0,1,0,1,0
49897,443,23230,443,allow,33013,21249,11764,151,492,79,72
51043,445,0,0,drop,70,70,0,1,0,1,0
62916,445,0,0,drop,70,70,0,1,0,1,0
56926,445,0,0,drop,70,70,0,1,0,1,0
49926,80,8028,80,allow,1126,609,517,11,15,6,5
56838,53,39774,53,allow,177,94,83,2,30,1,1
50049,445,0,0,drop,70,70,0,1,0,1,0
56617,3389,56617,3389,allow,3425,1470,1955,16,17,8,8
27641,39004,0,0,deny,62,62,0,1,0,1,0
49538,80,51947,80,allow,2050,1691,359,9,75,6,3
50459,80,33223,80,allow,1328,917,411,10,28,6,4
48658,443,56881,443,allow,6799,4474,2325,38,85,20,18
53712,80,11675,80,allow,2424,529,1895,11,75,6,5
65485,443,65115,443,allow,92447,4519,87928,105,16,39,66
40301,8696,0,0,deny,60,60,0,1,0,1,0
64274,53,64916,53,allow,110,110,0,1,30,1,0
9179,443,30869,443,allow,5731,495,5236,14,15,7,7
39588,25174,0,0,deny,66,66,0,1,0,1,0
53912,443,35610,443,allow,1346,918,428,10,33,6,4
51298,57470,0,0,deny,66,66,0,1,0,1,0
37609,443,19871,443,allow,499,425,74,4,0,3,1
49862,443,63314,443,allow,819841,23462,796379,897,56,298,599
50025,53,41046,53,allow,369,150,219,2,30,1,1
64002,15503,0,0,deny,146,146,0,1,0,1,0
57422,53,42352,53,allow,198,102,96,2,30,1,1
1319,443,12846,443,allow,448,256,192,8,25,5,3
62780,35440,0,0,deny,66,66,0,1,0,1,0
52802,56205,0,0,deny,66,66,0,1,0,1,0
50478,443,59774,443,allow,25979,7217,18762,36,15,19,17
56035,53,24305,53,allow,173,94,79,2,30,1,1
51465,443,37534,443,allow,318,70,248,5,17,1,4
22,15260,22,15260,allow,130,70,60,2,15,1,1
61387,43890,0,0,deny,66,66,0,1,0,1,0
57871,443,42705,443,allow,7716,3991,3725,50,125,25,25
51948,37965,0,0,deny,62,62,0,1,0,1,0
65432,53,33110,53,allow,448,184,264,6,30,3,3
57142,53,15103,53,allow,165,86,79,2,30,1,1
55179,53,36377,53,allow,188,96,92,2,31,1,1
56760,443,12877,443,allow,7894,1671,6223,21,185,11,10
58638,5900,0,0,deny,62,62,0,1,0,1,0
61510,37965,0,0,deny,66,66,0,1,0,1,0
49505,53,46670,53,allow,232,110,122,2,30,1,1
54420,80,23681,80,allow,1596,511,1085,10,15,5,5
42319,443,8708,443,allow,6664,1570,5094,23,18,13,10
54874,445,0,0,drop,70,70,0,1,0,1,0
45537,80,48297,80,allow,1638,1324,314,10,15,5,5
43047,80,45126,80,allow,2088,472,1616,15,155,3,12
34331,443,59493,443,allow,9415,3998,5417,23,301,11,12
65109,53,18311,53,allow,753,94,659,2,30,1,1
50008,445,0,0,drop,70,70,0,1,0,1,0
63949,53,2589,53,allow,338,97,241,4,43,2,2
51852,18636,28064,18636,allow,136,136,0,3,13,3,0
36628,80,36628,80,allow,5529,713,4816,15,15,8,7
51025,443,40011,443,allow,6999,2523,4476,22,80,13,9
56239,53,24103,53,allow,176,90,86,2,31,1,1
56349,53,28965,53,allow,216,110,106,2,31,1,1
57430,53,3513,53,allow,200,102,98,2,31,1,1
41236,443,52117,443,allow,1807,1048,759,16,25,8,8
37827,443,64403,443,allow,424,210,214,7,131,4,3
54983,443,42126,443,allow,865636,22536,843100,903,50,309,594
49656,443,39036,443,allow,6006,763,5243,17,52,8,9
48488,443,26104,443,allow,12993,3240,9753,36,24,18,18
63288,52848,0,0,deny,66,66,0,1,0,1,0
64689,53,60672,53,allow,183,94,89,2,30,1,1
47700,51505,0,0,deny,66,66,0,1,0,1,0
65292,445,0,0,drop,66,66,0,1,0,1,0
56292,53,0,0,allow,238,94,144,2,29,1,1
11136,15503,0,0,deny,62,62,0,1,0,1,0
50904,80,18118,80,allow,12289218,202774,12086444,11470,149,2789,8681
59645,53,23128,53,allow,263,94,169,2,30,1,1
59246,445,0,0,drop,70,70,0,1,0,1,0
53739,27290,11218,27290,allow,70,70,0,2,7,2,0
50484,80,53622,80,allow,318,192,126,6,26,4,2
27081,10197,0,0,deny,62,62,0,1,0,1,0
50265,65535,43978,65535,allow,222,132,90,4,1210,3,1
22399,22,0,0,deny,60,60,0,1,0,1,0
52309,80,52309,80,allow,450,246,204,8,29,5,3
59887,443,6975,443,allow,1576,973,603,14,28,7,7
55204,53,12205,53,allow,263,94,169,2,30,1,1
63703,445,0,0,drop,70,70,0,1,0,1,0
65200,51050,0,0,deny,66,66,0,1,0,1,0
55261,53,19096,53,allow,177,94,83,2,29,1,1
57132,53,28118,53,allow,216,110,106,2,31,1,1
51480,445,0,0,drop,70,70,0,1,0,1,0
37965,8999,11644,8999,allow,402,132,270,6,1208,3,3
50066,30188,0,0,deny,66,66,0,1,0,1,0
9477,443,41654,443,allow,7461,1448,6013,22,35,11,11
56500,53,23471,53,allow,199,102,97,2,30,1,1
51622,445,0,0,drop,70,70,0,1,0,1,0
60936,443,44472,443,allow,4621,3079,1542,24,52,13,11
52917,445,0,0,drop,66,66,0,1,0,1,0
58638,5900,0,0,deny,62,62,0,1,0,1,0
5588,5588,0,0,allow,3354,1792,1562,46,194,23,23
57239,5228,64844,5228,allow,16135,7514,8621,173,9115,72,101
63919,80,26463,80,allow,314,192,122,6,15,4,2
63558,445,0,0,drop,70,70,0,1,0,1,0
11842,35440,0,0,deny,66,66,0,1,0,1,0
57353,443,50919,443,allow,70,70,0,1,5,1,0
51902,445,0,0,drop,66,66,0,1,0,1,0
55766,443,53751,443,allow,1864,250,1614,8,120,4,4
49996,445,0,0,drop,70,70,0,1,0,1,0
49862,443,6856,443,allow,17924,7867,10057,45,88,24,21
63111,445,0,0,drop,66,66,0,1,0,1,0
31978,57470,0,0,deny,60,60,0,1,0,1,0
26085,51221,0,0,deny,72,72,0,1,0,1,0
57321,53,18718,53,allow,199,102,97,2,30,1,1
39430,443,21846,443,allow,506,292,214,8,50,5,3
1025,25174,0,0,deny,62,62,0,1,0,1,0
63692,42635,61565,42635,allow,562,380,182,8,15,5,3
58103,10197,0,0,deny,66,66,0,1,0,1,0
57423,443,2574,443,allow,10222,4415,5807,26,15,11,15
58638,5900,0,0,deny,62,62,0,1,0,1,0
443,4512,0,0,deny,60,60,0,1,0,1,0
33238,443,21628,443,allow,21538,3952,17586,48,17,27,21
14613,12446,0,0,deny,66,66,0,1,0,1,0
56536,443,5996,443,allow,6044,3444,2600,49,501,25,24
49263,445,0,0,drop,66,66,0,1,0,1,0
56334,53,1244,53,allow,177,94,83,2,29,1,1
59213,445,0,0,drop,66,66,0,1,0,1,0
49484,445,0,0,drop,66,66,0,1,0,1,0
25565,27960,0,0,deny,60,60,0,1,0,1,0
65372,53,1041,53,allow,196,100,96,2,31,1,1
59932,443,1750,443,allow,333535,35190,298345,555,285,257,298
51059,445,0,0,drop,66,66,0,1,0,1,0
63648,445,0,0,drop,70,70,0,1,0,1,0
55390,53,32407,53,allow,778,103,675,2,31,1,1
25469,57470,0,0,deny,62,62,0,1,0,1,0
52127,80,9783,80,allow,2412,1750,662,13,36,9,4
52931,443,65247,443,allow,8519,1687,6832,29,17,16,13
62493,50584,0,0,deny,62,62,0,1,0,1,0
59941,445,0,0,drop,70,70,0,1,0,1,0
49157,53,58041,53,allow,184,94,90,2,31,1,1
62492,445,0,0,drop,66,66,0,1,0,1,0
57726,445,0,0,drop,70,70,0,1,0,1,0
51894,80,51074,80,allow,7434,3830,3604,17,26,9,8
52435,53,3973,53,allow,216,78,138,2,29,1,1
62424,37965,0,0,deny,62,62,0,1,0,1,0
50527,80,17326,80,allow,261781,16421,245360,330,156,137,193
123,123,56817,123,allow,184,94,90,2,30,1,1
56487,53,12533,53,allow,188,96,92,2,30,1,1
55705,53,13969,53,allow,281,101,180,4,58,2,2
64639,53,5053,53,allow,198,101,97,2,31,1,1
19330,25174,0,0,deny,62,62,0,1,0,1,0
43584,24748,0,0,deny,156,156,0,1,0,1,0
55578,45682,64868,45682,allow,70,70,0,1,5,1,0
58506,443,5356,443,allow,2408,1399,1009,18,274,9,9
64995,53,33043,53,allow,199,102,97,2,30,1,1
64773,445,0,0,drop,70,70,0,1,0,1,0
50277,445,0,0,drop,66,66,0,1,0,1,0
36307,53,54070,53,allow,200,86,114,2,30,1,1
64152,445,0,0,drop,70,70,0,1,0,1,0
56258,53,45112,53,allow,166,85,81,2,31,1,1
57444,53,32931,53,allow,177,94,83,2,30,1,1
57369,1433,0,0,deny,60,60,0,1,0,1,0
39548,8696,0,0,deny,60,60,0,1,0,1,0
42298,40016,35583,40016,allow,157,94,63,2,30,1,1
55232,25174,0,0,deny,146,146,0,1,0,1,0
45899,53,19119,53,allow,168,78,90,2,30,1,1
61187,443,13311,443,allow,4862,1820,3042,14,120,7,7
60397,43129,12174,43129,allow,70,70,0,2,8,2,0
30654,51221,0,0,deny,72,72,0,1,0,1,0
57557,445,0,0,drop,70,70,0,1,0,1,0
57662,445,0,0,drop,70,70,0,1,0,1,0
62423,445,0,0,drop,66,66,0,1,0,1,0
54766,445,0,0,drop,70,70,0,1,0,1,0
61462,445,0,0,drop,66,66,0,1,0,1,0
48125,7548,0,0,deny,60,60,0,1,0,1,0
56969,443,46839,443,allow,6431,1792,4639,22,80,13,9
53256,443,33815,443,allow,6185,1994,4191,27,16,16,11
60796,40010,42755,40010,allow,316,136,180,6,7,3,3
63512,445,0,0,drop,66,66,0,1,0,1,0
53805,34155,22730,34155,allow,70,70,0,1,4,1,0
64765,445,0,0,drop,70,70,0,1,0,1,0
36357,25174,0,0,deny,62,62,0,1,0,1,0
31136,50584,0,0,deny,62,62,0,1,0,1,0
60245,80,28831,80,allow,14705,6415,8290,26,149,12,14
56509,53,27088,53,allow,1164,93,1071,2,30,1,1
56747,42333,2469,42333,allow,66,66,0,1,5,1,0
55991,53,30604,53,allow,183,94,89,2,30,1,1
54321,27015,42449,27015,allow,924,924,0,3,29,3,0
61041,445,0,0,drop,70,70,0,1,0,1,0
55146,53,47251,53,allow,181,94,87,2,30,1,1
37988,64147,0,0,deny,66,66,0,1,0,1,0
50346,53,56767,53,allow,760,97,663,2,30,1,1
42094,35440,0,0,deny,62,62,0,1,0,1,0
48676,53395,0,0,deny,60,60,0,1,0,1,0
64681,35993,0,0,deny,62,62,0,1,0,1,0
59817,443,40958,443,allow,1401,864,537,12,29,6,6
16490,25174,0,0,deny,66,66,0,1,0,1,0
60167,5222,36653,5222,allow,908,650,258,11,20,7,4
63793,53,63793,53,allow,237,91,146,2,33,1,1
58900,37807,0,0,deny,66,66,0,1,0,1,0
64096,1127,15786,1127,allow,312,132,180,6,6,3,3
57398,53,10527,53,allow,770,102,668,2,31,1,1
58183,445,0,0,drop,70,70,0,1,0,1,0
44099,443,28525,443,allow,6235,1562,4673,21,191,12,9
57347,443,40026,443,allow,3889,1296,2593,11,120,6,5
5379,37965,0,0,deny,66,66,0,1,0,1,0
36792,80,39617,80,allow,152694,8416,144278,200,32,101,99
65319,53,54613,53,allow,200,94,106,2,30,1,1
62427,445,0,0,drop,70,70,0,1,0,1,0
53239,443,57625,443,allow,84664,6099,78565,140,70,56,84
65229,53,50750,53,allow,193,102,91,2,31,1,1
52718,445,0,0,drop,70,70,0,1,0,1,0
62341,445,0,0,drop,70,70,0,1,0,1,0
56317,53,26526,53,allow,183,94,89,2,30,1,1
56474,53,60230,53,allow,209,110,99,2,29,1,1
57193,80,36563,80,allow,2235,1055,1180,12,16,7,5
56377,51505,0,0,deny,66,66,0,1,0,1,0
61256,445,0,0,drop,70,70,0,1,0,1,0
56489,53,32825,53,allow,178,94,84,2,30,1,1
54104,443,3216,443,allow,190,70,120,4,15,2,2
42473,80,36510,80,allow,1737,796,941,12,16,7,5
55142,445,0,0,drop,70,70,0,1,0,1,0
51754,1182,55646,1182,allow,70,70,0,2,7,2,0
6882,6889,43478,6889,allow,221,111,110,2,1200,1,1
42954,443,44795,443,allow,6813,2515,4298,30,58,16,14
50584,2775,5247,2775,allow,150,150,0,1,1200,1,0
57709,445,0,0,drop,70,70,0,1,0,1,0
33227,53,32032,53,allow,177,86,91,2,30,1,1
63414,445,0,0,drop,66,66,0,1,0,1,0
56866,53,6471,53,allow,194,102,92,2,30,1,1
56261,53,26001,53,allow,184,94,90,2,29,1,1
49908,56205,0,0,deny,62,62,0,1,0,1,0
64101,445,0,0,drop,66,66,0,1,0,1,0
8984,443,5920,443,allow,13750,4934,8816,64,167,31,33
63832,25174,0,0,deny,62,62,0,1,0,1,0
10833,23,0,0,deny,60,60,0,1,0,1,0
57284,53,3184,53,allow,212,108,104,2,31,1,1
53030,56205,0,0,deny,66,66,0,1,0,1,0
50975,80,19286,80,allow,24781,3304,21477,43,21,24,19
61143,8080,0,0,deny,60,60,0,1,0,1,0
64810,53,65205,53,allow,272,93,179,4,32,2,2
49615,53,30558,53,allow,413,170,243,6,31,3,3
65236,53,60243,53,allow,247,118,129,2,30,1,1
31021,35440,0,0,deny,62,62,0,1,0,1,0
34431,443,7506,443,allow,1701,1048,653,15,39,8,7
56158,445,0,0,drop,70,70,0,1,0,1,0
63262,445,0,0,drop,66,66,0,1,0,1,0
51166,31573,0,0,deny,66,66,0,1,0,1,0
60869,48817,0,0,deny,66,66,0,1,0,1,0
49203,53,34232,53,allow,195,102,93,2,30,1,1
59528,50584,0,0,deny,146,146,0,1,0,1,0
65073,80,65073,80,allow,169702,10513,159189,187,23,72,115
57282,53,60817,53,allow,198,101,97,2,30,1,1
58638,5900,0,0,deny,62,62,0,1,0,1,0
39313,37965,0,0,deny,62,62,0,1,0,1,0
53704,15000,63052,15000,allow,70,70,0,1,4,1,0
64649,81,0,0,deny,60,60,0,1,0,1,0
54660,445,0,0,drop,70,70,0,1,0,1,0
52112,22114,0,0,deny,66,66,0,1,0,1,0
26865,443,47610,443,allow,20959,15902,5057,38,20,21,17
45908,3383,0,0,deny,60,60,0,1,0,1,0
56100,445,0,0,drop,70,70,0,1,0,1,0
27348,22114,0,0,deny,62,62,0,1,0,1,0
61622,445,0,0,drop,70,70,0,1,0,1,0
58186,443,61282,443,allow,5086,3296,1790,36,56,18,18
49855,53,65525,53,allow,177,94,83,2,30,1,1
41541,25174,0,0,deny,66,66,0,1,0,1,0
51984,54606,27351,54606,allow,70,70,0,1,5,1,0
56988,53,43201,53,allow,216,110,106,2,30,1,1
61717,445,0,0,drop,66,66,0,1,0,1,0
55735,53,52965,53,allow,184,94,90,2,30,1,1
57306,53,57306,53,allow,220,90,130,2,30,1,1
42665,80,22230,80,allow,7651,2046,5605,16,91,10,6
62663,35253,0,0,deny,66,66,0,1,0,1,0
51640,445,0,0,drop,66,66,0,1,0,1,0
30794,37965,0,0,deny,62,62,0,1,0,1,0
53947,867,53640,867,allow,70,70,0,2,8,2,0
65404,53,47407,53,allow,334,226,108,3,29,2,1
53909,20545,63910,20545,allow,612,366,246,10,19,6,4
61364,443,41959,443,allow,8492,2950,5542,27,16,15,12
49296,53,40772,53,allow,193,102,91,2,30,1,1
64473,53,9936,53,allow,184,94,90,2,30,1,1
29424,37807,0,0,deny,62,62,0,1,0,1,0
55441,443,55441,443,allow,4423,1516,2907,19,30,11,8
58638,5900,58638,5900,allow,62,62,0,1,5,1,0
50967,80,65454,80,allow,1439,697,742,12,35,6,6
44912,80,52893,80,allow,1602,1282,320,10,15,5,5
57596,445,0,0,drop,70,70,0,1,0,1,0
49379,53,52143,53,allow,260,102,158,2,30,1,1
61929,445,0,0,drop,70,70,0,1,0,1,0
63278,443,14519,443,allow,11570,3553,8017,24,134,10,14
56893,53,21610,53,allow,177,94,83,2,30,1,1
34951,443,13510,443,allow,3308,2109,1199,30,751,16,14
58638,5900,0,0,deny,62,62,0,1,0,1,0
52477,445,0,0,drop,70,70,0,1,0,1,0
61849,445,0,0,drop,66,66,0,1,0,1,0
55413,37965,0,0,deny,66,66,0,1,0,1,0
55752,53,39716,53,allow,177,94,83,2,30,1,1
38000,443,20816,443,allow,13123,6654,6469,29,135,15,14
61029,445,0,0,drop,70,70,0,1,0,1,0
51953,443,64481,443,allow,8900,2020,6880,28,25,15,13
53346,445,0,0,drop,70,70,0,1,0,1,0
8239,37965,0,0,deny,146,146,0,1,0,1,0
53871,443,16922,443,allow,499,425,74,4,1,3,1
55816,53,28988,53,allow,212,108,104,2,30,1,1
43897,443,6897,443,allow,6259,1816,4443,30,2615,16,14
56459,53,30479,53,allow,209,110,99,2,30,1,1
58638,5900,0,0,deny,62,62,0,1,0,1,0
42927,443,28678,443,allow,6921,1769,5152,22,24,13,9
50143,35253,0,0,deny,66,66,0,1,0,1,0
65038,53,25509,53,allow,165,86,79,2,30,1,1
53047,445,0,0,drop,66,66,0,1,0,1,0
63098,35440,0,0,deny,66,66,0,1,0,1,0
55478,53,55747,53,allow,177,94,83,2,30,1,1
56680,8100,35918,8100,allow,78,78,0,1,5,1,0
57265,53,26246,53,allow,762,98,664,2,30,1,1
38961,443,19720,443,allow,67063,17409,49654,94,274,48,46
58829,445,0,0,drop,66,66,0,1,0,1,0
49797,445,0,0,drop,70,70,0,1,0,1,0
45063,80,24999,80,allow,1892,1014,878,10,21,6,4
55628,13343,19881,13343,allow,634,388,246,10,18,6,4
47892,443,55293,443,allow,172,172,0,2,5,2,0
2995,26467,0,0,deny,62,62,0,1,0,1,0
34326,443,28311,443,allow,5692,1597,4095,19,18,11,8
59002,53,19057,53,allow,238,94,144,2,30,1,1
65020,53,14135,53,allow,184,94,90,2,31,1,1
49818,37965,0,0,deny,62,62,0,1,0,1,0
56106,53,61650,53,allow,816,102,714,2,30,1,1
30188,51419,27819,51419,allow,502,150,352,2,1200,1,1
50105,445,0,0,drop,70,70,0,1,0,1,0
55163,443,13789,443,allow,2329,505,1824,14,124,7,7
9108,443,64667,443,allow,5510,901,4609,15,26,8,7
50294,53,23372,53,allow,178,94,84,2,30,1,1
57370,6969,42648,6969,allow,70,70,0,1,5,1,0
41421,443,56908,443,allow,168930,11361,157569,252,31,101,151
56410,443,52137,443,allow,16167,1392,14775,25,105,12,13
50584,12754,22956,12754,allow,161,161,0,2,1200,2,0
58334,5223,0,0,deny,148,148,0,1,0,1,0
49355,53,16925,53,allow,186,95,91,2,0,1,1
7905,22114,0,0,deny,66,66,0,1,0,1,0
49418,23010,54751,23010,allow,288,78,210,2,30,1,1
58638,5900,0,0,deny,62,62,0,1,0,1,0
57762,25174,0,0,deny,146,146,0,1,0,1,0
55005,53,64520,53,allow,183,94,89,2,30,1,1
27988,40023,43847,40023,allow,143,81,62,2,31,1,1
57896,1,0,0,deny,100,100,0,1,0,1,0
52160,445,0,0,drop,70,70,0,1,0,1,0
45341,443,7736,443,allow,2754,1394,1360,22,36,11,11
56421,53,33128,53,allow,177,94,83,2,29,1,1
48620,53,31132,53,allow,199,94,105,2,29,1,1
62549,64147,0,0,deny,62,62,0,1,0,1,0
50086,57470,0,0,deny,66,66,0,1,0,1,0
49477,443,54783,443,allow,1332,876,456,11,27,6,5
5588,5588,0,0,allow,3562,1936,1626,48,194,24,24
36770,56205,0,0,deny,62,62,0,1,0,1,0
52113,19619,19801,19619,allow,70,70,0,1,4,1,0
41325,443,52651,443,allow,9669,2488,7181,26,149,11,15
53876,53380,47868,53380,allow,70,70,0,1,5,1,0
58363,443,44841,443,allow,46992,4773,42219,89,160,36,53
54002,445,0,0,drop,70,70,0,1,0,1,0
25363,23,0,0,deny,60,60,0,1,0,1,0
64690,445,0,0,drop,70,70,0,1,0,1,0
56509,445,0,0,drop,66,66,0,1,0,1,0
12651,62413,0,0,deny,62,62,0,1,0,1,0
40200,5222,30344,5222,allow,8250,3928,4322,80,296,44,36
19570,50584,0,0,deny,62,62,0,1,0,1,0
22835,51221,0,0,deny,62,62,0,1,0,1,0
40967,443,61086,443,allow,1786,172,1614,7,121,3,4
8416,8416,61571,8416,allow,66,66,0,1,30,1,0
56079,53,1064,53,allow,199,102,97,2,31,1,1
39569,443,5001,443,allow,1784075,46752,1737323,1812,47,606,1206
56266,53,13342,53,allow,193,102,91,2,31,1,1
3911,50584,0,0,deny,62,62,0,1,0,1,0
60872,443,60963,443,allow,10306,3254,7052,32,47,18,14
56842,24233,45791,24233,allow,70,70,0,1,5,1,0
56711,53,25495,53,allow,209,110,99,2,30,1,1
55810,80,19012,80,allow,11093,1415,9678,18,18,8,10
63840,36829,0,0,deny,66,66,0,1,0,1,0
64335,53,18778,53,allow,186,95,91,2,30,1,1
51949,80,39415,80,allow,5106,766,4340,16,45,9,7
64792,443,39397,443,allow,16199,7657,8542,58,127,28,30
47457,41615,0,0,deny,145,145,0,1,0,1,0
19037,53,19037,53,allow,227,89,138,2,31,1,1
46452,53,46452,53,allow,247,98,149,2,32,1,1
21322,25174,0,0,deny,146,146,0,1,0,1,0
56715,443,19932,443,allow,1207531,28695,1178836,1184,46,400,784
49418,27333,30238,27333,allow,254,78,176,2,30,1,1
56847,36370,51543,36370,allow,624,318,306,10,15,5,5
52124,443,40698,443,allow,78269,5330,72939,127,313,57,70
2525,23,0,0,deny,60,60,0,1,0,1,0
22587,30188,0,0,deny,66,66,0,1,0,1,0
64758,445,0,0,drop,70,70,0,1,0,1,0
55019,443,64416,443,allow,13326,1847,11479,27,31,14,13
53546,443,23696,443,allow,7268,3166,4102,19,136,10,9
55535,53,57254,53,allow,199,102,97,2,30,1,1
27005,28002,21197,28002,allow,918,126,792,2,30,1,1
6881,6881,0,0,deny,62,62,0,1,0,1,0
63593,22114,0,0,deny,62,62,0,1,0,1,0
56411,53,42159,53,allow,184,94,90,2,31,1,1
49638,53,20349,53,allow,210,110,100,2,30,1,1
59117,53,0,0,allow,82,82,0,1,31,1,0
61190,21247,0,0,deny,66,66,0,1,0,1,0
60308,445,0,0,drop,66,66,0,1,0,1,0
61566,445,0,0,drop,70,70,0,1,0,1,0
49873,80,19431,80,allow,9540,2954,6586,18,88,8,10
46159,443,12485,443,allow,124567,6787,117780,175,263,82,93
51410,443,1294,443,allow,619870,220857,399013,1045,123,531,514
65356,53,36098,53,allow,199,102,97,2,30,1,1
49545,53,14108,53,allow,195,102,93,2,30,1,1
52069,53446,38596,53446,allow,70,70,0,2,7,2,0
56965,445,0,0,drop,66,66,0,1,0,1,0
52205,24416,50314,24416,allow,136,136,0,3,13,3,0
49387,53,43855,53,allow,323,102,221,2,30,1,1
62231,443,62231,443,allow,180730,19869,160861,239,171,103,136
64348,53,23011,53,allow,321,102,219,2,30,1,1
58888,15000,44683,15000,allow,138,78,60,2,5,1,1
55913,53,19739,53,allow,177,94,83,2,30,1,1
63794,445,0,0,drop,70,70,0,1,0,1,0
59924,443,2445,443,allow,682,310,372,12,68,6,6
62820,445,0,0,drop,70,70,0,1,0,1,0
65429,80,58851,80,allow,366,180,186,7,29,4,3
61180,445,0,0,drop,66,66,0,1,0,1,0
65505,53,15527,53,allow,166,86,80,2,31,1,1
37067,443,4326,443,allow,21446,1599,19847,35,155,16,19
11136,15503,0,0,deny,62,62,0,1,0,1,0
49348,53,28507,53,allow,312,96,216,4,35,2,2
60375,32277,60465,32277,allow,70,70,0,1,5,1,0
34988,80,55946,80,allow,416,210,206,7,28,4,3
49510,53,7986,53,allow,754,94,660,2,30,1,1
57337,64147,0,0,deny,66,66,0,1,0,1,0
12164,22114,0,0,deny,62,62,0,1,0,1,0
56666,443,25263,443,allow,8006,1986,6020,20,15,11,9
49381,53,1330,53,allow,209,110,99,2,30,1,1
51635,80,51635,80,allow,699944,13137,686807,676,20,195,481
56664,53,62279,53,allow,774,101,673,2,31,1,1
57285,445,0,0,drop,66,66,0,1,0,1,0
50574,445,0,0,drop,70,70,0,1,0,1,0
34464,443,64076,443,allow,1402,910,492,11,360,6,5
53444,443,53444,443,allow,960,539,421,9,30,5,4
26460,80,26460,80,allow,490,264,226,8,32,5,3
50498,445,0,0,drop,70,70,0,1,0,1,0
52535,445,0,0,drop,70,70,0,1,0,1,0
51776,14645,62934,14645,allow,70,70,0,1,5,1,0
57229,445,0,0,drop,70,70,0,1,0,1,0
60676,57866,0,0,deny,66,66,0,1,0,1,0
26924,37965,0,0,deny,66,66,0,1,0,1,0
63888,6881,1639,6881,allow,66,66,0,2,7,2,0
57572,445,0,0,drop,70,70,0,1,0,1,0
58286,37965,0,0,deny,66,66,0,1,0,1,0
50532,80,48066,80,allow,4561,2110,2451,15,26,9,6
27005,27025,27504,27025,allow,895,126,769,2,30,1,1
19875,30170,0,0,deny,145,145,0,1,0,1,0
64331,53,48009,53,allow,179,94,85,2,29,1,1
55155,2767,0,0,deny,62,62,0,1,0,1,0
57733,445,0,0,drop,66,66,0,1,0,1,0
32806,7275,9524,7275,allow,1564,560,1004,23,38,9,14
63584,443,2301,443,allow,7146,2010,5136,34,167,18,16
50857,3389,50857,3389,allow,3613,1594,2019,19,18,10,9
36215,443,40898,443,allow,3554,2208,1346,18,256,10,8
65130,445,0,0,drop,66,66,0,1,0,1,0
49212,53,38007,53,allow,183,94,89,2,29,1,1
49174,443,55183,443,allow,524887,14310,510577,546,18,201,345
50536,445,0,0,drop,70,70,0,1,0,1,0
55591,445,0,0,drop,70,70,0,1,0,1,0
58928,445,0,0,drop,70,70,0,1,0,1,0
58467,53,16449,53,allow,235,95,140,2,31,1,1
56463,17,0,0,deny,60,60,0,1,0,1,0
56218,43890,0,0,deny,66,66,0,1,0,1,0
1024,26296,0,0,deny,159,159,0,1,0,1,0
50135,53,57045,53,allow,774,101,673,2,30,1,1
65280,53,36660,53,allow,213,102,111,2,30,1,1
50857,26467,0,0,deny,66,66,0,1,0,1,0
5285,64147,0,0,deny,145,145,0,1,0,1,0
49223,443,17029,443,allow,14838,6995,7843,52,244,26,26
49439,443,14852,443,allow,9495,2281,7214,22,78,11,11
18085,26467,0,0,deny,66,66,0,1,0,1,0
65293,53,50670,53,allow,94,94,0,1,30,1,0
59947,445,0,0,drop,66,66,0,1,0,1,0
50402,445,0,0,drop,70,70,0,1,0,1,0
14333,51050,0,0,deny,62,62,0,1,0,1,0
26872,44847,0,0,deny,62,62,0,1,0,1,0
36661,53,36661,53,allow,237,93,144,2,30,1,1
56770,53,63283,53,allow,208,106,102,2,30,1,1
7844,22114,0,0,deny,66,66,0,1,0,1,0
36017,443,12463,443,allow,4883,3524,1359,20,200,11,9
56825,53,3164,53,allow,177,94,83,2,30,1,1
55462,53,19938,53,allow,214,110,104,2,29,1,1
64914,445,0,0,drop,70,70,0,1,0,1,0
60350,51505,0,0,deny,66,66,0,1,0,1,0
54506,443,29033,443,allow,89702,83941,5761,91,181,66,25
37965,15509,12475,15509,allow,481,150,331,2,1199,1,1
48430,22,0,0,deny,60,60,0,1,0,1,0
50,64147,0,0,deny,62,62,0,1,0,1,0
36816,1812,36816,1812,allow,204,138,66,2,29,1,1
50807,445,0,0,drop,66,66,0,1,0,1,0
63433,57866,0,0,deny,66,66,0,1,0,1,0
51920,80,17031,80,allow,5069,4443,626,11,30,6,5
57427,443,63478,443,allow,5337,1085,4252,14,76,8,6
57207,53,13941,53,allow,190,97,93,2,30,1,1
80,57411,0,0,deny,1514,1514,0,1,0,1,0
49779,445,0,0,drop,70,70,0,1,0,1,0
53445,443,53445,443,allow,960,539,421,9,30,5,4
53171,445,0,0,drop,70,70,0,1,0,1,0
57211,445,0,0,drop,70,70,0,1,0,1,0
42732,53,10027,53,allow,86,86,0,1,30,1,0
49509,443,49509,443,allow,242669,43830,198839,310,67,159,151
61145,445,0,0,drop,70,70,0,1,0,1,0
54034,445,0,0,drop,70,70,0,1,0,1,0
54598,53,30660,53,allow,168,78,90,2,30,1,1
52109,60841,45067,60841,allow,156,66,90,2,5,1,1
57292,53,56725,53,allow,170,87,83,2,31,1,1
50052,65010,0,0,deny,60,60,0,1,0,1,0
56459,53,48405,53,allow,177,94,83,2,30,1,1
56434,445,0,0,drop,66,66,0,1,0,1,0
51365,445,0,0,drop,66,66,0,1,0,1,0
34932,38608,0,0,deny,62,62,0,1,0,1,0
56779,43137,58075,43137,allow,70,70,0,2,8,2,0
49561,53,53882,53,allow,211,102,109,2,30,1,1
27005,1308,10914,1308,allow,855,126,729,2,29,1,1
52040,2524,8539,2524,allow,70,70,0,2,7,2,0
56980,445,0,0,drop,66,66,0,1,0,1,0
36037,53,7009,53,allow,198,93,105,2,30,1,1
60946,445,0,0,drop,70,70,0,1,0,1,0
61806,443,30997,443,allow,7439,1156,6283,19,75,11,8
51900,15755,25086,15755,allow,316,136,180,6,6,3,3
47595,33434,0,0,allow,106,106,0,1,60,1,0
64485,53,10635,53,allow,183,94,89,2,30,1,1
6881,19215,41309,19215,allow,509,150,359,2,1199,1,1
61020,445,0,0,drop,70,70,0,1,0,1,0
55242,445,0,0,drop,66,66,0,1,0,1,0
50926,445,0,0,drop,66,66,0,1,0,1,0
64135,53,23762,53,allow,196,102,94,2,30,1,1
9092,26672,0,0,deny,60,60,0,1,0,1,0
39338,443,49574,443,allow,7624,1384,6240,23,17,12,11
64682,445,0,0,drop,66,66,0,1,0,1,0
50495,53,47068,53,allow,195,102,93,2,30,1,1
64878,26467,0,0,deny,145,145,0,1,0,1,0
23795,44847,0,0,deny,146,146,0,1,0,1,0
60455,445,0,0,drop,66,66,0,1,0,1,0
57470,50321,46751,50321,allow,538,166,372,2,1199,1,1
45964,2225,0,0,deny,60,60,0,1,0,1,0
52731,445,0,0,drop,70,70,0,1,0,1,0
45908,33330,0,0,deny,60,60,0,1,0,1,0
57441,53,33174,53,allow,177,94,83,2,30,1,1
58464,445,0,0,drop,70,70,0,1,0,1,0
60887,445,0,0,drop,66,66,0,1,0,1,0
46557,57866,0,0,deny,62,62,0,1,0,1,0
50510,53,6283,53,allow,734,94,640,2,30,1,1
63464,443,19526,443,allow,8543,1114,7429,26,93,11,15
51105,50584,0,0,deny,66,66,0,1,0,1,0
50265,49754,28018,49754,allow,402,132,270,6,1209,3,3
51338,443,48161,443,allow,424,210,214,7,131,4,3
57185,53,50357,53,allow,784,94,690,2,30,1,1
49665,53,15025,53,allow,168,86,82,2,29,1,1
52177,25320,0,0,deny,66,66,0,1,0,1,0
60896,443,6271,443,allow,14819,8197,6622,47,45,26,21
28007,443,65025,443,allow,10168,968,9200,19,15,9,10
55156,53,44381,53,allow,194,102,92,2,30,1,1
59663,445,0,0,drop,70,70,0,1,0,1,0
35546,443,6886,443,allow,5198,973,4225,16,17,10,6
58703,50584,0,0,deny,66,66,0,1,0,1,0
51708,21278,38128,21278,allow,70,70,0,1,5,1,0
37965,63666,47723,63666,allow,10717,6715,4002,121,4588,71,50
53871,37965,0,0,deny,66,66,0,1,0,1,0
56743,53,42878,53,allow,816,97,719,2,30,1,1
55384,53,49003,53,allow,194,102,92,2,31,1,1
13996,56205,0,0,deny,62,62,0,1,0,1,0
45545,53,45545,53,allow,178,82,96,2,30,1,1
9476,443,21369,443,allow,3999,905,3094,15,26,8,7
35336,443,36436,443,allow,6821,1076,5745,21,27,12,9
51661,443,59276,443,allow,11558,3964,7594,37,17,15,22
26900,27017,64702,27017,allow,422,164,258,6,30,3,3
51244,57587,0,0,deny,100,100,0,1,0,1,0
51978,80,13488,80,allow,24474,2101,22373,38,48,19,19
46808,25174,0,0,deny,62,62,0,1,0,1,0
50579,80,48781,80,allow,265114,13651,251463,346,76,161,185
60747,40010,30374,40010,allow,316,136,180,6,6,3,3
56153,53,6546,53,allow,742,88,654,2,31,1,1
64432,445,0,0,drop,70,70,0,1,0,1,0
65327,445,0,0,drop,70,70,0,1,0,1,0
50346,80,22819,80,allow,502,250,252,9,41,5,4
59532,445,0,0,drop,70,70,0,1,0,1,0
55514,53,24000,53,allow,216,94,122,2,30,1,1
6666,62078,0,0,deny,60,60,0,1,0,1,0
35422,443,43455,443,allow,154,94,60,2,5,1,1
44795,443,55624,443,allow,9608,1958,7650,21,15,11,10
29145,8168,0,0,deny,62,62,0,1,0,1,0
63941,53,42926,53,allow,253,102,151,2,30,1,1
51176,445,0,0,drop,70,70,0,1,0,1,0
55658,445,0,0,drop,70,70,0,1,0,1,0
42873,443,33511,443,allow,3379,2111,1268,19,15,10,9
55061,80,17010,80,allow,486,240,246,9,28,5,4
49858,80,51229,80,allow,1539,674,865,11,89,6,5
50693,80,37544,80,allow,56849,29352,27497,239,175,120,119
56621,443,14784,443,allow,1327,918,409,10,26,6,4
6666,401,0,0,deny,60,60,0,1,0,1,0
53242,443,60207,443,allow,42135,4098,38037,64,323,25,39
53803,445,0,0,drop,66,66,0,1,0,1,0
57429,445,0,0,drop,70,70,0,1,0,1,0
58022,3000,0,0,deny,60,60,0,1,0,1,0
64964,445,0,0,drop,70,70,0,1,0,1,0
52038,80,51825,80,allow,70,70,0,1,5,1,0
51154,445,0,0,drop,70,70,0,1,0,1,0
51157,443,53397,443,allow,2791,1800,991,26,186,15,11
59053,445,0,0,drop,70,70,0,1,0,1,0
50004,445,0,0,drop,70,70,0,1,0,1,0
59954,445,0,0,drop,66,66,0,1,0,1,0
51461,443,45147,443,allow,318,70,248,5,17,1,4
49744,53,14742,53,allow,816,102,714,2,30,1,1
49680,443,50049,443,allow,63100,10145,52955,87,147,37,50
59809,445,0,0,drop,66,66,0,1,0,1,0
63537,445,0,0,drop,70,70,0,1,0,1,0
55709,30217,48170,30217,allow,70,70,0,1,5,1,0
65026,53,20362,53,allow,188,96,92,2,30,1,1
64235,445,0,0,drop,66,66,0,1,0,1,0
20939,60461,0,0,deny,60,60,0,1,0,1,0
47771,25174,0,0,deny,62,62,0,1,0,1,0
55008,445,0,0,drop,70,70,0,1,0,1,0
51602,22114,0,0,deny,66,66,0,1,0,1,0
52655,445,0,0,drop,70,70,0,1,0,1,0
49670,53,58566,53,allow,168,86,82,2,29,1,1
58993,443,16211,443,allow,1437,736,701,15,28,7,8
57205,445,0,0,drop,66,66,0,1,0,1,0
53306,53,0,0,allow,86,86,0,1,29,1,0
56541,443,2047,443,allow,1560,988,572,13,25,7,6
35702,443,5840,443,allow,6751,1889,4862,24,316,13,11
46838,80,4801,80,allow,70,70,0,1,120,1,0
64477,445,0,0,drop,70,70,0,1,0,1,0
38731,443,59272,443,allow,13181,5856,7325,23,135,11,12
47130,80,63322,80,allow,613,539,74,7,15,6,1
39213,443,39213,443,allow,4378,1471,2907,19,29,11,8
45941,23386,0,0,deny,60,60,0,1,0,1,0
38323,443,27893,443,allow,130,70,60,2,15,1,1
51727,1024,33037,1024,allow,70,70,0,2,8,2,0
45964,55559,0,0,deny,60,60,0,1,0,1,0
64787,53,13133,53,allow,299,101,198,4,34,2,2
15227,26467,0,0,deny,66,66,0,1,0,1,0
48079,43227,0,0,deny,66,66,0,1,0,1,0
56260,53,6502,53,allow,177,94,83,2,30,1,1
57569,445,0,0,drop,70,70,0,1,0,1,0
64520,53,44752,53,allow,184,86,98,2,29,1,1
64752,53,32902,53,allow,186,102,84,2,30,1,1
63960,53,41492,53,allow,172,88,84,2,31,1,1
64934,53,46124,53,allow,194,99,95,2,31,1,1
49797,25174,0,0,deny,66,66,0,1,0,1,0
51791,56116,1472,56116,allow,70,70,0,2,8,2,0
58752,443,52846,443,allow,5167,700,4467,16,15,7,9
53236,445,0,0,drop,66,66,0,1,0,1,0
61589,443,61589,443,allow,4672,1765,2907,19,28,11,8
64677,445,0,0,drop,66,66,0,1,0,1,0
57007,53,5847,53,allow,183,94,89,2,30,1,1
1024,64147,0,0,deny,62,62,0,1,0,1,0
50566,22114,0,0,deny,62,62,0,1,0,1,0
65486,53,11134,53,allow,760,97,663,2,30,1,1
53992,445,0,0,drop,66,66,0,1,0,1,0
29623,37807,0,0,deny,62,62,0,1,0,1,0
60059,53,45306,53,allow,168,78,90,2,30,1,1
56449,443,10507,443,allow,3182,1568,1614,8,120,4,4
55517,53,64032,53,allow,179,94,85,2,29,1,1
40545,443,53543,443,allow,8691,6945,1746,25,80,14,11
64033,29834,16078,29834,allow,70,70,0,1,5,1,0
58055,80,49869,80,allow,254,128,126,5,15,3,2
64077,25174,0,0,deny,66,66,0,1,0,1,0
61243,445,0,0,drop,70,70,0,1,0,1,0
26531,25174,0,0,deny,62,62,0,1,0,1,0
49827,443,50182,443,allow,5863,1580,4283,17,15,9,8
53588,445,0,0,drop,70,70,0,1,0,1,0
15933,64147,0,0,deny,62,62,0,1,0,1,0
51818,43942,60184,43942,allow,156,66,90,2,5,1,1
57691,53,57691,53,allow,247,98,149,2,32,1,1
65388,55783,0,0,deny,66,66,0,1,0,1,0
43261,53,43261,53,allow,247,98,149,2,34,1,1
57018,53,1950,53,allow,170,87,83,2,30,1,1
4296,53,43153,53,allow,217,86,131,2,30,1,1
57239,161,0,0,deny,82,82,0,1,0,1,0
49587,443,57871,443,allow,5879,870,5009,18,53,9,9
57470,6881,59936,6881,allow,132,132,0,3,1199,3,0
57089,53,22992,53,allow,239,94,145,2,29,1,1
49972,53,40776,53,allow,184,94,90,2,30,1,1
50482,445,0,0,drop,66,66,0,1,0,1,0
56279,445,0,0,drop,70,70,0,1,0,1,0
63131,445,0,0,drop,70,70,0,1,0,1,0
44858,5228,3088,5228,allow,6819,1586,5233,18,3603,9,9
34417,50265,0,0,deny,145,145,0,1,0,1,0
59456,445,0,0,drop,70,70,0,1,0,1,0
50535,445,0,0,drop,66,66,0,1,0,1,0
52098,29067,36738,29067,allow,70,70,0,2,7,2,0
53168,80,46007,80,allow,1501,958,543,10,323,6,4
58638,5900,0,0,deny,62,62,0,1,0,1,0
49363,53,12270,53,allow,208,106,102,2,30,1,1
56747,443,56747,443,allow,33901,9598,24303,56,61,32,24
64823,445,0,0,drop,70,70,0,1,0,1,0
51505,17372,0,0,deny,62,62,0,1,0,1,0
61015,443,14729,443,allow,7863,1962,5901,29,270,16,13
56332,53,17265,53,allow,193,102,91,2,30,1,1
53090,59356,0,0,deny,66,66,0,1,0,1,0
7744,32480,0,0,deny,62,62,0,1,0,1,0
57048,53,62627,53,allow,512,95,417,4,34,2,2
55159,445,0,0,drop,66,66,0,1,0,1,0
56858,32330,59933,32330,allow,66,66,0,1,5,1,0
65515,22114,0,0,deny,66,66,0,1,0,1,0
59937,443,7727,443,allow,8852,1428,7424,22,199,11,11
57368,53,45045,53,allow,167,86,81,2,29,1,1
6882,6999,21724,6999,allow,228,118,110,2,1200,1,1
52217,80,27362,80,allow,1074,565,509,11,16,6,5
53371,26467,0,0,deny,66,66,0,1,0,1,0
59194,445,0,0,drop,66,66,0,1,0,1,0
64665,53,55262,53,allow,181,94,87,2,31,1,1
58961,80,54182,80,allow,1674,1360,314,11,15,6,5
63848,80,63848,80,allow,555419,4827,550592,451,21,64,387
30960,45736,51969,45736,allow,396,396,0,7,3616,7,0
51986,80,3605,80,allow,1274,694,580,13,16,6,7
53123,445,0,0,drop,70,70,0,1,0,1,0
38000,49152,22175,49152,allow,156,156,0,3,8,3,0
64228,53,55912,53,allow,266,110,156,2,30,1,1
49826,445,0,0,drop,66,66,0,1,0,1,0
56268,53,23212,53,allow,210,102,108,2,30,1,1
50750,443,64318,443,allow,70,70,0,2,171,2,0
52172,445,0,0,drop,66,66,0,1,0,1,0
8583,443,8583,443,allow,19994,4745,15249,47,82,21,26
65208,445,0,0,drop,70,70,0,1,0,1,0
65467,443,32500,443,allow,92244,4799,87445,107,15,43,64
41744,37965,0,0,deny,62,62,0,1,0,1,0
55262,445,0,0,drop,70,70,0,1,0,1,0
51804,31012,6657,31012,allow,70,70,0,2,8,2,0
1058,36866,0,0,deny,136,136,0,1,0,1,0
4581,23,0,0,deny,60,60,0,1,0,1,0
54223,443,38222,443,allow,499,425,74,4,0,3,1
7916,23,0,0,deny,60,60,0,1,0,1,0
51340,445,0,0,drop,70,70,0,1,0,1,0
63136,25174,0,0,deny,62,62,0,1,0,1,0
60866,443,47757,443,allow,14519,9445,5074,35,15,20,15
43927,443,42119,443,allow,3410,1249,2161,16,136,8,8
52836,36829,0,0,deny,66,66,0,1,0,1,0
16270,56205,0,0,deny,62,62,0,1,0,1,0
51037,80,32981,80,allow,134,60,74,3,4,2,1
42298,40023,18178,40023,allow,1531,729,802,10,31,5,5
55719,443,5079,443,allow,2936,343,2593,12,120,5,7
64697,53,13382,53,allow,199,102,97,2,30,1,1
49354,53,30111,53,allow,192,98,94,2,31,1,1
56445,53,52720,53,allow,198,101,97,2,30,1,1
26502,64147,0,0,deny,62,62,0,1,0,1,0
53979,26308,29256,26308,allow,70,70,0,1,4,1,0
56796,443,3501,443,allow,5475,1610,3865,19,255,11,8
39513,443,6930,443,allow,16012,10450,5562,33,80,18,15
60715,445,0,0,drop,70,70,0,1,0,1,0
10252,11392,0,0,deny,62,62,0,1,0,1,0
50561,55777,0,0,deny,62,62,0,1,0,1,0
49601,53,48706,53,allow,762,97,665,2,30,1,1
49502,44847,0,0,deny,66,66,0,1,0,1,0
64323,53,64062,53,allow,195,102,93,2,30,1,1
51071,445,0,0,drop,66,66,0,1,0,1,0
22571,51505,0,0,deny,62,62,0,1,0,1,0
64589,53,62557,53,allow,814,110,704,2,29,1,1
58780,443,38855,443,allow,8661,1687,6974,30,244,16,14
52261,5222,10119,5222,allow,5380,2214,3166,55,503,26,29
46734,53,46734,53,allow,314,98,216,2,29,1,1
49767,53,22379,53,allow,177,94,83,2,31,1,1
50577,23,0,0,deny,60,60,0,1,0,1,0
43788,80,23555,80,allow,2597,699,1898,11,181,6,5
51971,20347,9073,20347,allow,66,66,0,1,5,1,0
56385,53,50019,53,allow,249,85,164,4,56,2,2
54858,51505,0,0,deny,66,66,0,1,0,1,0
57131,31061,0,0,deny,145,145,0,1,0,1,0
52604,445,0,0,drop,66,66,0,1,0,1,0
46567,443,46567,443,allow,4398,1491,2907,19,29,11,8
56343,53,52506,53,allow,177,94,83,2,29,1,1
50761,445,0,0,drop,70,70,0,1,0,1,0
54501,445,0,0,drop,70,70,0,1,0,1,0
49984,53,7504,53,allow,178,94,84,2,30,1,1
64398,53,23095,53,allow,181,86,95,2,29,1,1
51206,445,0,0,drop,70,70,0,1,0,1,0
56821,53,37054,53,allow,199,102,97,2,29,1,1
53232,443,40771,443,allow,69742,34581,35161,105,63,52,53
64461,445,0,0,drop,70,70,0,1,0,1,0
64934,53,9879,53,allow,216,94,122,2,30,1,1
1043,48817,0,0,deny,136,136,0,1,0,1,0
55893,45711,0,0,deny,78,78,0,1,0,1,0
52534,445,0,0,drop,66,66,0,1,0,1,0
57566,445,0,0,drop,66,66,0,1,0,1,0
51409,443,49977,443,allow,394,70,324,7,31,2,5
62740,44847,0,0,deny,146,146,0,1,0,1,0
58691,445,0,0,drop,66,66,0,1,0,1,0
63513,445,0,0,deny,70,70,0,1,0,1,0
64546,53,11850,53,allow,183,94,89,2,29,1,1
49272,7000,49272,7000,allow,3132,815,2317,14,15,7,7
61989,445,0,0,drop,70,70,0,1,0,1,0
52165,443,19255,443,allow,289596,9131,280465,283,48,85,198
50848,445,0,0,drop,66,66,0,1,0,1,0
42821,53,25927,53,allow,168,78,90,2,30,1,1
57968,53,57968,53,allow,371,237,134,3,32,2,1
64929,53,59059,53,allow,168,86,82,2,30,1,1
28668,8696,0,0,deny,60,60,0,1,0,1,0
56327,53,13541,53,allow,178,94,84,2,30,1,1
48839,37807,0,0,deny,62,62,0,1,0,1,0
38661,15000,5688,15000,allow,138,78,60,2,5,1,1
62765,445,0,0,drop,66,66,0,1,0,1,0
55865,53,22117,53,allow,184,94,90,2,30,1,1
50095,53,54067,53,allow,146,75,71,2,31,1,1
55803,53,42450,53,allow,261,89,172,4,38,2,2
54322,443,16940,443,allow,14649,11393,3256,49,99,22,27
56227,53,18236,53,allow,174,89,85,2,31,1,1
56727,445,0,0,drop,70,70,0,1,0,1,0
57388,53,36277,53,allow,732,89,643,2,30,1,1
29576,37807,0,0,deny,66,66,0,1,0,1,0
60421,6882,25350,6882,allow,70,70,0,1,5,1,0
56930,53,11324,53,allow,297,94,203,2,30,1,1
64334,25174,0,0,deny,62,62,0,1,0,1,0
50368,53,59190,53,allow,70,70,0,1,30,1,0
43743,53,43743,53,allow,240,98,142,2,29,1,1
60228,80,30633,80,allow,6854,6211,643,16,151,9,7
55949,53,62692,53,allow,774,101,673,2,30,1,1
42298,40021,40004,40021,allow,148,86,62,2,31,1,1
56595,445,0,0,drop,70,70,0,1,0,1,0
64957,445,0,0,drop,70,70,0,1,0,1,0
62037,445,0,0,drop,70,70,0,1,0,1,0
49326,53,31358,53,allow,193,102,91,2,31,1,1
48817,60483,48817,60483,allow,519,158,361,2,1199,1,1
40604,443,31639,443,allow,130,70,60,3,5,2,1
64518,445,0,0,deny,70,70,0,1,0,1,0
64053,53,8111,53,allow,276,94,182,4,56,2,2
57470,1500,26703,1500,allow,528,528,0,9,1200,9,0
54688,445,0,0,drop,70,70,0,1,0,1,0
43130,443,2379,443,allow,207714,9731,197983,267,193,120,147
52726,445,0,0,drop,66,66,0,1,0,1,0
57525,445,0,0,drop,66,66,0,1,0,1,0
60022,443,60022,443,allow,18674,1910,16764,32,18,17,15
56399,53,36148,53,allow,498,204,294,6,29,3,3
63137,445,0,0,drop,70,70,0,1,0,1,0
3169,22114,0,0,deny,62,62,0,1,0,1,0
50929,443,35060,443,allow,9571,2966,6605,52,35,29,23
58638,5900,0,0,deny,62,62,0,1,0,1,0
51368,1900,0,0,deny,139,139,0,1,0,1,0
52385,53,0,0,allow,138,69,69,2,30,1,1
10797,50584,0,0,deny,62,62,0,1,0,1,0
10164,80,10164,80,allow,7351,803,6548,16,24,7,9
56958,53,59654,53,allow,816,102,714,2,30,1,1
65398,53,49816,53,allow,214,110,104,2,30,1,1
49521,53,40316,53,allow,183,94,89,2,30,1,1
6416,22114,0,0,deny,62,62,0,1,0,1,0
50234,53,63121,53,allow,720,94,626,2,30,1,1
80,37649,0,0,deny,60,60,0,1,0,1,0
2099,53,2099,53,allow,217,82,135,2,33,1,1
57038,53,13307,53,allow,735,88,647,2,30,1,1
56450,53,26592,53,allow,170,87,83,2,30,1,1
39586,22114,0,0,deny,66,66,0,1,0,1,0
51465,443,39975,443,allow,3961,1595,2366,21,16,12,9
47902,443,46766,443,allow,2420,1462,958,18,170,10,8
63318,443,32091,443,allow,8451,2698,5753,21,129,9,12
3564,57470,0,0,deny,62,62,0,1,0,1,0
57859,445,0,0,drop,66,66,0,1,0,1,0
51425,80,51425,80,allow,11369,3404,7965,28,26,14,14
65186,53,5333,53,allow,285,94,191,2,30,1,1
64088,39650,57206,39650,allow,66,66,0,2,7,2,0
64810,53,57933,53,allow,199,102,97,2,30,1,1
54465,445,0,0,drop,70,70,0,1,0,1,0
64084,445,0,0,drop,70,70,0,1,0,1,0
55620,53,33396,53,allow,172,88,84,2,31,1,1
57202,53,37225,53,allow,184,94,90,2,29,1,1
25150,25174,0,0,deny,62,62,0,1,0,1,0
55697,53,14156,53,allow,193,102,91,2,31,1,1
58638,5900,0,0,deny,62,62,0,1,0,1,0
48230,57866,0,0,deny,62,62,0,1,0,1,0
18423,51505,0,0,deny,62,62,0,1,0,1,0
55025,443,11622,443,allow,7599,3113,4486,30,20,17,13
64467,80,64467,80,allow,5570,699,4871,14,22,7,7
56204,53,64652,53,allow,168,86,82,2,29,1,1
56245,53,14605,53,allow,200,102,98,2,30,1,1
45273,53,45273,53,allow,213,79,134,2,32,1,1
49710,53,37323,53,allow,179,94,85,2,30,1,1
55014,53,9068,53,allow,716,95,621,2,31,1,1
49907,53,44048,53,allow,198,101,97,2,31,1,1
60387,445,0,0,drop,70,70,0,1,0,1,0
52614,44847,0,0,deny,66,66,0,1,0,1,0
50428,443,32117,443,allow,9844,4554,5290,24,92,13,11
59890,443,5968,443,allow,1401,864,537,12,28,6,6
3410,17372,0,0,deny,62,62,0,1,0,1,0
9327,57470,0,0,deny,62,62,0,1,0,1,0
49879,80,2147,80,allow,2087,1215,872,8,88,5,3
27528,35440,0,0,deny,62,62,0,1,0,1,0
46389,27098,0,0,deny,66,66,0,1,0,1,0
30861,46783,0,0,deny,62,62,0,1,0,1,0
55225,11392,0,0,deny,62,62,0,1,0,1,0
57470,8999,29205,8999,allow,863,363,500,4,1200,2,2
56498,445,0,0,drop,70,70,0,1,0,1,0
34489,35440,0,0,deny,66,66,0,1,0,1,0
51762,445,0,0,drop,66,66,0,1,0,1,0
37336,443,19104,443,allow,995086,50081,945005,1281,216,515,766
64349,53,48163,53,allow,392,102,290,2,30,1,1
57150,53,36180,53,allow,177,94,83,2,30,1,1
63837,14023,26076,14023,allow,70,70,0,1,4,1,0
61419,445,0,0,drop,66,66,0,1,0,1,0
51114,445,0,0,drop,66,66,0,1,0,1,0
62111,35440,0,0,deny,66,66,0,1,0,1,0
64640,445,0,0,drop,70,70,0,1,0,1,0
37110,53,37110,53,allow,247,98,149,2,33,1,1
62580,25174,0,0,deny,62,62,0,1,0,1,0
49666,53,61369,53,allow,392,124,268,4,35,2,2
55687,47613,13232,47613,allow,258,70,188,4,8,2,2
34932,38608,0,0,deny,62,62,0,1,0,1,0
34166,22114,0,0,deny,62,62,0,1,0,1,0
64955,53,3638,53,allow,210,110,100,2,29,1,1
52743,443,59107,443,allow,1547,960,587,14,26,8,6
56913,53,31255,53,allow,193,102,91,2,29,1,1
59725,445,0,0,drop,66,66,0,1,0,1,0
63697,445,0,0,drop,70,70,0,1,0,1,0
56794,46824,0,0,deny,66,66,0,1,0,1,0
51628,445,0,0,drop,66,66,0,1,0,1,0
17097,62413,0,0,deny,62,62,0,1,0,1,0
64628,53,28992,53,allow,199,102,97,2,30,1,1
53976,52534,48449,52534,allow,70,70,0,2,7,2,0
60986,443,43448,443,allow,7231,2305,4926,32,40,18,14
9336,443,60185,443,allow,4702,674,4028,15,15,8,7
60811,445,0,0,drop,70,70,0,1,0,1,0
50551,80,44425,80,allow,374,192,182,7,26,4,3
56282,445,0,0,drop,70,70,0,1,0,1,0
27005,27016,31585,27016,allow,876,126,750,2,30,1,1
33973,50265,0,0,deny,62,62,0,1,0,1,0
50751,445,0,0,drop,70,70,0,1,0,1,0
49753,445,0,0,drop,70,70,0,1,0,1,0
55646,14420,49852,14420,allow,70,70,0,2,8,2,0
64306,64147,0,0,deny,62,62,0,1,0,1,0
53418,445,0,0,drop,66,66,0,1,0,1,0
48335,25174,0,0,deny,62,62,0,1,0,1,0
51244,3855,0,0,deny,100,100,0,1,0,1,0
44037,5223,40215,5223,allow,5096,1030,4066,25,1751,9,16
60477,30889,55230,30889,allow,70,70,0,2,8,2,0
37666,443,8330,443,allow,3354,2353,1001,18,45,11,7
50848,445,0,0,drop,70,70,0,1,0,1,0
57924,445,0,0,drop,66,66,0,1,0,1,0
50496,443,27297,443,allow,90570,3437,87133,103,90,34,69
49343,445,0,0,drop,70,70,0,1,0,1,0
60867,443,23930,443,allow,14125,3827,10298,33,45,18,15
35338,443,31577,443,allow,571121,38361,532760,718,69,342,376
51794,445,0,0,drop,70,70,0,1,0,1,0
64471,53,53728,53,allow,264,110,154,2,30,1,1
58733,445,0,0,drop,70,70,0,1,0,1,0
51207,445,0,0,drop,70,70,0,1,0,1,0
64949,44847,0,0,deny,62,62,0,1,0,1,0
53308,445,0,0,drop,66,66,0,1,0,1,0
32342,62413,0,0,deny,66,66,0,1,0,1,0
65048,53,54954,53,allow,754,94,660,2,31,1,1
61256,445,0,0,drop,66,66,0,1,0,1,0
51091,53,0,0,allow,325,75,250,2,30,1,1
56952,53,7156,53,allow,186,95,91,2,30,1,1
51964,1103,26830,1103,allow,70,70,0,1,4,1,0
2267,53,35610,53,allow,204,118,86,2,30,1,1
41365,443,33138,443,allow,27475,5634,21841,76,145,35,41
56940,445,0,0,drop,70,70,0,1,0,1,0
54902,80,36045,80,allow,1107,630,477,10,16,6,4
60136,56205,0,0,deny,62,62,0,1,0,1,0
37698,443,12829,443,allow,1781,1062,719,16,275,8,8
58786,443,62467,443,allow,13240,8717,4523,33,16,17,16
58910,443,57868,443,allow,27575,18478,9097,64,22,36,28
51291,445,0,0,drop,70,70,0,1,0,1,0
34522,80,31284,80,allow,1420,715,705,12,16,7,5
39715,443,41417,443,allow,65276,4554,60722,82,217,34,48
49656,445,0,0,drop,66,66,0,1,0,1,0
61078,445,0,0,drop,70,70,0,1,0,1,0
64059,80,17237,80,allow,374,192,182,7,15,4,3
62062,443,21250,443,allow,134,60,74,3,5,2,1
51102,443,51987,443,allow,13990,9102,4888,28,15,16,12
62072,443,3018,443,allow,6095,1965,4130,26,46,15,11
15930,53,15930,53,allow,244,98,146,2,31,1,1
54621,445,0,0,drop,70,70,0,1,0,1,0
63384,445,0,0,drop,70,70,0,1,0,1,0
41776,443,58103,443,allow,3196404,47816,3148588,2668,147,469,2199
39691,443,19471,443,allow,6219,4130,2089,29,221,16,13
57434,445,0,0,drop,70,70,0,1,0,1,0
55601,53,58800,53,allow,177,94,83,2,30,1,1
57315,443,45136,443,allow,77504,4494,73010,112,200,54,58
50440,53,43767,53,allow,216,110,106,2,30,1,1
56119,443,4138,443,allow,144290,9387,134903,217,42,110,107
50802,445,0,0,drop,66,66,0,1,0,1,0
30188,39920,5702,39920,allow,501,150,351,2,1200,1,1
55657,53,52636,53,allow,822,102,720,2,30,1,1
57362,53,47817,53,allow,183,86,97,2,30,1,1
56438,53,21882,53,allow,312,94,218,2,30,1,1
63347,25174,0,0,deny,62,62,0,1,0,1,0
55207,445,0,0,drop,70,70,0,1,0,1,0
40127,53,0,0,allow,82,82,0,1,31,1,0
57067,53,26997,53,allow,178,94,84,2,30,1,1
55595,445,0,0,drop,70,70,0,1,0,1,0
33992,53,33992,53,allow,79,79,0,1,30,1,0
16948,990,0,0,deny,60,60,0,1,0,1,0
49907,443,59724,443,allow,5895,728,5167,16,47,8,8
49343,53,32839,53,allow,202,103,99,2,31,1,1
50504,53,41149,53,allow,168,86,82,2,30,1,1
50212,1688,56560,1688,allow,70,70,0,2,8,2,0
64990,445,0,0,drop,70,70,0,1,0,1,0
49846,53,37794,53,allow,763,101,662,2,31,1,1
52041,48103,59658,48103,allow,70,70,0,1,5,1,0
64808,53,34038,53,allow,239,94,145,2,30,1,1
64406,53,8536,53,allow,102,102,0,2,31,2,0
56114,53,2423,53,allow,216,110,106,2,30,1,1
49160,445,0,0,drop,70,70,0,1,0,1,0
8211,28793,0,0,deny,66,66,0,1,0,1,0
8999,57470,0,0,deny,146,146,0,1,0,1,0
63435,445,0,0,drop,70,70,0,1,0,1,0
55336,53,26759,53,allow,199,102,97,2,31,1,1
39100,2767,0,0,deny,62,62,0,1,0,1,0
42459,22114,0,0,deny,62,62,0,1,0,1,0
59234,21247,0,0,deny,62,62,0,1,0,1,0
16275,23117,0,0,deny,146,146,0,1,0,1,0
49224,53,6029,53,allow,170,87,83,2,31,1,1
53615,867,2680,867,allow,70,70,0,1,5,1,0
64712,445,0,0,drop,70,70,0,1,0,1,0
4138,55777,0,0,deny,66,66,0,1,0,1,0
63279,445,0,0,drop,70,70,0,1,0,1,0
58638,5900,0,0,deny,62,62,0,1,0,1,0
24260,50584,0,0,deny,62,62,0,1,0,1,0
27005,33086,33799,33086,allow,877,126,751,2,30,1,1
50972,3544,50946,3544,allow,258,107,151,2,30,1,1
53961,13067,41847,13067,allow,70,70,0,2,8,2,0
50377,445,0,0,drop,70,70,0,1,0,1,0
51208,443,57276,443,allow,8886,2767,6119,52,17,28,24
3381,44847,0,0,deny,78,78,0,1,0,1,0
55172,445,0,0,drop,70,70,0,1,0,1,0
51493,445,0,0,drop,70,70,0,1,0,1,0
61611,445,0,0,drop,70,70,0,1,0,1,0
58913,443,48481,443,allow,5264,3357,1907,21,17,11,10
53565,58695,57027,58695,allow,70,70,0,2,8,2,0
50255,445,0,0,drop,66,66,0,1,0,1,0
65118,445,0,0,drop,70,70,0,1,0,1,0
55653,53,52726,53,allow,94,94,0,1,29,1,0
64935,53,54508,53,allow,193,102,91,2,29,1,1
56710,53,40167,53,allow,195,102,93,2,31,1,1
50619,443,52531,443,allow,10483,1021,9462,30,100,11,19
56163,53,14069,53,allow,265,85,180,4,42,2,2
64956,53,28840,53,allow,322,84,238,4,36,2,2
53868,52706,53464,52706,allow,70,70,0,1,4,1,0
43818,53,4303,53,allow,168,78,90,2,30,1,1
60471,445,0,0,drop,70,70,0,1,0,1,0
56963,53,26493,53,allow,210,110,100,2,30,1,1
61491,445,0,0,drop,66,66,0,1,0,1,0
50368,80,46672,80,allow,318,192,126,6,28,4,2
64302,53,55170,53,allow,258,94,164,2,31,1,1
49803,443,21959,443,allow,9506,1461,8045,20,158,9,11
54305,35440,0,0,deny,62,62,0,1,0,1,0
64357,53,31050,53,allow,183,94,89,2,29,1,1
63453,445,0,0,drop,66,66,0,1,0,1,0
3001,28680,0,0,deny,148,148,0,1,0,1,0
51831,80,34274,80,allow,486,300,186,9,31,6,3
13171,53,13171,53,allow,404,259,145,3,32,2,1
63002,445,0,0,drop,66,66,0,1,0,1,0
27642,23,0,0,deny,60,60,0,1,0,1,0
58445,17500,0,0,deny,66,66,0,1,0,1,0
58872,443,3820,443,allow,1178,820,358,9,15,6,3
59839,443,29303,443,allow,93467,4007,89460,107,22,33,74
51243,80,3228,80,allow,1451,949,502,12,46,7,5
62598,445,0,0,drop,66,66,0,1,0,1,0
63684,445,0,0,drop,70,70,0,1,0,1,0
55027,48051,0,0,deny,62,62,0,1,0,1,0
61637,25174,0,0,deny,66,66,0,1,0,1,0
63398,25174,0,0,deny,66,66,0,1,0,1,0
57470,39113,45501,39113,allow,14689,8867,5822,93,3051,67,26
48857,50584,0,0,deny,66,66,0,1,0,1,0
50700,80,7989,80,allow,142,142,0,1,5,1,0
56861,445,0,0,drop,70,70,0,1,0,1,0
27999,443,45047,443,allow,5577,1390,4187,19,15,9,10
56472,80,20215,80,allow,45108,2309,42799,60,134,28,32
61156,445,0,0,drop,70,70,0,1,0,1,0
45833,13494,0,0,deny,60,60,0,1,0,1,0
65401,445,0,0,drop,70,70,0,1,0,1,0
18085,26467,0,0,deny,62,62,0,1,0,1,0
56633,53,58541,53,allow,166,86,80,2,30,1,1
57221,53,53360,53,allow,184,102,82,2,30,1,1
11651,64147,0,0,deny,145,145,0,1,0,1,0
53796,443,58960,443,allow,499,425,74,4,0,3,1
52633,30188,0,0,deny,62,62,0,1,0,1,0
55399,53,9206,53,allow,180,94,86,2,31,1,1
44505,53,44505,53,allow,216,90,126,2,30,1,1
51934,36180,0,0,deny,66,66,0,1,0,1,0
49551,445,0,0,drop,70,70,0,1,0,1,0
49935,445,0,0,drop,70,70,0,1,0,1,0
39488,53,45099,53,allow,199,94,105,2,29,1,1
10570,53,10570,53,allow,215,80,135,2,32,1,1
57094,53,10369,53,allow,196,102,94,2,30,1,1
60374,443,14239,443,allow,15475,7059,8416,33,97,18,15
16862,21247,0,0,deny,62,62,0,1,0,1,0
64880,9694,0,0,deny,66,66,0,1,0,1,0
9445,56205,0,0,deny,62,62,0,1,0,1,0
64988,445,0,0,drop,70,70,0,1,0,1,0
64595,64147,0,0,deny,62,62,0,1,0,1,0
65092,53,51583,53,allow,263,94,169,2,30,1,1
49690,443,64449,443,allow,9107,2174,6933,29,187,14,15
49907,445,0,0,drop,70,70,0,1,0,1,0
59778,443,59778,443,allow,4580,1673,2907,19,28,11,8
61876,443,60944,443,allow,3776,1446,2330,20,153,9,11
53796,53,64571,53,allow,213,78,135,2,30,1,1
51295,443,51295,443,allow,4334,1427,2907,19,27,11,8
55375,44847,0,0,deny,62,62,0,1,0,1,0
53985,445,0,0,drop,70,70,0,1,0,1,0
35011,37965,0,0,deny,62,62,0,1,0,1,0
49614,80,63774,80,allow,374,192,182,7,41,4,3
55141,53,56040,53,allow,184,94,90,2,31,1,1
58646,445,0,0,drop,70,70,0,1,0,1,0
49490,443,14327,443,allow,9109,1943,7166,32,270,16,16
55315,445,0,0,drop,70,70,0,1,0,1,0
56470,53,63709,53,allow,198,102,96,2,30,1,1
50476,80,50476,80,allow,28872,5086,23786,50,24,24,26
50207,445,0,0,drop,66,66,0,1,0,1,0
18011,44847,0,0,deny,62,62,0,1,0,1,0
55871,443,13590,443,allow,21179,8150,13029,46,153,25,21
56648,53,44024,53,allow,199,102,97,2,30,1,1
51858,445,0,0,drop,70,70,0,1,0,1,0
55656,53,37585,53,allow,214,110,104,2,30,1,1
65424,53,5090,53,allow,210,110,100,2,31,1,1
56450,53,45835,53,allow,184,102,82,2,29,1,1
22263,30188,0,0,deny,66,66,0,1,0,1,0
40932,8434,40932,8434,allow,156,156,0,3,8,3,0
63599,443,32617,443,allow,10050,1802,8248,30,39,16,14
56672,53,51134,53,allow,177,94,83,2,30,1,1
59755,44512,0,0,deny,66,66,0,1,0,1,0
54089,445,0,0,drop,66,66,0,1,0,1,0
51244,16474,0,0,deny,100,100,0,1,0,1,0
53793,443,25367,443,allow,499,425,74,4,0,3,1
64537,53,43379,53,allow,251,102,149,2,30,1,1
51387,443,34318,443,allow,5795,3322,2473,22,93,13,9
47325,443,49234,443,allow,130,70,60,2,15,1,1
50478,51505,0,0,deny,62,62,0,1,0,1,0
54957,53,36470,53,allow,99,99,0,1,30,1,0
34028,443,55750,443,allow,7804,2108,5696,24,32,14,10
43099,5900,0,0,deny,60,60,0,1,0,1,0
42532,22114,0,0,deny,146,146,0,1,0,1,0
49888,53,1710,53,allow,198,102,96,2,29,1,1
56584,445,0,0,drop,66,66,0,1,0,1,0
10090,443,45576,443,allow,20612,7872,12740,57,643,21,36
56005,53,41493,53,allow,403,142,261,2,30,1,1
46002,443,21932,443,allow,6299,1424,4875,27,291,10,17
55364,53,26181,53,allow,168,86,82,2,31,1,1
56623,443,24976,443,allow,8963,2190,6773,18,138,8,10
50595,80,62524,80,allow,2049,1065,984,15,78,8,7
60727,445,0,0,drop,70,70,0,1,0,1,0
51727,445,0,0,drop,66,66,0,1,0,1,0
56004,445,0,0,drop,66,66,0,1,0,1,0
57129,53,40985,53,allow,793,101,692,2,31,1,1
42298,40022,48973,40022,allow,730,548,182,4,30,2,2
9184,80,49214,80,allow,2066,651,1415,11,35,6,5
33886,65504,0,0,deny,162,162,0,1,0,1,0
63595,51050,0,0,deny,66,66,0,1,0,1,0
56767,445,0,0,drop,66,66,0,1,0,1,0
56130,445,0,0,drop,66,66,0,1,0,1,0
53966,57470,0,0,deny,62,62,0,1,0,1,0
64385,53,43683,53,allow,179,94,85,2,30,1,1
56459,53,55165,53,allow,392,86,306,2,30,1,1
49540,80,39259,80,allow,374,192,182,7,42,4,3
51609,37807,0,0,deny,66,66,0,1,0,1,0
80,37649,0,0,deny,60,60,0,1,0,1,0
63778,50584,0,0,deny,146,146,0,1,0,1,0
50170,445,0,0,drop,70,70,0,1,0,1,0
65188,53,34848,53,allow,213,102,111,2,30,1,1
59418,443,19462,443,allow,7222,1633,5589,24,201,13,11
59312,443,40068,443,allow,233778,8502,225276,276,34,109,167
59357,445,0,0,drop,66,66,0,1,0,1,0
17213,22114,0,0,deny,146,146,0,1,0,1,0
58221,445,0,0,drop,70,70,0,1,0,1,0
39460,23117,0,0,deny,66,66,0,1,0,1,0
58638,5900,58638,5900,allow,126,62,64,2,5,1,1
55893,53,24260,53,allow,267,94,173,4,55,2,2
59219,80,51900,80,allow,1658,1344,314,10,15,5,5
51682,445,0,0,drop,66,66,0,1,0,1,0
38287,443,17803,443,allow,424,210,214,7,131,4,3
49329,53,8761,53,allow,258,102,156,2,30,1,1
60304,443,14746,443,allow,3982,2461,1521,28,144,14,14
62758,445,0,0,drop,70,70,0,1,0,1,0
53623,445,0,0,drop,66,66,0,1,0,1,0
35981,53,35981,53,allow,227,89,138,2,31,1,1
47322,80,21803,80,allow,75931,3459,72472,97,43,38,59
64873,445,0,0,drop,66,66,0,1,0,1,0
55561,53,57871,53,allow,313,102,211,2,30,1,1
59782,26467,0,0,deny,62,62,0,1,0,1,0
27005,27016,17329,27016,allow,883,126,757,2,30,1,1
58905,443,41213,443,allow,13055,5677,7378,29,122,15,14
59416,445,0,0,drop,70,70,0,1,0,1,0
51597,445,0,0,drop,70,70,0,1,0,1,0
50305,443,65523,443,allow,7725,2029,5696,23,136,13,10
443,36576,0,0,deny,60,60,0,1,0,1,0
56306,445,0,0,drop,66,66,0,1,0,1,0
19875,30170,0,0,deny,145,145,0,1,0,1,0
64825,53,49543,53,allow,184,94,90,2,31,1,1
62553,445,0,0,drop,66,66,0,1,0,1,0
61424,443,36108,443,allow,1119,589,530,12,28,6,6
63759,443,31179,443,allow,7995,2096,5899,18,120,8,10
43700,30188,0,0,deny,62,62,0,1,0,1,0
56400,80,42500,80,allow,1281,398,883,16,392,4,12
30114,65151,0,0,deny,60,60,0,1,0,1,0
55502,53,15110,53,allow,194,102,92,2,30,1,1
64519,53,15868,53,allow,518,185,333,6,60,3,3
55713,47783,7321,47783,allow,70,70,0,2,8,2,0
61639,37965,0,0,deny,66,66,0,1,0,1,0
55194,53,53010,53,allow,190,97,93,2,31,1,1
63997,445,0,0,drop,70,70,0,1,0,1,0
58638,5900,0,0,deny,62,62,0,1,0,1,0
49454,443,27908,443,allow,7212,1757,5455,20,17,10,10
24144,57470,0,0,deny,62,62,0,1,0,1,0
56005,445,0,0,drop,70,70,0,1,0,1,0
55039,443,11955,443,allow,62,62,0,1,4,1,0
65455,53,29477,53,allow,564,108,456,4,50,2,2
55494,80,14370,80,allow,188544,9826,178718,241,32,113,128
58915,443,1330,443,allow,6138,3860,2278,20,16,10,10
49248,35993,0,0,deny,66,66,0,1,0,1,0
49675,7000,49675,7000,allow,3132,815,2317,14,15,7,7
57134,53,42837,53,allow,195,102,93,2,30,1,1
4817,11392,0,0,deny,146,146,0,1,0,1,0
50420,443,27192,443,allow,648,210,438,10,27,4,6
57331,445,0,0,drop,66,66,0,1,0,1,0
39983,80,29072,80,allow,1614,1300,314,10,16,5,5
62440,445,0,0,drop,66,66,0,1,0,1,0
27005,27016,44876,27016,allow,887,126,761,2,30,1,1
55653,53,53327,53,allow,199,102,97,2,30,1,1
60188,15503,0,0,deny,62,62,0,1,0,1,0
42776,443,39063,443,allow,4353,687,3666,14,25,8,6
62064,443,63626,443,allow,11582,2503,9079,33,47,17,16
29000,48817,0,0,deny,148,148,0,1,0,1,0
60979,443,13590,443,allow,49981,8331,41650,75,48,36,39
44808,443,1785,443,allow,22366,9583,12783,50,37,25,25
26831,443,14363,443,allow,7283,2586,4697,22,19,11,11
58049,443,10248,443,allow,8242,1641,6601,22,360,12,10
21846,53,21846,53,allow,247,98,149,2,33,1,1
49677,64147,0,0,deny,62,62,0,1,0,1,0
58202,445,0,0,drop,70,70,0,1,0,1,0
54599,443,16547,443,allow,6410,2001,4409,27,28,16,11
53380,445,0,0,deny,70,70,0,1,0,1,0
50470,61463,0,0,deny,86,86,0,1,0,1,0
50044,445,0,0,drop,70,70,0,1,0,1,0
57210,53,57210,53,allow,628,82,546,2,30,1,1
64132,53,11636,53,allow,179,94,85,2,30,1,1
65218,53,61017,53,allow,193,102,91,2,31,1,1
443,62451,0,0,deny,199,199,0,1,0,1,0
50688,80,9336,80,allow,27391,3550,23841,36,20,15,21
1040,37965,0,0,deny,62,62,0,1,0,1,0
47037,80,10159,80,allow,613,539,74,7,15,6,1
61341,445,0,0,drop,66,66,0,1,0,1,0
64930,445,0,0,drop,70,70,0,1,0,1,0
58823,443,42336,443,allow,25195,16739,8456,60,20,35,25
49167,53,55211,53,allow,258,94,164,2,30,1,1
55806,80,55806,80,allow,424,198,226,7,142,4,3
62618,445,0,0,drop,70,70,0,1,0,1,0
64306,53,2693,53,allow,216,110,106,2,30,1,1
62890,993,29471,993,allow,9624,4559,5065,88,196,45,43
58638,5900,0,0,deny,62,62,0,1,0,1,0
52117,445,0,0,drop,70,70,0,1,0,1,0
61435,445,0,0,drop,66,66,0,1,0,1,0
52348,62413,0,0,deny,66,66,0,1,0,1,0
56600,80,32176,80,allow,234,234,0,4,12,4,0
52744,25174,0,0,deny,66,66,0,1,0,1,0
63932,53,25694,53,allow,179,94,85,2,31,1,1
50598,80,63854,80,allow,17837,3830,14007,27,24,12,15
64300,445,0,0,drop,70,70,0,1,0,1,0
49247,80,49247,80,allow,135755,6750,129005,160,22,68,92
55151,445,0,0,drop,70,70,0,1,0,1,0
54849,445,0,0,drop,70,70,0,1,0,1,0
55830,53,46828,53,allow,183,94,89,2,30,1,1
5686,80,5686,80,allow,326,186,140,6,29,4,2
27005,27015,15666,27015,allow,876,126,750,2,30,1,1
1929,53,20387,53,allow,260,86,174,2,30,1,1
56940,80,20270,80,allow,2925,1480,1445,11,30,7,4
36261,443,56856,443,allow,1269784,41489,1228295,1339,37,478,861
53797,53,41009,53,allow,260,86,174,2,30,1,1
27617,51505,0,0,deny,146,146,0,1,0,1,0
49631,445,0,0,drop,70,70,0,1,0,1,0
53293,445,0,0,drop,66,66,0,1,0,1,0
58476,445,0,0,drop,70,70,0,1,0,1,0
27296,443,26053,443,allow,10243,1659,8584,29,83,13,16
64750,53,14070,53,allow,276,102,174,2,30,1,1
63783,1375,0,0,deny,109,109,0,1,0,1,0
64878,26467,0,0,deny,62,62,0,1,0,1,0
54389,28543,0,0,deny,62,62,0,1,0,1,0
61174,445,0,0,drop,70,70,0,1,0,1,0
60204,2767,0,0,deny,62,62,0,1,0,1,0
42298,40014,17083,40014,allow,216,94,122,4,29,2,2
55496,64097,0,0,deny,62,62,0,1,0,1,0
49651,37965,0,0,deny,74,74,0,1,0,1,0
60086,445,0,0,drop,70,70,0,1,0,1,0
56246,445,0,0,drop,70,70,0,1,0,1,0
993,33264,0,0,deny,66,66,0,1,0,1,0
59122,445,0,0,drop,70,70,0,1,0,1,0
9180,443,3139,443,allow,5731,495,5236,14,15,7,7
56494,50432,0,0,deny,146,146,0,1,0,1,0
33067,53,47200,53,allow,168,78,90,2,30,1,1
13588,15503,0,0,deny,62,62,0,1,0,1,0
12318,36866,0,0,deny,139,139,0,1,0,1,0
10248,21247,0,0,deny,146,146,0,1,0,1,0
64049,445,0,0,drop,70,70,0,1,0,1,0
47262,443,28246,443,allow,4609,763,3846,14,14,8,6
49198,64509,42217,64509,allow,70,70,0,2,8,2,0
51104,445,0,0,drop,66,66,0,1,0,1,0
56985,53,40638,53,allow,165,86,79,2,29,1,1
55755,53,57482,53,allow,779,86,693,2,30,1,1
58930,443,60456,443,allow,10413,7123,3290,30,18,17,13
56327,44512,0,0,deny,66,66,0,1,0,1,0
57406,445,0,0,drop,70,70,0,1,0,1,0
58568,445,0,0,drop,66,66,0,1,0,1,0
64281,53,42063,53,allow,214,110,104,2,30,1,1
7810,25174,0,0,deny,66,66,0,1,0,1,0
5223,32965,0,0,deny,66,66,0,1,0,1,0
65277,53,48607,53,allow,199,102,97,2,30,1,1
54013,37965,0,0,deny,66,66,0,1,0,1,0
52050,11392,0,0,deny,62,62,0,1,0,1,0
39207,80,25613,80,allow,78,78,0,1,5,1,0
45336,443,30419,443,allow,2312,1382,930,19,28,11,8
7686,25174,0,0,deny,62,62,0,1,0,1,0
60758,53,57238,53,allow,199,94,105,2,30,1,1
49622,80,33304,80,allow,454,262,192,8,42,5,3
56819,443,59951,443,allow,79878,10479,69399,138,120,68,70
62902,445,0,0,drop,66,66,0,1,0,1,0
56689,443,16946,443,allow,7890,1901,5989,20,15,11,9
61418,443,63876,443,allow,7741,1614,6127,21,77,11,10
65511,445,0,0,drop,70,70,0,1,0,1,0
42388,161,0,0,allow,109,109,0,2,35,2,0
59000,443,15029,443,allow,6362,1745,4617,25,18,13,12
6843,42873,0,0,deny,62,62,0,1,0,1,0
63705,19652,30539,19652,allow,70,70,0,1,5,1,0
60888,445,0,0,drop,70,70,0,1,0,1,0
58131,1,0,0,deny,146,146,0,1,0,1,0
36906,50584,0,0,deny,62,62,0,1,0,1,0
55161,445,0,0,drop,70,70,0,1,0,1,0
60568,445,0,0,drop,66,66,0,1,0,1,0
62787,445,0,0,drop,70,70,0,1,0,1,0
26879,37965,0,0,deny,62,62,0,1,0,1,0
64185,445,0,0,drop,70,70,0,1,0,1,0
55380,53,32660,53,allow,289,97,192,4,44,2,2
61732,443,11286,443,allow,8655,2300,6355,24,21,12,12
48258,37965,0,0,deny,62,62,0,1,0,1,0
60089,445,0,0,drop,70,70,0,1,0,1,0
64579,445,0,0,drop,66,66,0,1,0,1,0
32071,51221,0,0,deny,66,66,0,1,0,1,0
10018,80,16761,80,allow,1052,612,440,10,15,5,5
52115,10012,9221,10012,allow,70,70,0,2,8,2,0
64633,53,57902,53,allow,231,110,121,2,30,1,1
57221,443,19947,443,allow,7306,2784,4522,22,202,12,10
63827,445,0,0,drop,66,66,0,1,0,1,0
57095,53,10011,53,allow,177,94,83,2,30,1,1
44911,443,42749,443,allow,10194,2176,8018,25,186,14,11
48082,443,55722,443,allow,5619,885,4734,17,26,9,8
65448,443,34387,443,allow,3224,2373,851,17,23,9,8
50255,53,55681,53,allow,199,102,97,2,29,1,1
56698,80,23963,80,allow,176644,9435,167209,266,65,104,162
50067,64147,0,0,deny,66,66,0,1,0,1,0
49417,53,32052,53,allow,211,110,101,2,30,1,1
61680,443,50542,443,allow,12015,3771,8244,41,18,23,18
49722,443,17749,443,allow,5943,850,5093,16,50,7,9
64175,56502,0,0,deny,66,66,0,1,0,1,0
64363,22114,0,0,deny,62,62,0,1,0,1,0
22439,25174,0,0,deny,66,66,0,1,0,1,0
34212,11392,0,0,deny,66,66,0,1,0,1,0
49550,443,28578,443,allow,2338,1407,931,18,200,10,8
27442,44847,0,0,deny,62,62,0,1,0,1,0
64324,445,0,0,drop,70,70,0,1,0,1,0
58286,37965,0,0,deny,66,66,0,1,0,1,0
58154,445,0,0,drop,70,70,0,1,0,1,0
56928,53,33620,53,allow,172,88,84,2,30,1,1
64709,53,47288,53,allow,353,118,235,2,30,1,1
9087,53,9087,53,allow,215,80,135,2,33,1,1
56317,53,35779,53,allow,183,94,89,2,31,1,1
52041,80,18599,80,allow,2901,1407,1494,15,38,9,6
56998,53,2449,53,allow,199,94,105,2,30,1,1
60999,445,0,0,drop,70,70,0,1,0,1,0
62124,445,0,0,drop,70,70,0,1,0,1,0
64122,53,64122,53,allow,220,90,130,2,30,1,1
54464,445,0,0,drop,66,66,0,1,0,1,0
6014,37965,0,0,deny,66,66,0,1,0,1,0
50927,445,0,0,drop,66,66,0,1,0,1,0
49248,35993,0,0,deny,66,66,0,1,0,1,0
9314,443,56500,443,allow,3792,488,3304,14,16,7,7
58715,64097,0,0,deny,62,62,0,1,0,1,0
61864,80,52616,80,allow,9747,537,9210,14,16,6,8
51466,4545,51466,4545,allow,156,156,0,3,8,3,0
19875,30170,0,0,deny,145,145,0,1,0,1,0
61425,445,0,0,drop,70,70,0,1,0,1,0
49651,443,6996,443,allow,920003,731041,188962,2024,929,1212,812
58131,3855,0,0,deny,146,146,0,1,0,1,0
50223,445,0,0,drop,70,70,0,1,0,1,0
62678,57470,0,0,deny,62,62,0,1,0,1,0
55056,80,55056,80,allow,2959,1505,1454,10,16,6,4
56747,53,48027,53,allow,226,110,116,2,30,1,1
63715,445,0,0,drop,66,66,0,1,0,1,0
56510,443,37047,443,allow,8742,2483,6259,41,114,22,19
64683,53,5338,53,allow,376,95,281,4,36,2,2
49418,27016,19249,27016,allow,240,71,169,2,30,1,1
45540,443,45540,443,allow,4702,1795,2907,19,28,11,8
51880,8000,42444,8000,allow,582,270,312,8,32,4,4
49357,53,3200,53,allow,211,102,109,2,30,1,1
57467,445,0,0,drop,70,70,0,1,0,1,0
57026,445,0,0,drop,70,70,0,1,0,1,0
56973,445,0,0,drop,70,70,0,1,0,1,0
52136,443,52136,443,allow,298081,63335,234746,337,323,145,192
56437,80,52294,80,allow,17128,1499,15629,24,21,9,15
53437,44847,0,0,deny,62,62,0,1,0,1,0
50522,443,53720,443,allow,460,394,66,4,0,3,1
49595,53,47380,53,allow,180,94,86,2,30,1,1
49354,53,25819,53,allow,196,102,94,2,30,1,1
51871,23801,64442,23801,allow,316,136,180,6,6,3,3
57998,80,49916,80,allow,318,192,126,6,21,4,2
52076,445,0,0,drop,70,70,0,1,0,1,0
37965,1025,42195,1025,allow,158,158,0,1,1200,1,0
29964,53,52267,53,allow,200,86,114,2,30,1,1
60546,53,37684,53,allow,199,94,105,2,30,1,1
64670,53,38301,53,allow,186,95,91,2,31,1,1
26978,443,38800,443,allow,7547,2728,4819,26,20,13,13
55605,53,8941,53,allow,711,87,624,2,30,1,1
56368,53,19422,53,allow,817,98,719,2,30,1,1
60013,445,0,0,drop,70,70,0,1,0,1,0
51194,445,0,0,drop,70,70,0,1,0,1,0
50151,445,0,0,drop,66,66,0,1,0,1,0
53543,44847,0,0,deny,146,146,0,1,0,1,0
443,21717,0,0,deny,97,97,0,1,0,1,0
6882,50239,19851,50239,allow,296,150,146,2,1200,1,1
59969,445,0,0,drop,66,66,0,1,0,1,0
11136,57587,0,0,deny,62,62,0,1,0,1,0
65192,53,25403,53,allow,249,102,147,2,30,1,1
50813,445,0,0,drop,70,70,0,1,0,1,0
64312,445,0,0,drop,70,70,0,1,0,1,0
55312,53,24613,53,allow,195,102,93,2,30,1,1
3212,22114,0,0,deny,62,62,0,1,0,1,0
43475,443,10490,443,allow,5578,1646,3932,23,16,13,10
56169,53,17161,53,allow,916,86,830,2,30,1,1
54335,445,0,0,drop,70,70,0,1,0,1,0
64313,445,0,0,drop,70,70,0,1,0,1,0
64183,445,0,0,drop,70,70,0,1,0,1,0
13985,34159,0,0,deny,66,66,0,1,0,1,0
60612,445,0,0,drop,70,70,0,1,0,1,0
36154,47807,0,0,deny,146,146,0,1,0,1,0
49262,445,0,0,drop,70,70,0,1,0,1,0
62456,443,40302,443,allow,8678,3253,5425,22,25,11,11
56318,53,21992,53,allow,183,94,89,2,29,1,1
12605,57470,0,0,deny,62,62,0,1,0,1,0
49593,53,57101,53,allow,212,94,118,2,29,1,1
41486,1433,0,0,deny,60,60,0,1,0,1,0
55967,53,9494,53,allow,701,88,613,2,30,1,1
58530,445,0,0,drop,70,70,0,1,0,1,0
53355,23117,0,0,deny,66,66,0,1,0,1,0
55854,54369,0,0,deny,74,74,0,1,0,1,0
52050,11392,0,0,deny,62,62,0,1,0,1,0
64509,445,0,0,drop,70,70,0,1,0,1,0
1138,42873,0,0,deny,62,62,0,1,0,1,0
60303,445,0,0,drop,66,66,0,1,0,1,0
58745,30188,0,0,deny,66,66,0,1,0,1,0
27300,6881,0,0,deny,66,66,0,1,0,1,0
60369,443,30950,443,allow,12859,2557,10302,25,80,10,15
53178,42671,48767,42671,allow,70,70,0,2,8,2,0
51938,11218,50761,11218,allow,70,70,0,2,8,2,0
42298,40030,21853,40030,allow,546,486,60,2,30,1,1
56724,53,0,0,allow,86,86,0,1,30,1,0
53496,445,0,0,drop,66,66,0,1,0,1,0
56198,445,0,0,drop,70,70,0,1,0,1,0
61837,443,61837,443,allow,18398,2360,16038,39,75,17,22
49867,445,0,0,drop,70,70,0,1,0,1,0
49254,53,34045,53,allow,214,102,112,2,30,1,1
52054,80,38291,80,allow,41406,4176,37230,57,32,25,32
57336,445,0,0,drop,70,70,0,1,0,1,0
49476,80,51976,80,allow,5000,4058,942,15,15,8,7
52466,443,10561,443,allow,5082,896,4186,16,70,8,8
26900,27017,23136,27017,allow,422,164,258,6,29,3,3
52243,35643,17676,35643,allow,70,70,0,2,6,2,0
3478,61463,0,0,deny,1188,1188,0,1,0,1,0
56330,53,41814,53,allow,271,95,176,4,47,2,2
53861,53065,56189,53065,allow,70,70,0,1,5,1,0
12537,28816,0,0,deny,145,145,0,1,0,1,0
64979,53,10691,53,allow,194,102,92,2,30,1,1
55491,445,0,0,drop,70,70,0,1,0,1,0
54360,445,0,0,drop,70,70,0,1,0,1,0
44823,53,0,0,allow,82,82,0,1,30,1,0
52194,443,33437,443,allow,9075,3727,5348,38,50,18,20
60368,443,34243,443,allow,6041,1830,4211,21,82,10,11
53789,47191,38332,47191,allow,70,70,0,1,5,1,0
55071,53,28115,53,allow,711,87,624,2,30,1,1
9095,22114,0,0,deny,146,146,0,1,0,1,0
55976,53,37566,53,allow,758,96,662,2,31,1,1
57928,30188,0,0,deny,62,62,0,1,0,1,0
16980,53,16980,53,allow,197,90,107,2,30,1,1
49552,53,25565,53,allow,194,102,92,2,30,1,1
64347,53,35603,53,allow,321,109,212,4,47,2,2
58132,80,58132,80,allow,348,132,216,6,15,3,3
49367,443,60799,443,allow,22639,7456,15183,32,16,17,15
60464,445,0,0,drop,70,70,0,1,0,1,0
57732,445,0,0,drop,66,66,0,1,0,1,0
53146,50393,43018,50393,allow,70,70,0,1,5,1,0
37625,443,14545,443,allow,7766,1810,5956,24,46,14,10
65499,53,27912,53,allow,182,102,80,2,30,1,1
61408,445,0,0,drop,66,66,0,1,0,1,0
49855,53,31460,53,allow,170,87,83,2,30,1,1
51875,25072,31017,25072,allow,70,70,0,2,7,2,0
53264,443,4162,443,allow,41321,1491,39830,52,41,15,37
10080,443,4270,443,allow,130,70,60,3,5,2,1
55264,53,35896,53,allow,170,87,83,2,30,1,1
52740,445,0,0,drop,66,66,0,1,0,1,0
57377,445,0,0,drop,70,70,0,1,0,1,0
59811,443,39338,443,allow,36149,11297,24852,56,29,25,31
63305,445,0,0,drop,70,70,0,1,0,1,0
64592,53,20935,53,allow,177,94,83,2,30,1,1
49990,62413,0,0,deny,66,66,0,1,0,1,0
49518,443,56139,443,allow,7834,1758,6076,26,171,13,13
51589,445,0,0,drop,70,70,0,1,0,1,0
28436,22114,0,0,deny,146,146,0,1,0,1,0
38123,443,24032,443,allow,15449,1976,13473,32,16,16,16
57539,44847,0,0,deny,62,62,0,1,0,1,0
65176,53,2902,53,allow,186,95,91,2,30,1,1
64283,37965,0,0,deny,74,74,0,1,0,1,0
61522,64147,0,0,deny,62,62,0,1,0,1,0
61868,445,0,0,drop,70,70,0,1,0,1,0
58984,443,13660,443,allow,4874459,114404,4760055,4469,188,1112,3357
56695,53,47655,53,allow,183,94,89,2,30,1,1
6882,40796,60379,40796,allow,228,118,110,2,1200,1,1
60316,445,0,0,drop,66,66,0,1,0,1,0
52059,80,19994,80,allow,426,240,186,8,25,5,3
13413,44847,0,0,deny,62,62,0,1,0,1,0
51108,80,16411,80,allow,2794,2075,719,15,30,9,6
47730,22,0,0,deny,60,60,0,1,0,1,0
49672,53,36807,53,allow,718,94,624,2,30,1,1
14343,6881,0,0,deny,62,62,0,1,0,1,0
57857,445,0,0,drop,70,70,0,1,0,1,0
63972,53,24077,53,allow,193,102,91,2,29,1,1
61466,443,43127,443,allow,6205,1125,5080,23,89,13,10
49838,53,8093,53,allow,182,93,89,2,31,1,1
55646,445,0,0,drop,70,70,0,1,0,1,0
61158,445,0,0,drop,70,70,0,1,0,1,0
65495,53,9784,53,allow,202,103,99,2,31,1,1
50381,445,0,0,drop,66,66,0,1,0,1,0
49980,443,59748,443,allow,7227,4437,2790,29,271,16,13
34359,80,6984,80,allow,350,210,140,6,14,4,2
42956,443,56970,443,allow,11435,2668,8767,38,233,14,24
65020,53,52884,53,allow,289,102,187,2,30,1,1
49549,443,60727,443,allow,5903,1270,4633,14,17,8,6
55892,53,8349,53,allow,182,93,89,2,30,1,1
64937,53,47101,53,allow,210,110,100,2,30,1,1
4041,50584,0,0,deny,62,62,0,1,0,1,0
51877,53,28972,53,allow,254,78,176,2,29,1,1
53138,445,0,0,drop,70,70,0,1,0,1,0
0,0,0,0,deny,98,98,0,1,0,1,0
64512,53,2401,53,allow,524,91,433,4,34,2,2
63878,50829,45177,50829,allow,66,66,0,2,8,2,0
56800,23,0,0,deny,60,60,0,1,0,1,0
52082,14804,24933,14804,allow,70,70,0,1,4,1,0
63588,445,0,0,drop,66,66,0,1,0,1,0
49383,445,0,0,drop,66,66,0,1,0,1,0
65336,53,55246,53,allow,200,102,98,2,30,1,1
65365,445,0,0,drop,70,70,0,1,0,1,0
40239,22114,0,0,deny,146,146,0,1,0,1,0
54705,443,23468,443,allow,5411,851,4560,17,15,8,9
47257,443,58413,443,allow,64727,10981,53746,91,141,36,55
58079,50584,0,0,deny,66,66,0,1,0,1,0
54999,443,63007,443,allow,6430,1513,4917,26,40,14,12
65379,443,37475,443,allow,76625,63648,12977,139,83,79,60
51047,445,0,0,drop,66,66,0,1,0,1,0
48706,23393,0,0,deny,60,60,0,1,0,1,0
50950,445,0,0,drop,66,66,0,1,0,1,0
42231,57470,0,0,deny,78,78,0,1,0,1,0
64266,53,26877,53,allow,180,94,86,2,35,1,1
56701,53,21171,53,allow,211,110,101,2,30,1,1
57991,22114,0,0,deny,66,66,0,1,0,1,0
56503,53,8942,53,allow,916,86,830,2,31,1,1
53716,6881,40646,6881,allow,70,70,0,2,7,2,0
10949,22114,0,0,deny,146,146,0,1,0,1,0
51776,8000,6250,8000,allow,328,142,186,6,90,3,3
64645,53,50507,53,allow,391,96,295,4,49,2,2
65055,53,62687,53,allow,225,86,139,2,30,1,1
56955,53,15071,53,allow,183,94,89,2,30,1,1
40845,64147,0,0,deny,62,62,0,1,0,1,0
50095,30188,0,0,deny,66,66,0,1,0,1,0
49856,53,57011,53,allow,168,78,90,2,30,1,1
62705,443,21442,443,allow,357841,77119,280722,646,142,316,330
56354,53,44261,53,allow,182,102,80,2,29,1,1
57709,53,57709,53,allow,265,111,154,2,30,1,1
60537,445,0,0,drop,70,70,0,1,0,1,0
13394,23,0,0,deny,60,60,0,1,0,1,0
56608,443,64637,443,allow,8034,2014,6020,20,15,11,9
57470,54058,20688,54058,allow,150,150,0,1,1199,1,0
45964,59999,45964,59999,allow,60,60,0,1,5,1,0
50443,80,50443,80,allow,73400,3702,69698,77,19,26,51
51921,443,16602,443,allow,7970,4154,3816,39,102,23,16
57750,37965,0,0,deny,62,62,0,1,0,1,0
51265,445,0,0,drop,70,70,0,1,0,1,0
52065,52021,23578,52021,allow,70,70,0,1,4,1,0
40784,443,40784,443,allow,4378,1471,2907,19,25,11,8
60941,25174,0,0,deny,62,62,0,1,0,1,0
63820,27441,46760,27441,allow,70,70,0,1,4,1,0
57187,445,0,0,drop,70,70,0,1,0,1,0
52894,443,46843,443,allow,5424,1445,3979,29,117,14,15
62150,23718,0,0,deny,66,66,0,1,0,1,0
46760,50584,0,0,deny,146,146,0,1,0,1,0
27005,50003,14417,50003,allow,887,126,761,2,31,1,1
55379,443,27244,443,allow,13679,7277,6402,35,262,15,20
49485,80,52074,80,allow,1155,781,374,10,15,6,4
15499,22114,0,0,deny,146,146,0,1,0,1,0
57655,445,0,0,drop,70,70,0,1,0,1,0
55539,53,25818,53,allow,249,94,155,2,31,1,1
64227,53,63621,53,allow,302,92,210,4,30,2,2
56419,53,27801,53,allow,199,102,97,2,30,1,1
26900,27017,34324,27017,allow,422,164,258,6,30,3,3
49233,8080,49233,8080,allow,2602,846,1756,13,136,7,6
51836,37753,57785,37753,allow,70,70,0,1,4,1,0
62250,23117,0,0,deny,66,66,0,1,0,1,0
55991,53,2664,53,allow,199,102,97,2,30,1,1
49205,445,0,0,drop,70,70,0,1,0,1,0
49697,53,7185,53,allow,195,94,101,2,30,1,1
56587,445,0,0,drop,70,70,0,1,0,1,0
52817,443,5709,443,allow,2658,1126,1532,25,120,12,13
23873,30188,0,0,deny,62,62,0,1,0,1,0
49773,80,19021,80,allow,70,70,0,2,8,2,0
60239,53,53135,53,allow,219,102,117,2,30,1,1
49520,53,1147,53,allow,209,110,99,2,30,1,1
64487,445,0,0,drop,70,70,0,1,0,1,0
56592,53,38145,53,allow,200,102,98,2,30,1,1
49680,26467,0,0,deny,146,146,0,1,0,1,0
49322,445,0,0,drop,70,70,0,1,0,1,0
53162,60352,25976,60352,allow,70,70,0,2,8,2,0
65529,53,12629,53,allow,199,102,97,2,30,1,1
62627,7000,62627,7000,allow,2990,1599,1391,15,15,8,7
39690,443,65323,443,allow,5806,3167,2639,29,221,16,13
58638,5900,58638,5900,allow,62,62,0,1,5,1,0
57799,445,0,0,drop,66,66,0,1,0,1,0
65532,53,19828,53,allow,819,102,717,2,30,1,1
64059,30188,0,0,deny,62,62,0,1,0,1,0
28498,36237,0,0,deny,62,62,0,1,0,1,0
59314,443,58564,443,allow,16862,7584,9278,97,8912,60,37
35266,53,50904,53,allow,164,78,86,2,30,1,1
57413,443,19121,443,allow,16749,7614,9135,74,17,34,40
63834,445,0,0,drop,70,70,0,1,0,1,0
60469,445,0,0,drop,70,70,0,1,0,1,0
51880,443,34522,443,allow,4358,1056,3302,16,30,9,7
53991,445,0,0,drop,66,66,0,1,0,1,0
56662,443,10328,443,allow,318,192,126,6,15,4,2
65100,53,63534,53,allow,199,102,97,2,30,1,1
34531,443,54332,443,allow,135231,5033,130198,149,216,55,94
56458,53,36864,53,allow,192,98,94,2,31,1,1
49296,443,51414,443,allow,7419,2173,5246,17,16,9,8
51799,58416,38209,58416,allow,316,136,180,6,6,3,3
18623,1,0,0,deny,66,66,0,1,0,1,0
55377,53,41334,53,allow,195,102,93,2,30,1,1
51738,47483,4479,47483,allow,70,70,0,1,5,1,0
53980,36153,43274,36153,allow,164,70,94,2,5,1,1
46408,443,13228,443,allow,15452,3787,11665,36,62,19,17
55728,445,0,0,drop,66,66,0,1,0,1,0
59027,445,0,0,drop,66,66,0,1,0,1,0
50891,80,64394,80,allow,136656,9764,126892,162,140,70,92
49768,53,39040,53,allow,459,103,356,4,43,2,2
53094,443,6776,443,allow,6726,3603,3123,34,80,17,17
48817,51414,48817,51414,allow,150,150,0,1,1200,1,0
51088,443,60075,443,allow,14025,7301,6724,38,171,22,16
1749,64147,0,0,deny,66,66,0,1,0,1,0
65152,53,13983,53,allow,167,86,81,2,30,1,1
64996,27034,9075,27034,allow,1761,924,837,6,30,3,3
54761,5228,49627,5228,allow,12683,1205,11478,27,182,8,19
62981,445,0,0,drop,70,70,0,1,0,1,0
5588,5588,0,0,allow,3354,1792,1562,46,193,23,23
56323,53,21945,53,allow,168,94,74,2,30,1,1
9454,443,57468,443,allow,5699,505,5194,14,15,7,7
51718,55003,38571,55003,allow,70,70,0,2,8,2,0
32736,22114,0,0,deny,66,66,0,1,0,1,0
54186,445,0,0,drop,70,70,0,1,0,1,0
48706,23393,0,0,deny,60,60,0,1,0,1,0
55858,53,14376,53,allow,214,102,112,2,30,1,1
50332,80,8939,80,allow,5517,2843,2674,19,47,10,9
60401,80,25195,80,allow,190,64,126,4,103,2,2
50914,443,65485,443,allow,6813,1729,5084,18,16,10,8
34062,443,2265,443,allow,3208,2015,1193,19,34,11,8
65251,53,36655,53,allow,277,98,179,4,36,2,2
65406,445,0,0,drop,70,70,0,1,0,1,0
49208,6881,3930,6881,allow,70,70,0,2,8,2,0
62952,443,20995,443,allow,1304,612,692,18,120,9,9
49349,53,14349,53,allow,183,94,89,2,30,1,1
57184,53,36086,53,allow,272,94,178,2,29,1,1
49556,53,1572,53,allow,300,100,200,4,43,2,2
65264,80,41866,80,allow,7440,4032,3408,48,629,25,23
49359,53,18838,53,allow,216,110,106,2,30,1,1
46716,443,30978,443,allow,7298,2661,4637,21,17,11,10
64727,445,0,0,drop,66,66,0,1,0,1,0
64790,53,41901,53,allow,178,94,84,2,29,1,1
62178,445,0,0,drop,70,70,0,1,0,1,0
65114,53,6427,53,allow,253,87,166,4,31,2,2
64877,37450,0,0,deny,62,62,0,1,0,1,0
59107,25174,0,0,deny,66,66,0,1,0,1,0
55470,445,0,0,drop,66,66,0,1,0,1,0
62776,443,62776,443,allow,4398,1491,2907,19,26,11,8
59897,443,7806,443,allow,1743,934,809,15,32,7,8
28474,3389,28474,3389,allow,3850,1745,2105,19,18,11,8
57542,445,0,0,drop,66,66,0,1,0,1,0
56629,53,37533,53,allow,177,94,83,2,30,1,1
53298,443,6587,443,allow,5601,1187,4414,24,80,13,11
51944,12470,26336,12470,allow,316,136,180,6,6,3,3
54541,445,0,0,drop,70,70,0,1,0,1,0
49889,443,5001,443,allow,214782,13389,201393,277,50,98,179
64816,53,50725,53,allow,166,86,80,2,30,1,1
53283,445,0,0,drop,70,70,0,1,0,1,0
56295,443,26147,443,allow,8550,1880,6670,22,376,12,10
65227,53,53714,53,allow,180,86,94,2,30,1,1
27005,4444,13134,4444,allow,881,126,755,2,30,1,1
57993,80,1572,80,allow,3822,2132,1690,19,32,11,8
61659,445,0,0,drop,70,70,0,1,0,1,0
64053,445,0,0,drop,70,70,0,1,0,1,0
43782,7275,17092,7275,allow,4955,1749,3206,24,16,15,9
50584,6889,32589,6889,allow,311,311,0,3,1200,3,0
49282,6881,35216,6881,allow,709,523,186,6,16,3,3
35937,25174,0,0,deny,66,66,0,1,0,1,0
52083,26607,11051,26607,allow,70,70,0,2,7,2,0
52240,445,0,0,drop,70,70,0,1,0,1,0
54693,30188,0,0,deny,62,62,0,1,0,1,0
34814,80,10830,80,allow,9105,1930,7175,18,16,9,9
50587,443,51277,443,allow,1198,716,482,12,98,7,5
63241,443,59120,443,allow,5248,2550,2698,21,178,10,11
55399,53,43504,53,allow,180,94,86,2,30,1,1
53680,445,0,0,drop,70,70,0,1,0,1,0
55879,53,24811,53,allow,749,94,655,2,30,1,1
41399,443,26251,443,allow,8512,2563,5949,27,24,15,12
46260,80,59881,80,allow,3459,1620,1839,16,186,10,6
39735,53,51086,53,allow,223,78,145,2,30,1,1
63547,37965,0,0,deny,66,66,0,1,0,1,0
56360,53,60818,53,allow,184,102,82,2,30,1,1
57144,53,3454,53,allow,172,88,84,2,31,1,1
49705,80,59166,80,allow,132198,5466,126732,140,109,45,95
53907,45622,50876,45622,allow,70,70,0,2,7,2,0
49573,443,10413,443,allow,1326,876,450,11,55,6,5
45531,53,30846,53,allow,168,78,90,2,30,1,1
55409,445,0,0,drop,70,70,0,1,0,1,0
64574,443,40988,443,allow,9151,2109,7042,27,30,15,12
49650,443,26849,443,allow,92597,47158,45439,747,1187,422,325
59861,445,0,0,drop,70,70,0,1,0,1,0
14431,443,44094,443,allow,2601,1455,1146,18,16,8,10
45941,23386,0,0,deny,60,60,0,1,0,1,0
61343,443,57856,443,allow,1784740,34746,1749994,1769,331,357,1412
49186,53,28433,53,allow,821,102,719,2,30,1,1
39094,443,9909,443,allow,350650,19028,331622,494,83,251,243
56322,53,2088,53,allow,209,110,99,2,30,1,1
49487,53,10311,53,allow,183,94,89,2,31,1,1
42298,40005,17939,40005,allow,263,182,81,2,30,1,1
49527,53,33639,53,allow,173,94,79,2,30,1,1
47473,443,41796,443,allow,11072,3983,7089,27,186,15,12
57987,56125,0,0,deny,90,90,0,1,0,1,0
53037,80,8932,80,allow,2906,1233,1673,24,92,13,11
61491,443,56385,443,allow,5628,1716,3912,26,109,16,10
53895,443,14973,443,allow,390740,13639,377101,441,132,152,289
57773,443,16393,443,allow,11544,6888,4656,32,125,17,15
54294,445,0,0,drop,66,66,0,1,0,1,0
52251,80,52251,80,allow,1838,1319,519,11,48,6,5
59378,50584,0,0,deny,66,66,0,1,0,1,0
56425,53,0,0,allow,82,82,0,1,30,1,0
61530,445,0,0,drop,70,70,0,1,0,1,0
62519,445,0,0,drop,70,70,0,1,0,1,0
39236,80,55447,80,allow,190,70,120,4,16,2,2
58931,443,42670,443,allow,1413,876,537,12,28,6,6
65496,53,6299,53,allow,210,86,124,2,30,1,1
42804,443,52813,443,allow,8113,1626,6487,24,21,14,10
46576,23718,0,0,deny,66,66,0,1,0,1,0
64688,445,0,0,drop,70,70,0,1,0,1,0
49570,445,0,0,drop,66,66,0,1,0,1,0
64843,53,27388,53,allow,772,103,669,2,30,1,1
58608,62413,0,0,deny,62,62,0,1,0,1,0
46219,53,46219,53,allow,237,91,146,2,33,1,1
50928,445,0,0,drop,66,66,0,1,0,1,0
59868,445,0,0,drop,70,70,0,1,0,1,0
53216,443,34085,443,allow,14933,1671,13262,31,66,15,16
49586,445,0,0,drop,66,66,0,1,0,1,0
64408,53,9592,53,allow,257,126,131,2,31,1,1
64016,53,48329,53,allow,183,94,89,2,30,1,1
58885,443,6031,443,allow,152,86,66,2,5,1,1
64127,53,10956,53,allow,471,182,289,6,57,3,3
5571,80,5571,80,allow,326,186,140,6,29,4,2
56670,443,11392,443,allow,8006,1986,6020,20,15,11,9
49487,53,6709,53,allow,182,93,89,2,30,1,1
63768,55755,10523,55755,allow,70,70,0,1,4,1,0
52876,445,0,0,drop,66,66,0,1,0,1,0
33059,58962,0,0,deny,774,774,0,1,0,1,0
64854,53,54158,53,allow,260,102,158,2,30,1,1
46529,80,23858,80,allow,1119,388,731,9,223,5,4
62888,53,62888,53,allow,240,98,142,2,29,1,1
35053,80,19912,80,allow,71843,2833,69010,83,15,36,47
52865,443,19165,443,allow,13139,6481,6658,36,262,16,20
53465,57470,0,0,deny,62,62,0,1,0,1,0
64540,53,24153,53,allow,179,94,85,2,30,1,1
55803,53,18638,53,allow,261,89,172,4,32,2,2
53238,445,0,0,drop,66,66,0,1,0,1,0
57289,31573,0,0,deny,62,62,0,1,0,1,0
56658,53,51855,53,allow,177,94,83,2,30,1,1
54951,445,0,0,drop,70,70,0,1,0,1,0
55759,53,57416,53,allow,170,87,83,2,30,1,1
49793,53,56349,53,allow,271,102,169,2,30,1,1
29139,64147,0,0,deny,62,62,0,1,0,1,0
1027,64147,0,0,deny,62,62,0,1,0,1,0
50048,80,54605,80,allow,2140,1030,1110,22,149,8,14
56255,53,37256,53,allow,701,88,613,2,31,1,1
37780,443,37780,443,allow,4294,695,3599,15,20,8,7
51433,80,51433,80,allow,12796,1635,11161,21,15,8,13
55154,443,28417,443,allow,1610,771,839,22,120,11,11
60715,80,28604,80,allow,198,78,120,4,11,2,2
53651,47758,20351,47758,allow,70,70,0,2,7,2,0
54276,39004,0,0,deny,62,62,0,1,0,1,0
53455,53,0,0,allow,82,82,0,2,40,2,0
62527,445,0,0,drop,70,70,0,1,0,1,0
1027,57866,0,0,deny,62,62,0,1,0,1,0
51901,15860,21103,15860,allow,316,136,180,6,6,3,3
57418,443,37526,443,allow,29994,1927,28067,50,20,17,33
36339,50584,0,0,deny,62,62,0,1,0,1,0
49554,53,40462,53,allow,210,110,100,2,31,1,1
36629,23117,0,0,deny,62,62,0,1,0,1,0
54484,445,0,0,drop,66,66,0,1,0,1,0
64035,445,0,0,drop,66,66,0,1,0,1,0
63993,53,47498,53,allow,338,110,228,2,31,1,1
48551,443,38107,443,allow,7104,888,6216,19,27,9,10
64582,443,48743,443,allow,24686,1935,22751,36,19,17,19
34715,443,46649,443,allow,584,370,214,9,26,6,3
65236,53,36812,53,allow,215,102,113,2,30,1,1
24480,35440,0,0,deny,66,66,0,1,0,1,0
51069,80,24367,80,allow,254,128,126,5,15,3,2
52370,445,0,0,drop,66,66,0,1,0,1,0
53741,43800,53441,43800,allow,70,70,0,2,7,2,0
55902,53,9062,53,allow,178,91,87,2,31,1,1
64477,3478,36622,3478,allow,189,79,110,2,301,1,1
55735,53,17069,53,allow,772,100,672,2,30,1,1
52056,445,0,0,drop,70,70,0,1,0,1,0
53713,443,33766,443,allow,9555,4200,5355,25,86,15,10
65373,443,38852,443,allow,3104883,106687,2998196,3406,190,1320,2086
53832,53,28034,53,allow,211,78,133,2,29,1,1
58638,5900,0,0,deny,62,62,0,1,0,1,0
18739,23,0,0,deny,60,60,0,1,0,1,0
52072,25595,25464,25595,allow,70,70,0,2,8,2,0
63989,20939,6044,20939,allow,504,382,122,8,15,6,2
63139,12311,7837,12311,allow,70,70,0,2,8,2,0
63963,50584,0,0,deny,66,66,0,1,0,1,0
55918,53,38281,53,allow,184,94,90,2,31,1,1
52802,56205,0,0,deny,66,66,0,1,0,1,0
50602,80,38980,80,allow,1658,1247,411,8,15,5,3
65014,53,29342,53,allow,193,102,91,2,30,1,1
49267,53,65415,53,allow,184,94,90,2,30,1,1
57402,9992,42519,9992,allow,47040,13931,33109,428,129,207,221
50436,80,19701,80,allow,314,192,122,6,26,4,2
39244,36829,0,0,deny,146,146,0,1,0,1,0
53140,51221,0,0,deny,74,74,0,1,0,1,0
56519,53,32715,53,allow,711,87,624,2,30,1,1
61468,443,50536,443,allow,6265,1185,5080,24,89,14,10
43563,80,9467,80,allow,10597,2910,7687,24,47,14,10
63033,445,0,0,drop,70,70,0,1,0,1,0
38676,443,10906,443,allow,5306,1619,3687,20,29,12,8
60378,443,48147,443,allow,22073,10774,11299,48,107,26,22
54428,445,0,0,drop,70,70,0,1,0,1,0
50979,445,0,0,drop,70,70,0,1,0,1,0
51497,443,45992,443,allow,4945,1060,3885,21,15,12,9
58638,5900,0,0,deny,62,62,0,1,0,1,0
56819,53,44720,53,allow,209,110,99,2,29,1,1
65204,445,0,0,drop,70,70,0,1,0,1,0
49573,80,24541,80,allow,180917,5183,175734,175,65,49,126
49663,53,58279,53,allow,195,102,93,2,30,1,1
49205,53,38111,53,allow,188,96,92,2,31,1,1
53247,443,23976,443,allow,10542,1216,9326,26,44,10,16
61833,443,42241,443,allow,3429,784,2645,18,135,8,10
53427,445,0,0,drop,66,66,0,1,0,1,0
53249,443,17659,443,allow,3292049,87705,3204344,3470,232,1188,2282
62129,445,0,0,drop,70,70,0,1,0,1,0
49940,80,46739,80,allow,1130,613,517,11,15,6,5
14434,443,32675,443,allow,2556,1470,1086,17,16,8,9
51805,445,0,0,drop,70,70,0,1,0,1,0
65523,443,11792,443,allow,92518,4869,87649,109,15,44,65
35341,443,55051,443,allow,1473,988,485,12,26,7,5
0,0,0,0,deny,98,98,0,1,0,1,0
60543,53,6634,53,allow,211,78,133,2,30,1,1
14697,8000,26641,8000,allow,212,150,62,2,31,1,1
42044,60043,0,0,deny,66,66,0,1,0,1,0
49349,53,37003,53,allow,183,94,89,2,31,1,1
46901,26672,0,0,deny,60,60,0,1,0,1,0
5223,22981,0,0,deny,60,60,0,1,0,1,0
48826,25174,0,0,deny,62,62,0,1,0,1,0
56710,53,54162,53,allow,355,97,258,4,60,2,2
49540,53,53210,53,allow,198,110,88,2,30,1,1
65344,53,21017,53,allow,90,90,0,1,30,1,0
41858,443,41858,443,allow,4350,1443,2907,19,26,11,8
1182,23,0,0,deny,60,60,0,1,0,1,0
56667,53,55956,53,allow,199,102,97,2,29,1,1
64884,53,2199,53,allow,190,97,93,2,31,1,1
48541,80,51953,80,allow,812,672,140,6,28,4,2
57044,53,24810,53,allow,197,102,95,2,30,1,1
56633,445,0,0,drop,66,66,0,1,0,1,0
60374,57470,0,0,deny,62,62,0,1,0,1,0
42252,33303,0,0,deny,60,60,0,1,0,1,0
52451,56205,0,0,deny,66,66,0,1,0,1,0
57999,445,0,0,drop,70,70,0,1,0,1,0
49418,33086,18224,33086,allow,237,78,159,2,30,1,1
62152,56205,0,0,deny,66,66,0,1,0,1,0
52100,54130,10499,54130,allow,70,70,0,2,8,2,0
27005,27015,36150,27015,allow,889,126,763,2,30,1,1
57417,445,0,0,drop,70,70,0,1,0,1,0
54569,445,0,0,drop,70,70,0,1,0,1,0
58773,443,53074,443,allow,3854,2390,1464,17,15,8,9
54402,53,53139,53,allow,291,86,205,2,30,1,1
64208,53,37921,53,allow,194,94,100,2,29,1,1
1530,62413,0,0,deny,62,62,0,1,0,1,0
53586,443,61806,443,allow,8510,3207,5303,25,324,13,12
60376,445,0,0,drop,70,70,0,1,0,1,0
65269,53,14472,53,allow,237,94,143,2,30,1,1
19698,502,0,0,deny,60,60,0,1,0,1,0
58999,445,0,0,drop,66,66,0,1,0,1,0
50039,53,19771,53,allow,261,110,151,2,30,1,1
37633,44847,0,0,deny,62,62,0,1,0,1,0
51099,443,34189,443,allow,11482,3696,7786,28,62,15,13
49659,443,27992,443,allow,11455,2804,8651,59,121,28,31
55179,53,2667,53,allow,178,94,84,2,31,1,1
43532,80,43879,80,allow,1449,364,1085,13,15,6,7
56312,53,44683,53,allow,756,95,661,2,31,1,1
7447,53,7447,53,allow,244,98,146,2,32,1,1
35974,23,0,0,deny,60,60,0,1,0,1,0
49411,445,0,0,drop,70,70,0,1,0,1,0
3580,25174,0,0,deny,62,62,0,1,0,1,0
60301,445,0,0,drop,70,70,0,1,0,1,0
51826,445,0,0,drop,66,66,0,1,0,1,0
50438,50584,0,0,deny,146,146,0,1,0,1,0
57092,445,0,0,drop,70,70,0,1,0,1,0
16215,6881,0,0,deny,146,146,0,1,0,1,0
53085,53,0,0,allow,82,82,0,1,30,1,0
55323,445,0,0,drop,70,70,0,1,0,1,0
60463,6890,23297,6890,allow,164,70,94,3,8,2,1
61502,445,0,0,drop,66,66,0,1,0,1,0
53183,443,26366,443,allow,6094,1073,5021,19,15,10,9
443,23622,0,0,deny,74,74,0,1,0,1,0
64244,53,64721,53,allow,199,102,97,2,29,1,1
56677,53,32244,53,allow,286,103,183,4,48,2,2
52098,445,0,0,drop,70,70,0,1,0,1,0
56711,53,8899,53,allow,209,110,99,2,30,1,1
58638,5900,0,0,deny,62,62,0,1,0,1,0
65265,53,48964,53,allow,207,86,121,2,30,1,1
55771,53,49572,53,allow,283,98,185,4,51,2,2
55921,443,24781,443,allow,4348,1536,2812,14,121,6,8
65474,53,42125,53,allow,197,94,103,2,29,1,1
38171,443,40043,443,allow,1649,980,669,14,28,7,7
27005,33076,50946,33076,allow,889,126,763,2,31,1,1
54778,22114,0,0,deny,62,62,0,1,0,1,0
13917,18033,0,0,deny,62,62,0,1,0,1,0
55604,44235,60786,44235,allow,504,318,186,8,15,5,3
51266,16103,3760,16103,allow,70,70,0,2,8,2,0
57389,53,16174,53,allow,193,102,91,2,31,1,1
55016,445,0,0,drop,66,66,0,1,0,1,0
64776,80,31533,80,allow,4502,1072,3430,15,98,7,8
59285,445,0,0,drop,70,70,0,1,0,1,0
50584,62833,22282,62833,allow,1275,300,975,6,1200,3,3
49954,443,61436,443,allow,25995,13597,12398,53,186,28,25
55332,53,45716,53,allow,211,110,101,2,30,1,1
80,37649,0,0,deny,60,60,0,1,0,1,0
3478,61463,0,0,deny,1044,1044,0,1,0,1,0
27005,27015,14961,27015,allow,884,126,758,2,30,1,1
55141,53,13525,53,allow,184,94,90,2,31,1,1
60354,445,0,0,drop,70,70,0,1,0,1,0
55888,445,0,0,drop,70,70,0,1,0,1,0
64000,44847,0,0,deny,66,66,0,1,0,1,0
1860,25174,0,0,deny,66,66,0,1,0,1,0
55512,53,3521,53,allow,458,188,270,6,30,3,3
54056,445,0,0,drop,70,70,0,1,0,1,0
53575,1025,61617,1025,allow,70,70,0,1,4,1,0
57001,53,10240,53,allow,170,87,83,2,31,1,1
41232,443,32307,443,allow,1807,1048,759,16,25,8,8
56817,445,0,0,drop,66,66,0,1,0,1,0
40439,443,42690,443,allow,8126,1627,6499,29,165,16,13
13188,35440,0,0,deny,62,62,0,1,0,1,0
48627,443,55025,443,allow,638,70,568,10,207,2,8
52254,445,0,0,drop,70,70,0,1,0,1,0
51967,443,12004,443,allow,21063,13499,7564,47,68,25,22
56995,443,35339,443,allow,8721,2518,6203,29,159,13,16
49229,6921,0,0,deny,145,145,0,1,0,1,0
28481,53,51837,53,allow,205,86,119,2,30,1,1
54857,445,0,0,drop,70,70,0,1,0,1,0
27005,27015,25452,27015,allow,887,126,761,2,30,1,1
52280,443,52280,443,allow,1615,941,674,15,20,7,8
30023,3389,30023,3389,allow,4145,1976,2169,22,19,13,9
49440,53,37784,53,allow,210,102,108,2,29,1,1
59608,443,1997,443,allow,2149,1277,872,18,829,10,8
64765,53,64580,53,allow,177,94,83,2,30,1,1
60467,51095,40128,51095,allow,320,140,180,6,7,3,3
41405,443,41405,443,allow,4565,1658,2907,19,29,11,8
52962,445,0,0,drop,70,70,0,1,0,1,0
63932,53,16188,53,allow,179,94,85,2,31,1,1
26180,35440,0,0,deny,66,66,0,1,0,1,0
36826,443,2632,443,allow,6040,1612,4428,21,255,12,9
64268,53,55887,53,allow,679,179,500,6,69,3,3
53232,80,53232,80,allow,6385,778,5607,17,16,9,8
57173,44847,0,0,deny,62,62,0,1,0,1,0
49538,443,16302,443,allow,2926,1825,1101,22,171,11,11
52775,445,0,0,drop,66,66,0,1,0,1,0
37566,443,61835,443,allow,1386,924,462,12,30,7,5
58638,5900,0,0,deny,62,62,0,1,0,1,0
53573,445,0,0,drop,70,70,0,1,0,1,0
19875,30170,0,0,deny,145,145,0,1,0,1,0
51634,445,0,0,drop,66,66,0,1,0,1,0
56330,53,30393,53,allow,198,101,97,2,31,1,1
57173,53,30572,53,allow,322,110,212,4,31,2,2
6881,64910,0,0,deny,146,146,0,1,0,1,0
1446,35440,0,0,deny,66,66,0,1,0,1,0
55548,53,43983,53,allow,197,102,95,2,33,1,1
53814,443,6695,443,allow,499,425,74,4,0,3,1
15503,21394,46725,21394,allow,479,150,329,2,1200,1,1
60789,445,0,0,drop,70,70,0,1,0,1,0
41458,443,29775,443,allow,13059,5161,7898,34,84,19,15
61835,443,61835,443,allow,21703,2433,19270,44,76,18,26
65187,53,4197,53,allow,198,101,97,2,30,1,1
55921,43890,0,0,deny,66,66,0,1,0,1,0
37383,443,62473,443,allow,11389,4837,6552,27,120,13,14
59140,445,0,0,drop,66,66,0,1,0,1,0
56062,53,55511,53,allow,196,102,94,2,30,1,1
50968,443,1243,443,allow,469,403,66,4,0,3,1
9450,443,24290,443,allow,5691,503,5188,14,15,7,7
43227,443,48195,443,allow,460628,23936,436692,580,124,264,316
49713,53,34138,53,allow,198,94,104,2,30,1,1
49866,443,16607,443,allow,6058,1038,5020,20,56,11,9
23528,44847,0,0,deny,62,62,0,1,0,1,0
56765,1841,2876,1841,allow,70,70,0,1,5,1,0
51412,51505,0,0,deny,62,62,0,1,0,1,0
51015,64147,0,0,deny,145,145,0,1,0,1,0
50386,53,42277,53,allow,782,110,672,2,30,1,1
5588,5588,0,0,allow,3562,1936,1626,48,193,24,24
57504,443,39017,443,allow,5238,695,4543,14,25,8,6
50533,443,28213,443,allow,3518,1654,1864,10,120,5,5
59096,57866,0,0,deny,66,66,0,1,0,1,0
53105,61310,38041,61310,allow,70,70,0,1,5,1,0
57147,53,3974,53,allow,166,86,80,2,31,1,1
24606,55783,0,0,deny,72,72,0,1,0,1,0
55704,13343,3338,13343,allow,564,318,246,9,15,5,4
55344,53,18078,53,allow,208,106,102,2,31,1,1
50529,44847,0,0,deny,66,66,0,1,0,1,0
52831,445,0,0,drop,70,70,0,1,0,1,0
60991,445,0,0,drop,70,70,0,1,0,1,0
56759,445,0,0,drop,66,66,0,1,0,1,0
443,49988,0,0,deny,82,82,0,1,0,1,0
52780,53,38802,53,allow,338,94,244,2,30,1,1
6881,6881,0,0,deny,62,62,0,1,0,1,0
60206,445,0,0,drop,70,70,0,1,0,1,0
56376,44847,0,0,deny,62,62,0,1,0,1,0
50400,443,29231,443,allow,1124,594,530,12,26,6,6
13084,53,13084,53,allow,224,88,136,2,30,1,1
27005,27015,27620,27015,allow,880,126,754,2,30,1,1
65343,53,10337,53,allow,184,94,90,2,30,1,1
59857,445,0,0,drop,66,66,0,1,0,1,0
56549,443,22340,443,allow,13979,2593,11386,29,114,11,18
47105,64147,0,0,deny,62,62,0,1,0,1,0
52226,48784,24421,48784,allow,70,70,0,2,8,2,0
3585,64147,0,0,deny,62,62,0,1,0,1,0
56007,53,24693,53,allow,197,102,95,2,35,1,1
59894,443,37643,443,allow,1537,934,603,14,33,7,7
50520,80,14281,80,allow,1615,793,822,13,91,7,6
39297,443,49533,443,allow,9320,3888,5432,21,119,10,11
50262,443,64245,443,allow,11220,726,10494,18,75,8,10
49840,445,0,0,drop,66,66,0,1,0,1,0
54355,445,0,0,drop,66,66,0,1,0,1,0
53195,443,48069,443,allow,1462,965,497,13,18,7,6
57061,53,39332,53,allow,1780,674,1106,18,68,9,9
37965,47686,60898,47686,allow,480,149,331,2,1200,1,1
56318,53,47693,53,allow,183,94,89,2,31,1,1
63798,16357,31313,16357,allow,70,70,0,1,4,1,0
9230,443,20303,443,allow,6020,792,5228,18,25,9,9
52019,40689,48482,40689,allow,70,70,0,2,8,2,0
56776,445,0,0,drop,70,70,0,1,0,1,0
57599,80,57599,80,allow,60244,2829,57415,65,144,22,43
53092,443,35345,443,allow,7676,1577,6099,28,395,9,19
57587,443,15184,443,allow,7150,1958,5192,28,144,14,14
39570,62413,0,0,deny,146,146,0,1,0,1,0
58966,30188,0,0,deny,66,66,0,1,0,1,0
63927,53,2248,53,allow,374,101,273,4,33,2,2
56072,53,35892,53,allow,199,102,97,2,31,1,1
55869,53,64090,53,allow,196,102,94,2,30,1,1
57470,32554,26489,32554,allow,726,726,0,12,1199,12,0
58101,46314,0,0,deny,72,72,0,1,0,1,0
38643,443,11641,443,allow,1468,893,575,15,62,8,7
57671,445,0,0,drop,70,70,0,1,0,1,0
64912,53,33217,53,allow,183,94,89,2,31,1,1
35965,443,31855,443,allow,3821,2814,1007,22,17,12,10
50615,445,0,0,drop,70,70,0,1,0,1,0
53821,443,16981,443,allow,7980,1434,6546,24,19,13,11
64664,80,64664,80,allow,1921,1472,449,10,20,6,4
55698,45710,26352,45710,allow,70,70,0,2,8,2,0
22350,25174,0,0,deny,62,62,0,1,0,1,0
60533,445,0,0,drop,70,70,0,1,0,1,0
60075,41705,0,0,deny,62,62,0,1,0,1,0
17101,25174,0,0,deny,66,66,0,1,0,1,0
51887,16514,28256,16514,allow,70,70,0,1,5,1,0
49355,443,38735,443,allow,4960,896,4064,14,16,8,6
65146,445,0,0,drop,70,70,0,1,0,1,0
57598,80,57598,80,allow,40484,2008,38476,47,145,17,30
80,37649,0,0,deny,60,60,0,1,0,1,0
33457,27015,0,0,deny,67,67,0,1,0,1,0
55844,443,40826,443,allow,6881,2073,4808,37,255,18,19
63467,445,0,0,drop,70,70,0,1,0,1,0
64725,53,58713,53,allow,757,102,655,2,30,1,1
53237,80,8152,80,allow,194,128,66,4,55,3,1
63930,443,21272,443,allow,2940,669,2271,13,122,6,7
50254,53,7590,53,allow,749,94,655,2,30,1,1
49648,80,25450,80,allow,318,192,126,6,41,4,2
27005,52013,16949,52013,allow,901,126,775,2,30,1,1
60771,58414,0,0,deny,66,66,0,1,0,1,0
56633,53,19316,53,allow,197,102,95,2,30,1,1
63712,445,0,0,drop,66,66,0,1,0,1,0
65104,53,46686,53,allow,311,94,217,2,30,1,1
50482,443,21793,443,allow,2520,1267,1253,17,83,9,8
44673,80,44673,80,allow,1916,1467,449,10,20,6,4
50820,443,64516,443,allow,2760048,78471,2681577,2863,250,962,1901
41029,53,0,0,allow,86,86,0,1,29,1,0
57902,443,28629,443,allow,20509,7660,12849,54,131,28,26
61055,445,0,0,drop,70,70,0,1,0,1,0
443,64347,0,0,deny,131,131,0,1,0,1,0
50865,445,0,0,drop,70,70,0,1,0,1,0
56672,443,28399,443,allow,7888,1899,5989,20,15,11,9
47904,443,37875,443,allow,2766,1907,859,17,24,10,7
56040,445,0,0,drop,70,70,0,1,0,1,0
39771,80,39771,80,allow,17982,4308,13674,30,20,15,15
48443,53,3585,53,allow,168,78,90,2,30,1,1
50716,50584,0,0,deny,70,70,0,1,0,1,0
62508,445,0,0,drop,70,70,0,1,0,1,0
16001,48817,0,0,deny,143,143,0,1,0,1,0
60875,443,9147,443,allow,45373,35377,9996,88,72,48,40
59754,53,13358,53,allow,303,85,218,2,30,1,1
33040,443,3946,443,allow,118,118,0,1,30,1,0
57816,445,0,0,drop,70,70,0,1,0,1,0
59866,443,32010,443,allow,6135,843,5292,20,26,10,10
1057,57470,0,0,deny,62,62,0,1,0,1,0
57023,53,64217,53,allow,174,89,85,2,31,1,1
39915,443,9924,443,allow,15058,8409,6649,40,271,21,19
60515,445,0,0,drop,70,70,0,1,0,1,0
59626,22114,0,0,deny,62,62,0,1,0,1,0
55705,53,14171,53,allow,209,110,99,2,30,1,1
443,54507,0,0,deny,82,82,0,1,0,1,0
53822,18716,3913,18716,allow,70,70,0,2,8,2,0
13285,29892,0,0,deny,145,145,0,1,0,1,0
50450,80,35672,80,allow,2781,563,2218,11,125,6,5
14331,23,0,0,deny,60,60,0,1,0,1,0
27005,27017,10039,27017,allow,891,126,765,2,30,1,1
29011,32468,0,0,deny,66,66,0,1,0,1,0
53260,36237,0,0,deny,62,62,0,1,0,1,0
64287,53,8913,53,allow,280,91,189,4,33,2,2
63423,445,0,0,drop,66,66,0,1,0,1,0
53936,443,5510,443,allow,886,70,816,14,166,2,12
54892,445,0,0,drop,70,70,0,1,0,1,0
58815,445,0,0,drop,70,70,0,1,0,1,0
56906,53,34993,53,allow,167,86,81,2,31,1,1
55067,53,2725,53,allow,164,84,80,2,31,1,1
57386,443,57835,443,allow,1056,569,487,10,38,6,4
49734,53,51597,53,allow,259,110,149,2,30,1,1
40885,23,0,0,deny,60,60,0,1,0,1,0
57221,53,46489,53,allow,184,102,82,2,29,1,1
49905,53,31462,53,allow,180,94,86,2,29,1,1
48068,443,12098,443,allow,10418,1427,8991,27,16,12,15
7536,53,7536,53,allow,198,90,108,2,30,1,1
61276,445,0,0,drop,70,70,0,1,0,1,0
49513,80,22592,80,allow,476333,9582,466751,453,225,135,318
12346,53,12346,53,allow,216,98,118,2,30,1,1
51413,57470,0,0,deny,72,72,0,1,0,1,0
60420,2924,28301,2924,allow,320,140,180,6,7,3,3
51651,445,0,0,drop,66,66,0,1,0,1,0
40840,21247,0,0,deny,62,62,0,1,0,1,0
54681,443,46461,443,allow,4417,2187,2230,16,135,8,8
64238,53,6347,53,allow,215,102,113,2,30,1,1
60165,445,0,0,drop,70,70,0,1,0,1,0
6666,5000,0,0,deny,60,60,0,1,0,1,0
56412,445,0,0,drop,70,70,0,1,0,1,0
49969,53,53673,53,allow,789,102,687,2,30,1,1
63981,34250,53768,34250,allow,66,66,0,2,8,2,0
123,123,49669,123,allow,184,94,90,2,29,1,1
26833,443,13799,443,allow,21487,16430,5057,39,21,22,17
58724,43890,0,0,deny,66,66,0,1,0,1,0
55312,53,28336,53,allow,195,102,93,2,31,1,1
53641,16605,38186,16605,allow,70,70,0,2,7,2,0
61463,443,9374,443,allow,11355,3474,7881,45,93,22,23
58508,443,23694,443,allow,3386,1894,1492,20,25,10,10
57676,64147,0,0,deny,74,74,0,1,0,1,0
57470,44224,31554,44224,allow,480,149,331,2,1200,1,1
59750,53,24886,53,allow,304,86,218,2,29,1,1
51955,39871,39902,39871,allow,70,70,0,1,5,1,0
56654,445,0,0,drop,70,70,0,1,0,1,0
56219,53,57925,53,allow,177,94,83,2,30,1,1
35615,443,10957,443,allow,6179,1242,4937,22,42,11,11
16168,23,0,0,deny,60,60,0,1,0,1,0
37614,53,37614,53,allow,209,98,111,2,30,1,1
50021,445,0,0,drop,70,70,0,1,0,1,0
56799,80,63768,80,allow,1514,481,1033,11,15,6,5
51689,993,61833,993,allow,11580,4032,7548,79,19,40,39
55286,53,22334,53,allow,194,102,92,2,31,1,1
53771,57470,0,0,deny,66,66,0,1,0,1,0
49225,53,55909,53,allow,295,101,194,4,49,2,2
45939,443,45939,443,allow,4504,1597,2907,19,27,11,8
45079,31573,0,0,deny,62,62,0,1,0,1,0
49367,445,0,0,drop,70,70,0,1,0,1,0
49229,53,54866,53,allow,178,94,84,2,29,1,1
54399,445,0,0,drop,70,70,0,1,0,1,0
62488,445,0,0,drop,66,66,0,1,0,1,0
56892,53,3600,53,allow,198,101,97,2,31,1,1
57467,443,57467,443,allow,4373,1466,2907,19,27,11,8
30960,45763,2134,45763,allow,330,330,0,6,3609,6,0
39612,443,50624,443,allow,482030,16677,465353,539,28,207,332
10061,443,5696,443,allow,4984,892,4092,18,185,9,9
64968,53,11604,53,allow,448,98,350,4,41,2,2
15503,61471,17657,61471,allow,490,149,341,2,1200,1,1
65045,53,47072,53,allow,755,94,661,2,30,1,1
26750,57470,0,0,deny,66,66,0,1,0,1,0
61496,445,0,0,drop,70,70,0,1,0,1,0
49932,53,48698,53,allow,190,97,93,2,30,1,1
52288,445,0,0,drop,70,70,0,1,0,1,0
51915,35068,4331,35068,allow,316,136,180,6,6,3,3
50586,445,0,0,drop,70,70,0,1,0,1,0
57371,53,9888,53,allow,755,93,662,2,31,1,1
26301,22114,0,0,deny,62,62,0,1,0,1,0
2064,22114,0,0,deny,62,62,0,1,0,1,0
56260,53,30984,53,allow,177,94,83,2,31,1,1
49742,53,36313,53,allow,216,110,106,2,30,1,1
58376,445,0,0,drop,66,66,0,1,0,1,0
65292,53,37185,53,allow,195,102,93,2,30,1,1
65205,445,0,0,drop,70,70,0,1,0,1,0
27005,33070,6671,33070,allow,883,126,757,2,31,1,1
65099,445,0,0,drop,70,70,0,1,0,1,0
58638,5900,0,0,deny,62,62,0,1,0,1,0
60782,20010,25511,20010,allow,70,70,0,1,5,1,0
62210,445,0,0,drop,70,70,0,1,0,1,0
64987,445,0,0,drop,70,70,0,1,0,1,0
53665,29135,50493,29135,allow,70,70,0,2,8,2,0
53670,53,0,0,allow,82,82,0,1,30,1,0
14697,8000,59482,8000,allow,212,150,62,2,30,1,1
59350,443,59350,443,allow,4401,1494,2907,19,27,11,8
63421,44847,0,0,deny,66,66,0,1,0,1,0
22547,48817,0,0,deny,72,72,0,1,0,1,0
52094,443,44037,443,allow,2983,1667,1316,25,153,12,13
5121,35440,0,0,deny,62,62,0,1,0,1,0
44886,443,1331,443,allow,7775,2973,4802,36,57,19,17
61315,48817,0,0,deny,62,62,0,1,0,1,0
63259,445,0,0,drop,70,70,0,1,0,1,0
65444,80,16519,80,allow,486,240,246,9,28,5,4
60378,443,38205,443,allow,130,70,60,2,15,1,1
57312,53,43620,53,allow,208,106,102,2,30,1,1
65051,445,0,0,drop,70,70,0,1,0,1,0
54547,445,0,0,drop,70,70,0,1,0,1,0
50130,53,58704,53,allow,183,94,89,2,29,1,1
62255,445,0,0,drop,70,70,0,1,0,1,0
50325,445,0,0,drop,66,66,0,1,0,1,0
47739,5228,19332,5228,allow,2852,2143,709,16,121,8,8
50859,443,27316,443,allow,6886,1380,5506,19,132,9,10
58638,5900,0,0,deny,62,62,0,1,0,1,0
49722,443,18328,443,allow,9698,3026,6672,54,618,27,27
64686,53,28216,53,allow,811,94,717,2,30,1,1
54994,53,62711,53,allow,209,110,99,2,30,1,1
60306,445,0,0,drop,66,66,0,1,0,1,0
50169,25174,0,0,deny,62,62,0,1,0,1,0
1030,44847,0,0,deny,62,62,0,1,0,1,0
65300,53,9182,53,allow,195,102,93,2,31,1,1
50164,445,0,0,drop,66,66,0,1,0,1,0
58605,445,0,0,drop,70,70,0,1,0,1,0
55905,53,39225,53,allow,754,94,660,2,30,1,1
63765,3389,63765,3389,allow,3444,1730,1714,16,33,8,8
56436,445,0,0,drop,66,66,0,1,0,1,0
63714,445,0,0,drop,70,70,0,1,0,1,0
9510,443,20445,443,allow,3615,435,3180,11,15,6,5
52146,80,22638,80,allow,1868,1374,494,12,16,7,5
50251,35440,0,0,deny,66,66,0,1,0,1,0
60977,443,59690,443,allow,275026,15030,259996,353,72,167,186
60351,50584,0,0,deny,66,66,0,1,0,1,0
49452,53,60984,53,allow,244,110,134,2,30,1,1
56000,53,40530,53,allow,170,87,83,2,31,1,1
50028,443,29629,443,allow,15425,9901,5524,33,84,17,16
56337,53,46173,53,allow,268,89,179,4,45,2,2
41958,5222,34545,5222,allow,2380,1500,880,24,130,13,11
59285,445,0,0,drop,70,70,0,1,0,1,0
50162,445,0,0,drop,70,70,0,1,0,1,0
62068,445,0,0,drop,70,70,0,1,0,1,0
61501,445,0,0,drop,70,70,0,1,0,1,0
2541,51505,0,0,deny,66,66,0,1,0,1,0
53342,445,0,0,drop,70,70,0,1,0,1,0
54973,445,0,0,drop,70,70,0,1,0,1,0
57470,43155,32052,43155,allow,594,594,0,10,1199,10,0
53568,443,10135,443,allow,12646,7169,5477,53,198,25,28
53266,443,29507,443,allow,30264,2794,27470,47,322,19,28
60078,80,2527,80,allow,1114,534,580,12,15,7,5
49951,80,47463,80,allow,38898,1623,37275,49,15,21,28
16086,6881,0,0,deny,146,146,0,1,0,1,0
61846,445,0,0,drop,70,70,0,1,0,1,0
3456,11392,0,0,deny,66,66,0,1,0,1,0
36939,80,43312,80,allow,5733,3036,2697,25,235,9,16
63580,445,0,0,drop,70,70,0,1,0,1,0
443,44138,0,0,deny,60,60,0,1,0,1,0
45964,2225,0,0,deny,60,60,0,1,0,1,0
443,15564,0,0,deny,85,85,0,1,0,1,0
49913,443,31997,443,allow,5570,901,4669,16,27,8,8
12364,80,12364,80,allow,7282,653,6629,16,16,8,8
12348,50265,0,0,deny,62,62,0,1,0,1,0
57315,445,0,0,drop,70,70,0,1,0,1,0
58939,445,0,0,drop,66,66,0,1,0,1,0
54167,445,0,0,drop,70,70,0,1,0,1,0
35864,44847,0,0,deny,78,78,0,1,0,1,0
62550,51505,0,0,deny,66,66,0,1,0,1,0
53123,443,38611,443,allow,1630,1089,541,14,15,8,6
65487,443,51445,443,allow,3641,886,2755,13,136,6,7
62670,445,0,0,drop,70,70,0,1,0,1,0
47820,443,39799,443,allow,1132,596,536,17,28,9,8
59753,27016,15718,27016,allow,1718,1386,332,8,30,4,4
53724,53,53724,53,allow,268,114,154,2,29,1,1
55545,53,34965,53,allow,196,100,96,3,33,2,1
53260,443,48140,443,allow,4885,983,3902,21,53,10,11
50932,443,17054,443,allow,167483,7402,160081,221,23,93,128
64555,53,10175,53,allow,469,97,372,4,49,2,2
63878,50829,35363,50829,allow,70,70,0,1,5,1,0
64383,443,47790,443,allow,4017,978,3039,14,53,8,6
31780,11392,0,0,deny,146,146,0,1,0,1,0
49163,53,27365,53,allow,167,86,81,2,31,1,1
52430,22114,0,0,deny,62,62,0,1,0,1,0
49229,53,40938,53,allow,183,94,89,2,29,1,1
23383,64147,0,0,deny,62,62,0,1,0,1,0
5588,5588,0,0,allow,3562,1936,1626,48,196,24,24
53950,123,31431,123,allow,184,94,90,2,30,1,1
58154,445,0,0,drop,66,66,0,1,0,1,0
49480,53,58009,53,allow,184,94,90,2,31,1,1
49180,443,17664,443,allow,888019,22655,865364,902,18,322,580
50350,445,0,0,drop,66,66,0,1,0,1,0
11878,37807,0,0,deny,62,62,0,1,0,1,0
58935,445,0,0,drop,66,66,0,1,0,1,0
32787,80,54491,80,allow,1412,848,564,14,316,8,6
46525,53,46525,53,allow,404,259,145,3,32,2,1
63950,443,48115,443,allow,5844,2360,3484,25,127,12,13
58229,50584,0,0,deny,66,66,0,1,0,1,0
40911,443,37854,443,allow,11095,2599,8496,45,257,22,23
65147,53,28135,53,allow,763,101,662,2,30,1,1
6666,50070,0,0,deny,60,60,0,1,0,1,0
17842,22114,0,0,deny,62,62,0,1,0,1,0
59277,445,0,0,drop,66,66,0,1,0,1,0
52170,80,60754,80,allow,362,240,122,7,17,5,2
64940,36237,0,0,deny,62,62,0,1,0,1,0
9296,443,44194,443,allow,3792,488,3304,14,16,7,7
65201,53,38349,53,allow,216,110,106,2,30,1,1
59068,49813,0,0,deny,70,70,0,1,0,1,0
50360,35440,0,0,deny,62,62,0,1,0,1,0
49582,53,29592,53,allow,168,78,90,2,30,1,1
9197,80,56702,80,allow,1701,883,818,14,26,7,7
58668,445,0,0,drop,70,70,0,1,0,1,0
19204,57866,0,0,deny,66,66,0,1,0,1,0
63438,445,0,0,drop,66,66,0,1,0,1,0
60184,443,18301,443,allow,3915,1934,1981,14,122,7,7
35408,56205,0,0,deny,66,66,0,1,0,1,0
55778,53,21245,53,allow,189,102,87,2,29,1,1
14667,80,14667,80,allow,3197,2167,1030,17,72,10,7
39348,443,17067,443,allow,28301,21778,6523,88,125,49,39
51129,80,6520,80,allow,2794,2075,719,15,30,9,6
51480,3027,51480,3027,allow,156,156,0,3,8,3,0
55431,443,58607,443,allow,999955,25445,974510,1003,171,325,678
55579,58420,44629,58420,allow,70,70,0,1,5,1,0
52459,33890,0,0,deny,60,60,0,1,0,1,0
1030,44847,0,0,deny,62,62,0,1,0,1,0
63364,57470,0,0,deny,66,66,0,1,0,1,0
65070,53,12563,53,allow,198,102,96,2,30,1,1
41641,443,28317,443,allow,13106,6413,6693,24,121,12,12
57903,80,16780,80,allow,6457,1210,5247,14,17,8,6
44014,53,29782,53,allow,199,94,105,2,30,1,1
64322,53,37052,53,allow,273,90,183,4,32,2,2
40806,443,37490,443,allow,3287,2049,1238,12,31,7,5
60684,53,9516,53,allow,199,94,105,2,30,1,1
28040,443,50475,443,allow,5578,1390,4188,19,15,9,10
56717,53,2347,53,allow,178,94,84,2,30,1,1
443,7387,0,0,deny,60,60,0,1,0,1,0
37656,443,58778,443,allow,9875,3479,6396,29,46,17,12
30960,45759,38428,45759,allow,330,330,0,6,3609,6,0
57653,445,0,0,drop,70,70,0,1,0,1,0
65319,80,8384,80,allow,2284,484,1800,10,133,6,4
57510,443,62415,443,allow,16532,2229,14303,26,133,11,15
49743,53,1715,53,allow,210,94,116,2,30,1,1
6929,35440,0,0,deny,62,62,0,1,0,1,0
53874,445,0,0,drop,70,70,0,1,0,1,0
55784,53,32669,53,allow,184,94,90,2,30,1,1
63962,53,53078,53,allow,188,96,92,2,31,1,1
51893,63924,11081,63924,allow,70,70,0,2,8,2,0
55417,53,34497,53,allow,198,102,96,2,33,1,1
45428,80,14591,80,allow,350,210,140,6,28,4,2
38446,443,2799,443,allow,46008,3750,42258,77,48,39,38
49568,445,0,0,drop,66,66,0,1,0,1,0
57323,53,38814,53,allow,194,102,92,2,31,1,1
57092,445,0,0,drop,66,66,0,1,0,1,0
57378,53,2616,53,allow,756,95,661,2,31,1,1
23553,37965,0,0,deny,62,62,0,1,0,1,0
49324,443,52610,443,allow,6147,943,5204,17,16,9,8
65028,53,37363,53,allow,79,79,0,2,33,2,0
50259,445,0,0,drop,70,70,0,1,0,1,0
54445,443,28246,443,allow,2782,1778,1004,20,33,10,10
61700,443,65174,443,allow,12613,2946,9667,38,50,18,20
64983,53,54706,53,allow,181,94,87,2,30,1,1
12283,25773,0,0,reset-both,139,139,0,1,0,1,0
51426,47563,0,0,deny,100,100,0,1,0,1,0
47944,50584,0,0,deny,146,146,0,1,0,1,0
20939,60461,0,0,deny,60,60,0,1,0,1,0
43888,64147,0,0,deny,62,62,0,1,0,1,0
61683,445,0,0,drop,70,70,0,1,0,1,0
51830,32787,47434,32787,allow,70,70,0,2,6,2,0
53500,1,0,0,deny,66,66,0,1,0,1,0
60772,36829,0,0,deny,66,66,0,1,0,1,0
60492,443,48948,443,allow,81016,8373,72643,122,339,57,65
25342,8168,0,0,deny,66,66,0,1,0,1,0
64318,53,51027,53,allow,183,94,89,2,30,1,1
42382,443,39819,443,allow,4844,1099,3745,18,25,10,8
54538,80,35235,80,allow,4162,3455,707,14,15,8,6
30188,58770,26804,58770,allow,14172,5733,8439,79,1531,37,42
52427,42873,0,0,deny,66,66,0,1,0,1,0
56601,443,39654,443,allow,8978,3243,5735,22,45,13,9
64254,53,25297,53,allow,211,78,133,2,30,1,1
55160,443,10978,443,allow,333522,14341,319181,347,129,109,238
55958,53,14434,53,allow,177,94,83,2,30,1,1
49396,80,45610,80,allow,13738839,196158,13542681,11272,248,2231,9041
55530,445,0,0,drop,70,70,0,1,0,1,0
34083,22,0,0,deny,60,60,0,1,0,1,0
63237,445,0,0,drop,70,70,0,1,0,1,0
48681,11392,0,0,deny,146,146,0,1,0,1,0
62776,62413,0,0,deny,62,62,0,1,0,1,0
45941,23386,0,0,deny,60,60,0,1,0,1,0
62949,37965,0,0,deny,62,62,0,1,0,1,0
64199,445,0,0,drop,70,70,0,1,0,1,0
60446,445,0,0,drop,66,66,0,1,0,1,0
56988,53,25747,53,allow,216,110,106,2,30,1,1
56515,995,45992,995,allow,2901,1472,1429,27,17,12,15
64157,53,10043,53,allow,323,90,233,4,48,2,2
56946,443,38559,443,allow,10408,4790,5618,34,322,16,18
51933,53,51933,53,allow,253,106,147,2,30,1,1
46640,9002,46640,9002,allow,124,60,64,2,5,1,1
57239,53,63537,53,allow,186,95,91,2,31,1,1
50237,53,53638,53,allow,183,94,89,2,31,1,1
61040,443,61040,443,allow,4886,1530,3356,17,17,10,7
51107,445,0,0,drop,66,66,0,1,0,1,0
58248,50584,0,0,deny,66,66,0,1,0,1,0
58638,5900,0,0,deny,62,62,0,1,0,1,0
56942,443,55057,443,allow,8172,2656,5516,29,330,15,14
2072,7000,2072,7000,allow,3164,783,2381,15,16,7,8
42796,22114,0,0,deny,62,62,0,1,0,1,0
16424,55108,0,0,deny,145,145,0,1,0,1,0
56969,445,0,0,drop,66,66,0,1,0,1,0
64445,53,20808,53,allow,269,94,175,2,30,1,1
10151,1042,12380,1042,allow,490,149,341,2,1200,1,1
58045,443,63795,443,allow,3296,1329,1967,14,135,7,7
51056,445,0,0,drop,66,66,0,1,0,1,0
27988,40037,18791,40037,allow,568,78,490,2,29,1,1
40189,80,30791,80,allow,5043,1656,3387,18,205,10,8
65114,445,0,0,drop,70,70,0,1,0,1,0
52791,25174,0,0,deny,66,66,0,1,0,1,0
55577,53,64711,53,allow,198,101,97,2,31,1,1
57322,53,63683,53,allow,196,102,94,2,31,1,1
55489,445,0,0,drop,70,70,0,1,0,1,0
55490,80,37170,80,allow,186387,10616,175771,243,33,116,127
52217,22114,0,0,deny,66,66,0,1,0,1,0
57370,53,22264,53,allow,347,110,237,2,30,1,1
59732,445,0,0,drop,70,70,0,1,0,1,0
63220,445,0,0,drop,70,70,0,1,0,1,0
56033,443,32455,443,allow,3250,1058,2192,13,136,6,7
17873,23117,0,0,deny,66,66,0,1,0,1,0
45941,23388,0,0,deny,60,60,0,1,0,1,0
60403,60092,47131,60092,allow,70,70,0,2,8,2,0
43025,23,0,0,deny,60,60,0,1,0,1,0
56809,53,35484,53,allow,178,94,84,2,30,1,1
53450,445,0,0,drop,70,70,0,1,0,1,0
54914,445,0,0,drop,70,70,0,1,0,1,0
56357,53,47293,53,allow,196,102,94,2,30,1,1
57265,53,29608,53,allow,200,102,98,2,31,1,1
52544,443,52544,443,allow,4487,1580,2907,19,26,11,8
41981,443,19357,443,allow,5164,2984,2180,42,1285,26,16
62599,445,0,0,drop,66,66,0,1,0,1,0
50437,445,0,0,drop,66,66,0,1,0,1,0
55100,445,0,0,drop,70,70,0,1,0,1,0
59761,445,0,0,drop,66,66,0,1,0,1,0
48589,443,15567,443,allow,15400,9133,6267,40,272,22,18
59037,51505,0,0,deny,66,66,0,1,0,1,0
2844,3389,2844,3389,allow,4635,2460,2175,21,18,12,9
64172,53,61363,53,allow,361,99,262,4,54,2,2
65483,53,14095,53,allow,701,88,613,2,31,1,1
50689,443,64099,443,allow,180,60,120,4,15,2,2
51828,11916,54336,11916,allow,316,136,180,6,6,3,3
56628,445,0,0,drop,70,70,0,1,0,1,0
51835,29778,40587,29778,allow,70,70,0,1,5,1,0
27005,27015,58222,27015,allow,901,126,775,2,30,1,1
65282,53,57609,53,allow,522,91,431,4,49,2,2
56635,80,4559,80,allow,234,234,0,4,12,4,0
20850,53,20850,53,allow,245,98,147,2,30,1,1
49488,53,49488,53,allow,823,98,725,2,30,1,1
54617,445,0,0,drop,70,70,0,1,0,1,0
33246,443,57032,443,allow,8340,2896,5444,28,16,16,12
11552,44847,0,0,deny,62,62,0,1,0,1,0
49506,443,26865,443,allow,18260,2912,15348,30,28,11,19
56906,53,48411,53,allow,167,86,81,2,29,1,1
57646,443,57646,443,allow,4492,1585,2907,19,30,11,8
50676,80,23134,80,allow,13054,6885,6169,27,26,13,14
20689,53,20689,53,allow,237,91,146,2,33,1,1
54845,445,0,0,drop,66,66,0,1,0,1,0
53788,1,8231,1,allow,70,70,0,2,8,2,0
51806,49530,42413,49530,allow,66,66,0,1,5,1,0
51269,36983,55294,36983,allow,70,70,0,2,8,2,0
56229,53,1556,53,allow,173,94,79,2,30,1,1
54345,445,0,0,drop,66,66,0,1,0,1,0
31089,53,31089,53,allow,197,90,107,2,30,1,1
64689,53,18910,53,allow,182,93,89,2,31,1,1
64107,53,23798,53,allow,212,102,110,2,29,1,1
26332,57470,0,0,deny,62,62,0,1,0,1,0
63465,443,3023,443,allow,3942,1406,2536,18,135,8,10
50123,445,0,0,drop,70,70,0,1,0,1,0
53676,35974,0,0,deny,60,60,0,1,0,1,0
53816,445,0,0,drop,70,70,0,1,0,1,0
52588,443,7205,443,allow,3523,518,3005,12,15,6,6
26447,80,26447,80,allow,12599,1479,11120,28,16,15,13
64869,445,0,0,drop,70,70,0,1,0,1,0
51792,445,0,0,drop,70,70,0,1,0,1,0
62889,993,15893,993,allow,9608,4549,5059,88,199,45,43
64324,53,5232,53,allow,344,105,239,4,33,2,2
27005,27058,26884,27058,allow,908,126,782,2,31,1,1
40858,53,40858,53,allow,200,90,110,2,30,1,1
35610,80,8611,80,allow,1970,977,993,12,61,7,5
16979,56205,0,0,deny,66,66,0,1,0,1,0
61527,51050,0,0,deny,66,66,0,1,0,1,0
49564,80,48576,80,allow,318,192,126,6,45,4,2
57275,53,14863,53,allow,177,94,83,2,30,1,1
60385,445,0,0,drop,70,70,0,1,0,1,0
53036,445,0,0,drop,70,70,0,1,0,1,0
55810,53,12633,53,allow,182,93,89,2,30,1,1
56076,80,28614,80,allow,5055,3100,1955,34,17,28,6
54099,445,0,0,drop,70,70,0,1,0,1,0
59734,443,48585,443,allow,1312,651,661,13,184,7,6
62171,445,0,0,drop,66,66,0,1,0,1,0
49873,443,58284,443,allow,14476,2843,11633,45,55,22,23
53350,443,13931,443,allow,5987,2780,3207,21,140,10,11
54958,53,54115,53,allow,1413,85,1328,4,47,2,2
19623,25174,0,0,deny,62,62,0,1,0,1,0
54721,22114,0,0,deny,66,66,0,1,0,1,0
56784,443,32848,443,allow,7957,1968,5989,20,15,11,9
64200,53,60467,53,allow,186,95,91,2,30,1,1
56477,53,13759,53,allow,199,102,97,2,30,1,1
62799,25174,0,0,deny,146,146,0,1,0,1,0
65126,53,60546,53,allow,718,94,624,2,30,1,1
15503,3082,40195,3082,allow,480,149,331,2,1200,1,1
50231,445,0,0,drop,70,70,0,1,0,1,0
53812,45694,7999,45694,allow,3156,1011,2145,16,16,8,8
58638,5900,0,0,deny,62,62,0,1,0,1,0
41213,25174,0,0,deny,62,62,0,1,0,1,0
50542,445,0,0,drop,66,66,0,1,0,1,0
63981,53,11790,53,allow,199,102,97,2,30,1,1
60813,443,60813,443,allow,1386,751,635,15,182,8,7
59815,445,0,0,drop,66,66,0,1,0,1,0
52140,53155,46318,53155,allow,70,70,0,1,5,1,0
55724,445,0,0,drop,70,70,0,1,0,1,0
63948,80,9193,80,allow,314,192,122,6,15,4,2
35843,51505,0,0,deny,146,146,0,1,0,1,0
52966,80,53251,80,allow,2974,1352,1622,28,113,15,13
50,38211,0,0,deny,66,66,0,1,0,1,0
52502,445,0,0,drop,70,70,0,1,0,1,0
57885,443,33287,443,allow,1792,1153,639,17,177,10,7
56761,53,40671,53,allow,788,108,680,2,30,1,1
26079,53,52153,53,allow,226,78,148,2,29,1,1
60311,30627,0,0,deny,66,66,0,1,0,1,0
49418,32038,58741,32038,allow,235,78,157,2,30,1,1
50082,445,0,0,drop,70,70,0,1,0,1,0
27005,33035,15064,33035,allow,864,126,738,2,31,1,1
57401,53,55696,53,allow,179,94,85,2,31,1,1
58638,5900,0,0,deny,62,62,0,1,0,1,0
64723,445,0,0,drop,70,70,0,1,0,1,0
50970,80,61956,80,allow,11340,3061,8279,31,115,12,19
0,0,0,0,allow,244,244,0,2,0,2,0
40474,1488,40474,1488,allow,156,156,0,3,8,3,0
63867,64147,0,0,deny,62,62,0,1,0,1,0
59685,443,54976,443,allow,7747,1533,6214,27,31,13,14
56719,37807,0,0,deny,66,66,0,1,0,1,0
51953,62964,9503,62964,allow,316,136,180,6,5,3,3
63904,445,0,0,drop,70,70,0,1,0,1,0
57232,53,10597,53,allow,821,102,719,2,30,1,1
18172,23,0,0,deny,60,60,0,1,0,1,0
62273,50584,0,0,deny,62,62,0,1,0,1,0
52121,58933,11142,58933,allow,66,66,0,1,5,1,0
55236,53,12241,53,allow,819,102,717,2,29,1,1
49229,53,37715,53,allow,243,110,133,2,29,1,1
26900,27017,25587,27017,allow,422,164,258,6,30,3,3
55727,53,2697,53,allow,195,102,93,2,31,1,1
56847,53,25632,53,allow,225,86,139,2,30,1,1
49615,53,9854,53,allow,276,94,182,2,30,1,1
55417,53,15668,53,allow,179,94,85,2,31,1,1
42685,51180,0,0,deny,62,62,0,1,0,1,0
55223,1053,57960,1053,allow,1210,950,260,2,30,1,1
51008,80,51008,80,allow,114613,6365,108248,134,26,51,83
16057,51050,0,0,deny,66,66,0,1,0,1,0
49180,80,59682,80,allow,6158,654,5504,15,16,8,7
65403,53,51244,53,allow,178,94,84,2,30,1,1
9185,80,20640,80,allow,17855,1067,16788,26,35,11,15
27515,53,18456,53,allow,224,78,146,2,30,1,1
31727,57470,0,0,deny,62,62,0,1,0,1,0
50606,445,0,0,drop,70,70,0,1,0,1,0
49889,80,51133,80,allow,1376,946,430,8,87,5,3
57987,3478,50170,3478,allow,312,140,172,4,30,2,2
57073,57470,0,0,deny,62,62,0,1,0,1,0
56919,53,21784,53,allow,177,94,83,2,29,1,1
38632,443,3130,443,allow,9606,1228,8378,20,115,9,11
55833,53,54382,53,allow,170,87,83,2,31,1,1
51500,443,12798,443,allow,49843,3506,46337,77,16,39,38
59755,53,7532,53,allow,211,78,133,2,30,1,1
55919,53,46329,53,allow,177,94,83,2,31,1,1
55519,445,0,0,drop,70,70,0,1,0,1,0
59084,443,59084,443,allow,4598,1691,2907,19,30,11,8
64932,445,0,0,drop,70,70,0,1,0,1,0
50852,445,0,0,drop,70,70,0,1,0,1,0
53975,443,21855,443,allow,2845,1694,1151,18,125,10,8
49229,53,8820,53,allow,88,88,0,1,31,1,0
45373,443,33904,443,allow,33357,26315,7042,65,273,38,27
33201,443,28063,443,allow,21805,2081,19724,38,34,19,19
49634,443,7107,443,allow,1575,988,587,13,35,7,6
50084,26672,0,0,deny,62,62,0,1,0,1,0
53120,25174,0,0,deny,62,62,0,1,0,1,0
54998,53,17431,53,allow,711,87,624,2,30,1,1
27005,27023,20750,27023,allow,875,126,749,3,32,2,1
43275,443,50486,443,allow,9093,4719,4374,52,310,24,28
49874,445,0,0,drop,70,70,0,1,0,1,0
58513,445,0,0,drop,70,70,0,1,0,1,0
26752,64147,0,0,deny,62,62,0,1,0,1,0
55582,53,15587,53,allow,168,86,82,2,30,1,1
55689,37965,0,0,deny,66,66,0,1,0,1,0
58835,17372,0,0,deny,66,66,0,1,0,1,0
45754,443,17919,443,allow,1625,1038,587,14,25,8,6
52361,53,7907,53,allow,186,78,108,2,29,1,1
11450,57470,0,0,deny,66,66,0,1,0,1,0
59813,445,0,0,drop,70,70,0,1,0,1,0
16429,56205,0,0,deny,146,146,0,1,0,1,0
63698,59517,14181,59517,allow,504,382,122,8,15,6,2
52907,445,0,0,drop,66,66,0,1,0,1,0
45682,1,0,0,deny,62,62,0,1,0,1,0
64572,53,23687,53,allow,561,104,457,4,57,2,2
55514,445,0,0,drop,70,70,0,1,0,1,0
64083,63666,39336,63666,allow,70,70,0,1,4,1,0
50668,80,30546,80,allow,24370,5713,18657,37,26,17,20
51702,33451,34580,33451,allow,70,70,0,1,5,1,0
39524,10104,0,0,deny,137,137,0,1,0,1,0
51944,56205,0,0,deny,66,66,0,1,0,1,0
61785,64147,0,0,deny,66,66,0,1,0,1,0
52253,443,52253,443,allow,429263,14390,414873,449,24,159,290
60192,35440,0,0,deny,66,66,0,1,0,1,0
19875,30170,0,0,deny,145,145,0,1,0,1,0
56690,53,19054,53,allow,802,104,698,2,30,1,1
58638,5900,0,0,deny,62,62,0,1,0,1,0
64804,445,0,0,drop,70,70,0,1,0,1,0
64558,53,57812,53,allow,321,102,219,2,31,1,1
50208,1688,32119,1688,allow,70,70,0,2,8,2,0
36417,443,45000,443,allow,3579,1914,1665,23,291,8,15
53676,445,0,0,drop,66,66,0,1,0,1,0
46295,443,56188,443,allow,7493,3793,3700,40,109,26,14
64767,51221,0,0,deny,62,62,0,1,0,1,0
61711,445,0,0,drop,70,70,0,1,0,1,0
8889,64500,0,0,deny,60,60,0,1,0,1,0
26889,50265,0,0,deny,62,62,0,1,0,1,0
6014,37965,0,0,deny,62,62,0,1,0,1,0
49418,27015,34023,27015,allow,249,71,178,2,30,1,1
60381,26312,40513,26312,allow,70,70,0,1,5,1,0
53584,62974,57251,62974,allow,70,70,0,1,5,1,0
56843,443,16451,443,allow,54661,36820,17841,266,201,128,138
55208,53,2198,53,allow,177,94,83,2,30,1,1
49325,41615,0,0,deny,157,157,0,1,0,1,0
50218,53,36162,53,allow,165,86,79,2,31,1,1
46265,7700,48956,7700,allow,1440,956,484,15,35,8,7
443,50238,0,0,deny,331,331,0,1,0,1,0
59033,445,0,0,drop,70,70,0,1,0,1,0
65345,53,26359,53,allow,782,105,677,2,31,1,1
64627,53,17603,53,allow,198,101,97,2,30,1,1
1067,51221,0,0,deny,62,62,0,1,0,1,0
50903,445,0,0,drop,70,70,0,1,0,1,0
51830,42707,0,0,deny,66,66,0,1,0,1,0
57354,53,55769,53,allow,767,102,665,2,30,1,1
56141,53,30553,53,allow,184,94,90,2,30,1,1
56775,20617,28248,20617,allow,70,70,0,2,8,2,0
36716,53,54815,53,allow,224,78,146,2,31,1,1
65388,445,0,0,drop,66,66,0,1,0,1,0
49418,27015,50177,27015,allow,78,78,0,1,30,1,0
51009,80,51009,80,allow,450,246,204,8,25,5,3
123,123,15177,123,allow,184,94,90,2,30,1,1
61800,445,0,0,drop,70,70,0,1,0,1,0
6247,51221,0,0,deny,78,78,0,1,0,1,0
49036,44847,0,0,deny,62,62,0,1,0,1,0
63035,443,45890,443,allow,304,86,218,2,29,1,1
55721,445,0,0,drop,70,70,0,1,0,1,0
53771,53,15804,53,allow,168,78,90,2,30,1,1
57263,445,0,0,drop,70,70,0,1,0,1,0
37523,443,28556,443,allow,154,94,60,2,4,1,1
53089,24211,0,0,deny,62,62,0,1,0,1,0
27005,27016,52967,27016,allow,879,126,753,2,30,1,1
64811,445,0,0,drop,70,70,0,1,0,1,0
58338,3353,0,0,deny,60,60,0,1,0,1,0
50544,445,0,0,drop,66,66,0,1,0,1,0
54754,50432,0,0,deny,66,66,0,1,0,1,0
54240,445,0,0,drop,70,70,0,1,0,1,0
44911,80,9577,80,allow,1492,1050,442,7,15,5,2
58638,5900,0,0,deny,62,62,0,1,0,1,0
64052,443,61598,443,allow,4395,1673,2722,14,119,7,7
46597,53,0,0,allow,86,86,0,1,30,1,0
49864,53,25609,53,allow,186,95,91,2,31,1,1
31859,33909,0,0,deny,62,62,0,1,0,1,0
49752,53,10768,53,allow,193,102,91,2,29,1,1
58638,5900,0,0,deny,62,62,0,1,0,1,0
53486,443,39031,443,allow,8879,2420,6459,32,255,17,15
56370,443,46541,443,allow,3715,1791,1924,23,203,12,11
65507,53,1633,53,allow,177,94,83,2,30,1,1
64535,53,14565,53,allow,763,101,662,2,30,1,1
55724,45682,40719,45682,allow,70,70,0,2,8,2,0
50116,22,50116,22,allow,66,66,0,1,5,1,0
49560,445,0,0,drop,70,70,0,1,0,1,0
15581,46713,0,0,deny,66,66,0,1,0,1,0
57342,443,57537,443,allow,10761,5724,5037,43,15,25,18
58345,24748,0,0,deny,148,148,0,1,0,1,0
1847,64147,0,0,deny,62,62,0,1,0,1,0
64709,53,11434,53,allow,821,102,719,2,30,1,1
53551,445,0,0,drop,66,66,0,1,0,1,0
61911,50432,0,0,deny,146,146,0,1,0,1,0
51446,3033,0,0,deny,100,100,0,1,0,1,0
15581,46713,0,0,deny,66,66,0,1,0,1,0
52502,445,0,0,drop,70,70,0,1,0,1,0
27005,27013,56795,27013,allow,879,126,753,2,30,1,1
50198,445,0,0,drop,66,66,0,1,0,1,0
53795,443,29582,443,allow,499,425,74,4,0,3,1
31500,1,0,0,deny,146,146,0,1,0,1,0
1534,54369,0,0,deny,66,66,0,1,0,1,0
36325,443,45107,443,allow,2930,1614,1316,16,249,9,7
49696,445,0,0,drop,66,66,0,1,0,1,0
33877,53,33877,53,allow,643,88,555,2,31,1,1
57470,20015,34460,20015,allow,150,150,0,1,1199,1,0
52932,443,50755,443,allow,3032,1082,1950,9,120,5,4
56557,443,11082,443,allow,36053,3513,32540,54,96,25,29
55003,53,40085,53,allow,196,102,94,2,30,1,1
60376,80,60376,80,allow,180425,10839,169586,213,33,93,120
56422,53,35743,53,allow,190,97,93,2,31,1,1
65392,445,0,0,drop,66,66,0,1,0,1,0
49274,53,46367,53,allow,194,99,95,2,31,1,1
43298,53,31678,53,allow,199,94,105,2,30,1,1
56012,445,0,0,drop,70,70,0,1,0,1,0
42101,443,25094,443,allow,4904,1934,2970,17,135,8,9
56502,445,0,0,drop,66,66,0,1,0,1,0
53783,443,19626,443,allow,499,425,74,4,0,3,1
55165,445,0,0,drop,66,66,0,1,0,1,0
49418,27015,26438,27015,allow,78,78,0,1,30,1,0
57874,26467,0,0,deny,62,62,0,1,0,1,0
64242,53,41761,53,allow,180,94,86,2,30,1,1
51715,443,35378,443,allow,4175264,89546,4085718,4141,532,1111,3030
50312,80,40765,80,allow,2699,1007,1692,14,64,7,7
34993,15503,0,0,deny,62,62,0,1,0,1,0
2021,44847,0,0,deny,66,66,0,1,0,1,0
50538,445,0,0,drop,66,66,0,1,0,1,0
38644,1723,38644,1723,allow,146,60,86,2,9,1,1
56647,443,45722,443,allow,8059,2039,6020,20,15,11,9
60738,445,0,0,drop,70,70,0,1,0,1,0
58424,443,8670,443,allow,81295,4140,77155,114,117,42,72
45652,10214,0,0,deny,62,62,0,1,0,1,0
8069,80,8069,80,allow,638,306,332,11,84,6,5
42277,443,42277,443,allow,2200,1253,947,23,76,12,11
60765,445,0,0,drop,70,70,0,1,0,1,0
63069,445,0,0,drop,70,70,0,1,0,1,0
49539,53,25645,53,allow,177,94,83,2,30,1,1
36313,443,38446,443,allow,55608,48375,7233,140,95,81,59
55542,445,0,0,drop,70,70,0,1,0,1,0
40481,22114,0,0,deny,66,66,0,1,0,1,0
33528,23,0,0,deny,60,60,0,1,0,1,0
55193,53,3630,53,allow,533,102,431,4,42,2,2
40737,443,35009,443,allow,44004,3909,40095,80,135,38,42
55386,445,0,0,drop,70,70,0,1,0,1,0
53617,1056,21327,1056,allow,320,140,180,6,6,3,3
55458,445,0,0,drop,70,70,0,1,0,1,0
52059,445,0,0,drop,70,70,0,1,0,1,0
51517,445,0,0,drop,70,70,0,1,0,1,0
60696,445,0,0,drop,66,66,0,1,0,1,0
50056,27018,7128,27018,allow,468,390,78,5,30,4,1
52140,80,9768,80,allow,3476,1433,2043,26,418,14,12
58445,17500,0,0,deny,66,66,0,1,0,1,0
65325,53,48288,53,allow,216,110,106,2,30,1,1
64581,53,7849,53,allow,514,88,426,4,42,2,2
57433,21247,0,0,deny,66,66,0,1,0,1,0
43632,80,17222,80,allow,2000,710,1290,8,15,5,3
63916,445,0,0,drop,70,70,0,1,0,1,0
60115,443,39754,443,allow,268,120,148,5,10,3,2
46299,443,43257,443,allow,648083,28117,619966,751,30,323,428
49477,53,9524,53,allow,271,88,183,4,59,2,2
41311,443,64855,443,allow,70,70,0,1,5,1,0
50562,443,27211,443,allow,1313,876,437,11,27,6,5
50352,445,0,0,drop,66,66,0,1,0,1,0
58638,5900,0,0,deny,62,62,0,1,0,1,0
53812,443,40871,443,allow,2966,801,2165,13,135,6,7
54033,443,51149,443,allow,43491,8521,34970,69,50,34,35
51413,10387,0,0,deny,139,139,0,1,0,1,0
52091,445,0,0,drop,66,66,0,1,0,1,0
65134,53,41256,53,allow,273,102,171,2,30,1,1
51922,80,2848,80,allow,52962,3994,48968,71,27,32,39
50219,445,0,0,drop,70,70,0,1,0,1,0
55444,53,60851,53,allow,193,102,91,2,30,1,1
50620,443,5914,443,allow,1277,851,426,12,92,7,5
47944,50584,0,0,deny,62,62,0,1,0,1,0
60334,443,17024,443,allow,7506,4789,2717,28,130,16,12
61231,443,59948,443,allow,1864,250,1614,8,121,4,4
61527,443,62594,443,allow,17161,1619,15542,18,143,4,14
59965,36237,0,0,deny,62,62,0,1,0,1,0
34932,38608,0,0,deny,62,62,0,1,0,1,0
56266,53,40991,53,allow,166,86,80,2,31,1,1
49735,443,18914,443,allow,1143,672,471,12,129,7,5
61804,51505,0,0,deny,66,66,0,1,0,1,0
62514,37807,0,0,deny,66,66,0,1,0,1,0
50582,53,45109,53,allow,216,110,106,2,30,1,1
51992,443,50696,443,allow,1083,596,487,11,16,7,4
57528,53,37207,53,allow,585,192,393,6,54,3,3
56654,443,1981,443,allow,8007,1987,6020,20,15,11,9
65260,53,63253,53,allow,184,94,90,2,30,1,1
52575,445,0,0,drop,70,70,0,1,0,1,0
63776,445,0,0,drop,66,66,0,1,0,1,0
63717,37965,0,0,deny,62,62,0,1,0,1,0
58264,44847,0,0,deny,66,66,0,1,0,1,0
49756,445,0,0,drop,70,70,0,1,0,1,0
18517,31652,0,0,reset-both,62,62,0,1,0,1,0
61335,445,0,0,drop,66,66,0,1,0,1,0
64874,445,0,0,drop,66,66,0,1,0,1,0
54142,20541,0,0,deny,66,66,0,1,0,1,0
55944,53,13576,53,allow,194,94,100,2,30,1,1
54017,443,16478,443,allow,33220,3819,29401,77,255,39,38
39166,53,0,0,allow,82,82,0,1,31,1,0
60342,36237,0,0,deny,66,66,0,1,0,1,0
52297,80,4278,80,allow,1061,574,487,13,256,7,6
51920,32678,45180,32678,allow,70,70,0,2,8,2,0
0,0,0,0,deny,70,70,0,1,0,1,0
53551,445,0,0,drop,70,70,0,1,0,1,0
64670,53,61851,53,allow,193,102,91,2,29,1,1
54997,443,59177,443,allow,10817,4402,6415,31,23,17,14
64551,2310,0,0,deny,143,143,0,1,0,1,0
3911,50584,0,0,deny,62,62,0,1,0,1,0
55955,53,59392,53,allow,164,86,78,2,30,1,1
29268,53,40863,53,allow,220,78,142,2,30,1,1
12143,56205,0,0,deny,62,62,0,1,0,1,0
55244,445,0,0,drop,70,70,0,1,0,1,0
52413,53,24477,53,allow,168,78,90,2,30,1,1
55026,53,14938,53,allow,177,94,83,2,30,1,1
37234,44847,0,0,deny,62,62,0,1,0,1,0
56169,53,29884,53,allow,749,94,655,2,30,1,1
55865,64147,0,0,deny,66,66,0,1,0,1,0
49306,443,46343,443,allow,83411,4586,78825,94,47,30,64
60756,445,0,0,drop,66,66,0,1,0,1,0
52614,44847,0,0,deny,66,66,0,1,0,1,0
51712,445,0,0,drop,70,70,0,1,0,1,0
48857,50584,0,0,deny,66,66,0,1,0,1,0
65257,53,51798,53,allow,266,110,156,2,30,1,1
57242,443,22643,443,allow,291104,18601,272503,413,77,186,227
64029,38651,25596,38651,allow,70,70,0,1,4,1,0
51852,80,36581,80,allow,182,60,122,4,29,2,2
56536,53,64182,53,allow,209,110,99,2,30,1,1
41164,443,60993,443,allow,8949,1938,7011,21,17,12,9
54963,445,0,0,drop,70,70,0,1,0,1,0
64823,53,48646,53,allow,210,102,108,2,30,1,1
60612,445,0,0,drop,70,70,0,1,0,1,0
50356,443,55689,443,allow,505625,19174,486451,584,143,204,380
65280,445,0,0,drop,66,66,0,1,0,1,0
61060,53,61060,53,allow,257,106,151,2,30,1,1
8999,15503,0,0,deny,146,146,0,1,0,1,0
0,0,0,0,deny,98,98,0,1,0,1,0
52231,445,0,0,drop,66,66,0,1,0,1,0
58354,445,0,0,drop,66,66,0,1,0,1,0
55326,53,7571,53,allow,177,94,83,2,30,1,1
37234,443,63563,443,allow,1622,1137,485,11,26,7,4
55669,62781,37625,62781,allow,320,140,180,6,7,3,3
63379,36237,0,0,deny,66,66,0,1,0,1,0
52751,443,8615,443,allow,5378,984,4394,18,17,10,8
65447,53,45832,53,allow,756,95,661,2,31,1,1
61470,443,10942,443,allow,12420,4900,7520,47,88,24,23
52017,26175,18735,26175,allow,70,70,0,2,9,2,0
31066,57470,0,0,deny,74,74,0,1,0,1,0
50543,445,0,0,drop,70,70,0,1,0,1,0
36101,53,61383,53,allow,168,78,90,2,30,1,1
60207,80,10851,80,allow,3596,2562,1034,14,151,8,6
61363,80,43167,80,allow,1931,752,1179,15,16,8,7
60861,25174,0,0,deny,66,66,0,1,0,1,0
8999,15503,0,0,deny,146,146,0,1,0,1,0
60476,445,0,0,drop,70,70,0,1,0,1,0
55647,61042,18333,61042,allow,320,140,180,6,7,3,3
33571,443,51011,443,allow,4281,1160,3121,12,122,6,6
24949,47224,0,0,deny,145,145,0,1,0,1,0
42108,23,0,0,deny,60,60,0,1,0,1,0
49690,50265,0,0,deny,66,66,0,1,0,1,0
58638,5900,0,0,deny,62,62,0,1,0,1,0
55069,53,19618,53,allow,195,102,93,2,31,1,1
62643,445,0,0,drop,70,70,0,1,0,1,0
21998,51221,0,0,deny,62,62,0,1,0,1,0
49582,443,23714,443,allow,29241,2457,26784,48,171,24,24
59174,445,0,0,drop,70,70,0,1,0,1,0
55806,53,53227,53,allow,200,102,98,2,30,1,1
43701,443,61661,443,allow,1201,707,494,12,26,7,5
56579,443,24024,443,allow,23150,13858,9292,52,49,32,20
65069,445,0,0,drop,70,70,0,1,0,1,0
49412,53,45661,53,allow,761,102,659,2,29,1,1
3478,61463,0,0,deny,315,315,0,1,0,1,0
45941,23386,0,0,deny,60,60,0,1,0,1,0
60519,445,0,0,drop,70,70,0,1,0,1,0
60794,20010,30261,20010,allow,70,70,0,2,8,2,0
49663,53,0,0,allow,86,86,0,1,30,1,0
59207,445,0,0,drop,70,70,0,1,0,1,0
65532,53,33764,53,allow,196,102,94,2,30,1,1
32911,443,37831,443,allow,970703,43045,927658,1244,141,563,681
65192,53,33207,53,allow,178,94,84,2,30,1,1
27005,1106,25259,1106,allow,903,126,777,2,29,1,1
9316,443,33323,443,allow,3649,424,3225,12,15,6,6
54873,443,62397,443,allow,9238,3472,5766,43,75,24,19
52634,445,0,0,drop,70,70,0,1,0,1,0
57591,53,13897,53,allow,165,78,87,2,31,1,1
48981,15000,58211,15000,allow,130,70,60,2,5,1,1
36692,443,41344,443,allow,996,526,470,15,30,8,7
64712,53,1546,53,allow,177,94,83,2,30,1,1
63649,445,0,0,drop,66,66,0,1,0,1,0
58509,443,26840,443,allow,13973721,436876,13536845,14039,1629,4929,9110
16134,45680,0,0,deny,148,148,0,1,0,1,0
47595,33438,0,0,allow,106,106,0,1,60,1,0
58628,445,0,0,drop,66,66,0,1,0,1,0
45846,443,37447,443,allow,4819,829,3990,15,40,8,7
49474,7000,49474,7000,allow,2990,1599,1391,15,15,8,7
51988,443,46112,443,allow,10492,3167,7325,40,15,24,16
53843,443,32315,443,allow,499,425,74,4,0,3,1
36008,80,27818,80,allow,1614,1300,314,10,15,5,5
50723,445,0,0,drop,66,66,0,1,0,1,0
49695,445,0,0,drop,66,66,0,1,0,1,0
58638,5900,0,0,deny,62,62,0,1,0,1,0
27005,27015,22209,27015,allow,1654,126,1528,4,30,2,2
56145,53,42798,53,allow,458,188,270,6,31,3,3
47052,80,21524,80,allow,1217,486,731,8,43,5,3
55069,44847,0,0,deny,66,66,0,1,0,1,0
60894,443,14726,443,allow,3507,900,2607,13,135,6,7
58638,5900,0,0,deny,62,62,0,1,0,1,0
56786,443,47874,443,allow,36203,1763,34440,46,119,17,29
53729,40721,47011,40721,allow,70,70,0,1,4,1,0
62019,445,0,0,drop,70,70,0,1,0,1,0
55525,53,40797,53,allow,210,102,108,2,30,1,1
53419,28189,0,0,deny,60,60,0,1,0,1,0
65477,445,0,0,drop,70,70,0,1,0,1,0
50427,445,0,0,drop,70,70,0,1,0,1,0
37837,37965,0,0,deny,62,62,0,1,0,1,0
49369,53,21699,53,allow,168,86,82,2,30,1,1
63830,445,0,0,drop,70,70,0,1,0,1,0
1955,35974,0,0,deny,60,60,0,1,0,1,0
56712,53,17239,53,allow,177,94,83,2,30,1,1
60423,443,61729,443,allow,6849,1103,5746,23,120,12,11
32945,80,47829,80,allow,234,234,0,4,12,4,0
55360,443,39812,443,allow,6379,1762,4617,27,27,14,13
37739,443,17741,443,allow,138037,13843,124194,197,206,94,103
26560,26467,0,0,deny,66,66,0,1,0,1,0
53629,445,0,0,drop,66,66,0,1,0,1,0
5223,14446,0,0,deny,220,220,0,1,0,1,0
57812,7635,57812,7635,allow,138,78,60,3,6,2,1
51995,50031,39289,50031,allow,70,70,0,2,8,2,0
50591,443,54685,443,allow,5611,3452,2159,22,133,13,9
53987,57470,0,0,deny,66,66,0,1,0,1,0
49493,443,39689,443,allow,9692,6055,3637,21,30,11,10
49597,53,64001,53,allow,216,102,114,2,30,1,1
2850,64147,0,0,deny,66,66,0,1,0,1,0
50313,53,50313,53,allow,202,91,111,2,30,1,1
33814,443,5866,443,allow,8601,2870,5731,40,225,22,18
55968,56205,0,0,deny,66,66,0,1,0,1,0
56094,443,60801,443,allow,5616,3106,2510,22,223,13,9
53490,62413,0,0,deny,62,62,0,1,0,1,0
63728,11785,52016,11785,allow,66,66,0,2,8,2,0
31619,51221,0,0,deny,62,62,0,1,0,1,0
64578,443,29592,443,allow,9156,2109,7047,27,32,15,12
2267,53,13184,53,allow,826,826,0,8,44,8,0
49418,27015,22382,27015,allow,243,78,165,2,31,1,1
56519,53,20744,53,allow,167,86,81,2,29,1,1
54226,443,4295,443,allow,499,425,74,4,0,3,1
46703,443,29330,443,allow,4589,2090,2499,15,120,7,8
52779,445,0,0,drop,70,70,0,1,0,1,0
56642,443,26637,443,allow,27108,2396,24712,40,80,18,22
57296,53,45722,53,allow,200,102,98,2,30,1,1
3478,61463,0,0,deny,665,665,0,1,0,1,0
65197,445,0,0,drop,70,70,0,1,0,1,0
56382,53,19333,53,allow,190,97,93,2,31,1,1
53826,10168,43672,10168,allow,70,70,0,1,5,1,0
41543,443,55490,443,allow,234,234,0,4,12,4,0
58638,5900,0,0,deny,62,62,0,1,0,1,0
52258,443,2636,443,allow,3757,356,3401,12,120,5,7
51927,445,0,0,drop,70,70,0,1,0,1,0
49450,53,29878,53,allow,758,102,656,2,30,1,1
49689,53,60193,53,allow,812,110,702,2,30,1,1
53812,443,19260,443,allow,499,425,74,4,0,3,1
27055,25174,0,0,deny,62,62,0,1,0,1,0
51550,443,50088,443,allow,13331,2421,10910,38,209,20,18
65152,53,30200,53,allow,177,94,83,2,30,1,1
65066,445,0,0,drop,66,66,0,1,0,1,0
53864,24874,8342,24874,allow,320,140,180,6,6,3,3
50629,80,39121,80,allow,1658,1247,411,8,15,5,3
59586,56205,0,0,deny,62,62,0,1,0,1,0
60403,443,22407,443,allow,3802,1769,2033,15,135,7,8
63944,8999,33141,8999,allow,66,66,0,2,8,2,0
62729,51558,61898,51558,allow,70,70,0,1,4,1,0
50584,54993,58004,54993,allow,652,300,352,4,1200,3,1
52246,52840,54967,52840,allow,258,70,188,4,9,2,2
49220,2710,39360,2710,allow,70,70,0,2,8,2,0
64743,443,34069,443,allow,31480,1953,29527,54,196,20,34
55520,445,0,0,drop,70,70,0,1,0,1,0
52223,443,45658,443,allow,6710,4371,2339,33,109,18,15
51539,443,19176,443,allow,262,70,192,5,21,2,3
53270,443,54512,443,allow,12757,4360,8397,41,17,23,18
48282,8080,0,0,allow,184,78,106,3,9,2,1
58638,5900,0,0,deny,62,62,0,1,0,1,0
64755,445,0,0,drop,70,70,0,1,0,1,0
50739,443,62875,443,allow,6335,1376,4959,19,165,9,10
56775,9200,31796,9200,allow,8223,3066,5157,30,33,15,15
62690,445,0,0,drop,66,66,0,1,0,1,0
49562,443,59931,443,allow,3380,346,3034,12,120,5,7
51503,445,0,0,drop,66,66,0,1,0,1,0
55321,53,21988,53,allow,193,102,91,2,31,1,1
52869,445,0,0,drop,70,70,0,1,0,1,0
55866,53,14599,53,allow,168,78,90,2,30,1,1
58424,443,34481,443,allow,6020,2493,3527,29,80,14,15
34215,443,33625,443,allow,5341,1386,3955,19,649,11,8
16387,8455,0,0,deny,60,60,0,1,0,1,0
60407,443,49458,443,allow,8328,1611,6717,25,121,14,11
37557,443,30973,443,allow,9824,2477,7347,27,37,16,11
10844,53,10844,53,allow,222,90,132,2,30,1,1
56125,53,56568,53,allow,311,118,193,2,30,1,1
59745,53635,0,0,deny,66,66,0,1,0,1,0
57470,51413,34257,51413,allow,508,163,345,2,1200,1,1
54352,53,16730,53,allow,578,286,292,9,16,5,4
54196,443,33780,443,allow,499,425,74,4,0,3,1
45964,55559,0,0,deny,60,60,0,1,0,1,0
1028,62609,0,0,deny,148,148,0,1,0,1,0
49926,53,49666,53,allow,176,90,86,2,31,1,1
60591,53,16493,53,allow,218,78,140,2,31,1,1
51148,9571,0,0,deny,66,66,0,1,0,1,0
56601,53,1857,53,allow,177,94,83,2,31,1,1
58049,50265,0,0,deny,145,145,0,1,0,1,0
54326,27054,42842,27054,allow,924,924,0,3,30,3,0
53206,443,65067,443,allow,3656,2345,1311,18,17,9,9
64941,53,15219,53,allow,199,102,97,2,30,1,1
17176,443,17176,443,allow,6311,1229,5082,18,16,8,10
50567,443,48889,443,allow,7367,1149,6218,18,26,9,9
45837,443,61728,443,allow,39986,3118,36868,72,82,30,42
56322,53,19228,53,allow,209,110,99,2,29,1,1
65516,53,35992,53,allow,305,89,216,4,41,2,2
49224,53,31598,53,allow,177,94,83,2,30,1,1
60771,445,0,0,drop,70,70,0,1,0,1,0
32185,47807,0,0,deny,159,159,0,1,0,1,0
60235,443,27735,443,allow,7990,1730,6260,25,151,13,12
49202,53,58969,53,allow,295,86,209,2,30,1,1
49424,53,53979,53,allow,228,110,118,2,30,1,1
50888,445,0,0,drop,70,70,0,1,0,1,0
16387,16862,0,0,deny,60,60,0,1,0,1,0
50278,53,34897,53,allow,819,102,717,2,30,1,1
55206,443,55206,443,allow,18965,2061,16904,35,17,18,17
43916,21,0,0,deny,60,60,0,1,0,1,0
40392,443,64453,443,allow,8105,2278,5827,27,196,15,12
54586,161,0,0,allow,14172,5597,8575,50,31,25,25
50753,445,0,0,drop,66,66,0,1,0,1,0
49601,53,30637,53,allow,178,94,84,2,30,1,1
59771,445,0,0,drop,66,66,0,1,0,1,0
61271,445,0,0,drop,66,66,0,1,0,1,0
53436,445,0,0,drop,70,70,0,1,0,1,0
52107,53,0,0,allow,210,77,133,2,29,1,1
21542,57470,0,0,deny,74,74,0,1,0,1,0
61513,445,0,0,drop,66,66,0,1,0,1,0
55138,53,34113,53,allow,165,86,79,2,30,1,1
55580,53,57711,53,allow,195,102,93,2,31,1,1
57445,445,0,0,drop,70,70,0,1,0,1,0
55415,53,9661,53,allow,183,94,89,2,30,1,1
52940,443,39271,443,allow,14640,5951,8689,52,115,26,26
14715,56205,0,0,deny,62,62,0,1,0,1,0
50955,445,0,0,drop,66,66,0,1,0,1,0
55056,44512,0,0,deny,62,62,0,1,0,1,0
55364,445,0,0,drop,70,70,0,1,0,1,0
65317,51221,0,0,deny,78,78,0,1,0,1,0
3181,53,3181,53,allow,214,97,117,2,30,1,1
51830,443,51830,443,allow,17899,5015,12884,33,36,14,19
59416,443,46812,443,allow,2834,1700,1134,16,15,8,8
32578,443,32578,443,allow,25033,2433,22600,42,25,21,21
40988,80,28753,80,allow,19112,2192,16920,46,90,23,23
60741,445,0,0,drop,70,70,0,1,0,1,0
49418,27017,24547,27017,allow,258,78,180,2,29,1,1
58177,445,0,0,drop,70,70,0,1,0,1,0
53734,22051,59968,22051,allow,70,70,0,2,7,2,0
63065,54369,0,0,deny,66,66,0,1,0,1,0
62401,445,0,0,drop,70,70,0,1,0,1,0
62539,445,0,0,drop,66,66,0,1,0,1,0
57434,50584,0,0,deny,146,146,0,1,0,1,0
59255,445,0,0,drop,70,70,0,1,0,1,0
54781,445,0,0,drop,66,66,0,1,0,1,0
45941,23386,0,0,deny,60,60,0,1,0,1,0
64229,445,0,0,drop,70,70,0,1,0,1,0
61673,443,54566,443,allow,9218,3728,5490,30,50,16,14
54299,443,30059,443,allow,9986,2440,7546,17,120,8,9
6931,55108,0,0,deny,139,139,0,1,0,1,0
14777,25174,0,0,deny,62,62,0,1,0,1,0
62337,443,30628,443,allow,3908576,93181,3815395,3743,56,1160,2583
58638,5900,0,0,deny,62,62,0,1,0,1,0
55833,53,32426,53,allow,177,94,83,2,30,1,1
61140,27520,0,0,deny,66,66,0,1,0,1,0
50524,445,0,0,drop,70,70,0,1,0,1,0
55042,80,32886,80,allow,306,180,126,6,34,4,2
56751,53,17361,53,allow,752,93,659,2,30,1,1
59829,445,0,0,drop,70,70,0,1,0,1,0
62787,51221,0,0,deny,66,66,0,1,0,1,0
57612,28793,0,0,deny,66,66,0,1,0,1,0
50783,23,0,0,deny,60,60,0,1,0,1,0
58574,21247,0,0,deny,66,66,0,1,0,1,0
53686,445,0,0,drop,66,66,0,1,0,1,0
59696,57470,0,0,deny,62,62,0,1,0,1,0
49892,53,17000,53,allow,525,110,415,4,43,2,2
61600,56205,0,0,deny,62,62,0,1,0,1,0
61057,445,0,0,drop,70,70,0,1,0,1,0
57043,53,20251,53,allow,166,86,80,2,31,1,1
65024,53,20074,53,allow,199,102,97,2,30,1,1
55823,53,52028,53,allow,210,102,108,2,30,1,1
52347,443,62894,443,allow,7847,2985,4862,30,337,16,14
57421,445,0,0,drop,70,70,0,1,0,1,0
33473,443,49097,443,allow,146684,25233,121451,183,189,75,108
57238,443,50721,443,allow,7549,2807,4742,42,78,22,20
55835,53,15423,53,allow,180,94,86,2,29,1,1
50858,445,0,0,drop,70,70,0,1,0,1,0
9136,80,1532,80,allow,908,842,66,7,15,6,1
49418,27019,38743,27019,allow,251,71,180,2,30,1,1
54977,443,65082,443,allow,263411,11905,251506,318,144,118,200
4323,64147,0,0,deny,66,66,0,1,0,1,0
44992,80,44992,80,allow,2091,1642,449,10,20,6,4
50240,53,16161,53,allow,733,93,640,2,30,1,1
52906,445,0,0,drop,70,70,0,1,0,1,0
56376,53,49970,53,allow,198,102,96,2,31,1,1
63467,37807,0,0,deny,62,62,0,1,0,1,0
2082,7000,2082,7000,allow,3022,1567,1455,16,15,8,8
58344,53,58344,53,allow,847,110,737,2,30,1,1
51167,445,0,0,drop,66,66,0,1,0,1,0
64942,53,20482,53,allow,215,94,121,2,30,1,1
64735,53,29173,53,allow,350,118,232,2,29,1,1
63140,30685,24929,30685,allow,70,70,0,1,5,1,0
52977,445,0,0,drop,70,70,0,1,0,1,0
53702,51413,14183,51413,allow,70,70,0,2,7,2,0
56274,445,0,0,drop,66,66,0,1,0,1,0
8168,80,8168,80,allow,282487,10736,271751,315,52,124,191
63932,53,27137,53,allow,179,94,85,2,30,1,1
50714,445,0,0,drop,70,70,0,1,0,1,0
57137,53,2649,53,allow,279,96,183,4,31,2,2
53012,51050,0,0,deny,66,66,0,1,0,1,0
21322,25174,0,0,deny,62,62,0,1,0,1,0
49948,53,19107,53,allow,380,110,270,2,30,1,1
65115,50584,0,0,deny,62,62,0,1,0,1,0
50427,80,43709,80,allow,312,192,120,6,27,4,2
58495,443,34760,443,allow,1638,829,809,18,43,10,8
51946,9407,10036,9407,allow,70,70,0,2,7,2,0
50827,445,0,0,drop,66,66,0,1,0,1,0
64538,445,0,0,drop,70,70,0,1,0,1,0
26527,25174,0,0,deny,66,66,0,1,0,1,0
63907,445,0,0,drop,66,66,0,1,0,1,0
50506,10214,0,0,deny,66,66,0,1,0,1,0
55126,53,7380,53,allow,177,94,83,2,30,1,1
57143,53,50787,53,allow,184,94,90,2,30,1,1
52885,445,0,0,drop,66,66,0,1,0,1,0
57586,443,57586,443,allow,13517,1521,11996,32,87,11,21
64890,445,0,0,drop,66,66,0,1,0,1,0
33043,443,36029,443,allow,1788,968,820,20,15,11,9
62088,56205,0,0,deny,66,66,0,1,0,1,0
50028,53,56615,53,allow,323,110,213,2,29,1,1
26953,30317,0,0,deny,62,62,0,1,0,1,0
40005,36237,0,0,deny,62,62,0,1,0,1,0
38428,443,25567,443,allow,9483,2964,6519,23,17,13,10
55866,445,0,0,drop,66,66,0,1,0,1,0
64174,53,47378,53,allow,438,130,308,4,35,2,2
55038,443,26774,443,allow,4424,876,3548,15,35,8,7
34441,53,34441,53,allow,314,98,216,2,30,1,1
53250,445,0,0,drop,70,70,0,1,0,1,0
52149,52188,10170,52188,allow,70,70,0,1,5,1,0
37564,443,36169,443,allow,499,425,74,4,0,3,1
56375,53,25593,53,allow,216,110,106,2,30,1,1
63296,445,0,0,drop,70,70,0,1,0,1,0
62169,445,0,0,drop,70,70,0,1,0,1,0
5530,80,5530,80,allow,514,246,268,9,91,5,4
64314,53,49422,53,allow,319,126,193,2,30,1,1
58148,43890,0,0,deny,66,66,0,1,0,1,0
49270,80,7008,80,allow,254,128,126,5,15,3,2
64685,53,55702,53,allow,193,102,91,2,30,1,1
48676,53393,0,0,deny,60,60,0,1,0,1,0
51248,445,0,0,drop,66,66,0,1,0,1,0
62767,57470,0,0,deny,74,74,0,1,0,1,0
55857,53,40207,53,allow,199,102,97,2,29,1,1
17640,55442,0,0,deny,66,66,0,1,0,1,0
64385,53,34139,53,allow,174,89,85,2,30,1,1
65127,443,37615,443,allow,146,64,82,3,9,2,1
443,44683,0,0,deny,83,83,0,1,0,1,0
62020,445,0,0,drop,70,70,0,1,0,1,0
0,0,0,0,allow,124,64,60,2,0,1,1
50199,445,0,0,drop,70,70,0,1,0,1,0
64203,445,0,0,drop,70,70,0,1,0,1,0
53452,443,10617,443,allow,15368,8643,6725,36,49,19,17
43136,443,64659,443,allow,9329,2900,6429,27,135,15,12
56181,53,2631,53,allow,784,94,690,2,29,1,1
50054,443,33481,443,allow,7630,839,6791,20,79,9,11
56615,53,33953,53,allow,177,94,83,2,30,1,1
57707,443,36174,443,allow,3150,1709,1441,26,276,13,13
56704,80,26438,80,allow,1146417,29701,1116716,1218,54,422,796
53328,443,21893,443,allow,4670,2814,1856,33,81,15,18
53016,445,0,0,drop,70,70,0,1,0,1,0
59097,445,0,0,drop,70,70,0,1,0,1,0
27735,53,27735,53,allow,235,90,145,2,32,1,1
49225,443,22877,443,allow,11707,2326,9381,28,19,14,14
49901,53,43057,53,allow,752,93,659,2,31,1,1
50289,53,8502,53,allow,189,102,87,2,30,1,1
64169,53,20022,53,allow,209,110,99,2,30,1,1
50041,445,0,0,drop,70,70,0,1,0,1,0
55478,443,16411,443,allow,23029908,732047,22297861,24550,183,8143,16407
56860,445,0,0,drop,70,70,0,1,0,1,0
57014,445,0,0,drop,66,66,0,1,0,1,0
55001,80,28763,80,allow,9249354,297929,8951425,10789,208,4872,5917
54011,22114,0,0,deny,62,62,0,1,0,1,0
48706,23393,0,0,deny,60,60,0,1,0,1,0
61366,445,0,0,drop,66,66,0,1,0,1,0
49765,445,0,0,drop,66,66,0,1,0,1,0
41908,1433,0,0,deny,60,60,0,1,0,1,0
55115,53,50368,53,allow,313,110,203,4,35,2,2
65152,53,60141,53,allow,177,94,83,2,30,1,1
49321,53,55835,53,allow,184,94,90,2,31,1,1
50785,445,0,0,drop,70,70,0,1,0,1,0
62821,445,0,0,drop,70,70,0,1,0,1,0
50347,445,0,0,drop,70,70,0,1,0,1,0
50056,27018,46603,27018,allow,468,390,78,5,30,4,1
58703,50584,0,0,deny,66,66,0,1,0,1,0
46277,443,48047,443,allow,15670,12575,3095,51,37,30,21
56792,53,2003,53,allow,782,105,677,2,31,1,1
52496,445,0,0,drop,70,70,0,1,0,1,0
65518,53,57051,53,allow,198,94,104,2,30,1,1
56361,445,0,0,drop,70,70,0,1,0,1,0
10038,443,58313,443,allow,7481,2070,5411,25,315,12,13
51046,445,0,0,drop,66,66,0,1,0,1,0
64357,53,36127,53,allow,183,94,89,2,30,1,1
57275,443,6369,443,allow,22074,3005,19069,58,31,31,27
48346,80,10787,80,allow,1878,1444,434,14,15,7,7
56755,443,63082,443,allow,1327,918,409,10,26,6,4
63469,64147,0,0,deny,62,62,0,1,0,1,0
41151,80,58286,80,allow,1711,786,925,12,16,7,5
50459,62413,0,0,deny,66,66,0,1,0,1,0
60141,62413,0,0,deny,66,66,0,1,0,1,0
53136,41442,55511,41442,allow,70,70,0,1,5,1,0
51749,1408,5548,1408,allow,66,66,0,1,5,1,0
25570,35440,0,0,deny,62,62,0,1,0,1,0
64885,53,14280,53,allow,261,102,159,2,29,1,1
49355,53,58716,53,allow,193,102,91,2,29,1,1
6703,21247,0,0,deny,62,62,0,1,0,1,0
27005,1306,39345,1306,allow,858,126,732,2,30,1,1
64531,53,46731,53,allow,182,93,89,2,30,1,1
51429,22114,0,0,deny,66,66,0,1,0,1,0
56830,53,55667,53,allow,195,102,93,2,30,1,1
60343,445,0,0,drop,70,70,0,1,0,1,0
65257,53,65257,53,allow,176,78,98,2,30,1,1
29471,57470,0,0,deny,145,145,0,1,0,1,0
55857,53,31762,53,allow,196,102,94,2,30,1,1
50943,443,64250,443,allow,29452,1988,27464,37,3619,10,27
32161,53,32161,53,allow,823,98,725,2,31,1,1
56137,53,13627,53,allow,198,101,97,2,30,1,1
51298,445,0,0,drop,70,70,0,1,0,1,0
61407,443,5972,443,allow,6248,829,5419,17,29,9,8
54067,445,0,0,drop,66,66,0,1,0,1,0
46641,443,43427,443,allow,8471,3278,5193,21,120,11,10
64028,53,50736,53,allow,263,134,129,2,30,1,1
3597,11392,0,0,deny,66,66,0,1,0,1,0
56644,443,53305,443,allow,3079,1895,1184,18,16,10,8
50358,443,36799,443,allow,1786,172,1614,7,121,3,4
58912,443,7357,443,allow,7941,5160,2781,25,17,13,12
50784,50584,0,0,deny,62,62,0,1,0,1,0
64810,53,23866,53,allow,199,102,97,2,29,1,1
55817,445,0,0,drop,70,70,0,1,0,1,0
51840,445,0,0,drop,66,66,0,1,0,1,0
65390,445,0,0,drop,70,70,0,1,0,1,0
54883,51505,0,0,deny,66,66,0,1,0,1,0
52976,31573,0,0,deny,62,62,0,1,0,1,0
60994,445,0,0,drop,70,70,0,1,0,1,0
56485,80,20851,80,allow,569,365,204,6,16,3,3
55100,53,34612,53,allow,182,102,80,2,30,1,1
27348,80,31901,80,allow,1550,850,700,10,18,5,5
64903,51050,0,0,deny,66,66,0,1,0,1,0
55431,53,2541,53,allow,196,102,94,2,31,1,1
48125,7558,0,0,deny,60,60,0,1,0,1,0
65126,53,19594,53,allow,216,94,122,2,30,1,1
38028,443,50090,443,allow,8805,1300,7505,23,30,12,11
41815,50265,0,0,deny,146,146,0,1,0,1,0
52047,80,55413,80,allow,27784,13980,13804,44,35,22,22
56703,53,34394,53,allow,199,102,97,2,31,1,1
49396,53,60623,53,allow,216,102,114,2,30,1,1
58059,445,0,0,drop,70,70,0,1,0,1,0
54676,445,0,0,drop,66,66,0,1,0,1,0
49713,53,55679,53,allow,734,94,640,2,30,1,1
43415,443,53448,443,allow,130,70,60,2,15,1,1
56878,443,56878,443,allow,27657,5506,22151,58,46,30,28
55039,443,64407,443,allow,10961,2666,8295,35,237,16,19
56456,53,8981,53,allow,195,102,93,2,30,1,1
56148,445,0,0,drop,66,66,0,1,0,1,0
35747,443,32307,443,allow,8676,3499,5177,31,373,17,14
8116,25773,0,0,reset-both,157,157,0,1,0,1,0
51979,80,28537,80,allow,6083,699,5384,14,46,7,7
48817,6881,48817,6881,allow,490,149,341,2,1200,1,1
65379,22114,0,0,deny,66,66,0,1,0,1,0
12604,3389,12604,3389,reset-both,293,223,70,4,1,3,1
13294,64147,0,0,deny,145,145,0,1,0,1,0
56455,53,58599,53,allow,183,94,89,2,30,1,1
55107,445,0,0,drop,70,70,0,1,0,1,0
60755,40010,18324,40010,allow,316,136,180,6,7,3,3
443,48056,0,0,deny,135,135,0,1,0,1,0
55991,53,22499,53,allow,199,102,97,2,30,1,1
54985,53,45907,53,allow,177,94,83,2,30,1,1
53201,28513,16417,28513,allow,862,562,300,13,145,8,5
34354,80,61619,80,allow,350,210,140,6,15,4,2
9332,443,23835,443,allow,3616,429,3187,11,15,6,5
59613,445,0,0,drop,70,70,0,1,0,1,0
43056,11119,0,0,deny,146,146,0,1,0,1,0
52133,445,0,0,drop,70,70,0,1,0,1,0
48690,443,27547,443,allow,19402,10414,8988,35,22,21,14
51216,445,0,0,drop,70,70,0,1,0,1,0
56375,53,4600,53,allow,184,102,82,2,30,1,1
443,49988,0,0,deny,82,82,0,1,0,1,0
64731,53,43372,53,allow,241,110,131,2,30,1,1
56772,445,0,0,drop,70,70,0,1,0,1,0
58472,53,35113,53,allow,246,246,0,4,47,4,0
56636,53,19411,53,allow,302,86,216,2,30,1,1
35957,51185,0,0,deny,60,60,0,1,0,1,0
60985,443,19268,443,allow,20423,4091,16332,33,122,15,18
1070,26467,0,0,deny,62,62,0,1,0,1,0
55690,53,57021,53,allow,183,94,89,2,30,1,1
14070,62413,0,0,deny,66,66,0,1,0,1,0
7978,50584,0,0,deny,66,66,0,1,0,1,0
50613,80,39114,80,allow,85306,4735,80571,120,22,55,65
56202,53,15464,53,allow,196,102,94,2,29,1,1
52097,443,17045,443,allow,7246,3017,4229,21,15,11,10
55448,445,0,0,drop,70,70,0,1,0,1,0
50530,445,0,0,drop,70,70,0,1,0,1,0
62184,445,0,0,drop,66,66,0,1,0,1,0
52604,25174,0,0,deny,66,66,0,1,0,1,0
57431,53,12535,53,allow,994,86,908,2,30,1,1
60820,445,0,0,drop,70,70,0,1,0,1,0
49565,53,54064,53,allow,768,193,575,6,40,3,3
51966,443,55026,443,allow,35199,15909,19290,70,152,34,36
53156,35993,0,0,deny,66,66,0,1,0,1,0
51795,80,9427,80,allow,3955,2325,1630,18,47,11,7
63888,6881,45286,6881,allow,70,70,0,1,5,1,0
50442,37807,0,0,deny,66,66,0,1,0,1,0
49986,18242,0,0,allow,66,66,0,1,90,1,0
64438,23,0,0,deny,60,60,0,1,0,1,0
64416,53,53808,53,allow,211,94,117,2,30,1,1
53320,445,0,0,drop,66,66,0,1,0,1,0
64808,27098,0,0,deny,66,66,0,1,0,1,0
54432,445,0,0,drop,66,66,0,1,0,1,0
44847,26356,3716,26356,allow,501,150,351,2,1200,1,1
56908,443,5972,443,allow,187104,26358,160746,205,190,58,147
64626,50584,0,0,deny,66,66,0,1,0,1,0
9494,23,0,0,deny,60,60,0,1,0,1,0
53570,24874,57819,24874,allow,70,70,0,1,4,1,0
39689,443,12729,443,allow,7259,3893,3366,34,236,18,16
51996,57470,0,0,deny,66,66,0,1,0,1,0
39724,443,28049,443,allow,45852,4123,41729,61,17,25,36
52164,445,0,0,drop,70,70,0,1,0,1,0
1026,64147,0,0,deny,145,145,0,1,0,1,0
57926,445,0,0,drop,66,66,0,1,0,1,0
63906,36909,30978,36909,allow,66,66,0,2,7,2,0
64113,443,11350,443,allow,14057427,329652,13727775,13768,110,4655,9113
54344,443,13534,443,allow,10015,6047,3968,22,122,12,10
62061,53,49325,53,allow,181,78,103,2,30,1,1
41945,443,44467,443,allow,12146,2681,9465,63,4156,25,38
44740,443,62303,443,allow,5954,1454,4500,22,142,13,9
50970,445,0,0,drop,70,70,0,1,0,1,0
51867,48059,47188,48059,allow,160,70,90,2,5,1,1
51666,45702,58433,45702,allow,1201,577,624,8,30,4,4
39251,53,9429,53,allow,198,93,105,2,30,1,1
65449,53,22193,53,allow,177,94,83,2,30,1,1
50747,445,0,0,drop,70,70,0,1,0,1,0
46567,443,52746,443,allow,6407,984,5423,21,360,11,10
51052,50584,0,0,deny,66,66,0,1,0,1,0
54005,445,0,0,drop,66,66,0,1,0,1,0
10003,64147,0,0,deny,62,62,0,1,0,1,0
61591,22114,0,0,deny,62,62,0,1,0,1,0
37277,80,37277,80,allow,52625,3140,49485,55,52,14,41
60997,445,0,0,drop,70,70,0,1,0,1,0
62408,3478,35393,3478,allow,3548,1868,1680,57,87,29,28
64000,53,61132,53,allow,214,102,112,2,30,1,1
5588,5588,0,0,allow,3354,1792,1562,46,193,23,23
49820,445,0,0,drop,70,70,0,1,0,1,0
55067,445,0,0,drop,70,70,0,1,0,1,0
55012,64147,0,0,deny,62,62,0,1,0,1,0
38101,443,38674,443,allow,190,70,120,4,15,2,2
55979,445,0,0,drop,70,70,0,1,0,1,0
56103,21247,0,0,deny,66,66,0,1,0,1,0
5774,37965,0,0,deny,66,66,0,1,0,1,0
52596,445,0,0,drop,66,66,0,1,0,1,0
49788,53,26549,53,allow,302,97,205,4,43,2,2
49160,46824,0,0,deny,146,146,0,1,0,1,0
63639,445,0,0,drop,70,70,0,1,0,1,0
57761,15503,0,0,deny,66,66,0,1,0,1,0
49502,443,43578,443,allow,31780,3232,28548,44,29,16,28
50368,443,46131,443,allow,8048,1189,6859,19,25,10,9
59948,443,41928,443,allow,349197,16542,332655,411,129,150,261
55957,53,33865,53,allow,178,94,84,2,30,1,1
56389,53,5155,53,allow,279,93,186,4,32,2,2
53703,16426,38652,16426,allow,70,70,0,1,4,1,0
52121,445,0,0,drop,70,70,0,1,0,1,0
54935,443,10103,443,allow,10198,3881,6317,46,146,26,20
55235,445,0,0,drop,70,70,0,1,0,1,0
32736,22114,0,0,deny,66,66,0,1,0,1,0
43639,26467,0,0,deny,66,66,0,1,0,1,0
49470,445,0,0,drop,66,66,0,1,0,1,0
52356,55442,0,0,deny,66,66,0,1,0,1,0
3155,23,3155,23,allow,66,66,0,1,5,1,0
57685,445,0,0,drop,70,70,0,1,0,1,0
51136,443,51136,443,allow,1210,637,573,14,25,7,7
27005,27055,64070,27055,allow,915,126,789,2,31,1,1
49709,53,49112,53,allow,466,93,373,4,50,2,2
0,0,0,0,deny,156,156,0,2,0,2,0
46209,443,22477,443,allow,4900,2781,2119,25,95,13,12
49298,445,0,0,drop,70,70,0,1,0,1,0
64617,445,0,0,drop,70,70,0,1,0,1,0
51655,26467,0,0,deny,62,62,0,1,0,1,0
53233,443,34879,443,allow,6059,1040,5019,20,58,11,9
55637,27816,50457,27816,allow,316,190,126,5,15,3,2
50391,80,6997,80,allow,300,180,120,6,26,4,2
63586,46824,0,0,deny,62,62,0,1,0,1,0
49728,443,36312,443,allow,5037,1135,3902,16,18,9,7
60372,80,60372,80,allow,186272,9792,176480,216,21,93,123
54417,53,12775,53,allow,259,86,173,2,30,1,1
45386,5222,47309,5222,allow,4579,2357,2222,46,114,26,20
49862,53,59363,53,allow,817,102,715,2,30,1,1
62923,445,0,0,drop,70,70,0,1,0,1,0
57118,80,7804,80,allow,2404,568,1836,10,75,6,4
33627,36237,0,0,deny,66,66,0,1,0,1,0
57849,50584,0,0,deny,66,66,0,1,0,1,0
53437,44847,0,0,deny,66,66,0,1,0,1,0
7342,22114,0,0,deny,66,66,0,1,0,1,0
64077,445,0,0,drop,70,70,0,1,0,1,0
26501,80,26501,80,allow,93644,8868,84776,131,31,64,67
53896,48027,30657,48027,allow,70,70,0,1,5,1,0
46999,53,31962,53,allow,168,78,90,2,30,1,1
48513,44847,0,0,deny,62,62,0,1,0,1,0
53109,41661,38343,41661,allow,320,140,180,6,8,3,3
37993,49152,8346,49152,allow,156,156,0,3,8,3,0
50336,53,8935,53,allow,102,102,0,1,30,1,0
55087,53,19901,53,allow,183,94,89,2,31,1,1
51480,445,0,0,drop,66,66,0,1,0,1,0
62379,445,0,0,drop,70,70,0,1,0,1,0
37965,16881,45844,16881,allow,448,246,202,4,1199,2,2
55724,445,0,0,drop,70,70,0,1,0,1,0
62315,445,0,0,drop,70,70,0,1,0,1,0
42263,443,55947,443,allow,6431,1665,4766,22,275,12,10
52564,15503,0,0,deny,74,74,0,1,0,1,0
40026,443,36114,443,allow,6058,1749,4309,22,200,13,9
58143,57866,0,0,deny,66,66,0,1,0,1,0
58638,5900,0,0,deny,62,62,0,1,0,1,0
50355,443,60927,443,allow,4137,2232,1905,13,132,8,5
64115,2767,0,0,deny,62,62,0,1,0,1,0
57546,25174,0,0,deny,66,66,0,1,0,1,0
53577,8999,47694,8999,allow,372,186,186,6,15,3,3
49584,80,44285,80,allow,318,192,126,6,42,4,2
57746,15000,19364,15000,allow,130,70,60,2,6,1,1
63729,6969,55353,6969,allow,66,66,0,2,8,2,0
43916,21,0,0,deny,60,60,0,1,0,1,0
56556,445,0,0,drop,70,70,0,1,0,1,0
49863,8100,10467,8100,allow,78,78,0,1,4,1,0
47910,7464,0,0,deny,60,60,0,1,0,1,0
57131,35776,0,0,deny,145,145,0,1,0,1,0
63334,445,0,0,drop,70,70,0,1,0,1,0
57248,445,0,0,drop,70,70,0,1,0,1,0
49506,53,23058,53,allow,200,102,98,2,30,1,1
55254,50584,0,0,deny,66,66,0,1,0,1,0
39180,443,51621,443,allow,3221,2218,1003,16,15,8,8
49248,445,0,0,drop,70,70,0,1,0,1,0
57226,53,37479,53,allow,178,94,84,2,30,1,1
42969,8146,0,0,deny,62,62,0,1,0,1,0
51724,25807,42911,25807,allow,66,66,0,1,5,1,0
10265,64147,0,0,deny,66,66,0,1,0,1,0
65187,445,0,0,drop,70,70,0,1,0,1,0
58638,5900,0,0,deny,62,62,0,1,0,1,0
63916,56318,63492,56318,allow,70,70,0,1,4,1,0
64789,53,51641,53,allow,199,102,97,2,30,1,1
38269,443,44100,443,allow,130,70,60,2,15,1,1
52789,445,0,0,drop,70,70,0,1,0,1,0
15503,63093,6070,63093,allow,481,150,331,2,1200,1,1
62999,445,0,0,drop,66,66,0,1,0,1,0
43151,443,30299,443,allow,9462,4488,4974,28,96,13,15
60419,53,60419,53,allow,217,87,130,2,30,1,1
58085,57470,0,0,deny,66,66,0,1,0,1,0
50394,25174,0,0,deny,62,62,0,1,0,1,0
49595,53,17154,53,allow,176,90,86,2,30,1,1
53211,22114,0,0,deny,62,62,0,1,0,1,0
33074,5900,0,0,deny,60,60,0,1,0,1,0
55049,443,4491,443,allow,1600,1089,511,13,151,7,6
64273,53,19409,53,allow,256,102,154,2,30,1,1
49168,57470,0,0,deny,66,66,0,1,0,1,0
65256,53,14067,53,allow,213,102,111,2,30,1,1
62329,443,62329,443,allow,1210,637,573,14,51,7,7
52913,443,33752,443,allow,50739,5508,45231,100,116,36,64
50102,445,0,0,drop,66,66,0,1,0,1,0
4961,62741,0,0,deny,66,66,0,1,0,1,0
443,9986,0,0,deny,352,352,0,1,0,1,0
57894,443,47420,443,allow,85263,3763,81500,115,216,46,69
49913,53,50642,53,allow,216,110,106,2,31,1,1
49486,53,33759,53,allow,170,87,83,2,31,1,1
52019,80,54297,80,allow,426,240,186,8,24,5,3
20341,53,20341,53,allow,225,90,135,2,30,1,1
53813,39832,19071,39832,allow,320,140,180,6,5,3,3
65324,53,6556,53,allow,749,94,655,2,30,1,1
49837,53,9778,53,allow,167,86,81,2,30,1,1
35619,12883,0,0,deny,159,159,0,1,0,1,0
51725,56205,0,0,deny,62,62,0,1,0,1,0
57414,57470,0,0,deny,146,146,0,1,0,1,0
60706,443,17990,443,allow,4974,836,4138,16,40,8,8
48755,80,48755,80,allow,630,264,366,10,44,5,5
12550,37807,0,0,deny,62,62,0,1,0,1,0
17428,3389,17428,3389,allow,4695,2520,2175,22,19,13,9
49160,63766,0,0,deny,146,146,0,1,0,1,0
57399,445,0,0,drop,66,66,0,1,0,1,0
55850,443,8932,443,allow,2883,642,2241,13,135,6,7
56326,56205,0,0,deny,66,66,0,1,0,1,0
40218,443,5218,443,allow,5254,927,4327,20,84,9,11
65313,53,6135,53,allow,193,102,91,2,30,1,1
56773,80,16432,80,allow,1462,703,759,8,16,5,3
64110,51617,13818,51617,allow,66,66,0,2,7,2,0
56634,443,43198,443,allow,8865,1819,7046,24,30,14,10
50651,25174,0,0,deny,62,62,0,1,0,1,0
51244,21162,0,0,deny,100,100,0,1,0,1,0
49152,53,51402,53,allow,206,105,101,2,31,1,1
53853,39723,8770,39723,allow,1890,1010,880,13,16,8,5
52914,37965,0,0,deny,66,66,0,1,0,1,0
39570,443,58125,443,allow,127970,4968,123002,144,30,53,91
33048,443,57285,443,allow,90054,6681,83373,104,133,33,71
63846,445,0,0,drop,66,66,0,1,0,1,0
63877,51413,26586,51413,allow,564,382,182,9,18,6,3
49418,27015,17910,27015,allow,232,71,161,2,31,1,1
24160,37807,0,0,deny,62,62,0,1,0,1,0
56257,53,40578,53,allow,177,94,83,2,31,1,1
51948,17372,0,0,deny,62,62,0,1,0,1,0
49248,35993,0,0,deny,66,66,0,1,0,1,0
51649,80,42317,80,allow,1965,1402,563,13,16,7,6
62724,53,2730,53,allow,195,78,117,2,29,1,1
56569,53,23106,53,allow,182,93,89,2,31,1,1
57252,53,26443,53,allow,229,102,127,2,30,1,1
52187,38153,27552,38153,allow,70,70,0,1,4,1,0
64879,445,0,0,drop,66,66,0,1,0,1,0
27005,27016,21347,27016,allow,902,126,776,2,30,1,1
65430,80,47649,80,allow,306,180,126,6,29,4,2
55198,80,49692,80,allow,41822,2038,39784,56,15,27,29
60311,56205,0,0,deny,62,62,0,1,0,1,0
62538,445,0,0,drop,66,66,0,1,0,1,0
65033,53,12694,53,allow,214,94,120,2,30,1,1
63183,64147,0,0,deny,66,66,0,1,0,1,0
53535,1393,2385,1393,allow,70,70,0,2,8,2,0
18246,64097,0,0,deny,62,62,0,1,0,1,0
52053,80,43263,80,allow,27839,14036,13803,46,36,24,22
56652,53,9807,53,allow,177,94,83,2,30,1,1
45754,80,60037,80,allow,1282,650,632,9,127,5,4
49875,443,6451,443,allow,31715,20427,11288,103,54,54,49
55893,45711,0,0,deny,78,78,0,1,0,1,0
56798,443,60246,443,allow,8073,2053,6020,20,15,11,9
54973,445,0,0,drop,66,66,0,1,0,1,0
10965,22114,0,0,deny,146,146,0,1,0,1,0
52012,80,40658,80,allow,366,240,126,7,25,5,2
50604,443,64927,443,allow,1385,783,602,14,23,8,6
42298,40008,65439,40008,allow,140,78,62,2,30,1,1
49895,80,46026,80,allow,2781,1400,1381,11,87,6,5
51540,443,24638,443,allow,957715,36759,920956,1075,161,378,697
33502,5529,0,0,deny,143,143,0,1,0,1,0
56583,53,58946,53,allow,177,94,83,2,31,1,1
50449,445,0,0,drop,70,70,0,1,0,1,0
46676,443,54715,443,allow,16425,3923,12502,37,156,19,18
57470,25089,59334,25089,allow,132,132,0,3,1199,3,0
33017,443,62492,443,allow,11008,4624,6384,36,322,19,17
56956,53,61460,53,allow,183,94,89,2,30,1,1
52099,443,31661,443,allow,39798,12257,27541,68,97,27,41
57035,53,29329,53,allow,199,102,97,2,30,1,1
44687,443,14376,443,allow,3054,1741,1313,20,27,8,12
62125,445,0,0,drop,66,66,0,1,0,1,0
62922,993,33264,993,allow,9484,4222,5262,86,45,40,46
60641,443,61674,443,allow,34758,2573,32185,50,320,21,29
56998,53,18836,53,allow,711,87,624,2,30,1,1
49216,53,15355,53,allow,181,94,87,2,30,1,1
9552,22114,0,0,deny,146,146,0,1,0,1,0
62369,445,0,0,drop,70,70,0,1,0,1,0
56333,53,17825,53,allow,199,102,97,2,30,1,1
60941,25174,0,0,deny,62,62,0,1,0,1,0
60308,443,13749,443,allow,5445,1072,4373,24,80,11,13
0,0,0,0,deny,98,98,0,1,0,1,0
56422,445,0,0,drop,70,70,0,1,0,1,0
56797,443,58873,443,allow,8022,2002,6020,20,16,11,9
443,14315,0,0,deny,158,158,0,1,0,1,0
56496,80,21274,80,allow,458684,19849,438835,488,66,185,303
58305,51180,0,0,deny,66,66,0,1,0,1,0
57174,57470,0,0,deny,66,66,0,1,0,1,0
10775,35440,0,0,deny,66,66,0,1,0,1,0
59210,50584,0,0,deny,62,62,0,1,0,1,0
58087,53,39920,53,allow,168,78,90,2,30,1,1
50585,80,50585,80,allow,9588,4478,5110,28,21,16,12
63431,443,3951,443,allow,3182,1568,1614,8,120,4,4
54340,443,13340,443,allow,3176,752,2424,10,121,5,5
45764,443,11581,443,allow,57543,2347,55196,68,16,26,42
49277,53,20518,53,allow,199,102,97,2,30,1,1
61945,48817,0,0,deny,62,62,0,1,0,1,0
50820,57470,0,0,deny,66,66,0,1,0,1,0
64973,53,36407,53,allow,257,102,155,2,30,1,1
27005,27018,40028,27018,allow,891,126,765,2,31,1,1
50286,445,0,0,drop,66,66,0,1,0,1,0
58638,5900,0,0,deny,62,62,0,1,0,1,0
36586,5900,0,0,deny,60,60,0,1,0,1,0
51396,56205,0,0,deny,66,66,0,1,0,1,0
51792,22318,43615,22318,allow,316,136,180,6,5,3,3
51730,445,0,0,drop,66,66,0,1,0,1,0
41916,443,13885,443,allow,8634,3251,5383,24,17,14,10
54174,445,0,0,drop,70,70,0,1,0,1,0
65486,53,61924,53,allow,216,102,114,2,30,1,1
65316,445,0,0,drop,70,70,0,1,0,1,0
57173,445,0,0,drop,66,66,0,1,0,1,0
38808,443,46954,443,allow,25120,1874,23246,39,171,17,22
58304,443,13109,443,allow,13442,1200,12242,26,29,11,15
50018,80,3941,80,allow,825,685,140,6,33,4,2
61240,445,0,0,drop,70,70,0,1,0,1,0
52103,7172,60174,7172,allow,70,70,0,1,5,1,0
56160,53,61640,53,allow,195,102,93,2,30,1,1
56151,53,10029,53,allow,194,102,92,2,30,1,1
65172,53,25157,53,allow,306,110,196,2,30,1,1
1284,50584,0,0,deny,66,66,0,1,0,1,0
65216,53,28628,53,allow,218,94,124,2,30,1,1
49272,53,53692,53,allow,198,102,96,2,30,1,1
51761,445,0,0,drop,66,66,0,1,0,1,0
60949,443,41744,443,allow,1598,794,804,16,18,9,7
55985,44847,0,0,deny,62,62,0,1,0,1,0
55215,443,18070,443,allow,3717,2233,1484,34,80,20,14
53259,445,0,0,drop,70,70,0,1,0,1,0
58761,443,45887,443,allow,318,192,126,6,26,4,2
27005,27015,62315,27015,allow,1006,252,754,4,32,3,1
54518,445,0,0,drop,70,70,0,1,0,1,0
50694,445,0,0,drop,70,70,0,1,0,1,0
54593,51505,0,0,deny,62,62,0,1,0,1,0
53381,25174,0,0,deny,62,62,0,1,0,1,0
50535,445,0,0,drop,70,70,0,1,0,1,0
0,0,0,0,deny,98,98,0,1,0,1,0
52495,443,27354,443,allow,787462,10645,776817,653,131,87,566
63669,445,0,0,drop,70,70,0,1,0,1,0
58468,37965,0,0,deny,66,66,0,1,0,1,0
53928,15503,0,0,deny,62,62,0,1,0,1,0
49171,53,6707,53,allow,199,102,97,2,30,1,1
57227,443,51779,443,allow,9322,2994,6328,26,22,16,10
55413,37965,0,0,deny,66,66,0,1,0,1,0
62444,445,0,0,drop,70,70,0,1,0,1,0
34756,443,27102,443,allow,100090,8304,91786,135,127,50,85
40845,53,40845,53,allow,210,98,112,2,31,1,1
49766,443,21804,443,allow,12026,1450,10576,27,127,12,15
49198,53,18910,53,allow,164,78,86,2,31,1,1
64898,53,23347,53,allow,487,201,286,6,37,3,3
55639,53,39796,53,allow,292,102,190,2,29,1,1
55261,53,37106,53,allow,177,94,83,2,30,1,1
52640,6881,33244,6881,allow,719,413,306,10,14,5,5
56774,39553,10646,39553,allow,70,70,0,2,8,2,0
59914,445,0,0,drop,66,66,0,1,0,1,0
35292,443,36726,443,allow,4866,3323,1543,25,94,14,11
30304,26467,0,0,deny,62,62,0,1,0,1,0
64212,53,41326,53,allow,215,102,113,2,30,1,1
64145,53,59140,53,allow,177,94,83,2,30,1,1
55467,53,6293,53,allow,320,95,225,4,41,2,2
57864,445,0,0,drop,66,66,0,1,0,1,0
63194,50265,0,0,deny,62,62,0,1,0,1,0
49464,443,43565,443,allow,4555,2472,2083,20,119,11,9
65248,53,20664,53,allow,208,106,102,2,30,1,1
28764,2323,0,0,deny,60,60,0,1,0,1,0
31691,50584,0,0,deny,62,62,0,1,0,1,0
49985,53,62790,53,allow,227,102,125,2,29,1,1
37837,37965,0,0,deny,62,62,0,1,0,1,0
50483,445,0,0,drop,66,66,0,1,0,1,0
50668,58833,0,0,deny,66,66,0,1,0,1,0
10916,44847,0,0,deny,66,66,0,1,0,1,0
56536,443,9088,443,allow,8866,2743,6123,23,139,11,12
55360,445,0,0,drop,70,70,0,1,0,1,0
42999,3389,42999,3389,allow,3910,1805,2105,20,19,12,8
55732,5900,0,0,deny,60,60,0,1,0,1,0
49256,53,47190,53,allow,177,94,83,2,30,1,1
55784,53,41751,53,allow,184,94,90,2,30,1,1
52799,445,0,0,drop,66,66,0,1,0,1,0
65159,37965,0,0,deny,74,74,0,1,0,1,0
53732,22704,63994,22704,allow,70,70,0,2,8,2,0
51330,445,0,0,drop,70,70,0,1,0,1,0
64994,27032,29881,27032,allow,737,462,275,2,29,1,1
54879,445,0,0,drop,70,70,0,1,0,1,0
62757,445,0,0,drop,70,70,0,1,0,1,0
6773,57470,0,0,deny,62,62,0,1,0,1,0
34419,443,53851,443,allow,2713,1386,1327,18,316,10,8
48155,443,36559,443,allow,7395,1514,5881,26,225,11,15
49367,445,0,0,drop,66,66,0,1,0,1,0
65118,53,14399,53,allow,539,91,448,4,43,2,2
47682,64147,0,0,deny,66,66,0,1,0,1,0
55634,53,8065,53,allow,210,110,100,2,30,1,1
50379,53,12803,53,allow,197,102,95,2,30,1,1
53841,8999,39565,8999,allow,70,70,0,1,4,1,0
55619,53,46483,53,allow,183,94,89,2,30,1,1
57303,53,6094,53,allow,177,94,83,2,30,1,1
41314,80,2894,80,allow,1723,438,1285,10,136,6,4
50803,443,31091,443,allow,6417,1376,5041,19,140,9,10
32864,53,32864,53,allow,404,259,145,3,32,2,1
10151,6881,61137,6881,allow,469,150,319,2,1200,1,1
56967,35440,0,0,deny,66,66,0,1,0,1,0
56349,53,17487,53,allow,216,110,106,2,31,1,1
56451,53,25472,53,allow,322,102,220,2,30,1,1
50413,445,0,0,drop,66,66,0,1,0,1,0
36061,4500,28501,4500,allow,12526,5944,6582,24,3599,11,13
59089,445,0,0,drop,70,70,0,1,0,1,0
56133,445,0,0,drop,70,70,0,1,0,1,0
49707,445,0,0,drop,70,70,0,1,0,1,0
56115,445,0,0,drop,66,66,0,1,0,1,0
50666,445,0,0,drop,66,66,0,1,0,1,0
39735,443,13542,443,allow,280,140,140,5,130,3,2
52792,445,0,0,drop,70,70,0,1,0,1,0
57995,80,53962,80,allow,4065,2650,1415,25,75,13,12
57470,61467,29646,61467,allow,479,150,329,2,1199,1,1
60721,443,60721,443,allow,1092,645,447,10,34,6,4
40249,443,14843,443,allow,70,70,0,1,5,1,0
50968,443,54503,443,allow,13683,6075,7608,58,5113,23,35
59781,56205,0,0,deny,66,66,0,1,0,1,0
59754,80,41353,80,allow,1352,848,504,13,83,8,5
57864,445,0,0,drop,70,70,0,1,0,1,0
43350,58414,0,0,deny,62,62,0,1,0,1,0
53242,37965,0,0,deny,66,66,0,1,0,1,0
54188,443,5906,443,allow,2895,1646,1249,17,16,8,9
64414,53,6612,53,allow,186,95,91,2,30,1,1
63982,53,27288,53,allow,244,94,150,2,30,1,1
62527,445,0,0,drop,70,70,0,1,0,1,0
60019,445,0,0,drop,70,70,0,1,0,1,0
55062,53,27959,53,allow,194,94,100,2,31,1,1
64172,53,13713,53,allow,197,102,95,2,29,1,1
52740,51505,0,0,deny,66,66,0,1,0,1,0
50930,443,54294,443,allow,134,60,74,3,10,2,1
56919,53,19863,53,allow,186,95,91,2,31,1,1
48817,6889,48817,6889,allow,1283,666,617,6,1200,3,3
42798,26467,0,0,deny,62,62,0,1,0,1,0
65422,53,59464,53,allow,208,94,114,2,30,1,1
54627,443,30890,443,allow,182017,6621,175396,189,181,55,134
64598,445,0,0,drop,70,70,0,1,0,1,0
58359,64147,0,0,deny,72,72,0,1,0,1,0
50229,443,13758,443,allow,6846,2479,4367,41,256,19,22
28839,30188,0,0,deny,62,62,0,1,0,1,0
50689,80,10754,80,allow,54757,28216,26541,229,175,114,115
6881,55108,0,0,deny,143,143,0,1,0,1,0
50999,443,48896,443,allow,33716,17750,15966,134,329,72,62
63733,47013,29294,47013,allow,70,70,0,1,5,1,0
49841,53,34208,53,allow,264,110,154,2,31,1,1
53566,8999,11689,8999,allow,3428,1820,1608,21,17,12,9
55893,45711,0,0,deny,78,78,0,1,0,1,0
57925,445,0,0,drop,70,70,0,1,0,1,0
54990,53,62190,53,allow,166,86,80,2,29,1,1
59227,11392,0,0,deny,62,62,0,1,0,1,0
50618,443,50618,443,allow,4351,1444,2907,19,28,11,8
57763,445,0,0,drop,70,70,0,1,0,1,0
56216,53,5035,53,allow,170,87,83,2,31,1,1
63286,445,0,0,drop,70,70,0,1,0,1,0
52242,3749,25339,3749,allow,70,70,0,2,7,2,0
57470,40870,29859,40870,allow,535,163,372,2,1200,1,1
50121,443,39430,443,allow,29425,9485,19940,54,35,27,27
54858,445,0,0,drop,70,70,0,1,0,1,0
60823,25174,0,0,deny,66,66,0,1,0,1,0
23969,57470,0,0,deny,62,62,0,1,0,1,0
27005,33059,8397,33059,allow,900,126,774,2,31,1,1
49447,53,25197,53,allow,248,102,146,2,29,1,1
64725,445,0,0,drop,70,70,0,1,0,1,0
32710,22114,0,0,deny,62,62,0,1,0,1,0
56588,53,41777,53,allow,197,102,95,2,29,1,1
58638,5900,0,0,deny,62,62,0,1,0,1,0
55561,445,0,0,drop,66,66,0,1,0,1,0
45755,443,42960,443,allow,1625,1038,587,14,26,8,6
62625,445,0,0,drop,70,70,0,1,0,1,0
61550,5529,0,0,deny,145,145,0,1,0,1,0
63620,445,0,0,drop,70,70,0,1,0,1,0
49473,443,31044,443,allow,3990,1296,2694,17,158,9,8
59713,3389,59713,3389,allow,4213,2429,1784,18,32,9,9
65189,27015,11223,27015,allow,275,78,197,2,29,1,1
65321,53,36858,53,allow,167,86,81,2,29,1,1
60384,80,50302,80,allow,1420,715,705,12,16,7,5
54272,445,0,0,drop,70,70,0,1,0,1,0
25015,64147,0,0,deny,66,66,0,1,0,1,0
52115,10012,62951,10012,allow,66,66,0,1,5,1,0
52658,80,12733,80,allow,214,140,74,4,15,3,1
64102,53,25876,53,allow,274,94,180,2,29,1,1
2238,22114,0,0,deny,62,62,0,1,0,1,0
64415,445,0,0,drop,70,70,0,1,0,1,0
36942,53,36942,53,allow,197,90,107,2,30,1,1
65343,445,0,0,drop,70,70,0,1,0,1,0
53454,445,0,0,drop,66,66,0,1,0,1,0
35412,443,65351,443,allow,1251,749,502,11,68,6,5
52182,53,34693,53,allow,199,94,105,2,30,1,1
56424,53,14436,53,allow,306,94,212,2,30,1,1
55531,53,57594,53,allow,370,126,244,2,30,1,1
37233,53,50033,53,allow,198,93,105,2,30,1,1
24009,53,46041,53,allow,223,86,137,2,29,1,1
61638,445,0,0,drop,70,70,0,1,0,1,0
27005,27015,21869,27015,allow,877,126,751,2,29,1,1
55912,53,21691,53,allow,184,94,90,2,31,1,1
30960,45684,7454,45684,allow,330,330,0,6,3609,6,0
63331,51221,0,0,deny,62,62,0,1,0,1,0
56611,443,45204,443,allow,7983,1963,6020,20,15,11,9
49504,53,3816,53,allow,198,94,104,2,30,1,1
53790,53,7041,53,allow,167,78,89,2,29,1,1
55216,53,0,0,allow,192,86,106,2,30,1,1
64829,53,40836,53,allow,213,102,111,2,30,1,1
58976,43890,0,0,deny,66,66,0,1,0,1,0
51222,35440,0,0,deny,62,62,0,1,0,1,0
43163,443,21681,443,allow,10100,3072,7028,25,16,14,11
49351,53,18900,53,allow,212,102,110,2,30,1,1
6881,6881,43994,6881,allow,502,150,352,2,1200,1,1
42298,40024,27133,40024,allow,207,85,122,4,29,2,2
55371,53,41494,53,allow,168,86,82,2,30,1,1
51447,443,8869,443,allow,202,70,132,3,11,1,2
35092,22,0,0,deny,60,60,0,1,0,1,0
61016,443,27858,443,allow,56191,3435,52756,81,271,37,44
10797,50584,0,0,deny,62,62,0,1,0,1,0
56301,53,2529,53,allow,177,94,83,2,30,1,1
65056,53,56800,53,allow,270,94,176,2,30,1,1
52341,445,0,0,drop,66,66,0,1,0,1,0
30650,25174,0,0,deny,62,62,0,1,0,1,0
26458,44847,0,0,deny,146,146,0,1,0,1,0
52218,80,8584,80,allow,2373,614,1759,11,15,6,5
57384,53,57923,53,allow,228,110,118,2,30,1,1
64790,53,49419,53,allow,182,93,89,2,31,1,1
61140,27520,0,0,deny,66,66,0,1,0,1,0
27005,27025,23287,27025,allow,895,126,769,2,30,1,1
54735,443,61550,443,allow,12507,6114,6393,30,90,18,12
65309,53,47712,53,allow,258,110,148,2,30,1,1
60386,9136,45378,9136,allow,624,318,306,10,16,5,5
55095,53,24827,53,allow,188,96,92,2,30,1,1
56609,53,42819,53,allow,199,102,97,2,31,1,1
64772,53,64772,53,allow,241,98,143,2,30,1,1
49618,53,25113,53,allow,774,101,673,2,30,1,1
26900,27017,27524,27017,allow,422,164,258,6,30,3,3
58923,445,0,0,drop,70,70,0,1,0,1,0
49240,53,11212,53,allow,199,102,97,2,29,1,1
49453,53,4294,53,allow,763,101,662,2,31,1,1
27055,25174,0,0,deny,146,146,0,1,0,1,0
57138,443,59763,443,allow,70379,4205,66174,101,403,51,50
57073,53,22592,53,allow,197,102,95,2,33,1,1
53119,58118,15448,58118,allow,70,70,0,2,8,2,0
50098,443,16798,443,allow,12942,3659,9283,66,217,36,30
10916,44847,0,0,deny,62,62,0,1,0,1,0
26324,30188,0,0,deny,62,62,0,1,0,1,0
55487,445,0,0,drop,70,70,0,1,0,1,0
64744,53,33076,53,allow,376,118,258,2,30,1,1
51970,443,63530,443,allow,17072,6138,10934,33,85,18,15
51443,443,35232,443,allow,322,66,256,6,16,2,4
55962,445,0,0,drop,70,70,0,1,0,1,0
55029,443,56750,443,allow,35270,2782,32488,48,51,22,26
35570,22114,0,0,deny,62,62,0,1,0,1,0
53381,25174,0,0,deny,66,66,0,1,0,1,0
55192,53,1273,53,allow,760,97,663,2,31,1,1
38411,17372,0,0,deny,62,62,0,1,0,1,0
39423,80,5862,80,allow,234,234,0,4,12,4,0
52424,445,0,0,drop,66,66,0,1,0,1,0
65189,27016,36079,27016,allow,78,78,0,1,29,1,0
65121,443,49060,443,allow,11416,4745,6671,45,256,22,23
63672,22114,0,0,deny,66,66,0,1,0,1,0
57416,66,17429,66,allow,70,70,0,2,7,2,0
56411,53,39978,53,allow,184,94,90,2,30,1,1
58826,445,0,0,drop,70,70,0,1,0,1,0
49525,443,29311,443,allow,14786,2845,11941,32,121,17,15
52321,26467,0,0,deny,62,62,0,1,0,1,0
6881,6881,60771,6881,allow,150,150,0,1,1200,1,0
55941,53,54126,53,allow,184,94,90,2,30,1,1
9448,57866,0,0,deny,62,62,0,1,0,1,0
55661,49671,9206,49671,allow,70,70,0,2,8,2,0
48467,80,55817,80,allow,1113,534,579,12,15,7,5
53625,445,0,0,drop,66,66,0,1,0,1,0
54524,445,0,0,drop,66,66,0,1,0,1,0
58638,5900,58638,5900,allow,66,66,0,1,4,1,0
49931,25174,0,0,deny,66,66,0,1,0,1,0
50234,53,13512,53,allow,242,78,164,2,30,1,1
57911,443,43527,443,allow,9662,4079,5583,66,194,30,36
62765,16933,0,0,deny,66,66,0,1,0,1,0
27005,27016,10139,27016,allow,887,126,761,2,30,1,1
45414,443,2299,443,allow,2215,1412,803,19,38,10,9
50098,445,0,0,drop,70,70,0,1,0,1,0
56650,443,36450,443,allow,4628,1035,3593,19,25,11,8
55090,53,17815,53,allow,196,102,94,2,30,1,1
55413,53,9671,53,allow,216,110,106,2,31,1,1
56322,53,0,0,allow,629,73,556,2,30,1,1
55942,53,19231,53,allow,197,102,95,2,31,1,1
15345,36829,0,0,deny,66,66,0,1,0,1,0
49726,443,2292,443,allow,3941,902,3039,13,50,7,6
45944,44847,0,0,deny,146,146,0,1,0,1,0
49228,443,49228,443,allow,32952,11546,21406,60,71,36,24
56532,443,17749,443,allow,8381,2848,5533,26,572,14,12
50695,80,16857,80,allow,1426,865,561,9,15,5,4
53550,445,0,0,drop,66,66,0,1,0,1,0
58536,53,15925,53,allow,177,86,91,2,30,1,1
52863,50584,0,0,deny,66,66,0,1,0,1,0
49425,53,61081,53,allow,772,102,670,2,30,1,1
59684,443,44849,443,allow,5173,860,4313,16,15,9,7
64125,53,55658,53,allow,370,94,276,2,30,1,1
51674,51505,0,0,deny,66,66,0,1,0,1,0
64235,53,36798,53,allow,194,99,95,2,30,1,1
57136,53,53104,53,allow,177,94,83,2,30,1,1
8536,37965,0,0,deny,62,62,0,1,0,1,0
443,48120,0,0,deny,97,97,0,1,0,1,0
10192,25174,0,0,deny,66,66,0,1,0,1,0
50495,80,9941,80,allow,312,192,120,6,25,4,2
61419,57470,0,0,deny,66,66,0,1,0,1,0
51875,25072,3449,25072,allow,70,70,0,1,5,1,0
26805,443,51742,443,allow,21055,15996,5059,39,22,22,17
34043,443,15753,443,allow,7280,4154,3126,30,735,16,14
49503,443,38675,443,allow,1363701,35511,1328190,1382,271,476,906
50687,443,7518,443,allow,1199,618,581,13,29,6,7
15016,443,15016,443,allow,21083,3108,17975,45,80,24,21
58118,22114,0,0,deny,66,66,0,1,0,1,0
52118,445,0,0,drop,70,70,0,1,0,1,0
64877,445,0,0,drop,70,70,0,1,0,1,0
47134,37965,0,0,deny,62,62,0,1,0,1,0
57584,443,53316,443,allow,915797,52405,863392,1231,269,604,627
51738,445,0,0,drop,70,70,0,1,0,1,0
60075,445,0,0,drop,70,70,0,1,0,1,0
53924,45212,48371,45212,allow,70,70,0,2,8,2,0
37711,443,32947,443,allow,8060,2166,5894,23,255,12,11
52347,445,0,0,drop,66,66,0,1,0,1,0
51832,40607,46819,40607,allow,70,70,0,2,7,2,0
53016,443,53016,443,allow,4787,1880,2907,19,27,11,8
46537,25174,0,0,deny,62,62,0,1,0,1,0
41810,443,22241,443,allow,7474,2385,5089,15,121,7,8
50337,445,0,0,drop,66,66,0,1,0,1,0
52714,64147,0,0,deny,62,62,0,1,0,1,0
14084,43890,0,0,deny,62,62,0,1,0,1,0
46212,443,60547,443,allow,9753,1572,8181,22,362,11,11
57302,62413,0,0,deny,66,66,0,1,0,1,0
4447,35440,0,0,deny,66,66,0,1,0,1,0
56046,53,55070,53,allow,193,102,91,2,31,1,1
2935,64147,0,0,deny,62,62,0,1,0,1,0
52209,37241,61696,37241,allow,136,136,0,3,14,3,0
44546,32468,0,0,deny,62,62,0,1,0,1,0
64132,53,9025,53,allow,174,89,85,2,30,1,1
1931,53,26121,53,allow,210,78,132,2,30,1,1
57240,53,57857,53,allow,215,94,121,2,30,1,1
50011,53,8163,53,allow,272,110,162,2,30,1,1
58638,5900,0,0,deny,62,62,0,1,0,1,0
43693,443,24547,443,allow,6389,1439,4950,22,18,11,11
443,12105,0,0,deny,66,66,0,1,0,1,0
45964,2225,0,0,deny,60,60,0,1,0,1,0
58072,445,0,0,drop,66,66,0,1,0,1,0
57416,53,8404,53,allow,193,102,91,2,29,1,1
41812,443,33083,443,allow,6617,1705,4912,24,331,11,13
53226,443,20634,443,allow,5993,974,5019,19,59,10,9
56930,53,53703,53,allow,774,101,673,2,31,1,1
60319,445,0,0,drop,70,70,0,1,0,1,0
55517,53,26427,53,allow,179,94,85,2,29,1,1
57417,53,39419,53,allow,199,102,97,2,30,1,1
59552,445,0,0,drop,70,70,0,1,0,1,0
40452,1488,40452,1488,allow,156,156,0,3,8,3,0
57470,1136,15403,1136,allow,402,132,270,6,1209,3,3
52957,53,50377,53,allow,168,78,90,2,29,1,1
61356,53,61356,53,allow,235,90,145,2,32,1,1
50559,53,13725,53,allow,216,110,106,2,29,1,1
56067,53,5556,53,allow,195,102,93,2,30,1,1
58638,5900,0,0,deny,62,62,0,1,0,1,0
33453,64147,0,0,deny,62,62,0,1,0,1,0
9319,443,38033,443,allow,5687,499,5188,14,16,7,7
64908,53,55022,53,allow,232,94,138,2,30,1,1
50182,443,53780,443,allow,6349,1071,5278,18,42,10,8
51077,445,0,0,drop,70,70,0,1,0,1,0
62431,445,0,0,drop,70,70,0,1,0,1,0
52008,49383,8718,49383,allow,70,70,0,2,8,2,0
64030,445,0,0,drop,70,70,0,1,0,1,0
56941,53,4680,53,allow,192,98,94,2,31,1,1
49321,53,65339,53,allow,225,102,123,2,30,1,1
65029,445,0,0,drop,70,70,0,1,0,1,0
55602,53,61633,53,allow,711,87,624,2,30,1,1
59884,445,0,0,drop,70,70,0,1,0,1,0
52128,445,0,0,drop,70,70,0,1,0,1,0
56439,80,9837,80,allow,17128,1499,15629,24,25,9,15
55020,443,57548,443,allow,3533,1045,2488,17,147,8,9
56246,53,65270,53,allow,202,103,99,2,30,1,1
58366,445,0,0,drop,70,70,0,1,0,1,0
65336,445,0,0,drop,70,70,0,1,0,1,0
55872,53,55193,53,allow,819,102,717,2,30,1,1
55199,53,62068,53,allow,152,78,74,2,30,1,1
60041,443,53446,443,allow,1015,572,443,11,142,6,5
58638,5900,0,0,deny,62,62,0,1,0,1,0
64019,445,0,0,drop,66,66,0,1,0,1,0
53433,445,0,0,drop,70,70,0,1,0,1,0
64610,53,2406,53,allow,292,102,190,2,30,1,1
30948,50584,0,0,deny,146,146,0,1,0,1,0
64037,445,0,0,drop,70,70,0,1,0,1,0
57541,445,0,0,drop,70,70,0,1,0,1,0
61213,445,0,0,drop,66,66,0,1,0,1,0
0,0,0,0,allow,244,244,0,2,0,2,0
62104,445,0,0,drop,70,70,0,1,0,1,0
62864,443,56821,443,allow,86513,10300,76213,131,137,54,77
55491,445,0,0,drop,70,70,0,1,0,1,0
48978,443,3498,443,allow,10163,3585,6578,47,26,24,23
49359,443,29384,443,allow,6261,1362,4899,22,15,12,10
63770,445,0,0,drop,70,70,0,1,0,1,0
63026,53,55076,53,allow,304,86,218,2,30,1,1
53023,443,2353,443,allow,9625,3512,6113,41,92,21,20
57947,443,51760,443,allow,3282,781,2501,17,136,8,9
52066,60118,24886,60118,allow,70,70,0,2,8,2,0
27005,27017,50516,27017,allow,873,126,747,2,30,1,1
29805,53,29805,53,allow,226,89,137,2,30,1,1
60048,443,33885,443,allow,12254,3186,9068,27,171,13,14
50288,80,24804,80,allow,2032,600,1432,10,45,6,4
60772,36829,0,0,deny,66,66,0,1,0,1,0
60535,80,60535,80,allow,318,120,198,6,25,3,3
56317,53,55686,53,allow,182,93,89,2,31,1,1
56975,445,0,0,drop,70,70,0,1,0,1,0
38567,80,39974,80,allow,1571,877,694,11,181,6,5
45682,37965,0,0,deny,62,62,0,1,0,1,0
64950,53,22680,53,allow,182,93,89,2,31,1,1
46640,9002,0,0,deny,60,60,0,1,0,1,0
63951,53,11656,53,allow,193,102,91,2,30,1,1
56879,53,15909,53,allow,780,93,687,2,31,1,1
28378,56205,0,0,deny,62,62,0,1,0,1,0
57366,445,0,0,drop,70,70,0,1,0,1,0
55382,53,48828,53,allow,199,102,97,2,30,1,1
56100,53,20590,53,allow,216,110,106,2,30,1,1
59723,443,10674,443,allow,70,70,0,2,5,2,0
56741,53,5499,53,allow,370,94,276,2,30,1,1
62020,64147,0,0,deny,145,145,0,1,0,1,0
57987,56125,0,0,deny,90,90,0,1,0,1,0
56985,443,5059,443,allow,2281,1126,1155,25,120,12,13
62557,445,0,0,drop,70,70,0,1,0,1,0
60772,36829,0,0,deny,62,62,0,1,0,1,0
42166,443,20816,443,allow,5309,3110,2199,36,81,18,18
49631,53,56350,53,allow,198,102,96,2,30,1,1
3052,20421,0,0,deny,104,104,0,1,0,1,0
0,0,0,0,deny,156,156,0,2,0,2,0
36903,56205,0,0,deny,146,146,0,1,0,1,0
63448,445,0,0,drop,70,70,0,1,0,1,0
49418,27016,30078,27016,allow,78,78,0,1,30,1,0
49380,53,47715,53,allow,199,102,97,2,30,1,1
49640,53,5967,53,allow,402,118,284,2,30,1,1
56732,10271,46976,10271,allow,3090,1706,1384,16,30,10,6
49921,53,21465,53,allow,214,110,104,2,31,1,1
50083,80,45276,80,allow,38045,26409,11636,105,476,68,37
65200,53,35834,53,allow,290,102,188,2,30,1,1
52996,443,47538,443,allow,22513,15188,7325,69,517,31,38
45000,443,43427,443,allow,2227,1018,1209,17,16,8,9
44583,443,45015,443,allow,6834,3797,3037,48,97,23,25
57246,8525,57246,8525,allow,138,78,60,2,5,1,1
50638,443,62460,443,allow,14401,2712,11689,52,19,23,29
1373,22114,0,0,deny,62,62,0,1,0,1,0
53713,443,37609,443,allow,4931,957,3974,17,15,10,7
61803,445,0,0,drop,66,66,0,1,0,1,0
1024,64147,0,0,deny,62,62,0,1,0,1,0
58744,80,31824,80,allow,4635,1572,3063,12,15,7,5
55027,37965,0,0,deny,145,145,0,1,0,1,0
46587,57470,0,0,deny,66,66,0,1,0,1,0
50875,53,21370,53,allow,78,78,0,1,30,1,0
51985,80,53937,80,allow,14233438,253696,13979742,12752,54,3515,9237
9500,443,23639,443,allow,3614,434,3180,11,15,6,5
64727,25174,0,0,deny,66,66,0,1,0,1,0
45912,44847,0,0,deny,62,62,0,1,0,1,0
49746,53,8872,53,allow,290,102,188,2,30,1,1
64228,445,0,0,drop,70,70,0,1,0,1,0
50669,443,61553,443,allow,2985,1505,1480,16,20,9,7
53460,443,49234,443,allow,6118,5698,420,12,124,6,6
64748,53,7421,53,allow,152,78,74,2,30,1,1
39981,57470,0,0,deny,62,62,0,1,0,1,0
57298,445,0,0,drop,66,66,0,1,0,1,0
49296,80,39063,80,allow,1515,481,1034,11,15,6,5
26900,27017,37776,27017,allow,422,164,258,6,30,3,3
56388,53,20771,53,allow,816,102,714,2,30,1,1
5231,30114,20445,30114,allow,832,832,0,14,96,14,0
42558,64147,0,0,deny,62,62,0,1,0,1,0
9123,80,23605,80,allow,65336,2808,62528,73,37,28,45
56444,53,36861,53,allow,730,102,628,2,29,1,1
55251,53,62666,53,allow,208,106,102,2,31,1,1
54418,443,37950,443,allow,3350,1804,1546,19,255,10,9
56744,53,44320,53,allow,740,93,647,2,31,1,1
49197,30188,0,0,deny,62,62,0,1,0,1,0
15503,57141,65001,57141,allow,481,150,331,2,1200,1,1
53892,445,0,0,drop,70,70,0,1,0,1,0
53913,28402,8057,28402,allow,70,70,0,1,4,1,0
55667,445,0,0,drop,70,70,0,1,0,1,0
57282,53,4028,53,allow,199,102,97,2,29,1,1
49788,443,22621,443,allow,74171,1888,72283,72,126,18,54
56612,53,28216,53,allow,178,94,84,2,30,1,1
61000,15503,0,0,deny,146,146,0,1,0,1,0
49159,53,48232,53,allow,213,102,111,2,29,1,1
40936,5900,0,0,deny,60,60,0,1,0,1,0
51579,445,0,0,drop,70,70,0,1,0,1,0
56156,445,0,0,drop,70,70,0,1,0,1,0
63998,21247,0,0,deny,66,66,0,1,0,1,0
63943,53,31455,53,allow,254,110,144,2,30,1,1
51975,445,0,0,drop,66,66,0,1,0,1,0
55528,443,24685,443,allow,7845,1860,5985,24,81,14,10
56752,53,41172,53,allow,183,94,89,2,30,1,1
64406,50584,0,0,deny,66,66,0,1,0,1,0
55556,445,0,0,drop,70,70,0,1,0,1,0
62804,37965,0,0,deny,62,62,0,1,0,1,0
58003,80,63884,80,allow,14987,10571,4416,40,75,20,20
58638,5900,0,0,deny,62,62,0,1,0,1,0
55910,53,5285,53,allow,182,93,89,2,30,1,1
61282,445,0,0,drop,66,66,0,1,0,1,0
43837,443,27944,443,allow,70,70,0,1,4,1,0
19416,23,0,0,deny,60,60,0,1,0,1,0
55123,64097,0,0,deny,66,66,0,1,0,1,0
54778,445,0,0,drop,66,66,0,1,0,1,0
32124,30188,0,0,deny,62,62,0,1,0,1,0
55206,53,49621,53,allow,196,94,102,2,30,1,1
52918,443,11338,443,allow,326078,45627,280451,737,116,252,485
58993,443,47340,443,allow,6414,1614,4800,24,17,13,11
20650,26467,0,0,deny,62,62,0,1,0,1,0
64455,445,0,0,drop,70,70,0,1,0,1,0
49429,53,19123,53,allow,204,104,100,2,31,1,1
39586,22114,0,0,deny,66,66,0,1,0,1,0
56986,53,21320,53,allow,177,94,83,2,31,1,1
60720,443,36383,443,allow,41921,15385,26536,69,34,37,32
63141,445,0,0,drop,70,70,0,1,0,1,0
58547,445,0,0,drop,70,70,0,1,0,1,0
37602,53,37602,53,allow,260,106,154,2,32,1,1
56734,443,60875,443,allow,7889,1900,5989,20,15,11,9
39661,53733,0,0,deny,146,146,0,1,0,1,0
16654,50265,0,0,deny,62,62,0,1,0,1,0
59422,51221,0,0,deny,66,66,0,1,0,1,0
51525,445,0,0,drop,70,70,0,1,0,1,0
53856,445,0,0,drop,70,70,0,1,0,1,0
64673,53,43122,53,allow,213,94,119,2,30,1,1
47682,64147,0,0,deny,66,66,0,1,0,1,0
40985,443,29028,443,allow,3166,2097,1069,24,46,12,12
56020,53,53467,53,allow,198,101,97,2,31,1,1
49418,22114,0,0,deny,62,62,0,1,0,1,0
55010,443,35131,443,allow,9023,4071,4952,30,35,17,13
65409,53,62247,53,allow,200,94,106,2,30,1,1
65216,35440,0,0,deny,66,66,0,1,0,1,0
59679,37807,0,0,deny,66,66,0,1,0,1,0
61832,445,0,0,drop,66,66,0,1,0,1,0
55077,53,49404,53,allow,394,94,300,2,30,1,1
59948,22114,0,0,deny,146,146,0,1,0,1,0
54251,445,0,0,drop,70,70,0,1,0,1,0
53163,32834,49682,32834,allow,70,70,0,1,5,1,0
52837,53,0,0,allow,86,86,0,1,29,1,0
37965,54371,6962,54371,allow,132,132,0,3,1199,3,0
43223,443,31934,443,allow,836939,25380,811559,864,64,302,562
55004,53,63304,53,allow,270,102,168,2,30,1,1
27677,22114,0,0,deny,62,62,0,1,0,1,0
58418,445,0,0,drop,70,70,0,1,0,1,0
65530,53,20818,53,allow,166,85,81,2,30,1,1
64582,445,0,0,drop,70,70,0,1,0,1,0
27739,7000,27739,7000,allow,2163,676,1487,14,15,7,7
49207,445,0,0,drop,70,70,0,1,0,1,0
55126,53,57162,53,allow,177,94,83,2,30,1,1
40959,61903,0,0,deny,145,145,0,1,0,1,0
64900,445,0,0,drop,70,70,0,1,0,1,0
62843,53,62843,53,allow,235,90,145,2,32,1,1
59723,443,40207,443,allow,304,86,218,2,30,1,1
55180,53,64280,53,allow,780,93,687,2,31,1,1
53248,443,53248,443,allow,1588,817,771,20,121,10,10
50337,53,50337,53,allow,260,106,154,2,30,1,1
51457,443,49898,443,allow,642,582,60,2,15,1,1
49647,53,18676,53,allow,361,102,259,2,30,1,1
39317,443,31071,443,allow,2045,1025,1020,17,80,9,8
49418,27056,31810,27056,allow,269,78,191,2,30,1,1
27005,27015,26613,27015,allow,1664,126,1538,4,30,2,2
3478,61463,0,0,deny,918,918,0,1,0,1,0
50252,53,45062,53,allow,173,94,79,2,30,1,1
62360,445,0,0,drop,66,66,0,1,0,1,0
65322,53,59723,53,allow,235,94,141,2,30,1,1
50125,443,44397,443,allow,9798,3571,6227,43,143,23,20
60741,443,38588,443,allow,2042,559,1483,20,89,6,14
62581,445,0,0,drop,70,70,0,1,0,1,0
32618,53,32618,53,allow,231,90,141,2,31,1,1
57072,53,1078,53,allow,190,97,93,2,31,1,1
50017,443,23366,443,allow,56408,47400,9008,88,138,49,39
12785,2323,0,0,deny,60,60,0,1,0,1,0
49198,443,22902,443,allow,533813,25885,507928,678,50,308,370
64321,445,0,0,drop,70,70,0,1,0,1,0
50619,53,43137,53,allow,815,95,720,2,30,1,1
52123,1433,0,0,deny,60,60,0,1,0,1,0
55247,443,30780,443,allow,9656,3460,6196,22,46,12,10
52207,80,29595,80,allow,372,246,126,6,27,4,2
59353,445,0,0,drop,70,70,0,1,0,1,0
49202,53,22068,53,allow,498,204,294,6,29,3,3
62055,443,14508,443,allow,11694,4947,6747,34,48,19,15
65233,23117,0,0,deny,66,66,0,1,0,1,0
15986,8000,55980,8000,allow,274,150,124,4,60,2,2
42298,40007,31436,40007,allow,148,86,62,2,30,1,1
52527,445,0,0,drop,70,70,0,1,0,1,0
50951,445,0,0,drop,70,70,0,1,0,1,0
49503,443,6313,443,allow,20565,2848,17717,31,27,10,21
48867,443,13159,443,allow,6107,2079,4028,19,68,11,8
50440,53,39485,53,allow,216,110,106,2,30,1,1
65229,53,46914,53,allow,193,102,91,2,30,1,1
51164,64147,0,0,deny,66,66,0,1,0,1,0
26452,80,26452,80,allow,642,338,304,10,33,6,4
57432,443,22941,443,allow,26468,3325,23143,41,147,16,25
53864,443,51683,443,allow,232,172,60,3,5,2,1
64798,53,7114,53,allow,178,94,84,2,30,1,1
49158,80,49158,80,allow,10922,816,10106,19,18,8,11
52307,445,0,0,drop,70,70,0,1,0,1,0
59770,443,53384,443,allow,9630,1304,8326,28,30,14,14
48631,443,20403,443,allow,42910,5005,37905,72,136,36,36
56112,445,0,0,drop,70,70,0,1,0,1,0
63323,54369,0,0,deny,78,78,0,1,0,1,0
15400,47807,0,0,deny,159,159,0,1,0,1,0
55285,53,1660,53,allow,268,95,173,4,45,2,2
51076,443,8592,443,allow,19880,4739,15141,58,187,26,32
52910,51221,0,0,deny,78,78,0,1,0,1,0
59759,443,40820,443,allow,13342,1221,12121,33,41,15,18
35201,53,32554,53,allow,308,118,190,2,30,1,1
49180,53,37264,53,allow,314,97,217,4,34,2,2
60479,445,0,0,drop,70,70,0,1,0,1,0
64675,445,0,0,drop,66,66,0,1,0,1,0
62569,44847,0,0,deny,66,66,0,1,0,1,0
53756,50584,0,0,deny,66,66,0,1,0,1,0
65155,53,9340,53,allow,613,200,413,6,59,3,3
58638,5900,0,0,deny,62,62,0,1,0,1,0
64750,53,43856,53,allow,193,102,91,2,30,1,1
50202,53,17431,53,allow,166,86,80,2,30,1,1
63888,25174,0,0,deny,66,66,0,1,0,1,0
53810,8999,16528,8999,allow,320,140,180,6,5,3,3
52741,24211,0,0,deny,66,66,0,1,0,1,0
59899,3389,59899,3389,allow,3624,1910,1714,19,32,11,8
55199,443,36951,443,allow,4086,1248,2838,24,140,11,13
6828,64322,0,0,deny,60,60,0,1,0,1,0
49639,443,42419,443,allow,21062,2202,18860,34,80,15,19
59773,443,43322,443,allow,165464,10322,155142,189,71,69,120
49311,445,0,0,drop,70,70,0,1,0,1,0
49905,445,0,0,drop,70,70,0,1,0,1,0
53911,445,0,0,drop,70,70,0,1,0,1,0
50472,80,63342,80,allow,12222,3865,8357,23,22,11,12
53114,32975,63232,32975,allow,70,70,0,1,5,1,0
63427,445,0,0,drop,70,70,0,1,0,1,0
56769,445,0,0,drop,66,66,0,1,0,1,0
64957,53,47584,53,allow,192,98,94,2,30,1,1
55066,80,57629,80,allow,2554,1742,812,15,77,8,7
58165,445,0,0,drop,66,66,0,1,0,1,0
62306,443,62306,443,allow,5442,2195,3247,22,39,13,9
60416,55998,54141,55998,allow,70,70,0,1,5,1,0
49767,53,59870,53,allow,200,102,98,2,30,1,1
55341,39004,0,0,deny,74,74,0,1,0,1,0
51941,445,0,0,drop,66,66,0,1,0,1,0
59592,445,0,0,drop,70,70,0,1,0,1,0
57307,53,14179,53,allow,177,94,83,2,30,1,1
33324,42873,0,0,deny,62,62,0,1,0,1,0
55145,443,65048,443,allow,13231,6169,7062,38,120,19,19
42630,53,12099,53,allow,168,78,90,2,30,1,1
27005,31010,2449,31010,allow,1626,126,1500,4,31,2,2
27005,27015,63716,27015,allow,889,126,763,2,30,1,1
50049,443,7528,443,allow,27889,1445,26444,37,121,14,23
63658,445,0,0,drop,70,70,0,1,0,1,0
28498,36237,0,0,deny,146,146,0,1,0,1,0
49706,53,34348,53,allow,258,110,148,2,30,1,1
48513,443,48513,443,allow,4566,1659,2907,19,27,11,8
58213,445,0,0,drop,70,70,0,1,0,1,0
55469,53,16063,53,allow,817,98,719,2,31,1,1
49227,53,39429,53,allow,174,89,85,2,30,1,1
63621,445,0,0,drop,70,70,0,1,0,1,0
49909,445,0,0,drop,66,66,0,1,0,1,0
19875,30170,0,0,deny,145,145,0,1,0,1,0
54816,445,0,0,drop,70,70,0,1,0,1,0
65273,53,14991,53,allow,338,110,228,2,29,1,1
41243,443,21826,443,allow,3697,2379,1318,26,16,14,12
58830,28678,13686,28678,allow,1806,1806,0,22,224,22,0
11136,17500,0,0,deny,145,145,0,1,0,1,0
55806,53,43969,53,allow,200,102,98,2,32,1,1
49710,445,0,0,drop,66,66,0,1,0,1,0
62662,445,0,0,drop,70,70,0,1,0,1,0
63264,445,0,0,drop,70,70,0,1,0,1,0
62725,51221,0,0,deny,66,66,0,1,0,1,0
18415,37965,0,0,deny,62,62,0,1,0,1,0
62997,445,0,0,drop,66,66,0,1,0,1,0
63847,445,0,0,drop,66,66,0,1,0,1,0
55972,53,38960,53,allow,756,95,661,2,31,1,1
48817,27003,48817,27003,allow,839,296,543,4,1200,2,2
58901,443,24407,443,allow,17071,1532,15539,17,27,3,14
49296,53,40688,53,allow,322,98,224,4,32,2,2
57987,56125,0,0,deny,90,90,0,1,0,1,0
35187,443,44307,443,allow,27553,21226,6327,57,216,31,26
55492,80,58922,80,allow,164902,9835,155067,227,32,114,113
63310,445,0,0,drop,70,70,0,1,0,1,0
27005,27015,56758,27015,allow,869,126,743,2,30,1,1
57146,445,0,0,drop,66,66,0,1,0,1,0
50354,443,29554,443,allow,1786,172,1614,7,120,3,4
9518,30228,0,0,deny,100,100,0,1,0,1,0
53502,443,33693,443,allow,10893,6516,4377,36,131,16,20
39802,443,21011,443,allow,3025,1958,1067,26,49,14,12
64992,53,21333,53,allow,177,94,83,2,29,1,1
56386,445,0,0,drop,66,66,0,1,0,1,0
43260,41615,0,0,deny,145,145,0,1,0,1,0
2904,44847,0,0,deny,78,78,0,1,0,1,0
52975,23718,0,0,deny,66,66,0,1,0,1,0
56783,53,3501,53,allow,186,95,91,2,30,1,1
14059,21247,0,0,deny,146,146,0,1,0,1,0
52516,80,41641,80,allow,3224,2776,448,11,15,7,4
55181,53,51083,53,allow,815,95,720,2,31,1,1
60967,443,57765,443,allow,11529,8753,2776,41,120,22,19
53392,445,0,0,drop,70,70,0,1,0,1,0
49898,53,31342,53,allow,184,94,90,2,30,1,1
65099,53,22746,53,allow,199,102,97,2,31,1,1
64326,53,28923,53,allow,192,98,94,2,31,1,1
56673,53,38951,53,allow,183,94,89,2,30,1,1
53370,445,0,0,drop,66,66,0,1,0,1,0
56643,53,21130,53,allow,195,102,93,2,31,1,1
1749,64147,0,0,deny,62,62,0,1,0,1,0
50303,443,45984,443,allow,3051,1801,1250,18,15,8,10
54633,36237,0,0,deny,66,66,0,1,0,1,0
44849,46478,0,0,deny,74,74,0,1,0,1,0
55630,53,24833,53,allow,197,102,95,2,30,1,1
59419,80,51819,80,allow,3442,1672,1770,19,22,10,9
57941,445,0,0,drop,66,66,0,1,0,1,0
40893,123,36091,123,allow,184,94,90,2,31,1,1
50416,80,7917,80,allow,11343,3864,7479,22,21,11,11
56569,445,0,0,drop,70,70,0,1,0,1,0
60119,445,0,0,drop,70,70,0,1,0,1,0
60923,49903,0,0,deny,66,66,0,1,0,1,0
54903,445,0,0,drop,70,70,0,1,0,1,0
54134,445,0,0,drop,70,70,0,1,0,1,0
55000,53,30925,53,allow,753,93,660,2,31,1,1
58558,445,0,0,drop,70,70,0,1,0,1,0
49289,445,0,0,drop,70,70,0,1,0,1,0
55459,50584,0,0,deny,66,66,0,1,0,1,0
52011,443,52011,443,allow,110812,7779,103033,122,49,44,78
55560,445,0,0,drop,70,70,0,1,0,1,0
56979,445,0,0,drop,70,70,0,1,0,1,0
51895,17172,52457,17172,allow,70,70,0,2,8,2,0
58638,5900,0,0,deny,62,62,0,1,0,1,0
55639,445,0,0,drop,70,70,0,1,0,1,0
53592,23578,40087,23578,allow,70,70,0,2,7,2,0
49172,53,32719,53,allow,227,102,125,2,29,1,1
54752,31573,0,0,deny,62,62,0,1,0,1,0
55796,53,53720,53,allow,196,102,94,2,30,1,1
38518,1900,0,0,deny,139,139,0,1,0,1,0
60547,445,0,0,drop,70,70,0,1,0,1,0
56490,80,11731,80,allow,43084,3056,40028,60,135,27,33
62377,443,62377,443,allow,4378,1471,2907,19,27,11,8
42804,80,7713,80,allow,1115,534,581,12,15,7,5
9322,443,10424,443,allow,4106,703,3403,15,26,8,7
64814,53,35715,53,allow,173,94,79,2,30,1,1
2267,53,54801,53,allow,204,118,86,2,30,1,1
57339,57470,0,0,deny,66,66,0,1,0,1,0
57038,445,0,0,drop,70,70,0,1,0,1,0
64288,53,63361,53,allow,229,110,119,2,29,1,1
34454,80,29541,80,allow,2913,633,2280,15,16,8,7
49365,443,8370,443,allow,3598,1145,2453,15,120,7,8
18771,35440,0,0,deny,62,62,0,1,0,1,0
56076,53,58265,53,allow,311,94,217,2,30,1,1
64980,53,27979,53,allow,199,102,97,2,29,1,1
64106,53,52132,53,allow,195,102,93,2,29,1,1
63791,445,0,0,drop,70,70,0,1,0,1,0
54276,37628,0,0,deny,66,66,0,1,0,1,0
56397,26467,0,0,deny,62,62,0,1,0,1,0
51383,445,0,0,drop,66,66,0,1,0,1,0
1024,44847,0,0,deny,62,62,0,1,0,1,0
41520,53,0,0,allow,82,82,0,1,30,1,0
25889,11446,0,0,deny,66,66,0,1,0,1,0
58638,5900,0,0,deny,62,62,0,1,0,1,0
49503,53,43089,53,allow,167,86,81,2,29,1,1
57323,53,24768,53,allow,194,102,92,2,31,1,1
40521,28678,47764,28678,allow,1806,1806,0,22,225,22,0
43461,35440,0,0,deny,62,62,0,1,0,1,0
53719,49306,59032,49306,allow,70,70,0,2,8,2,0
55388,53,5023,53,allow,720,94,626,2,30,1,1
51263,445,0,0,drop,66,66,0,1,0,1,0
40507,53,2072,53,allow,86,86,0,1,30,1,0
52043,80,5658,80,allow,1484,805,679,11,25,7,4
51403,445,0,0,drop,66,66,0,1,0,1,0
58638,5900,0,0,deny,62,62,0,1,0,1,0
61762,44847,0,0,deny,62,62,0,1,0,1,0
11295,40002,5818,40002,allow,356,170,186,6,53,3,3
27998,443,50249,443,allow,5515,1388,4127,18,15,9,9
55199,53,24591,53,allow,152,78,74,2,29,1,1
57744,53,14767,53,allow,198,93,105,2,31,1,1
123,123,55557,123,allow,184,94,90,2,29,1,1
64876,53,13922,53,allow,718,94,624,2,31,1,1
40401,80,34965,80,allow,1603,1179,424,10,124,6,4
48739,443,34033,443,allow,7107,1636,5471,24,38,11,13
49358,443,12762,443,allow,137147,82203,54944,174,105,103,71
50367,445,0,0,drop,70,70,0,1,0,1,0
60881,443,30566,443,allow,8284,1577,6707,29,48,14,15
50251,445,0,0,drop,70,70,0,1,0,1,0
2946,25174,0,0,deny,62,62,0,1,0,1,0
53675,29970,54968,29970,allow,612,426,186,10,22,7,3
65372,53,40284,53,allow,198,102,96,2,30,1,1
13795,2323,0,0,deny,60,60,0,1,0,1,0
44847,20009,63949,20009,allow,502,150,352,2,1200,1,1
52073,80,46138,80,allow,482,300,182,9,26,6,3
19698,502,0,0,deny,60,60,0,1,0,1,0
56004,443,20130,443,allow,53826,3670,50156,85,275,41,44
53889,19002,16357,19002,allow,552,306,246,9,15,5,4
64534,53,57803,53,allow,214,110,104,2,30,1,1
27005,27023,4968,27023,allow,1640,126,1514,4,30,2,2
54321,445,0,0,drop,70,70,0,1,0,1,0
64519,445,0,0,drop,66,66,0,1,0,1,0
57602,80,57602,80,allow,4226,2910,1316,19,38,10,9
54563,445,0,0,drop,70,70,0,1,0,1,0
64023,53,57287,53,allow,179,94,85,2,30,1,1
5588,5588,0,0,allow,3562,1936,1626,48,192,24,24
63542,3389,63542,3389,allow,3504,1790,1714,17,32,9,8
15503,14130,48221,14130,allow,480,149,331,2,1200,1,1
33850,443,55796,443,allow,6987,2005,4982,18,16,9,9
65398,7129,0,0,deny,66,66,0,1,0,1,0
49418,27018,39372,27018,allow,259,71,188,2,31,1,1
19236,53,19236,53,allow,235,90,145,2,33,1,1
50511,80,14463,80,allow,318,192,126,6,25,4,2
49167,53,55909,53,allow,193,102,91,2,30,1,1
49777,53,14014,53,allow,166,86,80,2,30,1,1
64550,445,0,0,drop,66,66,0,1,0,1,0
7372,61248,0,0,reset-both,139,139,0,1,0,1,0
56700,443,13069,443,allow,8059,2039,6020,20,16,11,9
64358,445,0,0,drop,70,70,0,1,0,1,0
55143,445,0,0,drop,66,66,0,1,0,1,0
63323,54369,0,0,deny,78,78,0,1,0,1,0
58736,53,58736,53,allow,235,90,145,2,32,1,1
56531,53,17376,53,allow,309,94,215,2,30,1,1
57170,53,64269,53,allow,200,102,98,2,31,1,1
58638,5900,0,0,deny,62,62,0,1,0,1,0
56058,53,33400,53,allow,200,94,106,2,30,1,1
51581,22114,0,0,deny,66,66,0,1,0,1,0
53197,25174,0,0,deny,66,66,0,1,0,1,0
31539,37965,0,0,deny,62,62,0,1,0,1,0
51913,80,58997,80,allow,366,240,126,7,29,5,2
14397,37965,0,0,deny,62,62,0,1,0,1,0
60130,80,60130,80,allow,23216,1806,21410,40,28,20,20
28345,11392,0,0,deny,66,66,0,1,0,1,0
42847,443,14614,443,allow,162,102,60,2,4,1,1
55006,443,44050,443,allow,2900,2007,893,20,36,12,8
65192,53,4438,53,allow,172,88,84,2,30,1,1
50489,80,24870,80,allow,318,192,126,6,25,4,2
50453,445,0,0,drop,66,66,0,1,0,1,0
48676,53392,0,0,deny,60,60,0,1,0,1,0
64631,53,54731,53,allow,351,93,258,4,50,2,2
61550,5529,0,0,deny,145,145,0,1,0,1,0
52079,80,61511,80,allow,366,240,126,7,25,5,2
52144,15208,55499,15208,allow,70,70,0,1,5,1,0
64627,53,26278,53,allow,168,86,82,2,30,1,1
50456,53,42563,53,allow,754,94,660,2,30,1,1
51151,64147,0,0,deny,62,62,0,1,0,1,0
52482,445,0,0,drop,70,70,0,1,0,1,0
55085,53,9873,53,allow,301,94,207,2,30,1,1
64697,53,40381,53,allow,199,102,97,2,30,1,1
64946,53,64946,53,allow,233,90,143,2,33,1,1
55223,53,31444,53,allow,168,86,82,2,30,1,1
64083,63666,21856,63666,allow,66,66,0,2,8,2,0
15523,53,15523,53,allow,227,88,139,2,30,1,1
443,10010,0,0,deny,60,60,0,1,0,1,0
55479,53,50336,53,allow,184,94,90,2,31,1,1
59404,445,0,0,drop,66,66,0,1,0,1,0
49893,80,42792,80,allow,1376,946,430,8,86,5,3
4483,53,4483,53,allow,213,87,126,2,31,1,1
56434,80,3931,80,allow,17128,1499,15629,24,25,9,15
50683,445,0,0,drop,70,70,0,1,0,1,0
56713,25174,0,0,deny,62,62,0,1,0,1,0
64706,53,6789,53,allow,179,94,85,2,30,1,1
53761,54363,63571,54363,allow,618,432,186,9,16,6,3
53034,445,0,0,drop,70,70,0,1,0,1,0
61053,44847,0,0,deny,66,66,0,1,0,1,0
62965,445,0,0,drop,70,70,0,1,0,1,0
36660,443,25642,443,allow,25051,3368,21683,50,313,26,24
63925,37965,0,0,deny,66,66,0,1,0,1,0
65355,445,0,0,drop,70,70,0,1,0,1,0
28034,443,40574,443,allow,5456,1388,4068,17,15,9,8
11337,15503,0,0,deny,62,62,0,1,0,1,0
56368,53,19580,53,allow,711,87,624,2,30,1,1
63316,445,0,0,drop,66,66,0,1,0,1,0
53468,443,36235,443,allow,3153,2232,921,15,15,8,7
57956,445,0,0,drop,70,70,0,1,0,1,0
65482,53,46055,53,allow,179,94,85,2,31,1,1
55560,443,48574,443,allow,7047,1994,5053,20,24,12,8
65257,445,0,0,drop,70,70,0,1,0,1,0
60806,445,0,0,drop,66,66,0,1,0,1,0
56648,53,16460,53,allow,199,102,97,2,31,1,1
50518,80,23907,80,allow,2864,1338,1526,17,21,9,8
63020,445,0,0,drop,70,70,0,1,0,1,0
32970,443,36092,443,allow,8910,2660,6250,24,18,13,11
62234,445,0,0,drop,70,70,0,1,0,1,0
60435,445,0,0,drop,66,66,0,1,0,1,0
2990,64147,0,0,deny,66,66,0,1,0,1,0
56674,53,17434,53,allow,183,94,89,2,31,1,1
58343,23718,0,0,deny,66,66,0,1,0,1,0
43422,80,45475,80,allow,3863,875,2988,12,16,8,4
63779,26467,0,0,deny,66,66,0,1,0,1,0
50557,80,9717,80,allow,318,192,126,6,26,4,2
63939,24867,28601,24867,allow,312,132,180,6,6,3,3
56865,445,0,0,drop,70,70,0,1,0,1,0
51255,445,0,0,drop,70,70,0,1,0,1,0
49628,35440,0,0,deny,66,66,0,1,0,1,0
64104,22114,0,0,deny,62,62,0,1,0,1,0
61861,445,0,0,drop,70,70,0,1,0,1,0
25342,8168,0,0,deny,62,62,0,1,0,1,0
55419,53,50922,53,allow,760,97,663,2,31,1,1
59477,443,16193,443,allow,7825,4076,3749,19,121,10,9
36411,443,59094,443,allow,10691,3704,6987,25,181,13,12
27005,32065,5075,32065,allow,877,126,751,2,31,1,1
34332,443,1542,443,allow,1717,1153,564,13,26,7,6
53481,443,12218,443,allow,5913,4482,1431,30,30,20,10
55704,64097,0,0,deny,66,66,0,1,0,1,0
57436,53,43639,53,allow,733,85,648,2,30,1,1
56974,53,21612,53,allow,814,110,704,2,30,1,1
49332,443,12336,443,allow,4425,1910,2515,36,3656,12,24
41440,443,30380,443,allow,4370,1148,3222,17,25,9,8
60162,53436,0,0,deny,66,66,0,1,0,1,0
62721,56205,0,0,deny,66,66,0,1,0,1,0
33654,443,14790,443,allow,8628,2898,5730,20,144,9,11
45118,39004,0,0,deny,74,74,0,1,0,1,0
23900,64147,0,0,deny,62,62,0,1,0,1,0
52775,80,57119,80,allow,432,240,192,8,101,5,3
58885,443,39873,443,allow,354,294,60,2,15,1,1
39105,443,21624,443,allow,2853588,73973,2779615,2907,129,994,1913
49364,53,61563,53,allow,182,94,88,2,30,1,1
10976,22,10976,22,allow,9240,3413,5827,59,37,26,33
51808,46390,6189,46390,allow,70,70,0,2,8,2,0
54989,50265,0,0,deny,66,66,0,1,0,1,0
59365,42873,0,0,deny,74,74,0,1,0,1,0
10910,57866,0,0,deny,146,146,0,1,0,1,0
49225,80,23885,80,allow,15343,3240,12103,23,81,9,14
65096,37807,0,0,deny,66,66,0,1,0,1,0
43104,26467,0,0,deny,62,62,0,1,0,1,0
32782,80,6482,80,allow,1495,779,716,10,30,6,4
65321,53,29738,53,allow,166,85,81,2,30,1,1
51704,445,0,0,drop,66,66,0,1,0,1,0
49888,53,17695,53,allow,198,102,96,2,29,1,1
56756,443,23896,443,allow,8007,1987,6020,20,15,11,9
11464,37965,0,0,deny,62,62,0,1,0,1,0
51858,445,0,0,drop,70,70,0,1,0,1,0
61915,445,0,0,drop,70,70,0,1,0,1,0
51514,50584,0,0,deny,62,62,0,1,0,1,0
6881,6881,34489,6881,allow,253,118,135,2,1199,1,1
46987,443,53868,443,allow,8688,3211,5477,24,343,11,13
55059,445,0,0,drop,70,70,0,1,0,1,0
48016,57470,0,0,deny,62,62,0,1,0,1,0
56702,445,0,0,drop,70,70,0,1,0,1,0
53760,445,0,0,drop,70,70,0,1,0,1,0
123,123,58588,123,allow,184,94,90,2,30,1,1
50865,445,0,0,drop,66,66,0,1,0,1,0
30800,25174,0,0,deny,146,146,0,1,0,1,0
49877,443,32997,443,allow,37364,16799,20565,189,53,87,102
46715,443,4396,443,allow,2945,779,2166,10,121,5,5
51191,26467,0,0,deny,66,66,0,1,0,1,0
64990,55442,0,0,deny,66,66,0,1,0,1,0
51681,445,0,0,drop,70,70,0,1,0,1,0
63834,27037,60626,27037,allow,1592,1386,206,6,31,4,2
49756,53,28013,53,allow,264,89,175,4,47,2,2
54982,53,55508,53,allow,282,96,186,4,48,2,2
56529,443,43021,443,allow,266757,6935,259822,274,19,97,177
6666,138,0,0,deny,60,60,0,1,0,1,0
64568,53,24682,53,allow,388,134,254,2,30,1,1
52635,445,0,0,drop,70,70,0,1,0,1,0
31680,53,31680,53,allow,404,259,145,3,32,2,1
50859,445,0,0,drop,70,70,0,1,0,1,0
52829,443,52829,443,allow,4613,1706,2907,19,30,11,8
54140,445,0,0,drop,66,66,0,1,0,1,0
6356,26467,0,0,deny,62,62,0,1,0,1,0
14437,443,4301,443,allow,2589,1443,1146,18,16,8,10
57557,64147,0,0,deny,66,66,0,1,0,1,0
62115,57470,0,0,deny,66,66,0,1,0,1,0
37335,443,14228,443,allow,130,70,60,3,5,2,1
61600,56205,0,0,deny,66,66,0,1,0,1,0
49949,53,60223,53,allow,186,95,91,2,31,1,1
2874,53,2874,53,allow,216,82,134,2,31,1,1
21274,30188,0,0,deny,62,62,0,1,0,1,0
51221,57522,58823,57522,allow,481,150,331,2,1200,1,1
49633,80,21073,80,allow,318,192,126,6,41,4,2
56213,26467,0,0,deny,62,62,0,1,0,1,0
14435,443,15912,443,allow,2569,1470,1099,17,15,8,9
51999,37965,0,0,deny,62,62,0,1,0,1,0
27005,27016,48371,27016,allow,887,126,761,2,30,1,1
36765,443,20693,443,allow,27557,20627,6930,89,5581,44,45
51446,53,21490,53,allow,168,78,90,2,30,1,1
58929,445,0,0,drop,70,70,0,1,0,1,0
50042,80,50042,80,allow,2986,1514,1472,10,15,6,4
55163,445,0,0,drop,66,66,0,1,0,1,0
51568,445,0,0,drop,70,70,0,1,0,1,0
48125,7548,0,0,deny,60,60,0,1,0,1,0
62108,443,7391,443,allow,9652,2914,6738,22,124,11,11
49695,445,0,0,drop,70,70,0,1,0,1,0
56632,443,17597,443,allow,13148,2310,10838,29,80,16,13
58638,5900,0,0,deny,62,62,0,1,0,1,0
51864,38544,39396,38544,allow,1345,679,666,9,30,5,4
53230,443,3800,443,allow,6177,1038,5139,22,58,11,11
64068,53,64068,53,allow,1184,83,1101,4,59,2,2
49655,53,33441,53,allow,209,110,99,2,30,1,1
61953,443,64547,443,allow,15246,5574,9672,60,391,27,33
49238,53,49238,53,allow,235,90,145,2,32,1,1
51342,53,21697,53,allow,199,94,105,2,30,1,1
64719,53,44200,53,allow,196,102,94,2,31,1,1
58805,443,25945,443,allow,32148,21507,10641,72,21,42,30
52318,443,6808,443,allow,9453,2797,6656,46,32,25,21
51798,37020,7892,37020,allow,70,70,0,1,5,1,0
27005,27018,36101,27018,allow,1634,126,1508,4,31,2,2
62705,445,0,0,drop,70,70,0,1,0,1,0
55743,445,0,0,drop,70,70,0,1,0,1,0
56500,53,60506,53,allow,199,102,97,2,30,1,1
55978,445,0,0,drop,70,70,0,1,0,1,0
59115,443,45739,443,allow,30048,2775,27273,41,137,16,25
56303,53,63690,53,allow,177,94,83,2,29,1,1
50466,80,60136,80,allow,1718,1247,471,9,15,5,4
32299,40019,6627,40019,allow,261,175,86,2,31,1,1
49952,53,48831,53,allow,195,102,93,2,30,1,1
38002,49152,2185,49152,allow,156,156,0,3,8,3,0
53471,445,0,0,drop,70,70,0,1,0,1,0
49254,53,47857,53,allow,173,94,79,2,30,1,1
56984,53,44033,53,allow,209,102,107,2,30,1,1
40204,40012,25675,40012,allow,148,86,62,2,30,1,1
63934,55027,48051,55027,allow,66,66,0,2,8,2,0
38562,443,38562,443,allow,4611,1704,2907,19,28,11,8
30280,37965,0,0,deny,66,66,0,1,0,1,0
50006,445,0,0,drop,70,70,0,1,0,1,0
58229,50584,0,0,deny,66,66,0,1,0,1,0
60632,445,0,0,drop,70,70,0,1,0,1,0
10704,25174,0,0,deny,62,62,0,1,0,1,0
49362,443,33824,443,allow,9551,6129,3422,35,47,19,16
51413,1,0,0,deny,72,72,0,1,0,1,0
49241,445,0,0,drop,70,70,0,1,0,1,0
35140,123,7443,123,allow,184,94,90,2,30,1,1
53906,443,56748,443,allow,499,425,74,4,0,3,1
65415,445,0,0,drop,70,70,0,1,0,1,0
64756,53,24462,53,allow,757,98,659,2,30,1,1
56979,53,36485,53,allow,176,90,86,2,31,1,1
56750,53,47077,53,allow,711,87,624,2,30,1,1
33896,57470,0,0,deny,74,74,0,1,0,1,0
49556,80,42311,80,allow,7002,5717,1285,15,45,9,6
49469,443,50617,443,allow,6416,1302,5114,20,119,10,10
56532,53,39559,53,allow,193,102,91,2,30,1,1
55457,445,0,0,drop,70,70,0,1,0,1,0
49767,53,45579,53,allow,341,102,239,4,37,2,2
11136,17500,0,0,deny,62,62,0,1,0,1,0
59014,445,0,0,drop,66,66,0,1,0,1,0
51221,20864,10145,20864,allow,7308,6812,496,71,3243,63,8
65487,53,58054,53,allow,184,94,90,2,29,1,1
53161,443,30923,443,allow,2731,1895,836,18,28,10,8
64948,25198,0,0,deny,145,145,0,1,0,1,0
50460,443,50460,443,allow,1159,668,491,11,31,6,5
55708,22094,3066,22094,allow,564,318,246,9,15,5,4
49191,35440,0,0,deny,66,66,0,1,0,1,0
52931,443,32527,443,allow,23112,6278,16834,140,115,55,85
48440,443,28168,443,allow,6945,1551,5394,25,200,12,13
48731,443,51910,443,allow,769074,31261,737813,876,165,356,520
43724,35440,0,0,deny,62,62,0,1,0,1,0
13285,29892,0,0,deny,145,145,0,1,0,1,0
63026,445,0,0,drop,70,70,0,1,0,1,0
50493,443,36062,443,allow,2147464,35144,2112320,1951,72,540,1411
50313,80,19871,80,allow,3450,1386,2064,15,83,8,7
51291,445,0,0,drop,70,70,0,1,0,1,0
60058,445,0,0,drop,70,70,0,1,0,1,0
65439,53,10579,53,allow,228,110,118,2,30,1,1
55896,53,65305,53,allow,184,94,90,2,30,1,1
34053,443,6934,443,allow,5987,1678,4309,21,199,12,9
37647,36237,0,0,deny,62,62,0,1,0,1,0
54420,443,57977,443,allow,5809,1552,4257,19,74,11,8
51936,443,23888,443,allow,4940,3363,1577,27,34,16,11
60038,445,0,0,drop,70,70,0,1,0,1,0
53816,22114,0,0,deny,62,62,0,1,0,1,0
60222,22114,0,0,deny,66,66,0,1,0,1,0
55616,56205,0,0,deny,66,66,0,1,0,1,0
5588,5588,0,0,allow,3562,1936,1626,48,193,24,24
0,0,0,0,deny,102,102,0,1,0,1,0
47040,25174,0,0,deny,146,146,0,1,0,1,0
56733,53,65238,53,allow,177,94,83,2,30,1,1
2323,23117,0,0,deny,146,146,0,1,0,1,0
51722,445,0,0,drop,70,70,0,1,0,1,0
65513,445,0,0,drop,70,70,0,1,0,1,0
58664,53,10827,53,allow,167,78,89,2,29,1,1
27988,40011,54890,40011,allow,253,190,63,2,30,1,1
36803,53,44440,53,allow,243,86,157,2,30,1,1
47663,443,61725,443,allow,214,140,74,4,15,3,1
55857,53,19177,53,allow,437,98,339,4,41,2,2
1620,53567,0,0,deny,66,66,0,1,0,1,0
49646,443,27491,443,allow,12279,4202,8077,33,43,16,17
62649,445,0,0,drop,70,70,0,1,0,1,0
64602,53,34002,53,allow,184,94,90,2,30,1,1
36579,30188,0,0,deny,66,66,0,1,0,1,0
38102,5228,57941,5228,allow,4235,1797,2438,38,4443,13,25
64969,53,18068,53,allow,329,118,211,2,30,1,1
50537,80,34758,80,allow,4186,3559,627,15,31,8,7
59191,35440,0,0,deny,66,66,0,1,0,1,0
57128,445,0,0,drop,70,70,0,1,0,1,0
22724,9822,0,0,deny,66,66,0,1,0,1,0
11076,53,11076,53,allow,832,106,726,2,30,1,1
10949,22114,0,0,deny,62,62,0,1,0,1,0
65408,53,49701,53,allow,817,98,719,2,30,1,1
55820,53,12238,53,allow,184,94,90,2,30,1,1
27005,27017,10381,27017,allow,600,126,474,2,30,1,1
45908,3383,0,0,deny,60,60,0,1,0,1,0
49266,53,16843,53,allow,199,102,97,2,30,1,1
64178,53,3511,53,allow,276,94,182,2,30,1,1
36144,443,59381,443,allow,8859,1662,7197,26,75,14,12
49746,53,11363,53,allow,236,94,142,2,29,1,1
51946,445,0,0,drop,70,70,0,1,0,1,0
50068,445,0,0,drop,70,70,0,1,0,1,0
10126,57470,0,0,deny,62,62,0,1,0,1,0
52519,44847,0,0,deny,66,66,0,1,0,1,0
48436,53,48436,53,allow,216,82,134,2,32,1,1
50468,80,50468,80,allow,90393,7684,82709,132,22,69,63
12945,53,12945,53,allow,233,90,143,2,32,1,1
51674,445,0,0,drop,70,70,0,1,0,1,0
59537,443,51089,443,allow,3351,841,2510,13,136,6,7
55286,37965,0,0,deny,66,66,0,1,0,1,0
55450,53,40761,53,allow,193,102,91,2,29,1,1
54971,445,0,0,drop,70,70,0,1,0,1,0
50181,80,60161,80,allow,2149,1165,984,15,77,8,7
34331,53,34331,53,allow,404,259,145,3,32,2,1
49867,53,7070,53,allow,177,94,83,2,29,1,1
65189,27015,18038,27015,allow,257,78,179,2,30,1,1
44076,443,35127,443,allow,202384,47621,154763,307,198,112,195
64729,445,0,0,drop,66,66,0,1,0,1,0
56127,53,41688,53,allow,167,86,81,2,30,1,1
53328,53,0,0,allow,232,77,155,2,32,1,1
44154,22114,0,0,deny,62,62,0,1,0,1,0
51033,443,39133,443,allow,14697,3801,10896,52,120,24,28
56835,53,37097,53,allow,170,87,83,2,31,1,1
62103,445,0,0,drop,66,66,0,1,0,1,0
10909,30975,0,0,deny,148,148,0,1,0,1,0
27988,40003,22369,40003,allow,148,86,62,2,30,1,1
57318,53,50520,53,allow,418,88,330,4,41,2,2
46417,22114,0,0,deny,146,146,0,1,0,1,0
33814,22114,0,0,deny,146,146,0,1,0,1,0
54302,53,4566,53,allow,168,78,90,2,30,1,1
65318,80,50736,80,allow,2356,499,1857,10,134,6,4
64157,445,0,0,drop,70,70,0,1,0,1,0
45964,55559,0,0,deny,60,60,0,1,0,1,0
58754,445,0,0,drop,70,70,0,1,0,1,0
53702,445,0,0,drop,66,66,0,1,0,1,0
59215,445,0,0,drop,66,66,0,1,0,1,0
56180,53,37696,53,allow,200,102,98,2,30,1,1
0,0,0,0,allow,320,320,0,5,0,5,0
29203,26467,0,0,deny,62,62,0,1,0,1,0
25063,64147,0,0,deny,62,62,0,1,0,1,0
58343,23718,0,0,deny,66,66,0,1,0,1,0
50875,445,0,0,drop,66,66,0,1,0,1,0
44933,23,0,0,deny,60,60,0,1,0,1,0
58058,53,0,0,allow,86,86,0,1,30,1,0
26531,25174,0,0,deny,146,146,0,1,0,1,0
54782,445,0,0,drop,66,66,0,1,0,1,0
46839,51050,0,0,deny,62,62,0,1,0,1,0
55549,445,0,0,drop,66,66,0,1,0,1,0
50608,443,5976,443,allow,5039,2265,2774,21,30,11,10
9058,443,18160,443,allow,5655,934,4721,16,130,8,8
27005,27015,22389,27015,allow,879,126,753,2,30,1,1
50427,445,0,0,drop,70,70,0,1,0,1,0
51026,445,0,0,drop,70,70,0,1,0,1,0
49411,53,20667,53,allow,195,102,93,2,30,1,1
443,11817,0,0,deny,74,74,0,1,0,1,0
58705,445,0,0,drop,70,70,0,1,0,1,0
63364,57470,0,0,deny,66,66,0,1,0,1,0
52278,445,0,0,drop,70,70,0,1,0,1,0
35507,15503,0,0,deny,62,62,0,1,0,1,0
38971,25174,0,0,deny,146,146,0,1,0,1,0
60196,53,0,0,deny,88,88,0,1,0,1,0
19473,40959,26703,40959,allow,491,150,341,2,1200,1,1
55034,443,40095,443,allow,14671,2953,11718,31,31,17,14
1038,37965,0,0,deny,62,62,0,1,0,1,0
56826,22114,0,0,deny,66,66,0,1,0,1,0
38262,80,2079,80,allow,3843,1312,2531,19,227,6,13
60595,445,0,0,drop,66,66,0,1,0,1,0
58000,17,58000,17,allow,66,66,0,1,30,1,0
57389,53,29962,53,allow,193,102,91,2,30,1,1
36379,443,4482,443,allow,4041,2623,1418,22,94,12,10
49440,445,0,0,drop,66,66,0,1,0,1,0
54912,64147,0,0,deny,66,66,0,1,0,1,0
11337,25773,0,0,reset-both,159,159,0,1,0,1,0
21733,56205,0,0,deny,66,66,0,1,0,1,0
52994,443,57845,443,allow,10694,4129,6565,41,111,20,21
57816,445,0,0,drop,66,66,0,1,0,1,0
58638,5900,0,0,deny,62,62,0,1,0,1,0
44792,443,44086,443,allow,9700,2137,7563,21,16,12,9
1024,25174,0,0,deny,62,62,0,1,0,1,0
56767,53,32268,53,allow,177,94,83,2,30,1,1
55713,445,0,0,drop,66,66,0,1,0,1,0
1081,59353,0,0,deny,146,146,0,1,0,1,0
64235,53,30515,53,allow,321,99,222,4,52,2,2
65346,53,19469,53,allow,183,94,89,2,30,1,1
63967,53,14948,53,allow,283,97,186,4,36,2,2
50387,80,54775,80,allow,8105,3187,4918,18,24,9,9
50949,443,50949,443,allow,4453,1546,2907,19,29,11,8
38672,443,23620,443,allow,4478,1133,3345,13,35,8,5
60619,445,0,0,drop,70,70,0,1,0,1,0
38279,80,49834,80,allow,122,62,60,2,15,1,1
55784,53,34530,53,allow,199,94,105,2,29,1,1
50622,53,8191,53,allow,177,94,83,2,31,1,1
49212,53,2222,53,allow,183,94,89,2,30,1,1
57470,41315,64435,41315,allow,792,792,0,13,1199,13,0
55294,53,64912,53,allow,199,102,97,2,29,1,1
53506,50144,41476,50144,allow,492,306,186,8,15,5,3
9018,23,0,0,deny,60,60,0,1,0,1,0
56730,53,45534,53,allow,210,110,100,2,30,1,1
64680,22114,0,0,deny,146,146,0,1,0,1,0
63429,445,0,0,drop,70,70,0,1,0,1,0
56274,53,38501,53,allow,177,94,83,2,30,1,1
45013,50584,0,0,deny,62,62,0,1,0,1,0
49923,445,0,0,drop,70,70,0,1,0,1,0
51825,25501,11280,25501,allow,70,70,0,2,9,2,0
53449,443,9843,443,allow,12474,4810,7664,39,66,19,20
36245,53,44289,53,allow,168,78,90,2,30,1,1
59680,445,0,0,drop,70,70,0,1,0,1,0
59012,445,0,0,drop,70,70,0,1,0,1,0
50429,445,0,0,drop,70,70,0,1,0,1,0
54968,53,59501,53,allow,199,102,97,2,30,1,1
33255,443,24023,443,allow,7579,3093,4486,25,21,14,11
55036,53,30063,53,allow,733,93,640,2,31,1,1
49920,80,51045,80,allow,3649288,78688,3570600,2923,179,528,2395
55373,53,29623,53,allow,164,86,78,2,30,1,1
32843,443,63526,443,allow,6444,2640,3804,18,122,9,9
18652,64147,0,0,deny,62,62,0,1,0,1,0
57869,445,0,0,drop,70,70,0,1,0,1,0
64982,53,55675,53,allow,215,102,113,2,30,1,1
52003,80,10916,80,allow,7464,4661,2803,47,323,30,17
55697,53,39982,53,allow,186,95,91,2,31,1,1
51525,35440,0,0,deny,66,66,0,1,0,1,0
59441,445,0,0,drop,70,70,0,1,0,1,0
56569,53,13010,53,allow,183,94,89,2,30,1,1
51300,64147,0,0,deny,66,66,0,1,0,1,0
56880,53,23570,53,allow,202,103,99,2,31,1,1
55994,22114,0,0,deny,66,66,0,1,0,1,0
53121,443,47087,443,allow,36181,3264,32917,51,62,24,27
55238,53,60752,53,allow,168,86,82,2,29,1,1
49261,80,5363,80,allow,3802643,113349,3689294,3463,206,982,2481
58791,30188,0,0,deny,146,146,0,1,0,1,0
60466,445,0,0,drop,70,70,0,1,0,1,0
50803,445,0,0,drop,70,70,0,1,0,1,0
61237,445,0,0,drop,70,70,0,1,0,1,0
65258,53,4624,53,allow,186,95,91,2,31,1,1
50881,80,32099,80,allow,128327,7366,120961,154,141,67,87
57912,443,57912,443,allow,4559,1652,2907,19,27,11,8
56586,53,54269,53,allow,177,94,83,2,30,1,1
48478,49903,0,0,deny,62,62,0,1,0,1,0
55910,53,63749,53,allow,183,94,89,2,31,1,1
54115,445,0,0,drop,70,70,0,1,0,1,0
50429,445,0,0,drop,70,70,0,1,0,1,0
64417,53,4241,53,allow,184,94,90,2,30,1,1
63390,445,0,0,drop,66,66,0,1,0,1,0
53715,443,59918,443,allow,70,70,0,1,5,1,0
38570,443,8181,443,allow,6260,1587,4673,21,191,12,9
56202,53,30224,53,allow,916,86,830,2,30,1,1
58638,5900,0,0,deny,62,62,0,1,0,1,0
26642,57470,0,0,deny,62,62,0,1,0,1,0
64749,443,34361,443,allow,10750,1814,8936,37,195,17,20
50592,445,0,0,drop,66,66,0,1,0,1,0
64722,53,58551,53,allow,214,110,104,2,30,1,1
59602,445,0,0,drop,70,70,0,1,0,1,0
52328,44847,0,0,deny,66,66,0,1,0,1,0
64987,27042,62086,27042,allow,1012,462,550,4,30,2,2
56658,53,42222,53,allow,177,94,83,2,29,1,1
49418,27015,24745,27015,allow,270,78,192,2,30,1,1
64132,53,36663,53,allow,179,94,85,2,31,1,1
63977,54486,31444,54486,allow,66,66,0,2,8,2,0
55148,53,64223,53,allow,711,87,624,2,30,1,1
39054,443,15031,443,allow,7772,4119,3653,31,17,16,15
54979,443,32141,443,allow,643217,29500,613717,787,53,338,449
43560,443,3098,443,allow,8964,2125,6839,34,120,18,16
49738,53,39292,53,allow,228,86,142,2,29,1,1
59786,443,7763,443,allow,170002,17069,152933,229,48,118,111
50074,443,37111,443,allow,1625,838,787,18,92,10,8
49703,53,23224,53,allow,288,102,186,2,31,1,1
60209,445,0,0,drop,70,70,0,1,0,1,0
51942,22272,51406,22272,allow,210,70,140,4,8,2,2
56754,443,15698,443,allow,8006,1986,6020,20,16,11,9
32484,2323,0,0,deny,60,60,0,1,0,1,0
65085,445,0,0,drop,70,70,0,1,0,1,0
50383,445,0,0,drop,70,70,0,1,0,1,0
55176,53,63516,53,allow,190,97,93,2,31,1,1
49240,53,19807,53,allow,330,101,229,4,47,2,2
50363,53,62670,53,allow,214,110,104,2,30,1,1
62711,443,43946,443,allow,266781,12334,254447,323,161,119,204
57431,53,3019,53,allow,181,94,87,2,31,1,1
49772,53,54364,53,allow,181,94,87,2,31,1,1
16327,55442,0,0,deny,66,66,0,1,0,1,0
62566,445,0,0,drop,66,66,0,1,0,1,0
63317,53,0,0,allow,181,86,95,2,30,1,1
56669,443,61657,443,allow,8058,2038,6020,20,15,11,9
53220,445,0,0,drop,70,70,0,1,0,1,0
58478,445,0,0,drop,70,70,0,1,0,1,0
53599,445,0,0,drop,70,70,0,1,0,1,0
65417,53,53892,53,allow,183,94,89,2,30,1,1
27005,1302,11338,1302,allow,862,126,736,2,30,1,1
59145,445,0,0,drop,66,66,0,1,0,1,0
65299,53,60442,53,allow,177,94,83,2,30,1,1
21274,30188,0,0,deny,62,62,0,1,0,1,0
65315,53,25931,53,allow,770,101,669,2,30,1,1
63877,445,0,0,drop,70,70,0,1,0,1,0
51782,10637,37366,10637,allow,70,70,0,2,8,2,0
51842,27665,45700,27665,allow,66,66,0,1,5,1,0
64956,53,29274,53,allow,196,102,94,2,30,1,1
51880,18468,34831,18468,allow,70,70,0,1,5,1,0
37683,53,37683,53,allow,240,98,142,2,30,1,1
14112,443,14112,443,allow,25629,5823,19806,44,179,25,19
58338,3369,0,0,deny,60,60,0,1,0,1,0
49370,443,33059,443,allow,5782,1008,4774,17,1,8,9
58567,445,0,0,drop,66,66,0,1,0,1,0
57470,6881,39218,6881,allow,517,163,354,2,1200,1,1
59985,57470,0,0,deny,66,66,0,1,0,1,0
60232,445,0,0,drop,66,66,0,1,0,1,0
62930,21247,0,0,deny,66,66,0,1,0,1,0
58728,445,0,0,drop,70,70,0,1,0,1,0
15998,36829,0,0,deny,62,62,0,1,0,1,0
23578,2323,0,0,deny,60,60,0,1,0,1,0
53243,57470,0,0,deny,74,74,0,1,0,1,0
55046,53,5301,53,allow,300,102,198,4,40,2,2
6881,6882,26617,6882,allow,231,111,120,2,1200,1,1
56747,80,7383,80,allow,194,128,66,4,25,3,1
37591,443,4877,443,allow,62657,4444,58213,83,46,37,46
64332,53,56454,53,allow,195,102,93,2,31,1,1
55994,53,19158,53,allow,182,93,89,2,31,1,1
62229,443,62229,443,allow,211574,21152,190422,236,96,92,144
51261,53,15838,53,allow,259,86,173,2,30,1,1
56138,53,1894,53,allow,783,96,687,2,31,1,1
56206,53,31271,53,allow,211,102,109,2,30,1,1
56945,53,62206,53,allow,180,94,86,2,30,1,1
44068,443,30325,443,allow,3947,1744,2203,16,361,8,8
64692,53,27620,53,allow,760,97,663,2,31,1,1
60260,22114,0,0,deny,66,66,0,1,0,1,0
51928,445,0,0,drop,70,70,0,1,0,1,0
50610,445,0,0,drop,66,66,0,1,0,1,0
56695,53,7335,53,allow,183,94,89,2,30,1,1
56185,53,61715,53,allow,168,86,82,2,30,1,1
43681,443,22567,443,allow,40598,5313,35285,83,97,43,40
64099,55470,5838,55470,allow,66,66,0,2,8,2,0
49811,53,10574,53,allow,763,102,661,2,29,1,1
53258,443,42318,443,allow,31919,3528,28391,49,323,19,30
64585,53,40349,53,allow,210,110,100,2,30,1,1
57470,44573,53035,44573,allow,883,288,595,4,1200,2,2
57292,445,0,0,drop,66,66,0,1,0,1,0
56814,53,30689,53,allow,816,102,714,2,30,1,1
51487,445,0,0,drop,70,70,0,1,0,1,0
50450,53,9173,53,allow,209,110,99,2,30,1,1
52064,443,64308,443,allow,9003,2598,6405,33,345,15,18
59801,443,35070,443,allow,5678,2820,2858,25,141,11,14
33871,34476,0,0,deny,137,137,0,1,0,1,0
57798,443,21508,443,allow,12877,5188,7689,27,130,12,15
64071,53,30972,53,allow,188,96,92,2,31,1,1
56668,53,12015,53,allow,199,94,105,2,30,1,1
55846,53,44796,53,allow,821,102,719,2,29,1,1
50222,443,19718,443,allow,9582,2201,7381,28,99,14,14
36834,80,37812,80,allow,12993,6920,6073,22,20,13,9
55848,445,0,0,drop,70,70,0,1,0,1,0
53666,80,3658,80,allow,3741,3008,733,16,15,10,6
51768,445,0,0,drop,66,66,0,1,0,1,0
60758,40010,38736,40010,allow,316,136,180,6,5,3,3
6881,30096,6963,30096,allow,509,150,359,2,1199,1,1
64718,53,58761,53,allow,266,110,156,2,30,1,1
52061,35717,8703,35717,allow,70,70,0,2,8,2,0
56472,53,44784,53,allow,177,94,83,2,30,1,1
27005,27016,17178,27016,allow,914,126,788,2,31,1,1
53933,20801,58007,20801,allow,70,70,0,2,7,2,0
55826,42771,0,0,deny,66,66,0,1,0,1,0
64957,53,41435,53,allow,506,131,375,4,41,2,2
64034,445,0,0,drop,70,70,0,1,0,1,0
58377,445,0,0,drop,70,70,0,1,0,1,0
27005,27015,32670,27015,allow,912,126,786,2,31,1,1
2837,25174,0,0,deny,66,66,0,1,0,1,0
34768,443,18480,443,allow,11605,6867,4738,29,256,17,12
52332,445,0,0,drop,70,70,0,1,0,1,0
52134,445,0,0,drop,70,70,0,1,0,1,0
48209,53,48209,53,allow,628,82,546,2,30,1,1
27005,27055,18786,27055,allow,915,126,789,2,30,1,1
26900,27017,33807,27017,allow,422,164,258,6,30,3,3
35356,25174,0,0,deny,146,146,0,1,0,1,0
55817,53,51311,53,allow,177,94,83,2,30,1,1
56821,53,11694,53,allow,235,94,141,2,30,1,1
57275,53,65357,53,allow,170,87,83,2,31,1,1
50888,445,0,0,drop,70,70,0,1,0,1,0
56196,53,24743,53,allow,498,204,294,6,31,3,3
55489,53,26827,53,allow,193,102,91,2,30,1,1
53406,50584,0,0,deny,66,66,0,1,0,1,0
28998,53,28998,53,allow,220,90,130,2,30,1,1
58638,5900,58638,5900,allow,160,66,94,2,9,1,1
60813,443,34578,443,allow,658,140,518,10,3632,3,7
49826,443,11659,443,allow,6105,852,5253,17,77,9,8
58971,445,0,0,drop,70,70,0,1,0,1,0
1040,6004,0,0,deny,72,72,0,1,0,1,0
49526,53,60849,53,allow,402,118,284,2,30,1,1
51896,43357,29923,43357,allow,70,70,0,2,8,2,0
54638,36829,0,0,deny,146,146,0,1,0,1,0
53761,123,54980,123,allow,184,94,90,2,30,1,1
57454,445,0,0,drop,70,70,0,1,0,1,0
49690,50265,0,0,deny,62,62,0,1,0,1,0
27811,57866,0,0,deny,146,146,0,1,0,1,0
50057,80,26007,80,allow,1570,754,816,10,16,6,4
56680,443,28221,443,allow,8942,1817,7125,23,77,13,10
58638,5900,0,0,deny,62,62,0,1,0,1,0
56405,443,6737,443,allow,12470,1570,10900,21,125,10,11
61412,53,24202,53,allow,225,78,147,2,30,1,1
5588,5588,0,0,allow,3562,1936,1626,48,195,24,24
1594,44847,0,0,deny,62,62,0,1,0,1,0
51007,445,0,0,drop,66,66,0,1,0,1,0
43169,443,5370,443,allow,8615,2156,6459,37,315,16,21
56299,445,0,0,drop,70,70,0,1,0,1,0
19579,23,0,0,deny,60,60,0,1,0,1,0
55675,53,48589,53,allow,198,102,96,2,30,1,1
46495,4607,0,0,deny,60,60,0,1,0,1,0
59714,3389,59714,3389,allow,4134,2109,2025,18,17,9,9
56167,445,0,0,drop,70,70,0,1,0,1,0
60449,80,21730,80,allow,50477,10880,39597,69,16,33,36
51977,443,5724,443,allow,2497,1528,969,22,46,13,9
58135,445,0,0,drop,66,66,0,1,0,1,0
59835,53,53528,53,allow,168,78,90,2,30,1,1
27005,27203,54242,27203,allow,871,126,745,2,29,1,1
57593,443,14217,443,allow,7037,1786,5251,23,200,13,10
55236,53,57748,53,allow,216,102,114,2,30,1,1
43271,50584,0,0,deny,146,146,0,1,0,1,0
52070,443,55434,443,allow,8971,4228,4743,20,95,12,8
53197,25174,0,0,deny,66,66,0,1,0,1,0
13285,29892,0,0,deny,145,145,0,1,0,1,0
53024,57866,0,0,deny,146,146,0,1,0,1,0
50933,443,10395,443,allow,10546,2453,8093,28,15,16,12
44401,53,44401,53,allow,197,90,107,2,30,1,1
37551,443,6245,443,allow,9381,2351,7030,26,37,15,11
45350,443,10693,443,allow,918,358,560,14,40,6,8
49178,53,17300,53,allow,348,105,243,4,45,2,2
24972,27262,0,0,deny,60,60,0,1,0,1,0
62060,443,7381,443,allow,12169,4985,7184,34,52,19,15
50998,443,9197,443,allow,6765,1108,5657,17,18,10,7
43108,443,11094,443,allow,3117,1867,1250,19,16,9,10
59569,445,0,0,drop,70,70,0,1,0,1,0
58786,445,0,0,drop,66,66,0,1,0,1,0
62909,993,50101,993,allow,8033,4241,3792,67,54,42,25
52518,445,0,0,drop,70,70,0,1,0,1,0
38909,57470,0,0,deny,62,62,0,1,0,1,0
2681,48817,0,0,deny,146,146,0,1,0,1,0
4529,56205,0,0,deny,62,62,0,1,0,1,0
43350,58414,0,0,deny,66,66,0,1,0,1,0
61546,445,0,0,drop,66,66,0,1,0,1,0
15503,26886,1778,26886,allow,481,150,331,2,1200,1,1
9327,57470,0,0,deny,62,62,0,1,0,1,0
60563,445,0,0,drop,70,70,0,1,0,1,0
56396,443,27935,443,allow,4239,1850,2389,25,179,12,13
22376,443,22376,443,allow,6620,3193,3427,23,26,13,10
57161,53,62554,53,allow,196,94,102,2,30,1,1
41786,443,30860,443,allow,174542,9281,165261,227,78,104,123
50271,445,0,0,drop,70,70,0,1,0,1,0
56249,443,29498,443,allow,80340,72269,8071,106,122,65,41
52937,443,42865,443,allow,22218,12408,9810,66,115,33,33
50251,35440,0,0,deny,66,66,0,1,0,1,0
53185,443,12844,443,allow,8020,1134,6886,23,15,11,12
54078,445,0,0,drop,70,70,0,1,0,1,0
10736,35440,0,0,deny,62,62,0,1,0,1,0
53594,445,0,0,drop,70,70,0,1,0,1,0
51341,445,0,0,drop,66,66,0,1,0,1,0
443,29326,0,0,deny,82,82,0,1,0,1,0
63594,443,17345,443,allow,7673,2645,5028,31,137,17,14
61622,445,0,0,drop,66,66,0,1,0,1,0
49765,53,55989,53,allow,233,102,131,2,30,1,1
53035,445,0,0,drop,66,66,0,1,0,1,0
62141,445,0,0,drop,66,66,0,1,0,1,0
63902,445,0,0,drop,70,70,0,1,0,1,0
58608,62413,0,0,deny,66,66,0,1,0,1,0
57363,53,22472,53,allow,178,94,84,2,30,1,1
50863,445,0,0,drop,66,66,0,1,0,1,0
3541,22114,0,0,deny,62,62,0,1,0,1,0
40204,40005,24841,40005,allow,148,86,62,2,30,1,1
55319,445,0,0,drop,66,66,0,1,0,1,0
56067,25174,0,0,deny,62,62,0,1,0,1,0
54746,22114,0,0,deny,146,146,0,1,0,1,0
65438,53,17432,53,allow,332,94,238,2,29,1,1
16092,50265,0,0,deny,62,62,0,1,0,1,0
49945,53,48312,53,allow,281,97,184,4,58,2,2
51914,5222,1180,5222,allow,5141,2331,2810,41,144,24,17
0,0,0,0,deny,60,60,0,1,0,1,0
33947,443,18903,443,allow,25302,10587,14715,88,123,37,51
53017,80,53017,80,allow,184725,5028,179697,217,25,75,142
23310,22114,0,0,deny,62,62,0,1,0,1,0
56627,53,58271,53,allow,193,102,91,2,29,1,1
48933,443,5665,443,allow,4372,2402,1970,27,53,14,13
59029,445,0,0,drop,70,70,0,1,0,1,0
63997,59512,17767,59512,allow,312,132,180,6,5,3,3
55834,445,0,0,drop,66,66,0,1,0,1,0
52406,445,0,0,drop,70,70,0,1,0,1,0
53291,445,0,0,drop,70,70,0,1,0,1,0
64603,34021,0,0,allow,66,66,0,1,90,1,0
61495,37965,0,0,deny,66,66,0,1,0,1,0
55225,445,0,0,drop,66,66,0,1,0,1,0
56455,53,54287,53,allow,183,94,89,2,31,1,1
27517,23,0,0,deny,60,60,0,1,0,1,0
12471,48817,0,0,deny,62,62,0,1,0,1,0
58638,5900,0,0,deny,62,62,0,1,0,1,0
49928,443,19902,443,allow,4904,864,4040,17,28,10,7
5894,44847,0,0,deny,62,62,0,1,0,1,0
52788,64147,0,0,deny,66,66,0,1,0,1,0
45775,443,19122,443,allow,8706,1430,7276,23,316,9,14
50501,123,36469,123,allow,184,94,90,2,30,1,1
3478,61463,0,0,deny,1118,1118,0,1,0,1,0
49845,53,42421,53,allow,168,86,82,2,30,1,1
52618,23718,0,0,deny,146,146,0,1,0,1,0
58638,5900,0,0,deny,62,62,0,1,0,1,0
54070,445,0,0,drop,66,66,0,1,0,1,0
44792,80,52125,80,allow,1295,781,514,12,16,6,6
48087,16069,0,0,deny,66,66,0,1,0,1,0
43345,443,34624,443,allow,7767,1069,6698,23,3971,7,16
52503,50584,0,0,deny,66,66,0,1,0,1,0
51422,443,51422,443,allow,4399,1492,2907,19,27,11,8
65394,445,0,0,drop,66,66,0,1,0,1,0
52040,80,45485,80,allow,4185,3462,723,14,16,7,7
21526,53,21526,53,allow,230,90,140,2,30,1,1
50900,80,32944,80,allow,14423569,189925,14233644,12194,135,2586,9608
46573,50584,0,0,deny,62,62,0,1,0,1,0
54981,445,0,0,drop,70,70,0,1,0,1,0
56160,53,10248,53,allow,94,94,0,1,30,1,0
47201,44847,0,0,deny,66,66,0,1,0,1,0
54059,445,0,0,drop,66,66,0,1,0,1,0
26762,22114,0,0,deny,62,62,0,1,0,1,0
55421,445,0,0,drop,70,70,0,1,0,1,0
58638,5900,0,0,deny,62,62,0,1,0,1,0
52787,443,54390,443,allow,1550,834,716,19,141,10,9
53767,10004,19496,10004,allow,70,70,0,1,4,1,0
60480,80,35551,80,allow,7406,1038,6368,18,16,10,8
56082,53,20820,53,allow,184,94,90,2,30,1,1
56574,53,4025,53,allow,198,94,104,2,30,1,1
64083,445,0,0,drop,70,70,0,1,0,1,0
60196,53,0,0,deny,88,88,0,1,0,1,0
63021,445,0,0,drop,70,70,0,1,0,1,0
51809,52528,58895,52528,allow,70,70,0,1,4,1,0
50478,80,50478,80,allow,2086,1637,449,10,19,6,4
50266,445,0,0,drop,70,70,0,1,0,1,0
55548,445,0,0,drop,66,66,0,1,0,1,0
50636,80,12150,80,allow,16521,6496,10025,31,49,16,15
34086,25174,0,0,deny,62,62,0,1,0,1,0
20222,53,8890,53,allow,223,78,145,2,30,1,1
64751,445,0,0,drop,66,66,0,1,0,1,0
55470,445,0,0,drop,70,70,0,1,0,1,0
51859,445,0,0,drop,66,66,0,1,0,1,0
55933,64097,0,0,deny,62,62,0,1,0,1,0
55171,53,21824,53,allow,198,101,97,2,31,1,1
22439,25174,0,0,deny,66,66,0,1,0,1,0
64982,53,35426,53,allow,195,102,93,2,30,1,1
56838,53,31421,53,allow,327,87,240,4,50,2,2
52213,56682,55020,56682,allow,66,66,0,1,5,1,0
49374,53,42809,53,allow,197,94,103,2,30,1,1
56285,445,0,0,drop,70,70,0,1,0,1,0
64122,53,44861,53,allow,212,108,104,2,31,1,1
56082,53,33966,53,allow,807,94,713,2,29,1,1
53258,443,7093,443,allow,5124,979,4145,19,54,10,9
24534,50584,0,0,deny,62,62,0,1,0,1,0
55452,53,8362,53,allow,184,94,90,2,29,1,1
50908,80,37284,80,allow,14077960,171956,13906004,11755,133,2437,9318
17581,23,0,0,deny,60,60,0,1,0,1,0
57998,445,0,0,drop,66,66,0,1,0,1,0
38121,443,50120,443,allow,1515436,54168,1461268,1689,16,687,1002
33589,23,0,0,deny,60,60,0,1,0,1,0
42951,44847,0,0,deny,66,66,0,1,0,1,0
49652,80,63583,80,allow,372,192,180,7,42,4,3
64304,53,40913,53,allow,1054,293,761,8,94,4,4
51615,25174,0,0,deny,62,62,0,1,0,1,0
18017,25773,0,0,reset-both,143,143,0,1,0,1,0
65258,53,62928,53,allow,178,94,84,2,30,1,1
56336,53,18502,53,allow,192,98,94,2,30,1,1
26697,37965,0,0,deny,66,66,0,1,0,1,0
49796,53,34008,53,allow,238,102,136,2,30,1,1
27005,27018,28436,27018,allow,895,126,769,2,31,1,1
63952,50734,27783,50734,allow,70,70,0,1,5,1,0
56977,80,20065,80,allow,214,140,74,4,35,3,1
53817,443,11999,443,allow,7443,2043,5400,34,255,17,17
63079,64147,0,0,deny,66,66,0,1,0,1,0
56757,443,47194,443,allow,6205,986,5219,16,25,10,6
26900,27017,32007,27017,allow,422,164,258,6,30,3,3
57863,443,52780,443,allow,1981,1155,826,19,86,10,9
65269,53,55640,53,allow,273,134,139,2,30,1,1
57201,53,44480,53,allow,165,86,79,2,30,1,1
59023,64097,0,0,deny,62,62,0,1,0,1,0
52558,445,0,0,drop,70,70,0,1,0,1,0
55760,443,34599,443,allow,4344,2974,1370,22,94,12,10
64191,44847,0,0,deny,62,62,0,1,0,1,0
64877,53,56552,53,allow,183,94,89,2,29,1,1
60426,25988,19003,25988,allow,70,70,0,2,8,2,0
58120,25174,0,0,deny,66,66,0,1,0,1,0
55329,443,18522,443,allow,9458,2227,7231,23,15,12,11
65045,443,13703,443,allow,4305,2217,2088,11,120,5,6
54689,445,0,0,drop,70,70,0,1,0,1,0
43921,443,8788,443,allow,8324,1658,6666,24,83,14,10
57188,53,35661,53,allow,193,102,91,2,29,1,1
22927,48817,0,0,deny,143,143,0,1,0,1,0
57304,443,45886,443,allow,134,60,74,3,5,2,1
52280,44847,0,0,deny,66,66,0,1,0,1,0
51619,445,0,0,drop,66,66,0,1,0,1,0
61475,445,0,0,drop,66,66,0,1,0,1,0
80,9918,0,0,deny,60,60,0,1,0,1,0
52016,80,31831,80,allow,19693,1957,17736,49,32,23,26
52028,35097,53575,35097,allow,206,136,70,4,13,3,1
50151,53,24855,53,allow,177,94,83,2,30,1,1
42298,40018,41162,40018,allow,629,83,546,4,31,2,2
55834,53,17845,53,allow,184,94,90,2,30,1,1
56635,445,0,0,drop,66,66,0,1,0,1,0
52334,445,0,0,drop,70,70,0,1,0,1,0
38852,37965,0,0,deny,62,62,0,1,0,1,0
60948,53,22265,53,allow,168,78,90,2,30,1,1
58638,5900,0,0,deny,62,62,0,1,0,1,0
64872,445,0,0,drop,70,70,0,1,0,1,0
51930,443,10848,443,allow,9114,2713,6401,33,82,15,18
57197,445,0,0,drop,70,70,0,1,0,1,0
44080,443,25950,443,allow,7476,2315,5161,18,135,8,10
9152,443,16352,443,allow,15550,1508,14042,28,19,13,15
9523,443,27776,443,allow,7199,1410,5789,22,33,11,11
52475,443,47203,443,allow,14713,3210,11503,24,135,9,15
55817,36829,0,0,deny,66,66,0,1,0,1,0
56332,53,16709,53,allow,209,110,99,2,30,1,1
64235,53,18011,53,allow,197,102,95,2,30,1,1
49636,53,12225,53,allow,180,94,86,2,30,1,1
57106,33000,6001,33000,allow,223,223,0,1,30,1,0
64665,53,63171,53,allow,91,91,0,1,30,1,0
48817,64245,48817,64245,allow,481,150,331,2,1200,1,1
52486,445,0,0,drop,66,66,0,1,0,1,0
49252,445,0,0,drop,70,70,0,1,0,1,0
58638,5900,0,0,deny,62,62,0,1,0,1,0
55238,445,0,0,drop,66,66,0,1,0,1,0
52238,48996,43886,48996,allow,70,70,0,1,5,1,0
55757,53,56073,53,allow,177,94,83,2,29,1,1
38320,51505,0,0,deny,66,66,0,1,0,1,0
55812,443,35991,443,allow,9398,2478,6920,26,82,14,12
40500,5618,0,0,reset-both,146,146,0,1,0,1,0
57636,80,57636,80,allow,147506,3521,143985,125,32,23,102
54994,53,24459,53,allow,202,103,99,2,31,1,1
59114,445,0,0,drop,70,70,0,1,0,1,0
50288,445,0,0,drop,70,70,0,1,0,1,0
64022,53,64185,53,allow,197,102,95,2,30,1,1
55236,443,64536,443,allow,10293,2881,7412,25,45,14,11
61751,445,0,0,drop,70,70,0,1,0,1,0
50465,445,0,0,drop,66,66,0,1,0,1,0
60458,61473,34807,61473,allow,1587,935,652,14,16,8,6
21276,53,21276,53,allow,244,98,146,2,33,1,1
52462,25174,0,0,deny,66,66,0,1,0,1,0
51795,443,38241,443,allow,4209,2221,1988,25,157,12,13
50005,53,45437,53,allow,295,101,194,4,30,2,2
8239,37965,0,0,deny,146,146,0,1,0,1,0
65382,53,20387,53,allow,301,108,193,4,54,2,2
57470,58695,5572,58695,allow,726,726,0,12,1200,12,0
53372,443,36591,443,allow,214,140,74,4,20,3,1
59777,443,29457,443,allow,966,480,486,17,29,9,8
63391,445,0,0,drop,66,66,0,1,0,1,0
5180,57866,0,0,deny,66,66,0,1,0,1,0
57044,53,35114,53,allow,197,102,95,2,30,1,1
56952,443,36539,443,allow,5601,1203,4398,14,60,9,5
57134,53,30351,53,allow,190,97,93,2,30,1,1
60128,22114,0,0,deny,62,62,0,1,0,1,0
18415,37965,0,0,deny,62,62,0,1,0,1,0
53802,59932,27956,59932,allow,320,140,180,6,6,3,3
50473,80,6625,80,allow,1658,1247,411,8,15,5,3
33193,50584,0,0,deny,146,146,0,1,0,1,0
52026,26467,0,0,deny,60,60,0,1,0,1,0
53373,445,0,0,drop,70,70,0,1,0,1,0
8999,57470,0,0,deny,146,146,0,1,0,1,0
52909,445,0,0,drop,66,66,0,1,0,1,0
61400,64147,0,0,deny,62,62,0,1,0,1,0
2075,19473,0,0,deny,66,66,0,1,0,1,0
62636,445,0,0,drop,70,70,0,1,0,1,0
31976,53,31976,53,allow,241,95,146,2,30,1,1
35945,8080,16769,8080,allow,170,110,60,2,5,1,1
32877,443,56293,443,allow,5701,1585,4116,23,1102,13,10
60826,445,0,0,drop,66,66,0,1,0,1,0
53773,15459,13024,15459,allow,70,70,0,2,7,2,0
33563,14037,0,0,deny,78,78,0,1,0,1,0
50724,443,63657,443,allow,3171,1369,1802,9,120,5,4
48676,53395,0,0,deny,60,60,0,1,0,1,0
52038,50584,0,0,deny,66,66,0,1,0,1,0
64903,53,4073,53,allow,210,110,100,2,30,1,1
55165,53,3036,53,allow,193,102,91,2,29,1,1
60304,445,0,0,drop,66,66,0,1,0,1,0
59230,445,0,0,drop,66,66,0,1,0,1,0
48706,23393,0,0,deny,60,60,0,1,0,1,0
49427,445,0,0,drop,70,70,0,1,0,1,0
3478,61463,0,0,deny,179,179,0,1,0,1,0
56994,53,35888,53,allow,177,94,83,2,30,1,1
52788,64147,0,0,deny,66,66,0,1,0,1,0
48575,123,43562,123,allow,184,94,90,2,30,1,1
18653,42707,0,0,deny,66,66,0,1,0,1,0
35810,443,45947,443,allow,9276,1884,7392,23,94,13,10
64067,53,26067,53,allow,331,102,229,2,30,1,1
65521,53,38042,53,allow,167,86,81,2,29,1,1
64591,445,0,0,drop,70,70,0,1,0,1,0
58814,445,0,0,drop,70,70,0,1,0,1,0
63039,443,48295,443,allow,448,166,282,2,29,1,1
50667,443,38450,443,allow,8536,2068,6468,36,18,16,20
63679,445,0,0,drop,70,70,0,1,0,1,0
61429,443,58099,443,allow,9504,3379,6125,28,77,15,13
53512,23280,49318,23280,allow,1950,957,993,17,17,10,7
53399,53,53399,53,allow,414,268,146,3,32,2,1
56560,53,25642,53,allow,900,110,790,2,31,1,1
38679,443,29452,443,allow,484912,17317,467595,550,16,229,321
41464,443,7904,443,allow,3978,2714,1264,24,83,13,11
56035,53,29824,53,allow,337,94,243,2,30,1,1
5179,50265,0,0,deny,62,62,0,1,0,1,0
57346,445,0,0,drop,70,70,0,1,0,1,0
51221,57254,65381,57254,allow,491,150,341,2,1200,1,1
51302,445,0,0,drop,70,70,0,1,0,1,0
35050,80,51635,80,allow,350,210,140,6,30,4,2
65223,443,38564,443,allow,5012,4134,878,17,98,10,7
56663,80,6268,80,allow,234,234,0,4,12,4,0
29599,443,15239,443,allow,2227,1018,1209,17,16,8,9
61656,445,0,0,drop,66,66,0,1,0,1,0
50261,64147,0,0,deny,66,66,0,1,0,1,0
56656,443,8282,443,allow,7743,3072,4671,18,125,10,8
44893,53,32339,53,allow,199,94,105,2,30,1,1
58047,80,5646,80,allow,7453,2953,4500,19,21,10,9
36696,25174,0,0,deny,62,62,0,1,0,1,0
28830,37965,0,0,deny,62,62,0,1,0,1,0
50743,445,0,0,drop,70,70,0,1,0,1,0
16403,16386,26193,16386,allow,308,128,180,6,30,3,3
5222,27389,0,0,deny,66,66,0,1,0,1,0
49547,443,10107,443,allow,6180,1249,4931,14,20,8,6
443,7387,0,0,deny,60,60,0,1,0,1,0
49205,53,3818,53,allow,720,94,626,2,30,1,1
55591,445,0,0,drop,70,70,0,1,0,1,0
55201,22114,0,0,deny,62,62,0,1,0,1,0
65107,53,27622,53,allow,193,102,91,2,30,1,1
7184,15503,0,0,deny,66,66,0,1,0,1,0
6999,11119,0,0,deny,143,143,0,1,0,1,0
41484,443,26840,443,allow,433834,12764,421070,452,32,156,296
56563,53,31162,53,allow,751,95,656,2,30,1,1
30654,51221,0,0,deny,72,72,0,1,0,1,0
55426,53,25381,53,allow,177,94,83,2,30,1,1
58118,22114,0,0,deny,62,62,0,1,0,1,0
65483,443,48950,443,allow,92479,4869,87610,109,16,44,65
57044,445,0,0,drop,66,66,0,1,0,1,0
49160,61365,56372,61365,allow,502,150,352,3,1200,2,1
59286,445,0,0,drop,70,70,0,1,0,1,0
443,20995,0,0,deny,83,83,0,1,0,1,0
59088,57470,0,0,deny,62,62,0,1,0,1,0
50932,80,42211,80,allow,11381441,121813,11259628,9309,119,1741,7568
30188,14038,49780,14038,allow,502,150,352,2,1200,1,1
62396,445,0,0,drop,70,70,0,1,0,1,0
58457,445,0,0,drop,70,70,0,1,0,1,0
64311,53,39516,53,allow,199,102,97,2,30,1,1
47276,443,9154,443,allow,9503,5267,4236,56,218,31,25
62440,443,45155,443,allow,28183,7016,21167,51,45,23,28
41850,53,41850,53,allow,257,101,156,2,33,1,1
23079,9694,0,0,deny,62,62,0,1,0,1,0
44849,46478,0,0,deny,74,74,0,1,0,1,0
56786,53,1954,53,allow,194,102,92,2,30,1,1
15442,22114,0,0,deny,66,66,0,1,0,1,0
27005,30008,53621,30008,allow,890,126,764,2,31,1,1
43271,50584,0,0,deny,62,62,0,1,0,1,0
50619,445,0,0,drop,70,70,0,1,0,1,0
57276,443,44097,443,allow,14236,2699,11537,51,31,27,24
47161,443,37026,443,allow,11342,3715,7627,28,92,17,11
50927,44847,0,0,deny,62,62,0,1,0,1,0
64316,53,5577,53,allow,184,94,90,2,30,1,1
53872,443,24185,443,allow,499,425,74,4,1,3,1
51382,56205,0,0,deny,66,66,0,1,0,1,0
64402,445,0,0,drop,66,66,0,1,0,1,0
55807,80,52839,80,allow,73021,1232,71789,66,80,14,52
59644,443,54066,443,allow,8362065,55143,8306922,6375,152,332,6043
5223,14446,0,0,deny,220,220,0,1,0,1,0
65404,53,9178,53,allow,198,110,88,2,30,1,1
13654,50584,0,0,deny,146,146,0,1,0,1,0
58638,5900,0,0,deny,62,62,0,1,0,1,0
36945,23,0,0,deny,60,60,0,1,0,1,0
62415,57470,0,0,deny,66,66,0,1,0,1,0
49594,53,57290,53,allow,301,102,199,2,30,1,1
39057,443,14567,443,allow,70,70,0,1,5,1,0
49497,445,0,0,drop,70,70,0,1,0,1,0
54601,443,45945,443,allow,28386,15864,12522,59,471,31,28
54530,35440,0,0,deny,66,66,0,1,0,1,0
64808,27098,0,0,deny,66,66,0,1,0,1,0
65183,445,0,0,drop,70,70,0,1,0,1,0
57449,80,1245,80,allow,4508,2978,1530,13,15,6,7
51429,22114,0,0,deny,66,66,0,1,0,1,0
64936,53,18480,53,allow,749,94,655,2,29,1,1
11112,43890,0,0,deny,66,66,0,1,0,1,0
35722,123,29832,123,allow,94,94,0,1,30,1,0
50514,52752,0,0,deny,146,146,0,1,0,1,0
27005,27016,13972,27016,allow,1656,126,1530,4,30,2,2
57470,6881,26091,6881,allow,330,330,0,6,1201,6,0
59891,53,0,0,allow,248,75,173,2,30,1,1
51881,443,23769,443,allow,4418,1116,3302,17,30,10,7
55874,64147,0,0,deny,66,66,0,1,0,1,0
64034,17935,14010,17935,allow,66,66,0,2,8,2,0
55481,53,52263,53,allow,793,101,692,2,31,1,1
59955,25,59955,25,allow,1656,677,979,21,16,10,11
50389,445,0,0,drop,70,70,0,1,0,1,0
57120,445,0,0,drop,66,66,0,1,0,1,0
52236,25174,0,0,deny,66,66,0,1,0,1,0
49418,29999,25371,29999,allow,244,78,166,2,31,1,1
61766,443,43724,443,allow,4326,2217,2109,14,120,7,7
49218,445,0,0,drop,70,70,0,1,0,1,0
45725,443,40804,443,allow,8600,4882,3718,44,225,23,21
26048,21,0,0,deny,60,60,0,1,0,1,0
61741,443,4502,443,allow,68851,3430,65421,93,121,35,58
10283,53,10283,53,allow,370,238,132,3,31,2,1
49632,53,14328,53,allow,199,102,97,2,30,1,1
38681,15503,0,0,deny,74,74,0,1,0,1,0
49454,53,42230,53,allow,248,118,130,2,30,1,1
27005,32063,39805,32063,allow,889,126,763,2,30,1,1
65040,53,27133,53,allow,256,88,168,4,32,2,2
53540,34134,25153,34134,allow,70,70,0,1,5,1,0
65459,445,0,0,drop,70,70,0,1,0,1,0
56194,445,0,0,drop,66,66,0,1,0,1,0
64237,51505,0,0,deny,66,66,0,1,0,1,0
62907,445,0,0,drop,70,70,0,1,0,1,0
25756,22114,0,0,deny,146,146,0,1,0,1,0
56995,53,19045,53,allow,196,94,102,2,30,1,1
56656,445,0,0,drop,70,70,0,1,0,1,0
2904,44847,0,0,deny,78,78,0,1,0,1,0
64592,53,58811,53,allow,209,110,99,2,30,1,1
58880,443,32825,443,allow,1413,876,537,12,11,6,6
3478,61463,0,0,deny,252,252,0,1,0,1,0
53180,443,55711,443,allow,7876,3195,4681,22,20,11,11
55013,443,19104,443,allow,7531,1773,5758,30,32,17,13
64540,53,45439,53,allow,179,94,85,2,30,1,1
56800,443,5999,443,allow,8337,2820,5517,19,30,10,9
55032,445,0,0,drop,70,70,0,1,0,1,0
50322,445,0,0,drop,70,70,0,1,0,1,0
48071,25174,0,0,deny,62,62,0,1,0,1,0
50612,80,47441,80,allow,1559,1107,452,9,24,5,4
52846,445,0,0,drop,70,70,0,1,0,1,0
60260,22114,0,0,deny,62,62,0,1,0,1,0
30542,25174,0,0,deny,62,62,0,1,0,1,0
50552,53,61704,53,allow,757,102,655,2,30,1,1
52901,443,37617,443,allow,87558,4155,83403,115,117,41,74
48556,80,48556,80,allow,19225,817,18408,29,15,13,16
58783,443,56867,443,allow,5166,700,4466,16,15,7,9
40312,55442,0,0,deny,62,62,0,1,0,1,0
54889,445,0,0,drop,70,70,0,1,0,1,0
55635,445,0,0,drop,70,70,0,1,0,1,0
64160,53,55275,53,allow,258,110,148,2,30,1,1
49616,443,57635,443,allow,7238,2601,4637,20,17,10,10
50652,445,0,0,drop,66,66,0,1,0,1,0
60017,443,62960,443,allow,5291,2624,2667,28,145,15,13
55205,53,50575,53,allow,167,86,81,2,30,1,1
55786,53,44397,53,allow,177,94,83,2,30,1,1
51764,80,40729,80,allow,5605,3306,2299,21,74,13,8
49201,80,60094,80,allow,2986,825,2161,10,135,6,4
26531,37965,0,0,deny,62,62,0,1,0,1,0
61423,445,0,0,drop,70,70,0,1,0,1,0
41619,443,17467,443,allow,188529,10173,178356,248,256,93,155
58185,445,0,0,drop,66,66,0,1,0,1,0
1638,25174,0,0,deny,146,146,0,1,0,1,0
2437,23117,0,0,deny,146,146,0,1,0,1,0
53990,445,0,0,drop,66,66,0,1,0,1,0
41793,53,3227,53,allow,168,78,90,2,30,1,1
60373,443,19425,443,allow,3875761,85491,3790270,3838,89,1315,2523
61360,445,0,0,drop,70,70,0,1,0,1,0
7273,64147,0,0,deny,66,66,0,1,0,1,0
37965,61085,23932,61085,allow,132,132,0,3,1199,3,0
49561,53,14887,53,allow,211,94,117,2,30,1,1
55018,53,50628,53,allow,179,94,85,2,30,1,1
59523,37965,0,0,deny,62,62,0,1,0,1,0
50226,445,0,0,drop,70,70,0,1,0,1,0
59610,51505,0,0,deny,66,66,0,1,0,1,0
65014,445,0,0,drop,66,66,0,1,0,1,0
26821,57866,0,0,deny,62,62,0,1,0,1,0
52600,22,0,0,deny,60,60,0,1,0,1,0
27005,33060,38657,33060,allow,928,126,802,2,31,1,1
46085,443,28925,443,allow,13018,2021,10997,34,95,14,20
52076,445,0,0,drop,70,70,0,1,0,1,0
54454,445,0,0,drop,66,66,0,1,0,1,0
40189,443,26952,443,allow,7221,2940,4281,30,23,16,14
49504,7275,25597,7275,allow,8962,1625,7337,28,16,15,13
61784,49903,0,0,deny,66,66,0,1,0,1,0
63984,25174,0,0,deny,62,62,0,1,0,1,0
55889,53,7976,53,allow,168,86,82,2,30,1,1
56227,53,39156,53,allow,194,102,92,2,30,1,1
45230,443,23452,443,allow,33924,26047,7877,73,403,33,40
56740,443,11618,443,allow,456259,379546,76713,1179,364,656,523
52650,36237,0,0,deny,62,62,0,1,0,1,0
59452,445,0,0,drop,66,66,0,1,0,1,0
50265,58840,23141,58840,allow,132,132,0,3,1200,3,0
56906,50584,0,0,deny,146,146,0,1,0,1,0
55731,445,0,0,drop,70,70,0,1,0,1,0
59511,21247,0,0,deny,66,66,0,1,0,1,0
49944,53,20178,53,allow,192,98,94,2,31,1,1
50464,80,22574,80,allow,8453,2011,6442,17,21,8,9
52007,445,0,0,drop,70,70,0,1,0,1,0
57001,80,47227,80,allow,214,140,74,4,35,3,1
38771,443,39867,443,allow,7407,3501,3906,18,15,10,8
51584,443,13301,443,allow,12641,5741,6900,26,362,12,14
59780,445,0,0,drop,70,70,0,1,0,1,0
30574,64147,0,0,deny,62,62,0,1,0,1,0
52348,62413,0,0,deny,66,66,0,1,0,1,0
49418,27016,1873,27016,allow,281,78,203,2,31,1,1
14208,51221,0,0,deny,66,66,0,1,0,1,0
29136,31652,0,0,reset-both,145,145,0,1,0,1,0
58436,445,0,0,drop,66,66,0,1,0,1,0
49157,443,32525,443,allow,5115,977,4138,18,18,10,8
64070,53,45355,53,allow,337,89,248,4,38,2,2
56321,445,0,0,drop,70,70,0,1,0,1,0
49156,445,0,0,drop,66,66,0,1,0,1,0
57241,445,0,0,drop,70,70,0,1,0,1,0
65414,53,34166,53,allow,197,102,95,2,30,1,1
50039,445,0,0,drop,70,70,0,1,0,1,0
57441,57470,0,0,deny,66,66,0,1,0,1,0
64297,443,21726,443,allow,56432,4371,52061,72,135,29,43
34166,443,10129,443,allow,1984,1233,751,16,20,8,8
56367,53,52598,53,allow,188,96,92,2,31,1,1
48471,443,48471,443,allow,4381,1474,2907,19,26,11,8
52221,33166,34754,33166,allow,70,70,0,2,8,2,0
39622,53,25768,53,allow,168,78,90,2,30,1,1
52459,33890,0,0,deny,60,60,0,1,0,1,0
6881,6881,0,0,deny,62,62,0,1,0,1,0
41471,443,22977,443,allow,1973617,48070,1925547,1945,84,606,1339
55400,445,0,0,drop,66,66,0,1,0,1,0
1629,64147,0,0,deny,146,146,0,1,0,1,0
58638,5900,0,0,deny,62,62,0,1,0,1,0
55825,52700,0,0,deny,62,62,0,1,0,1,0
60971,443,2878,443,allow,2732,1359,1373,29,193,16,13
61087,445,0,0,drop,70,70,0,1,0,1,0
6881,37957,48141,37957,allow,509,150,359,2,1199,1,1
50291,80,56837,80,allow,442,250,192,8,45,5,3
52997,443,41046,443,allow,10754,4129,6625,42,112,20,22
37455,50584,0,0,deny,66,66,0,1,0,1,0
31011,53,31011,53,allow,197,76,121,2,30,1,1
56246,53,1913,53,allow,209,110,99,2,30,1,1
49680,80,4197,80,allow,1548,847,701,10,16,5,5
52079,445,0,0,drop,70,70,0,1,0,1,0
52472,7302,0,0,deny,66,66,0,1,0,1,0
41050,443,28705,443,allow,137809,4697,133112,153,170,55,98
58245,445,0,0,drop,70,70,0,1,0,1,0
49835,53,6905,53,allow,817,102,715,2,30,1,1
63006,445,0,0,drop,70,70,0,1,0,1,0
52241,51717,19106,51717,allow,70,70,0,1,4,1,0
49512,443,62361,443,allow,12472,1628,10844,35,195,16,19
55986,26467,0,0,deny,66,66,0,1,0,1,0
59376,5900,0,0,deny,60,60,0,1,0,1,0
18963,80,18963,80,allow,1501,652,849,9,15,5,4
59970,445,0,0,drop,66,66,0,1,0,1,0
48346,443,9051,443,allow,2272788,106549,2166239,2492,190,850,1642
45554,443,45554,443,allow,4617,1710,2907,19,26,11,8
57827,445,0,0,drop,70,70,0,1,0,1,0
52097,443,1702,443,allow,11181,7329,3852,39,53,20,19
46542,443,1363,443,allow,5916,1144,4772,20,17,11,9
56127,37965,0,0,deny,62,62,0,1,0,1,0
55566,445,0,0,drop,70,70,0,1,0,1,0
56239,53,9531,53,allow,179,86,93,2,29,1,1
50095,53,10662,53,allow,168,86,82,2,30,1,1
52226,48784,61623,48784,allow,70,70,0,1,5,1,0
48757,80,48757,80,allow,560,264,296,9,44,5,4
30598,37965,0,0,deny,62,62,0,1,0,1,0
2321,53,2321,53,allow,216,98,118,2,30,1,1
49724,53,16397,53,allow,183,94,89,2,30,1,1
64706,53,11232,53,allow,179,94,85,2,29,1,1
19875,30170,0,0,deny,145,145,0,1,0,1,0
63578,5228,10061,5228,allow,8544,2633,5911,51,154,28,23
6881,26296,0,0,deny,143,143,0,1,0,1,0
56688,443,28124,443,allow,19185,2445,16740,40,25,20,20
56592,53,24895,53,allow,200,102,98,2,30,1,1
50276,53,20646,53,allow,94,94,0,1,30,1,0
49421,445,0,0,drop,70,70,0,1,0,1,0
59364,44847,0,0,deny,66,66,0,1,0,1,0
13554,53,13554,53,allow,404,259,145,3,33,2,1
51151,64147,0,0,deny,66,66,0,1,0,1,0
49884,443,63837,443,allow,5998,978,5020,19,50,10,9
65179,53,5745,53,allow,184,94,90,2,31,1,1
45682,37965,0,0,deny,62,62,0,1,0,1,0
52496,443,9919,443,allow,9500,4662,4838,20,16,11,9
55986,53,53201,53,allow,744,89,655,2,30,1,1
36676,443,44727,443,allow,7636,3367,4269,24,319,13,11
44414,23718,0,0,deny,66,66,0,1,0,1,0
61838,37965,0,0,deny,66,66,0,1,0,1,0
55586,17332,63048,17332,allow,70,70,0,2,8,2,0
59928,53,64195,53,allow,168,78,90,2,30,1,1
50905,80,47395,80,allow,11749346,149441,11599905,10089,147,2116,7973
61938,443,24031,443,allow,3663,1097,2566,13,136,6,7
65026,53,29362,53,allow,193,102,91,2,31,1,1
55469,445,0,0,drop,66,66,0,1,0,1,0
64937,53,22410,53,allow,182,93,89,2,31,1,1
49650,53,11402,53,allow,216,110,106,2,30,1,1
55641,53,35786,53,allow,184,94,90,2,31,1,1
45964,2228,0,0,deny,60,60,0,1,0,1,0
40500,48009,0,0,deny,146,146,0,1,0,1,0
57146,53,33353,53,allow,199,102,97,2,31,1,1
39748,80,44062,80,allow,1638,1324,314,10,15,5,5
56967,445,0,0,drop,66,66,0,1,0,1,0
49201,53,24647,53,allow,243,86,157,2,30,1,1
57846,57866,0,0,deny,66,66,0,1,0,1,0
54011,44847,0,0,deny,66,66,0,1,0,1,0
49565,445,0,0,drop,70,70,0,1,0,1,0
52329,443,64562,443,allow,294025,14919,279106,401,42,192,209
27988,40027,31364,40027,allow,148,86,62,2,30,1,1
52021,443,14701,443,allow,7508,2350,5158,37,1323,21,16
63672,53,63672,53,allow,198,90,108,2,30,1,1
62341,445,0,0,drop,70,70,0,1,0,1,0
56837,53,43966,53,allow,176,90,86,2,31,1,1
51691,993,8747,993,allow,17462,4583,12879,93,19,47,46
50501,443,19632,443,allow,1499,930,569,16,78,9,7
12677,53,12677,53,allow,234,93,141,2,30,1,1
58686,18375,0,0,deny,66,66,0,1,0,1,0
53737,445,0,0,drop,66,66,0,1,0,1,0
51221,10476,15636,10476,allow,528,528,0,9,1201,9,0
55608,53,12316,53,allow,195,102,93,2,30,1,1
37014,25174,0,0,deny,66,66,0,1,0,1,0
56695,53,57441,53,allow,776,102,674,2,30,1,1
64237,51505,0,0,deny,62,62,0,1,0,1,0
50137,53,53286,53,allow,448,184,264,6,31,3,3
59225,445,0,0,drop,70,70,0,1,0,1,0
65189,27015,29892,27015,allow,295,78,217,2,30,1,1
57397,53,60967,53,allow,177,94,83,2,30,1,1
51179,443,22561,443,allow,13708,1734,11974,25,31,12,13
56756,53,42523,53,allow,760,97,663,2,30,1,1
62658,445,0,0,drop,70,70,0,1,0,1,0
13963,50584,0,0,deny,66,66,0,1,0,1,0
57016,445,0,0,drop,66,66,0,1,0,1,0
60394,53,18080,53,allow,330,94,236,2,30,1,1
58382,50584,0,0,deny,62,62,0,1,0,1,0
35670,443,58907,443,allow,295458,11828,283630,339,185,137,202
50109,53,61948,53,allow,768,99,669,2,30,1,1
63836,14791,9109,14791,allow,66,66,0,2,7,2,0
56380,36829,0,0,deny,66,66,0,1,0,1,0
51652,80,57447,80,allow,141220,4280,136940,159,17,59,100
53661,34967,21536,34967,allow,70,70,0,2,8,2,0
49111,443,50826,443,allow,43887,3283,40604,60,398,21,39
49762,53,65280,53,allow,184,94,90,2,30,1,1
50732,445,0,0,drop,70,70,0,1,0,1,0
63486,445,0,0,drop,70,70,0,1,0,1,0
58638,5900,0,0,deny,62,62,0,1,0,1,0
1638,22114,0,0,deny,62,62,0,1,0,1,0
60263,445,0,0,drop,70,70,0,1,0,1,0
40839,53,42784,53,allow,78,78,0,1,29,1,0
58480,57470,0,0,deny,66,66,0,1,0,1,0
56279,443,57070,443,allow,97608,4852,92756,108,121,37,71
46475,80,46475,80,allow,8300,966,7334,14,20,6,8
58768,443,60756,443,allow,18568,12357,6211,43,18,24,19
58638,5900,0,0,deny,62,62,0,1,0,1,0
33525,53,64644,53,allow,179,86,93,2,30,1,1
62865,443,23097,443,allow,21313,7245,14068,48,128,22,26
55945,53,26703,53,allow,170,87,83,2,30,1,1
56771,445,0,0,drop,70,70,0,1,0,1,0
51578,44847,0,0,deny,66,66,0,1,0,1,0
55528,445,0,0,drop,66,66,0,1,0,1,0
57316,443,30855,443,allow,5613,733,4880,16,15,9,7
56082,53,31858,53,allow,271,88,183,4,37,2,2
55901,445,0,0,drop,70,70,0,1,0,1,0
64985,53,7448,53,allow,196,102,94,2,31,1,1
64188,53,11006,53,allow,299,98,201,4,57,2,2
64203,445,0,0,drop,70,70,0,1,0,1,0
53878,55950,30797,55950,allow,70,70,0,1,5,1,0
56614,445,0,0,drop,70,70,0,1,0,1,0
49282,53,14515,53,allow,178,94,84,2,30,1,1
60485,22114,0,0,deny,62,62,0,1,0,1,0
54289,445,0,0,drop,70,70,0,1,0,1,0
64974,53,51198,53,allow,493,111,382,4,57,2,2
58057,443,19504,443,allow,6821,1076,5745,21,38,12,9
53459,37807,0,0,deny,62,62,0,1,0,1,0
55213,53,60229,53,allow,238,94,144,2,30,1,1
53865,445,0,0,drop,66,66,0,1,0,1,0
53704,443,40944,443,allow,5743,1339,4404,18,180,8,10
52680,445,0,0,drop,70,70,0,1,0,1,0
53676,3678,50673,3678,allow,70,70,0,1,4,1,0
123,123,5546,123,allow,184,94,90,2,29,1,1
50116,22,50116,22,allow,60,60,0,1,5,1,0
65152,53,2972,53,allow,763,102,661,2,30,1,1
53154,44645,45393,44645,allow,320,140,180,6,5,3,3
63972,445,0,0,drop,66,66,0,1,0,1,0
52824,443,36459,443,allow,7118,2239,4879,22,15,12,10
60981,445,0,0,drop,70,70,0,1,0,1,0
4162,21532,0,0,deny,146,146,0,1,0,1,0
50523,53,12561,53,allow,168,86,82,2,29,1,1
63190,35440,0,0,deny,62,62,0,1,0,1,0
50610,445,0,0,drop,70,70,0,1,0,1,0
51026,37450,0,0,deny,66,66,0,1,0,1,0
59254,445,0,0,drop,70,70,0,1,0,1,0
49958,36829,0,0,deny,66,66,0,1,0,1,0
46116,57470,0,0,deny,74,74,0,1,0,1,0
56612,443,41735,443,allow,8033,2013,6020,20,15,11,9
63253,445,0,0,drop,70,70,0,1,0,1,0
49319,53,45899,53,allow,166,86,80,2,30,1,1
36456,25174,0,0,deny,62,62,0,1,0,1,0
64778,445,0,0,drop,66,66,0,1,0,1,0
49927,80,6147,80,allow,1141,636,505,10,45,6,4
65100,53,65386,53,allow,720,94,626,2,30,1,1
15420,53,15420,53,allow,237,91,146,2,32,1,1
50584,55624,58737,55624,allow,1326,300,1026,6,1200,3,3
9299,443,15796,443,allow,4216,771,3445,16,26,9,7
63964,53,35341,53,allow,195,102,93,2,30,1,1
53469,44847,0,0,deny,62,62,0,1,0,1,0
51413,48637,0,0,deny,72,72,0,1,0,1,0
57557,64147,0,0,deny,66,66,0,1,0,1,0
58793,443,26304,443,allow,5167,700,4467,16,15,7,9
50884,80,30103,80,allow,238059,13790,224269,276,141,113,163
54726,30041,0,0,deny,66,66,0,1,0,1,0
53915,443,38797,443,allow,7917,2410,5507,32,26,18,14
65446,53,24128,53,allow,210,110,100,2,30,1,1
57239,123,0,0,deny,90,90,0,1,0,1,0
64068,53,64068,53,allow,1184,83,1101,4,59,2,2
65435,445,0,0,drop,66,66,0,1,0,1,0
49334,53,44213,53,allow,194,102,92,2,31,1,1
12031,36237,0,0,deny,66,66,0,1,0,1,0
49845,53,33096,53,allow,194,102,92,2,30,1,1
55193,53,27254,53,allow,177,94,83,2,30,1,1
50973,443,10208,443,allow,9525,6135,3390,24,120,13,11
51579,443,8189,443,allow,1522,1210,312,9,28,4,5
49340,443,62697,443,allow,7492336,235716,7256620,8119,428,3022,5097
49597,53,33201,53,allow,168,86,82,2,31,1,1
55934,53,60885,53,allow,196,102,94,2,30,1,1
49768,443,40344,443,allow,12934,1419,11515,27,127,11,16
56595,80,43530,80,allow,234,234,0,4,12,4,0
2704,37,0,0,deny,60,60,0,1,0,1,0
63210,445,0,0,drop,70,70,0,1,0,1,0
12939,53,12939,53,allow,216,82,134,2,32,1,1
62452,21247,0,0,deny,62,62,0,1,0,1,0
35657,48637,0,0,deny,62,62,0,1,0,1,0
58638,5900,0,0,deny,62,62,0,1,0,1,0
64025,26826,1858,26826,allow,70,70,0,1,4,1,0
55674,53,14625,53,allow,744,89,655,2,31,1,1
60359,443,21791,443,allow,9607,3847,5760,51,134,26,25
1114,46824,0,0,deny,62,62,0,1,0,1,0
55646,443,13625,443,allow,11771,2624,9147,50,19,25,25
46965,443,48357,443,allow,1786,172,1614,7,120,3,4
52910,53,52910,53,allow,414,268,146,3,32,2,1
62157,445,0,0,drop,66,66,0,1,0,1,0
50663,443,57930,443,allow,7732,3046,4686,22,26,12,10
56596,53,26887,53,allow,198,101,97,2,30,1,1
47508,443,1346,443,allow,5778,1095,4683,17,26,10,7
57152,53,2032,53,allow,183,94,89,2,30,1,1
56192,53,47862,53,allow,177,94,83,2,30,1,1
45964,3111,0,0,deny,60,60,0,1,0,1,0
51166,31573,0,0,deny,66,66,0,1,0,1,0
51524,445,0,0,drop,66,66,0,1,0,1,0
56529,53,60444,53,allow,711,87,624,2,31,1,1
51880,445,0,0,drop,70,70,0,1,0,1,0
64885,53,51711,53,allow,212,102,110,2,31,1,1
18876,44847,0,0,deny,66,66,0,1,0,1,0
55693,45341,14771,45341,allow,70,70,0,2,8,2,0
62133,445,0,0,drop,70,70,0,1,0,1,0
40549,443,43115,443,allow,1352,691,661,14,42,8,6
53638,445,0,0,drop,70,70,0,1,0,1,0
33247,443,33617,443,allow,7527,2435,5092,16,120,8,8
55893,53,33227,53,allow,267,94,173,4,56,2,2
65211,445,0,0,drop,70,70,0,1,0,1,0
5588,5588,0,0,allow,3354,1792,1562,46,194,23,23
63869,34368,37141,34368,allow,70,70,0,1,4,1,0
48735,443,54377,443,allow,77050,5353,71697,113,95,46,67
51763,34121,10888,34121,allow,70,70,0,2,8,2,0
9377,56205,0,0,deny,66,66,0,1,0,1,0
63550,80,63550,80,allow,1232,481,751,10,15,5,5
56568,53,11893,53,allow,306,306,0,4,47,4,0
49676,53,36174,53,allow,733,86,647,2,30,1,1
11816,53,11816,53,allow,240,98,142,2,30,1,1
14309,56205,0,0,deny,62,62,0,1,0,1,0
9212,51505,0,0,deny,62,62,0,1,0,1,0
64567,53,31447,53,allow,186,95,91,2,31,1,1
49693,53,49502,53,allow,209,110,99,2,30,1,1
56880,53,8683,53,allow,209,110,99,2,31,1,1
60430,51413,63647,51413,allow,70,70,0,2,8,2,0
49214,445,0,0,drop,70,70,0,1,0,1,0
16387,35583,0,0,deny,60,60,0,1,0,1,0
51221,31285,26575,31285,allow,2274,924,1350,30,3293,15,15
64711,53,52164,53,allow,178,94,84,2,29,1,1
39839,22114,0,0,deny,62,62,0,1,0,1,0
49204,54530,41547,54530,allow,316,136,180,6,6,3,3
56838,53,49360,53,allow,170,87,83,2,30,1,1
54578,26467,0,0,deny,66,66,0,1,0,1,0
57204,443,62645,443,allow,340,140,200,6,25,3,3
49982,37965,0,0,deny,66,66,0,1,0,1,0
64439,53,36450,53,allow,199,102,97,2,30,1,1
52925,443,2164,443,allow,114867,4243,110624,128,120,44,84
55972,53,18787,53,allow,193,102,91,2,31,1,1
64618,445,0,0,drop,70,70,0,1,0,1,0
65442,80,64392,80,allow,366,180,186,7,28,4,3
62852,445,0,0,drop,70,70,0,1,0,1,0
50914,51505,0,0,deny,66,66,0,1,0,1,0
51334,443,42102,443,allow,8407,2034,6373,19,121,8,11
11677,44847,0,0,deny,146,146,0,1,0,1,0
17173,23,0,0,deny,60,60,0,1,0,1,0
60876,445,0,0,drop,66,66,0,1,0,1,0
55748,53,59262,53,allow,188,96,92,2,31,1,1
38562,443,22999,443,allow,1310,649,661,13,185,7,6
12878,25174,0,0,deny,146,146,0,1,0,1,0
65382,53,20411,53,allow,274,94,180,2,30,1,1
56276,445,0,0,drop,70,70,0,1,0,1,0
52494,36237,0,0,deny,62,62,0,1,0,1,0
57210,445,0,0,drop,70,70,0,1,0,1,0
57290,445,0,0,drop,70,70,0,1,0,1,0
54955,7302,0,0,deny,62,62,0,1,0,1,0
50329,80,27783,80,allow,1550,728,822,13,47,7,6
56951,53,44679,53,allow,168,86,82,2,29,1,1
51940,26399,4423,26399,allow,66,66,0,1,5,1,0
53077,443,54152,443,allow,6173,924,5249,18,177,10,8
27005,27016,51239,27016,allow,888,126,762,2,30,1,1
57295,443,4265,443,allow,5614,733,4881,16,15,9,7
52958,445,0,0,drop,70,70,0,1,0,1,0
56045,53,39272,53,allow,731,91,640,2,30,1,1
56961,445,0,0,drop,66,66,0,1,0,1,0
64910,53,52147,53,allow,259,86,173,2,30,1,1
50100,445,0,0,drop,70,70,0,1,0,1,0
52398,443,30861,443,allow,323437,18923,304514,544,252,276,268
58129,445,0,0,drop,70,70,0,1,0,1,0
57470,56098,25356,56098,allow,1359,726,633,6,1199,3,3
6778,50584,0,0,deny,66,66,0,1,0,1,0
48163,443,22836,443,allow,20124,12085,8039,54,385,29,25
56626,53,17271,53,allow,224,102,122,2,30,1,1
48965,443,50088,443,allow,9519,4377,5142,33,354,17,16
68,67,0,0,deny,346,346,0,1,0,1,0
51160,8090,0,0,deny,60,60,0,1,0,1,0
38693,443,10334,443,allow,90177,3481,86696,96,15,31,65
29742,50584,0,0,deny,62,62,0,1,0,1,0
4515,37807,0,0,deny,62,62,0,1,0,1,0
55912,445,0,0,drop,70,70,0,1,0,1,0
55600,22,0,0,deny,60,60,0,1,0,1,0
7222,57470,0,0,deny,62,62,0,1,0,1,0
65304,445,0,0,drop,66,66,0,1,0,1,0
55749,37965,0,0,deny,66,66,0,1,0,1,0
58638,5900,0,0,deny,62,62,0,1,0,1,0
55502,445,0,0,drop,70,70,0,1,0,1,0
49842,7302,0,0,deny,66,66,0,1,0,1,0
40521,23117,0,0,deny,62,62,0,1,0,1,0
55043,443,31088,443,allow,11681,3607,8074,40,120,20,20
60159,22114,0,0,deny,66,66,0,1,0,1,0
65331,53,50741,53,allow,732,89,643,2,0,1,1
61679,445,0,0,drop,70,70,0,1,0,1,0
52369,445,0,0,drop,70,70,0,1,0,1,0
64913,53,33116,53,allow,194,102,92,2,30,1,1
51571,445,0,0,drop,66,66,0,1,0,1,0
53780,47132,22525,47132,allow,70,70,0,2,8,2,0
64054,53,41905,53,allow,1299,387,912,10,103,5,5
44962,8802,46440,8802,allow,4014,2342,1672,42,386,21,21
53654,445,0,0,drop,70,70,0,1,0,1,0
37090,443,37090,443,allow,4637,1730,2907,19,30,11,8
28156,50584,0,0,deny,62,62,0,1,0,1,0
54022,443,12904,443,allow,7653,1188,6465,21,16,12,9
60222,443,32889,443,allow,12428,5331,7097,47,32,21,26
9442,443,1324,443,allow,6100,777,5323,17,25,9,8
54313,445,0,0,drop,66,66,0,1,0,1,0
64897,53,54215,53,allow,312,94,218,2,30,1,1
38961,443,38961,443,allow,4425,1518,2907,19,29,11,8
42366,57470,0,0,deny,66,66,0,1,0,1,0
49726,445,0,0,drop,66,66,0,1,0,1,0
55355,445,0,0,drop,70,70,0,1,0,1,0
51764,445,0,0,drop,66,66,0,1,0,1,0
60479,25174,0,0,deny,66,66,0,1,0,1,0
51815,443,62038,443,allow,9061,3443,5618,64,121,27,37
15793,64147,0,0,deny,66,66,0,1,0,1,0
49592,53,47137,53,allow,177,94,83,2,30,1,1
59847,443,63269,443,allow,21180,2662,18518,34,17,14,20
49610,53,38769,53,allow,754,94,660,2,30,1,1
63950,53,19633,53,allow,200,102,98,2,30,1,1
53931,55300,33330,55300,allow,492,306,186,8,15,5,3
59964,443,8853,443,allow,166170,5611,160559,189,16,78,111
23936,41615,0,0,deny,146,146,0,1,0,1,0
50450,53,51972,53,allow,209,110,99,2,30,1,1
56462,53,3765,53,allow,168,78,90,2,30,1,1
33886,65504,0,0,deny,162,162,0,1,0,1,0
49418,27111,53348,27111,allow,258,78,180,2,30,1,1
35927,443,23260,443,allow,9102,1205,7897,25,14,14,11
58473,443,15678,443,allow,3120,1862,1258,18,15,11,7
55771,53,58272,53,allow,283,98,185,4,51,2,2
55065,443,23726,443,allow,13236,4421,8815,28,61,16,12
55333,123,5768,123,allow,184,94,90,2,30,1,1
52151,445,0,0,drop,70,70,0,1,0,1,0
56195,445,0,0,drop,66,66,0,1,0,1,0
55445,53,54858,53,allow,96,96,0,2,31,2,0
64816,53,25047,53,allow,166,86,80,2,30,1,1
59977,30188,0,0,deny,66,66,0,1,0,1,0
65463,53,50986,53,allow,177,94,83,2,30,1,1
55800,53,53999,53,allow,711,87,624,2,30,1,1
60379,443,13895,443,allow,9593,3182,6411,19,23,8,11
58638,5900,0,0,deny,62,62,0,1,0,1,0
55057,53,28179,53,allow,889,404,485,10,30,5,5
64614,53,5990,53,allow,517,179,338,6,62,3,3
54770,445,0,0,drop,70,70,0,1,0,1,0
56964,53,13707,53,allow,267,87,180,4,57,2,2
43578,15503,0,0,deny,74,74,0,1,0,1,0
49917,53,47966,53,allow,752,93,659,2,31,1,1
2267,53,1251,53,allow,204,118,86,2,31,1,1
51221,49683,21900,49683,allow,870,330,540,12,1316,6,6
62760,445,0,0,drop,66,66,0,1,0,1,0
55217,53,15991,53,allow,744,89,655,2,31,1,1
64280,445,0,0,drop,70,70,0,1,0,1,0
56294,53,56294,53,allow,229,89,140,2,31,1,1
63797,47784,45642,47784,allow,66,66,0,1,5,1,0
55220,53,48038,53,allow,193,102,91,2,31,1,1
65372,445,0,0,drop,70,70,0,1,0,1,0
63867,35993,0,0,deny,66,66,0,1,0,1,0
58638,5900,0,0,deny,62,62,0,1,0,1,0
49365,445,0,0,drop,70,70,0,1,0,1,0
51957,80,56020,80,allow,486,300,186,9,27,6,3
60700,445,0,0,drop,70,70,0,1,0,1,0
50453,445,0,0,drop,66,66,0,1,0,1,0
59623,161,0,0,allow,11212,5520,5692,58,30,29,29
6881,6889,7381,6889,allow,228,118,110,2,1200,1,1
52986,445,0,0,drop,66,66,0,1,0,1,0
60265,443,40784,443,allow,11048,3161,7887,26,24,15,11
62446,445,0,0,drop,66,66,0,1,0,1,0
55520,443,13062,443,allow,272841,13586,259255,353,176,164,189
16814,53,16814,53,allow,217,87,130,2,30,1,1
55496,80,55496,80,allow,1099,578,521,10,15,6,4
64493,445,0,0,drop,66,66,0,1,0,1,0
50012,53,54567,53,allow,208,106,102,2,30,1,1
46770,443,32021,443,allow,90614,3825,86789,108,214,42,66
49818,37965,0,0,deny,66,66,0,1,0,1,0
41629,15000,21496,15000,allow,130,70,60,2,5,1,1
58415,443,33034,443,allow,560,280,280,9,30,5,4
55655,63670,23563,63670,allow,70,70,0,2,8,2,0
45275,443,27366,443,allow,130,70,60,3,5,2,1
29424,37807,0,0,deny,66,66,0,1,0,1,0
57677,57470,0,0,deny,62,62,0,1,0,1,0
49900,443,19208,443,allow,52800,13228,39572,134,154,64,70
64403,53,53109,53,allow,387,134,253,2,30,1,1
1695,30349,0,0,deny,148,148,0,1,0,1,0
50851,25864,0,0,deny,74,74,0,1,0,1,0
28364,23,0,0,deny,60,60,0,1,0,1,0
21674,28189,0,0,deny,60,60,0,1,0,1,0
57392,443,57392,443,allow,4729,1822,2907,19,27,11,8
51076,80,51076,80,allow,8170,844,7326,17,42,7,10
61150,11392,0,0,deny,66,66,0,1,0,1,0
53728,443,11260,443,allow,499,425,74,4,0,3,1
55830,53,32937,53,allow,183,94,89,2,30,1,1
52432,443,37828,443,allow,330,190,140,6,15,4,2
53123,59228,32782,59228,allow,70,70,0,2,8,2,0
62177,445,0,0,drop,70,70,0,1,0,1,0
42030,25,0,0,deny,74,74,0,1,0,1,0
31950,22114,0,0,deny,62,62,0,1,0,1,0
55855,53,25503,53,allow,182,102,80,2,30,1,1
50408,445,0,0,drop,70,70,0,1,0,1,0
57468,2258,57468,2258,allow,156,156,0,3,8,3,0
55338,445,0,0,drop,66,66,0,1,0,1,0
3407,57866,0,0,deny,66,66,0,1,0,1,0
58259,445,0,0,drop,66,66,0,1,0,1,0
55471,53,40426,53,allow,760,97,663,2,31,1,1
56226,53,33247,53,allow,200,102,98,2,30,1,1
55334,53,17897,53,allow,199,102,97,2,31,1,1
50661,80,9944,80,allow,2693,461,2232,14,17,6,8
56589,53,29325,53,allow,198,101,97,2,31,1,1
50837,445,0,0,drop,66,66,0,1,0,1,0
56752,443,37907,443,allow,8007,1987,6020,20,15,11,9
63766,445,0,0,drop,70,70,0,1,0,1,0
63895,445,0,0,drop,70,70,0,1,0,1,0
64093,445,0,0,drop,70,70,0,1,0,1,0
58638,5900,0,0,deny,62,62,0,1,0,1,0
55617,53,37518,53,allow,194,102,92,2,31,1,1
55215,445,0,0,drop,66,66,0,1,0,1,0
60323,443,19514,443,allow,1743,1164,579,16,25,10,6
57470,53756,4202,53756,allow,132,132,0,3,1199,3,0
49661,445,0,0,drop,70,70,0,1,0,1,0
59759,445,0,0,drop,70,70,0,1,0,1,0
23406,443,23406,443,allow,5368,1609,3759,21,75,12,9
49377,443,6065,443,allow,6350,1550,4800,23,19,12,11
51869,25355,58736,25355,allow,70,70,0,2,8,2,0
55756,53,23922,53,allow,311,94,217,2,30,1,1
63663,445,0,0,drop,70,70,0,1,0,1,0
51841,21960,6708,21960,allow,136,136,0,3,14,3,0
57459,51505,0,0,deny,62,62,0,1,0,1,0
63515,445,0,0,drop,70,70,0,1,0,1,0
37234,53,61804,53,allow,168,78,90,2,30,1,1
47943,50584,0,0,deny,74,74,0,1,0,1,0
58359,64147,0,0,deny,72,72,0,1,0,1,0
51934,443,29764,443,allow,550,310,240,10,35,6,4
20706,23718,0,0,deny,66,66,0,1,0,1,0
54677,443,15752,443,allow,3704,1428,2276,14,135,7,7
56216,5228,61293,5228,allow,2495,1477,1018,17,3600,8,9
49501,11392,0,0,deny,66,66,0,1,0,1,0
55040,80,41951,80,allow,486,240,246,9,34,5,4
45402,80,27119,80,allow,573,499,74,6,15,5,1
46403,443,21158,443,allow,6035,1758,4277,27,1169,15,12
56610,443,5877,443,allow,100002,5891,94111,138,44,60,78
52630,445,0,0,drop,70,70,0,1,0,1,0
5588,5588,0,0,allow,3562,1936,1626,48,195,24,24
60980,443,25213,443,allow,134,60,74,3,6,2,1
27272,64147,0,0,deny,66,66,0,1,0,1,0
56812,443,43977,443,allow,11568,9158,2410,42,80,23,19
49566,443,65424,443,allow,1394,540,854,24,36,10,14
50131,445,0,0,drop,70,70,0,1,0,1,0
49418,27015,18735,27015,allow,244,78,166,2,30,1,1
49275,7000,49275,7000,allow,2163,676,1487,14,15,7,7
62080,54532,0,0,deny,60,60,0,1,0,1,0
35556,443,19765,443,allow,2988,1649,1339,17,255,9,8
54120,445,0,0,drop,70,70,0,1,0,1,0
53835,443,32854,443,allow,499,425,74,4,0,3,1
64034,53,38664,53,allow,194,102,92,2,29,1,1
65352,53,63363,53,allow,321,102,219,2,29,1,1
26658,25174,0,0,deny,62,62,0,1,0,1,0
56841,53,54383,53,allow,177,94,83,2,29,1,1
49162,53,30620,53,allow,401,94,307,4,32,2,2
58922,445,0,0,drop,70,70,0,1,0,1,0
55516,5228,12835,5228,allow,2769,1694,1075,20,3600,10,10
61701,15503,0,0,deny,66,66,0,1,0,1,0
61217,53,50317,53,allow,281,94,187,2,30,1,1
53822,25174,0,0,deny,66,66,0,1,0,1,0
57631,443,64255,443,allow,154,94,60,2,5,1,1
49977,57470,0,0,deny,62,62,0,1,0,1,0
55265,53,44071,53,allow,199,102,97,2,30,1,1
58787,23,0,0,deny,60,60,0,1,0,1,0
37175,53,14480,53,allow,231,86,145,2,29,1,1
55630,53,39473,53,allow,197,102,95,2,30,1,1
51901,443,44241,443,allow,6215,948,5267,18,15,9,9
45412,53,45412,53,allow,220,90,130,2,30,1,1
55633,53,30545,53,allow,195,102,93,2,30,1,1
56695,443,49657,443,allow,3874,2523,1351,18,17,10,8
62536,445,0,0,drop,66,66,0,1,0,1,0
61593,445,0,0,drop,70,70,0,1,0,1,0
40453,443,22159,443,allow,114,114,0,2,120,2,0
40707,443,1072,443,allow,1969,1195,774,18,122,11,7
55169,53,58327,53,allow,199,102,97,2,30,1,1
47905,443,5382,443,allow,172,172,0,2,5,2,0
52227,27904,24192,27904,allow,316,136,180,6,9,3,3
2267,53,1505,53,allow,204,118,86,2,30,1,1
49284,53,32626,53,allow,245,102,143,2,29,1,1
57075,445,0,0,drop,66,66,0,1,0,1,0
50118,445,0,0,drop,70,70,0,1,0,1,0
56996,80,27965,80,allow,214,140,74,4,35,3,1
56767,34578,60694,34578,allow,564,318,246,9,16,5,4
54320,27016,28839,27016,allow,924,924,0,3,30,3,0
50571,445,0,0,drop,66,66,0,1,0,1,0
51433,443,11382,443,allow,194,70,124,3,11,1,2
56255,445,0,0,drop,66,66,0,1,0,1,0
56603,53,32862,53,allow,168,86,82,2,30,1,1
9295,443,22317,443,allow,3837,488,3349,15,15,7,8
60449,445,0,0,drop,70,70,0,1,0,1,0
55230,443,41463,443,allow,39555,12054,27501,78,66,41,37
52218,62004,11964,62004,allow,136,136,0,3,12,3,0
64051,53,14293,53,allow,430,172,258,6,60,3,3
39814,443,9384,443,allow,5761,3561,2200,45,51,23,22
49658,53,2388,53,allow,195,102,93,2,30,1,1
54826,445,0,0,drop,66,66,0,1,0,1,0
64427,445,0,0,drop,70,70,0,1,0,1,0
65286,445,0,0,drop,70,70,0,1,0,1,0
56791,443,55063,443,allow,8021,2001,6020,20,15,11,9
49394,443,40363,443,allow,7129,1853,5276,27,316,13,14
64352,53,14227,53,allow,213,102,111,2,29,1,1
37536,80,9440,80,allow,3565,1020,2545,16,15,9,7
49620,53,32011,53,allow,198,110,88,2,30,1,1
53842,443,26608,443,allow,499,425,74,4,0,3,1
51459,53,51459,53,allow,256,114,142,2,30,1,1
55295,445,0,0,drop,70,70,0,1,0,1,0
58991,445,0,0,drop,70,70,0,1,0,1,0
60731,80,1160,80,allow,5911,4727,1184,20,16,11,9
20608,28189,0,0,deny,60,60,0,1,0,1,0
63744,47106,38855,47106,allow,66,66,0,2,8,2,0
63069,53,35959,53,allow,384,166,218,2,30,1,1
27005,29999,55945,29999,allow,887,126,761,2,31,1,1
56883,22114,0,0,deny,62,62,0,1,0,1,0
34112,44847,0,0,deny,66,66,0,1,0,1,0
60189,443,11334,443,allow,10816,1112,9704,22,125,10,12
11907,57470,0,0,deny,66,66,0,1,0,1,0
50994,443,11381,443,allow,6349,1072,5277,18,21,10,8
56332,443,3765,443,allow,6028,1958,4070,34,124,14,20
56658,53,53602,53,allow,193,102,91,2,30,1,1
59601,445,0,0,drop,70,70,0,1,0,1,0
57786,445,0,0,drop,66,66,0,1,0,1,0
56655,53,1875,53,allow,210,110,100,2,30,1,1
57377,53,64833,53,allow,1165,94,1071,2,30,1,1
50691,80,62082,80,allow,4237,3610,627,15,31,8,7
50017,80,11643,80,allow,827,687,140,6,32,4,2
58829,443,11100,443,allow,2576,1549,1027,15,15,7,8
7322,80,9945,80,allow,950,485,465,9,16,5,4
53158,17234,38811,17234,allow,70,70,0,1,4,1,0
58638,5900,0,0,deny,62,62,0,1,0,1,0
50946,44847,0,0,deny,66,66,0,1,0,1,0
18381,53,18381,53,allow,237,91,146,2,32,1,1
58079,50584,0,0,deny,66,66,0,1,0,1,0
55446,445,0,0,drop,70,70,0,1,0,1,0
65204,443,43176,443,allow,1786,172,1614,7,120,3,4
37965,1052,51562,1052,allow,132,132,0,3,1199,3,0
50916,445,0,0,drop,70,70,0,1,0,1,0
59128,44847,0,0,deny,66,66,0,1,0,1,0
61664,445,0,0,drop,66,66,0,1,0,1,0
52143,445,0,0,drop,66,66,0,1,0,1,0
64814,53,31747,53,allow,565,215,350,6,37,3,3
61006,445,0,0,drop,66,66,0,1,0,1,0
64159,445,0,0,drop,70,70,0,1,0,1,0
56644,443,7171,443,allow,12924,3689,9235,31,82,17,14
65377,53,44573,53,allow,193,102,91,2,31,1,1
6881,32056,50769,32056,allow,509,150,359,2,1199,1,1
56314,53,21778,53,allow,211,102,109,2,29,1,1
37096,443,33249,443,allow,1753,1108,645,16,26,9,7
38848,11119,0,0,deny,146,146,0,1,0,1,0
13285,29892,0,0,deny,145,145,0,1,0,1,0
60627,51050,0,0,deny,62,62,0,1,0,1,0
58856,443,36240,443,allow,6350667,198580,6152087,6885,451,2497,4388
60945,445,0,0,drop,70,70,0,1,0,1,0
57312,53,16678,53,allow,1385,85,1300,4,42,2,2
64020,53,53035,53,allow,196,102,94,2,30,1,1
55828,443,52104,443,allow,5278,1026,4252,20,15,11,9
55831,53,65358,53,allow,183,94,89,2,30,1,1
51600,445,0,0,drop,70,70,0,1,0,1,0
36749,443,54855,443,allow,487330,18074,469256,508,122,148,360
11859,64147,0,0,deny,62,62,0,1,0,1,0
49797,25174,0,0,deny,66,66,0,1,0,1,0
60872,443,25312,443,allow,27204,15677,11527,59,62,30,29
50056,27018,38815,27018,allow,468,390,78,5,29,4,1
37647,36237,0,0,deny,66,66,0,1,0,1,0
65483,445,0,0,drop,70,70,0,1,0,1,0
42722,56448,0,0,deny,74,74,0,1,0,1,0
53174,41442,13286,41442,allow,70,70,0,1,5,1,0
56697,445,0,0,drop,70,70,0,1,0,1,0
22683,39210,0,0,deny,60,60,0,1,0,1,0
52377,53,52377,53,allow,229,89,140,2,31,1,1
40207,80,3053,80,allow,1364,860,504,13,32,8,5
55127,80,31027,80,allow,4239,2334,1905,17,187,10,7
59326,57470,0,0,deny,74,74,0,1,0,1,0
44654,80,35775,80,allow,2121,1558,563,13,16,7,6
52010,445,0,0,drop,70,70,0,1,0,1,0
7891,25174,0,0,deny,66,66,0,1,0,1,0
11821,64147,0,0,deny,62,62,0,1,0,1,0
47812,30627,0,0,deny,62,62,0,1,0,1,0
46128,443,47204,443,allow,9814,2331,7483,38,255,19,19
50610,443,21425,443,allow,9469,1273,8196,29,93,15,14
53456,443,13197,443,allow,25555,2220,23335,44,30,20,24
56677,443,24316,443,allow,7941,1952,5989,20,15,11,9
62825,443,8189,443,allow,17772,2595,15177,25,122,12,13
40772,15503,0,0,deny,74,74,0,1,0,1,0
36000,443,6421,443,allow,68705,5084,63621,93,172,36,57
30046,15503,0,0,deny,62,62,0,1,0,1,0
56548,53,54465,53,allow,199,102,97,2,31,1,1
57470,6881,50879,6881,allow,1806,726,1080,24,2426,12,12
34357,443,9724,443,allow,33131,26333,6798,49,121,28,21
64650,53,46185,53,allow,257,126,131,2,30,1,1
56668,53,61467,53,allow,701,88,613,2,30,1,1
53155,28206,42266,28206,allow,70,70,0,2,8,2,0
50023,53,38403,53,allow,164,84,80,2,31,1,1
56998,53,64754,53,allow,177,94,83,2,30,1,1
54371,445,0,0,drop,70,70,0,1,0,1,0
58521,445,0,0,drop,70,70,0,1,0,1,0
64229,53,36573,53,allow,266,110,156,2,31,1,1
32974,37965,0,0,deny,66,66,0,1,0,1,0
1912,48817,0,0,deny,62,62,0,1,0,1,0
443,43775,0,0,deny,97,97,0,1,0,1,0
36966,10387,0,0,deny,159,159,0,1,0,1,0
57729,443,45932,443,allow,12689,5742,6947,26,43,14,12
53849,17580,55160,17580,allow,492,306,186,8,15,5,3
37965,58043,10741,58043,allow,6029,3652,2377,79,3221,45,34
48972,443,48972,443,allow,4657,1750,2907,19,31,11,8
56923,53,49262,53,allow,711,87,624,2,30,1,1
54266,445,0,0,drop,66,66,0,1,0,1,0
62651,445,0,0,drop,70,70,0,1,0,1,0
45964,55559,0,0,deny,60,60,0,1,0,1,0
54176,445,0,0,drop,66,66,0,1,0,1,0
56763,27734,6083,27734,allow,70,70,0,1,5,1,0
27005,27015,61856,27015,allow,888,126,762,2,30,1,1
50473,80,50473,80,allow,78355,11395,66960,122,27,62,60
55600,53,56237,53,allow,168,78,90,2,30,1,1
15875,50584,0,0,deny,62,62,0,1,0,1,0
58756,445,0,0,drop,66,66,0,1,0,1,0
50063,35776,0,0,deny,148,148,0,1,0,1,0
59800,443,57363,443,allow,94202,5247,88955,115,37,41,74
58369,53,2783,53,allow,167,78,89,2,30,1,1
53524,45395,6631,45395,allow,70,70,0,2,8,2,0
52052,80,64577,80,allow,2188,593,1595,11,16,5,6
52306,445,0,0,drop,70,70,0,1,0,1,0
60727,443,60727,443,allow,2169,1158,1011,20,15,11,9
60761,445,0,0,drop,70,70,0,1,0,1,0
53531,48908,42269,48908,allow,70,70,0,1,4,1,0
55244,53,24318,53,allow,184,102,82,2,30,1,1
64961,27025,27939,27025,allow,1334,462,872,4,30,2,2
22683,39210,0,0,deny,60,60,0,1,0,1,0
56339,445,0,0,drop,70,70,0,1,0,1,0
61499,445,0,0,drop,70,70,0,1,0,1,0
62824,37807,0,0,deny,66,66,0,1,0,1,0
56655,53,35529,53,allow,210,110,100,2,30,1,1
60123,443,13855,443,allow,6485,1957,4528,22,16,11,11
51422,3027,51422,3027,allow,156,156,0,3,8,3,0
55040,443,51805,443,allow,36648,3634,33014,51,62,23,28
21588,52700,0,0,deny,145,145,0,1,0,1,0
55462,445,0,0,drop,70,70,0,1,0,1,0
49692,53,65365,53,allow,212,110,102,2,30,1,1
57424,53,8409,53,allow,210,102,108,2,30,1,1
53559,58968,6999,58968,allow,70,70,0,1,4,1,0
50924,445,0,0,drop,66,66,0,1,0,1,0
58483,445,0,0,drop,70,70,0,1,0,1,0
56556,53,50468,53,allow,184,94,90,2,30,1,1
37203,443,4528,443,allow,466,392,74,4,0,3,1
17982,11392,0,0,deny,62,62,0,1,0,1,0
57828,445,0,0,drop,70,70,0,1,0,1,0
65514,53,14703,53,allow,214,110,104,2,29,1,1
51580,53,9399,53,allow,199,94,105,2,30,1,1
57330,443,48576,443,allow,36551,3569,32982,57,46,28,29
60184,37965,0,0,deny,66,66,0,1,0,1,0
13727,13751,0,0,deny,148,148,0,1,0,1,0
52269,445,0,0,drop,66,66,0,1,0,1,0
50375,53,45862,53,allow,211,110,101,2,30,1,1
57009,53,27487,53,allow,1435,98,1337,4,34,2,2
49330,443,57448,443,allow,137414,6004,131410,170,80,59,111
57053,53,14057,53,allow,173,94,79,2,29,1,1
51936,17650,3656,17650,allow,70,70,0,1,5,1,0
48655,53,0,0,allow,82,82,0,2,40,2,0
52494,36237,0,0,deny,146,146,0,1,0,1,0
44776,443,54500,443,allow,10087,4073,6014,33,88,18,15
53841,443,33528,443,allow,499,425,74,4,0,3,1
49103,443,44063,443,allow,6725,505,6220,20,181,5,15
59013,445,0,0,drop,66,66,0,1,0,1,0
55939,53,41055,53,allow,177,94,83,2,30,1,1
38664,37965,0,0,deny,62,62,0,1,0,1,0
49747,53,22028,53,allow,278,94,184,2,30,1,1
51263,443,47905,443,allow,143597,6963,136634,206,439,103,103
58800,443,5645,443,allow,3874,2470,1404,17,15,9,8
58638,5900,0,0,deny,62,62,0,1,0,1,0
64330,53,10524,53,allow,193,102,91,2,30,1,1
23528,44847,0,0,deny,62,62,0,1,0,1,0
55383,53,13927,53,allow,177,94,83,2,30,1,1
3976,25174,0,0,deny,62,62,0,1,0,1,0
51110,80,59490,80,allow,1524,1028,496,10,20,7,3
50994,35974,0,0,deny,60,60,0,1,0,1,0
51197,445,0,0,drop,70,70,0,1,0,1,0
52624,443,65468,443,allow,5837,1982,3855,19,19,11,8
26263,8168,0,0,deny,66,66,0,1,0,1,0
7444,57470,0,0,deny,66,66,0,1,0,1,0
8886,80,28945,80,allow,1748,716,1032,19,395,6,13
41763,443,59315,443,allow,9797,1934,7863,21,15,12,9
22490,25174,0,0,deny,62,62,0,1,0,1,0
55421,57470,0,0,deny,74,74,0,1,0,1,0
58638,5900,0,0,deny,62,62,0,1,0,1,0
49759,53,39321,53,allow,201,86,115,2,30,1,1
65355,53,61445,53,allow,741,94,647,2,30,1,1
54943,443,33087,443,allow,7118,2618,4500,21,30,12,9
443,49313,0,0,deny,97,97,0,1,0,1,0
515,10214,0,0,deny,62,62,0,1,0,1,0
56949,443,2703,443,allow,5601,1203,4398,14,59,9,5
51320,37965,0,0,deny,62,62,0,1,0,1,0
27005,26259,41193,26259,allow,889,126,763,2,31,1,1
53723,51501,24523,51501,allow,70,70,0,1,5,1,0
12567,23,0,0,deny,60,60,0,1,0,1,0
63455,445,0,0,drop,70,70,0,1,0,1,0
26180,35440,0,0,deny,66,66,0,1,0,1,0
27988,40001,35761,40001,allow,148,86,62,2,30,1,1
56551,53,16307,53,allow,458,188,270,6,30,3,3
52073,16316,19866,16316,allow,70,70,0,2,8,2,0
49783,443,33987,443,allow,10095,2871,7224,23,126,12,11
51500,443,60787,443,allow,451,259,192,5,23,2,3
49620,443,22598,443,allow,4565,3479,1086,13,138,8,5
64395,445,0,0,drop,70,70,0,1,0,1,0
65006,53,63104,53,allow,994,86,908,2,30,1,1
55805,445,0,0,drop,70,70,0,1,0,1,0
54944,445,0,0,drop,70,70,0,1,0,1,0
50730,443,7850,443,allow,1323,738,585,10,16,6,4
33370,22,0,0,deny,60,60,0,1,0,1,0
1660,8696,0,0,deny,62,62,0,1,0,1,0
52225,31985,35881,31985,allow,66,66,0,1,5,1,0
49418,27053,45679,27053,allow,78,78,0,1,30,1,0
5011,53,5011,53,allow,244,98,146,2,32,1,1
51939,80,10449,80,allow,103732,4081,99651,128,61,55,73
38085,443,1147,443,allow,78,78,0,1,5,1,0
54195,443,37622,443,allow,499,425,74,4,0,3,1
53337,1433,0,0,deny,60,60,0,1,0,1,0
59053,53,2855,53,allow,227,86,141,2,30,1,1
57774,445,0,0,drop,70,70,0,1,0,1,0
8999,43109,0,0,deny,146,146,0,1,0,1,0
63369,445,0,0,drop,66,66,0,1,0,1,0
56118,443,45922,443,allow,187927,12115,175812,276,42,137,139
54179,443,27953,443,allow,5037,2002,3035,14,120,7,7
54956,53,56541,53,allow,194,102,92,2,30,1,1
45964,2228,0,0,deny,60,60,0,1,0,1,0
64288,445,0,0,drop,66,66,0,1,0,1,0
52172,7353,21812,7353,allow,70,70,0,1,5,1,0
10151,49001,62928,49001,allow,481,150,331,2,1201,1,1
43185,50584,0,0,deny,146,146,0,1,0,1,0
51613,443,47721,443,allow,5052,2873,2179,26,15,14,12
60362,443,18140,443,allow,130,70,60,2,15,1,1
55701,31543,58312,31543,allow,320,140,180,6,5,3,3
63956,38211,0,0,deny,62,62,0,1,0,1,0
58536,53,40631,53,allow,522,162,360,6,64,3,3
26448,9192,0,0,deny,145,145,0,1,0,1,0
42128,54532,0,0,deny,60,60,0,1,0,1,0
51510,445,0,0,drop,66,66,0,1,0,1,0
52318,22114,0,0,deny,62,62,0,1,0,1,0
49288,443,9666,443,allow,7846,2369,5477,23,385,10,13
57398,445,0,0,drop,70,70,0,1,0,1,0
49934,445,0,0,drop,70,70,0,1,0,1,0
49206,53,41774,53,allow,301,89,212,4,48,2,2
50704,80,8069,80,allow,499,192,307,6,26,4,2
29979,53,29979,53,allow,215,80,135,2,33,1,1
41278,443,28567,443,allow,7238,2601,4637,20,17,10,10
58869,443,38937,443,allow,4657,2146,2511,14,135,7,7
51560,46783,0,0,deny,66,66,0,1,0,1,0
56788,443,39724,443,allow,7929,1940,5989,20,15,11,9
40108,23,0,0,deny,60,60,0,1,0,1,0
48935,443,24879,443,allow,12753,6074,6679,44,88,23,21
49179,80,7093,80,allow,2807,587,2220,13,16,7,6
31683,53,31683,53,allow,197,90,107,2,30,1,1
56237,26467,0,0,deny,66,66,0,1,0,1,0
60286,443,29238,443,allow,7576,1897,5679,23,136,13,10
49530,445,0,0,drop,66,66,0,1,0,1,0
52145,443,2383,443,allow,190,70,120,4,15,2,2
64722,53,18980,53,allow,384,94,290,4,42,2,2
35710,443,47207,443,allow,1053,566,487,10,31,6,4
49411,445,0,0,drop,70,70,0,1,0,1,0
64065,53,29677,53,allow,270,94,176,2,30,1,1
59596,3389,59596,3389,allow,3523,1714,1809,17,34,8,9
45981,51505,0,0,deny,62,62,0,1,0,1,0
53886,445,0,0,drop,70,70,0,1,0,1,0
33801,62413,0,0,deny,62,62,0,1,0,1,0
64289,53,50043,53,allow,199,102,97,2,30,1,1
40358,53,40358,53,allow,414,268,146,3,32,2,1
49179,53,18943,53,allow,309,118,191,2,30,1,1
64074,53,54669,53,allow,209,110,99,2,30,1,1
443,29326,0,0,deny,82,82,0,1,0,1,0
49378,53,26888,53,allow,210,94,116,2,30,1,1
60728,445,0,0,drop,70,70,0,1,0,1,0
54372,443,7862,443,allow,11828,2811,9017,31,76,16,15
44675,53,44675,53,allow,197,76,121,2,30,1,1
50232,443,24591,443,allow,7292,950,6342,19,75,9,10
36986,53,36986,53,allow,234,93,141,2,31,1,1
35005,53,35005,53,allow,233,90,143,2,33,1,1
50228,445,0,0,drop,66,66,0,1,0,1,0
1284,50584,0,0,deny,66,66,0,1,0,1,0
49624,445,0,0,drop,70,70,0,1,0,1,0
55257,80,57672,80,allow,3564,1625,1939,12,131,6,6
60821,443,28093,443,allow,16554,7445,9109,49,255,24,25
56837,53,27740,53,allow,195,102,93,2,32,1,1
51156,445,0,0,drop,70,70,0,1,0,1,0
34716,23,0,0,deny,60,60,0,1,0,1,0
56528,64147,0,0,deny,62,62,0,1,0,1,0
41910,443,63630,443,allow,9358,2304,7054,39,120,20,19
20389,64147,0,0,deny,66,66,0,1,0,1,0
52430,35440,0,0,deny,62,62,0,1,0,1,0
61270,445,0,0,drop,70,70,0,1,0,1,0
443,14591,0,0,deny,131,131,0,1,0,1,0
53694,8999,50905,8999,allow,1179,606,573,12,17,7,5
62164,445,0,0,drop,70,70,0,1,0,1,0
22587,30188,0,0,deny,62,62,0,1,0,1,0
56324,53,13523,53,allow,177,94,83,2,30,1,1
7286,51221,0,0,deny,62,62,0,1,0,1,0
56245,53,35606,53,allow,200,102,98,2,30,1,1
443,44683,0,0,deny,83,83,0,1,0,1,0
443,20087,0,0,deny,83,83,0,1,0,1,0
52447,445,0,0,drop,70,70,0,1,0,1,0
64709,53,54232,53,allow,338,110,228,2,29,1,1
50686,443,29049,443,allow,6340,1381,4959,19,170,9,10
63813,53455,26592,53455,allow,66,66,0,2,7,2,0
57996,445,0,0,drop,70,70,0,1,0,1,0
26900,27017,64848,27017,allow,422,164,258,6,30,3,3
50779,445,0,0,drop,70,70,0,1,0,1,0
65191,53,55910,53,allow,294,102,192,2,30,1,1
55912,53,45004,53,allow,199,102,97,2,29,1,1
49493,53,48045,53,allow,241,118,123,2,30,1,1
39417,53,53271,53,allow,224,78,146,2,30,1,1
49418,27015,23061,27015,allow,256,78,178,2,30,1,1
35516,22,0,0,deny,60,60,0,1,0,1,0
49777,443,39129,443,allow,8638,2215,6423,24,126,14,10
36404,443,36404,443,allow,4651,1744,2907,19,28,11,8
59295,445,0,0,drop,70,70,0,1,0,1,0
50265,45589,64355,45589,allow,132,132,0,3,1200,3,0
49345,443,62638,443,allow,26156,6762,19394,37,16,16,21
58295,445,0,0,drop,70,70,0,1,0,1,0
64179,53,19210,53,allow,212,102,110,2,30,1,1
32551,51221,0,0,deny,62,62,0,1,0,1,0
53230,443,53230,443,allow,1462,916,546,13,34,7,6
46764,443,46764,443,allow,4401,1494,2907,19,29,11,8
43154,80,38984,80,allow,139303,9065,130238,210,20,120,90
51356,22114,0,0,deny,66,66,0,1,0,1,0
45652,10214,0,0,deny,62,62,0,1,0,1,0
55727,445,0,0,drop,66,66,0,1,0,1,0
52261,48208,15422,48208,allow,70,70,0,2,8,2,0
53220,80,25607,80,allow,17976,840,17136,21,16,6,15
50596,53,57766,53,allow,168,86,82,2,30,1,1
56325,445,0,0,drop,66,66,0,1,0,1,0
50386,8080,50386,8080,allow,5533,2632,2901,20,46,12,8
54461,80,46042,80,allow,2544,900,1644,12,255,7,5
60114,445,0,0,drop,66,66,0,1,0,1,0
56033,443,58131,443,allow,8396,1919,6477,27,116,12,15
55218,80,61870,80,allow,2568,1705,863,12,186,7,5
51789,443,60352,443,allow,6218,4326,1892,31,124,17,14
27260,443,46156,443,allow,4329,2374,1955,23,520,8,15
49870,53,59356,53,allow,194,102,92,2,30,1,1
9246,80,48818,80,allow,318,192,126,6,26,4,2
57996,53,57996,53,allow,847,110,737,2,30,1,1
10026,443,31835,443,allow,3409,1599,1810,24,80,12,12
49175,2710,9134,2710,allow,66,66,0,1,5,1,0
52100,80,3260,80,allow,30068,3203,26865,43,35,19,24
51596,443,63040,443,allow,4638384,61757,4576627,3641,280,309,3332
1038,37965,0,0,deny,62,62,0,1,0,1,0
56928,53,11160,53,allow,178,94,84,2,31,1,1
54658,445,0,0,drop,70,70,0,1,0,1,0
55711,26467,0,0,deny,66,66,0,1,0,1,0
54849,445,0,0,drop,70,70,0,1,0,1,0
56606,3389,56606,3389,allow,4130,2105,2025,18,16,9,9
57397,53,56026,53,allow,177,94,83,2,31,1,1
64385,445,0,0,drop,70,70,0,1,0,1,0
49255,44847,0,0,deny,62,62,0,1,0,1,0
59400,445,0,0,drop,66,66,0,1,0,1,0
49546,53,27218,53,allow,193,102,91,2,30,1,1
54295,445,0,0,drop,70,70,0,1,0,1,0
22530,25174,0,0,deny,62,62,0,1,0,1,0
57206,53,29989,53,allow,292,85,207,4,50,2,2
38568,53,38568,53,allow,247,98,149,2,33,1,1
54982,53,58418,53,allow,282,96,186,4,47,2,2
49885,53,38127,53,allow,377,94,283,2,30,1,1
27005,27015,9469,27015,allow,887,126,761,2,30,1,1
10738,50584,0,0,deny,62,62,0,1,0,1,0
27005,27015,45876,27015,allow,886,126,760,2,30,1,1
50799,445,0,0,drop,70,70,0,1,0,1,0
7274,64147,0,0,deny,62,62,0,1,0,1,0
13840,37965,0,0,deny,146,146,0,1,0,1,0
55052,53,1245,53,allow,198,102,96,2,30,1,1
16965,3389,16965,3389,allow,4085,1916,2169,21,18,12,9
65116,53,63151,53,allow,214,110,104,2,30,1,1
63808,53,2452,53,allow,578,286,292,9,15,5,4
49800,5900,0,0,deny,60,60,0,1,0,1,0
54336,445,0,0,drop,66,66,0,1,0,1,0
5240,36828,56682,36828,allow,166456,128,166328,270,35,3,267
60224,443,54670,443,allow,9079,3570,5509,68,152,34,34
46384,443,46384,443,allow,4594,1687,2907,19,30,11,8
56922,445,0,0,drop,70,70,0,1,0,1,0
9462,443,5144,443,allow,4717,2929,1788,23,26,13,10
55489,53,34902,53,allow,748,106,642,2,31,1,1
56809,53,64424,53,allow,172,88,84,2,31,1,1
59383,445,0,0,drop,66,66,0,1,0,1,0
50010,53,39739,53,allow,756,95,661,2,31,1,1
57484,445,0,0,drop,70,70,0,1,0,1,0
56770,443,61506,443,allow,5829,2962,2867,35,89,17,18
57649,6881,0,0,deny,146,146,0,1,0,1,0
64498,445,0,0,drop,66,66,0,1,0,1,0
8971,80,8971,80,allow,326,186,140,6,29,4,2
58638,5900,0,0,deny,62,62,0,1,0,1,0
57700,53,7203,53,allow,308,118,190,2,29,1,1
50834,64147,0,0,deny,62,62,0,1,0,1,0
57852,7635,57852,7635,allow,216,156,60,4,8,3,1
56330,53,26400,53,allow,199,102,97,2,30,1,1
50708,22114,0,0,deny,62,62,0,1,0,1,0
57305,53,63466,53,allow,177,94,83,2,30,1,1
64823,53,30935,53,allow,508,102,406,2,30,1,1
55081,445,0,0,drop,70,70,0,1,0,1,0
62292,445,0,0,drop,70,70,0,1,0,1,0
49418,27018,24351,27018,allow,240,78,162,2,30,1,1
54120,445,0,0,drop,66,66,0,1,0,1,0
38888,22,38888,22,allow,5130,2103,3027,28,25,16,12
5060,37965,0,0,deny,66,66,0,1,0,1,0
49730,53,24529,53,allow,211,110,101,2,30,1,1
52559,443,18708,443,allow,4479,2526,1953,10,120,6,4
53050,445,0,0,drop,70,70,0,1,0,1,0
7928,80,7928,80,allow,25909,3016,22893,40,83,15,25
56473,80,3557,80,allow,48910,2361,46549,63,135,29,34
50610,445,0,0,drop,66,66,0,1,0,1,0
37672,5223,1351,5223,allow,110,110,0,1,5,1,0
14869,44847,0,0,deny,62,62,0,1,0,1,0
5610,37965,0,0,deny,66,66,0,1,0,1,0
15792,3478,30536,3478,allow,428935914,213443641,215492273,635946,2242,308738,327208
49686,44847,0,0,deny,62,62,0,1,0,1,0
54279,443,54279,443,allow,4699,1792,2907,19,28,11,8
56833,28571,3493,28571,allow,5436,3022,2414,17,32,11,6
38330,44847,0,0,deny,66,66,0,1,0,1,0
56275,65348,0,0,deny,142,142,0,1,0,1,0
57251,37965,0,0,deny,62,62,0,1,0,1,0
37573,443,61773,443,allow,499,425,74,4,0,3,1
39094,443,50838,443,allow,828718,43410,785308,1071,347,479,592
49790,80,49818,80,allow,1769,1271,498,10,126,6,4
43675,80,34710,80,allow,1676620,41953,1634667,1725,25,636,1089
54463,445,0,0,drop,70,70,0,1,0,1,0
57072,53,34434,53,allow,193,102,91,2,30,1,1
56574,443,27778,443,allow,75732,15030,60702,137,138,56,81
63822,14382,38807,14382,allow,70,70,0,1,4,1,0
39313,37965,0,0,deny,62,62,0,1,0,1,0
57594,443,61887,443,allow,291,171,120,4,15,2,2
63987,445,0,0,drop,70,70,0,1,0,1,0
50985,80,61422,80,allow,613,539,74,7,15,6,1
27005,27015,11957,27015,allow,901,126,775,2,30,1,1
19987,53,54747,53,allow,208,86,122,2,30,1,1
49319,53,53546,53,allow,260,102,158,2,30,1,1
61488,53,0,0,allow,314,93,221,2,30,1,1
16387,64660,0,0,deny,60,60,0,1,0,1,0
51963,22114,0,0,deny,66,66,0,1,0,1,0
51790,46839,56676,46839,allow,70,70,0,1,5,1,0
24504,37965,0,0,deny,62,62,0,1,0,1,0
52112,22114,0,0,deny,66,66,0,1,0,1,0
57987,56125,0,0,deny,90,90,0,1,0,1,0
29972,50584,0,0,deny,62,62,0,1,0,1,0
52831,53,52831,53,allow,200,90,110,2,30,1,1
55195,53,34217,53,allow,969,86,883,2,29,1,1
33570,443,59571,443,allow,81954,13611,68343,174,34,79,95
51401,6881,0,0,deny,66,66,0,1,0,1,0
55184,53,41873,53,allow,183,94,89,2,31,1,1
10151,10016,24460,10016,allow,460,150,310,2,1200,1,1
55763,443,52551,443,allow,48162,46496,1666,59,136,39,20
54369,445,0,0,drop,70,70,0,1,0,1,0
57143,445,0,0,drop,66,66,0,1,0,1,0
56464,445,0,0,drop,70,70,0,1,0,1,0
55906,445,0,0,drop,70,70,0,1,0,1,0
50417,80,26233,80,allow,1658,1247,411,8,15,5,3
16387,26193,0,0,deny,60,60,0,1,0,1,0
57370,6969,42046,6969,allow,70,70,0,2,8,2,0
64595,53,62622,53,allow,167,86,81,2,30,1,1
34517,80,7727,80,allow,1056,682,374,10,16,6,4
50408,53,52200,53,allow,182,93,89,2,30,1,1
55046,443,52512,443,allow,3804,1099,2705,19,137,8,11
27005,27018,46285,27018,allow,895,126,769,2,30,1,1
58956,80,51257,80,allow,2493,1830,663,12,15,6,6
61107,445,0,0,drop,70,70,0,1,0,1,0
11252,23,0,0,deny,60,60,0,1,0,1,0
54389,445,0,0,drop,70,70,0,1,0,1,0
49600,80,7933,80,allow,312,192,120,6,41,4,2
64926,53,43197,53,allow,192,98,94,2,40,1,1
27005,27017,53303,27017,allow,1634,126,1508,4,30,2,2
58638,5900,0,0,deny,62,62,0,1,0,1,0
63272,445,0,0,drop,66,66,0,1,0,1,0
49983,53,22293,53,allow,206,105,101,2,31,1,1
51202,443,46664,443,allow,7702,2410,5292,26,34,13,13
3765,64147,0,0,deny,66,66,0,1,0,1,0
55764,53,63898,53,allow,250,94,156,2,30,1,1
50575,80,50575,80,allow,44569,12221,32348,81,19,42,39
52910,443,4102,443,allow,179433,12614,166819,217,116,78,139
49845,53,35831,53,allow,168,86,82,2,30,1,1
56263,443,47325,443,allow,101747,13436,88311,135,319,53,82
28064,36237,0,0,deny,62,62,0,1,0,1,0
55596,53,61686,53,allow,170,87,83,2,30,1,1
65479,443,61050,443,allow,92397,4379,88018,102,16,37,65
55228,443,61820,443,allow,12645,4916,7729,39,94,22,17
27442,44847,0,0,deny,62,62,0,1,0,1,0
64082,53,17005,53,allow,356,97,259,4,58,2,2
65231,53,2677,53,allow,200,102,98,2,30,1,1
37014,23,0,0,deny,60,60,0,1,0,1,0
63221,53436,0,0,deny,62,62,0,1,0,1,0
56612,53,36295,53,allow,184,94,90,2,31,1,1
53721,62413,0,0,deny,146,146,0,1,0,1,0
57246,53,9725,53,allow,183,94,89,2,30,1,1
21750,39004,0,0,deny,66,66,0,1,0,1,0
59732,443,8520,443,allow,7310,967,6343,18,25,10,8
36836,443,26019,443,allow,9381,1457,7924,21,31,11,10
49326,443,59214,443,allow,5514,3341,2173,31,75,15,16
55877,6380,28997,6380,allow,149,149,0,2,1200,2,0
55325,53,12048,53,allow,762,101,661,2,30,1,1
13911,57470,0,0,deny,60,60,0,1,0,1,0
37649,443,13055,443,allow,32391,21443,10948,69,47,41,28
11295,40018,57800,40018,allow,213,89,124,4,31,2,2
50284,443,28484,443,allow,208,60,148,4,12,2,2
56946,1,0,0,deny,66,66,0,1,0,1,0
61295,443,30551,443,allow,134322,10347,123975,220,304,77,143
38675,443,37452,443,allow,13929,2854,11075,43,128,22,21
55707,53,37897,53,allow,170,87,83,2,31,1,1
57318,443,57308,443,allow,10504,1787,8717,27,364,12,15
56409,53,35272,53,allow,199,102,97,2,30,1,1
57858,445,0,0,drop,66,66,0,1,0,1,0
65068,23,0,0,deny,60,60,0,1,0,1,0
63520,445,0,0,drop,70,70,0,1,0,1,0
44208,26467,0,0,deny,62,62,0,1,0,1,0
56962,53,51903,53,allow,170,87,83,2,30,1,1
47966,443,16155,443,allow,10895,2151,8744,26,362,11,15
58387,445,0,0,drop,66,66,0,1,0,1,0
49634,53,57122,53,allow,718,94,624,2,30,1,1
63033,443,16495,443,allow,6869,3059,3810,30,123,15,15
58665,445,0,0,drop,66,66,0,1,0,1,0
6881,6881,48136,6881,allow,238,118,120,2,1200,1,1
50118,445,0,0,drop,70,70,0,1,0,1,0
56827,53,43714,53,allow,190,97,93,2,31,1,1
60278,80,27803,80,allow,1422,734,688,7,99,4,3
55600,22,0,0,deny,60,60,0,1,0,1,0
58980,123,62249,123,allow,184,94,90,2,30,1,1
50438,53,15254,53,allow,296,101,195,4,31,2,2
63116,22114,0,0,deny,62,62,0,1,0,1,0
41587,5222,51042,5222,allow,208,60,148,4,14,2,2
63136,25174,0,0,deny,66,66,0,1,0,1,0
65489,443,61860,443,allow,92240,4799,87441,107,16,43,64
55649,42266,57482,42266,allow,70,70,0,1,5,1,0
52039,445,0,0,drop,70,70,0,1,0,1,0
43681,443,58156,443,allow,7235,1097,6138,21,27,10,11
1081,21162,0,0,deny,146,146,0,1,0,1,0
33521,80,30889,80,allow,3429,1679,1750,14,22,8,6
65201,53,7188,53,allow,216,110,106,2,30,1,1
57580,443,3612,443,allow,4049,1992,2057,23,96,13,10
58372,445,0,0,drop,66,66,0,1,0,1,0
50092,80,20230,80,allow,11297,8141,3156,52,508,34,18
58510,445,0,0,drop,66,66,0,1,0,1,0
51048,445,0,0,drop,70,70,0,1,0,1,0
63032,22114,0,0,deny,66,66,0,1,0,1,0
64691,25320,0,0,deny,66,66,0,1,0,1,0
44587,443,26672,443,allow,16341,3306,13035,42,17,24,18
9148,443,13581,443,allow,6334,840,5494,19,29,10,9
7310,44847,0,0,deny,62,62,0,1,0,1,0
56674,53,43592,53,allow,182,93,89,2,31,1,1
57380,443,31912,443,allow,5553,927,4626,16,15,10,6
49845,445,0,0,drop,70,70,0,1,0,1,0
55641,61762,32816,61762,allow,70,70,0,2,8,2,0
38095,443,38095,443,allow,247172,58810,188362,325,90,174,151
53028,443,47549,443,allow,12081,2070,10011,33,620,12,21
49360,53,44969,53,allow,263,102,161,2,29,1,1
12242,51221,0,0,deny,62,62,0,1,0,1,0
44048,443,44048,443,allow,4401,1494,2907,19,29,11,8
27005,30005,45159,30005,allow,890,126,764,2,31,1,1
59095,57470,0,0,deny,66,66,0,1,0,1,0
38427,443,30130,443,allow,12591,2902,9689,40,55,19,21
55646,53,54569,53,allow,182,93,89,2,30,1,1
50255,445,0,0,drop,70,70,0,1,0,1,0
55656,31165,21172,31165,allow,70,70,0,2,8,2,0
56442,11392,0,0,deny,66,66,0,1,0,1,0
57737,445,0,0,drop,66,66,0,1,0,1,0
52806,445,0,0,drop,70,70,0,1,0,1,0
28580,64147,0,0,deny,62,62,0,1,0,1,0
53097,443,17057,443,allow,7013,1718,5295,18,326,9,9
65286,3389,65286,3389,allow,3424,1710,1714,16,31,8,8
52566,443,55072,443,allow,8594,1042,7552,16,120,7,9
50803,443,40558,443,allow,1590,1038,552,12,48,6,6
56402,53,29838,53,allow,322,134,188,2,30,1,1
52010,80,6411,80,allow,1327,822,505,11,21,7,4
60270,445,0,0,drop,70,70,0,1,0,1,0
49619,80,12609,80,allow,318,192,126,6,42,4,2
52531,445,0,0,drop,70,70,0,1,0,1,0
53120,25174,0,0,deny,62,62,0,1,0,1,0
55721,53,12194,53,allow,177,94,83,2,29,1,1
26805,443,46763,443,allow,7697,2940,4757,25,18,13,12
58550,21247,0,0,deny,62,62,0,1,0,1,0
46600,443,0,0,deny,1097,1097,0,1,0,1,0
55354,53,21132,53,allow,214,110,104,2,30,1,1
55199,53,53506,53,allow,214,110,104,2,31,1,1
61468,445,0,0,drop,66,66,0,1,0,1,0
65456,445,0,0,drop,70,70,0,1,0,1,0
59128,443,26405,443,allow,92207,5395,86812,130,88,58,72
55323,53,29422,53,allow,279,94,185,2,30,1,1
50853,50584,0,0,deny,62,62,0,1,0,1,0
52221,53,10859,53,allow,177,86,91,2,30,1,1
57360,18375,0,0,deny,66,66,0,1,0,1,0
50380,443,13367,443,allow,306,180,126,6,25,4,2
51877,13472,45197,13472,allow,66,66,0,1,5,1,0
52200,23,0,0,deny,60,60,0,1,0,1,0
54753,443,7702,443,allow,84945,5052,79893,120,360,61,59
64744,445,0,0,drop,66,66,0,1,0,1,0
56566,53,0,0,allow,86,86,0,1,30,1,0
48151,123,24928,123,allow,184,94,90,2,30,1,1
52027,49743,23707,49743,allow,70,70,0,1,4,1,0
52113,443,33178,443,allow,17710,1892,15818,37,24,17,20
56952,53,60759,53,allow,193,102,91,2,30,1,1
43063,57470,0,0,deny,62,62,0,1,0,1,0
54916,445,0,0,drop,70,70,0,1,0,1,0
3521,6881,0,0,deny,66,66,0,1,0,1,0
35048,80,62136,80,allow,15867,2466,13401,29,33,16,13
13090,36237,0,0,deny,66,66,0,1,0,1,0
50143,35253,0,0,deny,62,62,0,1,0,1,0
50535,80,27169,80,allow,36985,3992,32993,56,151,25,31
57296,443,59127,443,allow,5613,733,4880,16,15,9,7
56883,53,20999,53,allow,184,94,90,2,30,1,1
58700,445,0,0,drop,66,66,0,1,0,1,0
65248,53,6844,53,allow,446,106,340,4,47,2,2
56724,445,0,0,drop,70,70,0,1,0,1,0
50106,53,61175,53,allow,209,110,99,2,30,1,1
46495,4607,0,0,deny,60,60,0,1,0,1,0
61017,64147,0,0,deny,62,62,0,1,0,1,0
49146,443,34396,443,allow,3655,1807,1848,17,15,9,8
62575,12207,0,0,deny,66,66,0,1,0,1,0
60616,445,0,0,drop,66,66,0,1,0,1,0
26793,3389,26793,3389,reset-both,293,223,70,4,1,3,1
55489,53,54406,53,allow,186,95,91,2,31,1,1
51163,445,0,0,drop,70,70,0,1,0,1,0
51858,443,51858,443,allow,12505,3792,8713,48,255,24,24
45871,443,58048,443,allow,275011,235921,39090,651,350,363,288
54989,50265,0,0,deny,66,66,0,1,0,1,0
64033,445,0,0,drop,66,66,0,1,0,1,0
64070,445,0,0,drop,70,70,0,1,0,1,0
62936,445,0,0,drop,70,70,0,1,0,1,0
57672,445,0,0,drop,70,70,0,1,0,1,0
49889,53,17299,53,allow,194,99,95,2,30,1,1
53122,80,53122,80,allow,19237,829,18408,29,15,13,16
47256,37807,0,0,deny,62,62,0,1,0,1,0
49563,53,8253,53,allow,200,102,98,2,30,1,1
49767,53,4502,53,allow,177,94,83,2,30,1,1
1733,65448,0,0,deny,62,62,0,1,0,1,0
42607,443,22766,443,allow,167,107,60,2,5,1,1
49531,80,9012,80,allow,78,78,0,1,5,1,0
65238,53,61898,53,allow,302,104,198,4,46,2,2
50211,1688,29763,1688,allow,70,70,0,2,7,2,0
53018,80,53018,80,allow,182677,4908,177769,213,25,73,140
55730,53,1752,53,allow,819,102,717,2,29,1,1
1238,51505,0,0,deny,146,146,0,1,0,1,0
64898,53,12662,53,allow,487,201,286,6,42,3,3
50902,80,25107,80,allow,5166,1278,3888,14,144,8,6
55688,53,51379,53,allow,184,94,90,2,30,1,1
58221,445,0,0,drop,70,70,0,1,0,1,0
56060,445,0,0,drop,70,70,0,1,0,1,0
53879,443,22578,443,allow,499,425,74,4,1,3,1
56026,53,4908,53,allow,183,94,89,2,31,1,1
64862,53,32776,53,allow,206,105,101,2,30,1,1
46834,53,46834,53,allow,235,90,145,2,32,1,1
55094,445,0,0,drop,66,66,0,1,0,1,0
56639,48817,0,0,deny,62,62,0,1,0,1,0
58270,445,0,0,drop,70,70,0,1,0,1,0
52888,5223,32740,5223,allow,12302,5509,6793,43,1061,16,27
59364,44847,0,0,deny,62,62,0,1,0,1,0
60691,445,0,0,drop,70,70,0,1,0,1,0
49945,53,50921,53,allow,281,97,184,4,58,2,2
52321,26467,0,0,deny,62,62,0,1,0,1,0
59688,445,0,0,drop,66,66,0,1,0,1,0
63171,5228,60967,5228,allow,3535,1973,1562,36,3961,18,18
1024,25174,0,0,deny,146,146,0,1,0,1,0
56249,55442,0,0,deny,66,66,0,1,0,1,0
5938,18721,0,0,allow,60,60,0,1,91,1,0
30188,53,30188,53,allow,238,95,143,2,30,1,1
34746,80,56625,80,allow,1299,793,506,12,15,6,6
50637,445,0,0,drop,70,70,0,1,0,1,0
40095,23,0,0,deny,60,60,0,1,0,1,0
54996,445,0,0,drop,70,70,0,1,0,1,0
53927,443,24116,443,allow,495,421,74,4,0,3,1
45941,23386,0,0,deny,60,60,0,1,0,1,0
31978,57470,0,0,deny,60,60,0,1,0,1,0
51943,80,43908,80,allow,306,120,186,6,27,3,3
50866,445,0,0,drop,70,70,0,1,0,1,0
57383,445,0,0,drop,70,70,0,1,0,1,0
58638,5900,0,0,deny,62,62,0,1,0,1,0
62766,443,11804,443,allow,3370,1226,2144,13,135,6,7
50160,57470,0,0,deny,146,146,0,1,0,1,0
34141,53,34141,53,allow,217,87,130,2,30,1,1
61452,53,0,0,allow,223,89,134,2,30,1,1
51221,1950,25491,1950,allow,870,330,540,12,1316,6,6
55533,80,6176,80,allow,3386,2365,1021,19,39,11,8
63385,445,0,0,drop,70,70,0,1,0,1,0
56443,53,60191,53,allow,168,86,82,2,30,1,1
56661,53,7946,53,allow,297,102,195,4,33,2,2
49813,53,53266,53,allow,775,102,673,2,30,1,1
51745,57470,0,0,deny,145,145,0,1,0,1,0
56756,443,1855,443,allow,7565,2187,5378,27,24,15,12
64920,445,0,0,drop,66,66,0,1,0,1,0
35657,48637,0,0,deny,62,62,0,1,0,1,0
52270,445,0,0,drop,70,70,0,1,0,1,0
49824,53,4911,53,allow,392,88,304,4,53,2,2
57476,445,0,0,drop,66,66,0,1,0,1,0
50303,443,52524,443,allow,208,60,148,4,11,2,2
43725,54532,0,0,deny,109,109,0,1,0,1,0
65218,53,38514,53,allow,194,102,92,2,31,1,1
51972,13604,43742,13604,allow,160,70,90,2,5,1,1
33241,443,5641,443,allow,37452,28136,9316,56,15,33,23
58627,25174,0,0,deny,62,62,0,1,0,1,0
44353,443,12767,443,allow,15234,2503,12731,45,135,20,25
48015,443,20608,443,allow,138,78,60,2,4,1,1
57882,443,30006,443,allow,22342,1787,20555,38,177,16,22
55396,26467,0,0,deny,62,62,0,1,0,1,0
50634,443,27378,443,allow,8220,1670,6550,26,71,13,13
56783,43890,0,0,deny,66,66,0,1,0,1,0
9061,80,4144,80,allow,639,279,360,8,121,4,4
63758,445,0,0,drop,66,66,0,1,0,1,0
12608,21247,0,0,deny,66,66,0,1,0,1,0
7246,59858,0,0,deny,66,66,0,1,0,1,0
52887,80,9477,80,allow,5694,2514,3180,36,118,19,17
53532,22114,0,0,deny,62,62,0,1,0,1,0
57326,443,4725,443,allow,5613,733,4880,16,14,9,7
51637,80,27014,80,allow,378,192,186,7,39,4,3
49791,53,7553,53,allow,216,94,122,2,30,1,1
50544,445,0,0,drop,70,70,0,1,0,1,0
19570,50584,0,0,deny,66,66,0,1,0,1,0
58503,445,0,0,drop,70,70,0,1,0,1,0
5223,21557,0,0,deny,91,91,0,1,0,1,0
50909,80,20271,80,allow,12826704,145724,12680980,10558,133,2024,8534
3783,40740,0,0,deny,160,160,0,1,0,1,0
62678,57470,0,0,deny,62,62,0,1,0,1,0
80,37649,0,0,deny,60,60,0,1,0,1,0
54986,53,61995,53,allow,214,110,104,2,30,1,1
47111,80,20951,80,allow,162355,7124,155231,207,27,96,111
48233,443,29829,443,allow,9759,3896,5863,28,230,15,13
50984,445,0,0,drop,66,66,0,1,0,1,0
49732,53,17684,53,allow,178,94,84,2,30,1,1
51520,443,51520,443,allow,53075,3609,49466,74,173,25,49
56410,445,0,0,drop,70,70,0,1,0,1,0
45912,44847,0,0,deny,62,62,0,1,0,1,0
36644,443,15948,443,allow,9329,3935,5394,30,405,17,13
55487,53,48616,53,allow,199,102,97,2,29,1,1
59201,51221,0,0,deny,62,62,0,1,0,1,0
51459,443,30706,443,allow,6779,2365,4414,19,15,10,9
28280,53,52004,53,allow,168,78,90,2,30,1,1
39455,80,39455,80,allow,14349,1038,13311,26,20,13,13
56257,53,40161,53,allow,177,94,83,2,30,1,1
52070,55946,25301,55946,allow,316,136,180,6,7,3,3
60982,443,39893,443,allow,18274,7660,10614,46,48,26,20
64614,53,45879,53,allow,616,188,428,6,35,3,3
56748,80,11482,80,allow,946,531,415,11,296,6,5
52158,3841,53385,3841,allow,70,70,0,1,5,1,0
40244,443,63008,443,allow,21525,15159,6366,43,315,25,18
55275,445,0,0,drop,70,70,0,1,0,1,0
28679,3389,28679,3389,allow,3910,1805,2105,20,19,12,8
80,9918,0,0,deny,60,60,0,1,0,1,0
56785,28902,26302,28902,allow,66,66,0,1,5,1,0
56254,80,61838,80,allow,1196,682,514,12,15,6,6
48203,80,21963,80,allow,946,531,415,11,315,6,5
56717,53,57782,53,allow,183,94,89,2,29,1,1
61810,443,52096,443,allow,3109,812,2297,13,136,6,7
55594,445,0,0,drop,66,66,0,1,0,1,0
60498,55100,54000,55100,allow,164,70,94,2,5,1,1
39296,80,42810,80,allow,740,452,288,11,17,7,4
39017,443,58610,443,allow,5176,861,4315,16,26,9,7
49970,445,0,0,drop,66,66,0,1,0,1,0
54454,5222,49306,5222,allow,9568,1982,7586,44,345,17,27
56658,53,20785,53,allow,177,94,83,2,29,1,1
55727,53,47747,53,allow,701,88,613,2,31,1,1
63061,443,64217,443,allow,304,86,218,2,30,1,1
48817,51413,48817,51413,allow,479,152,327,2,1200,1,1
49793,445,0,0,drop,70,70,0,1,0,1,0
56571,53,42202,53,allow,325,102,223,2,30,1,1
58638,5900,0,0,deny,62,62,0,1,0,1,0
443,35385,0,0,deny,130,130,0,1,0,1,0
57096,53,45247,53,allow,198,102,96,2,30,1,1
56703,50584,0,0,deny,66,66,0,1,0,1,0
54199,443,3753,443,allow,26903,3579,23324,72,278,33,39
41429,50584,0,0,deny,66,66,0,1,0,1,0
56929,53,5055,53,allow,170,87,83,2,30,1,1
64586,50584,0,0,deny,62,62,0,1,0,1,0
56652,80,44398,80,allow,9012,4718,4294,43,81,21,22
43584,24748,0,0,deny,156,156,0,1,0,1,0
50470,61463,0,0,deny,86,86,0,1,0,1,0
64159,445,0,0,drop,70,70,0,1,0,1,0
43405,443,52895,443,allow,5977,1326,4651,18,30,11,7
57750,37965,0,0,deny,146,146,0,1,0,1,0
49543,80,13855,80,allow,1548,847,701,10,15,5,5
51797,30712,39713,30712,allow,70,70,0,2,8,2,0
62347,25,62347,25,deny,291,126,165,4,0,2,2
64049,53,41804,53,allow,209,102,107,2,30,1,1
63109,445,0,0,drop,70,70,0,1,0,1,0
61805,445,0,0,drop,70,70,0,1,0,1,0
56544,53,54094,53,allow,224,102,122,2,30,1,1
37222,443,49931,443,allow,2394,1365,1029,18,275,9,9
60150,443,32146,443,allow,7741,2692,5049,24,16,13,11
53634,445,0,0,drop,70,70,0,1,0,1,0
47141,50584,0,0,deny,62,62,0,1,0,1,0
55404,53,28730,53,allow,711,87,624,2,30,1,1
56754,53,42272,53,allow,209,110,99,2,30,1,1
52146,445,0,0,drop,66,66,0,1,0,1,0
55773,53,28630,53,allow,102,102,0,1,60,1,0
49839,443,44506,443,allow,7021,1767,5254,26,224,13,13
62880,53,59831,53,allow,248,78,170,2,30,1,1
50908,445,0,0,drop,70,70,0,1,0,1,0
38611,443,14308,443,allow,22215289,662818,21552471,25924,349,8862,17062
65526,53,17062,53,allow,198,101,97,2,31,1,1
57352,53,7772,53,allow,196,102,94,2,29,1,1
33067,53,0,0,allow,86,86,0,1,30,1,0
49667,53,65184,53,allow,448,184,264,6,30,3,3
43523,53,26419,53,allow,168,78,90,2,30,1,1
26865,443,22998,443,allow,21239,16302,4937,35,20,20,15
55337,53,28465,53,allow,196,100,96,2,30,1,1
54200,445,0,0,drop,70,70,0,1,0,1,0
57395,53,40276,53,allow,262,88,174,4,58,2,2
6666,21,6666,21,allow,66,66,0,1,5,1,0
64180,445,0,0,drop,70,70,0,1,0,1,0
59343,80,59343,80,allow,32527,13068,19459,56,15,21,35
47463,53,25330,53,allow,167,78,89,2,30,1,1
58223,445,0,0,drop,70,70,0,1,0,1,0
24589,10197,0,0,deny,145,145,0,1,0,1,0
64605,25174,0,0,deny,66,66,0,1,0,1,0
53730,445,0,0,drop,70,70,0,1,0,1,0
53975,443,8391,443,allow,9782,1996,7786,30,31,14,16
8389,80,8389,80,allow,1700,1073,627,15,84,8,7
55348,53,40546,53,allow,184,80,104,2,30,1,1
55346,53,11251,53,allow,396,102,294,2,30,1,1
57790,445,0,0,drop,70,70,0,1,0,1,0
61881,48817,0,0,deny,148,148,0,1,0,1,0
48551,443,15020,443,allow,7433,2086,5347,26,316,12,14
57183,53,6659,53,allow,178,94,84,2,31,1,1
56525,443,51595,443,allow,14108,2487,11621,32,81,18,14
41953,443,3719,443,allow,4129,2865,1264,17,361,9,8
50381,443,49531,443,allow,316,136,180,6,6,3,3
49420,445,0,0,drop,70,70,0,1,0,1,0
49359,53,57768,53,allow,102,102,0,1,60,1,0
55337,443,55337,443,allow,7710,3932,3778,23,18,14,9
56490,443,32124,443,allow,163763,5320,158443,178,120,60,118
40322,23,0,0,deny,60,60,0,1,0,1,0
55294,53,35326,53,allow,199,102,97,2,30,1,1
63800,80,60637,80,allow,314,192,122,6,15,4,2
52788,443,17904,443,allow,21915,3929,17986,40,31,23,17
64980,53,10354,53,allow,200,102,98,2,29,1,1
53513,56205,0,0,deny,62,62,0,1,0,1,0
65085,53,45076,53,allow,258,102,156,2,30,1,1
63509,445,0,0,drop,70,70,0,1,0,1,0
57665,52700,0,0,deny,66,66,0,1,0,1,0
55234,53,22160,53,allow,177,94,83,2,30,1,1
49341,80,65147,80,allow,1969,463,1506,13,55,7,6
50357,445,0,0,drop,70,70,0,1,0,1,0
38053,50584,0,0,deny,146,146,0,1,0,1,0
50433,80,24726,80,allow,318,192,126,6,26,4,2
55726,445,0,0,drop,70,70,0,1,0,1,0
58782,445,0,0,drop,70,70,0,1,0,1,0
64106,53,27158,53,allow,195,102,93,2,31,1,1
49537,53,59309,53,allow,269,96,173,4,59,2,2
58638,5900,0,0,deny,62,62,0,1,0,1,0
58519,445,0,0,drop,66,66,0,1,0,1,0
64055,53,9885,53,allow,265,91,174,4,37,2,2
64403,53,16361,53,allow,783,197,586,6,70,3,3
50453,80,44692,80,allow,5978,3592,2386,15,34,8,7
55406,25174,0,0,deny,66,66,0,1,0,1,0
50386,22114,0,0,deny,66,66,0,1,0,1,0
64816,53,1997,53,allow,164,84,80,2,31,1,1
57801,445,0,0,drop,70,70,0,1,0,1,0
8976,44847,0,0,deny,66,66,0,1,0,1,0
62197,445,0,0,drop,70,70,0,1,0,1,0
64629,445,0,0,drop,66,66,0,1,0,1,0
52095,48896,29371,48896,allow,66,66,0,1,5,1,0
52563,17235,0,0,deny,70,70,0,1,0,1,0
50584,16526,25996,16526,allow,166,166,0,1,1199,1,0
50637,80,36749,80,allow,175050,8089,166961,167,48,48,119
60735,445,0,0,drop,70,70,0,1,0,1,0
50708,22114,0,0,deny,62,62,0,1,0,1,0
55043,57470,0,0,deny,78,78,0,1,0,1,0
55543,445,0,0,drop,70,70,0,1,0,1,0
51104,445,0,0,drop,70,70,0,1,0,1,0
60294,80,59530,80,allow,1463,865,598,11,144,6,5
50174,445,0,0,drop,70,70,0,1,0,1,0
56336,53,12124,53,allow,196,102,94,2,30,1,1
57209,53,54053,53,allow,764,99,665,2,30,1,1
56724,53,52473,53,allow,195,102,93,2,30,1,1
1925,53,9734,53,allow,210,78,132,2,30,1,1
52070,80,7371,80,allow,362,240,122,7,25,5,2
64639,53,46471,53,allow,199,102,97,2,30,1,1
35955,5228,64424,5228,allow,6776,1542,5234,21,3600,12,9
58865,445,0,0,drop,70,70,0,1,0,1,0
52876,445,0,0,drop,70,70,0,1,0,1,0
2938,64147,0,0,deny,62,62,0,1,0,1,0
59731,443,62257,443,allow,7236,827,6409,17,25,8,9
55336,53,49932,53,allow,199,102,97,2,30,1,1
56351,53,4846,53,allow,195,102,93,2,32,1,1
56448,53,7304,53,allow,200,102,98,2,30,1,1
64937,53,12503,53,allow,210,110,100,2,30,1,1
55531,445,0,0,drop,70,70,0,1,0,1,0
17289,25174,0,0,deny,146,146,0,1,0,1,0
65200,53,5141,53,allow,214,110,104,2,30,1,1
50772,445,0,0,drop,70,70,0,1,0,1,0
45908,3383,0,0,deny,60,60,0,1,0,1,0
63352,445,0,0,drop,70,70,0,1,0,1,0
35978,443,55185,443,allow,2959,793,2166,10,120,5,5
59016,445,0,0,drop,66,66,0,1,0,1,0
60248,30188,0,0,deny,62,62,0,1,0,1,0
59136,50584,0,0,deny,66,66,0,1,0,1,0
37613,443,61713,443,allow,10042,3117,6925,28,47,16,12
56938,8000,45584,8000,allow,110,110,0,1,30,1,0
53942,445,0,0,drop,66,66,0,1,0,1,0
37004,80,37004,80,allow,13825,1203,12622,22,29,9,13
30179,23,0,0,deny,60,60,0,1,0,1,0
51272,12210,15332,12210,allow,70,70,0,1,5,1,0
61388,445,0,0,drop,66,66,0,1,0,1,0
64091,443,50015,443,allow,3258,1197,2061,14,136,7,7
54930,445,0,0,drop,70,70,0,1,0,1,0
51723,445,0,0,drop,70,70,0,1,0,1,0
27005,27023,64597,27023,allow,875,126,749,2,31,1,1
55718,27025,19303,27025,allow,1778,1386,392,8,30,4,4
50027,21247,0,0,deny,66,66,0,1,0,1,0
55729,63805,38910,63805,allow,70,70,0,2,8,2,0
63978,53,35845,53,allow,214,110,104,2,30,1,1
52492,443,60482,443,allow,33131,9092,24039,41,15,19,22
61389,80,44525,80,allow,17407,1529,15878,30,255,16,14
64602,80,64602,80,allow,18594,5204,13390,42,26,25,17
61806,445,0,0,drop,66,66,0,1,0,1,0
48706,23393,0,0,deny,60,60,0,1,0,1,0
53958,80,11138,80,allow,130,70,60,2,15,1,1
51720,51388,49576,51388,allow,70,70,0,2,8,2,0
38712,443,31171,443,allow,382972,9177,373795,378,16,120,258
60241,80,52293,80,allow,29924,6743,23181,37,150,16,21
65206,53,37251,53,allow,193,102,91,2,30,1,1
56652,80,38597,80,allow,234,234,0,4,12,4,0
993,51747,0,0,deny,66,66,0,1,0,1,0
56788,53,1582,53,allow,199,102,97,2,30,1,1
50423,445,0,0,drop,70,70,0,1,0,1,0
56085,53,41627,53,allow,167,86,81,2,30,1,1
51130,80,19465,80,allow,366,240,126,7,21,5,2
60521,445,0,0,drop,66,66,0,1,0,1,0
31404,36841,0,0,deny,100,100,0,1,0,1,0
64046,18318,32519,18318,allow,3197,1526,1671,19,26,12,7
52208,47300,63479,47300,allow,70,70,0,1,5,1,0
57778,443,43252,443,allow,6182,3879,2303,53,3828,31,22
52932,443,63575,443,allow,13165,3626,9539,56,115,30,26
53278,445,0,0,drop,66,66,0,1,0,1,0
44318,51180,0,0,deny,74,74,0,1,0,1,0
51233,445,0,0,drop,70,70,0,1,0,1,0
62747,445,0,0,drop,70,70,0,1,0,1,0
50886,445,0,0,drop,66,66,0,1,0,1,0
0,0,0,0,allow,244,244,0,2,0,2,0
55037,443,53217,443,allow,13372,3722,9650,37,47,21,16
49791,53,47745,53,allow,226,94,132,2,30,1,1
65201,53,5254,53,allow,288,94,194,2,30,1,1
59068,443,48115,443,allow,11182,6150,5032,65,1775,41,24
50455,445,0,0,drop,70,70,0,1,0,1,0
53510,58706,37396,58706,allow,492,306,186,8,16,5,3
52183,443,6084,443,allow,10107,1324,8783,22,75,12,10
1044,23,0,0,deny,60,60,0,1,0,1,0
60018,64147,0,0,deny,62,62,0,1,0,1,0
52014,443,52014,443,allow,16507,6060,10447,32,49,16,16
37887,22114,0,0,deny,66,66,0,1,0,1,0
45926,443,11767,443,allow,9153,4216,4937,29,331,16,13
57038,53,5859,53,allow,186,102,84,2,31,1,1
11835,53,11835,53,allow,216,88,128,2,31,1,1
60806,51050,0,0,deny,66,66,0,1,0,1,0
58043,445,0,0,drop,66,66,0,1,0,1,0
1660,8696,0,0,deny,62,62,0,1,0,1,0
53373,64147,0,0,deny,66,66,0,1,0,1,0
63885,6969,1755,6969,allow,66,66,0,2,8,2,0
36172,443,19620,443,allow,6295,1324,4971,22,983,10,12
50043,443,32430,443,allow,6551,2085,4466,25,85,14,11
59965,36237,0,0,deny,62,62,0,1,0,1,0
63092,46776,0,0,deny,78,78,0,1,0,1,0
58638,5900,58638,5900,allow,126,62,64,2,5,1,1
46734,50265,0,0,deny,74,74,0,1,0,1,0
58094,53,1806,53,allow,249,102,147,2,29,1,1
57325,37965,0,0,deny,62,62,0,1,0,1,0
50892,443,40533,443,allow,8057,1135,6922,19,129,9,10
65444,445,0,0,drop,70,70,0,1,0,1,0
56478,80,51578,80,allow,73400,4542,68858,87,136,37,50
36255,53,36255,53,allow,197,90,107,2,30,1,1
53544,22051,5953,22051,allow,70,70,0,2,7,2,0
60114,443,25008,443,allow,268,120,148,5,10,3,2
24037,53415,0,0,deny,76,76,0,1,0,1,0
57264,53,53973,53,allow,197,102,95,2,30,1,1
49742,53,9539,53,allow,213,102,111,2,29,1,1
54184,445,0,0,drop,70,70,0,1,0,1,0
40476,443,53143,443,allow,17360,5578,11782,71,281,39,32
57893,445,0,0,drop,70,70,0,1,0,1,0
61195,56205,0,0,deny,66,66,0,1,0,1,0
63867,35993,0,0,deny,66,66,0,1,0,1,0
58878,443,22672,443,allow,25575,16682,8893,57,21,31,26
58091,51505,0,0,deny,62,62,0,1,0,1,0
57669,445,0,0,drop,70,70,0,1,0,1,0
56484,443,2923,443,allow,1857,1218,639,18,135,11,7
54373,26467,0,0,deny,62,62,0,1,0,1,0
51104,443,47911,443,allow,5220,3063,2157,14,135,7,7
51052,445,0,0,drop,70,70,0,1,0,1,0
38599,443,40890,443,allow,3605,1648,1957,20,255,10,10
56723,53,3556,53,allow,198,94,104,2,30,1,1
0,0,0,0,allow,244,244,0,2,0,2,0
54063,445,0,0,drop,70,70,0,1,0,1,0
51103,445,0,0,drop,70,70,0,1,0,1,0
49910,445,0,0,drop,66,66,0,1,0,1,0
58247,57866,0,0,deny,66,66,0,1,0,1,0
38337,443,4269,443,allow,499,425,74,4,1,3,1
56759,53,42507,53,allow,338,118,220,2,30,1,1
48757,443,52585,443,allow,6353,1075,5278,18,33,10,8
57352,53,29825,53,allow,196,102,94,2,31,1,1
50616,443,60964,443,allow,8643,1918,6725,21,26,11,10
62913,445,0,0,drop,70,70,0,1,0,1,0
57396,53,6439,53,allow,183,94,89,2,30,1,1
51997,445,0,0,drop,66,66,0,1,0,1,0
52193,443,39804,443,allow,8868,4111,4757,24,16,12,12
61491,445,0,0,drop,70,70,0,1,0,1,0
57470,1024,34451,1024,allow,132,132,0,3,1200,3,0
50674,445,0,0,drop,66,66,0,1,0,1,0
42298,40031,50162,40031,allow,1341,657,684,8,30,4,4
52540,443,62112,443,allow,153,93,60,2,5,1,1
63953,445,0,0,drop,66,66,0,1,0,1,0
49332,53,50877,53,allow,281,98,183,4,57,2,2
50630,443,47610,443,allow,5013,968,4045,20,87,11,9
56170,53,28854,53,allow,196,100,96,2,30,1,1
55172,445,0,0,drop,70,70,0,1,0,1,0
11983,57470,0,0,deny,62,62,0,1,0,1,0
56999,80,32577,80,allow,214,140,74,4,35,3,1
53524,445,0,0,drop,70,70,0,1,0,1,0
55837,53,32132,53,allow,195,102,93,2,30,1,1
50584,21094,39450,21094,allow,1356,300,1056,6,1200,3,3
65335,53,50606,53,allow,216,102,114,2,30,1,1
40940,443,13530,443,allow,12685,7319,5366,36,398,15,21
6881,55108,0,0,deny,148,148,0,1,0,1,0
60787,40010,15005,40010,allow,316,136,180,6,6,3,3
33931,50584,0,0,deny,62,62,0,1,0,1,0
50470,61463,0,0,deny,86,86,0,1,0,1,0
23331,25174,0,0,deny,66,66,0,1,0,1,0
53388,445,0,0,drop,66,66,0,1,0,1,0
54471,36237,0,0,deny,66,66,0,1,0,1,0
38683,17,0,0,deny,60,60,0,1,0,1,0
56665,53,14967,53,allow,223,86,137,2,30,1,1
25179,62609,0,0,deny,148,148,0,1,0,1,0
55358,445,0,0,drop,66,66,0,1,0,1,0
49688,445,0,0,drop,70,70,0,1,0,1,0
63743,25174,0,0,deny,62,62,0,1,0,1,0
55712,53,52427,53,allow,164,86,78,2,29,1,1
63066,445,0,0,drop,66,66,0,1,0,1,0
14208,51221,0,0,deny,66,66,0,1,0,1,0
51185,37965,0,0,deny,66,66,0,1,0,1,0
50886,80,22505,80,allow,312952,13869,299083,347,141,138,209
64607,53,1706,53,allow,211,110,101,2,30,1,1
50002,53,25520,53,allow,196,102,94,2,30,1,1
57043,53,5336,53,allow,166,86,80,2,31,1,1
57341,53,29078,53,allow,184,94,90,2,31,1,1
6943,57099,0,0,deny,100,100,0,1,0,1,0
50949,445,0,0,drop,70,70,0,1,0,1,0
63809,45193,55077,45193,allow,66,66,0,1,5,1,0
62911,36237,0,0,deny,62,62,0,1,0,1,0
55466,445,0,0,drop,70,70,0,1,0,1,0
56634,80,24022,80,allow,234,234,0,4,12,4,0
64335,35440,0,0,deny,62,62,0,1,0,1,0
59966,37965,0,0,deny,66,66,0,1,0,1,0
46837,57470,0,0,deny,62,62,0,1,0,1,0
55367,53,25329,53,allow,215,102,113,2,30,1,1
55288,445,0,0,drop,66,66,0,1,0,1,0
65317,51221,0,0,deny,78,78,0,1,0,1,0
37965,54777,17164,54777,allow,158,158,0,1,1200,1,0
55362,53,21893,53,allow,195,102,93,2,29,1,1
26531,37965,0,0,deny,62,62,0,1,0,1,0
55897,53,59750,53,allow,733,85,648,2,30,1,1
64904,445,0,0,drop,70,70,0,1,0,1,0
50589,443,28626,443,allow,10257,6305,3952,31,134,19,12
37886,443,62818,443,allow,134,60,74,3,5,2,1
0,0,0,0,deny,140,140,0,2,0,2,0
56445,53,26251,53,allow,199,102,97,2,30,1,1
27005,27018,3011,27018,allow,882,126,756,2,30,1,1
6889,8970,0,0,reset-both,143,143,0,1,0,1,0
11295,40002,59394,40002,allow,209,85,124,4,34,2,2
26391,44847,0,0,deny,146,146,0,1,0,1,0
53160,25174,0,0,deny,146,146,0,1,0,1,0
37429,25174,0,0,deny,62,62,0,1,0,1,0
52486,443,26318,443,allow,57366,41661,15705,111,440,66,45
12632,25174,0,0,deny,62,62,0,1,0,1,0
44821,64147,0,0,deny,62,62,0,1,0,1,0
9748,21247,0,0,deny,66,66,0,1,0,1,0
65482,53,43448,53,allow,179,94,85,2,30,1,1
60480,57470,0,0,deny,62,62,0,1,0,1,0
52480,445,0,0,drop,70,70,0,1,0,1,0
58839,443,29041,443,allow,6270,4231,2039,22,16,11,11
4447,35440,0,0,deny,66,66,0,1,0,1,0
30500,26296,0,0,deny,159,159,0,1,0,1,0
59475,445,0,0,drop,66,66,0,1,0,1,0
60524,443,60524,443,allow,1088,641,447,10,26,6,4
51691,5543,12224,5543,allow,70,70,0,1,5,1,0
62869,445,0,0,drop,66,66,0,1,0,1,0
50503,443,63118,443,allow,5987,1085,4902,15,25,8,7
60022,443,9132,443,allow,6906,1458,5448,24,16,14,10
50592,445,0,0,drop,70,70,0,1,0,1,0
6712,123,0,0,deny,90,90,0,1,0,1,0
55106,53,55106,53,allow,200,90,110,2,30,1,1
53971,18810,57788,18810,allow,70,70,0,1,5,1,0
53352,445,0,0,drop,66,66,0,1,0,1,0
50584,13560,50803,13560,allow,166,166,0,1,1200,1,0
54550,443,8260,443,allow,3296,1329,1967,14,135,7,7
21604,50201,0,0,deny,66,66,0,1,0,1,0
63460,443,27370,443,allow,502,250,252,9,63,5,4
59868,443,9732,443,allow,6869,3351,3518,22,135,11,11
34073,37965,0,0,deny,62,62,0,1,0,1,0
64334,25174,0,0,deny,66,66,0,1,0,1,0
49182,21247,0,0,deny,62,62,0,1,0,1,0
50069,53,27415,53,allow,179,94,85,2,30,1,1
61828,443,31671,443,allow,7490,2688,4802,23,383,10,13
47398,7302,0,0,deny,62,62,0,1,0,1,0
56390,445,0,0,drop,70,70,0,1,0,1,0
50092,445,0,0,drop,70,70,0,1,0,1,0
11562,30188,0,0,deny,62,62,0,1,0,1,0
63963,50584,0,0,deny,66,66,0,1,0,1,0
63956,38211,0,0,deny,62,62,0,1,0,1,0
1773,11392,0,0,deny,62,62,0,1,0,1,0
50552,53,38940,53,allow,164,78,86,2,30,1,1
38852,37965,0,0,deny,62,62,0,1,0,1,0
11458,2767,0,0,deny,66,66,0,1,0,1,0
55293,53,52510,53,allow,230,110,120,2,30,1,1
55160,445,0,0,drop,70,70,0,1,0,1,0
56322,53,19434,53,allow,166,86,80,2,30,1,1
2001,80,2001,80,allow,1535,652,883,9,16,5,4
62338,50011,0,0,deny,62,62,0,1,0,1,0
51655,445,0,0,drop,70,70,0,1,0,1,0
61100,80,15206,80,allow,1516,481,1035,11,15,6,5
49823,53,8034,53,allow,209,110,99,2,29,1,1
57546,25174,0,0,deny,66,66,0,1,0,1,0
60340,443,5002,443,allow,6844,2441,4403,19,181,9,10
55111,39004,0,0,deny,66,66,0,1,0,1,0
62065,443,18237,443,allow,21959,8954,13005,65,63,33,32
51840,34678,2661,34678,allow,70,70,0,2,8,2,0
443,18177,0,0,deny,66,66,0,1,0,1,0
60303,445,0,0,drop,70,70,0,1,0,1,0
42378,443,63662,443,allow,1970,1231,739,14,30,8,6
49928,443,22562,443,allow,9330,2410,6920,25,81,13,12
57309,53,6657,53,allow,197,102,95,2,29,1,1
53895,53,0,0,allow,86,86,0,1,29,1,0
27005,27015,55058,27015,allow,1666,126,1540,4,31,2,2
3986,17372,0,0,deny,66,66,0,1,0,1,0
50175,53,55281,53,allow,196,102,94,2,30,1,1
57575,443,57575,443,allow,206737,25710,181027,212,180,75,137
56266,53,11208,53,allow,193,102,91,2,30,1,1
57325,60043,0,0,deny,66,66,0,1,0,1,0
50299,53,31351,53,allow,770,102,668,2,30,1,1
13970,42873,0,0,deny,62,62,0,1,0,1,0
57275,53,57275,53,allow,217,86,131,2,30,1,1
53906,12051,34312,12051,allow,258,70,188,4,9,2,2
49418,52013,5997,52013,allow,257,71,186,2,30,1,1
57077,53,61276,53,allow,166,86,80,2,30,1,1
53797,443,48154,443,allow,499,425,74,4,0,3,1
48079,43227,0,0,deny,66,66,0,1,0,1,0
53825,443,49613,443,allow,499,425,74,4,0,3,1
64940,445,0,0,drop,66,66,0,1,0,1,0
59350,445,0,0,drop,70,70,0,1,0,1,0
53256,5900,0,0,deny,60,60,0,1,0,1,0
59398,443,65413,443,allow,3730,1956,1774,16,15,8,8
56484,53,39719,53,allow,214,110,104,2,30,1,1
57515,445,0,0,drop,70,70,0,1,0,1,0
33882,80,63489,80,allow,1454,866,588,11,58,7,4
42820,443,40301,443,allow,20255,5440,14815,32,122,16,16
57458,445,0,0,drop,66,66,0,1,0,1,0
58151,445,0,0,drop,70,70,0,1,0,1,0
63816,2073,59297,2073,allow,70,70,0,1,4,1,0
49881,80,7229,80,allow,1965,1450,515,7,87,5,2
57470,2710,46091,2710,allow,124,124,0,3,1199,3,0
65484,443,29745,443,allow,148284,6200,142084,165,16,63,102
80,9918,0,0,deny,60,60,0,1,0,1,0
49218,443,48762,443,allow,8929,3316,5613,38,255,18,20
54522,443,63026,443,allow,4728282,133897,4594385,4756,80,1650,3106
58374,445,0,0,drop,66,66,0,1,0,1,0
55132,53,34901,53,allow,889,404,485,10,30,5,5
55474,80,42098,80,allow,25970,2371,23599,52,17,26,26
52045,445,0,0,drop,70,70,0,1,0,1,0
52153,80,26645,80,allow,366,240,126,7,32,5,2
60303,443,45517,443,allow,7914400,166459,7747941,6839,775,1138,5701
52013,80,47338,80,allow,27271,12050,15221,45,38,24,21
61286,443,11751,443,allow,8970,5359,3611,22,121,11,11
18061,25174,0,0,deny,62,62,0,1,0,1,0
49701,53,55177,53,allow,197,102,95,2,30,1,1
51743,40358,22101,40358,allow,136,136,0,3,14,3,0
53240,443,55808,443,allow,14932,1671,13261,31,69,15,16
53782,42855,3816,42855,allow,70,70,0,1,5,1,0
65312,53,47796,53,allow,180,92,88,2,30,1,1
44612,25174,0,0,deny,66,66,0,1,0,1,0
11136,17500,0,0,deny,62,62,0,1,0,1,0
45590,53,0,0,allow,82,82,0,1,31,1,0
55453,443,3812,443,allow,3015948,160028,2855920,3852,218,1499,2353
59247,53,59247,53,allow,825,99,726,2,31,1,1
53459,37807,0,0,deny,146,146,0,1,0,1,0
50278,53,13442,53,allow,196,102,94,2,31,1,1
56038,53,12140,53,allow,177,94,83,2,30,1,1
37116,80,37116,80,allow,2971,1509,1462,10,15,6,4
64888,53,40321,53,allow,767,102,665,2,30,1,1
52830,443,59305,443,allow,12577,3687,8890,63,415,30,33
65463,445,0,0,drop,66,66,0,1,0,1,0
46991,443,46408,443,allow,2809,1884,925,19,26,11,8
52925,3389,0,0,deny,60,60,0,1,0,1,0
53612,1032,47132,1032,allow,130,70,60,3,5,2,1
58794,443,62373,443,allow,5166,700,4466,16,15,7,9
53526,445,0,0,drop,66,66,0,1,0,1,0
41348,53,0,0,allow,86,86,0,1,30,1,0
53214,445,0,0,drop,70,70,0,1,0,1,0
49428,53,34747,53,allow,267,94,173,2,31,1,1
49268,53,9594,53,allow,200,94,106,2,30,1,1
56020,53,56318,53,allow,168,86,82,2,29,1,1
21716,443,21716,443,allow,10913,762,10151,17,19,7,10
60108,443,32347,443,allow,9091,2988,6103,47,19,22,25
64240,50584,0,0,deny,62,62,0,1,0,1,0
64367,443,64367,443,allow,4347,1440,2907,19,26,11,8
23126,35440,0,0,deny,66,66,0,1,0,1,0
26782,443,49572,443,allow,7407,2650,4757,24,20,12,12
64955,443,38956,443,allow,2279,1129,1150,25,120,12,13
50486,445,0,0,drop,66,66,0,1,0,1,0
57033,53,60387,53,allow,754,94,660,2,31,1,1
63898,13205,16525,13205,allow,66,66,0,2,7,2,0
41821,80,46291,80,allow,1056,362,694,10,49,6,4
55741,445,0,0,drop,66,66,0,1,0,1,0
19626,3389,19626,3389,reset-both,293,223,70,4,0,3,1
44586,443,61467,443,allow,122708,5797,116911,169,132,75,94
50566,443,4143,443,allow,2064,1287,777,16,139,9,7
49418,27016,42028,27016,allow,246,71,175,2,30,1,1
51273,445,0,0,drop,66,66,0,1,0,1,0
58872,443,35466,443,allow,5166,700,4466,16,15,7,9
51396,56205,0,0,deny,66,66,0,1,0,1,0
55690,53,21416,53,allow,183,94,89,2,29,1,1
49655,80,40166,80,allow,499,192,307,6,42,4,2
56388,443,22343,443,allow,11093,2322,8771,40,17,23,17
50561,80,50561,80,allow,1695,995,700,11,21,6,5
50127,445,0,0,drop,66,66,0,1,0,1,0
65384,53,41711,53,allow,197,102,95,2,30,1,1
50130,53,10528,53,allow,183,94,89,2,30,1,1
56805,1,17140,1,allow,70,70,0,1,5,1,0
65361,53,5566,53,allow,764,102,662,2,30,1,1
4431,32480,0,0,deny,66,66,0,1,0,1,0
54435,443,54824,443,allow,18802,3386,15416,54,293,28,26
55660,53,60167,53,allow,177,94,83,2,30,1,1
64217,445,0,0,drop,70,70,0,1,0,1,0
64677,53,37767,53,allow,182,93,89,2,31,1,1
49172,445,0,0,drop,70,70,0,1,0,1,0
61273,445,0,0,drop,70,70,0,1,0,1,0
37661,53,37661,53,allow,237,91,146,2,32,1,1
50815,445,0,0,drop,70,70,0,1,0,1,0
63010,53,14322,53,allow,304,86,218,2,29,1,1
51308,445,0,0,drop,70,70,0,1,0,1,0
38223,443,38223,443,allow,4782,1875,2907,19,29,11,8
51607,445,0,0,drop,70,70,0,1,0,1,0
61019,445,0,0,drop,66,66,0,1,0,1,0
58461,443,33796,443,allow,6100,1233,4867,21,17,11,10
50116,22,0,0,deny,60,60,0,1,0,1,0
61875,445,0,0,drop,66,66,0,1,0,1,0
64820,53,5211,53,allow,195,102,93,2,29,1,1
50438,80,13874,80,allow,314,192,122,6,26,4,2
56703,50584,0,0,deny,62,62,0,1,0,1,0
64825,445,0,0,drop,70,70,0,1,0,1,0
51913,52188,58050,52188,allow,66,66,0,1,5,1,0
49483,7000,49483,7000,allow,755531,16955,738576,785,16,265,520
58174,445,0,0,drop,66,66,0,1,0,1,0
56291,53,26927,53,allow,177,94,83,2,31,1,1
56334,53,55727,53,allow,170,87,83,2,30,1,1
42522,80,42522,80,allow,29727,1571,28156,44,16,21,23
50617,80,45162,80,allow,1658,1247,411,8,14,5,3
58401,445,0,0,drop,70,70,0,1,0,1,0
64013,57470,0,0,deny,74,74,0,1,0,1,0
42951,22114,0,0,deny,62,62,0,1,0,1,0
52900,445,0,0,drop,70,70,0,1,0,1,0
61370,445,0,0,drop,70,70,0,1,0,1,0
34400,39004,0,0,deny,74,74,0,1,0,1,0
59626,22114,0,0,deny,66,66,0,1,0,1,0
51093,57470,0,0,deny,66,66,0,1,0,1,0
36306,80,36306,80,allow,1917,1468,449,10,20,6,4
52328,445,0,0,drop,70,70,0,1,0,1,0
54629,445,0,0,drop,70,70,0,1,0,1,0
54387,445,0,0,drop,70,70,0,1,0,1,0
56185,53,24061,53,allow,168,86,82,2,31,1,1
53824,443,33513,443,allow,499,425,74,4,0,3,1
51160,445,0,0,drop,70,70,0,1,0,1,0
53591,445,0,0,drop,70,70,0,1,0,1,0
64684,53,19854,53,allow,184,94,90,2,31,1,1
52872,443,5601,443,allow,110507,3940,106567,129,118,37,92
56920,445,0,0,drop,70,70,0,1,0,1,0
58431,443,11477,443,allow,5771,3201,2570,22,161,10,12
56786,443,61415,443,allow,238132,13988,224144,317,32,161,156
52112,22114,0,0,deny,66,66,0,1,0,1,0
55525,445,0,0,drop,70,70,0,1,0,1,0
65196,53,20787,53,allow,164,86,78,2,30,1,1
57005,80,30107,80,allow,214,140,74,4,30,3,1
57307,53,5441,53,allow,177,94,83,2,30,1,1
49227,445,0,0,drop,70,70,0,1,0,1,0
54624,445,0,0,drop,70,70,0,1,0,1,0
56538,443,26463,443,allow,8490,2953,5537,27,569,15,12
58316,445,0,0,drop,70,70,0,1,0,1,0
64859,53,38916,53,allow,385,134,251,2,30,1,1
57511,445,0,0,drop,70,70,0,1,0,1,0
50176,53,47477,53,allow,768,99,669,2,31,1,1
57283,64147,0,0,deny,66,66,0,1,0,1,0
2522,64147,0,0,deny,62,62,0,1,0,1,0
50572,445,0,0,drop,70,70,0,1,0,1,0
65515,445,0,0,drop,66,66,0,1,0,1,0
50536,80,24703,80,allow,24166,3105,21061,31,24,12,19
56356,53,2062,53,allow,758,96,662,2,31,1,1
58377,445,0,0,drop,66,66,0,1,0,1,0
42166,443,27279,443,allow,4057,966,3091,14,31,8,6
56648,445,0,0,drop,66,66,0,1,0,1,0
53928,15503,0,0,deny,62,62,0,1,0,1,0
60014,445,0,0,drop,70,70,0,1,0,1,0
57539,445,0,0,drop,66,66,0,1,0,1,0
0,0,0,0,deny,70,70,0,1,0,1,0
42973,57470,0,0,deny,62,62,0,1,0,1,0
52837,445,0,0,drop,66,66,0,1,0,1,0
3524,25174,0,0,deny,66,66,0,1,0,1,0
57898,445,0,0,drop,66,66,0,1,0,1,0
50042,53,35274,53,allow,738,86,652,2,29,1,1
59732,53,64408,53,allow,384,166,218,2,30,1,1
6057,51221,0,0,deny,78,78,0,1,0,1,0
55123,64097,0,0,deny,66,66,0,1,0,1,0
58986,443,33028,443,allow,2894,1653,1241,24,26,12,12
42465,443,2367,443,allow,4885,895,3990,16,29,9,7
9300,443,62109,443,allow,4216,771,3445,16,26,9,7
62859,35440,0,0,deny,66,66,0,1,0,1,0
49210,53,33969,53,allow,410,93,317,4,30,2,2
64092,14447,3904,14447,allow,66,66,0,2,8,2,0
53855,443,61273,443,allow,134631,7253,127378,176,171,79,97
50018,445,0,0,drop,66,66,0,1,0,1,0
55010,443,19028,443,allow,7651,2261,5390,41,255,21,20
65079,53,34794,53,allow,272,94,178,2,30,1,1
57471,62413,0,0,deny,66,66,0,1,0,1,0
50883,80,64742,80,allow,204646,11741,192905,240,141,104,136
50386,22114,0,0,deny,62,62,0,1,0,1,0
52030,43068,29971,43068,allow,66,66,0,1,5,1,0
60564,445,0,0,drop,66,66,0,1,0,1,0
8999,57470,0,0,deny,146,146,0,1,0,1,0
50675,80,44462,80,allow,1658,1247,411,8,15,5,3
50407,445,0,0,drop,66,66,0,1,0,1,0
61304,443,62811,443,allow,8594,1042,7552,16,120,7,9
55747,53,24250,53,allow,258,102,156,2,30,1,1
64240,445,0,0,drop,70,70,0,1,0,1,0
56206,445,0,0,drop,70,70,0,1,0,1,0
56924,53,48740,53,allow,216,110,106,2,30,1,1
55610,23383,13424,23383,allow,70,70,0,1,5,1,0
59543,445,0,0,drop,70,70,0,1,0,1,0
55302,445,0,0,drop,70,70,0,1,0,1,0
38694,443,56498,443,allow,90289,3481,86808,96,16,31,65
58646,445,0,0,drop,70,70,0,1,0,1,0
63500,445,0,0,drop,66,66,0,1,0,1,0
64385,443,4632,443,allow,3677,1168,2509,17,120,8,9
46108,48817,0,0,deny,145,145,0,1,0,1,0
44307,443,62796,443,allow,92044,19483,72561,147,186,55,92
55230,443,46201,443,allow,42376115,1180708,41195407,45399,148,13976,31423
43584,24748,0,0,deny,156,156,0,1,0,1,0
58638,5900,0,0,deny,62,62,0,1,0,1,0
51158,443,53566,443,allow,3155111,84086,3071025,3163,75,1072,2091
57170,445,0,0,drop,70,70,0,1,0,1,0
49929,53,22603,53,allow,214,110,104,2,29,1,1
12709,51505,0,0,deny,62,62,0,1,0,1,0
64473,53,39348,53,allow,184,94,90,2,31,1,1
52764,443,33185,443,allow,14001,2908,11093,35,150,18,17
56380,36829,0,0,deny,66,66,0,1,0,1,0
64985,53,53017,53,allow,196,102,94,2,30,1,1
49342,443,54046,443,allow,10075,6346,3729,48,84,25,23
42298,40020,48690,40020,allow,148,86,62,2,30,1,1
3584,25174,0,0,deny,62,62,0,1,0,1,0
50655,445,0,0,drop,70,70,0,1,0,1,0
6755,53,6755,53,allow,247,98,149,2,32,1,1
58638,5900,0,0,deny,62,62,0,1,0,1,0
45941,23388,0,0,deny,60,60,0,1,0,1,0
49752,50584,0,0,deny,62,62,0,1,0,1,0
62236,445,0,0,drop,70,70,0,1,0,1,0
60309,445,0,0,drop,66,66,0,1,0,1,0
63908,33945,27378,33945,allow,312,132,180,6,7,3,3
58665,445,0,0,drop,70,70,0,1,0,1,0
26929,443,8333,443,allow,7487,2728,4759,25,19,13,12
55147,53,22954,53,allow,184,94,90,2,30,1,1
55403,53,28747,53,allow,211,102,109,2,30,1,1
4793,50584,0,0,deny,62,62,0,1,0,1,0
22036,44847,0,0,deny,62,62,0,1,0,1,0
52607,443,23239,443,allow,2860,258,2602,9,121,4,5
64681,443,43290,443,allow,2924,653,2271,13,135,6,7
36548,80,36548,80,allow,514,246,268,9,76,5,4
61366,445,0,0,drop,70,70,0,1,0,1,0
56716,80,53461,80,allow,3742344,115431,3626913,3995,79,1382,2613
49546,53,57576,53,allow,208,106,102,2,31,1,1
65077,445,0,0,drop,70,70,0,1,0,1,0
52789,445,0,0,drop,66,66,0,1,0,1,0
56324,445,0,0,drop,66,66,0,1,0,1,0
60974,443,22731,443,allow,166465,9498,156967,220,72,100,120
62170,445,0,0,drop,70,70,0,1,0,1,0
53232,445,0,0,drop,70,70,0,1,0,1,0
53714,6882,37422,6882,allow,70,70,0,2,7,2,0
49528,53,13440,53,allow,177,94,83,2,30,1,1
57394,53,17167,53,allow,193,102,91,2,31,1,1
65221,445,0,0,drop,70,70,0,1,0,1,0
45657,443,4313,443,allow,2553,1355,1198,22,77,13,9
27078,25174,0,0,deny,146,146,0,1,0,1,0
40204,40038,53758,40038,allow,585,86,499,2,30,1,1
59859,443,59054,443,allow,27510,4470,23040,67,122,34,33
53686,8999,26730,8999,allow,70,70,0,1,4,1,0
56695,53,39577,53,allow,93,93,0,1,30,1,0
42674,22114,0,0,deny,62,62,0,1,0,1,0
57570,443,12758,443,allow,21267,5407,15860,36,361,17,19
48817,25636,48817,25636,allow,481,150,331,2,1200,1,1
24910,64147,0,0,deny,66,66,0,1,0,1,0
63996,443,19057,443,allow,122293139,3727246,118565893,125460,331,39649,85811
57911,445,0,0,drop,70,70,0,1,0,1,0
0,0,0,0,deny,98,98,0,1,0,1,0
59829,443,54560,443,allow,948180,35714,912466,1121,119,378,743
49173,27402,64212,27402,allow,70,70,0,1,5,1,0
54248,443,24435,443,allow,499,425,74,4,0,3,1
16221,50584,0,0,deny,62,62,0,1,0,1,0
57625,445,0,0,drop,66,66,0,1,0,1,0
56252,445,0,0,drop,66,66,0,1,0,1,0
49281,445,0,0,drop,66,66,0,1,0,1,0
35647,3389,35647,3389,allow,4575,2400,2175,20,18,11,9
63106,445,0,0,drop,70,70,0,1,0,1,0
64205,445,0,0,drop,70,70,0,1,0,1,0
65373,53,60314,53,allow,194,99,95,2,31,1,1
53495,37807,0,0,deny,66,66,0,1,0,1,0
59724,445,0,0,drop,70,70,0,1,0,1,0
58638,5900,0,0,deny,62,62,0,1,0,1,0
65011,53,20412,53,allow,183,94,89,2,29,1,1
54377,56205,0,0,deny,66,66,0,1,0,1,0
53640,25174,0,0,deny,66,66,0,1,0,1,0
56403,443,35663,443,allow,24745,1926,22819,39,170,18,21
65447,53,50068,53,allow,277,102,175,2,29,1,1
14489,25174,0,0,deny,62,62,0,1,0,1,0
54987,443,13107,443,allow,7502,2299,5203,37,18,21,16
59883,17637,0,0,deny,66,66,0,1,0,1,0
52640,64147,0,0,deny,62,62,0,1,0,1,0
49635,443,49110,443,allow,54634,6944,47690,99,47,47,52
35921,443,5709,443,allow,5207,1058,4149,21,150,12,9
56818,60043,0,0,deny,66,66,0,1,0,1,0
55564,53,55564,53,allow,215,88,127,2,30,1,1
45964,2225,0,0,deny,60,60,0,1,0,1,0
57432,53,25990,53,allow,193,102,91,2,30,1,1
36561,2767,0,0,deny,62,62,0,1,0,1,0
56602,53,29182,53,allow,197,102,95,2,30,1,1
7342,22114,0,0,deny,62,62,0,1,0,1,0
59345,445,0,0,drop,70,70,0,1,0,1,0
55817,53,47066,53,allow,177,94,83,2,30,1,1
53887,443,39424,443,allow,499,425,74,4,0,3,1
55656,53,7470,53,allow,214,110,104,2,30,1,1
55690,53,56846,53,allow,182,93,89,2,30,1,1
56703,22,0,0,deny,60,60,0,1,0,1,0
56942,53,10682,53,allow,177,94,83,2,31,1,1
43028,443,42197,443,allow,6748,1643,5105,26,138,14,12
58736,445,0,0,drop,70,70,0,1,0,1,0
56775,53,45440,53,allow,177,94,83,2,30,1,1
52150,39109,0,0,deny,66,66,0,1,0,1,0
9303,443,49206,443,allow,3616,429,3187,11,16,6,5
49532,53,28306,53,allow,730,102,628,2,31,1,1
50828,443,8189,443,allow,178483,7778,170705,219,218,90,129
65494,53,0,0,deny,88,88,0,1,0,1,0
50366,443,19959,443,allow,1755,986,769,13,25,8,5
54752,445,0,0,drop,70,70,0,1,0,1,0
37837,37965,0,0,deny,62,62,0,1,0,1,0
49183,53,43011,53,allow,592,198,394,6,78,3,3
50323,445,0,0,drop,70,70,0,1,0,1,0
50057,53,42578,53,allow,177,94,83,2,29,1,1
8229,22114,0,0,deny,66,66,0,1,0,1,0
11295,40040,53425,40040,allow,213,89,124,4,54,2,2
56706,443,32876,443,allow,8057,2037,6020,20,15,11,9
64681,445,0,0,drop,66,66,0,1,0,1,0
39537,80,22901,80,allow,903,482,421,10,360,5,5
48340,443,49643,443,allow,18198,13269,4929,47,324,20,27
53885,443,38826,443,allow,499,425,74,4,0,3,1
53972,443,53972,443,allow,4380,1473,2907,19,29,11,8
55415,53,34000,53,allow,182,93,89,2,31,1,1
55192,53,17598,53,allow,178,94,84,2,30,1,1
50460,53,9714,53,allow,751,95,656,2,30,1,1
13281,51050,0,0,deny,66,66,0,1,0,1,0
50357,443,38830,443,allow,1786,172,1614,7,121,3,4
64605,25174,0,0,deny,62,62,0,1,0,1,0
50195,53,23918,53,allow,199,102,97,2,30,1,1
51753,445,0,0,drop,70,70,0,1,0,1,0
44062,443,52650,443,allow,8998,1684,7314,24,170,12,12
51966,25174,0,0,deny,146,146,0,1,0,1,0
60246,445,0,0,drop,66,66,0,1,0,1,0
52078,80,58261,80,allow,366,240,126,7,25,5,2
52095,56079,0,0,deny,62,62,0,1,0,1,0
55654,443,49899,443,allow,186406,10415,175991,218,123,79,139
59851,80,45085,80,allow,307815,6418,301397,285,63,84,201
56630,445,0,0,drop,66,66,0,1,0,1,0
65513,53,25094,53,allow,178,94,84,2,30,1,1
58286,37965,0,0,deny,66,66,0,1,0,1,0
55100,53,52662,53,allow,438,94,344,2,29,1,1
56596,53,31650,53,allow,194,102,92,2,30,1,1
57727,443,62460,443,allow,54944,4374,50570,88,361,44,44
55432,443,59316,443,allow,256189,15094,241095,316,122,120,196
60909,443,5719,443,allow,5150,3651,1499,34,46,18,16
54978,53,3492,53,allow,198,94,104,2,30,1,1
63364,445,0,0,drop,70,70,0,1,0,1,0
27005,27050,14571,27050,allow,1684,126,1558,4,31,2,2
56661,53,2934,53,allow,288,93,195,4,32,2,2
64733,53,63976,53,allow,889,404,485,10,30,5,5
57236,443,34862,443,allow,2294,1126,1168,25,120,12,13
64620,53,50964,53,allow,166,86,80,2,30,1,1
6712,80,6712,80,allow,514,246,268,9,82,5,4
44847,6892,1040,6892,allow,279,161,118,3,1200,2,1
64936,445,0,0,drop,66,66,0,1,0,1,0
50280,53,20623,53,allow,916,86,830,2,31,1,1
56748,53,55168,53,allow,184,94,90,2,30,1,1
55278,445,0,0,drop,70,70,0,1,0,1,0
56240,53,50619,53,allow,748,95,653,2,30,1,1
1026,30188,0,0,deny,62,62,0,1,0,1,0
1067,51221,0,0,deny,145,145,0,1,0,1,0
50341,37965,0,0,deny,66,66,0,1,0,1,0
59605,445,0,0,drop,66,66,0,1,0,1,0
50469,443,45578,443,allow,19063941,342071,18721870,17124,384,4119,13005
58736,443,28275,443,allow,7978,1143,6835,19,26,9,10
58638,5900,0,0,deny,62,62,0,1,0,1,0
53769,443,28627,443,allow,499,425,74,4,0,3,1
52600,445,0,0,drop,66,66,0,1,0,1,0
53776,445,0,0,drop,70,70,0,1,0,1,0
59799,445,0,0,drop,70,70,0,1,0,1,0
64695,53,40312,53,allow,193,102,91,2,29,1,1
53133,445,0,0,drop,70,70,0,1,0,1,0
36453,443,24873,443,allow,7298,2661,4637,21,18,11,10
25565,62778,0,0,deny,60,60,0,1,0,1,0
62339,25174,0,0,deny,66,66,0,1,0,1,0
49878,445,0,0,drop,66,66,0,1,0,1,0
54485,445,0,0,drop,70,70,0,1,0,1,0
443,62451,0,0,deny,199,199,0,1,0,1,0
50459,62413,0,0,deny,62,62,0,1,0,1,0
49696,53,15575,53,allow,200,94,106,2,30,1,1
47362,443,49001,443,allow,8263,2100,6163,34,255,16,18
55498,53,3379,53,allow,340,134,206,2,30,1,1
50285,80,56429,80,allow,4064,607,3457,12,45,6,6
0,0,0,0,deny,98,98,0,1,0,1,0
50330,53,50330,53,allow,237,93,144,2,0,1,1
55630,53,58025,53,allow,194,99,95,2,31,1,1
65316,80,11827,80,allow,2430,531,1899,10,133,6,4
26469,26348,0,0,deny,66,66,0,1,0,1,0
57888,443,62185,443,allow,9802,5628,4174,56,225,29,27
51745,30188,0,0,deny,62,62,0,1,0,1,0
53327,445,0,0,drop,70,70,0,1,0,1,0
14336,64147,0,0,deny,62,62,0,1,0,1,0
58638,5900,0,0,deny,62,62,0,1,0,1,0
54966,53,31791,53,allow,254,87,167,4,31,2,2
50494,443,62791,443,allow,5331564,43954,5287610,4171,80,672,3499
52387,445,0,0,drop,70,70,0,1,0,1,0
36563,6851,45259,6851,allow,7584,4075,3509,51,169,27,24
50857,26467,0,0,deny,66,66,0,1,0,1,0
51327,445,0,0,drop,70,70,0,1,0,1,0
40932,443,9497,443,allow,10803,4485,6318,36,345,19,17
27197,22114,0,0,deny,146,146,0,1,0,1,0
57603,445,0,0,drop,66,66,0,1,0,1,0
55174,80,55174,80,allow,374,240,134,7,15,5,2
62408,3478,62290,3478,allow,140,140,0,1,30,1,0
58902,443,55109,443,allow,8119,5152,2967,29,18,14,15
57377,443,22825,443,allow,11247,3991,7256,30,149,14,16
40128,80,6000,80,allow,2437,1277,1160,12,16,7,5
14199,443,14199,443,allow,416,198,218,7,27,4,3
61739,445,0,0,drop,66,66,0,1,0,1,0
57127,53,41835,53,allow,195,102,93,2,30,1,1
65444,445,0,0,drop,70,70,0,1,0,1,0
50716,80,11421,80,allow,1106,326,780,12,140,6,6
19718,37965,0,0,deny,66,66,0,1,0,1,0
26110,2310,0,0,deny,148,148,0,1,0,1,0
60389,443,56749,443,allow,8166,1734,6432,23,81,12,11
60995,443,4422,443,allow,1351,846,505,12,19,7,5
8889,30434,0,0,deny,60,60,0,1,0,1,0
58439,443,16787,443,allow,232,172,60,3,5,2,1
49177,53,27104,53,allow,184,94,90,2,30,1,1
65289,53,55210,53,allow,179,94,85,2,30,1,1
63901,42053,50757,42053,allow,2980,1647,1333,16,31,10,6
55088,445,0,0,drop,70,70,0,1,0,1,0
27005,27017,53290,27017,allow,881,126,755,2,31,1,1
23415,11392,0,0,deny,62,62,0,1,0,1,0
59815,443,31852,443,allow,4586,955,3631,17,28,9,8
49917,53,18720,53,allow,209,110,99,2,30,1,1
52773,443,22036,443,allow,19594,11977,7617,48,100,25,23
54448,53,29193,53,allow,70,70,0,1,30,1,0
2075,19473,0,0,deny,66,66,0,1,0,1,0
58638,5900,0,0,deny,62,62,0,1,0,1,0
61074,445,0,0,drop,70,70,0,1,0,1,0
54666,443,61385,443,allow,3648,1080,2568,18,135,8,10
27005,27015,1608,27015,allow,888,126,762,2,30,1,1
34912,443,42889,443,allow,36366,2297,34069,51,139,21,30
61980,53,64563,53,allow,374,104,270,4,50,2,2
49547,53,49951,53,allow,193,102,91,2,30,1,1
39423,443,60458,443,allow,121145,3578,117567,128,77,39,89
49526,53,12720,53,allow,272,97,175,4,58,2,2
50671,443,30836,443,allow,5409,1834,3575,25,17,12,13
36811,80,46728,80,allow,1475,837,638,10,15,5,5
49270,53,46560,53,allow,322,110,212,4,30,2,2
53616,445,0,0,drop,70,70,0,1,0,1,0
50931,445,0,0,drop,70,70,0,1,0,1,0
49543,53,11834,53,allow,779,110,669,2,30,1,1
38358,22300,0,0,deny,60,60,0,1,0,1,0
50556,445,0,0,drop,70,70,0,1,0,1,0
58638,5900,0,0,deny,62,62,0,1,0,1,0
53868,443,61364,443,allow,499,425,74,4,1,3,1
52657,53,48551,53,allow,302,210,92,3,30,2,1
56352,80,27612,80,allow,1258,752,506,13,16,7,6
44550,80,64720,80,allow,3577,1983,1594,18,153,9,9
64022,53,48680,53,allow,197,102,95,2,31,1,1
64361,445,0,0,drop,70,70,0,1,0,1,0
65340,53,38317,53,allow,313,110,203,4,33,2,2
20508,57470,0,0,deny,62,62,0,1,0,1,0
50257,3389,50257,3389,allow,3473,1518,1955,17,18,9,8
47478,443,52438,443,allow,4019,1462,2557,21,120,11,10
52143,443,25458,443,allow,712,452,260,8,25,4,4
53798,62166,25360,62166,allow,164,70,94,2,4,1,1
52626,44847,0,0,deny,62,62,0,1,0,1,0
62208,37965,0,0,deny,66,66,0,1,0,1,0
50789,445,0,0,drop,70,70,0,1,0,1,0
59736,53,9602,53,allow,571,166,405,2,29,1,1
62507,445,0,0,drop,70,70,0,1,0,1,0
49413,53,49413,53,allow,225,90,135,2,30,1,1
53832,56005,15467,56005,allow,70,70,0,2,8,2,0
34530,80,15851,80,allow,1056,682,374,10,15,6,4
59611,56205,0,0,deny,62,62,0,1,0,1,0
8999,57470,0,0,deny,146,146,0,1,0,1,0
15333,60043,0,0,deny,62,62,0,1,0,1,0
52850,445,0,0,drop,70,70,0,1,0,1,0
46327,25903,25335,25903,allow,332,192,140,6,25,4,2
60223,67,0,0,deny,60,60,0,1,0,1,0
56820,53,32969,53,allow,186,95,91,2,31,1,1
56627,53,7670,53,allow,193,102,91,2,31,1,1
57797,64147,0,0,deny,66,66,0,1,0,1,0
54350,443,24025,443,allow,10318,2117,8201,38,371,19,19
53647,16194,38859,16194,allow,70,70,0,1,5,1,0
57273,443,35041,443,allow,10926,3915,7011,50,33,28,22
53245,443,58724,443,allow,4595,1038,3557,19,69,11,8
64053,53,10506,53,allow,193,102,91,2,30,1,1
54351,443,26403,443,allow,7900,2042,5858,27,36,15,12
64925,53,10435,53,allow,338,110,228,2,30,1,1
60265,53,3375,53,allow,215,86,129,2,30,1,1
41032,80,41032,80,allow,11428,2250,9178,22,126,11,11
49523,53,19380,53,allow,314,93,221,4,43,2,2
52206,445,0,0,drop,70,70,0,1,0,1,0
55031,445,0,0,drop,66,66,0,1,0,1,0
57131,53,26066,53,allow,168,78,90,2,30,1,1
53252,445,0,0,drop,70,70,0,1,0,1,0
55184,53,55740,53,allow,443,92,351,4,31,2,2
57845,445,0,0,drop,66,66,0,1,0,1,0
37834,30349,0,0,deny,145,145,0,1,0,1,0
59276,445,0,0,drop,70,70,0,1,0,1,0
0,0,0,0,deny,98,98,0,1,0,1,0
44731,443,63210,443,allow,4920,2738,2182,33,259,16,17
55531,53,2010,53,allow,322,110,212,4,30,2,2
57131,31061,0,0,deny,145,145,0,1,0,1,0
58638,5900,0,0,deny,62,62,0,1,0,1,0
28015,443,63063,443,allow,6435,1089,5346,18,75,9,9
59524,25174,0,0,deny,66,66,0,1,0,1,0
52035,80,61330,80,allow,4185,3462,723,14,15,7,7
34677,51185,0,0,deny,60,60,0,1,0,1,0
64913,53,45899,53,allow,183,94,89,2,30,1,1
50377,445,0,0,drop,70,70,0,1,0,1,0
56478,53,14582,53,allow,200,102,98,2,30,1,1
59724,53,63001,53,allow,304,86,218,2,30,1,1
48886,443,65287,443,allow,8468,2867,5601,23,144,10,13
49390,53,56282,53,allow,210,110,100,2,30,1,1
35449,443,35449,443,allow,157435,9243,148192,220,97,101,119
63132,445,0,0,drop,70,70,0,1,0,1,0
60610,58414,0,0,deny,62,62,0,1,0,1,0
37460,443,55415,443,allow,2885,1732,1153,16,256,9,7
40367,80,26121,80,allow,2119,808,1311,12,16,7,5
27005,27016,11664,27016,allow,902,126,776,2,30,1,1
61218,22114,0,0,deny,66,66,0,1,0,1,0
57408,53,58813,53,allow,190,97,93,2,30,1,1
57062,80,49519,80,allow,864,507,357,8,38,5,3
58638,5900,0,0,deny,62,62,0,1,0,1,0
55293,445,0,0,drop,70,70,0,1,0,1,0
56779,43137,15198,43137,allow,70,70,0,1,5,1,0
50367,53,53044,53,allow,821,102,719,2,30,1,1
46862,15000,28105,15000,allow,130,70,60,2,5,1,1
63973,445,0,0,drop,70,70,0,1,0,1,0
39337,443,52807,443,allow,4362,1145,3217,17,26,9,8
33845,53,0,0,allow,82,82,0,1,30,1,0
39717,5228,64597,5228,allow,7587,2099,5488,26,3602,14,12
50170,445,0,0,drop,70,70,0,1,0,1,0
15854,50584,0,0,deny,62,62,0,1,0,1,0
11988,48817,0,0,deny,66,66,0,1,0,1,0
35549,443,45483,443,allow,9032,2244,6788,36,255,17,19
34166,22114,0,0,deny,146,146,0,1,0,1,0
64885,53,54457,53,allow,182,102,80,2,31,1,1
62995,53,59527,53,allow,101,101,0,2,31,2,0
49193,443,41261,443,allow,11773,2390,9383,29,19,15,14
63910,44847,0,0,deny,62,62,0,1,0,1,0
49171,443,58850,443,allow,13649,6228,7421,28,30,15,13
60476,80,59400,80,allow,613,539,74,7,15,6,1
64695,445,0,0,drop,70,70,0,1,0,1,0
1865,25174,0,0,deny,62,62,0,1,0,1,0
56380,36829,0,0,deny,66,66,0,1,0,1,0
60880,443,55222,443,allow,25751,2629,23122,49,49,23,26
0,0,0,0,deny,98,98,0,1,0,1,0
57545,35440,0,0,deny,66,66,0,1,0,1,0
56173,37807,0,0,deny,66,66,0,1,0,1,0
58638,5900,0,0,deny,62,62,0,1,0,1,0
62243,445,0,0,drop,70,70,0,1,0,1,0
58638,5900,0,0,deny,62,62,0,1,0,1,0
52630,1433,0,0,deny,60,60,0,1,0,1,0
18173,25174,0,0,deny,66,66,0,1,0,1,0
27005,27017,7414,27017,allow,882,126,756,2,30,1,1
50546,445,0,0,drop,70,70,0,1,0,1,0
64451,53,26294,53,allow,363,92,271,4,31,2,2
55541,53,53785,53,allow,772,100,672,2,31,1,1
55410,53,52970,53,allow,212,102,110,2,30,1,1
58664,53,14984,53,allow,192,90,102,2,30,1,1
64959,53,12491,53,allow,209,110,99,2,30,1,1
49217,52769,38751,52769,allow,2189,1143,1046,10,16,6,4
64908,445,0,0,drop,70,70,0,1,0,1,0
49546,53,30362,53,allow,193,102,91,2,30,1,1
64051,36829,0,0,deny,66,66,0,1,0,1,0
57139,53,34151,53,allow,166,86,80,2,29,1,1
52919,443,28761,443,allow,7573,1986,5587,40,115,19,21
63370,445,0,0,drop,66,66,0,1,0,1,0
49849,53,18692,53,allow,173,94,79,2,30,1,1
63824,445,0,0,drop,66,66,0,1,0,1,0
56483,80,37968,80,allow,82266,4947,77319,94,136,37,57
59970,443,20638,443,allow,7448,1347,6101,24,16,13,11
40301,8696,0,0,deny,60,60,0,1,0,1,0
53330,445,0,0,drop,70,70,0,1,0,1,0
49605,53,37521,53,allow,239,110,129,2,30,1,1
26900,27017,57216,27017,allow,422,164,258,6,30,3,3
10082,64147,0,0,deny,62,62,0,1,0,1,0
57343,53,33500,53,allow,181,94,87,2,30,1,1
68,67,0,0,deny,594,594,0,1,0,1,0
60899,445,0,0,drop,70,70,0,1,0,1,0
65083,53,18755,53,allow,198,94,104,2,30,1,1
1024,44847,0,0,deny,146,146,0,1,0,1,0
6881,46776,0,0,deny,146,146,0,1,0,1,0
60713,443,57689,443,allow,6287,1742,4545,17,19,10,7
3764,9694,0,0,deny,66,66,0,1,0,1,0
65025,53,29192,53,allow,786,110,676,2,29,1,1
41756,56205,0,0,deny,62,62,0,1,0,1,0
64906,53,18657,53,allow,209,110,99,2,30,1,1
53905,443,17585,443,allow,499,425,74,4,0,3,1
54155,445,0,0,drop,70,70,0,1,0,1,0
46734,50265,0,0,deny,74,74,0,1,0,1,0
56816,53,44842,53,allow,754,94,660,2,31,1,1
64919,53,28952,53,allow,199,102,97,2,29,1,1
10445,46824,0,0,deny,62,62,0,1,0,1,0
443,35385,0,0,deny,161,161,0,1,0,1,0
51594,53,51594,53,allow,219,92,127,2,30,1,1
56330,53,49598,53,allow,199,102,97,2,30,1,1
57331,53,59568,53,allow,172,88,84,2,30,1,1
21839,443,21839,443,allow,13003,1226,11777,25,19,12,13
57188,53,44023,53,allow,186,95,91,2,30,1,1
56470,53,21021,53,allow,196,100,96,2,31,1,1
53247,443,53247,443,allow,1528,757,771,19,121,9,10
63175,445,0,0,drop,70,70,0,1,0,1,0
59899,53,59899,53,allow,194,87,107,2,31,1,1
57511,123,47594,123,allow,184,94,90,2,29,1,1
54008,443,44994,443,allow,4249,724,3525,13,15,7,6
49576,445,0,0,drop,70,70,0,1,0,1,0
64275,53,47631,53,allow,324,90,234,4,35,2,2
52600,445,0,0,drop,70,70,0,1,0,1,0
50363,53,11154,53,allow,214,110,104,2,30,1,1
55237,53,6417,53,allow,259,87,172,4,56,2,2
50464,445,0,0,drop,66,66,0,1,0,1,0
62617,445,0,0,drop,66,66,0,1,0,1,0
57020,36237,0,0,deny,66,66,0,1,0,1,0
48676,53392,0,0,deny,60,60,0,1,0,1,0
58145,445,0,0,drop,70,70,0,1,0,1,0
54373,53,8646,53,allow,200,86,114,2,30,1,1
63347,25174,0,0,deny,66,66,0,1,0,1,0
56555,445,0,0,drop,70,70,0,1,0,1,0
54955,53,32337,53,allow,177,94,83,2,30,1,1
53286,80,26328,80,allow,3096,1001,2095,12,150,7,5
64570,443,7059,443,allow,24984,2042,22942,41,32,19,22
51931,443,20564,443,allow,2328,1677,651,17,23,9,8
27908,23,0,0,deny,60,60,0,1,0,1,0
27313,53,27313,53,allow,194,87,107,2,31,1,1
50533,80,13873,80,allow,3672,1976,1696,12,26,7,5
59282,80,59282,80,allow,181627,17128,164499,277,15,79,198
38534,443,44926,443,allow,8918,730,8188,20,72,7,13
20726,2767,0,0,deny,66,66,0,1,0,1,0
48726,80,33900,80,allow,1794,1480,314,13,15,8,5
49845,53,0,0,allow,206,83,123,2,30,1,1
43596,80,25616,80,allow,1947,1182,765,10,515,6,4
49772,53,60667,53,allow,178,91,87,2,30,1,1
61501,443,38275,443,allow,633920,7867,626053,505,41,81,424
34338,443,23040,443,allow,8152,3395,4757,27,18,15,12
53819,445,0,0,drop,70,70,0,1,0,1,0
50524,53,62327,53,allow,193,102,91,2,30,1,1
59166,123,2980,123,allow,184,94,90,2,30,1,1
64420,53,3288,53,allow,194,102,92,2,31,1,1
57300,443,65390,443,allow,8979,3093,5886,43,15,24,19
53408,445,0,0,drop,70,70,0,1,0,1,0
53804,24067,52480,24067,allow,70,70,0,2,7,2,0
65132,53,29079,53,allow,167,86,81,2,30,1,1
60393,443,18640,443,allow,3371,2029,1342,16,360,8,8
9478,443,35302,443,allow,6092,775,5317,17,28,9,8
55806,53,52811,53,allow,200,102,98,2,33,1,1
36289,53,0,0,allow,86,86,0,1,30,1,0
53043,445,0,0,drop,66,66,0,1,0,1,0
65185,53,26657,53,allow,453,186,267,6,30,3,3
56731,53,43957,53,allow,173,94,79,2,31,1,1
55244,53,54182,53,allow,186,102,84,2,30,1,1
57441,53,16567,53,allow,177,94,83,2,29,1,1
51824,53021,25345,53021,allow,66,66,0,2,8,2,0
49317,53,61782,53,allow,194,102,92,2,30,1,1
43162,443,31273,443,allow,10096,3002,7094,25,16,13,12
60572,445,0,0,drop,70,70,0,1,0,1,0
51806,443,51806,443,allow,1466,856,610,13,27,6,7
56105,53,14961,53,allow,372,142,230,2,29,1,1
60156,443,49389,443,allow,178,118,60,2,15,1,1
45338,443,42439,443,allow,2719,1454,1265,22,34,12,10
57470,51413,27069,51413,allow,807,275,532,4,1200,2,2
58791,443,11218,443,allow,5167,700,4467,16,15,7,9
59733,53,57614,53,allow,384,166,218,2,30,1,1
57594,80,6266,80,allow,486,280,206,8,25,5,3
56948,443,19472,443,allow,5601,1203,4398,14,59,9,5
33582,44847,0,0,deny,62,62,0,1,0,1,0
61944,445,0,0,drop,70,70,0,1,0,1,0
55476,53,58894,53,allow,232,110,122,2,30,1,1
58463,443,33811,443,allow,19057,9308,9749,111,307,53,58
65228,53,28438,53,allow,200,102,98,2,30,1,1
51906,17491,64843,17491,allow,70,70,0,2,8,2,0
48668,7275,13487,7275,allow,276,70,206,5,32,2,3
56013,445,0,0,drop,66,66,0,1,0,1,0
49663,53,18877,53,allow,184,80,104,2,30,1,1
56356,53,61835,53,allow,184,102,82,2,30,1,1
60857,445,0,0,drop,70,70,0,1,0,1,0
37612,443,3287,443,allow,2141,1270,871,18,130,10,8
54706,443,10559,443,allow,5612,1051,4561,20,16,11,9
51845,80,46640,80,allow,502,310,192,9,31,6,3
11136,19910,0,0,deny,62,62,0,1,0,1,0
17295,18242,0,0,allow,66,66,0,1,90,1,0
59277,445,0,0,drop,70,70,0,1,0,1,0
32496,48817,0,0,deny,148,148,0,1,0,1,0
58750,443,9806,443,allow,3776,2372,1404,17,15,9,8
54136,443,41489,443,allow,10109,1394,8715,22,75,13,9
9254,443,60082,443,allow,6135,770,5365,17,26,9,8
42075,36237,0,0,deny,62,62,0,1,0,1,0
47388,443,27845,443,allow,350,210,140,6,15,4,2
61390,80,4844,80,allow,13706,1388,12318,26,255,14,12
54775,445,0,0,drop,70,70,0,1,0,1,0
56386,50584,0,0,deny,66,66,0,1,0,1,0
61985,445,0,0,drop,70,70,0,1,0,1,0
42298,40032,22903,40032,allow,720,549,171,4,30,2,2
23331,25174,0,0,deny,62,62,0,1,0,1,0
48676,53395,0,0,deny,60,60,0,1,0,1,0
56222,5228,31508,5228,allow,2531,1513,1018,17,3601,8,9
17781,50265,0,0,deny,62,62,0,1,0,1,0
59980,443,52666,443,allow,345468,18536,326932,432,22,200,232
62082,443,37456,443,allow,2826,1618,1208,21,45,12,9
64608,53,12446,53,allow,212,110,102,2,30,1,1
60953,443,32015,443,allow,103580,4856,98724,133,17,56,77
52112,26467,0,0,deny,66,66,0,1,0,1,0
50227,57470,0,0,deny,62,62,0,1,0,1,0
57294,445,0,0,drop,70,70,0,1,0,1,0
51461,445,0,0,drop,70,70,0,1,0,1,0
63262,445,0,0,drop,70,70,0,1,0,1,0
53611,58508,47899,58508,allow,320,140,180,6,7,3,3
36972,443,35947,443,allow,7557,3602,3955,20,150,12,8
43893,443,47910,443,allow,1440,719,721,15,198,8,7
49890,443,45754,443,allow,6068,1047,5021,20,50,11,9
50865,53,50865,53,allow,242,98,144,2,30,1,1
49527,53,63553,53,allow,415,98,317,4,51,2,2
55872,445,0,0,drop,70,70,0,1,0,1,0
56354,53,56354,53,allow,214,97,117,2,30,1,1
50973,80,49428,80,allow,1095221,7065,1088156,829,36,105,724
62042,80,65130,80,allow,10924,548,10376,17,48,6,11
13423,56205,0,0,deny,62,62,0,1,0,1,0
53748,445,0,0,drop,70,70,0,1,0,1,0
38114,443,10061,443,allow,863998,37140,826858,1072,61,479,593
57437,443,10192,443,allow,9539,3344,6195,36,17,17,19
53908,443,36300,443,allow,499,425,74,4,0,3,1
51870,445,0,0,drop,66,66,0,1,0,1,0
49782,445,0,0,drop,70,70,0,1,0,1,0
63379,36237,0,0,deny,62,62,0,1,0,1,0
22981,15503,0,0,deny,62,62,0,1,0,1,0
24882,50647,0,0,deny,60,60,0,1,0,1,0
45377,443,49244,443,allow,5291,3987,1304,19,255,11,8
51262,445,0,0,drop,66,66,0,1,0,1,0
39050,443,47247,443,allow,26692,5527,21165,54,31,28,26
54134,443,5561,443,allow,10425,1383,9042,23,75,13,10
64323,53,33071,53,allow,376,126,250,2,30,1,1
60415,40829,46260,40829,allow,70,70,0,1,5,1,0
52863,50584,0,0,deny,66,66,0,1,0,1,0
48817,7294,48817,7294,allow,479,152,327,2,1200,1,1
59039,445,0,0,drop,70,70,0,1,0,1,0
50629,80,50629,80,allow,6210,2976,3234,16,20,9,7
58645,445,0,0,drop,70,70,0,1,0,1,0
33401,51505,0,0,deny,66,66,0,1,0,1,0
58022,5555,0,0,deny,60,60,0,1,0,1,0
52724,80,24269,80,allow,9532,745,8787,18,113,9,9
50419,443,44835,443,allow,4590,575,4015,14,28,6,8
14696,42707,0,0,deny,62,62,0,1,0,1,0
49153,53,32682,53,allow,214,102,112,2,29,1,1
27005,32055,61239,32055,allow,878,126,752,2,31,1,1
55678,445,0,0,drop,70,70,0,1,0,1,0
56624,53,53106,53,allow,259,118,141,2,29,1,1
58028,445,0,0,drop,70,70,0,1,0,1,0
52030,443,52030,443,allow,4400,1493,2907,19,30,11,8
15641,26467,0,0,deny,62,62,0,1,0,1,0
37991,49152,57920,49152,allow,156,156,0,3,7,3,0
65259,37965,0,0,deny,62,62,0,1,0,1,0
63011,443,30939,443,allow,304,86,218,2,30,1,1
54437,443,40534,443,allow,716056,89267,626789,952,300,368,584
59988,64147,0,0,deny,66,66,0,1,0,1,0
64144,53,48969,53,allow,186,95,91,2,30,1,1
56838,35124,44520,35124,allow,70,70,0,1,5,1,0
9381,35440,0,0,deny,62,62,0,1,0,1,0
56658,53,56658,53,allow,257,114,143,2,30,1,1
35484,443,11377,443,allow,1633,1038,595,14,34,8,6
56809,53,41798,53,allow,178,94,84,2,31,1,1
57470,6881,6226,6881,allow,453,251,202,4,1200,2,2
51700,7000,51700,7000,allow,2163,676,1487,14,15,7,7
57410,53,64082,53,allow,711,87,624,2,30,1,1
60761,51221,0,0,deny,66,66,0,1,0,1,0
61978,445,0,0,drop,70,70,0,1,0,1,0
21519,443,21519,443,allow,14483,1152,13331,27,19,12,15
52110,80,18812,80,allow,422,240,182,8,26,5,3
59124,443,60758,443,allow,27431,19413,8018,71,175,36,35
0,0,0,0,allow,400,204,196,4,0,2,2
51045,25174,0,0,deny,66,66,0,1,0,1,0
57414,443,40284,443,allow,103144,2997,100147,114,16,36,78
54053,445,0,0,drop,70,70,0,1,0,1,0
65349,53,5493,53,allow,284,94,190,2,29,1,1
54189,64147,0,0,deny,66,66,0,1,0,1,0
41852,35440,0,0,deny,62,62,0,1,0,1,0
41098,443,2984,443,allow,3384,762,2622,15,135,7,8
49513,443,49513,443,allow,140969,40311,100658,180,68,92,88
64462,53,6951,53,allow,174,89,85,2,30,1,1
57705,443,65472,443,allow,7915,1994,5921,31,270,15,16
37981,80,45214,80,allow,1572,755,817,11,15,6,5
58701,27030,51697,27030,allow,70,70,0,2,9,2,0
30188,33365,39784,33365,allow,42329,18517,23812,241,2378,116,125
48817,8621,48817,8621,allow,152,152,0,1,1200,1,0
58892,443,12440,443,allow,5167,700,4467,16,15,7,9
55767,445,0,0,drop,70,70,0,1,0,1,0
11030,37965,0,0,deny,62,62,0,1,0,1,0
56928,53,56928,53,allow,823,98,725,2,30,1,1
52932,443,34898,443,allow,20789,4927,15862,35,31,20,15
59532,445,0,0,drop,66,66,0,1,0,1,0
63588,443,6782,443,allow,11301,2292,9009,37,165,20,17
39615,443,17497,443,allow,130,70,60,3,5,2,1
56586,53,33852,53,allow,177,94,83,2,31,1,1
49256,445,0,0,drop,66,66,0,1,0,1,0
62852,445,0,0,drop,70,70,0,1,0,1,0
56001,445,0,0,drop,70,70,0,1,0,1,0
28003,443,64020,443,allow,5515,1388,4127,18,15,9,9
443,50238,0,0,deny,286,286,0,1,0,1,0
50138,445,0,0,drop,70,70,0,1,0,1,0
59788,445,0,0,drop,66,66,0,1,0,1,0
57090,51505,0,0,deny,66,66,0,1,0,1,0
45204,53,45204,53,allow,237,91,146,2,33,1,1
10072,25174,0,0,deny,146,146,0,1,0,1,0
49325,443,26750,443,allow,5749,3401,2348,29,76,15,14
50881,445,0,0,drop,66,66,0,1,0,1,0
52438,443,56919,443,allow,70,70,0,1,4,1,0
54506,445,0,0,drop,70,70,0,1,0,1,0
26799,50584,0,0,deny,62,62,0,1,0,1,0
61279,445,0,0,drop,66,66,0,1,0,1,0
52969,44847,0,0,deny,66,66,0,1,0,1,0
6889,30170,0,0,deny,143,143,0,1,0,1,0
48605,50584,0,0,deny,146,146,0,1,0,1,0
64428,53,23839,53,allow,621,196,425,6,59,3,3
49498,53,33432,53,allow,211,102,109,2,30,1,1
52128,80,31768,80,allow,366,240,126,7,26,5,2
64990,53,21080,53,allow,323,94,229,2,30,1,1
57222,445,0,0,drop,66,66,0,1,0,1,0
64674,445,0,0,drop,70,70,0,1,0,1,0
49407,53,49407,53,allow,247,98,149,2,32,1,1
50409,53,47032,53,allow,731,85,646,2,30,1,1
34910,443,51247,443,allow,18452,11429,7023,39,64,23,16
61701,15503,0,0,deny,66,66,0,1,0,1,0
52064,22114,0,0,deny,66,66,0,1,0,1,0
58511,53,45280,53,allow,302,86,216,2,30,1,1
51535,44847,0,0,deny,62,62,0,1,0,1,0
60203,445,0,0,drop,70,70,0,1,0,1,0
53948,445,0,0,drop,70,70,0,1,0,1,0
64385,53,23181,53,allow,179,94,85,2,30,1,1
60980,5900,0,0,deny,60,60,0,1,0,1,0
50035,445,0,0,drop,70,70,0,1,0,1,0
55069,53,50203,53,allow,195,102,93,2,30,1,1
52125,80,43801,80,allow,2178,1003,1175,10,15,6,4
58725,10387,0,0,deny,145,145,0,1,0,1,0
25808,53,25808,53,allow,218,99,119,2,31,1,1
57909,443,27742,443,allow,2653,1558,1095,18,124,10,8
53193,445,0,0,drop,70,70,0,1,0,1,0
50823,443,50823,443,allow,1210,637,573,14,25,7,7
50898,80,8835,80,allow,21445,1605,19840,36,255,19,17
18224,23,0,0,deny,60,60,0,1,0,1,0
57384,53,45393,53,allow,752,93,659,2,31,1,1
59377,53,59377,53,allow,216,98,118,2,30,1,1
54942,80,32519,80,allow,5696,703,4993,14,75,8,6
58710,445,0,0,drop,66,66,0,1,0,1,0
54206,445,0,0,drop,70,70,0,1,0,1,0
65312,53,9346,53,allow,182,94,88,2,30,1,1
65258,53,18646,53,allow,763,102,661,2,30,1,1
56636,53,34067,53,allow,168,86,82,2,30,1,1
16430,31573,0,0,deny,62,62,0,1,0,1,0
58645,445,0,0,drop,70,70,0,1,0,1,0
34298,53,58428,53,allow,199,94,105,2,30,1,1
50662,445,0,0,drop,66,66,0,1,0,1,0
55714,445,0,0,drop,70,70,0,1,0,1,0
57570,443,58853,443,allow,6226,4213,2013,30,79,18,12
42298,40012,32444,40012,allow,148,86,62,2,29,1,1
48706,23393,0,0,deny,60,60,0,1,0,1,0
65414,53,56360,53,allow,216,102,114,2,30,1,1
50613,445,0,0,drop,70,70,0,1,0,1,0
61387,80,56509,80,allow,28791,2297,26494,41,255,20,21
47103,55378,0,0,deny,146,146,0,1,0,1,0
64023,53,2522,53,allow,179,94,85,2,29,1,1
27507,25174,0,0,deny,146,146,0,1,0,1,0
63531,445,0,0,drop,70,70,0,1,0,1,0
57240,443,57240,443,allow,4623,1716,2907,19,26,11,8
58638,5900,0,0,deny,62,62,0,1,0,1,0
46908,80,46908,80,allow,5464,713,4751,15,16,8,7
52454,80,19961,80,allow,2425,529,1896,11,75,6,5
43578,15503,0,0,deny,74,74,0,1,0,1,0
16387,24782,0,0,deny,60,60,0,1,0,1,0
53918,445,0,0,drop,70,70,0,1,0,1,0
53913,443,40081,443,allow,499,425,74,4,0,3,1
40204,40028,12239,40028,allow,143,81,62,2,30,1,1
57985,443,21475,443,allow,140109,5229,134880,159,46,59,100
64770,53,63194,53,allow,93,93,0,1,31,1,0
65075,53,49710,53,allow,278,100,178,4,30,2,2
30304,26467,0,0,deny,62,62,0,1,0,1,0
62856,443,62856,443,allow,3743,1654,2089,10,120,5,5
56649,443,38913,443,allow,8060,2040,6020,20,15,11,9
49631,53,6299,53,allow,198,102,96,2,33,1,1
54234,53,54234,53,allow,237,91,146,2,33,1,1
62029,22114,0,0,deny,66,66,0,1,0,1,0
49567,5223,11151,5223,allow,9705,5123,4582,29,74,15,14
46053,443,15914,443,allow,6999,1563,5436,18,186,3,15
56605,53,38242,53,allow,341,110,231,2,30,1,1
51087,80,58473,80,allow,6363,3093,3270,36,130,19,17
49729,443,33717,443,allow,8322,2585,5737,23,16,12,11
45552,80,5282,80,allow,890,420,470,14,27,7,7
55629,53,22449,53,allow,168,86,82,2,30,1,1
49706,53,30583,53,allow,296,102,194,4,41,2,2
56970,53,57331,53,allow,428,103,325,4,34,2,2
46750,80,46750,80,allow,27124,1455,25669,41,15,20,21
65422,443,52517,443,allow,2494,1643,851,17,23,9,8
52765,443,14674,443,allow,283,163,120,4,16,2,2
41685,161,0,0,allow,109,109,0,2,34,2,0
64327,445,0,0,drop,70,70,0,1,0,1,0
56485,443,48158,443,allow,5711,1208,4503,21,121,11,10
64292,53,46657,53,allow,199,94,105,2,30,1,1
49305,57470,0,0,deny,66,66,0,1,0,1,0
52200,445,0,0,drop,66,66,0,1,0,1,0
53120,49860,38739,49860,allow,70,70,0,2,8,2,0
58781,443,48906,443,allow,6673,4335,2338,22,16,11,11
53801,53,14956,53,allow,167,78,89,2,30,1,1
50584,44816,28229,44816,allow,161,161,0,1,1201,1,0
56650,53,58049,53,allow,253,102,151,2,30,1,1
58638,5900,0,0,deny,62,62,0,1,0,1,0
12934,53,12934,53,allow,237,91,146,2,33,1,1
57490,443,55071,443,allow,1778,1219,559,13,26,8,5
58115,3389,58115,3389,allow,4166,2141,2025,18,17,9,9
50078,53,19314,53,allow,185,102,83,2,29,1,1
47595,33436,0,0,allow,106,106,0,1,60,1,0
9283,57470,0,0,deny,66,66,0,1,0,1,0
53698,8120,60768,8120,allow,70,70,0,1,5,1,0
64226,445,0,0,drop,66,66,0,1,0,1,0
50584,51413,31327,51413,allow,498,150,348,4,2396,2,2
9836,22114,0,0,deny,62,62,0,1,0,1,0
65437,53,50016,53,allow,190,97,93,2,30,1,1
58161,445,0,0,drop,70,70,0,1,0,1,0
57701,445,0,0,drop,70,70,0,1,0,1,0
55747,445,0,0,drop,70,70,0,1,0,1,0
65106,53,25747,53,allow,772,102,670,2,30,1,1
40308,67,0,0,deny,60,60,0,1,0,1,0
35516,80,25484,80,allow,841,715,126,5,15,3,2
56748,53,37401,53,allow,184,94,90,2,30,1,1
7912,35440,0,0,deny,146,146,0,1,0,1,0
64703,53,47599,53,allow,306,142,164,2,30,1,1
50133,445,0,0,drop,70,70,0,1,0,1,0
53779,51505,0,0,deny,66,66,0,1,0,1,0
50579,443,37078,443,allow,2707,1383,1324,29,36,16,13
55417,445,0,0,drop,70,70,0,1,0,1,0
65307,53,36094,53,allow,811,94,717,2,29,1,1
56891,53,21983,53,allow,200,94,106,2,30,1,1
54397,445,0,0,drop,66,66,0,1,0,1,0
50497,445,0,0,drop,70,70,0,1,0,1,0
30707,30317,0,0,deny,62,62,0,1,0,1,0
49518,443,49518,443,allow,103941,6635,97306,158,76,81,77
50515,80,58648,80,allow,7871,1409,6462,17,75,7,10
57031,443,21412,443,allow,2963,797,2166,10,120,5,5
49875,80,61335,80,allow,35824,4558,31266,39,88,13,26
60339,7010,60339,7010,allow,3322,2027,1295,16,16,9,7
49453,53,64414,53,allow,227,110,117,2,31,1,1
22924,25174,0,0,deny,62,62,0,1,0,1,0
59241,62413,0,0,deny,62,62,0,1,0,1,0
57925,445,0,0,drop,70,70,0,1,0,1,0
56405,62413,0,0,deny,66,66,0,1,0,1,0
54464,56205,0,0,deny,66,66,0,1,0,1,0
48574,443,45361,443,allow,9336,1153,8183,27,34,14,13
64110,443,18222,443,allow,5060,3367,1693,21,102,12,9
56239,53,49542,53,allow,180,94,86,2,30,1,1
50882,80,51896,80,allow,207895,10483,197412,229,141,90,139
35265,80,15083,80,allow,3524,2698,826,14,16,8,6
57452,57470,0,0,deny,62,62,0,1,0,1,0
52024,47600,3124,47600,allow,70,70,0,1,4,1,0
36080,26467,0,0,deny,62,62,0,1,0,1,0
53838,36829,0,0,deny,66,66,0,1,0,1,0
52609,443,37495,443,allow,24091,7349,16742,75,162,36,39
51665,443,64553,443,allow,8783,4321,4462,39,94,19,20
58528,445,0,0,drop,70,70,0,1,0,1,0
57346,53,32731,53,allow,210,110,100,2,30,1,1
60149,445,0,0,drop,66,66,0,1,0,1,0
25973,26467,0,0,deny,66,66,0,1,0,1,0
54633,36237,0,0,deny,66,66,0,1,0,1,0
56900,445,0,0,drop,70,70,0,1,0,1,0
54669,80,16041,80,allow,1148,599,549,14,318,7,7
56655,53,60599,53,allow,168,86,82,2,31,1,1
55415,53,7035,53,allow,183,94,89,2,30,1,1
56180,53,31487,53,allow,200,102,98,2,30,1,1
63059,53,39205,53,allow,304,86,218,2,30,1,1
56524,445,0,0,drop,70,70,0,1,0,1,0
57346,443,28545,443,allow,72170,4208,67962,102,186,48,54
1794,22114,0,0,deny,146,146,0,1,0,1,0
3478,61463,0,0,deny,902,902,0,1,0,1,0
53608,445,0,0,drop,70,70,0,1,0,1,0
64549,445,0,0,drop,66,66,0,1,0,1,0
58771,53,46484,53,allow,168,78,90,2,30,1,1
52182,443,53611,443,allow,10422,1313,9109,23,75,12,11
62921,445,0,0,drop,66,66,0,1,0,1,0
52088,53,34492,53,allow,168,78,90,2,30,1,1
54084,445,0,0,drop,70,70,0,1,0,1,0
49901,53,7736,53,allow,272,122,150,2,30,1,1
52406,445,0,0,drop,66,66,0,1,0,1,0
34079,443,61674,443,allow,14068,7909,6159,37,82,23,14
55615,13826,16730,13826,allow,70,70,0,1,5,1,0
65002,445,0,0,drop,70,70,0,1,0,1,0
50219,445,0,0,drop,70,70,0,1,0,1,0
52644,57209,0,0,deny,66,66,0,1,0,1,0
27005,1306,35061,1306,allow,858,126,732,2,29,1,1
56309,22114,0,0,deny,62,62,0,1,0,1,0
55496,80,55496,80,allow,124,60,64,2,5,1,1
56447,445,0,0,drop,70,70,0,1,0,1,0
47910,7454,0,0,deny,60,60,0,1,0,1,0
58638,5900,0,0,deny,62,62,0,1,0,1,0
56263,445,0,0,drop,70,70,0,1,0,1,0
35742,53,48792,53,allow,199,94,105,2,30,1,1
62900,993,6178,993,allow,12900,4980,7920,91,117,51,40
443,59890,0,0,deny,60,60,0,1,0,1,0
14721,53,14721,53,allow,217,87,130,2,31,1,1
37576,443,42873,443,allow,499,425,74,4,0,3,1
64929,53,16910,53,allow,168,86,82,2,31,1,1
50421,445,0,0,drop,70,70,0,1,0,1,0
56791,11500,23499,11500,allow,70,70,0,1,5,1,0
49716,445,0,0,drop,66,66,0,1,0,1,0
52221,33166,38901,33166,allow,66,66,0,1,5,1,0
57131,7774,0,0,deny,145,145,0,1,0,1,0
51867,53,1821,53,allow,179,86,93,2,30,1,1
27005,27015,34776,27015,allow,882,126,756,2,31,1,1
58638,5900,0,0,deny,62,62,0,1,0,1,0
49269,53,11598,53,allow,254,102,152,2,30,1,1
17010,57470,0,0,deny,62,62,0,1,0,1,0
58638,5900,0,0,deny,62,62,0,1,0,1,0
64631,53,53048,53,allow,226,102,124,2,30,1,1
59363,443,28293,443,allow,15860,1930,13930,37,195,14,23
50849,445,0,0,drop,70,70,0,1,0,1,0
56534,443,29507,443,allow,265430,17951,247479,305,105,122,183
56573,445,0,0,drop,70,70,0,1,0,1,0
65180,53,32141,53,allow,198,101,97,2,31,1,1
53806,445,0,0,drop,66,66,0,1,0,1,0
59345,25174,0,0,deny,62,62,0,1,0,1,0
50584,28387,54140,28387,allow,161,161,0,2,1200,2,0
39064,443,7055,443,allow,11356,4341,7015,33,128,16,17
50125,443,38569,443,allow,15687,3764,11923,32,34,18,14
48706,23393,0,0,deny,60,60,0,1,0,1,0
11344,42873,0,0,deny,62,62,0,1,0,1,0
55089,53,56950,53,allow,199,102,97,2,30,1,1
39096,443,59336,443,allow,1268772,32833,1235939,1288,81,409,879
60635,445,0,0,drop,66,66,0,1,0,1,0
58747,443,20889,443,allow,5167,700,4467,16,15,7,9
55697,53,51781,53,allow,193,102,91,2,30,1,1
52626,80,56571,80,allow,2820,1466,1354,20,534,11,9
9142,80,13917,80,allow,54219,1884,52335,61,37,23,38
50369,50584,0,0,deny,66,66,0,1,0,1,0
63742,26305,40966,26305,allow,70,70,0,1,4,1,0
56440,53,9792,53,allow,711,87,624,2,31,1,1
50488,22114,0,0,deny,66,66,0,1,0,1,0
65443,53,19494,53,allow,215,102,113,2,30,1,1
56964,53,17076,53,allow,267,87,180,4,53,2,2
51555,443,44960,443,allow,876,390,486,12,39,4,8
41762,443,13178,443,allow,2306249,52358,2253891,2041,239,447,1594
64922,53,2264,53,allow,209,102,107,2,30,1,1
58638,5900,0,0,deny,62,62,0,1,0,1,0
64001,445,0,0,drop,70,70,0,1,0,1,0
64842,53,17214,53,allow,802,104,698,2,31,1,1
56002,53,0,0,allow,213,88,125,2,30,1,1
55223,53,62144,53,allow,168,86,82,2,30,1,1
3730,37965,0,0,deny,62,62,0,1,0,1,0
57073,57470,0,0,deny,62,62,0,1,0,1,0
48676,53392,0,0,deny,60,60,0,1,0,1,0
443,31367,0,0,deny,74,74,0,1,0,1,0
49167,53,5532,53,allow,816,102,714,2,30,1,1
1116,44847,0,0,deny,66,66,0,1,0,1,0
50293,443,61876,443,allow,12677,3097,9580,37,26,19,18
50211,51050,0,0,deny,62,62,0,1,0,1,0
58808,80,14493,80,allow,2295,1574,721,10,375,6,4
50755,445,0,0,drop,70,70,0,1,0,1,0
7665,80,7665,80,allow,110567,7016,103551,135,46,60,75
47169,15000,52806,15000,allow,130,70,60,2,5,1,1
60270,443,42458,443,allow,9551,2173,7378,33,26,17,16
53640,443,55622,443,allow,3201,1057,2144,13,135,6,7
60786,445,0,0,drop,70,70,0,1,0,1,0
51638,445,0,0,drop,70,70,0,1,0,1,0
56539,445,0,0,drop,70,70,0,1,0,1,0
58117,445,0,0,drop,70,70,0,1,0,1,0
63797,445,0,0,drop,70,70,0,1,0,1,0
49974,445,0,0,drop,70,70,0,1,0,1,0
60993,445,0,0,drop,70,70,0,1,0,1,0
57131,26296,0,0,deny,145,145,0,1,0,1,0
65165,53,27998,53,allow,783,96,687,2,31,1,1
60294,30188,0,0,deny,66,66,0,1,0,1,0
62739,21416,0,0,deny,145,145,0,1,0,1,0
59676,53,12870,53,allow,195,94,101,2,30,1,1
50265,18417,40558,18417,allow,7282,4118,3164,57,1696,35,22
49699,53,40136,53,allow,266,89,177,4,58,2,2
56653,53,34935,53,allow,78,78,0,1,30,1,0
56803,53,10846,53,allow,195,102,93,2,30,1,1
27005,27091,18957,27091,allow,883,126,757,2,31,1,1
50470,445,0,0,drop,70,70,0,1,0,1,0
52539,80,47321,80,allow,1152,712,440,10,15,5,5
45941,23386,0,0,deny,60,60,0,1,0,1,0
56440,53,14356,53,allow,742,88,654,2,30,1,1
7905,22114,0,0,deny,66,66,0,1,0,1,0
443,10010,0,0,deny,60,60,0,1,0,1,0
50235,445,0,0,drop,70,70,0,1,0,1,0
57440,53,58703,53,allow,199,102,97,2,30,1,1
50999,53,58447,53,allow,214,78,136,2,30,1,1
45459,53,25942,53,allow,198,93,105,2,31,1,1
65081,443,33904,443,allow,5291,339,4952,11,120,5,6
60113,22114,0,0,deny,66,66,0,1,0,1,0
65397,445,0,0,drop,70,70,0,1,0,1,0
53912,3478,60537,3478,allow,3532,1792,1740,58,88,29,29
443,35385,0,0,deny,97,97,0,1,0,1,0
6712,5060,0,0,deny,410,410,0,1,0,1,0
54129,445,0,0,drop,70,70,0,1,0,1,0
30179,57470,0,0,deny,60,60,0,1,0,1,0
63132,80,36171,80,allow,19934,920,19014,23,15,7,16
48706,23393,0,0,deny,60,60,0,1,0,1,0
65168,53,15649,53,allow,230,110,120,2,30,1,1
39703,443,48474,443,allow,4719,2313,2406,15,132,7,8
52953,80,11532,80,allow,3247,1730,1517,12,36,7,5
50618,443,39503,443,allow,11054,1724,9330,28,91,15,13
55795,443,23533,443,allow,5283,2688,2595,14,135,7,7
50048,445,0,0,drop,70,70,0,1,0,1,0
62203,445,0,0,drop,66,66,0,1,0,1,0
55820,53,26876,53,allow,184,94,90,2,30,1,1
60851,445,0,0,drop,66,66,0,1,0,1,0
56700,80,19955,80,allow,51889,4253,47636,68,64,31,37
41476,53,41476,53,allow,235,90,145,2,33,1,1
59095,57470,0,0,deny,66,66,0,1,0,1,0
64030,53,24656,53,allow,338,110,228,2,30,1,1
64257,53,4953,53,allow,261,94,167,2,30,1,1
25849,53,25849,53,allow,404,259,145,3,32,2,1
56634,443,30287,443,allow,8654,2150,6504,20,15,11,9
54540,22,0,0,deny,60,60,0,1,0,1,0
53211,22114,0,0,deny,66,66,0,1,0,1,0
51957,53,51957,53,allow,825,99,726,2,31,1,1
61110,445,0,0,drop,66,66,0,1,0,1,0
63819,445,0,0,drop,70,70,0,1,0,1,0
54984,53,62420,53,allow,994,86,908,2,30,1,1
37628,443,18772,443,allow,70,70,0,2,5,2,0
7184,15503,0,0,deny,66,66,0,1,0,1,0
58305,51180,0,0,deny,66,66,0,1,0,1,0
60369,443,26606,443,allow,6052,1841,4211,21,82,10,11
5222,46866,0,0,deny,66,66,0,1,0,1,0
52024,25174,0,0,deny,62,62,0,1,0,1,0
38633,51221,0,0,deny,66,66,0,1,0,1,0
46422,80,48489,80,allow,1447,468,979,9,181,5,4
52021,32202,28754,32202,allow,66,66,0,1,5,1,0
59563,30188,0,0,deny,66,66,0,1,0,1,0
60481,445,0,0,drop,70,70,0,1,0,1,0
10312,23117,0,0,deny,62,62,0,1,0,1,0
63804,445,0,0,drop,70,70,0,1,0,1,0
52156,18238,30723,18238,allow,70,70,0,1,5,1,0
60818,445,0,0,drop,70,70,0,1,0,1,0
64023,445,0,0,drop,70,70,0,1,0,1,0
0,0,0,0,allow,1188,1188,0,2,0,2,0
50081,57470,0,0,deny,66,66,0,1,0,1,0
57275,53,13596,53,allow,193,102,91,2,31,1,1
16387,35308,0,0,deny,60,60,0,1,0,1,0
59377,9319,0,0,deny,62,62,0,1,0,1,0
43472,5228,13384,5228,allow,2531,1416,1115,17,3600,8,9
56130,445,0,0,drop,70,70,0,1,0,1,0
64041,53,17809,53,allow,200,102,98,2,30,1,1
59906,443,52197,443,allow,13657,5248,8409,33,171,17,16
59222,53,30617,53,allow,181,86,95,2,30,1,1
65203,30188,0,0,deny,66,66,0,1,0,1,0
24041,55783,0,0,deny,62,62,0,1,0,1,0
59592,37965,0,0,deny,62,62,0,1,0,1,0
35626,22114,0,0,deny,62,62,0,1,0,1,0
60395,443,53609,443,allow,10672,1729,8943,24,81,12,12
27005,27027,58259,27027,allow,1654,126,1528,4,31,2,2
64331,53,26878,53,allow,324,89,235,4,31,2,2
34166,50584,0,0,deny,146,146,0,1,0,1,0
62132,445,0,0,drop,66,66,0,1,0,1,0
5200,6643,0,0,deny,145,145,0,1,0,1,0
56934,53,48178,53,allow,216,110,106,2,31,1,1
5617,64147,0,0,deny,62,62,0,1,0,1,0
57071,53,61611,53,allow,164,84,80,2,31,1,1
50654,80,39837,80,allow,3728,1504,2224,13,21,7,6
65526,53,9344,53,allow,199,102,97,2,30,1,1
56664,443,21855,443,allow,8005,1985,6020,20,15,11,9
55995,53,15590,53,allow,182,94,88,2,29,1,1
5228,3434,0,0,deny,345,345,0,1,0,1,0
3478,61463,0,0,deny,503,503,0,1,0,1,0
55423,53,7848,53,allow,170,87,83,2,30,1,1
58562,57587,0,0,deny,66,66,0,1,0,1,0
53494,445,0,0,drop,66,66,0,1,0,1,0
50003,443,32664,443,allow,13812,3042,10770,29,16,15,14
50022,443,50896,443,allow,70,70,0,2,5,2,0
51950,17499,15514,17499,allow,70,70,0,2,8,2,0
54655,445,0,0,drop,70,70,0,1,0,1,0
31404,52955,0,0,deny,100,100,0,1,0,1,0
52138,25621,30366,25621,allow,70,70,0,2,8,2,0
27005,27016,42013,27016,allow,893,126,767,2,31,1,1
49929,53,44359,53,allow,214,110,104,2,29,1,1
45908,33330,0,0,deny,60,60,0,1,0,1,0
58638,5900,0,0,deny,62,62,0,1,0,1,0
50530,80,18434,80,allow,3561,1337,2224,13,20,7,6
55067,53,28702,53,allow,166,86,80,2,30,1,1
49812,445,0,0,drop,70,70,0,1,0,1,0
17177,64147,0,0,deny,62,62,0,1,0,1,0
59892,445,0,0,drop,70,70,0,1,0,1,0
30960,45692,4911,45692,allow,330,330,0,6,3609,6,0
33556,25174,0,0,deny,62,62,0,1,0,1,0
50401,443,63156,443,allow,256,136,120,5,9,3,2
59474,445,0,0,drop,66,66,0,1,0,1,0
48092,443,48092,443,allow,4398,1491,2907,19,27,11,8
56308,53,53406,53,allow,700,282,418,8,81,4,4
56079,53,63600,53,allow,198,101,97,2,31,1,1
64496,53,57419,53,allow,196,94,102,2,30,1,1
38369,443,64342,443,allow,434,226,208,7,28,4,3
65181,53,41975,53,allow,421,96,325,4,42,2,2
55146,445,0,0,drop,70,70,0,1,0,1,0
57367,53,52070,53,allow,177,94,83,2,30,1,1
45239,443,9489,443,allow,11147,3412,7735,36,458,20,16
27005,27018,24466,27018,allow,882,126,756,2,30,1,1
54973,53,3418,53,allow,308,102,206,2,30,1,1
58056,80,49652,80,allow,3518,1780,1738,12,20,7,5
55776,53,14354,53,allow,271,93,178,4,31,2,2
56647,443,58814,443,allow,1327,918,409,10,25,6,4
55018,445,0,0,drop,66,66,0,1,0,1,0
57196,53,22247,53,allow,754,94,660,2,31,1,1
58255,123,13070,123,allow,184,94,90,2,30,1,1
49640,443,18216,443,allow,8607,3608,4999,25,256,14,11
40140,53,40140,53,allow,404,259,145,3,32,2,1
54446,443,54881,443,allow,2782,1778,1004,20,33,10,10
52050,31648,38816,31648,allow,70,70,0,1,5,1,0
51899,80,55362,80,allow,1758,989,769,13,76,8,5
52183,13503,58173,13503,allow,70,70,0,1,5,1,0
51197,443,47968,443,allow,3211,781,2430,17,135,8,9
51983,443,27301,443,allow,23955,4211,19744,42,46,21,21
56433,53,33860,53,allow,210,110,100,2,29,1,1
62208,443,62208,443,allow,4497,1590,2907,19,29,11,8
59850,443,34758,443,allow,10260,1360,8900,22,18,7,15
48817,8677,48817,8677,allow,490,149,341,2,1200,1,1
19845,30024,0,0,deny,62,62,0,1,0,1,0
46409,35440,0,0,deny,66,66,0,1,0,1,0
47196,443,63403,443,allow,2701330,44089,2657241,2230,134,296,1934
49719,443,28042,443,allow,4717,849,3868,15,52,7,8
43484,443,55073,443,allow,130,70,60,2,15,1,1
49199,53,34176,53,allow,816,102,714,2,30,1,1
9437,443,16715,443,allow,6285,839,5446,19,25,10,9
53469,44847,0,0,deny,66,66,0,1,0,1,0
51446,57587,0,0,deny,100,100,0,1,0,1,0
38330,123,58815,123,allow,184,94,90,2,30,1,1
55966,443,15279,443,allow,9006,2048,6958,36,121,18,18
16944,50584,0,0,deny,62,62,0,1,0,1,0
65422,53,8384,53,allow,448,84,364,4,54,2,2
63587,22114,0,0,deny,62,62,0,1,0,1,0
2074,7010,2074,7010,allow,4279,2090,2189,16,15,8,8
55699,53,30470,53,allow,271,103,168,4,59,2,2
59758,53,7104,53,allow,211,78,133,2,30,1,1
55076,53,45529,53,allow,182,93,89,2,31,1,1
57004,53,12740,53,allow,195,78,117,2,30,1,1
53169,445,0,0,drop,66,66,0,1,0,1,0
56217,53,16338,53,allow,183,94,89,2,29,1,1
43480,443,57887,443,allow,58423,25600,32823,86,138,40,46
52522,445,0,0,drop,70,70,0,1,0,1,0
55031,443,21855,443,allow,134,60,74,3,5,2,1
50337,80,47050,80,allow,1083,653,430,8,16,5,3
53248,443,60652,443,allow,532222,22112,510110,645,232,259,386
11136,19910,0,0,deny,62,62,0,1,0,1,0
56061,445,0,0,drop,66,66,0,1,0,1,0
64563,445,0,0,drop,70,70,0,1,0,1,0
51820,53738,52497,53738,allow,70,70,0,1,5,1,0
27005,27015,24637,27015,allow,1630,126,1504,4,31,2,2
57470,16414,19962,16414,allow,726,726,0,12,1200,12,0
57911,445,0,0,drop,66,66,0,1,0,1,0
55212,53733,0,0,deny,66,66,0,1,0,1,0
62063,443,35010,443,allow,25511,1260,24251,34,121,13,21
50102,17546,0,0,deny,66,66,0,1,0,1,0
64559,53,44867,53,allow,168,86,82,2,31,1,1
55177,80,55177,80,allow,374,240,134,7,15,5,2
50552,443,41023,443,allow,8311,3156,5155,29,17,16,13
51354,445,0,0,drop,70,70,0,1,0,1,0
64318,53,45436,53,allow,183,94,89,2,30,1,1
57226,51505,0,0,deny,66,66,0,1,0,1,0
61181,445,0,0,drop,70,70,0,1,0,1,0
7482,57470,0,0,deny,66,66,0,1,0,1,0
56622,53,41480,53,allow,179,94,85,2,31,1,1
50705,80,25198,80,allow,499,192,307,6,26,4,2
63967,445,0,0,drop,66,66,0,1,0,1,0
49667,53,30486,53,allow,759,102,657,2,31,1,1
49446,80,49446,80,allow,5724,3966,1758,25,38,14,11
50714,80,62410,80,allow,708,384,324,12,195,7,5
55907,53,13623,53,allow,711,87,624,2,30,1,1
55619,53,10755,53,allow,182,93,89,2,31,1,1
3717,25174,0,0,deny,62,62,0,1,0,1,0
56888,443,32016,443,allow,15807,12220,3587,44,242,18,26
59921,445,0,0,drop,66,66,0,1,0,1,0
3478,61463,0,0,deny,1288,1288,0,1,0,1,0
49938,445,0,0,drop,70,70,0,1,0,1,0
55336,53,18020,53,allow,308,94,214,2,30,1,1
44121,23,0,0,deny,60,60,0,1,0,1,0
49405,53,14474,53,allow,94,94,0,1,30,1,0
56455,445,0,0,drop,66,66,0,1,0,1,0
50958,53,61318,53,allow,94,94,0,1,30,1,0
59991,445,0,0,drop,66,66,0,1,0,1,0
16387,64075,0,0,deny,60,60,0,1,0,1,0
56498,53,39557,53,allow,199,102,97,2,30,1,1
35776,443,4893,443,allow,7500,2339,5161,18,136,8,10
52862,80,51424,80,allow,3150,1478,1672,32,131,17,15
55777,53,5442,53,allow,733,94,639,2,29,1,1
45482,80,16084,80,allow,1130,624,506,11,15,5,6
46863,15000,49470,15000,allow,130,70,60,2,5,1,1
49277,53,5788,53,allow,199,86,113,2,29,1,1
53166,61600,0,0,deny,66,66,0,1,0,1,0
51267,38070,5566,38070,allow,210,140,70,4,14,3,1
51940,80,37296,80,allow,366,240,126,7,27,5,2
53164,443,1379,443,allow,7434,1695,5739,23,27,12,11
37876,23,0,0,deny,60,60,0,1,0,1,0
16158,50584,0,0,deny,66,66,0,1,0,1,0
59879,55783,0,0,deny,66,66,0,1,0,1,0
65090,53,43740,53,allow,209,102,107,2,30,1,1
46211,443,37976,443,allow,190,70,120,4,16,2,2
49385,53,9929,53,allow,843,285,558,8,56,4,4
53724,443,54768,443,allow,499,425,74,4,0,3,1
50028,53,64249,53,allow,256,102,154,2,30,1,1
65505,53,17210,53,allow,166,86,80,2,29,1,1
55027,445,0,0,drop,70,70,0,1,0,1,0
27005,1202,29779,1202,allow,865,126,739,2,29,1,1
54997,26467,0,0,deny,66,66,0,1,0,1,0
58973,445,0,0,drop,70,70,0,1,0,1,0
49785,53,38466,53,allow,206,105,101,2,31,1,1
53783,445,0,0,drop,70,70,0,1,0,1,0
52336,64097,0,0,deny,62,62,0,1,0,1,0
51941,80,19964,80,allow,82496,3881,78615,104,61,47,57
32934,443,9755,443,allow,7623,3362,4261,26,31,14,12
65371,53,1608,53,allow,199,102,97,2,30,1,1
51289,445,0,0,drop,70,70,0,1,0,1,0
34808,22114,0,0,deny,66,66,0,1,0,1,0
58638,5900,0,0,deny,62,62,0,1,0,1,0
63261,445,0,0,drop,66,66,0,1,0,1,0
27005,1303,22373,1303,allow,868,126,742,2,30,1,1
53710,80,64568,80,allow,2499,531,1968,11,75,6,5
43220,5222,35739,5222,allow,5415,2041,3374,53,467,23,30
58638,5900,0,0,deny,62,62,0,1,0,1,0
64733,35440,0,0,deny,66,66,0,1,0,1,0
54369,53,50744,53,allow,168,78,90,2,31,1,1
58824,443,46343,443,allow,11863,7694,4169,33,17,17,16
63447,44847,0,0,deny,66,66,0,1,0,1,0
57095,53,44244,53,allow,170,87,83,2,30,1,1
64124,53,27285,53,allow,294,93,201,4,42,2,2
64237,53,49326,53,allow,227,110,117,2,31,1,1
52344,445,0,0,drop,66,66,0,1,0,1,0
51010,22114,0,0,deny,146,146,0,1,0,1,0
56826,31310,8679,31310,allow,70,70,0,1,5,1,0
64307,53,35303,53,allow,241,94,147,2,30,1,1
58131,29072,0,0,deny,146,146,0,1,0,1,0
51118,445,0,0,drop,70,70,0,1,0,1,0
59177,443,33565,443,allow,280,140,140,5,130,3,2
52026,12523,2339,12523,allow,70,70,0,2,7,2,0
61147,445,0,0,drop,70,70,0,1,0,1,0
54707,445,0,0,drop,70,70,0,1,0,1,0
41783,443,41782,443,allow,23344,2097,21247,39,15,18,21
27005,27014,60254,27014,allow,879,126,753,2,31,1,1
64999,53,5804,53,allow,178,94,84,2,29,1,1
52348,445,0,0,drop,70,70,0,1,0,1,0
52492,37965,0,0,deny,66,66,0,1,0,1,0
50927,44847,0,0,deny,146,146,0,1,0,1,0
65412,445,0,0,drop,70,70,0,1,0,1,0
50116,22,50116,22,allow,184,120,64,4,10,3,1
46439,443,34571,443,allow,8246,1739,6507,21,17,11,10
64006,53,16897,53,allow,394,96,298,4,47,2,2
49602,445,0,0,drop,70,70,0,1,0,1,0
60238,80,26979,80,allow,1176,701,475,9,150,6,3
49308,53,35422,53,allow,320,97,223,4,50,2,2
40880,443,42551,443,allow,8142,2090,6052,22,360,10,12
65005,445,0,0,drop,66,66,0,1,0,1,0
53559,445,0,0,drop,70,70,0,1,0,1,0
54613,53,0,0,allow,86,86,0,1,30,1,0
57423,53,20278,53,allow,774,101,673,2,30,1,1
37249,25174,0,0,deny,146,146,0,1,0,1,0
63783,445,0,0,drop,70,70,0,1,0,1,0
49929,443,23324,443,allow,7298,2303,4995,22,16,12,10
54526,44847,0,0,deny,62,62,0,1,0,1,0
49737,443,51096,443,allow,334252,14917,319335,405,73,179,226
50683,445,0,0,drop,70,70,0,1,0,1,0
33354,10387,0,0,deny,148,148,0,1,0,1,0
54228,445,0,0,drop,70,70,0,1,0,1,0
55477,53,61973,53,allow,183,94,89,2,31,1,1
54796,443,9714,443,allow,6668,1926,4742,20,15,11,9
51038,445,0,0,drop,70,70,0,1,0,1,0
50287,443,51254,443,allow,14559,2721,11838,31,16,17,14
49772,53,51587,53,allow,531,188,343,6,58,3,3
57866,53,0,0,allow,627,80,547,2,29,1,1
51176,53,44581,53,allow,236,86,150,2,30,1,1
55392,53,27900,53,allow,195,102,93,2,31,1,1
55913,53,60589,53,allow,177,94,83,2,30,1,1
30906,53,30906,53,allow,227,89,138,2,30,1,1
43584,26543,0,0,deny,156,156,0,1,0,1,0
62424,443,60409,443,allow,4650,3116,1534,19,44,10,9
53650,64147,0,0,deny,66,66,0,1,0,1,0
44529,6881,0,0,deny,146,146,0,1,0,1,0
53406,44847,0,0,deny,62,62,0,1,0,1,0
50581,445,0,0,drop,70,70,0,1,0,1,0
51365,445,0,0,drop,70,70,0,1,0,1,0
53781,36366,44419,36366,allow,70,70,0,2,8,2,0
2876,35440,0,0,deny,62,62,0,1,0,1,0
56845,53,56845,53,allow,825,99,726,2,30,1,1
49568,53,32071,53,allow,168,86,82,2,31,1,1
27005,27017,53289,27017,allow,900,126,774,2,31,1,1
55618,445,0,0,drop,70,70,0,1,0,1,0
50037,53,63751,53,allow,195,102,93,2,31,1,1
50228,443,34666,443,allow,1775,169,1606,7,120,3,4
51974,54759,44030,54759,allow,70,70,0,2,7,2,0
55240,53,47282,53,allow,193,102,91,2,30,1,1
49476,53,2698,53,allow,200,94,106,2,30,1,1
5087,22114,0,0,deny,66,66,0,1,0,1,0
7660,443,7660,443,allow,5640,2394,3246,25,82,13,12
60373,80,60373,80,allow,116680,5773,110907,126,21,46,80
63795,445,0,0,drop,66,66,0,1,0,1,0
46286,443,2203,443,allow,1053,566,487,10,41,6,4
65513,53,57723,53,allow,195,102,93,2,29,1,1
47127,443,18899,443,allow,7166,2377,4789,16,122,7,9
45458,443,14560,443,allow,7144,4917,2227,36,561,18,18
51636,445,0,0,drop,70,70,0,1,0,1,0
63050,53,33894,53,allow,384,166,218,2,30,1,1
56120,53,36940,53,allow,212,102,110,2,30,1,1
57610,443,60687,443,allow,4327,674,3653,14,25,8,6
58635,51505,0,0,deny,62,62,0,1,0,1,0
49936,53,50715,53,allow,152,78,74,2,31,1,1
57010,53,26340,53,allow,199,102,97,2,30,1,1
49952,53,65134,53,allow,195,102,93,2,31,1,1
41518,443,53815,443,allow,25342,17809,7533,56,80,28,28
56860,49991,37577,49991,allow,70,70,0,2,8,2,0
52006,49849,60139,49849,allow,70,70,0,1,5,1,0
37346,443,8413,443,allow,7814,2339,5475,26,316,12,14
59631,445,0,0,drop,70,70,0,1,0,1,0
57120,53,16635,53,allow,761,100,661,2,30,1,1
58695,53,54969,53,allow,392,86,306,2,30,1,1
64295,445,0,0,drop,66,66,0,1,0,1,0
53490,5228,31385,5228,allow,7188,2098,5090,38,113,22,16
4419,23,0,0,deny,60,60,0,1,0,1,0
61207,445,0,0,drop,66,66,0,1,0,1,0
50309,53,29176,53,allow,193,102,91,2,29,1,1
45941,23386,0,0,deny,60,60,0,1,0,1,0
49449,53,12310,53,allow,216,110,106,2,30,1,1
49762,53,30143,53,allow,819,102,717,2,29,1,1
56673,53,26407,53,allow,193,102,91,2,30,1,1
56268,53,11800,53,allow,711,87,624,2,31,1,1
56481,53,4723,53,allow,193,102,91,2,30,1,1
54582,445,0,0,drop,66,66,0,1,0,1,0
43357,443,59688,443,allow,1053,566,487,10,15,6,4
59935,445,0,0,drop,70,70,0,1,0,1,0
62237,443,62237,443,allow,169315,5255,164060,190,77,66,124
62113,443,7270,443,allow,3262,256,3006,9,121,4,5
53063,80,2438,80,allow,2725,1228,1497,24,90,13,11
44890,443,50264,443,allow,232,172,60,3,4,2,1
49466,53,63958,53,allow,324,103,221,4,46,2,2
56098,55442,0,0,deny,66,66,0,1,0,1,0
49216,53,25748,53,allow,178,91,87,2,31,1,1
39208,5900,39208,5900,allow,152,66,86,2,10,1,1
46218,23,0,0,deny,60,60,0,1,0,1,0
50356,80,58294,80,allow,1578,756,822,13,34,7,6
64671,53,7191,53,allow,294,102,192,2,30,1,1
55350,53,12521,53,allow,185,102,83,2,29,1,1
43715,443,63901,443,allow,81803,3159,78644,93,20,33,60
59679,37807,0,0,deny,66,66,0,1,0,1,0
50840,80,15901,80,allow,268155,6485,261670,281,25,97,184
54938,445,0,0,drop,70,70,0,1,0,1,0
55772,53,55772,53,allow,194,87,107,2,30,1,1
65253,53,35458,53,allow,321,150,171,2,30,1,1
27005,27016,24190,27016,allow,1696,126,1570,4,31,2,2
27005,27015,5725,27015,allow,876,126,750,2,30,1,1
57275,443,62988,443,allow,45483074,398771,45084303,36307,333,3386,32921
51358,445,0,0,drop,70,70,0,1,0,1,0
49851,53,28608,53,allow,164,84,80,2,30,1,1
46965,53,4424,53,allow,199,94,105,2,30,1,1
53138,443,56360,443,allow,7141,2507,4634,28,42,13,15
58143,445,0,0,drop,66,66,0,1,0,1,0
49858,443,3076,443,allow,16232,3319,12913,23,124,9,14
52039,38541,31838,38541,allow,70,70,0,2,7,2,0
21133,24035,37028,24035,allow,481,150,331,2,1200,1,1
53790,21011,8352,21011,allow,70,70,0,1,5,1,0
53466,445,0,0,drop,70,70,0,1,0,1,0
1027,25174,0,0,deny,62,62,0,1,0,1,0
64037,18592,48496,18592,allow,70,70,0,1,5,1,0
51947,16935,29468,16935,allow,70,70,0,2,8,2,0
64077,25174,0,0,deny,66,66,0,1,0,1,0
65318,53,18281,53,allow,184,94,90,2,30,1,1
55588,53,33228,53,allow,168,86,82,2,30,1,1
64936,53,55896,53,allow,816,102,714,2,30,1,1
55020,443,26568,443,allow,7239,2934,4305,26,16,15,11
64962,27048,15901,27048,allow,747,462,285,2,30,1,1
43642,48817,0,0,deny,134,134,0,1,0,1,0
60381,26312,6064,26312,allow,70,70,0,2,8,2,0
59214,57866,0,0,deny,66,66,0,1,0,1,0
50265,50262,19967,50262,allow,3758,2456,1302,52,2355,31,21
45997,443,45997,443,allow,1494,898,596,12,142,6,6
53084,443,55326,443,allow,490914,83866,407048,1048,332,526,522
443,62732,0,0,deny,199,199,0,1,0,1,0
65260,53,38236,53,allow,184,94,90,2,30,1,1
64602,53,18957,53,allow,185,102,83,2,30,1,1
61163,445,0,0,drop,66,66,0,1,0,1,0
49222,53,61468,53,allow,418,150,268,2,30,1,1
56629,53,53878,53,allow,183,94,89,2,30,1,1
53696,445,0,0,drop,66,66,0,1,0,1,0
37624,443,54201,443,allow,471102,14016,457086,503,25,191,312
1036,64147,0,0,deny,62,62,0,1,0,1,0
51906,17491,7245,17491,allow,70,70,0,1,5,1,0
54280,3398,0,0,deny,60,60,0,1,0,1,0
49447,445,0,0,drop,70,70,0,1,0,1,0
54797,445,0,0,drop,66,66,0,1,0,1,0
56875,53,33833,53,allow,167,86,81,2,30,1,1
20962,22114,0,0,deny,62,62,0,1,0,1,0
46081,443,10510,443,allow,125213,5113,120100,153,96,58,95
58638,5900,0,0,deny,62,62,0,1,0,1,0
39100,2767,0,0,deny,62,62,0,1,0,1,0
64711,53,17611,53,allow,211,110,101,2,30,1,1
0,0,0,0,allow,480,244,236,4,0,2,2
37965,28596,25273,28596,allow,479,150,329,2,1199,1,1
5223,5025,0,0,deny,220,220,0,1,0,1,0
49209,53,48140,53,allow,199,102,97,2,31,1,1
37876,5900,0,0,deny,60,60,0,1,0,1,0
61933,445,0,0,drop,70,70,0,1,0,1,0
54986,443,39292,443,allow,5684,3042,2642,32,46,18,14
65201,445,0,0,drop,70,70,0,1,0,1,0
42298,40013,38063,40013,allow,209,87,122,4,29,2,2
5588,5588,0,0,allow,3562,1936,1626,48,194,24,24
64752,53,55237,53,allow,190,97,93,2,31,1,1
53686,19010,53686,19010,allow,70,70,0,1,30,1,0
64806,445,0,0,drop,66,66,0,1,0,1,0
60768,40010,23273,40010,allow,316,136,180,6,7,3,3
49282,53,18906,53,allow,197,94,103,2,30,1,1
63601,443,6476,443,allow,26835,2611,24224,36,121,14,22
6828,64322,0,0,deny,60,60,0,1,0,1,0
50265,31240,10906,31240,allow,726,726,0,12,1200,12,0
47391,443,14660,443,allow,9921,3169,6752,31,20,17,14
59329,53,2601,53,allow,199,94,105,2,30,1,1
37834,45129,0,0,deny,145,145,0,1,0,1,0
58638,5900,0,0,deny,62,62,0,1,0,1,0
63013,443,17200,443,allow,304,86,218,2,30,1,1
51989,29736,26603,29736,allow,160,70,90,2,5,1,1
51632,445,0,0,drop,66,66,0,1,0,1,0
52643,36237,0,0,deny,66,66,0,1,0,1,0
54225,445,0,0,drop,70,70,0,1,0,1,0
50965,443,11513,443,allow,8949,1200,7749,21,85,10,11
52018,2425,48269,2425,allow,70,70,0,1,5,1,0
61499,443,53254,443,allow,15584,2626,12958,34,37,18,16
53370,443,49689,443,allow,6877,1694,5183,24,306,13,11
59712,445,0,0,drop,66,66,0,1,0,1,0
50320,53,20919,53,allow,168,78,90,2,30,1,1
53035,5228,40515,5228,allow,2725,1610,1115,20,3600,10,10
55877,14966,41407,14966,allow,480,149,331,2,1200,1,1
49301,443,5775,443,allow,6550,1836,4714,25,46,15,10
56755,53,24589,53,allow,184,94,90,2,30,1,1
57073,443,48824,443,allow,7731,2016,5715,38,271,20,18
63044,443,58831,443,allow,512,166,346,2,30,1,1
44774,22114,0,0,deny,146,146,0,1,0,1,0
63562,445,0,0,drop,70,70,0,1,0,1,0
50489,443,45489,443,allow,1268,638,630,12,17,7,5
59981,443,57380,443,allow,180817,9921,170896,241,21,116,125
51755,445,0,0,drop,70,70,0,1,0,1,0
43260,41615,0,0,deny,145,145,0,1,0,1,0
52575,22114,0,0,deny,62,62,0,1,0,1,0
63756,445,0,0,drop,66,66,0,1,0,1,0
52772,445,0,0,drop,70,70,0,1,0,1,0
49532,443,49532,443,allow,20488,16649,3839,30,24,18,12
59989,445,0,0,drop,66,66,0,1,0,1,0
26900,27017,55434,27017,allow,422,164,258,6,29,3,3
63852,445,0,0,drop,66,66,0,1,0,1,0
62068,80,36797,80,allow,2806,626,2180,12,15,6,6
39205,53,46384,53,allow,489,94,395,2,30,1,1
65238,53,13271,53,allow,86,86,0,1,30,1,0
48298,2043,0,0,deny,60,60,0,1,0,1,0
11136,19910,0,0,deny,62,62,0,1,0,1,0
49782,443,53470,443,allow,70,70,0,2,7,2,0
59763,445,0,0,drop,70,70,0,1,0,1,0
53895,443,16317,443,allow,375374,160846,214528,633,1412,294,339
52737,443,14623,443,allow,32774,3629,29145,52,26,27,25
56609,53,37814,53,allow,199,102,97,2,30,1,1
41612,80,44236,80,allow,2016,552,1464,8,16,5,3
55070,53,47871,53,allow,195,102,93,2,31,1,1
55421,445,0,0,drop,66,66,0,1,0,1,0
64191,44847,0,0,deny,66,66,0,1,0,1,0
56272,53,7235,53,allow,193,102,91,2,30,1,1
34170,80,19669,80,allow,1298,473,825,16,392,5,11
53368,445,0,0,drop,66,66,0,1,0,1,0
39871,53,52816,53,allow,198,93,105,2,31,1,1
51957,56737,56106,56737,allow,316,136,180,6,6,3,3
63068,445,0,0,drop,66,66,0,1,0,1,0
45941,23386,0,0,deny,60,60,0,1,0,1,0
50584,47174,17468,47174,allow,300,300,0,3,1200,3,0
60517,445,0,0,drop,70,70,0,1,0,1,0
51752,445,0,0,drop,70,70,0,1,0,1,0
34135,443,33569,443,allow,9932,1987,7945,22,16,12,10
65031,53,34987,53,allow,184,94,90,2,30,1,1
51749,445,0,0,drop,66,66,0,1,0,1,0
44681,31573,0,0,deny,146,146,0,1,0,1,0
10115,52700,0,0,deny,62,62,0,1,0,1,0
9176,443,40179,443,allow,6331,837,5494,19,28,10,9
51221,40624,20030,40624,allow,594,594,0,10,1200,10,0
56063,53,23721,53,allow,196,102,94,2,31,1,1
57431,53,32621,53,allow,178,91,87,2,31,1,1
51616,15000,27735,15000,allow,130,70,60,2,6,1,1
63569,445,0,0,drop,66,66,0,1,0,1,0
39356,443,35388,443,allow,7134,2290,4844,29,80,15,14
123,123,8140,123,allow,184,94,90,2,30,1,1
49466,53,52804,53,allow,184,94,90,2,29,1,1
49696,53,9591,53,allow,178,94,84,2,30,1,1
59659,445,0,0,drop,66,66,0,1,0,1,0
62646,445,0,0,drop,66,66,0,1,0,1,0
41852,35440,0,0,deny,62,62,0,1,0,1,0
58638,5900,0,0,deny,62,62,0,1,0,1,0
37538,37965,0,0,deny,66,66,0,1,0,1,0
58461,445,0,0,drop,70,70,0,1,0,1,0
59917,445,0,0,drop,70,70,0,1,0,1,0
52044,5824,18446,5824,allow,70,70,0,2,8,2,0
52127,445,0,0,drop,66,66,0,1,0,1,0
57313,443,59852,443,allow,134,60,74,3,5,2,1
45155,443,55125,443,allow,4000,1726,2274,13,135,6,7
36148,443,59223,443,allow,2233,1237,996,18,75,9,9
48826,25174,0,0,deny,66,66,0,1,0,1,0
33794,53,45704,53,allow,168,78,90,2,29,1,1
54201,445,0,0,drop,70,70,0,1,0,1,0
56984,53,7040,53,allow,199,102,97,2,29,1,1
51669,445,0,0,drop,70,70,0,1,0,1,0
1026,8305,0,0,deny,148,148,0,1,0,1,0
57430,53,55125,53,allow,185,102,83,2,29,1,1
37555,16386,35583,16386,allow,432,192,240,8,30,4,4
33041,443,60563,443,allow,12375,6777,5598,28,49,13,15
54955,53,54702,53,allow,177,94,83,2,29,1,1
56620,53,63507,53,allow,216,110,106,2,30,1,1
55987,445,0,0,drop,66,66,0,1,0,1,0
50265,40448,36258,40448,allow,2118,858,1260,28,1274,14,14
33215,37965,0,0,deny,62,62,0,1,0,1,0
63165,445,0,0,drop,70,70,0,1,0,1,0
61917,445,0,0,drop,66,66,0,1,0,1,0
55200,53,14143,53,allow,209,110,99,2,30,1,1
56857,43237,51679,43237,allow,66,66,0,1,5,1,0
60105,443,39991,443,allow,4856,1587,3269,17,138,9,8
57340,443,31175,443,allow,1169,616,553,12,16,7,5
38334,443,30322,443,allow,1864,250,1614,8,121,4,4
54080,443,47688,443,allow,1173681,52597,1121084,1428,177,642,786
51676,443,25301,443,allow,90135,76061,14074,251,247,132,119
60354,443,37287,443,allow,10223,3933,6290,49,115,22,27
6666,2001,0,0,deny,60,60,0,1,0,1,0
9479,443,13111,443,allow,6100,777,5323,17,25,9,8
59660,445,0,0,drop,70,70,0,1,0,1,0
4748,64147,0,0,deny,62,62,0,1,0,1,0
54011,445,0,0,drop,66,66,0,1,0,1,0
48025,44847,0,0,deny,62,62,0,1,0,1,0
53928,15503,0,0,deny,62,62,0,1,0,1,0
57136,53,22982,53,allow,209,110,99,2,30,1,1
49206,53,42939,53,allow,179,94,85,2,31,1,1
65188,27126,32293,27126,allow,268,78,190,2,29,1,1
55193,53,60056,53,allow,170,87,83,2,31,1,1
55927,80,55927,80,allow,450,246,204,8,29,5,3
46892,443,33257,443,allow,12488,5447,7041,28,16,16,12
57171,443,13487,443,allow,13932,3673,10259,26,121,11,15
58996,443,63733,443,allow,4979,1505,3474,21,40,11,10
57011,49813,0,0,deny,66,66,0,1,0,1,0
44299,80,44299,80,allow,1915,1466,449,10,20,6,4
59218,53,41217,53,allow,511,126,385,2,31,1,1
56665,443,40335,443,allow,8058,2038,6020,20,15,11,9
65186,53,51165,53,allow,521,90,431,4,43,2,2
64985,53,50795,53,allow,412,97,315,4,58,2,2
55067,53,59893,53,allow,178,94,84,2,30,1,1
55705,53,27815,53,allow,281,101,180,4,59,2,2
52635,443,48519,443,allow,8993,5205,3788,48,167,25,23
59321,445,0,0,drop,66,66,0,1,0,1,0
54403,443,27679,443,allow,3486,924,2562,13,122,6,7
46774,51050,0,0,deny,62,62,0,1,0,1,0
40226,443,40694,443,allow,13853,4638,9215,42,387,21,21
56768,443,55318,443,allow,7889,1900,5989,20,16,11,9
55933,53,17036,53,allow,212,102,110,2,30,1,1
55619,445,0,0,drop,70,70,0,1,0,1,0
49480,53,38554,53,allow,428,96,332,4,52,2,2
123,123,62754,123,allow,184,94,90,2,30,1,1
43900,443,13168,443,allow,442,250,192,8,25,5,3
49611,53,44019,53,allow,177,94,83,2,30,1,1
64890,51180,0,0,deny,66,66,0,1,0,1,0
56644,80,27121,80,allow,234,234,0,4,12,4,0
55410,53,27764,53,allow,711,87,624,2,30,1,1
50264,443,29730,443,allow,430,60,370,7,24,2,5
59937,37965,0,0,deny,66,66,0,1,0,1,0
36532,6555,55068,6555,allow,922,428,494,10,14,5,5
61033,39004,0,0,deny,66,66,0,1,0,1,0
55696,64301,60133,64301,allow,316,190,126,5,15,3,2
47450,443,63060,443,allow,9950,4684,5266,26,306,12,14
56677,53,31185,53,allow,767,102,665,2,31,1,1
64955,53,63777,53,allow,210,110,100,2,30,1,1
58429,53,0,0,allow,360,160,200,4,49,2,2
65036,53,31003,53,allow,209,94,115,2,30,1,1
55123,53,62052,53,allow,762,97,665,2,31,1,1
35921,443,62122,443,allow,9667,4709,4958,27,88,14,13
64883,445,0,0,drop,70,70,0,1,0,1,0
50107,445,0,0,drop,70,70,0,1,0,1,0
42744,443,24894,443,allow,224178,118713,105465,333,140,162,171
51781,43909,29947,43909,allow,70,70,0,2,8,2,0
29109,11392,0,0,deny,146,146,0,1,0,1,0
56622,53,6660,53,allow,340,107,233,4,30,2,2
58849,443,31441,443,allow,1366,631,735,14,81,7,7
47681,443,29966,443,allow,6790,1336,5454,20,187,11,9
25772,7302,0,0,deny,66,66,0,1,0,1,0
443,45788,0,0,deny,332,332,0,1,0,1,0
56956,53,28771,53,allow,182,93,89,2,30,1,1
65191,445,0,0,drop,66,66,0,1,0,1,0
65317,51221,0,0,deny,78,78,0,1,0,1,0
51130,61689,0,0,deny,66,66,0,1,0,1,0
51872,48108,5295,48108,allow,70,70,0,2,8,2,0
61740,443,10410,443,allow,9854,2716,7138,36,49,20,16
2075,19473,0,0,deny,62,62,0,1,0,1,0
61563,445,0,0,drop,66,66,0,1,0,1,0
55223,443,2473,443,allow,1118883,33814,1085069,1206,48,451,755
55129,445,0,0,drop,70,70,0,1,0,1,0
59694,50584,0,0,deny,66,66,0,1,0,1,0
56572,53,63633,53,allow,177,94,83,2,31,1,1
56307,445,0,0,drop,66,66,0,1,0,1,0
64657,53,12172,53,allow,312,94,218,2,30,1,1
8413,8413,11663,8413,allow,66,66,0,1,30,1,0
49632,53,31125,53,allow,288,94,194,2,30,1,1
55590,53,20424,53,allow,177,94,83,2,30,1,1
64283,53,28343,53,allow,186,95,91,2,31,1,1
45941,23386,0,0,deny,60,60,0,1,0,1,0
56838,445,0,0,drop,66,66,0,1,0,1,0
56649,445,0,0,drop,66,66,0,1,0,1,0
57122,53,4958,53,allow,199,102,97,2,29,1,1
65064,53,64961,53,allow,197,94,103,2,30,1,1
9504,25174,0,0,deny,62,62,0,1,0,1,0
1128,44847,0,0,deny,146,146,0,1,0,1,0
59257,445,0,0,drop,66,66,0,1,0,1,0
62226,443,62226,443,allow,130836,22940,107896,161,170,72,89
49410,53,62890,53,allow,177,94,83,2,30,1,1
53639,15079,39945,15079,allow,546,306,240,9,15,5,4
37708,443,23854,443,allow,8604,2228,6376,36,739,19,17
53619,11513,10996,11513,allow,320,140,180,6,6,3,3
57051,53,59033,53,allow,711,87,624,2,30,1,1
64292,445,0,0,drop,70,70,0,1,0,1,0
55745,443,5170,443,allow,11503,3691,7812,30,240,14,16
51204,443,55515,443,allow,37173,3712,33461,54,74,24,30
49555,53,24625,53,allow,193,102,91,2,30,1,1
50674,445,0,0,drop,70,70,0,1,0,1,0
51233,43890,0,0,deny,66,66,0,1,0,1,0
50523,443,44131,443,allow,1389,868,521,12,25,6,6
59833,53,25424,53,allow,195,94,101,2,30,1,1
62915,445,0,0,drop,70,70,0,1,0,1,0
55079,443,57713,443,allow,7156,1187,5969,20,16,10,10
50634,53,32177,53,allow,218,86,132,2,30,1,1
61050,445,0,0,drop,66,66,0,1,0,1,0
49985,53,61904,53,allow,312,90,222,2,31,1,1
38872,443,38872,443,allow,4480,1573,2907,19,29,11,8
6881,6881,0,0,deny,62,62,0,1,0,1,0
40834,50584,0,0,deny,146,146,0,1,0,1,0
51407,443,57078,443,allow,202,70,132,3,11,1,2
21365,23718,0,0,deny,62,62,0,1,0,1,0
16370,56205,0,0,deny,62,62,0,1,0,1,0
5223,32965,0,0,deny,167,167,0,1,0,1,0
31925,53,31925,53,allow,237,91,146,2,33,1,1
56476,443,56476,443,allow,4624,1717,2907,19,30,11,8
46225,53,7961,53,allow,199,94,105,2,30,1,1
58729,443,41982,443,allow,5167,700,4467,16,15,7,9
443,20995,0,0,deny,83,83,0,1,0,1,0
53638,443,29587,443,allow,2090,1100,990,17,119,9,8
62995,445,0,0,drop,70,70,0,1,0,1,0
51093,57470,0,0,deny,66,66,0,1,0,1,0
59489,53,5531,53,allow,168,78,90,2,30,1,1
49883,53,5470,53,allow,177,94,83,2,29,1,1
49316,53,24928,53,allow,184,94,90,2,31,1,1
51413,48637,0,0,deny,72,72,0,1,0,1,0
7288,25174,0,0,deny,66,66,0,1,0,1,0
5938,26428,0,0,allow,60,60,0,1,90,1,0
48706,23393,0,0,deny,60,60,0,1,0,1,0
51643,445,0,0,drop,66,66,0,1,0,1,0
37836,443,46026,443,allow,4647,1536,3111,25,40,12,13
52663,445,0,0,drop,70,70,0,1,0,1,0
52358,30188,0,0,deny,66,66,0,1,0,1,0
3792,52700,0,0,deny,62,62,0,1,0,1,0
54534,443,41952,443,allow,7153,2581,4572,28,74,15,13
64616,445,0,0,drop,70,70,0,1,0,1,0
61788,445,0,0,drop,70,70,0,1,0,1,0
37672,5223,15708,5223,allow,110,110,0,1,5,1,0
64312,53,26634,53,allow,202,103,99,2,31,1,1
25209,53,25209,53,allow,240,98,142,2,30,1,1
57604,443,23765,443,allow,2614,1689,925,18,21,10,8
49525,445,0,0,drop,70,70,0,1,0,1,0
25973,26467,0,0,deny,66,66,0,1,0,1,0
49781,53,14753,53,allow,194,102,92,2,30,1,1
45120,15000,54128,15000,allow,130,70,60,2,6,1,1
50572,445,0,0,drop,70,70,0,1,0,1,0
35514,80,18032,80,allow,841,715,126,5,14,3,2
54600,6881,0,0,deny,66,66,0,1,0,1,0
64823,53,51719,53,allow,199,102,97,2,30,1,1
43357,443,31552,443,allow,6392,1099,5293,18,33,10,8
6882,6889,29221,6889,allow,221,111,110,2,1201,1,1
64899,53,42372,53,allow,767,102,665,2,29,1,1
19068,37965,0,0,deny,62,62,0,1,0,1,0
34312,80,11906,80,allow,874,500,374,10,14,6,4
40214,443,5611,443,allow,3910,2223,1687,24,3676,8,16
57985,445,0,0,drop,70,70,0,1,0,1,0
50825,443,14787,443,allow,6601,1120,5481,17,116,9,8
52015,25487,39642,25487,allow,70,70,0,1,5,1,0
55877,47528,12404,47528,allow,491,150,341,2,1200,1,1
57486,80,57486,80,allow,1248,535,713,10,20,5,5
9731,64147,0,0,deny,62,62,0,1,0,1,0
62988,60038,0,0,allow,66,66,0,1,90,1,0
9435,443,2463,443,allow,5693,499,5194,14,15,7,7
10914,35974,0,0,deny,60,60,0,1,0,1,0
49633,53,37557,53,allow,210,102,108,2,30,1,1
58941,445,0,0,drop,70,70,0,1,0,1,0
62387,445,0,0,drop,70,70,0,1,0,1,0
54902,445,0,0,drop,66,66,0,1,0,1,0
56127,35440,0,0,deny,62,62,0,1,0,1,0
54263,445,0,0,drop,66,66,0,1,0,1,0
53161,30013,6313,30013,allow,70,70,0,2,7,2,0
42957,64147,0,0,deny,145,145,0,1,0,1,0
42223,67,0,0,deny,60,60,0,1,0,1,0
10079,443,27678,443,allow,7122,1766,5356,27,331,14,13
55871,53,0,0,allow,82,82,0,1,31,1,0
49718,80,57630,80,allow,11291,1348,9943,17,131,6,11
50265,53606,10997,53606,allow,528,528,0,9,1200,9,0
33525,53,23050,53,allow,168,78,90,2,31,1,1
48258,37965,0,0,deny,62,62,0,1,0,1,0
49483,53,61034,53,allow,319,94,225,2,29,1,1
64474,445,0,0,drop,70,70,0,1,0,1,0
60381,443,9520,443,allow,24271,17315,6956,53,107,34,19
50090,50265,0,0,deny,62,62,0,1,0,1,0
22541,64147,0,0,deny,66,66,0,1,0,1,0
55826,53,30050,53,allow,86,86,0,1,31,1,0
56038,53,24286,53,allow,177,94,83,2,30,1,1
64281,53,18314,53,allow,212,108,104,2,30,1,1
9246,35440,0,0,deny,66,66,0,1,0,1,0
55964,445,0,0,drop,70,70,0,1,0,1,0
9226,57470,0,0,deny,66,66,0,1,0,1,0
52060,29868,29510,29868,allow,70,70,0,1,5,1,0
51234,443,8944,443,allow,31736,1463,30273,43,32,14,29
64547,445,0,0,drop,66,66,0,1,0,1,0
55088,53,51001,53,allow,177,94,83,2,29,1,1
13160,53,13160,53,allow,198,89,109,2,31,1,1
21034,50265,0,0,deny,66,66,0,1,0,1,0
61078,445,0,0,drop,66,66,0,1,0,1,0
53479,445,0,0,drop,66,66,0,1,0,1,0
49209,53,10202,53,allow,198,101,97,2,31,1,1
54142,20541,0,0,deny,66,66,0,1,0,1,0
61689,443,8639,443,allow,8036,3293,4743,32,48,18,14
6881,6881,46331,6881,allow,259,150,109,2,1201,1,1
53968,445,0,0,drop,66,66,0,1,0,1,0
51329,443,55771,443,allow,2019,1219,800,15,17,8,7
50339,445,0,0,drop,66,66,0,1,0,1,0
23197,44847,0,0,deny,62,62,0,1,0,1,0
58421,30188,0,0,deny,66,66,0,1,0,1,0
49411,53,5629,53,allow,764,99,665,2,31,1,1
58638,5900,0,0,deny,62,62,0,1,0,1,0
51815,51221,0,0,deny,74,74,0,1,0,1,0
56747,443,3267,443,allow,19030,7323,11707,51,122,23,28
22835,51221,0,0,deny,62,62,0,1,0,1,0
39803,443,33160,443,allow,1701571,69958,1631613,1930,170,782,1148
58888,445,0,0,drop,70,70,0,1,0,1,0
42110,80,55658,80,allow,1056,682,374,10,15,6,4
56563,445,0,0,drop,66,66,0,1,0,1,0
36688,443,22490,443,allow,86101,7312,78789,145,128,63,82
42355,443,21738,443,allow,4181,998,3183,14,26,7,7
38654,443,36804,443,allow,9144,1783,7361,19,16,10,9
49918,53,24031,53,allow,196,100,96,2,31,1,1
64571,443,18253,443,allow,9155,2109,7046,27,31,15,12
64190,445,0,0,drop,70,70,0,1,0,1,0
59838,445,0,0,drop,66,66,0,1,0,1,0
55746,53,40664,53,allow,216,110,106,2,30,1,1
21704,16933,0,0,deny,62,62,0,1,0,1,0
57647,80,36132,80,allow,1530,1216,314,10,15,5,5
34990,80,36946,80,allow,1534,996,538,10,35,6,4
60350,443,44026,443,allow,5242,861,4381,17,16,9,8
54492,80,36549,80,allow,1384,937,447,9,360,5,4
54531,445,0,0,drop,70,70,0,1,0,1,0
51726,3389,51726,3389,allow,3444,1730,1714,16,33,8,8
61497,445,0,0,drop,70,70,0,1,0,1,0
59535,25174,0,0,deny,146,146,0,1,0,1,0
53788,53,27955,53,allow,213,78,135,2,30,1,1
58509,21247,0,0,deny,66,66,0,1,0,1,0
59486,53,24146,53,allow,316,86,230,2,29,1,1
37712,443,12957,443,allow,7660,2239,5421,32,255,16,16
49751,53,48975,53,allow,232,92,140,2,30,1,1
62919,993,20862,993,allow,134,60,74,3,11,2,1
60777,445,0,0,drop,66,66,0,1,0,1,0
11585,56205,0,0,deny,62,62,0,1,0,1,0
12318,41864,0,0,deny,139,139,0,1,0,1,0
56406,53,47759,53,allow,749,89,660,2,30,1,1
57366,445,0,0,drop,70,70,0,1,0,1,0
49224,53,4375,53,allow,199,102,97,2,32,1,1
1111,25174,0,0,deny,62,62,0,1,0,1,0
49771,53,61386,53,allow,86,86,0,1,30,1,0
57643,28189,0,0,deny,60,60,0,1,0,1,0
42231,57470,0,0,deny,78,78,0,1,0,1,0
55704,53,24414,53,allow,170,87,83,2,30,1,1
33252,443,7874,443,allow,89817,21083,68734,148,36,77,71
59828,53,0,0,allow,275,75,200,2,30,1,1
53160,25174,0,0,deny,62,62,0,1,0,1,0
49763,443,47715,443,allow,12767,8343,4424,31,122,17,14
23353,25174,0,0,deny,62,62,0,1,0,1,0
65398,53,64087,53,allow,811,94,717,2,29,1,1
50478,445,0,0,drop,66,66,0,1,0,1,0
49918,53,55343,53,allow,396,88,308,4,59,2,2
49944,53,37550,53,allow,196,102,94,2,30,1,1
50045,443,55393,443,allow,5661,1526,4135,22,85,12,10
51070,445,0,0,drop,70,70,0,1,0,1,0
64390,53,22708,53,allow,225,110,115,2,30,1,1
27005,37569,49792,37569,allow,892,126,766,2,30,1,1
56489,443,54085,443,allow,75930,4291,71639,90,120,32,58
49599,80,35878,80,allow,312,192,120,6,41,4,2
52093,445,0,0,drop,70,70,0,1,0,1,0
58889,443,61172,443,allow,3956,2519,1437,18,80,10,8
49268,445,0,0,drop,70,70,0,1,0,1,0
54229,443,56153,443,allow,499,425,74,4,0,3,1
49898,53,13665,53,allow,184,94,90,2,30,1,1
55796,53,15761,53,allow,196,102,94,2,31,1,1
56588,53,8372,53,allow,197,102,95,2,30,1,1
59613,443,9064,443,allow,10366,4530,5836,21,135,10,11
50276,5223,4771,5223,allow,552,280,272,9,16,5,4
7067,22114,0,0,deny,146,146,0,1,0,1,0
53839,15000,61295,15000,allow,130,70,60,2,5,1,1
43661,443,21697,443,allow,11255,7612,3643,36,248,19,17
29922,2750,0,0,deny,145,145,0,1,0,1,0
52176,445,0,0,drop,70,70,0,1,0,1,0
65533,445,0,0,drop,66,66,0,1,0,1,0
51676,23718,0,0,deny,66,66,0,1,0,1,0
41269,443,9096,443,allow,78,78,0,1,5,1,0
46285,443,49897,443,allow,36209,28887,7322,65,364,34,31
51329,445,0,0,drop,70,70,0,1,0,1,0
54828,445,0,0,drop,70,70,0,1,0,1,0
36851,53,52640,53,allow,404,261,143,3,30,2,1
55081,443,63191,443,allow,19866,7188,12678,18,151,7,11
64114,53,8208,53,allow,251,102,149,2,30,1,1
54360,445,0,0,drop,70,70,0,1,0,1,0
56869,17637,0,0,deny,66,66,0,1,0,1,0
1025,46232,0,0,deny,145,145,0,1,0,1,0
61714,443,30943,443,allow,134,60,74,3,10,2,1
51913,52188,11778,52188,allow,70,70,0,2,8,2,0
65397,443,12248,443,allow,2494,1643,851,17,25,9,8
56994,53,19050,53,allow,177,94,83,2,30,1,1
58638,5900,0,0,deny,62,62,0,1,0,1,0
64627,53,53750,53,allow,305,101,204,4,44,2,2
55963,443,55963,443,allow,8882,1866,7016,24,148,13,11
49492,53,11177,53,allow,198,101,97,2,31,1,1
50582,445,0,0,drop,70,70,0,1,0,1,0
58638,5900,0,0,deny,62,62,0,1,0,1,0
58958,445,0,0,drop,70,70,0,1,0,1,0
56830,53,35063,53,allow,752,93,659,2,30,1,1
53954,57868,45044,57868,allow,70,70,0,2,8,2,0
61280,26467,0,0,deny,62,62,0,1,0,1,0
26900,27017,35355,27017,allow,422,164,258,6,30,3,3
22751,53,22751,53,allow,235,90,145,2,32,1,1
13285,29892,0,0,deny,145,145,0,1,0,1,0
61216,445,0,0,drop,70,70,0,1,0,1,0
55445,53,8991,53,allow,102,102,0,1,30,1,0
55703,445,0,0,drop,70,70,0,1,0,1,0
53595,445,0,0,drop,70,70,0,1,0,1,0
50002,53,41135,53,allow,196,102,94,2,30,1,1
34355,80,5779,80,allow,416,210,206,7,15,4,3
64890,53,13860,53,allow,210,110,100,2,30,1,1
64353,445,0,0,drop,66,66,0,1,0,1,0
47637,443,16997,443,allow,280,140,140,5,151,3,2
49631,443,24213,443,allow,6304,1793,4511,29,255,15,14
49669,443,57280,443,allow,6911,897,6014,22,28,10,12
31066,57470,0,0,deny,74,74,0,1,0,1,0
56846,53,45229,53,allow,196,102,94,2,30,1,1
64044,445,0,0,drop,70,70,0,1,0,1,0
55211,445,0,0,drop,70,70,0,1,0,1,0
33555,443,31836,443,allow,10856,3151,7705,34,361,16,18
51478,445,0,0,drop,70,70,0,1,0,1,0
56873,53,37492,53,allow,184,94,90,2,30,1,1
53619,443,9096,443,allow,24190,18242,5948,43,330,25,18
50650,80,8138,80,allow,129929,6216,123713,164,21,74,90
51244,50432,0,0,deny,100,100,0,1,0,1,0
59297,80,59297,80,allow,107500,4003,103497,173,16,57,116
49755,443,49571,443,allow,447301,17016,430285,539,128,196,343
51900,80,40398,80,allow,366,240,126,7,29,5,2
60337,445,0,0,drop,70,70,0,1,0,1,0
61827,5223,22031,5223,allow,10784,5831,4953,33,521,15,18
49599,53,2987,53,allow,732,86,646,2,29,1,1
61465,445,0,0,drop,70,70,0,1,0,1,0
63385,25174,0,0,deny,66,66,0,1,0,1,0
51155,443,7506,443,allow,8351,2366,5985,41,185,20,21
50495,53,56662,53,allow,195,102,93,2,30,1,1
57167,445,0,0,drop,70,70,0,1,0,1,0
53562,8999,49942,8999,allow,320,140,180,6,6,3,3
50052,65008,0,0,deny,60,60,0,1,0,1,0
49193,443,7514,443,allow,3283,665,2618,16,160,7,9
50791,445,0,0,drop,70,70,0,1,0,1,0
55099,445,0,0,drop,66,66,0,1,0,1,0
37965,58609,35622,58609,allow,15544,7978,7566,132,3153,72,60
63867,43618,62706,43618,allow,66,66,0,2,7,2,0
49913,445,0,0,drop,70,70,0,1,0,1,0
12060,37965,0,0,deny,66,66,0,1,0,1,0
43274,443,35686,443,allow,6645,1668,4977,21,31,12,9
51976,443,42576,443,allow,2466,1497,969,21,46,12,9
21492,51505,0,0,deny,62,62,0,1,0,1,0
33886,52255,0,0,deny,162,162,0,1,0,1,0
48724,443,22721,443,allow,4371,2036,2335,18,24,10,8
58450,445,0,0,drop,66,66,0,1,0,1,0
55101,53,1606,53,allow,197,102,95,2,30,1,1
50648,445,0,0,drop,70,70,0,1,0,1,0
54829,445,0,0,drop,66,66,0,1,0,1,0
55372,53,13857,53,allow,271,93,178,4,42,2,2
17205,41864,0,0,deny,143,143,0,1,0,1,0
44388,63874,0,0,deny,66,66,0,1,0,1,0
56816,80,41001,80,allow,420340,15216,405124,441,376,163,278
53032,445,0,0,drop,70,70,0,1,0,1,0
56785,443,18418,443,allow,288525,15601,272924,383,33,193,190
46864,25174,0,0,deny,146,146,0,1,0,1,0
56844,44445,50438,44445,allow,70,70,0,1,5,1,0
59610,445,0,0,drop,70,70,0,1,0,1,0
56663,53,10723,53,allow,181,94,87,2,33,1,1
55961,53,7584,53,allow,214,102,112,2,30,1,1
57395,53,57395,53,allow,208,82,126,2,30,1,1
49692,53,30173,53,allow,212,110,102,2,30,1,1
54612,443,39989,443,allow,6110,857,5253,17,16,9,8
56671,443,62348,443,allow,8300,3581,4719,25,19,15,10
58638,5900,0,0,deny,62,62,0,1,0,1,0
4960,53,26982,53,allow,222,86,136,2,30,1,1
54948,443,58033,443,allow,493685,14728,478957,612,316,213,399
49434,53,25380,53,allow,183,86,97,2,29,1,1
62003,445,0,0,drop,70,70,0,1,0,1,0
42860,80,52081,80,allow,1346,842,504,13,123,8,5
42344,48637,0,0,deny,60,60,0,1,0,1,0
63074,445,0,0,drop,70,70,0,1,0,1,0
10669,49756,0,0,deny,60,60,0,1,0,1,0
60800,40010,5284,40010,allow,316,136,180,6,5,3,3
58638,5900,58638,5900,allow,62,62,0,1,5,1,0
33359,30188,0,0,deny,62,62,0,1,0,1,0
53771,37965,0,0,deny,66,66,0,1,0,1,0
26229,21247,0,0,deny,66,66,0,1,0,1,0
26900,27017,55012,27017,allow,422,164,258,6,30,3,3
52711,443,64979,443,allow,107997,3957,104040,135,80,51,84
39548,8696,0,0,deny,60,60,0,1,0,1,0
57741,445,0,0,drop,70,70,0,1,0,1,0
53624,7370,12914,7370,allow,70,70,0,2,8,2,0
50703,80,64252,80,allow,1082,896,186,18,214,15,3
54071,445,0,0,drop,70,70,0,1,0,1,0
60869,48817,0,0,deny,66,66,0,1,0,1,0
49620,443,27552,443,allow,13241,2865,10376,60,242,26,34
64637,53,26983,53,allow,194,102,92,2,31,1,1
54888,445,0,0,drop,66,66,0,1,0,1,0
56192,53,60489,53,allow,177,94,83,2,31,1,1
2267,53,32396,53,allow,204,118,86,2,30,1,1
49825,53,46479,53,allow,793,101,692,2,30,1,1
53237,443,53237,443,allow,1210,637,573,14,34,7,7
49354,443,56660,443,allow,4379,2565,1814,24,81,11,13
53883,443,37691,443,allow,495,421,74,4,0,3,1
64073,53,37819,53,allow,520,211,309,6,39,3,3
26900,27017,22133,27017,allow,422,164,258,6,30,3,3
16660,55783,0,0,deny,62,62,0,1,0,1,0
59935,445,0,0,drop,66,66,0,1,0,1,0
53663,17904,16406,17904,allow,320,140,180,6,7,3,3
55419,445,0,0,drop,66,66,0,1,0,1,0
57445,66,60334,66,allow,70,70,0,1,5,1,0
52903,443,59181,443,allow,3478,1580,1898,21,31,12,9
49539,443,38043,443,allow,5106,1861,3245,21,143,10,11
53004,80,58597,80,allow,9956,2570,7386,21,335,10,11
64516,53,9042,53,allow,216,110,106,2,30,1,1
0,0,0,0,allow,480,244,236,4,0,2,2
63126,445,0,0,drop,70,70,0,1,0,1,0
57268,445,0,0,drop,70,70,0,1,0,1,0
7246,59858,0,0,deny,66,66,0,1,0,1,0
30046,15503,0,0,deny,62,62,0,1,0,1,0
55879,53,9895,53,allow,184,94,90,2,29,1,1
56597,80,61984,80,allow,234,234,0,4,12,4,0
50382,445,0,0,drop,70,70,0,1,0,1,0
65107,53,20258,53,allow,266,87,179,4,32,2,2
56805,443,33799,443,allow,8022,2002,6020,20,15,11,9
64816,53,50363,53,allow,166,86,80,2,30,1,1
61714,443,1566,443,allow,2484,330,2154,12,135,5,7
64029,38651,56654,38651,allow,66,66,0,2,7,2,0
39531,19473,0,0,deny,62,62,0,1,0,1,0
57669,445,0,0,drop,70,70,0,1,0,1,0
47866,53,1378,53,allow,199,94,105,2,30,1,1
56772,53,9066,53,allow,168,86,82,2,30,1,1
57066,53,30352,53,allow,197,94,103,2,30,1,1
56290,53,40983,53,allow,716,95,621,2,31,1,1
61913,445,0,0,drop,70,70,0,1,0,1,0
28875,51505,0,0,deny,146,146,0,1,0,1,0
52797,443,22094,443,allow,8355,1923,6432,32,16,18,14
9304,443,28860,443,allow,3922,552,3370,16,16,8,8
5588,5588,0,0,allow,3354,1792,1562,46,195,23,23
61128,445,0,0,drop,70,70,0,1,0,1,0
63046,443,63046,443,allow,4419,1512,2907,19,30,11,8
64899,53,35861,53,allow,198,101,97,2,30,1,1
57350,53,19217,53,allow,771,101,670,2,31,1,1
39821,443,37984,443,allow,11179,7205,3974,47,136,26,21
56397,53,11047,53,allow,179,94,85,2,30,1,1
56743,53,46707,53,allow,209,110,99,2,30,1,1
55869,53,59798,53,allow,192,98,94,2,30,1,1
2681,48817,0,0,deny,146,146,0,1,0,1,0
60248,46776,0,0,deny,66,66,0,1,0,1,0
51731,39392,6820,39392,allow,70,70,0,2,8,2,0
56067,53,20488,53,allow,189,102,87,2,30,1,1
51964,80,61928,80,allow,306,120,186,6,25,3,3
46367,36237,0,0,deny,66,66,0,1,0,1,0
49659,80,54132,80,allow,1937,885,1052,13,42,7,6
30960,45665,23931,45665,allow,462,462,0,8,3632,8,0
49914,53,31140,53,allow,215,86,129,2,30,1,1
60312,57470,0,0,deny,74,74,0,1,0,1,0
9237,80,59192,80,allow,378,192,186,7,26,4,3
53244,53,53244,53,allow,217,82,135,2,32,1,1
51782,445,0,0,drop,66,66,0,1,0,1,0
64093,53,55556,53,allow,213,94,119,2,30,1,1
61912,17546,0,0,deny,66,66,0,1,0,1,0
60136,443,22877,443,allow,3647,1221,2426,13,135,6,7
43039,53,27551,53,allow,168,78,90,2,29,1,1
58638,5900,0,0,deny,62,62,0,1,0,1,0
50276,443,53649,443,allow,9984,2917,7067,49,102,28,21
63963,53,20929,53,allow,262,86,176,4,46,2,2
55206,22114,0,0,deny,66,66,0,1,0,1,0
49415,443,37841,443,allow,9623,3235,6388,33,118,18,15
50070,443,16090,443,allow,9148,1570,7578,31,257,13,18
50271,445,0,0,drop,70,70,0,1,0,1,0
1865,25174,0,0,deny,146,146,0,1,0,1,0
63906,36909,1381,36909,allow,70,70,0,1,4,1,0
55626,53,3780,53,allow,319,126,193,2,29,1,1
65056,53,43061,53,allow,211,102,109,2,30,1,1
59213,25174,0,0,deny,66,66,0,1,0,1,0
58638,5900,0,0,deny,62,62,0,1,0,1,0
34086,25174,0,0,deny,66,66,0,1,0,1,0
58420,53,57046,53,allow,351,78,273,2,29,1,1
11821,64147,0,0,deny,62,62,0,1,0,1,0
64533,53,56786,53,allow,183,102,81,2,29,1,1
51125,445,0,0,drop,66,66,0,1,0,1,0
38776,25174,0,0,deny,146,146,0,1,0,1,0
57470,3800,54639,3800,allow,150,150,0,1,1199,1,0
42993,443,7986,443,allow,10692,4532,6160,31,134,16,15
64585,80,64585,80,allow,405673,21057,384616,519,26,252,267
36727,443,3578,443,allow,27009,7414,19595,46,122,21,25
58201,445,0,0,drop,66,66,0,1,0,1,0
52190,443,16680,443,allow,7942,870,7072,22,15,10,12
55437,443,17546,443,allow,6622,859,5763,18,15,10,8
68,67,0,0,deny,346,346,0,1,0,1,0
57429,443,7406,443,allow,15017,8283,6734,47,18,24,23
63474,48817,0,0,deny,62,62,0,1,0,1,0
65452,445,0,0,drop,66,66,0,1,0,1,0
56672,53,28150,53,allow,199,102,97,2,30,1,1
45035,80,33169,80,allow,3720,1663,2057,17,186,10,7
55446,443,18400,443,allow,165191,6141,159050,184,30,67,117
61677,445,0,0,drop,66,66,0,1,0,1,0
64911,53,65363,53,allow,232,86,146,2,30,1,1
53527,5228,55667,5228,allow,9674,1776,7898,29,3764,11,18
61077,443,19799,443,allow,4970,2272,2698,12,121,6,6
42076,443,63627,443,allow,22106,5214,16892,23,128,9,14
57115,53,44854,53,allow,728,102,626,2,30,1,1
46451,443,47700,443,allow,350492,17722,332770,449,125,169,280
65354,53,12903,53,allow,168,86,82,2,30,1,1
51813,63933,50803,63933,allow,70,70,0,2,8,2,0
51610,445,0,0,drop,70,70,0,1,0,1,0
55556,53,12940,53,allow,302,78,224,2,30,1,1
61373,445,0,0,drop,70,70,0,1,0,1,0
6882,3800,7427,3800,allow,150,150,0,2,1201,2,0
57613,42707,0,0,deny,66,66,0,1,0,1,0
56895,445,0,0,drop,66,66,0,1,0,1,0
55826,53,63992,53,allow,168,86,82,2,30,1,1
62455,443,9859,443,allow,8302,2895,5407,22,25,11,11
42632,44847,0,0,deny,62,62,0,1,0,1,0
57240,53,54621,53,allow,180,94,86,2,30,1,1
49997,53,52835,53,allow,418,75,343,2,31,1,1
55877,39578,13811,39578,allow,150,150,0,1,1200,1,0
65212,53,6232,53,allow,196,102,94,2,31,1,1
55590,53,49633,53,allow,177,94,83,2,29,1,1
52734,445,0,0,drop,70,70,0,1,0,1,0
62184,443,42085,443,allow,4283,2038,2245,14,135,7,7
56704,53,19637,53,allow,188,96,92,2,31,1,1
55517,443,55517,443,allow,274414,45529,228885,359,170,186,173
44334,26467,0,0,deny,62,62,0,1,0,1,0
35967,443,11420,443,allow,3870,1743,2127,13,120,6,7
56643,443,30724,443,allow,8167,1980,6187,22,80,12,10
1117,37965,0,0,deny,62,62,0,1,0,1,0
44983,443,63267,443,allow,4991,3096,1895,22,220,13,9
27005,27016,48849,27016,allow,1688,126,1562,4,31,2,2
64999,53,64999,53,allow,230,90,140,2,30,1,1
51440,445,0,0,drop,66,66,0,1,0,1,0
2079,7000,2079,7000,allow,3102,1551,1551,16,16,8,8
54510,445,0,0,drop,70,70,0,1,0,1,0
51716,57137,62764,57137,allow,70,70,0,2,8,2,0
55513,53,5223,53,allow,184,94,90,2,30,1,1
55406,53,15179,53,allow,768,99,669,2,30,1,1
63194,50265,0,0,deny,66,66,0,1,0,1,0
65040,53,11010,53,allow,178,94,84,2,29,1,1
45454,80,45454,80,allow,42171,1901,40270,57,16,26,31
18653,42707,0,0,deny,66,66,0,1,0,1,0
53214,445,0,0,drop,70,70,0,1,0,1,0
56469,445,0,0,drop,70,70,0,1,0,1,0
57470,65534,12773,65534,allow,773,271,502,4,1200,2,2
49566,443,36540,443,allow,10225,5069,5156,30,106,17,13
49521,53,30278,53,allow,183,94,89,2,30,1,1
55326,53,27995,53,allow,177,94,83,2,30,1,1
49418,27222,49485,27222,allow,245,78,167,2,30,1,1
50920,60182,0,0,deny,66,66,0,1,0,1,0
1880,57470,0,0,deny,146,146,0,1,0,1,0
50277,443,12688,443,allow,3937,1191,2746,20,163,9,11
52015,80,59849,80,allow,14830,11044,3786,27,37,15,12
64283,37965,0,0,deny,74,74,0,1,0,1,0
64632,445,0,0,drop,66,66,0,1,0,1,0
49160,6889,21794,6889,allow,311,311,0,3,1200,3,0
58281,53,0,0,allow,82,82,0,2,40,2,0
38537,443,38537,443,allow,4662,1755,2907,19,30,11,8
55010,53,1751,53,allow,245,94,151,2,29,1,1
53815,445,0,0,drop,70,70,0,1,0,1,0
24480,35440,0,0,deny,62,62,0,1,0,1,0
55072,445,0,0,drop,70,70,0,1,0,1,0
64388,53,41426,53,allow,258,110,148,2,30,1,1
64989,53,14791,53,allow,756,95,661,2,31,1,1
54365,445,0,0,drop,70,70,0,1,0,1,0
19008,31652,0,0,allow,74,74,0,1,91,1,0
49566,80,39778,80,allow,10134,1142,8992,24,46,12,12
50302,443,11942,443,allow,11313,2617,8696,27,47,15,12
49408,443,47633,443,allow,4728,2928,1800,28,95,15,13
11859,64147,0,0,deny,62,62,0,1,0,1,0
51966,80,49895,80,allow,366,240,126,7,25,5,2
38317,443,31937,443,allow,9834,4297,5537,26,326,12,14
52146,1433,0,0,deny,60,60,0,1,0,1,0
45726,443,49906,443,allow,3068,1678,1390,17,242,9,8
62218,53,62218,53,allow,253,99,154,2,33,1,1
63331,51221,0,0,deny,62,62,0,1,0,1,0
64438,53,41293,53,allow,184,94,90,2,31,1,1
3074,64147,0,0,deny,62,62,0,1,0,1,0
6881,43642,35387,43642,allow,150,150,0,1,1201,1,0
1024,44847,0,0,deny,62,62,0,1,0,1,0
65225,53,58694,53,allow,199,102,97,2,30,1,1
55771,53,45760,53,allow,283,98,185,4,51,2,2
48676,53399,0,0,deny,60,60,0,1,0,1,0
51574,443,46080,443,allow,400,70,330,6,25,1,5
9084,53,9084,53,allow,224,88,136,2,30,1,1
42342,443,63705,443,allow,494,198,296,8,17,4,4
31974,51505,0,0,deny,66,66,0,1,0,1,0
63310,445,0,0,drop,66,66,0,1,0,1,0
8023,64147,0,0,deny,146,146,0,1,0,1,0
32909,443,28727,443,allow,160821,7879,152942,201,141,88,113
47962,16069,0,0,deny,62,62,0,1,0,1,0
36548,25174,0,0,deny,62,62,0,1,0,1,0
50584,445,0,0,drop,70,70,0,1,0,1,0
49999,53,5056,53,allow,178,91,87,2,31,1,1
40216,50265,0,0,deny,62,62,0,1,0,1,0
8239,37965,0,0,deny,146,146,0,1,0,1,0
38637,22,0,0,deny,60,60,0,1,0,1,0
49420,53,37701,53,allow,185,102,83,2,30,1,1
9377,56205,0,0,deny,66,66,0,1,0,1,0
53900,45682,23799,45682,allow,492,306,186,8,15,5,3
58799,445,0,0,drop,70,70,0,1,0,1,0
62524,123,21935,123,allow,184,94,90,2,31,1,1
61426,64910,0,0,deny,66,66,0,1,0,1,0
14694,443,0,0,deny,60,60,0,1,0,1,0
57346,53,23622,53,allow,210,110,100,2,29,1,1
55126,53,24901,53,allow,186,95,91,2,31,1,1
23824,80,23824,80,allow,24232,4550,19682,59,17,34,25
63985,53,11526,53,allow,351,103,248,4,46,2,2
55367,445,0,0,drop,66,66,0,1,0,1,0
58921,443,58921,443,allow,4627,1720,2907,19,28,11,8
58991,443,64156,443,allow,972647,20727,951920,916,263,245,671
50289,80,7131,80,allow,7166,1086,6080,18,87,9,9
50864,80,3838,80,allow,1888,1814,74,10,15,9,1
50992,443,14898,443,allow,49212,42366,6846,109,147,59,50
4772,37965,0,0,deny,66,66,0,1,0,1,0
50584,80,65205,80,allow,1883,995,888,11,47,6,5
34440,53,34440,53,allow,235,90,145,2,32,1,1
45042,443,17332,443,allow,8445,2120,6325,27,107,15,12
56447,53,39784,53,allow,403,110,293,2,30,1,1
56495,53,46439,53,allow,199,102,97,2,30,1,1
52913,2767,0,0,deny,66,66,0,1,0,1,0
37602,443,57970,443,allow,573,425,148,5,0,3,2
64185,53,32210,53,allow,403,110,293,2,31,1,1
13027,64147,0,0,deny,62,62,0,1,0,1,0
57747,80,27520,80,allow,2754,1602,1152,17,22,9,8
50490,445,0,0,drop,66,66,0,1,0,1,0
34111,53,34111,53,allow,213,87,126,2,30,1,1
63965,53,54423,53,allow,180,94,86,2,31,1,1
65325,53,33633,53,allow,216,110,106,2,29,1,1
37322,53,64245,53,allow,168,78,90,2,31,1,1
57424,53,35431,53,allow,711,87,624,2,30,1,1
34001,53,36189,53,allow,225,78,147,2,30,1,1
11716,37965,0,0,deny,62,62,0,1,0,1,0
40103,443,24820,443,allow,161,101,60,2,5,1,1
27005,32066,2938,32066,allow,881,126,755,2,31,1,1
65451,53,62075,53,allow,194,102,92,2,30,1,1
51943,55464,52953,55464,allow,70,70,0,1,5,1,0
54207,443,5893,443,allow,4788,785,4003,15,70,8,7
64724,443,50877,443,allow,8602,1050,7552,16,121,7,9
55482,53,39470,53,allow,199,102,97,2,30,1,1
1026,30188,0,0,deny,146,146,0,1,0,1,0
54721,445,0,0,drop,70,70,0,1,0,1,0
65472,53,51115,53,allow,209,110,99,2,30,1,1
63991,53,7704,53,allow,186,95,91,2,31,1,1
53129,38413,48065,38413,allow,70,70,0,2,8,2,0
56876,30188,0,0,deny,62,62,0,1,0,1,0
5357,32468,0,0,deny,62,62,0,1,0,1,0
45726,64147,0,0,deny,62,62,0,1,0,1,0
64363,22114,0,0,deny,66,66,0,1,0,1,0
59785,445,0,0,drop,70,70,0,1,0,1,0
57441,53,7425,53,allow,177,94,83,2,30,1,1
5132,23,0,0,deny,60,60,0,1,0,1,0
55088,53,21749,53,allow,177,94,83,2,30,1,1
53086,445,0,0,drop,70,70,0,1,0,1,0
59048,57470,0,0,deny,66,66,0,1,0,1,0
43688,22114,0,0,deny,66,66,0,1,0,1,0
52203,80,56885,80,allow,432,246,186,7,40,4,3
64850,445,0,0,drop,70,70,0,1,0,1,0
6881,57470,0,0,deny,100,100,0,1,0,1,0
17811,23,0,0,deny,60,60,0,1,0,1,0
57470,15870,28583,15870,allow,149,149,0,2,1199,2,0
60000,1879,0,0,deny,145,145,0,1,0,1,0
64480,53,30625,53,allow,276,126,150,2,30,1,1
57648,443,58910,443,allow,35696,3196,32500,48,121,19,29
54358,445,0,0,drop,70,70,0,1,0,1,0
50283,443,2548,443,allow,49752,4187,45565,87,100,45,42
63952,53,32922,53,allow,211,110,101,2,29,1,1
34916,51185,0,0,deny,62,62,0,1,0,1,0
6881,26171,65454,26171,allow,219,118,101,2,1199,1,1
52040,53,52040,53,allow,251,98,153,2,31,1,1
9552,57470,0,0,deny,66,66,0,1,0,1,0
6881,6881,0,0,deny,146,146,0,1,0,1,0
57961,445,0,0,drop,70,70,0,1,0,1,0
45754,80,23823,80,allow,47137,10210,36927,80,477,38,42
58959,445,0,0,drop,70,70,0,1,0,1,0
49418,27080,21881,27080,allow,238,78,160,2,30,1,1
45232,80,45232,80,allow,2895,1484,1411,10,15,6,4
7166,64147,0,0,deny,66,66,0,1,0,1,0
50516,443,49495,443,allow,12855,2077,10778,30,78,15,15
64429,53,41917,53,allow,217,94,123,2,30,1,1
38566,443,54032,443,allow,4108,1272,2836,11,121,5,6
27005,27016,12661,27016,allow,879,126,753,2,30,1,1
53107,44060,63943,44060,allow,70,70,0,2,8,2,0
49397,53,28669,53,allow,365,94,271,2,30,1,1
42385,443,55838,443,allow,321621,14025,307596,408,41,185,223
52014,80,24294,80,allow,30427,2131,28296,66,32,25,41
58638,5900,0,0,deny,62,62,0,1,0,1,0
52263,445,0,0,drop,70,70,0,1,0,1,0
8282,39458,7982,39458,allow,78,78,0,1,30,1,0
1187,64147,0,0,deny,66,66,0,1,0,1,0
64333,57470,0,0,deny,78,78,0,1,0,1,0
2980,53,2980,53,allow,216,90,126,2,30,1,1
53668,80,20063,80,allow,1173,665,508,13,16,7,6
57303,445,0,0,drop,70,70,0,1,0,1,0
33444,53,33346,53,allow,168,78,90,2,30,1,1
49903,445,0,0,drop,66,66,0,1,0,1,0
59772,443,48331,443,allow,181413,11493,169920,167,85,41,126
65248,53,43627,53,allow,212,110,102,2,29,1,1
60400,56243,17811,56243,allow,70,70,0,1,5,1,0
43111,8080,0,0,deny,60,60,0,1,0,1,0
22404,443,22404,443,allow,5576,2436,3140,21,26,12,9
50678,445,0,0,drop,70,70,0,1,0,1,0
51732,445,0,0,drop,70,70,0,1,0,1,0
59919,445,0,0,drop,66,66,0,1,0,1,0
64299,53,64888,53,allow,166,86,80,2,29,1,1
55273,53,49246,53,allow,317,85,232,4,60,2,2
56293,53,1963,53,allow,166,86,80,2,30,1,1
31727,57470,0,0,deny,62,62,0,1,0,1,0
58526,445,0,0,drop,70,70,0,1,0,1,0
60778,445,0,0,drop,70,70,0,1,0,1,0
49418,27016,47902,27016,allow,245,78,167,2,30,1,1
50571,80,64124,80,allow,300,174,126,5,15,3,2
65366,53,12473,53,allow,199,102,97,2,30,1,1
33814,22114,0,0,deny,62,62,0,1,0,1,0
50691,443,45100,443,allow,152,86,66,2,6,1,1
60961,443,5669,443,allow,75122,4244,70878,101,45,48,53
62119,53,18352,53,allow,239,102,137,2,30,1,1
56738,80,55725,80,allow,1462,703,759,8,16,5,3
60665,443,60665,443,allow,5715,1432,4283,19,15,9,10
43155,35440,0,0,deny,66,66,0,1,0,1,0
51835,443,19929,443,allow,48635,5346,43289,83,151,38,45
52018,80,60048,80,allow,4988,2667,2321,15,38,10,5
55214,445,0,0,drop,70,70,0,1,0,1,0
52091,11392,0,0,deny,66,66,0,1,0,1,0
58396,22114,0,0,deny,66,66,0,1,0,1,0
57399,445,0,0,drop,70,70,0,1,0,1,0
62938,445,0,0,drop,70,70,0,1,0,1,0
50281,5223,28986,5223,allow,208,60,148,4,11,2,2
63486,51505,0,0,deny,66,66,0,1,0,1,0
41371,53,41371,53,allow,220,90,130,2,30,1,1
57591,80,57591,80,allow,144228,2522,141706,135,144,36,99
65012,32468,0,0,deny,66,66,0,1,0,1,0
59524,25174,0,0,deny,62,62,0,1,0,1,0
6881,6889,31599,6889,allow,221,111,110,2,1200,1,1
49708,53,64935,53,allow,178,94,84,2,30,1,1
50663,80,56397,80,allow,1366,865,501,8,15,5,3
53971,50265,0,0,deny,62,62,0,1,0,1,0
63203,445,0,0,drop,66,66,0,1,0,1,0
64585,53,62482,53,allow,821,102,719,2,30,1,1
60046,443,51072,443,allow,8241,2346,5895,18,136,8,10
64737,53,51522,53,allow,757,98,659,2,0,1,1
42121,53,52822,53,allow,199,94,105,2,31,1,1
50388,8080,50388,8080,allow,4417,2499,1918,18,56,10,8
62342,445,0,0,deny,66,66,0,1,0,1,0
56210,5228,6603,5228,allow,7061,1730,5331,21,3600,11,10
15585,64147,0,0,deny,62,62,0,1,0,1,0
55061,445,0,0,drop,66,66,0,1,0,1,0
25202,25174,0,0,deny,62,62,0,1,0,1,0
49816,443,49816,443,allow,4682,1775,2907,19,28,11,8
63852,35440,0,0,deny,66,66,0,1,0,1,0
53656,58624,54901,58624,allow,70,70,0,1,5,1,0
49825,53,56726,53,allow,168,86,82,2,30,1,1
56468,53,56108,53,allow,209,110,99,2,30,1,1
3068,36237,0,0,deny,62,62,0,1,0,1,0
11005,30188,0,0,deny,146,146,0,1,0,1,0
64749,53,28339,53,allow,199,94,105,2,33,1,1
31637,17348,0,0,deny,60,60,0,1,0,1,0
63748,445,0,0,drop,70,70,0,1,0,1,0
55310,50584,0,0,deny,66,66,0,1,0,1,0
64858,53,43430,53,allow,211,102,109,2,30,1,1
38671,443,56566,443,allow,90139,3545,86594,96,15,32,64
50240,445,0,0,drop,70,70,0,1,0,1,0
57956,445,0,0,drop,70,70,0,1,0,1,0
58043,80,57225,80,allow,378,192,186,7,20,4,3
56496,53,36684,53,allow,164,86,78,2,29,1,1
56426,53,19941,53,allow,184,94,90,2,31,1,1
59584,36237,0,0,deny,66,66,0,1,0,1,0
64939,445,0,0,drop,66,66,0,1,0,1,0
14185,48637,0,0,deny,60,60,0,1,0,1,0
53343,445,0,0,drop,70,70,0,1,0,1,0
25063,64147,0,0,deny,62,62,0,1,0,1,0
12074,10197,0,0,deny,72,72,0,1,0,1,0
49242,53,5506,53,allow,167,86,81,2,30,1,1
49635,445,0,0,drop,66,66,0,1,0,1,0
58524,445,0,0,drop,70,70,0,1,0,1,0
55213,445,0,0,drop,66,66,0,1,0,1,0
64757,52700,0,0,deny,62,62,0,1,0,1,0
56328,53,20002,53,allow,214,102,112,2,31,1,1
37965,22343,64266,22343,allow,1307,594,713,17,1657,10,7
63040,53,20975,53,allow,512,166,346,2,29,1,1
60807,443,39155,443,allow,9127,2506,6621,38,146,20,18
64940,36237,0,0,deny,62,62,0,1,0,1,0
52917,443,10403,443,allow,5583,1390,4193,19,14,9,10
54927,443,30686,443,allow,7148,1924,5224,35,364,19,16
56810,53,28804,53,allow,177,94,83,2,30,1,1
64985,53,37843,53,allow,194,102,92,2,30,1,1
55042,443,45406,443,allow,126,60,66,3,5,2,1
52719,445,0,0,drop,70,70,0,1,0,1,0
50404,8080,50404,8080,allow,11938,4533,7405,33,98,20,13
55640,53,50783,53,allow,742,88,654,2,31,1,1
3803,51505,0,0,deny,62,62,0,1,0,1,0
52064,80,49794,80,allow,2125,709,1416,11,16,5,6
59297,445,0,0,drop,70,70,0,1,0,1,0
44847,31381,18131,31381,allow,150,150,0,1,1200,1,0
55917,53,58501,53,allow,371,109,262,4,59,2,2
50197,445,0,0,drop,70,70,0,1,0,1,0
49723,443,63349,443,allow,6780,710,6070,16,50,7,9
37592,36829,0,0,deny,146,146,0,1,0,1,0
64255,53,15083,53,allow,260,86,174,2,30,1,1
56507,80,59986,80,allow,1583,712,871,10,136,6,4
53625,64147,0,0,deny,66,66,0,1,0,1,0
56560,53,3085,53,allow,199,102,97,2,30,1,1
38976,46824,0,0,deny,62,62,0,1,0,1,0
12226,37965,0,0,deny,62,62,0,1,0,1,0
61661,445,0,0,drop,70,70,0,1,0,1,0
65445,53,54616,53,allow,199,102,97,2,30,1,1
16387,56995,0,0,deny,60,60,0,1,0,1,0
56775,53,1038,53,allow,733,85,648,2,30,1,1
53034,53,25305,53,allow,238,94,144,2,30,1,1
58226,52848,0,0,deny,62,62,0,1,0,1,0
57319,443,43757,443,allow,134,60,74,3,5,2,1
40204,40016,4435,40016,allow,148,86,62,2,30,1,1
55636,445,0,0,drop,66,66,0,1,0,1,0
57396,443,49419,443,allow,362,302,60,2,5,1,1
18423,51505,0,0,deny,66,66,0,1,0,1,0
55582,53,5858,53,allow,177,94,83,2,30,1,1
60959,445,0,0,drop,70,70,0,1,0,1,0
51979,25174,0,0,deny,66,66,0,1,0,1,0
50345,53,41743,53,allow,193,102,91,2,30,1,1
56492,53,39207,53,allow,177,94,83,2,30,1,1
57235,53,31902,53,allow,210,102,108,2,30,1,1
65514,53,17473,53,allow,177,94,83,2,29,1,1
62311,443,60007,443,allow,4778,1121,3657,15,280,8,7
51413,25864,0,0,deny,72,72,0,1,0,1,0
2864,25174,0,0,deny,66,66,0,1,0,1,0
50281,53,8038,53,allow,195,102,93,2,30,1,1
55463,53,39462,53,allow,816,102,714,2,29,1,1
9092,26672,0,0,deny,60,60,0,1,0,1,0
55300,445,0,0,drop,70,70,0,1,0,1,0
49304,53,30791,53,allow,214,102,112,2,30,1,1
57017,445,0,0,drop,66,66,0,1,0,1,0
25091,64147,0,0,deny,66,66,0,1,0,1,0
61431,445,0,0,drop,70,70,0,1,0,1,0
62057,445,0,0,drop,70,70,0,1,0,1,0
64064,445,0,0,drop,66,66,0,1,0,1,0
64214,25174,0,0,deny,62,62,0,1,0,1,0
55264,53,44429,53,allow,177,94,83,2,30,1,1
64468,445,0,0,drop,70,70,0,1,0,1,0
63242,50584,0,0,deny,66,66,0,1,0,1,0
43461,35440,0,0,deny,146,146,0,1,0,1,0
63917,443,22910,443,allow,9043,5948,3095,31,121,15,16
13581,51505,0,0,deny,66,66,0,1,0,1,0
64618,53,46697,53,allow,196,100,96,2,31,1,1
54122,443,54122,443,allow,186718,24971,161747,253,84,127,126
57601,443,61546,443,allow,2614,1689,925,18,20,10,8
14696,42707,0,0,deny,62,62,0,1,0,1,0
51049,445,0,0,drop,70,70,0,1,0,1,0
59100,445,0,0,drop,70,70,0,1,0,1,0
54998,53,32757,53,allow,195,102,93,2,29,1,1
6666,5984,0,0,deny,60,60,0,1,0,1,0
39824,51505,0,0,deny,62,62,0,1,0,1,0
42298,40031,35344,40031,allow,1346,662,684,8,32,4,4
50583,80,64336,80,allow,630930,27504,603426,812,74,381,431
56766,41605,18996,41605,allow,1639,460,1179,8,30,4,4
59210,8168,0,0,deny,66,66,0,1,0,1,0
45941,23388,0,0,deny,60,60,0,1,0,1,0
33893,80,46490,80,allow,1376,788,588,10,23,6,4
50265,51413,14137,51413,allow,460,150,310,2,1200,1,1
59494,443,29596,443,allow,338,278,60,2,5,1,1
54958,443,14997,443,allow,6578,1571,5007,24,17,13,11
3270,35440,0,0,deny,62,62,0,1,0,1,0
60601,53,19741,53,allow,451,86,365,2,30,1,1
62617,443,37156,443,allow,3931,678,3253,15,140,6,9
5773,53,5773,53,allow,229,90,139,2,30,1,1
45455,443,59423,443,allow,17237,2632,14605,34,420,18,16
50586,80,48187,80,allow,6718,3126,3592,16,78,8,8
51908,443,56072,443,allow,8481,1976,6505,23,25,13,10
16618,52952,0,0,deny,146,146,0,1,0,1,0
30960,45673,1133,45673,allow,462,462,0,8,3633,8,0
49531,26467,0,0,deny,66,66,0,1,0,1,0
56922,53,63628,53,allow,168,86,82,2,31,1,1
2332,35440,0,0,deny,66,66,0,1,0,1,0
52175,1101,39473,1101,allow,70,70,0,2,8,2,0
50034,53,15680,53,allow,179,94,85,2,30,1,1
59752,443,56734,443,allow,2233,1237,996,18,75,9,9
58190,445,0,0,drop,70,70,0,1,0,1,0
56230,80,56230,80,allow,44881,949,43932,47,15,14,33
64763,445,0,0,drop,66,66,0,1,0,1,0
62208,37965,0,0,deny,66,66,0,1,0,1,0
62045,445,0,0,drop,70,70,0,1,0,1,0
55841,53,16397,53,allow,458,188,270,6,31,3,3
48909,5228,27859,5228,allow,11007,2491,8516,44,4411,18,26
61142,445,0,0,drop,66,66,0,1,0,1,0
51412,51505,0,0,deny,66,66,0,1,0,1,0
57368,7302,0,0,deny,66,66,0,1,0,1,0
59637,53,37515,53,allow,273,94,179,2,30,1,1
64539,53,12093,53,allow,177,94,83,2,30,1,1
61386,80,24052,80,allow,17583,1529,16054,30,255,16,14
58276,43890,0,0,deny,62,62,0,1,0,1,0
10126,57470,0,0,deny,62,62,0,1,0,1,0
64572,443,16176,443,allow,24918,2042,22876,40,16,19,21
56143,3389,56143,3389,allow,4365,2581,1784,20,32,11,9
57395,53,64683,53,allow,262,88,174,4,58,2,2
50265,6881,13047,6881,allow,491,150,341,2,1200,1,1
50006,80,59669,80,allow,2087,1159,928,10,86,6,4
48269,443,55381,443,allow,4800,3396,1404,19,60,10,9
17146,57470,0,0,deny,62,62,0,1,0,1,0
49546,53,5497,53,allow,212,110,102,2,30,1,1
64335,53,30399,53,allow,193,102,91,2,29,1,1
55628,53,5942,53,allow,821,102,719,2,30,1,1
59430,445,0,0,drop,70,70,0,1,0,1,0
65336,53,14965,53,allow,732,89,643,2,31,1,1
60293,80,44550,80,allow,1462,864,598,11,144,6,5
49320,53,28326,53,allow,185,102,83,2,30,1,1
10003,64147,0,0,deny,62,62,0,1,0,1,0
60973,443,19022,443,allow,398300,18473,379827,492,72,222,270
1138,57470,0,0,deny,146,146,0,1,0,1,0
63814,81,0,0,deny,60,60,0,1,0,1,0
51993,80,56681,80,allow,482,300,182,9,25,6,3
44933,26467,0,0,deny,62,62,0,1,0,1,0
50544,443,24381,443,allow,8592,1152,7440,25,150,13,12
57284,53,19677,53,allow,214,110,104,2,30,1,1
61879,53,34841,53,allow,207,86,121,2,29,1,1
52101,443,56883,443,allow,5706850,104758,5602092,5170,41,1379,3791
1026,64147,0,0,deny,145,145,0,1,0,1,0
63487,445,0,0,drop,70,70,0,1,0,1,0
50287,443,3897,443,allow,8247,2761,5486,36,99,19,17
56273,53,58204,53,allow,197,102,95,2,30,1,1
52160,1,0,0,deny,145,145,0,1,0,1,0
33453,64147,0,0,deny,62,62,0,1,0,1,0
51245,445,0,0,drop,66,66,0,1,0,1,0
56553,53,14002,53,allow,198,101,97,2,30,1,1
60486,8999,61783,8999,allow,70,70,0,2,8,2,0
54521,443,4685,443,allow,1574197,46737,1527460,1590,34,557,1033
56927,53,35589,53,allow,183,94,89,2,30,1,1
57348,25174,0,0,deny,62,62,0,1,0,1,0
51913,443,46255,443,allow,13337,10008,3329,47,185,23,24
26900,27017,38519,27017,allow,422,164,258,6,30,3,3
60347,80,6401,80,allow,2018,1704,314,16,15,11,5
56369,22114,0,0,deny,146,146,0,1,0,1,0
57470,6881,33137,6881,allow,792,792,0,13,1200,13,0
54656,443,58488,443,allow,6509,1635,4874,21,186,11,10
6057,51221,0,0,deny,62,62,0,1,0,1,0
56564,9571,0,0,deny,78,78,0,1,0,1,0
56979,53,50155,53,allow,180,94,86,2,29,1,1
62388,39004,0,0,deny,62,62,0,1,0,1,0
64237,51505,0,0,deny,66,66,0,1,0,1,0
55066,53,27707,53,allow,180,94,86,2,30,1,1
49735,443,35310,443,allow,6292,1682,4610,21,15,9,12
15313,34068,0,0,deny,146,146,0,1,0,1,0
443,60496,0,0,deny,320,320,0,1,0,1,0
63229,445,0,0,drop,70,70,0,1,0,1,0
58112,445,0,0,drop,70,70,0,1,0,1,0
58912,445,0,0,drop,70,70,0,1,0,1,0
42463,56205,0,0,deny,62,62,0,1,0,1,0
51794,80,29436,80,allow,5480,3236,2244,19,47,12,7
2978,48817,0,0,deny,66,66,0,1,0,1,0
49526,53,27945,53,allow,272,97,175,4,57,2,2
21189,53,21189,53,allow,374,240,134,3,32,2,1
63701,46824,0,0,deny,66,66,0,1,0,1,0
52095,56079,0,0,deny,66,66,0,1,0,1,0
56704,53,35730,53,allow,210,94,116,2,30,1,1
7246,59858,0,0,deny,66,66,0,1,0,1,0
44154,22114,0,0,deny,62,62,0,1,0,1,0
55655,53,10525,53,allow,304,110,194,4,34,2,2
57015,42707,0,0,deny,62,62,0,1,0,1,0
57749,15000,61462,15000,allow,130,70,60,2,6,1,1
50082,53,51299,53,allow,199,94,105,2,30,1,1
48941,443,29294,443,allow,7437,2128,5309,22,33,13,9
42798,26467,0,0,deny,62,62,0,1,0,1,0
33893,443,60654,443,allow,8623,1758,6865,36,28,17,19
34535,443,2952,443,allow,74325,3719,70606,98,200,44,54
55266,53,20409,53,allow,365,102,263,2,30,1,1
9742,80,9742,80,allow,1384,648,736,9,15,5,4
55164,53,9551,53,allow,170,87,83,2,31,1,1
63287,445,0,0,drop,66,66,0,1,0,1,0
3766,25174,0,0,deny,146,146,0,1,0,1,0
25739,64147,0,0,deny,62,62,0,1,0,1,0
36949,443,20544,443,allow,7474,1298,6176,25,81,11,14
52083,445,0,0,drop,70,70,0,1,0,1,0
65153,53,29688,53,allow,168,86,82,2,30,1,1
33814,22114,0,0,deny,62,62,0,1,0,1,0
37121,21247,0,0,deny,66,66,0,1,0,1,0
43868,23,0,0,deny,60,60,0,1,0,1,0
36697,443,4687,443,allow,21563,17259,4304,70,78,37,33
59814,443,30492,443,allow,1560,977,583,15,30,8,7
59179,80,14130,80,allow,1399,762,637,10,76,6,4
51424,30188,0,0,deny,62,62,0,1,0,1,0
49418,27015,12745,27015,allow,227,78,149,2,30,1,1
55761,445,0,0,drop,70,70,0,1,0,1,0
58638,5900,0,0,deny,62,62,0,1,0,1,0
47828,443,14141,443,allow,143399,8522,134877,208,153,101,107
64024,57470,0,0,deny,66,66,0,1,0,1,0
61950,445,0,0,drop,70,70,0,1,0,1,0
44721,443,28122,443,allow,24317,1518,22799,38,218,16,22
11235,30188,0,0,deny,66,66,0,1,0,1,0
50061,445,0,0,drop,70,70,0,1,0,1,0
63577,30188,0,0,deny,66,66,0,1,0,1,0
56291,445,0,0,drop,70,70,0,1,0,1,0
26900,27017,30659,27017,allow,168,82,86,2,30,1,1
56621,53,7810,53,allow,760,96,664,2,31,1,1
52091,11392,0,0,deny,62,62,0,1,0,1,0
53144,58987,43141,58987,allow,70,70,0,2,8,2,0
53676,445,0,0,drop,70,70,0,1,0,1,0
34349,25174,0,0,deny,146,146,0,1,0,1,0
54550,53,0,0,allow,188,86,102,2,29,1,1
65072,445,0,0,drop,70,70,0,1,0,1,0
50416,445,0,0,drop,66,66,0,1,0,1,0
50163,445,0,0,drop,70,70,0,1,0,1,0
57106,443,27171,443,allow,38893,31305,7588,107,101,55,52
56468,80,52689,80,allow,214,140,74,4,26,3,1
34808,22114,0,0,deny,62,62,0,1,0,1,0
52045,443,60420,443,allow,51604,4684,46920,70,133,28,42
57474,445,0,0,drop,66,66,0,1,0,1,0
53860,53,53860,53,allow,197,90,107,2,30,1,1
49421,5228,11226,5228,allow,8399,1901,6498,39,1562,16,23
64475,53,62342,53,allow,184,94,90,2,29,1,1
65270,3855,0,0,deny,78,78,0,1,0,1,0
54636,26467,0,0,deny,62,62,0,1,0,1,0
42119,36237,0,0,deny,66,66,0,1,0,1,0
52165,80,35107,80,allow,1945,1002,943,11,19,7,4
50486,443,8859,443,allow,5791,3692,2099,21,78,13,8
61273,443,55960,443,allow,19675,8597,11078,137,480,68,69
6486,64147,0,0,deny,66,66,0,1,0,1,0
53488,445,0,0,drop,70,70,0,1,0,1,0
45912,44847,0,0,deny,146,146,0,1,0,1,0
50414,443,29700,443,allow,1346,918,428,10,25,6,4
53051,44847,0,0,deny,66,66,0,1,0,1,0
34760,443,55387,443,allow,70,70,0,1,4,1,0
49232,53,52451,53,allow,242,78,164,2,29,1,1
65048,443,9174,443,allow,3283,1019,2264,10,120,5,5
59803,22114,0,0,deny,146,146,0,1,0,1,0
59703,445,0,0,drop,70,70,0,1,0,1,0
52089,16543,21777,16543,allow,70,70,0,2,9,2,0
11023,51505,0,0,deny,66,66,0,1,0,1,0
62333,443,30059,443,allow,3170,1556,1614,7,121,3,4
55503,53,56462,53,allow,216,110,106,2,30,1,1
3578,51505,0,0,deny,66,66,0,1,0,1,0
34325,443,18256,443,allow,2450,1451,999,19,315,10,9
63080,443,52084,443,allow,304,86,218,2,30,1,1
25237,25174,0,0,deny,146,146,0,1,0,1,0
64222,445,0,0,drop,70,70,0,1,0,1,0
62731,21247,0,0,deny,66,66,0,1,0,1,0
64882,445,0,0,drop,66,66,0,1,0,1,0
56644,53,3506,53,allow,199,94,105,2,30,1,1
63743,46081,6085,46081,allow,70,70,0,1,4,1,0
20409,23,0,0,deny,60,60,0,1,0,1,0
57347,443,57555,443,allow,1081375,19607,1061768,921,122,142,779
51954,80,41489,80,allow,18285,8756,9529,29,27,15,14
50427,443,32859,443,allow,783009,84254,698755,776,706,250,526
51972,80,28549,80,allow,7001170,112187,6888983,6101,29,1546,4555
50602,80,50602,80,allow,7596,5063,2533,28,27,16,12
58638,5900,0,0,deny,62,62,0,1,0,1,0
49723,445,0,0,drop,70,70,0,1,0,1,0
63364,57470,0,0,deny,62,62,0,1,0,1,0
38591,53,55685,53,allow,391,102,289,2,30,1,1
58558,53,58236,53,allow,268,86,182,2,30,1,1
51615,25174,0,0,deny,66,66,0,1,0,1,0
41840,50584,0,0,deny,66,66,0,1,0,1,0
60335,443,9738,443,allow,1853,1214,639,18,77,11,7
9109,443,23310,443,allow,4400,433,3967,12,15,6,6
49671,53,11585,53,allow,183,94,89,2,29,1,1
55877,53,16386,53,allow,164,84,80,2,30,1,1
56520,53,9113,53,allow,177,94,83,2,29,1,1
16862,21247,0,0,deny,62,62,0,1,0,1,0
53395,445,0,0,drop,66,66,0,1,0,1,0
26921,26467,0,0,deny,62,62,0,1,0,1,0
50391,80,25680,80,allow,2837,582,2255,12,17,7,5
64368,443,54903,443,allow,4741,1306,3435,26,300,14,12
56376,80,29400,80,allow,1635,945,690,15,72,8,7
60873,445,0,0,drop,66,66,0,1,0,1,0
53669,23,0,0,deny,60,60,0,1,0,1,0
10921,19847,0,0,deny,62,62,0,1,0,1,0
50861,445,0,0,drop,70,70,0,1,0,1,0
65384,53,35279,53,allow,197,102,95,2,33,1,1
24931,25174,0,0,deny,62,62,0,1,0,1,0
53581,12169,27472,12169,allow,492,306,186,8,15,5,3
60411,80,48309,80,allow,1589,941,648,11,121,6,5
58638,5900,0,0,deny,62,62,0,1,0,1,0
49481,53,49481,53,allow,222,101,121,2,31,1,1
21348,22,0,0,deny,60,60,0,1,0,1,0
55312,53,35283,53,allow,438,180,258,6,30,3,3
55979,53,24460,53,allow,168,86,82,2,30,1,1
54816,443,23557,443,allow,130,70,60,3,4,2,1
45410,1,0,0,deny,62,62,0,1,0,1,0
56327,53,4067,53,allow,178,94,84,2,30,1,1
9324,443,33759,443,allow,3255,430,2825,11,15,6,5
57442,66,38674,66,allow,70,70,0,1,5,1,0
12074,10197,0,0,deny,72,72,0,1,0,1,0
60167,80,41576,80,allow,6017,5209,808,12,30,7,5
55277,53,53790,53,allow,701,88,613,2,30,1,1
60113,443,5252,443,allow,704,280,424,11,19,5,6
65315,53,47241,53,allow,767,102,665,2,31,1,1
51653,445,0,0,drop,66,66,0,1,0,1,0
57226,443,27047,443,allow,7924,2027,5897,23,22,14,9
34932,38608,0,0,deny,62,62,0,1,0,1,0
28124,37965,0,0,deny,62,62,0,1,0,1,0
65067,53,43932,53,allow,411,115,296,4,38,2,2
49703,80,27292,80,allow,71256,962,70294,63,52,11,52
33633,443,34965,443,allow,5698,1585,4113,23,1108,13,10
58346,443,42517,443,allow,5571,1518,4053,22,614,13,9
53168,23074,22420,23074,allow,958,454,504,14,21,8,6
49157,53,42050,53,allow,184,94,90,2,29,1,1
55255,37965,0,0,deny,146,146,0,1,0,1,0
54787,445,0,0,drop,70,70,0,1,0,1,0
9291,443,14472,443,allow,3944,902,3042,14,26,8,6
50574,443,59952,443,allow,5870,1785,4085,21,80,12,9
56382,53,5952,53,allow,195,102,93,2,31,1,1
45941,23386,0,0,deny,60,60,0,1,0,1,0
52861,445,0,0,drop,70,70,0,1,0,1,0
51420,445,0,0,drop,70,70,0,1,0,1,0
61967,445,0,0,drop,70,70,0,1,0,1,0
61185,54532,0,0,deny,62,62,0,1,0,1,0
64041,53,58555,53,allow,200,102,98,2,31,1,1
56098,55442,0,0,deny,66,66,0,1,0,1,0
10101,443,13897,443,allow,7563,1536,6027,26,316,14,12
56562,53,42626,53,allow,183,94,89,2,30,1,1
64116,53,59887,53,allow,177,94,83,2,31,1,1
51846,41510,18249,41510,allow,70,70,0,2,8,2,0
53906,12051,58772,12051,allow,164,70,94,2,5,1,1
40512,80,26257,80,allow,2543,691,1852,13,17,8,5
49813,445,0,0,drop,70,70,0,1,0,1,0
12531,22114,0,0,deny,62,62,0,1,0,1,0
50265,37083,2868,37083,allow,490,150,340,2,1200,1,1
50552,445,0,0,drop,66,66,0,1,0,1,0
58638,5900,0,0,deny,62,62,0,1,0,1,0
51120,445,0,0,drop,70,70,0,1,0,1,0
65366,53,59432,53,allow,199,102,97,2,31,1,1
4019,50584,0,0,deny,66,66,0,1,0,1,0
44398,50584,0,0,deny,146,146,0,1,0,1,0
51495,445,0,0,drop,66,66,0,1,0,1,0
58849,443,61655,443,allow,36920,24591,12329,80,24,47,33
55581,53,16064,53,allow,167,86,81,2,30,1,1
53606,445,0,0,drop,66,66,0,1,0,1,0
57793,53,34542,53,allow,168,78,90,2,31,1,1
57710,445,0,0,drop,70,70,0,1,0,1,0
65096,53,51459,53,allow,216,94,122,2,30,1,1
60983,443,50042,443,allow,7458,2832,4626,26,16,15,11
52585,53,6341,53,allow,265,91,174,4,40,2,2
65416,53,1423,53,allow,758,102,656,2,30,1,1
58646,44847,0,0,deny,66,66,0,1,0,1,0
54934,443,9475,443,allow,11700,3386,8314,63,362,33,30
57595,445,0,0,drop,70,70,0,1,0,1,0
50052,65008,0,0,deny,60,60,0,1,0,1,0
51696,14370,13279,14370,allow,70,70,0,1,5,1,0
64171,445,0,0,drop,70,70,0,1,0,1,0
54146,5900,0,0,deny,60,60,0,1,0,1,0
65469,53,34501,53,allow,195,102,93,2,29,1,1
14614,25174,0,0,deny,62,62,0,1,0,1,0
55283,53,5653,53,allow,754,94,660,2,31,1,1
53103,443,15301,443,allow,130,70,60,2,15,1,1
58230,64147,0,0,deny,66,66,0,1,0,1,0
49765,443,5454,443,allow,11588,4383,7205,39,46,22,17
49418,27015,38933,27015,allow,78,78,0,1,29,1,0
7423,22114,0,0,deny,62,62,0,1,0,1,0
38664,37965,0,0,deny,62,62,0,1,0,1,0
50734,443,16701,443,allow,1726,668,1058,13,2033,4,9
58942,443,33385,443,allow,5168,700,4468,16,15,7,9
65045,53,16728,53,allow,197,102,95,2,29,1,1
55941,53,34210,53,allow,184,94,90,2,30,1,1
38258,443,9287,443,allow,5714,1536,4178,24,21,13,11
57090,51505,0,0,deny,66,66,0,1,0,1,0
49367,53,30708,53,allow,389,94,295,4,55,2,2
49784,443,6049,443,allow,7805,1949,5856,22,126,12,10
64844,445,0,0,drop,70,70,0,1,0,1,0
53060,1433,53060,1433,allow,60,60,0,1,5,1,0
63069,443,57757,443,allow,2523249,58976,2464273,2483,33,820,1663
58638,5900,0,0,deny,62,62,0,1,0,1,0
48188,443,44045,443,allow,1263,536,727,13,82,6,7
57912,53,13801,53,allow,295,77,218,2,30,1,1
55401,53,40210,53,allow,168,86,82,2,31,1,1
53725,57418,10921,57418,allow,70,70,0,1,4,1,0
0,0,0,0,allow,480,244,236,4,0,2,2
52109,445,0,0,drop,70,70,0,1,0,1,0
57022,53,55045,53,allow,369,150,219,2,30,1,1
60211,443,55686,443,allow,126490514,2726981,123763533,123275,553,41466,81809
60195,443,54821,443,allow,8894,1633,7261,18,15,9,9
9327,57470,0,0,deny,62,62,0,1,0,1,0
56968,80,44242,80,allow,53181,50384,2797,75,20,39,36
58022,9200,0,0,deny,60,60,0,1,0,1,0
64967,53,44002,53,allow,751,102,649,2,30,1,1
55666,36653,26608,36653,allow,70,70,0,2,8,2,0
61834,443,61834,443,allow,220115,6038,214077,231,76,78,153
56387,53,8885,53,allow,757,98,659,2,31,1,1
51942,443,54861,443,allow,2646,1322,1324,28,36,15,13
9849,53,9849,53,allow,219,87,132,2,31,1,1
57444,443,3253,443,allow,9581,3281,6300,36,16,16,20
63643,445,0,0,drop,66,66,0,1,0,1,0
53955,3290,40369,3290,allow,70,70,0,2,7,2,0
49190,80,2197,80,allow,6158,654,5504,15,15,8,7
53137,35111,13746,35111,allow,70,70,0,2,8,2,0
60486,8999,41044,8999,allow,70,70,0,1,5,1,0
64614,53,56180,53,allow,193,102,91,2,30,1,1
65496,53,41450,53,allow,280,96,184,4,34,2,2
39527,443,33957,443,allow,8447,3506,4941,28,333,15,13
45941,23388,0,0,deny,60,60,0,1,0,1,0
62414,50584,0,0,deny,66,66,0,1,0,1,0
65476,53,44080,53,allow,226,110,116,2,29,1,1
32976,37965,0,0,deny,66,66,0,1,0,1,0
55680,23711,32600,23711,allow,70,70,0,1,5,1,0
57312,53,15531,53,allow,212,110,102,2,30,1,1
65220,53,7032,53,allow,371,97,274,4,53,2,2
15806,11392,0,0,deny,66,66,0,1,0,1,0
54471,36237,0,0,deny,66,66,0,1,0,1,0
43221,443,25236,443,allow,72183,3193,68990,89,20,34,55
43107,443,43113,443,allow,3051,1801,1250,18,16,8,10
51958,51322,1745,51322,allow,70,70,0,1,4,1,0
33938,443,14561,443,allow,6919,2112,4807,19,15,10,9
45964,2225,0,0,deny,60,60,0,1,0,1,0
64290,53,4027,53,allow,302,98,204,4,47,2,2
58806,445,0,0,drop,70,70,0,1,0,1,0
63239,443,35910,443,allow,5725,3290,2435,34,125,19,15
61733,445,0,0,drop,70,70,0,1,0,1,0
54974,445,0,0,drop,70,70,0,1,0,1,0
20682,57470,0,0,deny,62,62,0,1,0,1,0
54598,37965,0,0,deny,66,66,0,1,0,1,0
56131,37807,0,0,deny,66,66,0,1,0,1,0
54979,53,64417,53,allow,183,94,89,2,30,1,1
51265,31652,0,0,reset-both,72,72,0,1,0,1,0
26900,27017,38373,27017,allow,422,164,258,6,30,3,3
52402,53,52402,53,allow,212,98,114,2,30,1,1
50563,445,0,0,drop,70,70,0,1,0,1,0
52455,443,34682,443,allow,7356,1014,6342,20,75,10,10
43890,123,0,0,deny,234,234,0,1,0,1,0
49761,80,17829,80,allow,2113,1181,932,10,127,6,4
49288,53,48281,53,allow,322,102,220,2,30,1,1
45472,443,53386,443,allow,1568,759,809,17,43,9,8
53475,3389,0,0,deny,66,66,0,1,0,1,0
56794,46824,0,0,deny,66,66,0,1,0,1,0
2427,25174,0,0,deny,146,146,0,1,0,1,0
35218,53,23519,53,allow,168,78,90,2,30,1,1
58295,445,0,0,drop,70,70,0,1,0,1,0
50987,445,0,0,drop,70,70,0,1,0,1,0
52232,53,0,0,deny,71,71,0,1,0,1,0
20726,2767,0,0,deny,62,62,0,1,0,1,0
54996,443,52291,443,allow,8637,2889,5748,40,41,23,17
49912,443,43170,443,allow,2048821,56490,1992331,2082,44,522,1560
49418,52013,42400,52013,allow,278,78,200,2,31,1,1
52150,37603,63249,37603,allow,70,70,0,1,5,1,0
23632,64147,0,0,deny,66,66,0,1,0,1,0
52450,443,52450,443,allow,4750,1843,2907,19,26,11,8
63983,53,48725,53,allow,447,94,353,4,54,2,2
443,35385,0,0,deny,66,66,0,1,0,1,0
53573,14856,10337,14856,allow,320,140,180,6,5,3,3
55461,443,39176,443,allow,2341,540,1801,9,121,5,4
65224,53,29187,53,allow,232,110,122,2,30,1,1
43834,443,19453,443,allow,4824,671,4153,13,29,7,6
53374,443,16272,443,allow,4317,1134,3183,16,26,9,7
35408,56205,0,0,deny,62,62,0,1,0,1,0
56589,53,35173,53,allow,199,102,97,2,30,1,1
3755,443,3755,443,allow,12079,1344,10735,24,17,10,14
57789,30188,0,0,deny,62,62,0,1,0,1,0
65067,53,28760,53,allow,86,86,0,1,30,1,0
53294,445,0,0,drop,70,70,0,1,0,1,0
49160,57470,0,0,deny,146,146,0,1,0,1,0
52111,44847,0,0,deny,62,62,0,1,0,1,0
57651,80,10587,80,allow,1151,711,440,10,15,5,5
61334,445,0,0,drop,70,70,0,1,0,1,0
61512,445,0,0,drop,70,70,0,1,0,1,0
60473,22170,57823,22170,allow,1599,743,856,13,36,7,6
27502,50584,0,0,deny,66,66,0,1,0,1,0
49559,443,1739,443,allow,3641,1047,2594,14,120,7,7
63595,443,51163,443,allow,8062,2186,5876,29,136,15,14
52599,443,49618,443,allow,2044,1024,1020,17,80,9,8
50896,80,56677,80,allow,11459959,142694,11317265,9719,135,1994,7725
60822,445,0,0,drop,66,66,0,1,0,1,0
53751,443,44095,443,allow,499,425,74,4,0,3,1
51052,445,0,0,drop,66,66,0,1,0,1,0
49418,57470,0,0,deny,62,62,0,1,0,1,0
35372,443,41929,443,allow,269750,10062,259688,285,152,92,193
45941,23386,0,0,deny,60,60,0,1,0,1,0
49687,53,40743,53,allow,184,102,82,2,30,1,1
53706,443,53579,443,allow,499,425,74,4,0,3,1
23769,53,45289,53,allow,334,226,108,3,30,2,1
50205,445,0,0,drop,70,70,0,1,0,1,0
50584,30773,22058,30773,allow,1356,300,1056,6,1200,3,3
55661,53,42015,53,allow,213,102,111,2,30,1,1
52765,443,7289,443,allow,10359,1566,8793,27,150,13,14
27005,32066,15067,32066,allow,881,126,755,2,31,1,1
62030,53,0,0,allow,229,85,144,2,31,1,1
63937,43443,65141,43443,allow,160,70,90,2,5,1,1
52769,443,2032,443,allow,8083,1790,6293,27,150,14,13
58760,445,0,0,drop,70,70,0,1,0,1,0
6882,64287,36114,64287,allow,228,118,110,2,1200,1,1
64882,53,49587,53,allow,279,126,153,2,30,1,1
58086,445,0,0,drop,70,70,0,1,0,1,0
38936,443,16870,443,allow,3217,2090,1127,16,255,9,7
64559,53,43720,53,allow,168,86,82,2,30,1,1
58638,5900,0,0,deny,62,62,0,1,0,1,0
49841,1433,0,0,deny,60,60,0,1,0,1,0
52217,22114,0,0,deny,66,66,0,1,0,1,0
55144,30188,0,0,deny,66,66,0,1,0,1,0
33973,50265,0,0,deny,62,62,0,1,0,1,0
56578,64147,0,0,deny,66,66,0,1,0,1,0
57270,443,35956,443,allow,9415,3482,5933,57,16,29,28
27153,80,27153,80,allow,6397,947,5450,15,18,8,7
56757,53,22580,53,allow,322,118,204,2,30,1,1
9968,53,9968,53,allow,370,238,132,3,32,2,1
49235,53,22418,53,allow,172,94,78,2,30,1,1
51797,30712,27964,30712,allow,70,70,0,1,5,1,0
45682,47993,0,0,deny,62,62,0,1,0,1,0
64995,53,14595,53,allow,210,110,100,2,30,1,1
63126,445,0,0,drop,66,66,0,1,0,1,0
4748,64147,0,0,deny,66,66,0,1,0,1,0
62926,445,0,0,drop,66,66,0,1,0,1,0
59739,443,20531,443,allow,304,86,218,2,30,1,1
50298,53,22376,53,allow,172,94,78,2,30,1,1
59325,53,7735,53,allow,211,78,133,2,30,1,1
37174,443,43183,443,allow,752907,69016,683891,1372,231,537,835
56640,80,54626,80,allow,234,234,0,4,11,4,0
60306,443,16522,443,allow,2866,623,2243,13,136,6,7
65195,445,0,0,drop,66,66,0,1,0,1,0
55597,53,45448,53,allow,168,86,82,2,30,1,1
49183,53,29082,53,allow,451,91,360,4,36,2,2
49217,53,20500,53,allow,209,110,99,2,29,1,1
63707,28423,64677,28423,allow,564,382,182,9,16,6,3
56242,53,42071,53,allow,711,87,624,2,30,1,1
6929,35440,0,0,deny,66,66,0,1,0,1,0
49922,443,6981,443,allow,11466,1320,10146,22,135,10,12
61701,44847,0,0,deny,66,66,0,1,0,1,0
50595,445,0,0,drop,66,66,0,1,0,1,0
1187,64147,0,0,deny,66,66,0,1,0,1,0
49730,53,40205,53,allow,194,102,92,2,30,1,1
14869,44847,0,0,deny,62,62,0,1,0,1,0
56504,53,4684,53,allow,196,100,96,2,30,1,1
50474,443,49167,443,allow,17449456,390704,17058752,16816,383,4917,11899
50584,48493,7175,48493,allow,161,161,0,1,1200,1,0
58593,57470,0,0,deny,62,62,0,1,0,1,0
59781,56205,0,0,deny,66,66,0,1,0,1,0
53814,6725,20985,6725,allow,70,70,0,1,4,1,0
53974,53,45539,53,allow,578,286,292,9,15,5,4
57201,53,54960,53,allow,173,94,79,2,30,1,1
59724,64147,0,0,deny,66,66,0,1,0,1,0
12266,443,12266,443,allow,18634,3895,14739,48,29,27,21
6977,53,6977,53,allow,235,90,145,2,32,1,1
56531,443,49300,443,allow,215863,14423,201440,245,105,95,150
59862,445,0,0,drop,66,66,0,1,0,1,0
18398,21247,0,0,deny,66,66,0,1,0,1,0
56808,54393,51587,54393,allow,70,70,0,2,8,2,0
49792,53,55353,53,allow,755,202,553,6,61,3,3
59726,53,53950,53,allow,304,86,218,2,30,1,1
49563,53,27885,53,allow,200,102,98,2,30,1,1
49475,53,49996,53,allow,243,110,133,2,30,1,1
64361,445,0,0,drop,66,66,0,1,0,1,0
50038,53,5932,53,allow,170,87,83,2,31,1,1
59988,64147,0,0,deny,66,66,0,1,0,1,0
57470,867,17411,867,allow,330,330,0,6,1200,6,0
64309,53,10386,53,allow,308,94,214,2,30,1,1
52155,80,52769,80,allow,366,240,126,7,32,5,2
58805,445,0,0,drop,66,66,0,1,0,1,0
60412,443,58640,443,allow,7353,1573,5780,21,78,11,10
50480,445,0,0,drop,66,66,0,1,0,1,0
59457,53,59457,53,allow,213,87,126,2,30,1,1
44453,1433,0,0,deny,60,60,0,1,0,1,0
49282,53,46163,53,allow,172,88,84,2,31,1,1
55972,53,36064,53,allow,193,102,91,2,30,1,1
62917,993,58803,993,allow,9056,4223,4833,82,35,42,40
44383,30188,0,0,deny,66,66,0,1,0,1,0
55025,53,8549,53,allow,93,93,0,1,31,1,0
50470,61463,0,0,deny,86,86,0,1,0,1,0
54113,445,0,0,drop,70,70,0,1,0,1,0
11601,53,11601,53,allow,233,91,142,2,31,1,1
55066,443,25317,443,allow,12715,3716,8999,28,62,16,12
18608,11392,0,0,deny,62,62,0,1,0,1,0
443,62451,0,0,deny,199,199,0,1,0,1,0
65449,53,26123,53,allow,315,87,228,4,40,2,2
49459,53,24594,53,allow,198,101,97,2,30,1,1
57470,49160,41673,49160,allow,132,132,0,3,1199,3,0
28009,36237,0,0,deny,62,62,0,1,0,1,0
80,9918,0,0,deny,60,60,0,1,0,1,0
1399,53,11703,53,allow,256,94,162,2,30,1,1
33405,37965,0,0,deny,62,62,0,1,0,1,0
10077,443,21308,443,allow,10940,4625,6315,36,347,19,17
62389,445,0,0,drop,70,70,0,1,0,1,0
45941,23386,0,0,deny,60,60,0,1,0,1,0
65024,53,40250,53,allow,198,101,97,2,32,1,1
55459,50584,0,0,deny,66,66,0,1,0,1,0
48629,63131,0,0,deny,74,74,0,1,0,1,0
41152,443,5083,443,allow,1848,1139,709,14,579,8,6
52011,80,26180,80,allow,23580,10536,13044,36,39,18,18
50930,443,14420,443,allow,1786,172,1614,7,121,3,4
57748,445,0,0,drop,70,70,0,1,0,1,0
55710,445,0,0,drop,70,70,0,1,0,1,0
56896,53,21578,53,allow,177,94,83,2,30,1,1
56751,53,35800,53,allow,177,94,83,2,30,1,1
51804,31012,28842,31012,allow,70,70,0,1,5,1,0
57768,7635,57768,7635,allow,138,78,60,2,6,1,1
64581,53,16875,53,allow,214,110,104,2,29,1,1
52404,443,21006,443,allow,132575,6675,125900,206,94,91,115
49987,443,39263,443,allow,426,180,246,8,21,4,4
49879,53,57267,53,allow,517,95,422,4,44,2,2
57729,445,0,0,drop,66,66,0,1,0,1,0
38795,40032,51125,40032,allow,243,180,63,2,31,1,1
63684,445,0,0,drop,70,70,0,1,0,1,0
50896,445,0,0,drop,70,70,0,1,0,1,0
58016,445,0,0,drop,66,66,0,1,0,1,0
53555,445,0,0,drop,66,66,0,1,0,1,0
59406,445,0,0,drop,70,70,0,1,0,1,0
39873,23,0,0,deny,60,60,0,1,0,1,0
51983,30472,23592,30472,allow,70,70,0,2,8,2,0
62658,445,0,0,drop,70,70,0,1,0,1,0
58890,15000,13228,15000,allow,138,78,60,2,5,1,1
49009,53,49009,53,allow,172,76,96,2,30,1,1
56099,445,0,0,drop,70,70,0,1,0,1,0
60666,123,38509,123,allow,184,94,90,2,30,1,1
51444,3027,51444,3027,allow,156,156,0,3,8,3,0
49891,53,6545,53,allow,375,126,249,2,30,1,1
65295,445,0,0,drop,70,70,0,1,0,1,0
50222,445,0,0,drop,70,70,0,1,0,1,0
25961,55783,0,0,deny,62,62,0,1,0,1,0
54586,445,0,0,drop,70,70,0,1,0,1,0
50659,445,0,0,drop,66,66,0,1,0,1,0
33609,443,62063,443,allow,9348,1018,8330,22,256,11,11
44491,50584,0,0,deny,146,146,0,1,0,1,0
55617,53,30754,53,allow,212,108,104,2,31,1,1
48706,23393,0,0,deny,60,60,0,1,0,1,0
61222,445,0,0,drop,70,70,0,1,0,1,0
55858,80,7371,80,allow,104399,8436,95963,122,21,49,73
64921,53,46383,53,allow,238,102,136,2,31,1,1
50476,445,0,0,drop,70,70,0,1,0,1,0
64745,3389,64745,3389,allow,3413,1458,1955,16,18,8,8
55712,445,0,0,drop,70,70,0,1,0,1,0
43212,443,25002,443,allow,7476,2192,5284,27,316,13,14
49214,443,63008,443,allow,7177,2666,4511,20,15,11,9
50719,443,22608,443,allow,17803069,497380,17305689,17583,219,5899,11684
58498,445,0,0,drop,66,66,0,1,0,1,0
49876,53,42623,53,allow,211,102,109,2,30,1,1
49490,53,51051,53,allow,246,94,152,2,30,1,1
61405,445,0,0,drop,66,66,0,1,0,1,0
54410,445,0,0,drop,66,66,0,1,0,1,0
58213,37807,0,0,deny,66,66,0,1,0,1,0
43785,443,28083,443,allow,6017,1285,4732,18,984,8,10
64502,53,7896,53,allow,374,101,273,4,42,2,2
56633,53,60296,53,allow,197,102,95,2,30,1,1
61692,445,0,0,drop,70,70,0,1,0,1,0
57090,53,28237,53,allow,198,102,96,2,30,1,1
56665,53,16180,53,allow,216,102,114,2,30,1,1
56981,80,19891,80,allow,214,140,74,4,35,3,1
1582,56205,0,0,deny,62,62,0,1,0,1,0
50082,53,42387,53,allow,774,101,673,2,30,1,1
36005,22,0,0,deny,60,60,0,1,0,1,0
1024,57470,0,0,deny,62,62,0,1,0,1,0
49717,666,0,0,deny,60,60,0,1,0,1,0
39804,443,42042,443,allow,56980,4095,52885,90,256,37,53
64675,53,55719,53,allow,749,94,655,2,31,1,1
64108,53,41542,53,allow,296,126,170,2,30,1,1
55702,80,29070,80,allow,70,70,0,1,5,1,0
50041,445,0,0,drop,70,70,0,1,0,1,0
16224,443,3120,443,allow,7525,1098,6427,22,16,12,10
59919,53,59919,53,allow,231,90,141,2,31,1,1
64957,53,39699,53,allow,196,102,94,2,30,1,1
55155,445,0,0,drop,70,70,0,1,0,1,0
49249,445,0,0,drop,70,70,0,1,0,1,0
64856,53,25050,53,allow,451,124,327,4,45,2,2
56536,443,5996,443,allow,210110,14803,195307,246,105,103,143
30654,51221,0,0,deny,72,72,0,1,0,1,0
64960,27021,59267,27021,allow,742,462,280,2,31,1,1
34613,80,39992,80,allow,1013,504,509,10,17,6,4
2475,6881,0,0,deny,66,66,0,1,0,1,0
49469,53,17330,53,allow,718,94,624,2,30,1,1
56303,53,55286,53,allow,177,94,83,2,30,1,1
27005,26258,3792,26258,allow,886,126,760,2,31,1,1
59200,53,0,0,allow,82,82,0,1,30,1,0
50893,443,25118,443,allow,9452,1832,7620,20,130,10,10
30960,45756,31120,45756,allow,396,396,0,7,3616,7,0
65075,53,61185,53,allow,172,94,78,2,30,1,1
25620,50432,0,0,deny,146,146,0,1,0,1,0
3911,50584,0,0,deny,62,62,0,1,0,1,0
63954,60430,18529,60430,allow,66,66,0,2,8,2,0
40479,35993,0,0,deny,62,62,0,1,0,1,0
25276,50584,0,0,deny,146,146,0,1,0,1,0
6881,6881,0,0,deny,62,62,0,1,0,1,0
64307,53,12624,53,allow,463,90,373,4,34,2,2
65444,53,41449,53,allow,227,110,117,2,29,1,1
49699,53,32857,53,allow,266,89,177,4,58,2,2
51898,443,2125,443,allow,7866,1549,6317,21,321,10,11
46849,36237,0,0,deny,66,66,0,1,0,1,0
55608,17425,43686,17425,allow,320,140,180,6,7,3,3
27005,27015,57738,27015,allow,1638,126,1512,4,30,2,2
57169,53,44732,53,allow,170,87,83,2,30,1,1
55099,445,0,0,drop,70,70,0,1,0,1,0
63170,445,0,0,drop,70,70,0,1,0,1,0
52226,445,0,0,drop,70,70,0,1,0,1,0
42642,443,22756,443,allow,10548,2689,7859,38,24,19,19
58755,443,6984,443,allow,4827,2244,2583,16,135,8,8
33886,39127,0,0,deny,162,162,0,1,0,1,0
58339,445,0,0,drop,70,70,0,1,0,1,0
51970,18752,15573,18752,allow,70,70,0,1,5,1,0
53500,1,0,0,deny,66,66,0,1,0,1,0
61428,443,21919,443,allow,7276,1763,5513,22,77,12,10
56717,53,63655,53,allow,178,94,84,2,30,1,1
54404,445,0,0,drop,70,70,0,1,0,1,0
37145,443,8419,443,allow,4578,2334,2244,21,16,12,9
56247,23,0,0,deny,60,60,0,1,0,1,0
53044,36237,0,0,deny,62,62,0,1,0,1,0
49337,445,0,0,drop,70,70,0,1,0,1,0
50487,80,25708,80,allow,378,192,186,7,21,4,3
50116,22,50116,22,allow,66,66,0,1,5,1,0
47377,443,54637,443,allow,2725,1153,1572,19,208,8,11
59109,445,0,0,drop,70,70,0,1,0,1,0
60097,445,0,0,drop,70,70,0,1,0,1,0
64673,445,0,0,drop,70,70,0,1,0,1,0
57131,26296,0,0,deny,145,145,0,1,0,1,0
53815,443,57260,443,allow,499,425,74,4,0,3,1
50484,443,37149,443,allow,30475,26737,3738,62,26,35,27
63221,53436,0,0,deny,62,62,0,1,0,1,0
6881,6881,34169,6881,allow,502,150,352,2,1200,1,1
59904,53,31184,53,allow,312,78,234,2,29,1,1
39115,443,62542,443,allow,335190,17497,317693,449,42,211,238
55365,53,5213,53,allow,214,110,104,2,29,1,1
55044,53,9273,53,allow,192,98,94,2,30,1,1
54351,445,0,0,drop,70,70,0,1,0,1,0
56120,53,56120,53,allow,237,91,146,2,33,1,1
56322,445,0,0,drop,66,66,0,1,0,1,0
57480,445,0,0,drop,66,66,0,1,0,1,0
55504,445,0,0,drop,66,66,0,1,0,1,0
60003,443,18889,443,allow,32538,7037,25501,49,143,20,29
57987,80,45212,80,allow,2803,1625,1178,16,21,9,7
51754,445,0,0,drop,70,70,0,1,0,1,0
56937,8200,16885,8200,allow,78,78,0,1,30,1,0
27005,27015,2437,27015,allow,878,126,752,2,30,1,1
6015,23,0,0,deny,60,60,0,1,0,1,0
25889,11446,0,0,deny,62,62,0,1,0,1,0
16387,22272,0,0,deny,60,60,0,1,0,1,0
53754,443,24588,443,allow,499,425,74,4,0,3,1
57319,53,22543,53,allow,176,90,86,2,30,1,1
37433,443,8364,443,allow,8641,955,7686,19,259,8,11
26287,56205,0,0,deny,66,66,0,1,0,1,0
57501,445,0,0,drop,70,70,0,1,0,1,0
64072,445,0,0,drop,66,66,0,1,0,1,0
53557,445,0,0,drop,66,66,0,1,0,1,0
59403,443,58702,443,allow,5853,2409,3444,35,80,16,19
20389,64147,0,0,deny,62,62,0,1,0,1,0
42650,3389,42650,3389,allow,4930,2691,2239,24,19,14,10
59891,443,64677,443,allow,7718,1947,5771,25,46,14,11
49276,80,4660,80,allow,254,128,126,5,16,3,2
40765,443,6306,443,allow,1093,662,431,10,41,6,4
37694,443,63637,443,allow,234688,15158,219530,324,173,157,167
26900,27017,30872,27017,allow,422,164,258,6,29,3,3
50624,445,0,0,drop,70,70,0,1,0,1,0
65209,57866,0,0,deny,62,62,0,1,0,1,0
20619,25174,0,0,deny,62,62,0,1,0,1,0
51439,443,29374,443,allow,396,66,330,7,17,2,5
56423,445,0,0,drop,70,70,0,1,0,1,0
11136,15503,0,0,deny,62,62,0,1,0,1,0
52666,40108,0,0,deny,148,148,0,1,0,1,0
37308,43890,0,0,deny,62,62,0,1,0,1,0
27995,22114,0,0,deny,62,62,0,1,0,1,0
55957,53,34097,53,allow,178,94,84,2,30,1,1
65251,80,48445,80,allow,6352,4052,2300,44,630,23,21
55388,53,11740,53,allow,292,87,205,4,42,2,2
54167,53,8254,53,allow,210,94,116,2,30,1,1
49922,445,0,0,drop,70,70,0,1,0,1,0
15281,25174,0,0,deny,146,146,0,1,0,1,0
63579,445,0,0,drop,66,66,0,1,0,1,0
62333,443,8530,443,allow,4019,2219,1800,33,186,17,16
48681,80,45826,80,allow,918,461,457,9,15,6,3
57352,445,0,0,drop,66,66,0,1,0,1,0
49848,443,28970,443,allow,33314,1722,31592,40,88,14,26
7444,57470,0,0,deny,66,66,0,1,0,1,0
7372,25773,0,0,reset-both,139,139,0,1,0,1,0
50786,445,0,0,drop,70,70,0,1,0,1,0
64919,53,63713,53,allow,822,102,720,2,29,1,1
53963,445,0,0,drop,66,66,0,1,0,1,0
62485,445,0,0,drop,66,66,0,1,0,1,0
56365,53,6321,53,allow,199,102,97,2,30,1,1
58976,43890,0,0,deny,62,62,0,1,0,1,0
58181,445,0,0,drop,66,66,0,1,0,1,0
53085,443,17021,443,allow,16024,3168,12856,56,76,31,25
38926,37965,0,0,deny,62,62,0,1,0,1,0
49475,53,56421,53,allow,196,102,94,2,30,1,1
52062,443,35040,443,allow,466,392,74,4,0,3,1
54998,53,23774,53,allow,198,102,96,2,29,1,1
56688,25174,0,0,deny,66,66,0,1,0,1,0
49667,80,52853,80,allow,1165,468,697,8,125,5,3
64320,53,39088,53,allow,197,94,103,2,29,1,1
61426,443,49528,443,allow,7348,1763,5585,23,77,12,11
54135,443,36564,443,allow,11065,1394,9671,23,75,13,10
65085,22114,0,0,deny,66,66,0,1,0,1,0
55596,53,2008,53,allow,177,94,83,2,29,1,1
64311,53,1855,53,allow,198,101,97,2,31,1,1
56905,80,13949,80,allow,78,78,0,2,8,2,0
59035,445,0,0,drop,70,70,0,1,0,1,0
56192,53,42935,53,allow,177,94,83,2,30,1,1
61442,443,19223,443,allow,3403,1891,1512,24,42,13,11
54142,20541,0,0,deny,62,62,0,1,0,1,0
51414,22,0,0,deny,60,60,0,1,0,1,0
60849,445,0,0,drop,70,70,0,1,0,1,0
56044,80,25395,80,allow,1515,481,1034,11,16,6,5
39540,37965,0,0,deny,66,66,0,1,0,1,0
64758,445,0,0,drop,66,66,0,1,0,1,0
64125,53,26967,53,allow,199,102,97,2,30,1,1
37805,443,65176,443,allow,5577,1977,3600,29,56,16,13
60349,445,0,0,drop,70,70,0,1,0,1,0
58638,5900,0,0,deny,62,62,0,1,0,1,0
61148,445,0,0,drop,70,70,0,1,0,1,0
35190,80,55473,80,allow,130,70,60,2,14,1,1
56966,35440,0,0,deny,66,66,0,1,0,1,0
63940,3389,63940,3389,allow,3347,1458,1889,15,17,8,7
40941,443,61408,443,allow,9794,2178,7616,26,48,16,10
64619,53,25912,53,allow,179,94,85,2,31,1,1
16387,63752,0,0,deny,60,60,0,1,0,1,0
9522,51505,0,0,deny,66,66,0,1,0,1,0
58793,445,0,0,drop,66,66,0,1,0,1,0
64681,35993,0,0,deny,66,66,0,1,0,1,0
59883,443,34270,443,allow,8031,2957,5074,27,46,16,11
56430,443,5643,443,allow,2274816,85295,2189521,2305,127,825,1480
44849,443,64447,443,allow,13791,7866,5925,35,46,20,15
53258,445,0,0,drop,66,66,0,1,0,1,0
30598,46824,0,0,deny,62,62,0,1,0,1,0
49815,53,3379,53,allow,789,110,679,2,31,1,1
65427,53,25865,53,allow,677,188,489,6,57,3,3
56952,445,0,0,drop,70,70,0,1,0,1,0
64034,53,39969,53,allow,194,102,92,2,31,1,1
54221,443,30528,443,allow,499,425,74,4,0,3,1
56941,53,32595,53,allow,212,102,110,2,30,1,1
62591,445,0,0,drop,70,70,0,1,0,1,0
42298,40014,14476,40014,allow,148,86,62,2,31,1,1
51443,443,11818,443,allow,4773,2454,2319,14,135,7,7
53894,2944,38557,2944,allow,70,70,0,1,5,1,0
49272,53,48276,53,allow,168,86,82,2,33,1,1
62233,445,0,0,drop,66,66,0,1,0,1,0
49319,53,39564,53,allow,199,102,97,2,29,1,1
53021,445,0,0,drop,70,70,0,1,0,1,0
51892,46647,6843,46647,allow,70,70,0,1,5,1,0
65057,445,0,0,drop,70,70,0,1,0,1,0
54519,445,0,0,drop,70,70,0,1,0,1,0
55868,445,0,0,drop,70,70,0,1,0,1,0
57482,445,0,0,drop,70,70,0,1,0,1,0
49867,53,63133,53,allow,177,94,83,2,30,1,1
55216,53,63091,53,allow,174,89,85,2,30,1,1
2267,53,11454,53,allow,204,118,86,2,31,1,1
59592,37965,0,0,deny,62,62,0,1,0,1,0
28194,32468,0,0,deny,62,62,0,1,0,1,0
49944,80,49944,80,allow,220279,13007,207272,266,22,115,151
53233,443,40528,443,allow,47830,23388,24442,74,51,37,37
51135,80,13103,80,allow,366,240,126,7,21,5,2
60166,443,38227,443,allow,8198,2252,5946,29,318,14,15
57025,53,16250,53,allow,168,86,82,2,30,1,1
59972,25174,0,0,deny,62,62,0,1,0,1,0
55256,53,58019,53,allow,79,79,0,2,35,2,0
56551,53,25599,53,allow,225,102,123,2,30,1,1
62363,445,0,0,drop,66,66,0,1,0,1,0
45211,443,19368,443,allow,1629,968,661,15,275,8,7
50572,443,24489,443,allow,5867,1782,4085,21,80,12,9
49564,53,7876,53,allow,168,78,90,2,30,1,1
61981,9000,0,0,deny,60,60,0,1,0,1,0
49216,53,56828,53,allow,274,94,180,2,30,1,1
64024,445,0,0,drop,70,70,0,1,0,1,0
1484,22114,0,0,deny,146,146,0,1,0,1,0
55546,53,22275,53,allow,1417,96,1321,4,30,2,2
60174,445,0,0,drop,66,66,0,1,0,1,0
56616,53,31793,53,allow,183,94,89,2,30,1,1
63212,445,0,0,drop,66,66,0,1,0,1,0
23528,44847,0,0,deny,146,146,0,1,0,1,0
49761,53,10383,53,allow,182,93,89,2,31,1,1
60120,445,0,0,drop,66,66,0,1,0,1,0
56143,53,46074,53,allow,177,94,83,2,30,1,1
37343,21247,0,0,deny,146,146,0,1,0,1,0
53939,9504,53453,9504,allow,492,306,186,8,15,5,3
56579,53,36844,53,allow,288,94,194,2,30,1,1
45376,80,8854,80,allow,2259,1068,1191,12,31,8,4
46412,53,4555,53,allow,164,78,86,2,31,1,1
55294,445,0,0,drop,70,70,0,1,0,1,0
1024,64147,0,0,deny,62,62,0,1,0,1,0
55211,445,0,0,drop,66,66,0,1,0,1,0
52772,80,28043,80,allow,2501,1085,1416,15,108,8,7
63440,53,0,0,allow,206,95,111,2,30,1,1
49245,80,49245,80,allow,378,180,198,7,54,4,3
49968,53,46436,53,allow,285,94,191,2,30,1,1
52973,23,0,0,deny,60,60,0,1,0,1,0
60563,445,0,0,drop,66,66,0,1,0,1,0
40977,21247,0,0,deny,66,66,0,1,0,1,0
5790,43890,0,0,deny,62,62,0,1,0,1,0
55146,53,27596,53,allow,178,91,87,2,31,1,1
49712,53,62216,53,allow,178,94,84,2,30,1,1
57290,53,54259,53,allow,178,94,84,2,30,1,1
47337,443,13338,443,allow,14281,2906,11375,15,122,4,11
58307,443,36806,443,allow,934,506,428,14,29,8,6
53713,26085,40044,26085,allow,70,70,0,1,5,1,0
55605,53,24748,53,allow,195,102,93,2,29,1,1
55707,53,50329,53,allow,177,94,83,2,29,1,1
46985,993,3733,993,allow,9725,3931,5794,46,48,25,21
63255,445,0,0,drop,66,66,0,1,0,1,0
61068,445,0,0,drop,70,70,0,1,0,1,0
49832,443,25686,443,allow,8589,2871,5718,26,46,14,12
51576,443,34580,443,allow,3323,2023,1300,17,255,9,8
57120,443,27868,443,allow,23906,9380,14526,40,16,24,16
33912,443,41888,443,allow,6288,3354,2934,9,122,5,4
49779,445,0,0,drop,66,66,0,1,0,1,0
49531,53,21298,53,allow,740,93,647,2,31,1,1
56966,35440,0,0,deny,66,66,0,1,0,1,0
5227,50584,0,0,deny,62,62,0,1,0,1,0
55142,443,55142,443,allow,4480,555,3925,11,20,6,5
50159,445,0,0,drop,70,70,0,1,0,1,0
59430,50584,0,0,deny,66,66,0,1,0,1,0
45116,80,45116,80,allow,24787,1571,23216,40,21,20,20
41163,443,48910,443,allow,9045,1938,7107,21,16,12,9
48706,23393,0,0,deny,60,60,0,1,0,1,0
49968,53,62146,53,allow,1412,94,1318,4,33,2,2
56641,445,0,0,drop,70,70,0,1,0,1,0
15249,22114,0,0,deny,62,62,0,1,0,1,0
57274,443,44033,443,allow,11536,2572,8964,41,33,24,17
55554,445,0,0,drop,70,70,0,1,0,1,0
50839,445,0,0,drop,70,70,0,1,0,1,0
6929,35440,0,0,deny,66,66,0,1,0,1,0
64021,53,18880,53,allow,195,102,93,2,29,1,1
56789,443,21644,443,allow,257154,11550,245604,303,54,121,182
16387,7205,0,0,deny,60,60,0,1,0,1,0
56462,37965,0,0,deny,66,66,0,1,0,1,0
59209,25174,0,0,deny,62,62,0,1,0,1,0
60438,17372,0,0,deny,66,66,0,1,0,1,0
46618,443,48794,443,allow,9505,3214,6291,33,19,19,14
58638,5900,58638,5900,allow,156,62,94,2,10,1,1
38385,443,54542,443,allow,5304,1112,4192,19,31,10,9
26802,50584,0,0,deny,62,62,0,1,0,1,0
49921,53,58309,53,allow,214,110,104,2,30,1,1
60580,53,24695,53,allow,229,94,135,2,30,1,1
6712,44818,0,0,deny,66,66,0,1,0,1,0
51899,47537,11729,47537,allow,66,66,0,1,5,1,0
56872,445,0,0,drop,70,70,0,1,0,1,0
59016,443,23931,443,allow,12676,4222,8454,36,87,20,16
52481,443,2836,443,allow,70,70,0,1,5,1,0
51242,80,19033,80,allow,3506,2280,1226,24,50,13,11
52260,52142,32000,52142,allow,70,70,0,2,8,2,0
56757,443,9849,443,allow,8057,2037,6020,20,15,11,9
39851,443,44930,443,allow,9355,3422,5933,56,16,28,28
34256,443,33618,443,allow,67835,6280,61555,96,108,45,51
6881,56867,6114,56867,allow,150,150,0,1,1199,1,0
52661,80,52661,80,allow,1950,1338,612,11,14,5,6
56141,53,40551,53,allow,713,94,619,4,54,2,2
64922,53,12906,53,allow,255,102,153,2,30,1,1
56502,443,5913,443,allow,5414,1010,4404,17,33,9,8
47642,443,46910,443,allow,12735,10573,2162,33,316,16,17
58976,43890,0,0,deny,66,66,0,1,0,1,0
56504,53,22416,53,allow,198,102,96,2,33,1,1
3478,61463,0,0,deny,1188,1188,0,1,0,1,0
1049,54369,0,0,deny,62,62,0,1,0,1,0
44355,443,45033,443,allow,354,140,214,6,131,3,3
54137,443,48423,443,allow,2573,330,2243,12,136,5,7
57455,443,26313,443,allow,9124,5296,3828,54,120,29,25
39872,53,48299,53,allow,78,78,0,1,30,1,0
64085,443,64085,443,allow,140818,8751,132067,156,168,57,99
61329,51505,0,0,deny,66,66,0,1,0,1,0
56723,443,2144,443,allow,7889,1900,5989,20,15,11,9
53274,445,0,0,drop,70,70,0,1,0,1,0
51313,64147,0,0,deny,66,66,0,1,0,1,0
52134,18470,2197,18470,allow,70,70,0,2,7,2,0
64753,53,4084,53,allow,287,102,185,2,30,1,1
53792,1,12742,1,allow,70,70,0,2,7,2,0
44871,53,64533,53,allow,164,78,86,2,31,1,1
56643,445,0,0,drop,70,70,0,1,0,1,0
45941,23388,0,0,deny,60,60,0,1,0,1,0
52090,445,0,0,drop,70,70,0,1,0,1,0
60258,80,44486,80,allow,3348,2437,911,12,150,7,5
57226,53,39140,53,allow,178,94,84,2,31,1,1
59795,443,6313,443,allow,120014,7352,112662,155,37,64,91
51516,443,35060,443,allow,1195,634,561,12,21,7,5
63675,123,55630,123,allow,184,94,90,2,29,1,1
36877,443,64698,443,allow,9787,2382,7405,17,120,7,10
60822,443,31127,443,allow,4435,2482,1953,10,121,6,4
6289,44847,0,0,deny,66,66,0,1,0,1,0
52644,57209,0,0,deny,62,62,0,1,0,1,0
47531,8080,0,0,allow,184,78,106,3,10,2,1
50735,443,6692,443,allow,22676,8150,14526,33,16,17,16
55418,53,39604,53,allow,168,86,82,2,31,1,1
53758,445,0,0,drop,70,70,0,1,0,1,0
26900,27017,30170,27017,allow,422,164,258,6,30,3,3
56373,53,59936,53,allow,200,102,98,2,30,1,1
37462,53,30454,53,allow,207,86,121,2,30,1,1
25579,23,0,0,deny,60,60,0,1,0,1,0
65180,53,7905,53,allow,199,102,97,2,30,1,1
53951,80,8930,80,allow,78,78,0,2,7,2,0
35106,443,63708,443,allow,309321,13076,296245,368,189,150,218
46518,44847,0,0,deny,62,62,0,1,0,1,0
58638,5900,0,0,deny,62,62,0,1,0,1,0
56805,53,39519,53,allow,178,94,84,2,30,1,1
49836,53,26222,53,allow,889,404,485,10,29,5,5
0,0,0,0,allow,320,320,0,5,0,5,0
52176,17572,27555,17572,allow,70,70,0,2,8,2,0
50639,80,20616,80,allow,318,192,126,6,25,4,2
54288,445,0,0,drop,70,70,0,1,0,1,0
50516,53,58230,53,allow,168,86,82,2,30,1,1
49159,23,0,0,deny,60,60,0,1,0,1,0
65189,53,46273,53,allow,328,93,235,4,29,2,2
34565,53,14106,53,allow,168,78,90,2,30,1,1
49823,53,39316,53,allow,388,102,286,2,30,1,1
50208,80,63761,80,allow,1277,460,817,16,77,5,11
6666,6379,0,0,deny,60,60,0,1,0,1,0
58338,3375,0,0,deny,60,60,0,1,0,1,0
58966,30188,0,0,deny,66,66,0,1,0,1,0
35202,443,16914,443,allow,10848,4083,6765,37,16,21,16
50280,57470,0,0,deny,78,78,0,1,0,1,0
53077,443,28917,443,allow,6715,1415,5300,27,84,14,13
48323,35253,0,0,deny,146,146,0,1,0,1,0
63999,53,37511,53,allow,193,102,91,2,29,1,1
56752,44847,0,0,deny,66,66,0,1,0,1,0
56256,445,0,0,drop,70,70,0,1,0,1,0
53906,17372,0,0,deny,62,62,0,1,0,1,0
57169,53,0,0,allow,208,86,122,2,30,1,1
56941,443,11257,443,allow,8304,2968,5336,24,362,13,11
49899,7000,49899,7000,allow,758568,17631,740937,772,17,269,503
64693,53,60951,53,allow,766,102,664,2,30,1,1
54525,445,0,0,drop,70,70,0,1,0,1,0
50213,80,50213,80,allow,1723391,21750,1701641,1450,16,326,1124
63482,445,0,0,drop,70,70,0,1,0,1,0
52210,443,33908,443,allow,6294,1716,4578,27,23,16,11
58228,53733,0,0,deny,62,62,0,1,0,1,0
50184,443,37537,443,allow,6349,1071,5278,18,42,10,8
40821,41615,0,0,deny,157,157,0,1,0,1,0
8283,45858,25688,45858,allow,130,70,60,2,30,1,1
42252,33306,0,0,deny,60,60,0,1,0,1,0
48086,443,38296,443,allow,3138,2011,1127,16,255,9,7
26494,26467,0,0,deny,62,62,0,1,0,1,0
61456,443,24877,443,allow,9577,1475,8102,30,124,14,16
48285,80,8478,80,allow,6713,1736,4977,24,1130,8,16
56717,80,40230,80,allow,3894448,104279,3790169,4041,97,1411,2630
52812,25174,0,0,deny,66,66,0,1,0,1,0
50577,80,50577,80,allow,18679,9115,9564,45,18,24,21
64835,53,7153,53,allow,174,89,85,2,30,1,1
59403,443,14686,443,allow,30995,9655,21340,65,121,27,38
53079,443,11081,443,allow,8233,5537,2696,40,84,21,19
49177,54532,0,0,deny,60,60,0,1,0,1,0
55835,53,25257,53,allow,180,94,86,2,30,1,1
63518,445,0,0,drop,70,70,0,1,0,1,0
58867,443,59291,443,allow,5167,700,4467,16,15,7,9
64326,53,30580,53,allow,196,102,94,2,29,1,1
59572,445,0,0,drop,70,70,0,1,0,1,0
60708,53,53667,53,allow,291,86,205,2,29,1,1
50732,445,0,0,drop,66,66,0,1,0,1,0
40335,443,28601,443,allow,4397,2104,2293,29,85,11,18
64166,35440,0,0,deny,66,66,0,1,0,1,0
57661,53,46284,53,allow,70,70,0,1,30,1,0
56171,445,0,0,drop,70,70,0,1,0,1,0
60951,445,0,0,drop,66,66,0,1,0,1,0
56947,53,0,0,allow,86,86,0,1,29,1,0
49822,445,0,0,drop,70,70,0,1,0,1,0
42155,443,26461,443,allow,70,70,0,1,5,1,0
54941,445,0,0,drop,70,70,0,1,0,1,0
23414,53,23414,53,allow,197,90,107,2,30,1,1
28064,36237,0,0,deny,62,62,0,1,0,1,0
53652,443,55573,443,allow,11041,3217,7824,26,24,15,11
53585,43611,54963,43611,allow,612,306,306,10,15,5,5
30960,45746,57659,45746,allow,330,330,0,6,3609,6,0
55993,53,8187,53,allow,199,102,97,2,29,1,1
52196,445,0,0,drop,70,70,0,1,0,1,0
53019,80,53019,80,allow,181759,5146,176613,216,25,77,139
8999,55783,0,0,deny,146,146,0,1,0,1,0
57319,53,57319,53,allow,198,90,108,2,29,1,1
52292,445,0,0,drop,70,70,0,1,0,1,0
57592,443,17732,443,allow,2614,1689,925,18,19,10,8
47274,5223,2647,5223,allow,4269,1451,2818,22,3002,13,9
57309,53,11380,53,allow,194,99,95,2,30,1,1
50525,80,36119,80,allow,152171,9332,142839,189,156,78,111
14148,1,0,0,deny,66,66,0,1,0,1,0
26053,33720,0,0,deny,160,160,0,1,0,1,0
42034,28189,0,0,deny,62,62,0,1,0,1,0
50570,80,64078,80,allow,318,192,126,6,26,4,2
54530,445,0,0,drop,70,70,0,1,0,1,0
52228,49974,17167,49974,allow,230,136,94,4,14,3,1
50156,443,23478,443,allow,6666,1682,4984,28,1157,15,13
55070,80,64489,80,allow,246,120,126,5,16,3,2
50295,445,0,0,drop,66,66,0,1,0,1,0
9126,80,52469,80,allow,318,192,126,6,30,4,2
53791,53,14073,53,allow,102,102,0,2,31,2,0
56559,53,15416,53,allow,731,85,646,2,30,1,1
50316,25604,0,0,deny,66,66,0,1,0,1,0
34677,51185,0,0,deny,60,60,0,1,0,1,0
56826,22114,0,0,deny,62,62,0,1,0,1,0
62386,445,0,0,drop,70,70,0,1,0,1,0
53110,8830,57205,8830,allow,70,70,0,1,5,1,0
11410,36237,0,0,deny,146,146,0,1,0,1,0
58468,37965,0,0,deny,66,66,0,1,0,1,0
62058,443,34202,443,allow,8666,2933,5733,46,15,27,19
50864,443,18823,443,allow,6663,1556,5107,21,132,10,11
42298,40007,6536,40007,allow,148,86,62,2,30,1,1
55099,445,0,0,drop,70,70,0,1,0,1,0
50795,445,0,0,drop,66,66,0,1,0,1,0
50544,53,6922,53,allow,193,102,91,2,30,1,1
51479,25174,0,0,deny,62,62,0,1,0,1,0
58764,443,5482,443,allow,21960,14378,7582,49,18,26,23
37568,443,50535,443,allow,214,140,74,4,15,3,1
60294,30188,0,0,deny,66,66,0,1,0,1,0
56376,44847,0,0,deny,66,66,0,1,0,1,0
49603,53,29581,53,allow,199,102,97,2,30,1,1
3399,25174,0,0,deny,66,66,0,1,0,1,0
1903,43890,0,0,deny,66,66,0,1,0,1,0
53321,443,65410,443,allow,416,210,206,7,28,4,3
23519,25174,0,0,deny,146,146,0,1,0,1,0
2267,53,10348,53,allow,204,118,86,2,30,1,1
52237,53,52237,53,allow,220,90,130,2,30,1,1
58934,53,32905,53,allow,205,86,119,2,30,1,1
56637,53,18660,53,allow,214,110,104,2,30,1,1
45304,64147,0,0,deny,72,72,0,1,0,1,0
1943,48817,0,0,deny,66,66,0,1,0,1,0
65495,11392,0,0,deny,66,66,0,1,0,1,0
39617,80,39617,80,allow,419378,16035,403343,506,132,226,280
47080,80,47080,80,allow,276453,7832,268621,287,165,92,195
26048,21,0,0,deny,60,60,0,1,0,1,0
64381,53,4400,53,allow,168,86,82,2,32,1,1
13062,52752,0,0,deny,66,66,0,1,0,1,0
49841,445,0,0,drop,70,70,0,1,0,1,0
55797,53,36305,53,allow,177,94,83,2,31,1,1
57078,3389,57078,3389,allow,3407,1518,1889,16,17,9,7
37632,443,56701,443,allow,11338,2980,8358,31,46,18,13
56806,445,0,0,drop,70,70,0,1,0,1,0
49762,53,13712,53,allow,335,142,193,2,30,1,1
58688,53,58688,53,allow,235,92,143,2,30,1,1
60047,443,35596,443,allow,1350,689,661,14,44,8,6
59143,445,0,0,drop,66,66,0,1,0,1,0
64494,53,52141,53,allow,337,110,227,2,29,1,1
53771,37965,0,0,deny,66,66,0,1,0,1,0
63984,445,0,0,drop,66,66,0,1,0,1,0
17925,26467,0,0,deny,66,66,0,1,0,1,0
54201,443,55731,443,allow,499,425,74,4,0,3,1
61933,445,0,0,drop,66,66,0,1,0,1,0
50439,64147,0,0,deny,62,62,0,1,0,1,0
55466,53,45668,53,allow,177,94,83,2,30,1,1
48063,80,21248,80,allow,1638,1324,314,10,15,5,5
52431,64147,0,0,deny,62,62,0,1,0,1,0
10144,62609,0,0,deny,148,148,0,1,0,1,0
49600,53,23356,53,allow,243,94,149,2,30,1,1
52137,445,0,0,drop,70,70,0,1,0,1,0
55595,445,0,0,drop,70,70,0,1,0,1,0
51924,28016,24796,28016,allow,70,70,0,2,8,2,0
51599,445,0,0,drop,66,66,0,1,0,1,0
58847,443,24312,443,allow,3143,1064,2079,18,82,8,10
53226,445,0,0,drop,70,70,0,1,0,1,0
56146,445,0,0,drop,66,66,0,1,0,1,0
11494,51505,0,0,deny,146,146,0,1,0,1,0
42971,3478,43871,3478,allow,452,280,172,5,31,3,2
52802,445,0,0,drop,70,70,0,1,0,1,0
55193,53,45543,53,allow,200,102,98,2,30,1,1
58638,5900,0,0,deny,62,62,0,1,0,1,0
44399,443,14238,443,allow,11367,9355,2012,32,395,13,19
47913,25174,0,0,deny,146,146,0,1,0,1,0
50483,443,29109,443,allow,10050,1192,8858,28,81,14,14
64169,53,10688,53,allow,202,103,99,2,30,1,1
50359,80,14465,80,allow,1770,961,809,10,15,5,5
53314,64097,0,0,deny,66,66,0,1,0,1,0
8313,51505,0,0,deny,62,62,0,1,0,1,0
54985,53,30088,53,allow,177,94,83,2,30,1,1
31785,25174,0,0,deny,146,146,0,1,0,1,0
62640,445,0,0,drop,70,70,0,1,0,1,0
53231,443,53231,443,allow,1402,856,546,12,34,6,6
51969,37558,21407,37558,allow,70,70,0,2,8,2,0
1660,8696,0,0,deny,62,62,0,1,0,1,0
58497,445,0,0,drop,66,66,0,1,0,1,0
57717,445,0,0,drop,66,66,0,1,0,1,0
42968,56205,0,0,deny,146,146,0,1,0,1,0
36394,443,63478,443,allow,6485,1692,4793,23,170,13,10
12221,81,0,0,deny,60,60,0,1,0,1,0
37835,443,55999,443,allow,63724,45783,17941,171,123,85,86
55776,53,11863,53,allow,216,110,106,2,29,1,1
33147,443,60062,443,allow,7639,948,6691,25,395,9,16
55300,445,0,0,drop,70,70,0,1,0,1,0
49415,53,62672,53,allow,194,102,92,2,30,1,1
12694,12446,0,0,deny,62,62,0,1,0,1,0
51058,445,0,0,drop,66,66,0,1,0,1,0
50127,64147,0,0,deny,62,62,0,1,0,1,0
62101,443,33220,443,allow,1867,250,1617,8,120,4,4
39583,37965,0,0,deny,66,66,0,1,0,1,0
56948,53,55604,53,allow,183,94,89,2,29,1,1
58612,443,21355,443,allow,154,94,60,2,5,1,1
59787,445,0,0,drop,70,70,0,1,0,1,0
59257,445,0,0,drop,70,70,0,1,0,1,0
59770,445,0,0,drop,66,66,0,1,0,1,0
51409,443,17023,443,allow,1442,721,721,15,122,8,7
2864,25174,0,0,deny,66,66,0,1,0,1,0
49895,443,39538,443,allow,6060,1040,5020,20,34,11,9
49664,37965,0,0,deny,66,66,0,1,0,1,0
62908,993,3979,993,allow,8772,3614,5158,77,54,35,42
64399,53,19303,53,allow,373,90,283,4,53,2,2
53666,445,0,0,drop,70,70,0,1,0,1,0
59103,445,0,0,drop,70,70,0,1,0,1,0
50265,26650,50101,26650,allow,480,149,331,2,1201,1,1
65356,53,60802,53,allow,197,94,103,2,31,1,1
55286,37965,0,0,deny,66,66,0,1,0,1,0
58840,443,27383,443,allow,5108,700,4408,15,15,7,8
60508,55998,14688,55998,allow,70,70,0,2,8,2,0
57156,445,0,0,drop,66,66,0,1,0,1,0
58638,5900,0,0,deny,62,62,0,1,0,1,0
25091,64147,0,0,deny,66,66,0,1,0,1,0
50893,445,0,0,drop,70,70,0,1,0,1,0
43184,80,44137,80,allow,1972,1464,508,15,16,7,8
5588,5588,0,0,allow,3562,1936,1626,48,193,24,24
51525,35440,0,0,deny,66,66,0,1,0,1,0
55763,53,36537,53,allow,197,94,103,2,31,1,1
65189,28215,62292,28215,allow,259,78,181,2,29,1,1
16403,16386,35244,16386,allow,426,186,240,8,30,4,4
52042,53,52042,53,allow,478,292,186,5,30,3,2
26900,27017,12054,27017,allow,422,164,258,6,30,3,3
53627,1099,28999,1099,allow,320,140,180,6,7,3,3
57395,53,28814,53,allow,262,88,174,4,59,2,2
58638,5900,0,0,deny,62,62,0,1,0,1,0
49183,53,46145,53,allow,817,102,715,2,30,1,1
55958,53,32998,53,allow,177,94,83,2,30,1,1
51173,443,13645,443,allow,13772,1738,12034,26,31,12,14
59595,53,23581,53,allow,164,78,86,2,30,1,1
54459,445,0,0,drop,66,66,0,1,0,1,0
54518,25174,0,0,deny,146,146,0,1,0,1,0
59505,53733,0,0,deny,66,66,0,1,0,1,0
6666,3389,0,0,deny,60,60,0,1,0,1,0
54796,22114,0,0,deny,62,62,0,1,0,1,0
31654,65473,0,0,deny,148,148,0,1,0,1,0
56118,445,0,0,drop,70,70,0,1,0,1,0
53692,16624,3177,16624,allow,320,140,180,6,6,3,3
28391,80,28391,80,allow,12237,2818,9419,27,26,14,13
53189,62413,0,0,deny,62,62,0,1,0,1,0
54048,25174,0,0,deny,62,62,0,1,0,1,0
65016,53,63384,53,allow,215,94,121,2,29,1,1
9448,443,19728,443,allow,5691,503,5188,14,15,7,7
50299,445,0,0,drop,70,70,0,1,0,1,0
49424,53,32316,53,allow,100,100,0,1,0,1,0
1100,27540,17868,27540,allow,132,70,62,2,30,1,1
22856,22114,0,0,deny,66,66,0,1,0,1,0
64791,53,42823,53,allow,184,94,90,2,31,1,1
38770,5228,21583,5228,allow,6033,1874,4159,33,4073,11,22
59808,53,0,0,allow,86,86,0,1,30,1,0
63096,44847,0,0,deny,66,66,0,1,0,1,0
6881,21416,0,0,deny,146,146,0,1,0,1,0
53900,443,15989,443,allow,499,425,74,4,0,3,1
49519,80,21026,80,allow,2981,1514,1467,12,38,7,5
49473,80,51676,80,allow,388,262,126,7,29,5,2
3212,22114,0,0,deny,146,146,0,1,0,1,0
50563,37965,0,0,deny,66,66,0,1,0,1,0
64605,445,0,0,drop,70,70,0,1,0,1,0
53499,445,0,0,drop,66,66,0,1,0,1,0
56776,18318,59158,18318,allow,70,70,0,1,5,1,0
49262,53,46554,53,allow,168,86,82,2,30,1,1
49851,53,9637,53,allow,166,86,80,2,29,1,1
24311,22617,0,0,deny,60,60,0,1,0,1,0
64711,53,46738,53,allow,211,110,101,2,30,1,1
58826,443,32981,443,allow,5168,700,4468,16,15,7,9
60401,30046,40405,30046,allow,70,70,0,1,5,1,0
49429,443,33645,443,allow,8861,3484,5377,19,120,9,10
57240,53,0,0,allow,230,87,143,2,30,1,1
59711,445,0,0,drop,70,70,0,1,0,1,0
64751,53,57978,53,allow,178,94,84,2,30,1,1
50709,80,20258,80,allow,708,384,324,12,195,7,5
55238,21247,0,0,deny,62,62,0,1,0,1,0
36151,22,0,0,deny,60,60,0,1,0,1,0
49205,80,50738,80,allow,890,411,479,11,15,6,5
39336,443,55309,443,allow,7759,4000,3759,23,96,11,12
49343,53,1518,53,allow,209,110,99,2,30,1,1
33823,443,20715,443,allow,8237,1724,6513,31,270,16,15
10097,53,3471,53,allow,259,86,173,2,30,1,1
41689,443,36583,443,allow,1307513,51701,1255812,1486,148,576,910
49777,53,45833,53,allow,166,86,80,2,31,1,1
50697,80,53956,80,allow,2525,1403,1122,22,272,12,10
56606,443,12642,443,allow,7914,1925,5989,20,15,11,9
3181,53567,0,0,deny,66,66,0,1,0,1,0
15503,8624,29745,8624,allow,491,150,341,2,1200,1,1
49308,443,39770,443,allow,4256,2975,1281,23,47,12,11
50584,42504,10356,42504,allow,161,161,0,2,1199,2,0
64957,5555,0,0,deny,60,60,0,1,0,1,0
22240,22114,0,0,deny,62,62,0,1,0,1,0
53761,443,39818,443,allow,499,425,74,4,0,3,1
0,0,0,0,allow,244,244,0,2,0,2,0
51107,80,61498,80,allow,366,240,126,7,21,5,2
6882,27032,16689,27032,allow,1200,1200,0,9,1201,9,0
53692,44512,0,0,deny,66,66,0,1,0,1,0
54769,50584,0,0,deny,62,62,0,1,0,1,0
38637,443,8499,443,allow,12339,2392,9947,36,287,15,21
49309,443,31644,443,allow,4250,2969,1281,23,47,12,11
58638,5900,0,0,deny,62,62,0,1,0,1,0
59397,445,0,0,drop,70,70,0,1,0,1,0
59937,443,15432,443,allow,7701,3981,3720,27,70,12,15
55071,53,51447,53,allow,177,94,83,2,30,1,1
56894,445,0,0,drop,70,70,0,1,0,1,0
64618,53,41913,53,allow,305,100,205,4,54,2,2
57137,53,7336,53,allow,711,87,624,2,30,1,1
53716,443,15837,443,allow,70,70,0,1,5,1,0
35207,22114,0,0,deny,62,62,0,1,0,1,0
64125,53,8672,53,allow,198,101,97,2,31,1,1
6882,8999,49067,8999,allow,238,118,120,2,1200,1,1
48713,80,15220,80,allow,3588672,75353,3513319,3500,154,1175,2325
56359,443,2986,443,allow,3734,1750,1984,24,203,12,12
55305,53,27046,53,allow,176,176,0,3,46,3,0
64290,445,0,0,drop,66,66,0,1,0,1,0
62249,443,58132,443,allow,9251,6353,2898,25,120,13,12
49453,443,59315,443,allow,8251,2124,6127,21,16,11,10
59321,53,33396,53,allow,209,70,139,2,30,1,1
56616,53,21461,53,allow,183,94,89,2,30,1,1
65072,53,64909,53,allow,338,110,228,2,29,1,1
51674,80,17494,80,allow,533166,22786,510380,905,50,321,584
1356,57470,0,0,deny,72,72,0,1,0,1,0
55021,53,26465,53,allow,94,94,0,1,30,1,0
16057,56205,0,0,deny,66,66,0,1,0,1,0
56697,53,7977,53,allow,711,87,624,2,31,1,1
26457,80,26457,80,allow,17147,1829,15318,28,17,15,13
443,9986,0,0,deny,669,669,0,1,0,1,0
52549,445,0,0,drop,70,70,0,1,0,1,0
60521,443,45323,443,allow,45001,3799,41202,74,331,35,39
60030,443,28456,443,allow,711172,27430,683742,812,104,342,470
26906,22114,0,0,deny,66,66,0,1,0,1,0
64433,53,21792,53,allow,257,94,163,2,30,1,1
443,22238,0,0,deny,112,112,0,1,0,1,0
56787,53,13426,53,allow,209,110,99,2,30,1,1
55496,64097,0,0,deny,66,66,0,1,0,1,0
62875,445,0,0,drop,70,70,0,1,0,1,0
7954,53,7954,53,allow,226,90,136,2,29,1,1
63916,56318,49851,56318,allow,66,66,0,2,7,2,0
50646,443,35425,443,allow,6789,1020,5769,20,101,11,9
65454,53,35372,53,allow,218,86,132,2,31,1,1
15503,42286,2173,42286,allow,480,149,331,2,1200,1,1
49686,445,0,0,drop,70,70,0,1,0,1,0
58024,80,1081,80,allow,318,192,126,6,20,4,2
64995,53,32093,53,allow,199,102,97,2,30,1,1
58844,51505,0,0,deny,66,66,0,1,0,1,0
49872,80,54932,80,allow,31938,3363,28575,38,88,15,23
49594,53,49594,53,allow,199,90,109,2,30,1,1
63139,53,8265,53,allow,78,78,0,2,31,2,0
61278,56205,0,0,deny,66,66,0,1,0,1,0
26330,26348,0,0,deny,62,62,0,1,0,1,0
50970,443,47824,443,allow,469,403,66,4,0,3,1
60835,445,0,0,drop,70,70,0,1,0,1,0
61872,445,0,0,drop,70,70,0,1,0,1,0
2890,53,28510,53,allow,78,78,0,1,30,1,0
56432,35253,0,0,deny,66,66,0,1,0,1,0
49999,53,61068,53,allow,181,94,87,2,30,1,1
55230,53,3013,53,allow,183,94,89,2,30,1,1
55464,22114,0,0,deny,146,146,0,1,0,1,0
16013,61903,0,0,deny,145,145,0,1,0,1,0
62747,445,0,0,drop,66,66,0,1,0,1,0
56644,443,57838,443,allow,7862,1873,5989,20,15,11,9
52557,44847,0,0,deny,66,66,0,1,0,1,0
61350,445,0,0,drop,70,70,0,1,0,1,0
52660,443,21035,443,allow,5042,2002,3040,14,119,7,7
55922,53,46699,53,allow,423,102,321,2,30,1,1
56166,53,15271,53,allow,193,102,91,2,30,1,1
63018,53,50611,53,allow,384,166,218,2,29,1,1
51639,445,0,0,drop,66,66,0,1,0,1,0
58392,445,0,0,drop,70,70,0,1,0,1,0
58373,445,0,0,drop,70,70,0,1,0,1,0
54124,80,4965,80,allow,1594,1280,314,10,15,5,5
53204,445,0,0,drop,70,70,0,1,0,1,0
49418,27016,64137,27016,allow,270,78,192,2,30,1,1
59537,80,26442,80,allow,3892,1824,2068,21,187,12,9
49962,53,28111,53,allow,184,94,90,2,30,1,1
65187,53,58684,53,allow,199,102,97,2,31,1,1
49914,443,44270,443,allow,5895,728,5167,16,27,8,8
56616,445,0,0,drop,66,66,0,1,0,1,0
49459,53,35212,53,allow,199,102,97,2,31,1,1
57505,443,24632,443,allow,3640,606,3034,13,120,6,7
55265,53,65356,53,allow,199,102,97,2,30,1,1
56297,53,12569,53,allow,168,86,82,2,30,1,1
63334,37807,0,0,deny,66,66,0,1,0,1,0
58369,443,14100,443,allow,155345,11568,143777,195,195,73,122
56493,80,12499,80,allow,65864,3286,62578,76,135,30,46
49627,445,0,0,drop,70,70,0,1,0,1,0
50600,443,20473,443,allow,5035,3194,1841,23,96,12,11
56190,445,0,0,drop,66,66,0,1,0,1,0
65447,53,29961,53,allow,330,105,225,4,37,2,2
47744,80,34323,80,allow,1571,877,694,11,180,6,5
64092,445,0,0,drop,66,66,0,1,0,1,0
49800,53,2151,53,allow,183,94,89,2,31,1,1
52409,443,39608,443,allow,1369,708,661,14,24,8,6
49723,53,9926,53,allow,209,110,99,2,30,1,1
34779,443,25876,443,allow,34914,5279,29635,47,543,18,29
65400,53,61482,53,allow,211,102,109,2,30,1,1
55035,443,52274,443,allow,13310,3162,10148,31,46,16,15
55727,53,33963,53,allow,335,93,242,4,32,2,2
25758,53,25758,53,allow,198,90,108,2,30,1,1
64325,445,0,0,drop,70,70,0,1,0,1,0
65149,53,43485,53,allow,760,97,663,2,31,1,1
53251,53,53251,53,allow,247,98,149,2,34,1,1
54431,443,24894,443,allow,9398,2027,7371,33,270,14,19
55894,53,40691,53,allow,216,102,114,2,30,1,1
43704,37965,0,0,deny,66,66,0,1,0,1,0
20844,64147,0,0,deny,66,66,0,1,0,1,0
55199,53,58104,53,allow,212,108,104,2,30,1,1
50616,53,27498,53,allow,177,94,83,2,30,1,1
60554,445,0,0,drop,70,70,0,1,0,1,0
56910,53,3209,53,allow,199,102,97,2,30,1,1
52729,80,27175,80,allow,2255,997,1258,16,152,8,8
59635,7275,39827,7275,allow,448,78,370,6,25,1,5
54894,445,0,0,drop,70,70,0,1,0,1,0
49981,445,0,0,drop,70,70,0,1,0,1,0
54007,445,0,0,drop,66,66,0,1,0,1,0
51962,1024,18199,1024,allow,316,136,180,6,5,3,3
36628,80,54402,80,allow,78,78,0,2,8,2,0
56863,5900,0,0,deny,60,60,0,1,0,1,0
56388,443,41257,443,allow,15485,8351,7134,71,130,40,31
1036,64147,0,0,deny,62,62,0,1,0,1,0
56712,53,57306,53,allow,170,87,83,2,31,1,1
46640,443,38435,443,allow,10768,1726,9042,35,199,17,18
53837,443,2999,443,allow,499,425,74,4,0,3,1
65073,53,55415,53,allow,325,102,223,2,29,1,1
37453,443,30746,443,allow,8891,1846,7045,27,147,14,13
49721,443,52287,443,allow,4588,843,3745,14,52,7,7
54521,445,0,0,drop,66,66,0,1,0,1,0
58146,445,0,0,drop,66,66,0,1,0,1,0
55516,445,0,0,drop,70,70,0,1,0,1,0
65504,53,23026,53,allow,193,102,91,2,30,1,1
33804,443,22331,443,allow,5815,1128,4687,19,0,9,10
50413,80,12074,80,allow,8388,2010,6378,17,23,8,9
40500,48817,0,0,deny,143,143,0,1,0,1,0
63943,53,51755,53,allow,274,90,184,4,56,2,2
51083,445,0,0,drop,70,70,0,1,0,1,0
58616,80,39662,80,allow,1056,682,374,10,15,6,4
64191,53,1179,53,allow,212,102,110,2,30,1,1
53757,1,5970,1,allow,70,70,0,1,5,1,0
55807,445,0,0,drop,66,66,0,1,0,1,0
51050,445,0,0,drop,66,66,0,1,0,1,0
44912,443,31289,443,allow,414,140,274,7,26,3,4
54167,50584,0,0,deny,66,66,0,1,0,1,0
15503,62336,46736,62336,allow,127653507,122661116,4992391,161030,2162,82907,78123
50602,26467,0,0,deny,66,66,0,1,0,1,0
53197,25174,0,0,deny,62,62,0,1,0,1,0
40695,53,6681,53,allow,168,78,90,2,29,1,1
58751,9571,0,0,deny,62,62,0,1,0,1,0
64335,53,25261,53,allow,193,102,91,2,30,1,1
32955,80,30230,80,allow,14961,937,14024,25,16,11,14
60873,445,0,0,drop,70,70,0,1,0,1,0
50572,80,46272,80,allow,62,62,0,1,5,1,0
60514,39004,0,0,deny,66,66,0,1,0,1,0
49707,53,0,0,allow,82,82,0,1,31,1,0
56243,53,64458,53,allow,762,101,661,2,30,1,1
54305,39004,0,0,deny,145,145,0,1,0,1,0
36368,80,28918,80,allow,78,78,0,2,8,2,0
63740,64147,0,0,deny,66,66,0,1,0,1,0
43514,443,45895,443,allow,9643,2462,7181,26,146,11,15
62392,15503,0,0,deny,146,146,0,1,0,1,0
50137,445,0,0,drop,70,70,0,1,0,1,0
49772,53,62355,53,allow,181,94,87,2,29,1,1
49832,445,0,0,drop,70,70,0,1,0,1,0
58719,445,0,0,drop,70,70,0,1,0,1,0
49266,445,0,0,drop,70,70,0,1,0,1,0
51430,445,0,0,drop,70,70,0,1,0,1,0
33922,443,8890,443,allow,6084,1842,4242,26,329,14,12
50585,445,0,0,drop,70,70,0,1,0,1,0
6666,16010,0,0,deny,60,60,0,1,0,1,0
51968,445,0,0,drop,70,70,0,1,0,1,0
57669,64147,0,0,deny,66,66,0,1,0,1,0
51788,35787,52462,35787,allow,70,70,0,2,8,2,0
56660,80,51147,80,allow,234,234,0,4,12,4,0
64693,445,0,0,drop,70,70,0,1,0,1,0
56234,443,33837,443,allow,8971,2446,6525,50,347,23,27
59956,445,0,0,drop,70,70,0,1,0,1,0
51861,445,0,0,drop,70,70,0,1,0,1,0
56756,53,22443,53,allow,711,87,624,2,30,1,1
59170,445,0,0,drop,70,70,0,1,0,1,0
62591,445,0,0,drop,70,70,0,1,0,1,0
63600,445,0,0,drop,70,70,0,1,0,1,0
51090,80,46921,80,allow,10434,1041,9393,20,45,11,9
64539,53,18826,53,allow,177,94,83,2,29,1,1
9605,57470,0,0,deny,62,62,0,1,0,1,0
1024,57470,0,0,deny,72,72,0,1,0,1,0
64711,53,31035,53,allow,273,118,155,2,30,1,1
49657,443,3247,443,allow,6181,833,5348,19,52,9,10
50867,443,26907,443,allow,6351,1370,4981,18,131,9,9
3478,61463,0,0,deny,252,252,0,1,0,1,0
65460,53,23650,53,allow,184,94,90,2,30,1,1
65091,53,53299,53,allow,212,102,110,2,29,1,1
53543,445,0,0,deny,70,70,0,1,0,1,0
1733,65448,0,0,deny,66,66,0,1,0,1,0
64299,53,27762,53,allow,164,84,80,2,31,1,1
50639,445,0,0,drop,66,66,0,1,0,1,0
51042,22114,0,0,deny,66,66,0,1,0,1,0
56296,53,12716,53,allow,216,110,106,2,29,1,1
53175,445,0,0,drop,66,66,0,1,0,1,0
51633,445,0,0,drop,66,66,0,1,0,1,0
49227,53,48621,53,allow,718,94,624,2,30,1,1
55877,42466,20270,42466,allow,481,150,331,2,1200,1,1
56595,445,0,0,drop,70,70,0,1,0,1,0
27783,57470,0,0,deny,62,62,0,1,0,1,0
57344,53,44764,53,allow,228,110,118,2,30,1,1
59990,445,0,0,drop,70,70,0,1,0,1,0
56289,25174,0,0,deny,66,66,0,1,0,1,0
49861,80,57112,80,allow,4892,1157,3735,16,89,8,8
49900,443,21992,443,allow,6896,2139,4757,31,33,15,16
27005,33051,48719,33051,allow,887,126,761,2,31,1,1
58194,443,27436,443,allow,3108,1047,2061,14,136,7,7
56942,443,61847,443,allow,494,420,74,4,0,3,1
63925,53,36572,53,allow,682,199,483,6,46,3,3
53795,22719,46314,22719,allow,164,70,94,2,6,1,1
57555,443,43596,443,allow,25519,7061,18458,37,16,20,17
11136,57587,0,0,deny,62,62,0,1,0,1,0
53706,445,0,0,drop,70,70,0,1,0,1,0
54140,43890,0,0,deny,66,66,0,1,0,1,0
49073,443,18222,443,allow,8960,2497,6463,35,32,19,16
49418,57470,0,0,deny,66,66,0,1,0,1,0
56262,53,24636,53,allow,177,94,83,2,30,1,1
60550,50584,0,0,deny,62,62,0,1,0,1,0
62962,443,7055,443,allow,5036,2564,2472,15,125,8,7
59581,53,59581,53,allow,823,98,725,2,29,1,1
44546,32468,0,0,deny,62,62,0,1,0,1,0
49885,443,26423,443,allow,10216,2749,7467,27,86,14,13
35751,80,35751,80,allow,336615,15190,321425,383,31,159,224
0,0,0,0,deny,60,60,0,1,0,1,0
10039,443,49424,443,allow,12579,1722,10857,29,171,12,17
54592,445,0,0,drop,70,70,0,1,0,1,0
58638,5900,0,0,deny,62,62,0,1,0,1,0
53185,443,52524,443,allow,4442408,142153,4300255,4731,235,1574,3157
32971,443,57614,443,allow,300,180,120,4,15,2,2
49275,53,23304,53,allow,212,102,110,2,30,1,1
60175,445,0,0,drop,70,70,0,1,0,1,0
38515,443,54100,443,allow,12624,5203,7421,48,274,24,24
27005,1105,65392,1105,allow,855,126,729,2,29,1,1
27005,33059,58962,33059,allow,900,126,774,3,30,2,1
55699,53,21219,53,allow,211,102,109,2,29,1,1
51882,443,57503,443,allow,366,180,186,7,30,4,3
55340,445,0,0,drop,70,70,0,1,0,1,0
60097,53,60097,53,allow,193,90,103,2,30,1,1
35261,15503,0,0,deny,74,74,0,1,0,1,0
64714,53,3550,53,allow,168,86,82,2,31,1,1
3478,61463,0,0,deny,877,877,0,1,0,1,0
56624,53,36589,53,allow,177,94,83,2,31,1,1
54348,443,26587,443,allow,12594,5098,7496,32,35,17,15
50720,445,0,0,drop,70,70,0,1,0,1,0
64000,44847,0,0,deny,66,66,0,1,0,1,0
5200,6643,0,0,deny,145,145,0,1,0,1,0
55238,53,27709,53,allow,168,86,82,2,31,1,1
52296,445,0,0,drop,66,66,0,1,0,1,0
49536,445,0,0,drop,70,70,0,1,0,1,0
64051,19548,46632,19548,allow,66,66,0,2,8,2,0
0,0,0,0,deny,156,156,0,2,0,2,0
53807,28630,23692,28630,allow,70,70,0,1,4,1,0
55533,53,2426,53,allow,183,94,89,2,30,1,1
54618,5900,0,0,deny,60,60,0,1,0,1,0
56462,37965,0,0,deny,62,62,0,1,0,1,0
50811,445,0,0,drop,70,70,0,1,0,1,0
64999,445,0,0,drop,66,66,0,1,0,1,0
50822,443,34134,443,allow,89322,8569,80753,102,316,31,71
25510,48817,0,0,deny,140,140,0,1,0,1,0
64811,51221,0,0,deny,66,66,0,1,0,1,0
65403,53,11897,53,allow,199,102,97,2,31,1,1
55367,53,11900,53,allow,195,102,93,2,30,1,1
54430,445,0,0,drop,70,70,0,1,0,1,0
59959,80,18461,80,allow,1052,612,440,10,16,5,5
7285,51221,0,0,deny,66,66,0,1,0,1,0
49161,53,58186,53,allow,168,86,82,2,30,1,1
54889,443,50379,443,allow,4600,2214,2386,13,134,7,6
65451,53,9650,53,allow,194,102,92,2,31,1,1
63557,445,0,0,drop,70,70,0,1,0,1,0
57372,443,37935,443,allow,4612,700,3912,12,15,8,4
50123,445,0,0,drop,70,70,0,1,0,1,0
52153,12673,40206,12673,allow,316,136,180,6,6,3,3
57164,50584,0,0,deny,62,62,0,1,0,1,0
60479,53928,56520,53928,allow,70,70,0,1,5,1,0
54326,7000,54326,7000,allow,2958,1567,1391,15,15,8,7
51046,25174,0,0,deny,66,66,0,1,0,1,0
65466,53,3496,53,allow,733,86,647,2,31,1,1
65359,53,51803,53,allow,731,91,640,2,30,1,1
50069,445,0,0,drop,70,70,0,1,0,1,0
65187,53,19736,53,allow,392,86,306,2,30,1,1
56728,443,61064,443,allow,5367,725,4642,15,15,8,7
50290,53,11389,53,allow,211,110,101,2,30,1,1
52596,17372,0,0,deny,66,66,0,1,0,1,0
60450,56494,22389,56494,allow,70,70,0,1,5,1,0
11136,15503,0,0,deny,62,62,0,1,0,1,0
65177,53,43720,53,allow,258,110,148,2,30,1,1
56813,53,39428,53,allow,711,87,624,2,30,1,1
37168,5900,0,0,deny,60,60,0,1,0,1,0
43323,1,0,0,deny,62,62,0,1,0,1,0
56759,53,36247,53,allow,733,94,639,2,31,1,1
62434,445,0,0,drop,66,66,0,1,0,1,0
55320,22114,0,0,deny,146,146,0,1,0,1,0
65185,445,0,0,drop,70,70,0,1,0,1,0
49398,445,0,0,drop,70,70,0,1,0,1,0
49499,445,0,0,drop,70,70,0,1,0,1,0
60711,443,10147,443,allow,10569,3485,7084,27,515,15,12
1117,37965,0,0,deny,62,62,0,1,0,1,0
62110,443,43597,443,allow,10390,3051,7339,16,121,6,10
55093,53,0,0,allow,318,86,232,2,30,1,1
5588,5588,0,0,allow,3498,1872,1626,48,193,24,24
56487,80,45530,80,allow,42070,2703,39367,53,135,22,31
55372,53,7739,53,allow,448,184,264,6,30,3,3
55600,53,36294,53,allow,184,94,90,2,30,1,1
63324,445,0,0,drop,70,70,0,1,0,1,0
58638,5900,0,0,deny,62,62,0,1,0,1,0
64483,53,53474,53,allow,168,86,82,2,29,1,1
62371,445,0,0,drop,70,70,0,1,0,1,0
55122,53,17738,53,allow,173,94,79,2,30,1,1
56713,445,0,0,drop,70,70,0,1,0,1,0
65472,445,0,0,drop,70,70,0,1,0,1,0
58672,43890,0,0,deny,66,66,0,1,0,1,0
56071,53,13568,53,allow,193,102,91,2,30,1,1
3117,37965,0,0,deny,62,62,0,1,0,1,0
58638,5900,0,0,deny,62,62,0,1,0,1,0
13262,53,13262,53,allow,208,94,114,2,31,1,1
63397,26467,0,0,deny,66,66,0,1,0,1,0
64104,22114,0,0,deny,66,66,0,1,0,1,0
58907,445,0,0,drop,70,70,0,1,0,1,0
55826,53,27290,53,allow,86,86,0,2,34,2,0
50358,443,18545,443,allow,5133,2154,2979,26,81,13,13
55497,53,48989,53,allow,168,86,82,2,30,1,1
44847,15315,12919,15315,allow,150,150,0,1,1200,1,0
55312,64147,0,0,deny,66,66,0,1,0,1,0
55466,53,37366,53,allow,177,94,83,2,30,1,1
9328,443,4611,443,allow,5198,504,4694,13,15,7,6
59597,37965,0,0,deny,66,66,0,1,0,1,0
57026,445,0,0,drop,66,66,0,1,0,1,0
57269,445,0,0,drop,70,70,0,1,0,1,0
50700,80,27825,80,allow,142,142,0,1,5,1,0
8040,44847,0,0,deny,66,66,0,1,0,1,0
53810,443,53810,443,allow,7656,4622,3034,24,139,12,12
65125,445,0,0,drop,70,70,0,1,0,1,0
63690,64147,0,0,deny,66,66,0,1,0,1,0
49157,53,49157,53,allow,229,89,140,2,31,1,1
58500,445,0,0,drop,66,66,0,1,0,1,0
64966,53,26229,53,allow,376,126,250,2,29,1,1
53917,445,0,0,drop,66,66,0,1,0,1,0
55584,445,0,0,drop,70,70,0,1,0,1,0
58046,53,58046,53,allow,231,88,143,2,32,1,1
60196,53,0,0,deny,88,88,0,1,0,1,0
32520,47993,0,0,deny,66,66,0,1,0,1,0
58349,445,0,0,drop,70,70,0,1,0,1,0
58888,23718,0,0,deny,62,62,0,1,0,1,0
49168,443,13690,443,allow,519325,13798,505527,535,18,193,342
51113,80,51632,80,allow,1948,1092,856,10,20,7,3
51231,445,0,0,drop,70,70,0,1,0,1,0
35459,443,42175,443,allow,2350,1392,958,17,275,9,8
51627,445,0,0,drop,70,70,0,1,0,1,0
64677,53,58771,53,allow,183,94,89,2,30,1,1
20830,1433,0,0,deny,60,60,0,1,0,1,0
43495,5223,36493,5223,allow,142,142,0,1,4,1,0
26900,27017,33518,27017,allow,422,164,258,6,30,3,3
53853,445,0,0,drop,70,70,0,1,0,1,0
53198,53,24028,53,allow,365,86,279,2,30,1,1
64742,445,0,0,drop,66,66,0,1,0,1,0
10009,40008,62477,40008,allow,156,94,62,2,30,1,1
64579,53,27350,53,allow,178,94,84,2,30,1,1
51413,1,0,0,deny,72,72,0,1,0,1,0
51217,443,21771,443,allow,126,60,66,3,5,2,1
56469,53,63453,53,allow,177,94,83,2,31,1,1
63849,445,0,0,drop,70,70,0,1,0,1,0
1041,25174,0,0,deny,146,146,0,1,0,1,0
57887,445,0,0,drop,66,66,0,1,0,1,0
65442,443,8292,443,allow,3783,1087,2696,11,120,5,6
57109,443,58630,443,allow,7170,1436,5734,35,261,19,16
60815,445,0,0,drop,70,70,0,1,0,1,0
56663,53,41717,53,allow,181,94,87,2,33,1,1
51968,445,0,0,drop,70,70,0,1,0,1,0
64455,53,64455,53,allow,257,101,156,2,33,1,1
63494,445,0,0,drop,70,70,0,1,0,1,0
37525,443,14541,443,allow,9082,3492,5590,26,61,15,11
48864,123,32657,123,allow,184,94,90,2,30,1,1
5228,3434,0,0,deny,345,345,0,1,0,1,0
50579,53,55360,53,allow,174,89,85,2,31,1,1
53983,40500,52248,40500,allow,70,70,0,2,7,2,0
45941,23386,0,0,deny,60,60,0,1,0,1,0
443,9986,0,0,deny,66,66,0,1,0,1,0
38320,51505,0,0,deny,66,66,0,1,0,1,0
50633,445,0,0,drop,70,70,0,1,0,1,0
19858,38211,0,0,deny,145,145,0,1,0,1,0
49732,443,42008,443,allow,27125,14251,12874,99,23,57,42
56351,53,9188,53,allow,190,97,93,2,30,1,1
57424,53,63565,53,allow,197,102,95,2,30,1,1
59710,445,0,0,drop,70,70,0,1,0,1,0
9494,23,0,0,deny,60,60,0,1,0,1,0
16630,44847,0,0,deny,146,146,0,1,0,1,0
64544,445,0,0,drop,70,70,0,1,0,1,0
55879,53,40028,53,allow,184,94,90,2,30,1,1
56433,53,26629,53,allow,177,94,83,2,30,1,1
59538,80,28530,80,allow,1895,755,1140,11,14,6,5
43329,50584,0,0,deny,146,146,0,1,0,1,0
42186,443,1253,443,allow,3562,2096,1466,18,336,9,9
38695,443,12020,443,allow,1185199,19993,1165206,1088,16,289,799
53132,22448,0,0,allow,66,66,0,1,90,1,0
64595,64147,0,0,deny,66,66,0,1,0,1,0
51502,445,0,0,drop,66,66,0,1,0,1,0
49722,53,53892,53,allow,873,280,593,8,80,4,4
58163,20005,0,0,deny,60,60,0,1,0,1,0
53922,42285,39226,42285,allow,70,70,0,2,8,2,0
56113,445,0,0,drop,66,66,0,1,0,1,0
57197,445,0,0,drop,70,70,0,1,0,1,0
64602,53,17194,53,allow,751,94,657,2,29,1,1
49806,445,0,0,drop,70,70,0,1,0,1,0
39228,53,7632,53,allow,199,94,105,2,30,1,1
59862,443,40236,443,allow,5301,953,4348,17,28,9,8
65309,53,31055,53,allow,764,102,662,2,30,1,1
64968,53,11084,53,allow,87,87,0,1,31,1,0
60943,445,0,0,drop,70,70,0,1,0,1,0
55158,445,0,0,drop,66,66,0,1,0,1,0
50265,443,41315,443,allow,10788,6022,4766,36,144,20,16
55876,445,0,0,drop,70,70,0,1,0,1,0
19473,12430,61068,12430,allow,491,150,341,2,1200,1,1
59064,445,0,0,drop,66,66,0,1,0,1,0
56939,53,33751,53,allow,351,94,257,2,30,1,1
55678,32468,0,0,deny,66,66,0,1,0,1,0
51567,443,51567,443,allow,1654,916,738,16,126,7,9
6712,123,0,0,deny,90,90,0,1,0,1,0
1101,11119,0,0,deny,146,146,0,1,0,1,0
43205,22,43205,22,allow,6957,2330,4627,35,27,17,18
51948,17372,0,0,deny,62,62,0,1,0,1,0
58638,5900,0,0,deny,62,62,0,1,0,1,0
53376,445,0,0,drop,70,70,0,1,0,1,0
30016,36237,0,0,deny,62,62,0,1,0,1,0
49304,7010,49304,7010,allow,6247,4138,2109,21,15,13,8
56659,53,34690,53,allow,199,94,105,2,30,1,1
20706,23718,0,0,deny,66,66,0,1,0,1,0
54667,443,17668,443,allow,3989,1104,2885,12,122,5,7
56658,53,32323,53,allow,193,102,91,2,30,1,1
49586,53,25001,53,allow,212,94,118,2,29,1,1
56889,53,34055,53,allow,170,87,83,2,31,1,1
53538,445,0,0,drop,70,70,0,1,0,1,0
65515,53,35838,53,allow,718,94,624,2,30,1,1
57777,445,0,0,drop,70,70,0,1,0,1,0
50265,18183,50480,18183,allow,966,464,502,14,1200,7,7
63738,443,63738,443,allow,4349,1442,2907,19,27,11,8
63584,445,0,0,drop,70,70,0,1,0,1,0
55101,53,52227,53,allow,197,102,95,2,31,1,1
64956,53,13763,53,allow,565,92,473,4,38,2,2
56036,53,20624,53,allow,762,98,664,2,31,1,1
55229,53,8520,53,allow,173,94,79,2,30,1,1
55133,53,17544,53,allow,443,182,261,6,31,3,3
52214,27480,63759,27480,allow,70,70,0,1,5,1,0
53868,52706,33006,52706,allow,70,70,0,2,7,2,0
42034,28189,0,0,deny,145,145,0,1,0,1,0
54816,35440,0,0,deny,146,146,0,1,0,1,0
30472,53,56482,53,allow,223,86,137,2,30,1,1
14360,64147,0,0,deny,145,145,0,1,0,1,0
49554,53,50726,53,allow,210,110,100,2,30,1,1
60474,8999,5230,8999,allow,70,70,0,1,5,1,0
63380,23,0,0,deny,60,60,0,1,0,1,0
50459,53,40007,53,allow,811,94,717,2,30,1,1
61568,53,62912,53,allow,260,86,174,2,29,1,1
50368,445,0,0,drop,66,66,0,1,0,1,0
57862,445,0,0,drop,70,70,0,1,0,1,0
49162,53,41472,53,allow,183,94,89,2,30,1,1
60875,443,10095,443,allow,1786,172,1614,7,120,3,4
60312,80,47441,80,allow,2390,532,1858,11,75,6,5
57444,53,35555,53,allow,177,94,83,2,29,1,1
48673,443,24154,443,allow,18147,9173,8974,42,175,24,18
30599,46824,0,0,deny,66,66,0,1,0,1,0
45837,25174,0,0,deny,62,62,0,1,0,1,0
35924,443,41677,443,allow,4310,1640,2670,22,159,10,12
55116,445,0,0,drop,70,70,0,1,0,1,0
35154,60038,0,0,allow,66,66,0,1,91,1,0
56791,53,43251,53,allow,250,87,163,4,58,2,2
22075,53,22075,53,allow,404,259,145,3,33,2,1
57547,445,0,0,drop,70,70,0,1,0,1,0
2422,50584,0,0,deny,62,62,0,1,0,1,0
26553,57470,0,0,deny,62,62,0,1,0,1,0
61135,50265,0,0,deny,62,62,0,1,0,1,0
64707,445,0,0,drop,70,70,0,1,0,1,0
56987,445,0,0,drop,70,70,0,1,0,1,0
61730,25320,0,0,deny,62,62,0,1,0,1,0
50354,445,0,0,drop,66,66,0,1,0,1,0
61808,18375,0,0,deny,66,66,0,1,0,1,0
43723,5900,0,0,deny,60,60,0,1,0,1,0
50262,443,49732,443,allow,7608,2413,5195,19,120,9,10
56942,53,26338,53,allow,170,87,83,2,31,1,1
59096,8604,0,0,deny,66,66,0,1,0,1,0
31738,51505,0,0,deny,62,62,0,1,0,1,0
30188,59035,2297,59035,allow,1794,750,1044,12,4220,6,6
42030,25,0,0,deny,74,74,0,1,0,1,0
56871,53,58198,53,allow,745,93,652,2,30,1,1
64044,21989,15782,21989,allow,816,508,308,12,27,7,5
57131,31061,0,0,deny,145,145,0,1,0,1,0
49737,443,13001,443,allow,37094,22774,14320,125,27,72,53
11344,42873,0,0,deny,62,62,0,1,0,1,0
40932,443,14613,443,allow,4435,2949,1486,25,80,14,11
53521,443,50004,443,allow,130,70,60,2,15,1,1
52970,445,0,0,drop,70,70,0,1,0,1,0
65059,53,56951,53,allow,197,94,103,2,29,1,1
51729,63553,6792,63553,allow,70,70,0,1,5,1,0
55370,53,18357,53,allow,747,93,654,2,31,1,1
51546,445,0,0,deny,70,70,0,1,0,1,0
62908,21,0,0,deny,60,60,0,1,0,1,0
38091,7275,44065,7275,allow,350,210,140,6,15,4,2
54054,5228,24551,5228,allow,8767,2486,6281,45,6062,24,21
41774,53,0,0,allow,82,82,0,1,30,1,0
39799,443,18557,443,allow,5597,3595,2002,42,68,23,19
55582,53,45316,53,allow,170,87,83,2,30,1,1
0,0,0,0,allow,320,320,0,5,0,5,0
29424,37807,0,0,deny,66,66,0,1,0,1,0
56415,53,16835,53,allow,740,93,647,2,30,1,1
49687,53,13204,53,allow,197,102,95,2,31,1,1
17344,62413,0,0,deny,66,66,0,1,0,1,0
56484,443,15925,443,allow,2948,782,2166,10,121,5,5
50589,80,50589,80,allow,1714,1014,700,11,21,6,5
63331,51221,0,0,deny,62,62,0,1,0,1,0
58712,80,8787,80,allow,4176,3453,723,14,15,7,7
50346,445,0,0,drop,66,66,0,1,0,1,0
49539,53,54919,53,allow,198,94,104,2,31,1,1
55960,445,0,0,drop,70,70,0,1,0,1,0
1092,57470,0,0,deny,145,145,0,1,0,1,0
13554,44847,0,0,deny,62,62,0,1,0,1,0
55770,53,22601,53,allow,177,94,83,2,30,1,1
53073,80,1603,80,allow,2594,1200,1394,16,17,10,6
55137,445,0,0,drop,70,70,0,1,0,1,0
49207,443,35553,443,allow,9852,2190,7662,49,257,22,27
20746,53,43830,53,allow,191,86,105,2,30,1,1
55661,443,55661,443,allow,24362,8850,15512,52,47,32,20
64452,445,0,0,drop,70,70,0,1,0,1,0
12549,50265,0,0,deny,146,146,0,1,0,1,0
54962,53,32571,53,allow,188,96,92,2,30,1,1
50990,53,51984,53,allow,232,94,138,2,29,1,1
63213,445,0,0,drop,70,70,0,1,0,1,0
50949,445,0,0,drop,70,70,0,1,0,1,0
52633,30188,0,0,deny,66,66,0,1,0,1,0
51963,80,35774,80,allow,422,240,182,8,25,5,3
56955,53,57810,53,allow,182,93,89,2,31,1,1
56336,53,36932,53,allow,198,93,105,2,30,1,1
45392,443,53669,443,allow,1312,651,661,13,185,7,6
27005,50003,10902,50003,allow,1636,126,1510,4,31,2,2
45013,50584,0,0,deny,62,62,0,1,0,1,0
58627,445,0,0,drop,66,66,0,1,0,1,0
57410,25174,0,0,deny,62,62,0,1,0,1,0
63621,445,0,0,drop,70,70,0,1,0,1,0
63843,53603,44636,53603,allow,312,132,180,6,6,3,3
56098,445,0,0,drop,70,70,0,1,0,1,0
80,57411,0,0,deny,1514,1514,0,1,0,1,0
55683,445,0,0,drop,70,70,0,1,0,1,0
64511,53,2785,53,allow,305,102,203,2,30,1,1
55933,445,0,0,drop,66,66,0,1,0,1,0
61461,50584,0,0,deny,62,62,0,1,0,1,0
55641,53,45216,53,allow,184,94,90,2,31,1,1
64583,445,0,0,drop,70,70,0,1,0,1,0
49295,443,9529,443,allow,4179,2599,1580,27,75,13,14
27005,27015,49152,27015,allow,919,126,793,2,30,1,1
41858,53,0,0,allow,86,86,0,1,30,1,0
57139,53,51563,53,allow,166,86,80,2,30,1,1
55441,445,0,0,drop,70,70,0,1,0,1,0
443,54507,0,0,deny,82,82,0,1,0,1,0
28557,53,28557,53,allow,213,79,134,2,32,1,1
57731,443,57731,443,allow,5508,2261,3247,22,38,13,9
58633,445,0,0,drop,66,66,0,1,0,1,0
50583,80,50583,80,allow,17375,11554,5821,52,27,32,20
26332,57470,0,0,deny,62,62,0,1,0,1,0
49207,58751,6797,58751,allow,70,70,0,2,8,2,0
6881,6881,13981,6881,allow,150,150,0,1,1200,1,0
50713,53,50713,53,allow,198,90,108,2,30,1,1
63088,445,0,0,drop,70,70,0,1,0,1,0
51538,443,33433,443,allow,262,70,192,5,21,2,3
14175,10387,0,0,deny,159,159,0,1,0,1,0
10091,22114,0,0,deny,62,62,0,1,0,1,0
59891,445,0,0,drop,70,70,0,1,0,1,0
10775,35440,0,0,deny,66,66,0,1,0,1,0
49290,53,50836,53,allow,184,94,90,2,30,1,1
64977,53,18612,53,allow,334,94,240,2,30,1,1
64081,59517,43134,59517,allow,504,382,122,8,16,6,2
55107,53,60503,53,allow,816,102,714,2,30,1,1
49263,53,54586,53,allow,178,94,84,2,30,1,1
59283,53,37048,53,allow,359,86,273,2,30,1,1
57508,445,0,0,drop,70,70,0,1,0,1,0
55470,53,6327,53,allow,197,102,95,2,30,1,1
53053,443,10274,443,allow,9303,2569,6734,39,106,20,19
49735,443,60036,443,allow,378,256,122,7,18,5,2
64226,53,55510,53,allow,211,102,109,2,30,1,1
63407,445,0,0,drop,70,70,0,1,0,1,0
53333,445,0,0,drop,70,70,0,1,0,1,0
38723,15503,0,0,deny,146,146,0,1,0,1,0
58966,30188,0,0,deny,62,62,0,1,0,1,0
61000,57587,0,0,deny,146,146,0,1,0,1,0
54405,53,0,0,allow,174,79,95,2,30,1,1
8430,53,61822,53,allow,239209,233954,5255,2850,88,2822,28
64755,31573,0,0,deny,66,66,0,1,0,1,0
62197,22114,0,0,deny,62,62,0,1,0,1,0
53860,443,61776,443,allow,499,425,74,4,1,3,1
57411,443,31872,443,allow,214,140,74,4,15,3,1
50404,445,0,0,drop,70,70,0,1,0,1,0
59159,445,0,0,drop,70,70,0,1,0,1,0
59007,443,65066,443,allow,2608,1523,1085,19,15,10,9
30960,45742,3769,45742,allow,330,330,0,6,3609,6,0
21108,25174,0,0,deny,62,62,0,1,0,1,0
55634,58846,20945,58846,allow,70,70,0,1,5,1,0
57470,23848,47855,23848,allow,545,166,379,2,1199,1,1
50684,80,24128,80,allow,57576,29602,27974,239,175,118,121
52183,443,6530,443,allow,3560269,64410,3495859,2930,132,383,2547
35666,22114,0,0,deny,62,62,0,1,0,1,0
58638,5900,0,0,deny,62,62,0,1,0,1,0
62337,445,0,0,drop,70,70,0,1,0,1,0
64382,44847,0,0,deny,62,62,0,1,0,1,0
43891,8497,0,0,deny,148,148,0,1,0,1,0
57783,445,0,0,drop,70,70,0,1,0,1,0
63459,443,62292,443,allow,7782,1280,6502,22,79,10,12
46864,443,31788,443,allow,5349,1090,4259,18,31,10,8
58638,5900,0,0,deny,62,62,0,1,0,1,0
58104,443,9408,443,allow,2396,1144,1252,14,979,7,7
50962,5900,0,0,deny,60,60,0,1,0,1,0
27947,26467,0,0,deny,66,66,0,1,0,1,0
63846,443,9201,443,allow,3811,1538,2273,20,135,10,10
46741,53,52840,53,allow,221,75,146,2,30,1,1
53789,47191,44143,47191,allow,70,70,0,2,8,2,0
58097,445,0,0,drop,70,70,0,1,0,1,0
19473,45556,7986,45556,allow,469,150,319,2,1200,1,1
49278,445,0,0,drop,70,70,0,1,0,1,0
55681,53,52185,53,allow,711,87,624,2,30,1,1
65258,445,0,0,drop,70,70,0,1,0,1,0
12226,37965,0,0,deny,62,62,0,1,0,1,0
55594,53,44459,53,allow,752,93,659,2,31,1,1
3341,23117,0,0,deny,66,66,0,1,0,1,0
58576,445,0,0,drop,70,70,0,1,0,1,0
49887,443,18602,443,allow,977,590,387,10,87,6,4
61827,443,61827,443,allow,56634,10853,45781,76,175,34,42
50265,60276,27315,60276,allow,481,150,331,2,1200,1,1
58064,445,0,0,drop,70,70,0,1,0,1,0
53165,445,0,0,drop,70,70,0,1,0,1,0
59482,445,0,0,drop,70,70,0,1,0,1,0
49221,80,26224,80,allow,214,140,74,4,15,3,1
62029,36237,0,0,deny,66,66,0,1,0,1,0
45980,443,15108,443,allow,9611,2412,7199,44,20,22,22
31660,35440,0,0,deny,62,62,0,1,0,1,0
50631,443,5471,443,allow,4158,1021,3137,15,26,8,7
55972,53,35969,53,allow,193,102,91,2,29,1,1
27005,27246,16977,27246,allow,865,126,739,2,30,1,1
30960,45750,9630,45750,allow,66,66,0,1,3600,1,0
51107,80,41417,80,allow,8827,4961,3866,34,47,18,16
55049,443,41973,443,allow,5587,3950,1637,26,55,15,11
27005,27015,37450,27015,allow,879,126,753,2,31,1,1
1040,37965,0,0,deny,62,62,0,1,0,1,0
49486,53,9984,53,allow,177,94,83,2,30,1,1
52712,445,0,0,drop,66,66,0,1,0,1,0
64872,53,61410,53,allow,166,86,80,2,29,1,1
45313,64147,0,0,deny,62,62,0,1,0,1,0
57290,53,48036,53,allow,758,93,665,2,30,1,1
56050,53,26569,53,allow,178,94,84,2,30,1,1
38608,80,62728,80,allow,1289,303,986,12,16,5,7
58795,445,0,0,drop,70,70,0,1,0,1,0
53222,53,43522,53,allow,165,78,87,2,30,1,1
56836,1,16144,1,allow,130,70,60,2,5,1,1
6881,51413,17965,51413,allow,150,150,0,1,1200,1,0
56456,443,10392,443,allow,3528,1162,2366,10,120,5,5
39682,443,54017,443,allow,4439,862,3577,16,160,9,7
53540,34134,43313,34134,allow,70,70,0,2,7,2,0
36538,64147,0,0,deny,62,62,0,1,0,1,0
47413,23,0,0,deny,60,60,0,1,0,1,0
53718,445,0,0,drop,70,70,0,1,0,1,0
57860,443,46825,443,allow,1786,172,1614,7,120,3,4
60697,445,0,0,drop,66,66,0,1,0,1,0
64097,443,12441,443,allow,6372,1893,4479,15,120,8,7
58638,5900,0,0,deny,62,62,0,1,0,1,0
50108,53,30433,53,allow,969,86,883,2,30,1,1
8941,443,25184,443,allow,541643,15245,526398,507,416,103,404
49008,53,13913,53,allow,168,78,90,2,29,1,1
50973,445,0,0,drop,70,70,0,1,0,1,0
56397,53,56445,53,allow,179,94,85,2,31,1,1
55695,28182,59050,28182,allow,504,318,186,8,16,5,3
36404,80,8914,80,allow,534,460,74,6,15,5,1
54687,445,0,0,drop,70,70,0,1,0,1,0
64831,53,59275,53,allow,216,110,106,2,30,1,1
50079,443,3173,443,allow,32829,8718,24111,41,17,18,23
49934,80,37957,80,allow,1130,613,517,11,15,6,5
56888,445,0,0,drop,66,66,0,1,0,1,0
56111,53,50559,53,allow,168,94,74,2,30,1,1
57281,53,33051,53,allow,178,94,84,2,30,1,1
45375,1900,0,0,deny,139,139,0,1,0,1,0
48496,443,6861,443,allow,2661,1558,1103,18,807,7,11
58818,443,11066,443,allow,1413,876,537,12,25,6,6
62345,445,0,0,drop,66,66,0,1,0,1,0
38720,5222,21758,5222,allow,6262,2015,4247,35,48,17,18
64330,53,5975,53,allow,193,102,91,2,30,1,1
62392,15503,0,0,deny,62,62,0,1,0,1,0
64051,36829,0,0,deny,66,66,0,1,0,1,0
37534,443,60202,443,allow,6927,1883,5044,25,46,14,11
58638,5900,0,0,deny,62,62,0,1,0,1,0
63438,445,0,0,drop,70,70,0,1,0,1,0
53076,443,8791,443,allow,96850,6037,90813,150,177,55,95
43087,443,6969,443,allow,4909,1007,3902,14,35,8,6
55063,445,0,0,drop,66,66,0,1,0,1,0
1025,64147,0,0,deny,62,62,0,1,0,1,0
51939,445,0,0,drop,70,70,0,1,0,1,0
51752,31677,2687,31677,allow,70,70,0,2,8,2,0
52966,445,0,0,drop,66,66,0,1,0,1,0
41995,80,63213,80,allow,1105,634,471,11,15,6,5
53107,44060,27368,44060,allow,70,70,0,1,5,1,0
10004,57470,0,0,deny,145,145,0,1,0,1,0
49722,53,40518,53,allow,200,102,98,2,31,1,1
49370,11392,0,0,deny,62,62,0,1,0,1,0
56661,80,6258,80,allow,234,234,0,4,12,4,0
61195,56205,0,0,deny,62,62,0,1,0,1,0
65106,53,10929,53,allow,193,102,91,2,30,1,1
27005,27018,47282,27018,allow,891,126,765,2,31,1,1
443,10010,0,0,deny,60,60,0,1,0,1,0
55220,53,9691,53,allow,186,95,91,2,31,1,1
56395,53,34668,53,allow,199,102,97,2,29,1,1
56429,443,9683,443,allow,355939,9284,346655,365,121,125,240
29080,50265,0,0,deny,62,62,0,1,0,1,0
52626,44847,0,0,deny,66,66,0,1,0,1,0
62319,445,0,0,drop,70,70,0,1,0,1,0
54997,445,0,0,drop,70,70,0,1,0,1,0
55565,443,12183,443,allow,21087,4784,16303,25,146,7,18
49846,80,53092,80,allow,2644,1918,726,11,89,7,4
50584,12948,3713,12948,allow,346,161,185,2,1200,1,1
65250,53,12810,53,allow,900,110,790,2,30,1,1
52018,57866,0,0,deny,62,62,0,1,0,1,0
50826,445,0,0,drop,70,70,0,1,0,1,0
51965,48708,39312,48708,allow,70,70,0,2,8,2,0
49925,443,37960,443,allow,19134,7361,11773,40,148,19,21
61915,445,0,0,drop,70,70,0,1,0,1,0
56604,443,32761,443,allow,7314,2061,5253,29,92,15,14
57366,53,60542,53,allow,458,188,270,6,31,3,3
64997,53,9569,53,allow,164,84,80,2,31,1,1
56964,53,11967,53,allow,774,101,673,2,31,1,1
57192,53,42489,53,allow,177,94,83,2,30,1,1
60755,443,57914,443,allow,61151,2474,58677,61,25,16,45
49394,443,39992,443,allow,6211,1869,4342,18,181,8,10
60593,80,43950,80,allow,130,70,60,2,15,1,1
54573,80,38100,80,allow,2091,823,1268,12,45,7,5
52097,445,0,0,drop,70,70,0,1,0,1,0
56655,53,57319,53,allow,209,110,99,2,29,1,1
49727,443,37710,443,allow,5037,1135,3902,16,18,9,7
64778,53,20977,53,allow,269,110,159,2,30,1,1
59879,55783,0,0,deny,66,66,0,1,0,1,0
58836,51505,0,0,deny,66,66,0,1,0,1,0
51472,80,52276,80,allow,1410,797,613,10,302,6,4
55927,53,11810,53,allow,711,87,624,2,30,1,1
48617,443,54481,443,allow,10802,2841,7961,29,21,14,15
51114,445,0,0,drop,70,70,0,1,0,1,0
63976,445,0,0,drop,66,66,0,1,0,1,0
55062,443,36502,443,allow,14701,3640,11061,29,60,16,13
39462,80,39462,80,allow,1058,497,561,10,16,6,4
15875,50584,0,0,deny,62,62,0,1,0,1,0
56757,53,30520,53,allow,167,86,81,2,31,1,1
55641,445,0,0,drop,70,70,0,1,0,1,0
60230,443,4763,443,allow,1868,1229,639,18,151,11,7
49744,53,33458,53,allow,193,102,91,2,30,1,1
50079,445,0,0,drop,66,66,0,1,0,1,0
64313,53,9214,53,allow,226,110,116,2,30,1,1
49160,34021,0,0,reset-both,146,146,0,1,0,1,0
52156,445,0,0,drop,66,66,0,1,0,1,0
57225,445,0,0,drop,66,66,0,1,0,1,0
58182,443,50635,443,allow,15327,8305,7022,49,137,24,25
7539,53,7539,53,allow,194,87,107,2,30,1,1
64175,56502,0,0,deny,66,66,0,1,0,1,0
37912,443,31339,443,allow,130,70,60,3,5,2,1
60216,445,0,0,drop,70,70,0,1,0,1,0
55221,443,37010,443,allow,12954,2333,10621,20,120,9,11
56710,53,57885,53,allow,177,94,83,2,30,1,1
59597,445,0,0,drop,66,66,0,1,0,1,0
49216,63752,46385,63752,allow,70,70,0,2,8,2,0
49590,57470,0,0,deny,78,78,0,1,0,1,0
63924,445,0,0,drop,70,70,0,1,0,1,0
49842,7302,0,0,deny,62,62,0,1,0,1,0
44481,443,29524,443,allow,6336,1633,4703,22,256,12,10
50972,80,5146,80,allow,1095399,7129,1088270,832,37,106,726
58858,443,49748,443,allow,208,60,148,4,10,2,2
49657,53,23289,53,allow,198,94,104,2,30,1,1
50698,445,0,0,drop,70,70,0,1,0,1,0
48706,23393,0,0,deny,60,60,0,1,0,1,0
3478,61463,0,0,deny,1267,1267,0,1,0,1,0
57040,53,44476,53,allow,174,89,85,2,31,1,1
16059,22114,0,0,deny,146,146,0,1,0,1,0
58497,39004,0,0,deny,66,66,0,1,0,1,0
59157,443,21885,443,allow,7139,3570,3569,22,166,11,11
65196,53,54719,53,allow,392,90,302,4,55,2,2
52164,443,1593,443,allow,161883,8848,153035,177,54,64,113
51728,44847,0,0,deny,62,62,0,1,0,1,0
50252,445,0,0,drop,66,66,0,1,0,1,0
49578,445,0,0,drop,70,70,0,1,0,1,0
60735,28080,14759,28080,allow,70,70,0,1,5,1,0
54079,443,33342,443,allow,1050267,44816,1005451,1276,177,580,696
38112,443,61056,443,allow,1053962,45604,1008358,1190,69,456,734
41000,443,31779,443,allow,10675,5079,5596,88,588,47,41
59850,445,0,0,drop,66,66,0,1,0,1,0
53649,26085,23135,26085,allow,612,306,306,10,15,5,5
41193,443,45935,443,allow,6035,782,5253,16,109,8,8
65437,53,59504,53,allow,488,111,377,4,53,2,2
56387,53,17582,53,allow,183,94,89,2,30,1,1
57762,25174,0,0,deny,62,62,0,1,0,1,0
5588,5588,0,0,allow,3562,1936,1626,48,194,24,24
64595,53,13089,53,allow,299,93,206,4,35,2,2
49905,445,0,0,drop,70,70,0,1,0,1,0
58005,80,36908,80,allow,14927,10571,4356,39,75,20,19
49622,53,6128,53,allow,209,102,107,2,30,1,1
60864,443,60864,443,allow,8578,2549,6029,22,16,13,9
54612,445,0,0,drop,66,66,0,1,0,1,0
10540,25174,0,0,deny,146,146,0,1,0,1,0
56727,53,55377,53,allow,250,86,164,4,52,2,2
56069,445,0,0,drop,70,70,0,1,0,1,0
60793,53733,0,0,deny,66,66,0,1,0,1,0
55796,53,34450,53,allow,214,94,120,2,30,1,1
60972,445,0,0,drop,70,70,0,1,0,1,0
10416,64147,0,0,deny,62,62,0,1,0,1,0
50287,445,0,0,drop,66,66,0,1,0,1,0
51933,80,40922,80,allow,3676,2136,1540,15,40,10,5
41970,23,0,0,deny,60,60,0,1,0,1,0
47788,12250,0,0,deny,146,146,0,1,0,1,0
65324,445,0,0,drop,66,66,0,1,0,1,0
49964,53,63838,53,allow,380,110,270,2,31,1,1
63607,53,63607,53,allow,643,88,555,2,30,1,1
35100,11392,0,0,deny,62,62,0,1,0,1,0
49384,53,22527,53,allow,193,102,91,2,29,1,1
52743,15503,0,0,deny,66,66,0,1,0,1,0
58087,445,0,0,drop,70,70,0,1,0,1,0
64414,53,56894,53,allow,182,93,89,2,31,1,1
49671,53,37210,53,allow,182,93,89,2,31,1,1
56893,53,56270,53,allow,177,94,83,2,30,1,1
61223,37965,0,0,deny,66,66,0,1,0,1,0
12285,61248,0,0,reset-both,139,139,0,1,0,1,0
64219,51050,0,0,deny,66,66,0,1,0,1,0
56780,443,59581,443,allow,7922,1933,5989,20,16,11,9
11777,37965,0,0,deny,62,62,0,1,0,1,0
64740,53,21372,53,allow,204,96,108,2,0,1,1
58638,5900,0,0,deny,62,62,0,1,0,1,0
13525,51505,0,0,deny,62,62,0,1,0,1,0
55469,445,0,0,drop,70,70,0,1,0,1,0
44063,443,1759,443,allow,7762,2601,5161,18,137,8,10
56550,53,42634,53,allow,166,86,80,2,30,1,1
56840,53,4523,53,allow,242,110,132,2,30,1,1
61956,445,0,0,drop,70,70,0,1,0,1,0
55670,53,52397,53,allow,774,101,673,2,30,1,1
51414,50584,0,0,deny,66,66,0,1,0,1,0
58672,43890,0,0,deny,62,62,0,1,0,1,0
58564,50432,0,0,deny,66,66,0,1,0,1,0
56334,53,19616,53,allow,177,94,83,2,30,1,1
49432,53,34624,53,allow,812,110,702,2,30,1,1
55084,443,30495,443,allow,6936,819,6117,20,85,11,9
49459,53,33594,53,allow,199,102,97,2,30,1,1
64195,53,9148,53,allow,270,110,160,2,29,1,1
27005,23010,48268,23010,allow,881,126,755,2,30,1,1
59371,161,59371,161,allow,2085,880,1205,10,31,5,5
52525,80,56526,80,allow,3951,3437,514,13,15,8,5
64425,53,47922,53,allow,216,94,122,2,30,1,1
50470,61463,0,0,deny,86,86,0,1,0,1,0
56512,443,45161,443,allow,155750,151462,4288,169,215,112,57
58638,5900,0,0,deny,62,62,0,1,0,1,0
52074,445,0,0,drop,70,70,0,1,0,1,0
64710,53,1727,53,allow,195,102,93,2,29,1,1
64627,53,3343,53,allow,199,102,97,2,31,1,1
62623,443,47203,443,allow,5311,1546,3765,15,122,7,8
65495,443,43238,443,allow,418463,12360,406103,430,16,151,279
50561,445,0,0,drop,70,70,0,1,0,1,0
56161,62413,0,0,deny,66,66,0,1,0,1,0
53238,80,59852,80,allow,1726,940,786,8,55,5,3
52111,53162,33838,53162,allow,1330,706,624,10,33,6,4
53118,443,63279,443,allow,21933,11660,10273,206,188,114,92
50452,80,41109,80,allow,318,192,126,6,29,4,2
64098,10096,39565,10096,allow,66,66,0,2,8,2,0
60331,443,58220,443,allow,1867,1228,639,18,87,11,7
65168,53,17811,53,allow,185,102,83,2,30,1,1
57969,42873,0,0,deny,66,66,0,1,0,1,0
31521,57470,0,0,deny,145,145,0,1,0,1,0
37556,16384,16862,16384,allow,556,256,300,10,30,5,5
17643,50584,0,0,deny,62,62,0,1,0,1,0
47976,443,55009,443,allow,16187,11705,4482,33,159,19,14
55644,45579,20057,45579,allow,70,70,0,1,5,1,0
48424,53,48424,53,allow,220,90,130,2,30,1,1
49335,445,0,0,drop,70,70,0,1,0,1,0
53794,445,0,0,drop,70,70,0,1,0,1,0
26962,26467,0,0,deny,66,66,0,1,0,1,0
60494,33709,52651,33709,allow,504,318,186,8,16,5,3
65206,53,7490,53,allow,816,102,714,2,30,1,1
55645,445,0,0,drop,70,70,0,1,0,1,0
58638,5900,0,0,deny,62,62,0,1,0,1,0
49554,53,13063,53,allow,204,104,100,2,30,1,1
61183,25174,0,0,deny,62,62,0,1,0,1,0
51751,80,4770,80,allow,1854,1360,494,12,15,7,5
19473,58093,47634,58093,allow,460,150,310,2,1200,1,1
53353,26467,0,0,deny,62,62,0,1,0,1,0
52853,80,51325,80,allow,7502,3168,4334,41,140,22,19
58054,80,39200,80,allow,3561,3028,533,14,31,8,6
64790,53,41786,53,allow,183,94,89,2,30,1,1
60411,58131,51349,58131,allow,70,70,0,2,8,2,0
4328,7302,0,0,deny,66,66,0,1,0,1,0
60092,443,60092,443,allow,4700,1793,2907,19,28,11,8
49454,445,0,0,drop,70,70,0,1,0,1,0
57982,25174,0,0,deny,62,62,0,1,0,1,0
49174,53,59747,53,allow,199,102,97,2,33,1,1
56652,53,23903,53,allow,821,102,719,2,30,1,1
14923,51505,0,0,deny,66,66,0,1,0,1,0
56707,445,0,0,drop,66,66,0,1,0,1,0
60891,443,53303,443,allow,204,70,134,4,25,2,2
63381,443,50807,443,allow,11344,5681,5663,34,3601,20,14
64718,53,52565,53,allow,781,94,687,2,30,1,1
50957,445,0,0,drop,70,70,0,1,0,1,0
30188,64511,50224,64511,allow,854,150,704,4,1200,2,2
61431,443,56520,443,allow,352310,324883,27427,389,300,270,119
16361,60888,0,0,deny,146,146,0,1,0,1,0
61044,53,61044,53,allow,180,82,98,2,30,1,1
52393,445,0,0,drop,66,66,0,1,0,1,0
50994,443,10248,443,allow,3137,1855,1282,19,16,9,10
55465,443,38707,443,allow,12399,3942,8457,83,615,42,41
44410,443,17016,443,allow,2359,1436,923,18,38,10,8
57430,53,65274,53,allow,177,94,83,2,30,1,1
53395,50321,40284,50321,allow,7546,4168,3378,37,53,24,13
49665,80,35482,80,allow,8457,3062,5395,16,41,7,9
49898,53,38099,53,allow,184,94,90,2,31,1,1
51808,443,51808,443,allow,1466,856,610,13,27,6,7
57131,35776,0,0,deny,145,145,0,1,0,1,0
39858,443,36124,443,allow,167,107,60,2,5,1,1
51450,80,49507,80,allow,214,140,74,4,15,3,1
3478,61463,0,0,deny,180,180,0,1,0,1,0
26921,57470,0,0,deny,62,62,0,1,0,1,0
61897,445,0,0,drop,70,70,0,1,0,1,0
37991,443,2941,443,allow,9566,2592,6974,29,134,16,13
58068,443,17873,443,allow,543,303,240,8,5,4,4
50984,443,27569,443,allow,8023,3352,4671,19,80,11,8
49997,53,42691,53,allow,209,110,99,2,29,1,1
53794,39607,29958,39607,allow,70,70,0,2,8,2,0
33202,80,39571,80,allow,1114,534,580,12,15,7,5
62464,443,10700,443,allow,4595,3120,1475,18,33,10,8
55728,53,24572,53,allow,195,102,93,2,31,1,1
64888,53,19204,53,allow,718,94,624,2,30,1,1
23174,80,23174,80,allow,490,264,226,8,31,5,3
64035,25174,0,0,deny,62,62,0,1,0,1,0
49417,38558,0,0,deny,66,66,0,1,0,1,0
52403,443,54910,443,allow,8811,3668,5143,26,126,13,13
54542,443,54542,443,allow,150554,18764,131790,192,117,95,97
56622,53,24570,53,allow,179,94,85,2,30,1,1
56557,53,49880,53,allow,214,110,104,2,29,1,1
64673,6881,0,0,deny,66,66,0,1,0,1,0
55179,53,17808,53,allow,183,94,89,2,30,1,1
64962,53,10417,53,allow,196,94,102,2,30,1,1
64450,445,0,0,drop,66,66,0,1,0,1,0
57603,80,12542,80,allow,886,886,0,1,120,1,0
54934,445,0,0,drop,70,70,0,1,0,1,0
54278,53,0,0,allow,82,82,0,1,30,1,0
61097,445,0,0,drop,70,70,0,1,0,1,0
55190,443,14814,443,allow,12801,4250,8551,40,118,21,19
59237,53,43242,53,allow,164,78,86,2,30,1,1
57585,443,57585,443,allow,2504,1458,1046,21,87,10,11
64617,445,0,0,drop,66,66,0,1,0,1,0
65165,53,5142,53,allow,177,94,83,2,30,1,1
64357,53,38839,53,allow,469,103,366,4,43,2,2
52294,445,0,0,drop,66,66,0,1,0,1,0
56827,53,30639,53,allow,195,102,93,2,29,1,1
49848,53,25784,53,allow,167,86,81,2,30,1,1
51767,59158,56330,59158,allow,70,70,0,1,5,1,0
64172,53,18592,53,allow,194,99,95,2,30,1,1
36068,80,51482,80,allow,41269,2915,38354,62,33,32,30
53659,445,0,0,drop,70,70,0,1,0,1,0
63622,445,0,0,drop,70,70,0,1,0,1,0
50254,44847,0,0,deny,66,66,0,1,0,1,0
58731,445,0,0,drop,70,70,0,1,0,1,0
64706,53,5159,53,allow,179,94,85,2,30,1,1
50500,53,52272,53,allow,164,84,80,2,30,1,1
49243,53,19778,53,allow,212,102,110,2,30,1,1
36858,50265,0,0,deny,146,146,0,1,0,1,0
53819,9472,27834,9472,allow,70,70,0,2,7,2,0
65076,53,51472,53,allow,215,94,121,2,29,1,1
58638,5900,0,0,deny,62,62,0,1,0,1,0
59897,445,0,0,drop,70,70,0,1,0,1,0
58501,445,0,0,drop,66,66,0,1,0,1,0
52090,64823,30736,64823,allow,634,568,66,8,29,7,1
49942,53,42847,53,allow,264,94,170,2,31,1,1
64338,53,41701,53,allow,200,102,98,2,30,1,1
59663,445,0,0,drop,66,66,0,1,0,1,0
63463,53,56932,53,allow,199,86,113,2,29,1,1
45057,443,53651,443,allow,1394,733,661,14,80,8,6
6712,161,0,0,deny,82,82,0,1,0,1,0
55786,53,7570,53,allow,193,102,91,2,30,1,1
53578,34129,11045,34129,allow,70,70,0,2,7,2,0
61399,445,0,0,drop,70,70,0,1,0,1,0
58481,445,0,0,drop,70,70,0,1,0,1,0
55666,53,48851,53,allow,728,96,632,2,30,1,1
50372,445,0,0,drop,70,70,0,1,0,1,0
49675,53,62598,53,allow,199,102,97,2,29,1,1
54992,53,12659,53,allow,190,97,93,2,31,1,1
52917,445,0,0,drop,70,70,0,1,0,1,0
53776,37650,27111,37650,allow,70,70,0,2,7,2,0
64580,53,16498,53,allow,176,90,86,2,31,1,1
65394,53,54686,53,allow,230,94,136,2,30,1,1
65495,53,16317,53,allow,209,110,99,2,30,1,1
50197,64147,0,0,deny,66,66,0,1,0,1,0
60192,35440,0,0,deny,66,66,0,1,0,1,0
55849,53,49045,53,allow,195,102,93,2,30,1,1
50319,443,50669,443,allow,9933,2306,7627,27,82,13,14
45908,33330,0,0,deny,60,60,0,1,0,1,0
56074,445,0,0,drop,70,70,0,1,0,1,0
58638,5900,0,0,deny,62,62,0,1,0,1,0
62353,445,0,0,drop,70,70,0,1,0,1,0
51313,64147,0,0,deny,62,62,0,1,0,1,0
56632,53,26751,53,allow,200,94,106,2,29,1,1
65286,53,2453,53,allow,369,102,267,2,30,1,1
52009,1035,48428,1035,allow,316,136,180,6,7,3,3
61185,54532,0,0,deny,62,62,0,1,0,1,0
49240,53,28241,53,allow,198,101,97,2,30,1,1
55696,445,0,0,drop,70,70,0,1,0,1,0
46856,25174,0,0,deny,62,62,0,1,0,1,0
443,41237,0,0,deny,89,89,0,1,0,1,0
51538,445,0,0,drop,70,70,0,1,0,1,0
44517,53,22276,53,allow,306,212,94,3,29,2,1
50067,64147,0,0,deny,62,62,0,1,0,1,0
38852,37965,0,0,deny,62,62,0,1,0,1,0
19875,30170,0,0,deny,145,145,0,1,0,1,0
55797,53,43104,53,allow,194,102,92,2,30,1,1
54895,445,0,0,drop,70,70,0,1,0,1,0
40204,40039,52941,40039,allow,152,90,62,2,31,1,1
59752,443,31611,443,allow,12150,1262,10888,29,41,13,16
61385,80,34601,80,allow,30257,2427,27830,45,255,22,23
53318,56648,63034,56648,allow,672,432,240,10,142,6,4
63777,80,2556,80,allow,314,192,122,6,15,4,2
49415,53,54397,53,allow,188,96,92,2,31,1,1
64637,53,20905,53,allow,810,108,702,2,30,1,1
60730,443,28797,443,allow,14776,5238,9538,41,175,21,20
65499,443,30170,443,allow,410116,12150,397966,421,16,148,273
34996,5222,11344,5222,allow,8140,2222,5918,42,201,22,20
64752,445,0,0,drop,70,70,0,1,0,1,0
38653,443,4233,443,allow,9664,1703,7961,22,15,11,11
61878,445,0,0,drop,66,66,0,1,0,1,0
52749,64147,0,0,deny,66,66,0,1,0,1,0
48646,80,48646,80,allow,1916,1467,449,10,20,6,4
58638,5900,0,0,deny,62,62,0,1,0,1,0
48740,443,37273,443,allow,7868,2194,5674,26,36,13,13
42338,443,46950,443,allow,4181,998,3183,14,26,7,7
53573,445,0,0,drop,70,70,0,1,0,1,0
56391,445,0,0,drop,70,70,0,1,0,1,0
45941,23388,0,0,deny,60,60,0,1,0,1,0
54206,25174,0,0,deny,62,62,0,1,0,1,0
49240,443,49240,443,allow,8448,3368,5080,25,48,15,10
57470,1073,4669,1073,allow,402,132,270,6,1209,3,3
53950,32057,54034,32057,allow,70,70,0,1,4,1,0
57301,53,40888,53,allow,177,94,83,2,29,1,1
50046,22114,0,0,deny,62,62,0,1,0,1,0
50081,57470,0,0,deny,66,66,0,1,0,1,0
52632,443,1395,443,allow,4399,1857,2542,28,136,14,14
52858,445,0,0,drop,70,70,0,1,0,1,0
54210,64097,0,0,deny,66,66,0,1,0,1,0
53117,37529,25510,37529,allow,70,70,0,2,8,2,0
55831,53,4843,53,allow,183,94,89,2,30,1,1
49805,445,0,0,drop,70,70,0,1,0,1,0
64384,53,46498,53,allow,350,94,256,2,30,1,1
60064,445,0,0,drop,70,70,0,1,0,1,0
52116,64692,45907,64692,allow,70,70,0,2,8,2,0
49575,53,46030,53,allow,775,102,673,2,29,1,1
54489,443,33538,443,allow,4263,2019,2244,14,136,7,7
63014,53,26673,53,allow,304,86,218,2,29,1,1
64280,53,51701,53,allow,211,94,117,2,30,1,1
51414,22,0,0,deny,60,60,0,1,0,1,0
58673,443,29883,443,allow,11116,2910,8206,30,20,16,14
32051,37965,0,0,deny,62,62,0,1,0,1,0
64316,53,59418,53,allow,184,94,90,2,31,1,1
49465,443,57765,443,allow,11184,6821,4363,27,53,14,13
64204,53,27061,53,allow,264,102,162,2,31,1,1
51046,25174,0,0,deny,62,62,0,1,0,1,0
37999,49152,14143,49152,allow,156,156,0,3,8,3,0
60261,25174,0,0,deny,66,66,0,1,0,1,0
55011,445,0,0,drop,70,70,0,1,0,1,0
56100,57470,0,0,deny,62,62,0,1,0,1,0
54166,445,0,0,drop,66,66,0,1,0,1,0
62579,57866,0,0,deny,66,66,0,1,0,1,0
53419,28189,0,0,deny,60,60,0,1,0,1,0
443,61686,0,0,deny,1484,1484,0,1,0,1,0
4427,50584,0,0,deny,62,62,0,1,0,1,0
57877,445,0,0,drop,70,70,0,1,0,1,0
3504,23,0,0,deny,60,60,0,1,0,1,0
56360,53,26019,53,allow,184,102,82,2,30,1,1
49935,443,48016,443,allow,366,180,186,7,28,4,3
64058,53,58322,53,allow,280,110,170,2,30,1,1
65049,53,34852,53,allow,199,102,97,2,30,1,1
58439,443,54279,443,allow,2659,1417,1242,19,276,9,10
27005,1104,16545,1104,allow,870,126,744,2,30,1,1
64418,445,0,0,drop,66,66,0,1,0,1,0
55282,445,0,0,drop,70,70,0,1,0,1,0
55588,53,17857,53,allow,168,86,82,2,34,1,1
65250,22114,0,0,deny,62,62,0,1,0,1,0
53565,58695,4400,58695,allow,70,70,0,1,5,1,0
51630,80,41968,80,allow,7679,5325,2354,15,29,8,7
20724,19750,0,0,deny,78,78,0,1,0,1,0
58638,5900,58638,5900,allow,156,62,94,2,10,1,1
63447,44847,0,0,deny,62,62,0,1,0,1,0
65145,53,64400,53,allow,338,110,228,2,30,1,1
25222,37965,0,0,deny,62,62,0,1,0,1,0
51315,445,0,0,drop,70,70,0,1,0,1,0
29706,50584,0,0,deny,66,66,0,1,0,1,0
56004,53,58058,53,allow,178,94,84,2,30,1,1
59309,445,0,0,drop,70,70,0,1,0,1,0
60150,445,0,0,drop,70,70,0,1,0,1,0
27988,40031,63445,40031,allow,140,78,62,2,30,1,1
35194,57470,0,0,deny,74,74,0,1,0,1,0
57002,53,39237,53,allow,211,94,117,2,30,1,1
53751,22266,31272,22266,allow,754,502,252,11,20,7,4
54140,17372,0,0,deny,66,66,0,1,0,1,0
55970,53,39090,53,allow,810,108,702,2,31,1,1
16387,7205,0,0,deny,60,60,0,1,0,1,0
49782,80,13908,80,allow,1661,1147,514,9,210,5,4
59424,50265,0,0,deny,74,74,0,1,0,1,0
51594,53,0,0,allow,206,95,111,2,31,1,1
55939,53,57194,53,allow,193,102,91,2,31,1,1
11136,15503,0,0,deny,62,62,0,1,0,1,0
65018,53,40867,53,allow,198,94,104,2,30,1,1
37737,443,61948,443,allow,190013,14784,175229,238,206,101,137
57354,443,9548,443,allow,28807,2716,26091,54,466,21,33
60602,5222,39358,5222,allow,5564,2206,3358,50,310,20,30
6247,51221,0,0,deny,78,78,0,1,0,1,0
56224,53,54618,53,allow,221,102,119,2,30,1,1
49705,22,49705,22,allow,1108,66,1042,3,15,2,1
57038,53,18190,53,allow,240,86,154,2,30,1,1
55353,53,50896,53,allow,311,86,225,4,55,2,2
50603,445,0,0,drop,70,70,0,1,0,1,0
52008,49383,19063,49383,allow,70,70,0,1,5,1,0
57283,64147,0,0,deny,66,66,0,1,0,1,0
56901,445,0,0,drop,70,70,0,1,0,1,0
50939,80,16478,80,allow,1375,1038,337,7,137,4,3
53221,53,3242,53,allow,165,78,87,2,30,1,1
55405,53,37369,53,allow,199,102,97,2,30,1,1
50143,445,0,0,drop,70,70,0,1,0,1,0
55533,53,40009,53,allow,183,94,89,2,30,1,1
63586,443,51785,443,allow,12760,2205,10555,39,122,21,18
50913,445,0,0,drop,66,66,0,1,0,1,0
57005,53,13005,53,allow,199,94,105,2,30,1,1
37271,443,4038,443,allow,51402,5964,45438,86,153,32,54
18570,2323,0,0,deny,60,60,0,1,0,1,0
57537,443,24448,443,allow,130,70,60,3,5,2,1
59624,445,0,0,drop,70,70,0,1,0,1,0
19245,64147,0,0,deny,62,62,0,1,0,1,0
56338,443,8628,443,allow,11148,3099,8049,26,24,15,11
50857,26467,0,0,deny,66,66,0,1,0,1,0
65360,445,0,0,drop,66,66,0,1,0,1,0
52816,445,0,0,drop,66,66,0,1,0,1,0
51999,37965,0,0,deny,62,62,0,1,0,1,0
62614,445,0,0,drop,66,66,0,1,0,1,0
52471,445,0,0,drop,66,66,0,1,0,1,0
57408,53,37720,53,allow,195,102,93,2,30,1,1
39953,80,18059,80,allow,1035,564,471,10,15,5,5
51594,53,0,0,allow,206,95,111,2,30,1,1
51708,445,0,0,drop,70,70,0,1,0,1,0
11028,443,11028,443,allow,6671,3244,3427,26,30,16,10
60412,12965,23315,12965,allow,70,70,0,2,8,2,0
51752,445,0,0,drop,66,66,0,1,0,1,0
26449,80,26449,80,allow,642,338,304,10,33,6,4
64048,53,38443,53,allow,209,110,99,2,30,1,1
38234,443,15725,443,allow,9807,2542,7265,47,19,24,23
58279,443,21713,443,allow,3878,1156,2722,14,136,7,7
64010,445,0,0,drop,70,70,0,1,0,1,0
54332,445,0,0,drop,66,66,0,1,0,1,0
56411,50584,0,0,deny,62,62,0,1,0,1,0
50458,53,29574,53,allow,177,94,83,2,31,1,1
50660,80,5489,80,allow,875,327,548,9,15,5,4
56004,53,53891,53,allow,177,94,83,2,30,1,1
63397,26467,0,0,deny,66,66,0,1,0,1,0
64099,53,12065,53,allow,227,110,117,2,30,1,1
49194,65100,3468,65100,allow,624,318,306,10,15,5,5
25151,58833,0,0,deny,62,62,0,1,0,1,0
35944,23,0,0,deny,60,60,0,1,0,1,0
53471,161,0,0,allow,5907,2302,3605,22,30,11,11
53839,443,31646,443,allow,499,425,74,4,0,3,1
59905,443,62793,443,allow,21212,14546,6666,43,362,24,19
27988,40021,42591,40021,allow,245,182,63,2,30,1,1
62717,445,0,0,drop,66,66,0,1,0,1,0
63992,53,39861,53,allow,199,102,97,2,30,1,1
55367,53,40346,53,allow,195,102,93,2,30,1,1
56067,53,59693,53,allow,294,102,192,2,30,1,1
37965,30982,7359,30982,allow,528,528,0,9,1199,9,0
60131,445,0,0,drop,70,70,0,1,0,1,0
58476,443,24063,443,allow,25370,5607,19763,40,138,18,22
60840,443,45920,443,allow,54975,32043,22932,71,319,40,31
52450,445,0,0,drop,70,70,0,1,0,1,0
62670,445,0,0,drop,66,66,0,1,0,1,0
55782,53,43309,53,allow,245,94,151,2,29,1,1
60465,445,0,0,drop,70,70,0,1,0,1,0
54124,443,54124,443,allow,105609,16179,89430,150,84,79,71
51610,443,19441,443,allow,6952,3608,3344,27,21,14,13
34574,443,39427,443,allow,130,70,60,2,15,1,1
52473,445,0,0,drop,66,66,0,1,0,1,0
49913,53,15271,53,allow,177,94,83,2,30,1,1
50394,445,0,0,drop,70,70,0,1,0,1,0
53263,443,15903,443,allow,14269,5761,8508,43,18,23,20
1111,25174,0,0,deny,62,62,0,1,0,1,0
49416,53,31346,53,allow,177,94,83,2,31,1,1
49380,53,64533,53,allow,199,102,97,2,30,1,1
55769,53,28226,53,allow,373,103,270,4,43,2,2
49199,53,25125,53,allow,193,102,91,2,30,1,1
60975,443,27000,443,allow,333131,17461,315670,435,72,211,224
44805,443,37165,443,allow,6975,2168,4807,20,15,11,9
55695,53,64745,53,allow,177,94,83,2,29,1,1
58556,445,0,0,drop,66,66,0,1,0,1,0
59420,53,63231,53,allow,224,78,146,2,30,1,1
38708,443,36955,443,allow,90166,3481,86685,96,15,31,65
50349,80,24554,80,allow,3909,888,3021,12,15,6,6
60125,445,0,0,drop,66,66,0,1,0,1,0
56035,445,0,0,drop,70,70,0,1,0,1,0
64701,53,64701,53,allow,265,111,154,2,30,1,1
49232,445,0,0,drop,70,70,0,1,0,1,0
57981,445,0,0,drop,70,70,0,1,0,1,0
36017,53,46700,53,allow,198,93,105,2,31,1,1
49378,445,0,0,drop,66,66,0,1,0,1,0
36897,443,23482,443,allow,6351,4202,2149,35,94,18,17
59779,443,38576,443,allow,142,142,0,1,5,1,0
51674,51505,0,0,deny,66,66,0,1,0,1,0
51136,445,0,0,drop,70,70,0,1,0,1,0
50999,443,32321,443,allow,3051,1801,1250,18,16,8,10
57343,445,0,0,drop,70,70,0,1,0,1,0
43063,57470,0,0,deny,62,62,0,1,0,1,0
55060,80,45377,80,allow,1289,724,565,11,26,6,5
62153,35440,0,0,deny,66,66,0,1,0,1,0
53335,445,0,0,drop,70,70,0,1,0,1,0
60292,80,43938,80,allow,1462,864,598,11,144,6,5
60901,443,55846,443,allow,622058,33681,588377,765,65,327,438
57268,443,29567,443,allow,11546,3604,7942,38,120,20,18
45908,3383,0,0,deny,60,60,0,1,0,1,0
0,0,0,0,deny,156,156,0,2,0,2,0
56170,53,63567,53,allow,198,102,96,2,30,1,1
54631,44847,0,0,deny,74,74,0,1,0,1,0
55694,445,0,0,drop,70,70,0,1,0,1,0
45017,443,13860,443,allow,11771,2624,9147,50,20,25,25
17579,57470,0,0,deny,62,62,0,1,0,1,0
2780,23117,0,0,deny,66,66,0,1,0,1,0
60191,443,1843,443,allow,7292,950,6342,19,125,9,10
50454,80,32603,80,allow,4185,3618,567,14,34,8,6
54854,19847,0,0,deny,66,66,0,1,0,1,0
53579,42707,0,0,deny,66,66,0,1,0,1,0
53016,80,9240,80,allow,4419,271,4148,13,28,3,10
47625,53,55385,53,allow,168,78,90,2,30,1,1
54007,445,0,0,drop,70,70,0,1,0,1,0
64985,53,10267,53,allow,86,86,0,1,60,1,0
22975,23,0,0,deny,60,60,0,1,0,1,0
55193,53,55120,53,allow,200,102,98,2,33,1,1
55441,53,20729,53,allow,216,110,106,2,30,1,1
50827,443,49837,443,allow,7298,2661,4637,21,17,11,10
1431,30041,0,0,deny,62,62,0,1,0,1,0
40801,443,33203,443,allow,3289,1265,2024,13,32,7,6
65386,53,25163,53,allow,194,99,95,2,30,1,1
60058,25174,0,0,deny,66,66,0,1,0,1,0
63495,50584,0,0,deny,66,66,0,1,0,1,0
63960,53,45995,53,allow,178,94,84,2,30,1,1
65321,53,63779,53,allow,283,103,180,4,54,2,2
16687,10214,0,0,deny,66,66,0,1,0,1,0
49901,53,54026,53,allow,776,102,674,2,30,1,1
38475,11392,0,0,deny,66,66,0,1,0,1,0
62880,445,0,0,drop,70,70,0,1,0,1,0
49276,53,39804,53,allow,199,102,97,2,29,1,1
33896,57470,0,0,deny,74,74,0,1,0,1,0
65053,53,62092,53,allow,197,94,103,2,30,1,1
53711,80,6435,80,allow,2391,532,1859,11,75,6,5
49328,445,0,0,drop,70,70,0,1,0,1,0
55949,443,10704,443,allow,21852,2269,19583,48,95,23,25
64441,445,0,0,drop,70,70,0,1,0,1,0
51359,445,0,0,drop,70,70,0,1,0,1,0
65242,445,0,0,drop,70,70,0,1,0,1,0
52758,53,52758,53,allow,197,90,107,2,30,1,1
49776,53,49776,53,allow,256,114,142,2,30,1,1
55224,53,5980,53,allow,209,110,99,2,30,1,1
65406,53,1627,53,allow,102,102,0,1,60,1,0
34163,443,6967,443,allow,5035,768,4267,14,15,8,6
60302,445,0,0,drop,70,70,0,1,0,1,0
49001,48983,0,0,deny,161,161,0,1,0,1,0
3175,60038,0,0,allow,66,66,0,1,91,1,0
3875,25174,0,0,deny,62,62,0,1,0,1,0
64551,53,37333,53,allow,495,127,368,4,33,2,2
49324,64147,0,0,deny,66,66,0,1,0,1,0
50318,53,63172,53,allow,732,89,643,2,30,1,1
55684,53,46714,53,allow,214,110,104,2,30,1,1
30179,57470,0,0,deny,60,60,0,1,0,1,0
39350,3389,39350,3389,allow,3910,1805,2105,20,18,12,8
55033,445,0,0,drop,70,70,0,1,0,1,0
62731,443,8633,443,allow,27905,17646,10259,131,308,73,58
51077,443,51077,443,allow,32010,3207,28803,52,128,20,32
55893,53,44273,53,allow,267,94,173,4,55,2,2
5588,5588,0,0,allow,3562,1936,1626,48,195,24,24
56396,5900,0,0,deny,60,60,0,1,0,1,0
56813,443,32005,443,allow,8021,2001,6020,20,16,11,9
57408,53,13747,53,allow,195,102,93,2,33,1,1
49995,53,53855,53,allow,303,98,205,4,40,2,2
50871,53,48869,53,allow,86,86,0,1,30,1,0
50116,22,50116,22,allow,152,66,86,2,9,1,1
54313,64147,0,0,deny,66,66,0,1,0,1,0
51892,445,0,0,drop,66,66,0,1,0,1,0
54539,26467,0,0,deny,62,62,0,1,0,1,0
56945,53,11659,53,allow,180,94,86,2,30,1,1
54447,53,9967,53,allow,199,94,105,2,29,1,1
1057,57470,0,0,deny,62,62,0,1,0,1,0
62991,51221,0,0,deny,66,66,0,1,0,1,0
54346,443,54346,443,allow,4651,1744,2907,19,27,11,8
31683,35440,0,0,deny,62,62,0,1,0,1,0
52680,445,0,0,drop,66,66,0,1,0,1,0
61522,445,0,0,drop,70,70,0,1,0,1,0
54351,23,0,0,deny,60,60,0,1,0,1,0
61085,445,0,0,drop,70,70,0,1,0,1,0
46159,443,16876,443,allow,4168,1128,3040,14,121,7,7
53016,80,53016,80,allow,265868,5026,260842,277,24,75,202
51882,15733,38796,15733,allow,70,70,0,2,8,2,0
53857,443,11803,443,allow,499,425,74,4,1,3,1
58638,5900,58638,5900,allow,130,66,64,2,4,1,1
62392,445,0,0,drop,70,70,0,1,0,1,0
44822,11848,0,0,reset-both,148,148,0,1,0,1,0
54277,22114,0,0,deny,62,62,0,1,0,1,0
50853,50584,0,0,deny,66,66,0,1,0,1,0
62548,445,0,0,drop,70,70,0,1,0,1,0
58972,57866,0,0,deny,66,66,0,1,0,1,0
50307,443,61889,443,allow,1786,172,1614,7,120,3,4
53090,59356,0,0,deny,66,66,0,1,0,1,0
50523,443,53596,443,allow,6676,1074,5602,22,84,12,10
64417,53,46438,53,allow,184,94,90,2,31,1,1
50643,445,0,0,drop,70,70,0,1,0,1,0
61595,50939,0,0,deny,145,145,0,1,0,1,0
53502,443,53502,443,allow,960,539,421,9,35,5,4
443,60496,0,0,deny,60,60,0,1,0,1,0
57228,53,47428,53,allow,199,102,97,2,30,1,1
57794,445,0,0,drop,70,70,0,1,0,1,0
55658,45261,40194,45261,allow,70,70,0,2,8,2,0
4127,26467,0,0,deny,62,62,0,1,0,1,0
65260,53,8952,53,allow,199,102,97,2,30,1,1
25565,20455,0,0,deny,60,60,0,1,0,1,0
49418,27015,24624,27015,allow,78,78,0,1,30,1,0
58873,443,46096,443,allow,5166,700,4466,16,15,7,9
33761,25174,0,0,deny,62,62,0,1,0,1,0
57803,445,0,0,drop,70,70,0,1,0,1,0
60142,445,0,0,drop,70,70,0,1,0,1,0
20619,25174,0,0,deny,66,66,0,1,0,1,0
14924,44847,0,0,deny,62,62,0,1,0,1,0
58791,15503,0,0,deny,66,66,0,1,0,1,0
47424,25174,0,0,deny,62,62,0,1,0,1,0
26900,27017,57110,27017,allow,422,164,258,6,30,3,3
49608,445,0,0,deny,70,70,0,1,0,1,0
58168,445,0,0,drop,66,66,0,1,0,1,0
60320,443,1355,443,allow,4679,2232,2447,15,136,7,8
49754,35440,0,0,deny,62,62,0,1,0,1,0
65343,53,45711,53,allow,197,102,95,2,30,1,1
55032,443,19722,443,allow,8965,3021,5944,39,360,22,17
63843,445,0,0,drop,66,66,0,1,0,1,0
23030,30170,0,0,deny,159,159,0,1,0,1,0
64585,445,0,0,drop,70,70,0,1,0,1,0
64390,445,0,0,drop,70,70,0,1,0,1,0
64639,53,49663,53,allow,199,102,97,2,31,1,1
49247,53,6509,53,allow,478,196,282,6,64,3,3
56799,443,31346,443,allow,6496,1340,5156,31,506,10,21
51955,80,57774,80,allow,366,240,126,7,27,5,2
63854,53,30633,53,allow,578,286,292,9,15,5,4
55382,53,35558,53,allow,199,102,97,2,30,1,1
27005,30010,26771,30010,allow,887,126,761,2,31,1,1
4752,30188,0,0,deny,62,62,0,1,0,1,0
49370,11392,0,0,deny,66,66,0,1,0,1,0
56200,53,9546,53,allow,206,105,101,2,30,1,1
39980,443,41321,443,allow,130,70,60,2,15,1,1
42298,40036,28327,40036,allow,205,83,122,4,29,2,2
54501,80,17667,80,allow,254,128,126,5,16,3,2
6666,21,0,0,deny,60,60,0,1,0,1,0
53773,443,19967,443,allow,499,425,74,4,0,3,1
52164,443,54936,443,allow,4187,773,3414,16,30,9,7
50027,445,0,0,drop,70,70,0,1,0,1,0
2572,35440,0,0,deny,62,62,0,1,0,1,0
63759,64509,33605,64509,allow,66,66,0,2,7,2,0
55411,53,33954,53,allow,183,94,89,2,30,1,1
56417,80,64869,80,allow,38188,688,37500,35,104,7,28
64766,53,47744,53,allow,214,110,104,2,29,1,1
27930,53,0,0,allow,222,82,140,2,30,1,1
49866,443,6704,443,allow,7128,865,6263,19,87,9,10
31619,51221,0,0,deny,62,62,0,1,0,1,0
55725,445,0,0,drop,66,66,0,1,0,1,0
64003,38926,55687,38926,allow,66,66,0,1,5,1,0
55984,445,0,0,drop,70,70,0,1,0,1,0
59230,445,0,0,drop,70,70,0,1,0,1,0
61653,445,0,0,drop,70,70,0,1,0,1,0
50241,53,51739,53,allow,184,102,82,2,30,1,1
40495,53,8395,53,allow,168,78,90,2,29,1,1
443,56513,0,0,deny,78,78,0,1,0,1,0
53115,40693,38172,40693,allow,70,70,0,2,8,2,0
58638,5900,0,0,deny,62,62,0,1,0,1,0
50760,445,0,0,drop,70,70,0,1,0,1,0
42341,443,25797,443,allow,276,70,206,5,26,2,3
3478,61463,0,0,deny,164,164,0,1,0,1,0
13285,29892,0,0,deny,145,145,0,1,0,1,0
54959,53,17105,53,allow,206,105,101,2,31,1,1
56413,53,33044,53,allow,338,110,228,2,30,1,1
56448,53,60650,53,allow,177,94,83,2,29,1,1
26435,39004,0,0,deny,62,62,0,1,0,1,0
48676,53399,0,0,deny,60,60,0,1,0,1,0
64076,53,25451,53,allow,255,102,153,2,30,1,1
56411,50584,0,0,deny,62,62,0,1,0,1,0
53724,445,0,0,drop,70,70,0,1,0,1,0
10532,26672,0,0,deny,60,60,0,1,0,1,0
52336,64097,0,0,deny,66,66,0,1,0,1,0
60501,40829,17093,40829,allow,70,70,0,1,5,1,0
32299,40015,23096,40015,allow,188,70,118,2,31,1,1
51752,31677,14033,31677,allow,70,70,0,1,5,1,0
30129,37965,0,0,deny,72,72,0,1,0,1,0
60887,445,0,0,drop,70,70,0,1,0,1,0
58042,80,52870,80,allow,318,192,126,6,20,4,2
56167,53,17314,53,allow,178,94,84,2,30,1,1
52143,80,6472,80,allow,366,240,126,7,32,5,2
60721,22114,0,0,deny,62,62,0,1,0,1,0
63791,48817,0,0,deny,145,145,0,1,0,1,0
38285,443,16953,443,allow,6872,1815,5057,22,318,13,9
59629,445,0,0,drop,70,70,0,1,0,1,0
48230,57866,0,0,deny,146,146,0,1,0,1,0
65322,443,20624,443,allow,8429792,268889,8160903,8985,135,2983,6002
58638,5900,0,0,deny,62,62,0,1,0,1,0
50659,80,44031,80,allow,24433,3378,21055,31,21,12,19
52148,29104,16660,29104,allow,70,70,0,1,5,1,0
50668,445,0,0,drop,66,66,0,1,0,1,0
47053,5228,30906,5228,allow,11647,2439,9208,47,3724,21,26
58368,53,61007,53,allow,167,78,89,2,30,1,1
37075,48817,0,0,deny,62,62,0,1,0,1,0
55868,53,39236,53,allow,458,188,270,6,29,3,3
56567,53,47104,53,allow,701,88,613,2,30,1,1
39959,23117,0,0,deny,62,62,0,1,0,1,0
59274,443,55424,443,allow,8640,2329,6311,19,76,10,9
49456,53,22820,53,allow,308,101,207,4,32,2,2
21420,44847,0,0,deny,66,66,0,1,0,1,0
49237,8080,49237,8080,allow,4451,1329,3122,13,53,7,6
65349,53,30593,53,allow,772,103,669,2,31,1,1
62295,445,0,0,drop,66,66,0,1,0,1,0
49846,445,0,0,drop,70,70,0,1,0,1,0
49521,80,17385,80,allow,1653,831,822,13,93,7,6
51909,33509,56937,33509,allow,70,70,0,1,5,1,0
53031,443,28915,443,allow,2399,1799,600,15,120,10,5
55944,445,0,0,drop,70,70,0,1,0,1,0
58638,5900,0,0,deny,62,62,0,1,0,1,0
54991,36829,0,0,deny,62,62,0,1,0,1,0
44907,80,29624,80,allow,1514,962,552,7,16,5,2
49973,445,0,0,drop,66,66,0,1,0,1,0
26527,25174,0,0,deny,62,62,0,1,0,1,0
58746,443,54765,443,allow,5107,700,4407,15,15,7,8
64345,53,39290,53,allow,499,94,405,2,29,1,1
54950,443,18760,443,allow,5281,1393,3888,22,16,13,9
37574,123,51434,123,allow,184,94,90,2,30,1,1
57665,53,28556,53,allow,168,78,90,2,30,1,1
52038,80,27418,80,allow,366,240,126,7,25,5,2
50508,443,43933,443,allow,5938,1012,4926,20,77,11,9
61377,445,0,0,drop,70,70,0,1,0,1,0
50712,80,10227,80,allow,708,384,324,12,195,7,5
58638,5900,0,0,deny,62,62,0,1,0,1,0
57186,445,0,0,drop,70,70,0,1,0,1,0
35405,53,35405,53,allow,217,87,130,2,30,1,1
53819,443,53819,443,allow,1386,751,635,15,180,8,7
50405,445,0,0,drop,66,66,0,1,0,1,0
47261,443,56817,443,allow,4536,845,3691,16,15,9,7
64124,80,34060,80,allow,1517,481,1036,11,15,6,5
43676,80,45378,80,allow,696,378,318,12,35,7,5
49418,27001,19678,27001,allow,274,78,196,2,31,1,1
63849,16632,35962,16632,allow,66,66,0,2,8,2,0
34957,80,4367,80,allow,7136,3526,3610,42,1239,21,21
60492,11339,45509,11339,allow,70,70,0,1,5,1,0
56236,445,0,0,drop,70,70,0,1,0,1,0
57470,51413,47712,51413,allow,543,166,377,2,1199,1,1
55787,53,59622,53,allow,229,102,127,2,29,1,1
47013,37965,0,0,deny,62,62,0,1,0,1,0
19610,9571,0,0,deny,62,62,0,1,0,1,0
24271,52700,0,0,deny,66,66,0,1,0,1,0
50152,53,50662,53,allow,776,102,674,2,30,1,1
27005,32056,3703,32056,allow,886,126,760,2,30,1,1
61807,443,12289,443,allow,6244,1855,4389,16,75,9,7
52922,443,7305,443,allow,5583,1390,4193,19,15,9,10
53095,443,22543,443,allow,7014,1719,5295,18,326,9,9
31021,35440,0,0,deny,146,146,0,1,0,1,0
59145,445,0,0,drop,70,70,0,1,0,1,0
34147,53,34147,53,allow,227,106,121,2,30,1,1
29988,44847,0,0,deny,66,66,0,1,0,1,0
59699,55783,0,0,deny,62,62,0,1,0,1,0
65460,53,21678,53,allow,387,102,285,2,29,1,1
65388,55783,0,0,deny,66,66,0,1,0,1,0
13559,57866,0,0,deny,62,62,0,1,0,1,0
64066,23718,0,0,deny,62,62,0,1,0,1,0
56736,53,58809,53,allow,283,94,189,4,41,2,2
55329,53,39839,53,allow,210,102,108,2,29,1,1
64544,53,63880,53,allow,199,94,105,2,30,1,1
62813,25174,0,0,deny,62,62,0,1,0,1,0
37592,443,5868,443,allow,499,425,74,4,0,3,1
55526,445,0,0,drop,70,70,0,1,0,1,0
15274,81,0,0,deny,60,60,0,1,0,1,0
65528,62413,0,0,deny,62,62,0,1,0,1,0
54503,445,0,0,drop,66,66,0,1,0,1,0
33841,443,9860,443,allow,12521,6232,6289,43,80,22,21
61592,445,0,0,drop,66,66,0,1,0,1,0
54910,32480,0,0,deny,66,66,0,1,0,1,0
65226,443,51904,443,allow,35968,13816,22152,77,96,34,43
37628,443,37628,443,allow,1452,817,635,16,20,9,7
1117,37965,0,0,deny,62,62,0,1,0,1,0
64422,53,60156,53,allow,180,94,86,2,29,1,1
65157,445,0,0,drop,70,70,0,1,0,1,0
56766,53,34150,53,allow,204,104,100,2,30,1,1
51903,35904,6046,35904,allow,70,70,0,2,8,2,0
22683,39210,0,0,deny,60,60,0,1,0,1,0
51120,53,11316,53,allow,168,78,90,2,30,1,1
55872,53,55616,53,allow,177,94,83,2,30,1,1
56578,64147,0,0,deny,66,66,0,1,0,1,0
56308,443,13053,443,allow,1622,1137,485,11,26,7,4
11136,15503,0,0,deny,145,145,0,1,0,1,0
36003,123,29238,123,allow,184,94,90,2,30,1,1
64403,445,0,0,drop,66,66,0,1,0,1,0
55364,53,1221,53,allow,168,86,82,2,31,1,1
57341,53,25205,53,allow,184,94,90,2,30,1,1
53686,19010,53686,19010,allow,70,70,0,1,30,1,0
10669,49756,0,0,deny,60,60,0,1,0,1,0
5617,64147,0,0,deny,145,145,0,1,0,1,0
0,0,0,0,allow,600,306,294,6,0,3,3
63996,53,49603,53,allow,252,102,150,2,30,1,1
57009,80,12239,80,allow,214,140,74,4,30,3,1
61117,445,0,0,drop,66,66,0,1,0,1,0
56489,445,0,0,drop,66,66,0,1,0,1,0
35216,123,45101,123,allow,184,94,90,2,30,1,1
20898,53,20898,53,allow,233,90,143,2,32,1,1
59723,80,4011,80,allow,613,539,74,7,15,6,1
47089,443,11846,443,allow,172,172,0,2,5,2,0
16387,16862,0,0,deny,60,60,0,1,0,1,0
9448,57866,0,0,deny,62,62,0,1,0,1,0
64687,53,30992,53,allow,495,109,386,4,53,2,2
54757,443,1080,443,allow,6954,1758,5196,29,361,15,14
9055,443,33529,443,allow,6594797,175738,6419059,6398,123,1755,4643
55951,53,2710,53,allow,780,104,676,2,31,1,1
49502,445,0,0,drop,70,70,0,1,0,1,0
53958,80,17834,80,allow,23134,15926,7208,53,541,32,21
12240,48817,0,0,deny,146,146,0,1,0,1,0
60525,443,60525,443,allow,1088,641,447,10,26,6,4
59782,26467,0,0,deny,62,62,0,1,0,1,0
53011,445,0,0,drop,70,70,0,1,0,1,0
56445,53,12217,53,allow,711,87,624,2,30,1,1
49945,53,14331,53,allow,281,97,184,4,56,2,2
64379,37965,0,0,deny,66,66,0,1,0,1,0
51259,445,0,0,drop,70,70,0,1,0,1,0
52422,443,1583,443,allow,1043,556,487,10,15,6,4
56875,53,55228,53,allow,167,86,81,2,30,1,1
61948,445,0,0,drop,66,66,0,1,0,1,0
48488,50584,0,0,deny,146,146,0,1,0,1,0
40204,40027,54251,40027,allow,245,182,63,2,30,1,1
4607,6004,0,0,deny,70,70,0,1,0,1,0
60461,10138,55813,10138,allow,70,70,0,2,8,2,0
56771,43648,30018,43648,allow,70,70,0,2,8,2,0
58502,445,0,0,drop,66,66,0,1,0,1,0
58022,8080,0,0,deny,60,60,0,1,0,1,0
50648,80,8370,80,allow,62,62,0,1,5,1,0
63572,443,58406,443,allow,125798,40014,85784,276,171,125,151
65328,53,16469,53,allow,174,89,85,2,30,1,1
27005,27015,4147,27015,allow,869,126,743,2,30,1,1
60437,30889,62883,30889,allow,1729,1125,604,14,16,8,6
42631,443,38369,443,allow,153,93,60,2,5,1,1
47357,50584,0,0,deny,66,66,0,1,0,1,0
50565,53,50708,53,allow,707,94,613,2,30,1,1
38476,161,0,0,allow,3304,1560,1744,18,30,9,9
53886,49618,46889,49618,allow,492,306,186,8,16,5,3
56374,53,9778,53,allow,212,102,110,2,30,1,1
64051,53,27383,53,allow,430,172,258,6,59,3,3
64980,53,62800,53,allow,180,94,86,2,30,1,1
58056,443,56911,443,allow,866223,30135,836088,916,138,300,616
37672,5223,8222,5223,allow,110,110,0,1,5,1,0
60480,60519,7495,60519,allow,320,140,180,6,8,3,3
34366,443,52089,443,allow,520306,17622,502684,582,210,210,372
50721,445,0,0,drop,66,66,0,1,0,1,0
55762,53,29389,53,allow,249,94,155,2,29,1,1
49989,445,0,0,drop,70,70,0,1,0,1,0
56703,53,62070,53,allow,183,94,89,2,31,1,1
52569,80,52569,80,allow,93783,3885,89898,105,167,37,68
36103,443,46915,443,allow,130,70,60,2,15,1,1
61670,443,47830,443,allow,5943,1991,3952,23,17,14,9
55824,53,60939,53,allow,819,102,717,2,30,1,1
55513,53,52238,53,allow,184,94,90,2,29,1,1
50912,53,50912,53,allow,213,81,132,2,30,1,1
26235,37965,0,0,deny,66,66,0,1,0,1,0
49379,53,24029,53,allow,199,102,97,2,30,1,1
53632,58037,4206,58037,allow,70,70,0,2,8,2,0
49406,80,42946,80,allow,2074,1309,765,10,124,6,4
47134,37965,0,0,deny,62,62,0,1,0,1,0
47461,50584,0,0,deny,62,62,0,1,0,1,0
38475,11392,0,0,deny,66,66,0,1,0,1,0
49776,53,43757,53,allow,182,94,88,2,29,1,1
33898,80,33898,80,allow,14448,2001,12447,26,16,14,12
6881,6881,3673,6881,allow,237,118,119,2,1200,1,1
38139,443,10441,443,allow,49386,4604,44782,82,32,43,39
47910,7454,0,0,deny,60,60,0,1,0,1,0
49802,53,5262,53,allow,755,93,662,2,31,1,1
59959,445,0,0,drop,70,70,0,1,0,1,0
27153,50584,0,0,deny,146,146,0,1,0,1,0
50394,443,24134,443,allow,60424,4482,55942,101,686,39,62
50041,443,48278,443,allow,7924,1798,6126,26,15,14,12
49380,443,11402,443,allow,2382775,72482,2310293,2485,252,843,1642
49201,53,3474,53,allow,200,102,98,2,30,1,1
65374,445,0,0,drop,66,66,0,1,0,1,0
60485,445,0,0,drop,66,66,0,1,0,1,0
53630,445,0,0,drop,70,70,0,1,0,1,0
48817,18529,48817,18529,allow,152,152,0,1,1200,1,0
56504,53,24881,53,allow,198,102,96,2,32,1,1
50574,80,28738,80,allow,318,192,126,6,25,4,2
13871,53,13871,53,allow,240,98,142,2,30,1,1
49355,53,60733,53,allow,193,102,91,2,30,1,1
46103,80,5613,80,allow,70,70,0,2,5,2,0
63595,445,0,0,drop,70,70,0,1,0,1,0
27505,25174,0,0,deny,62,62,0,1,0,1,0
55940,53,24862,53,allow,168,86,82,2,30,1,1
61453,443,29702,443,allow,8052,1307,6745,27,125,16,11
50470,61463,0,0,deny,86,86,0,1,0,1,0
62541,445,0,0,drop,66,66,0,1,0,1,0
49450,443,32537,443,allow,9704,2335,7369,20,26,10,10
19502,53,19502,53,allow,198,89,109,2,31,1,1
53269,445,0,0,drop,66,66,0,1,0,1,0
39165,23,0,0,deny,60,60,0,1,0,1,0
51813,445,0,0,drop,70,70,0,1,0,1,0
65465,443,59471,443,allow,92040,4799,87241,107,16,43,64
64169,53,57112,53,allow,212,102,110,2,30,1,1
57652,445,0,0,drop,66,66,0,1,0,1,0
59321,445,0,0,drop,70,70,0,1,0,1,0
39452,123,25633,123,allow,184,94,90,2,30,1,1
34625,443,10799,443,allow,6393,1025,5368,18,27,9,9
21133,11342,54289,11342,allow,478,149,329,2,1200,1,1
58638,5900,0,0,deny,62,62,0,1,0,1,0
20012,444,0,0,deny,60,60,0,1,0,1,0
45682,47993,0,0,deny,62,62,0,1,0,1,0
64819,445,0,0,drop,66,66,0,1,0,1,0
16387,49252,0,0,deny,60,60,0,1,0,1,0
58638,5900,0,0,deny,62,62,0,1,0,1,0
48176,50584,0,0,deny,146,146,0,1,0,1,0
50494,80,52508,80,allow,18059,13615,4444,29,27,16,13
54666,445,0,0,drop,70,70,0,1,0,1,0
13095,80,13095,80,allow,32613,1160,31453,38,16,13,25
65495,53,27520,53,allow,209,110,99,2,30,1,1
27448,22114,0,0,deny,62,62,0,1,0,1,0
57188,53,28885,53,allow,193,102,91,2,29,1,1
36548,443,36548,443,allow,4621,1714,2907,19,30,11,8
63724,23,0,0,deny,60,60,0,1,0,1,0
55732,53,29178,53,allow,177,94,83,2,30,1,1
57052,53,31599,53,allow,711,87,624,2,31,1,1
56273,53,61553,53,allow,194,99,95,2,30,1,1
53673,445,0,0,drop,66,66,0,1,0,1,0
43747,22114,0,0,deny,62,62,0,1,0,1,0
49886,443,58788,443,allow,77867,2411,75456,82,87,27,55
57355,443,34540,443,allow,16483,8545,7938,40,281,21,19
58321,445,0,0,drop,66,66,0,1,0,1,0
55130,25174,0,0,deny,62,62,0,1,0,1,0
52430,35440,0,0,deny,62,62,0,1,0,1,0
37916,443,12180,443,allow,6202,872,5330,19,361,9,10
51310,64147,0,0,deny,66,66,0,1,0,1,0
53816,42459,30480,42459,allow,552,306,246,9,16,5,4
49700,445,0,0,drop,70,70,0,1,0,1,0
64363,53,54171,53,allow,212,102,110,2,30,1,1
64490,445,0,0,drop,70,70,0,1,0,1,0
52042,443,63896,443,allow,8740,1799,6941,25,25,13,12
55675,445,0,0,drop,66,66,0,1,0,1,0
50531,80,35066,80,allow,21782,2162,19620,28,20,11,17
49820,123,49820,123,allow,184,94,90,2,30,1,1
58638,5900,0,0,deny,62,62,0,1,0,1,0
56924,53,46939,53,allow,177,94,83,2,30,1,1
33143,80,14116,80,allow,7406,1038,6368,18,15,10,8
11324,443,11324,443,allow,6981,948,6033,17,28,10,7
56406,22114,0,0,deny,62,62,0,1,0,1,0
56675,53,13397,53,allow,254,94,160,2,30,1,1
5912,22114,0,0,deny,62,62,0,1,0,1,0
65282,53,39898,53,allow,193,102,91,2,30,1,1
40547,443,6575,443,allow,4916,2083,2833,24,43,13,11
49459,443,9422,443,allow,39932,34025,5907,52,21,34,18
47091,443,62680,443,allow,3543,1570,1973,18,120,9,9
49464,53,1533,53,allow,213,102,111,2,30,1,1
5462,21247,0,0,deny,66,66,0,1,0,1,0
52130,1035,52488,1035,allow,66,66,0,1,5,1,0
58638,5900,0,0,deny,62,62,0,1,0,1,0
49812,53,5502,53,allow,166,86,80,2,30,1,1
55417,53,62498,53,allow,198,102,96,2,32,1,1
56550,53,61639,53,allow,183,94,89,2,30,1,1
3597,11392,0,0,deny,62,62,0,1,0,1,0
49684,443,64157,443,allow,9083,2300,6783,19,56,10,9
24961,53,24961,53,allow,215,80,135,2,33,1,1
56742,443,19670,443,allow,1327,918,409,10,34,6,4
56363,445,0,0,drop,70,70,0,1,0,1,0
443,56858,0,0,deny,85,85,0,1,0,1,0
58414,53,7367,53,allow,245,118,127,2,29,1,1
9412,7302,0,0,deny,66,66,0,1,0,1,0
51909,80,5336,80,allow,6057,4543,1514,16,15,9,7
65263,53,53101,53,allow,232,110,122,2,30,1,1
55056,56205,0,0,deny,62,62,0,1,0,1,0
49326,53,56279,53,allow,765,102,663,2,30,1,1
36400,51505,0,0,deny,62,62,0,1,0,1,0
52184,22114,0,0,deny,66,66,0,1,0,1,0
56676,53,4759,53,allow,172,88,84,2,31,1,1
58272,445,0,0,drop,66,66,0,1,0,1,0
64551,445,0,0,drop,66,66,0,1,0,1,0
54028,37965,0,0,deny,66,66,0,1,0,1,0
54855,445,0,0,drop,66,66,0,1,0,1,0
57130,443,40605,443,allow,6489,1065,5424,22,255,12,10
62642,25174,0,0,deny,66,66,0,1,0,1,0
26311,23,0,0,deny,60,60,0,1,0,1,0
34897,50584,0,0,deny,62,62,0,1,0,1,0
55326,445,0,0,drop,70,70,0,1,0,1,0
49798,53,59765,53,allow,365,97,268,4,40,2,2
65285,44847,0,0,deny,146,146,0,1,0,1,0
55933,53,60713,53,allow,182,94,88,2,30,1,1
5683,50584,0,0,deny,66,66,0,1,0,1,0
49670,53,37029,53,allow,168,86,82,2,30,1,1
57470,33159,38691,33159,allow,594,594,0,10,1199,10,0
53941,53739,17149,53739,allow,70,70,0,1,4,1,0
27005,27333,40989,27333,allow,890,126,764,2,30,1,1
37952,80,16690,80,allow,1372,868,504,13,35,8,5
33924,80,28051,80,allow,1139,609,530,10,61,6,4
53543,44847,0,0,deny,62,62,0,1,0,1,0
50403,53,9932,53,allow,749,94,655,2,30,1,1
55639,53,11030,53,allow,819,102,717,2,30,1,1
13445,44847,0,0,deny,66,66,0,1,0,1,0
43611,1879,0,0,deny,145,145,0,1,0,1,0
52888,445,0,0,drop,70,70,0,1,0,1,0
65393,445,0,0,drop,66,66,0,1,0,1,0
57583,445,0,0,drop,70,70,0,1,0,1,0
58842,445,0,0,drop,70,70,0,1,0,1,0
51987,80,37675,80,allow,2175,1532,643,10,22,7,3
64145,53,4283,53,allow,177,94,83,2,31,1,1
56928,53,10586,53,allow,178,94,84,2,30,1,1
55718,27025,38370,27025,allow,1778,1386,392,8,30,4,4
49632,7000,49632,7000,allow,1236,676,560,13,15,7,6
62772,445,0,0,drop,66,66,0,1,0,1,0
1025,35447,0,0,deny,62,62,0,1,0,1,0
55044,53,47229,53,allow,168,78,90,2,30,1,1
45682,47993,0,0,deny,62,62,0,1,0,1,0
9775,30188,0,0,deny,62,62,0,1,0,1,0
51741,48440,47763,48440,allow,136,136,0,3,14,3,0
63932,445,0,0,drop,66,66,0,1,0,1,0
55308,443,1473,443,allow,4981,943,4038,20,360,10,10
65220,53,7048,53,allow,184,94,90,2,29,1,1
56416,53,40943,53,allow,969,86,883,2,29,1,1
59956,445,0,0,drop,70,70,0,1,0,1,0
3406,17372,0,0,deny,62,62,0,1,0,1,0
52827,445,0,0,drop,70,70,0,1,0,1,0
61053,443,61053,443,allow,40415,2911,37504,57,18,27,30
63124,445,0,0,drop,70,70,0,1,0,1,0
55089,53,42866,53,allow,198,101,97,2,30,1,1
42094,35440,0,0,deny,146,146,0,1,0,1,0
51994,25509,30907,25509,allow,70,70,0,2,8,2,0
1046,25174,0,0,deny,146,146,0,1,0,1,0
52065,52021,26408,52021,allow,70,70,0,2,7,2,0
52655,445,0,0,drop,70,70,0,1,0,1,0
28973,30188,0,0,deny,66,66,0,1,0,1,0
65126,445,0,0,drop,70,70,0,1,0,1,0
53571,19636,6508,19636,allow,70,70,0,1,4,1,0
57208,53,39529,53,allow,183,94,89,2,30,1,1
55319,443,12527,443,allow,6210,2720,3490,15,121,7,8
60376,443,21896,443,allow,9379,2092,7287,21,126,9,12
52175,445,0,0,drop,70,70,0,1,0,1,0
56533,53,7408,53,allow,199,102,97,2,29,1,1
60117,50934,0,0,deny,66,66,0,1,0,1,0
41781,443,5729,443,allow,1820,1101,719,18,82,10,8
49908,445,0,0,drop,66,66,0,1,0,1,0
56173,37807,0,0,deny,66,66,0,1,0,1,0
50414,445,0,0,drop,66,66,0,1,0,1,0
53784,16671,31656,16671,allow,70,70,0,1,4,1,0
56086,443,37563,443,allow,7535,1003,6532,24,304,7,17
63943,53,24441,53,allow,509,176,333,6,56,3,3
2717,31573,0,0,deny,66,66,0,1,0,1,0
39475,443,29487,443,allow,3310,2291,1019,17,16,10,7
64381,53,43493,53,allow,168,86,82,2,31,1,1
4935,3389,0,0,deny,66,66,0,1,0,1,0
60342,36237,0,0,deny,62,62,0,1,0,1,0
58721,51505,0,0,deny,66,66,0,1,0,1,0
57470,21178,29997,21178,allow,166,166,0,1,1200,1,0
59206,445,0,0,drop,70,70,0,1,0,1,0
1043,30170,0,0,deny,159,159,0,1,0,1,0
61973,445,0,0,drop,70,70,0,1,0,1,0
64566,443,6952,443,allow,8573,2039,6534,25,31,14,11
61363,445,0,0,drop,70,70,0,1,0,1,0
58098,445,0,0,drop,66,66,0,1,0,1,0
51401,6881,0,0,deny,66,66,0,1,0,1,0
58638,5900,0,0,deny,62,62,0,1,0,1,0
64613,53,26326,53,allow,89,89,0,1,30,1,0
40755,123,40939,123,allow,184,94,90,2,30,1,1
55722,26192,51333,26192,allow,70,70,0,1,5,1,0
54721,445,0,0,drop,66,66,0,1,0,1,0
63407,445,0,0,drop,66,66,0,1,0,1,0
61066,53,0,0,allow,283,78,205,2,29,1,1
59211,445,0,0,drop,66,66,0,1,0,1,0
55836,53,41454,53,allow,181,94,87,2,33,1,1
33992,53,33992,53,allow,462,158,304,4,30,2,2
24236,26296,0,0,deny,148,148,0,1,0,1,0
64256,53,29163,53,allow,244,94,150,2,30,1,1
53036,443,40328,443,allow,249145,4184,244961,218,107,40,178
2828,35253,0,0,deny,66,66,0,1,0,1,0
11295,53,11295,53,allow,197,90,107,2,30,1,1
54789,445,0,0,drop,70,70,0,1,0,1,0
49941,53,13341,53,allow,193,102,91,2,30,1,1
6881,6881,56925,6881,allow,238,118,120,2,1200,1,1
64277,30188,0,0,deny,62,62,0,1,0,1,0
62331,445,0,0,drop,66,66,0,1,0,1,0
65343,53,41692,53,allow,184,94,90,2,29,1,1
55431,53,28791,53,allow,192,98,94,2,30,1,1
49654,80,62671,80,allow,1506,914,592,9,16,5,4
39839,22114,0,0,deny,62,62,0,1,0,1,0
7275,13487,0,0,allow,66,66,0,1,91,1,0
51341,445,0,0,drop,70,70,0,1,0,1,0
48488,50584,0,0,deny,62,62,0,1,0,1,0
54214,445,0,0,drop,66,66,0,1,0,1,0
64505,53,53732,53,allow,388,134,254,2,30,1,1
60934,80,21512,80,allow,1212,774,438,11,81,7,4
59860,445,0,0,deny,70,70,0,1,0,1,0
27005,27015,25382,27015,allow,937,126,811,2,30,1,1
55600,22,0,0,deny,60,60,0,1,0,1,0
2697,28189,0,0,deny,60,60,0,1,0,1,0
51975,443,14807,443,allow,29510,15378,14132,76,216,35,41
56582,53,17999,53,allow,196,102,94,2,32,1,1
56035,1310,0,0,deny,62,62,0,1,0,1,0
63016,445,0,0,drop,70,70,0,1,0,1,0
51221,51413,17316,51413,allow,460,150,310,2,1200,1,1
49624,443,29597,443,allow,2899,1813,1086,12,136,7,5
49520,445,0,0,drop,66,66,0,1,0,1,0
46780,443,9186,443,allow,9801,3049,6752,29,20,15,14
51872,443,26165,443,allow,442,250,192,8,30,5,3
44258,25,0,0,deny,74,74,0,1,0,1,0
64790,53,14045,53,allow,178,94,84,2,29,1,1
64804,53,12585,53,allow,383,97,286,4,58,2,2
57601,80,57601,80,allow,25872,4400,21472,41,38,16,25
46799,443,46799,443,allow,22215,2460,19755,39,198,15,24
52251,443,26101,443,allow,23328780,730794,22597986,24754,320,8113,16641
50584,6889,64241,6889,allow,1326,300,1026,6,1200,3,3
49974,445,0,0,drop,66,66,0,1,0,1,0
64303,53,30875,53,allow,298,87,211,4,34,2,2
37965,24475,30249,24475,allow,480,149,331,2,1200,1,1
49595,53,24473,53,allow,180,94,86,2,30,1,1
64811,53,25235,53,allow,193,102,91,2,29,1,1
36661,53,19439,53,allow,164,78,86,2,31,1,1
10192,25174,0,0,deny,66,66,0,1,0,1,0
63978,53,35344,53,allow,214,110,104,2,30,1,1
49883,443,6647,443,allow,17238,4435,12803,32,103,15,17
53073,32468,0,0,deny,66,66,0,1,0,1,0
53178,445,0,0,drop,70,70,0,1,0,1,0
44147,64147,0,0,deny,62,62,0,1,0,1,0
60652,445,0,0,drop,70,70,0,1,0,1,0
37953,1935,23472,1935,allow,3623810,67493,3556317,3486,35,943,2543
64774,53,37147,53,allow,214,102,112,2,29,1,1
62029,22114,0,0,deny,66,66,0,1,0,1,0
60803,445,0,0,drop,70,70,0,1,0,1,0
64937,53,10087,53,allow,182,93,89,2,31,1,1
15680,53,61838,53,allow,464,287,177,3,30,2,1
54210,36237,0,0,deny,62,62,0,1,0,1,0
50633,443,56668,443,allow,6673,1791,4882,22,72,12,10
52201,44054,14407,44054,allow,70,70,0,1,5,1,0
48994,443,64205,443,allow,46452,6817,39635,103,299,45,58
49236,8080,49236,8080,allow,4458,1336,3122,13,53,7,6
58795,443,29024,443,allow,19700,12992,6708,44,18,23,21
9187,443,51654,443,allow,158704,5074,153630,184,34,69,115
63196,445,0,0,deny,62,62,0,1,0,1,0
44922,57470,0,0,deny,74,74,0,1,0,1,0
26881,25174,0,0,deny,62,62,0,1,0,1,0
63278,445,0,0,drop,66,66,0,1,0,1,0
49374,53,26527,53,allow,199,94,105,2,30,1,1
38502,443,34798,443,allow,2378,1126,1252,14,978,7,7
55619,53,64151,53,allow,183,94,89,2,30,1,1
63166,445,0,0,drop,66,66,0,1,0,1,0
60579,25174,0,0,deny,66,66,0,1,0,1,0
56067,53,40948,53,allow,195,102,93,2,30,1,1
55562,50584,0,0,deny,62,62,0,1,0,1,0
30559,64147,0,0,deny,62,62,0,1,0,1,0
57772,50584,0,0,deny,66,66,0,1,0,1,0
53067,4040,59736,4040,allow,115,115,0,1,31,1,0
51575,9694,0,0,deny,66,66,0,1,0,1,0
58672,443,27008,443,allow,4649,2114,2535,11,120,6,5
64990,55442,0,0,deny,66,66,0,1,0,1,0
55463,53,8245,53,allow,193,102,91,2,30,1,1
48818,443,11974,443,allow,4167,1669,2498,23,15,12,11
52495,443,36037,443,allow,32875,8836,24039,37,16,15,22
55736,53,0,0,allow,338,70,268,2,30,1,1
64370,443,23826,443,allow,2783,692,2091,10,120,5,5
60141,30188,0,0,deny,66,66,0,1,0,1,0
49176,443,60169,443,allow,533295,14310,518985,552,18,201,351
49748,443,24833,443,allow,7084,1703,5381,19,128,10,9
62940,445,0,0,drop,66,66,0,1,0,1,0
58830,445,0,0,drop,70,70,0,1,0,1,0
11136,15503,0,0,deny,62,62,0,1,0,1,0
55440,53,50711,53,allow,711,87,624,2,30,1,1
57889,445,0,0,drop,70,70,0,1,0,1,0
33013,443,50966,443,allow,88895,4807,84088,104,136,37,67
51834,445,0,0,drop,66,66,0,1,0,1,0
57470,8999,23972,8999,allow,1577,594,983,20,1616,10,10
59803,22114,0,0,deny,62,62,0,1,0,1,0
55865,53,59187,53,allow,192,98,94,2,31,1,1
42318,443,52319,443,allow,10723,2046,8677,29,116,10,19
52149,80,52149,80,allow,2928,694,2234,13,141,6,7
1620,53567,0,0,deny,66,66,0,1,0,1,0
57157,445,0,0,drop,70,70,0,1,0,1,0
54545,49344,0,0,deny,66,66,0,1,0,1,0
64477,443,32832,443,allow,8965,3771,5194,33,124,14,19
60365,443,29839,443,allow,13649,6567,7082,29,127,14,15
58638,5900,0,0,deny,62,62,0,1,0,1,0
64629,445,0,0,drop,70,70,0,1,0,1,0
23089,48817,0,0,deny,62,62,0,1,0,1,0
62052,443,44827,443,allow,11674,2699,8975,27,48,14,13
49555,53,29992,53,allow,193,102,91,2,30,1,1
57093,26467,0,0,deny,66,66,0,1,0,1,0
0,0,0,0,deny,74,74,0,1,0,1,0
55159,53,20403,53,allow,200,102,98,2,29,1,1
63488,22114,0,0,deny,62,62,0,1,0,1,0
57793,37807,0,0,deny,66,66,0,1,0,1,0
56369,22114,0,0,deny,62,62,0,1,0,1,0
52913,2767,0,0,deny,66,66,0,1,0,1,0
60769,443,35964,443,allow,3758,1691,2067,12,135,6,6
36192,443,26140,443,allow,4555,859,3696,17,360,9,8
54990,53,8264,53,allow,168,86,82,2,31,1,1
49699,64147,0,0,deny,62,62,0,1,0,1,0
53362,445,0,0,drop,70,70,0,1,0,1,0
3964,51505,0,0,deny,62,62,0,1,0,1,0
55706,22,55706,22,allow,252,60,192,5,14,2,3
50055,445,0,0,drop,66,66,0,1,0,1,0
50245,443,54814,443,allow,6866,1958,4908,21,20,13,8
64743,445,0,0,drop,70,70,0,1,0,1,0
51728,44847,0,0,deny,66,66,0,1,0,1,0
1024,37450,0,0,deny,62,62,0,1,0,1,0
59741,443,12538,443,allow,384,166,218,2,30,1,1
36754,7,13340,7,allow,138,78,60,2,5,1,1
44075,80,12675,80,allow,3560,1256,2304,22,86,10,12
56431,53,59476,53,allow,177,94,83,2,30,1,1
56606,53,17065,53,allow,762,97,665,2,31,1,1
10010,40029,17242,40029,allow,148,86,62,2,29,1,1
51215,443,16837,443,allow,11490,3671,7819,33,93,18,15
63503,42707,0,0,deny,66,66,0,1,0,1,0
443,22323,0,0,deny,61,61,0,1,0,1,0
56468,53,8242,53,allow,176,90,86,2,30,1,1
55871,53,11606,53,allow,711,87,624,2,30,1,1
54796,22114,0,0,deny,66,66,0,1,0,1,0
55752,53,6985,53,allow,200,102,98,2,30,1,1
61838,37965,0,0,deny,62,62,0,1,0,1,0
15180,26467,0,0,deny,62,62,0,1,0,1,0
6904,30228,0,0,deny,146,146,0,1,0,1,0
27724,53,46943,53,allow,322,84,238,4,29,2,2
51802,443,43953,443,allow,4976,1826,3150,19,151,9,10
51730,33399,18349,33399,allow,66,66,0,1,5,1,0
57899,445,0,0,deny,70,70,0,1,0,1,0
56388,443,34459,443,allow,70,70,0,1,5,1,0
31384,56205,0,0,deny,62,62,0,1,0,1,0
55273,53,2212,53,allow,168,78,90,2,30,1,1
6247,51221,0,0,deny,78,78,0,1,0,1,0
57918,445,0,0,drop,70,70,0,1,0,1,0
64193,445,0,0,drop,70,70,0,1,0,1,0
52699,25174,0,0,deny,66,66,0,1,0,1,0
33367,80,33367,80,allow,424,198,226,7,141,4,3
56272,53,26836,53,allow,186,95,91,2,31,1,1
52837,35440,0,0,deny,66,66,0,1,0,1,0
46503,443,50192,443,allow,6492,1764,4728,56,996,20,36
63201,445,0,0,drop,66,66,0,1,0,1,0
56762,53,35908,53,allow,168,86,82,2,31,1,1
52053,445,0,0,drop,70,70,0,1,0,1,0
34285,53,45642,53,allow,168,78,90,2,30,1,1
17750,30022,45838,30022,allow,481,150,331,2,1200,1,1
55084,445,0,0,drop,70,70,0,1,0,1,0
60894,443,20427,443,allow,34862,6364,28498,64,54,31,33
56656,53,40908,53,allow,255,88,167,4,53,2,2
60698,445,0,0,drop,66,66,0,1,0,1,0
51765,52862,26786,52862,allow,70,70,0,2,7,2,0
55508,64147,0,0,deny,62,62,0,1,0,1,0
48290,443,64782,443,allow,7920,2731,5189,27,82,15,12
51825,25501,31893,25501,allow,66,66,0,1,5,1,0
50362,53,19652,53,allow,177,94,83,2,30,1,1
58445,17500,0,0,deny,66,66,0,1,0,1,0
50304,443,23238,443,allow,3565,1947,1618,19,15,9,10
17230,25174,0,0,deny,146,146,0,1,0,1,0
52955,443,44904,443,allow,3617,2035,1582,30,346,15,15
51067,445,0,0,drop,66,66,0,1,0,1,0
27160,64147,0,0,deny,66,66,0,1,0,1,0
60851,445,0,0,drop,70,70,0,1,0,1,0
56484,53,42861,53,allow,214,110,104,2,31,1,1
51759,55308,19017,55308,allow,70,70,0,1,5,1,0
55373,1,0,0,deny,66,66,0,1,0,1,0
43366,53,27594,53,allow,168,78,90,2,30,1,1
63147,445,0,0,drop,70,70,0,1,0,1,0
38565,51505,0,0,deny,62,62,0,1,0,1,0
58453,50584,0,0,deny,66,66,0,1,0,1,0
56609,53,56720,53,allow,198,101,97,2,30,1,1
56688,25174,0,0,deny,62,62,0,1,0,1,0
43969,7000,43969,7000,allow,3370,1595,1775,16,15,9,7
44258,25,0,0,deny,74,74,0,1,0,1,0
53800,443,21628,443,allow,499,425,74,4,0,3,1
59057,445,0,0,drop,70,70,0,1,0,1,0
55110,53,57772,53,allow,770,102,668,2,30,1,1
64678,445,0,0,drop,66,66,0,1,0,1,0
16387,22226,0,0,allow,60,60,0,1,61,1,0
54743,445,0,0,drop,70,70,0,1,0,1,0
52114,64853,12974,64853,allow,70,70,0,2,8,2,0
25776,53,25776,53,allow,233,90,143,2,32,1,1
64739,53,17167,53,allow,178,94,84,2,30,1,1
52893,445,0,0,drop,70,70,0,1,0,1,0
50462,80,58102,80,allow,4603,2152,2451,14,22,8,6
60418,39537,32602,39537,allow,70,70,0,2,8,2,0
56227,53,19451,53,allow,194,102,92,2,30,1,1
34993,15503,0,0,deny,62,62,0,1,0,1,0
61441,443,10709,443,allow,7832,1143,6689,19,31,9,10
18754,30188,0,0,deny,66,66,0,1,0,1,0
37586,443,60764,443,allow,19675,10416,9259,53,81,30,23
34351,443,4638,443,allow,402051,17714,384337,520,83,228,292
63852,35440,0,0,deny,62,62,0,1,0,1,0
49673,53,51744,53,allow,421,88,333,4,39,2,2
55066,53,26532,53,allow,815,95,720,2,31,1,1
58638,5900,0,0,deny,62,62,0,1,0,1,0
53807,443,5620,443,allow,4622,860,3762,16,17,9,7
58352,445,0,0,drop,70,70,0,1,0,1,0
56460,445,0,0,drop,70,70,0,1,0,1,0
53730,37965,0,0,deny,66,66,0,1,0,1,0
56710,53,13287,53,allow,195,102,93,2,30,1,1
55733,53,35309,53,allow,170,87,83,2,31,1,1
64432,53,46411,53,allow,168,86,82,2,30,1,1
43916,21,0,0,deny,60,60,0,1,0,1,0
54908,53,0,0,allow,174,79,95,2,30,1,1
56637,445,0,0,drop,70,70,0,1,0,1,0
49826,443,3257,443,allow,102548,19098,83450,140,35,60,80
50581,80,61624,80,allow,2573,1859,714,9,47,5,4
49940,53,29743,53,allow,197,94,103,2,29,1,1
61336,445,0,0,drop,66,66,0,1,0,1,0
58887,443,25823,443,allow,5167,700,4467,16,15,7,9
64131,445,0,0,drop,70,70,0,1,0,1,0
3478,61463,0,0,deny,921,921,0,1,0,1,0
27679,37965,0,0,deny,62,62,0,1,0,1,0
43584,24748,0,0,deny,156,156,0,1,0,1,0
53693,26515,52761,26515,allow,70,70,0,2,7,2,0
49625,445,0,0,drop,70,70,0,1,0,1,0
58026,80,26240,80,allow,454,262,192,8,21,5,3
51787,35661,32624,35661,allow,70,70,0,2,8,2,0
49036,44847,0,0,deny,62,62,0,1,0,1,0
49485,11392,0,0,deny,66,66,0,1,0,1,0
49451,53,46529,53,allow,757,98,659,2,31,1,1
64036,445,0,0,drop,66,66,0,1,0,1,0
51760,36558,34247,36558,allow,70,70,0,1,5,1,0
49654,53,58880,53,allow,214,110,104,2,31,1,1
57614,80,57614,80,allow,470276,8994,461282,388,25,75,313
56560,53,17987,53,allow,199,102,97,2,30,1,1
64073,53,23568,53,allow,199,102,97,2,30,1,1
55584,34914,32488,34914,allow,504,318,186,8,15,5,3
13826,53,57057,53,allow,200,94,106,2,31,1,1
52335,443,49316,443,allow,5670,2739,2931,18,129,9,9
62973,51505,0,0,deny,62,62,0,1,0,1,0
49858,53,41757,53,allow,177,94,83,2,30,1,1
52694,443,37161,443,allow,10384,4563,5821,34,436,17,17
51647,445,0,0,drop,70,70,0,1,0,1,0
65211,53,44478,53,allow,183,94,89,2,30,1,1
57797,445,0,0,drop,70,70,0,1,0,1,0
40116,23,0,0,deny,60,60,0,1,0,1,0
63264,53,63264,53,allow,197,90,107,2,30,1,1
29016,25174,0,0,deny,62,62,0,1,0,1,0
53689,445,0,0,drop,70,70,0,1,0,1,0
61223,37965,0,0,deny,62,62,0,1,0,1,0
55013,53,27966,53,allow,198,102,96,2,30,1,1
52046,59791,37077,59791,allow,70,70,0,2,7,2,0
54051,445,0,0,drop,70,70,0,1,0,1,0
42377,443,33699,443,allow,1622,1137,485,11,26,7,4
55866,53,10182,53,allow,257,94,163,2,30,1,1
58638,5900,0,0,deny,62,62,0,1,0,1,0
53774,443,4137,443,allow,499,425,74,4,0,3,1
64664,53,51475,53,allow,168,86,82,2,34,1,1
59392,443,2075,443,allow,105190,30835,74355,372,589,169,203
63047,445,0,0,drop,70,70,0,1,0,1,0
55103,445,0,0,drop,70,70,0,1,0,1,0
46216,443,47226,443,allow,13769,11153,2616,30,361,16,14
50606,445,0,0,drop,70,70,0,1,0,1,0
64704,53,49716,53,allow,213,102,111,2,29,1,1
56927,53,19352,53,allow,182,93,89,2,31,1,1
56174,443,33268,443,allow,1310,649,661,13,185,7,6
34657,443,31367,443,allow,448,78,370,6,25,1,5
52030,43068,39879,43068,allow,70,70,0,2,8,2,0
60291,445,0,0,drop,70,70,0,1,0,1,0
27000,23117,0,0,deny,62,62,0,1,0,1,0
43702,443,33020,443,allow,1201,707,494,12,26,7,5
58361,443,12659,443,allow,7297,2046,5251,22,29,13,9
1025,46776,0,0,deny,62,62,0,1,0,1,0
57436,53,31842,53,allow,182,93,89,2,30,1,1
53928,15503,0,0,deny,145,145,0,1,0,1,0
9177,443,23456,443,allow,6331,837,5494,19,28,10,9
49189,443,36551,443,allow,15611,1501,14110,32,361,14,18
51960,58601,12629,58601,allow,70,70,0,2,8,2,0
56977,53,6420,53,allow,322,102,220,2,30,1,1
64695,53,11927,53,allow,193,102,91,2,30,1,1
57021,445,0,0,drop,70,70,0,1,0,1,0
64615,445,0,0,drop,70,70,0,1,0,1,0
49931,25174,0,0,deny,62,62,0,1,0,1,0
48788,443,25045,443,allow,6254,1075,5179,22,34,10,12
44568,3389,0,0,deny,60,60,0,1,0,1,0
58638,5900,0,0,deny,62,62,0,1,0,1,0
50812,445,0,0,drop,70,70,0,1,0,1,0
53260,36237,0,0,deny,146,146,0,1,0,1,0
63970,53,19074,53,allow,228,110,118,2,30,1,1
52754,26467,0,0,deny,62,62,0,1,0,1,0
49590,57470,0,0,deny,78,78,0,1,0,1,0
38010,443,65428,443,allow,5474,2239,3235,31,80,14,17
51692,445,0,0,drop,70,70,0,1,0,1,0
49649,80,26716,80,allow,378,192,186,7,41,4,3
54530,46776,0,0,deny,66,66,0,1,0,1,0
30280,37965,0,0,deny,66,66,0,1,0,1,0
50434,445,0,0,drop,70,70,0,1,0,1,0
61637,53,50085,53,allow,246,246,0,4,47,4,0
25197,1433,0,0,deny,60,60,0,1,0,1,0
64949,445,0,0,drop,70,70,0,1,0,1,0
53263,445,0,0,drop,70,70,0,1,0,1,0
50806,51505,0,0,deny,66,66,0,1,0,1,0
40260,44610,0,0,deny,145,145,0,1,0,1,0
56052,445,0,0,drop,70,70,0,1,0,1,0
2876,35440,0,0,deny,62,62,0,1,0,1,0
63028,53,16966,53,allow,384,166,218,2,30,1,1
50722,445,0,0,drop,70,70,0,1,0,1,0
61037,445,0,0,drop,66,66,0,1,0,1,0
42956,53,20926,53,allow,168,78,90,2,30,1,1
51753,445,0,0,drop,70,70,0,1,0,1,0
55684,53,56434,53,allow,193,102,91,2,30,1,1
61846,445,0,0,drop,66,66,0,1,0,1,0
53833,53,46684,53,allow,211,78,133,2,30,1,1
55683,53,63904,53,allow,391,134,257,2,30,1,1
55043,53,56883,53,allow,167,86,81,2,29,1,1
60764,445,0,0,drop,70,70,0,1,0,1,0
3512,23,0,0,deny,60,60,0,1,0,1,0
64387,53,16161,53,allow,359,99,260,4,54,2,2
4567,80,4567,80,allow,23456,1005,22451,32,16,13,19
58813,443,14180,443,allow,6475,4197,2278,22,16,12,10
10903,53,10903,53,allow,247,98,149,2,32,1,1
50723,80,33475,80,allow,1546,1109,437,7,15,5,2
50461,443,58774,443,allow,5440,4368,1072,19,34,11,8
57357,445,0,0,drop,70,70,0,1,0,1,0
62885,62413,0,0,deny,66,66,0,1,0,1,0
63388,445,0,0,drop,70,70,0,1,0,1,0
54328,445,0,0,drop,66,66,0,1,0,1,0
52064,80,33091,80,allow,692,300,392,9,25,6,3
62743,445,0,0,drop,66,66,0,1,0,1,0
39636,80,39636,80,allow,4774,553,4221,13,20,6,7
56441,80,54346,80,allow,17008,1379,15629,22,25,7,15
11775,25174,0,0,deny,62,62,0,1,0,1,0
32307,22114,0,0,deny,146,146,0,1,0,1,0
52782,443,35099,443,allow,1581,924,657,15,125,7,8
54499,445,0,0,drop,70,70,0,1,0,1,0
49323,53,32529,53,allow,204,104,100,2,31,1,1
56388,53,28849,53,allow,193,102,91,2,29,1,1
33000,53,0,0,allow,82,82,0,1,31,1,0
40216,443,24772,443,allow,10196,2175,8021,25,186,14,11
51090,80,51090,80,allow,19837,2061,17776,30,21,14,16
56702,53,49433,53,allow,168,78,90,2,30,1,1
59503,445,0,0,drop,66,66,0,1,0,1,0
54653,6881,28676,6881,allow,658,412,246,9,15,5,4
49201,53,35149,53,allow,200,102,98,2,30,1,1
56667,53,35653,53,allow,199,102,97,2,29,1,1
50839,445,0,0,drop,70,70,0,1,0,1,0
62524,53,62524,53,allow,212,90,122,2,30,1,1
48817,32794,48817,32794,allow,152,152,0,1,1200,1,0
53454,443,37572,443,allow,10416,3195,7221,32,46,18,14
55354,53,26809,53,allow,212,108,104,2,31,1,1
59045,53,10960,53,allow,231,110,121,2,30,1,1
54184,445,0,0,drop,66,66,0,1,0,1,0
42607,443,6741,443,allow,10221,3259,6962,36,120,18,18
64341,57470,0,0,deny,62,62,0,1,0,1,0
44861,443,14296,443,allow,1625,1038,587,14,27,8,6
10036,44847,0,0,deny,66,66,0,1,0,1,0
56614,25174,0,0,deny,66,66,0,1,0,1,0
51628,443,16414,443,allow,8084,2509,5575,36,195,19,17
58178,443,51468,443,allow,8000,1760,6240,32,43,16,16
60432,80,60432,80,allow,19915,764,19151,23,16,7,16
57029,53,54997,53,allow,413,170,243,6,30,3,3
49978,53,47119,53,allow,774,101,673,2,31,1,1
49744,80,34902,80,allow,1111,749,362,9,15,5,4
6881,6992,61749,6992,allow,150,150,0,1,1200,1,0
54341,443,8795,443,allow,10046,3300,6746,23,61,14,9
49520,445,0,0,drop,70,70,0,1,0,1,0
15176,62413,0,0,deny,66,66,0,1,0,1,0
64772,445,0,0,drop,70,70,0,1,0,1,0
54905,445,0,0,drop,66,66,0,1,0,1,0
64605,53,37496,53,allow,183,94,89,2,30,1,1
56513,53,43170,53,allow,184,86,98,2,30,1,1
53813,443,59809,443,allow,499,425,74,4,0,3,1
48271,25174,0,0,deny,146,146,0,1,0,1,0
56668,53,7163,53,allow,199,102,97,2,30,1,1
40799,443,51690,443,allow,21024,14637,6387,46,271,26,20
63976,25725,20832,25725,allow,66,66,0,1,5,1,0
65291,53,57485,53,allow,195,102,93,2,29,1,1
9687,35440,0,0,deny,66,66,0,1,0,1,0
49577,57470,0,0,deny,66,66,0,1,0,1,0
51413,1,0,0,deny,72,72,0,1,0,1,0
27005,1304,58771,1304,allow,859,126,733,2,29,1,1
56753,44847,0,0,deny,62,62,0,1,0,1,0
60805,445,0,0,drop,70,70,0,1,0,1,0
55994,22114,0,0,deny,66,66,0,1,0,1,0
57084,443,60490,443,allow,9905,4321,5584,27,315,13,14
61851,445,0,0,drop,66,66,0,1,0,1,0
443,51550,0,0,deny,100,100,0,1,0,1,0
59454,445,0,0,drop,70,70,0,1,0,1,0
56611,443,56611,443,allow,4530,1623,2907,19,26,11,8
27084,50584,0,0,deny,66,66,0,1,0,1,0
49717,443,52321,443,allow,4876,855,4021,16,52,7,9
13235,44847,0,0,deny,62,62,0,1,0,1,0
64504,445,0,0,drop,70,70,0,1,0,1,0
50502,443,59383,443,allow,11323,3376,7947,29,77,16,13
57411,53,38630,53,allow,711,87,624,2,31,1,1
63787,18318,22110,18318,allow,70,70,0,1,5,1,0
55327,443,55327,443,allow,16304,2069,14235,39,17,19,20
8662,80,8662,80,allow,194259,7011,187248,211,39,80,131
37585,443,50718,443,allow,499,425,74,4,2,3,1
32491,15503,0,0,deny,66,66,0,1,0,1,0
58057,80,11789,80,allow,2708,1386,1322,23,75,12,11
58811,53976,0,0,deny,66,66,0,1,0,1,0
64380,53,30464,53,allow,196,102,94,2,32,1,1
49181,53,18919,53,allow,184,102,82,2,30,1,1
49629,53,5781,53,allow,198,102,96,2,30,1,1
63002,22114,0,0,deny,66,66,0,1,0,1,0
52492,445,0,0,drop,66,66,0,1,0,1,0
53171,11820,1212,11820,allow,698,320,378,10,16,6,4
56385,53,50438,53,allow,249,85,164,4,56,2,2
64602,53,49677,53,allow,184,94,90,2,30,1,1
63012,53,5232,53,allow,304,86,218,2,30,1,1
46939,443,46939,443,allow,4657,1750,2907,19,28,11,8
55134,53,17370,53,allow,214,110,104,2,30,1,1
59644,445,0,0,drop,66,66,0,1,0,1,0
61563,37807,0,0,deny,66,66,0,1,0,1,0
61583,64147,0,0,deny,66,66,0,1,0,1,0
41477,50584,0,0,deny,66,66,0,1,0,1,0
56919,53,23059,53,allow,423,95,328,4,34,2,2
49522,443,49522,443,allow,7647,1693,5954,31,77,16,15
65018,53,20967,53,allow,310,102,208,2,30,1,1
30951,50584,0,0,deny,62,62,0,1,0,1,0
49939,53,35198,53,allow,231,102,129,2,29,1,1
53609,53,21780,53,allow,385,94,291,2,30,1,1
57629,80,39284,80,allow,1115,534,581,12,16,7,5
50800,445,0,0,drop,70,70,0,1,0,1,0
56636,80,30803,80,allow,234,234,0,4,12,4,0
49045,80,27391,80,allow,1105,624,481,13,316,7,6
39890,443,25429,443,allow,18127,8010,10117,41,116,24,17
64357,53,13293,53,allow,183,94,89,2,30,1,1
55587,43890,0,0,deny,66,66,0,1,0,1,0
61142,445,0,0,drop,70,70,0,1,0,1,0
60717,445,0,0,drop,70,70,0,1,0,1,0
52042,80,17014,80,allow,70,70,0,2,8,2,0
49499,443,5486,443,allow,8848,4908,3940,23,42,12,11
50548,445,0,0,drop,66,66,0,1,0,1,0
52305,445,0,0,drop,70,70,0,1,0,1,0
53888,443,38577,443,allow,499,425,74,4,0,3,1
36836,443,63140,443,allow,7195,1791,5404,18,99,11,7
50612,443,9041,443,allow,6782,3367,3415,25,139,15,10
57470,51413,33371,51413,allow,460,150,310,2,1199,1,1
22783,64147,0,0,deny,66,66,0,1,0,1,0
34373,28678,41304,28678,allow,1806,1806,0,22,224,22,0
64805,53,48699,53,allow,278,102,176,2,31,1,1
55657,37273,33354,37273,allow,70,70,0,2,8,2,0
56240,80,56240,80,allow,101524,1673,99851,94,15,24,70
24486,53,24486,53,allow,414,268,146,3,31,2,1
60143,443,49806,443,allow,16448,5420,11028,47,319,23,24
50649,80,63151,80,allow,1366,865,501,8,15,5,3
54391,445,0,0,drop,70,70,0,1,0,1,0
56119,46824,0,0,deny,62,62,0,1,0,1,0
55242,53,7339,53,allow,373,126,247,2,30,1,1
30443,44847,0,0,deny,62,62,0,1,0,1,0
58841,445,0,0,drop,70,70,0,1,0,1,0
49544,80,16588,80,allow,10192,3818,6374,20,16,9,11
61818,80,36349,80,allow,4454,591,3863,12,45,6,6
62348,443,31303,443,allow,1592,965,627,15,20,7,8
38474,28678,45201,28678,allow,1806,1806,0,22,224,22,0
56975,53,33537,53,allow,197,102,95,2,30,1,1
65168,53,46023,53,allow,239,94,145,2,30,1,1
54819,443,51134,443,allow,8093,1263,6830,25,39,13,12
53010,445,0,0,drop,70,70,0,1,0,1,0
51671,443,38152,443,allow,1143,703,440,13,38,8,5
51325,445,0,0,drop,70,70,0,1,0,1,0
53650,64147,0,0,deny,66,66,0,1,0,1,0
56785,53,32079,53,allow,193,102,91,2,30,1,1
14484,39004,0,0,deny,145,145,0,1,0,1,0
49502,53,5291,53,allow,193,102,91,2,30,1,1
65060,35440,0,0,deny,66,66,0,1,0,1,0
58638,5900,0,0,deny,62,62,0,1,0,1,0
50600,53,50600,53,allow,257,101,156,2,34,1,1
56679,51505,0,0,deny,62,62,0,1,0,1,0
60122,445,0,0,drop,66,66,0,1,0,1,0
58638,5900,0,0,deny,62,62,0,1,0,1,0
65166,62413,0,0,deny,66,66,0,1,0,1,0
63424,445,0,0,drop,70,70,0,1,0,1,0
52000,80,35865,80,allow,3495,1150,2345,17,18,8,9
55426,53,8033,53,allow,181,98,83,2,30,1,1
49500,53,31434,53,allow,248,118,130,2,29,1,1
55599,80,22870,80,allow,1165,473,692,10,14,5,5
62338,443,61578,443,allow,13396186,148566,13247620,10474,59,1498,8976
65136,53,56323,53,allow,458,104,354,4,57,2,2
42280,443,42280,443,allow,2052,1187,865,21,76,11,10
53757,1,21144,1,allow,70,70,0,2,8,2,0
56679,5900,0,0,deny,60,60,0,1,0,1,0
58125,445,0,0,drop,70,70,0,1,0,1,0
60500,445,0,0,drop,66,66,0,1,0,1,0
56708,443,4344,443,allow,8059,2039,6020,20,15,11,9
57485,445,0,0,drop,70,70,0,1,0,1,0
56525,443,34500,443,allow,5022,973,4049,17,60,9,8
49488,53,28678,53,allow,194,102,92,2,31,1,1
13654,50584,0,0,deny,62,62,0,1,0,1,0
52819,15503,0,0,deny,66,66,0,1,0,1,0
64419,445,0,0,drop,66,66,0,1,0,1,0
62815,445,0,0,drop,70,70,0,1,0,1,0
49860,53,63227,53,allow,184,102,82,2,30,1,1
47892,443,19816,443,allow,6454,1447,5007,22,17,11,11
49186,53,38504,53,allow,198,102,96,2,30,1,1
53071,25174,0,0,deny,66,66,0,1,0,1,0
61020,445,0,0,drop,70,70,0,1,0,1,0
56105,445,0,0,drop,70,70,0,1,0,1,0
49245,53,24840,53,allow,195,102,93,2,30,1,1
54047,445,0,0,drop,66,66,0,1,0,1,0
49204,443,40475,443,allow,1786,172,1614,7,120,3,4
55280,445,0,0,drop,70,70,0,1,0,1,0
16387,22272,0,0,deny,60,60,0,1,0,1,0
56441,53,4935,53,allow,209,110,99,2,29,1,1
61016,445,0,0,drop,70,70,0,1,0,1,0
63811,445,0,0,drop,70,70,0,1,0,1,0
64884,53,3518,53,allow,195,102,93,2,30,1,1
55994,22114,0,0,deny,66,66,0,1,0,1,0
8889,9794,0,0,deny,60,60,0,1,0,1,0
64463,53,2430,53,allow,183,94,89,2,29,1,1
51522,445,0,0,drop,70,70,0,1,0,1,0
50658,445,0,0,drop,66,66,0,1,0,1,0
40888,8434,40888,8434,allow,156,156,0,3,8,3,0
55083,445,0,0,drop,66,66,0,1,0,1,0
63937,43443,33286,43443,allow,246,66,180,4,7,2,2
55483,443,25400,443,allow,4496,2369,2127,15,136,7,8
58593,57470,0,0,deny,62,62,0,1,0,1,0
51975,11998,3978,11998,allow,70,70,0,2,8,2,0
51827,48432,31400,48432,allow,160,70,90,2,4,1,1
27745,50584,0,0,deny,62,62,0,1,0,1,0
57283,443,46704,443,allow,7792,2318,5474,38,27,22,16
37561,443,20164,443,allow,9766,3093,6673,37,270,21,16
64730,53,5756,53,allow,261,94,167,2,30,1,1
49557,53,50413,53,allow,272,110,162,2,29,1,1
6881,6881,0,0,deny,62,62,0,1,0,1,0
42898,25174,0,0,deny,62,62,0,1,0,1,0
15005,32480,0,0,deny,145,145,0,1,0,1,0
64254,53,19864,53,allow,197,94,103,2,30,1,1
51414,22,0,0,deny,60,60,0,1,0,1,0
52201,44054,12966,44054,allow,66,66,0,2,9,2,0
43260,41615,0,0,deny,145,145,0,1,0,1,0
60923,49903,0,0,deny,66,66,0,1,0,1,0
51791,56116,24331,56116,allow,70,70,0,1,5,1,0
29300,35440,0,0,deny,62,62,0,1,0,1,0
33583,443,54351,443,allow,479444,14906,464538,489,62,173,316
51304,443,39350,443,allow,5839,3609,2230,25,361,13,12
65060,53,36666,53,allow,761,100,661,2,30,1,1
50355,43890,0,0,deny,66,66,0,1,0,1,0
55245,53,25152,53,allow,193,102,91,2,30,1,1
60632,445,0,0,drop,70,70,0,1,0,1,0
52520,80,54295,80,allow,3224,2776,448,11,15,7,4
58843,80,20341,80,allow,1439485,27511,1411974,1308,108,369,939
59168,445,0,0,drop,70,70,0,1,0,1,0
55000,53,31472,53,allow,193,102,91,2,29,1,1
55390,443,55390,443,allow,164571,13257,151314,206,19,95,111
55046,53,20538,53,allow,300,102,198,4,40,2,2
45540,8100,25472,8100,allow,234,234,0,4,12,4,0
37996,49152,50684,49152,allow,156,156,0,3,8,3,0
34092,53,13668,53,allow,168,78,90,2,30,1,1
2588,53,2588,53,allow,197,76,121,2,30,1,1
56911,53,31733,53,allow,177,94,83,2,30,1,1
50699,80,28391,80,allow,54318,27824,26494,227,174,113,114
57139,53,1323,53,allow,164,84,80,2,31,1,1
30960,45727,32973,45727,allow,330,330,0,6,3610,6,0
50908,445,0,0,drop,70,70,0,1,0,1,0
56597,443,50431,443,allow,10135129,248530,9886599,9808,64,3124,6684
49163,53,4379,53,allow,167,86,81,2,30,1,1
54667,445,0,0,drop,70,70,0,1,0,1,0
58227,445,0,0,drop,66,66,0,1,0,1,0
58888,445,0,0,drop,70,70,0,1,0,1,0
48830,5900,0,0,deny,60,60,0,1,0,1,0
53779,24874,46162,24874,allow,70,70,0,1,5,1,0
51594,443,50600,443,allow,5854,1148,4706,18,23,10,8
49864,445,0,0,drop,70,70,0,1,0,1,0
50664,443,33919,443,allow,9666,1682,7984,25,16,13,12
50584,8622,56694,8622,allow,166,166,0,1,1200,1,0
57470,5254,14927,5254,allow,453,251,202,4,1200,2,2
65507,53,62722,53,allow,177,94,83,2,30,1,1
64947,53,11296,53,allow,275,96,179,4,41,2,2
51426,445,0,0,drop,66,66,0,1,0,1,0
45682,1,0,0,deny,62,62,0,1,0,1,0
63891,51350,44570,51350,allow,312,132,180,6,7,3,3
50335,445,0,0,drop,66,66,0,1,0,1,0
49343,445,0,0,drop,66,66,0,1,0,1,0
3478,61463,0,0,deny,686,686,0,1,0,1,0
58638,5900,0,0,deny,62,62,0,1,0,1,0
51094,35440,0,0,deny,66,66,0,1,0,1,0
55545,3389,55545,3389,allow,3527,1638,1889,18,18,11,7
59779,443,18781,443,allow,6055,3602,2453,16,136,8,8
443,9986,0,0,deny,669,669,0,1,0,1,0
61484,443,59400,443,allow,9479,3507,5972,24,16,12,12
58057,445,0,0,drop,66,66,0,1,0,1,0
61682,445,0,0,drop,70,70,0,1,0,1,0
50524,445,0,0,drop,66,66,0,1,0,1,0
43585,443,18767,443,allow,6636,3565,3071,22,187,13,9
49679,53,54923,53,allow,166,86,80,2,30,1,1
19933,35440,0,0,deny,62,62,0,1,0,1,0
53930,445,0,0,drop,70,70,0,1,0,1,0
58856,443,16403,443,allow,4005,1421,2584,14,136,7,7
1070,26467,0,0,deny,62,62,0,1,0,1,0
13285,29892,0,0,deny,145,145,0,1,0,1,0
80,13987,0,0,deny,66,66,0,1,0,1,0
47950,443,47950,443,allow,9159,1627,7532,19,150,11,8
54210,36237,0,0,deny,62,62,0,1,0,1,0
55664,53,44957,53,allow,190,97,93,2,30,1,1
27005,27015,5485,27015,allow,889,126,763,2,30,1,1
62548,445,0,0,drop,70,70,0,1,0,1,0
60342,36237,0,0,deny,66,66,0,1,0,1,0
58992,53,0,0,allow,273,86,187,2,30,1,1
56456,53,45669,53,allow,199,102,97,2,30,1,1
49364,53,30235,53,allow,183,94,89,2,30,1,1
50116,22,50116,22,allow,60,60,0,1,5,1,0
42796,22114,0,0,deny,146,146,0,1,0,1,0
49988,443,49988,443,allow,2123,1050,1073,23,120,11,12
56426,80,33168,80,allow,17008,1379,15629,22,25,7,15
54078,443,47563,443,allow,1060654,45683,1014971,1265,176,560,705
50808,445,0,0,drop,66,66,0,1,0,1,0
57061,53,28599,53,allow,1780,674,1106,18,68,9,9
55664,53,1350,53,allow,195,102,93,2,30,1,1
51230,443,29300,443,allow,33489,19602,13887,98,43,51,47
49696,53,30519,53,allow,178,94,84,2,30,1,1
29047,80,29047,80,allow,10148,1458,8690,23,25,11,12
56678,443,37527,443,allow,4099,2450,1649,36,2615,19,17
53227,443,46822,443,allow,5430,687,4743,15,73,6,9
64933,445,0,0,drop,66,66,0,1,0,1,0
54301,445,0,0,drop,70,70,0,1,0,1,0
27005,27015,4428,27015,allow,884,126,758,2,31,1,1
50397,445,0,0,drop,70,70,0,1,0,1,0
9717,22114,0,0,deny,146,146,0,1,0,1,0
64512,53,55792,53,allow,244,118,126,2,30,1,1
61402,445,0,0,drop,66,66,0,1,0,1,0
55344,53,62039,53,allow,212,110,102,2,30,1,1
55546,445,0,0,drop,66,66,0,1,0,1,0
59560,443,54712,443,allow,4038,1219,2819,22,135,9,13
49476,443,31371,443,allow,7254,1183,6071,19,152,9,10
58338,3369,0,0,deny,60,60,0,1,0,1,0
49339,80,8376,80,allow,1467,361,1106,10,15,5,5
58694,445,0,0,drop,70,70,0,1,0,1,0
4540,23,0,0,deny,60,60,0,1,0,1,0
1738,80,1738,80,allow,87958,5378,82580,100,95,39,61
54602,445,0,0,drop,70,70,0,1,0,1,0
55453,53,1077,53,allow,730,102,628,2,30,1,1
62228,443,62228,443,allow,296688,57600,239088,332,96,141,191
37330,53,37330,53,allow,237,91,146,2,31,1,1
50328,80,59408,80,allow,55878,5841,50037,70,94,29,41
50236,443,15469,443,allow,5858,791,5067,19,22,10,9
55276,53,25720,53,allow,177,94,83,2,29,1,1
49609,53,20657,53,allow,177,94,83,2,29,1,1
64555,53,55433,53,allow,166,85,81,2,31,1,1
64546,57470,0,0,deny,66,66,0,1,0,1,0
65464,445,0,0,drop,70,70,0,1,0,1,0
49228,53,49228,53,allow,825,99,726,2,30,1,1
59592,37965,0,0,deny,62,62,0,1,0,1,0
63068,443,30672,443,allow,2928239,68426,2859813,2888,37,955,1933
55326,53,8434,53,allow,170,87,83,2,30,1,1
49790,445,0,0,drop,66,66,0,1,0,1,0
57896,443,11349,443,allow,7332,3746,3586,37,176,19,18
34527,443,29221,443,allow,480624,56231,424393,860,196,427,433
12573,53,12573,53,allow,235,90,145,2,32,1,1
51852,443,17719,443,allow,1382291,55962,1326329,1491,24,582,909
53448,5223,10796,5223,allow,134,60,74,3,4,2,1
49418,27015,48509,27015,allow,266,71,195,2,31,1,1
49936,53,28353,53,allow,211,102,109,2,31,1,1
42895,53,15137,53,allow,168,78,90,2,30,1,1
50287,445,0,0,drop,66,66,0,1,0,1,0
51784,8245,58196,8245,allow,280,214,66,2,31,1,1
23594,48983,0,0,deny,159,159,0,1,0,1,0
63969,445,0,0,drop,66,66,0,1,0,1,0
56054,53,43314,53,allow,740,93,647,2,31,1,1
30188,63236,11932,63236,allow,11247,4773,6474,66,1454,32,34
46945,64147,0,0,deny,62,62,0,1,0,1,0
60399,80,36861,80,allow,1168,815,353,10,122,6,4
65286,53,17051,53,allow,756,94,662,2,30,1,1
2837,25174,0,0,deny,62,62,0,1,0,1,0
64915,53,11027,53,allow,177,94,83,2,30,1,1
7347,56205,0,0,deny,66,66,0,1,0,1,0
52578,445,0,0,drop,70,70,0,1,0,1,0
56417,445,0,0,drop,70,70,0,1,0,1,0
51073,80,13586,80,allow,525373,237667,287706,1387,390,693,694
23306,25174,0,0,deny,146,146,0,1,0,1,0
34879,443,57316,443,allow,167,107,60,2,5,1,1
51300,445,0,0,drop,70,70,0,1,0,1,0
57217,445,0,0,drop,66,66,0,1,0,1,0
55854,54369,0,0,deny,74,74,0,1,0,1,0
33328,25174,0,0,deny,62,62,0,1,0,1,0
30015,36237,0,0,deny,66,66,0,1,0,1,0
23317,443,22656,443,allow,2227,1018,1209,17,15,8,9
32927,443,31722,443,allow,867883,29498,838385,922,58,328,594
49740,53,58621,53,allow,167,86,81,2,29,1,1
56629,443,36618,443,allow,22938,14436,8502,43,35,23,20
30960,45740,3924,45740,allow,330,330,0,6,3609,6,0
55726,27015,16348,27015,allow,1173,924,249,6,30,3,3
53416,445,0,0,drop,70,70,0,1,0,1,0
63855,25174,0,0,deny,62,62,0,1,0,1,0
993,58185,0,0,deny,129,129,0,1,0,1,0
51632,443,13714,443,allow,5021,2884,2137,14,135,7,7
53457,443,28376,443,allow,26693,2059,24634,42,30,18,24
50759,445,0,0,drop,66,66,0,1,0,1,0
46619,123,26763,123,allow,184,94,90,2,30,1,1
49983,53,19113,53,allow,267,110,157,2,30,1,1
25497,44847,0,0,deny,62,62,0,1,0,1,0
49982,37965,0,0,deny,66,66,0,1,0,1,0
53664,13701,27246,13701,allow,70,70,0,2,8,2,0
56607,443,33013,443,allow,21604,12969,8635,49,112,28,21
54012,443,7741,443,allow,4318,726,3592,14,16,7,7
63196,445,0,0,deny,66,66,0,1,0,1,0
57550,445,0,0,drop,70,70,0,1,0,1,0
55015,443,8354,443,allow,1786,172,1614,7,120,3,4
60167,445,0,0,drop,70,70,0,1,0,1,0
59773,5900,0,0,deny,60,60,0,1,0,1,0
50825,443,30672,443,allow,252960,10277,242683,301,209,119,182
65510,443,47071,443,allow,92101,4799,87302,107,16,43,64
60474,443,49891,443,allow,5888,1175,4713,19,76,11,8
56176,53,62297,53,allow,102,102,0,1,30,1,0
57034,44847,0,0,deny,62,62,0,1,0,1,0
53831,54676,36346,54676,allow,492,306,186,8,16,5,3
27005,27015,50537,27015,allow,878,126,752,2,30,1,1
50116,80,62862,80,allow,10094,1100,8994,20,33,10,10
62791,445,0,0,drop,70,70,0,1,0,1,0
65454,61600,0,0,deny,66,66,0,1,0,1,0
5227,50584,0,0,deny,146,146,0,1,0,1,0
57706,64147,0,0,deny,66,66,0,1,0,1,0
55619,53,59792,53,allow,241,78,163,2,30,1,1
6828,64322,0,0,deny,60,60,0,1,0,1,0
63213,15503,0,0,deny,62,62,0,1,0,1,0
5637,23,0,0,deny,60,60,0,1,0,1,0
40217,443,61607,443,allow,5377,857,4520,21,88,8,13
55448,53,23931,53,allow,184,94,90,2,29,1,1
60637,445,0,0,drop,70,70,0,1,0,1,0
61523,37807,0,0,deny,66,66,0,1,0,1,0
5575,8889,5575,8889,deny,497,497,0,1,0,1,0
58117,445,0,0,drop,66,66,0,1,0,1,0
63787,445,0,0,drop,70,70,0,1,0,1,0
443,38385,0,0,allow,66,66,0,1,90,1,0
49556,443,16559,443,allow,8602,2308,6294,23,82,13,10
53286,443,1896,443,allow,123194,68738,54456,402,287,167,235
56312,445,0,0,drop,70,70,0,1,0,1,0
60018,443,30525,443,allow,8127,1796,6331,21,79,12,9
57307,443,55707,443,allow,35035,5135,29900,81,216,33,48
13188,35440,0,0,deny,66,66,0,1,0,1,0
55500,445,0,0,drop,70,70,0,1,0,1,0
51727,1024,54726,1024,allow,66,66,0,1,5,1,0
49514,80,16033,80,allow,1352,832,520,12,38,7,5
59027,445,0,0,drop,70,70,0,1,0,1,0
56330,53,9857,53,allow,271,95,176,4,48,2,2
1873,37965,0,0,deny,62,62,0,1,0,1,0
44603,53,44603,53,allow,229,98,131,2,29,1,1
49245,53,34102,53,allow,376,126,250,2,29,1,1
61759,445,0,0,drop,70,70,0,1,0,1,0
51158,445,0,0,drop,70,70,0,1,0,1,0
42263,443,45775,443,allow,224,164,60,3,5,2,1
53719,443,54352,443,allow,3225,1939,1286,26,139,14,12
50699,80,24288,80,allow,7292,3171,4121,19,21,11,8
49730,443,40154,443,allow,3233,1141,2092,14,135,7,7
64601,445,0,0,drop,66,66,0,1,0,1,0
2267,53,48892,53,allow,204,118,86,2,30,1,1
54650,445,0,0,drop,70,70,0,1,0,1,0
37151,80,11771,80,allow,130,70,60,2,15,1,1
56835,53,56114,53,allow,177,94,83,2,29,1,1
54087,443,2699,443,allow,2637658,83234,2554424,2794,140,929,1865
64991,53,4692,53,allow,779,86,693,2,30,1,1
21322,25174,0,0,deny,62,62,0,1,0,1,0
59984,443,19518,443,allow,1527,940,587,14,21,8,6
50734,80,62871,80,allow,3498,2696,802,9,26,5,4
59880,443,7834,443,allow,16776,7513,9263,42,47,24,18
35232,36602,0,0,deny,74,74,0,1,0,1,0
53808,443,50826,443,allow,10785,2147,8638,22,30,10,12
58638,5900,0,0,deny,62,62,0,1,0,1,0
55532,445,0,0,drop,70,70,0,1,0,1,0
58744,443,27181,443,allow,2576,1549,1027,15,15,7,8
44976,53,45616,53,allow,86,86,0,1,30,1,0
38653,21247,0,0,deny,62,62,0,1,0,1,0
7001,6881,0,0,deny,62,62,0,1,0,1,0
49418,22114,0,0,deny,66,66,0,1,0,1,0
2206,25174,0,0,deny,62,62,0,1,0,1,0
49944,80,31108,80,allow,3695,550,3145,12,15,6,6
49234,53,38404,53,allow,170,87,83,2,30,1,1
58638,5900,58638,5900,allow,62,62,0,1,5,1,0
51197,57470,0,0,deny,66,66,0,1,0,1,0
52781,57470,0,0,deny,62,62,0,1,0,1,0
54432,445,0,0,drop,70,70,0,1,0,1,0
8536,37965,0,0,deny,62,62,0,1,0,1,0
56604,17372,0,0,deny,66,66,0,1,0,1,0
17750,60780,57502,60780,allow,481,150,331,2,1200,1,1
50392,80,28117,80,allow,306,180,126,6,26,4,2
3406,17372,0,0,deny,66,66,0,1,0,1,0
57347,445,0,0,drop,66,66,0,1,0,1,0
58858,15503,0,0,deny,66,66,0,1,0,1,0
49630,443,54596,443,allow,7776,2266,5510,17,35,9,8
46295,443,39789,443,allow,178,118,60,2,15,1,1
43300,18242,0,0,allow,62,62,0,1,60,1,0
50546,80,2878,80,allow,1990,812,1178,9,15,5,4
55044,53,38715,53,allow,196,102,94,2,30,1,1
63643,445,0,0,drop,70,70,0,1,0,1,0
9102,29635,0,0,deny,148,148,0,1,0,1,0
9522,51505,0,0,deny,66,66,0,1,0,1,0
9474,443,14729,443,allow,6100,777,5323,17,26,9,8
44949,443,16538,443,allow,4093,2830,1263,21,24,11,10
60289,80,35170,80,allow,1928,906,1022,11,145,6,5
61408,30188,0,0,deny,62,62,0,1,0,1,0
52120,42751,45034,42751,allow,70,70,0,1,5,1,0
50438,445,0,0,drop,70,70,0,1,0,1,0
56112,53,63692,53,allow,199,102,97,2,29,1,1
65231,53,56850,53,allow,200,102,98,2,30,1,1
53431,445,0,0,drop,70,70,0,1,0,1,0
56613,445,0,0,deny,70,70,0,1,0,1,0
28121,443,57798,443,allow,9075,2662,6413,34,462,16,18
50965,445,0,0,drop,66,66,0,1,0,1,0
32746,50584,0,0,deny,146,146,0,1,0,1,0
58495,445,0,0,drop,70,70,0,1,0,1,0
39148,443,64587,443,allow,6818,1800,5018,30,271,16,14
15503,50321,53712,50321,allow,490,149,341,2,1200,1,1
52782,445,0,0,drop,70,70,0,1,0,1,0
26420,25174,0,0,deny,66,66,0,1,0,1,0
49812,445,0,0,drop,66,66,0,1,0,1,0
52220,445,0,0,drop,70,70,0,1,0,1,0
52965,445,0,0,drop,66,66,0,1,0,1,0
64837,53,39780,53,allow,195,102,93,2,30,1,1
55165,53,23562,53,allow,193,102,91,2,29,1,1
57470,18560,34437,18560,allow,150,150,0,1,1199,1,0
50849,80,37869,80,allow,1218354,26709,1191645,1128,133,332,796
49505,443,22158,443,allow,3182,1568,1614,8,120,4,4
29126,7000,29126,7000,allow,4124,2423,1701,20,16,11,9
56330,53,38670,53,allow,760,97,663,2,30,1,1
49558,53,59753,53,allow,186,95,91,2,30,1,1
58781,443,55654,443,allow,6133,1655,4478,12,120,5,7
43412,443,47585,443,allow,2423,1465,958,18,171,10,8
57082,53,1107,53,allow,211,102,109,2,30,1,1
55305,53,15624,53,allow,88,88,0,2,31,2,0
50322,445,0,0,drop,70,70,0,1,0,1,0
6247,51221,0,0,deny,62,62,0,1,0,1,0
5480,53,5480,53,allow,244,98,146,2,33,1,1
49182,53,13161,53,allow,199,102,97,2,30,1,1
65466,53,31281,53,allow,200,102,98,2,33,1,1
49995,53,57379,53,allow,197,102,95,2,30,1,1
54973,53,47397,53,allow,731,91,640,2,31,1,1
65239,53,58774,53,allow,199,102,97,2,29,1,1
57524,445,0,0,drop,70,70,0,1,0,1,0
49876,53,54830,53,allow,199,102,97,2,30,1,1
50784,445,0,0,drop,70,70,0,1,0,1,0
22724,9822,0,0,deny,62,62,0,1,0,1,0
45941,23386,0,0,deny,60,60,0,1,0,1,0
41472,53,41472,53,allow,218,90,128,2,30,1,1
51042,445,0,0,drop,66,66,0,1,0,1,0
52160,80,10438,80,allow,502,310,192,9,31,6,3
21750,39004,0,0,deny,66,66,0,1,0,1,0
52184,57262,18616,57262,allow,70,70,0,2,8,2,0
55972,53,10428,53,allow,186,95,91,2,30,1,1
55878,53,54979,53,allow,760,97,663,2,31,1,1
15899,37807,0,0,deny,146,146,0,1,0,1,0
3170,53567,0,0,deny,66,66,0,1,0,1,0
55915,445,0,0,drop,70,70,0,1,0,1,0
52217,22114,0,0,deny,62,62,0,1,0,1,0
56078,22,0,0,deny,60,60,0,1,0,1,0
53803,443,59546,443,allow,499,425,74,4,0,3,1
3980,63710,0,0,deny,66,66,0,1,0,1,0
58044,80,31147,80,allow,2742,1116,1626,11,20,6,5
58907,443,50091,443,allow,2976,1572,1404,17,17,9,8
65263,80,27562,80,allow,7440,4032,3408,48,629,25,23
61234,48817,0,0,deny,106,106,0,1,0,1,0
56582,23718,0,0,deny,66,66,0,1,0,1,0
64617,445,0,0,drop,70,70,0,1,0,1,0
49741,445,0,0,drop,66,66,0,1,0,1,0
58638,5900,0,0,deny,62,62,0,1,0,1,0
56965,53,30276,53,allow,182,93,89,2,31,1,1
62919,445,0,0,drop,70,70,0,1,0,1,0
64024,22114,0,0,deny,62,62,0,1,0,1,0
62802,445,0,0,drop,66,66,0,1,0,1,0
15585,64147,0,0,deny,66,66,0,1,0,1,0
57791,443,18201,443,allow,30057,13955,16102,146,556,65,81
49953,80,9395,80,allow,11209,819,10390,19,15,9,10
56561,53,19091,53,allow,216,110,106,2,30,1,1
51077,80,9544,80,allow,9133,1055,8078,17,151,8,9
60431,445,0,0,drop,70,70,0,1,0,1,0
65093,445,0,0,drop,70,70,0,1,0,1,0
53159,58710,30090,58710,allow,698,320,378,10,18,6,4
58851,443,38942,443,allow,5166,700,4466,16,15,7,9
59370,445,0,0,drop,70,70,0,1,0,1,0
60282,445,0,0,drop,70,70,0,1,0,1,0
55752,8060,62936,8060,allow,70,70,0,2,8,2,0
51938,80,6039,80,allow,82321,4061,78260,109,61,50,59
55487,53,4696,53,allow,732,89,643,2,30,1,1
63952,53,34336,53,allow,206,105,101,2,31,1,1
65171,53,52756,53,allow,194,94,100,2,29,1,1
64710,53,31226,53,allow,190,97,93,2,30,1,1
62668,445,0,0,drop,70,70,0,1,0,1,0
51872,48108,27950,48108,allow,70,70,0,1,5,1,0
59126,57470,0,0,deny,66,66,0,1,0,1,0
15959,56205,0,0,deny,66,66,0,1,0,1,0
54994,53,25626,53,allow,209,110,99,2,31,1,1
47134,37965,0,0,deny,62,62,0,1,0,1,0
60985,443,55270,443,allow,11535,4866,6669,34,50,20,14
52191,443,46265,443,allow,7882,810,7072,21,15,9,12
56701,445,0,0,drop,70,70,0,1,0,1,0
53654,445,0,0,drop,70,70,0,1,0,1,0
59704,445,0,0,drop,70,70,0,1,0,1,0
59486,445,0,0,drop,70,70,0,1,0,1,0
63934,53,27798,53,allow,347,103,244,4,46,2,2
49418,27022,63608,27022,allow,229,71,158,2,31,1,1
49567,53,36957,53,allow,184,102,82,2,29,1,1
49382,53,23594,53,allow,200,102,98,2,30,1,1
37661,443,23960,443,allow,3226,2225,1001,18,46,11,7
41631,443,38429,443,allow,20180,2917,17263,35,124,14,21
64750,53,24687,53,allow,193,102,91,2,29,1,1
37697,443,26341,443,allow,2071929,56793,2015136,2088,179,685,1403
56301,53,31707,53,allow,177,94,83,2,29,1,1
54105,80,38446,80,allow,78,78,0,1,5,1,0
41388,1433,0,0,deny,60,60,0,1,0,1,0
50985,443,12787,443,allow,8007,3336,4671,19,78,11,8
46773,80,41646,80,allow,2075,1376,699,13,83,7,6
51914,445,0,0,drop,66,66,0,1,0,1,0
55963,53,27489,53,allow,755,93,662,2,30,1,1
57782,57470,0,0,deny,66,66,0,1,0,1,0
62627,445,0,0,drop,70,70,0,1,0,1,0
51616,443,56570,443,allow,62241,4598,57643,82,170,35,47
55439,37965,0,0,deny,66,66,0,1,0,1,0
29744,53,29744,53,allow,235,90,145,2,33,1,1
50547,53,5293,53,allow,210,110,100,2,30,1,1
59254,445,0,0,drop,66,66,0,1,0,1,0
65179,445,0,0,drop,70,70,0,1,0,1,0
50014,443,7099,443,allow,5644,3210,2434,22,86,13,9
56400,35440,0,0,deny,66,66,0,1,0,1,0
56141,53,2789,53,allow,184,94,90,2,31,1,1
7797,443,7797,443,allow,1474,697,777,18,82,8,10
37672,5223,41244,5223,allow,220,220,0,3,6,3,0
54907,445,0,0,drop,70,70,0,1,0,1,0
62459,445,0,0,drop,66,66,0,1,0,1,0
64589,445,0,0,drop,70,70,0,1,0,1,0
47303,31170,0,0,deny,145,145,0,1,0,1,0
57422,53,31757,53,allow,821,102,719,2,30,1,1
42853,443,43627,443,allow,3508,2120,1388,20,241,10,10
55372,445,0,0,drop,70,70,0,1,0,1,0
49543,445,0,0,drop,66,66,0,1,0,1,0
16862,21247,0,0,deny,146,146,0,1,0,1,0
63771,445,0,0,drop,70,70,0,1,0,1,0
65312,53,52827,53,allow,182,94,88,2,30,1,1
64435,445,0,0,drop,70,70,0,1,0,1,0
49637,53,40941,53,allow,255,102,153,2,30,1,1
50293,80,34278,80,allow,134242,13446,120796,154,161,58,96
0,0,0,0,allow,244,244,0,2,0,2,0
38707,443,59526,443,allow,774099,15769,758330,743,16,223,520
64333,57470,0,0,deny,78,78,0,1,0,1,0
56063,53,52462,53,allow,196,102,94,2,30,1,1
53072,445,0,0,drop,66,66,0,1,0,1,0
55442,53,12898,53,allow,177,94,83,2,30,1,1
56285,53,7225,53,allow,751,95,656,2,31,1,1
52932,445,0,0,drop,70,70,0,1,0,1,0
48676,53395,0,0,deny,60,60,0,1,0,1,0
55218,443,17111,443,allow,17915,7421,10494,39,61,21,18
45964,2225,0,0,deny,60,60,0,1,0,1,0
44211,443,12188,443,allow,6263,1804,4459,21,361,11,10
64259,53,65307,53,allow,211,78,133,2,31,1,1
63660,445,0,0,drop,70,70,0,1,0,1,0
49571,443,40326,443,allow,12258,5621,6637,52,286,25,27
59627,443,59627,443,allow,4401,1494,2907,19,29,11,8
60646,11392,0,0,deny,66,66,0,1,0,1,0
49708,53,2580,53,allow,177,94,83,2,30,1,1
57319,445,0,0,drop,70,70,0,1,0,1,0
51671,53,51671,53,allow,200,90,110,2,30,1,1
56450,445,0,0,drop,66,66,0,1,0,1,0
55083,445,0,0,drop,70,70,0,1,0,1,0
31956,53,16501,53,allow,268,94,174,2,30,1,1
52415,443,3677,443,allow,14050,4805,9245,30,158,17,13
40238,443,22315,443,allow,7283,2384,4899,25,361,12,13
58638,5900,0,0,deny,62,62,0,1,0,1,0
30188,17677,54608,17677,allow,11116,4642,6474,64,1457,30,34
49924,80,4925,80,allow,1126,609,517,11,15,6,5
60049,445,0,0,drop,66,66,0,1,0,1,0
16524,22114,0,0,deny,62,62,0,1,0,1,0
6247,51221,0,0,deny,78,78,0,1,0,1,0
53198,443,2334,443,allow,1462,965,497,13,18,7,6
11842,23,0,0,deny,60,60,0,1,0,1,0
58483,443,25541,443,allow,3024,709,2315,13,120,6,7
64793,53,53457,53,allow,184,94,90,2,30,1,1
50910,445,0,0,drop,70,70,0,1,0,1,0
64877,37450,0,0,deny,66,66,0,1,0,1,0
55555,53,39560,53,allow,188,96,92,2,31,1,1
56288,445,0,0,drop,70,70,0,1,0,1,0
51945,1587,22122,1587,allow,70,70,0,2,8,2,0
56892,445,0,0,drop,70,70,0,1,0,1,0
11825,38338,0,0,deny,86,86,0,1,0,1,0
57202,53,47171,53,allow,184,94,90,2,30,1,1
3169,22114,0,0,deny,66,66,0,1,0,1,0
52144,49344,0,0,deny,62,62,0,1,0,1,0
51880,4000,30933,4000,allow,270,270,0,4,32,4,0
26783,443,21530,443,allow,22489,15918,6571,39,26,21,18
49285,53,46992,53,allow,94,94,0,1,30,1,0
26177,53,26177,53,allow,220,90,130,2,30,1,1
46389,27098,0,0,deny,66,66,0,1,0,1,0
64599,53,10160,53,allow,250,94,156,2,29,1,1
64582,53,25024,53,allow,202,103,99,2,30,1,1
57353,445,0,0,drop,66,66,0,1,0,1,0
443,1340,0,0,deny,85,85,0,1,0,1,0
49981,44847,0,0,deny,62,62,0,1,0,1,0
38602,80,59364,80,allow,2586,832,1754,14,16,7,7
45196,443,61474,443,allow,6357,1546,4811,26,17,14,12
29988,44847,0,0,deny,66,66,0,1,0,1,0
51693,56308,27101,56308,allow,70,70,0,1,5,1,0
64752,53,29277,53,allow,195,102,93,2,30,1,1
51487,443,12254,443,allow,828,390,438,11,60,4,7
53020,443,6371,443,allow,3183,2180,1003,16,15,8,8
55937,53,29379,53,allow,174,89,85,2,0,1,1
40204,40031,4239,40031,allow,140,78,62,2,29,1,1
58638,5900,0,0,deny,62,62,0,1,0,1,0
36562,443,34526,443,allow,3452,1535,1917,18,82,10,8
14185,48637,0,0,deny,60,60,0,1,0,1,0
49839,443,39363,443,allow,17843,13076,4767,27,134,17,10
54896,445,0,0,drop,70,70,0,1,0,1,0
52967,443,11017,443,allow,9893,2231,7662,42,113,21,21
56362,445,0,0,drop,70,70,0,1,0,1,0
37965,51498,7708,51498,allow,158,158,0,1,1199,1,0
53547,27759,47610,27759,allow,684,432,252,10,16,6,4
8313,51505,0,0,deny,66,66,0,1,0,1,0
57333,443,55597,443,allow,12837,1681,11156,30,62,16,14
19004,51505,0,0,deny,62,62,0,1,0,1,0
50095,30188,0,0,deny,62,62,0,1,0,1,0
50314,31652,0,0,allow,66,66,0,1,90,1,0
49807,445,0,0,deny,70,70,0,1,0,1,0
55067,53,40121,53,allow,178,94,84,2,30,1,1
64283,53,27743,53,allow,193,102,91,2,30,1,1
61911,3855,0,0,deny,146,146,0,1,0,1,0
54270,443,24840,443,allow,6620,672,5948,17,128,8,9
52308,80,52308,80,allow,14704,1558,13146,25,29,11,14
3478,61463,0,0,deny,491,491,0,1,0,1,0
55945,53,36008,53,allow,760,97,663,2,30,1,1
48640,47993,0,0,deny,145,145,0,1,0,1,0
61355,445,0,0,drop,70,70,0,1,0,1,0
58374,445,0,0,drop,70,70,0,1,0,1,0
22029,50584,0,0,deny,66,66,0,1,0,1,0
58638,5900,0,0,deny,62,62,0,1,0,1,0
58962,23,0,0,deny,60,60,0,1,0,1,0
49332,53,35822,53,allow,276,118,158,2,30,1,1
56081,53,45307,53,allow,237,94,143,2,29,1,1
56318,53,32737,53,allow,183,94,89,2,30,1,1
40554,53,2086,53,allow,223,78,145,2,30,1,1
59366,35440,0,0,deny,62,62,0,1,0,1,0
9404,443,30760,443,allow,5693,499,5194,14,15,7,7
16387,20045,0,0,deny,60,60,0,1,0,1,0
6881,6881,14892,6881,allow,502,150,352,2,1200,1,1
62849,62413,0,0,deny,66,66,0,1,0,1,0
46342,53,46342,53,allow,220,90,130,2,30,1,1
64000,14441,35024,14441,allow,66,66,0,2,7,2,0
50238,53,50499,53,allow,438,180,258,6,30,3,3
49588,53,53938,53,allow,733,94,639,2,29,1,1
58553,445,0,0,drop,70,70,0,1,0,1,0
50369,50584,0,0,deny,66,66,0,1,0,1,0
49949,53,12218,53,allow,193,102,91,2,29,1,1
61961,11392,0,0,deny,66,66,0,1,0,1,0
49430,443,47050,443,allow,18859,5795,13064,62,3666,28,34
54924,3478,57299,3478,allow,432,200,232,6,31,3,3
62933,445,0,0,drop,70,70,0,1,0,1,0
49616,30188,0,0,deny,66,66,0,1,0,1,0
55601,445,0,0,drop,70,70,0,1,0,1,0
55810,445,0,0,drop,66,66,0,1,0,1,0
50192,445,0,0,drop,70,70,0,1,0,1,0
53770,64147,0,0,deny,66,66,0,1,0,1,0
58612,445,0,0,drop,70,70,0,1,0,1,0
5938,49414,0,0,allow,60,60,0,1,90,1,0
10808,443,10808,443,allow,4902,861,4041,15,16,7,8
55310,53,40255,53,allow,168,78,90,2,29,1,1
16330,50584,0,0,deny,62,62,0,1,0,1,0
63529,53,63529,53,allow,217,91,126,2,30,1,1
64837,53,35241,53,allow,195,102,93,2,31,1,1
55004,80,20099,80,allow,2394,630,1764,9,16,6,3
53247,445,0,0,drop,70,70,0,1,0,1,0
40845,64147,0,0,deny,62,62,0,1,0,1,0
28221,37965,0,0,deny,62,62,0,1,0,1,0
59437,53,35841,53,allow,215,86,129,2,29,1,1
51993,25174,0,0,deny,62,62,0,1,0,1,0
49153,53,53527,53,allow,280,94,186,2,30,1,1
63097,44847,0,0,deny,62,62,0,1,0,1,0
2828,35253,0,0,deny,66,66,0,1,0,1,0
37995,49152,51662,49152,allow,156,156,0,3,8,3,0
55159,53,49513,53,allow,199,102,97,2,29,1,1
39823,36237,0,0,deny,62,62,0,1,0,1,0
60192,35440,0,0,deny,62,62,0,1,0,1,0
57602,445,0,0,drop,70,70,0,1,0,1,0
52934,26467,0,0,deny,66,66,0,1,0,1,0
57093,26467,0,0,deny,66,66,0,1,0,1,0
64641,53,5011,53,allow,260,102,158,2,30,1,1
55315,53,24638,53,allow,196,102,94,2,31,1,1
61626,443,21665,443,allow,5663,3258,2405,19,120,9,10
10022,55839,0,0,deny,145,145,0,1,0,1,0
60498,445,0,0,drop,70,70,0,1,0,1,0
57736,443,25293,443,allow,3345,823,2522,12,120,6,6
49843,80,51294,80,allow,2901,1805,1096,17,108,13,4
64281,53,45768,53,allow,214,110,104,2,31,1,1
55668,80,2182,80,allow,70,70,0,2,8,2,0
58468,57587,0,0,deny,66,66,0,1,0,1,0
50678,80,52506,80,allow,1549,1097,452,9,21,5,4
56629,25174,0,0,deny,66,66,0,1,0,1,0
58251,36237,0,0,deny,66,66,0,1,0,1,0
56587,53,37194,53,allow,184,94,90,2,30,1,1
54084,443,63980,443,allow,37440,7952,29488,67,128,28,39
63947,445,0,0,drop,70,70,0,1,0,1,0
57614,445,0,0,drop,70,70,0,1,0,1,0
62558,445,0,0,drop,66,66,0,1,0,1,0
51432,25174,0,0,deny,146,146,0,1,0,1,0
48706,23393,0,0,deny,60,60,0,1,0,1,0
50979,80,12190,80,allow,576971,8128,568843,497,38,114,383
57045,445,0,0,drop,66,66,0,1,0,1,0
55612,36239,64723,36239,allow,320,140,180,6,5,3,3
60328,80,20117,80,allow,2006,1095,911,11,61,6,5
50375,443,2479,443,allow,5419,705,4714,16,25,8,8
49937,445,0,0,drop,70,70,0,1,0,1,0
50881,50584,0,0,deny,66,66,0,1,0,1,0
49754,35440,0,0,deny,62,62,0,1,0,1,0
57641,445,0,0,drop,66,66,0,1,0,1,0
57193,53,40448,53,allow,229,110,119,2,30,1,1
57500,37965,0,0,deny,62,62,0,1,0,1,0
53872,445,0,0,drop,70,70,0,1,0,1,0
65353,53,60832,53,allow,170,87,83,2,30,1,1
51100,443,10929,443,allow,9429,1978,7451,27,46,14,13
56625,53,55820,53,allow,193,102,91,2,30,1,1
51782,10637,45950,10637,allow,66,66,0,1,5,1,0
64497,53,35440,53,allow,232,110,122,2,29,1,1
58505,445,0,0,drop,70,70,0,1,0,1,0
61268,445,0,0,drop,70,70,0,1,0,1,0
50276,445,0,0,drop,66,66,0,1,0,1,0
27507,25174,0,0,deny,62,62,0,1,0,1,0
35864,44847,0,0,deny,78,78,0,1,0,1,0
46029,80,61068,80,allow,111564,6775,104789,160,85,86,74
50031,44847,0,0,deny,74,74,0,1,0,1,0
49559,443,14886,443,allow,1332,876,456,11,56,6,5
27641,39004,0,0,deny,62,62,0,1,0,1,0
53553,53,53553,53,allow,229,98,131,2,30,1,1
35499,443,34865,443,allow,2270,1303,967,20,102,11,9
55903,53,1701,53,allow,170,87,83,2,30,1,1
56494,15503,0,0,deny,146,146,0,1,0,1,0
52745,25174,0,0,deny,66,66,0,1,0,1,0
56038,53,40412,53,allow,170,87,83,2,30,1,1
56940,53,50066,53,allow,200,102,98,2,30,1,1
55027,445,0,0,drop,70,70,0,1,0,1,0
65390,53,64921,53,allow,387,134,253,2,30,1,1
56358,53,65243,53,allow,210,110,100,2,33,1,1
55038,445,0,0,drop,70,70,0,1,0,1,0
49353,53,30816,53,allow,738,86,652,2,31,1,1
5223,11387,0,0,deny,66,66,0,1,0,1,0
50366,80,53987,80,allow,318,192,126,6,28,4,2
50828,443,49506,443,allow,6337,1378,4959,19,140,9,10
50313,80,63654,80,allow,736,670,66,6,15,5,1
49534,53,33345,53,allow,186,95,91,2,31,1,1
40633,53,51896,53,allow,168,78,90,2,30,1,1
56940,53,28824,53,allow,200,102,98,2,30,1,1
51775,57887,37993,57887,allow,66,66,0,1,5,1,0
50379,80,42640,80,allow,1083,653,430,8,16,5,3
64444,53,59792,53,allow,93,93,0,1,30,1,0
50211,53,50211,53,allow,217,90,127,2,29,1,1
34733,80,35506,80,allow,1056,682,374,10,15,6,4
17837,62609,0,0,deny,148,148,0,1,0,1,0
37965,32405,17637,32405,allow,766,248,518,4,1200,2,2
56231,53,14277,53,allow,268,94,174,2,30,1,1
56497,53,23071,53,allow,214,110,104,2,30,1,1
60027,443,20291,443,allow,8216,2269,5947,42,106,25,17
49538,53,59762,53,allow,754,94,660,2,30,1,1
63893,443,26379,443,allow,3071,804,2267,15,135,7,8
56234,445,0,0,drop,70,70,0,1,0,1,0
53889,445,0,0,drop,70,70,0,1,0,1,0
65495,53,62386,53,allow,209,110,99,2,31,1,1
65514,445,0,0,drop,70,70,0,1,0,1,0
42298,40039,40294,40039,allow,211,89,122,4,30,2,2
51443,443,42123,443,allow,322,262,60,2,15,1,1
55052,80,37545,80,allow,11677266,314362,11362904,12711,129,5174,7537
35105,443,59131,443,allow,639937,14873,625064,627,230,188,439
60680,445,0,0,drop,70,70,0,1,0,1,0
53806,443,13248,443,allow,499,425,74,4,0,3,1
53962,445,0,0,drop,70,70,0,1,0,1,0
58986,443,40709,443,allow,10624,6845,3779,50,123,25,25
443,20087,0,0,deny,83,83,0,1,0,1,0
26900,27017,18355,27017,allow,422,164,258,6,31,3,3
55357,445,0,0,drop,70,70,0,1,0,1,0
8883,443,24361,443,allow,9742,2044,7698,30,391,12,18
52052,445,0,0,drop,70,70,0,1,0,1,0
59848,445,0,0,drop,70,70,0,1,0,1,0
60752,445,0,0,drop,66,66,0,1,0,1,0
38066,443,48945,443,allow,328599,275779,52820,868,342,483,385
65469,445,0,0,drop,66,66,0,1,0,1,0
53553,2297,8843,2297,allow,70,70,0,2,7,2,0
16322,57470,0,0,deny,62,62,0,1,0,1,0
44099,443,23895,443,allow,8049289,98432,7950857,6501,125,717,5784
57397,53,11845,53,allow,183,94,89,2,29,1,1
61732,3389,61732,3389,allow,3380,1730,1650,15,33,8,7
1042,33175,0,0,deny,145,145,0,1,0,1,0
50535,51505,0,0,deny,66,66,0,1,0,1,0
56740,443,16895,443,allow,7862,1873,5989,20,15,11,9
27005,27016,26608,27016,allow,880,126,754,2,30,1,1
63876,5968,40554,5968,allow,70,70,0,1,4,1,0
55620,53,23313,53,allow,177,94,83,2,30,1,1
55641,53,38684,53,allow,184,94,90,2,30,1,1
56694,53,47429,53,allow,196,102,94,2,29,1,1
64974,445,0,0,drop,70,70,0,1,0,1,0
29742,50584,0,0,deny,146,146,0,1,0,1,0
63786,25174,0,0,deny,66,66,0,1,0,1,0
59180,445,0,0,drop,66,66,0,1,0,1,0
35120,26467,0,0,deny,62,62,0,1,0,1,0
56183,445,0,0,drop,70,70,0,1,0,1,0
27005,27018,61540,27018,allow,881,126,755,2,30,1,1
55724,45682,6518,45682,allow,70,70,0,1,5,1,0
54228,443,39518,443,allow,499,425,74,4,0,3,1
57044,53,35705,53,allow,197,102,95,2,30,1,1
27005,27015,43445,27015,allow,882,126,756,2,30,1,1
60313,445,0,0,drop,70,70,0,1,0,1,0
53328,445,0,0,drop,66,66,0,1,0,1,0
54535,80,13360,80,allow,4162,3455,707,14,15,8,6
62886,993,19324,993,allow,9557,4773,4784,84,199,48,36
9471,443,58396,443,allow,8533,1544,6989,22,30,11,11
55836,53,17348,53,allow,177,94,83,2,30,1,1
65371,53,53875,53,allow,356,101,255,4,55,2,2
26249,7000,26249,7000,allow,2269,815,1454,14,16,7,7
52325,443,52325,443,allow,17806,3169,14637,41,86,18,23
56616,445,0,0,drop,70,70,0,1,0,1,0
49911,445,0,0,drop,66,66,0,1,0,1,0
64619,53,62516,53,allow,229,94,135,2,30,1,1
53624,53,53624,53,allow,832,106,726,2,29,1,1
64289,53,24247,53,allow,198,101,97,2,30,1,1
58638,5900,0,0,deny,62,62,0,1,0,1,0
55067,443,5248,443,allow,17968,12031,5937,38,63,21,17
52065,80,16889,80,allow,81670,2359,79311,89,621,30,59
64967,27051,5112,27051,allow,1020,462,558,4,29,2,2
52086,80,55343,80,allow,2703,632,2071,12,22,7,5
23021,25174,0,0,deny,66,66,0,1,0,1,0
58906,445,0,0,drop,70,70,0,1,0,1,0
63566,445,0,0,drop,66,66,0,1,0,1,0
60426,57470,0,0,deny,62,62,0,1,0,1,0
59878,443,30562,443,allow,3864,2812,1052,17,112,8,9
50096,445,0,0,drop,70,70,0,1,0,1,0
15955,48817,0,0,deny,140,140,0,1,0,1,0
54071,50265,0,0,deny,66,66,0,1,0,1,0
56275,53,46209,53,allow,166,86,80,2,30,1,1
57353,443,37638,443,allow,150,150,0,1,5,1,0
57548,445,0,0,drop,70,70,0,1,0,1,0
443,38956,0,0,deny,82,82,0,1,0,1,0
51397,445,0,0,drop,66,66,0,1,0,1,0
63878,22114,0,0,deny,62,62,0,1,0,1,0
55366,53,65278,53,allow,79,79,0,2,35,2,0
54215,443,45620,443,allow,499,425,74,4,0,3,1
49967,53,41633,53,allow,186,95,91,2,31,1,1
65356,53,49410,53,allow,199,102,97,2,30,1,1
64666,53,52653,53,allow,226,102,124,2,30,1,1
26566,44847,0,0,deny,66,66,0,1,0,1,0
57335,443,56068,443,allow,56199,3856,52343,81,216,39,42
65176,53,60246,53,allow,299,103,196,4,53,2,2
57122,53,5518,53,allow,295,101,194,4,31,2,2
58638,5900,0,0,deny,62,62,0,1,0,1,0
60400,80,41884,80,allow,1704,808,896,10,122,6,4
61907,445,0,0,drop,70,70,0,1,0,1,0
56822,53,57328,53,allow,184,94,90,2,29,1,1
63804,52520,33916,52520,allow,66,66,0,2,8,2,0
49206,443,56721,443,allow,7875,1817,6058,41,255,19,22
50556,80,38454,80,allow,378,192,186,7,26,4,3
60452,62582,62916,62582,allow,70,70,0,1,5,1,0
0,0,0,0,deny,98,98,0,1,0,1,0
49296,443,49940,443,allow,20862040,250452,20611588,16880,170,1832,15048
50316,25604,0,0,deny,66,66,0,1,0,1,0
63991,80,39490,80,allow,314,192,122,6,15,4,2
59805,443,46522,443,allow,2334,1113,1221,19,27,9,10
55903,53,28482,53,allow,177,94,83,2,30,1,1
56314,53,18925,53,allow,733,86,647,2,31,1,1
42345,443,8962,443,allow,7593,2146,5447,21,10,12,9
35718,20238,0,0,deny,62,62,0,1,0,1,0
44411,37965,0,0,deny,62,62,0,1,0,1,0
54473,37807,0,0,deny,66,66,0,1,0,1,0
24351,57470,0,0,deny,62,62,0,1,0,1,0
53053,64147,0,0,deny,66,66,0,1,0,1,0
65039,53,3857,53,allow,302,102,200,2,30,1,1
62653,445,0,0,drop,66,66,0,1,0,1,0
53176,445,0,0,drop,70,70,0,1,0,1,0
60796,53,60796,53,allow,248,106,142,2,30,1,1
59835,443,54646,443,allow,13306,9499,3807,32,23,17,15
38941,443,53715,443,allow,4613,2811,1802,27,95,14,13
57784,445,0,0,drop,66,66,0,1,0,1,0
56066,53,20182,53,allow,212,110,102,2,30,1,1
61703,445,0,0,drop,66,66,0,1,0,1,0
64534,53,35373,53,allow,214,110,104,2,30,1,1
50995,445,0,0,drop,66,66,0,1,0,1,0
52072,445,0,0,drop,70,70,0,1,0,1,0
53114,445,0,0,drop,66,66,0,1,0,1,0
56514,445,0,0,drop,70,70,0,1,0,1,0
54992,53,3265,53,allow,195,102,93,2,30,1,1
64747,53,39095,53,allow,216,94,122,2,29,1,1
65228,53,0,0,deny,88,88,0,1,0,1,0
56840,20413,10874,20413,allow,70,70,0,2,8,2,0
52064,43273,5722,43273,allow,70,70,0,2,7,2,0
65385,53,41370,53,allow,259,110,149,2,30,1,1
61430,37965,0,0,deny,66,66,0,1,0,1,0
5588,5588,0,0,allow,3354,1792,1562,46,193,23,23
55067,53,8321,53,allow,172,88,84,2,30,1,1
55056,44512,0,0,deny,62,62,0,1,0,1,0
49365,445,0,0,drop,70,70,0,1,0,1,0
61406,445,0,0,drop,70,70,0,1,0,1,0
58638,5900,0,0,deny,62,62,0,1,0,1,0
52177,21079,54277,21079,allow,316,136,180,6,5,3,3
2077,7000,2077,7000,allow,3054,1599,1455,16,15,8,8
53860,445,0,0,drop,70,70,0,1,0,1,0
60407,8106,10620,8106,allow,2541,1158,1383,19,16,9,10
65028,53,13338,53,allow,763,102,661,2,30,1,1
65412,53,28937,53,allow,782,105,677,2,31,1,1
56250,36237,0,0,deny,66,66,0,1,0,1,0
50274,445,0,0,drop,66,66,0,1,0,1,0
27010,64147,0,0,deny,62,62,0,1,0,1,0
54455,445,0,0,drop,70,70,0,1,0,1,0
50361,80,40866,80,allow,318,192,126,6,28,4,2
43886,5223,33165,5223,allow,3721,1173,2548,18,257,11,7
65412,53,14297,53,allow,305,118,187,2,30,1,1
64539,53,23141,53,allow,712,214,498,6,44,3,3
60278,445,0,0,drop,70,70,0,1,0,1,0
65103,445,0,0,drop,70,70,0,1,0,1,0
37555,16385,34137,16385,allow,130,70,60,2,30,1,1
58799,30188,0,0,deny,66,66,0,1,0,1,0
60382,445,0,0,drop,70,70,0,1,0,1,0
55216,443,23383,443,allow,8058,5498,2560,20,120,11,9
49788,1433,0,0,deny,60,60,0,1,0,1,0
53136,41442,29017,41442,allow,70,70,0,2,8,2,0
37918,443,25153,443,allow,6123,860,5263,18,361,9,9
55216,53,59483,53,allow,711,87,624,2,30,1,1
61147,445,0,0,drop,70,70,0,1,0,1,0
39666,443,38106,443,allow,7522,2433,5089,16,120,8,8
15333,44847,0,0,deny,146,146,0,1,0,1,0
49221,36069,51500,36069,allow,1941,1009,932,10,16,6,4
44538,50584,0,0,deny,62,62,0,1,0,1,0
51712,443,2406,443,allow,66148,6145,60003,116,80,60,56
55261,445,0,0,drop,70,70,0,1,0,1,0
49622,53,47185,53,allow,185,102,83,2,30,1,1
58809,445,0,0,deny,66,66,0,1,0,1,0
49850,445,0,0,drop,70,70,0,1,0,1,0
60948,445,0,0,drop,66,66,0,1,0,1,0
60575,443,23365,443,allow,5994,1594,4400,23,42,12,11
49972,53,6023,53,allow,314,94,220,4,31,2,2
52704,53,49844,53,allow,168,78,90,2,30,1,1
63271,52752,0,0,deny,78,78,0,1,0,1,0
55963,445,0,0,drop,66,66,0,1,0,1,0
48857,53,48857,53,allow,213,82,131,2,30,1,1
56760,53,34251,53,allow,216,102,114,2,30,1,1
58331,443,26953,443,allow,31515,26798,4717,91,82,49,42
57590,80,57590,80,allow,1165239,13055,1152184,977,149,193,784
61192,445,0,0,drop,70,70,0,1,0,1,0
19933,35440,0,0,deny,62,62,0,1,0,1,0
52405,445,0,0,drop,70,70,0,1,0,1,0
49730,445,0,0,drop,70,70,0,1,0,1,0
49267,53,55057,53,allow,209,94,115,2,30,1,1
32927,443,11670,443,allow,5746,1079,4667,17,27,10,7
1264,26296,0,0,deny,143,143,0,1,0,1,0
22300,51505,0,0,deny,66,66,0,1,0,1,0
64609,53,19942,53,allow,168,86,82,2,30,1,1
53608,1024,20573,1024,allow,70,70,0,1,5,1,0
22352,443,22352,443,allow,6899,3403,3496,27,76,16,11
55087,53,26632,53,allow,183,94,89,2,30,1,1
54972,445,0,0,drop,70,70,0,1,0,1,0
28999,37807,0,0,deny,62,62,0,1,0,1,0
60970,20541,0,0,deny,66,66,0,1,0,1,0
28878,51505,0,0,deny,62,62,0,1,0,1,0
53862,443,35996,443,allow,499,425,74,4,1,3,1
56516,445,0,0,drop,70,70,0,1,0,1,0
56152,56205,0,0,deny,62,62,0,1,0,1,0
51703,3010,58034,3010,allow,70,70,0,1,5,1,0
42298,40029,57945,40029,allow,652,83,569,4,31,2,2
51584,445,0,0,drop,70,70,0,1,0,1,0
51922,445,0,0,drop,70,70,0,1,0,1,0
56512,445,0,0,drop,66,66,0,1,0,1,0
50720,443,25123,443,allow,6336,1377,4959,19,169,9,10
52317,5223,5494,5223,allow,6070,1779,4291,17,3600,8,9
56017,445,0,0,drop,66,66,0,1,0,1,0
54236,36829,0,0,deny,66,66,0,1,0,1,0
62047,445,0,0,drop,66,66,0,1,0,1,0
61694,443,25571,443,allow,8696,3245,5451,36,47,16,20
58610,53,58610,53,allow,244,98,146,2,32,1,1
60724,445,0,0,drop,70,70,0,1,0,1,0
39569,443,64666,443,allow,125906,21096,104810,172,130,68,104
42722,56448,0,0,deny,74,74,0,1,0,1,0
27785,37965,0,0,deny,66,66,0,1,0,1,0
61094,445,0,0,drop,70,70,0,1,0,1,0
61550,5529,0,0,deny,145,145,0,1,0,1,0
51114,25174,0,0,deny,66,66,0,1,0,1,0
36435,443,62505,443,allow,7046,3518,3528,66,612,35,31
51848,445,0,0,drop,66,66,0,1,0,1,0
64681,53,5691,53,allow,86,86,0,1,60,1,0
51414,443,43551,443,allow,78740,40216,38524,126,42,66,60
50462,80,37104,80,allow,113965,10014,103951,154,204,65,89
60441,445,0,0,drop,70,70,0,1,0,1,0
49569,53,48621,53,allow,91,91,0,2,37,2,0
41322,443,6156,443,allow,994089,30018,964071,1058,350,373,685
53859,34334,7486,34334,allow,492,306,186,8,14,5,3
51183,56205,0,0,deny,62,62,0,1,0,1,0
55759,445,0,0,drop,70,70,0,1,0,1,0
58863,443,23250,443,allow,3873,2469,1404,17,16,9,8
53607,51631,46867,51631,allow,70,70,0,1,4,1,0
53971,50265,0,0,deny,66,66,0,1,0,1,0
57470,31114,57905,31114,allow,528,528,0,9,1199,9,0
63847,445,0,0,drop,70,70,0,1,0,1,0
57999,80,9823,80,allow,5434,3724,1710,26,76,14,12
4956,53,4956,53,allow,203,82,121,2,30,1,1
50422,443,13716,443,allow,1389,868,521,12,25,6,6
60514,80,54084,80,allow,1641,944,697,9,15,5,4
40465,443,49132,443,allow,1053,566,487,10,47,6,4
54790,1433,0,0,deny,60,60,0,1,0,1,0
52716,445,0,0,drop,70,70,0,1,0,1,0
7377,57470,0,0,deny,62,62,0,1,0,1,0
57007,53,38539,53,allow,183,94,89,2,30,1,1
22300,51505,0,0,deny,62,62,0,1,0,1,0
58267,443,58267,443,allow,4674,1767,2907,19,26,11,8
1040,6004,0,0,deny,72,72,0,1,0,1,0
55467,445,0,0,drop,70,70,0,1,0,1,0
64347,445,0,0,drop,66,66,0,1,0,1,0
51026,37450,0,0,deny,66,66,0,1,0,1,0
38761,123,12089,123,allow,184,94,90,2,30,1,1
55450,53,40253,53,allow,213,102,111,2,30,1,1
51349,80,65226,80,allow,1056,682,374,10,15,6,4
59696,57470,0,0,deny,62,62,0,1,0,1,0
49604,53,54196,53,allow,179,94,85,2,29,1,1
62079,30188,0,0,deny,66,66,0,1,0,1,0
63595,51050,0,0,deny,66,66,0,1,0,1,0
63089,53,1694,53,allow,512,166,346,2,30,1,1
49336,25174,0,0,deny,66,66,0,1,0,1,0
39802,443,46895,443,allow,2863801,103667,2760134,3193,182,1240,1953
64095,1976,59706,1976,allow,70,70,0,1,5,1,0
46069,80,2181,80,allow,2684,2550,134,7,17,5,2
46414,80,41611,80,allow,1155,781,374,10,15,6,4
32983,51221,0,0,deny,66,66,0,1,0,1,0
24985,443,23171,443,allow,2227,1018,1209,17,15,8,9
56704,53,2427,53,allow,318,94,224,2,30,1,1
51877,13472,10032,13472,allow,70,70,0,2,8,2,0
49662,80,35388,80,allow,6753,3135,3618,17,41,8,9
49693,53,17140,53,allow,196,94,102,2,30,1,1
58638,5900,0,0,deny,62,62,0,1,0,1,0
61862,80,50297,80,allow,9747,537,9210,14,16,6,8
51295,443,27138,443,allow,7448,1737,5711,24,201,13,11
59584,36237,0,0,deny,66,66,0,1,0,1,0
46409,80,19897,80,allow,4674,767,3907,17,15,9,8
57874,26467,0,0,deny,62,62,0,1,0,1,0
55902,53,57612,53,allow,181,94,87,2,30,1,1
56783,53,44308,53,allow,193,102,91,2,30,1,1
59761,53,13611,53,allow,569,164,405,2,31,1,1
59865,443,51225,443,allow,502,250,252,9,26,5,4
53590,8999,22601,8999,allow,1207,605,602,10,25,5,5
6338,23117,0,0,deny,66,66,0,1,0,1,0
52315,445,0,0,drop,70,70,0,1,0,1,0
54517,443,8632,443,allow,11460,2522,8938,19,122,9,10
55440,53,55440,53,allow,220,90,130,2,30,1,1
62387,80,62387,80,allow,548903,4452,544451,440,20,58,382
55897,445,0,0,drop,70,70,0,1,0,1,0
53472,17,0,0,deny,60,60,0,1,0,1,0
57698,64147,0,0,deny,62,62,0,1,0,1,0
50097,445,0,0,drop,70,70,0,1,0,1,0
56440,56205,0,0,deny,62,62,0,1,0,1,0
57146,53,31700,53,allow,198,101,97,2,31,1,1
62742,445,0,0,drop,66,66,0,1,0,1,0
64090,53,12119,53,allow,227,102,125,2,30,1,1
59974,443,8585,443,allow,7820,1344,6476,24,16,13,11
17378,44847,0,0,deny,62,62,0,1,0,1,0
52016,58318,42027,58318,allow,66,66,0,1,5,1,0
57180,53,28550,53,allow,305,86,219,2,31,1,1
58006,443,30394,443,allow,9596,1688,7908,26,255,13,13
9521,443,4635,443,allow,7231,1442,5789,21,30,10,11
16387,41860,0,0,deny,60,60,0,1,0,1,0
58039,161,0,0,allow,11672,5710,5962,60,29,30,30
60400,443,24179,443,allow,7073,1556,5517,21,80,11,10
56934,80,1586,80,allow,486,280,206,8,26,5,3
52013,35185,29346,35185,allow,66,66,0,1,5,1,0
45941,23386,0,0,deny,60,60,0,1,0,1,0
51706,25174,0,0,deny,66,66,0,1,0,1,0
32012,500,63361,500,allow,879,462,417,2,600,1,1
53212,443,49183,443,allow,4681,2403,2278,19,135,10,9
57965,445,0,0,drop,70,70,0,1,0,1,0
58774,445,0,0,drop,70,70,0,1,0,1,0
55123,445,0,0,drop,70,70,0,1,0,1,0
63954,60430,37652,60430,allow,70,70,0,1,4,1,0
64053,53,26364,53,allow,193,102,91,2,30,1,1
50017,445,0,0,drop,70,70,0,1,0,1,0
60946,443,58938,443,allow,1373,712,661,14,18,8,6
50439,80,32782,80,allow,318,192,126,6,26,4,2
61096,445,0,0,drop,66,66,0,1,0,1,0
63467,37807,0,0,deny,62,62,0,1,0,1,0
27005,1301,24545,1301,allow,860,126,734,2,30,1,1
42298,40006,18530,40006,allow,243,180,63,2,31,1,1
56733,53,47115,53,allow,187,98,89,3,52,2,1
51809,443,51809,443,allow,1466,856,610,13,27,6,7
54280,3398,0,0,deny,60,60,0,1,0,1,0
14260,36829,0,0,deny,62,62,0,1,0,1,0
57393,445,0,0,drop,70,70,0,1,0,1,0
51837,445,0,0,drop,70,70,0,1,0,1,0
64592,53,28124,53,allow,197,94,103,2,30,1,1
58541,445,0,0,drop,70,70,0,1,0,1,0
44861,443,26247,443,allow,1053,566,487,10,47,6,4
60628,445,0,0,drop,70,70,0,1,0,1,0
59292,445,0,0,drop,70,70,0,1,0,1,0
45630,443,4110,443,allow,2996,1629,1367,17,21,9,8
49821,53,3854,53,allow,265,94,171,2,30,1,1
64068,53,56393,53,allow,168,86,82,2,31,1,1
18624,29434,0,0,deny,148,148,0,1,0,1,0
53165,18504,40263,18504,allow,444,192,252,8,17,4,4
62119,445,0,0,drop,70,70,0,1,0,1,0
55354,53,24160,53,allow,168,94,74,2,30,1,1
58638,5900,0,0,deny,62,62,0,1,0,1,0
61686,80,38395,80,allow,4004,1513,2491,20,47,10,10
56367,44847,0,0,deny,66,66,0,1,0,1,0
25772,7302,0,0,deny,66,66,0,1,0,1,0
50581,53,15550,53,allow,185,102,83,2,30,1,1
32961,80,43846,80,allow,480,258,222,8,12,5,3
26053,33720,0,0,deny,160,160,0,1,0,1,0
51434,443,45613,443,allow,12291742,358717,11933025,12485,181,3846,8639
63466,443,61707,443,allow,5828,1439,4389,16,75,9,7
37965,8272,8707,8272,allow,1577,594,983,20,1740,10,10
61979,445,0,0,drop,66,66,0,1,0,1,0
52025,42442,23036,42442,allow,70,70,0,2,7,2,0
46772,80,10171,80,allow,2068,1371,697,13,83,7,6
64022,60918,60664,60918,allow,70,70,0,1,4,1,0
39661,7275,31233,7275,allow,8822,1485,7337,26,15,13,13
56615,443,28312,443,allow,4425,2899,1526,24,34,14,10
65000,445,0,0,drop,66,66,0,1,0,1,0
51148,9571,0,0,deny,66,66,0,1,0,1,0
35347,20238,0,0,deny,66,66,0,1,0,1,0
60374,57470,0,0,deny,145,145,0,1,0,1,0
51580,80,9107,80,allow,1752,786,966,16,17,9,7
49993,37965,0,0,deny,66,66,0,1,0,1,0
50193,443,31534,443,allow,2404,1121,1283,14,115,7,7
50972,3544,63114,3544,allow,409,107,302,4,30,2,2
443,64347,0,0,deny,131,131,0,1,0,1,0
40022,443,32042,443,allow,6073,1628,4445,23,15,12,11
56413,51221,0,0,deny,62,62,0,1,0,1,0
65109,53,42813,53,allow,229,102,127,2,30,1,1
55159,53,29512,53,allow,200,102,98,2,30,1,1
13518,25174,0,0,deny,146,146,0,1,0,1,0
63927,50265,0,0,deny,62,62,0,1,0,1,0
31281,57470,0,0,deny,145,145,0,1,0,1,0
51446,445,0,0,drop,66,66,0,1,0,1,0
55694,53,60951,53,allow,167,86,81,2,30,1,1
45964,2225,0,0,deny,60,60,0,1,0,1,0
54078,445,0,0,drop,66,66,0,1,0,1,0
50837,445,0,0,drop,70,70,0,1,0,1,0
49238,8080,49238,8080,allow,378,180,198,7,53,4,3
49897,443,33898,443,allow,8586,1352,7234,27,34,13,14
64779,53,1103,53,allow,810,108,702,2,30,1,1
63043,445,0,0,drop,70,70,0,1,0,1,0
55005,443,32809,443,allow,134,60,74,3,11,2,1
47063,15503,0,0,deny,146,146,0,1,0,1,0
55580,45817,63033,45817,allow,70,70,0,1,5,1,0
55865,53,59326,53,allow,196,102,94,2,29,1,1
55697,445,0,0,drop,70,70,0,1,0,1,0
27018,61508,0,0,deny,753,753,0,1,0,1,0
39032,443,17584,443,allow,5819,1571,4248,26,58,14,12
63129,47117,14419,47117,allow,574,448,126,10,25,8,2
53813,11392,0,0,deny,62,62,0,1,0,1,0
65078,53,19268,53,allow,177,94,83,2,30,1,1
56624,80,12583,80,allow,234,234,0,4,12,4,0
50611,443,62610,443,allow,11152,2086,9066,33,93,17,16
56615,53,39007,53,allow,177,94,83,2,29,1,1
65257,443,11599,443,allow,4019,708,3311,16,137,7,9
64949,53,27237,53,allow,744,89,655,2,30,1,1
59952,53,59952,53,allow,215,80,135,2,32,1,1
49410,53,59985,53,allow,324,87,237,4,55,2,2
53156,35993,0,0,deny,66,66,0,1,0,1,0
55687,53,12551,53,allow,193,102,91,2,29,1,1
53711,30355,27778,30355,allow,320,140,180,6,5,3,3
26900,27017,9336,27017,allow,422,164,258,6,30,3,3
55221,443,65521,443,allow,10435,2860,7575,27,46,15,12
64958,53,26216,53,allow,194,99,95,2,31,1,1
52237,16801,36529,16801,allow,70,70,0,2,4,2,0
62401,445,0,0,drop,70,70,0,1,0,1,0
60688,445,0,0,drop,70,70,0,1,0,1,0
64567,53,64760,53,allow,193,102,91,2,30,1,1
51877,445,0,0,drop,70,70,0,1,0,1,0
64284,53,55514,53,allow,229,110,119,2,30,1,1
59826,445,0,0,drop,66,66,0,1,0,1,0
50576,80,50576,80,allow,24419,8463,15956,49,19,25,24
28549,53,28549,53,allow,194,87,107,2,30,1,1
52240,52893,59916,52893,allow,70,70,0,2,6,2,0
59347,57470,0,0,deny,62,62,0,1,0,1,0
63104,445,0,0,drop,70,70,0,1,0,1,0
11295,40002,55023,40002,allow,209,85,124,4,54,2,2
58585,445,0,0,drop,70,70,0,1,0,1,0
44922,57470,0,0,deny,74,74,0,1,0,1,0
64588,53,18701,53,allow,211,102,109,2,30,1,1
49792,445,0,0,drop,70,70,0,1,0,1,0
51709,53,0,0,allow,201,94,107,2,29,1,1
53230,445,0,0,drop,70,70,0,1,0,1,0
60777,443,22998,443,allow,10417,2617,7800,32,15,17,15
54192,445,0,0,drop,70,70,0,1,0,1,0
56363,443,4827,443,allow,4864,3011,1853,20,234,12,8
56670,445,0,0,drop,66,66,0,1,0,1,0
49486,7000,49486,7000,allow,3370,1595,1775,16,15,9,7
64357,445,0,0,drop,66,66,0,1,0,1,0
13285,29892,0,0,deny,145,145,0,1,0,1,0
63463,443,46376,443,allow,3182,1568,1614,8,120,4,4
59574,443,1442,443,allow,2582500,86854,2495646,2678,84,986,1692
65152,53,43515,53,allow,170,87,83,2,30,1,1
53243,57470,0,0,deny,74,74,0,1,0,1,0
30960,45722,27416,45722,allow,396,396,0,7,3616,7,0
28579,64147,0,0,deny,62,62,0,1,0,1,0
51226,7275,28428,7275,allow,416,210,206,7,16,4,3
58638,5900,0,0,deny,62,62,0,1,0,1,0
60754,445,0,0,drop,70,70,0,1,0,1,0
49418,32058,6170,32058,allow,78,78,0,1,30,1,0
6881,37965,0,0,deny,146,146,0,1,0,1,0
35543,443,52290,443,allow,7298,2601,4697,21,26,10,11
64902,53,51695,53,allow,414,106,308,2,30,1,1
49188,53,21489,53,allow,777,87,690,2,31,1,1
64322,53,60744,53,allow,273,90,183,4,33,2,2
49268,443,60948,443,allow,77368,9874,67494,139,100,65,74
51757,54657,24157,54657,allow,66,66,0,1,5,1,0
50408,53,64657,53,allow,755,94,661,2,31,1,1
49759,53,54195,53,allow,164,84,80,2,31,1,1
49764,443,46462,443,allow,114197,7285,106912,177,77,85,92
65184,53,54868,53,allow,164,84,80,2,31,1,1
9483,80,46807,80,allow,1579,421,1158,9,15,4,5
53572,22754,17581,22754,allow,70,70,0,1,5,1,0
49444,53,27495,53,allow,199,94,105,2,30,1,1
51067,445,0,0,drop,70,70,0,1,0,1,0
55624,80,56586,80,allow,70,70,0,1,5,1,0
53417,443,8874,443,allow,9193,6294,2899,27,121,14,13
63024,445,0,0,drop,70,70,0,1,0,1,0
55273,53,29396,53,allow,167,86,81,2,30,1,1
33165,443,61975,443,allow,7442,1260,6182,19,15,10,9
16387,34137,0,0,deny,60,60,0,1,0,1,0
53229,445,0,0,drop,70,70,0,1,0,1,0
53915,1026,61852,1026,allow,70,70,0,1,5,1,0
61345,21247,0,0,deny,66,66,0,1,0,1,0
62479,443,46621,443,allow,14673,3914,10759,31,27,14,17
44913,443,18458,443,allow,414,140,274,7,27,3,4
50424,55777,0,0,deny,62,62,0,1,0,1,0
49853,53,48467,53,allow,811,94,717,2,30,1,1
41653,21247,0,0,deny,62,62,0,1,0,1,0
38911,443,33015,443,allow,13187,2075,11112,35,420,11,24
56424,53,21857,53,allow,177,94,83,2,30,1,1
49628,443,15510,443,allow,5600,1187,4413,24,80,13,11
54932,443,37338,443,allow,84306,6712,77594,156,236,58,98
58634,445,0,0,drop,70,70,0,1,0,1,0
50971,44847,0,0,deny,62,62,0,1,0,1,0
55056,56205,0,0,deny,66,66,0,1,0,1,0
52244,58774,22208,58774,allow,70,70,0,2,6,2,0
55622,33342,63556,33342,allow,70,70,0,2,8,2,0
56052,53,55355,53,allow,1392,85,1307,4,12,2,2
54559,445,0,0,drop,70,70,0,1,0,1,0
50591,445,0,0,drop,70,70,0,1,0,1,0
58638,5900,0,0,deny,62,62,0,1,0,1,0
50241,443,61373,443,allow,27900,6291,21609,46,515,23,23
15113,25174,0,0,deny,146,146,0,1,0,1,0
64828,53,62244,53,allow,260,102,158,2,30,1,1
55504,53,20782,53,allow,199,94,105,2,30,1,1
58671,445,0,0,drop,70,70,0,1,0,1,0
57162,445,0,0,drop,70,70,0,1,0,1,0
50051,445,0,0,drop,70,70,0,1,0,1,0
64560,53,36010,53,allow,184,94,90,2,29,1,1
49418,27015,2773,27015,allow,243,78,165,2,30,1,1
54073,443,61123,443,allow,90387,4941,85446,123,170,54,69
52327,443,52327,443,allow,5444,2263,3181,23,86,12,11
60331,445,0,0,drop,70,70,0,1,0,1,0
46734,50265,0,0,deny,74,74,0,1,0,1,0
38664,443,9528,443,allow,6887,1076,5811,22,50,12,10
52785,443,33714,443,allow,5806,1059,4747,16,63,8,8
48186,443,28155,443,allow,1947,688,1259,18,82,8,10
36535,443,34984,443,allow,3319,2176,1143,21,15,11,10
51505,17372,0,0,deny,66,66,0,1,0,1,0
53197,443,58160,443,allow,1462,965,497,13,18,7,6
55311,44847,0,0,deny,66,66,0,1,0,1,0
49418,27018,3626,27018,allow,71,71,0,1,30,1,0
55158,53,38311,53,allow,212,102,110,2,30,1,1
64124,53,35184,53,allow,183,94,89,2,30,1,1
53587,32029,40143,32029,allow,70,70,0,1,5,1,0
50391,8080,50391,8080,allow,1614,785,829,11,54,6,5
6881,9074,0,0,deny,143,143,0,1,0,1,0
55372,53,36344,53,allow,199,102,97,2,30,1,1
3478,61463,0,0,deny,1103,1103,0,1,0,1,0
36513,443,42006,443,allow,4216,2615,1601,26,80,13,13
63641,445,0,0,drop,66,66,0,1,0,1,0
50052,65010,0,0,deny,60,60,0,1,0,1,0
65239,445,0,0,drop,70,70,0,1,0,1,0
64500,53,31734,53,allow,212,102,110,2,30,1,1
35440,443,40080,443,allow,7419,2136,5283,23,255,11,12
58282,445,0,0,drop,66,66,0,1,0,1,0
49292,53,63112,53,allow,323,94,229,2,31,1,1
50265,26512,31440,26512,allow,480,149,331,2,1200,1,1
64997,53,32660,53,allow,771,102,669,2,29,1,1
52277,80,52277,80,allow,259496,6676,252820,249,28,74,175
51498,443,60787,443,allow,7211,823,6388,16,15,10,6
59820,445,0,0,drop,70,70,0,1,0,1,0
52679,445,0,0,drop,70,70,0,1,0,1,0
49630,53,20567,53,allow,374,126,248,2,30,1,1
38160,443,10215,443,allow,8185,2274,5911,18,135,8,10
60867,443,29499,443,allow,3072,2174,898,14,317,8,6
53145,44634,28253,44634,allow,70,70,0,2,8,2,0
54438,443,22711,443,allow,8198,1975,6223,24,361,11,13
16057,56205,0,0,deny,62,62,0,1,0,1,0
54269,443,49860,443,allow,5768,3426,2342,22,135,11,11
60513,445,0,0,drop,70,70,0,1,0,1,0
53877,445,0,0,drop,66,66,0,1,0,1,0
39915,443,44120,443,allow,6922156,117604,6804552,6122,50,1519,4603
44290,53,27070,53,allow,240,76,164,2,31,1,1
56369,53,50667,53,allow,168,86,82,2,29,1,1
58638,5900,0,0,deny,62,62,0,1,0,1,0
63976,443,11736,443,allow,1270998,514773,756225,3073,2384,1413,1660
49173,53,47440,53,allow,234,94,140,2,30,1,1
63058,443,54083,443,allow,304,86,218,2,30,1,1
48817,51413,48817,51413,allow,479,152,327,2,1200,1,1
52925,53,48232,53,allow,168,78,90,2,29,1,1
40408,1488,40408,1488,allow,156,156,0,3,8,3,0
65174,53,23443,53,allow,214,110,104,2,30,1,1
56968,53,34326,53,allow,762,97,665,2,30,1,1
55874,445,0,0,drop,70,70,0,1,0,1,0
49778,53,5798,53,allow,319,98,221,4,53,2,2
55074,443,36824,443,allow,3143,2172,971,19,25,9,10
37666,48817,0,0,deny,146,146,0,1,0,1,0
49874,443,49241,443,allow,15358,8278,7080,47,19,24,23
25108,53,24919,53,allow,222,78,144,2,30,1,1
52929,443,62112,443,allow,5582,1388,4194,19,15,9,10
64806,53,2007,53,allow,273,94,179,2,30,1,1
9233,443,25219,443,allow,5955,728,5227,17,15,8,9
56244,80,56244,80,allow,101473,1494,99979,91,15,21,70
49352,445,0,0,drop,70,70,0,1,0,1,0
60806,51050,0,0,deny,66,66,0,1,0,1,0
60408,55557,44331,55557,allow,70,70,0,2,8,2,0
44564,22,44564,22,allow,5130,2103,3027,28,21,16,12
49359,53,18321,53,allow,216,110,106,2,30,1,1
55566,53,37015,53,allow,740,93,647,2,30,1,1
42810,443,64537,443,allow,9265,2134,7131,24,123,12,12
55385,445,0,0,drop,70,70,0,1,0,1,0
53793,20468,60935,20468,allow,70,70,0,2,8,2,0
49355,53,45330,53,allow,184,102,82,2,30,1,1
50629,53,6662,53,allow,756,94,662,2,30,1,1
54497,445,0,0,drop,70,70,0,1,0,1,0
39500,443,7473,443,allow,6517,2048,4469,21,90,12,9
57252,53,53751,53,allow,183,94,89,2,30,1,1
37912,443,38909,443,allow,2738,1475,1263,19,275,10,9
49846,80,38683,80,allow,3215,2272,943,15,38,9,6
45020,443,16879,443,allow,2293,1592,701,16,21,8,8
60238,445,0,0,drop,70,70,0,1,0,1,0
58056,443,24409,443,allow,6821,1076,5745,21,38,12,9
56337,53,25650,53,allow,268,89,179,4,45,2,2
65513,53,49907,53,allow,186,102,84,2,30,1,1
53756,50584,0,0,deny,62,62,0,1,0,1,0
51216,443,25956,443,allow,4540,1056,3484,19,17,11,8
64811,445,0,0,drop,66,66,0,1,0,1,0
49353,53,9997,53,allow,237,94,143,2,30,1,1
49428,445,0,0,drop,70,70,0,1,0,1,0
56129,445,0,0,drop,70,70,0,1,0,1,0
49253,53,58276,53,allow,199,102,97,2,30,1,1
1024,22114,0,0,deny,146,146,0,1,0,1,0
65253,53,8346,53,allow,766,102,664,2,30,1,1
55475,53,23006,53,allow,784,94,690,2,30,1,1
56597,53,51184,53,allow,711,87,624,2,30,1,1
60406,443,21053,443,allow,8404,1892,6512,23,30,12,11
54931,445,0,0,drop,70,70,0,1,0,1,0
52320,443,52845,443,allow,65770,4466,61304,94,46,44,50
53786,445,0,0,drop,70,70,0,1,0,1,0
64514,53,1734,53,allow,209,102,107,2,30,1,1
64051,53,63556,53,allow,275,102,173,2,30,1,1
62301,445,0,0,drop,70,70,0,1,0,1,0
59967,445,0,0,drop,66,66,0,1,0,1,0
57892,445,0,0,drop,70,70,0,1,0,1,0
50578,80,35081,80,allow,367162,17367,349795,470,143,214,256
63787,18318,40020,18318,allow,66,66,0,2,8,2,0
51858,44647,20973,44647,allow,66,66,0,1,5,1,0
65503,443,44158,443,allow,429890,12640,417250,442,16,155,287
61469,445,0,0,drop,66,66,0,1,0,1,0
58442,123,61048,123,allow,184,94,90,2,30,1,1
46256,443,26728,443,allow,15090,9197,5893,33,97,19,14
28830,37965,0,0,deny,62,62,0,1,0,1,0
52340,22114,0,0,deny,66,66,0,1,0,1,0
56791,11500,39420,11500,allow,70,70,0,2,8,2,0
56968,445,0,0,drop,70,70,0,1,0,1,0
52138,445,0,0,drop,70,70,0,1,0,1,0
55675,53,42703,53,allow,196,100,96,2,31,1,1
50020,445,0,0,drop,70,70,0,1,0,1,0
61830,445,0,0,drop,70,70,0,1,0,1,0
41812,8080,0,0,deny,60,60,0,1,0,1,0
55038,443,38606,443,allow,30239,8906,21333,61,32,34,27
53792,445,0,0,drop,70,70,0,1,0,1,0
55370,443,38504,443,allow,3055,953,2102,23,50,10,13
45676,123,45676,123,allow,184,94,90,2,30,1,1
64238,53,60413,53,allow,213,102,111,2,30,1,1
45908,33330,0,0,deny,60,60,0,1,0,1,0
2582,80,2582,80,allow,8395,700,7695,17,15,8,9
59442,53,59442,53,allow,235,90,145,2,33,1,1
58050,80,17128,80,allow,318,192,126,6,20,4,2
53321,80,20263,80,allow,3483,2072,1411,21,214,17,4
3478,61463,0,0,deny,627,627,0,1,0,1,0
64680,53,61021,53,allow,808,272,536,8,78,4,4
54506,80,60844,80,allow,254,128,126,5,15,3,2
64133,53,49082,53,allow,225,110,115,2,30,1,1
58638,5900,0,0,deny,62,62,0,1,0,1,0
58016,80,61881,80,allow,378,192,186,7,21,4,3
55241,443,32846,443,allow,8080,2630,5450,24,45,12,12
64016,53,54267,53,allow,183,94,89,2,30,1,1
55505,53,4978,53,allow,199,102,97,2,29,1,1
56230,5228,8322,5228,allow,2564,1546,1018,18,3600,9,9
65274,445,0,0,drop,70,70,0,1,0,1,0
53253,443,36100,443,allow,8662,1469,7193,28,66,15,13
6881,6889,18694,6889,allow,221,111,110,2,1200,1,1
53280,445,0,0,drop,70,70,0,1,0,1,0
55594,42459,54770,42459,allow,1253,716,537,12,23,7,5
53048,445,0,0,drop,66,66,0,1,0,1,0
55547,53,9428,53,allow,774,101,673,2,31,1,1
58477,445,0,0,drop,70,70,0,1,0,1,0
62443,445,0,0,drop,70,70,0,1,0,1,0
57163,53,45195,53,allow,209,110,99,2,30,1,1
55790,53,7477,53,allow,170,87,83,2,31,1,1
59986,53,15041,53,allow,186,86,100,2,30,1,1
51602,22114,0,0,deny,66,66,0,1,0,1,0
63849,16632,40129,16632,allow,66,66,0,1,5,1,0
62549,53733,0,0,deny,66,66,0,1,0,1,0
65179,53,9786,53,allow,289,102,187,2,30,1,1
50990,443,22704,443,allow,6090,2628,3462,21,24,11,10
47992,5228,27773,5228,allow,2988,2036,952,16,3601,8,8
64477,53,1968,53,allow,272,94,178,2,30,1,1
53778,6881,15801,6881,allow,70,70,0,1,5,1,0
35165,443,20390,443,allow,7174,4658,2516,18,121,10,8
52330,443,52330,443,allow,11451,5432,6019,34,86,17,17
47656,443,30620,443,allow,684,140,544,11,165,3,8
60129,55442,0,0,deny,66,66,0,1,0,1,0
53590,445,0,0,drop,70,70,0,1,0,1,0
51843,445,0,0,drop,70,70,0,1,0,1,0
65292,53,3636,53,allow,195,102,93,2,30,1,1
50907,443,12062,443,allow,124,64,60,2,15,1,1
43382,443,40551,443,allow,9624,2231,7393,24,22,14,10
65179,44847,0,0,deny,66,66,0,1,0,1,0
64330,53,52470,53,allow,193,102,91,2,31,1,1
49516,53,19547,53,allow,183,94,89,2,31,1,1
37710,443,47259,443,allow,13986,9199,4787,59,94,24,35
53209,80,42720,80,allow,1452,484,968,8,15,5,3
64132,53,49481,53,allow,179,94,85,2,29,1,1
2090,50265,0,0,deny,145,145,0,1,0,1,0
52742,443,24275,443,allow,69884,4367,65517,96,26,44,52
50413,445,0,0,drop,70,70,0,1,0,1,0
59261,80,59261,80,allow,109128,4773,104355,197,15,68,129
61361,443,58250,443,allow,7653,1226,6427,24,18,14,10
29746,53,29746,53,allow,235,90,145,2,32,1,1
55985,445,0,0,drop,66,66,0,1,0,1,0
57973,445,0,0,drop,66,66,0,1,0,1,0
54737,50584,0,0,deny,66,66,0,1,0,1,0
54225,53,12389,53,allow,274,78,196,2,30,1,1
55444,23,0,0,deny,60,60,0,1,0,1,0
52249,443,52249,443,allow,152755,7304,145451,171,21,65,106
11382,43890,0,0,deny,66,66,0,1,0,1,0
49380,53,7490,53,allow,110,110,0,1,30,1,0
27005,27018,4129,27018,allow,881,126,755,2,30,1,1
65323,53,33275,53,allow,356,118,238,2,30,1,1
58110,23,0,0,deny,60,60,0,1,0,1,0
63157,445,0,0,drop,70,70,0,1,0,1,0
59919,445,0,0,drop,70,70,0,1,0,1,0
60522,443,60522,443,allow,1088,641,447,10,25,6,4
61429,80,5078,80,allow,214,140,74,4,41,3,1
39890,443,4730,443,allow,21106,2445,18661,45,20,24,21
9244,80,12299,80,allow,318,192,126,6,26,4,2
42298,40005,47580,40005,allow,211,89,122,4,29,2,2
52802,443,30052,443,allow,4202,1924,2278,27,80,13,14
50294,445,0,0,drop,70,70,0,1,0,1,0
49727,445,0,0,drop,70,70,0,1,0,1,0
62322,445,0,0,drop,70,70,0,1,0,1,0
6775,53,6775,53,allow,228,90,138,2,32,1,1
47402,443,25875,443,allow,6118,1180,4938,22,16,11,11
53689,42719,50216,42719,allow,70,70,0,1,4,1,0
24480,35440,0,0,deny,66,66,0,1,0,1,0
50423,80,33009,80,allow,23470,2457,21013,31,22,13,18
41734,57470,0,0,deny,62,62,0,1,0,1,0
56632,443,5495,443,allow,7941,1952,5989,20,15,11,9
64831,53,56461,53,allow,216,110,106,2,30,1,1
58102,443,20475,443,allow,14197,9283,4914,28,122,15,13
55932,53,30562,53,allow,209,110,99,2,31,1,1
62156,445,0,0,drop,70,70,0,1,0,1,0
58914,443,39439,443,allow,5168,700,4468,16,16,7,9
53827,5889,21032,5889,allow,70,70,0,2,7,2,0
58948,445,0,0,drop,66,66,0,1,0,1,0
57371,443,2707,443,allow,5619,927,4692,17,15,10,7
60560,445,0,0,drop,70,70,0,1,0,1,0
46679,64147,0,0,deny,62,62,0,1,0,1,0
50293,445,0,0,drop,70,70,0,1,0,1,0
35849,30188,0,0,deny,146,146,0,1,0,1,0
49253,53,20812,53,allow,198,101,97,2,30,1,1
50043,445,0,0,drop,66,66,0,1,0,1,0
52209,80,41464,80,allow,372,246,126,6,27,4,2
50661,80,15216,80,allow,1658,1247,411,8,15,5,3
48568,443,2828,443,allow,56258,45661,10597,165,244,88,77
37603,443,61350,443,allow,573,425,148,5,1,3,2
53650,64147,0,0,deny,62,62,0,1,0,1,0
38140,443,44966,443,allow,82608,3591,79017,101,15,39,62
5223,32965,0,0,deny,119,119,0,1,0,1,0
50445,80,48799,80,allow,318,192,126,6,27,4,2
61145,445,0,0,drop,70,70,0,1,0,1,0
61488,443,29110,443,allow,7036,2247,4789,39,141,19,20
57283,64147,0,0,deny,66,66,0,1,0,1,0
50251,35440,0,0,deny,66,66,0,1,0,1,0
45105,443,12616,443,allow,3607,2257,1350,22,19,12,10
52946,80,25585,80,allow,2043,1331,712,13,17,7,6
52949,443,60761,443,allow,9564,2054,7510,42,114,20,22
62085,445,0,0,drop,70,70,0,1,0,1,0
56349,53,33887,53,allow,168,86,82,2,29,1,1
64327,53,33651,53,allow,204,104,100,2,31,1,1
48275,15000,58699,15000,allow,130,70,60,2,5,1,1
45601,443,27195,443,allow,5378,984,4394,18,17,10,8
51860,53854,59221,53854,allow,70,70,0,1,5,1,0
53718,443,33767,443,allow,318,192,126,6,16,4,2
62212,445,0,0,drop,70,70,0,1,0,1,0
62043,25174,0,0,deny,146,146,0,1,0,1,0
55635,445,0,0,drop,70,70,0,1,0,1,0
34200,443,26443,443,allow,7341,2121,5220,18,135,8,10
58638,5900,0,0,deny,62,62,0,1,0,1,0
58048,445,0,0,drop,70,70,0,1,0,1,0
32770,51505,0,0,deny,62,62,0,1,0,1,0
6121,51505,0,0,deny,66,66,0,1,0,1,0
59278,445,0,0,drop,70,70,0,1,0,1,0
56450,443,16622,443,allow,1786,172,1614,7,120,3,4
38626,443,25389,443,allow,97751,9140,88611,115,82,39,76
39458,443,56911,443,allow,1053,566,487,10,31,6,4
64679,53,17226,53,allow,211,102,109,2,31,1,1
57040,443,58515,443,allow,59451,47894,11557,177,91,99,78
63854,16437,6082,16437,allow,70,70,0,1,4,1,0
62212,445,0,0,drop,70,70,0,1,0,1,0
59407,443,59407,443,allow,4736,1829,2907,19,29,11,8
52155,445,0,0,drop,70,70,0,1,0,1,0
59647,47993,0,0,deny,62,62,0,1,0,1,0
53845,443,42345,443,allow,499,425,74,4,0,3,1
26085,8305,0,0,deny,148,148,0,1,0,1,0
60593,445,0,0,drop,70,70,0,1,0,1,0
53932,27258,15001,27258,allow,70,70,0,2,7,2,0
49897,80,15304,80,allow,188,128,60,3,15,2,1
55340,53,63068,53,allow,184,94,90,2,31,1,1
49416,443,60307,443,allow,27484,4857,22627,42,46,15,27
38555,443,24882,443,allow,40928,36006,4922,59,16,34,25
50880,445,0,0,drop,70,70,0,1,0,1,0
64016,53,9177,53,allow,93,93,0,1,31,1,0
49591,5228,57295,5228,allow,18548,2772,15776,41,3957,17,24
50929,445,0,0,drop,66,66,0,1,0,1,0
58440,53,26101,53,allow,305,102,203,2,30,1,1
59985,443,16838,443,allow,25649,1485,24164,36,144,14,22
48694,123,37842,123,allow,184,94,90,2,30,1,1
50784,52952,0,0,deny,66,66,0,1,0,1,0
49759,53,30943,53,allow,216,110,106,2,31,1,1
55657,53,56154,53,allow,101,101,0,2,34,2,0
55564,445,0,0,drop,70,70,0,1,0,1,0
54348,445,0,0,drop,66,66,0,1,0,1,0
58881,445,0,0,drop,70,70,0,1,0,1,0
50769,443,26960,443,allow,6882,1377,5505,19,151,9,10
64987,53,43588,53,allow,198,102,96,2,30,1,1
38755,22114,0,0,deny,66,66,0,1,0,1,0
56403,445,0,0,drop,70,70,0,1,0,1,0
51341,7000,51341,7000,allow,3132,815,2317,14,16,7,7
55131,53,48118,53,allow,744,95,649,2,30,1,1
54018,445,0,0,drop,70,70,0,1,0,1,0
49867,443,24010,443,allow,7461,2841,4620,19,103,11,8
58557,443,4317,443,allow,114852,43911,70941,248,69,132,116
55836,53,51304,53,allow,177,94,83,2,30,1,1
37307,443,33957,443,allow,9563,2336,7227,25,15,14,11
39582,80,57536,80,allow,1614,1300,314,10,15,5,5
17280,22114,0,0,deny,62,62,0,1,0,1,0
56602,443,27563,443,allow,7942,1953,5989,20,15,11,9
56328,445,0,0,drop,70,70,0,1,0,1,0
56092,53,54654,53,allow,177,94,83,2,30,1,1
55488,57470,0,0,deny,145,145,0,1,0,1,0
61464,80,54948,80,allow,366,180,186,7,93,4,3
52074,57947,10118,57947,allow,70,70,0,2,8,2,0
56929,53,14776,53,allow,177,94,83,2,30,1,1
64824,37965,0,0,deny,62,62,0,1,0,1,0
64017,53,10978,53,allow,461,94,367,2,29,1,1
11136,19910,0,0,deny,62,62,0,1,0,1,0
1024,44847,0,0,deny,62,62,0,1,0,1,0
6356,26467,0,0,deny,62,62,0,1,0,1,0
53124,52917,46926,52917,allow,70,70,0,2,8,2,0
49860,80,9156,80,allow,6892,2154,4738,22,89,12,10
49671,53,15823,53,allow,166,86,80,2,29,1,1
63389,445,0,0,drop,70,70,0,1,0,1,0
50788,48817,0,0,deny,62,62,0,1,0,1,0
62686,445,0,0,drop,70,70,0,1,0,1,0
50374,443,25596,443,allow,4749,859,3890,18,30,9,9
53755,45416,43327,45416,allow,320,140,180,6,6,3,3
57316,53,3738,53,allow,177,94,83,2,30,1,1
55021,443,46013,443,allow,31237,2116,29121,57,195,24,33
54959,53,28413,53,allow,211,110,101,2,30,1,1
49283,53,8368,53,allow,251,102,149,2,30,1,1
56185,53,12663,53,allow,183,102,81,2,29,1,1
43154,53,41451,53,allow,168,78,90,2,30,1,1
55720,53,40889,53,allow,774,101,673,2,31,1,1
10933,23,0,0,deny,60,60,0,1,0,1,0
59948,80,1436,80,allow,1756,414,1342,12,15,6,6
56793,56205,0,0,deny,66,66,0,1,0,1,0
50622,445,0,0,drop,66,66,0,1,0,1,0
64410,445,0,0,drop,70,70,0,1,0,1,0
30135,37965,0,0,deny,66,66,0,1,0,1,0
18964,443,18964,443,allow,5157,2180,2977,21,16,12,9
64216,53,45002,53,allow,295,93,202,4,30,2,2
53806,445,0,0,drop,70,70,0,1,0,1,0
32424,25174,0,0,deny,146,146,0,1,0,1,0
55337,53,17571,53,allow,294,106,188,4,56,2,2
63450,445,0,0,drop,66,66,0,1,0,1,0
50002,53,11892,53,allow,196,102,94,2,31,1,1
50455,80,38947,80,allow,4395,3599,796,15,34,8,7
40204,40035,37692,40035,allow,156,94,62,2,30,1,1
64741,53,19831,53,allow,420,110,310,2,30,1,1
49514,65504,0,0,deny,162,162,0,1,0,1,0
52086,445,0,0,drop,70,70,0,1,0,1,0
57032,53,53093,53,allow,166,86,80,2,29,1,1
6980,48543,0,0,deny,139,139,0,1,0,1,0
54397,443,59448,443,allow,1786,172,1614,7,120,3,4
56854,445,0,0,drop,70,70,0,1,0,1,0
2267,53,16452,53,allow,204,118,86,2,30,1,1
53036,443,2888,443,allow,3039,1089,1950,9,120,5,4
37987,49152,22842,49152,allow,156,156,0,3,7,3,0
28579,64147,0,0,deny,62,62,0,1,0,1,0
53163,443,28652,443,allow,12979,4609,8370,27,25,15,12
60520,53,60520,53,allow,198,90,108,2,30,1,1
62041,445,0,0,drop,70,70,0,1,0,1,0
56561,443,49349,443,allow,26334,2210,24124,49,66,22,27
65123,53,24943,53,allow,307,110,197,2,29,1,1
64413,53,4808,53,allow,209,102,107,2,30,1,1
63686,445,0,0,drop,70,70,0,1,0,1,0
58638,5900,0,0,deny,62,62,0,1,0,1,0
64017,80,54075,80,allow,314,192,122,6,15,4,2
29045,41864,0,0,deny,159,159,0,1,0,1,0
50197,64147,0,0,deny,66,66,0,1,0,1,0
51916,80,61338,80,allow,182,60,122,4,26,2,2
45908,3383,0,0,deny,60,60,0,1,0,1,0
40474,23117,0,0,deny,62,62,0,1,0,1,0
30496,57470,0,0,deny,62,62,0,1,0,1,0
46275,23,0,0,deny,60,60,0,1,0,1,0
62935,445,0,0,drop,70,70,0,1,0,1,0
60633,445,0,0,drop,70,70,0,1,0,1,0
58844,443,8325,443,allow,5167,700,4467,16,15,7,9
18130,25174,0,0,deny,62,62,0,1,0,1,0
55352,53,35227,53,allow,216,110,106,2,30,1,1
61575,445,0,0,drop,66,66,0,1,0,1,0
55962,53,39113,53,allow,186,95,91,2,31,1,1
62928,443,42185,443,allow,52219,4148,48071,75,125,33,42
57365,38303,0,0,deny,62,62,0,1,0,1,0
56712,443,63256,443,allow,8058,2038,6020,20,15,11,9
64580,53,23762,53,allow,199,102,97,2,30,1,1
64805,53,57151,53,allow,215,102,113,2,30,1,1
57594,80,57594,80,allow,110070,5374,104696,112,156,36,76
50934,443,28821,443,allow,9989,3003,6986,30,46,17,13
56183,53,22164,53,allow,179,94,85,2,30,1,1
41410,30188,0,0,deny,146,146,0,1,0,1,0
54858,445,0,0,drop,66,66,0,1,0,1,0
6486,64147,0,0,deny,62,62,0,1,0,1,0
49352,443,43143,443,allow,2118582,46411,2072171,2066,90,617,1449
43674,53,36130,53,allow,199,94,105,2,30,1,1
50779,443,59788,443,allow,16067,4838,11229,43,121,21,22
50328,22114,0,0,deny,62,62,0,1,0,1,0
61949,445,0,0,drop,70,70,0,1,0,1,0
50972,3544,56182,3544,allow,409,107,302,4,31,2,2
2440,37807,0,0,deny,66,66,0,1,0,1,0
64810,53,55417,53,allow,272,93,179,4,33,2,2
65526,53,37729,53,allow,199,102,97,2,30,1,1
16387,20045,0,0,deny,60,60,0,1,0,1,0
2705,37,0,0,deny,60,60,0,1,0,1,0
443,47582,0,0,deny,60,60,0,1,0,1,0
57351,53,37431,53,allow,184,94,90,2,31,1,1
44889,23,0,0,deny,60,60,0,1,0,1,0
14420,443,3846,443,allow,5103,3164,1939,32,168,17,15
53225,443,23994,443,allow,6659,1215,5444,17,15,9,8
49614,53,6383,53,allow,183,94,89,2,30,1,1
54246,80,56298,80,allow,506,292,214,8,16,5,3
38649,443,32676,443,allow,13463,5427,8036,24,121,11,13
62953,445,0,0,drop,70,70,0,1,0,1,0
58968,445,0,0,drop,66,66,0,1,0,1,0
33044,443,19147,443,allow,268582,23654,244928,341,190,128,213
58638,5900,0,0,deny,62,62,0,1,0,1,0
53727,445,0,0,drop,70,70,0,1,0,1,0
49656,53,53745,53,allow,309,118,191,2,30,1,1
55500,445,0,0,drop,70,70,0,1,0,1,0
48817,6882,48817,6882,allow,152,152,0,1,1200,1,0
53156,57780,14557,57780,allow,320,140,180,6,7,3,3
62642,25174,0,0,deny,66,66,0,1,0,1,0
62132,42873,0,0,deny,66,66,0,1,0,1,0
53223,445,0,0,drop,66,66,0,1,0,1,0
57291,53,29680,53,allow,178,94,84,2,30,1,1
56933,80,47498,80,allow,486,280,206,8,26,5,3
38370,443,49097,443,allow,9194,5026,4168,24,32,11,13
58902,5223,20774,5223,allow,308,86,222,4,13,1,3
63015,445,0,0,drop,70,70,0,1,0,1,0
44577,53,21603,53,allow,199,94,105,2,30,1,1
56764,443,62218,443,allow,8006,1986,6020,20,16,11,9
64360,53,15501,53,allow,350,88,262,4,31,2,2
35628,443,46062,443,allow,8414,4131,4283,36,64,16,20
64073,53,57961,53,allow,304,101,203,4,38,2,2
53241,443,12408,443,allow,6058,1038,5020,20,69,11,9
39572,443,50194,443,allow,64247,3857,60390,94,30,43,51
65306,445,0,0,drop,66,66,0,1,0,1,0
57077,443,42602,443,allow,7159,1851,5308,22,31,13,9
63416,445,0,0,drop,70,70,0,1,0,1,0
60009,445,0,0,drop,70,70,0,1,0,1,0
63217,445,0,0,drop,70,70,0,1,0,1,0
50961,80,36404,80,allow,5730066,61301,5668765,4686,81,891,3795
64614,53,3667,53,allow,186,95,91,2,30,1,1
52591,445,0,0,drop,70,70,0,1,0,1,0
51729,63553,13105,63553,allow,70,70,0,2,8,2,0
65037,53,16035,53,allow,210,110,100,2,29,1,1
51242,445,0,0,drop,70,70,0,1,0,1,0
65130,53,36063,53,allow,266,110,156,2,30,1,1
64824,37965,0,0,deny,62,62,0,1,0,1,0
53717,443,48427,443,allow,318,192,126,6,15,4,2
54930,445,0,0,drop,70,70,0,1,0,1,0
50063,35776,0,0,deny,148,148,0,1,0,1,0
34112,44847,0,0,deny,62,62,0,1,0,1,0
25961,55783,0,0,deny,60,60,0,1,0,1,0
50227,57470,0,0,deny,66,66,0,1,0,1,0
56373,53,29361,53,allow,200,102,98,2,31,1,1
64338,445,0,0,drop,70,70,0,1,0,1,0
9445,56205,0,0,deny,66,66,0,1,0,1,0
60228,445,0,0,drop,66,66,0,1,0,1,0
56940,80,57845,80,allow,606,70,536,10,278,2,8
49741,443,56871,443,allow,6060,1553,4507,18,129,10,8
1431,53,1431,53,allow,215,80,135,2,32,1,1
64055,53,48031,53,allow,501,94,407,4,52,2,2
10306,44847,0,0,deny,66,66,0,1,0,1,0
58849,64147,0,0,deny,66,66,0,1,0,1,0
26713,64147,0,0,deny,62,62,0,1,0,1,0
50623,443,54546,443,allow,13392,11220,2172,31,53,19,12
54060,445,0,0,drop,66,66,0,1,0,1,0
13663,23,0,0,deny,60,60,0,1,0,1,0
60571,26467,0,0,deny,62,62,0,1,0,1,0
52102,19604,10302,19604,allow,70,70,0,2,8,2,0
53577,35894,0,0,deny,66,66,0,1,0,1,0
55056,53,39813,53,allow,209,110,99,2,30,1,1
47814,51505,0,0,deny,62,62,0,1,0,1,0
51539,443,52838,443,allow,94949,5974,88975,118,148,45,73
49881,443,45580,443,allow,5997,978,5019,19,53,10,9
49332,53,40502,53,allow,281,98,183,4,57,2,2
40662,53,39686,53,allow,223,78,145,2,30,1,1
57022,445,0,0,drop,70,70,0,1,0,1,0
6069,45680,0,0,deny,159,159,0,1,0,1,0
55387,53,44046,53,allow,172,94,78,2,29,1,1
443,56513,0,0,deny,78,78,0,1,0,1,0
16687,10214,0,0,deny,66,66,0,1,0,1,0
55704,53,41065,53,allow,752,93,659,2,30,1,1
40080,80,40080,80,allow,424,198,226,7,142,4,3
53899,45682,27773,45682,allow,70,70,0,2,7,2,0
32846,80,52606,80,allow,1644,1324,320,10,15,5,5
64462,53,14604,53,allow,179,94,85,2,29,1,1
57023,53,45929,53,allow,179,94,85,2,31,1,1
64981,53,62988,53,allow,214,102,112,2,29,1,1
53799,443,27170,443,allow,499,425,74,4,0,3,1
58732,443,10734,443,allow,1038,502,536,16,33,8,8
63134,445,0,0,drop,70,70,0,1,0,1,0
49636,53,23682,53,allow,180,94,86,2,30,1,1
52172,7353,52329,7353,allow,70,70,0,2,7,2,0
61160,445,0,0,drop,70,70,0,1,0,1,0
11136,19910,0,0,deny,62,62,0,1,0,1,0
57331,53,57928,53,allow,178,94,84,2,29,1,1
59518,80,10090,80,allow,14862,1091,13771,26,135,14,12
63314,57470,0,0,deny,66,66,0,1,0,1,0
51411,445,0,0,drop,70,70,0,1,0,1,0
53516,443,26441,443,allow,560,280,280,9,34,5,4
49477,53,4842,53,allow,178,94,84,2,31,1,1
47063,15503,0,0,deny,62,62,0,1,0,1,0
53918,443,16862,443,allow,499,425,74,4,0,3,1
56541,443,9751,443,allow,130,70,60,2,15,1,1
52537,445,0,0,drop,66,66,0,1,0,1,0
55225,53,48958,53,allow,822,102,720,2,30,1,1
64520,53,16253,53,allow,198,102,96,2,29,1,1
57942,445,0,0,drop,66,66,0,1,0,1,0
59485,80,39693,80,allow,882,527,355,10,255,6,4
52780,37965,0,0,deny,66,66,0,1,0,1,0
55631,53,42735,53,allow,422,96,326,4,42,2,2
52311,80,52311,80,allow,450,246,204,8,29,5,3
60423,443,39132,443,allow,11488,7258,4230,47,122,27,20
49418,27015,25593,27015,allow,258,78,180,2,30,1,1
57385,53,40272,53,allow,194,99,95,2,31,1,1
55156,53,28197,53,allow,256,87,169,4,36,2,2
1024,50265,0,0,deny,62,62,0,1,0,1,0
54996,53,30248,53,allow,252,102,150,2,29,1,1
53151,53,29237,53,allow,168,78,90,2,31,1,1
51455,53733,0,0,deny,66,66,0,1,0,1,0
64853,445,0,0,drop,70,70,0,1,0,1,0
52247,49278,31090,49278,allow,316,136,180,6,6,3,3
64883,445,0,0,drop,70,70,0,1,0,1,0
50408,445,0,0,drop,70,70,0,1,0,1,0
58638,5900,0,0,deny,62,62,0,1,0,1,0
58034,80,58034,80,allow,21684,903,20781,30,41,12,18
56682,53,9242,53,allow,196,86,110,2,30,1,1
42185,443,3806,443,allow,15233,9395,5838,33,338,16,17
49824,25174,0,0,deny,62,62,0,1,0,1,0
64870,53,47029,53,allow,200,102,98,2,31,1,1
49689,445,0,0,drop,70,70,0,1,0,1,0
50248,443,36330,443,allow,8882,3013,5869,29,137,14,15
61669,445,0,0,drop,70,70,0,1,0,1,0
52313,445,0,0,drop,70,70,0,1,0,1,0
63056,443,24879,443,allow,304,86,218,2,30,1,1
57752,445,0,0,drop,70,70,0,1,0,1,0
55318,53,26417,53,allow,167,86,81,2,29,1,1
55086,445,0,0,drop,70,70,0,1,0,1,0
52662,443,35849,443,allow,5382,1353,4029,19,135,10,9
38554,3389,38554,3389,reset-both,293,223,70,4,1,3,1
64426,53,47787,53,allow,289,101,188,4,50,2,2
53724,64923,33470,64923,allow,70,70,0,2,8,2,0
6189,53,29429,53,allow,229,86,143,2,30,1,1
61144,445,0,0,drop,70,70,0,1,0,1,0
19841,50584,0,0,deny,62,62,0,1,0,1,0
50469,80,50469,80,allow,350722,14506,336216,459,26,231,228
5223,1210,0,0,deny,66,66,0,1,0,1,0
32051,37965,0,0,deny,62,62,0,1,0,1,0
51106,445,0,0,drop,66,66,0,1,0,1,0
56288,53,18039,53,allow,210,110,100,2,30,1,1
64462,53,49415,53,allow,179,94,85,2,30,1,1
62757,123,11526,123,allow,184,94,90,2,30,1,1
56528,445,0,0,drop,70,70,0,1,0,1,0
49550,445,0,0,drop,70,70,0,1,0,1,0
50625,443,24719,443,allow,9588,1204,8384,29,93,15,14
64110,53,20636,53,allow,215,102,113,2,30,1,1
60546,445,0,0,drop,66,66,0,1,0,1,0
49366,445,0,0,drop,70,70,0,1,0,1,0
49433,445,0,0,drop,70,70,0,1,0,1,0
54795,445,0,0,drop,70,70,0,1,0,1,0
53981,29500,46111,29500,allow,320,140,180,6,7,3,3
62509,445,0,0,drop,66,66,0,1,0,1,0
50475,80,52145,80,allow,2669,1434,1235,11,21,6,5
61314,443,62611,443,allow,3320,2053,1267,27,318,14,13
35196,5222,52205,5222,allow,3376,1509,1867,32,83,16,16
49555,53,21166,53,allow,199,102,97,2,30,1,1
60864,80,22050,80,allow,10629,1104,9525,23,46,12,11
50561,80,19741,80,allow,318,192,126,6,26,4,2
51157,445,0,0,drop,70,70,0,1,0,1,0
64593,53,56394,53,allow,94,94,0,1,30,1,0
64944,445,0,0,drop,70,70,0,1,0,1,0
49902,445,0,0,deny,70,70,0,1,0,1,0
55306,53,18601,53,allow,177,94,83,2,29,1,1
21179,44847,0,0,deny,146,146,0,1,0,1,0
41753,443,5130,443,allow,11570,3005,8565,43,255,20,23
52738,443,34014,443,allow,56339,3530,52809,79,26,39,40
49502,44847,0,0,deny,66,66,0,1,0,1,0
58155,445,0,0,drop,70,70,0,1,0,1,0
55629,42873,0,0,deny,74,74,0,1,0,1,0
55641,53,43709,53,allow,70,70,0,1,30,1,0
55002,53,11641,53,allow,196,102,94,2,31,1,1
43078,80,13694,80,allow,1052,612,440,10,15,5,5
63809,45193,55784,45193,allow,66,66,0,2,8,2,0
45434,443,37816,443,allow,74123,16210,57913,106,57,52,54
38697,443,5230,443,allow,90001,3161,86840,91,15,26,65
65049,53,16377,53,allow,210,110,100,2,30,1,1
59060,443,38409,443,allow,16775,1879,14896,36,16,17,19
54553,443,44028,443,allow,68345,58488,9857,122,329,62,60
55226,443,46963,443,allow,8025,3048,4977,23,45,13,10
49344,53,20668,53,allow,458,188,270,6,29,3,3
1927,53,62865,53,allow,210,78,132,2,30,1,1
56547,445,0,0,drop,70,70,0,1,0,1,0
27005,27035,7636,27035,allow,891,126,765,2,30,1,1
48165,53,17622,53,allow,199,94,105,2,30,1,1
53240,445,0,0,drop,66,66,0,1,0,1,0
1045,36237,0,0,deny,66,66,0,1,0,1,0
58249,443,60364,443,allow,4220,2048,2172,11,122,6,5
50306,80,39882,80,allow,182517,10761,171756,265,352,130,135
58638,5900,0,0,deny,62,62,0,1,0,1,0
27005,27017,57092,27017,allow,900,126,774,2,30,1,1
60364,445,0,0,drop,66,66,0,1,0,1,0
1935,53,17873,53,allow,260,86,174,2,30,1,1
50917,445,0,0,drop,66,66,0,1,0,1,0
55805,80,55805,80,allow,424,198,226,7,141,4,3
56636,443,56636,443,allow,4620,1713,2907,19,28,11,8
33919,53,58115,53,allow,168,78,90,2,30,1,1
65341,53,20700,53,allow,200,102,98,2,30,1,1
61481,443,1524,443,allow,23229,1880,21349,46,80,21,25
60305,80,11406,80,allow,4419,3852,567,15,144,8,7
55100,53,15692,53,allow,182,102,80,2,30,1,1
55271,53,11109,53,allow,168,86,82,2,31,1,1
56629,25174,0,0,deny,66,66,0,1,0,1,0
52321,443,49472,443,allow,10320,5152,5168,45,15,25,20
53003,11392,0,0,deny,66,66,0,1,0,1,0
61546,443,4493,443,allow,208,60,148,4,13,2,2
64711,53,44473,53,allow,206,105,101,2,31,1,1
49392,80,13895,80,allow,156587,46628,109959,307,314,203,104
51185,37965,0,0,deny,66,66,0,1,0,1,0
40400,22114,0,0,deny,62,62,0,1,0,1,0
65244,53,26357,53,allow,177,94,83,2,31,1,1
53490,62413,0,0,deny,66,66,0,1,0,1,0
55799,445,0,0,drop,70,70,0,1,0,1,0
64776,50584,0,0,deny,66,66,0,1,0,1,0
57581,445,0,0,drop,70,70,0,1,0,1,0
51117,80,26474,80,allow,5040,3914,1126,19,32,12,7
50080,445,0,0,drop,66,66,0,1,0,1,0
56472,53,9100,53,allow,166,85,81,2,31,1,1
59447,445,0,0,drop,70,70,0,1,0,1,0
1560,51505,0,0,deny,62,62,0,1,0,1,0
55966,35440,0,0,deny,62,62,0,1,0,1,0
50571,80,62731,80,allow,318,192,126,6,26,4,2
52973,443,33521,443,allow,9294,2728,6566,43,113,22,21
50379,53,49959,53,allow,197,102,95,2,29,1,1
46405,80,41634,80,allow,1213,755,458,10,15,6,4
55930,443,56260,443,allow,6271,1354,4917,25,113,14,11
49369,445,0,0,drop,70,70,0,1,0,1,0
55376,53,64673,53,allow,198,101,97,2,31,1,1
37618,443,28939,443,allow,28034,26485,1549,48,16,29,19
54250,443,54030,443,allow,499,425,74,4,0,3,1
54539,443,15655,443,allow,4552,2230,2322,14,134,7,7
37334,443,47156,443,allow,6592,1735,4857,23,360,11,12
51023,445,0,0,drop,70,70,0,1,0,1,0
51414,22,0,0,deny,60,60,0,1,0,1,0
3290,57470,0,0,deny,145,145,0,1,0,1,0
54970,445,0,0,drop,70,70,0,1,0,1,0
21998,51221,0,0,deny,62,62,0,1,0,1,0
7444,57470,0,0,deny,66,66,0,1,0,1,0
4961,62741,0,0,deny,66,66,0,1,0,1,0
53300,37807,0,0,deny,66,66,0,1,0,1,0
56785,53,13080,53,allow,213,102,111,2,30,1,1
27300,6881,0,0,deny,66,66,0,1,0,1,0
61713,80,49521,80,allow,134,60,74,3,5,2,1
64486,53,21384,53,allow,290,102,188,2,30,1,1
37455,50584,0,0,deny,62,62,0,1,0,1,0
56724,53,16788,53,allow,190,97,93,2,31,1,1
46478,64147,0,0,deny,62,62,0,1,0,1,0
64808,62413,0,0,deny,66,66,0,1,0,1,0
55321,445,0,0,drop,70,70,0,1,0,1,0
40006,80,2393,80,allow,7086,1841,5245,15,92,8,7
58884,23,0,0,deny,60,60,0,1,0,1,0
51159,445,0,0,drop,70,70,0,1,0,1,0
61467,445,0,0,drop,70,70,0,1,0,1,0
1143,25174,0,0,deny,62,62,0,1,0,1,0
62812,445,0,0,drop,70,70,0,1,0,1,0
27005,27015,32214,27015,allow,878,126,752,2,30,1,1
48300,443,42844,443,allow,7762,2247,5515,21,31,11,10
51620,445,0,0,drop,70,70,0,1,0,1,0
54395,445,0,0,drop,66,66,0,1,0,1,0
50629,443,10461,443,allow,1048,1048,0,9,17,9,0
50091,53,37575,53,allow,183,94,89,2,30,1,1
54961,443,45503,443,allow,25572,2605,22967,56,133,29,27
50949,80,11302,80,allow,942,527,415,11,342,6,5
50444,80,3294,80,allow,378,192,186,7,19,4,3
56800,443,21923,443,allow,79399,4048,75351,90,120,32,58
57596,443,20240,443,allow,8154,1791,6363,21,187,11,10
57251,445,0,0,drop,70,70,0,1,0,1,0
43269,50584,0,0,deny,66,66,0,1,0,1,0
52519,80,46745,80,allow,3771,3257,514,12,14,7,5
49662,53,17327,53,allow,268,93,175,4,57,2,2
37957,443,45183,443,allow,7280,2250,5030,15,120,7,8
62489,23117,0,0,deny,66,66,0,1,0,1,0
54848,445,0,0,drop,70,70,0,1,0,1,0
45941,23386,0,0,deny,60,60,0,1,0,1,0
47823,443,63568,443,allow,9842,2224,7618,20,122,10,10
49874,53,61806,53,allow,165,86,79,2,29,1,1
54706,445,0,0,drop,66,66,0,1,0,1,0
52636,443,34549,443,allow,1309,670,639,16,166,9,7
50438,53,42985,53,allow,199,102,97,2,29,1,1
57565,443,12958,443,allow,3586,1074,2512,17,137,8,9
27005,27017,41161,27017,allow,883,126,757,2,30,1,1
33852,443,7849,443,allow,3419,2241,1178,16,16,8,8
65339,53,32222,53,allow,193,102,91,2,29,1,1
55639,53,27613,53,allow,244,94,150,2,30,1,1
51570,445,0,0,drop,66,66,0,1,0,1,0
50624,443,1028,443,allow,12712,3662,9050,32,140,17,15
49213,443,9169,443,allow,157994,4952,153042,186,255,68,118
63670,64097,0,0,deny,66,66,0,1,0,1,0
54071,445,0,0,drop,70,70,0,1,0,1,0
35809,443,51066,443,allow,13084,2704,10380,36,201,21,15
54054,443,10549,443,allow,34629391,1109219,33520172,36863,278,12240,24623
51291,25174,0,0,deny,62,62,0,1,0,1,0
44207,44847,0,0,deny,66,66,0,1,0,1,0
50054,53,65410,53,allow,775,103,672,2,31,1,1
56417,53,7039,53,allow,389,126,263,2,30,1,1
55046,53,35740,53,allow,198,102,96,2,30,1,1
49639,53,29692,53,allow,250,102,148,2,29,1,1
53975,445,0,0,drop,70,70,0,1,0,1,0
37965,33738,46824,33738,allow,1548,265,1283,4,1200,2,2
58638,5900,0,0,deny,62,62,0,1,0,1,0
64850,53,16958,53,allow,196,102,94,2,30,1,1
49418,30007,64637,30007,allow,242,71,171,2,30,1,1
37492,53,45298,53,allow,199,94,105,2,30,1,1
44285,25174,0,0,deny,62,62,0,1,0,1,0
43260,41615,0,0,deny,145,145,0,1,0,1,0
54343,50584,0,0,deny,62,62,0,1,0,1,0
6881,6881,6157,6881,allow,253,118,135,2,1200,1,1
59308,443,6790,443,allow,12169,4963,7206,60,262,31,29
56544,443,41897,443,allow,39717,3740,35977,76,53,39,37
51943,55464,31100,55464,allow,70,70,0,2,8,2,0
55576,445,0,0,drop,66,66,0,1,0,1,0
64260,445,0,0,drop,70,70,0,1,0,1,0
34341,28678,47024,28678,allow,1806,1806,0,22,224,22,0
57381,443,25601,443,allow,4645,700,3945,12,15,8,4
60311,30627,0,0,deny,66,66,0,1,0,1,0
54991,53,13574,53,allow,177,94,83,2,29,1,1
50780,445,0,0,drop,66,66,0,1,0,1,0
63036,53,45835,53,allow,304,86,218,2,29,1,1
48755,23,0,0,deny,60,60,0,1,0,1,0
59210,80,59210,80,allow,1990,833,1157,10,21,6,4
49567,445,0,0,drop,66,66,0,1,0,1,0
43018,443,63361,443,allow,4664,962,3702,15,120,7,8
64461,53,32838,53,allow,350,89,261,4,53,2,2
11066,50584,0,0,deny,62,62,0,1,0,1,0
58638,5900,0,0,deny,62,62,0,1,0,1,0
5588,5588,0,0,allow,3498,1872,1626,48,195,24,24
57301,53,28379,53,allow,177,94,83,2,30,1,1
53712,25174,0,0,deny,66,66,0,1,0,1,0
57117,53,45575,53,allow,366,102,264,4,46,2,2
58638,5900,0,0,deny,62,62,0,1,0,1,0
50540,445,0,0,drop,66,66,0,1,0,1,0
50271,443,3937,443,allow,10103,2342,7761,39,121,22,17
56341,443,63475,443,allow,8325,1483,6842,24,47,13,11
56343,445,0,0,drop,66,66,0,1,0,1,0
50382,443,9728,443,allow,10423,2542,7881,48,20,24,24
55835,62413,0,0,deny,66,66,0,1,0,1,0
37011,25174,0,0,deny,62,62,0,1,0,1,0
49791,53,6212,53,allow,777,87,690,2,30,1,1
10265,64147,0,0,deny,62,62,0,1,0,1,0
9231,3389,0,0,deny,66,66,0,1,0,1,0
48689,443,50166,443,allow,9681,2243,7438,35,24,18,17
50584,51413,3341,51413,allow,475,150,325,2,1200,1,1
62424,37965,0,0,deny,66,66,0,1,0,1,0
62185,53,27701,53,allow,578,286,292,9,15,5,4
65289,53,50124,53,allow,564,193,371,6,51,3,3
56622,53,10987,53,allow,214,110,104,2,30,1,1
49889,53,3966,53,allow,310,99,211,4,40,2,2
55394,445,0,0,drop,70,70,0,1,0,1,0
56680,53,24501,53,allow,711,87,624,2,30,1,1
51749,445,0,0,drop,70,70,0,1,0,1,0
53284,80,44514,80,allow,6995,783,6212,14,317,7,7
58638,5900,0,0,deny,62,62,0,1,0,1,0
55989,53,34510,53,allow,301,80,221,2,31,1,1
58638,5900,0,0,deny,62,62,0,1,0,1,0
53739,53,43732,53,allow,168,78,90,2,30,1,1
54968,53,43880,53,allow,198,101,97,2,30,1,1
1880,57470,0,0,deny,146,146,0,1,0,1,0
50229,80,35977,80,allow,1743,979,764,13,81,7,6
64850,53,55584,53,allow,167,86,81,2,30,1,1
26989,80,26989,80,allow,256062,8754,247308,297,18,124,173
57898,443,41076,443,allow,240332,6623,233709,258,170,92,166
49369,53,34405,53,allow,324,86,238,4,47,2,2
20198,17372,0,0,deny,62,62,0,1,0,1,0
62109,44847,0,0,deny,66,66,0,1,0,1,0
49679,53,7089,53,allow,166,86,80,2,31,1,1
55059,443,19056,443,allow,32852,17447,15405,61,64,32,29
19963,2767,0,0,deny,66,66,0,1,0,1,0
53423,445,0,0,drop,70,70,0,1,0,1,0
64947,53,23514,53,allow,275,96,179,4,41,2,2
23023,80,23023,80,allow,2270,1645,625,9,26,6,3
58488,37965,0,0,deny,62,62,0,1,0,1,0
50272,53,52496,53,allow,210,110,100,2,29,1,1
27402,37628,0,0,deny,62,62,0,1,0,1,0
49341,443,6648,443,allow,6882,1788,5094,15,16,9,6
61336,61689,0,0,deny,62,62,0,1,0,1,0
54586,445,0,0,drop,66,66,0,1,0,1,0
53055,443,19489,443,allow,17225,7769,9456,71,91,34,37
51686,80,25444,80,allow,45058,2444,42614,90,52,33,57
17752,53,17752,53,allow,230,90,140,2,30,1,1
61256,443,47931,443,allow,2680,255,2425,9,120,4,5
58638,5900,0,0,deny,62,62,0,1,0,1,0
30583,25174,0,0,deny,66,66,0,1,0,1,0
54967,53,27983,53,allow,178,94,84,2,30,1,1
56443,53,48417,53,allow,250,86,164,4,29,2,2
50550,5228,24310,5228,allow,2661,1518,1143,18,3600,9,9
50957,445,0,0,drop,70,70,0,1,0,1,0
53162,445,0,0,drop,70,70,0,1,0,1,0
59229,445,0,0,drop,70,70,0,1,0,1,0
52186,57609,42161,57609,allow,66,66,0,1,5,1,0
53120,49860,25192,49860,allow,70,70,0,1,5,1,0
55782,53,15555,53,allow,245,94,151,2,29,1,1
49448,443,41135,443,allow,186882,17018,169864,206,29,84,122
37927,50265,0,0,deny,66,66,0,1,0,1,0
51980,80,55042,80,allow,4247,699,3548,13,46,7,6
61503,443,25661,443,allow,182448,3931,178517,161,26,36,125
58677,445,0,0,drop,70,70,0,1,0,1,0
49380,21247,0,0,deny,66,66,0,1,0,1,0
52802,80,4743,80,allow,1465,729,736,12,16,7,5
50925,445,0,0,drop,70,70,0,1,0,1,0
57260,53,31217,53,allow,211,102,109,2,30,1,1
56222,445,0,0,drop,70,70,0,1,0,1,0
63463,445,0,0,drop,70,70,0,1,0,1,0
55005,53,54882,53,allow,182,93,89,2,31,1,1
50415,443,63011,443,allow,2542,1504,1038,16,20,9,7
55886,443,32004,443,allow,161,101,60,2,5,1,1
49444,443,41469,443,allow,2293735,61874,2231861,2321,87,764,1557
56711,25174,0,0,deny,62,62,0,1,0,1,0
50908,445,0,0,drop,66,66,0,1,0,1,0
50870,445,0,0,drop,70,70,0,1,0,1,0
65383,443,27965,443,allow,839325,38439,800886,1027,94,451,576
27005,27015,32114,27015,allow,1634,126,1508,4,31,2,2
55123,53,29393,53,allow,198,102,96,2,29,1,1
58734,443,17024,443,allow,8758,3850,4908,26,330,14,12
45405,161,0,0,allow,5858,2302,3556,22,30,11,11
49800,53,49800,53,allow,235,90,145,2,33,1,1
55000,443,57257,443,allow,16063,2691,13372,38,38,18,20
61002,445,0,0,drop,66,66,0,1,0,1,0
64503,53,62802,53,allow,477,87,390,4,37,2,2
57403,445,0,0,drop,66,66,0,1,0,1,0
44611,23,0,0,deny,60,60,0,1,0,1,0
50466,53,28614,53,allow,199,102,97,2,30,1,1
40078,44847,0,0,deny,146,146,0,1,0,1,0
43218,443,34506,443,allow,2683108,71922,2611186,2467,150,623,1844
58009,80,11441,80,allow,495,192,303,6,21,4,2
27147,22114,0,0,deny,146,146,0,1,0,1,0
49291,53,30701,53,allow,759,102,657,2,30,1,1
64947,53,18048,53,allow,275,96,179,4,41,2,2
55539,57470,0,0,deny,66,66,0,1,0,1,0
13257,53,13257,53,allow,227,88,139,2,31,1,1
39941,2767,0,0,deny,62,62,0,1,0,1,0
51691,445,0,0,drop,70,70,0,1,0,1,0
57880,443,33669,443,allow,1868,1229,639,18,177,11,7
58459,53,37044,53,allow,307,86,221,2,29,1,1
49606,80,25049,80,allow,454,262,192,8,41,5,3
47700,51505,0,0,deny,66,66,0,1,0,1,0
13581,51505,0,0,deny,62,62,0,1,0,1,0
51784,34568,29870,34568,allow,70,70,0,2,8,2,0
50197,64147,0,0,deny,62,62,0,1,0,1,0
63313,445,0,0,drop,70,70,0,1,0,1,0
56478,53,58747,53,allow,200,102,98,2,31,1,1
52252,46314,0,0,deny,62,62,0,1,0,1,0
52779,445,0,0,drop,66,66,0,1,0,1,0
50239,443,44236,443,allow,9418,2681,6737,39,256,18,21
51756,41471,58464,41471,allow,70,70,0,1,5,1,0
37567,443,51638,443,allow,13774,4989,8785,35,51,20,15
37738,443,40273,443,allow,296068,21814,274254,358,206,150,208
65107,53,56824,53,allow,266,87,179,4,32,2,2
49556,53,59272,53,allow,300,100,200,4,44,2,2
50542,443,16831,443,allow,5347,2537,2810,17,120,8,9
63981,53,63404,53,allow,198,101,97,2,30,1,1
50321,23684,0,0,deny,143,143,0,1,0,1,0
43055,80,43055,80,allow,1246,533,713,10,20,5,5
52224,445,0,0,drop,70,70,0,1,0,1,0
56819,445,0,0,drop,66,66,0,1,0,1,0
2598,23718,0,0,deny,66,66,0,1,0,1,0
49591,53,54188,53,allow,408,86,322,4,31,2,2
26900,27017,34490,27017,allow,422,164,258,6,30,3,3
51021,445,0,0,drop,70,70,0,1,0,1,0
53808,443,30751,443,allow,499,425,74,4,0,3,1
45157,7,33504,7,allow,138,78,60,2,5,1,1
50327,445,0,0,drop,70,70,0,1,0,1,0
63140,30685,55473,30685,allow,70,70,0,2,8,2,0
51060,80,61015,80,allow,4632,2660,1972,49,193,26,23
58021,443,29855,443,allow,8075,4109,3966,42,91,19,23
33498,25,33498,25,allow,7825,2062,5763,36,17,17,19
64071,53,46762,53,allow,194,102,92,2,29,1,1
65365,53,21509,53,allow,178,94,84,2,29,1,1
59774,443,17301,443,allow,846,420,426,15,29,8,7
58375,445,0,0,drop,70,70,0,1,0,1,0
51924,80,58410,80,allow,32222,3146,29076,43,31,18,25
49613,80,63557,80,allow,374,192,182,7,41,4,3
53170,20259,55641,20259,allow,70,70,0,1,5,1,0
38700,443,53165,443,allow,40207,7892,32315,59,152,23,36
49367,51505,0,0,deny,66,66,0,1,0,1,0
58562,57587,0,0,deny,66,66,0,1,0,1,0
58638,5900,0,0,deny,62,62,0,1,0,1,0
52143,33283,33804,33283,allow,70,70,0,1,5,1,0
64327,53,64327,53,allow,243,100,143,2,30,1,1
23415,11392,0,0,deny,66,66,0,1,0,1,0
33705,443,51177,443,allow,4610,918,3692,15,135,7,8
52312,80,52312,80,allow,450,246,204,8,29,5,3
49782,443,62911,443,allow,70,70,0,1,5,1,0
55596,53,31644,53,allow,194,102,92,2,30,1,1
57296,53,12062,53,allow,200,102,98,2,31,1,1
49918,443,49171,443,allow,10385,3107,7278,28,16,16,12
51779,3389,21341,3389,allow,62242217,4119315,58122902,123738,4772,43917,79821
54635,443,11319,443,allow,11955,1861,10094,30,172,14,16
58758,22114,0,0,deny,66,66,0,1,0,1,0
50146,445,0,0,drop,70,70,0,1,0,1,0
49722,53,29083,53,allow,215,94,121,2,30,1,1
52051,29868,56419,29868,allow,70,70,0,2,8,2,0
36810,80,28528,80,allow,18460,3166,15294,34,32,18,16
27005,32025,48806,32025,allow,887,126,761,2,31,1,1
56629,53,25209,53,allow,183,94,89,2,30,1,1
36405,443,39201,443,allow,1149,709,440,13,38,8,5
50780,445,0,0,drop,70,70,0,1,0,1,0
55865,445,0,0,drop,66,66,0,1,0,1,0
62512,25174,0,0,deny,146,146,0,1,0,1,0
57149,53,29225,53,allow,612,114,498,4,52,2,2
46279,443,60019,443,allow,172,172,0,2,5,2,0
51594,445,0,0,drop,70,70,0,1,0,1,0
50584,29040,20008,29040,allow,509,150,359,2,1200,1,1
62432,445,0,0,drop,70,70,0,1,0,1,0
64639,53,21872,53,allow,199,102,97,2,30,1,1
57441,57470,0,0,deny,66,66,0,1,0,1,0
64989,50265,0,0,deny,66,66,0,1,0,1,0
34910,443,46197,443,allow,16227,7159,9068,40,524,21,19
51817,54601,57265,54601,allow,316,136,180,6,7,3,3
58123,80,21790,80,allow,3641,1784,1857,19,375,10,9
52034,48856,21980,48856,allow,70,70,0,2,9,2,0
64002,2880,14112,2880,allow,66,66,0,1,5,1,0
22278,53,34234,53,allow,806,458,348,3,29,2,1
58856,443,60071,443,allow,2694,1614,1080,14,386,8,6
64605,53,20190,53,allow,183,94,89,2,31,1,1
54986,445,0,0,drop,66,66,0,1,0,1,0
56380,53,5120,53,allow,177,94,83,2,30,1,1
53165,443,14639,443,allow,7434,1695,5739,23,27,12,11
55528,80,12209,80,allow,3868,2218,1650,19,39,11,8
50584,8999,10076,8999,allow,161,161,0,1,1200,1,0
50545,445,0,0,drop,66,66,0,1,0,1,0
56955,80,64782,80,allow,214,140,74,4,30,3,1
64763,53,55818,53,allow,212,108,104,2,31,1,1
63113,445,0,0,drop,66,66,0,1,0,1,0
38365,15000,43140,15000,allow,130,70,60,2,6,1,1
50944,445,0,0,drop,70,70,0,1,0,1,0
55610,53,57817,53,allow,181,94,87,2,30,1,1
56395,53,56804,53,allow,199,102,97,2,29,1,1
27005,30008,3198,30008,allow,890,126,764,2,31,1,1
49461,53,21062,53,allow,821,102,719,2,29,1,1
56528,64147,0,0,deny,62,62,0,1,0,1,0
50572,80,10361,80,allow,318,192,126,6,26,4,2
65340,53,54833,53,allow,313,110,203,4,33,2,2
51525,445,0,0,drop,70,70,0,1,0,1,0
33215,37965,0,0,deny,62,62,0,1,0,1,0
51218,5223,10817,5223,allow,11005,5789,5216,34,23,18,16
50156,53,35377,53,allow,178,94,84,2,29,1,1
59404,53,59404,53,allow,237,91,146,2,32,1,1
52683,22114,0,0,deny,62,62,0,1,0,1,0
7877,22114,0,0,deny,62,62,0,1,0,1,0
40687,64147,0,0,deny,62,62,0,1,0,1,0
49663,53,41171,53,allow,184,102,82,2,30,1,1
49788,53,45773,53,allow,198,102,96,2,33,1,1
44007,123,12438,123,allow,184,94,90,2,30,1,1
55131,445,0,0,drop,70,70,0,1,0,1,0
65061,53,60210,53,allow,733,204,529,6,40,3,3
62089,8604,0,0,deny,62,62,0,1,0,1,0
45169,14037,0,0,deny,74,74,0,1,0,1,0
63832,6969,23907,6969,allow,66,66,0,2,8,2,0
53756,61137,24650,61137,allow,672,306,366,11,16,5,6
50971,443,37029,443,allow,469,403,66,4,0,3,1
65212,53,30386,53,allow,196,102,94,2,30,1,1
3818,37965,0,0,deny,66,66,0,1,0,1,0
58382,50584,0,0,deny,146,146,0,1,0,1,0
14717,64147,0,0,deny,66,66,0,1,0,1,0
49516,53,51751,53,allow,182,93,89,2,30,1,1
60874,445,0,0,drop,66,66,0,1,0,1,0
58638,5900,0,0,deny,62,62,0,1,0,1,0
51648,80,37574,80,allow,974005,25912,948093,1003,32,361,642
33098,443,16704,443,allow,466,392,74,4,0,3,1
20962,22114,0,0,deny,62,62,0,1,0,1,0
53219,443,33001,443,allow,6058,1038,5020,20,66,11,9
52220,22,52220,22,allow,8248,3445,4803,57,38,26,31
56995,53,4474,53,allow,167,86,81,2,30,1,1
55735,50584,0,0,deny,62,62,0,1,0,1,0
8889,60297,0,0,deny,60,60,0,1,0,1,0
56618,443,57435,443,allow,8034,2014,6020,20,15,11,9
34734,443,41689,443,allow,7974,2716,5258,50,7261,26,24
50064,445,0,0,drop,70,70,0,1,0,1,0
40430,80,30893,80,allow,1566,754,812,10,15,6,4
57633,50584,0,0,deny,62,62,0,1,0,1,0
59949,44847,0,0,deny,62,62,0,1,0,1,0
58724,443,33462,443,allow,10179,4285,5894,60,272,31,29
58453,50584,0,0,deny,66,66,0,1,0,1,0
50818,80,50818,80,allow,514,246,268,9,42,5,4
56754,443,40687,443,allow,9868,2027,7841,24,20,12,12
65165,53,58294,53,allow,200,102,98,2,31,1,1
14740,26467,0,0,deny,62,62,0,1,0,1,0
50506,445,0,0,drop,70,70,0,1,0,1,0
56876,11392,0,0,deny,66,66,0,1,0,1,0
49761,53,31558,53,allow,183,94,89,2,30,1,1
61143,445,0,0,drop,66,66,0,1,0,1,0
34325,80,9980,80,allow,2243,1115,1128,14,152,7,7
55245,443,9754,443,allow,6799,1581,5218,27,25,14,13
57111,445,0,0,drop,66,66,0,1,0,1,0
58357,62413,0,0,deny,62,62,0,1,0,1,0
53843,17556,3555,17556,allow,320,140,180,6,7,3,3
45918,443,28786,443,allow,12351,7584,4767,38,48,22,16
39716,443,56404,443,allow,131171,10346,120825,183,150,93,90
61716,443,60379,443,allow,3168,1038,2130,16,136,8,8
48817,6881,48817,6881,allow,773,279,494,4,1200,2,2
39880,80,44153,80,allow,1779,793,986,17,58,6,11
45563,443,24709,443,allow,1022491,42917,979574,1099,36,416,683
56250,36237,0,0,deny,66,66,0,1,0,1,0
35937,25174,0,0,deny,66,66,0,1,0,1,0
50790,445,0,0,drop,66,66,0,1,0,1,0
55771,53,25077,53,allow,196,102,94,2,30,1,1
58074,11392,0,0,deny,62,62,0,1,0,1,0
2705,37,0,0,deny,60,60,0,1,0,1,0
65317,51221,0,0,deny,78,78,0,1,0,1,0
53605,13468,43310,13468,allow,70,70,0,1,4,1,0
65039,445,0,0,drop,70,70,0,1,0,1,0
58638,5900,0,0,deny,62,62,0,1,0,1,0
51885,64546,64002,64546,allow,70,70,0,2,8,2,0
55102,445,0,0,drop,66,66,0,1,0,1,0
49746,53,23888,53,allow,177,94,83,2,30,1,1
49382,53,23586,53,allow,200,102,98,2,30,1,1
57053,53,14001,53,allow,211,102,109,2,30,1,1
55582,445,0,0,drop,70,70,0,1,0,1,0
16630,44847,0,0,deny,62,62,0,1,0,1,0
50327,1433,0,0,deny,60,60,0,1,0,1,0
49994,443,47759,443,allow,352,292,60,2,5,1,1
60153,445,0,0,drop,70,70,0,1,0,1,0
11488,22114,0,0,deny,66,66,0,1,0,1,0
58365,53,51432,53,allow,260,86,174,2,30,1,1
57030,445,0,0,drop,66,66,0,1,0,1,0
64215,53,28280,53,allow,196,94,102,2,30,1,1
49582,445,0,0,drop,66,66,0,1,0,1,0
63133,445,0,0,drop,66,66,0,1,0,1,0
27200,34021,0,0,allow,66,66,0,1,90,1,0
49190,445,0,0,drop,70,70,0,1,0,1,0
50283,445,0,0,drop,70,70,0,1,0,1,0
59760,53,48696,53,allow,384,166,218,2,29,1,1
53826,10168,29575,10168,allow,70,70,0,2,7,2,0
59597,445,0,0,drop,70,70,0,1,0,1,0
5176,53,35292,53,allow,86,86,0,1,30,1,0
59979,445,0,0,drop,66,66,0,1,0,1,0
55998,15503,0,0,deny,146,146,0,1,0,1,0
49578,80,61645,80,allow,25846,2486,23360,39,50,16,23
57600,80,57600,80,allow,3164,815,2349,12,144,6,6
61962,53733,0,0,deny,62,62,0,1,0,1,0
14360,64147,0,0,deny,62,62,0,1,0,1,0
50145,53,7031,53,allow,184,94,90,2,30,1,1
40306,443,40306,443,allow,4520,1613,2907,19,26,11,8
42298,40002,3434,40002,allow,241,178,63,2,31,1,1
64468,53,38719,53,allow,259,118,141,2,30,1,1
51418,443,51418,443,allow,4742,1835,2907,19,30,11,8
56403,51505,0,0,deny,62,62,0,1,0,1,0
13588,15503,0,0,deny,62,62,0,1,0,1,0
49254,53,63665,53,allow,173,94,79,2,29,1,1
55217,53,39301,53,allow,210,102,108,2,30,1,1
44351,53,3058,53,allow,168,78,90,2,30,1,1
61828,445,0,0,drop,70,70,0,1,0,1,0
62729,445,0,0,drop,66,66,0,1,0,1,0
65401,445,0,0,drop,66,66,0,1,0,1,0
51086,443,36949,443,allow,11749,5336,6413,32,153,18,14
57270,53,53677,53,allow,200,102,98,2,31,1,1
50770,443,41782,443,allow,6350,1369,4981,18,151,9,9
55388,53,28391,53,allow,177,94,83,2,30,1,1
64509,9571,0,0,deny,62,62,0,1,0,1,0
54614,37807,0,0,deny,66,66,0,1,0,1,0
3980,63710,0,0,deny,62,62,0,1,0,1,0
52031,20301,50759,20301,allow,66,66,0,1,5,1,0
52963,80,22153,80,allow,1600,581,1019,10,15,6,4
59875,443,3172,443,allow,12357,5182,7175,30,108,13,17
63621,30188,0,0,deny,62,62,0,1,0,1,0
1027,9822,0,0,deny,146,146,0,1,0,1,0
60470,445,0,0,drop,70,70,0,1,0,1,0
63727,61557,39781,61557,allow,312,132,180,6,6,3,3
51874,43161,58126,43161,allow,70,70,0,2,8,2,0
52790,445,0,0,drop,70,70,0,1,0,1,0
54493,445,0,0,drop,70,70,0,1,0,1,0
16985,57866,0,0,deny,66,66,0,1,0,1,0
62688,32480,0,0,deny,109,109,0,1,0,1,0
50118,443,10177,443,allow,125395,8711,116684,178,143,83,95
50674,445,0,0,drop,66,66,0,1,0,1,0
34366,443,43232,443,allow,1053,566,487,10,16,6,4
50275,443,24781,443,allow,708,362,346,11,18,6,5
41852,443,11364,443,allow,22648,14673,7975,96,245,45,51
61757,445,0,0,drop,66,66,0,1,0,1,0
60427,80,8033,80,allow,186,64,122,4,28,2,2
56005,53,33914,53,allow,199,102,97,2,29,1,1
63804,52520,44580,52520,allow,66,66,0,1,5,1,0
39195,25174,0,0,deny,62,62,0,1,0,1,0
52727,443,14385,443,allow,1369,708,661,14,45,8,6
49798,53,59206,53,allow,192,98,94,2,31,1,1
59020,445,0,0,drop,70,70,0,1,0,1,0
50972,3544,45034,3544,allow,258,107,151,2,31,1,1
60395,6890,41049,6890,allow,70,70,0,2,8,2,0
65516,445,0,0,drop,70,70,0,1,0,1,0
56962,445,0,0,drop,66,66,0,1,0,1,0
55553,53,10197,53,allow,711,87,624,2,30,1,1
54168,80,20934,80,allow,1582,1003,579,12,360,6,6
53536,445,0,0,drop,70,70,0,1,0,1,0
56678,53,49059,53,allow,240,110,130,2,30,1,1
51716,5223,22569,5223,allow,4524,1489,3035,26,1327,15,11
49746,53,24579,53,allow,479,88,391,4,58,2,2
52076,44847,0,0,deny,62,62,0,1,0,1,0
59753,443,43725,443,allow,303,85,218,2,30,1,1
53715,443,45128,443,allow,70,70,0,2,8,2,0
58898,443,10940,443,allow,5108,700,4408,15,15,7,8
49312,53,2239,53,allow,184,86,98,2,30,1,1
55730,53,15730,53,allow,196,102,94,2,30,1,1
46477,443,29699,443,allow,4900,904,3996,16,97,9,7
9329,443,17986,443,allow,3255,430,2825,11,15,6,5
51769,51505,0,0,deny,66,66,0,1,0,1,0
50165,445,0,0,drop,70,70,0,1,0,1,0
50938,53,64544,53,allow,209,81,128,2,30,1,1
49501,445,0,0,drop,70,70,0,1,0,1,0
55386,32480,0,0,deny,66,66,0,1,0,1,0
64371,443,25379,443,allow,5925,3462,2463,13,120,7,6
64438,445,0,0,drop,70,70,0,1,0,1,0
60463,445,0,0,drop,66,66,0,1,0,1,0
63052,445,0,0,drop,70,70,0,1,0,1,0
54922,445,0,0,drop,66,66,0,1,0,1,0
51940,445,0,0,drop,66,66,0,1,0,1,0
50113,51505,0,0,deny,66,66,0,1,0,1,0
50816,443,50681,443,allow,134,60,74,3,6,2,1
58755,53,43262,53,allow,277,102,175,2,30,1,1
60302,445,0,0,drop,66,66,0,1,0,1,0
53745,443,56954,443,allow,499,425,74,4,0,3,1
44098,1433,0,0,deny,60,60,0,1,0,1,0
50191,445,0,0,drop,70,70,0,1,0,1,0
56611,53,54736,53,allow,181,94,87,2,32,1,1
60496,56871,22838,56871,allow,504,318,186,8,15,5,3
51298,57470,0,0,deny,66,66,0,1,0,1,0
57470,11696,14471,11696,allow,353,166,187,2,1199,1,1
49687,53,63012,53,allow,241,94,147,2,29,1,1
22036,44847,0,0,deny,62,62,0,1,0,1,0
25470,24748,0,0,deny,143,143,0,1,0,1,0
63386,445,0,0,drop,66,66,0,1,0,1,0
64100,445,0,0,drop,70,70,0,1,0,1,0
23719,22114,0,0,deny,62,62,0,1,0,1,0
50095,53,20934,53,allow,168,86,82,2,30,1,1
60945,443,60187,443,allow,1373,712,661,14,18,8,6
63799,445,0,0,drop,70,70,0,1,0,1,0
56986,53,31308,53,allow,177,94,83,2,29,1,1
31123,53,31123,53,allow,231,88,143,2,34,1,1
50917,80,57551,80,allow,11626518,135099,11491419,9627,134,1907,7720
58638,5900,0,0,deny,62,62,0,1,0,1,0
59738,445,0,0,drop,66,66,0,1,0,1,0
50861,443,62102,443,allow,1501,590,911,12,26,6,6
57254,443,6263,443,allow,3948,1290,2658,13,120,6,7
35287,443,46797,443,allow,47587,20536,27051,345,581,173,172
61484,445,0,0,drop,70,70,0,1,0,1,0
56970,443,2688,443,allow,20635942,626393,20009549,21680,138,6969,14711
25237,57470,0,0,deny,62,62,0,1,0,1,0
1818,22114,0,0,deny,62,62,0,1,0,1,0
44220,443,37375,443,allow,2709,1698,1011,20,1143,11,9
27988,40006,7041,40006,allow,148,86,62,2,30,1,1
53799,80,41607,80,allow,1056,682,374,10,15,6,4
58638,5900,0,0,deny,62,62,0,1,0,1,0
60397,443,49717,443,allow,7643,1678,5965,21,80,11,10
62007,24184,0,0,allow,66,66,0,1,91,1,0
57314,445,0,0,drop,70,70,0,1,0,1,0
60771,58414,0,0,deny,66,66,0,1,0,1,0
23379,57866,0,0,deny,62,62,0,1,0,1,0
49162,53,42033,53,allow,182,93,89,2,30,1,1
55363,53,15445,53,allow,228,110,118,2,30,1,1
52401,623,0,0,deny,60,60,0,1,0,1,0
59651,445,0,0,drop,70,70,0,1,0,1,0
43671,37965,0,0,deny,62,62,0,1,0,1,0
53097,25174,0,0,deny,66,66,0,1,0,1,0
39556,443,12327,443,allow,7469,2547,4922,18,135,8,10
62765,16933,0,0,deny,66,66,0,1,0,1,0
61422,80,46677,80,allow,214,140,74,4,41,3,1
62473,445,0,0,drop,70,70,0,1,0,1,0
51959,445,0,0,drop,66,66,0,1,0,1,0
57094,445,0,0,drop,66,66,0,1,0,1,0
54236,443,22668,443,allow,499,425,74,4,0,3,1
62721,445,0,0,drop,70,70,0,1,0,1,0
51935,443,8500,443,allow,2780,1797,983,21,35,11,10
65371,445,0,0,drop,66,66,0,1,0,1,0
50928,445,0,0,drop,66,66,0,1,0,1,0
57419,53,24851,53,allow,326,110,216,2,29,1,1
53376,443,49944,443,allow,4814,1207,3607,17,75,10,7
64214,25174,0,0,deny,66,66,0,1,0,1,0
60350,51505,0,0,deny,66,66,0,1,0,1,0
50511,445,0,0,drop,70,70,0,1,0,1,0
53791,53,58724,53,allow,204,204,0,3,46,3,0
65199,445,0,0,drop,66,66,0,1,0,1,0
54355,443,13555,443,allow,15334,4707,10627,28,24,14,14
51762,12747,31596,12747,allow,70,70,0,1,5,1,0
55754,53,55090,53,allow,199,102,97,2,30,1,1
56796,41431,54757,41431,allow,70,70,0,1,5,1,0
50886,445,0,0,drop,70,70,0,1,0,1,0
54870,443,33932,443,allow,424,210,214,7,131,4,3
27005,1104,28939,1104,allow,870,126,744,2,29,1,1
58638,5900,0,0,deny,62,62,0,1,0,1,0
50584,17991,30598,17991,allow,161,161,0,2,1199,2,0
51430,443,37453,443,allow,7318,1585,5733,24,50,14,10
53372,445,0,0,drop,66,66,0,1,0,1,0
64676,53,19072,53,allow,276,94,182,2,30,1,1
53561,35885,5770,35885,allow,70,70,0,1,5,1,0
60426,80,65008,80,allow,4515,3889,626,11,27,6,5
56568,53,45144,53,allow,211,110,101,2,30,1,1
56147,53,61785,53,allow,258,110,148,2,30,1,1
63945,28291,25473,28291,allow,504,382,122,8,15,6,2
57750,37965,0,0,deny,62,62,0,1,0,1,0
53012,443,30523,443,allow,4073,2039,2034,14,135,7,7
123,123,22929,123,allow,184,94,90,2,29,1,1
64253,53,64253,53,allow,288,83,205,2,30,1,1
52163,14181,27565,14181,allow,70,70,0,1,5,1,0
55866,53,0,0,allow,86,86,0,1,30,1,0
52323,44847,0,0,deny,146,146,0,1,0,1,0
39244,36829,0,0,deny,62,62,0,1,0,1,0
45721,443,58682,443,allow,1925,1120,805,16,25,9,7
55694,62954,52341,62954,allow,504,318,186,8,15,5,3
51937,38056,49622,38056,allow,66,66,0,1,5,1,0
64679,53,50625,53,allow,172,88,84,2,31,1,1
52075,80,29185,80,allow,422,240,182,8,25,5,3
50239,53,31652,53,allow,183,94,89,2,31,1,1
59752,443,12592,443,allow,304,86,218,2,30,1,1
60398,443,6115,443,allow,8060,1868,6192,28,16,15,13
49908,56205,0,0,deny,62,62,0,1,0,1,0
65231,445,0,0,drop,70,70,0,1,0,1,0
56590,25174,0,0,deny,66,66,0,1,0,1,0
35517,443,27389,443,allow,130,70,60,3,5,2,1
65341,53,7483,53,allow,200,102,98,2,30,1,1
17750,55265,61135,55265,allow,481,150,331,2,1200,1,1
56381,25174,0,0,deny,62,62,0,1,0,1,0
55531,53,31789,53,allow,216,110,106,2,30,1,1
60342,80,14869,80,allow,2005,1094,911,11,87,6,5
10052,443,12703,443,allow,1832,1113,719,18,110,10,8
53836,445,0,0,drop,70,70,0,1,0,1,0
54595,443,41142,443,allow,5692,2502,3190,24,131,12,12
57425,53,41826,53,allow,168,86,82,2,30,1,1
52849,443,32844,443,allow,7735,1260,6475,16,133,7,9
49961,53,12419,53,allow,377,107,270,4,45,2,2
51816,27721,33144,27721,allow,70,70,0,2,8,2,0
2267,53,49774,53,allow,826,826,0,8,44,8,0
37641,443,55231,443,allow,8423,2244,6179,32,15,17,15
58808,445,0,0,drop,66,66,0,1,0,1,0
63284,445,0,0,drop,70,70,0,1,0,1,0
57129,445,0,0,drop,70,70,0,1,0,1,0
56906,53,55216,53,allow,167,86,81,2,31,1,1
49476,53,24497,53,allow,402,118,284,2,29,1,1
37917,443,55165,443,allow,6124,860,5264,18,361,9,9
65448,53,6069,53,allow,264,110,154,2,30,1,1
57139,443,39822,443,allow,2162,1317,845,16,25,9,7
49894,1433,0,0,deny,60,60,0,1,0,1,0
63966,443,14721,443,allow,22930,2512,20418,37,75,17,20
65029,53,39227,53,allow,214,102,112,2,29,1,1
50318,53,54870,53,allow,94,94,0,1,30,1,0
52138,25621,21857,25621,allow,70,70,0,1,5,1,0
62064,22114,0,0,deny,66,66,0,1,0,1,0
24949,47563,0,0,deny,145,145,0,1,0,1,0
62468,445,0,0,drop,70,70,0,1,0,1,0
64950,53,51754,53,allow,728,102,626,2,30,1,1
56570,443,57405,443,allow,4722,1330,3392,18,80,9,9
55728,445,0,0,drop,70,70,0,1,0,1,0
56913,53,26881,53,allow,193,102,91,2,30,1,1
53800,445,0,0,drop,70,70,0,1,0,1,0
59273,445,0,0,drop,70,70,0,1,0,1,0
55056,53,20306,53,allow,209,110,99,2,30,1,1
25653,26296,0,0,deny,148,148,0,1,0,1,0
49418,27015,62235,27015,allow,258,78,180,2,30,1,1
19116,53,19116,53,allow,398,255,143,3,33,2,1
53665,445,0,0,drop,70,70,0,1,0,1,0
58638,5900,0,0,deny,62,62,0,1,0,1,0
62937,30975,0,0,deny,185,185,0,1,0,1,0
57894,44847,0,0,deny,66,66,0,1,0,1,0
56111,53,49193,53,allow,179,94,85,2,31,1,1
50876,80,52453,80,allow,121344,7345,113999,144,141,61,83
58695,445,0,0,drop,70,70,0,1,0,1,0
49764,445,0,0,drop,66,66,0,1,0,1,0
61053,44847,0,0,deny,66,66,0,1,0,1,0
48996,22114,0,0,deny,146,146,0,1,0,1,0
61085,445,0,0,drop,66,66,0,1,0,1,0
53937,28506,44986,28506,allow,492,306,186,8,15,5,3
60469,53,22418,53,allow,78,78,0,1,30,1,0
17781,50265,0,0,deny,62,62,0,1,0,1,0
55547,445,0,0,drop,70,70,0,1,0,1,0
52108,20175,4699,20175,allow,66,66,0,1,5,1,0
49898,53,22442,53,allow,184,94,90,2,30,1,1
54615,445,0,0,drop,70,70,0,1,0,1,0
50580,80,50580,80,allow,18727,8262,10465,44,18,23,21
31017,50584,0,0,deny,62,62,0,1,0,1,0
63624,445,0,0,drop,70,70,0,1,0,1,0
5223,44091,0,0,deny,119,119,0,1,0,1,0
64817,53,59265,53,allow,199,94,105,2,29,1,1
51632,80,60453,80,allow,502,256,246,9,39,5,4
57319,53,46855,53,allow,353,94,259,2,30,1,1
50071,445,0,0,drop,70,70,0,1,0,1,0
33453,64147,0,0,deny,62,62,0,1,0,1,0
53139,445,0,0,drop,70,70,0,1,0,1,0
44125,5222,56837,5222,allow,6329,3447,2882,67,841,34,33
38280,443,38280,443,allow,3333,2072,1261,21,148,12,9
58244,445,0,0,drop,70,70,0,1,0,1,0
56969,53,8130,53,allow,754,94,660,2,31,1,1
49418,27015,35776,27015,allow,78,78,0,1,29,1,0
39055,53,10136,53,allow,289,86,203,2,30,1,1
52090,443,53299,443,allow,45583818,387905,45195913,35736,272,5246,30490
57098,1,0,0,deny,78,78,0,1,0,1,0
54474,445,0,0,drop,66,66,0,1,0,1,0
61411,443,46300,443,allow,4775,894,3881,18,28,10,8
65487,53,21256,53,allow,184,94,90,2,30,1,1
6666,3389,0,0,deny,60,60,0,1,0,1,0
26084,36237,0,0,deny,66,66,0,1,0,1,0
63944,30188,0,0,deny,66,66,0,1,0,1,0
60658,445,0,0,drop,70,70,0,1,0,1,0
34937,443,49817,443,allow,10059,2039,8020,23,186,12,11
41674,5900,0,0,deny,60,60,0,1,0,1,0
64824,36829,0,0,deny,66,66,0,1,0,1,0
59019,445,0,0,drop,66,66,0,1,0,1,0
60184,37965,0,0,deny,66,66,0,1,0,1,0
44993,53,47761,53,allow,168,78,90,2,30,1,1
64792,53,47254,53,allow,166,86,80,2,30,1,1
62673,34159,0,0,deny,66,66,0,1,0,1,0
27621,50584,0,0,deny,146,146,0,1,0,1,0
49667,53,34670,53,allow,183,94,89,2,29,1,1
58638,5900,0,0,deny,62,62,0,1,0,1,0
60433,443,40567,443,allow,7113,3977,3136,23,136,12,11
443,20087,0,0,deny,83,83,0,1,0,1,0
3521,6881,0,0,deny,62,62,0,1,0,1,0
50716,50584,0,0,deny,74,74,0,1,0,1,0
51774,16930,45672,16930,allow,70,70,0,2,8,2,0
49293,22,0,0,deny,60,60,0,1,0,1,0
16225,443,41335,443,allow,13126,5105,8021,37,31,21,16
58685,445,0,0,drop,70,70,0,1,0,1,0
53395,445,0,0,drop,70,70,0,1,0,1,0
51535,44847,0,0,deny,62,62,0,1,0,1,0
60814,443,39150,443,allow,740,222,518,11,3631,4,7
39447,443,60525,443,allow,7878,1909,5969,31,28,16,15
56312,53,57178,53,allow,214,102,112,2,29,1,1
55921,53,64539,53,allow,177,94,83,2,29,1,1
56583,445,0,0,drop,70,70,0,1,0,1,0
49734,445,0,0,drop,66,66,0,1,0,1,0
55026,443,23738,443,allow,11413,6823,4590,34,18,19,15
63125,445,0,0,drop,66,66,0,1,0,1,0
59823,445,0,0,drop,70,70,0,1,0,1,0
50645,53,59508,53,allow,177,94,83,2,30,1,1
54489,53,0,0,allow,418,154,264,4,33,2,2
64555,53,59391,53,allow,167,86,81,2,30,1,1
49472,53,37751,53,allow,210,110,100,2,30,1,1
64813,53,4341,53,allow,180,94,86,2,30,1,1
50316,25604,0,0,deny,62,62,0,1,0,1,0
58638,5900,0,0,deny,62,62,0,1,0,1,0
6889,40740,0,0,deny,143,143,0,1,0,1,0
64438,53,23542,53,allow,211,102,109,2,30,1,1
55688,33958,47150,33958,allow,70,70,0,2,8,2,0
1638,22114,0,0,deny,62,62,0,1,0,1,0
56136,53,4435,53,allow,733,94,639,2,30,1,1
5610,37965,0,0,deny,66,66,0,1,0,1,0
34212,11392,0,0,deny,66,66,0,1,0,1,0
3980,63710,0,0,deny,66,66,0,1,0,1,0
61580,53,48820,53,allow,275,94,181,2,29,1,1
61257,445,0,0,drop,70,70,0,1,0,1,0
50658,443,64697,443,allow,4876,2522,2354,22,83,13,9
62359,445,0,0,drop,66,66,0,1,0,1,0
51348,7000,51348,7000,allow,2163,676,1487,14,15,7,7
55341,445,0,0,drop,70,70,0,1,0,1,0
33664,80,64127,80,allow,3667,1654,2013,20,189,11,9
54327,7000,54327,7000,allow,3310,1535,1775,15,15,8,7
55475,80,10225,80,allow,350,210,140,6,27,4,2
45533,80,45533,80,allow,52365,3013,49352,53,51,13,40
58638,5900,0,0,deny,62,62,0,1,0,1,0
27005,27025,58786,27025,allow,1634,126,1508,4,31,2,2
60287,80,59923,80,allow,10135,7433,2702,28,164,19,9
64847,53,37930,53,allow,211,102,109,2,30,1,1
65330,445,0,0,drop,70,70,0,1,0,1,0
55833,53,8720,53,allow,177,94,83,2,30,1,1
52333,443,52333,443,allow,960,539,421,9,52,5,4
49890,443,3826,443,allow,6370237,150385,6219852,6047,138,1688,4359
11964,53,13321,53,allow,268,94,174,2,30,1,1
55859,53,29640,53,allow,210,110,100,2,30,1,1
50407,8080,50407,8080,allow,378,180,198,7,33,4,3
65514,53,6429,53,allow,212,108,104,2,31,1,1
55529,44847,0,0,deny,66,66,0,1,0,1,0
61077,445,0,0,drop,66,66,0,1,0,1,0
34734,5222,46866,5222,allow,7064,2904,4160,68,88,33,35
64404,445,0,0,drop,70,70,0,1,0,1,0
40689,443,13371,443,allow,4203,1564,2639,26,470,14,12
61294,445,0,0,drop,66,66,0,1,0,1,0
57033,53,22099,53,allow,216,110,106,2,30,1,1
6881,6881,44146,6881,allow,502,150,352,2,1199,1,1
50084,26672,0,0,deny,62,62,0,1,0,1,0
63903,445,0,0,drop,66,66,0,1,0,1,0
54237,443,5337,443,allow,499,425,74,4,0,3,1
53097,445,0,0,drop,70,70,0,1,0,1,0
1024,63737,0,0,deny,518,518,0,1,0,1,0
51764,33432,19826,33432,allow,70,70,0,2,8,2,0
49593,53,25320,53,allow,253,102,151,2,30,1,1
52154,445,0,0,drop,66,66,0,1,0,1,0
46000,53,44521,53,allow,164,78,86,2,31,1,1
49348,80,58488,80,allow,2695,601,2094,14,17,7,7
56661,445,0,0,drop,70,70,0,1,0,1,0
6881,6881,0,0,deny,146,146,0,1,0,1,0
55658,443,55658,443,allow,26504,10384,16120,58,48,37,21
49418,27017,19640,27017,allow,78,78,0,1,30,1,0
57616,80,57616,80,allow,266789,7684,259105,234,25,54,180
56557,53,47692,53,allow,214,110,104,2,30,1,1
1024,35894,0,0,deny,62,62,0,1,0,1,0
60380,443,8139,443,allow,70,70,0,2,8,2,0
51976,11816,28383,11816,allow,70,70,0,1,5,1,0
40334,443,51232,443,allow,8296,3123,5173,40,132,14,26
63910,44847,0,0,deny,66,66,0,1,0,1,0
65246,53,37552,53,allow,183,94,89,2,30,1,1
61938,443,14944,443,allow,7118,2462,4656,18,75,10,8
50606,443,59722,443,allow,1511,849,662,16,94,9,7
38644,443,1255,443,allow,2622,1399,1223,18,28,10,8
1070,26467,0,0,deny,62,62,0,1,0,1,0
64576,443,6624,443,allow,8503,1969,6534,24,32,13,11
51437,443,45199,443,allow,6286,1494,4792,22,16,11,11
63609,53,0,0,allow,182,81,101,2,30,1,1
42231,57470,0,0,deny,78,78,0,1,0,1,0
58879,443,4460,443,allow,5168,700,4468,16,15,7,9
52457,445,0,0,drop,70,70,0,1,0,1,0
50684,445,0,0,drop,70,70,0,1,0,1,0
49769,80,36678,80,allow,254,128,126,5,15,3,2
56940,445,0,0,drop,70,70,0,1,0,1,0
64703,53,15968,53,allow,314,92,222,4,31,2,2
49274,53,14620,53,allow,197,102,95,2,30,1,1
65494,53,0,0,deny,88,88,0,1,0,1,0
56444,445,0,0,drop,70,70,0,1,0,1,0
60606,3389,0,0,deny,60,60,0,1,0,1,0
3981,23117,0,0,deny,66,66,0,1,0,1,0
9402,53,9402,53,allow,237,91,146,2,32,1,1
65487,443,56960,443,allow,413465,12290,401175,427,16,150,277
51076,445,0,0,drop,70,70,0,1,0,1,0
50394,443,25886,443,allow,7584,1848,5736,19,29,10,9
60171,443,39238,443,allow,1059,556,503,12,25,6,6
31172,22114,0,0,deny,146,146,0,1,0,1,0
57228,8525,57228,8525,allow,138,78,60,2,5,1,1
56940,5900,0,0,deny,60,60,0,1,0,1,0
47943,50584,0,0,deny,74,74,0,1,0,1,0
50730,27029,7986,27029,allow,269,78,191,2,30,1,1
51929,53371,7224,53371,allow,70,70,0,2,8,2,0
64153,53,31839,53,allow,213,94,119,2,30,1,1
64894,53,1246,53,allow,550,113,437,4,46,2,2
1024,45129,0,0,deny,145,145,0,1,0,1,0
59315,35440,0,0,deny,62,62,0,1,0,1,0
54141,445,0,0,drop,66,66,0,1,0,1,0
61660,64097,0,0,deny,62,62,0,1,0,1,0
56852,6057,3356,6057,allow,2499,2499,0,22,300,22,0
9474,53,9474,53,allow,237,91,146,2,33,1,1
49343,53,20254,53,allow,478,106,372,4,48,2,2
64763,53,29524,53,allow,728,96,632,2,30,1,1
49414,443,63863,443,allow,43326,4905,38421,56,43,16,40
56736,443,32910,443,allow,7890,1901,5989,20,15,11,9
80,53945,0,0,deny,60,60,0,1,0,1,0
18725,35440,0,0,deny,146,146,0,1,0,1,0
25565,28739,0,0,deny,60,60,0,1,0,1,0
57282,53,14101,53,allow,199,102,97,2,30,1,1
36866,443,19337,443,allow,6798,2901,3897,22,151,13,9
7041,37965,0,0,deny,66,66,0,1,0,1,0
55667,19667,61736,19667,allow,70,70,0,1,5,1,0
49664,443,7925,443,allow,134,60,74,3,6,2,1
5588,5588,0,0,allow,3354,1792,1562,46,196,23,23
64473,53,45476,53,allow,184,94,90,2,30,1,1
13035,25174,0,0,deny,146,146,0,1,0,1,0
60055,443,24328,443,allow,2314,1232,1082,15,141,8,7
58678,445,0,0,drop,66,66,0,1,0,1,0
65304,53,46271,53,allow,209,110,99,2,30,1,1
64418,445,0,0,drop,70,70,0,1,0,1,0
63423,445,0,0,drop,70,70,0,1,0,1,0
36821,443,10604,443,allow,5948,1553,4395,16,15,10,6
1972,57470,0,0,deny,78,78,0,1,0,1,0
56333,53,59595,53,allow,209,110,99,2,31,1,1
13285,29892,0,0,deny,145,145,0,1,0,1,0
60417,55100,62868,55100,allow,164,70,94,2,5,1,1
54957,53,30594,53,allow,197,102,95,2,33,1,1
58638,5900,0,0,deny,62,62,0,1,0,1,0
64224,443,1301,443,allow,24320,6711,17609,45,122,20,25
55411,53,25352,53,allow,183,94,89,2,30,1,1
49765,53,11309,53,allow,194,102,92,2,30,1,1
58886,15000,23434,15000,allow,138,78,60,2,5,1,1
53671,60416,42593,60416,allow,70,70,0,2,7,2,0
58874,443,22621,443,allow,4738,1023,3715,18,66,10,8
51221,45722,40795,45722,allow,481,150,331,2,1200,1,1
49855,53,19600,53,allow,916,86,830,2,30,1,1
57332,53,59062,53,allow,184,102,82,2,30,1,1
59526,445,0,0,drop,70,70,0,1,0,1,0
52101,443,43263,443,allow,22696,18094,4602,41,315,25,16
56413,53,29873,53,allow,233,94,139,2,30,1,1
51656,53,51656,53,allow,198,89,109,2,30,1,1
62155,53,41278,53,allow,263,86,177,2,29,1,1
55391,53,35560,53,allow,210,110,100,2,31,1,1
61916,445,0,0,drop,66,66,0,1,0,1,0
49265,53,7053,53,allow,178,91,87,2,31,1,1
55496,64097,0,0,deny,66,66,0,1,0,1,0
56225,53,55911,53,allow,183,94,89,2,31,1,1
58396,443,53120,443,allow,138065,109491,28574,429,186,230,199
26900,27017,48615,27017,allow,422,164,258,6,30,3,3
60930,443,60930,443,allow,16379,2214,14165,39,18,20,19
54998,53,11974,53,allow,179,94,85,2,30,1,1
50132,445,0,0,drop,70,70,0,1,0,1,0
64355,53,3739,53,allow,213,102,111,2,30,1,1
61258,445,0,0,drop,66,66,0,1,0,1,0
65308,445,0,0,drop,70,70,0,1,0,1,0
57758,445,0,0,drop,70,70,0,1,0,1,0
62724,445,0,0,drop,70,70,0,1,0,1,0
41056,443,45681,443,allow,8185,1381,6804,22,831,11,11
53848,443,21534,443,allow,7015200,135026,6880174,6063,438,1252,4811
61392,50584,0,0,deny,62,62,0,1,0,1,0
50106,445,0,0,drop,70,70,0,1,0,1,0
58925,443,39506,443,allow,5167,700,4467,16,15,7,9
65208,445,0,0,drop,70,70,0,1,0,1,0
54471,36237,0,0,deny,66,66,0,1,0,1,0
62696,50584,0,0,deny,66,66,0,1,0,1,0
55122,53,24716,53,allow,173,94,79,2,30,1,1
59636,443,44710,443,allow,3197,1047,2150,15,120,8,7
64998,27037,18339,27037,allow,3287,2072,1215,12,30,6,6
3730,17372,0,0,deny,62,62,0,1,0,1,0
1054,57470,0,0,deny,62,62,0,1,0,1,0
14255,2767,0,0,deny,146,146,0,1,0,1,0
55651,445,0,0,drop,70,70,0,1,0,1,0
55588,49737,20798,49737,allow,504,318,186,8,15,5,3
8868,50584,0,0,deny,146,146,0,1,0,1,0
53971,55442,0,0,deny,62,62,0,1,0,1,0
63443,445,0,0,drop,70,70,0,1,0,1,0
56864,15646,51512,15646,allow,70,70,0,2,8,2,0
63885,445,0,0,drop,66,66,0,1,0,1,0
64344,53,48570,53,allow,286,102,184,4,46,2,2
62912,26467,0,0,deny,62,62,0,1,0,1,0
64555,53,23004,53,allow,297,102,195,4,48,2,2
49367,53,7025,53,allow,548,112,436,4,36,2,2
56957,445,0,0,drop,70,70,0,1,0,1,0
64548,445,0,0,drop,66,66,0,1,0,1,0
60823,25174,0,0,deny,66,66,0,1,0,1,0
56637,80,52477,80,allow,234,234,0,4,12,4,0
9957,32480,0,0,deny,66,66,0,1,0,1,0
56026,53,14279,53,allow,189,102,87,2,30,1,1
53972,445,0,0,drop,70,70,0,1,0,1,0
55066,443,16494,443,allow,39091,9981,29110,93,208,42,51
53259,123,17557,123,allow,184,94,90,2,31,1,1
60088,443,5059,443,allow,1000,557,443,11,141,6,5
40204,40003,21367,40003,allow,156,94,62,2,30,1,1
53576,23505,43782,23505,allow,70,70,0,2,7,2,0
37591,443,50251,443,allow,499,425,74,4,0,3,1
50964,445,0,0,drop,70,70,0,1,0,1,0
57942,443,1661,443,allow,2791,1800,991,26,185,15,11
56391,443,8649,443,allow,13706,5958,7748,78,202,42,36
62388,39004,0,0,deny,62,62,0,1,0,1,0
50378,443,15906,443,allow,8663,1983,6680,21,33,10,11
58010,445,0,0,drop,70,70,0,1,0,1,0
52188,1433,0,0,deny,60,60,0,1,0,1,0
37565,443,55641,443,allow,4898,1119,3779,17,30,9,8
49497,53,38810,53,allow,297,102,195,2,29,1,1
51399,443,28295,443,allow,642,582,60,2,5,1,1
60413,443,19866,443,allow,9398,2320,7078,24,77,13,11
60095,443,60308,443,allow,2357,1467,890,15,140,8,7
52851,445,0,0,drop,70,70,0,1,0,1,0
6881,6881,2586,6881,allow,237,118,119,2,1200,1,1
54521,445,0,0,drop,70,70,0,1,0,1,0
5830,22114,0,0,deny,66,66,0,1,0,1,0
34346,443,57407,443,allow,3497,1845,1652,18,15,9,9
58638,5900,0,0,deny,62,62,0,1,0,1,0
65398,53,61803,53,allow,212,108,104,2,30,1,1
56417,53,44124,53,allow,752,93,659,2,30,1,1
52848,445,0,0,drop,70,70,0,1,0,1,0
57176,53,43366,53,allow,178,94,84,2,30,1,1
56141,53,19077,53,allow,184,94,90,2,30,1,1
64967,53,21374,53,allow,389,134,255,2,30,1,1
53227,53,29917,53,allow,205,86,119,2,29,1,1
50485,445,0,0,drop,66,66,0,1,0,1,0
44690,443,54599,443,allow,1648,813,835,17,185,9,8
42412,443,55628,443,allow,204,70,134,4,26,2,2
55859,443,4096,443,allow,399086,26649,372437,488,462,156,332
10331,6881,0,0,deny,146,146,0,1,0,1,0
51815,445,0,0,drop,70,70,0,1,0,1,0
59788,443,27023,443,allow,248845,14935,233910,308,49,148,160
63968,53,26432,53,allow,200,102,98,2,30,1,1
60689,445,0,0,drop,70,70,0,1,0,1,0
56183,445,0,0,drop,70,70,0,1,0,1,0
51768,61765,15043,61765,allow,66,66,0,1,5,1,0
55451,53,40344,53,allow,816,102,714,2,29,1,1
56383,445,0,0,drop,70,70,0,1,0,1,0
30960,45686,49488,45686,allow,330,330,0,6,3609,6,0
60965,443,57735,443,allow,1439,718,721,15,111,8,7
54657,445,0,0,drop,70,70,0,1,0,1,0
50907,445,0,0,drop,70,70,0,1,0,1,0
55098,53,22759,53,allow,474,200,274,6,44,3,3
55232,445,0,0,drop,70,70,0,1,0,1,0
49903,53,65277,53,allow,231,110,121,2,30,1,1
41049,443,3441,443,allow,197239,6098,191141,213,170,75,138
56377,80,8742,80,allow,1633,943,690,15,72,8,7
57440,53,5992,53,allow,199,102,97,2,30,1,1
58638,5900,0,0,deny,62,62,0,1,0,1,0
49533,445,0,0,drop,70,70,0,1,0,1,0
50266,443,54511,443,allow,21634,11226,10408,54,402,35,19
0,0,0,0,allow,320,320,0,5,0,5,0
49359,445,0,0,drop,70,70,0,1,0,1,0
53240,443,24615,443,allow,46348,20067,26281,75,60,37,38
58076,21247,0,0,deny,66,66,0,1,0,1,0
13408,44847,0,0,deny,66,66,0,1,0,1,0
49919,443,28097,443,allow,4534,909,3625,16,32,8,8
51929,80,26646,80,allow,1213,821,392,8,15,6,2
49769,445,0,0,drop,70,70,0,1,0,1,0
33132,123,0,0,deny,234,234,0,1,0,1,0
50239,445,0,0,drop,66,66,0,1,0,1,0
60136,56205,0,0,deny,66,66,0,1,0,1,0
55843,445,0,0,drop,70,70,0,1,0,1,0
37573,443,7707,443,allow,13637,6347,7290,34,46,20,14
65262,53,31670,53,allow,216,110,106,2,30,1,1
57052,53,38641,53,allow,177,94,83,2,30,1,1
53075,445,0,0,drop,70,70,0,1,0,1,0
51885,64546,12386,64546,allow,66,66,0,1,5,1,0
57363,53,63578,53,allow,193,102,91,2,30,1,1
46669,80,58799,80,allow,1802,1488,314,11,16,6,5
64347,53,32269,53,allow,193,102,91,2,30,1,1
27005,27025,48292,27025,allow,1774,252,1522,5,31,3,2
61012,445,0,0,drop,70,70,0,1,0,1,0
19298,30188,0,0,deny,62,62,0,1,0,1,0
53244,445,0,0,drop,70,70,0,1,0,1,0
28754,50584,0,0,deny,62,62,0,1,0,1,0
65002,445,0,0,drop,70,70,0,1,0,1,0
56719,445,0,0,drop,66,66,0,1,0,1,0
53413,35440,0,0,deny,146,146,0,1,0,1,0
60337,30188,0,0,deny,66,66,0,1,0,1,0
61550,5529,0,0,deny,145,145,0,1,0,1,0
53447,443,53447,443,allow,960,539,421,9,30,5,4
58612,445,0,0,drop,66,66,0,1,0,1,0
27005,27020,57425,27020,allow,890,126,764,2,30,1,1
56508,80,35273,80,allow,318,192,126,6,30,4,2
9017,6881,0,0,deny,66,66,0,1,0,1,0
30353,53,30353,53,allow,200,90,110,2,30,1,1
51038,445,0,0,drop,70,70,0,1,0,1,0
53962,16251,51780,16251,allow,70,70,0,1,4,1,0
35212,443,35212,443,allow,4700,1793,2907,19,27,11,8
56496,53,28777,53,allow,193,102,91,2,30,1,1
36906,50584,0,0,deny,62,62,0,1,0,1,0
56317,53,56317,53,allow,216,82,134,2,32,1,1
55975,53,28209,53,allow,195,102,93,2,30,1,1
65324,53,23853,53,allow,748,94,654,2,30,1,1
60443,445,0,0,drop,70,70,0,1,0,1,0
60085,445,0,0,drop,70,70,0,1,0,1,0
12986,64147,0,0,deny,62,62,0,1,0,1,0
49591,445,0,0,drop,70,70,0,1,0,1,0
49926,53,46406,53,allow,333,90,243,4,41,2,2
5617,64147,0,0,deny,62,62,0,1,0,1,0
40182,443,51089,443,allow,6865,1958,4907,21,16,13,8
6889,24748,0,0,deny,143,143,0,1,0,1,0
59291,53,59291,53,allow,197,90,107,2,30,1,1
51090,445,0,0,drop,70,70,0,1,0,1,0
60337,445,0,0,drop,70,70,0,1,0,1,0
8976,44847,0,0,deny,62,62,0,1,0,1,0
61569,53,2254,53,allow,211,78,133,2,30,1,1
56341,3389,56341,3389,allow,3424,1710,1714,16,33,8,8
1972,57470,0,0,deny,78,78,0,1,0,1,0
49160,51839,39818,51839,allow,868,150,718,4,1200,2,2
6881,10104,0,0,deny,107,107,0,1,0,1,0
60781,40010,23139,40010,allow,316,136,180,6,5,3,3
57504,44847,0,0,deny,66,66,0,1,0,1,0
58638,5900,0,0,deny,62,62,0,1,0,1,0
61321,445,0,0,drop,66,66,0,1,0,1,0
57188,443,33520,443,allow,7162,1731,5431,29,32,14,15
56953,53,15670,53,allow,421,78,343,2,31,1,1
58843,445,0,0,drop,66,66,0,1,0,1,0
19875,30170,0,0,deny,145,145,0,1,0,1,0
62550,51505,0,0,deny,62,62,0,1,0,1,0
56603,53,17293,53,allow,179,94,85,2,30,1,1
53003,11392,0,0,deny,66,66,0,1,0,1,0
47164,15000,48096,15000,allow,130,70,60,2,5,1,1
39742,62413,0,0,deny,66,66,0,1,0,1,0
55246,31573,0,0,deny,66,66,0,1,0,1,0
65449,53,31955,53,allow,177,94,83,2,30,1,1
48436,443,64004,443,allow,9744,1958,7786,25,18,13,12
11337,15503,0,0,deny,62,62,0,1,0,1,0
53822,80,58040,80,allow,1655,1341,314,10,15,5,5
56748,445,0,0,drop,70,70,0,1,0,1,0
44414,23718,0,0,deny,66,66,0,1,0,1,0
49445,53,33858,53,allow,770,101,669,2,30,1,1
49476,7010,49476,7010,allow,4215,2090,2125,15,16,8,7
50330,80,61342,80,allow,736,670,66,6,15,5,1
49485,7080,49485,7080,allow,2960,432,2528,11,15,6,5
64789,53,49397,53,allow,199,102,97,2,30,1,1
65404,445,0,0,drop,70,70,0,1,0,1,0
52745,57866,0,0,deny,62,62,0,1,0,1,0
64975,27033,50776,27033,allow,734,462,272,2,30,1,1
58528,443,58528,443,allow,4672,1765,2907,19,29,11,8
57986,443,51773,443,allow,124014,6270,117744,175,27,69,106
62952,35440,0,0,deny,66,66,0,1,0,1,0
52998,445,0,0,drop,70,70,0,1,0,1,0
52003,80,22055,80,allow,16479,1820,14659,31,26,17,14
27005,27015,31409,27015,allow,891,126,765,2,31,1,1
52925,64147,0,0,deny,62,62,0,1,0,1,0
56366,443,56718,443,allow,7234,4345,2889,27,235,15,12
59709,445,0,0,drop,70,70,0,1,0,1,0
62817,445,0,0,drop,66,66,0,1,0,1,0
51963,21638,62624,21638,allow,70,70,0,2,8,2,0
49759,53,16085,53,allow,216,110,106,2,29,1,1
41429,50584,0,0,deny,66,66,0,1,0,1,0
62075,445,0,0,drop,70,70,0,1,0,1,0
55607,17820,29778,17820,allow,504,318,186,8,16,5,3
32704,46824,0,0,deny,66,66,0,1,0,1,0
65327,445,0,0,drop,70,70,0,1,0,1,0
123,123,40397,123,allow,184,94,90,2,30,1,1
55648,80,35736,80,allow,70,70,0,1,5,1,0
35685,123,34944,123,allow,184,94,90,2,30,1,1
43129,20220,0,0,deny,62,62,0,1,0,1,0
50650,445,0,0,drop,70,70,0,1,0,1,0
61049,53,17729,53,allow,525,150,375,6,33,3,3
53278,443,21560,443,allow,38395,6930,31465,56,30,27,29
63050,57470,0,0,deny,74,74,0,1,0,1,0
51746,17867,44740,17867,allow,136,136,0,3,14,3,0
14432,443,31078,443,allow,7420,1078,6342,21,75,11,10
47756,443,23688,443,allow,8504,4770,3734,46,196,25,21
57027,53,20222,53,allow,198,94,104,2,30,1,1
54570,445,0,0,drop,66,66,0,1,0,1,0
49199,8106,41963,8106,allow,370,190,180,6,15,3,3
7048,25174,0,0,deny,66,66,0,1,0,1,0
27005,27015,15962,27015,allow,906,126,780,2,30,1,1
50514,443,24194,443,allow,11554,3028,8526,34,86,19,15
58696,443,11326,443,allow,6889,4719,2170,25,330,14,11
55050,80,49586,80,allow,246,120,126,5,15,3,2
38406,443,5076,443,allow,564,292,272,9,26,5,4
49644,445,0,0,drop,70,70,0,1,0,1,0
65115,50584,0,0,deny,66,66,0,1,0,1,0
53754,445,0,0,drop,66,66,0,1,0,1,0
53807,28630,53835,28630,allow,70,70,0,2,8,2,0
53192,445,0,0,drop,66,66,0,1,0,1,0
54216,445,0,0,drop,70,70,0,1,0,1,0
52168,62118,2887,62118,allow,70,70,0,2,8,2,0
80,53945,0,0,deny,60,60,0,1,0,1,0
56710,53,52813,53,allow,177,94,83,2,30,1,1
55641,61762,29914,61762,allow,70,70,0,1,5,1,0
50376,53,40722,53,allow,196,102,94,2,30,1,1
52860,443,7208,443,allow,7683,2076,5607,42,131,21,21
64853,53,19289,53,allow,198,101,97,2,31,1,1
60244,80,21449,80,allow,1114,534,580,12,16,7,5
57333,53,18124,53,allow,342,110,232,2,30,1,1
56712,46824,0,0,deny,66,66,0,1,0,1,0
443,23133,0,0,deny,97,97,0,1,0,1,0
51880,8001,9632,8001,allow,86,86,0,1,30,1,0
64048,53,63585,53,allow,326,92,234,4,31,2,2
57514,53,51498,53,allow,168,78,90,2,30,1,1
58010,445,0,0,drop,70,70,0,1,0,1,0
53803,17637,1467,17637,allow,70,70,0,2,8,2,0
58638,5900,0,0,deny,62,62,0,1,0,1,0
57827,443,29156,443,allow,912754,34972,877782,1035,294,410,625
50249,443,46250,443,allow,6125,1674,4451,22,81,11,11
42298,58000,33594,58000,allow,596,256,340,10,30,5,5
58638,5900,0,0,deny,62,62,0,1,0,1,0
29021,23,0,0,deny,60,60,0,1,0,1,0
49851,53,2859,53,allow,306,88,218,4,32,2,2
59213,25174,0,0,deny,66,66,0,1,0,1,0
56332,53,33283,53,allow,199,102,97,2,29,1,1
55690,54233,5574,54233,allow,320,140,180,6,6,3,3
53885,50379,49864,50379,allow,492,306,186,8,15,5,3
61802,23,0,0,deny,60,60,0,1,0,1,0
34900,443,21666,443,allow,70,70,0,1,5,1,0
50854,445,0,0,drop,70,70,0,1,0,1,0
61719,445,0,0,drop,66,66,0,1,0,1,0
61135,445,0,0,drop,70,70,0,1,0,1,0
49686,53,35211,53,allow,182,93,89,2,30,1,1
53943,445,0,0,drop,70,70,0,1,0,1,0
56288,53,63412,53,allow,210,110,100,2,30,1,1
65267,445,0,0,drop,66,66,0,1,0,1,0
56397,53,62027,53,allow,179,94,85,2,30,1,1
19473,20467,44164,20467,allow,480,149,331,2,1200,1,1
27005,27015,60875,27015,allow,881,126,755,2,30,1,1
51895,445,0,0,drop,70,70,0,1,0,1,0
52724,64147,0,0,deny,62,62,0,1,0,1,0
7934,443,7934,443,allow,6593,3073,3520,27,82,14,13
55836,443,59611,443,allow,7519,2177,5342,16,136,8,8
58058,445,0,0,drop,66,66,0,1,0,1,0
50584,51414,36185,51414,allow,475,150,325,2,1200,1,1
58638,5900,0,0,deny,62,62,0,1,0,1,0
56459,53,20811,53,allow,209,110,99,2,30,1,1
61448,445,0,0,drop,66,66,0,1,0,1,0
57266,443,13002,443,allow,16452,7129,9323,44,47,25,19
65361,53,62352,53,allow,211,102,109,2,30,1,1
1143,25174,0,0,deny,62,62,0,1,0,1,0
64370,53,62116,53,allow,399,102,297,4,54,2,2
56887,53,63111,53,allow,177,94,83,2,30,1,1
55039,443,37835,443,allow,19775,1890,17885,40,80,17,23
54527,443,27649,443,allow,13132,7107,6025,45,174,23,22
993,54748,0,0,deny,66,66,0,1,0,1,0
64335,53,51507,53,allow,293,95,198,4,46,2,2
64631,445,0,0,drop,70,70,0,1,0,1,0
59020,9600,0,0,deny,60,60,0,1,0,1,0
55207,445,0,0,drop,70,70,0,1,0,1,0
54300,22114,0,0,deny,66,66,0,1,0,1,0
54035,445,0,0,drop,66,66,0,1,0,1,0
30270,37965,0,0,deny,62,62,0,1,0,1,0
59365,42873,0,0,deny,74,74,0,1,0,1,0
59999,443,10266,443,allow,1571,660,911,13,18,7,6
53960,61038,13704,61038,allow,552,306,246,9,14,5,4
55628,445,0,0,drop,66,66,0,1,0,1,0
63027,35440,0,0,deny,66,66,0,1,0,1,0
60045,80,49980,80,allow,1455,965,490,10,142,6,4
55179,53,42268,53,allow,172,88,84,2,31,1,1
65432,80,46367,80,allow,486,240,246,9,28,5,4
56086,53,3323,53,allow,172,94,78,2,29,1,1
56971,445,0,0,drop,70,70,0,1,0,1,0
51844,80,51844,80,allow,72734,3432,69302,83,25,31,52
54550,445,0,0,drop,70,70,0,1,0,1,0
51315,445,0,0,drop,66,66,0,1,0,1,0
7308,50584,0,0,deny,66,66,0,1,0,1,0
57397,53,42252,53,allow,735,88,647,2,31,1,1
52222,11516,64024,11516,allow,70,70,0,2,8,2,0
49818,445,0,0,drop,70,70,0,1,0,1,0
39313,37965,0,0,deny,62,62,0,1,0,1,0
50140,44847,0,0,deny,62,62,0,1,0,1,0
56430,53,37979,53,allow,193,102,91,2,30,1,1
61475,443,7125,443,allow,198481,12339,186142,247,64,112,135
53891,1056,54785,1056,allow,260,140,120,5,6,3,2
58962,445,0,0,drop,70,70,0,1,0,1,0
62102,443,56889,443,allow,3466,821,2645,11,121,5,6
49483,53,5607,53,allow,273,94,179,2,30,1,1
58810,443,59123,443,allow,5167,700,4467,16,15,7,9
52992,443,3497,443,allow,97763,8230,89533,131,150,49,82
55715,53,18469,53,allow,168,86,82,2,30,1,1
29577,64147,0,0,deny,62,62,0,1,0,1,0
55707,445,0,0,drop,70,70,0,1,0,1,0
58955,445,0,0,drop,66,66,0,1,0,1,0
57234,21247,0,0,deny,66,66,0,1,0,1,0
50263,445,0,0,drop,66,66,0,1,0,1,0
57348,445,0,0,drop,70,70,0,1,0,1,0
35550,53,45606,53,allow,164,78,86,2,30,1,1
55105,53,24892,53,allow,194,94,100,2,30,1,1
49177,53,53466,53,allow,735,88,647,2,30,1,1
53768,19067,41942,19067,allow,70,70,0,2,8,2,0
53418,445,0,0,drop,70,70,0,1,0,1,0
51756,64147,0,0,deny,62,62,0,1,0,1,0
57286,445,0,0,drop,70,70,0,1,0,1,0
25878,25174,0,0,deny,66,66,0,1,0,1,0
24301,6881,0,0,deny,146,146,0,1,0,1,0
64691,445,0,0,drop,70,70,0,1,0,1,0
27005,27017,1737,27017,allow,891,126,765,2,30,1,1
64162,22114,0,0,deny,146,146,0,1,0,1,0
5685,35440,0,0,deny,62,62,0,1,0,1,0
60273,445,0,0,drop,70,70,0,1,0,1,0
49390,53,61910,53,allow,210,110,100,2,30,1,1
56951,53,9479,53,allow,199,102,97,2,30,1,1
56624,53,34436,53,allow,177,94,83,2,30,1,1
58061,445,0,0,drop,70,70,0,1,0,1,0
53105,53,53105,53,allow,216,90,126,2,30,1,1
54221,57470,0,0,deny,66,66,0,1,0,1,0
56677,53,50989,53,allow,286,103,183,4,49,2,2
52715,443,38027,443,allow,164840,5975,158865,179,122,61,118
58711,53,20725,53,allow,277,78,199,2,30,1,1
50225,445,0,0,drop,70,70,0,1,0,1,0
64544,445,0,0,drop,70,70,0,1,0,1,0
50394,25174,0,0,deny,62,62,0,1,0,1,0
51925,443,7342,443,allow,16797,8530,8267,53,82,30,23
65063,445,0,0,drop,66,66,0,1,0,1,0
65353,53,4050,53,allow,177,94,83,2,29,1,1
55549,53,20623,53,allow,209,110,99,2,30,1,1
49653,445,0,0,drop,66,66,0,1,0,1,0
56432,53,34927,53,allow,458,188,270,6,30,3,3
53768,19067,20998,19067,allow,70,70,0,1,5,1,0
49456,445,0,0,drop,70,70,0,1,0,1,0
65484,53,32858,53,allow,195,102,93,2,30,1,1
6666,138,0,0,deny,60,60,0,1,0,1,0
58638,5900,0,0,deny,62,62,0,1,0,1,0
18749,53,18749,53,allow,370,238,132,3,32,2,1
55380,53,27233,53,allow,289,97,192,4,45,2,2
45908,33330,0,0,deny,60,60,0,1,0,1,0
37168,443,59171,443,allow,17716,5150,12566,48,21,25,23
49156,53,59173,53,allow,195,102,93,2,30,1,1
65284,445,0,0,drop,70,70,0,1,0,1,0
53241,443,45177,443,allow,1950,1176,774,18,103,11,7
5179,50265,0,0,deny,62,62,0,1,0,1,0
59216,445,0,0,drop,66,66,0,1,0,1,0
56080,443,20631,443,allow,3970,1726,2244,13,135,6,7
51118,80,35500,80,allow,366,240,126,7,21,5,2
53366,445,0,0,drop,70,70,0,1,0,1,0
50316,37965,0,0,deny,66,66,0,1,0,1,0
52443,445,0,0,drop,70,70,0,1,0,1,0
49847,445,0,0,drop,70,70,0,1,0,1,0
46230,53,46230,53,allow,257,101,156,2,33,1,1
36538,64147,0,0,deny,62,62,0,1,0,1,0
56192,445,0,0,drop,70,70,0,1,0,1,0
57470,1031,51778,1031,allow,402,132,270,6,1209,3,3
56849,443,44408,443,allow,7374,2085,5289,33,270,18,15
54472,80,34355,80,allow,13695,1377,12318,26,255,14,12
63702,445,0,0,drop,70,70,0,1,0,1,0
63527,50584,0,0,deny,66,66,0,1,0,1,0
64476,445,0,0,drop,70,70,0,1,0,1,0
6546,37965,0,0,deny,62,62,0,1,0,1,0
65317,51221,0,0,deny,78,78,0,1,0,1,0
50633,80,7997,80,allow,1717,1247,470,9,15,5,4
65515,445,0,0,drop,70,70,0,1,0,1,0
63569,62413,0,0,deny,66,66,0,1,0,1,0
62371,445,0,0,drop,70,70,0,1,0,1,0
35481,443,52517,443,allow,6804,1473,5331,33,258,15,18
58638,5900,0,0,deny,62,62,0,1,0,1,0
45077,443,30343,443,allow,9599,1234,8365,27,29,15,12
49418,27022,21779,27022,allow,71,71,0,1,30,1,0
56813,37092,33767,37092,allow,70,70,0,1,5,1,0
64840,53,3676,53,allow,193,102,91,2,30,1,1
56765,53,27082,53,allow,194,102,92,2,31,1,1
55868,445,0,0,drop,66,66,0,1,0,1,0
55570,44847,0,0,deny,66,66,0,1,0,1,0
59016,445,0,0,drop,70,70,0,1,0,1,0
53561,35885,64999,35885,allow,70,70,0,2,7,2,0
51421,443,61384,443,allow,9345,3051,6294,22,15,13,9
55695,445,0,0,drop,66,66,0,1,0,1,0
59001,80,22174,80,allow,1266,383,883,16,393,4,12
52867,53,61685,53,allow,184,86,98,2,30,1,1
60389,80,65223,80,allow,2499,531,1968,11,125,6,5
56121,53,26656,53,allow,338,110,228,2,30,1,1
55365,53,41996,53,allow,184,94,90,2,31,1,1
60756,445,0,0,drop,70,70,0,1,0,1,0
55538,445,0,0,drop,70,70,0,1,0,1,0
50113,445,0,0,drop,66,66,0,1,0,1,0
61362,443,33042,443,allow,8167,2671,5496,22,69,11,11
55570,53,55501,53,allow,341,134,207,2,30,1,1
56592,53,12698,53,allow,200,102,98,2,29,1,1
49783,53,20382,53,allow,174,89,85,2,31,1,1
1038,37965,0,0,deny,62,62,0,1,0,1,0
49198,64509,55959,64509,allow,70,70,0,1,5,1,0
53936,5915,56119,5915,allow,70,70,0,1,5,1,0
53628,445,0,0,drop,66,66,0,1,0,1,0
63819,18445,34551,18445,allow,70,70,0,1,4,1,0
56953,443,22328,443,allow,7245,1282,5963,16,135,7,9
64357,445,0,0,drop,70,70,0,1,0,1,0
56221,443,24462,443,allow,129824,16359,113465,185,459,79,106
61363,445,0,0,drop,66,66,0,1,0,1,0
49775,53,55039,53,allow,399,93,306,4,41,2,2
50692,445,0,0,drop,70,70,0,1,0,1,0
52786,445,0,0,drop,66,66,0,1,0,1,0
35999,443,44617,443,allow,670261,26523,643738,728,188,262,466
64609,53,7620,53,allow,250,86,164,4,30,2,2
65387,53,24725,53,allow,272,122,150,2,30,1,1
58638,5900,0,0,deny,62,62,0,1,0,1,0
50303,445,0,0,drop,66,66,0,1,0,1,0
9440,443,42891,443,allow,7573,1528,6045,22,33,11,11
21173,37965,0,0,deny,62,62,0,1,0,1,0
52523,445,0,0,drop,70,70,0,1,0,1,0
36712,53,0,0,allow,138,69,69,2,30,1,1
64461,31652,0,0,reset-both,62,62,0,1,0,1,0
55655,63670,50631,63670,allow,70,70,0,1,5,1,0
59051,27520,0,0,deny,62,62,0,1,0,1,0
49320,445,0,0,drop,70,70,0,1,0,1,0
50575,80,13060,80,allow,318,192,126,6,25,4,2
55201,445,0,0,drop,70,70,0,1,0,1,0
62739,445,0,0,drop,70,70,0,1,0,1,0
13868,53,13868,53,allow,215,80,135,2,34,1,1
57606,80,57606,80,allow,11536,3264,8272,29,37,15,14
58981,443,5501,443,allow,3155,836,2319,13,135,6,7
41037,55839,0,0,deny,157,157,0,1,0,1,0
49512,53,36100,53,allow,195,102,93,2,30,1,1
54080,443,18578,443,allow,6673,1531,5142,22,341,10,12
52103,80,61932,80,allow,68083,5515,62568,90,38,40,50
56937,53,52000,53,allow,181,94,87,2,33,1,1
51712,53203,62336,53203,allow,70,70,0,1,5,1,0
30246,51050,0,0,deny,146,146,0,1,0,1,0
993,49276,0,0,deny,129,129,0,1,0,1,0
58193,445,0,0,drop,66,66,0,1,0,1,0
56712,443,43897,443,allow,1540037,36876,1503161,1511,62,511,1000
63417,445,0,0,drop,70,70,0,1,0,1,0
25565,43088,0,0,deny,60,60,0,1,0,1,0
53947,445,0,0,drop,66,66,0,1,0,1,0
49767,53,46615,53,allow,200,102,98,2,31,1,1
53656,11119,0,0,deny,148,148,0,1,0,1,0
62231,445,0,0,drop,66,66,0,1,0,1,0
11030,17372,0,0,deny,62,62,0,1,0,1,0
54583,443,25809,443,allow,11307,7633,3674,25,163,18,7
62478,443,29633,443,allow,10391,7059,3332,27,27,15,12
59136,50584,0,0,deny,62,62,0,1,0,1,0
29951,34021,0,0,reset-both,62,62,0,1,0,1,0
64677,53,13173,53,allow,195,102,93,2,31,1,1
50353,445,0,0,drop,66,66,0,1,0,1,0
37592,443,51917,443,allow,9000,2566,6434,29,47,17,12
56385,53,22600,53,allow,249,85,164,4,55,2,2
24592,50584,0,0,deny,62,62,0,1,0,1,0
53973,50546,28275,50546,allow,2069,1081,988,12,16,7,5
51719,13715,5835,13715,allow,70,70,0,2,8,2,0
51142,80,61764,80,allow,1114,534,580,12,16,7,5
65238,53,15919,53,allow,168,86,82,2,31,1,1
61673,443,61673,443,allow,76863,6096,70767,103,17,49,54
50366,445,0,0,drop,70,70,0,1,0,1,0
64180,53,16774,53,allow,176,90,86,2,31,1,1
55776,53,11984,53,allow,271,93,178,4,32,2,2
55653,53,34737,53,allow,199,102,97,2,30,1,1
52114,64853,36038,64853,allow,70,70,0,1,5,1,0
1814,62413,0,0,deny,66,66,0,1,0,1,0
64971,53,64971,53,allow,218,85,133,2,30,1,1
62158,443,35160,443,allow,4975,2828,2147,14,135,7,7
61060,53,35678,53,allow,311,94,217,2,30,1,1
48706,23393,0,0,deny,60,60,0,1,0,1,0
64134,445,0,0,drop,70,70,0,1,0,1,0
64614,53,55438,53,allow,168,86,82,2,30,1,1
25565,42779,0,0,deny,60,60,0,1,0,1,0
55012,443,43376,443,allow,7249,1797,5452,29,32,17,12
61690,445,0,0,drop,66,66,0,1,0,1,0
65072,445,0,0,drop,70,70,0,1,0,1,0
61464,445,0,0,drop,66,66,0,1,0,1,0
58638,5900,0,0,deny,62,62,0,1,0,1,0
63878,22114,0,0,deny,146,146,0,1,0,1,0
2305,35440,0,0,deny,62,62,0,1,0,1,0
36933,23117,0,0,deny,62,62,0,1,0,1,0
52975,443,20822,443,allow,291803,6522,285281,284,113,58,226
50283,443,36964,443,allow,290,142,148,5,11,3,2
55463,445,0,0,drop,70,70,0,1,0,1,0
56377,51505,0,0,deny,66,66,0,1,0,1,0
62889,445,0,0,drop,66,66,0,1,0,1,0
58313,445,0,0,drop,66,66,0,1,0,1,0
55026,53,55024,53,allow,196,94,102,2,30,1,1
50260,53,44495,53,allow,168,86,82,2,30,1,1
49850,443,7446,443,allow,147320,5771,141549,184,72,73,111
40125,443,1221,443,allow,7000,1799,5201,20,256,12,8
65314,53,31001,53,allow,195,102,93,2,30,1,1
56786,53,65502,53,allow,817,102,715,2,30,1,1
50263,445,0,0,drop,70,70,0,1,0,1,0
61341,445,0,0,drop,70,70,0,1,0,1,0
61702,445,0,0,drop,66,66,0,1,0,1,0
49194,445,0,0,drop,70,70,0,1,0,1,0
57578,51221,0,0,deny,66,66,0,1,0,1,0
52515,80,55752,80,allow,4183,3603,580,14,15,8,6
49234,53,17767,53,allow,167,86,81,2,30,1,1
51453,64147,0,0,deny,62,62,0,1,0,1,0
52005,33191,35955,33191,allow,70,70,0,1,5,1,0
64601,80,64601,80,allow,56887,6820,50067,90,25,49,41
60954,443,45270,443,allow,62583,3743,58840,88,32,40,48
64561,445,0,0,drop,70,70,0,1,0,1,0
53176,58851,59130,58851,allow,70,70,0,2,8,2,0
57160,53,20461,53,allow,255,110,145,2,29,1,1
53030,56205,0,0,deny,66,66,0,1,0,1,0
62115,57470,0,0,deny,66,66,0,1,0,1,0
62972,445,0,0,drop,70,70,0,1,0,1,0
59809,443,46540,443,allow,35140,3700,31440,67,76,30,37
61202,35894,0,0,deny,66,66,0,1,0,1,0
32897,443,57512,443,allow,3166,936,2230,18,120,9,9
49449,53,15422,53,allow,216,110,106,2,30,1,1
56809,53,37761,53,allow,178,94,84,2,30,1,1
53781,445,0,0,drop,70,70,0,1,0,1,0
53035,443,38723,443,allow,20048,9134,10914,96,92,39,57
51511,445,0,0,drop,70,70,0,1,0,1,0
6881,35179,42052,35179,allow,228,118,110,2,1199,1,1
55729,53,33239,53,allow,199,102,97,2,30,1,1
9166,443,13455,443,allow,5242,902,4340,16,29,8,8
40204,40021,21562,40021,allow,148,86,62,2,31,1,1
22,44840,22,44840,allow,1427,1170,257,8,15,4,4
18642,42707,0,0,deny,145,145,0,1,0,1,0
55649,53,24364,53,allow,216,110,106,2,30,1,1
53914,44209,7956,44209,allow,1729,985,744,16,16,9,7
53246,443,25270,443,allow,6574,1935,4639,14,121,7,7
57791,445,0,0,drop,70,70,0,1,0,1,0
64662,445,0,0,drop,66,66,0,1,0,1,0
57136,53,60175,53,allow,209,110,99,2,29,1,1
65344,445,0,0,drop,70,70,0,1,0,1,0
53305,50584,0,0,deny,62,62,0,1,0,1,0
64771,53,46292,53,allow,793,101,692,2,30,1,1
52763,53,0,0,allow,296,87,209,2,30,1,1
24616,48983,0,0,deny,146,146,0,1,0,1,0
49286,53,14433,53,allow,184,94,90,2,30,1,1
64768,53,30874,53,allow,78,78,0,1,30,1,0
51865,61689,0,0,deny,62,62,0,1,0,1,0
63062,11392,0,0,deny,66,66,0,1,0,1,0
54720,445,0,0,drop,70,70,0,1,0,1,0
59703,445,0,0,drop,70,70,0,1,0,1,0
54383,445,0,0,drop,70,70,0,1,0,1,0
60632,445,0,0,drop,66,66,0,1,0,1,0
9528,44847,0,0,deny,62,62,0,1,0,1,0
54251,443,43085,443,allow,499,425,74,4,0,3,1
55529,445,0,0,drop,70,70,0,1,0,1,0
44513,443,46778,443,allow,3698,1302,2396,13,136,6,7
56367,53,12261,53,allow,900,110,790,2,29,1,1
27114,53,27114,53,allow,414,268,146,3,33,2,1
63526,3389,63526,3389,allow,4365,2581,1784,20,33,11,9
64116,445,0,0,drop,66,66,0,1,0,1,0
59274,445,0,0,drop,66,66,0,1,0,1,0
56617,53,16257,53,allow,286,94,192,2,30,1,1
2425,23117,0,0,deny,66,66,0,1,0,1,0
64502,53,19448,53,allow,198,101,97,2,31,1,1
44913,80,22574,80,allow,1270,387,883,16,393,4,12
54992,443,45267,443,allow,31183,3879,27304,52,19,26,26
4760,44847,0,0,deny,62,62,0,1,0,1,0
49312,53,34351,53,allow,767,102,665,2,31,1,1
55361,445,0,0,drop,66,66,0,1,0,1,0
49474,53,54970,53,allow,224,86,138,2,29,1,1
57470,50321,35732,50321,allow,490,149,341,2,1201,1,1
57139,53,32218,53,allow,166,86,80,2,30,1,1
35991,443,26374,443,allow,190,70,120,4,14,2,2
57588,445,0,0,drop,66,66,0,1,0,1,0
51547,445,0,0,drop,70,70,0,1,0,1,0
61426,80,34225,80,allow,214,140,74,4,41,3,1
29734,23,0,0,deny,60,60,0,1,0,1,0
52699,26467,0,0,deny,62,62,0,1,0,1,0
55269,53,18249,53,allow,102,102,0,1,30,1,0
44558,443,44558,443,allow,5480,2503,2977,20,15,11,9
6881,6881,43192,6881,allow,150,150,0,1,1200,1,0
54235,443,28529,443,allow,4665,2167,2498,23,16,12,11
54825,444,0,0,deny,60,60,0,1,0,1,0
52472,51221,0,0,deny,74,74,0,1,0,1,0
51690,80,20015,80,allow,1273,471,802,11,290,6,5
49380,53,50592,53,allow,377,110,267,2,31,1,1
56678,53,61385,53,allow,760,97,663,2,30,1,1
61440,445,0,0,drop,70,70,0,1,0,1,0
64016,53,50450,53,allow,183,94,89,2,30,1,1
55595,33677,1152,33677,allow,210,140,70,4,14,3,1
49752,53,64105,53,allow,193,102,91,2,30,1,1
49223,80,54325,80,allow,1793,1030,763,11,15,6,5
49450,443,58155,443,allow,8411,2042,6369,25,251,13,12
13062,52274,0,0,deny,66,66,0,1,0,1,0
43071,80,63845,80,allow,808,480,328,13,158,9,4
29178,35440,0,0,deny,62,62,0,1,0,1,0
43904,443,27046,443,allow,7552,2611,4941,24,360,13,11
52754,445,0,0,drop,70,70,0,1,0,1,0
59609,445,0,0,drop,66,66,0,1,0,1,0
53931,445,0,0,drop,66,66,0,1,0,1,0
56492,53,12334,53,allow,184,94,90,2,29,1,1
57534,445,0,0,drop,70,70,0,1,0,1,0
30046,15503,0,0,deny,62,62,0,1,0,1,0
50826,443,11870,443,allow,6601,1120,5481,17,115,9,8
56801,445,0,0,drop,70,70,0,1,0,1,0
41657,443,13161,443,allow,122547,6414,116133,160,81,61,99
59765,443,22401,443,allow,571,166,405,2,30,1,1
45908,3383,0,0,deny,60,60,0,1,0,1,0
52180,443,15332,443,allow,11127,1324,9803,24,75,12,12
49860,443,20445,443,allow,10754,2778,7976,38,59,19,19
65332,56205,0,0,deny,66,66,0,1,0,1,0
57969,42873,0,0,deny,66,66,0,1,0,1,0
3478,61463,0,0,deny,1094,1094,0,1,0,1,0
56491,445,0,0,drop,70,70,0,1,0,1,0
62597,445,0,0,drop,70,70,0,1,0,1,0
40903,5900,0,0,deny,60,60,0,1,0,1,0
58638,5900,0,0,deny,62,62,0,1,0,1,0
50100,53,17377,53,allow,734,94,640,2,30,1,1
50153,80,50079,80,allow,41846,1261,40585,45,75,13,32
47311,443,49307,443,allow,3398,2096,1302,19,16,10,9
58463,11392,0,0,deny,66,66,0,1,0,1,0
64588,53,11970,53,allow,193,102,91,2,29,1,1
52011,10722,14551,10722,allow,70,70,0,1,4,1,0
32342,62413,0,0,deny,66,66,0,1,0,1,0
443,32698,0,0,deny,89,89,0,1,0,1,0
11648,37965,0,0,deny,145,145,0,1,0,1,0
52973,57470,0,0,deny,74,74,0,1,0,1,0
50038,53,24889,53,allow,177,94,83,2,30,1,1
64748,53,54501,53,allow,183,94,89,2,30,1,1
9407,443,42706,443,allow,5697,503,5194,14,15,7,7
49577,53,36536,53,allow,242,94,148,2,30,1,1
64342,445,0,0,drop,70,70,0,1,0,1,0
55624,53,50480,53,allow,199,102,97,2,30,1,1
41794,41794,0,0,deny,308,308,0,1,0,1,0
55976,445,0,0,drop,70,70,0,1,0,1,0
48919,443,27329,443,allow,10338,3346,6992,27,19,15,12
49879,443,31980,443,allow,6121,1042,5079,21,53,11,10
65064,53,44516,53,allow,338,110,228,2,30,1,1
64016,25174,0,0,deny,62,62,0,1,0,1,0
43499,443,52568,443,allow,9685,2330,7355,23,15,12,11
53304,445,0,0,drop,66,66,0,1,0,1,0
50289,445,0,0,drop,70,70,0,1,0,1,0
0,0,0,0,allow,156,156,0,2,0,2,0
58166,445,0,0,drop,66,66,0,1,0,1,0
39995,443,64142,443,allow,6812,2910,3902,31,282,8,23
57259,53,43508,53,allow,199,102,97,2,30,1,1
43735,53,43735,53,allow,216,88,128,2,30,1,1
39532,443,10682,443,allow,345779,9537,336242,359,26,123,236
55958,53,14478,53,allow,212,102,110,2,30,1,1
53739,443,35645,443,allow,499,425,74,4,0,3,1
49733,80,1914,80,allow,4198,2450,1748,20,148,15,5
57183,53,22943,53,allow,178,94,84,2,29,1,1
65384,57470,0,0,deny,66,66,0,1,0,1,0
57837,443,45626,443,allow,9767,2606,7161,23,120,11,12
60218,445,0,0,drop,70,70,0,1,0,1,0
53751,443,64587,443,allow,61501,14276,47225,91,35,39,52
49569,80,41314,80,allow,454,262,192,8,44,5,3
50587,80,51672,80,allow,378,192,186,7,20,4,3
26900,27017,24961,27017,allow,168,82,86,2,30,1,1
55708,445,0,0,drop,70,70,0,1,0,1,0
53815,17290,25400,17290,allow,70,70,0,1,4,1,0
56252,53,39340,53,allow,228,110,118,2,30,1,1
62305,445,0,0,drop,70,70,0,1,0,1,0
56782,53,51814,53,allow,197,102,95,2,33,1,1
50438,53,8831,53,allow,199,102,97,2,29,1,1
53221,445,0,0,drop,66,66,0,1,0,1,0
54210,36237,0,0,deny,62,62,0,1,0,1,0
35078,53,22216,53,allow,198,93,105,2,30,1,1
64106,53,59908,53,allow,190,97,93,2,31,1,1
56938,53,31467,53,allow,452,101,351,4,36,2,2
65502,443,12498,443,allow,92573,4519,88054,105,16,39,66
56509,53,12733,53,allow,1165,94,1071,2,29,1,1
42386,443,56294,443,allow,12516,2906,9610,41,427,17,24
63670,64097,0,0,deny,66,66,0,1,0,1,0
49785,53,63638,53,allow,211,110,101,2,30,1,1
50798,445,0,0,drop,70,70,0,1,0,1,0
61307,445,0,0,drop,70,70,0,1,0,1,0
137,137,40295,137,allow,114,114,0,2,32,2,0
50223,53,39269,53,allow,165,86,79,2,30,1,1
54598,37965,0,0,deny,66,66,0,1,0,1,0
58928,443,59647,443,allow,6548,4210,2338,23,18,12,11
44945,80,24197,80,allow,1729,1287,442,7,15,5,2
48817,23944,48817,23944,allow,513,152,361,2,1201,1,1
41085,443,36619,443,allow,5553,1055,4498,19,121,9,10
60942,445,0,0,drop,70,70,0,1,0,1,0
53538,33791,33383,33791,allow,618,432,186,9,17,6,3
23969,57470,0,0,deny,62,62,0,1,0,1,0
5588,5588,0,0,allow,3354,1792,1562,46,193,23,23
62493,50584,0,0,deny,146,146,0,1,0,1,0
57043,53,5828,53,allow,735,88,647,2,31,1,1
5588,5588,0,0,allow,3354,1792,1562,46,192,23,23
53237,445,0,0,drop,66,66,0,1,0,1,0
50939,445,0,0,drop,66,66,0,1,0,1,0
50698,80,39680,80,allow,318,192,126,6,27,4,2
65443,445,0,0,drop,70,70,0,1,0,1,0
64587,53,36595,53,allow,167,86,81,2,31,1,1
49633,443,1902,443,allow,60196,10141,50055,122,33,62,60
60414,52559,64596,52559,allow,70,70,0,2,8,2,0
50966,443,44457,443,allow,7975,3304,4671,19,86,11,8
64288,53,10803,53,allow,182,93,89,2,31,1,1
65008,53,8162,53,allow,312,94,218,2,30,1,1
59907,445,0,0,drop,70,70,0,1,0,1,0
12465,9823,0,0,deny,146,146,0,1,0,1,0
53730,37965,0,0,deny,66,66,0,1,0,1,0
56261,445,0,0,drop,70,70,0,1,0,1,0
52164,443,52164,443,allow,20480,2066,18414,37,17,19,18
33649,123,62077,123,allow,184,94,90,2,30,1,1
52879,443,43280,443,allow,286404,12478,273926,379,118,130,249
42870,443,3034,443,allow,20248,1033,19215,28,3620,9,19
29064,23,0,0,deny,60,60,0,1,0,1,0
53362,23,0,0,deny,60,60,0,1,0,1,0
56615,53,58132,53,allow,170,87,83,2,30,1,1
50584,8999,32902,8999,allow,311,311,0,3,1199,3,0
51161,445,0,0,drop,70,70,0,1,0,1,0
36932,443,8229,443,allow,280,140,140,5,130,3,2
56824,55829,39772,55829,allow,70,70,0,1,5,1,0
52478,443,31557,443,allow,7985,2085,5900,18,121,8,10
64963,445,0,0,drop,70,70,0,1,0,1,0
12527,50584,0,0,deny,62,62,0,1,0,1,0
50318,445,0,0,drop,70,70,0,1,0,1,0
59626,443,63020,443,allow,5837,1982,3855,19,18,11,8
63469,64147,0,0,deny,62,62,0,1,0,1,0
61273,445,0,0,drop,70,70,0,1,0,1,0
65045,53,56055,53,allow,197,102,95,2,32,1,1
49349,53,12679,53,allow,405,110,295,4,38,2,2
54658,443,29655,443,allow,40096,3155,36941,50,135,19,31
56546,53,1301,53,allow,177,94,83,2,30,1,1
56745,443,12454,443,allow,8058,2038,6020,20,15,11,9
45395,53,0,0,allow,86,86,0,1,30,1,0
63441,445,0,0,drop,70,70,0,1,0,1,0
55365,53,11222,53,allow,214,110,104,2,29,1,1
55443,53,18885,53,allow,194,102,92,2,30,1,1
58778,443,47598,443,allow,5168,700,4468,16,15,7,9
56246,53,10681,53,allow,816,97,719,2,31,1,1
49430,53,28668,53,allow,332,99,233,4,45,2,2
46624,80,46624,80,allow,34504,2526,31978,45,156,16,29
56018,445,0,0,drop,70,70,0,1,0,1,0
50539,80,55226,80,allow,5912,3532,2380,15,31,8,7
62433,445,0,0,drop,70,70,0,1,0,1,0
55017,53,20456,53,allow,288,110,178,2,29,1,1
53589,445,0,0,drop,70,70,0,1,0,1,0
27005,30009,16373,30009,allow,889,126,763,2,31,1,1
54239,443,8377,443,allow,499,425,74,4,0,3,1
53513,51354,18257,51354,allow,70,70,0,1,4,1,0
63582,445,0,0,drop,66,66,0,1,0,1,0
51080,445,0,0,drop,66,66,0,1,0,1,0
36567,53,0,0,allow,86,86,0,1,30,1,0
56602,53,56281,53,allow,423,102,321,4,38,2,2
63676,445,0,0,drop,70,70,0,1,0,1,0
54127,445,0,0,drop,70,70,0,1,0,1,0
51966,25174,0,0,deny,62,62,0,1,0,1,0
50010,445,0,0,drop,70,70,0,1,0,1,0
56829,53,52849,53,allow,185,102,83,2,30,1,1
8889,49138,0,0,deny,60,60,0,1,0,1,0
11101,22114,0,0,deny,146,146,0,1,0,1,0
63949,53,18113,53,allow,195,102,93,2,31,1,1
49769,53,30329,53,allow,785,110,675,2,30,1,1
63815,11372,42999,11372,allow,504,382,122,8,16,6,2
49561,445,0,0,drop,70,70,0,1,0,1,0
57794,53,57794,53,allow,825,99,726,2,30,1,1
52630,445,0,0,drop,70,70,0,1,0,1,0
55710,5555,0,0,deny,60,60,0,1,0,1,0
50560,80,54497,80,allow,318,192,126,6,26,4,2
56883,53,30894,53,allow,184,94,90,2,29,1,1
64957,53,58925,53,allow,196,102,94,2,30,1,1
60884,445,0,0,drop,70,70,0,1,0,1,0
60416,445,0,0,drop,66,66,0,1,0,1,0
57772,50584,0,0,deny,66,66,0,1,0,1,0
45169,14037,0,0,deny,74,74,0,1,0,1,0
50203,80,15124,80,allow,4020,1978,2042,16,66,9,7
55284,443,12539,443,allow,2895,726,2169,10,121,5,5
59889,30188,0,0,deny,66,66,0,1,0,1,0
0,0,0,0,deny,60,60,0,1,0,1,0
57862,445,0,0,drop,70,70,0,1,0,1,0
10103,443,54343,443,allow,6334,910,5424,20,360,10,10
51582,48817,0,0,deny,66,66,0,1,0,1,0
5955,55160,0,0,deny,74,74,0,1,0,1,0
52118,443,25040,443,allow,22072,2166,19906,44,49,22,22
58950,443,1545,443,allow,5108,700,4408,15,15,7,8
55179,53,34684,53,allow,182,93,89,2,31,1,1
52348,62413,0,0,deny,66,66,0,1,0,1,0
50106,30317,0,0,deny,66,66,0,1,0,1,0
61323,23117,0,0,deny,62,62,0,1,0,1,0
62984,8920,64791,8920,allow,829,583,246,9,15,5,4
51543,445,0,0,drop,70,70,0,1,0,1,0
62635,445,0,0,drop,70,70,0,1,0,1,0
51911,14543,20500,14543,allow,70,70,0,1,5,1,0
5774,37965,0,0,deny,66,66,0,1,0,1,0
51169,443,52987,443,allow,21686,7655,14031,77,379,40,37
50504,443,62477,443,allow,6051,1149,4902,16,25,9,7
57242,53,53275,53,allow,184,86,98,2,29,1,1
56561,53,4757,53,allow,166,85,81,2,31,1,1
50280,53,42526,53,allow,794,102,692,2,30,1,1
50911,80,6093,80,allow,13780884,170419,13610465,11542,134,2387,9155
38700,443,49227,443,allow,130,70,60,2,14,1,1
63696,445,0,0,drop,66,66,0,1,0,1,0
54666,445,0,0,drop,66,66,0,1,0,1,0
53270,445,0,0,drop,70,70,0,1,0,1,0
51853,80,50403,80,allow,4903,4061,842,11,26,6,5
64211,445,0,0,drop,66,66,0,1,0,1,0
23151,53,23151,53,allow,194,87,107,2,31,1,1
49596,80,27800,80,allow,312,192,120,6,41,4,2
58596,445,0,0,drop,70,70,0,1,0,1,0
50594,445,0,0,drop,66,66,0,1,0,1,0
63101,445,0,0,drop,70,70,0,1,0,1,0
20005,37965,0,0,deny,62,62,0,1,0,1,0
27005,27015,54928,27015,allow,882,126,756,2,30,1,1
58833,445,0,0,drop,70,70,0,1,0,1,0
52014,20524,1318,20524,allow,70,70,0,2,8,2,0
55005,53,53050,53,allow,183,94,89,2,29,1,1
62629,445,0,0,drop,70,70,0,1,0,1,0
59435,37807,0,0,deny,66,66,0,1,0,1,0
50195,445,0,0,drop,70,70,0,1,0,1,0
55742,53,3708,53,allow,780,93,687,2,30,1,1
56362,53,31120,53,allow,195,102,93,2,29,1,1
63627,26296,0,0,deny,159,159,0,1,0,1,0
56008,53,22150,53,allow,230,86,144,2,30,1,1
60980,445,0,0,drop,70,70,0,1,0,1,0
52048,443,14008,443,allow,3182,1568,1614,8,120,4,4
56427,53,19551,53,allow,166,86,80,2,30,1,1
65127,53,25987,53,allow,780,104,676,2,31,1,1
60597,53,0,0,allow,344,94,250,2,30,1,1
54883,60043,0,0,deny,62,62,0,1,0,1,0
53375,53,19528,53,allow,298,86,212,2,30,1,1
36765,80,13699,80,allow,2272,1679,593,10,34,6,4
8080,37965,0,0,deny,62,62,0,1,0,1,0
50024,445,0,0,drop,70,70,0,1,0,1,0
49418,27015,26023,27015,allow,78,78,0,1,30,1,0
55705,53,50083,53,allow,209,110,99,2,30,1,1
62117,445,0,0,drop,70,70,0,1,0,1,0
51221,44710,11229,44710,allow,481,150,331,2,1200,1,1
63793,48970,37013,48970,allow,70,70,0,1,4,1,0
64116,443,49764,443,allow,7439,1156,6283,19,75,11,8
33404,443,64550,443,allow,4152,2734,1418,24,40,14,10
59897,443,39118,443,allow,9919,4495,5424,53,118,30,23
26944,443,13934,443,allow,6861,2224,4637,19,19,9,10
56202,53,55288,53,allow,819,102,717,2,29,1,1
53542,50321,25266,50321,allow,320,140,180,6,6,3,3
42298,40039,27373,40039,allow,148,86,62,2,30,1,1
57795,445,0,0,drop,66,66,0,1,0,1,0
57470,6881,62721,6881,allow,150,150,0,1,1200,1,0
55127,53,60626,53,allow,253,87,166,4,44,2,2
49160,16767,65061,16767,allow,854,150,704,4,1200,2,2
51866,443,8681,443,allow,2449,1794,655,17,31,10,7
55849,53,54594,53,allow,195,102,93,2,30,1,1
64102,445,0,0,drop,70,70,0,1,0,1,0
49157,53,54699,53,allow,184,94,90,2,30,1,1
55085,445,0,0,drop,66,66,0,1,0,1,0
41480,443,25670,443,allow,6004,1688,4316,22,29,13,9
52043,443,36100,443,allow,7847,1904,5943,21,361,10,11
53201,443,8091,443,allow,3907,2251,1656,16,321,8,8
60186,445,0,0,drop,70,70,0,1,0,1,0
44246,80,45320,80,allow,5584,2543,3041,20,27,11,9
60361,57470,0,0,deny,66,66,0,1,0,1,0
62730,443,41025,443,allow,12539,6472,6067,81,406,37,44
40620,443,2727,443,allow,7049,1412,5637,24,16,14,10
65012,2767,0,0,deny,66,66,0,1,0,1,0
49708,445,0,0,drop,70,70,0,1,0,1,0
44919,26467,0,0,deny,62,62,0,1,0,1,0
49672,80,15007,80,allow,3749,2453,1296,15,41,9,6
41577,53,15196,53,allow,168,78,90,2,30,1,1
65497,53,55657,53,allow,197,102,95,2,29,1,1
55387,53,15050,53,allow,195,94,101,2,29,1,1
49634,80,5183,80,allow,318,192,126,6,42,4,2
57633,50584,0,0,deny,62,62,0,1,0,1,0
56015,53,12325,53,allow,195,102,93,2,31,1,1
56539,443,14998,443,allow,52465,2787,49678,66,80,26,40
49197,53,27457,53,allow,751,95,656,2,30,1,1
48817,36292,48817,36292,allow,519,158,361,2,1200,1,1
2704,37,0,0,deny,60,60,0,1,0,1,0
14148,1,0,0,deny,66,66,0,1,0,1,0
27005,27016,3846,27016,allow,889,126,763,2,30,1,1
38291,443,42711,443,allow,6737,1006,5731,20,162,11,9
58671,445,0,0,drop,70,70,0,1,0,1,0
62804,445,0,0,drop,70,70,0,1,0,1,0
58865,443,15727,443,allow,10775,7126,3649,31,17,17,14
64752,53,43912,53,allow,210,94,116,2,30,1,1
9467,443,18809,443,allow,5960,438,5522,16,15,6,10
56926,53,49989,53,allow,747,93,654,2,31,1,1
35849,30188,0,0,deny,62,62,0,1,0,1,0
50845,445,0,0,drop,66,66,0,1,0,1,0
55596,53,25789,53,allow,194,102,92,2,31,1,1
57012,80,14292,80,allow,214,140,74,4,31,3,1
51772,59814,12241,59814,allow,70,70,0,2,8,2,0
49732,443,11249,443,allow,592433,191668,400765,1555,1157,608,947
49878,24855,0,0,allow,66,66,0,1,91,1,0
50000,53,40875,53,allow,263,110,153,2,30,1,1
57708,445,0,0,drop,70,70,0,1,0,1,0
56567,53,56060,53,allow,188,96,92,2,31,1,1
55466,53,2778,53,allow,170,87,83,2,30,1,1
45535,25174,0,0,deny,62,62,0,1,0,1,0
59762,53,43399,53,allow,401,86,315,2,30,1,1
55752,443,54224,443,allow,11823,4029,7794,25,143,12,13
49450,53,27588,53,allow,227,94,133,2,29,1,1
61113,27045,31501,27045,allow,1680,1386,294,7,30,4,3
51221,27048,22916,27048,allow,132,132,0,3,1200,3,0
61222,445,0,0,drop,70,70,0,1,0,1,0
56427,53,25251,53,allow,178,94,84,2,29,1,1
52155,63867,51864,63867,allow,70,70,0,2,7,2,0
62360,445,0,0,drop,70,70,0,1,0,1,0
50895,445,0,0,drop,66,66,0,1,0,1,0
55110,445,0,0,drop,66,66,0,1,0,1,0
53522,8765,27669,8765,allow,199,75,124,4,59,2,2
55896,53,64776,53,allow,168,86,82,2,30,1,1
56225,53,65429,53,allow,194,102,92,2,29,1,1
61069,445,0,0,drop,70,70,0,1,0,1,0
64532,53,56480,53,allow,258,110,148,2,30,1,1
63945,53,11861,53,allow,216,110,106,2,31,1,1
58075,445,0,0,drop,70,70,0,1,0,1,0
64308,53,43760,53,allow,181,86,95,2,30,1,1
53912,443,53912,443,allow,4447,1540,2907,19,30,11,8
27242,443,3447,443,allow,19477,14323,5154,45,309,22,23
50465,80,50465,80,allow,202622,12371,190251,264,22,132,132
57982,25174,0,0,deny,62,62,0,1,0,1,0
44901,443,19443,443,allow,11891,6219,5672,35,174,16,19
50265,41198,60886,41198,allow,330,330,0,6,1200,6,0
61433,443,33532,443,allow,41274,18956,22318,90,171,43,47
56680,161,0,0,allow,15721,6203,9518,50,30,25,25
43840,50265,0,0,deny,72,72,0,1,0,1,0
34378,443,1903,443,allow,11269403,319214,10950189,11392,382,3773,7619
48266,80,46749,80,allow,130,70,60,2,15,1,1
32520,50265,0,0,deny,145,145,0,1,0,1,0
58572,445,0,0,drop,66,66,0,1,0,1,0
50119,443,44388,443,allow,10557,2063,8494,40,144,22,18
58822,443,40826,443,allow,3594,1787,1807,31,163,17,14
60743,443,59766,443,allow,7028,2639,4389,23,16,12,11
39820,443,15397,443,allow,2642442,95056,2547386,2730,3629,999,1731
27996,80,2657,80,allow,2058,589,1469,10,45,6,4
57484,30317,0,0,deny,66,66,0,1,0,1,0
57054,53,52774,53,allow,241,94,147,2,29,1,1
51823,15843,53132,15843,allow,66,66,0,2,9,2,0
40787,57470,0,0,deny,62,62,0,1,0,1,0
58638,5900,0,0,deny,62,62,0,1,0,1,0
46346,35440,0,0,deny,66,66,0,1,0,1,0
51845,80,51845,80,allow,28037,2069,25968,40,26,16,24
52113,19619,23788,19619,allow,70,70,0,2,8,2,0
49854,443,54861,443,allow,5089,1037,4052,20,61,11,9
11488,22114,0,0,deny,62,62,0,1,0,1,0
57533,445,0,0,drop,66,66,0,1,0,1,0
64800,53,3701,53,allow,343,92,251,4,50,2,2
17824,53,17824,53,allow,244,98,146,2,32,1,1
54217,445,0,0,drop,66,66,0,1,0,1,0
49826,53,43562,53,allow,466,192,274,6,83,3,3
49800,53,35452,53,allow,485,93,392,4,48,2,2
3529,25773,0,0,reset-both,143,143,0,1,0,1,0
55922,53,13122,53,allow,184,94,90,2,29,1,1
64997,445,0,0,drop,70,70,0,1,0,1,0
54057,445,0,0,drop,66,66,0,1,0,1,0
63425,443,8137,443,allow,22815,20019,2796,55,81,31,24
50385,443,20761,443,allow,11098,2853,8245,25,33,12,13
65020,53,48553,53,allow,184,94,90,2,30,1,1
56111,53,53180,53,allow,174,89,85,2,31,1,1
19245,64147,0,0,deny,66,66,0,1,0,1,0
49547,53,39009,53,allow,193,102,91,2,30,1,1
51755,445,0,0,drop,66,66,0,1,0,1,0
56474,80,38347,80,allow,8790,1387,7403,17,134,9,8
49564,53,13171,53,allow,193,102,91,2,29,1,1
49568,80,26293,80,allow,1515,481,1034,11,15,6,5
51438,445,0,0,drop,66,66,0,1,0,1,0
30651,53,22880,53,allow,86,86,0,1,30,1,0
53406,44847,0,0,deny,66,66,0,1,0,1,0
50830,445,0,0,drop,70,70,0,1,0,1,0
62418,445,0,0,drop,66,66,0,1,0,1,0
46633,53,46633,53,allow,237,91,146,2,32,1,1
65378,53,28736,53,allow,770,102,668,2,30,1,1
47110,80,30489,80,allow,436,222,214,7,19,4,3
54390,445,0,0,drop,66,66,0,1,0,1,0
65530,53,42402,53,allow,194,102,92,2,30,1,1
64381,445,0,0,drop,70,70,0,1,0,1,0
61148,37965,0,0,deny,66,66,0,1,0,1,0
49556,445,0,0,drop,70,70,0,1,0,1,0
49469,53,45496,53,allow,177,94,83,2,30,1,1
50292,443,41099,443,allow,183024,16754,166270,247,28,114,133
10754,28793,0,0,deny,66,66,0,1,0,1,0
49993,445,0,0,drop,70,70,0,1,0,1,0
49418,27015,55530,27015,allow,244,78,166,2,30,1,1
36617,443,29137,443,allow,16276,14463,1813,33,95,20,13
64503,53,37724,53,allow,209,102,107,2,30,1,1
64811,53,21833,53,allow,193,102,91,2,30,1,1
65290,3389,65290,3389,allow,3327,1438,1889,15,16,8,7
55230,53,36374,53,allow,182,93,89,2,30,1,1
54827,443,62409,443,allow,11291,2426,8865,21,121,10,11
47834,443,47834,443,allow,4716,1809,2907,19,26,11,8
55809,443,31063,443,allow,62,62,0,1,4,1,0
55114,53,53852,53,allow,392,100,292,4,33,2,2
65098,53,21613,53,allow,740,93,647,2,31,1,1
49113,443,18821,443,allow,6318,877,5441,23,396,8,15
54385,445,0,0,drop,70,70,0,1,0,1,0
46684,80,18811,80,allow,4294,1112,3182,15,199,4,11
37561,80,40884,80,allow,1630,918,712,12,16,7,5
56192,53,12282,53,allow,282,87,195,4,45,2,2
1027,64147,0,0,deny,62,62,0,1,0,1,0
50227,57470,0,0,deny,66,66,0,1,0,1,0
36815,443,48632,443,allow,416,210,206,7,29,4,3
46438,443,46438,443,allow,5337,2090,3247,22,39,13,9
49461,53,38932,53,allow,198,102,96,2,29,1,1
5222,27389,0,0,deny,66,66,0,1,0,1,0
62919,9694,0,0,deny,146,146,0,1,0,1,0
45964,2666,0,0,deny,60,60,0,1,0,1,0
34220,443,12969,443,allow,7946,2731,5215,27,18,15,12
44368,53,44368,53,allow,233,91,142,2,30,1,1
54067,443,60829,443,allow,113020,6140,106880,149,202,66,83
57332,443,64135,443,allow,2687,1728,959,23,15,12,11
27005,27015,34659,27015,allow,899,126,773,2,30,1,1
49337,53,49651,53,allow,199,102,97,2,30,1,1
55075,443,61643,443,allow,2459,1608,851,17,25,9,8
60817,443,60817,443,allow,1320,685,635,14,180,7,7
6889,55108,0,0,deny,143,143,0,1,0,1,0
51295,445,0,0,drop,70,70,0,1,0,1,0
58638,5900,0,0,deny,62,62,0,1,0,1,0
10036,44847,0,0,deny,66,66,0,1,0,1,0
49488,53,56220,53,allow,194,102,92,2,31,1,1
56572,53,22035,53,allow,177,94,83,2,29,1,1
52079,443,42023,443,allow,4735,3589,1146,18,15,10,8
45314,80,7495,80,allow,72376,2899,69477,79,16,29,50
53272,80,30742,80,allow,11060,3925,7135,24,108,13,11
50135,50584,0,0,deny,62,62,0,1,0,1,0
56127,37965,0,0,deny,66,66,0,1,0,1,0
56797,445,0,0,drop,70,70,0,1,0,1,0
63197,445,0,0,drop,70,70,0,1,0,1,0
61576,445,0,0,drop,66,66,0,1,0,1,0
53877,445,0,0,drop,70,70,0,1,0,1,0
60760,20010,11977,20010,allow,70,70,0,1,5,1,0
62951,445,0,0,drop,66,66,0,1,0,1,0
64475,53,56794,53,allow,184,94,90,2,31,1,1
22948,26467,0,0,deny,62,62,0,1,0,1,0
54071,53,10458,53,allow,207,86,121,2,30,1,1
15164,53,15164,53,allow,217,82,135,2,31,1,1
57339,445,0,0,drop,70,70,0,1,0,1,0
41233,443,15671,443,allow,1807,1048,759,16,26,8,8
52094,443,49643,443,allow,3296065,47110,3248955,2746,51,533,2213
53870,24535,51626,24535,allow,70,70,0,1,5,1,0
57617,53,32772,53,allow,164,78,86,2,30,1,1
51651,53,58120,53,allow,237,86,151,2,29,1,1
40840,21247,0,0,deny,62,62,0,1,0,1,0
56375,53,53548,53,allow,184,102,82,2,30,1,1
64709,53,12288,53,allow,229,110,119,2,30,1,1
59583,445,0,0,drop,66,66,0,1,0,1,0
59726,445,0,0,drop,70,70,0,1,0,1,0
62285,445,0,0,drop,70,70,0,1,0,1,0
57470,9273,56118,9273,allow,491,150,341,2,1199,1,1
58470,445,0,0,drop,70,70,0,1,0,1,0
53681,31466,64750,31466,allow,70,70,0,2,8,2,0
56835,35894,0,0,deny,66,66,0,1,0,1,0
50426,445,0,0,drop,66,66,0,1,0,1,0
