Source Port,Destination Port,NAT Source Port,NAT Destination Port,Bytes,Bytes Sent,Bytes Received,Packets,Elapsed Time (sec),pkts_sent,pkts_received
54,1888,0,0,62,62,0,1,0,1,0
21836,26,16142,16,3182,1568,1614,8,120,4,4
21920,1215,0,0,62,62,0,1,0,1,0
12782,28,0,0,70,70,0,1,0,1,0
11406,10,26177,9,168,78,90,2,30,1,1
12005,2046,25395,1573,70,70,0,1,5,1,0
14980,10,5074,9,819,102,717,2,30,1,1
14342,26,7709,16,11626,4173,7453,25,121,12,13
22564,10,22093,9,197,102,95,2,31,1,1
12684,1017,0,0,66,66,0,1,0,1,0
14212,28,0,0,70,70,0,1,0,1,0
14967,10,5697,9,170,87,83,2,31,1,1
8,2234,0,0,66,66,0,1,0,1,0
15761,10,25268,9,220,90,130,2,30,1,1
14392,10,4052,9,770,101,669,2,30,1,1
20076,1880,0,0,66,66,0,1,0,1,0
9415,15,20261,11,1606,823,783,12,121,7,5
17999,10,0,0,248,75,173,2,30,1,1
17978,26,14008,16,502,250,252,9,26,5,4
15817,2611,0,0,66,66,0,1,0,1,0
9701,28,0,0,70,70,0,1,0,1,0
3297,26,16280,16,970703,43045,927658,1244,141,563,681
9002,28,0,0,70,70,0,1,0,1,0
4904,183,16406,121,293,223,70,4,1,3,1
4296,26,12702,16,8714,1606,7108,24,34,12,12
21297,10,14870,9,196,102,94,2,30,1,1
532,247,0,0,3354,1792,1562,46,195,23,23
14386,10,21755,9,177,94,83,2,30,1,1
21867,28,0,0,70,70,0,1,0,1,0
15204,10,25694,9,182,93,89,2,30,1,1
15499,15,19961,11,214,140,74,4,25,3,1
11963,10,0,0,168,74,94,2,29,1,1
15580,15,14390,11,214,140,74,4,31,3,1
9368,10,19101,9,751,95,656,2,31,1,1
14855,28,0,0,70,70,0,1,0,1,0
15242,10,19951,9,168,86,82,2,30,1,1
8678,15,7552,11,2225,1649,576,10,38,6,4
8997,28,0,0,70,70,0,1,0,1,0
21229,10,12837,9,195,102,93,2,31,1,1
21416,10,20797,9,193,102,91,2,30,1,1
18121,26,24135,16,4962,2551,2411,19,144,10,9
10141,15,22290,11,1905,1456,449,10,20,6,4
15526,15,13368,11,37311,3340,33971,52,65,26,26
5391,15,2498,11,1403,651,752,10,16,6,4
246,509,0,0,62,62,0,1,0,1,0
21490,10,24658,9,266,110,156,2,30,1,1
10715,15,9646,11,1515,481,1034,11,15,6,5
16559,28,0,0,66,66,0,1,0,1,0
7088,26,39,16,11156,3899,7257,31,234,17,14
12086,28,0,0,70,70,0,1,0,1,0
8713,10,21745,9,193,102,91,2,30,1,1
7278,10,19821,9,217,87,130,2,30,1,1
15452,10,12322,9,94,94,0,1,30,1,0
18442,1708,1902,1304,320,140,180,6,7,3,3
9427,10,3079,9,195,102,93,2,30,1,1
1527,3216,0,0,145,145,0,1,0,1,0
18612,28,0,0,70,70,0,1,0,1,0
497,1610,0,0,167,167,0,1,0,1,0
10575,1771,0,0,66,66,0,1,0,1,0
13916,10,27410,9,751,95,656,2,31,1,1
8651,10,26011,9,752,93,659,2,31,1,1
3263,6,0,0,60,60,0,1,0,1,0
21583,10,16682,9,479,111,368,4,50,2,2
15544,10,10211,9,195,102,93,2,30,1,1
17864,2743,0,0,66,66,0,1,0,1,0
195,1590,0,0,66,66,0,1,0,1,0
21496,28,0,0,66,66,0,1,0,1,0
8982,28,0,0,70,70,0,1,0,1,0
8812,10,7619,9,199,102,97,2,30,1,1
21584,10,28060,9,200,94,106,2,29,1,1
15968,28,0,0,66,66,0,1,0,1,0
19797,28,0,0,70,70,0,1,0,1,0
2968,1888,0,0,62,62,0,1,0,1,0
9122,1827,0,0,66,66,0,1,0,1,0
13754,28,0,0,70,70,0,1,0,1,0
14015,10,2743,9,164,78,86,2,30,1,1
17976,26,13627,16,6135,843,5292,20,26,10,10
16951,255,0,0,62,62,0,1,0,1,0
19103,28,0,0,70,70,0,1,0,1,0
13225,3216,0,0,62,62,0,1,0,1,0
14531,10,13993,9,177,94,83,2,30,1,1
15187,26,6016,16,4378,1140,3238,14,26,9,5
17137,183,26064,121,4429,2581,1848,21,33,11,10
12075,26,9703,16,10332,2735,7597,36,21,17,19
8670,26,12564,16,26816,2982,23834,50,270,23,27
4426,26,4234,16,5948,1553,4395,16,15,10,6
11141,2256,0,0,62,62,0,1,0,1,0
10958,2687,8305,2086,258,70,188,4,8,2,2
21117,1323,15601,999,66,66,0,2,7,2,0
14418,10,14735,9,214,94,120,2,30,1,1
22705,10,11198,9,290,94,196,4,40,2,2
17930,26,12797,16,622,310,312,11,29,6,5
15119,10,23700,9,183,94,89,2,29,1,1
18858,2154,0,0,66,66,0,1,0,1,0
18134,28,0,0,70,70,0,1,0,1,0
9065,26,14204,16,5583,1567,4016,16,85,9,7
11405,28,0,0,66,66,0,1,0,1,0
14602,10,13850,9,329,118,211,2,30,1,1
20361,28,0,0,70,70,0,1,0,1,0
8210,1609,21194,1232,152,152,0,1,1200,1,0
2819,1147,0,0,62,62,0,1,0,1,0
3472,10,28736,9,179,86,93,2,30,1,1
22594,10,10223,9,249,102,147,2,30,1,1
14698,10,14113,9,199,94,105,2,30,1,1
14941,28,0,0,66,66,0,1,0,1,0
14567,10,10764,9,209,102,107,2,30,1,1
20258,28,0,0,70,70,0,1,0,1,0
2272,26,9327,16,5576,2436,3140,21,26,12,9
14640,10,14477,9,177,94,83,2,30,1,1
15784,10,16855,9,178,94,84,2,31,1,1
4883,26,11779,16,6147,910,5237,18,100,10,8
19569,28,0,0,70,70,0,1,0,1,0
4875,26,21250,16,328599,275779,52820,868,342,483,385
15903,10,13935,9,210,110,100,2,30,1,1
12,2356,0,0,66,66,0,1,0,1,0
14342,10,28729,9,173,94,79,2,30,1,1
16575,28,0,0,70,70,0,1,0,1,0
7652,26,26109,16,9085,2222,6863,39,125,19,20
15396,10,4689,9,235,94,141,2,30,1,1
21951,28,0,0,70,70,0,1,0,1,0
10536,28,0,0,70,70,0,1,0,1,0
13723,26,24229,16,4517,1610,2907,19,27,11,8
20891,1147,0,0,66,66,0,1,0,1,0
15778,28,0,0,70,70,0,1,0,1,0
8306,2587,0,0,66,66,0,1,0,1,0
11678,26,28047,16,85011,4398,80613,113,26,52,61
8697,10,14944,9,183,94,89,2,30,1,1
10720,222,10416,143,66,66,0,1,5,1,0
2314,1147,0,0,62,62,0,1,0,1,0
360,3105,0,0,164,164,0,1,0,1,0
9728,280,26263,177,901,166,735,2,1200,1,1
11189,732,18621,524,70,70,0,1,5,1,0
12,1531,0,0,74,74,0,1,0,1,0
1909,280,2220,177,149,149,0,1,1200,1,0
9680,28,0,0,70,70,0,1,0,1,0
7539,26,27068,16,9439,3223,6216,27,137,13,14
15728,10,12037,9,177,94,83,2,30,1,1
13126,2587,0,0,66,66,0,1,0,1,0
3215,2235,0,0,62,62,0,1,0,1,0
22241,10,14978,9,184,94,90,2,30,1,1
5563,3139,0,0,62,62,0,1,0,1,0
11437,28,0,0,70,70,0,1,0,1,0
1133,1771,0,0,66,66,0,1,0,1,0
2627,1888,0,0,66,66,0,1,0,1,0
8680,1942,0,0,162,162,0,1,0,1,0
3977,26,11187,16,4477,2350,2127,16,135,8,8
15578,10,10147,9,762,98,664,2,30,1,1
13092,28,0,0,66,66,0,1,0,1,0
12963,28,0,0,70,70,0,1,0,1,0
13611,10,23728,9,197,102,95,2,35,1,1
637,2636,0,0,66,66,0,1,0,1,0
8731,10,23739,9,768,193,575,6,40,3,3
10984,2938,0,0,66,66,0,1,0,1,0
202,899,0,0,66,66,0,1,0,1,0
11054,2420,25146,1882,70,70,0,2,8,2,0
17456,2587,0,0,66,66,0,1,0,1,0
8678,26,21529,16,217225,47956,169269,284,64,149,135
12718,26,12899,16,499,425,74,4,1,3,1
10819,2054,8731,1580,70,70,0,2,8,2,0
13471,28,0,0,70,70,0,1,0,1,0
13419,26,9779,16,5411,851,4560,17,15,8,9
5556,26,15508,16,6058,1749,4309,22,200,13,9
16759,28,0,0,70,70,0,1,0,1,0
107,465,0,0,157,157,0,1,0,1,0
11340,1215,0,0,62,62,0,1,0,1,0
15391,15,17726,11,420340,15216,405124,441,376,163,278
12576,1846,28379,1406,70,70,0,1,4,1,0
8651,509,0,0,66,66,0,1,0,1,0
16138,28,0,0,70,70,0,1,0,1,0
8332,10,7938,9,379,94,285,2,30,1,1
12,2607,0,0,102,102,0,1,0,1,0
18442,26,5669,16,9593,3182,6411,19,23,8,11
13681,28,0,0,70,70,0,1,0,1,0
9818,1771,0,0,62,62,0,1,0,1,0
6370,10,18496,9,262,106,156,2,32,1,1
8248,26,24,16,6922,1618,5304,23,35,12,11
8800,26,2659,16,1575,988,587,13,35,7,6
14696,2938,0,0,62,62,0,1,0,1,0
12,3166,0,0,1514,1514,0,1,0,1,0
639,403,0,0,143,143,0,1,0,1,0
14894,10,565,9,311,94,217,2,30,1,1
3195,10,17704,9,209,86,123,2,29,1,1
9373,15,5721,11,1746,780,966,19,102,7,12
8445,15,219,11,254,128,126,5,16,3,2
8604,26,20805,16,135574,9426,126148,201,183,102,99
8853,10,3666,9,184,102,82,2,30,1,1
14816,10,3091,9,188,96,92,2,30,1,1
9049,10,25609,9,786,110,676,2,30,1,1
11246,396,9330,257,136,136,0,3,11,3,0
22433,10,20626,9,193,102,91,2,31,1,1
17977,26,10932,16,6197,843,5354,21,27,10,11
12016,26,4260,16,6668,2026,4642,15,120,8,7
6194,15,23025,11,1139,506,633,10,15,6,4
15261,26,17235,16,7941,1952,5989,20,16,11,9
12,3140,0,0,199,199,0,1,0,1,0
11871,26,19128,16,86041,4656,81385,102,113,34,68
538,7,0,0,60,60,0,1,0,1,0
14969,10,12093,9,186,95,91,3,46,2,1
9125,10,3827,9,327,126,201,2,30,1,1
15067,10,3824,9,172,88,84,2,31,1,1
17316,28,0,0,70,70,0,1,0,1,0
16653,28,0,0,70,70,0,1,0,1,0
14209,10,11293,9,167,86,81,2,30,1,1
11255,1551,15393,1182,66,66,0,1,5,1,0
14551,10,23773,9,184,94,90,2,30,1,1
21267,2587,0,0,66,66,0,1,0,1,0
9717,28,0,0,70,70,0,1,0,1,0
15825,26,12521,16,11546,3604,7942,38,120,20,18
20170,933,0,0,145,145,0,1,0,1,0
14682,10,11729,9,182,94,88,2,30,1,1
14227,15,9525,11,1165,473,692,10,14,5,5
0,0,0,0,70,70,0,1,0,1,0
15898,10,10534,9,184,94,90,2,30,1,1
19969,28,0,0,66,66,0,1,0,1,0
20764,28,0,0,70,70,0,1,0,1,0
9765,15,13554,11,11975,10368,1607,27,52,16,11
22519,28,0,0,66,66,0,1,0,1,0
17640,10,0,0,221,81,140,2,31,1,1
14399,28,0,0,70,70,0,1,0,1,0
22439,10,17215,9,199,94,105,2,30,1,1
5460,26,29053,16,5806,3167,2639,29,221,16,13
14355,10,20979,9,177,94,83,2,30,1,1
16951,255,0,0,62,62,0,1,0,1,0
15554,26,23390,16,7238,2601,4637,20,22,10,10
18103,28,0,0,70,70,0,1,0,1,0
8396,290,0,0,145,145,0,1,0,1,0
22432,1054,0,0,62,62,0,1,0,1,0
12157,15,15735,11,2960,1928,1032,13,75,8,5
10551,40,7717,23,12667,4060,8607,87,32,39,48
18190,1472,0,0,66,66,0,1,0,1,0
1841,2953,0,0,66,66,0,1,0,1,0
19041,10,0,0,283,78,205,2,29,1,1
18162,26,16435,16,3045,1340,1705,16,141,8,8
12,499,0,0,124,124,0,1,0,1,0
6917,255,0,0,60,60,0,1,0,1,0
7817,280,0,0,146,146,0,1,0,1,0
12,2453,0,0,97,97,0,1,0,1,0
15868,26,26554,16,134,60,74,3,6,2,1
21120,28,0,0,70,70,0,1,0,1,0
16107,26,25440,16,775362,32338,743024,683,180,169,514
16129,28,0,0,70,70,0,1,0,1,0
10775,150,5563,107,70,70,0,2,8,2,0
16961,28,0,0,70,70,0,1,0,1,0
15337,10,3966,9,168,86,82,2,29,1,1
4633,10,18119,9,240,76,164,2,30,1,1
8821,10,13942,9,209,110,99,2,30,1,1
863,1224,0,0,60,60,0,1,0,1,0
16240,10,25539,9,374,240,134,3,32,2,1
19108,28,0,0,66,66,0,1,0,1,0
2954,2205,0,0,66,66,0,1,0,1,0
1100,26,767,16,5657,487,5170,14,15,7,7
8276,1017,0,0,62,62,0,1,0,1,0
13059,28,0,0,66,66,0,1,0,1,0
16424,983,0,0,66,66,0,1,0,1,0
9773,26,24905,16,70,70,0,1,5,1,0
16894,2943,0,0,66,66,0,1,0,1,0
10467,26,7989,16,5360,3775,1585,22,35,13,9
14274,10,9753,9,182,93,89,2,31,1,1
14543,10,24253,9,330,92,238,4,43,2,2
17656,28,0,0,70,70,0,1,0,1,0
13568,28,0,0,70,70,0,1,0,1,0
1382,10,4745,9,240,98,142,2,30,1,1
13074,185,0,0,60,60,0,1,0,1,0
21721,10,16695,9,182,93,89,2,30,1,1
5425,1147,0,0,66,66,0,1,0,1,0
12767,697,0,0,62,62,0,1,0,1,0
19509,28,0,0,70,70,0,1,0,1,0
20436,28,0,0,70,70,0,1,0,1,0
16977,28,0,0,70,70,0,1,0,1,0
360,3105,0,0,164,164,0,1,0,1,0
13721,10,17296,9,178,94,84,2,30,1,1
5988,26,29040,16,204,70,134,4,26,2,2
9511,28,0,0,66,66,0,1,0,1,0
11790,26,23173,16,3133,814,2319,13,136,6,7
8620,10,18287,9,248,118,130,2,30,1,1
10775,2938,0,0,62,62,0,1,0,1,0
15252,10,8280,9,200,102,98,2,31,1,1
9537,10,786,9,759,94,665,2,29,1,1
6552,2093,0,0,145,145,0,1,0,1,0
2212,15,0,0,60,60,0,1,0,1,0
22673,10,13993,9,195,102,93,2,30,1,1
15321,15,15059,11,876072,26350,849722,935,27,335,600
16951,255,0,0,62,62,0,1,0,1,0
22514,10,15835,9,167,86,81,2,29,1,1
10413,28,0,0,66,66,0,1,0,1,0
17421,18,862,13,184,94,90,2,30,1,1
17697,28,0,0,70,70,0,1,0,1,0
9461,15,11776,11,1677,862,815,10,15,5,5
9361,10,21857,9,217,90,127,2,29,1,1
12136,28,0,0,70,70,0,1,0,1,0
8899,26,27128,16,204,70,134,4,26,2,2
10287,28,0,0,70,70,0,1,0,1,0
9199,10,4843,9,195,102,93,2,30,1,1
15204,26,15739,16,22938,14436,8502,43,35,23,20
13018,28,0,0,66,66,0,1,0,1,0
12482,680,17209,479,546,306,240,9,15,5,4
8664,10,1646,9,245,102,143,2,30,1,1
6086,26,939,16,13183,1682,11501,26,78,12,14
11737,1147,0,0,62,62,0,1,0,1,0
11000,871,24157,642,70,70,0,2,8,2,0
13875,26,20842,16,3602,1519,2083,18,60,10,8
13716,10,11795,9,194,94,100,2,31,1,1
14064,10,18514,9,442,110,332,4,44,2,2
18383,28,0,0,70,70,0,1,0,1,0
21712,10,24962,9,184,94,90,2,30,1,1
11055,26,20521,16,8034,2692,5342,15,16,8,7
9728,712,24569,510,1377,300,1077,6,1200,3,3
5415,26,17048,16,4601,1694,2907,19,28,11,8
11064,2487,9139,1934,70,70,0,2,9,2,0
22378,10,7657,9,269,94,175,2,30,1,1
11133,2747,0,0,62,62,0,1,0,1,0
9621,26,11260,16,55388,4069,51319,94,240,46,48
5338,26,23135,16,4362,1145,3217,17,26,9,8
17177,26,14998,16,183394,7389,176005,219,108,87,132
12709,26,8994,16,499,425,74,4,1,3,1
19107,28,0,0,66,66,0,1,0,1,0
16043,1147,0,0,66,66,0,1,0,1,0
10353,28,0,0,66,66,0,1,0,1,0
8620,28,0,0,66,66,0,1,0,1,0
2121,3216,0,0,66,66,0,1,0,1,0
14481,10,9197,9,184,94,90,2,30,1,1
20424,28,0,0,70,70,0,1,0,1,0
8584,1314,12828,991,254,78,176,2,30,1,1
15052,15,16494,11,8790,1387,7403,17,134,9,8
15070,10,1068,9,177,94,83,2,30,1,1
21046,28,0,0,70,70,0,1,0,1,0
14428,10,23137,9,200,102,98,2,33,1,1
22543,10,8028,9,75,75,0,1,30,1,0
8736,26,14049,16,6360,2483,3877,20,16,10,10
16581,26,29099,16,8365,2826,5539,27,693,15,12
12009,2966,7737,2302,70,70,0,1,5,1,0
21038,2044,13167,1571,66,66,0,2,7,2,0
4297,2636,0,0,62,62,0,1,0,1,0
11533,28,0,0,70,70,0,1,0,1,0
620,26,9004,16,13520,2288,11232,43,192,19,24
15873,10,5072,9,177,94,83,2,30,1,1
15987,10,5082,9,994,86,908,2,30,1,1
9662,15,9962,11,2864,1338,1526,17,21,9,8
8481,28,0,0,66,66,0,1,0,1,0
17324,10,26162,9,832,106,726,2,30,1,1
17317,28,0,0,70,70,0,1,0,1,0
22127,10,13700,9,168,86,82,2,31,1,1
15012,10,24850,9,177,94,83,2,30,1,1
20303,28,0,0,66,66,0,1,0,1,0
15992,10,20105,9,183,94,89,2,30,1,1
5903,26,445,16,1807,1048,759,16,26,8,8
21807,26,22067,16,24686,1935,22751,36,16,17,19
17088,26,17121,16,5166,700,4466,16,15,7,9
12055,10,7346,9,168,78,90,2,30,1,1
19485,28,0,0,70,70,0,1,0,1,0
20443,1888,0,0,62,62,0,1,0,1,0
10281,26,17374,16,9894856,232425,9662431,9829,90,3300,6529
8688,26,21538,16,7647,1693,5954,31,77,16,15
1020,26,50,16,3616,429,3187,11,15,6,5
20832,28,0,0,70,70,0,1,0,1,0
8723,10,14077,9,211,102,109,2,30,1,1
11195,2540,25045,1974,70,70,0,2,8,2,0
10985,1973,17198,1506,70,70,0,1,5,1,0
6552,2093,0,0,145,145,0,1,0,1,0
10066,26,12196,16,9989,3003,6986,30,46,17,13
12388,28,0,0,70,70,0,1,0,1,0
8635,10,19717,9,177,94,83,2,30,1,1
5311,10,3703,9,198,93,105,2,30,1,1
13973,10,3419,9,754,94,660,2,30,1,1
21357,2200,18126,1703,504,382,122,8,14,6,2
952,183,0,0,66,66,0,1,0,1,0
15399,2855,17130,2215,70,70,0,1,5,1,0
19446,28,0,0,66,66,0,1,0,1,0
16021,2719,21258,2113,491,150,341,2,1199,1,1
3133,2320,14055,1804,330,330,0,6,3610,6,0
13744,26,24246,16,21122,2591,18531,36,17,18,18
0,0,0,0,98,98,0,1,0,1,0
21710,295,28653,190,3434,1595,1839,17,15,9,8
838,2256,0,0,66,66,0,1,0,1,0
11200,2267,4142,1754,66,66,0,1,5,1,0
7463,26,27729,16,12157,3583,8574,81,480,34,47
7119,1147,0,0,62,62,0,1,0,1,0
10333,26,2516,16,63550,10766,52784,98,131,43,55
11935,234,17488,149,2725,1610,1115,20,3600,10,10
2743,1054,0,0,62,62,0,1,0,1,0
18168,28,0,0,70,70,0,1,0,1,0
11031,15,5472,11,546,300,246,10,25,6,4
14175,10,4094,9,170,87,83,2,30,1,1
21463,28,0,0,70,70,0,1,0,1,0
12469,10,23542,9,643,88,555,2,31,1,1
21329,2429,10035,1890,70,70,0,1,5,1,0
14678,10,20884,9,178,94,84,2,29,1,1
21432,1017,0,0,146,146,0,1,0,1,0
17212,26,2776,16,7941,5160,2781,25,17,13,12
20864,28,0,0,70,70,0,1,0,1,0
15848,10,12580,9,178,94,84,2,30,1,1
18808,1989,14169,1519,316,136,180,6,6,3,3
17679,28,0,0,70,70,0,1,0,1,0
9189,10,17752,9,369,150,219,2,30,1,1
12923,28,0,0,70,70,0,1,0,1,0
13722,10,18728,9,196,102,94,2,31,1,1
9575,15,19423,11,318,192,126,6,27,4,2
6065,10,18059,9,235,90,145,2,32,1,1
15100,26,21926,16,5212,1037,4175,20,115,10,10
22328,26,10926,16,5500,1277,4223,17,180,8,9
6429,2709,0,0,62,62,0,1,0,1,0
20742,2611,0,0,62,62,0,1,0,1,0
13920,28,0,0,70,70,0,1,0,1,0
14208,28,0,0,70,70,0,1,0,1,0
12692,15,20908,11,130,70,60,2,15,1,1
14536,28,0,0,70,70,0,1,0,1,0
12637,26,20910,16,499,425,74,4,0,3,1
21552,1215,0,0,66,66,0,1,0,1,0
14409,10,18173,9,200,102,98,2,29,1,1
8537,10,15204,9,430,85,345,4,54,2,2
8693,10,28253,9,415,98,317,4,51,2,2
16310,586,0,0,74,74,0,1,0,1,0
9191,28,0,0,70,70,0,1,0,1,0
5181,15,6111,11,810,413,397,7,19,5,2
717,10,2853,9,228,90,138,2,31,1,1
10639,1017,0,0,66,66,0,1,0,1,0
2491,1771,0,0,66,66,0,1,0,1,0
15326,10,4269,9,177,94,83,2,30,1,1
13013,10,3033,9,339,94,245,2,30,1,1
8984,10,10104,9,94,94,0,1,30,1,0
13374,26,28,16,355822,186974,168848,1039,1626,433,606
16046,28,0,0,70,70,0,1,0,1,0
14268,2781,20756,2158,70,70,0,2,8,2,0
1420,1017,0,0,62,62,0,1,0,1,0
14677,15,21392,11,2481,529,1952,11,75,6,5
8060,26,28812,16,7920,2731,5189,27,82,15,12
22198,1260,27572,940,1012,462,550,4,30,2,2
8210,2468,21194,1919,480,149,331,2,1200,1,1
22379,28,0,0,66,66,0,1,0,1,0
13006,28,0,0,66,66,0,1,0,1,0
10231,15,22577,11,1948,1092,856,10,20,7,3
1143,983,0,0,66,66,0,1,0,1,0
12124,26,23336,16,1270,697,573,15,33,8,7
3661,26,11775,16,33068,2556,30512,48,81,21,27
15808,10,13051,9,780,104,676,2,31,1,1
3870,1215,0,0,62,62,0,1,0,1,0
6884,26,27851,16,196732,11940,184792,257,139,103,154
11987,28,0,0,66,66,0,1,0,1,0
15699,10,23277,9,177,94,83,2,30,1,1
12079,15,22209,11,1873,713,1160,10,15,5,5
15513,15,8384,11,2925,1480,1445,11,30,7,4
15408,1054,0,0,62,62,0,1,0,1,0
12144,26,5385,16,6244,1104,5140,23,65,12,11
18314,28,0,0,66,66,0,1,0,1,0
17822,2938,0,0,62,62,0,1,0,1,0
5472,26,5518,16,280,140,140,5,130,3,2
591,10,2314,9,216,90,126,2,30,1,1
21573,10,17843,9,499,183,316,6,57,3,3
5212,1888,0,0,62,62,0,1,0,1,0
18525,2434,3783,1893,70,70,0,1,5,1,0
22488,10,23585,9,889,404,485,10,30,5,5
5199,983,0,0,62,62,0,1,0,1,0
4728,26,1370,16,4162,3001,1161,20,25,12,8
17578,26,27240,16,43483,26315,17168,86,62,54,32
331,10,951,9,214,97,117,2,30,1,1
8921,26,21558,16,447301,17016,430285,539,128,196,343
18240,1017,0,0,66,66,0,1,0,1,0
0,0,0,0,60,60,0,1,0,1,0
15761,10,7291,9,195,102,93,2,31,1,1
9425,28,0,0,66,66,0,1,0,1,0
14666,10,19347,9,196,86,110,2,30,1,1
13328,28,0,0,70,70,0,1,0,1,0
14140,10,350,9,814,110,704,2,30,1,1
2305,10,9477,9,235,90,145,2,32,1,1
7540,2938,0,0,62,62,0,1,0,1,0
3651,26,21728,16,8290,2156,6134,24,81,14,10
22298,10,11912,9,197,102,95,2,29,1,1
480,10,1730,9,244,98,146,2,32,1,1
12699,1712,2829,1307,492,306,186,8,14,5,3
17657,26,2663,16,14489,12206,2283,25,120,15,10
13280,26,8309,16,6256,1871,4385,20,45,12,8
8680,26,12131,16,28361,1861,26500,49,195,19,30
3406,26,25860,16,4193,2689,1504,23,23,14,9
9869,26,7120,16,6464,2707,3757,39,151,18,21
22225,10,1269,9,186,95,91,2,31,1,1
10933,1793,2186,1368,70,70,0,2,8,2,0
2744,1233,11984,913,883,126,757,2,30,1,1
588,2611,0,0,78,78,0,1,0,1,0
17559,1888,0,0,66,66,0,1,0,1,0
22197,10,20547,9,176,90,86,2,31,1,1
15193,28,0,0,70,70,0,1,0,1,0
22090,10,23012,9,94,94,0,1,30,1,0
12344,26,23325,16,17187157,553524,16633633,18453,352,6098,12355
10777,2771,14364,2150,136,136,0,3,14,3,0
1269,7,0,0,60,60,0,1,0,1,0
11247,1017,0,0,66,66,0,1,0,1,0
15839,10,26999,9,198,101,97,2,30,1,1
22685,10,21905,9,183,94,89,2,30,1,1
5822,104,0,0,60,60,0,1,0,1,0
8510,28,0,0,66,66,0,1,0,1,0
13954,10,27244,9,279,110,169,2,30,1,1
990,26,27776,16,6356,979,5377,19,27,10,9
14882,10,26010,9,168,86,82,2,30,1,1
1420,1017,0,0,62,62,0,1,0,1,0
979,15,2509,11,318,192,126,6,27,4,2
22508,10,10840,9,770,101,669,2,30,1,1
14887,10,8139,9,184,94,90,2,30,1,1
14877,28,0,0,70,70,0,1,0,1,0
8424,10,22479,9,199,102,97,2,30,1,1
12718,2864,25709,2223,70,70,0,2,8,2,0
636,1513,15138,1152,509,150,359,2,1199,1,1
16070,28,0,0,66,66,0,1,0,1,0
8171,1073,0,0,60,60,0,1,0,1,0
8606,10,28816,9,415,88,327,4,52,2,2
11329,15,22900,11,450,246,204,8,29,5,3
9384,10,14364,9,183,94,89,2,30,1,1
9150,28,0,0,70,70,0,1,0,1,0
13644,15,16463,11,9054746,285623,8769123,10474,214,4673,5801
9055,26,18500,16,8211,3683,4528,27,623,14,13
21690,10,14908,9,255,102,153,2,31,1,1
22650,28,0,0,70,70,0,1,0,1,0
16541,15,12833,11,4468,1145,3323,15,16,9,6
12898,28,0,0,66,66,0,1,0,1,0
9418,10,15279,9,210,110,100,2,29,1,1
6719,26,888,16,6933,1677,5256,22,305,12,10
16879,28,0,0,70,70,0,1,0,1,0
7536,2587,0,0,66,66,0,1,0,1,0
10881,28,0,0,70,70,0,1,0,1,0
5299,15,20954,11,234,234,0,4,12,4,0
12614,2636,0,0,62,62,0,1,0,1,0
22413,10,21354,9,216,102,114,2,30,1,1
13334,1888,0,0,62,62,0,1,0,1,0
15118,10,604,9,294,142,152,2,30,1,1
13218,28,0,0,70,70,0,1,0,1,0
18243,2733,0,0,66,66,0,1,0,1,0
11068,2587,0,0,66,66,0,1,0,1,0
19247,28,0,0,70,70,0,1,0,1,0
19089,26,20722,16,3854,1233,2621,19,120,9,10
17810,28,0,0,70,70,0,1,0,1,0
17843,3216,0,0,62,62,0,1,0,1,0
11089,28,0,0,70,70,0,1,0,1,0
12,2553,0,0,82,82,0,1,0,1,0
474,2154,0,0,70,70,0,1,0,1,0
14990,2587,0,0,62,62,0,1,0,1,0
10956,28,0,0,70,70,0,1,0,1,0
15350,10,14823,9,763,101,662,2,30,1,1
21303,15,20767,11,314,192,122,6,15,4,2
15293,26,21544,16,7940,1951,5989,20,15,11,9
9433,28,0,0,66,66,0,1,0,1,0
2521,2636,0,0,66,66,0,1,0,1,0
16442,15,15682,11,3703,2068,1635,17,33,10,7
7934,10,147,9,199,94,105,2,30,1,1
12432,28,0,0,70,70,0,1,0,1,0
9728,280,24989,177,161,161,0,1,1201,1,0
2883,26,12134,16,5516,1388,4128,18,15,9,9
16951,255,0,0,62,62,0,1,0,1,0
14878,10,10733,9,166,86,80,2,30,1,1
16231,28,0,0,70,70,0,1,0,1,0
9423,26,16050,16,3182,1568,1614,8,120,4,4
21769,10,16632,9,276,126,150,2,30,1,1
10051,28,0,0,66,66,0,1,0,1,0
9105,15,21740,11,493003,23995,469008,578,22,246,332
14581,28,0,0,70,70,0,1,0,1,0
9825,28,0,0,66,66,0,1,0,1,0
16393,28,0,0,70,70,0,1,0,1,0
777,1017,0,0,62,62,0,1,0,1,0
17439,1771,0,0,62,62,0,1,0,1,0
2163,183,8715,121,4085,1916,2169,21,18,12,9
15343,28,0,0,70,70,0,1,0,1,0
16951,255,0,0,62,62,0,1,0,1,0
311,3216,0,0,66,66,0,1,0,1,0
9710,26,1375,16,2064,1287,777,16,139,9,7
15591,10,25547,9,177,94,83,2,30,1,1
12304,155,0,0,66,66,0,1,0,1,0
14609,10,1432,9,771,101,670,2,31,1,1
9214,3257,0,0,60,60,0,1,0,1,0
10600,26,17986,16,254,70,184,5,22,2,3
4182,2610,0,0,60,60,0,1,0,1,0
5402,899,0,0,62,62,0,1,0,1,0
7789,1804,0,0,66,66,0,1,0,1,0
15996,10,11988,9,199,102,97,2,30,1,1
5337,26,5566,16,4362,1145,3217,17,25,9,8
15294,10,26281,9,185,102,83,2,30,1,1
1323,208,0,0,145,145,0,1,0,1,0
20644,2573,0,0,66,66,0,1,0,1,0
22142,26,28879,16,4596,1689,2907,19,27,11,8
8764,15,28957,11,400,70,330,6,24,1,5
360,3105,0,0,1049,1049,0,1,0,1,0
2433,2938,0,0,62,62,0,1,0,1,0
1596,3139,0,0,66,66,0,1,0,1,0
18666,28,0,0,66,66,0,1,0,1,0
10516,28,0,0,70,70,0,1,0,1,0
22559,10,7206,9,271,94,177,2,30,1,1
14638,10,8540,9,762,98,664,2,31,1,1
16951,255,0,0,62,62,0,1,0,1,0
11048,15,8687,11,1660,791,869,11,32,6,5
13874,28,0,0,66,66,0,1,0,1,0
13107,1238,18390,918,924,924,0,3,29,3,0
9156,28,0,0,70,70,0,1,0,1,0
14449,28,0,0,70,70,0,1,0,1,0
8197,26,23042,16,6353,1075,5278,18,33,10,8
12023,28,0,0,70,70,0,1,0,1,0
29,1888,0,0,62,62,0,1,0,1,0
12457,501,22863,329,492,306,186,8,16,5,3
1656,1147,0,0,62,62,0,1,0,1,0
14947,2611,0,0,66,66,0,1,0,1,0
16775,10,17981,9,274,94,180,2,30,1,1
7339,140,0,0,60,60,0,1,0,1,0
8698,10,25816,9,334,92,242,4,49,2,2
12995,1017,0,0,66,66,0,1,0,1,0
1219,449,10204,288,460,150,310,2,1200,1,1
9614,3105,0,0,86,86,0,1,0,1,0
16753,10,776,9,167,78,89,2,30,1,1
12963,28,0,0,70,70,0,1,0,1,0
12692,633,7329,438,320,140,180,6,6,3,3
8775,10,19927,9,177,94,83,2,31,1,1
17691,1888,0,0,62,62,0,1,0,1,0
8432,10,2634,9,178,91,87,2,31,1,1
9306,28,0,0,66,66,0,1,0,1,0
19314,26,8897,16,1664127,116770,1547357,2028,401,736,1292
13765,10,23640,9,392,100,292,4,33,2,2
18530,2606,17299,2022,320,140,180,6,7,3,3
2744,1240,3103,920,1658,126,1532,4,30,2,2
9781,28,0,0,70,70,0,1,0,1,0
16021,1533,6646,1167,792,792,0,13,1200,13,0
12813,28,0,0,70,70,0,1,0,1,0
8584,1238,8293,918,264,78,186,2,29,1,1
21037,1215,0,0,66,66,0,1,0,1,0
10403,29,22426,17,320,128,192,6,5,3,3
5366,15,16435,11,78,78,0,1,4,1,0
7476,1771,0,0,62,62,0,1,0,1,0
20535,1771,0,0,62,62,0,1,0,1,0
13779,1147,0,0,66,66,0,1,0,1,0
13094,26,20927,16,6376,1576,4800,24,19,13,11
9784,28,0,0,70,70,0,1,0,1,0
14970,10,17615,9,279,93,186,4,32,2,2
21809,1888,0,0,66,66,0,1,0,1,0
15105,28,0,0,70,70,0,1,0,1,0
15078,10,16716,9,164,86,78,2,30,1,1
22279,15,28945,11,296372,11959,284413,311,23,113,198
3948,26,1148,16,25542,17843,7699,58,59,34,24
48,1215,0,0,62,62,0,1,0,1,0
19757,28,0,0,70,70,0,1,0,1,0
17203,26,8289,16,6033,770,5263,18,15,8,10
4835,2484,7881,1932,132,132,0,3,1199,3,0
3574,2938,0,0,74,74,0,1,0,1,0
5101,15,15744,11,1114,534,580,12,16,7,5
18076,26,7043,16,7875,3100,4775,42,24,22,20
19554,28,0,0,66,66,0,1,0,1,0
2863,1984,6285,1514,148,86,62,2,30,1,1
13496,26,8867,16,3392,2305,1087,22,80,11,11
15957,10,18046,9,174,89,85,2,31,1,1
17091,1472,0,0,146,146,0,1,0,1,0
8327,3170,17024,2456,854,150,704,4,1200,2,2
22154,10,15618,9,284,102,182,4,38,2,2
2145,3216,0,0,62,62,0,1,0,1,0
2172,2774,14097,2153,480,149,331,2,1200,1,1
16021,2397,9451,1864,330,330,0,6,1199,6,0
13056,28,0,0,70,70,0,1,0,1,0
11610,28,0,0,70,70,0,1,0,1,0
20247,28,0,0,66,66,0,1,0,1,0
14773,10,12687,9,179,94,85,2,31,1,1
11051,1576,12158,1206,66,66,0,1,5,1,0
21596,10,28595,9,216,98,118,2,30,1,1
8043,1888,0,0,62,62,0,1,0,1,0
18132,28,0,0,70,70,0,1,0,1,0
18987,28,0,0,70,70,0,1,0,1,0
19740,28,0,0,66,66,0,1,0,1,0
3841,26,10822,16,34914,5279,29635,47,543,18,29
21619,26,28604,16,4347,1440,2907,19,26,11,8
8230,18,13904,13,184,94,90,2,30,1,1
3574,2938,0,0,74,74,0,1,0,1,0
12,447,0,0,60,60,0,1,0,1,0
11194,26,22820,16,20480,2066,18414,37,17,19,18
18085,26,28971,16,2419,330,2089,12,135,5,7
8632,26,28886,16,4562,2466,2096,20,119,11,9
15860,10,2215,9,177,94,83,2,30,1,1
22553,10,27705,9,211,102,109,2,30,1,1
16063,28,0,0,70,70,0,1,0,1,0
285,1763,0,0,66,66,0,1,0,1,0
16951,255,0,0,62,62,0,1,0,1,0
19283,2205,0,0,66,66,0,1,0,1,0
12516,28,0,0,66,66,0,1,0,1,0
7168,26,18717,16,10280,6167,4113,20,15,12,8
10779,103,1953,80,66,66,0,1,5,1,0
19505,28,0,0,66,66,0,1,0,1,0
8333,26,20951,16,9022,1416,7606,25,31,11,14
8765,28,0,0,70,70,0,1,0,1,0
10153,28,0,0,70,70,0,1,0,1,0
13839,10,26630,9,170,87,83,2,31,1,1
21367,26,28494,16,5643,2397,3246,26,159,14,12
9217,1241,18725,921,468,390,78,5,29,4,1
19646,1147,0,0,66,66,0,1,0,1,0
3363,15,11966,11,9055,863,8192,18,45,10,8
19776,1804,0,0,66,66,0,1,0,1,0
14272,10,21764,9,184,94,90,2,30,1,1
14561,10,5394,9,197,102,95,2,31,1,1
9049,26,11072,16,10216,2749,7467,27,86,14,13
8963,1147,0,0,66,66,0,1,0,1,0
20583,28,0,0,66,66,0,1,0,1,0
13577,28,0,0,70,70,0,1,0,1,0
22449,15,21026,11,6352,4052,2300,44,630,23,21
10673,15,26815,11,318,192,126,6,39,4,2
13656,10,23987,9,192,98,94,2,31,1,1
15236,15,2278,11,234,234,0,4,12,4,0
15953,10,1075,9,183,94,89,2,30,1,1
17833,28,0,0,70,70,0,1,0,1,0
15692,28,0,0,70,70,0,1,0,1,0
21747,10,2069,9,336,93,243,4,33,2,2
14849,28,0,0,66,66,0,1,0,1,0
19835,28,0,0,70,70,0,1,0,1,0
2744,1619,6571,1241,892,126,766,2,31,1,1
8540,26,8260,16,1857,1218,639,18,104,11,7
870,26,11755,16,7876,1511,6365,29,42,14,15
14425,10,18391,9,261,89,172,4,38,2,2
9169,10,19694,9,295,101,194,4,30,2,2
2948,1888,0,0,62,62,0,1,0,1,0
13093,1936,0,0,62,62,0,1,0,1,0
17433,28,0,0,70,70,0,1,0,1,0
12745,26,7241,16,499,425,74,4,0,3,1
4216,15,9903,11,1158,792,366,10,17,6,4
2744,1240,18540,920,880,126,754,2,30,1,1
20704,26,5953,16,11570,3553,8017,24,134,10,14
6954,26,4904,16,4728,3417,1311,23,35,12,11
10384,26,11415,16,7448,1737,5711,24,201,13,11
3434,183,14247,121,4695,2520,2175,22,19,13,9
10708,1086,0,0,62,62,0,1,0,1,0
9233,10,20851,9,168,86,82,2,30,1,1
8584,1351,9859,1024,271,78,193,2,30,1,1
15694,1787,0,0,145,145,0,1,0,1,0
15177,26,11615,16,7942,1953,5989,20,15,11,9
14873,28,0,0,70,70,0,1,0,1,0
15416,26,20634,16,156805,44621,112184,289,215,137,152
861,10,3554,9,215,80,135,2,33,1,1
1861,1147,0,0,62,62,0,1,0,1,0
2040,26,7996,16,10461,1417,9044,23,16,10,13
10963,10,22724,9,253,106,147,2,30,1,1
14775,10,27395,9,168,86,82,2,30,1,1
15099,10,15130,9,305,86,219,2,30,1,1
10278,1539,0,0,66,66,0,1,0,1,0
22708,26,8126,16,436359,12780,423579,448,16,157,291
22696,10,249,9,177,94,83,2,30,1,1
12590,26,1402,16,499,425,74,4,0,3,1
8741,10,19959,9,775,102,673,2,29,1,1
2450,2938,0,0,62,62,0,1,0,1,0
14419,10,25838,9,170,87,83,2,31,1,1
8417,28,0,0,66,66,0,1,0,1,0
16021,197,24012,130,150,150,0,1,1199,1,0
14100,10,23268,9,216,110,106,2,31,1,1
10246,3117,0,0,66,66,0,1,0,1,0
20939,28,0,0,70,70,0,1,0,1,0
18721,28,0,0,70,70,0,1,0,1,0
13724,10,9922,9,195,102,93,2,31,1,1
110,10,202,9,193,90,103,2,30,1,1
10912,704,1179,502,70,70,0,1,5,1,0
9392,26,24105,16,6866,1958,4908,21,20,13,8
21951,28,0,0,70,70,0,1,0,1,0
8991,26,15028,16,5635,1599,4036,19,125,11,8
10314,28,0,0,70,70,0,1,0,1,0
8638,15,6872,11,318,192,126,6,28,4,2
7455,10,20091,9,233,90,143,2,32,1,1
651,15,2569,11,124405,3747,120658,131,38,46,85
9450,26,29146,16,7725,2029,5696,23,136,13,10
19587,26,5978,16,5975,2713,3262,24,125,12,12
14546,10,560,9,170,87,83,2,30,1,1
19,1773,0,0,62,62,0,1,0,1,0
14314,2215,4455,1716,504,318,186,8,15,5,3
8688,983,0,0,66,66,0,1,0,1,0
2436,983,0,0,146,146,0,1,0,1,0
15327,2256,0,0,66,66,0,1,0,1,0
21966,10,8815,9,198,86,112,2,29,1,1
9523,10,5200,9,197,102,95,2,30,1,1
20858,28,0,0,70,70,0,1,0,1,0
19606,28,0,0,70,70,0,1,0,1,0
19814,26,13899,16,9559,3243,6316,28,46,16,12
16799,10,13002,9,197,94,103,2,30,1,1
8861,10,12599,9,240,102,138,2,30,1,1
9011,7,0,0,60,60,0,1,0,1,0
16358,26,4706,16,7668,2540,5128,22,155,12,10
3460,26,14164,16,8366,3900,4466,19,120,10,9
18049,26,7418,16,10477,3435,7042,34,20,18,16
9452,15,1851,11,2840,1750,1090,13,82,7,6
2978,1472,0,0,66,66,0,1,0,1,0
22356,10,5719,9,167,86,81,2,30,1,1
4868,2587,0,0,62,62,0,1,0,1,0
1526,775,0,0,62,62,0,1,0,1,0
4107,18,18484,13,184,94,90,2,30,1,1
8415,15,21395,11,163556,12140,151416,207,22,97,110
7335,1070,0,0,60,60,0,1,0,1,0
18554,26,21251,16,81016,8373,72643,122,339,57,65
6037,18,20701,13,184,94,90,2,30,1,1
11833,26,22023,16,21789,7672,14117,78,115,39,39
20507,10,8223,9,304,86,218,2,30,1,1
11451,28,0,0,70,70,0,1,0,1,0
21456,2256,0,0,66,66,0,1,0,1,0
8584,10,13768,9,165,86,79,2,29,1,1
12276,28,0,0,70,70,0,1,0,1,0
3276,26,17059,16,3167,1498,1669,19,315,10,9
20911,28,0,0,70,70,0,1,0,1,0
11497,28,0,0,70,70,0,1,0,1,0
8584,1239,2060,919,263,78,185,2,29,1,1
14976,10,2916,9,177,94,83,2,30,1,1
21349,1695,796,1296,312,132,180,6,6,3,3
15196,26,6075,16,1327,918,409,10,26,6,4
9326,28,0,0,66,66,0,1,0,1,0
11913,15,23229,11,349769,6527,343242,368,22,100,268
5737,15,10811,11,1278,774,504,12,360,7,5
15791,983,0,0,66,66,0,1,0,1,0
21567,10,17023,9,199,102,97,2,30,1,1
14328,26,12993,16,10286,1326,8960,25,1017,8,17
4606,2587,0,0,66,66,0,1,0,1,0
15357,10,23428,9,194,99,95,2,30,1,1
15674,28,0,0,66,66,0,1,0,1,0
8711,10,5899,9,195,102,93,2,29,1,1
21948,10,11468,9,184,94,90,2,30,1,1
12025,640,21395,445,70,70,0,1,5,1,0
17506,28,0,0,70,70,0,1,0,1,0
9484,10,12090,9,498,204,294,6,29,3,3
9489,10,18061,9,193,102,91,2,30,1,1
21381,10,9243,9,309,102,207,4,53,2,2
16965,28,0,0,70,70,0,1,0,1,0
10086,1147,0,0,146,146,0,1,0,1,0
20035,28,0,0,70,70,0,1,0,1,0
1783,2587,0,0,146,146,0,1,0,1,0
18974,255,0,0,60,60,0,1,0,1,0
15407,28,0,0,66,66,0,1,0,1,0
20090,26,24531,16,18884,4117,14767,37,25,16,21
20457,28,0,0,70,70,0,1,0,1,0
14987,26,24904,16,4373,1466,2907,19,28,11,8
10845,26,27548,16,9061,3443,5618,64,121,27,37
14165,10,2439,9,86,86,0,1,30,1,0
18759,26,17337,16,2258,559,1699,22,120,6,16
4668,26,8831,16,499,425,74,4,0,3,1
13316,28,0,0,70,70,0,1,0,1,0
4066,10,19773,9,164,78,86,2,30,1,1
9115,15,17179,11,1706,505,1201,8,14,5,3
17580,26,25842,16,4518,1784,2734,30,23,15,15
15233,10,23528,9,193,102,91,2,30,1,1
11893,26,25563,16,182945,23135,159810,191,111,63,128
14447,10,12745,9,86,86,0,1,31,1,0
4984,26,14924,16,8119,1962,6157,24,360,11,13
8551,10,9375,9,193,102,91,2,29,1,1
16951,255,25970,160,62,62,0,1,5,1,0
16951,255,0,0,62,62,0,1,0,1,0
21561,28,0,0,70,70,0,1,0,1,0
2313,2883,0,0,146,146,0,1,0,1,0
5297,26,25548,16,8918,2361,6557,35,255,18,17
9681,28,0,0,66,66,0,1,0,1,0
12703,26,27893,16,499,425,74,4,1,3,1
18440,3258,26122,2524,624,318,306,10,15,5,5
11528,28,0,0,66,66,0,1,0,1,0
16342,28,0,0,70,70,0,1,0,1,0
2744,1238,12026,918,881,126,755,2,31,1,1
8893,26,27615,16,1461,761,700,15,130,8,7
20144,28,0,0,70,70,0,1,0,1,0
22222,10,26235,9,168,86,82,2,30,1,1
1330,918,0,0,62,62,0,1,0,1,0
3719,15,27350,11,350,210,140,6,15,4,2
22490,10,22107,9,94,94,0,1,30,1,0
14018,10,13906,9,289,97,192,4,44,2,2
17060,28,0,0,70,70,0,1,0,1,0
17847,15,29006,11,821011,16040,804971,778,100,238,540
5299,15,10722,11,78,78,0,1,5,1,0
22518,10,14372,9,216,110,106,2,29,1,1
12828,28,0,0,66,66,0,1,0,1,0
10501,26,11919,16,322,66,256,6,16,2,4
19417,28,0,0,66,66,0,1,0,1,0
16021,2102,20372,1620,519,166,353,2,1200,1,1
1120,26,1574,16,7231,1442,5789,21,30,10,11
2597,1771,0,0,66,66,0,1,0,1,0
12299,2256,0,0,62,62,0,1,0,1,0
7756,2256,0,0,66,66,0,1,0,1,0
6582,26,21041,16,79561,11513,68048,183,94,95,88
15552,10,21866,9,209,110,99,2,30,1,1
8865,10,7356,9,266,89,177,4,58,2,2
21774,10,28396,9,199,94,105,2,30,1,1
8276,2820,0,0,160,160,0,1,0,1,0
15630,2587,0,0,62,62,0,1,0,1,0
7744,26,20474,16,4567,1660,2907,19,28,11,8
13881,10,7547,9,178,94,84,2,29,1,1
14306,1589,0,0,66,66,0,1,0,1,0
759,3216,0,0,146,146,0,1,0,1,0
0,0,0,0,110,110,0,1,0,1,0
170,10,3834,9,210,78,132,2,30,1,1
9591,15,21923,11,67694,29654,38040,85,37,40,45
16951,255,0,0,62,62,0,1,0,1,0
21353,2788,6093,2163,70,70,0,1,4,1,0
22409,10,3051,9,167,86,81,2,30,1,1
21809,10,11511,9,178,94,84,2,30,1,1
17889,26,20989,16,181413,11493,169920,167,85,41,126
10425,28,0,0,70,70,0,1,0,1,0
21569,10,3617,9,226,110,116,2,30,1,1
20117,26,20450,16,14840,3978,10862,32,33,15,17
8766,15,3027,11,312,192,120,6,41,4,2
15588,1147,0,0,66,66,0,1,0,1,0
20445,1771,0,0,66,66,0,1,0,1,0
18905,26,27034,16,24367,4634,19733,52,49,26,26
1513,1771,0,0,66,66,0,1,0,1,0
8843,1147,0,0,62,62,0,1,0,1,0
22313,10,8377,9,266,87,179,4,32,2,2
12844,1017,0,0,62,62,0,1,0,1,0
22709,10,568,9,379,94,285,2,30,1,1
12577,26,6443,16,499,425,74,4,0,3,1
7015,7,0,0,60,60,0,1,0,1,0
14020,10,21341,9,177,94,83,2,29,1,1
15524,10,13308,9,199,102,97,2,30,1,1
9728,287,21971,184,1326,300,1026,6,1200,3,3
19205,28,0,0,70,70,0,1,0,1,0
10102,28,0,0,70,70,0,1,0,1,0
686,10,2724,9,215,80,135,2,33,1,1
14312,15,21098,11,70,70,0,1,5,1,0
636,280,0,0,62,62,0,1,0,1,0
691,608,0,0,66,66,0,1,91,1,0
637,2107,17858,1623,492,150,342,2,1200,1,1
16719,10,15149,9,251,79,172,2,30,1,1
12958,295,23783,190,770727,19843,750884,802,16,295,507
9744,15,22066,11,4262,3329,933,17,19,9,8
1233,3216,0,0,66,66,0,1,0,1,0
13350,28,0,0,70,70,0,1,0,1,0
15347,10,24717,9,168,86,82,2,30,1,1
2865,1017,0,0,146,146,0,1,0,1,0
12657,26,18162,16,499,425,74,4,0,3,1
5567,2256,0,0,62,62,0,1,0,1,0
15350,10,12,9,733,85,648,2,30,1,1
9461,1167,0,0,66,66,0,1,0,1,0
11097,28,0,0,70,70,0,1,0,1,0
17936,2883,0,0,66,66,0,1,0,1,0
11177,1477,27406,1124,66,66,0,1,5,1,0
14494,10,17256,9,184,94,90,2,30,1,1
1909,636,965,441,150,150,0,1,1200,1,0
11957,15,631,11,2725,1228,1497,24,90,13,11
12115,15,14553,11,1054,602,452,10,20,5,5
10641,26,15937,16,7086,2173,4913,20,16,10,10
1365,1147,0,0,146,146,0,1,0,1,0
22055,10,1023,9,190,97,93,2,31,1,1
19628,15,15612,11,4454,591,3863,12,45,6,6
5670,1147,0,0,62,62,0,1,0,1,0
8457,28,0,0,70,70,0,1,0,1,0
14130,10,10392,9,305,94,211,2,30,1,1
22696,10,2646,9,229,102,127,2,30,1,1
7509,218,0,0,60,60,0,1,0,1,0
9568,2852,0,0,62,62,0,1,0,1,0
22097,10,527,9,190,97,93,2,31,1,1
13937,28,0,0,66,66,0,1,0,1,0
1362,2091,11744,1612,70,70,0,2,8,2,0
12610,3216,0,0,66,66,0,1,0,1,0
15528,10,176,9,183,94,89,2,30,1,1
22192,28,0,0,70,70,0,1,0,1,0
20898,2256,0,0,62,62,0,1,0,1,0
8788,10,19671,9,185,102,83,2,30,1,1
15094,28,0,0,66,66,0,1,0,1,0
12381,28,0,0,66,66,0,1,0,1,0
2770,983,0,0,146,146,0,1,0,1,0
10644,28,0,0,70,70,0,1,0,1,0
4835,2627,27638,2037,158,158,0,1,1200,1,0
21077,15,681,11,314,192,122,6,15,4,2
636,280,20901,177,238,118,120,2,1200,1,1
9557,15,4873,11,8388,2010,6378,17,23,8,9
6301,18,6156,13,184,94,90,2,30,1,1
22500,26,1138,16,5756,1781,3975,23,136,11,12
10341,26,20301,16,9649,4615,5034,42,16,24,18
22610,1215,0,0,62,62,0,1,0,1,0
10897,10,348,9,179,86,93,2,30,1,1
9499,2205,0,0,66,66,0,1,0,1,0
12391,788,25079,573,320,140,180,6,7,3,3
636,1202,0,0,143,143,0,1,0,1,0
1169,1984,11383,1514,148,86,62,2,30,1,1
8184,26,6805,16,371295,17988,353307,571,40,233,338
8794,26,5981,16,12843,3808,9035,26,81,13,13
17025,308,0,0,66,66,0,1,0,1,0
10952,849,24655,624,70,70,0,2,8,2,0
787,15,3248,11,1700,1073,627,15,84,8,7
6534,26,19919,16,4296557,96359,4200198,3781,143,838,2943
9232,26,8723,16,9873,2384,7489,25,242,14,11
17915,26,26512,16,4666,1759,2907,19,28,11,8
10078,2256,0,0,62,62,0,1,0,1,0
10007,10,8860,9,78,78,0,1,30,1,0
12260,28,0,0,70,70,0,1,0,1,0
17957,26,8150,16,14702,1976,12726,28,18,10,18
21941,10,26971,9,315,98,217,4,58,2,2
10309,10,22378,9,221,89,132,2,30,1,1
11906,509,0,0,66,66,0,1,0,1,0
19694,201,0,0,146,146,0,1,0,1,0
0,0,0,0,156,156,0,2,0,2,0
22206,10,13720,9,210,110,100,2,30,1,1
4962,10,1492,9,168,78,90,2,31,1,1
15925,308,0,0,66,66,0,1,0,1,0
5462,26,21042,16,4719,2313,2406,15,132,7,8
22416,28,0,0,66,66,0,1,0,1,0
18425,28,0,0,70,70,0,1,0,1,0
19318,28,0,0,70,70,0,1,0,1,0
14931,10,13144,9,287,102,185,2,30,1,1
8493,28,0,0,70,70,0,1,0,1,0
20126,28,0,0,70,70,0,1,0,1,0
14492,55,22011,38,323,150,173,2,1200,1,1
6988,183,19414,121,4870,2631,2239,23,19,13,10
10442,1482,0,0,66,66,0,1,0,1,0
11576,28,0,0,66,66,0,1,0,1,0
8719,10,1998,9,614,239,375,6,53,3,3
15126,10,27362,9,183,94,89,2,30,1,1
20677,28,0,0,70,70,0,1,0,1,0
10052,28,0,0,70,70,0,1,0,1,0
13074,185,0,0,60,60,0,1,0,1,0
13974,10,5586,9,295,101,194,4,31,2,2
4589,26,11723,16,64440,16508,47932,101,142,44,57
15483,10,9383,9,199,102,97,2,29,1,1
16951,255,0,0,62,62,0,1,0,1,0
0,0,0,0,156,156,0,2,0,2,0
11850,26,25863,16,14630,5941,8689,52,115,26,26
13326,10,0,0,82,82,0,1,30,1,0
11033,2235,0,0,66,66,0,1,0,1,0
21419,10,15266,9,301,108,193,4,50,2,2
15457,10,27642,9,184,94,90,2,30,1,1
14387,26,27041,16,12723734,404530,12319204,13539,134,4494,9045
12285,28,0,0,70,70,0,1,0,1,0
8584,1272,4802,952,269,78,191,2,30,1,1
11821,26,3650,16,41094,14929,26165,126,116,69,57
22603,28,0,0,70,70,0,1,0,1,0
13673,10,6882,9,299,110,189,4,31,2,2
13550,28,0,0,70,70,0,1,0,1,0
3822,1017,0,0,146,146,0,1,0,1,0
7028,15,9396,11,1270,387,883,16,393,4,12
21403,10,4579,9,186,95,91,2,31,1,1
3185,10,13489,9,233,90,143,2,32,1,1
4142,26,11330,16,13562,3104,10458,38,201,22,16
19286,15,1667,11,13706,1388,12318,26,255,14,12
13285,26,2717,16,2638,330,2308,12,135,5,7
20003,26,27329,16,13396186,148566,13247620,10474,59,1498,8976
14994,28,0,0,70,70,0,1,0,1,0
491,2953,0,0,62,62,0,1,0,1,0
10278,1539,0,0,66,66,0,1,0,1,0
22412,2953,0,0,66,66,0,1,0,1,0
22408,28,0,0,70,70,0,1,0,1,0
4755,26,5212,16,1781,1062,719,16,275,8,8
10919,28,0,0,66,66,0,1,0,1,0
21389,28,0,0,66,66,0,1,0,1,0
18303,26,5529,16,1058,641,417,10,50,6,4
21477,28,0,0,70,70,0,1,0,1,0
52,131,0,0,146,146,0,1,0,1,0
22470,28,0,0,70,70,0,1,0,1,0
15106,28,0,0,70,70,0,1,0,1,0
8012,983,0,0,66,66,0,1,0,1,0
9084,28,0,0,66,66,0,1,0,1,0
9055,10,12936,9,788,108,680,2,31,1,1
8467,26,13483,16,4364,2129,2235,12,121,6,6
18352,10,20431,9,215,86,129,2,30,1,1
13867,26,29145,16,10435,2860,7575,27,46,15,12
21044,2587,0,0,66,66,0,1,0,1,0
844,1,0,0,146,146,0,1,0,1,0
13565,28,0,0,70,70,0,1,0,1,0
9772,15,28967,11,4349,647,3702,16,22,7,9
139,15,301,11,78576,5218,73358,91,95,36,55
21275,2341,19271,1825,70,70,0,1,5,1,0
4140,26,22308,16,13084,2704,10380,36,201,21,15
15990,2587,0,0,62,62,0,1,0,1,0
13735,1147,0,0,66,66,0,1,0,1,0
6975,1017,0,0,62,62,0,1,0,1,0
9689,26,22440,16,9654,1771,7883,27,186,14,13
22516,1264,5004,944,1233,924,309,6,31,3,3
14082,10,24129,9,96,96,0,2,31,2,0
8051,676,14026,475,130,70,60,2,6,1,1
6073,2883,0,0,62,62,0,1,0,1,0
11078,15,5938,11,41486,20844,20642,64,37,32,32
2744,1239,23214,919,879,126,753,2,30,1,1
14905,10,10089,9,209,110,99,2,30,1,1
16951,255,0,0,62,62,0,1,0,1,0
3418,10,12634,9,168,78,90,2,30,1,1
3686,15,14665,11,424,198,226,7,141,4,3
19231,1054,0,0,62,62,0,1,0,1,0
19137,2883,0,0,66,66,0,1,0,1,0
2599,7,0,0,60,60,0,1,0,1,0
12498,1539,0,0,62,62,0,1,0,1,0
17275,2587,0,0,146,146,0,1,0,1,0
21697,28,0,0,66,66,0,1,0,1,0
5963,26,11923,16,1843,996,847,17,275,8,9
22145,10,4539,9,349,94,255,2,30,1,1
9566,2587,0,0,66,66,0,1,0,1,0
19247,983,0,0,66,66,0,1,0,1,0
16951,255,0,0,62,62,0,1,0,1,0
12117,26,23329,16,4456,2436,2020,19,24,10,9
14341,1147,0,0,62,62,0,1,0,1,0
9498,2883,0,0,66,66,0,1,0,1,0
13276,28,0,0,66,66,0,1,0,1,0
3377,26,21164,16,6509,973,5536,17,25,10,7
11719,3216,0,0,66,66,0,1,0,1,0
9612,26,15273,16,227265,6450,220815,225,124,63,162
9684,28,0,0,66,66,0,1,0,1,0
13277,28,0,0,70,70,0,1,0,1,0
16463,26,12895,16,9596,1688,7908,26,255,13,13
18103,1827,0,0,66,66,0,1,0,1,0
10994,64,22839,47,70,70,0,2,8,2,0
0,0,0,0,156,156,0,2,0,2,0
8872,10,14691,9,258,110,148,2,30,1,1
17441,28,0,0,70,70,0,1,0,1,0
15307,26,20630,16,6205,986,5219,16,48,10,6
15695,10,13588,9,177,94,83,2,30,1,1
15714,10,27306,9,183,94,89,2,29,1,1
15713,1936,0,0,66,66,0,1,0,1,0
5112,26,16072,16,13923,1728,12195,24,16,10,14
18993,697,0,0,146,146,0,1,0,1,0
19452,983,0,0,66,66,0,1,0,1,0
8584,1245,28280,925,229,71,158,2,31,1,1
9893,28,0,0,70,70,0,1,0,1,0
1979,2636,0,0,66,66,0,1,0,1,0
18501,797,0,0,66,66,0,1,0,1,0
9633,15,10379,11,318,192,126,6,25,4,2
9001,10,20606,9,214,110,104,2,30,1,1
21343,10,20595,9,168,86,82,2,31,1,1
15948,26,25358,16,4729,1822,2907,19,27,11,8
3776,15,2941,11,1056,682,374,10,16,6,4
2744,1241,10207,921,882,126,756,2,30,1,1
5072,26,6622,16,9096,1676,7420,20,18,10,10
13718,15,21118,11,1646,998,648,13,85,7,6
7697,26,23803,16,10326,4295,6031,29,62,16,13
21399,1147,0,0,146,146,0,1,0,1,0
19129,28,0,0,70,70,0,1,0,1,0
13193,28,0,0,66,66,0,1,0,1,0
21463,2587,0,0,146,146,0,1,0,1,0
17907,2256,0,0,66,66,0,1,0,1,0
10864,1771,0,0,66,66,0,1,0,1,0
1764,1054,0,0,146,146,0,1,0,1,0
22310,28,0,0,70,70,0,1,0,1,0
12558,28,0,0,70,70,0,1,0,1,0
11161,1407,21237,1070,70,70,0,2,8,2,0
3924,10,22582,9,168,78,90,2,30,1,1
16029,28,0,0,70,70,0,1,0,1,0
13074,185,0,0,60,60,0,1,0,1,0
14386,28,0,0,66,66,0,1,0,1,0
9214,3256,0,0,60,60,0,1,0,1,0
11180,1940,0,0,66,66,0,1,0,1,0
12187,28,0,0,70,70,0,1,0,1,0
13291,15,26055,11,4162,3455,707,14,15,8,6
12787,311,27793,203,70,70,0,1,5,1,0
5008,509,0,0,66,66,0,1,0,1,0
6991,1827,0,0,62,62,0,1,0,1,0
406,2587,0,0,62,62,0,1,0,1,0
6651,1129,0,0,156,156,0,1,0,1,0
22475,10,19652,9,264,110,154,2,30,1,1
21584,10,4191,9,193,102,91,2,30,1,1
8658,10,17727,9,199,102,97,2,31,1,1
13552,3051,0,0,62,62,0,1,0,1,0
16383,26,11691,16,2653,1558,1095,18,124,10,8
636,280,0,0,146,146,0,1,0,1,0
17756,28,0,0,66,66,0,1,0,1,0
10495,28,0,0,70,70,0,1,0,1,0
15984,26,9887,16,6277,1727,4550,16,75,9,7
20223,1147,0,0,66,66,0,1,0,1,0
9170,10,17960,9,994,86,908,2,29,1,1
7704,234,13107,149,11647,2439,9208,47,3724,21,26
14089,10,24152,9,184,94,90,2,30,1,1
21588,1147,0,0,66,66,0,1,0,1,0
6852,7,0,0,60,60,0,1,0,1,0
15783,28,0,0,70,70,0,1,0,1,0
1557,2587,0,0,146,146,0,1,0,1,0
12,443,0,0,66,66,0,1,0,1,0
636,256,2479,161,501,150,351,2,1200,1,1
10327,2931,29081,2274,491,150,341,2,1200,1,1
12169,26,16693,16,4228,1083,3145,15,31,8,7
13631,28,0,0,70,70,0,1,0,1,0
21335,15,7099,11,374,192,182,7,15,4,3
12758,10,0,0,222,82,140,2,30,1,1
14265,1343,21986,1018,316,190,126,5,15,3,2
2084,1471,0,0,145,145,0,1,0,1,0
2084,1471,0,0,145,145,0,1,0,1,0
8778,15,18406,11,1388,562,826,11,315,6,5
2046,287,27997,184,480,149,331,2,1200,1,1
9549,15,28448,11,4530,3395,1135,15,32,8,7
12458,26,4008,16,8347,1979,6368,32,19,17,15
8937,10,27246,9,86,86,0,1,30,1,0
21174,2938,0,0,62,62,0,1,0,1,0
2151,3216,0,0,66,66,0,1,0,1,0
15720,28,0,0,66,66,0,1,0,1,0
9583,15,21975,11,96018,5956,90062,107,20,41,66
303,3216,0,0,62,62,0,1,0,1,0
4070,697,0,0,66,66,0,1,0,1,0
11315,28,0,0,70,70,0,1,0,1,0
2744,1238,17613,918,1618,126,1492,4,31,2,2
14814,28,0,0,70,70,0,1,0,1,0
15972,10,3255,9,193,102,91,2,29,1,1
12095,26,28943,16,3656,2345,1311,18,17,9,9
14721,10,13971,9,183,94,89,2,30,1,1
14286,2271,27483,1758,70,70,0,1,5,1,0
8526,3216,0,0,66,66,0,1,0,1,0
9061,26,14488,16,8586,1352,7234,27,34,13,14
10327,3166,18306,2453,480,149,331,2,1201,1,1
22124,10,11266,9,209,110,99,2,31,1,1
22340,28,0,0,70,70,0,1,0,1,0
6379,2938,0,0,62,62,0,1,0,1,0
14451,10,20324,9,183,94,89,2,30,1,1
2423,1017,0,0,62,62,0,1,0,1,0
11787,1019,0,0,66,66,0,1,0,1,0
16341,26,23126,16,1981,1155,826,19,86,10,9
20123,2587,0,0,62,62,0,1,0,1,0
1909,2661,8264,2068,150,150,0,1,1200,1,0
21585,10,20850,9,179,94,85,2,29,1,1
10943,15,26143,11,366,240,126,7,29,5,2
16951,255,25970,160,130,66,64,2,4,1,1
15043,10,26043,9,177,94,83,2,30,1,1
1525,1444,0,0,145,145,0,1,0,1,0
10953,26,1763,16,8964,6357,2607,44,163,23,21
17542,15,26310,11,109128,4773,104355,197,16,68,129
4776,26,14174,16,282171,13444,268727,377,201,175,202
16177,280,0,0,146,146,0,1,0,1,0
8989,10,12432,9,178,94,84,2,31,1,1
21834,10,8351,9,183,94,89,2,31,1,1
6261,10,1362,9,164,78,86,2,30,1,1
1575,2938,0,0,66,66,0,1,0,1,0
10475,6,0,0,60,60,0,1,0,1,0
4153,1472,0,0,62,62,0,1,0,1,0
19497,28,0,0,66,66,0,1,0,1,0
19261,26,24586,16,9604,5021,4583,29,86,15,14
11140,28,0,0,70,70,0,1,0,1,0
9374,2938,0,0,62,62,0,1,0,1,0
1944,1880,0,0,66,66,0,1,0,1,0
1032,26,16868,16,3614,434,3180,11,15,6,5
8759,234,10671,149,9720,2717,7003,67,1019,34,33
13694,26,22661,16,36648,3634,33014,51,62,23,28
2093,840,0,0,146,146,0,1,0,1,0
17063,26,19534,16,5108,700,4408,15,15,7,8
11199,26,23226,16,7905,4819,3086,27,139,13,14
5975,26,3012,16,3978,2714,1264,24,83,13,11
22401,28,0,0,66,66,0,1,0,1,0
19191,28,0,0,70,70,0,1,0,1,0
17503,28,0,0,66,66,0,1,0,1,0
17437,28,0,0,70,70,0,1,0,1,0
22690,28,0,0,70,70,0,1,0,1,0
9622,15,15950,11,2869,1173,1696,11,21,6,5
15966,1147,0,0,62,62,0,1,0,1,0
8325,26,1379,16,3655,1807,1848,17,15,9,8
19385,1888,0,0,66,66,0,1,0,1,0
16136,26,13678,16,7527,1788,5739,23,20,13,10
636,280,208,177,237,118,119,2,1200,1,1
15273,26,19996,16,8058,2038,6020,20,15,11,9
1390,1880,0,0,62,62,0,1,0,1,0
18313,28,0,0,66,66,0,1,0,1,0
10073,26,9328,16,12831,2277,10554,37,145,17,20
21076,28,0,0,70,70,0,1,0,1,0
21335,28,0,0,70,70,0,1,0,1,0
1525,1444,0,0,145,145,0,1,0,1,0
14598,10,726,9,199,102,97,2,30,1,1
12285,15,6392,11,1638,1324,314,10,15,5,5
9298,26,17534,16,9040,2349,6691,22,64,13,9
1804,1762,0,0,60,60,0,1,0,1,0
14589,15,6744,11,824,469,355,9,360,5,4
10125,28,0,0,66,66,0,1,0,1,0
7084,26,9128,16,94099,5885,88214,140,104,69,71
19617,2636,0,0,66,66,0,1,0,1,0
21140,759,17300,547,66,66,0,1,5,1,0
15919,10,3695,9,346,102,244,2,31,1,1
9459,1543,0,0,66,66,0,1,90,1,0
21831,10,21611,9,184,94,90,2,30,1,1
10048,15,19322,11,11456216,116932,11339284,9298,139,1683,7615
9418,26,11412,16,772,432,340,12,18,7,5
14105,10,23145,9,754,94,660,2,31,1,1
22619,10,27148,9,195,102,93,2,30,1,1
11825,26,18990,16,5455,1388,4067,17,15,9,8
9471,2382,0,0,66,66,0,1,0,1,0
22053,10,24776,9,200,102,98,2,31,1,1
4641,740,19233,531,432,192,240,8,30,4,4
3225,2013,19118,1543,253,190,63,2,31,1,1
9223,26,21744,16,4118,2209,1909,36,239,21,15
497,82,0,0,103,103,0,1,0,1,0
15679,10,81,9,178,94,84,2,30,1,1
612,2252,0,0,60,60,0,1,0,1,0
21062,1182,18248,872,436,254,182,7,15,4,3
10065,15,19216,11,9932735,85391,9847344,7875,123,1237,6638
16021,2187,13584,1692,545,166,379,2,1200,1,1
1573,10,5657,9,215,80,135,2,34,1,1
14316,10,3238,9,184,94,90,2,30,1,1
2866,15,724,11,2058,589,1469,10,45,6,4
19273,28,0,0,70,70,0,1,0,1,0
22652,28,0,0,66,66,0,1,0,1,0
14859,10,11277,9,186,95,91,2,31,1,1
2744,1240,10053,920,880,126,754,2,30,1,1
9429,28,0,0,70,70,0,1,0,1,0
9365,26,9582,16,6796,1796,5000,26,257,14,12
7031,10,9426,9,168,78,90,2,30,1,1
8985,10,6972,9,193,102,91,2,29,1,1
21344,26,19484,16,11223,3362,7861,62,280,27,35
18501,10,3915,9,77,77,0,2,31,2,0
4835,1124,12835,828,480,149,331,2,1200,1,1
14408,10,768,9,184,94,90,2,30,1,1
21666,10,14060,9,178,94,84,2,29,1,1
15870,26,26535,16,134,60,74,3,5,2,1
5141,26,13917,16,90273,3481,86792,96,15,31,65
15902,28,0,0,70,70,0,1,0,1,0
3123,2380,0,0,62,62,0,1,0,1,0
2724,1240,8501,920,422,164,258,6,30,3,3
6553,10,18745,9,247,98,149,2,34,1,1
7326,1649,0,0,60,60,0,1,0,1,0
8874,26,23725,16,456387,11878,444509,427,81,121,306
9182,28,0,0,66,66,0,1,0,1,0
14248,10,4691,9,177,94,83,2,29,1,1
11357,3216,0,0,66,66,0,1,0,1,0
15864,26,24554,16,35035,5135,29900,81,216,33,48
15528,15,28812,11,214,140,74,4,30,3,1
16313,28,0,0,70,70,0,1,0,1,0
7675,26,14965,16,2809,1884,925,19,25,11,8
8445,28,0,0,70,70,0,1,0,1,0
8647,295,21509,190,3066,1675,1391,16,14,9,7
444,10,1518,9,213,87,126,2,31,1,1
15838,10,14098,9,178,94,84,2,30,1,1
15433,1584,27716,1214,70,70,0,2,8,2,0
1219,884,23974,653,489,149,340,2,1200,1,1
9704,15,23943,11,318,192,126,6,26,4,2
11855,15,24798,11,4085,2870,1215,23,358,14,9
9418,10,3795,9,744,95,649,2,30,1,1
11626,1017,0,0,66,66,0,1,0,1,0
1306,914,0,0,62,62,0,1,0,1,0
8859,10,21523,9,209,110,99,2,30,1,1
12024,2126,19720,1640,70,70,0,2,8,2,0
18656,28,0,0,70,70,0,1,0,1,0
11514,28,0,0,66,66,0,1,0,1,0
1807,2820,0,0,145,145,0,1,0,1,0
20163,2636,0,0,66,66,0,1,0,1,0
13017,3216,0,0,66,66,0,1,0,1,0
8887,28,0,0,70,70,0,1,0,1,0
8390,26,7014,16,14838,6995,7843,52,244,26,26
17923,28,0,0,66,66,0,1,0,1,0
9742,15,22064,11,10463,6606,3857,36,27,20,16
8458,10,11135,9,277,110,167,2,30,1,1
18149,28,0,0,70,70,0,1,0,1,0
21914,10,3850,9,183,94,89,2,29,1,1
17982,1017,0,0,146,146,0,1,0,1,0
16152,28,0,0,70,70,0,1,0,1,0
8327,1897,23059,1450,676,367,309,6,1200,3,3
10910,342,15885,218,86,86,0,1,30,1,0
17025,465,0,0,145,145,0,1,0,1,0
17188,1086,0,0,66,66,0,1,0,1,0
1171,26,11498,16,10336,4760,5576,37,315,18,19
13787,10,14586,9,165,86,79,2,30,1,1
12586,28,0,0,70,70,0,1,0,1,0
12604,26,24742,16,499,425,74,4,0,3,1
1587,7,0,0,60,60,0,1,0,1,0
16951,255,0,0,62,62,0,1,0,1,0
11675,26,14535,16,56339,3530,52809,79,26,39,40
11265,26,22851,16,4892,844,4048,19,21,9,10
22392,10,20060,9,328,93,235,4,29,2,2
21299,10,21133,9,197,102,95,2,31,1,1
10823,545,17606,362,70,70,0,2,8,2,0
9522,10,16194,9,167,78,89,2,30,1,1
20517,28,0,0,70,70,0,1,0,1,0
9682,15,11858,11,4314,3518,796,15,32,8,7
670,10,2654,9,644,90,554,2,30,1,1
9839,15,26881,11,58726,30286,28440,246,175,123,123
14583,10,8213,9,762,98,664,2,30,1,1
17155,15,26522,11,1601,902,699,8,387,5,3
16451,26,8097,16,14465,1797,12668,30,170,14,16
21910,28,0,0,66,66,0,1,0,1,0
20280,28,0,0,66,66,0,1,0,1,0
10692,15,8372,11,44842,2446,42396,73,255,34,39
17108,26,25897,16,5167,700,4467,16,15,7,9
8467,26,4490,16,26747,8027,18720,58,92,25,33
17382,26,24806,16,10912,6095,4817,28,17,15,13
16330,28,0,0,70,70,0,1,0,1,0
2084,1471,0,0,145,145,0,1,0,1,0
2368,3216,0,0,62,62,0,1,0,1,0
13840,10,8851,9,195,102,93,2,29,1,1
18544,28,0,0,70,70,0,1,0,1,0
15276,10,24038,9,211,110,101,2,30,1,1
9344,183,21848,121,3409,1454,1955,16,16,8,8
22472,10,26807,9,807,94,713,2,30,1,1
15006,26,8205,16,9901,1298,8603,19,79,10,9
17301,28,0,0,70,70,0,1,0,1,0
3238,697,0,0,66,66,0,1,0,1,0
21994,10,20069,9,793,101,692,2,30,1,1
16983,10,11441,9,298,102,196,2,29,1,1
13734,10,20013,9,209,102,107,2,30,1,1
14409,10,13586,9,102,102,0,1,30,1,0
5092,676,24967,475,138,78,60,2,6,1,1
16951,255,25970,160,66,66,0,1,4,1,0
18203,2601,0,0,66,66,0,1,0,1,0
16256,1482,0,0,66,66,0,1,0,1,0
11298,28,0,0,70,70,0,1,0,1,0
22371,10,19509,9,749,94,655,2,30,1,1
20498,10,18574,9,569,164,405,2,30,1,1
13953,10,5138,9,168,78,90,2,29,1,1
2724,1240,4905,920,422,164,258,6,30,3,3
15318,28,0,0,70,70,0,1,0,1,0
12800,589,1525,400,70,70,0,1,5,1,0
13874,10,26190,9,212,102,110,2,30,1,1
21263,10,21149,9,447,94,353,4,54,2,2
4413,26,15806,16,4555,1648,2907,19,29,11,8
9113,15,14562,11,16663,923,15740,25,15,11,14
18179,26,7999,16,2531,1288,1243,17,140,9,8
22071,10,4366,9,755,93,662,2,31,1,1
16951,255,0,0,62,62,0,1,0,1,0
3418,26,21848,16,1067,650,417,10,73,6,4
13919,28,0,0,66,66,0,1,0,1,0
17862,15,18422,11,815748,15896,799852,777,90,244,533
9749,26,25011,16,1766,975,791,15,71,9,6
5382,10,19878,9,168,78,90,2,30,1,1
2744,1200,17816,888,889,126,763,2,31,1,1
15896,28,0,0,70,70,0,1,0,1,0
10917,28,0,0,66,66,0,1,0,1,0
20670,28,0,0,70,70,0,1,0,1,0
17685,10,13076,9,212,92,120,2,30,1,1
11834,3216,0,0,62,62,0,1,0,1,0
15309,26,27026,16,7889,1900,5989,20,15,11,9
17315,28,0,0,70,70,0,1,0,1,0
22428,10,0,0,88,88,0,1,0,1,0
5362,26,13648,16,4179,1480,2699,18,124,9,9
21313,1086,0,0,66,66,0,1,0,1,0
7326,180,0,0,60,60,0,1,0,1,0
22169,10,20665,9,192,98,94,2,30,1,1
14179,10,10083,9,209,110,99,2,29,1,1
2141,1086,0,0,66,66,0,1,0,1,0
16951,255,0,0,62,62,0,1,0,1,0
9679,10,6134,9,210,110,100,2,29,1,1
13672,10,28529,9,312,89,223,4,36,2,2
9854,26,17917,16,6141,1268,4873,22,18,12,10
14282,841,9691,619,70,70,0,2,8,2,0
8837,10,14610,9,242,110,132,2,30,1,1
17774,28,0,0,66,66,0,1,0,1,0
313,1215,0,0,62,62,0,1,0,1,0
12304,26,17985,16,6824,2097,4727,19,15,11,8
8584,1238,10270,918,78,78,0,1,30,1,0
12246,26,6682,16,4317,1134,3183,16,26,9,7
16466,15,4590,11,495,192,303,6,21,4,2
4751,234,28827,149,6930,1665,5265,18,3601,9,9
21898,28,0,0,70,70,0,1,0,1,0
5554,26,13638,16,6073,1628,4445,23,15,12,11
13121,28,0,0,66,66,0,1,0,1,0
19419,28,0,0,66,66,0,1,0,1,0
9105,26,14764,16,8754,2895,5859,26,16,15,11
11107,28,0,0,70,70,0,1,0,1,0
11589,28,0,0,70,70,0,1,0,1,0
21157,3064,17207,2379,66,66,0,2,7,2,0
17706,28,0,0,70,70,0,1,0,1,0
9563,26,19427,16,4590,575,4015,14,28,6,8
22177,10,18332,9,200,94,106,2,31,1,1
12894,28,0,0,66,66,0,1,0,1,0
9306,15,10659,11,1915831,46544,1869287,1569,166,311,1258
6161,15,6808,11,42657,2962,39695,68,38,36,32
13661,10,9986,9,166,86,80,2,29,1,1
15400,10,24787,9,177,94,83,2,30,1,1
9519,26,647,16,5419,705,4714,16,25,8,8
22668,28,0,0,70,70,0,1,0,1,0
14220,10,6627,9,817,98,719,2,30,1,1
1804,1221,0,0,60,60,0,1,61,1,0
8724,10,27375,9,423,104,319,4,39,2,2
18889,26,9101,16,3855,2679,1176,28,45,15,13
22033,28,0,0,70,70,0,1,0,1,0
19462,2883,0,0,66,66,0,1,0,1,0
9013,10,5733,9,192,98,94,2,31,1,1
594,1147,0,0,62,62,0,1,0,1,0
3130,10,13123,9,237,91,146,2,32,1,1
10068,28,0,0,66,66,0,1,0,1,0
21047,2398,16736,1865,66,66,0,2,8,2,0
12,207,0,0,187,187,0,1,0,1,0
13248,10,0,0,418,154,264,4,33,2,2
1359,2256,0,0,62,62,0,1,0,1,0
14587,10,27521,9,275,110,165,2,30,1,1
22215,10,2899,9,261,102,159,2,30,1,1
22348,28,0,0,66,66,0,1,0,1,0
2268,26,9315,16,6620,3193,3427,23,26,13,10
7226,1147,0,0,66,66,0,1,0,1,0
20288,991,0,0,145,145,0,1,0,1,0
17167,28,0,0,66,66,0,1,0,1,0
12055,15,14919,11,1487,838,649,10,323,6,4
13794,10,11630,9,178,91,87,2,31,1,1
195,1590,0,0,66,66,0,1,0,1,0
15832,10,5540,9,193,102,91,2,31,1,1
10141,3216,0,0,62,62,0,1,0,1,0
5594,15,3195,11,130,70,60,2,15,1,1
13792,26,1739,16,3522,869,2653,13,121,6,7
9704,26,8459,16,17710,10880,6830,44,271,25,19
20317,1771,0,0,66,66,0,1,0,1,0
10455,26,27558,16,9973,1941,8032,38,121,19,19
10149,1861,0,0,66,66,0,1,0,1,0
11128,1411,15790,1073,70,70,0,2,7,2,0
12,2247,0,0,83,83,0,1,0,1,0
9097,15,21428,11,1130,613,517,11,15,6,5
14045,3216,0,0,66,66,0,1,0,1,0
20804,28,0,0,70,70,0,1,0,1,0
12034,26,2583,16,7121,2564,4557,26,127,15,11
14948,10,16678,9,194,102,92,2,30,1,1
7720,3216,0,0,62,62,0,1,0,1,0
14054,10,6445,9,179,94,85,2,31,1,1
1598,2205,0,0,146,146,0,1,0,1,0
8324,10,21342,9,229,89,140,2,31,1,1
18435,15,26780,11,186272,9792,176480,216,21,93,123
13619,15,11962,11,3419,2046,1373,12,515,7,5
15014,10,9094,9,193,102,91,2,30,1,1
17360,28,0,0,70,70,0,1,0,1,0
10542,15,6290,11,1517,481,1036,11,15,6,5
17945,10,12799,9,377,86,291,2,29,1,1
18106,26,21907,16,2798,1652,1146,15,143,8,7
12,1420,0,0,82,82,0,1,0,1,0
13822,10,6522,9,181,94,87,2,30,1,1
21518,10,27123,9,211,78,133,2,30,1,1
762,15,3092,11,638,306,332,11,84,6,5
12246,28,0,0,70,70,0,1,0,1,0
9705,15,22041,11,1695,995,700,11,21,6,5
10347,28,0,0,66,66,0,1,0,1,0
19084,15,27138,11,21678,2120,19558,33,20,16,17
9387,28,0,0,70,70,0,1,0,1,0
17258,15,21254,11,5412,4758,654,14,14,8,6
11851,26,24700,16,14696,5947,8749,53,115,26,27
9780,15,4909,11,16521,6496,10025,31,49,16,15
8832,15,2927,11,2356,499,1857,10,125,6,4
8171,1073,0,0,60,60,0,1,0,1,0
15360,1402,324,1065,70,70,0,2,8,2,0
16596,28,0,0,66,66,0,1,0,1,0
20712,2702,0,0,66,66,0,1,0,1,0
12391,28,0,0,70,70,0,1,0,1,0
15096,10,3568,9,177,94,83,2,30,1,1
13111,1239,20637,919,924,924,0,3,30,3,0
19156,28,0,0,70,70,0,1,0,1,0
13839,10,572,9,177,94,83,2,30,1,1
15325,10,7830,9,279,118,161,2,30,1,1
11469,26,17289,16,7103,2432,4671,18,76,10,8
18529,3226,23010,2502,70,70,0,2,8,2,0
8396,10,7592,9,178,94,84,2,31,1,1
14835,10,398,9,209,110,99,2,30,1,1
21562,10,738,9,216,110,106,2,30,1,1
15950,10,7071,9,193,102,91,2,31,1,1
8879,10,17158,9,184,94,90,2,30,1,1
10417,28,0,0,70,70,0,1,0,1,0
17283,28,0,0,70,70,0,1,0,1,0
22551,10,16110,9,210,102,108,2,30,1,1
16187,28,0,0,70,70,0,1,0,1,0
15215,26,28765,16,7797,1808,5989,20,14,11,9
17590,28,0,0,70,70,0,1,0,1,0
16710,28,0,0,66,66,0,1,0,1,0
2603,983,0,0,62,62,0,1,0,1,0
11951,26,4087,16,9303,2569,6734,39,106,20,19
13711,10,11896,9,889,404,485,10,30,5,5
15703,10,21551,9,177,94,83,2,30,1,1
22512,15,3246,11,2284,484,1800,10,133,6,4
3080,10,12879,9,200,90,110,2,30,1,1
14492,10,23002,9,166,86,80,2,30,1,1
15924,10,27915,9,170,87,83,2,30,1,1
9919,28,0,0,70,70,0,1,0,1,0
17940,26,26344,16,7083,2786,4297,24,81,14,10
15104,10,25399,9,210,102,108,2,30,1,1
10228,15,14054,11,23850,1662,22188,36,15,19,17
12412,3216,0,0,62,62,0,1,0,1,0
9543,15,8170,11,318,192,126,6,26,4,2
16118,26,5935,16,8937,3934,5003,18,120,9,9
14450,10,1622,9,208,106,102,2,31,1,1
16951,255,0,0,62,62,0,1,0,1,0
11127,28,0,0,70,70,0,1,0,1,0
17652,28,0,0,70,70,0,1,0,1,0
16951,255,0,0,62,62,0,1,0,1,0
10815,1641,6038,1261,70,70,0,2,8,2,0
8329,10,13003,9,401,94,307,4,32,2,2
1308,10,4380,9,197,90,107,2,29,1,1
15512,10,17829,9,322,134,188,2,30,1,1
461,3216,0,0,62,62,0,1,0,1,0
13334,1888,0,0,66,66,0,1,0,1,0
10720,26,20510,16,8488,2174,6314,23,255,12,11
14442,28,0,0,70,70,0,1,0,1,0
9198,28,0,0,66,66,0,1,0,1,0
5606,1995,1494,1525,148,86,62,2,30,1,1
11461,308,0,0,66,66,0,1,0,1,0
13549,28,0,0,70,70,0,1,0,1,0
20831,28,0,0,70,70,0,1,0,1,0
10946,1126,2432,830,70,70,0,2,8,2,0
21665,10,1262,9,194,102,92,2,30,1,1
21441,10,12904,9,94,94,0,1,30,1,0
692,2611,0,0,66,66,0,1,0,1,0
7335,1070,0,0,60,60,0,1,0,1,0
9026,26,2537,16,17924,7867,10057,45,88,24,21
15722,10,8467,9,255,110,145,2,29,1,1
15068,10,27241,9,744,89,655,2,31,1,1
15322,10,20859,9,226,110,116,2,30,1,1
7639,26,20948,16,6162,925,5237,18,179,10,8
10590,28,0,0,70,70,0,1,0,1,0
2946,3216,0,0,62,62,0,1,0,1,0
13745,10,0,0,318,86,232,2,30,1,1
15312,10,15529,9,817,98,719,2,31,1,1
14011,1,0,0,66,66,0,1,0,1,0
9031,28,0,0,70,70,0,1,0,1,0
21442,10,16290,9,197,102,95,2,33,1,1
8404,10,21534,9,216,110,106,2,30,1,1
11422,28,0,0,66,66,0,1,0,1,0
20021,28,0,0,66,66,0,1,0,1,0
11917,26,23233,16,4787,1880,2907,19,27,11,8
9861,15,1318,11,620,320,300,11,166,6,5
13629,28,0,0,70,70,0,1,0,1,0
0,0,0,0,98,98,0,1,0,1,0
14678,15,29121,11,2458,531,1927,11,75,6,5
11058,15,28331,11,422,240,182,8,24,5,3
4203,26,2948,16,7257,1619,5638,22,275,11,11
20497,26,5947,16,382,164,218,2,30,1,1
12548,1065,2348,784,1903,968,935,16,16,9,7
16951,255,0,0,62,62,0,1,0,1,0
10340,28,0,0,70,70,0,1,0,1,0
18107,26,3760,16,7060,1850,5210,35,110,21,14
5688,1017,0,0,66,66,0,1,0,1,0
9005,10,15871,9,227,110,117,2,30,1,1
7942,26,24344,16,172,172,0,2,5,2,0
13976,28,0,0,70,70,0,1,0,1,0
16241,28,0,0,70,70,0,1,0,1,0
18561,28,0,0,70,70,0,1,0,1,0
13074,28,0,0,70,70,0,1,0,1,0
8164,2727,0,0,60,60,0,1,0,1,0
9024,26,8460,16,10754,2778,7976,38,59,19,19
21977,10,24323,9,190,97,93,2,31,1,1
10921,28,0,0,66,66,0,1,0,1,0
11217,1900,6218,1453,70,70,0,2,9,2,0
8595,26,9157,16,990201,31101,959100,1061,192,383,678
820,26,16702,16,5307,3288,2019,25,397,8,17
19235,28,0,0,70,70,0,1,0,1,0
22344,10,4989,9,210,102,108,2,30,1,1
14319,26,24544,16,165616,8760,156856,199,82,79,120
22437,26,1817,16,26538,8416,18122,54,121,25,29
10271,348,0,0,60,60,0,1,0,1,0
1280,2938,0,0,66,66,0,1,0,1,0
11253,26,19791,16,6710,4371,2339,33,109,18,15
19265,28,0,0,70,70,0,1,0,1,0
8933,26,9327,16,11883,1419,10464,26,127,11,15
21904,10,20176,9,195,102,93,2,31,1,1
8836,10,26565,9,168,86,82,2,31,1,1
1229,1804,0,0,62,62,0,1,0,1,0
1005,26,10410,16,4618,840,3778,16,26,9,7
1984,2587,0,0,62,62,0,1,0,1,0
7873,26,27397,16,214,140,74,4,15,3,1
12477,28,0,0,70,70,0,1,0,1,0
9308,15,21803,11,41846,1261,40585,45,75,13,32
14233,10,11505,9,195,102,93,2,30,1,1
3926,10,9238,9,198,93,105,2,30,1,1
21385,2642,5638,2050,66,66,0,2,7,2,0
14418,10,24602,9,253,99,154,2,32,1,1
3765,26,26178,16,9107,2253,6854,22,185,11,11
10060,28,0,0,70,70,0,1,0,1,0
3751,26,3179,16,9083,2087,6996,28,18,16,12
12565,2936,145,2277,70,70,0,2,8,2,0
16021,2227,13414,1726,480,149,331,2,1200,1,1
3642,491,0,0,148,148,0,1,0,1,0
17697,28,0,0,66,66,0,1,0,1,0
9558,26,12589,16,1346,918,428,10,25,6,4
8455,26,3805,16,7846,2369,5477,23,385,10,13
13968,28,0,0,70,70,0,1,0,1,0
2158,7,0,0,60,60,0,1,0,1,0
16951,255,25970,160,126,62,64,2,5,1,1
13458,28,0,0,66,66,0,1,0,1,0
17248,28,0,0,70,70,0,1,0,1,0
13710,10,5132,9,202,103,99,2,31,1,1
21184,28,0,0,70,70,0,1,0,1,0
8903,26,24958,16,5566,1444,4122,17,129,10,7
15079,10,27792,9,711,87,624,2,31,1,1
864,1017,0,0,62,62,0,1,0,1,0
15850,26,9074,16,5161,2421,2740,14,122,7,7
9411,807,10171,587,1488,930,558,21,1200,12,9
22460,10,13476,9,216,110,106,2,30,1,1
7442,26,7912,16,5571,2240,3331,28,87,14,14
6981,15,22802,11,1295,781,514,12,16,6,6
20779,28,0,0,70,70,0,1,0,1,0
12935,28,0,0,66,66,0,1,0,1,0
19480,28,0,0,70,70,0,1,0,1,0
17692,1147,0,0,62,62,0,1,0,1,0
15844,28,0,0,66,66,0,1,0,1,0
17726,28,0,0,70,70,0,1,0,1,0
16856,28,0,0,66,66,0,1,0,1,0
1360,1472,0,0,62,62,0,1,0,1,0
18144,28,0,0,66,66,0,1,0,1,0
416,797,0,0,66,66,0,1,0,1,0
12982,7,0,0,60,60,0,1,0,1,0
16361,26,8526,16,6938,1531,5407,23,195,13,10
3825,26,18037,16,7974,2716,5258,50,7261,26,24
17386,26,10202,16,48923,5417,43506,61,122,25,36
16009,28,0,0,70,70,0,1,0,1,0
10327,3267,24858,2530,460,150,310,2,1200,1,1
2744,1238,7829,918,1618,126,1492,4,30,2,2
21371,10,24404,9,197,94,103,2,29,1,1
13496,28,0,0,70,70,0,1,0,1,0
14363,10,29128,9,184,94,90,2,31,1,1
11837,26,5219,16,56910,3384,53526,85,115,33,52
14564,10,538,9,814,110,704,2,30,1,1
22428,10,28380,9,267,93,174,4,46,2,2
15510,358,24461,229,78,78,0,1,30,1,0
2744,1621,27065,1243,873,126,747,2,31,1,1
17645,28,0,0,70,70,0,1,0,1,0
11330,10,0,0,247,76,171,2,30,1,1
532,247,0,0,3354,1792,1562,46,194,23,23
10569,26,22521,16,8680,2323,6357,31,173,13,18
20506,1017,0,0,66,66,0,1,0,1,0
9151,26,16911,16,426,180,246,8,21,4,4
14497,10,9884,9,438,180,258,6,30,3,3
22539,10,19834,9,182,93,89,2,31,1,1
6882,26,14664,16,6576,1937,4639,14,120,7,7
1938,1147,0,0,146,146,0,1,0,1,0
17423,2883,0,0,62,62,0,1,0,1,0
14288,10,26675,9,177,94,83,2,30,1,1
12128,26,25485,16,84664,6099,78565,140,70,56,84
17576,28,0,0,70,70,0,1,0,1,0
15925,10,17671,9,167,86,81,2,30,1,1
18924,28,0,0,70,70,0,1,0,1,0
22571,10,9664,9,180,94,86,2,30,1,1
38,1147,0,0,62,62,0,1,0,1,0
9045,26,19762,16,5997,978,5019,19,53,10,9
18703,28,0,0,70,70,0,1,0,1,0
9472,28,0,0,70,70,0,1,0,1,0
2744,1310,16535,987,887,126,761,2,30,1,1
14530,1147,0,0,62,62,0,1,0,1,0
9113,10,3370,9,307,110,197,2,30,1,1
14784,28,0,0,66,66,0,1,0,1,0
1182,2256,0,0,66,66,0,1,0,1,0
2259,2636,0,0,66,66,0,1,0,1,0
12406,26,20028,16,4586,1216,3370,17,28,10,7
14483,10,1535,9,184,94,90,2,31,1,1
6426,1147,0,0,62,62,0,1,0,1,0
12014,26,3586,16,64407,55712,8695,92,364,58,34
15541,15,16611,11,2273,1511,762,7,29,4,3
358,509,0,0,62,62,0,1,0,1,0
11068,2587,0,0,66,66,0,1,0,1,0
8671,26,10834,16,6318,2030,4288,25,270,12,13
16554,28,0,0,66,66,0,1,0,1,0
7082,1539,0,0,62,62,0,1,0,1,0
22396,10,7958,9,436,94,342,2,30,1,1
22200,10,4421,9,578,286,292,9,15,5,4
14076,10,23525,9,209,110,99,2,29,1,1
22308,10,29092,9,183,94,89,2,30,1,1
13213,26,11930,16,2782,1778,1004,20,33,10,10
9923,7,0,0,60,60,0,1,0,1,0
15341,26,24411,16,7888,1899,5989,20,15,11,9
21906,10,22083,9,172,88,84,2,31,1,1
21330,10,18522,9,182,93,89,2,31,1,1
15070,10,4998,9,184,94,90,2,29,1,1
12717,26,18316,16,499,425,74,4,1,3,1
9132,10,27603,9,1412,94,1318,4,33,2,2
17812,28,0,0,70,70,0,1,0,1,0
15672,3216,0,0,66,66,0,1,0,1,0
10519,26,19560,16,318,70,248,5,17,1,4
19650,28,0,0,66,66,0,1,0,1,0
2193,10,8890,9,244,98,146,2,32,1,1
19445,28,0,0,66,66,0,1,0,1,0
12229,1054,0,0,62,62,0,1,0,1,0
1151,10,3886,9,219,87,132,2,31,1,1
18736,15,12086,11,198,78,120,4,11,2,2
1095,26,8859,16,3999,905,3094,15,26,8,7
9727,15,28591,11,630930,27504,603426,812,74,381,431
17416,28,0,0,70,70,0,1,0,1,0
12753,26,17277,16,499,425,74,4,0,3,1
5472,10,22319,9,223,78,145,2,30,1,1
17613,26,1950,16,2854,1732,1122,16,15,8,8
19556,26,7161,16,6962,979,5983,19,15,10,9
12570,1843,20879,1404,70,70,0,1,4,1,0
18769,1356,16444,1029,70,70,0,2,8,2,0
9001,10,3338,9,176,90,86,2,30,1,1
20769,28,0,0,66,66,0,1,0,1,0
1418,10,4916,9,233,90,143,2,33,1,1
2548,2808,0,0,60,60,0,1,0,1,0
16305,28,0,0,66,66,0,1,0,1,0
8840,28,0,0,70,70,0,1,0,1,0
4235,26,26339,16,8859,1662,7197,26,75,14,12
10983,1888,0,0,66,66,0,1,0,1,0
144,3216,0,0,62,62,0,1,0,1,0
10869,15,22683,11,951054,20747,930307,902,26,276,626
15236,26,11005,16,18375,7252,11123,47,40,24,23
14544,10,24567,9,192,98,94,2,31,1,1
14748,10,3775,9,199,102,97,2,30,1,1
14156,10,24982,9,214,110,104,2,30,1,1
16444,2881,0,0,90,90,0,1,0,1,0
14394,26,25744,16,1786,172,1614,7,122,3,4
10128,26,13766,16,3051,1801,1250,18,16,8,10
15542,26,20328,16,6431,1792,4639,22,80,13,9
9638,28,0,0,70,70,0,1,0,1,0
9656,26,24560,16,6945,1842,5103,25,87,14,11
18528,28,0,0,70,70,0,1,0,1,0
9552,10,15607,9,182,93,89,2,31,1,1
18352,15,4583,11,130,70,60,2,15,1,1
2069,2486,0,0,143,143,0,1,0,1,0
20026,28,0,0,70,70,0,1,0,1,0
17600,26,15451,16,11018,5022,5996,84,588,43,41
20610,28,0,0,70,70,0,1,0,1,0
18869,26,6153,16,9934,4897,5037,43,15,25,18
15832,26,27990,16,45483074,398771,45084303,36307,333,3386,32921
6274,26,9031,16,4181,998,3183,14,26,7,7
2744,1238,28626,918,875,126,749,2,30,1,1
11671,28,0,0,70,70,0,1,0,1,0
9503,15,18041,11,318,192,126,6,28,4,2
11596,1804,0,0,66,66,0,1,0,1,0
14269,10,16654,9,184,94,90,2,30,1,1
21950,10,22269,9,195,102,93,2,31,1,1
16951,255,0,0,62,62,0,1,0,1,0
636,340,14549,216,238,118,120,2,1199,1,1
9125,15,8271,11,8315,820,7495,18,15,9,9
17034,26,7012,16,8758,3850,4908,26,330,14,12
771,26,3132,16,10130,4701,5429,34,82,18,16
764,10,3095,9,237,91,146,2,33,1,1
22623,10,14124,9,448,184,264,6,30,3,3
9271,28,0,0,66,66,0,1,0,1,0
13730,10,14045,9,179,94,85,2,29,1,1
8631,26,7002,16,4555,2472,2083,20,119,11,9
15569,10,12744,9,177,94,83,2,29,1,1
7289,15,26620,11,1282,650,632,9,127,5,4
1455,1880,0,0,62,62,0,1,0,1,0
1258,2382,0,0,62,62,0,1,0,1,0
15326,1581,490,1211,70,70,0,1,5,1,0
11106,2256,0,0,66,66,0,1,0,1,0
18293,15,8685,11,8268,6054,2214,23,151,14,9
15204,10,23657,9,183,94,89,2,30,1,1
22223,10,25998,9,775,102,673,2,30,1,1
13343,28,0,0,70,70,0,1,0,1,0
5125,10,16552,9,164,78,86,2,30,1,1
5348,26,15178,16,7134,2290,4844,29,80,15,14
11124,1017,0,0,146,146,0,1,0,1,0
21813,28,0,0,70,70,0,1,0,1,0
9452,26,21907,16,4378,1471,2907,19,30,11,8
19357,1017,0,0,62,62,0,1,0,1,0
8178,15,15996,11,3524,2698,826,14,16,8,6
2744,1241,20465,921,1898,378,1520,6,31,4,2
22668,26,27109,16,92397,4379,88018,102,16,37,65
7637,10,18272,9,447,101,346,4,29,2,2
21436,1771,0,0,66,66,0,1,0,1,0
12424,28,0,0,70,70,0,1,0,1,0
10112,26,28488,16,11897,6250,5647,27,81,14,13
21653,2587,0,0,66,66,0,1,0,1,0
12866,26,5812,16,4454,2001,2453,11,120,6,5
15650,10,35,9,211,102,109,2,30,1,1
12132,2938,0,0,74,74,0,1,0,1,0
611,7,0,0,60,60,0,1,0,1,0
15027,10,27707,9,200,102,98,2,29,1,1
13236,28,0,0,70,70,0,1,0,1,0
5451,26,25767,16,6540,5046,1494,19,115,12,7
3424,1147,0,0,62,62,0,1,0,1,0
9763,26,23015,16,10483,1021,9462,30,100,11,19
8935,15,15770,11,254,128,126,5,15,3,2
12714,26,22027,16,499,425,74,4,1,3,1
150,1017,0,0,66,66,0,1,0,1,0
14811,26,24810,16,4378,1471,2907,19,27,11,8
360,3105,0,0,409,409,0,1,0,1,0
15072,1,0,0,146,146,0,1,0,1,0
9218,15,10875,11,1570,754,816,10,16,6,4
15750,28,0,0,70,70,0,1,0,1,0
6157,15,4016,11,38137,1920,36217,51,81,24,27
6250,2001,2406,1531,148,86,62,2,30,1,1
8988,10,16936,9,388,102,286,2,30,1,1
21056,821,20143,601,2568,1944,624,20,29,13,7
2541,10,21822,9,311,86,225,2,30,1,1
14851,28,0,0,70,70,0,1,0,1,0
13940,1086,0,0,66,66,0,1,0,1,0
17625,1017,0,0,66,66,0,1,0,1,0
21707,28,0,0,66,66,0,1,0,1,0
12172,26,22296,16,3369,1036,2333,11,121,5,6
2548,3149,0,0,60,60,0,1,0,1,0
12225,28,0,0,66,66,0,1,0,1,0
17192,26,5042,16,5167,700,4467,16,15,7,9
11750,2611,0,0,66,66,0,1,0,1,0
12,2568,0,0,99,99,0,1,0,1,0
15709,10,28372,9,166,86,80,2,29,1,1
19307,26,25723,16,4934,771,4163,18,28,8,10
18899,28,0,0,66,66,0,1,0,1,0
9534,26,14696,16,1328,876,452,11,29,6,5
11205,26,22826,16,506908,20303,486605,548,25,204,344
17270,26,26132,16,6792,1521,5271,18,28,11,7
15474,28,0,0,70,70,0,1,0,1,0
14077,28,0,0,70,70,0,1,0,1,0
17100,28,0,0,70,70,0,1,0,1,0
20969,28,0,0,66,66,0,1,0,1,0
12750,26,5847,16,499,425,74,4,0,3,1
9614,3105,0,0,86,86,0,1,0,1,0
13219,26,5552,16,4227,1086,3141,15,28,8,7
15584,2545,0,0,66,66,0,1,0,1,0
9077,10,7001,9,216,110,106,2,31,1,1
16333,3216,0,0,62,62,0,1,0,1,0
8843,3216,0,0,62,62,0,1,0,1,0
15102,10,23188,9,711,87,624,2,31,1,1
20683,10,17325,9,330,228,102,3,33,2,1
15079,10,3944,9,216,94,122,2,31,1,1
22463,2817,0,0,62,62,0,1,0,1,0
6531,6,18716,6,6957,2330,4627,35,27,17,18
163,2205,0,0,62,62,0,1,0,1,0
14594,28,0,0,66,66,0,1,0,1,0
612,5,0,0,60,60,0,1,0,1,0
22468,10,16374,9,226,110,116,2,30,1,1
18376,2883,0,0,66,66,0,1,0,1,0
9157,15,12731,11,21812,900,20912,27,26,9,18
15252,10,10835,9,286,103,183,4,48,2,2
21013,28,0,0,70,70,0,1,0,1,0
13895,28,0,0,66,66,0,1,0,1,0
16067,28,0,0,66,66,0,1,0,1,0
22634,10,8045,9,215,102,113,2,30,1,1
9005,26,13785,16,7084,1611,5473,29,71,15,14
12430,26,27434,16,8510,3207,5303,25,324,13,12
15111,26,12501,16,265430,17951,247479,305,105,122,183
15277,26,23566,16,8058,2038,6020,20,15,11,9
13074,184,0,0,60,60,0,1,0,1,0
14685,28,0,0,70,70,0,1,0,1,0
12665,3010,12270,2340,70,70,0,2,7,2,0
13686,10,7620,9,458,188,270,6,31,3,3
11771,26,8985,16,9582,3906,5676,21,135,10,11
18891,28,0,0,66,66,0,1,0,1,0
16624,28,0,0,66,66,0,1,0,1,0
20646,28,0,0,62,62,0,1,0,1,0
22361,10,10270,9,209,102,107,2,31,1,1
22407,10,22266,9,182,93,89,2,31,1,1
9685,15,9381,11,4296,3281,1015,12,33,7,5
497,653,0,0,66,66,0,1,0,1,0
3567,26,14301,16,2279,1637,642,15,25,9,6
5508,26,3655,16,7903,3497,4406,38,72,22,16
2744,1352,24153,1025,888,126,762,2,30,1,1
20164,28,0,0,66,66,0,1,0,1,0
3776,26,19074,16,5996,1967,4029,17,99,10,7
2143,155,0,0,66,66,0,1,0,1,0
14398,10,10474,9,196,102,94,2,30,1,1
21045,28,0,0,70,70,0,1,0,1,0
5606,2005,16785,1535,148,86,62,2,30,1,1
15018,10,7568,9,198,102,96,2,30,1,1
20442,28,0,0,70,70,0,1,0,1,0
21418,10,13397,9,197,102,95,2,30,1,1
13334,1888,0,0,66,66,0,1,0,1,0
11371,1472,0,0,66,66,0,1,0,1,0
16861,15,26887,11,1666,1130,536,12,16,7,5
21162,3089,2798,2399,5431,3164,2267,32,76,18,14
18170,28,0,0,70,70,0,1,0,1,0
18018,10,16711,9,168,78,90,2,30,1,1
15808,28,0,0,70,70,0,1,0,1,0
636,280,0,0,62,62,0,1,0,1,0
13142,28,0,0,70,70,0,1,0,1,0
11792,26,18755,16,286404,12478,273926,379,118,130,249
8799,15,8735,11,318,192,126,6,41,4,2
5410,391,0,0,60,60,0,1,0,1,0
2521,2636,0,0,66,66,0,1,0,1,0
14058,2938,0,0,74,74,0,1,0,1,0
20182,2953,0,0,62,62,0,1,0,1,0
4274,15,15594,11,1917,1468,449,10,20,6,4
18144,1147,0,0,66,66,0,1,0,1,0
12456,49,20459,32,130,70,60,3,5,2,1
17574,6,26336,6,295,126,169,4,1,2,2
8643,10,15431,9,172,88,84,2,30,1,1
7908,2581,0,0,62,62,0,1,0,1,0
9589,15,21189,11,318,192,126,6,27,4,2
3444,10,2187,9,241272,234761,6511,2872,89,2833,39
16745,28,0,0,70,70,0,1,0,1,0
13926,10,7503,9,771,101,670,2,31,1,1
15537,26,21293,16,8085,2164,5921,22,86,12,10
13982,10,7443,9,208,106,102,2,31,1,1
10533,28,0,0,66,66,0,1,0,1,0
14257,2154,0,0,74,74,0,1,0,1,0
10232,28,0,0,70,70,0,1,0,1,0
18524,456,28633,294,70,70,0,1,5,1,0
13220,26,14575,16,257837,37453,220384,446,952,175,271
16265,2587,0,0,66,66,0,1,0,1,0
10102,26,4056,16,9525,6135,3390,24,120,13,11
3707,26,209,16,1717,1153,564,13,26,7,6
14419,10,18664,9,194,102,92,2,30,1,1
1415,2883,0,0,62,62,0,1,0,1,0
16951,255,0,0,62,62,0,1,0,1,0
16170,15,25499,11,220515,3488,217027,180,31,31,149
14904,28,0,0,66,66,0,1,0,1,0
13930,10,24224,9,188,96,92,2,30,1,1
4853,2504,9221,1947,156,156,0,3,8,3,0
14935,10,10615,9,753,93,660,2,30,1,1
22397,10,27666,9,298,102,196,2,29,1,1
8255,26,23633,16,10085,3487,6598,21,120,9,12
20105,28,0,0,66,66,0,1,0,1,0
758,3216,0,0,62,62,0,1,0,1,0
11086,2578,18101,2000,70,70,0,1,4,1,0
15559,145,0,0,159,159,0,1,0,1,0
16169,28,0,0,66,66,0,1,0,1,0
20953,28,0,0,70,70,0,1,0,1,0
6998,10,19432,9,653,349,304,5,30,3,2
636,3127,0,0,150,150,0,1,0,1,0
9490,28,0,0,70,70,0,1,0,1,0
14693,28,0,0,70,70,0,1,0,1,0
22029,10,13683,9,246,118,128,2,29,1,1
8394,10,21107,9,718,94,624,2,30,1,1
5163,10,11213,9,168,78,90,2,30,1,1
9283,3216,0,0,66,66,0,1,0,1,0
16484,28,0,0,70,70,0,1,0,1,0
15412,10,7277,9,190,97,93,2,31,1,1
9082,10,10679,9,198,102,96,2,31,1,1
11134,2654,11722,2061,70,70,0,2,8,2,0
8210,280,21194,177,334,158,176,2,1200,1,1
10554,26,3834,16,6656,769,5887,14,16,9,5
14643,28,0,0,70,70,0,1,0,1,0
7533,26,14371,16,6407,984,5423,21,360,11,10
14998,10,19807,9,199,102,97,2,30,1,1
10135,28,0,0,66,66,0,1,0,1,0
13379,26,16086,16,4869,1016,3853,18,121,9,9
14745,10,2155,9,195,102,93,2,31,1,1
33,3216,0,0,145,145,0,1,0,1,0
15568,28,0,0,70,70,0,1,0,1,0
20402,1589,0,0,66,66,0,1,0,1,0
16021,2674,25754,2080,1969,730,1239,19,1199,10,9
3953,2144,0,0,62,62,0,1,0,1,0
17608,28,0,0,66,66,0,1,0,1,0
15003,10,5916,9,306,94,212,2,30,1,1
17544,28,0,0,70,70,0,1,0,1,0
1117,1,0,0,100,100,0,1,0,1,0
21259,2529,3761,1965,312,132,180,6,6,3,3
15912,28,0,0,70,70,0,1,0,1,0
22702,28,0,0,66,66,0,1,0,1,0
7265,460,0,0,62,62,0,1,0,1,0
11482,1804,0,0,62,62,0,1,0,1,0
9827,26,13274,16,12362,1650,10712,33,300,14,19
626,7,0,0,60,60,0,1,0,1,0
15795,10,7442,9,701,88,613,2,31,1,1
11773,28,0,0,66,66,0,1,0,1,0
21378,2573,0,0,66,66,0,1,0,1,0
22428,10,23535,9,212,86,126,2,30,1,1
15880,10,16717,9,194,102,92,2,31,1,1
22462,10,6463,9,178,94,84,2,29,1,1
22321,10,13124,9,170,87,83,2,31,1,1
12731,58,24091,41,260,140,120,5,6,3,2
13852,26,24305,16,18965,2061,16904,35,17,18,17
8461,28,0,0,70,70,0,1,0,1,0
11770,15,15294,11,7572,3232,4340,42,140,23,19
7014,26,14808,16,296,78,218,4,19,1,3
4876,15,24468,11,15538,1307,14231,27,45,15,12
13930,10,7177,9,268,87,181,4,35,2,2
19969,26,12741,16,3538,2015,1523,28,325,14,14
10060,26,412,16,3347,2025,1322,31,34,18,13
2744,1453,9360,1106,890,126,764,2,31,1,1
1089,15,16607,11,1641,483,1158,10,15,5,5
0,0,0,0,70,70,0,1,0,1,0
0,0,0,0,244,244,0,2,0,2,0
17210,28,0,0,70,70,0,1,0,1,0
17103,26,5282,16,5166,700,4466,16,15,7,9
22314,10,17351,9,215,94,121,2,30,1,1
6806,10,10590,9,168,78,90,2,30,1,1
14047,15,28444,11,1250,472,778,13,46,3,10
275,9,0,0,60,60,0,1,0,1,0
20837,26,12208,16,3120,976,2144,13,135,6,7
8342,153,3575,108,66,66,0,1,5,1,0
11814,26,25436,16,253281,6271,247010,276,117,66,210
2282,10,7921,9,86,86,0,1,30,1,0
9872,28,0,0,70,70,0,1,0,1,0
15365,10,1939,9,747,92,655,2,31,1,1
8327,287,26486,184,834,150,684,4,1200,2,2
22020,10,7486,9,177,94,83,2,29,1,1
9388,10,13889,9,184,102,82,2,30,1,1
10303,26,12795,16,291595,261981,29614,587,206,339,248
14805,10,26039,9,177,94,83,2,30,1,1
21518,10,113,9,168,86,82,2,30,1,1
8787,28,0,0,70,70,0,1,0,1,0
13734,26,28094,16,19866,7188,12678,18,151,7,11
9230,10,27628,9,458,188,270,6,30,3,3
17405,28,0,0,66,66,0,1,0,1,0
20929,2256,0,0,62,62,0,1,0,1,0
22102,10,22104,9,215,102,113,2,30,1,1
21855,28,0,0,70,70,0,1,0,1,0
3020,1147,0,0,62,62,0,1,0,1,0
12500,26,18674,16,350,210,140,6,24,4,2
15623,10,16631,9,177,94,83,2,30,1,1
12,2903,0,0,78,78,0,1,0,1,0
13829,28,0,0,70,70,0,1,0,1,0
22332,28,0,0,70,70,0,1,0,1,0
6004,26,17977,16,4719,1812,2907,19,29,11,8
2862,1147,0,0,66,66,0,1,0,1,0
20927,1017,0,0,146,146,0,1,0,1,0
12561,405,13989,263,320,140,180,6,6,3,3
14539,15,24669,11,450,246,204,8,29,5,3
8412,15,21392,11,378,180,198,7,54,4,3
10852,28,0,0,70,70,0,1,0,1,0
4247,26,12367,16,5674,1556,4118,23,271,13,10
15135,26,18035,16,2723,1564,1159,15,17,9,6
8905,26,28007,16,3085,1404,1681,15,15,7,8
11072,10,22771,9,478,292,186,5,30,3,2
12455,2981,20807,2315,320,140,180,6,7,3,3
2236,2611,0,0,62,62,0,1,0,1,0
20709,28,0,0,66,66,0,1,0,1,0
14474,10,24627,9,221,89,132,2,31,1,1
8370,10,20349,9,168,86,82,2,30,1,1
2394,1017,0,0,146,146,0,1,0,1,0
21702,10,21473,9,179,94,85,2,30,1,1
15456,28,0,0,70,70,0,1,0,1,0
19321,3252,0,0,66,66,0,1,0,1,0
2339,1771,0,0,66,66,0,1,0,1,0
21254,28,0,0,70,70,0,1,0,1,0
10862,2040,14289,1567,66,66,0,1,5,1,0
15427,264,1030,165,2499,2499,0,22,300,22,0
20073,28,0,0,70,70,0,1,0,1,0
16690,28,0,0,70,70,0,1,0,1,0
14941,26,6367,16,3734,1750,1984,24,203,12,12
20354,28,0,0,70,70,0,1,0,1,0
15687,10,16651,9,811,94,717,2,30,1,1
10619,15,3562,11,1752,786,966,16,17,9,7
16757,28,0,0,66,66,0,1,0,1,0
22338,10,11444,9,167,86,81,2,30,1,1
673,3216,0,0,66,66,0,1,0,1,0
17348,28,0,0,66,66,0,1,0,1,0
9726,28,0,0,70,70,0,1,0,1,0
8276,2023,0,0,161,161,0,1,0,1,0
9958,26,10096,16,11217,3882,7335,42,164,19,23
11566,28,0,0,70,70,0,1,0,1,0
17723,28,0,0,70,70,0,1,0,1,0
20,3216,0,0,145,145,0,1,0,1,0
10025,28,0,0,66,66,0,1,0,1,0
15386,28,0,0,70,70,0,1,0,1,0
19827,28,0,0,66,66,0,1,0,1,0
12059,940,24516,692,70,70,0,1,5,1,0
20169,28,0,0,70,70,0,1,0,1,0
16951,255,0,0,62,62,0,1,0,1,0
276,9,0,0,60,60,0,1,0,1,0
21225,1472,0,0,66,66,0,1,0,1,0
10071,15,6758,11,1375,1038,337,7,137,4,3
11105,26,13754,16,18579,9266,9313,49,198,25,24
15986,10,24258,9,185,102,83,2,29,1,1
8328,10,188,9,385,102,283,2,30,1,1
10730,1848,11134,1408,66,66,0,1,5,1,0
19523,28,0,0,70,70,0,1,0,1,0
18813,26,26987,16,1092,645,447,10,34,6,4
17172,26,15210,16,5166,700,4466,16,15,7,9
18869,28,0,0,70,70,0,1,0,1,0
21611,10,27975,9,196,102,94,2,30,1,1
8770,10,12285,9,969,86,883,2,30,1,1
7872,15,6465,11,1067,697,370,8,63,5,3
8653,10,19769,9,267,102,165,2,30,1,1
20539,26,3707,16,448,166,282,2,30,1,1
17156,26,12335,16,2881,1766,1115,17,16,9,8
12107,26,425,16,245772,8639,237133,291,66,103,188
18406,1804,0,0,66,66,0,1,0,1,0
14379,345,17876,219,70,70,0,1,4,1,0
26,1202,0,0,159,159,0,1,0,1,0
2349,10,9675,9,217,82,135,2,33,1,1
3568,15,28231,11,1454,866,588,11,58,7,4
15009,10,16349,9,193,102,91,2,30,1,1
2534,1825,0,0,62,62,0,1,0,1,0
7691,26,14837,16,3545,1817,1728,22,95,11,11
4547,10,16007,9,172,76,96,2,30,1,1
12560,2594,21424,2013,320,140,180,6,7,3,3
18742,26,26947,16,1092,645,447,10,34,6,4
0,0,0,0,480,244,236,4,0,2,2
8970,26,18545,16,2839,1654,1185,15,126,9,6
13589,28,0,0,70,70,0,1,0,1,0
8849,26,11438,16,11301,2219,9082,29,187,14,15
18775,28,0,0,70,70,0,1,0,1,0
323,1,0,0,66,66,0,1,0,1,0
22078,10,12174,9,275,126,149,2,30,1,1
16485,28,0,0,70,70,0,1,0,1,0
13731,15,5859,11,265275,25834,239441,366,101,182,184
13612,26,6162,16,6578,1571,5007,24,17,13,11
521,10,1895,9,224,88,136,2,31,1,1
3807,2610,0,0,60,60,0,1,0,1,0
15764,10,29144,9,195,102,93,2,30,1,1
9039,15,27217,11,35824,4558,31266,39,88,13,26
9090,10,20118,9,333,90,243,4,41,2,2
2744,1296,18534,974,890,126,764,2,30,1,1
8276,2023,0,0,161,161,0,1,0,1,0
15257,26,27418,16,8654,2150,6504,20,15,11,9
22102,1215,0,0,66,66,0,1,0,1,0
21986,10,6024,9,214,110,104,2,30,1,1
18871,26,9971,16,14125,3827,10298,33,45,18,15
1760,3216,0,0,62,62,0,1,0,1,0
11039,26,22754,16,588633,17490,571143,578,51,186,392
8462,28,0,0,70,70,0,1,0,1,0
6614,10,18822,9,220,100,120,2,30,1,1
12262,28,0,0,70,70,0,1,0,1,0
12120,26,23332,16,1402,856,546,12,34,6,6
22704,10,1009,9,210,110,100,2,30,1,1
15279,10,3975,9,194,102,92,2,31,1,1
21210,28,0,0,70,70,0,1,0,1,0
22392,1295,9829,973,226,71,155,2,31,1,1
22580,1215,0,0,62,62,0,1,0,1,0
19512,28,0,0,70,70,0,1,0,1,0
8813,10,7690,9,361,102,259,2,30,1,1
15499,10,21761,9,747,93,654,2,31,1,1
14081,7,0,0,60,60,0,1,0,1,0
18575,28,0,0,70,70,0,1,0,1,0
2035,1147,0,0,62,62,0,1,0,1,0
22651,10,8415,9,196,102,94,2,33,1,1
5477,26,4011,16,9264,2848,6416,31,100,16,15
962,15,21195,11,318,192,126,6,26,4,2
15040,10,22242,9,760,96,664,2,31,1,1
22246,10,17888,9,210,110,100,2,29,1,1
11254,1847,18054,1407,136,136,0,3,14,3,0
21673,10,9942,9,621,196,425,6,59,3,3
14360,2296,15650,1780,70,70,0,2,8,2,0
9524,10,1533,9,737,94,643,2,29,1,1
16966,10,11420,9,260,86,174,2,30,1,1
1804,1163,0,0,60,60,0,1,61,1,0
12351,26,13431,16,2291912,60511,2231401,2353,196,863,1490
14342,10,453,9,165,86,79,2,30,1,1
10358,1771,0,0,66,66,0,1,0,1,0
12935,28,0,0,70,70,0,1,0,1,0
11803,26,11760,16,320255,9207,311048,343,117,107,236
20695,2938,0,0,66,66,0,1,0,1,0
19403,28,0,0,70,70,0,1,0,1,0
15615,10,10351,9,197,102,95,2,30,1,1
8514,15,21443,11,450,246,204,8,141,5,3
17949,15,14457,11,830733,17622,813111,789,66,245,544
14148,28,0,0,70,70,0,1,0,1,0
15786,10,1972,9,198,101,97,2,30,1,1
17043,1792,0,0,62,62,0,1,0,1,0
16051,28,0,0,70,70,0,1,0,1,0
17695,2587,0,0,146,146,0,1,0,1,0
4659,26,11897,16,499,425,74,4,0,3,1
3443,1888,0,0,62,62,0,1,0,1,0
13583,26,15896,16,62,62,0,1,4,1,0
19455,28,0,0,66,66,0,1,0,1,0
3584,2587,0,0,146,146,0,1,0,1,0
6540,26,7733,16,3178535,62767,3115768,2800,83,626,2174
14294,10,19667,9,211,102,109,2,30,1,1
14794,10,6654,9,195,102,93,2,30,1,1
5176,26,16713,16,5741,2532,3209,24,80,14,10
17748,28,0,0,66,66,0,1,0,1,0
1804,2232,0,0,60,60,0,1,0,1,0
22613,1215,0,0,62,62,0,1,0,1,0
1835,10,6914,9,217,87,130,2,30,1,1
9009,10,2441,9,188,96,92,2,31,1,1
13139,15,18543,11,9608,746,8862,19,82,9,10
14691,28,0,0,70,70,0,1,0,1,0
14780,10,6745,9,196,94,102,2,30,1,1
14696,10,8524,9,216,110,106,2,30,1,1
16021,2258,24365,1748,166,166,0,1,1199,1,0
18065,28,0,0,70,70,0,1,0,1,0
11034,2849,5096,2211,70,70,0,2,7,2,0
12433,183,23521,121,3407,1518,1889,16,16,9,7
18498,15,2214,11,1155,781,374,10,15,6,4
15041,10,1221,9,168,78,90,2,30,1,1
21766,10,14352,9,734,86,648,2,31,1,1
5847,15,17747,11,11428,2250,9178,22,126,11,11
15888,10,5354,9,1420,95,1325,4,32,2,2
16951,255,0,0,62,62,0,1,0,1,0
15768,10,18962,9,184,86,98,2,30,1,1
6059,26,26514,16,61983,10061,51922,85,130,35,50
16399,1472,0,0,146,146,0,1,0,1,0
15692,10,26411,9,265,94,171,2,30,1,1
16766,10,10817,9,357,87,270,2,31,1,1
4814,7,0,0,60,60,0,1,0,1,0
14875,10,17715,9,716,95,621,2,31,1,1
12058,26,1740,16,6716,922,5794,20,20,10,10
255,26,657,16,35555,4646,30909,59,23,33,26
8585,26,17997,16,318,192,126,6,15,4,2
13782,10,2793,9,711,87,624,2,30,1,1
592,1054,0,0,66,66,0,1,0,1,0
22476,10,17070,9,183,94,89,2,30,1,1
537,15,1996,11,16287,756,15531,23,16,9,14
18509,281,16266,178,70,70,0,1,5,1,0
3833,344,0,0,159,159,0,1,0,1,0
20,3216,0,0,62,62,0,1,0,1,0
20838,2883,0,0,66,66,0,1,0,1,0
8798,28,0,0,70,70,0,1,0,1,0
10044,28,0,0,70,70,0,1,0,1,0
20743,28,0,0,70,70,0,1,0,1,0
10680,15,28412,11,1038219,43977,994242,1734,30,616,1118
811,10,3415,9,233,91,142,2,31,1,1
15784,2636,0,0,66,66,0,1,0,1,0
15457,10,4013,9,184,94,90,2,30,1,1
15488,28,0,0,70,70,0,1,0,1,0
12,658,0,0,131,131,0,1,0,1,0
17309,28,0,0,66,66,0,1,0,1,0
20948,28,0,0,66,66,0,1,0,1,0
16924,28,0,0,70,70,0,1,0,1,0
20333,15,10518,11,1437,659,778,11,45,6,5
9166,10,9759,9,183,102,81,2,30,1,1
7382,2938,0,0,74,74,0,1,0,1,0
21516,10,5242,9,200,94,106,2,29,1,1
8920,10,26980,9,180,94,86,2,30,1,1
15186,26,24995,16,4530,1623,2907,19,26,11,8
5609,26,3082,16,6423,1543,4880,21,191,12,9
14403,10,1899,9,733,94,639,2,29,1,1
9198,15,21773,11,1665,923,742,7,32,4,3
15230,10,26892,9,168,86,82,2,31,1,1
13218,28,0,0,66,66,0,1,0,1,0
3760,26,13846,16,1402,910,492,11,360,6,5
12444,405,12679,263,492,306,186,8,15,5,3
19517,28,0,0,70,70,0,1,0,1,0
9490,10,25074,9,760,97,663,2,30,1,1
2744,1560,13873,1191,868,126,742,2,31,1,1
4024,2883,0,0,66,66,0,1,0,1,0
19879,28,0,0,66,66,0,1,0,1,0
8625,10,2087,9,199,102,97,2,29,1,1
11551,28,0,0,70,70,0,1,0,1,0
21331,28,0,0,66,66,0,1,0,1,0
22104,10,27267,9,320,97,223,4,34,2,2
22689,26,18114,16,8177,3420,4757,23,124,11,12
10285,26,5033,16,786014,23908,762106,803,47,276,527
3912,15,6493,11,5773,1197,4576,14,32,8,6
14625,10,14599,9,199,102,97,2,29,1,1
15300,10,20891,9,180,94,86,2,31,1,1
9582,897,0,0,62,62,0,1,0,1,0
13664,26,15056,16,9023,4071,4952,30,35,17,13
9544,10,3698,9,177,94,83,2,30,1,1
19416,28,0,0,70,70,0,1,0,1,0
5199,983,0,0,62,62,0,1,0,1,0
7013,26,235,16,309,309,0,1,5,1,0
15037,10,15839,9,192,98,94,2,31,1,1
21798,10,10293,9,388,134,254,2,30,1,1
13188,26,17292,16,7129,4391,2738,32,196,16,16
1250,3145,0,0,148,148,0,1,0,1,0
19744,2581,0,0,66,66,0,1,0,1,0
11740,15,4118,11,1152,712,440,10,15,5,5
22631,10,473,9,189,102,87,2,30,1,1
636,280,0,0,146,146,0,1,0,1,0
15883,26,1618,16,5613,733,4880,16,14,9,7
1990,7,0,0,60,60,0,1,0,1,0
470,2587,0,0,62,62,0,1,0,1,0
6586,10,11628,9,168,78,90,2,30,1,1
15242,10,8196,9,244,94,150,2,30,1,1
2301,1946,0,0,60,60,0,1,0,1,0
21648,10,7968,9,373,90,283,4,53,2,2
8964,10,9676,9,196,102,94,2,30,1,1
2744,1239,18658,919,878,126,752,2,30,1,1
8430,10,23984,9,178,94,84,2,30,1,1
11353,28,0,0,70,70,0,1,0,1,0
12259,10,10319,9,86,86,0,1,30,1,0
636,2498,8456,1944,210,111,99,2,1201,1,1
19466,28,0,0,66,66,0,1,0,1,0
19401,28,0,0,66,66,0,1,0,1,0
8302,10,21322,9,1415,689,726,3,30,2,1
18411,15,2341,11,2018,1704,314,16,15,11,5
15252,10,15605,9,286,103,183,4,48,2,2
8661,10,17145,9,758,102,656,2,31,1,1
844,697,0,0,146,146,0,1,0,1,0
2697,280,0,0,146,146,0,1,0,1,0
16368,15,25732,11,9800,2228,7572,23,24,12,11
9513,2587,0,0,62,62,0,1,0,1,0
22209,1258,23079,938,3573,2238,1335,16,34,8,8
9575,28,0,0,70,70,0,1,0,1,0
18509,281,650,178,70,70,0,2,8,2,0
9438,26,17770,16,183024,16754,166270,247,28,114,133
13506,28,0,0,70,70,0,1,0,1,0
7030,1215,0,0,62,62,0,1,0,1,0
10896,1017,0,0,66,66,0,1,0,1,0
8686,28,0,0,70,70,0,1,0,1,0
14275,3091,7548,2401,320,140,180,6,7,3,3
9432,10,19318,9,766,102,664,2,30,1,1
8820,10,26083,9,214,110,104,2,31,1,1
22520,28,0,0,70,70,0,1,0,1,0
15183,26,28731,16,8034,2014,6020,20,15,11,9
8360,26,2843,16,3283,665,2618,16,160,7,9
4078,18,1742,13,184,94,90,2,30,1,1
16734,10,528,9,209,102,107,2,30,1,1
22299,10,6835,9,266,118,148,2,29,1,1
2107,7,0,0,60,60,0,1,0,1,0
15024,10,7976,9,374,94,280,2,30,1,1
4899,10,17813,9,199,94,105,2,30,1,1
16951,255,0,0,62,62,0,1,0,1,0
8448,28,0,0,66,66,0,1,0,1,0
14285,26,24525,16,30650,11103,19547,66,51,40,26
1046,308,0,0,66,66,0,1,0,1,0
22225,10,15719,9,193,102,91,2,30,1,1
16951,255,0,0,62,62,0,1,0,1,0
17641,28,0,0,70,70,0,1,0,1,0
22171,10,21835,9,173,94,79,2,30,1,1
21471,10,17500,9,291,94,197,2,29,1,1
17913,7,0,0,60,60,0,1,0,1,0
8510,26,4097,16,1556,769,787,17,134,9,8
22359,28,0,0,70,70,0,1,0,1,0
13079,28,0,0,70,70,0,1,0,1,0
8213,1147,0,0,66,66,0,1,0,1,0
0,0,0,0,320,320,0,5,0,5,0
8584,1239,7942,919,240,71,169,2,30,1,1
14114,28,0,0,66,66,0,1,0,1,0
9285,26,11806,16,29436,9695,19741,54,34,30,24
19678,28,0,0,70,70,0,1,0,1,0
14808,1017,0,0,62,62,0,1,0,1,0
6060,26,14268,16,4590,3026,1564,28,80,15,13
17395,26,11060,16,92207,5395,86812,130,88,58,72
21346,10,24474,9,194,102,92,2,31,1,1
8598,28,0,0,70,70,0,1,0,1,0
6355,26,18784,16,4299,1870,2429,17,150,8,9
13641,26,5335,16,7502,2299,5203,37,18,21,16
16951,255,0,0,62,62,0,1,0,1,0
3058,3262,0,0,60,60,0,1,0,1,0
1174,15,6888,11,1052,612,440,10,15,5,5
6695,26,28406,16,81803,3159,78644,93,20,33,60
14733,10,24373,9,306,94,212,2,30,1,1
8678,10,26707,9,195,102,93,2,31,1,1
21789,10,6015,9,816,102,714,2,29,1,1
22112,10,18354,9,767,102,665,2,29,1,1
4001,26,5410,16,9675,2671,7004,36,262,18,18
15343,28,0,0,66,66,0,1,0,1,0
17669,26,17183,16,448,78,370,6,25,1,5
1845,2883,0,0,62,62,0,1,0,1,0
14480,28,0,0,70,70,0,1,0,1,0
22537,28,0,0,70,70,0,1,0,1,0
9001,10,18559,9,214,110,104,2,30,1,1
6294,1017,0,0,146,146,0,1,0,1,0
21343,10,26464,9,168,86,82,2,30,1,1
10288,28,0,0,70,70,0,1,0,1,0
15661,10,28885,9,192,98,94,2,31,1,1
9033,10,28581,9,209,110,99,2,30,1,1
2812,232,5343,147,3751,1007,2744,35,425,11,24
12060,26,13643,16,11080,4277,6803,23,42,10,13
16256,1482,0,0,66,66,0,1,0,1,0
8584,1238,13970,918,257,78,179,2,30,1,1
1804,1025,0,0,60,60,0,1,0,1,0
15027,10,3525,9,200,102,98,2,30,1,1
4393,10,0,0,139,70,69,2,30,1,1
2081,3216,0,0,62,62,0,1,0,1,0
20924,28,0,0,70,70,0,1,0,1,0
14473,2778,0,0,74,74,0,1,0,1,0
18995,1888,0,0,145,145,0,1,0,1,0
19830,2938,0,0,146,146,0,1,0,1,0
14271,10,23193,9,183,94,89,2,31,1,1
22231,10,10207,9,290,94,196,4,55,2,2
8649,15,26771,11,318,192,126,6,40,4,2
8625,10,15098,9,199,102,97,2,31,1,1
20555,28,0,0,70,70,0,1,0,1,0
6547,26,20930,16,460628,23936,436692,580,124,264,316
4475,26,8354,16,7326,1399,5927,29,280,15,14
14227,10,17241,9,258,94,164,2,29,1,1
20493,28,0,0,66,66,0,1,0,1,0
18444,1206,2196,893,70,70,0,2,8,2,0
21565,10,24433,9,549,188,361,6,57,3,3
18650,28,0,0,70,70,0,1,0,1,0
8327,2382,0,0,146,146,0,1,0,1,0
19412,28,0,0,70,70,0,1,0,1,0
10340,26,12382,16,8034,2584,5450,39,16,23,16
1330,2943,0,0,145,145,0,1,0,1,0
9662,10,26705,9,802,104,698,2,31,1,1
22684,509,0,0,66,66,0,1,0,1,0
17456,357,0,0,66,66,0,1,0,1,0
16951,255,0,0,62,62,0,1,0,1,0
16951,255,0,0,62,62,0,1,0,1,0
11626,1017,0,0,66,66,0,1,0,1,0
2307,26,9484,16,6993,960,6033,17,31,10,7
15511,10,13367,9,452,101,351,4,36,2,2
13904,10,1334,9,177,94,83,2,30,1,1
13408,28,0,0,70,70,0,1,0,1,0
3498,1804,0,0,66,66,0,1,0,1,0
11423,26,18823,16,8454,978,7476,20,15,10,10
22320,26,28964,16,4480,1573,2907,19,30,11,8
19349,28,0,0,70,70,0,1,0,1,0
20536,28,0,0,66,66,0,1,0,1,0
3341,10,22956,9,164,78,86,2,31,1,1
15165,10,15077,9,199,102,97,2,30,1,1
18497,28,0,0,70,70,0,1,0,1,0
707,1176,0,0,139,139,0,1,0,1,0
17360,28,0,0,66,66,0,1,0,1,0
11295,28,0,0,66,66,0,1,0,1,0
13992,10,8752,9,214,110,104,2,30,1,1
18763,1989,2747,1519,316,136,180,6,6,3,3
225,10,13880,9,204,118,86,2,30,1,1
13173,28,0,0,66,66,0,1,0,1,0
10734,165,25695,113,70,70,0,1,5,1,0
13866,10,24238,9,758,96,662,2,30,1,1
18223,26,8072,16,2993,1992,1001,16,15,8,8
21130,28,0,0,66,66,0,1,0,1,0
16181,1771,0,0,66,66,0,1,0,1,0
20659,1771,0,0,62,62,0,1,0,1,0
2944,1147,0,0,146,146,0,1,0,1,0
17,202,0,0,129,129,0,1,0,1,0
11616,2611,0,0,66,66,0,1,0,1,0
22040,10,1842,9,174,89,85,2,30,1,1
8333,28,0,0,70,70,0,1,0,1,0
11200,15,26963,11,362,240,122,7,17,5,2
11373,1086,0,0,66,66,0,1,0,1,0
13918,10,12699,9,167,86,81,2,30,1,1
12311,28,0,0,70,70,0,1,0,1,0
6250,1985,7629,1515,243,180,63,2,31,1,1
10812,475,16060,309,70,70,0,2,8,2,0
13074,185,0,0,60,60,0,1,0,1,0
20692,28,0,0,66,66,0,1,0,1,0
16021,700,1785,498,1577,594,983,20,1624,10,10
3424,1147,0,0,146,146,0,1,0,1,0
9031,10,4267,9,177,94,83,2,30,1,1
780,1181,10872,871,133,64,69,3,33,2,1
10985,26,28730,16,8390,1525,6865,24,26,11,13
9660,10,23285,9,168,86,82,2,30,1,1
21626,10,401,9,228,110,118,2,29,1,1
13189,10,5187,9,259,86,173,2,30,1,1
10434,28,0,0,70,70,0,1,0,1,0
11807,26,9995,16,18795,10297,8498,56,118,29,27
5359,1017,0,0,146,146,0,1,0,1,0
10614,28,0,0,66,66,0,1,0,1,0
4492,15,12072,11,2849,1631,1218,9,721,5,4
20568,26,3543,16,571,166,405,2,30,1,1
9830,26,12304,16,6340,1381,4959,19,170,9,10
14500,28,0,0,66,66,0,1,0,1,0
4453,2883,0,0,62,62,0,1,0,1,0
0,0,0,0,400,204,196,4,0,2,2
10755,2883,0,0,62,62,0,1,0,1,0
14518,10,13218,9,184,94,90,2,29,1,1
14246,10,26252,9,255,102,153,2,30,1,1
18282,28,0,0,70,70,0,1,0,1,0
15198,26,23768,16,7982,1962,6020,20,15,11,9
21179,15,25472,11,314,192,122,6,15,4,2
2362,15,9722,11,490,264,226,8,26,5,3
15793,26,4256,16,225524,59002,166522,402,78,192,210
8712,10,11447,9,193,102,91,2,30,1,1
8743,28,0,0,70,70,0,1,0,1,0
11890,26,25749,16,280,140,140,5,130,3,2
16724,26,24076,16,7353,2840,4513,33,107,18,15
6787,26,26616,16,9730,1613,8117,24,170,11,13
7216,15,6609,11,1130,624,506,11,15,5,6
19729,2747,0,0,66,66,0,1,0,1,0
9737,3216,0,0,66,66,0,1,0,1,0
20055,28,0,0,66,66,0,1,0,1,0
13969,10,20198,9,188,96,92,2,30,1,1
15732,183,25253,121,3413,1458,1955,16,19,8,8
18443,26,3114,16,70,70,0,2,8,2,0
22058,10,13149,9,186,95,91,2,31,1,1
21611,28,0,0,70,70,0,1,0,1,0
13707,10,20794,9,216,102,114,2,30,1,1
14251,3153,27701,2443,504,318,186,8,15,5,3
16219,3216,0,0,62,62,0,1,0,1,0
13908,10,11857,9,762,98,664,2,31,1,1
13734,28,0,0,70,70,0,1,0,1,0
19871,1017,0,0,66,66,0,1,0,1,0
13996,10,12133,9,183,94,89,2,31,1,1
8861,28,0,0,66,66,0,1,0,1,0
18707,28,0,0,70,70,0,1,0,1,0
14226,28,0,0,66,66,0,1,0,1,0
16132,26,4073,16,12463,6762,5701,28,31,14,14
612,1240,0,0,60,60,0,1,0,1,0
532,247,0,0,3562,1936,1626,48,195,24,24
16235,26,25537,16,5508,2261,3247,22,38,13,9
22208,10,25301,9,166,86,80,2,31,1,1
18263,1888,0,0,66,66,0,1,0,1,0
9996,28,0,0,66,66,0,1,0,1,0
12372,2287,5723,1772,70,70,0,1,5,1,0
15972,10,8852,9,193,102,91,2,30,1,1
21455,28,0,0,66,66,0,1,0,1,0
4179,1539,0,0,146,146,0,1,0,1,0
8881,10,16817,9,807,94,713,2,30,1,1
22449,10,23426,9,199,102,97,2,30,1,1
4591,26,12333,16,16590,1630,14960,33,199,15,18
14432,10,2080,9,183,94,89,2,31,1,1
8164,2727,0,0,60,60,0,1,0,1,0
16135,15,25465,11,25872,4400,21472,41,38,16,25
20752,28,0,0,70,70,0,1,0,1,0
6750,3216,0,0,62,62,0,1,0,1,0
256,3216,0,0,62,62,0,1,0,1,0
16781,28,0,0,70,70,0,1,0,1,0
16510,2883,0,0,146,146,0,1,0,1,0
21511,10,9472,9,314,102,212,2,29,1,1
19550,28,0,0,70,70,0,1,0,1,0
10993,28,0,0,66,66,0,1,0,1,0
11187,15,8221,11,366,240,126,7,32,5,2
8512,26,27832,16,26156,6762,19394,37,16,16,21
12565,26,4841,16,499,425,74,4,0,3,1
2697,2587,0,0,146,146,0,1,0,1,0
5218,26,16589,16,9096,4245,4851,29,121,14,15
4428,26,712,16,6040,1612,4428,21,255,12,9
8579,26,8964,16,7849,1104,6745,23,123,12,11
9868,26,18005,16,6593,3522,3071,56,76,33,23
15896,2938,0,0,66,66,0,1,0,1,0
19899,28,0,0,70,70,0,1,0,1,0
16258,2697,0,0,66,66,0,1,0,1,0
16166,15,25495,11,29263,2432,26831,36,31,13,23
8648,6,0,0,60,60,0,1,0,1,0
15493,28,0,0,70,70,0,1,0,1,0
5407,1888,0,0,66,66,0,1,0,1,0
8138,26,10914,16,476,410,66,4,0,3,1
10833,28,0,0,70,70,0,1,0,1,0
11907,28,0,0,66,66,0,1,0,1,0
7999,6,0,0,60,60,0,1,0,1,0
22348,10,3094,9,199,102,97,2,30,1,1
21270,10,2930,9,186,95,91,2,31,1,1
13273,28,0,0,66,66,0,1,0,1,0
10667,28,0,0,70,70,0,1,0,1,0
6108,7,0,0,60,60,0,1,0,1,0
20058,28,0,0,70,70,0,1,0,1,0
21410,10,17564,9,196,102,94,2,30,1,1
9400,2256,0,0,66,66,0,1,0,1,0
636,2275,0,0,146,146,0,1,0,1,0
9740,10,25553,9,168,86,82,2,30,1,1
14700,10,24587,9,210,110,100,2,30,1,1
22704,10,13874,9,204,104,100,2,31,1,1
22014,10,20523,9,166,86,80,2,30,1,1
11872,15,23348,11,2974,1352,1622,28,113,15,13
8670,26,6159,16,18746,2976,15770,32,32,12,20
10782,28,0,0,66,66,0,1,0,1,0
5705,1100,0,0,74,74,0,1,0,1,0
14333,10,5710,9,281,101,180,4,58,2,2
22704,10,18503,9,210,110,100,2,29,1,1
3645,26,15737,16,154,94,60,2,5,1,1
1548,2611,0,0,62,62,0,1,0,1,0
636,280,3639,177,501,150,351,2,1200,1,1
15535,10,22714,9,170,87,83,2,30,1,1
1487,2104,0,0,145,145,0,1,0,1,0
18915,10,27042,9,216,90,126,2,30,1,1
187,1795,0,0,60,60,0,1,0,1,0
20528,28,0,0,70,70,0,1,0,1,0
18928,15,19837,11,2235,1055,1180,12,15,7,5
13212,26,25361,16,9802,2594,7208,25,360,10,15
17768,26,9350,16,18261,2059,16202,40,31,20,20
21318,15,28272,11,314,192,122,6,15,4,2
11228,574,22017,388,66,66,0,2,10,2,0
13830,10,24571,9,443,92,351,4,31,2,2
6677,1888,0,0,62,62,0,1,0,1,0
9725,28,0,0,70,70,0,1,0,1,0
10456,28,0,0,66,66,0,1,0,1,0
16132,26,26341,16,3323,2398,925,18,21,10,8
13801,10,29126,9,188,96,92,2,31,1,1
2552,7,0,0,60,60,0,1,0,1,0
14172,26,22581,16,58975,3359,55616,78,26,34,44
8108,26,24964,16,9553,2175,7378,33,27,17,16
8642,28,0,0,66,66,0,1,0,1,0
16951,255,0,0,62,62,0,1,0,1,0
3755,15,13955,11,1638,1324,314,10,14,5,5
9109,28,0,0,70,70,0,1,0,1,0
2744,1239,24879,919,1646,126,1520,4,31,2,2
22548,26,349,16,3563945,186679,3377266,4424,723,1877,2547
7339,140,0,0,60,60,0,1,0,1,0
11142,26,12684,16,59796,4486,55310,92,48,45,47
1983,2144,0,0,66,66,0,1,0,1,0
19473,7,0,0,60,60,0,1,0,1,0
17453,28,0,0,70,70,0,1,0,1,0
3046,2587,0,0,62,62,0,1,0,1,0
1128,1017,0,0,146,146,0,1,0,1,0
8996,1472,0,0,66,66,0,1,0,1,0
2744,1239,28152,919,887,126,761,2,30,1,1
16951,255,0,0,62,62,0,1,0,1,0
20067,28,0,0,70,70,0,1,0,1,0
15147,10,18271,9,325,102,223,2,30,1,1
17278,26,5568,16,4874459,114404,4760055,4469,188,1112,3357
5428,26,19687,16,1352,691,661,14,18,8,6
10474,1,0,0,72,72,0,1,0,1,0
15887,10,25635,9,177,94,83,2,30,1,1
542,2256,0,0,66,66,0,1,0,1,0
1277,1054,0,0,66,66,0,1,0,1,0
12761,838,18471,617,826,386,440,12,15,6,6
17754,10,28959,9,209,102,107,2,30,1,1
22308,10,15360,9,183,94,89,2,30,1,1
22689,26,8769,16,91813,4379,87434,101,16,37,64
2201,2256,0,0,66,66,0,1,0,1,0
18795,28,0,0,66,66,0,1,0,1,0
8499,28,0,0,66,66,0,1,0,1,0
22717,10,19193,9,168,86,82,2,30,1,1
7010,26,19445,16,7123,1020,6103,19,151,11,8
14561,1472,0,0,66,66,0,1,0,1,0
18083,26,4223,16,3640,870,2770,13,120,6,7
2666,1017,0,0,66,66,0,1,0,1,0
11168,28,0,0,66,66,0,1,0,1,0
2252,1147,0,0,62,62,0,1,0,1,0
18873,2486,0,0,66,66,0,1,0,1,0
15323,26,4604,16,8007,1987,6020,20,15,11,9
13662,28,0,0,70,70,0,1,0,1,0
12464,26,26912,16,15422,1623,13799,34,18,14,20
15127,10,6692,9,458,188,270,6,30,3,3
11874,28,0,0,66,66,0,1,0,1,0
2172,3029,9367,2355,481,150,331,2,1199,1,1
17420,10,1001,9,186,78,108,2,30,1,1
21786,10,17714,9,195,102,93,2,30,1,1
9055,10,14758,9,166,86,80,2,30,1,1
11875,2256,0,0,66,66,0,1,0,1,0
11075,28,0,0,70,70,0,1,0,1,0
15093,10,3146,9,177,94,83,2,29,1,1
2092,155,0,0,66,66,0,1,0,1,0
15786,377,25283,243,138,78,60,2,5,1,1
7247,10,19767,9,225,106,119,2,30,1,1
15894,3216,0,0,66,66,0,1,0,1,0
8908,10,15597,9,216,110,106,2,30,1,1
22191,10,24002,9,200,102,98,2,30,1,1
16951,255,0,0,62,62,0,1,0,1,0
3030,2256,0,0,62,62,0,1,0,1,0
21907,1017,0,0,146,146,0,1,0,1,0
21779,28,0,0,66,66,0,1,0,1,0
20348,1880,0,0,66,66,0,1,0,1,0
6132,26,21292,16,466,392,74,4,0,3,1
14343,10,7607,9,168,86,82,2,30,1,1
16922,26,25950,16,4398,1491,2907,19,28,11,8
636,280,11205,177,238,118,120,2,1200,1,1
20020,28,0,0,70,70,0,1,0,1,0
10944,15,20329,11,366,240,126,7,28,5,2
8908,10,17697,9,790,110,680,2,30,1,1
5123,26,21970,16,90261,3545,86716,96,16,32,64
2744,1238,16586,918,876,126,750,2,31,1,1
21054,28,0,0,70,70,0,1,0,1,0
12821,2034,22861,1562,70,70,0,2,7,2,0
8874,10,20152,9,193,102,91,2,30,1,1
14478,28,0,0,66,66,0,1,0,1,0
1731,635,20940,440,480,149,331,2,1200,1,1
15606,28,0,0,66,66,0,1,0,1,0
18567,26,9583,16,1061,727,334,9,26,4,5
21079,1215,0,0,66,66,0,1,0,1,0
8027,26,19072,16,1263,536,727,13,82,6,7
15857,10,3669,9,184,94,90,2,29,1,1
6194,2787,0,0,60,60,0,1,0,1,0
22123,10,22812,9,259,86,173,2,30,1,1
18924,28,0,0,66,66,0,1,0,1,0
14620,10,13942,9,711,87,624,2,30,1,1
10487,15,22471,11,114697,3049,111648,114,26,35,79
19885,28,0,0,66,66,0,1,0,1,0
15973,10,16988,9,199,102,97,2,30,1,1
15525,10,23552,9,487,136,351,4,46,2,2
22619,10,13830,9,190,97,93,2,31,1,1
8509,26,11740,16,6944,2404,4540,21,15,10,11
21107,1276,10648,956,1778,1386,392,8,31,4,4
18685,1771,0,0,66,66,0,1,0,1,0
13002,28,0,0,66,66,0,1,0,1,0
22315,28,0,0,70,70,0,1,0,1,0
21060,3236,14361,2507,66,66,0,2,7,2,0
9028,10,28949,9,212,102,110,2,30,1,1
11612,28,0,0,66,66,0,1,0,1,0
14996,10,19111,9,752,93,659,2,30,1,1
11460,1017,0,0,66,66,0,1,0,1,0
3133,2309,4110,1793,396,396,0,7,3617,7,0
16951,255,0,0,62,62,0,1,0,1,0
14975,26,14190,16,12371,1344,11027,30,3944,10,20
9384,28,0,0,70,70,0,1,0,1,0
6167,234,6781,149,60,60,0,1,5,1,0
17555,28,0,0,66,66,0,1,0,1,0
6724,26,20537,16,5911,1666,4245,27,18,15,12
22142,10,11992,9,193,102,91,2,31,1,1
14712,10,8764,9,178,94,84,2,30,1,1
11157,2225,16851,1724,70,70,0,2,8,2,0
47,2611,0,0,62,62,0,1,0,1,0
21362,28,0,0,70,70,0,1,0,1,0
5241,26,6997,16,19733,3606,16127,43,16,22,21
13773,3212,0,0,66,66,0,1,0,1,0
8678,28,0,0,70,70,0,1,0,1,0
16951,255,0,0,62,62,0,1,0,1,0
14807,2205,0,0,66,66,0,1,0,1,0
18994,28,0,0,66,66,0,1,0,1,0
16951,255,0,0,62,62,0,1,0,1,0
8805,26,18372,16,21062,2202,18860,34,80,15,19
13432,1017,0,0,66,66,0,1,0,1,0
14744,28,0,0,70,70,0,1,0,1,0
14377,10,5431,9,211,110,101,2,30,1,1
20404,15,15139,11,1515,481,1034,11,16,6,5
22676,28,0,0,66,66,0,1,0,1,0
2744,1241,5772,921,881,126,755,2,30,1,1
12665,26,21578,16,499,425,74,4,0,3,1
1088,15,9390,11,1835,421,1414,9,15,4,5
14068,26,25954,16,999955,25445,974510,1003,171,325,678
14338,10,28939,9,198,93,105,2,30,1,1
14601,10,7899,9,182,93,89,2,31,1,1
17217,10,16612,9,192,82,110,2,30,1,1
19051,28,0,0,66,66,0,1,0,1,0
1546,1147,0,0,62,62,0,1,0,1,0
22209,1258,7550,938,3287,2072,1215,12,30,6,6
9498,15,20820,11,306,180,126,6,25,4,2
12789,1564,16752,1195,70,70,0,2,7,2,0
22010,2205,0,0,66,66,0,1,0,1,0
10122,28,0,0,66,66,0,1,0,1,0
10836,26,22662,16,1466,856,610,13,27,6,7
14171,10,23615,9,772,100,672,2,31,1,1
14136,10,24931,9,216,110,106,2,30,1,1
9711,26,6595,16,5866,1781,4085,21,81,12,9
22330,10,1566,9,353,118,235,2,30,1,1
9024,10,21081,9,168,86,82,2,31,1,1
12961,28,0,0,70,70,0,1,0,1,0
19815,26,24803,16,350,210,140,6,15,4,2
8337,28,0,0,70,70,0,1,0,1,0
8862,26,27438,16,42348,4871,37477,71,150,40,31
20532,26,18536,16,5772,3849,1923,27,270,14,13
10686,15,23104,11,32942,2548,30394,58,255,28,30
17338,10,807,9,227,86,141,2,30,1,1
8219,346,2747,220,533,327,206,8,33,5,3
9931,28,0,0,70,70,0,1,0,1,0
16383,28,0,0,70,70,0,1,0,1,0
9775,15,14869,11,14784,7048,7736,31,27,18,13
13320,1215,0,0,66,66,0,1,0,1,0
9098,15,16338,11,1130,613,517,11,15,6,5
20131,28,0,0,66,66,0,1,0,1,0
10344,15,7848,11,3506,2280,1226,24,50,13,11
20976,26,23323,16,51005,2084,48921,61,120,22,39
15287,2382,0,0,62,62,0,1,0,1,0
22341,28,0,0,66,66,0,1,0,1,0
2533,10,10634,9,235,90,145,2,32,1,1
4699,26,12249,16,28034,26485,1549,48,16,29,19
12857,28,0,0,70,70,0,1,0,1,0
16951,255,0,0,62,62,0,1,0,1,0
18209,28,0,0,70,70,0,1,0,1,0
21586,10,2185,9,167,86,81,2,30,1,1
18991,28,0,0,70,70,0,1,0,1,0
6843,26,21398,16,3374,2106,1268,19,15,10,9
15806,28,0,0,70,70,0,1,0,1,0
10973,2838,23208,2202,70,70,0,1,5,1,0
18250,28,0,0,70,70,0,1,0,1,0
21249,28,0,0,66,66,0,1,0,1,0
1317,3139,0,0,62,62,0,1,0,1,0
3182,10,13480,9,404,259,145,3,32,2,1
20900,28,0,0,70,70,0,1,0,1,0
16809,1017,0,0,146,146,0,1,0,1,0
9580,15,8149,11,314,192,122,6,26,4,2
14124,15,27704,11,180504,12712,167792,229,32,105,124
4314,233,8083,148,5243,1898,3345,34,3005,18,16
10486,1861,0,0,62,62,0,1,0,1,0
14777,28,0,0,70,70,0,1,0,1,0
9253,10,4255,9,168,86,82,2,30,1,1
17144,2636,0,0,66,66,0,1,0,1,0
15845,26,25751,16,116807,21042,95765,315,19,161,154
15500,10,15263,9,183,94,89,2,30,1,1
8866,10,5923,9,165,78,87,2,30,1,1
9295,26,11389,16,72523,5814,66709,125,255,61,64
15000,15,22721,11,34300,868,33432,35,104,10,25
3027,1880,0,0,146,146,0,1,0,1,0
2039,10,7995,9,214,82,132,2,31,1,1
1570,1888,0,0,146,146,0,1,0,1,0
8468,10,8604,9,214,102,112,2,30,1,1
15230,10,24085,9,86,86,0,1,29,1,0
12787,28,0,0,70,70,0,1,0,1,0
7248,10,0,0,82,82,0,1,31,1,0
18094,510,0,0,66,66,0,1,0,1,0
8351,28,0,0,66,66,0,1,0,1,0
2836,10,20371,9,322,84,238,4,29,2,2
2829,1936,0,0,62,62,0,1,0,1,0
17296,10,7859,9,238,94,144,2,30,1,1
16660,1804,0,0,66,66,0,1,0,1,0
22126,10,9690,9,194,102,92,2,29,1,1
2400,2587,0,0,66,66,0,1,0,1,0
8796,10,8513,9,374,126,248,2,30,1,1
14003,10,20674,9,184,94,90,2,31,1,1
11275,28,0,0,70,70,0,1,0,1,0
16851,28,0,0,70,70,0,1,0,1,0
14492,543,3486,361,150,150,0,1,1200,1,0
2744,1238,3900,918,937,126,811,2,30,1,1
19067,15,6254,11,1516,481,1035,11,15,6,5
44,2256,0,0,62,62,0,1,0,1,0
6188,15,24526,11,1056,682,374,10,15,6,4
21501,2587,0,0,62,62,0,1,0,1,0
8522,26,16678,16,4960,896,4064,14,16,8,6
5818,18,27752,13,184,94,90,2,30,1,1
20934,28,0,0,70,70,0,1,0,1,0
10970,10,11865,9,199,94,105,2,30,1,1
14332,28,0,0,66,66,0,1,0,1,0
22109,10,22183,9,195,94,101,2,30,1,1
10918,2136,18225,1649,316,136,180,6,6,3,3
532,247,0,0,3562,1936,1626,48,192,24,24
9191,983,0,0,66,66,0,1,0,1,0
17259,15,26123,11,22844,1529,21315,39,28,20,19
22589,10,21666,9,214,110,104,2,30,1,1
10274,28,0,0,70,70,0,1,0,1,0
378,1176,0,0,146,146,0,1,0,1,0
17681,3216,0,0,145,145,0,1,0,1,0
2744,1238,27613,918,889,126,763,2,30,1,1
14307,28,0,0,70,70,0,1,0,1,0
3776,10,14770,9,200,82,118,2,30,1,1
13913,10,649,9,193,102,91,2,30,1,1
14994,10,22676,9,179,94,85,2,30,1,1
10305,2938,0,0,62,62,0,1,0,1,0
12399,405,2367,263,130,70,60,3,6,2,1
21280,588,1408,399,70,70,0,1,4,1,0
2842,2883,0,0,62,62,0,1,0,1,0
9498,26,12516,16,1786,172,1614,7,120,3,4
8379,15,4087,11,912,410,502,10,15,5,5
15361,10,29135,9,817,102,715,2,30,1,1
6867,26,19513,16,354,140,214,6,131,3,3
17616,2611,0,0,62,62,0,1,0,1,0
10134,28,0,0,66,66,0,1,0,1,0
2744,1238,13369,918,888,126,762,2,30,1,1
8584,1238,14540,918,249,71,178,2,30,1,1
9533,346,21942,220,5724,1509,4215,18,55,10,8
14617,10,10383,9,184,94,90,2,30,1,1
15368,10,18984,9,196,102,94,2,30,1,1
8697,10,16947,9,289,94,195,4,31,2,2
16951,255,0,0,62,62,0,1,0,1,0
7658,26,289,16,5714,1536,4178,24,21,13,11
9881,28,0,0,66,66,0,1,0,1,0
5045,26,16599,16,5744,2534,3210,24,80,14,10
7390,1147,0,0,62,62,0,1,0,1,0
2390,1880,0,0,66,66,0,1,0,1,0
19633,28,0,0,70,70,0,1,0,1,0
15317,28,0,0,70,70,0,1,0,1,0
17014,28,0,0,70,70,0,1,0,1,0
14849,28,0,0,70,70,0,1,0,1,0
17059,28,0,0,70,70,0,1,0,1,0
12157,26,14254,16,13176,4779,8397,47,17,29,18
2744,1237,26723,917,879,126,753,2,31,1,1
20250,28,0,0,66,66,0,1,0,1,0
15207,26,7247,16,13148,2310,10838,29,80,16,13
15455,28,0,0,70,70,0,1,0,1,0
14613,7,0,0,60,60,0,1,0,1,0
16529,2587,0,0,62,62,0,1,0,1,0
20196,28,0,0,66,66,0,1,0,1,0
19088,28,0,0,70,70,0,1,0,1,0
12,2199,0,0,97,97,0,1,0,1,0
3264,2636,0,0,62,62,0,1,0,1,0
12949,3216,0,0,66,66,0,1,0,1,0
10376,28,0,0,70,70,0,1,0,1,0
13634,10,10460,9,763,101,662,2,30,1,1
21280,588,8305,399,66,66,0,2,7,2,0
17135,797,0,0,66,66,0,1,0,1,0
12744,42,25451,25,70,70,0,2,8,2,0
10991,2030,9356,1558,70,70,0,1,5,1,0
17933,28,0,0,70,70,0,1,0,1,0
11018,10,9152,9,78,78,0,1,30,1,0
8775,10,9161,9,170,87,83,2,30,1,1
14389,10,3111,9,196,86,110,2,29,1,1
9105,28,0,0,70,70,0,1,0,1,0
14269,10,15354,9,184,94,90,2,31,1,1
12909,28,0,0,70,70,0,1,0,1,0
3038,1888,0,0,62,62,0,1,0,1,0
1920,1017,0,0,62,62,0,1,0,1,0
20746,28,0,0,66,66,0,1,0,1,0
647,437,0,0,100,100,0,1,0,1,0
7768,26,25097,16,4536,845,3691,16,15,9,7
19222,28,0,0,70,70,0,1,0,1,0
15137,26,25389,16,341343,9074,332269,353,121,122,231
18003,26,26392,16,1537,934,603,14,32,7,7
22152,28,0,0,70,70,0,1,0,1,0
2502,2587,0,0,62,62,0,1,0,1,0
15362,10,17290,9,209,110,99,2,30,1,1
22608,10,21313,9,402,118,284,2,30,1,1
19747,28,0,0,70,70,0,1,0,1,0
14441,10,8533,9,168,86,82,2,30,1,1
13680,28,0,0,70,70,0,1,0,1,0
10190,26,12722,16,13412,5710,7702,50,257,24,26
14049,28,0,0,70,70,0,1,0,1,0
7349,26,19942,16,1494,898,596,12,142,6,6
949,2938,0,0,66,66,0,1,0,1,0
21301,1017,0,0,66,66,0,1,0,1,0
18993,697,0,0,146,146,0,1,0,1,0
6588,26,22959,16,10176,2162,8014,25,186,14,11
11936,15,23247,11,2954,720,2234,13,143,6,7
22293,10,19533,9,258,102,156,2,30,1,1
20911,28,0,0,66,66,0,1,0,1,0
8423,10,4627,9,179,94,85,2,30,1,1
22700,10,20306,9,214,102,112,2,30,1,1
1472,10,5144,9,234,93,141,2,30,1,1
2724,1240,4556,920,422,164,258,6,30,3,3
4753,26,5017,16,32798,2912,29886,58,170,29,29
11834,3216,0,0,62,62,0,1,0,1,0
9296,10,3249,9,177,94,83,2,30,1,1
18532,2627,1760,2037,741,435,306,10,16,5,5
15581,10,16352,9,255,110,145,2,30,1,1
8762,15,11711,11,312,192,120,6,41,4,2
22479,10,25472,9,522,91,431,4,49,2,2
8452,280,15315,177,411,225,186,6,16,3,3
9737,28,0,0,66,66,0,1,0,1,0
16951,255,0,0,62,62,0,1,0,1,0
8439,10,20964,9,168,86,82,2,33,1,1
15402,843,18344,621,70,70,0,1,5,1,0
3181,899,0,0,145,145,0,1,0,1,0
15205,15,24320,11,234,234,0,4,12,4,0
2823,1771,0,0,62,62,0,1,0,1,0
19105,509,0,0,66,66,0,1,0,1,0
17720,28,0,0,66,66,0,1,0,1,0
8384,10,496,9,209,110,99,2,31,1,1
17883,28,0,0,70,70,0,1,0,1,0
3787,26,28196,16,52330,13948,38382,131,129,71,60
15975,10,11168,9,196,102,94,2,30,1,1
16147,28,0,0,70,70,0,1,0,1,0
12,3116,0,0,1484,1484,0,1,0,1,0
7496,10,13894,9,168,78,90,2,30,1,1
974,15,13834,11,378,192,186,7,26,4,3
16951,255,0,0,62,62,0,1,0,1,0
8314,26,3634,16,2529,1230,1299,17,16,9,8
19279,28,0,0,70,70,0,1,0,1,0
2744,1240,15214,920,882,126,756,2,31,1,1
18548,405,17751,263,70,70,0,1,5,1,0
13643,26,4581,16,34038,16039,17999,79,63,43,36
8937,15,4153,11,254,128,126,5,16,3,2
16774,28,0,0,70,70,0,1,0,1,0
15327,10,6303,9,183,94,89,2,31,1,1
7335,1070,0,0,60,60,0,1,0,1,0
12187,28,0,0,66,66,0,1,0,1,0
8838,15,27110,11,3874260,98179,3776081,4003,1072,1479,2524
15880,10,7436,9,188,96,92,2,31,1,1
15366,511,16989,336,70,70,0,2,8,2,0
15190,10,6437,9,177,94,83,2,29,1,1
17894,26,12475,16,966,480,486,17,29,9,8
3876,1923,0,0,62,62,0,1,0,1,0
8220,1880,0,0,62,62,0,1,0,1,0
14289,2534,11623,1970,70,70,0,1,5,1,0
16951,255,0,0,62,62,0,1,0,1,0
17929,28,0,0,66,66,0,1,0,1,0
14764,28,0,0,70,70,0,1,0,1,0
16567,2256,0,0,146,146,0,1,0,1,0
15781,28,0,0,66,66,0,1,0,1,0
19974,28,0,0,70,70,0,1,0,1,0
21016,28,0,0,70,70,0,1,0,1,0
15264,10,7037,9,264,91,173,4,38,2,2
11712,28,0,0,66,66,0,1,0,1,0
11015,15,14047,11,1479,822,657,11,25,7,4
14890,2695,0,0,66,66,0,1,0,1,0
7359,15,13250,11,1176793,65077,1111716,1528,85,788,740
22322,10,1465,9,214,110,104,2,30,1,1
12479,1031,23883,759,492,306,186,8,17,5,3
18945,26,28314,16,7431,2753,4678,40,18,21,19
1296,10,4338,9,237,91,146,2,34,1,1
21239,28,0,0,66,66,0,1,0,1,0
16665,28,0,0,70,70,0,1,0,1,0
9373,26,19598,16,7726,4613,3113,21,137,11,10
8759,15,26643,11,7098,5692,1406,17,41,9,8
588,2611,0,0,62,62,0,1,0,1,0
21359,28,0,0,66,66,0,1,0,1,0
21535,10,28129,9,398,105,293,4,46,2,2
16523,28,0,0,70,70,0,1,0,1,0
7469,1282,0,0,66,66,0,1,0,1,0
15553,10,12117,9,267,87,180,4,38,2,2
15080,26,2121,16,5414,1010,4404,17,33,9,8
14020,28,0,0,70,70,0,1,0,1,0
14243,10,9817,9,772,100,672,2,31,1,1
16021,281,27924,178,528,528,0,9,1200,9,0
22392,1290,21795,968,230,78,152,2,29,1,1
8900,10,8363,9,216,110,106,2,30,1,1
22144,28,0,0,70,70,0,1,0,1,0
10359,26,25346,16,162,102,60,2,5,1,1
8595,10,24375,9,194,102,92,2,30,1,1
0,0,0,0,274,274,0,2,0,2,0
8587,10,5695,9,215,94,121,2,29,1,1
1481,1147,0,0,146,146,0,1,0,1,0
8872,10,12985,9,296,102,194,4,41,2,2
19776,1017,0,0,66,66,0,1,0,1,0
11338,26,27647,16,569666,25343,544323,721,46,320,401
10975,112,9200,86,70,70,0,2,8,2,0
22065,28,0,0,70,70,0,1,0,1,0
22276,28,0,0,66,66,0,1,0,1,0
2021,1202,0,0,159,159,0,1,0,1,0
17994,3216,0,0,72,72,0,1,0,1,0
20662,6,28111,6,9001,4087,4914,59,39,27,32
13404,1888,0,0,62,62,0,1,0,1,0
14581,10,12534,9,262,126,136,2,30,1,1
10085,28,0,0,66,66,0,1,0,1,0
9661,15,1745,11,502,256,246,9,25,5,4
8707,26,27164,16,8464,2891,5573,20,30,10,10
14912,28,0,0,70,70,0,1,0,1,0
14541,28,0,0,70,70,0,1,0,1,0
17909,15,26508,11,33435,1694,31741,43,20,18,25
18435,28,0,0,66,66,0,1,0,1,0
21540,28,0,0,70,70,0,1,0,1,0
12,2903,0,0,78,78,0,1,0,1,0
18786,26,15429,16,3758,1691,2067,12,135,6,6
14586,28,0,0,70,70,0,1,0,1,0
2955,391,0,0,60,60,0,1,0,1,0
22429,10,22791,9,193,102,91,2,30,1,1
18500,1505,27944,1145,1729,1125,604,14,16,8,6
8935,28,0,0,66,66,0,1,0,1,0
7975,26,20449,16,10665,3059,7606,28,17,16,12
8890,26,2422,16,7226,844,6382,19,50,9,10
2687,26,2317,16,20851,15854,4997,36,20,20,16
5146,15,15957,11,130,70,60,2,15,1,1
21385,10,8545,9,215,102,113,2,30,1,1
8532,26,2616,16,442336,371266,71070,1143,762,651,492
14347,345,12903,219,70,70,0,2,7,2,0
13633,10,999,9,97,97,0,1,61,1,0
16708,28,0,0,70,70,0,1,0,1,0
13552,2636,0,0,66,66,0,1,0,1,0
3368,26,26632,16,7639,948,6691,25,395,9,16
10832,994,14503,733,316,136,180,6,6,3,3
13192,26,25667,16,5809,1552,4257,19,74,11,8
15278,26,23516,16,8006,1986,6020,20,15,11,9
1342,697,0,0,62,62,0,1,0,1,0
21973,10,24024,9,212,102,110,2,30,1,1
8871,6,21621,6,1108,66,1042,3,15,2,1
14355,10,637,9,195,102,93,2,29,1,1
21579,28,0,0,70,70,0,1,0,1,0
8224,26,25191,16,2478246,45190,2433056,2175,27,520,1655
12942,26,10741,16,148422,10568,137854,223,115,114,109
3646,26,25393,16,154,94,60,2,5,1,1
11272,195,10591,129,70,70,0,2,7,2,0
22392,1240,7929,920,239,78,161,2,30,1,1
14962,26,6863,16,7236,2290,4946,18,16,11,7
12271,1771,0,0,146,146,0,1,0,1,0
17753,28,0,0,70,70,0,1,0,1,0
21025,1888,0,0,62,62,0,1,0,1,0
15477,28,0,0,70,70,0,1,0,1,0
8489,26,10565,16,3005,2082,923,18,28,9,9
17507,10,0,0,86,86,0,1,30,1,0
21111,580,28610,392,66,66,0,2,7,2,0
16372,28,0,0,70,70,0,1,0,1,0
1466,1017,0,0,146,146,0,1,0,1,0
15204,10,19547,9,183,94,89,2,29,1,1
4636,26,7566,16,203299,6930,196369,231,16,92,139
13233,26,11235,16,2402,1444,958,18,81,10,8
10071,28,0,0,70,70,0,1,0,1,0
1662,1147,0,0,66,66,0,1,0,1,0
20593,2859,16033,2218,316,190,126,5,15,3,2
21599,28,0,0,70,70,0,1,0,1,0
8790,26,12540,16,2899,1813,1086,12,136,7,5
21850,10,27668,9,214,102,112,2,30,1,1
6328,3216,0,0,62,62,0,1,0,1,0
7335,1072,0,0,60,60,0,1,0,1,0
22635,28,0,0,70,70,0,1,0,1,0
10056,28,0,0,66,66,0,1,0,1,0
10566,26,15018,16,1195,634,561,12,21,7,5
9158,26,20743,16,352,292,60,2,5,1,1
9735,1017,0,0,146,146,0,1,0,1,0
8432,10,15979,9,181,94,87,2,30,1,1
2675,1888,0,0,66,66,0,1,0,1,0
9752,15,5163,11,10029,8683,1346,20,36,11,9
10919,2230,16165,1729,70,70,0,1,5,1,0
16822,28,0,0,70,70,0,1,0,1,0
17325,28,0,0,70,70,0,1,0,1,0
6445,26,16118,16,5057,2448,2609,27,544,12,15
5974,921,0,0,60,60,0,1,0,1,0
9411,26,17867,16,10788,6022,4766,36,144,20,16
14124,10,14947,9,748,106,642,2,31,1,1
9433,26,1270,16,8247,2761,5486,36,99,19,17
8573,10,7875,9,209,102,107,2,30,1,1
15661,10,4124,9,196,102,94,2,30,1,1
18079,26,26413,16,10132,5161,4971,42,15,25,17
22092,10,5413,9,165,86,79,2,30,1,1
9606,26,9423,16,14264,4441,9823,74,386,38,36
3883,26,2345,16,9415,3482,5933,57,16,29,28
4846,2504,3219,1947,156,156,0,3,8,3,0
22076,10,2054,9,211,110,101,2,30,1,1
18284,28,0,0,70,70,0,1,0,1,0
5745,26,3937,16,5565,1382,4183,22,158,11,11
6331,15,17304,11,2161,1178,983,16,17,10,6
15850,1147,0,0,146,146,0,1,0,1,0
6250,2014,1020,1544,207,85,122,4,30,2,2
13074,181,0,0,60,60,0,1,0,1,0
3418,2787,0,0,60,60,0,1,0,1,0
22441,28,0,0,70,70,0,1,0,1,0
21370,132,26578,98,66,66,0,2,8,2,0
2919,1787,0,0,146,146,0,1,0,1,0
2000,1147,0,0,146,146,0,1,0,1,0
9969,28,0,0,70,70,0,1,0,1,0
13632,10,1093,9,198,94,104,2,30,1,1
15592,10,13173,9,193,102,91,2,31,1,1
9583,15,13958,11,318,192,126,6,26,4,2
14924,28,0,0,70,70,0,1,0,1,0
15181,26,5131,16,7914,1925,5989,20,15,11,9
8584,1239,26086,919,242,78,164,2,30,1,1
7641,26,13522,16,5349,1090,4259,18,31,10,8
9039,28,0,0,70,70,0,1,0,1,0
1821,2256,0,0,62,62,0,1,0,1,0
9423,15,7897,11,12764,7749,5015,28,84,14,14
9071,26,1850,16,6754,2219,4535,21,76,11,10
10821,28,0,0,70,70,0,1,0,1,0
18873,2486,0,0,66,66,0,1,0,1,0
13426,28,0,0,66,66,0,1,0,1,0
9383,1147,0,0,66,66,0,1,0,1,0
12860,28,0,0,66,66,0,1,0,1,0
20225,28,0,0,70,70,0,1,0,1,0
11064,1215,0,0,62,62,0,1,0,1,0
5318,2938,0,0,62,62,0,1,0,1,0
7690,1888,0,0,62,62,0,1,0,1,0
17017,432,0,0,62,62,0,1,0,1,0
12047,26,27760,16,4940,2342,2598,21,135,10,11
13687,10,19198,9,182,94,88,2,30,1,1
22040,28,0,0,70,70,0,1,0,1,0
15299,10,0,0,86,86,0,1,30,1,0
1908,10,11508,9,223,86,137,2,29,1,1
20677,26,510,16,4945,2798,2147,27,141,14,13
21845,10,12636,9,184,80,104,2,30,1,1
22460,15,11441,11,8814,4800,4014,52,629,27,25
7553,1804,0,0,62,62,0,1,0,1,0
22377,10,25265,9,214,110,104,2,30,1,1
9019,10,29148,9,177,94,83,2,30,1,1
14714,2382,0,0,62,62,0,1,0,1,0
11207,26,22828,16,38013,6855,31158,58,21,25,33
10615,432,0,0,66,66,0,1,0,1,0
4923,26,17260,16,1649,980,669,14,28,7,7
8388,15,10965,11,214,140,74,4,15,3,1
11296,10,6284,9,168,78,90,2,30,1,1
8386,26,27073,16,70,70,0,2,4,2,0
11236,28,0,0,70,70,0,1,0,1,0
21,2953,0,0,62,62,0,1,0,1,0
4246,26,10928,16,4555,859,3696,17,360,9,8
21585,10,27350,9,179,94,85,2,30,1,1
15385,10,13459,9,177,94,83,2,30,1,1
14274,10,1066,9,183,94,89,2,30,1,1
2434,10,10096,9,220,90,130,2,29,1,1
14448,28,0,0,66,66,0,1,0,1,0
17903,1147,0,0,66,66,0,1,0,1,0
274,9,0,0,60,60,0,1,0,1,0
12864,26,28305,16,190,70,120,4,15,2,2
22282,26,8668,16,7584,7094,490,14,124,7,7
5104,26,10870,16,5306,1619,3687,20,29,12,8
2365,1472,0,0,146,146,0,1,0,1,0
1805,1017,0,0,66,66,0,1,0,1,0
13802,10,27249,9,188,96,92,2,30,1,1
13721,10,12130,9,166,86,80,2,30,1,1
9435,10,114,9,189,102,87,2,30,1,1
8325,15,21343,11,10922,816,10106,19,18,8,11
22390,10,25985,9,199,102,97,2,31,1,1
3187,2636,0,0,62,62,0,1,0,1,0
13172,28,0,0,66,66,0,1,0,1,0
11750,2611,0,0,66,66,0,1,0,1,0
15987,10,882,9,181,94,87,2,31,1,1
21330,10,14439,9,183,94,89,2,31,1,1
18778,2611,0,0,62,62,0,1,0,1,0
6181,1771,0,0,146,146,0,1,0,1,0
13988,10,11808,9,177,94,83,2,29,1,1
16249,28,0,0,66,66,0,1,0,1,0
21324,10,28272,9,326,92,234,4,31,2,2
11753,10,23151,9,200,90,110,2,30,1,1
15803,10,23250,9,182,93,89,2,31,1,1
3280,26,14815,16,9695,4412,5283,22,172,13,9
7949,314,0,0,60,60,0,1,0,1,0
11491,28,0,0,70,70,0,1,0,1,0
6858,2608,0,0,74,74,0,1,0,1,0
20233,28,0,0,70,70,0,1,0,1,0
8816,10,28127,9,322,110,212,4,30,2,2
21605,28,0,0,66,66,0,1,0,1,0
13961,10,18909,9,186,95,91,2,31,1,1
20936,26,11750,16,8104,2201,5903,28,135,15,13
14862,10,6231,9,164,84,80,2,31,1,1
10708,28,0,0,70,70,0,1,0,1,0
22462,28,0,0,66,66,0,1,0,1,0
12602,428,1796,278,70,70,0,1,4,1,0
19327,26,23112,16,2959,1819,1140,19,86,10,9
13155,26,19418,16,9131,3499,5632,39,24,21,18
13782,10,24263,9,228,90,138,2,30,1,1
10311,26,24449,16,37173,3712,33461,54,74,24,30
18,3216,0,0,62,62,0,1,0,1,0
13473,1017,0,0,66,66,0,1,0,1,0
6085,26,23902,16,20365,2035,18330,36,15,17,19
10740,2161,28976,1669,70,70,0,2,8,2,0
21364,941,21387,693,66,66,0,2,8,2,0
19797,26,5949,16,11694,4947,6747,34,48,19,15
691,425,0,0,66,66,0,1,0,1,0
11601,26,19756,16,6292,1492,4800,22,17,11,11
277,1539,0,0,66,66,0,1,0,1,0
14281,26,3387,16,7267,2312,4955,16,120,7,9
14630,10,5842,9,189,102,87,2,30,1,1
17087,26,7805,16,5107,700,4407,15,15,7,8
12498,2987,6199,2321,70,70,0,2,8,2,0
16951,255,0,0,62,62,0,1,0,1,0
11170,15,3848,11,3476,1433,2043,26,418,14,12
9929,28,0,0,70,70,0,1,0,1,0
16912,28,0,0,70,70,0,1,0,1,0
14441,28,0,0,66,66,0,1,0,1,0
22713,28,0,0,66,66,0,1,0,1,0
19185,2899,0,0,146,146,0,1,0,1,0
15156,26,3383,16,20897,11903,8994,52,49,30,22
21904,10,26028,9,183,94,89,2,30,1,1
18376,1493,0,0,66,66,0,1,0,1,0
17139,26,15176,16,8595,2118,6477,40,179,22,18
21690,10,27458,9,197,94,103,2,30,1,1
21906,10,850,9,178,94,84,2,30,1,1
14354,28,0,0,70,70,0,1,0,1,0
1804,2513,0,0,60,60,0,1,0,1,0
20351,26,27916,16,4604,1697,2907,19,29,11,8
16509,15,16874,11,3561,3028,533,14,31,8,6
11084,26,20055,16,9339,4411,4928,20,135,10,10
22256,28,0,0,66,66,0,1,0,1,0
4643,740,8303,531,432,192,240,8,30,4,4
17844,26,302,16,89790,6036,83754,112,55,41,71
13789,10,24721,9,184,94,90,2,31,1,1
15738,10,28982,9,793,101,692,2,31,1,1
18044,2587,0,0,66,66,0,1,0,1,0
20408,28,0,0,70,70,0,1,0,1,0
13450,1539,0,0,66,66,0,1,0,1,0
18428,26,718,16,130,70,60,2,15,1,1
13028,28,0,0,70,70,0,1,0,1,0
3870,1215,0,0,62,62,0,1,0,1,0
12727,28,0,0,70,70,0,1,0,1,0
12481,26,22624,16,24895,2856,22039,46,270,22,24
20653,427,0,0,62,62,0,1,0,1,0
4956,10,16485,9,260,106,154,2,32,1,1
1775,10,6605,9,832,106,726,2,30,1,1
1557,2587,0,0,62,62,0,1,0,1,0
11357,1017,0,0,62,62,0,1,0,1,0
1731,1816,11249,1385,323,150,173,2,1201,1,1
10910,341,17927,217,172,94,78,2,29,1,1
2939,1804,0,0,62,62,0,1,0,1,0
22703,28,0,0,70,70,0,1,0,1,0
17201,26,10178,16,17071,1532,15539,17,27,3,14
14453,10,3395,9,177,94,83,2,30,1,1
16262,28,0,0,66,66,0,1,0,1,0
6630,26,18843,16,4691,1784,2907,19,29,11,8
14629,28,0,0,66,66,0,1,0,1,0
8345,15,1511,11,2807,587,2220,13,16,7,6
2461,1888,0,0,62,62,0,1,0,1,0
16919,1771,0,0,62,62,0,1,0,1,0
16569,1476,0,0,146,146,0,1,0,1,0
20584,28,0,0,66,66,0,1,0,1,0
3438,10,14253,9,229,98,131,2,30,1,1
14711,28,0,0,70,70,0,1,0,1,0
9809,26,11263,16,374,192,182,7,28,4,3
8210,1896,21194,1449,863,363,500,4,1200,2,2
17634,28,0,0,70,70,0,1,0,1,0
21025,28,0,0,70,70,0,1,0,1,0
6889,1888,0,0,62,62,0,1,0,1,0
8407,28,0,0,70,70,0,1,0,1,0
9072,2883,0,0,62,62,0,1,0,1,0
10107,15,20151,11,1442,700,742,12,35,6,6
11137,26,2336,16,12091,3135,8956,30,49,16,14
22594,10,17686,9,199,102,97,2,29,1,1
8730,10,3003,9,168,78,90,2,30,1,1
20436,28,0,0,66,66,0,1,0,1,0
16951,255,0,0,62,62,0,1,0,1,0
11709,28,0,0,70,70,0,1,0,1,0
4855,2504,519,1947,156,156,0,3,8,3,0
12920,28,0,0,70,70,0,1,0,1,0
21851,1827,0,0,66,66,0,1,0,1,0
8874,28,0,0,70,70,0,1,0,1,0
7469,1282,0,0,66,66,0,1,0,1,0
4942,15,21676,11,122,62,60,2,15,1,1
4351,26,14774,16,3452,1535,1917,18,82,10,8
14587,10,6899,9,184,102,82,2,29,1,1
15133,10,17968,9,214,110,104,2,30,1,1
18440,26,7933,16,10101,2782,7319,22,78,10,12
14541,10,1055,9,168,78,90,2,30,1,1
11248,15,3335,11,2373,614,1759,11,15,6,5
16930,28,0,0,70,70,0,1,0,1,0
20834,26,5406,16,622,310,312,11,59,6,5
17988,26,2983,16,16776,7513,9263,42,47,24,18
20143,28,0,0,70,70,0,1,0,1,0
11967,28,0,0,70,70,0,1,0,1,0
1591,1888,0,0,62,62,0,1,0,1,0
5096,26,19200,16,496852,12216,484636,499,16,167,332
3231,1215,0,0,66,66,0,1,0,1,0
9498,28,0,0,66,66,0,1,0,1,0
11148,15,27611,11,3158,1309,1849,28,418,15,13
9648,10,17789,9,168,86,82,2,30,1,1
2744,1239,17206,919,914,126,788,2,31,1,1
14483,10,21694,9,178,94,84,2,29,1,1
3559,26,2989,16,3419,2241,1178,16,16,8,8
19788,28,0,0,70,70,0,1,0,1,0
956,15,26243,11,378,192,186,7,26,4,3
8384,10,4879,9,202,103,99,2,31,1,1
9383,26,22128,16,6661,1489,5172,26,270,13,13
2724,1240,9074,920,422,164,258,6,31,3,3
21776,10,12328,9,183,94,89,2,30,1,1
48,1215,0,0,62,62,0,1,0,1,0
3757,15,10560,11,6260,696,5564,17,16,9,8
14856,2256,0,0,66,66,0,1,0,1,0
14090,10,25,9,730,102,628,2,30,1,1
11056,1215,0,0,60,60,0,1,0,1,0
21898,10,2699,9,294,102,192,2,30,1,1
9241,28,0,0,70,70,0,1,0,1,0
9166,10,10680,9,196,102,94,2,30,1,1
20788,2938,0,0,66,66,0,1,0,1,0
15520,10,4501,9,239,102,137,2,30,1,1
13990,10,20591,9,216,110,106,2,30,1,1
15832,10,6235,9,193,102,91,2,30,1,1
9078,26,9272,16,12190,2075,10115,28,16,14,14
8679,28,0,0,66,66,0,1,0,1,0
10857,2464,13333,1915,160,70,90,2,4,1,1
9360,26,4910,16,6444,1320,5124,31,727,10,21
2134,1367,0,0,60,60,0,1,0,1,0
16021,2627,6614,2037,700,275,425,4,1200,2,2
22404,10,19694,9,334,94,240,2,30,1,1
8270,676,15778,475,130,70,60,2,5,1,1
1691,1134,0,0,62,62,0,1,0,1,0
1454,2573,0,0,146,146,0,1,0,1,0
7406,10,20038,9,237,91,146,2,33,1,1
12040,28,0,0,66,66,0,1,0,1,0
19828,1771,0,0,66,66,0,1,0,1,0
3019,10,12491,9,825,99,726,2,31,1,1
8385,10,17432,9,195,102,93,2,30,1,1
22156,10,19499,9,749,89,660,2,30,1,1
15492,28,0,0,66,66,0,1,0,1,0
924,26,14116,16,5731,495,5236,14,15,7,7
18883,26,25409,16,15774,5540,10234,48,48,26,22
2568,10,10787,9,235,90,145,2,33,1,1
8638,10,13250,9,772,102,670,2,30,1,1
10860,1601,20600,1225,70,70,0,2,6,2,0
17287,28,0,0,70,70,0,1,0,1,0
5013,234,11467,149,3397,1506,1891,26,640,8,18
8551,10,856,9,186,95,91,2,30,1,1
12100,1017,0,0,66,66,0,1,0,1,0
2108,797,0,0,62,62,0,1,0,1,0
2274,2836,0,0,74,74,0,1,0,1,0
13688,26,28845,16,45487,4986,40501,74,47,36,38
21764,10,25082,9,183,102,81,2,29,1,1
11490,28,0,0,70,70,0,1,0,1,0
19776,1804,0,0,62,62,0,1,0,1,0
11219,1105,1186,811,70,70,0,2,9,2,0
10768,2412,1516,1877,70,70,0,1,5,1,0
1608,2477,0,0,60,60,0,1,0,1,0
6439,26,28950,16,6513,1609,4904,26,303,14,12
7985,10,20856,9,404,259,145,3,33,2,1
17010,26,11069,16,7924,702,7222,17,16,7,10
10957,15,8793,11,1945,1002,943,11,20,7,4
9214,3256,0,0,60,60,0,1,0,1,0
13811,10,22462,9,193,102,91,2,30,1,1
10836,2527,8786,1963,70,70,0,2,8,2,0
6564,26,4063,16,4389,797,3592,15,70,8,7
3669,26,14399,16,256793,17776,239017,327,23,146,181
13751,10,23075,9,438,94,344,2,29,1,1
8364,10,24055,9,214,102,112,2,30,1,1
12454,26,12404,16,3096,962,2134,13,135,6,7
15797,10,6957,9,176,90,86,2,30,1,1
11046,2974,13714,2309,70,70,0,2,9,2,0
11489,2587,0,0,66,66,0,1,0,1,0
8375,280,1285,177,70,70,0,2,8,2,0
22111,10,20022,9,209,94,115,2,29,1,1
18532,28,0,0,70,70,0,1,0,1,0
6590,26,1294,16,9551,2173,7378,33,25,17,16
4936,26,12112,16,134,60,74,3,4,2,1
11766,26,6327,16,6218,1239,4979,14,133,7,7
2744,1314,620,991,890,126,764,2,30,1,1
14087,10,17360,9,213,102,111,2,30,1,1
19817,26,4534,16,7370,2873,4497,23,47,13,10
18566,28,0,0,70,70,0,1,0,1,0
22058,10,1181,9,193,102,91,2,30,1,1
5725,26,10971,16,4917,1273,3644,17,34,10,7
15388,26,13625,16,8021,2001,6020,20,16,11,9
9566,10,21966,9,194,87,107,2,30,1,1
17663,15,17097,11,882,527,355,10,255,6,4
21883,10,16501,9,718,94,624,2,30,1,1
16543,28,0,0,70,70,0,1,0,1,0
21429,28,0,0,70,70,0,1,0,1,0
14022,28,0,0,70,70,0,1,0,1,0
19684,1694,0,0,66,66,0,1,91,1,0
10570,26,22522,16,53075,3609,49466,74,173,25,49
10473,2636,0,0,66,66,0,1,0,1,0
16951,255,0,0,62,62,0,1,0,1,0
17256,28,0,0,70,70,0,1,0,1,0
15853,10,11490,9,771,101,670,2,30,1,1
13669,26,3224,16,1786,172,1614,7,120,3,4
22198,10,1377,9,196,102,94,2,30,1,1
15048,1392,2889,1059,1806,1806,0,22,224,22,0
14451,10,16671,9,177,94,83,2,29,1,1
3811,26,4194,16,15997,3015,12982,31,18,16,15
1653,26,5926,16,274,132,142,5,15,3,2
9226,28,0,0,70,70,0,1,0,1,0
9598,28,0,0,70,70,0,1,0,1,0
11590,26,14788,16,1309,670,639,16,166,9,7
21131,28,0,0,66,66,0,1,0,1,0
15872,10,26748,9,748,95,653,2,30,1,1
18159,28,0,0,66,66,0,1,0,1,0
13035,28,0,0,70,70,0,1,0,1,0
19906,1888,0,0,66,66,0,1,0,1,0
21156,3216,0,0,62,62,0,1,0,1,0
2906,1888,0,0,62,62,0,1,0,1,0
22318,10,2268,9,209,110,99,2,31,1,1
21884,10,18565,9,816,102,714,2,30,1,1
12565,2936,4370,2277,70,70,0,1,4,1,0
4988,797,0,0,62,62,0,1,0,1,0
14478,26,1352,16,399086,26649,372437,488,462,156,332
8785,10,21846,9,789,110,679,2,30,1,1
16951,255,0,0,62,62,0,1,0,1,0
16021,2723,1499,2117,330,330,0,6,1200,6,0
13316,28,0,0,66,66,0,1,0,1,0
639,310,0,0,143,143,0,1,0,1,0
3210,2205,0,0,146,146,0,1,0,1,0
12028,26,24881,16,7141,2507,4634,28,42,13,15
3988,697,0,0,74,74,0,1,0,1,0
9032,26,8030,16,11578,2375,9203,47,55,22,25
14992,10,13023,9,224,94,130,2,30,1,1
21072,1771,0,0,62,62,0,1,0,1,0
19934,26,8874,16,117314,4775,112539,144,120,51,93
6788,26,26266,16,9734,1614,8120,24,170,11,13
356,2380,0,0,62,62,0,1,0,1,0
16951,255,0,0,62,62,0,1,0,1,0
723,2587,0,0,62,62,0,1,0,1,0
9595,15,5358,11,2673,564,2109,11,125,6,5
17368,28,0,0,70,70,0,1,0,1,0
2013,183,7857,121,3564,1850,1714,18,35,10,8
5675,26,18498,16,8126,1627,6499,29,165,16,13
8802,10,9877,9,180,94,86,2,30,1,1
11307,28,0,0,70,70,0,1,0,1,0
16458,26,6470,16,300,180,120,6,28,4,2
16378,26,15534,16,4042,2515,1527,28,169,14,14
15761,10,17714,9,214,110,104,2,29,1,1
631,2154,0,0,62,62,0,1,0,1,0
8777,15,16378,11,378,192,186,7,41,4,3
18352,28,0,0,66,66,0,1,0,1,0
22423,26,16593,16,5012,4134,878,17,98,10,7
1108,26,12519,16,3614,434,3180,11,15,6,5
21356,3033,18676,2358,504,382,122,8,16,6,2
21740,10,16677,9,373,126,247,2,30,1,1
13495,28,0,0,70,70,0,1,0,1,0
2773,1471,0,0,145,145,0,1,0,1,0
19347,3216,0,0,66,66,0,1,0,1,0
21724,10,7771,9,291,102,189,2,29,1,1
9586,1147,0,0,66,66,0,1,0,1,0
14267,3155,20496,2445,504,318,186,8,15,5,3
13158,2883,0,0,62,62,0,1,0,1,0
15528,10,15415,9,183,94,89,2,30,1,1
21353,2788,2735,2163,66,66,0,2,7,2,0
16624,28,0,0,70,70,0,1,0,1,0
21185,2873,28160,2232,312,132,180,6,6,3,3
2647,1210,0,0,62,62,0,1,0,1,0
3147,2587,0,0,66,66,0,1,0,1,0
15030,41,0,0,60,60,0,1,0,1,0
12655,2256,0,0,66,66,0,1,0,1,0
22251,10,18133,9,182,93,89,2,31,1,1
9273,6,21822,6,60,60,0,1,5,1,0
10061,15,7256,11,9630744,98097,9532647,7804,123,1387,6417
8723,10,21962,9,272,110,162,2,29,1,1
11815,28,0,0,70,70,0,1,0,1,0
14005,10,3202,9,190,97,93,2,31,1,1
13779,10,15291,9,216,110,106,2,30,1,1
9641,28,0,0,66,66,0,1,0,1,0
17300,26,6785,16,10214,2669,7545,30,170,14,16
15227,26,5852,16,1272,876,396,10,25,6,4
17794,26,8816,16,6695,1617,5078,23,200,13,10
18125,28,0,0,70,70,0,1,0,1,0
15340,10,10539,9,194,102,92,2,29,1,1
17892,26,10987,16,5024,2538,2486,23,15,13,10
21935,10,4589,9,821,102,719,2,30,1,1
415,1054,0,0,66,66,0,1,0,1,0
14462,15,9171,11,1151,711,440,10,15,5,5
7949,314,0,0,60,60,0,1,0,1,0
22302,1880,0,0,66,66,0,1,0,1,0
3533,10,19815,9,168,78,90,2,29,1,1
20193,28,0,0,70,70,0,1,0,1,0
16951,255,0,0,62,62,0,1,0,1,0
6961,1147,0,0,146,146,0,1,0,1,0
10919,15,7646,11,15867,8841,7026,29,29,16,13
14839,10,8389,9,802,104,698,2,31,1,1
19009,28,0,0,70,70,0,1,0,1,0
9424,10,14943,9,819,102,717,2,30,1,1
4055,15,7424,11,841,715,126,5,14,3,2
22711,28,0,0,66,66,0,1,0,1,0
15872,28,0,0,70,70,0,1,0,1,0
15004,10,7172,9,760,97,663,2,30,1,1
14334,10,3913,9,202,103,99,2,31,1,1
11161,1407,16057,1070,66,66,0,1,5,1,0
8016,26,22478,16,7209,2331,4878,20,23,11,9
11251,1637,16757,1258,66,66,0,1,5,1,0
7233,15,14281,11,1117,762,355,10,255,6,4
10104,28,0,0,70,70,0,1,0,1,0
14050,10,16480,9,216,110,106,2,29,1,1
9963,26,28090,16,337727,11283,326444,367,208,126,241
13539,28,0,0,70,70,0,1,0,1,0
15989,983,0,0,66,66,0,1,0,1,0
15405,818,7618,598,564,318,246,9,15,5,4
9629,28,0,0,70,70,0,1,0,1,0
21908,1797,0,0,66,66,0,1,0,1,0
17369,10,0,0,215,77,138,2,31,1,1
9700,28,0,0,70,70,0,1,0,1,0
1676,10,6041,9,217,87,130,2,31,1,1
7335,1070,0,0,60,60,0,1,0,1,0
11102,15,11102,11,482,300,182,9,26,6,3
8622,10,9504,9,308,101,207,4,32,2,2
21893,10,23070,9,226,102,124,2,30,1,1
22272,1472,0,0,66,66,0,1,0,1,0
14262,10,15967,9,210,110,100,2,30,1,1
16356,26,12721,16,22342,1787,20555,38,177,16,22
8172,6,21144,6,11002,3445,7557,60,42,26,34
21642,10,21736,9,182,93,89,2,31,1,1
18035,26,7166,16,58431,5847,52584,55,120,10,45
9389,28,0,0,70,70,0,1,0,1,0
10761,1952,12377,1489,66,66,0,1,5,1,0
9832,15,3668,11,27391,3550,23841,36,20,15,21
11232,3219,4830,2496,164,70,94,2,4,1,1
4069,26,8174,16,2988,1649,1339,17,255,9,8
2464,10,10243,9,216,90,126,2,30,1,1
9248,28,0,0,70,70,0,1,0,1,0
3498,1804,0,0,66,66,0,1,0,1,0
11337,3,0,0,60,60,0,1,0,1,0
9780,26,21355,16,7332,1611,5721,17,15,9,8
3571,10,0,0,86,86,0,1,30,1,0
12711,2177,14294,1682,70,70,0,2,7,2,0
0,0,0,0,98,98,0,1,0,1,0
11450,1686,0,0,60,60,0,1,0,1,0
18901,26,12441,16,10706,1679,9027,27,46,15,12
16808,26,6903,16,232,172,60,3,5,2,1
8404,346,21384,220,4451,1329,3122,13,53,7,6
3839,697,0,0,146,146,0,1,0,1,0
21656,10,1235,9,196,102,94,2,35,1,1
15268,10,2308,9,756,95,661,2,31,1,1
19606,28,0,0,70,70,0,1,0,1,0
20044,15,27722,11,29401,10036,19365,49,28,24,25
17940,10,0,0,275,75,200,2,30,1,1
22434,10,17198,9,216,94,122,2,30,1,1
15058,28,0,0,70,70,0,1,0,1,0
3489,2256,0,0,66,66,0,1,0,1,0
9067,10,18160,9,194,94,100,2,30,1,1
9589,26,22189,16,14431,2090,12341,42,142,20,22
10726,1869,4849,1427,70,70,0,1,5,1,0
14701,10,6149,9,372,142,230,2,29,1,1
15720,10,4810,9,969,86,883,2,30,1,1
1675,3216,0,0,66,66,0,1,0,1,0
13126,26,2010,16,7990,2701,5289,30,61,17,13
10302,26,15302,16,1561,768,793,17,185,9,8
15809,10,23598,9,183,94,89,2,30,1,1
6746,15,4009,11,2693,841,1852,13,16,8,5
22407,10,18770,9,183,94,89,2,30,1,1
15258,26,25027,16,4533,1626,2907,19,28,11,8
7812,1147,0,0,66,66,0,1,0,1,0
3400,26,14365,16,7527,2435,5092,16,120,8,8
2115,10,8414,9,233,91,142,2,31,1,1
20803,26,8906,16,10617247,317598,10299649,11317,243,4141,7176
7482,1017,0,0,146,146,0,1,0,1,0
13870,10,20920,9,182,94,88,2,30,1,1
12131,26,1131,16,5993,974,5019,19,70,10,9
21082,28,0,0,70,70,0,1,0,1,0
1438,10,5004,9,216,98,118,2,30,1,1
10217,15,23157,11,3422,1962,1460,33,131,18,15
2744,1238,24789,918,858,126,732,2,31,1,1
5473,15,16527,11,1569,593,976,10,44,6,4
532,247,0,0,3354,1792,1562,46,193,23,23
21475,10,14887,9,342,105,237,4,53,2,2
13122,28,0,0,70,70,0,1,0,1,0
9768,1215,0,0,66,66,0,1,0,1,0
13433,1462,0,0,66,66,0,1,0,1,0
662,15,2618,11,115811,3862,111949,123,38,44,79
2837,10,11684,9,407,261,146,3,32,2,1
219,3188,0,0,66,66,0,1,0,1,0
9901,28,0,0,70,70,0,1,0,1,0
15693,28,0,0,70,70,0,1,0,1,0
14637,28,0,0,70,70,0,1,0,1,0
10168,28,0,0,70,70,0,1,0,1,0
10298,3216,0,0,62,62,0,1,0,1,0
3323,1386,0,0,62,62,0,1,0,1,0
10171,26,427,16,7712,2203,5509,24,516,14,10
16508,28,0,0,70,70,0,1,0,1,0
18055,28,0,0,70,70,0,1,0,1,0
13836,28,0,0,70,70,0,1,0,1,0
13657,28,0,0,70,70,0,1,0,1,0
22208,10,13906,9,771,102,669,2,29,1,1
12334,28,0,0,70,70,0,1,0,1,0
8732,26,15701,16,10225,5069,5156,30,106,17,13
21467,28,0,0,70,70,0,1,0,1,0
4173,1147,0,0,66,66,0,1,0,1,0
19280,15,18873,11,2526,843,1683,12,255,7,5
18483,161,11953,111,320,140,180,6,7,3,3
15403,28,0,0,70,70,0,1,0,1,0
22289,1215,0,0,66,66,0,1,0,1,0
8546,10,12165,9,199,102,97,2,30,1,1
15378,10,23013,9,183,94,89,2,30,1,1
16951,255,0,0,62,62,0,1,0,1,0
9604,10,3823,9,751,95,656,2,30,1,1
14481,10,26310,9,196,102,94,2,29,1,1
13889,10,18817,9,356,118,238,2,30,1,1
22426,28,0,0,70,70,0,1,0,1,0
14321,2274,9551,1761,70,70,0,1,5,1,0
7692,16,0,0,60,60,0,1,0,1,0
8688,28,0,0,66,66,0,1,0,1,0
17967,26,17274,16,2118,1093,1025,22,44,9,13
1718,3051,0,0,62,62,0,1,0,1,0
3386,1888,0,0,62,62,0,1,0,1,0
13292,28,0,0,66,66,0,1,0,1,0
14767,10,18338,9,194,102,92,2,30,1,1
4948,26,17608,16,8627,2906,5721,10,121,4,6
7713,26,4760,16,172,172,0,2,5,2,0
21882,26,15222,16,8903,2857,6046,22,135,10,12
21579,10,1822,9,344,105,239,4,33,2,2
466,26,10756,16,1191,692,499,12,40,7,5
9719,26,3396,16,149414,8612,140802,208,25,107,101
8609,15,8023,11,3642,1460,2182,23,143,12,11
22530,10,23351,9,460,112,348,4,56,2,2
18297,26,14014,16,12428,5331,7097,47,32,21,26
1570,1888,0,0,146,146,0,1,0,1,0
2354,2747,0,0,66,66,0,1,0,1,0
2744,1561,12340,1192,883,126,757,2,31,1,1
10479,28,0,0,70,70,0,1,0,1,0
13131,26,13374,16,27760,9709,18051,56,45,27,29
1508,1147,0,0,146,146,0,1,0,1,0
11755,1827,0,0,66,66,0,1,0,1,0
16951,255,0,0,62,62,0,1,0,1,0
8413,10,1552,9,177,94,83,2,30,1,1
3430,1472,0,0,66,66,0,1,0,1,0
5701,1392,20746,1059,1806,1806,0,22,225,22,0
14252,10,5872,9,198,101,97,2,31,1,1
450,126,0,0,136,136,0,1,0,1,0
21330,2806,22005,2177,312,132,180,6,6,3,3
4844,2504,25640,1947,156,156,0,3,7,3,0
3529,15,14428,11,424,198,226,7,142,4,3
11143,26,14153,16,17710,1892,15818,37,24,17,20
7508,2587,0,0,62,62,0,1,0,1,0
14542,10,12976,9,209,110,99,2,31,1,1
13650,28,0,0,70,70,0,1,0,1,0
18463,26,10083,16,7073,1556,5517,21,80,11,10
1353,1888,0,0,62,62,0,1,0,1,0
4025,26,29065,16,1251,749,502,11,68,6,5
20450,28,0,0,70,70,0,1,0,1,0
20136,1147,0,0,62,62,0,1,0,1,0
9092,26,8238,16,4904,864,4040,17,28,10,7
20066,26,13376,16,28031,7016,21015,51,45,23,28
9128,10,28880,9,749,94,655,2,30,1,1
20727,2938,0,0,66,66,0,1,0,1,0
439,7,0,0,60,60,0,1,0,1,0
7190,10,25143,9,307,86,221,2,31,1,1
9863,26,10499,16,6336,1377,4959,19,169,9,10
9728,84,3316,64,1617,161,1456,4,1199,2,2
3272,26,7505,16,16652,13777,2875,48,44,27,21
14854,10,23638,9,182,102,80,2,30,1,1
1849,1017,0,0,62,62,0,1,0,1,0
15042,3,0,0,60,60,0,1,0,1,0
10800,15,2469,11,135293,6214,129079,161,24,71,90
19933,28,0,0,70,70,0,1,0,1,0
13101,28,0,0,70,70,0,1,0,1,0
8444,28,0,0,70,70,0,1,0,1,0
16951,255,0,0,62,62,0,1,0,1,0
9009,26,19265,16,5996,976,5020,19,72,10,9
14737,10,4605,9,214,94,120,2,30,1,1
14034,28,0,0,70,70,0,1,0,1,0
16381,10,25630,9,228,97,131,2,31,1,1
14596,10,4902,9,198,102,96,2,30,1,1
18762,18,13594,13,184,94,90,2,30,1,1
2084,1471,0,0,145,145,0,1,0,1,0
15525,28,0,0,70,70,0,1,0,1,0
16021,287,8251,184,546,166,380,2,1200,1,1
22510,2611,0,0,78,78,0,1,0,1,0
16727,178,0,0,60,60,0,1,0,1,0
3677,26,15106,16,11441,6765,4676,40,792,19,21
14308,28,0,0,66,66,0,1,0,1,0
13930,10,8004,9,268,87,181,4,35,2,2
19399,1888,0,0,66,66,0,1,0,1,0
2229,697,0,0,62,62,0,1,0,1,0
2084,1471,0,0,145,145,0,1,0,1,0
10451,28,0,0,70,70,0,1,0,1,0
2724,1240,18948,920,422,164,258,6,30,3,3
10870,28,0,0,66,66,0,1,0,1,0
12854,28,0,0,66,66,0,1,0,1,0
14916,10,14832,9,177,94,83,2,30,1,1
22166,28,0,0,66,66,0,1,0,1,0
14438,28,0,0,70,70,0,1,0,1,0
14312,10,3068,9,214,110,104,2,30,1,1
14043,1147,0,0,62,62,0,1,0,1,0
2099,2256,0,0,62,62,0,1,0,1,0
823,984,0,0,60,60,0,1,0,1,0
21209,3110,13281,2416,1691,446,1245,10,15,7,3
15042,26,21149,16,6364,1147,5217,19,24,11,8
8832,10,27233,9,392,124,268,4,35,2,2
8644,10,13821,9,551,114,437,4,37,2,2
10626,15,11220,11,2016,1050,966,21,300,11,10
9199,10,28341,9,195,102,93,2,31,1,1
11584,28,0,0,66,66,0,1,0,1,0
14758,28,0,0,70,70,0,1,0,1,0
8651,26,10970,16,49823,7236,42587,56,29,20,36
7656,1167,0,0,100,100,0,1,0,1,0
250,2587,0,0,66,66,0,1,0,1,0
15516,2256,0,0,62,62,0,1,0,1,0
14124,10,13629,9,193,102,91,2,30,1,1
11176,28,0,0,66,66,0,1,0,1,0
11500,15,20906,11,3290,2776,514,12,15,7,5
10194,15,22313,11,450,246,204,8,26,5,3
9696,28,0,0,70,70,0,1,0,1,0
6208,26,16583,16,7583,607,6976,18,119,7,11
22112,10,15387,9,198,101,97,2,30,1,1
8465,861,0,0,145,145,0,1,0,1,0
9781,15,21243,11,1742,589,1153,10,87,6,4
21949,10,16491,9,165,86,79,2,30,1,1
9083,26,6411,16,16012,2097,13915,33,16,15,18
16307,1598,0,0,361,361,0,1,0,1,0
9489,10,19143,9,193,102,91,2,30,1,1
14962,10,5857,9,196,102,94,2,31,1,1
8697,1215,0,0,66,66,0,1,0,1,0
13643,26,1014,16,7745,2583,5162,27,100,15,12
1540,2256,0,0,66,66,0,1,0,1,0
22456,10,1570,9,186,95,91,2,31,1,1
16279,26,13510,16,6400,1327,5073,21,21,13,8
218,2174,0,0,62,62,0,1,0,1,0
9445,15,13500,11,2316,1206,1110,16,81,9,7
21246,2137,679,1650,70,70,0,1,4,1,0
14835,10,13028,9,209,110,99,2,30,1,1
12045,26,27698,16,3814,2664,1150,22,28,12,10
19508,15,25246,11,21567,1666,19901,35,46,18,17
493,274,0,0,145,145,0,1,0,1,0
8931,10,24697,9,233,102,131,2,30,1,1
11013,26,11487,16,23955,4211,19744,42,46,21,21
14941,10,10880,9,184,102,82,2,30,1,1
14968,1147,0,0,66,66,0,1,0,1,0
17896,26,4557,16,142,142,0,1,5,1,0
2923,7,0,0,60,60,0,1,0,1,0
7744,676,19877,475,130,70,60,2,5,1,1
15060,28,0,0,70,70,0,1,0,1,0
1164,3216,0,0,145,145,0,1,0,1,0
18450,28,0,0,70,70,0,1,0,1,0
12460,2223,25529,1722,70,70,0,1,5,1,0
22198,28,0,0,70,70,0,1,0,1,0
409,1827,0,0,62,62,0,1,0,1,0
11140,28,0,0,70,70,0,1,0,1,0
22007,10,19317,9,281,94,187,2,29,1,1
5172,2011,22340,1541,243,180,63,2,31,1,1
22321,28,0,0,66,66,0,1,0,1,0
11982,3027,0,0,66,66,0,1,0,1,0
16021,1532,11071,1166,1386,1386,0,22,1798,22,0
11061,944,4438,696,70,70,0,2,8,2,0
10793,28,0,0,66,66,0,1,0,1,0
19681,28,0,0,70,70,0,1,0,1,0
15104,15,25240,11,1056,682,374,10,15,6,4
13346,1880,0,0,66,66,0,1,0,1,0
21306,28,0,0,70,70,0,1,0,1,0
22032,10,13080,9,257,126,131,2,30,1,1
14332,10,10182,9,170,87,83,2,30,1,1
22648,28,0,0,70,70,0,1,0,1,0
21891,15,28747,11,1921,1472,449,10,20,6,4
17719,28,0,0,70,70,0,1,0,1,0
14161,28,0,0,70,70,0,1,0,1,0
14112,10,26090,9,232,110,122,2,30,1,1
441,1590,0,0,66,66,0,1,0,1,0
1272,1147,0,0,62,62,0,1,0,1,0
13238,15,11996,11,14035,1381,12654,26,255,14,12
18119,28,0,0,66,66,0,1,0,1,0
20382,28,0,0,70,70,0,1,0,1,0
11124,26,21591,16,3296065,47110,3248955,2746,51,533,2213
3271,305,15109,199,130,70,60,2,15,1,1
10951,1877,14953,1433,70,70,0,1,5,1,0
9993,28,0,0,66,66,0,1,0,1,0
9580,10,21972,9,248,106,142,2,30,1,1
11765,10,22085,9,86,86,0,1,30,1,0
3337,26,4779,16,9695,5259,4436,24,35,12,12
10995,2480,16935,1929,70,70,0,2,8,2,0
4244,26,8106,16,6295,1324,4971,22,983,10,12
2744,1238,3266,918,882,126,756,2,30,1,1
4897,26,26262,16,8598,3880,4718,23,200,13,10
14136,10,24121,9,200,102,98,2,30,1,1
1251,1771,0,0,146,146,0,1,0,1,0
1455,1880,0,0,146,146,0,1,0,1,0
1493,1888,0,0,66,66,0,1,0,1,0
8702,28,0,0,70,70,0,1,0,1,0
11400,26,13085,16,323437,18923,304514,544,252,276,268
8515,26,20629,16,2879984,113967,2766017,3396,129,1423,1973
20604,2631,2662,2041,70,70,0,1,5,1,0
4545,26,12891,16,8877,1380,7497,30,18,15,15
12358,28,0,0,70,70,0,1,0,1,0
709,1017,0,0,62,62,0,1,0,1,0
20056,28,0,0,66,66,0,1,0,1,0
12948,28,0,0,66,66,0,1,0,1,0
14764,1880,0,0,66,66,0,1,0,1,0
13866,10,5521,9,193,102,91,2,30,1,1
14812,10,10898,9,768,99,669,2,30,1,1
14707,10,24907,9,152,78,74,2,30,1,1
9657,15,14448,11,318,192,126,6,25,4,2
7335,1070,0,0,60,60,0,1,0,1,0
15523,10,28209,9,211,102,109,2,30,1,1
10823,15,25672,11,3960,2330,1630,18,47,11,7
18271,1771,0,0,62,62,0,1,0,1,0
12686,28,0,0,70,70,0,1,0,1,0
21282,1931,14110,1475,66,66,0,2,8,2,0
11577,15,23054,11,3366,2547,819,15,49,8,7
16287,28,0,0,70,70,0,1,0,1,0
882,15,22974,11,318,192,126,6,30,4,2
8809,15,25362,11,312,192,120,6,41,4,2
19361,28,0,0,66,66,0,1,0,1,0
2744,1238,22029,918,878,126,752,2,30,1,1
8391,10,14475,9,198,101,97,2,30,1,1
9884,28,0,0,70,70,0,1,0,1,0
8943,10,26348,9,164,84,80,2,31,1,1
13187,28,0,0,66,66,0,1,0,1,0
17822,2938,0,0,62,62,0,1,0,1,0
15306,10,19024,9,173,94,79,2,31,1,1
14302,28,0,0,70,70,0,1,0,1,0
12746,536,14678,356,258,70,188,4,9,2,2
6684,26,25759,16,7235,1097,6138,21,27,10,11
1187,232,19313,147,6103,3081,3022,63,616,34,29
21362,15,20285,11,314,192,122,6,15,4,2
7273,1167,0,0,62,62,0,1,0,1,0
18085,28,0,0,66,66,0,1,0,1,0
1753,509,0,0,66,66,0,1,0,1,0
22652,10,22276,9,177,94,83,2,30,1,1
16203,28,0,0,70,70,0,1,0,1,0
12143,26,2339,16,310549,9420,301129,339,65,122,217
19538,2256,0,0,66,66,0,1,0,1,0
13681,10,5656,9,168,86,82,2,30,1,1
20137,1880,0,0,66,66,0,1,0,1,0
20888,183,28250,121,3504,1790,1714,17,32,9,8
19,2611,0,0,62,62,0,1,0,1,0
14120,26,7570,16,782,428,354,12,25,7,5
19966,28,0,0,70,70,0,1,0,1,0
15366,10,24381,9,250,87,163,4,58,2,2
22313,10,8978,9,186,95,91,2,31,1,1
13981,28,0,0,66,66,0,1,0,1,0
119,10,0,0,254,86,168,2,30,1,1
12052,1605,21613,1229,70,70,0,1,5,1,0
7587,26,11980,16,7648,1671,5977,25,31,13,12
251,155,0,0,66,66,0,1,0,1,0
8479,10,545,9,184,86,98,2,30,1,1
17757,10,23844,9,191,78,113,2,30,1,1
22572,28,0,0,70,70,0,1,0,1,0
0,0,0,0,98,98,0,1,0,1,0
243,3142,0,0,62,62,0,1,0,1,0
15853,10,21074,9,200,102,98,2,30,1,1
8114,2550,0,0,62,62,0,1,0,1,0
8584,1238,26227,918,78,78,0,1,30,1,0
18215,26,4084,16,16291,9102,7189,94,508,42,52
12662,15,25699,11,1655,1341,314,10,15,5,5
20387,28,0,0,70,70,0,1,0,1,0
16002,26,21417,16,9642,3343,6299,37,16,17,20
12,972,0,0,83,83,0,1,0,1,0
17373,28,0,0,70,70,0,1,0,1,0
15578,15,12771,11,214,140,74,4,30,3,1
12489,754,23269,542,422,140,282,6,15,3,3
3619,1888,0,0,62,62,0,1,0,1,0
20294,28,0,0,70,70,0,1,0,1,0
3403,10,11387,9,86,86,0,1,30,1,0
7090,676,28359,475,130,70,60,2,6,1,1
22707,10,26465,9,211,102,109,2,30,1,1
11306,26,5093,16,13832,4868,8964,91,364,37,54
21609,10,20351,9,182,93,89,2,30,1,1
16257,28,0,0,66,66,0,1,0,1,0
4788,26,24702,16,63724,45783,17941,171,123,85,86
5857,26,17754,16,4596,1689,2907,19,27,11,8
10813,2587,0,0,66,66,0,1,0,1,0
15117,26,19681,16,103117,6206,96911,127,106,54,73
10378,28,0,0,70,70,0,1,0,1,0
15348,28,0,0,66,66,0,1,0,1,0
6250,1984,7393,1514,263,182,81,2,30,1,1
16078,28,0,0,70,70,0,1,0,1,0
19935,28,0,0,70,70,0,1,0,1,0
19864,28,0,0,70,70,0,1,0,1,0
17022,2636,0,0,66,66,0,1,0,1,0
9728,2810,25679,2180,652,300,352,4,1200,3,1
7166,26,2729,16,410,210,200,7,92,4,3
15654,28,0,0,70,70,0,1,0,1,0
12198,15,28757,11,1536,982,554,10,76,6,4
19538,2256,0,0,66,66,0,1,0,1,0
14616,10,2856,9,172,88,84,2,31,1,1
244,1054,0,0,62,62,0,1,0,1,0
11324,28,0,0,70,70,0,1,0,1,0
9273,6,21822,6,60,60,0,1,5,1,0
12312,26,27281,16,52988,3128,49860,67,48,26,41
10517,28,0,0,70,70,0,1,0,1,0
12385,1700,18767,1299,70,70,0,2,7,2,0
18008,183,26559,121,4286,2261,2025,20,18,11,9
8150,3167,0,0,74,74,0,1,0,1,0
14292,28,0,0,70,70,0,1,0,1,0
5821,3125,0,0,145,145,0,1,0,1,0
1322,280,0,0,146,146,0,1,0,1,0
3939,10,8386,9,271,102,169,2,30,1,1
9857,2938,0,0,62,62,0,1,0,1,0
7431,983,0,0,62,62,0,1,0,1,0
7729,104,0,0,60,60,0,1,0,1,0
9750,26,26478,16,1511,849,662,16,94,9,7
16951,255,0,0,62,62,0,1,0,1,0
10327,2317,17622,1801,481,150,331,2,1200,1,1
22540,28,0,0,70,70,0,1,0,1,0
12725,26,16724,16,499,425,74,4,0,3,1
1492,2587,0,0,66,66,0,1,0,1,0
15642,10,7926,9,195,102,93,2,30,1,1
8817,1888,0,0,74,74,0,1,0,1,0
14773,10,9769,9,179,94,85,2,30,1,1
17190,28,0,0,70,70,0,1,0,1,0
9728,2533,18306,1969,523,161,362,2,1200,1,1
9015,10,809,9,306,88,218,4,32,2,2
15029,10,7269,9,177,94,83,2,29,1,1
9755,28,0,0,70,70,0,1,0,1,0
21557,28,0,0,70,70,0,1,0,1,0
597,1017,0,0,66,66,0,1,0,1,0
18246,15,19644,11,1982,692,1290,8,15,5,3
2903,1694,0,0,66,66,0,1,90,1,0
17252,28,0,0,70,70,0,1,0,1,0
7957,2587,0,0,146,146,0,1,0,1,0
9154,10,18819,9,198,102,96,2,30,1,1
22383,10,11043,9,165,86,79,2,30,1,1
18660,26,23355,16,187258,9720,177538,225,211,86,139
14604,28,0,0,66,66,0,1,0,1,0
15515,10,24534,9,177,94,83,2,30,1,1
11876,26,20413,16,19221,5366,13855,88,113,36,52
9525,28,0,0,70,70,0,1,0,1,0
15853,26,26212,16,5613,733,4880,16,15,9,7
9800,28,0,0,70,70,0,1,0,1,0
22179,10,21454,9,184,94,90,2,31,1,1
780,800,7402,582,73,73,0,1,30,1,0
8303,26,1521,16,43476,3775,39701,67,397,28,39
13672,28,0,0,66,66,0,1,0,1,0
8752,28,0,0,66,66,0,1,0,1,0
703,2883,0,0,66,66,0,1,0,1,0
15911,26,3754,16,28807,2716,26091,54,466,21,33
18884,26,24315,16,25751,2629,23122,49,49,23,26
9807,15,24899,11,1366,865,501,8,15,5,3
8688,10,6251,9,753,96,657,2,31,1,1
11196,1215,0,0,66,66,0,1,0,1,0
7945,26,20293,16,2420,1462,958,18,170,10,8
8928,10,12787,9,819,102,717,2,29,1,1
17039,28,0,0,66,66,0,1,0,1,0
9844,15,11726,11,142,142,0,1,5,1,0
2773,1149,0,0,145,145,0,1,0,1,0
12441,2152,1276,1661,678,492,186,10,18,7,3
1656,1147,0,0,62,62,0,1,0,1,0
3943,1215,0,0,62,62,0,1,0,1,0
15136,10,4618,9,198,102,96,2,31,1,1
15184,10,28997,9,199,102,97,2,30,1,1
15225,15,13686,11,234,234,0,4,12,4,0
22653,26,15484,16,395647,11870,383777,409,16,144,265
2976,1888,0,0,62,62,0,1,0,1,0
8725,26,305,16,3641,1047,2594,14,120,7,7
16951,255,0,0,62,62,0,1,0,1,0
12708,2696,23452,2094,70,70,0,1,4,1,0
22455,28,0,0,70,70,0,1,0,1,0
17119,28,0,0,66,66,0,1,0,1,0
15162,10,28235,9,177,94,83,2,31,1,1
6035,18,13468,13,184,94,90,2,30,1,1
17122,26,16154,16,5166,700,4466,16,15,7,9
13024,28,0,0,66,66,0,1,0,1,0
3596,26,10800,16,1409634,52704,1356930,1536,173,533,1003
8479,10,14388,9,306,94,212,2,29,1,1
22684,26,18733,16,418463,12360,406103,430,16,151,279
3755,15,12511,11,2913,633,2280,15,16,8,7
16919,1771,0,0,66,66,0,1,0,1,0
10686,15,26447,11,454,262,192,8,37,5,3
12304,155,0,0,66,66,0,1,0,1,0
15636,28,0,0,70,70,0,1,0,1,0
11782,26,27839,16,120290,2988,117302,123,132,32,91
11753,183,23151,121,4145,1976,2169,22,18,13,9
18649,28,0,0,70,70,0,1,0,1,0
22025,10,10004,9,303,303,0,4,47,4,0
15991,26,14723,16,13536,5529,8007,55,18,24,31
389,26,1215,16,12079,1344,10735,24,17,10,14
17875,10,20636,9,260,86,174,2,30,1,1
16951,255,0,0,62,62,0,1,0,1,0
9301,28,0,0,66,66,0,1,0,1,0
14939,10,18584,9,210,110,100,2,33,1,1
11411,26,16402,16,128802,48896,79906,237,24,121,116
12380,99,609,76,70,70,0,2,8,2,0
2422,26,10022,16,3611,2177,1434,24,17,13,11
13721,10,3205,9,172,88,84,2,30,1,1
22315,10,18550,9,229,102,127,2,30,1,1
2580,2853,0,0,66,66,0,1,0,1,0
17852,10,25477,9,384,166,218,2,30,1,1
21455,155,0,0,62,62,0,1,0,1,0
8435,28,0,0,70,70,0,1,0,1,0
21957,10,21216,9,779,86,693,2,30,1,1
10264,3216,0,0,62,62,0,1,0,1,0
14245,10,4663,9,214,110,104,2,30,1,1
21255,1136,11206,837,66,66,0,2,7,2,0
18447,15,21906,11,1420,715,705,12,16,7,5
19821,26,24730,16,3044,1694,1350,23,45,13,10
13930,28,0,0,70,70,0,1,0,1,0
60,1888,0,0,62,62,0,1,0,1,0
19615,7,0,0,60,60,0,1,0,1,0
22536,10,4995,9,194,99,95,2,30,1,1
7785,146,0,0,60,60,0,1,0,1,0
15991,10,17127,9,184,102,82,2,30,1,1
428,2852,0,0,66,66,0,1,0,1,0
17740,1888,0,0,62,62,0,1,0,1,0
3057,146,0,0,60,60,0,1,0,1,0
21182,2140,7752,1653,504,382,122,8,16,6,2
9836,26,13973,16,180,60,120,4,15,2,2
12859,1888,0,0,66,66,0,1,0,1,0
13107,28,0,0,70,70,0,1,0,1,0
22333,10,19880,9,194,102,92,2,30,1,1
7806,15,8798,11,3158,1159,1999,14,16,8,6
10158,15,542,11,1514,480,1034,11,16,6,5
18121,26,26613,16,18674,1910,16764,32,18,17,15
17864,1147,0,0,146,146,0,1,0,1,0
8646,10,5210,9,184,94,90,2,30,1,1
18527,10,0,0,180,82,98,2,30,1,1
21711,28,0,0,70,70,0,1,0,1,0
20299,28,0,0,70,70,0,1,0,1,0
19966,28,0,0,70,70,0,1,0,1,0
946,26,2262,16,6676,1097,5579,21,26,11,10
9293,28,0,0,70,70,0,1,0,1,0
22650,10,26802,9,226,94,132,2,30,1,1
12877,1397,0,0,66,66,0,1,0,1,0
8652,295,21514,190,3370,1595,1775,16,15,9,7
15591,10,4079,9,177,94,83,2,30,1,1
4639,26,5236,16,13220,4632,8588,32,37,19,13
21564,28,0,0,70,70,0,1,0,1,0
8544,28,0,0,70,70,0,1,0,1,0
10193,15,22312,11,168467,7348,161119,184,8,67,117
15965,10,13651,9,168,86,82,2,31,1,1
8456,10,6667,9,177,94,83,2,30,1,1
8439,10,12845,9,168,86,82,2,31,1,1
15812,28,0,0,70,70,0,1,0,1,0
12062,28,0,0,66,66,0,1,0,1,0
20470,10,26404,9,101,101,0,2,31,2,0
14884,28,0,0,70,70,0,1,0,1,0
18023,28,0,0,70,70,0,1,0,1,0
15380,1,7061,1,70,70,0,1,5,1,0
9263,28,0,0,70,70,0,1,0,1,0
6166,1367,0,0,62,62,0,1,0,1,0
15862,10,23171,9,168,86,82,2,29,1,1
8171,1073,0,0,60,60,0,1,0,1,0
21546,10,23915,9,398,103,295,4,41,2,2
22108,10,9957,9,199,102,97,2,29,1,1
13833,28,0,0,70,70,0,1,0,1,0
8394,153,10460,108,70,70,0,1,5,1,0
2783,280,0,0,146,146,0,1,0,1,0
12634,10,3433,9,260,86,174,2,30,1,1
12110,10,983,9,165,78,87,2,30,1,1
5960,26,25136,16,168930,11361,157569,252,31,101,151
9478,15,23691,11,442,250,192,8,47,5,3
10864,1481,4326,1127,70,70,0,1,5,1,0
19303,1472,0,0,66,66,0,1,0,1,0
10597,28,0,0,66,66,0,1,0,1,0
2608,2883,0,0,62,62,0,1,0,1,0
7078,1147,0,0,62,62,0,1,0,1,0
1332,7,0,0,60,60,0,1,0,1,0
12221,28,0,0,70,70,0,1,0,1,0
9291,28,0,0,66,66,0,1,0,1,0
12,2346,0,0,332,332,0,1,0,1,0
21425,10,607,9,183,94,89,2,30,1,1
22049,10,9920,9,372,94,278,2,30,1,1
14619,26,24707,16,4599,1692,2907,19,26,11,8
21139,2472,21167,1922,66,66,0,2,7,2,0
2450,2938,0,0,62,62,0,1,0,1,0
17992,26,14662,16,1401,864,537,12,28,6,6
14962,2636,0,0,146,146,0,1,0,1,0
781,2685,10430,2085,70,70,0,1,30,1,0
42,2938,0,0,62,62,0,1,0,1,0
6035,26,16530,16,20180,2917,17263,35,124,14,21
15118,26,458,16,1560,988,572,13,25,7,6
9458,15,8219,11,3450,1386,2064,15,83,8,7
17909,28,0,0,66,66,0,1,0,1,0
12638,3135,4571,2433,258,70,188,4,7,2,2
8278,26,16151,16,119425284,929428,118495856,93687,498,9675,84012
12194,26,1631,16,2253,1403,850,15,121,9,6
21307,10,28861,9,222,78,144,2,30,1,1
8537,509,0,0,62,62,0,1,0,1,0
2744,1240,3977,920,891,126,765,2,30,1,1
13940,1086,0,0,66,66,0,1,0,1,0
3066,3200,12139,2481,502,150,352,2,1200,1,1
14070,26,6847,16,72759,18547,54212,120,137,49,71
9502,15,2202,11,306,180,126,6,25,4,2
8987,28,0,0,70,70,0,1,0,1,0
15802,26,17102,16,170452,9659,160793,224,68,97,127
19021,28,0,0,70,70,0,1,0,1,0
15177,26,10303,16,27035,4207,22828,43,31,21,22
15758,15,25267,11,6738,909,5829,14,20,7,7
12936,1147,0,0,66,66,0,1,0,1,0
2205,2117,0,0,66,66,0,1,0,1,0
21635,28,0,0,70,70,0,1,0,1,0
18080,28,0,0,66,66,0,1,0,1,0
636,116,0,0,146,146,0,1,0,1,0
9411,2847,13334,2210,528,528,0,9,1200,9,0
2175,1888,0,0,62,62,0,1,0,1,0
10766,1713,2102,1308,70,70,0,2,8,2,0
1731,3107,7273,2414,490,149,341,2,1200,1,1
2172,2627,18731,2037,460,150,310,2,1200,1,1
8736,28,0,0,66,66,0,1,0,1,0
16354,15,13385,11,13028,3246,9782,29,30,16,13
15541,26,27471,16,5649,2005,3644,21,186,11,10
8935,10,16237,9,780,93,687,2,31,1,1
7261,15,9750,11,1573,702,871,12,45,7,5
22283,28,0,0,70,70,0,1,0,1,0
18017,28,0,0,70,70,0,1,0,1,0
22708,28,0,0,66,66,0,1,0,1,0
14174,28,0,0,70,70,0,1,0,1,0
6999,1211,1200,896,501,150,351,2,1200,1,1
7474,15,18014,11,1213,755,458,10,15,6,4
16422,28,0,0,70,70,0,1,0,1,0
12473,26,23544,16,4620,1713,2907,19,30,11,8
21834,1147,0,0,66,66,0,1,0,1,0
22666,26,14776,16,409770,12150,397620,421,16,148,273
9869,26,11626,16,12350,2504,9846,41,137,21,20
8042,26,24623,16,60300,47341,12959,192,39,108,84
21363,10,3526,9,434,108,326,4,51,2,2
20978,28,0,0,70,70,0,1,0,1,0
3882,10,29036,9,177,94,83,2,30,1,1
7039,26,20469,16,416,210,206,7,24,4,3
14615,10,9209,9,230,86,144,2,30,1,1
11459,631,0,0,66,66,0,1,0,1,0
2342,10,9646,9,365,233,132,3,32,2,1
1125,1215,0,0,62,62,0,1,0,1,0
4802,878,20593,647,602,174,428,2,31,1,1
18422,26,9058,16,9607,3847,5760,51,134,26,25
15659,10,1210,9,228,102,126,2,30,1,1
16951,255,0,0,62,62,0,1,0,1,0
18453,2900,28530,2252,70,70,0,2,8,2,0
11657,28,0,0,70,70,0,1,0,1,0
7683,10,20391,9,262,106,156,2,31,1,1
11389,10,0,0,138,69,69,2,30,1,1
22542,10,1925,9,284,94,190,2,29,1,1
12,1932,0,0,82,82,0,1,0,1,0
2744,102,7716,79,857,126,731,2,30,1,1
15187,10,15588,9,184,94,90,2,31,1,1
16349,28,0,0,70,70,0,1,0,1,0
8829,10,11781,9,168,86,82,2,31,1,1
22302,10,22491,9,216,94,122,2,30,1,1
16225,28,0,0,66,66,0,1,0,1,0
15482,2587,0,0,66,66,0,1,0,1,0
12408,28,0,0,70,70,0,1,0,1,0
18437,26,3785,16,130,70,60,2,15,1,1
11917,26,19754,16,50403,2032,48371,66,108,21,45
9425,26,9175,16,21204,10998,10206,51,392,27,24
15989,983,0,0,66,66,0,1,0,1,0
14062,1888,0,0,66,66,0,1,0,1,0
17798,28,0,0,70,70,0,1,0,1,0
8116,26,8665,16,60944,9555,51389,71,362,25,46
18793,206,12556,135,66,66,0,1,5,1,0
22336,10,15478,9,266,110,156,2,30,1,1
21246,28,0,0,70,70,0,1,0,1,0
13679,26,4658,16,7599,3113,4486,30,20,17,13
14690,28,0,0,66,66,0,1,0,1,0
10993,28,0,0,70,70,0,1,0,1,0
3358,26,1643,16,3820081,140348,3679733,4457,136,1736,2721
22645,3113,0,0,66,66,0,1,0,1,0
10784,78,10019,60,70,70,0,1,5,1,0
18965,26,818,16,2732,1359,1373,29,193,16,13
2744,1239,22394,919,888,126,762,2,30,1,1
9728,2627,13300,2037,498,150,348,4,2396,2,2
20645,28,0,0,66,66,0,1,0,1,0
0,0,0,0,2000,1020,980,20,0,10,10
8912,10,9956,9,177,94,83,2,30,1,1
11906,509,0,0,66,66,0,1,0,1,0
16329,2587,0,0,66,66,0,1,0,1,0
8722,10,27839,9,300,100,200,4,44,2,2
9179,26,11140,16,59858,24345,35513,148,612,78,70
17695,28,0,0,66,66,0,1,0,1,0
5,3216,0,0,62,62,0,1,0,1,0
15591,10,415,9,170,87,83,2,30,1,1
22249,10,20223,9,180,94,86,2,29,1,1
9072,2883,0,0,62,62,0,1,0,1,0
21246,10,2562,9,214,102,112,2,30,1,1
10739,2047,18711,1574,70,70,0,2,8,2,0
10814,1722,12668,1314,70,70,0,2,8,2,0
21922,10,3767,9,186,95,91,2,31,1,1
17364,28,0,0,70,70,0,1,0,1,0
2068,31,0,0,60,60,0,1,0,1,0
15279,10,524,9,177,94,83,2,30,1,1
21927,28,0,0,70,70,0,1,0,1,0
13909,10,10527,9,177,94,83,2,30,1,1
8745,15,4250,11,277736,7810,269926,277,65,91,186
9614,3105,0,0,86,86,0,1,0,1,0
16357,26,16585,16,5932,1264,4668,21,155,11,10
17197,7,0,0,60,60,0,1,0,1,0
16957,2256,0,0,66,66,0,1,0,1,0
15196,10,8167,9,177,94,83,2,30,1,1
18134,26,14978,16,376301,13445,362856,452,102,198,254
10488,28,0,0,70,70,0,1,0,1,0
16125,10,5670,9,165,78,87,2,31,1,1
14585,10,16149,9,758,96,662,2,31,1,1
6634,26,3878,16,13710,4975,8735,22,121,9,13
16504,15,27147,11,378,192,186,7,19,4,3
12543,743,6307,534,70,70,0,2,7,2,0
14138,10,22636,9,199,102,97,2,31,1,1
18630,15,7770,11,9034,1860,7174,17,16,8,9
22349,10,4199,9,210,110,100,2,30,1,1
2256,2636,0,0,62,62,0,1,0,1,0
9244,15,17800,11,5514,2362,3152,37,469,19,18
3018,2938,0,0,145,145,0,1,0,1,0
20377,28,0,0,66,66,0,1,0,1,0
20003,2558,0,0,66,66,0,1,0,1,0
8420,10,25821,9,199,102,97,2,30,1,1
16697,28,0,0,70,70,0,1,0,1,0
8525,26,600,16,9482,4710,4772,19,16,11,8
15462,10,11442,9,211,110,101,2,30,1,1
6768,10,19015,9,310,94,216,2,30,1,1
13790,28,0,0,70,70,0,1,0,1,0
2321,7,0,0,60,60,0,1,0,1,0
5507,15,17172,11,576,272,304,9,142,5,4
18225,1472,0,0,66,66,0,1,0,1,0
18357,300,0,0,62,62,0,1,0,1,0
12681,405,24319,263,70,70,0,2,8,2,0
21776,28,0,0,70,70,0,1,0,1,0
6091,2101,0,0,308,308,0,1,0,1,0
2679,1147,0,0,146,146,0,1,0,1,0
16021,2971,20333,2306,2118,858,1260,28,1261,14,14
20913,26,25874,16,125798,40014,85784,276,171,125,151
19352,28,0,0,70,70,0,1,0,1,0
11943,28,0,0,66,66,0,1,0,1,0
18199,1017,0,0,66,66,0,1,0,1,0
6149,7,0,0,60,60,0,1,0,1,0
21745,10,777,9,305,102,203,2,30,1,1
14522,10,9002,9,184,94,90,2,31,1,1
17927,28,0,0,70,70,0,1,0,1,0
10277,28,0,0,70,70,0,1,0,1,0
16889,26,2536,16,15546,2361,13185,39,123,18,21
17699,28,0,0,66,66,0,1,0,1,0
13413,28,0,0,70,70,0,1,0,1,0
16141,983,0,0,66,66,0,1,0,1,0
20170,28,0,0,66,66,0,1,0,1,0
13510,26,27728,16,11291,2426,8865,21,121,10,11
7326,1649,0,0,60,60,0,1,0,1,0
10870,1735,725,1324,70,70,0,2,8,2,0
17149,3216,0,0,62,62,0,1,0,1,0
16021,280,26577,177,132,132,0,3,1199,3,0
2706,2440,0,0,62,62,0,1,0,1,0
9454,26,20139,16,5955,1619,4336,23,15,13,10
14343,26,1361,16,1648,114,1534,5,120,2,3
1104,7,0,0,60,60,0,1,0,1,0
15308,10,29010,9,177,94,83,2,30,1,1
9671,28,0,0,70,70,0,1,0,1,0
18042,1888,0,0,66,66,0,1,0,1,0
8732,10,26435,9,200,94,106,2,30,1,1
17337,10,26168,9,235,90,145,2,32,1,1
14958,28,0,0,70,70,0,1,0,1,0
21750,10,8954,9,215,94,121,2,30,1,1
6145,26,1201,16,4129,2865,1264,17,361,9,8
12653,509,0,0,62,62,0,1,0,1,0
10965,1924,1431,1468,70,70,0,2,8,2,0
15684,10,6828,9,761,100,661,2,30,1,1
12771,28,0,0,70,70,0,1,0,1,0
15374,26,16005,16,7511,2237,5274,17,16,9,8
21756,10,18517,9,184,94,90,2,31,1,1
21621,28,0,0,70,70,0,1,0,1,0
16951,255,0,0,62,62,0,1,0,1,0
15184,10,18556,9,199,102,97,2,31,1,1
13723,10,21855,9,195,102,93,2,30,1,1
3013,1771,0,0,62,62,0,1,0,1,0
13526,28,0,0,70,70,0,1,0,1,0
5448,26,6313,16,18514,4506,14008,72,105,41,31
18341,28,0,0,70,70,0,1,0,1,0
9145,2256,0,0,62,62,0,1,0,1,0
22169,10,17101,9,196,102,94,2,30,1,1
20779,28,0,0,66,66,0,1,0,1,0
21261,10,5366,9,199,102,97,2,29,1,1
12533,28,0,0,70,70,0,1,0,1,0
21258,3194,25764,2476,70,70,0,1,4,1,0
1161,3216,0,0,62,62,0,1,0,1,0
1941,10,26196,9,223,86,137,2,30,1,1
8680,3270,0,0,162,162,0,1,0,1,0
16951,255,0,0,62,62,0,1,0,1,0
6621,26,24233,16,130,70,60,2,15,1,1
15634,26,25210,16,4378,1471,2907,19,29,11,8
15178,10,20658,9,168,86,82,2,29,1,1
3109,2611,0,0,72,72,0,1,0,1,0
17823,28,0,0,70,70,0,1,0,1,0
15958,444,18425,284,47040,13931,33109,428,129,207,221
12371,2262,10329,1751,552,306,246,9,15,5,4
13734,15,5549,11,1680,697,983,10,52,6,4
12715,28,0,0,70,70,0,1,0,1,0
1995,1472,0,0,66,66,0,1,0,1,0
947,26,14406,16,4081,443,3638,12,15,6,6
433,1224,0,0,60,60,0,1,0,1,0
16382,26,3039,16,1648,1017,631,18,124,10,8
13901,10,1496,9,282,94,188,2,29,1,1
8415,1797,0,0,66,66,0,1,0,1,0
12,455,5,293,64,64,0,1,5,1,0
9426,10,18430,9,794,102,692,2,30,1,1
7713,1017,0,0,146,146,0,1,0,1,0
5076,26,21790,16,6171,1091,5080,22,82,12,10
17409,2636,0,0,62,62,0,1,0,1,0
13370,26,18794,16,4679,3387,1292,18,304,10,8
12103,15,25766,11,19877,856,19021,22,16,6,16
1559,1147,0,0,62,62,0,1,0,1,0
19283,26,903,16,12231,6846,5385,38,160,19,19
7106,631,0,0,74,74,0,1,0,1,0
11127,1064,1137,783,70,70,0,2,7,2,0
11049,15,23863,11,426,240,186,8,24,5,3
21634,10,537,9,333,94,239,2,30,1,1
17699,28,0,0,70,70,0,1,0,1,0
21009,28,0,0,66,66,0,1,0,1,0
22178,10,10968,9,376,126,250,2,29,1,1
21546,10,28181,9,229,110,119,2,29,1,1
9396,10,7912,9,172,88,84,2,30,1,1
4637,26,2273,16,9381,2351,7030,26,37,15,11
12864,26,5223,16,5260,2704,2556,13,121,7,6
9236,26,12632,16,8172,1833,6339,25,93,14,11
8324,10,1393,9,184,94,90,2,30,1,1
22615,10,10533,9,204,104,100,2,31,1,1
9506,28,0,0,70,70,0,1,0,1,0
14220,28,0,0,70,70,0,1,0,1,0
8330,28,0,0,70,70,0,1,0,1,0
9422,10,8550,9,94,94,0,1,30,1,0
3209,2611,0,0,66,66,0,1,0,1,0
7339,140,0,0,60,60,0,1,0,1,0
22059,10,10290,9,165,86,79,2,30,1,1
21331,2264,13212,1753,70,70,0,1,4,1,0
22715,1397,0,0,66,66,0,1,0,1,0
14547,10,12442,9,174,89,85,2,0,1,1
20013,1483,0,0,148,148,0,1,0,1,0
12735,26,6694,16,375374,160846,214528,633,1412,294,339
9496,28,0,0,70,70,0,1,0,1,0
19301,1,0,0,78,78,0,1,0,1,0
5194,26,23872,16,16577,10269,6308,33,17,20,13
11355,28,0,0,70,70,0,1,0,1,0
10686,15,25385,11,141220,4280,136940,159,17,59,100
18564,28,0,0,70,70,0,1,0,1,0
14360,10,18184,9,177,94,83,2,29,1,1
11198,3132,822,2431,70,70,0,2,8,2,0
14286,2271,17332,1758,70,70,0,2,8,2,0
10695,28,0,0,66,66,0,1,0,1,0
18545,2946,23642,2285,320,140,180,6,6,3,3
3108,10,9529,9,86,86,0,1,30,1,0
19809,26,4906,16,4833,2196,2637,13,120,7,6
9046,26,22355,16,79524,18512,61012,205,50,101,104
21662,28,0,0,66,66,0,1,0,1,0
18163,2256,0,0,66,66,0,1,0,1,0
8663,26,14639,16,185560,47806,137754,421,295,217,204
2724,1240,26891,920,422,164,258,6,31,3,3
14771,10,711,9,784,94,690,2,29,1,1
4962,26,12865,16,1864,250,1614,8,121,4,4
9411,2742,4396,2126,528,528,0,9,1200,9,0
15314,2128,21490,1641,2810,1382,1428,12,31,6,6
12367,392,11658,254,199,75,124,4,59,2,2
17707,28,0,0,70,70,0,1,0,1,0
3978,389,15099,252,138,78,60,2,5,1,1
22611,10,12107,9,166,86,80,2,31,1,1
14400,10,22689,9,102,102,0,1,60,1,0
20471,28,0,0,70,70,0,1,0,1,0
15495,10,17242,9,168,86,82,2,30,1,1
14670,10,10991,9,193,102,91,2,30,1,1
15615,10,5557,9,177,94,83,2,29,1,1
14413,10,2824,9,170,87,83,2,31,1,1
11593,280,14186,177,719,413,306,10,14,5,5
1094,26,15758,16,4063,969,3094,16,26,9,7
21307,10,10283,9,338,110,228,2,30,1,1
18523,2769,5672,2148,70,70,0,1,5,1,0
16951,255,25970,160,130,66,64,2,5,1,1
18722,28,0,0,66,66,0,1,0,1,0
7621,15,2575,11,1764,751,1013,10,16,6,4
2709,26,13119,16,10585,3919,6666,33,80,16,17
12381,28,0,0,70,70,0,1,0,1,0
13261,28,0,0,66,66,0,1,0,1,0
11820,26,1356,16,179433,12614,166819,217,116,78,139
14916,10,88,9,177,94,83,2,29,1,1
16796,2695,0,0,66,66,0,1,0,1,0
22389,28,0,0,70,70,0,1,0,1,0
2831,10,20187,9,225,78,147,2,30,1,1
18214,2836,0,0,66,66,0,1,0,1,0
18032,28,0,0,70,70,0,1,0,1,0
8158,10,0,0,82,82,0,2,40,2,0
2429,7,0,0,60,60,0,1,0,1,0
8584,1238,5966,918,71,71,0,1,30,1,0
22692,28,0,0,66,66,0,1,0,1,0
16793,26,9679,16,17161,1619,15542,18,149,4,14
7861,26,3995,16,1058,571,487,10,38,6,4
15907,10,16299,9,177,94,83,2,30,1,1
18979,26,7952,16,20423,4091,16332,33,122,15,18
22503,10,13169,9,764,102,662,2,30,1,1
8635,10,613,9,185,102,83,2,30,1,1
15870,10,30,9,811,94,717,2,30,1,1
17326,1104,0,0,62,62,0,1,60,1,0
15522,26,744,16,5601,1203,4398,14,59,9,5
13652,10,12423,9,438,89,349,4,60,2,2
22357,10,4111,9,241,118,123,2,30,1,1
14696,10,24750,9,265,111,154,2,30,1,1
9811,26,16539,16,8536,2068,6468,36,18,16,20
630,2636,0,0,62,62,0,1,0,1,0
5676,107,17451,83,156,156,0,3,8,3,0
9187,26,7235,16,70,70,0,2,5,2,0
14175,10,26893,9,177,94,83,2,30,1,1
18067,1804,0,0,66,66,0,1,0,1,0
11010,2279,28670,1764,70,70,0,1,5,1,0
7839,26,21329,16,429929,11379,418550,456,21,174,282
10011,15,2189,11,15453,3281,12172,29,140,16,13
10628,28,0,0,66,66,0,1,0,1,0
3120,1147,0,0,146,146,0,1,0,1,0
20975,28,0,0,70,70,0,1,0,1,0
6067,1888,0,0,62,62,0,1,0,1,0
12507,2507,11675,1949,320,140,180,6,7,3,3
15230,10,26618,9,168,86,82,2,30,1,1
5136,26,9814,16,459089,10521,448568,449,16,141,308
13578,2636,0,0,66,66,0,1,0,1,0
9877,26,6858,16,1726,668,1058,13,2033,4,9
10009,1787,0,0,159,159,0,1,0,1,0
15318,10,27681,9,209,110,99,2,31,1,1
636,3231,12328,2505,219,111,108,2,1201,1,1
9253,28,0,0,70,70,0,1,0,1,0
8720,26,23859,16,10104,2646,7458,28,186,14,14
15275,10,18226,9,443,182,261,6,30,3,3
18537,28,0,0,70,70,0,1,0,1,0
6550,26,14284,16,56226,4852,51374,71,106,30,41
3656,2636,0,0,62,62,0,1,0,1,0
629,3225,0,0,60,60,0,1,0,1,0
8285,2256,0,0,146,146,0,1,0,1,0
22280,28,0,0,70,70,0,1,0,1,0
6311,15,15686,11,1737,796,941,12,16,7,5
3767,16,0,0,60,60,0,1,0,1,0
6256,26,9619,16,7295,1469,5826,30,360,9,21
9524,15,1721,11,3190,980,2210,13,30,7,6
15676,10,26318,9,199,94,105,2,30,1,1
2007,26,7816,16,5157,2180,2977,21,16,12,9
11158,15,13513,11,366,240,126,7,26,5,2
10561,28,0,0,70,70,0,1,0,1,0
13947,10,7660,9,177,94,83,2,29,1,1
21751,10,16828,9,194,102,92,2,31,1,1
15510,15,2806,11,2567,1586,981,13,75,8,5
5503,26,15409,16,6097,1540,4557,25,191,13,12
18069,28,0,0,70,70,0,1,0,1,0
16882,28,0,0,70,70,0,1,0,1,0
12096,2573,0,0,66,66,0,1,0,1,0
3901,10,16067,9,78,78,0,1,30,1,0
15841,1017,0,0,66,66,0,1,0,1,0
14302,2488,7880,1935,70,70,0,2,8,2,0
21430,28,0,0,66,66,0,1,0,1,0
3189,2883,0,0,146,146,0,1,0,1,0
9710,26,12051,16,7367,1149,6218,18,27,9,9
8273,15,20640,11,1114,534,580,12,16,7,5
18263,26,26685,16,4574,1667,2907,19,26,11,8
9411,1342,20634,1017,198,198,0,4,1200,4,0
19922,26,27646,16,180730,19869,160861,239,171,103,136
13709,28,0,0,70,70,0,1,0,1,0
10925,787,9384,572,70,70,0,1,5,1,0
19972,28,0,0,66,66,0,1,0,1,0
9644,26,26789,16,12556,1134,11422,28,78,13,15
8805,26,26221,16,13604,1980,11624,33,46,18,15
9146,10,8042,9,211,110,101,2,30,1,1
11501,28,0,0,66,66,0,1,0,1,0
18885,26,13285,16,31109,2922,28187,54,52,26,28
8933,28,0,0,66,66,0,1,0,1,0
20053,188,5841,123,142,142,0,1,30,1,0
21795,10,21372,9,802,104,698,2,31,1,1
22700,10,9399,9,545,136,409,4,56,2,2
1493,1888,0,0,66,66,0,1,0,1,0
15038,10,1824,9,177,94,83,2,30,1,1
16951,255,0,0,62,62,0,1,0,1,0
28,3216,0,0,62,62,0,1,0,1,0
13655,28,0,0,70,70,0,1,0,1,0
13034,15,23826,11,2334,1575,759,11,148,6,5
6903,2587,0,0,146,146,0,1,0,1,0
14384,10,21872,9,177,94,83,2,30,1,1
20410,40,28000,23,8753,4199,4554,76,54,41,35
15327,10,17173,9,701,88,613,2,30,1,1
16951,255,0,0,62,62,0,1,0,1,0
12001,28,0,0,66,66,0,1,0,1,0
10170,28,0,0,66,66,0,1,0,1,0
15662,10,9340,9,211,110,101,2,30,1,1
16090,28,0,0,66,66,0,1,0,1,0
20351,28,0,0,70,70,0,1,0,1,0
19336,26,7927,16,3403,1891,1512,24,42,13,11
15008,15,25544,11,17188,1559,15629,25,25,10,15
10021,15,4515,11,397616,15684,381932,419,141,157,262
15036,26,21334,16,3654,1144,2510,10,120,5,5
15476,28,0,0,70,70,0,1,0,1,0
20629,28,0,0,70,70,0,1,0,1,0
8677,15,13838,11,1693924,34466,1659458,1627,230,522,1105
6243,2938,0,0,62,62,0,1,0,1,0
952,183,0,0,66,66,0,1,0,1,0
17017,28,0,0,70,70,0,1,0,1,0
20618,28,0,0,70,70,0,1,0,1,0
15385,10,26529,9,751,95,656,2,30,1,1
16131,26,13860,16,12528,7238,5290,26,91,15,11
4487,1017,0,0,146,146,0,1,0,1,0
11995,2144,0,0,66,66,0,1,0,1,0
15344,28,0,0,66,66,0,1,0,1,0
225,10,7100,9,204,118,86,2,31,1,1
11221,26,20054,16,7882,810,7072,21,15,9,12
6168,26,18021,16,2351,1546,805,20,54,11,9
8928,10,6439,9,195,94,101,2,30,1,1
10996,26,28948,16,9249,4498,4751,39,15,22,17
22197,28,0,0,70,70,0,1,0,1,0
12022,28,0,0,66,66,0,1,0,1,0
14036,10,3612,9,180,94,86,2,31,1,1
12,3140,0,0,199,199,0,1,0,1,0
15293,2587,0,0,66,66,0,1,0,1,0
4584,234,5018,149,3277,1954,1323,27,3600,14,13
6252,26,3349,16,1262512,53286,1209226,1457,280,548,909
16951,255,0,0,62,62,0,1,0,1,0
10183,242,0,0,146,146,0,1,0,1,0
21557,28,0,0,70,70,0,1,0,1,0
15529,26,15400,16,4359,924,3435,15,59,9,6
225,10,15608,9,468,320,148,5,49,3,2
22322,10,28078,9,214,110,104,2,30,1,1
16951,255,0,0,62,62,0,1,0,1,0
20822,2256,0,0,66,66,0,1,0,1,0
11636,28,0,0,70,70,0,1,0,1,0
13938,183,24345,121,4470,2381,2089,23,19,13,10
10475,26,18855,16,78740,40216,38524,126,42,66,60
148,1771,0,0,62,62,0,1,0,1,0
15179,28,0,0,70,70,0,1,0,1,0
11046,15,8304,11,8551,5933,2618,18,26,12,6
22304,10,8969,9,740,93,647,2,31,1,1
1442,2953,0,0,66,66,0,1,0,1,0
16760,28,0,0,66,66,0,1,0,1,0
22271,10,9156,9,180,94,86,2,30,1,1
20270,28,0,0,70,70,0,1,0,1,0
11840,26,13844,16,23112,6278,16834,140,115,55,85
9346,10,18955,9,199,102,97,2,30,1,1
21914,10,13142,9,495,109,386,4,53,2,2
21147,280,13550,177,66,66,0,1,5,1,0
19005,28,0,0,70,70,0,1,0,1,0
15385,1690,8064,1292,70,70,0,1,5,1,0
14418,10,6482,9,196,102,94,2,31,1,1
11095,15,6950,11,81670,2359,79311,89,621,30,59
475,137,0,0,62,62,0,1,0,1,0
16992,18,25339,13,184,94,90,2,30,1,1
10509,26,25765,16,21779,7983,13796,44,97,25,19
15765,28,0,0,66,66,0,1,0,1,0
20557,3216,0,0,62,62,0,1,0,1,0
370,2938,0,0,62,62,0,1,0,1,0
16021,405,12369,263,863,363,500,4,1200,2,2
9106,10,7313,9,741,94,647,2,30,1,1
14745,2883,0,0,62,62,0,1,0,1,0
12706,405,26882,263,372,186,186,6,15,3,3
10197,26,22316,16,71902,4007,67895,98,127,40,58
19669,28,0,0,70,70,0,1,0,1,0
12052,1605,10077,1229,70,70,0,2,8,2,0
19218,26,24843,16,5399,2711,2688,13,120,7,6
11535,790,0,0,74,74,0,1,0,1,0
12654,276,8701,174,70,70,0,1,4,1,0
19623,28,0,0,70,70,0,1,0,1,0
1122,26,11704,16,7199,1410,5789,22,33,11,11
11191,916,28063,677,70,70,0,2,8,2,0
13704,26,1461,16,7372,2875,4497,23,61,13,10
13700,10,26184,9,300,102,198,4,40,2,2
14595,28,0,0,66,66,0,1,0,1,0
2445,1215,0,0,62,62,0,1,0,1,0
3175,3216,0,0,62,62,0,1,0,1,0
1167,1987,27759,1517,156,94,62,2,30,1,1
1567,146,0,0,60,60,0,1,0,1,0
16073,28,0,0,70,70,0,1,0,1,0
11968,28,0,0,70,70,0,1,0,1,0
9448,28,0,0,66,66,0,1,0,1,0
6439,2256,0,0,66,66,0,1,0,1,0
14227,10,26110,9,258,118,140,2,30,1,1
17448,10,0,0,82,82,0,1,30,1,0
21829,15,28718,11,98859,6426,92433,136,27,68,68
22617,26,11689,16,14205,1527,12678,13,145,2,11
3592,697,0,0,146,146,0,1,0,1,0
5822,104,0,0,60,60,0,1,0,1,0
5426,10,2104,9,168,78,90,2,30,1,1
22039,10,26278,9,199,94,105,2,29,1,1
21913,28,0,0,70,70,0,1,0,1,0
10826,15,5610,11,2188,1282,906,13,47,8,5
10605,2587,0,0,62,62,0,1,0,1,0
20273,2883,0,0,66,66,0,1,0,1,0
10764,28,0,0,70,70,0,1,0,1,0
22202,10,1603,9,779,86,693,2,30,1,1
14177,28,0,0,70,70,0,1,0,1,0
8009,26,1825,16,4515,2193,2322,14,135,7,7
226,1147,0,0,62,62,0,1,0,1,0
18739,26,9619,16,71105,20647,50458,107,38,53,54
14307,28,0,0,66,66,0,1,0,1,0
10708,1086,0,0,66,66,0,1,0,1,0
6702,26,14065,16,10930,1759,9171,27,28,13,14
4614,26,5355,16,70,70,0,2,5,2,0
11525,28,0,0,70,70,0,1,0,1,0
10689,28,0,0,66,66,0,1,0,1,0
21562,10,14967,9,216,110,106,2,31,1,1
18244,28,0,0,70,70,0,1,0,1,0
16487,26,5793,16,1314,653,661,13,185,7,6
14098,10,21234,9,198,110,88,2,31,1,1
18,1147,0,0,146,146,0,1,0,1,0
21874,10,26062,9,575,193,382,6,80,3,3
2134,1367,0,0,60,60,0,1,0,1,0
8673,26,5295,16,4151,1015,3136,16,27,8,8
22352,10,8413,9,194,102,92,2,29,1,1
10689,15,23819,11,318,192,126,6,37,4,2
16439,1147,0,0,62,62,0,1,0,1,0
12696,28,0,0,70,70,0,1,0,1,0
10472,26,4627,16,202,70,132,3,11,1,2
3889,15,12601,11,1658,1344,314,10,15,5,5
2217,2883,0,0,66,66,0,1,0,1,0
1950,1147,0,0,62,62,0,1,0,1,0
12974,26,14907,16,2680,1488,1192,19,41,10,9
424,26,11327,16,2227,1018,1209,17,16,8,9
8818,10,10899,9,229,110,119,2,30,1,1
8933,15,4146,11,70,70,0,1,4,1,0
22678,26,27466,16,92240,4799,87441,107,16,43,64
11468,26,3832,16,11052,4417,6635,19,137,10,9
5080,26,19257,16,8165,1664,6501,30,62,14,16
14189,26,21085,16,7047,1994,5053,20,24,12,8
18078,1472,0,0,66,66,0,1,0,1,0
18882,26,17085,16,31315,6036,25279,65,49,32,33
18760,26,26497,16,7028,2639,4389,23,16,12,11
14358,345,27614,219,70,70,0,2,7,2,0
5094,26,8275,16,8195,1780,6415,23,60,12,11
21884,10,981,9,193,102,91,2,30,1,1
17735,2883,0,0,62,62,0,1,0,1,0
20464,28,0,0,70,70,0,1,0,1,0
14598,10,12997,9,183,94,89,2,30,1,1
16409,1129,0,0,148,148,0,1,0,1,0
18809,28,0,0,66,66,0,1,0,1,0
8087,26,9809,16,8075,1766,6309,22,78,13,9
1877,1147,0,0,62,62,0,1,0,1,0
21016,1147,0,0,66,66,0,1,0,1,0
8336,28,0,0,70,70,0,1,0,1,0
9787,15,24859,11,5660,3544,2116,17,47,10,7
4734,740,28746,531,130,70,60,2,29,1,1
10260,26,24627,16,6162,925,5237,18,52,10,8
14475,10,24949,9,265,94,171,2,30,1,1
21625,10,8827,9,194,94,100,2,30,1,1
8484,26,3286,16,1486172,26246,1459926,1245,40,266,979
16153,28,0,0,70,70,0,1,0,1,0
7858,26,18727,16,5921,1018,4903,21,150,11,10
11934,10,10574,9,238,94,144,2,30,1,1
20308,2938,0,0,74,74,0,1,0,1,0
3990,15,6202,11,3524,2698,826,14,16,8,6
17979,28,0,0,66,66,0,1,0,1,0
6140,10,0,0,82,82,0,1,31,1,0
1077,26,18893,16,6096,777,5319,17,25,9,8
20274,26,21461,16,3491257,62261,3428996,3146,155,768,2378
21594,2938,0,0,62,62,0,1,0,1,0
8915,10,26908,9,200,102,98,2,30,1,1
5060,26,5861,16,22215289,662818,21552471,25924,349,8862,17062
15213,15,2799,11,234,234,0,4,11,4,0
2723,2573,0,0,66,66,0,1,0,1,0
14162,10,20075,9,216,110,106,2,30,1,1
17250,26,3925,16,4051,2587,1464,18,16,9,9
13687,26,24729,16,13944,2069,11875,28,30,15,13
9026,10,26331,9,817,102,715,2,30,1,1
5375,26,26854,16,7878,1909,5969,31,28,16,15
20531,26,23749,16,304,86,218,2,30,1,1
15202,10,2914,9,193,102,91,2,31,1,1
11052,2697,0,0,74,74,0,1,0,1,0
15574,10,4069,9,170,87,83,2,31,1,1
21468,10,15364,9,193,102,91,2,30,1,1
22649,10,20897,9,177,94,83,2,30,1,1
20918,234,3983,149,8544,2633,5911,51,154,28,23
18005,26,2971,16,1743,934,809,15,32,7,8
3084,2256,0,0,146,146,0,1,0,1,0
20189,295,27810,190,3530,2027,1503,16,15,9,7
17012,10,8583,9,277,78,199,2,30,1,1
13930,1888,0,0,66,66,0,1,0,1,0
6129,104,0,0,60,60,0,1,0,1,0
8584,1238,7382,918,232,71,161,2,31,1,1
13813,2486,0,0,66,66,0,1,0,1,0
7703,15,8933,11,1217,486,731,8,43,5,3
15881,26,16542,16,5612,733,4879,16,14,9,7
11211,52,15643,35,66,66,0,1,5,1,0
5966,234,25379,149,8866,2015,6851,29,4793,14,15
18955,26,20919,16,7488,1552,5936,23,46,13,10
12875,1147,0,0,66,66,0,1,0,1,0
2744,1630,17615,1252,906,126,780,2,31,1,1
15421,28,0,0,66,66,0,1,0,1,0
20235,28,0,0,70,70,0,1,0,1,0
4006,26,8149,16,6677,1006,5671,19,27,11,8
12233,28,0,0,70,70,0,1,0,1,0
9358,115,13673,88,70,70,0,2,8,2,0
18569,2754,25388,2135,320,140,180,6,6,3,3
4604,26,4555,16,617919,23432,594487,706,39,297,409
3041,1147,0,0,62,62,0,1,0,1,0
22370,26,25133,16,4925,2188,2737,36,360,16,20
2759,1017,0,0,60,60,0,1,0,1,0
3457,3216,0,0,62,62,0,1,0,1,0
10320,28,0,0,70,70,0,1,0,1,0
689,3216,0,0,66,66,0,1,0,1,0
11016,28,0,0,66,66,0,1,0,1,0
19831,28,0,0,70,70,0,1,0,1,0
1387,1771,0,0,62,62,0,1,0,1,0
5534,26,17206,16,4756,1849,2907,19,27,11,8
11620,15,25588,11,23776,1372,22404,35,112,15,20
7486,26,15190,16,14879,4981,9898,43,121,21,22
14103,10,773,9,170,87,83,2,30,1,1
9987,2587,0,0,66,66,0,1,0,1,0
15422,10,7076,9,761,100,661,2,31,1,1
14207,10,10377,9,178,94,84,2,29,1,1
4161,3,0,0,60,60,0,1,0,1,0
13689,28,0,0,70,70,0,1,0,1,0
13702,26,27246,16,1600,1089,511,13,151,7,6
13620,10,26155,9,255,88,167,4,32,2,2
14670,28,0,0,70,70,0,1,0,1,0
10176,28,0,0,66,66,0,1,0,1,0
15100,15,21319,11,798,401,397,7,17,5,2
10788,1510,15826,1149,70,70,0,2,8,2,0
11129,28,0,0,66,66,0,1,0,1,0
8424,10,22406,9,166,86,80,2,29,1,1
20905,1102,27085,809,198,198,0,1,5,1,0
1879,1017,0,0,146,146,0,1,0,1,0
19932,28,0,0,70,70,0,1,0,1,0
9721,15,6047,11,469212,19981,449231,601,134,276,325
22208,28,0,0,70,70,0,1,0,1,0
13074,185,0,0,60,60,0,1,0,1,0
9443,15,1655,11,145266,14613,130653,165,161,63,102
20482,10,13582,9,183,86,97,2,30,1,1
19294,15,1010,11,5518,527,4991,13,75,6,7
15958,142,25363,101,156,156,0,3,8,3,0
22604,28,0,0,70,70,0,1,0,1,0
15247,10,22344,9,177,94,83,2,30,1,1
16736,28,0,0,70,70,0,1,0,1,0
20522,28,0,0,66,66,0,1,0,1,0
3254,2382,0,0,66,66,0,1,0,1,0
2605,1147,0,0,66,66,0,1,0,1,0
20771,28,0,0,70,70,0,1,0,1,0
17665,26,1727,16,8702,580,8122,17,53,5,12
17287,26,24635,16,416,210,206,7,26,4,3
4131,15,15339,11,364170,17670,346500,412,31,170,242
22521,10,7809,9,166,86,80,2,30,1,1
18052,26,18153,16,349197,16542,332655,411,129,150,261
21761,10,19983,9,211,102,109,2,30,1,1
15451,28,0,0,70,70,0,1,0,1,0
4708,26,14524,16,172,172,0,2,5,2,0
7339,140,0,0,60,60,0,1,0,1,0
19009,28,0,0,70,70,0,1,0,1,0
6607,1539,0,0,146,146,0,1,0,1,0
850,26,14326,16,6594797,175738,6419059,6398,123,1755,4643
5,3216,0,0,66,66,0,1,0,1,0
11156,26,13810,16,12096,3734,8362,53,102,25,28
7722,15,8688,11,162355,7124,155231,207,27,96,111
8855,26,24457,16,1179,655,524,13,56,7,6
14935,28,0,0,70,70,0,1,0,1,0
7514,15,27262,11,1056,682,374,10,15,6,4
11340,26,21502,16,10320,5152,5168,45,15,25,20
16951,255,0,0,62,62,0,1,0,1,0
3927,15,5657,11,71843,2833,69010,83,16,36,47
2744,1241,878,921,882,126,756,2,30,1,1
5570,1017,0,0,146,146,0,1,0,1,0
19016,26,6906,16,109010,37307,71703,152,895,62,90
17924,26,13563,16,27370,17071,10299,51,30,26,25
5625,26,20036,16,543828,50144,493684,682,172,254,428
3723,15,2597,11,350,210,140,6,14,4,2
6346,26,16351,16,3243,2026,1217,16,15,8,8
14539,28,0,0,70,70,0,1,0,1,0
8626,28,0,0,66,66,0,1,0,1,0
19834,26,18700,16,6345,3495,2850,18,120,9,9
18597,28,0,0,70,70,0,1,0,1,0
18533,910,1654,673,70,70,0,1,5,1,0
15333,1979,13708,1509,70,70,0,2,8,2,0
9172,10,14321,9,193,102,91,2,29,1,1
15764,26,26202,16,35981,14676,21305,63,320,31,32
8800,28,0,0,66,66,0,1,0,1,0
19334,28,0,0,70,70,0,1,0,1,0
9686,26,831,16,6787,1846,4941,24,361,11,13
4835,2355,950,1834,132,132,0,3,1200,3,0
14303,10,8750,9,198,102,96,2,30,1,1
14845,3139,0,0,66,66,0,1,0,1,0
21791,10,21908,9,209,110,99,2,30,1,1
10938,15,28154,11,4542,2962,1580,13,28,8,5
3174,2611,0,0,62,62,0,1,0,1,0
14288,26,24528,16,51312,5706,45606,77,48,38,39
21181,28,0,0,70,70,0,1,0,1,0
15009,10,27255,9,193,102,91,2,30,1,1
9144,10,4235,9,503,103,400,4,47,2,2
12523,1475,14384,1123,492,306,186,8,15,5,3
22012,26,19381,16,15810,7525,8285,35,97,18,17
5542,26,20444,16,8030,7064,966,22,30,13,9
9280,26,14242,16,24329,7675,16654,47,16,25,22
15384,26,3510,16,7929,1909,6020,20,15,11,9
16562,15,9057,11,3641,1784,1857,19,375,10,9
22010,2205,0,0,62,62,0,1,0,1,0
18421,26,24913,16,17547,2695,14852,30,76,14,16
6574,2587,0,0,146,146,0,1,0,1,0
16978,26,11361,16,4649,2114,2535,11,120,6,5
5718,10,17533,9,240,96,144,2,31,1,1
9504,1888,0,0,62,62,0,1,0,1,0
16951,255,0,0,62,62,0,1,0,1,0
5587,26,13355,16,280,140,140,5,130,3,2
13807,28,0,0,66,66,0,1,0,1,0
3482,631,0,0,78,78,0,1,0,1,0
18652,697,0,0,62,62,0,1,0,1,0
13916,10,6789,9,268,102,166,2,30,1,1
14376,1888,0,0,66,66,0,1,0,1,0
16386,26,25634,16,4559,1652,2907,19,27,11,8
13933,28,0,0,70,70,0,1,0,1,0
5739,26,5453,16,4203,1564,2639,26,470,14,12
21407,28,0,0,66,66,0,1,0,1,0
15763,10,11218,9,199,102,97,2,30,1,1
15912,26,14784,16,16483,8545,7938,40,281,21,19
9,18,11307,13,826,376,450,10,34,5,5
0,0,0,0,320,320,0,5,0,5,0
9531,15,24087,11,8105,3187,4918,18,24,9,9
8531,15,20738,11,2168,1031,1137,8,166,5,3
19097,26,16624,16,383052,17263,365789,396,132,119,277
11593,3216,0,0,62,62,0,1,0,1,0
22172,1244,26280,924,742,462,280,2,31,1,1
1804,2513,0,0,60,60,0,1,0,1,0
11206,28,0,0,70,70,0,1,0,1,0
981,26,877,16,4230,760,3470,14,27,8,6
16952,26,25971,16,4380,1473,2907,19,30,11,8
3601,2573,0,0,62,62,0,1,0,1,0
22317,26,27916,16,3255,1259,1996,13,135,7,6
10957,28,0,0,70,70,0,1,0,1,0
1406,1804,0,0,66,66,0,1,0,1,0
21856,10,12273,9,199,102,97,2,30,1,1
8915,10,27305,9,200,102,98,2,30,1,1
13564,28,0,0,70,70,0,1,0,1,0
21835,10,17540,9,278,118,160,2,30,1,1
18237,1086,0,0,66,66,0,1,0,1,0
22482,28,0,0,70,70,0,1,0,1,0
4099,2477,0,0,145,145,0,1,0,1,0
16000,10,14034,9,177,94,83,2,30,1,1
5606,1996,15598,1526,156,94,62,2,30,1,1
21381,10,26563,9,190,97,93,2,31,1,1
11655,28,0,0,70,70,0,1,0,1,0
532,247,0,0,3562,1936,1626,48,195,24,24
1256,1888,0,0,62,62,0,1,0,1,0
763,1888,0,0,62,62,0,1,0,1,0
6338,26,2248,16,7733,1203,6530,21,15,12,9
1590,672,0,0,157,157,0,1,0,1,0
14782,10,26836,9,177,94,83,2,31,1,1
11004,15,22437,11,426,240,186,8,25,5,3
12948,28,0,0,70,70,0,1,0,1,0
12083,26,2236,16,1478,918,560,12,44,6,6
8426,10,26587,9,184,102,82,2,30,1,1
4958,26,25460,16,10632,3838,6794,37,256,18,19
8800,15,1806,11,318,192,126,6,42,4,2
8549,10,9826,9,200,102,98,2,30,1,1
12054,26,23309,16,208,66,142,4,148,2,2
15785,28,0,0,70,70,0,1,0,1,0
9458,10,581,9,744,95,649,2,30,1,1
13909,10,21260,9,177,94,83,2,30,1,1
16915,28,0,0,70,70,0,1,0,1,0
16021,280,27878,177,525,166,359,2,1200,1,1
5990,1147,0,0,146,146,0,1,0,1,0
11752,28,0,0,70,70,0,1,0,1,0
21267,10,22733,9,195,102,93,2,30,1,1
22091,1215,0,0,145,145,0,1,0,1,0
2134,1367,0,0,60,60,0,1,0,1,0
17850,28,0,0,66,66,0,1,0,1,0
15138,2256,0,0,66,66,0,1,0,1,0
10986,26,15353,16,5065,1658,3407,21,16,13,8
22558,10,5052,9,199,102,97,2,30,1,1
15089,10,24399,9,200,102,98,2,30,1,1
6163,26,19517,16,42402,3988,38414,82,89,39,43
18109,26,18376,16,4795,2875,1920,19,143,10,9
12139,26,6754,16,70319,5815,64504,146,67,52,94
18989,26,1487,16,1351,846,505,12,19,7,5
88,3216,0,0,66,66,0,1,0,1,0
8584,1238,10709,918,258,78,180,2,30,1,1
14175,28,0,0,70,70,0,1,0,1,0
2538,2938,0,0,62,62,0,1,0,1,0
21431,10,27844,9,261,102,159,2,30,1,1
21762,10,17767,9,183,94,89,2,30,1,1
14850,28,0,0,70,70,0,1,0,1,0
4169,26,2269,16,6997,1773,5224,27,17,15,12
2685,3216,0,0,62,62,0,1,0,1,0
7664,26,18907,16,6374,2446,3928,26,217,13,13
10884,15,1484,11,5438,1822,3616,17,38,11,6
1988,2023,0,0,146,146,0,1,0,1,0
5198,26,12048,16,10209,2574,7635,39,917,18,21
14529,10,19421,9,177,94,83,2,30,1,1
21122,28,0,0,70,70,0,1,0,1,0
16444,2881,0,0,90,90,0,1,0,1,0
12304,155,0,0,62,62,0,1,0,1,0
12553,26,14422,16,9555,4200,5355,25,86,15,10
15641,10,2512,9,166,86,80,2,30,1,1
15340,26,2731,16,7940,1951,5989,20,15,11,9
14015,10,3945,9,228,110,118,2,30,1,1
22458,10,3491,9,199,102,97,2,30,1,1
18,3216,0,0,62,62,0,1,0,1,0
9148,10,2837,9,178,94,84,2,30,1,1
14708,15,17039,11,8113,1082,7031,19,16,10,9
18928,1392,14747,1059,1806,1806,0,22,224,22,0
0,0,0,0,320,320,0,5,0,5,0
4954,2611,0,0,62,62,0,1,0,1,0
12,3227,0,0,131,131,0,1,0,1,0
21835,10,5270,9,290,102,188,2,30,1,1
18479,1888,0,0,66,66,0,1,0,1,0
22611,10,4697,9,166,86,80,2,30,1,1
16021,2990,1964,2324,726,726,0,12,1200,12,0
11653,26,21154,16,26399,2076,24323,37,319,15,22
9280,28,0,0,70,70,0,1,0,1,0
19194,1147,0,0,146,146,0,1,0,1,0
16145,2144,0,0,66,66,0,1,0,1,0
22278,15,28944,11,145038,9857,135181,162,23,62,100
15792,28,0,0,66,66,0,1,0,1,0
14269,28,0,0,70,70,0,1,0,1,0
2993,7,0,0,60,60,0,1,0,1,0
343,1054,0,0,62,62,0,1,0,1,0
18515,26,18748,16,5807,2168,3639,17,135,8,9
8501,10,1990,9,300,99,201,4,38,2,2
452,7,0,0,60,60,0,1,0,1,0
15328,2256,0,0,146,146,0,1,0,1,0
18062,28,0,0,70,70,0,1,0,1,0
984,26,15552,16,4612,830,3782,16,27,9,7
17689,15,3992,11,14862,1091,13771,26,135,14,12
12357,26,203,16,1625,1038,587,14,34,8,6
1827,1804,0,0,62,62,0,1,0,1,0
16174,26,25501,16,4492,1585,2907,19,30,11,8
10215,28,0,0,70,70,0,1,0,1,0
12790,405,849,263,70,70,0,2,7,2,0
12253,1147,0,0,62,62,0,1,0,1,0
8096,26,15892,16,5993,1261,4732,18,982,8,10
13652,10,14524,9,179,94,85,2,30,1,1
5904,26,22800,16,1807,1048,759,16,25,8,8
12865,26,9243,16,43491,8521,34970,69,50,34,35
22238,28,0,0,70,70,0,1,0,1,0
21969,183,28792,121,3428,1714,1714,16,33,8,8
11698,28,0,0,70,70,0,1,0,1,0
17350,2545,0,0,70,70,0,1,0,1,0
1139,3216,0,0,62,62,0,1,0,1,0
18104,28,0,0,70,70,0,1,0,1,0
15530,26,10879,16,4359,924,3435,15,59,9,6
9378,28,0,0,70,70,0,1,0,1,0
13702,15,9982,11,3084,1646,1438,19,131,10,9
13947,10,9681,9,170,87,83,2,0,1,1
3641,26,3022,16,12564,9272,3292,66,107,31,35
13979,1936,0,0,74,74,0,1,0,1,0
16181,1771,0,0,66,66,0,1,0,1,0
281,7,772,7,130,66,64,2,4,1,1
14726,10,12717,9,245,94,151,2,30,1,1
6432,26,16008,16,5617,1559,4058,22,138,13,9
8842,10,1679,9,216,110,106,2,30,1,1
12339,28,0,0,70,70,0,1,0,1,0
11585,104,0,0,60,60,0,1,0,1,0
17073,28,0,0,70,70,0,1,0,1,0
10337,15,6328,11,3588,2362,1226,24,87,13,11
17018,26,14031,16,280,140,140,5,130,3,2
17842,15,1323,11,613,539,74,7,15,6,1
10940,1888,0,0,62,62,0,1,0,1,0
5607,15,899,11,1364,860,504,13,32,8,5
7335,1072,0,0,60,60,0,1,0,1,0
2557,1147,0,0,146,146,0,1,0,1,0
20918,1771,0,0,66,66,0,1,0,1,0
1281,2543,0,0,60,60,0,1,0,1,0
11757,10,9273,9,168,78,90,2,30,1,1
11664,28,0,0,66,66,0,1,0,1,0
11990,26,20220,16,8571,1789,6782,20,326,10,10
9504,1771,0,0,66,66,0,1,0,1,0
19484,1147,0,0,66,66,0,1,0,1,0
11310,1888,0,0,66,66,0,1,0,1,0
14868,10,22086,9,170,87,83,2,31,1,1
14386,28,0,0,70,70,0,1,0,1,0
15111,10,6127,9,177,94,83,2,29,1,1
21293,1147,0,0,62,62,0,1,0,1,0
9124,10,25282,9,198,94,104,2,29,1,1
22440,10,7599,9,200,102,98,2,31,1,1
9739,26,13874,16,8981,4625,4356,22,135,11,11
9174,15,17467,11,5058,4299,759,11,27,6,5
22418,10,1962,9,194,102,92,2,31,1,1
1889,2205,0,0,146,146,0,1,0,1,0
8261,15,21262,11,24303,4898,19405,40,28,21,19
8058,26,28637,16,9590,3002,6588,25,96,14,11
12661,10,1818,9,199,94,105,2,30,1,1
17322,28,0,0,70,70,0,1,0,1,0
22340,10,23016,9,812,110,702,2,29,1,1
8584,1238,4251,918,224,78,146,2,30,1,1
3103,1804,0,0,146,146,0,1,0,1,0
7543,1392,14619,1059,1806,1806,0,22,224,22,0
11173,15,2373,11,366,240,126,7,32,5,2
8655,26,26655,16,1627,884,743,12,27,6,6
21653,2587,0,0,66,66,0,1,0,1,0
9136,10,9704,9,184,94,90,2,30,1,1
13910,10,20552,9,198,101,97,2,31,1,1
21364,10,19008,9,340,96,244,4,35,2,2
21099,28,0,0,70,70,0,1,0,1,0
16130,15,25460,11,64768,3074,61694,72,145,26,46
844,3026,0,0,146,146,0,1,0,1,0
16859,28,0,0,70,70,0,1,0,1,0
2530,26,10612,16,3072,696,2376,13,16,8,5
17997,26,13543,16,1576,973,603,14,28,7,7
14712,10,4120,9,757,98,659,2,30,1,1
10093,28,0,0,70,70,0,1,0,1,0
9039,10,22672,9,399,86,313,4,49,2,2
8828,15,15178,11,6753,3135,3618,17,41,8,9
19798,26,16213,16,13784,6865,6919,38,47,21,17
10491,1147,0,0,62,62,0,1,0,1,0
6305,232,28661,147,35380,2898,32482,63,227,22,41
15768,10,28185,9,182,93,89,2,31,1,1
6486,26,605,16,7011,2541,4470,19,15,11,8
20870,28,0,0,70,70,0,1,0,1,0
17171,26,10060,16,5106,700,4406,15,15,7,8
4300,15,3475,11,534,460,74,6,15,5,1
7877,26,11549,16,10372,4341,6031,28,319,15,13
5980,26,19201,16,190,70,120,4,15,2,2
20540,28,0,0,66,66,0,1,0,1,0
10650,26,12136,16,3833,867,2966,14,16,9,5
8568,10,7264,9,177,94,83,2,30,1,1
20389,3139,0,0,66,66,0,1,0,1,0
22265,10,23467,9,199,102,97,2,30,1,1
14854,10,6102,9,186,95,91,2,31,1,1
1372,1086,0,0,62,62,0,1,0,1,0
2345,15,9660,11,490,264,226,8,31,5,3
9451,26,18400,16,2474,735,1739,11,120,6,5
21252,10,15378,9,193,102,91,2,30,1,1
8667,10,22198,9,193,102,91,2,31,1,1
20174,1797,0,0,66,66,0,1,0,1,0
11163,677,15344,476,66,66,0,1,5,1,0
14551,10,14632,9,184,94,90,2,30,1,1
15171,10,22698,9,199,102,97,2,30,1,1
15165,10,5240,9,199,102,97,2,31,1,1
8527,28,0,0,70,70,0,1,0,1,0
5186,1888,0,0,62,62,0,1,0,1,0
19638,15,27451,11,2221,1482,739,11,149,6,5
15710,26,28573,16,12000,9252,2748,34,273,17,17
15821,10,2073,9,197,102,95,2,29,1,1
15204,10,14104,9,177,94,83,2,30,1,1
16853,2256,0,0,66,66,0,1,0,1,0
12038,2409,7529,1874,694,320,374,10,18,6,4
11596,713,0,0,66,66,0,1,0,1,0
19093,2573,0,0,62,62,0,1,0,1,0
437,308,0,0,66,66,0,1,0,1,0
19451,28,0,0,70,70,0,1,0,1,0
9750,28,0,0,70,70,0,1,0,1,0
12755,26,16706,16,7917,2410,5507,32,26,18,14
3085,2636,0,0,146,146,0,1,0,1,0
9416,28,0,0,70,70,0,1,0,1,0
21380,270,13063,170,66,66,0,2,8,2,0
8958,10,24372,9,755,202,553,6,61,3,3
11478,26,22583,16,23518,8884,14634,32,15,15,17
3993,16,0,0,60,60,0,1,0,1,0
9552,28,0,0,70,70,0,1,0,1,0
18373,1888,0,0,66,66,0,1,0,1,0
15993,10,15299,9,193,102,91,2,30,1,1
10099,28,0,0,70,70,0,1,0,1,0
16951,255,0,0,62,62,0,1,0,1,0
11838,104,0,0,60,60,0,1,0,1,0
2744,1240,22020,920,873,126,747,2,30,1,1
1712,899,0,0,62,62,0,1,0,1,0
14561,1472,0,0,66,66,0,1,0,1,0
9742,26,19201,16,1653,1010,643,16,94,9,7
10699,28,0,0,70,70,0,1,0,1,0
9223,28,0,0,70,70,0,1,0,1,0
20369,28,0,0,70,70,0,1,0,1,0
7326,1649,19908,1266,124,60,64,3,5,2,1
15346,2193,12725,1698,70,70,0,2,8,2,0
2461,1888,0,0,62,62,0,1,0,1,0
21377,28,0,0,66,66,0,1,0,1,0
14592,28,0,0,66,66,0,1,0,1,0
7335,1070,0,0,60,60,0,1,0,1,0
9006,308,0,0,66,66,0,1,0,1,0
14345,611,24169,421,70,70,0,1,5,1,0
3238,697,0,0,66,66,0,1,0,1,0
18879,2587,0,0,62,62,0,1,0,1,0
12087,26,23321,16,4591,1684,2907,19,28,11,8
16951,255,0,0,62,62,0,1,0,1,0
14812,10,11023,9,177,94,83,2,30,1,1
13826,28,0,0,70,70,0,1,0,1,0
360,3105,0,0,665,665,0,1,0,1,0
12634,1959,12703,1496,70,70,0,2,8,2,0
14895,10,23212,9,195,102,93,2,31,1,1
9011,26,23574,16,6117,976,5141,21,72,10,11
2280,1147,0,0,146,146,0,1,0,1,0
8748,10,18608,9,775,103,672,2,30,1,1
4212,213,12045,138,12526,5944,6582,24,3599,11,13
12409,3173,8574,2459,1721,971,750,15,16,8,7
14183,1888,0,0,66,66,0,1,0,1,0
15199,10,19342,9,199,102,97,2,30,1,1
21534,10,748,9,644,198,446,6,48,3,3
15689,10,21889,9,183,94,89,2,30,1,1
14761,26,19630,16,9201,4926,4275,19,120,10,9
14221,10,18475,9,193,102,91,2,29,1,1
6233,1646,0,0,60,60,0,1,0,1,0
687,3041,0,0,66,66,0,1,0,1,0
17409,1147,0,0,62,62,0,1,0,1,0
4732,26,26034,16,9875,3479,6396,29,46,17,12
15030,10,10656,9,322,102,220,2,30,1,1
21270,10,24509,9,193,102,91,2,29,1,1
13721,28,0,0,70,70,0,1,0,1,0
9458,28,0,0,70,70,0,1,0,1,0
14912,10,18101,9,271,95,176,4,47,2,2
117,2636,0,0,62,62,0,1,0,1,0
5658,2938,0,0,62,62,0,1,0,1,0
13939,28,0,0,70,70,0,1,0,1,0
19552,28,0,0,66,66,0,1,0,1,0
2565,10,10777,9,198,90,108,2,30,1,1
2874,1804,0,0,62,62,0,1,0,1,0
18268,26,4542,16,10816,1112,9704,22,125,10,12
13905,28,0,0,70,70,0,1,0,1,0
22623,10,758,9,254,94,160,2,30,1,1
15365,10,17499,9,758,93,665,2,30,1,1
18656,183,0,0,60,60,0,1,0,1,0
4980,26,23964,16,5304,1112,4192,19,31,10,9
8909,15,10006,11,2981,473,2508,9,16,5,4
21381,28,0,0,66,66,0,1,0,1,0
15303,26,27117,16,5367,725,4642,15,15,8,7
14138,10,1715,9,199,102,97,2,29,1,1
22354,10,18826,9,760,97,663,2,31,1,1
4973,676,21897,475,130,70,60,2,5,1,1
8615,28,0,0,70,70,0,1,0,1,0
21671,10,16928,9,669,200,469,6,49,3,3
9662,26,3694,16,7117,1288,5829,22,84,12,10
14458,26,21988,16,11446,4102,7344,32,20,16,16
12044,26,23030,16,3866,2774,1092,21,28,12,9
20625,28,0,0,70,70,0,1,0,1,0
18442,26,18350,16,4162,2121,2041,25,95,14,11
11028,124,21405,94,316,136,180,6,6,3,3
16573,28,0,0,70,70,0,1,0,1,0
15873,10,1208,9,177,94,83,2,30,1,1
5368,26,9080,16,506,292,214,8,50,5,3
13884,28,0,0,66,66,0,1,0,1,0
1812,2587,0,0,146,146,0,1,0,1,0
19603,3216,0,0,62,62,0,1,0,1,0
12322,23,0,0,5907,2302,3605,22,30,11,11
9696,15,27156,11,2367,1240,1127,10,16,5,5
12,3074,0,0,320,320,0,1,0,1,0
15742,28,0,0,70,70,0,1,0,1,0
8699,26,21543,16,20402,16563,3839,29,24,17,12
10845,2611,0,0,74,74,0,1,0,1,0
637,287,12374,184,221,111,110,2,1201,1,1
22351,10,15127,9,763,102,661,2,31,1,1
19793,509,0,0,62,62,0,1,0,1,0
9200,10,20302,9,177,94,83,2,31,1,1
1219,1348,5495,1022,469,149,320,2,1200,1,1
5119,26,24944,16,90289,3481,86808,96,16,31,65
1994,2953,0,0,62,62,0,1,0,1,0
18821,2604,0,0,62,62,0,1,0,1,0
15314,10,18261,9,195,102,93,2,30,1,1
19198,28,0,0,70,70,0,1,0,1,0
11536,28,0,0,70,70,0,1,0,1,0
532,247,0,0,3562,1936,1626,48,193,24,24
14657,10,7914,9,184,86,98,2,30,1,1
13964,10,21087,9,198,101,97,2,30,1,1
8356,28,0,0,70,70,0,1,0,1,0
10593,15,14175,11,1654,1340,314,11,15,6,5
15708,10,13485,9,198,101,97,2,31,1,1
12049,1147,0,0,146,146,0,1,0,1,0
19536,28,0,0,70,70,0,1,0,1,0
615,2252,0,0,66,66,0,1,0,1,0
1130,1888,0,0,66,66,0,1,0,1,0
22464,10,4616,9,754,94,660,2,30,1,1
2100,280,0,0,62,62,0,1,0,1,0
3230,2587,0,0,66,66,0,1,0,1,0
14714,10,18396,9,198,101,97,2,30,1,1
20446,28,0,0,70,70,0,1,0,1,0
8881,26,18899,16,4418,789,3629,13,54,6,7
10892,6,22700,6,7902,3301,4601,56,40,26,30
21631,10,19470,9,952,291,661,8,68,4,4
8488,10,6921,9,184,94,90,2,31,1,1
8332,10,18412,9,257,126,131,2,30,1,1
16231,1888,0,0,62,62,0,1,0,1,0
11005,535,1309,355,70,70,0,2,8,2,0
12980,15,8676,11,1582,1003,579,12,360,6,6
16896,2581,0,0,66,66,0,1,0,1,0
20773,26,13490,16,4704,2139,2565,13,119,7,6
20053,2587,0,0,62,62,0,1,0,1,0
18114,26,12019,16,6340,3788,2552,21,143,10,11
666,1017,0,0,62,62,0,1,0,1,0
1818,1147,0,0,62,62,0,1,0,1,0
561,509,0,0,62,62,0,1,0,1,0
18408,15,28015,11,2005,1094,911,11,87,6,5
19568,28,0,0,70,70,0,1,0,1,0
15450,509,0,0,66,66,0,1,0,1,0
9379,1375,20992,1046,4728691,2246710,2481981,40252,1121,19716,20536
13876,28,0,0,70,70,0,1,0,1,0
22256,10,23668,9,196,86,110,2,30,1,1
18055,28,0,0,70,70,0,1,0,1,0
11440,26,21243,16,7980,5952,2028,22,99,12,10
8847,26,14889,16,7383,2461,4922,18,135,8,10
14976,10,11960,9,177,94,83,2,30,1,1
14860,10,4040,9,200,102,98,2,30,1,1
14249,1363,8378,1035,70,70,0,2,8,2,0
16951,255,0,0,62,62,0,1,0,1,0
21653,2587,0,0,62,62,0,1,0,1,0
17413,1936,0,0,74,74,0,1,0,1,0
14456,10,13742,9,178,91,87,2,31,1,1
11009,1147,0,0,66,66,0,1,0,1,0
13958,28,0,0,70,70,0,1,0,1,0
16489,26,27146,16,4553,856,3697,17,362,9,8
21851,10,2015,9,738,86,652,2,30,1,1
7254,18,18265,13,184,94,90,2,30,1,1
11922,28,0,0,70,70,0,1,0,1,0
9293,10,23737,9,183,94,89,2,31,1,1
14282,28,0,0,70,70,0,1,0,1,0
15211,26,25008,16,4620,1713,2907,19,28,11,8
21441,28,0,0,70,70,0,1,0,1,0
15020,10,1698,9,209,110,99,2,29,1,1
404,2573,0,0,66,66,0,1,0,1,0
19689,28,0,0,66,66,0,1,0,1,0
8326,10,14196,9,733,86,647,2,31,1,1
11787,28,0,0,66,66,0,1,0,1,0
19686,2587,0,0,66,66,0,1,0,1,0
8771,10,16127,9,239,110,129,2,30,1,1
7810,15,24422,11,1614,1300,314,10,18,5,5
19200,1215,0,0,66,66,0,1,0,1,0
9735,28,0,0,66,66,0,1,0,1,0
15690,10,18108,9,195,102,93,2,30,1,1
16951,255,0,0,62,62,0,1,0,1,0
15661,26,19531,16,8180,2643,5537,19,121,9,10
1968,236,0,0,145,145,0,1,0,1,0
22477,10,1381,9,164,84,80,2,31,1,1
12094,26,20315,16,3658,2347,1311,18,17,9,9
16703,2608,0,0,66,66,0,1,0,1,0
3915,15,16625,11,350,210,140,6,30,4,2
19784,26,14493,16,29329,6712,22617,54,60,23,31
12504,28,0,0,70,70,0,1,0,1,0
13801,155,0,0,62,62,0,1,0,1,0
14456,10,7064,9,181,94,87,2,33,1,1
14804,10,11174,9,216,110,106,2,31,1,1
4488,2144,0,0,62,62,0,1,0,1,0
16128,26,24524,16,614577,24675,589902,673,149,228,445
15797,10,25288,9,198,89,109,2,30,1,1
11009,15,12057,11,6083,699,5384,14,46,7,7
11247,1822,13565,1389,316,136,180,6,9,3,3
22051,10,18403,9,216,110,106,2,30,1,1
8721,10,8773,9,199,102,97,2,30,1,1
18447,26,16074,16,39385,3771,35614,67,129,27,40
18754,1356,6058,1029,70,70,0,1,5,1,0
16115,26,25447,16,2512,1465,1047,21,87,10,11
13277,28,0,0,66,66,0,1,0,1,0
8707,10,6792,9,745,215,530,6,51,3,3
3405,26,18933,16,6958,4394,2564,30,28,17,13
11450,245,0,0,60,60,0,1,0,1,0
21275,10,21576,9,252,102,150,2,30,1,1
20535,28,0,0,70,70,0,1,0,1,0
13701,15,26299,11,306,180,126,6,32,4,2
21243,10,19407,9,212,102,110,2,30,1,1
12979,28,0,0,70,70,0,1,0,1,0
15711,10,14812,9,382,94,288,2,30,1,1
11575,2256,0,0,66,66,0,1,0,1,0
22154,10,10194,9,522,190,332,5,48,3,2
21707,10,17322,9,261,94,167,2,30,1,1
15539,10,28958,9,177,94,83,2,30,1,1
8515,10,704,9,194,102,92,2,30,1,1
15293,2587,0,0,66,66,0,1,0,1,0
1020,2938,0,0,62,62,0,1,0,1,0
15943,10,17016,9,193,102,91,2,30,1,1
17558,28,0,0,66,66,0,1,0,1,0
6888,26,7008,16,2359,1436,923,18,38,10,8
10042,15,8358,11,14877069,179445,14697624,12450,135,2531,9919
441,1590,0,0,66,66,0,1,0,1,0
15980,10,15198,9,711,87,624,2,30,1,1
10252,28,0,0,66,66,0,1,0,1,0
8949,10,10818,9,179,94,85,2,30,1,1
12640,28,0,0,70,70,0,1,0,1,0
13753,10,5336,9,195,102,93,2,29,1,1
4554,26,15867,16,3068,1678,1390,17,241,9,8
14943,26,12608,16,12746,7725,5021,39,234,24,15
5888,26,62,16,31541,25324,6217,49,91,29,20
7000,2370,0,0,74,74,0,1,0,1,0
16447,28,0,0,70,70,0,1,0,1,0
21904,10,2369,9,195,102,93,2,30,1,1
14259,724,10185,517,504,318,186,8,16,5,3
10229,28,0,0,70,70,0,1,0,1,0
16951,255,0,0,62,62,0,1,0,1,0
14848,28,0,0,70,70,0,1,0,1,0
19755,28,0,0,70,70,0,1,0,1,0
22323,10,10830,9,230,94,136,2,30,1,1
15068,28,0,0,70,70,0,1,0,1,0
14925,10,11045,9,194,102,92,2,29,1,1
21291,2493,13360,1940,70,70,0,1,4,1,0
18898,2587,0,0,66,66,0,1,0,1,0
1580,1888,0,0,145,145,0,1,0,1,0
9057,1147,0,0,66,66,0,1,0,1,0
9933,28,0,0,66,66,0,1,0,1,0
9197,28,0,0,66,66,0,1,0,1,0
15119,26,3016,16,3701,1521,2180,19,7,10,9
22412,28,0,0,70,70,0,1,0,1,0
21506,10,19253,9,199,102,97,2,30,1,1
21841,28,0,0,70,70,0,1,0,1,0
8981,26,21666,16,4682,1775,2907,19,28,11,8
10088,28,0,0,70,70,0,1,0,1,0
8275,26,15120,16,128299,119001,9298,178,280,103,75
6055,26,12237,16,27069,3064,24005,44,178,19,25
22527,26,24752,16,3182,1568,1614,8,120,4,4
2,782,0,0,554,554,0,1,0,1,0
12766,1881,25836,1436,552,306,246,9,16,5,4
3570,2675,0,0,162,162,0,1,0,1,0
14025,10,54,9,177,94,83,2,30,1,1
12746,536,26029,356,164,70,94,2,5,1,1
3066,632,21651,437,502,150,352,2,1200,1,1
17142,26,4800,16,8912,1537,7375,27,638,10,17
18807,10,16364,9,168,78,90,2,29,1,1
5291,10,16872,9,371,237,134,3,33,2,1
8801,28,0,0,66,66,0,1,0,1,0
8171,1073,0,0,60,60,0,1,0,1,0
3509,10,14383,9,643,88,555,2,30,1,1
12036,2580,9052,2002,70,70,0,2,8,2,0
20501,1771,0,0,62,62,0,1,0,1,0
16021,2577,23038,1999,1584,1584,0,25,1537,25,0
3133,2328,1283,1812,330,330,0,6,3609,6,0
13999,28,0,0,66,66,0,1,0,1,0
10491,26,16097,16,7318,1585,5733,24,50,14,10
823,778,3465,564,124,60,64,2,31,1,1
11179,15,22814,11,2928,694,2234,13,141,6,7
18071,26,21468,16,6655,1166,5489,21,360,11,10
2873,26,17471,16,31586,15587,15999,213,884,105,108
22056,28,0,0,66,66,0,1,0,1,0
18892,28,0,0,70,70,0,1,0,1,0
14449,10,1099,9,178,91,87,2,30,1,1
18598,15,26860,11,318,120,198,6,25,3,3
14758,10,15668,9,172,88,84,2,31,1,1
20034,28,0,0,66,66,0,1,0,1,0
8619,26,26306,16,8251,2124,6127,21,16,11,10
13583,188,19712,123,452,280,172,5,30,3,2
6653,26,27607,16,2328,1429,899,18,33,10,8
11552,26,1904,16,6170,918,5252,18,15,10,8
22603,10,5854,9,305,118,187,2,30,1,1
16902,28,0,0,66,66,0,1,0,1,0
14233,10,26227,9,198,102,96,2,30,1,1
532,247,0,0,3354,1792,1562,46,193,23,23
6889,1888,0,0,62,62,0,1,0,1,0
22222,10,16090,9,183,94,89,2,31,1,1
188,10,418,9,240,98,142,2,30,1,1
9159,15,789,11,2669,604,2065,11,16,6,5
13996,10,14528,9,200,94,106,2,29,1,1
10475,6,0,0,60,60,0,1,0,1,0
806,1797,0,0,66,66,0,1,0,1,0
11210,932,3047,687,70,70,0,1,5,1,0
22417,10,3228,9,775,102,673,2,30,1,1
1942,10,7450,9,216,98,118,2,30,1,1
14800,28,0,0,70,70,0,1,0,1,0
1373,1147,0,0,66,66,0,1,0,1,0
8339,28,0,0,66,66,0,1,0,1,0
9100,10,7299,9,168,94,74,2,30,1,1
9864,28,0,0,66,66,0,1,0,1,0
22368,10,23714,9,200,102,98,2,31,1,1
8918,10,5459,9,199,86,113,2,31,1,1
8496,28,0,0,66,66,0,1,0,1,0
15074,10,24885,9,193,102,91,2,30,1,1
8885,26,24971,16,560073,155518,404555,923,110,411,512
21977,10,22089,9,195,102,93,2,30,1,1
9411,26,14086,16,23684,13193,10491,84,63,44,40
3300,26,2160,16,7578,2270,5308,17,123,8,9
13796,28,0,0,70,70,0,1,0,1,0
15946,10,26331,9,186,95,91,2,30,1,1
21546,10,21607,9,183,94,89,2,29,1,1
17240,15,26865,11,1114,534,580,12,15,7,5
6520,26,1874,16,8615,2156,6459,37,315,16,21
5734,26,3866,16,9150,2155,6995,38,295,15,23
14505,10,19563,9,267,94,173,4,56,2,2
2689,26,11776,16,7343,2586,4757,23,20,11,12
10896,26,3379,16,2449,1794,655,17,31,10,7
10912,26,25407,16,366,180,186,7,30,4,3
4174,26,4868,16,9111,2919,6192,27,19,14,13
9689,10,19169,9,765,102,663,2,30,1,1
4176,26,21157,16,190,70,120,4,18,2,2
7568,26,24053,16,16425,3923,12502,37,156,19,18
21922,10,3004,9,275,118,157,2,30,1,1
14316,1691,6745,1293,70,70,0,1,5,1,0
16644,2747,0,0,62,62,0,1,0,1,0
10013,15,22217,11,13503,1052,12451,23,21,10,13
14331,28,0,0,70,70,0,1,0,1,0
13420,28,0,0,66,66,0,1,0,1,0
16951,255,0,0,62,62,0,1,0,1,0
20748,10,0,0,84,84,0,1,0,1,0
13029,28,0,0,70,70,0,1,0,1,0
13918,10,21393,9,317,85,232,4,60,2,2
2981,1880,0,0,62,62,0,1,0,1,0
22392,1238,26944,918,278,78,200,2,29,1,1
17745,1888,0,0,66,66,0,1,0,1,0
9136,10,25277,9,216,110,106,2,31,1,1
9085,15,6675,11,1126,609,517,11,15,6,5
16209,28,0,0,70,70,0,1,0,1,0
16645,2587,0,0,66,66,0,1,0,1,0
9479,26,19406,16,8863,1567,7296,24,41,12,12
21797,10,13357,9,186,95,91,2,31,1,1
16743,3139,0,0,62,62,0,1,0,1,0
15371,26,1098,16,5475,1610,3865,19,255,11,8
21792,10,9287,9,371,94,277,2,30,1,1
6250,1987,24980,1517,206,84,122,4,31,2,2
15987,10,13888,9,178,91,87,2,31,1,1
17716,28,0,0,70,70,0,1,0,1,0
9959,26,28668,16,2760048,78471,2681577,2863,250,962,1901
9038,10,27434,9,165,86,79,2,29,1,1
16663,2587,0,0,62,62,0,1,0,1,0
12390,28,0,0,66,66,0,1,0,1,0
12266,26,18703,16,4972,1547,3425,22,149,10,12
17117,26,2888,16,1413,876,537,12,25,6,6
16009,26,19029,16,2233,1347,886,23,135,13,10
4046,26,28429,16,4630,2803,1827,29,80,14,15
191,1215,0,0,62,62,0,1,0,1,0
2785,26,17132,16,9439,1890,7549,29,67,14,15
13750,28,0,0,66,66,0,1,0,1,0
1528,2093,0,0,145,145,0,1,0,1,0
10845,1391,3957,1058,70,70,0,1,4,1,0
1771,1147,0,0,146,146,0,1,0,1,0
16439,3216,0,0,66,66,0,1,0,1,0
14932,10,1668,9,195,102,93,2,32,1,1
21293,10,23819,9,184,94,90,2,31,1,1
336,15,980,11,12425,835,11590,19,17,8,11
19538,697,0,0,62,62,0,1,0,1,0
16951,255,0,0,62,62,0,1,0,1,0
4835,405,17390,263,491,150,341,2,1199,1,1
7334,26,19919,16,4504,1597,2907,19,27,11,8
20764,2938,0,0,66,66,0,1,0,1,0
12185,28,0,0,66,66,0,1,0,1,0
14103,10,11197,9,177,94,83,2,29,1,1
21973,28,0,0,66,66,0,1,0,1,0
11045,1159,25952,855,70,70,0,2,8,2,0
14912,10,11057,9,199,102,97,2,30,1,1
14505,10,19172,9,267,94,173,4,55,2,2
10782,28,0,0,70,70,0,1,0,1,0
14224,10,12842,9,194,102,92,2,31,1,1
383,15,15966,11,7072,1145,5927,20,105,12,8
6592,10,0,0,184,86,98,2,30,1,1
2125,2587,0,0,62,62,0,1,0,1,0
12684,26,24795,16,499,425,74,4,0,3,1
13710,10,8398,9,209,110,99,2,30,1,1
21729,10,18350,9,199,102,97,2,29,1,1
15572,15,13866,11,214,140,74,4,35,3,1
3032,2587,0,0,66,66,0,1,0,1,0
11125,2489,5244,1936,70,70,0,2,8,2,0
15841,10,8741,9,214,110,104,2,31,1,1
11121,509,0,0,62,62,0,1,0,1,0
9637,15,220,11,318,192,126,6,25,4,2
12460,2223,6732,1722,70,70,0,2,7,2,0
10225,15,27298,11,366,240,126,7,21,5,2
10926,2180,8294,1685,70,70,0,1,5,1,0
11296,1525,86,1162,70,70,0,1,5,1,0
18478,2058,15121,1584,70,70,0,2,8,2,0
2669,2876,0,0,62,62,0,1,0,1,0
15294,28,0,0,66,66,0,1,0,1,0
13446,28,0,0,70,70,0,1,0,1,0
14995,10,5913,9,193,102,91,2,30,1,1
22075,28,0,0,70,70,0,1,0,1,0
4328,15,15678,11,7594,863,6731,18,21,8,10
6699,1771,0,0,146,146,0,1,0,1,0
10566,26,22518,16,143921,6996,136925,152,174,42,110
15574,10,18844,9,177,94,83,2,30,1,1
1525,1444,0,0,145,145,0,1,0,1,0
22200,10,12350,9,214,94,120,2,31,1,1
22313,10,25101,9,266,87,179,4,32,2,2
18821,28,0,0,66,66,0,1,0,1,0
11066,2693,27475,2092,70,70,0,2,8,2,0
12631,10,5754,9,102,102,0,2,31,2,0
0,0,0,0,156,156,0,2,0,2,0
1871,1017,0,0,62,62,0,1,0,1,0
3133,2314,29084,1798,330,330,0,6,3609,6,0
7293,1771,0,0,62,62,0,1,0,1,0
9966,28,0,0,70,70,0,1,0,1,0
18431,26,7831,16,10387,2575,7812,26,108,13,13
7343,26,6215,16,9611,2412,7199,44,20,22,22
5557,15,27731,11,1286,403,883,16,393,4,12
12541,28,0,0,70,70,0,1,0,1,0
22474,10,469,9,775,102,673,2,30,1,1
15972,11,7180,10,70,70,0,2,7,2,0
9959,2938,0,0,66,66,0,1,0,1,0
2617,2938,0,0,62,62,0,1,0,1,0
20319,28,0,0,70,70,0,1,0,1,0
15024,10,22035,9,353,110,243,4,46,2,2
7992,26,27020,16,7358,2661,4697,22,17,11,11
8321,26,10076,16,3163100,158133,3004967,3863,264,1464,2399
20980,28,0,0,70,70,0,1,0,1,0
4649,26,20669,16,8553,3392,5161,25,202,13,12
8988,10,3078,9,209,110,99,2,29,1,1
15124,26,5288,16,4145,1069,3076,14,25,8,6
21798,28,0,0,66,66,0,1,0,1,0
16161,28,0,0,70,70,0,1,0,1,0
8439,10,23568,9,198,102,96,2,30,1,1
9189,10,8366,9,215,94,121,2,30,1,1
12569,2048,26198,1575,70,70,0,2,8,2,0
9752,26,10029,16,4758,2811,1947,22,140,12,10
19503,28,0,0,66,66,0,1,0,1,0
21174,280,19626,177,70,70,0,1,5,1,0
8377,10,14561,9,182,93,89,2,31,1,1
8381,15,22150,11,2734,1498,1236,21,262,11,10
8681,10,26097,9,195,102,93,2,29,1,1
11431,28,0,0,70,70,0,1,0,1,0
15721,10,13139,9,292,94,198,2,30,1,1
6441,15,28027,11,72023,4897,67126,97,115,46,51
14059,28,0,0,70,70,0,1,0,1,0
16144,1397,0,0,66,66,0,1,0,1,0
21102,28,0,0,66,66,0,1,0,1,0
10965,28,0,0,70,70,0,1,0,1,0
19213,1147,0,0,146,146,0,1,0,1,0
8769,15,1015,11,378,192,186,7,41,4,3
9618,28,0,0,70,70,0,1,0,1,0
4430,26,25223,16,560,280,280,9,27,5,4
18166,2097,0,0,66,66,0,1,0,1,0
20538,28,0,0,66,66,0,1,0,1,0
9847,15,1143,11,54304,27807,26497,227,175,113,114
243,3142,0,0,66,66,0,1,0,1,0
14761,10,12212,9,196,100,96,2,30,1,1
20476,1017,0,0,66,66,0,1,0,1,0
2891,3216,0,0,66,66,0,1,0,1,0
9760,10,11585,9,177,94,83,2,30,1,1
3381,26,6775,16,6989,5073,1916,24,111,14,10
21819,28,0,0,70,70,0,1,0,1,0
5210,15,16764,11,2993,1469,1524,13,20,8,5
22651,26,2048,16,92384,4519,87865,105,15,39,66
21304,10,813,9,360,97,263,4,38,2,2
16727,179,0,0,60,60,0,1,0,1,0
6967,26,2660,16,4383,2829,1554,27,80,14,13
9296,2256,0,0,62,62,0,1,0,1,0
9655,26,5133,16,6352,1073,5279,22,85,12,10
4373,10,8022,9,164,78,86,2,31,1,1
20039,1936,0,0,62,62,0,1,0,1,0
12,2784,0,0,82,82,0,1,0,1,0
20484,10,5863,9,304,86,218,2,29,1,1
2363,10,9723,9,215,80,135,2,33,1,1
5891,1472,0,0,146,146,0,1,0,1,0
22339,28,0,0,70,70,0,1,0,1,0
0,0,0,0,320,320,0,5,0,5,0
16129,15,25459,11,254,120,134,5,26,3,2
1804,304,0,0,60,60,0,1,0,1,0
360,3105,0,0,400,400,0,1,0,1,0
21879,28,0,0,70,70,0,1,0,1,0
14275,10,13341,9,168,86,82,2,29,1,1
21974,28,0,0,66,66,0,1,0,1,0
15055,28,0,0,70,70,0,1,0,1,0
15686,10,1940,9,295,101,194,4,31,2,2
12623,28,0,0,70,70,0,1,0,1,0
5965,26,12918,16,4370,1148,3222,17,26,9,8
14492,2823,3009,2191,481,150,331,2,1200,1,1
14062,1888,0,0,66,66,0,1,0,1,0
9,18,10215,13,184,94,90,2,29,1,1
1789,2883,0,0,62,62,0,1,0,1,0
1773,2604,0,0,66,66,0,1,0,1,0
8239,26,20918,16,79665,4371,75294,110,256,45,65
8437,10,19411,9,216,110,106,2,30,1,1
20862,28,0,0,70,70,0,1,0,1,0
22199,10,2228,9,360,110,250,2,30,1,1
19741,28,0,0,66,66,0,1,0,1,0
14819,28,0,0,70,70,0,1,0,1,0
9571,26,13994,16,783009,84254,698755,776,706,250,526
13598,28,0,0,70,70,0,1,0,1,0
21242,28,0,0,66,66,0,1,0,1,0
8823,26,15134,16,2800,1557,1243,33,53,19,14
15981,10,18104,9,168,86,82,2,30,1,1
1293,7,0,0,60,60,0,1,0,1,0
12164,983,0,0,62,62,0,1,0,1,0
17224,28,0,0,70,70,0,1,0,1,0
11199,3034,21693,2359,66,66,0,1,5,1,0
22238,10,21182,9,182,93,89,2,31,1,1
14171,10,1514,9,177,94,83,2,30,1,1
8584,1017,0,0,66,66,0,1,0,1,0
17209,26,10794,16,7671,4890,2781,25,17,13,12
11103,26,10998,16,22714,21388,1326,33,30,22,11
8,3192,0,0,66,66,0,1,0,1,0
15199,10,5442,9,198,101,97,2,31,1,1
14183,1888,0,0,66,66,0,1,0,1,0
7335,1070,0,0,60,60,0,1,0,1,0
20013,2938,0,0,109,109,0,1,0,1,0
1985,10,7682,9,295,90,205,2,29,1,1
1900,2938,0,0,62,62,0,1,0,1,0
11573,28,0,0,70,70,0,1,0,1,0
10003,15,28100,11,94083,6192,87891,121,139,57,64
17414,2587,0,0,62,62,0,1,0,1,0
3381,10,10558,9,181,86,95,2,30,1,1
17475,983,0,0,62,62,0,1,0,1,0
20802,2256,0,0,66,66,0,1,0,1,0
13593,15,6101,11,613,539,74,7,15,6,1
6367,26,18492,16,4378,1471,2907,19,30,11,8
18210,28,0,0,66,66,0,1,0,1,0
16951,255,0,0,62,62,0,1,0,1,0
6761,5,0,0,60,60,0,1,0,1,0
12065,28,0,0,70,70,0,1,0,1,0
18297,1017,0,0,66,66,0,1,0,1,0
17105,28,0,0,70,70,0,1,0,1,0
9557,28,0,0,70,70,0,1,0,1,0
1757,1880,0,0,62,62,0,1,0,1,0
10780,2789,20147,2164,70,70,0,1,5,1,0
15911,10,24588,9,767,102,665,2,30,1,1
1936,10,7438,9,219,87,132,2,30,1,1
11428,2573,0,0,62,62,0,1,0,1,0
17075,26,27593,16,9017,5865,3152,26,16,14,12
17464,28,0,0,70,70,0,1,0,1,0
7174,15,3450,11,2259,1068,1191,12,31,8,4
14632,10,785,9,346,94,252,2,30,1,1
6926,26,12708,16,6903,1185,5718,26,255,12,14
4197,6,0,0,60,60,0,1,0,1,0
8025,2604,0,0,62,62,0,1,0,1,0
14364,10,0,0,338,70,268,2,30,1,1
17825,26,4319,16,9015,2221,6794,27,421,13,14
4618,10,19631,9,199,94,105,2,30,1,1
22428,10,0,0,88,88,0,1,0,1,0
13998,15,5504,11,130,70,60,2,15,1,1
12966,26,13832,16,1749,966,783,13,75,8,5
12564,26,24080,16,499,425,74,4,0,3,1
11114,1504,28714,1144,70,70,0,2,7,2,0
15770,28,0,0,70,70,0,1,0,1,0
844,2166,0,0,146,146,0,1,0,1,0
22637,28,0,0,70,70,0,1,0,1,0
21512,10,24148,9,451,118,333,2,30,1,1
15537,10,27143,9,267,87,180,4,59,2,2
15752,10,19113,9,177,94,83,2,30,1,1
13494,26,10460,16,9657,1944,7713,31,82,15,16
16336,28,0,0,66,66,0,1,0,1,0
22027,28,0,0,66,66,0,1,0,1,0
15025,28,0,0,70,70,0,1,0,1,0
10346,2127,0,0,100,100,0,1,0,1,0
16687,1888,0,0,66,66,0,1,0,1,0
21785,10,26345,9,167,86,81,2,30,1,1
11116,15,24368,11,2703,632,2071,12,22,7,5
21154,2475,6650,1925,66,66,0,2,8,2,0
11238,2205,0,0,62,62,0,1,0,1,0
15584,10,2220,9,770,101,669,2,30,1,1
15380,10,26872,9,178,94,84,2,30,1,1
22615,28,0,0,70,70,0,1,0,1,0
13632,26,26725,16,225539,162879,62660,476,70,262,214
13809,26,5623,16,2329,505,1824,14,124,7,7
18144,26,15296,16,10124,2145,7979,24,156,11,13
9334,28,0,0,66,66,0,1,0,1,0
20693,28,0,0,70,70,0,1,0,1,0
15346,10,562,9,270,95,175,4,60,2,2
7284,26,16574,16,1625,1038,587,14,29,8,6
19146,28,0,0,70,70,0,1,0,1,0
13382,280,20418,177,1682,716,966,12,15,6,6
20759,28,0,0,66,66,0,1,0,1,0
4606,2587,0,0,62,62,0,1,0,1,0
9482,10,24935,9,762,97,665,2,30,1,1
21458,28,0,0,70,70,0,1,0,1,0
9093,26,4315,16,7069,2667,4402,22,28,13,9
12100,1017,0,0,62,62,0,1,0,1,0
21521,10,16703,9,211,78,133,2,30,1,1
22288,10,20200,9,741,94,647,2,30,1,1
15323,1758,7594,1343,66,66,0,1,5,1,0
16951,255,0,0,62,62,0,1,0,1,0
21013,1372,23613,1043,504,382,122,8,15,6,2
14663,10,28996,9,192,98,94,2,31,1,1
5704,26,23496,16,8691,6945,1746,25,80,14,11
9857,10,22129,9,198,90,108,2,30,1,1
7103,10,0,0,226,86,140,2,29,1,1
17388,28,0,0,70,70,0,1,0,1,0
20064,28,0,0,70,70,0,1,0,1,0
15856,26,3661,16,23282,4482,18800,67,17,35,32
13181,26,11663,16,3486,924,2562,13,122,6,7
9959,26,22183,16,37757,4416,33341,44,32,17,27
20286,26,2825,16,35936,2741,33195,62,15,30,32
14400,10,12102,9,102,102,0,1,60,1,0
9374,2938,0,0,66,66,0,1,0,1,0
1616,10,5835,9,247,98,149,2,33,1,1
16831,28,0,0,70,70,0,1,0,1,0
11152,2162,26229,1670,70,70,0,1,5,1,0
2895,26,25568,16,9075,2662,6413,34,462,16,18
13844,15,21616,11,41822,2038,39784,56,15,27,29
2744,1241,25917,921,888,126,762,2,30,1,1
15257,28,0,0,70,70,0,1,0,1,0
11347,28,0,0,66,66,0,1,0,1,0
20691,28,0,0,66,66,0,1,0,1,0
10860,2144,0,0,66,66,0,1,0,1,0
8951,10,20713,9,211,110,101,2,30,1,1
12712,28,0,0,70,70,0,1,0,1,0
919,15,6606,11,318,192,126,6,29,4,2
20194,28,0,0,70,70,0,1,0,1,0
1703,3139,0,0,66,66,0,1,0,1,0
18709,255,0,0,60,60,0,1,0,1,0
4054,183,15229,121,4224,2055,2169,22,21,13,9
13836,26,6089,16,12801,4250,8551,40,118,21,19
16411,26,265,16,2791,1800,991,26,185,15,11
13801,10,15403,9,194,102,92,2,31,1,1
22714,28,0,0,70,70,0,1,0,1,0
8579,10,21472,9,225,90,135,2,30,1,1
8224,26,159,16,2523,1483,1040,19,276,10,9
615,23,0,0,82,82,0,1,0,1,0
14980,1771,0,0,66,66,0,1,0,1,0
13685,10,28113,9,756,95,661,2,31,1,1
4200,1147,0,0,66,66,0,1,0,1,0
14091,10,14794,9,321,105,216,4,40,2,2
2744,1271,3429,951,921,126,795,2,31,1,1
17503,26,24409,16,8640,2329,6311,19,76,10,9
15437,28,0,0,66,66,0,1,0,1,0
14417,26,9804,16,5283,2688,2595,14,135,7,7
14294,1820,11166,1387,70,70,0,2,8,2,0
12767,697,0,0,62,62,0,1,0,1,0
18458,288,17753,185,70,70,0,2,8,2,0
1283,509,0,0,62,62,0,1,0,1,0
7660,26,3449,16,7094,1672,5422,21,361,10,11
15657,10,8121,9,198,102,96,2,30,1,1
19867,28,0,0,70,70,0,1,0,1,0
15361,10,416,9,194,102,92,2,30,1,1
11301,26,22875,16,1615,941,674,15,20,7,8
16951,255,0,0,62,62,0,1,0,1,0
21900,28,0,0,70,70,0,1,0,1,0
10617,2256,0,0,66,66,0,1,0,1,0
18463,15,18129,11,1704,808,896,10,122,6,4
1330,697,0,0,62,62,0,1,0,1,0
3199,2636,0,0,66,66,0,1,0,1,0
2306,10,9482,9,226,106,120,2,30,1,1
12531,28,0,0,66,66,0,1,0,1,0
15223,10,2397,9,198,101,97,2,31,1,1
2165,2573,0,0,66,66,0,1,0,1,0
2102,3216,0,0,62,62,0,1,0,1,0
823,2503,0,0,60,60,0,1,0,1,0
5492,10,25862,9,168,78,90,2,30,1,1
14438,10,6152,9,214,110,104,2,29,1,1
10266,28,0,0,70,70,0,1,0,1,0
7765,1880,0,0,62,62,0,1,0,1,0
14212,1745,13826,1333,504,318,186,8,15,5,3
6778,23,0,0,4491,2143,2348,24,30,12,12
298,1888,0,0,62,62,0,1,0,1,0
22011,10,17362,9,193,102,91,2,30,1,1
9017,10,1647,9,291,102,189,2,30,1,1
16555,183,25736,121,4166,2141,2025,18,17,9,9
6506,697,0,0,62,62,0,1,0,1,0
19081,28,0,0,70,70,0,1,0,1,0
14492,1345,2057,1020,480,149,331,2,1200,1,1
15330,26,17318,16,8059,2039,6020,20,15,11,9
6732,26,11782,16,70,70,0,1,4,1,0
17439,1771,0,0,66,66,0,1,0,1,0
21999,2587,0,0,62,62,0,1,0,1,0
2963,6,0,0,60,60,0,1,0,1,0
14598,10,17826,9,183,94,89,2,30,1,1
9081,10,20838,9,752,93,659,2,31,1,1
21944,10,26022,9,266,110,156,2,30,1,1
17414,2587,0,0,66,66,0,1,0,1,0
12184,1215,0,0,66,66,0,1,0,1,0
9042,10,14793,9,216,94,122,2,30,1,1
6999,281,12929,178,502,150,352,2,1200,1,1
18355,15,8500,11,1366,785,581,11,145,6,5
22035,10,1458,9,180,94,86,2,30,1,1
22398,10,25975,9,249,94,155,2,30,1,1
21525,10,10685,9,550,133,417,4,47,2,2
16628,28,0,0,70,70,0,1,0,1,0
15454,10,11410,9,209,110,99,2,30,1,1
17851,10,28623,9,384,166,218,2,30,1,1
17999,26,28756,16,7718,1947,5771,25,46,14,11
16021,56,12556,39,132,132,0,3,1199,3,0
19613,28,0,0,70,70,0,1,0,1,0
1337,1997,5304,1527,156,94,62,2,30,1,1
18466,3054,20458,2371,70,70,0,2,8,2,0
14162,28,0,0,66,66,0,1,0,1,0
22672,26,21252,16,92479,4869,87610,109,16,44,65
15230,26,3044,16,1272,876,396,10,26,6,4
12470,1482,0,0,66,66,0,1,0,1,0
21972,10,10744,9,167,78,89,2,30,1,1
12780,2749,7063,2130,70,70,0,1,4,1,0
8780,15,28352,11,374,192,182,7,41,4,3
8210,1473,21194,1121,469,150,319,2,1200,1,1
2216,26,9017,16,10913,762,10151,17,19,7,10
12,2419,0,0,60,60,0,1,0,1,0
17121,26,27971,16,16200,10803,5397,42,18,24,18
19386,28,0,0,70,70,0,1,0,1,0
9785,15,21347,11,1658,1247,411,8,15,5,3
8825,28,0,0,66,66,0,1,0,1,0
15145,10,27953,9,199,102,97,2,30,1,1
12,3227,0,0,131,131,0,1,0,1,0
12707,28,0,0,70,70,0,1,0,1,0
1139,3216,0,0,62,62,0,1,0,1,0
2744,1241,27314,921,881,126,755,2,30,1,1
17432,26,9091,16,2592,1486,1106,20,275,10,10
3906,26,9772,16,826,362,464,13,30,6,7
20029,28,0,0,70,70,0,1,0,1,0
16087,2587,0,0,62,62,0,1,0,1,0
16021,2627,11381,2037,807,275,532,4,1200,2,2
15195,26,827,16,1327,918,409,10,25,6,4
4262,26,17987,16,1128432,47396,1081036,1242,142,458,784
22342,28,0,0,70,70,0,1,0,1,0
8643,10,8562,9,178,94,84,2,30,1,1
19036,10,15304,9,311,94,217,2,30,1,1
8826,10,28839,9,186,95,91,2,30,1,1
10964,1802,0,0,66,66,0,1,0,1,0
20556,1147,0,0,66,66,0,1,0,1,0
14278,10,9567,9,179,94,85,2,31,1,1
636,280,18710,177,150,150,0,1,1200,1,0
2459,1771,0,0,66,66,0,1,0,1,0
18496,28,0,0,66,66,0,1,0,1,0
22704,10,9509,9,338,107,231,4,39,2,2
3159,2938,0,0,145,145,0,1,0,1,0
0,0,0,0,60,60,0,1,0,1,0
14121,28,0,0,70,70,0,1,0,1,0
14921,26,6558,16,8991,1756,7235,28,26,15,13
11650,26,25737,16,15118,3979,11139,34,353,17,17
13764,10,12597,9,196,100,96,2,31,1,1
9093,26,9716,16,7298,2303,4995,22,16,12,10
3352,255,0,0,60,60,0,1,0,1,0
22272,10,21163,9,821,102,719,2,29,1,1
17668,2256,0,0,66,66,0,1,0,1,0
12030,2611,0,0,74,74,0,1,0,1,0
10101,190,28061,125,409,107,302,4,30,2,2
11002,232,4049,147,5410,2343,3067,42,53,24,18
2104,10,8341,9,219,87,132,2,30,1,1
19045,10,26914,9,1139,878,261,2,30,1,1
13259,1737,0,0,66,66,0,1,0,1,0
21633,26,20760,16,4017,978,3039,14,53,8,6
13034,10,23826,9,237,91,146,2,33,1,1
15974,10,25070,9,209,102,107,2,30,1,1
8444,15,4691,11,13670,11470,2200,39,231,20,19
8720,10,17454,9,210,110,100,2,31,1,1
1921,10,7364,9,240,98,142,2,30,1,1
2939,1804,0,0,62,62,0,1,0,1,0
8709,10,10031,9,880,189,691,6,75,3,3
22171,1259,2593,939,996,462,534,4,30,2,2
17002,1252,3648,932,70,70,0,1,5,1,0
10583,1215,0,0,62,62,0,1,0,1,0
2744,1238,7034,918,886,126,760,2,30,1,1
14234,28,0,0,70,70,0,1,0,1,0
8842,10,14046,9,197,102,95,2,30,1,1
17840,26,5416,16,3346,1219,2127,15,136,7,8
15087,10,5166,9,1165,94,1071,2,29,1,1
13529,914,0,0,66,66,0,1,0,1,0
21830,15,28719,11,56887,6820,50067,90,25,49,41
9955,26,22112,16,134,60,74,3,6,2,1
733,1804,0,0,66,66,0,1,0,1,0
8735,10,21107,9,91,91,0,2,37,2,0
7730,1888,0,0,62,62,0,1,0,1,0
14581,10,16782,9,756,95,661,2,31,1,1
16569,697,0,0,146,146,0,1,0,1,0
10316,26,214,16,11983,2674,9309,51,17,29,22
16532,28,0,0,70,70,0,1,0,1,0
11053,2100,27367,1619,70,70,0,2,8,2,0
16047,7,0,0,60,60,0,1,0,1,0
9411,244,2794,157,472,150,322,2,1200,1,1
14584,10,19460,9,195,102,93,2,31,1,1
2076,7,0,0,60,60,0,1,0,1,0
16499,26,20115,16,24527,2438,22089,43,329,19,24
11822,155,0,0,66,66,0,1,0,1,0
20327,28,0,0,66,66,0,1,0,1,0
10474,1590,0,0,72,72,0,1,0,1,0
9476,15,15718,11,1677,862,815,10,15,5,5
17168,26,17283,16,3867,2403,1464,17,15,8,9
1533,1017,0,0,62,62,0,1,0,1,0
11378,26,9268,16,7058,2421,4637,21,17,11,10
21367,28,0,0,66,66,0,1,0,1,0
15860,10,18806,9,177,94,83,2,30,1,1
19639,26,18293,16,3429,784,2645,18,135,8,10
12485,1949,13057,1486,612,306,306,10,15,5,5
12245,3216,0,0,66,66,0,1,0,1,0
3525,1147,0,0,62,62,0,1,0,1,0
9,18,6238,13,184,94,90,2,30,1,1
20236,1763,0,0,66,66,0,1,0,1,0
21709,10,18513,9,183,94,89,2,30,1,1
22382,10,2047,9,184,94,90,2,31,1,1
15699,10,9572,9,209,110,99,2,30,1,1
15444,812,0,0,66,66,0,1,0,1,0
8741,28,0,0,70,70,0,1,0,1,0
19382,15,12663,11,901,398,503,10,15,5,5
22116,28,0,0,70,70,0,1,0,1,0
7807,26,10821,16,6118,1180,4938,22,16,11,11
9045,28,0,0,70,70,0,1,0,1,0
19538,2256,0,0,66,66,0,1,0,1,0
14066,1147,0,0,66,66,0,1,0,1,0
10327,1265,9542,945,132,132,0,3,1200,3,0
17421,26,17265,16,130458,7920,122538,199,359,94,105
12705,3208,15933,2488,492,306,186,8,15,5,3
17987,2853,0,0,62,62,0,1,0,1,0
17644,28,0,0,70,70,0,1,0,1,0
15511,10,3254,9,199,102,97,2,29,1,1
8757,10,8903,9,86,86,0,1,29,1,0
10472,26,11328,16,509,329,180,6,8,3,3
22403,10,21827,9,214,110,104,2,30,1,1
13815,10,25843,9,199,102,97,2,30,1,1
6641,26,4066,16,4680,2873,1807,26,53,15,11
15335,26,5234,16,7894,1671,6223,21,185,11,10
13631,28,0,0,66,66,0,1,0,1,0
16420,2486,0,0,78,78,0,1,0,1,0
21617,10,24645,9,196,94,102,2,30,1,1
532,247,0,0,3354,1792,1562,46,192,23,23
9482,10,21921,9,260,106,154,2,30,1,1
7477,15,13363,11,1163,705,458,10,15,6,4
15223,26,10897,16,8007,1987,6020,20,15,11,9
19784,28,0,0,70,70,0,1,0,1,0
20637,28,0,0,66,66,0,1,0,1,0
22420,10,24471,9,172,88,84,2,31,1,1
13444,28,0,0,70,70,0,1,0,1,0
3822,1017,0,0,62,62,0,1,0,1,0
13631,10,15462,9,275,93,182,4,31,2,2
12667,254,8723,159,70,70,0,2,7,2,0
8883,10,20946,9,444,96,348,4,44,2,2
2409,1472,0,0,66,66,0,1,0,1,0
7125,2256,0,0,62,62,0,1,0,1,0
7547,2953,0,0,62,62,0,1,0,1,0
15295,10,4651,9,177,94,83,2,29,1,1
12366,26,17174,16,710,350,360,12,33,6,6
17079,26,19400,16,5166,700,4466,16,15,7,9
15203,10,24103,9,789,110,679,2,30,1,1
21824,10,25133,9,183,94,89,2,29,1,1
11689,1215,0,0,66,66,0,1,0,1,0
15344,494,1792,324,66,66,0,1,5,1,0
2744,1238,3400,918,913,126,787,2,30,1,1
22456,28,0,0,70,70,0,1,0,1,0
20504,1147,0,0,62,62,0,1,0,1,0
16287,28,0,0,70,70,0,1,0,1,0
21391,10,2413,9,267,94,173,4,59,2,2
17371,2938,0,0,66,66,0,1,0,1,0
17016,3212,0,0,62,62,0,1,0,1,0
17401,28,0,0,70,70,0,1,0,1,0
11590,28,0,0,70,70,0,1,0,1,0
17692,28,0,0,70,70,0,1,0,1,0
21559,10,13094,9,298,87,211,4,34,2,2
2012,295,7856,190,2205,815,1390,13,16,7,6
14885,10,667,9,177,94,83,2,30,1,1
20399,40,6684,23,9831,4069,5762,88,192,40,48
5801,10,0,0,86,86,0,1,30,1,0
15184,10,16269,9,199,102,97,2,30,1,1
2744,1280,8770,960,926,126,800,2,31,1,1
15813,10,18578,9,771,101,670,2,31,1,1
12520,28,0,0,70,70,0,1,0,1,0
11110,28,0,0,70,70,0,1,0,1,0
17533,1771,0,0,66,66,0,1,0,1,0
14946,26,18340,16,4850,2997,1853,20,234,12,8
3861,10,15909,9,396,257,139,3,30,2,1
17788,26,20464,16,11784,7785,3999,55,120,28,27
15961,26,15807,16,5734,1543,4191,24,26,13,11
8561,28,0,0,70,70,0,1,0,1,0
19871,28,0,0,70,70,0,1,0,1,0
9373,28,0,0,66,66,0,1,0,1,0
3177,794,0,0,60,60,0,1,0,1,0
18141,26,22310,16,8241,2346,5895,18,136,8,10
11046,15,13542,11,19693,1957,17736,49,32,23,26
18396,10,3443,9,419,111,308,2,31,1,1
10243,15,2556,11,2880,815,2065,12,25,7,5
12510,1553,6283,1184,70,70,0,2,8,2,0
13321,28,0,0,70,70,0,1,0,1,0
11944,28,0,0,66,66,0,1,0,1,0
8442,10,9706,9,212,102,110,2,30,1,1
9807,28,0,0,70,70,0,1,0,1,0
17062,28,0,0,70,70,0,1,0,1,0
8977,10,1931,9,166,86,80,2,30,1,1
2426,1147,0,0,146,146,0,1,0,1,0
10522,26,12631,16,575,326,249,10,15,6,4
2485,2418,0,0,145,145,0,1,0,1,0
14387,26,14808,16,4344,2974,1370,22,94,12,10
10403,509,0,0,66,66,0,1,0,1,0
21253,10,25185,9,346,98,248,4,31,2,2
21545,28,0,0,70,70,0,1,0,1,0
5486,15,17148,11,424,198,226,7,142,4,3
9728,2627,1022,2037,475,150,325,2,1200,1,1
16561,28,0,0,66,66,0,1,0,1,0
15546,10,3590,9,193,102,91,2,30,1,1
9951,28,0,0,70,70,0,1,0,1,0
4835,2634,2934,2044,158,158,0,1,1199,1,0
4749,234,7845,149,5554,755,4799,14,3600,8,6
5615,26,17571,16,13853,4638,9215,42,387,21,21
21224,10,6688,9,258,90,168,4,56,2,2
9622,2636,0,0,66,66,0,1,0,1,0
155,3216,0,0,66,66,0,1,0,1,0
21834,28,0,0,70,70,0,1,0,1,0
10067,28,0,0,70,70,0,1,0,1,0
9724,15,7511,11,1513,694,819,10,15,5,5
3781,1054,0,0,62,62,0,1,0,1,0
8705,10,24154,9,198,94,104,2,31,1,1
11002,28,0,0,70,70,0,1,0,1,0
21916,10,14547,9,183,94,89,2,30,1,1
13897,10,6618,9,212,110,102,2,30,1,1
9095,26,28549,16,92352,5699,86653,105,134,35,70
14163,15,3402,11,3367,2346,1021,19,39,11,8
5985,7,0,0,60,60,0,1,0,1,0
8210,2098,21194,1617,513,152,361,2,1200,1,1
14361,2636,0,0,66,66,0,1,0,1,0
8347,10,16013,9,314,97,217,4,34,2,2
12375,405,16548,263,70,70,0,2,7,2,0
21799,10,12753,9,183,94,89,2,30,1,1
9995,26,7500,16,1501,590,911,12,26,6,6
6290,26,24507,16,204,70,134,4,26,2,2
17215,26,125,16,6138,3860,2278,20,16,10,10
15391,568,19896,382,70,70,0,1,5,1,0
18444,15,26788,11,448865,6437,442428,380,151,67,313
12227,1215,0,0,62,62,0,1,0,1,0
7339,140,0,0,60,60,0,1,0,1,0
18431,28,0,0,70,70,0,1,0,1,0
14121,28,0,0,66,66,0,1,0,1,0
17858,1763,0,0,62,62,0,1,0,1,0
8913,10,9154,9,278,94,184,2,30,1,1
13739,10,15989,9,328,90,238,4,37,2,2
11028,15,13009,11,52288,7809,44479,105,37,40,65
21404,28,0,0,70,70,0,1,0,1,0
18357,300,0,0,62,62,0,1,0,1,0
15446,28,0,0,66,66,0,1,0,1,0
18271,1771,0,0,62,62,0,1,0,1,0
20095,28,0,0,70,70,0,1,0,1,0
17255,15,17805,11,6969,6315,654,15,15,9,6
299,1888,0,0,62,62,0,1,0,1,0
9092,26,15475,16,11646,4774,6872,29,32,18,11
11701,2611,0,0,62,62,0,1,0,1,0
12034,3012,18679,2342,70,70,0,2,8,2,0
12005,2046,16428,1573,70,70,0,2,8,2,0
21512,10,10230,9,177,94,83,2,30,1,1
13617,28,0,0,70,70,0,1,0,1,0
10706,2636,0,0,66,66,0,1,0,1,0
16517,28,0,0,70,70,0,1,0,1,0
8743,2938,0,0,62,62,0,1,0,1,0
22264,10,14644,9,199,102,97,2,29,1,1
14714,2382,0,0,62,62,0,1,0,1,0
13412,28,0,0,70,70,0,1,0,1,0
12955,797,0,0,66,66,0,1,0,1,0
11146,28,0,0,70,70,0,1,0,1,0
7200,15,5981,11,350,210,140,6,28,4,2
12,443,0,0,669,669,0,1,0,1,0
8640,295,21503,190,2990,1599,1391,15,15,8,7
7707,10,20422,9,221,89,132,2,31,1,1
17389,28,0,0,70,70,0,1,0,1,0
12869,28,0,0,70,70,0,1,0,1,0
14825,15,24819,11,44755,823,43932,45,15,12,33
18840,10,16620,9,224,86,138,2,29,1,1
22382,2256,0,0,66,66,0,1,0,1,0
19212,28,0,0,70,70,0,1,0,1,0
15069,28,0,0,70,70,0,1,0,1,0
917,15,24670,11,318,192,126,6,29,4,2
7802,26,6017,16,9921,3169,6752,31,20,17,14
22473,10,20365,9,212,102,110,2,30,1,1
3066,1651,17136,1268,42329,18517,23812,241,2378,116,125
18762,1989,11751,1519,316,136,180,6,6,3,3
10402,26,25981,16,6250,1422,4828,20,17,10,10
16211,28,0,0,66,66,0,1,0,1,0
22007,28,0,0,70,70,0,1,0,1,0
13833,10,17583,9,172,94,78,2,30,1,1
21342,28,0,0,70,70,0,1,0,1,0
2098,27,0,0,60,60,0,1,0,1,0
15294,15,20291,11,1462,703,759,8,16,5,3
11352,28,0,0,70,70,0,1,0,1,0
7037,26,7356,16,554,280,274,9,111,5,4
10457,28,0,0,70,70,0,1,0,1,0
1879,1017,0,0,62,62,0,1,0,1,0
14111,26,22267,16,8714,1456,7258,25,32,13,12
15315,26,4656,16,456259,379546,76713,1179,364,656,523
628,10,2524,9,217,87,130,2,30,1,1
21999,10,14078,9,935,334,601,8,62,4,4
7326,1649,0,0,60,60,0,1,0,1,0
9794,26,619,16,9741,7503,2238,24,32,14,10
3785,2477,0,0,60,60,0,1,0,1,0
20007,28,0,0,66,66,0,1,0,1,0
532,247,0,0,3498,1872,1626,48,201,24,24
10673,28,0,0,70,70,0,1,0,1,0
17502,28,0,0,70,70,0,1,0,1,0
14153,10,6883,9,711,87,624,2,30,1,1
15416,1437,5665,1091,70,70,0,1,5,1,0
1810,1539,0,0,62,62,0,1,0,1,0
20789,28,0,0,70,70,0,1,0,1,0
16945,28,0,0,70,70,0,1,0,1,0
1909,2239,15333,1734,481,150,331,2,1200,1,1
22403,2604,0,0,66,66,0,1,0,1,0
18010,26,5978,16,694,370,324,12,34,7,5
2141,1086,0,0,62,62,0,1,0,1,0
19748,26,27527,16,4338,1431,2907,19,30,11,8
37,1147,0,0,146,146,0,1,0,1,0
16951,255,0,0,62,62,0,1,0,1,0
5598,3216,0,0,66,66,0,1,0,1,0
16219,3216,0,0,66,66,0,1,0,1,0
2842,2883,0,0,146,146,0,1,0,1,0
8865,10,17303,9,266,89,177,4,58,2,2
8858,10,14336,9,212,110,102,2,30,1,1
14017,28,0,0,70,70,0,1,0,1,0
21971,10,11829,9,193,102,91,2,31,1,1
18609,2587,0,0,62,62,0,1,0,1,0
21778,28,0,0,70,70,0,1,0,1,0
9984,28,0,0,70,70,0,1,0,1,0
7382,2938,0,0,74,74,0,1,0,1,0
12177,28,0,0,70,70,0,1,0,1,0
21151,1882,28764,1437,70,70,0,1,5,1,0
13801,28,0,0,70,70,0,1,0,1,0
17899,1215,0,0,62,62,0,1,0,1,0
8038,1017,0,0,146,146,0,1,0,1,0
15784,2636,0,0,66,66,0,1,0,1,0
15803,10,21590,9,183,94,89,2,31,1,1
11453,28,0,0,70,70,0,1,0,1,0
13756,10,10388,9,194,94,100,2,30,1,1
9561,15,10969,11,1658,1247,411,8,15,5,3
15102,28,0,0,70,70,0,1,0,1,0
2327,1147,0,0,62,62,0,1,0,1,0
12237,15,13642,11,405,285,120,5,15,3,2
980,15,8363,11,318,192,126,6,26,4,2
20257,26,22356,16,14518,2409,12109,23,135,10,13
15846,28,0,0,70,70,0,1,0,1,0
8522,10,6969,9,186,95,91,2,0,1,1
16478,346,0,0,60,60,0,1,0,1,0
22705,10,19765,9,749,94,655,2,31,1,1
3804,26,22989,16,8904,1058,7846,18,31,9,9
15504,26,13773,16,34750,2997,31753,61,95,29,32
4445,2883,0,0,62,62,0,1,0,1,0
14348,28,0,0,70,70,0,1,0,1,0
1688,2256,0,0,66,66,0,1,0,1,0
3982,26,5129,16,146299,21774,124525,246,141,98,148
8393,26,21375,16,118943,24432,94511,156,96,79,77
12101,26,21358,16,4681,2403,2278,19,135,10,9
3247,3212,0,0,66,66,0,1,0,1,0
10653,983,0,0,66,66,0,1,0,1,0
9176,10,13252,9,209,102,107,2,30,1,1
17249,26,24216,16,5166,700,4466,16,15,7,9
11344,26,11867,16,3188,1601,1587,34,48,18,16
10812,28,0,0,66,66,0,1,0,1,0
6552,2093,0,0,145,145,0,1,0,1,0
15553,28,0,0,70,70,0,1,0,1,0
3562,26,20153,16,12017,2031,9986,38,216,18,20
8286,26,13030,16,5144,847,4297,16,132,9,7
14488,28,0,0,70,70,0,1,0,1,0
16963,28,0,0,70,70,0,1,0,1,0
5645,26,12085,16,4397,2104,2293,29,85,11,18
21156,1797,0,0,66,66,0,1,0,1,0
8339,28,0,0,70,70,0,1,0,1,0
1623,3216,0,0,62,62,0,1,0,1,0
20522,10,23509,9,304,86,218,2,30,1,1
13938,28,0,0,70,70,0,1,0,1,0
2947,1017,0,0,146,146,0,1,0,1,0
11598,280,24332,177,841,535,306,10,14,5,5
21390,15,11788,11,2575,635,1940,12,36,7,5
7405,7,0,0,60,60,0,1,0,1,0
14542,10,987,9,209,110,99,2,30,1,1
3930,26,23759,16,800,452,348,12,94,7,5
15353,1771,0,0,66,66,0,1,0,1,0
10826,2483,13784,1931,70,70,0,1,5,1,0
15841,1017,0,0,66,66,0,1,0,1,0
15686,10,25533,9,199,102,97,2,29,1,1
8585,10,1121,9,343,100,243,4,52,2,2
14769,28,0,0,66,66,0,1,0,1,0
7472,26,8766,16,6035,1758,4277,27,1169,15,12
19636,26,27449,16,88574,15708,72866,114,176,52,62
6742,7,0,0,60,60,0,1,0,1,0
17937,26,2410,16,27406,15466,11940,123,188,62,61
8576,10,27948,9,177,94,83,2,30,1,1
11019,1436,11163,1090,160,70,90,2,5,1,1
18128,26,12031,16,711172,27430,683742,812,104,342,470
20863,3139,0,0,66,66,0,1,0,1,0
12147,26,2650,16,5124,979,4145,19,54,10,9
12847,234,11224,149,2493,1541,952,16,3601,8,8
2744,1244,5603,924,1616,126,1490,4,30,2,2
9963,28,0,0,66,66,0,1,0,1,0
9322,1147,0,0,62,62,0,1,0,1,0
9192,10,6821,9,210,102,108,2,30,1,1
22197,10,11711,9,180,94,86,2,30,1,1
1279,509,0,0,62,62,0,1,0,1,0
22288,10,18056,9,193,102,91,2,29,1,1
20168,28,0,0,70,70,0,1,0,1,0
15707,10,1078,9,172,88,84,2,31,1,1
14958,15,3407,11,1633,943,690,15,72,8,7
9313,2938,0,0,146,146,0,1,0,1,0
7317,26,13561,16,6617,1852,4765,23,132,13,10
22249,10,4400,9,178,94,84,2,29,1,1
12433,2026,5546,1555,70,70,0,2,7,2,0
15462,10,9372,9,211,110,101,2,30,1,1
21701,10,4342,9,170,87,83,2,30,1,1
8268,676,4172,475,130,70,60,2,5,1,1
11413,28,0,0,66,66,0,1,0,1,0
14033,10,396,9,778,103,675,2,30,1,1
5389,344,0,0,148,148,0,1,0,1,0
13811,10,892,9,193,102,91,2,29,1,1
12507,1017,0,0,62,62,0,1,0,1,0
3489,2256,0,0,66,66,0,1,0,1,0
12,3042,0,0,60,60,0,1,0,1,0
6958,10,19360,9,198,89,109,2,30,1,1
15255,23,0,0,15721,6203,9518,50,30,25,25
2427,1017,0,0,62,62,0,1,0,1,0
16563,15,25740,11,125299,3364,121935,129,19,44,85
5029,26,16578,16,4662,1755,2907,19,30,11,8
9329,26,21842,16,5206,1389,3817,22,15,10,12
16841,26,10688,16,3024,709,2315,13,120,6,7
8936,15,3572,11,254,128,126,5,15,3,2
428,2852,0,0,66,66,0,1,0,1,0
18518,26,9678,16,25055,5440,19615,65,84,35,30
20943,28,0,0,70,70,0,1,0,1,0
13708,26,15753,16,7993,677,7316,16,15,8,8
1943,1017,0,0,146,146,0,1,0,1,0
19721,28,0,0,70,70,0,1,0,1,0
575,2205,0,0,74,74,0,1,0,1,0
19782,15,8471,11,668,224,444,10,18,4,6
19554,26,18861,16,9676,2327,7349,25,16,15,10
21868,10,6519,9,193,94,99,2,30,1,1
1731,169,17333,116,480,149,331,2,1200,1,1
15934,10,11193,9,2235,93,2142,4,30,2,2
4082,15,11830,11,1151,711,440,10,15,5,5
8414,15,21394,11,135755,6750,129005,160,22,68,92
12664,2085,16704,1607,70,70,0,2,8,2,0
14530,10,25762,9,770,102,668,2,30,1,1
13598,10,0,0,631,74,557,2,30,1,1
5906,26,11445,16,234,234,0,4,12,4,0
14253,469,7523,304,564,318,246,9,15,5,4
19685,28,0,0,70,70,0,1,0,1,0
16560,28,0,0,70,70,0,1,0,1,0
5300,10,0,0,86,86,0,1,30,1,0
11181,1497,21652,1138,66,66,0,1,5,1,0
7282,26,17627,16,8600,4882,3718,44,225,23,21
5814,26,3730,16,10803,4485,6318,36,345,19,17
2744,1238,1492,918,884,126,758,2,31,1,1
11078,2218,2893,1719,160,70,90,2,5,1,1
10037,26,5550,16,124,64,60,2,15,1,1
7031,26,7721,16,5440,846,4594,15,15,9,6
1231,509,0,0,62,62,0,1,0,1,0
18270,26,360,16,7292,950,6342,19,125,9,10
6143,26,19252,16,12146,2681,9465,63,4156,25,38
5419,26,11370,16,29226,2150,27076,44,30,19,25
9728,3148,27503,2439,161,161,0,2,1199,2,0
15521,10,24495,9,183,94,89,2,29,1,1
12668,2621,2714,2032,70,70,0,2,8,2,0
13615,10,24268,9,375,99,276,4,54,2,2
5738,3216,0,0,62,62,0,1,0,1,0
15321,26,10761,16,8006,1986,6020,20,15,11,9
22245,10,1388,9,199,102,97,2,30,1,1
11215,599,5463,410,70,70,0,1,4,1,0
21205,28,0,0,70,70,0,1,0,1,0
7850,1663,0,0,106,106,0,1,61,1,0
9657,28,0,0,70,70,0,1,0,1,0
10653,676,23839,475,130,70,60,2,5,1,1
1614,1797,0,0,62,62,0,1,0,1,0
3017,1880,0,0,62,62,0,1,0,1,0
13122,26,4599,16,3149,769,2380,10,120,5,5
21670,10,20816,9,216,94,122,2,30,1,1
8857,10,19044,9,378,127,251,2,30,1,1
12683,28,0,0,70,70,0,1,0,1,0
16951,255,0,0,62,62,0,1,0,1,0
2749,2636,0,0,66,66,0,1,0,1,0
4804,255,0,0,60,60,0,1,0,1,0
1330,2943,0,0,62,62,0,1,0,1,0
7027,26,13279,16,414,140,274,7,26,3,4
15690,10,28732,9,193,102,91,2,30,1,1
18469,26,8728,16,8404,1892,6512,23,30,12,11
22356,10,5587,9,177,94,83,2,30,1,1
14801,10,9864,9,184,102,82,2,30,1,1
637,1490,27209,1132,150,150,0,1,1200,1,0
20509,26,28792,16,1864,250,1614,8,120,4,4
15185,26,2105,16,100002,5891,94111,138,44,60,78
12834,10,0,0,202,86,116,2,30,1,1
11970,26,12235,16,6715,1415,5300,27,84,14,13
2621,6,0,0,60,60,0,1,0,1,0
18473,28,0,0,70,70,0,1,0,1,0
3013,1771,0,0,146,146,0,1,0,1,0
15449,10,18734,9,167,86,81,2,30,1,1
21202,28,0,0,70,70,0,1,0,1,0
5854,26,1072,16,197239,6098,191141,213,170,75,138
17720,28,0,0,70,70,0,1,0,1,0
2070,1888,0,0,66,66,0,1,0,1,0
636,287,10165,184,228,118,110,2,1199,1,1
19646,1147,0,0,66,66,0,1,0,1,0
2724,1240,4825,920,422,164,258,6,30,3,3
18676,28,0,0,66,66,0,1,0,1,0
12852,28,0,0,70,70,0,1,0,1,0
12562,26,10454,16,499,425,74,4,0,3,1
9053,28,0,0,66,66,0,1,0,1,0
20176,2256,0,0,66,66,0,1,0,1,0
10078,15,15550,11,5870176,83236,5786940,5053,78,1161,3892
21774,28,0,0,70,70,0,1,0,1,0
2720,26,28777,16,10633,2672,7961,31,20,16,15
17958,28,0,0,66,66,0,1,0,1,0
1481,1147,0,0,62,62,0,1,0,1,0
14897,10,21769,9,183,94,89,2,30,1,1
2791,983,0,0,66,66,0,1,0,1,0
20524,2938,0,0,74,74,0,1,0,1,0
19127,28,0,0,70,70,0,1,0,1,0
4693,26,13377,16,3936,1618,2318,26,146,14,12
360,3105,0,0,252,252,0,1,0,1,0
12987,28,0,0,70,70,0,1,0,1,0
20124,28,0,0,70,70,0,1,0,1,0
9465,10,7993,9,754,94,660,2,29,1,1
22432,1054,0,0,66,66,0,1,0,1,0
20227,28,0,0,70,70,0,1,0,1,0
2739,1425,0,0,146,146,0,1,0,1,0
15517,1792,0,0,62,62,0,1,0,1,0
6403,10,10839,9,168,78,90,2,30,1,1
7326,1649,0,0,60,60,0,1,0,1,0
3771,26,20408,16,584,370,214,9,26,6,3
21627,28,0,0,66,66,0,1,0,1,0
10555,797,0,0,62,62,0,1,0,1,0
18257,28,0,0,66,66,0,1,0,1,0
13587,360,4436,231,280,214,66,2,30,1,1
15974,26,16130,16,29994,1927,28067,50,20,17,33
6288,2154,0,0,74,74,0,1,0,1,0
16250,28,0,0,70,70,0,1,0,1,0
21012,28,0,0,70,70,0,1,0,1,0
18987,26,19822,16,7201,2107,5094,23,61,13,10
7838,10,3692,9,198,93,105,2,30,1,1
19591,1147,0,0,62,62,0,1,0,1,0
16121,15,25453,11,218150,5323,212827,218,145,69,149
15710,7,0,0,60,60,0,1,0,1,0
13583,188,20724,123,312,140,172,4,30,2,2
5692,10,3252,9,168,78,90,2,29,1,1
17932,26,13407,16,1401,864,537,12,29,6,6
13795,28,0,0,70,70,0,1,0,1,0
21673,10,25231,9,190,97,93,2,31,1,1
21695,10,28645,9,257,101,156,2,33,1,1
8486,10,1483,9,199,94,105,2,30,1,1
12612,636,6815,441,70,70,0,2,8,2,0
19337,28,0,0,70,70,0,1,0,1,0
9650,460,0,0,66,66,0,1,0,1,0
21673,10,11268,9,299,97,202,4,44,2,2
8547,10,2832,9,110,110,0,1,30,1,0
20990,1017,0,0,62,62,0,1,0,1,0
13477,28,0,0,70,70,0,1,0,1,0
1925,2486,0,0,148,148,0,1,0,1,0
4277,26,19134,16,6287,1476,4811,25,16,13,12
9411,695,10626,494,1450,747,703,16,1200,9,7
17351,28,0,0,70,70,0,1,0,1,0
12207,26,9102,16,4670,2814,1856,33,81,15,18
9728,751,10869,539,166,166,0,1,1199,1,0
7674,26,3372,16,7633,5620,2013,31,60,19,12
3644,26,11034,16,45554,1695,43859,50,30,15,35
9045,10,12180,9,395,102,293,2,30,1,1
8508,10,8748,9,392,86,306,2,29,1,1
10555,28,0,0,66,66,0,1,0,1,0
2393,2093,0,0,145,145,0,1,0,1,0
10837,28,0,0,70,70,0,1,0,1,0
3410,10,10241,9,164,78,86,2,30,1,1
19241,26,23921,16,31111,6287,24824,62,247,25,37
16448,10,11266,9,220,78,142,2,30,1,1
15274,15,2789,11,64386,3122,61264,79,64,35,44
16105,26,25438,16,881747,19604,862143,728,175,144,584
15492,10,8216,9,186,95,91,2,31,1,1
22236,10,27152,9,194,102,92,2,29,1,1
15248,10,11062,9,193,102,91,2,30,1,1
615,18,0,0,90,90,0,1,0,1,0
13055,26,2198,16,5904,1876,4028,18,18,10,8
9349,28,0,0,70,70,0,1,0,1,0
17686,28,0,0,66,66,0,1,0,1,0
16188,10,18106,9,168,78,90,2,30,1,1
18946,10,23029,9,164,78,86,2,29,1,1
14860,10,12070,9,183,94,89,2,30,1,1
15998,28,0,0,70,70,0,1,0,1,0
1330,918,0,0,62,62,0,1,0,1,0
20989,518,14293,342,4501,3174,1327,26,61,16,10
8153,26,17211,16,448,78,370,6,25,1,5
9189,10,14153,9,761,102,659,2,30,1,1
12374,785,23138,570,492,306,186,8,15,5,3
15125,26,9294,16,13979,2593,11386,29,114,11,18
18731,28,0,0,70,70,0,1,0,1,0
15768,10,17030,9,183,94,89,2,30,1,1
20615,26,28077,16,6792,1521,5271,18,28,11,7
13971,18,2055,13,184,94,90,2,30,1,1
11998,28,0,0,70,70,0,1,0,1,0
20521,28,0,0,70,70,0,1,0,1,0
10521,10,2403,9,417,86,331,2,31,1,1
2810,232,26702,147,8039,1649,6390,41,357,13,28
10088,10,12821,9,264,264,0,4,47,4,0
1661,561,0,0,66,66,0,1,0,1,0
20692,28,0,0,70,70,0,1,0,1,0
16937,10,1729,9,256,94,162,2,29,1,1
16951,255,0,0,62,62,0,1,0,1,0
15010,10,12067,9,177,94,83,2,31,1,1
14901,10,20710,9,183,94,89,2,31,1,1
2548,2164,0,0,60,60,0,1,0,1,0
19710,28,0,0,70,70,0,1,0,1,0
19749,28,0,0,70,70,0,1,0,1,0
11823,26,4253,16,70,70,0,1,5,1,0
20260,2587,0,0,66,66,0,1,0,1,0
8868,10,12452,9,771,102,669,2,31,1,1
15580,10,2092,9,183,94,89,2,30,1,1
12762,28,0,0,70,70,0,1,0,1,0
7550,2938,0,0,62,62,0,1,0,1,0
10924,28,0,0,70,70,0,1,0,1,0
2213,2636,0,0,62,62,0,1,0,1,0
10947,1186,10620,875,70,70,0,1,5,1,0
9553,28,0,0,66,66,0,1,0,1,0
20975,26,7932,16,333668,12291,321377,321,170,72,249
20048,28,0,0,70,70,0,1,0,1,0
8949,28,0,0,66,66,0,1,0,1,0
18623,28,0,0,66,66,0,1,0,1,0
5161,234,8959,149,6033,1874,4159,33,4073,11,22
15942,10,24862,9,197,102,95,2,30,1,1
20281,2639,27482,2047,70,70,0,1,4,1,0
13038,28,0,0,70,70,0,1,0,1,0
12542,2627,5803,2037,70,70,0,2,7,2,0
2361,10,9721,9,242,98,144,2,30,1,1
13559,26,17588,16,602278,26008,576270,748,396,317,431
6250,1995,5503,1525,148,86,62,2,30,1,1
14117,28,0,0,66,66,0,1,0,1,0
22268,1771,0,0,66,66,0,1,0,1,0
15037,28,0,0,70,70,0,1,0,1,0
10949,15,15156,11,16004,8270,7734,32,57,17,15
4347,1147,0,0,62,62,0,1,0,1,0
8584,1238,9181,918,78,78,0,1,30,1,0
3229,10,13774,9,200,90,110,2,30,1,1
8434,10,12282,9,184,94,90,2,30,1,1
4767,26,17370,16,296068,21814,274254,358,206,150,208
22068,10,2696,9,248,102,146,2,29,1,1
697,2587,0,0,62,62,0,1,0,1,0
19381,28,0,0,66,66,0,1,0,1,0
4409,15,13602,11,16274,9170,7104,34,32,19,15
9803,26,25518,16,7128,2589,4539,25,37,15,10
15302,10,24749,9,168,86,82,3,50,2,1
8338,10,2474,9,199,102,97,2,30,1,1
10907,10,12265,9,254,78,176,2,29,1,1
21306,26,5973,16,252,70,182,3,120,1,2
12615,405,16591,263,320,140,180,6,5,3,3
15646,232,14698,147,15600,7789,7811,155,169,82,73
14167,28,0,0,70,70,0,1,0,1,0
17091,697,0,0,66,66,0,1,0,1,0
16001,28,0,0,70,70,0,1,0,1,0
2744,1236,18128,916,879,126,753,2,30,1,1
9286,10,25996,9,183,94,89,2,29,1,1
7659,10,1414,9,168,78,90,2,30,1,1
13558,15,17989,11,1222,782,440,11,15,6,5
5051,2930,0,0,62,62,0,1,0,1,0
22558,10,26363,9,199,102,97,2,31,1,1
15855,28,0,0,66,66,0,1,0,1,0
12012,26,26994,16,12409,2224,10185,36,26,19,17
9664,26,14920,16,9942,1211,8731,26,77,14,12
22702,10,22385,9,216,102,114,2,30,1,1
4382,26,6649,16,4590,3104,1486,25,95,14,11
11010,15,563,11,366,240,126,7,25,5,2
11410,26,17065,16,1369,708,661,14,24,8,6
9714,15,28485,11,318,192,126,6,26,4,2
6299,18,14884,13,184,94,90,2,30,1,1
19756,28,0,0,70,70,0,1,0,1,0
22345,10,2128,9,774,101,673,2,31,1,1
1772,1147,0,0,146,146,0,1,0,1,0
12587,999,12846,736,320,140,180,6,7,3,3
19785,28,0,0,66,66,0,1,0,1,0
19923,28,0,0,70,70,0,1,0,1,0
10506,10,8918,9,168,78,90,2,30,1,1
15828,10,109,9,228,102,126,2,30,1,1
21651,10,9754,9,193,102,91,2,30,1,1
21901,10,21877,9,183,94,89,2,29,1,1
465,10,1640,9,197,90,107,2,30,1,1
22096,10,19743,9,292,94,198,4,57,2,2
5539,15,7437,11,1035,564,471,10,15,5,5
11787,1019,0,0,62,62,0,1,0,1,0
5113,26,9873,16,90166,3481,86685,96,16,31,65
15446,983,0,0,74,74,0,1,0,1,0
9886,28,0,0,70,70,0,1,0,1,0
7188,23,0,0,5858,2302,3556,22,30,11,11
14124,10,15039,9,177,94,83,2,30,1,1
9950,26,14225,16,2719275,48822,2670453,2459,127,689,1770
10010,7,0,0,60,60,0,1,0,1,0
22030,1282,0,0,66,66,0,1,0,1,0
9597,28,0,0,66,66,0,1,0,1,0
13740,26,10181,16,101356,10743,90613,178,31,90,88
1519,2256,0,0,66,66,0,1,0,1,0
3345,3,0,0,60,60,0,1,0,1,0
22534,10,8573,9,200,102,98,2,30,1,1
8675,26,6049,16,17660,7465,10195,44,201,23,21
14065,28,0,0,70,70,0,1,0,1,0
21566,10,5148,9,404,102,302,2,30,1,1
6938,1147,0,0,66,66,0,1,0,1,0
19211,26,12971,16,134322,10347,123975,220,304,77,143
7126,26,3725,16,11147,3412,7735,36,458,20,16
12661,26,9361,16,499,425,74,4,0,3,1
8695,28,0,0,70,70,0,1,0,1,0
20004,1147,0,0,66,66,0,1,0,1,0
10442,1482,0,0,66,66,0,1,0,1,0
13802,28,0,0,70,70,0,1,0,1,0
4166,15,9041,11,1283,644,639,9,146,5,4
22083,10,22544,9,200,102,98,2,30,1,1
12,2964,0,0,60,60,0,1,0,1,0
17469,28,0,0,70,70,0,1,0,1,0
17610,28,0,0,70,70,0,1,0,1,0
17340,28,0,0,70,70,0,1,0,1,0
18482,1676,7383,1282,504,318,186,8,16,5,3
19369,26,20980,16,30516,3311,27205,49,47,25,24
9039,10,19664,9,445,94,351,2,30,1,1
14956,10,2865,9,216,110,106,2,31,1,1
8858,10,29075,9,212,110,102,2,30,1,1
1242,1017,0,0,146,146,0,1,0,1,0
15353,1771,0,0,66,66,0,1,0,1,0
12028,28,0,0,70,70,0,1,0,1,0
22480,28,0,0,70,70,0,1,0,1,0
636,280,0,0,146,146,0,1,0,1,0
2744,1199,1231,887,886,126,760,2,31,1,1
18401,1472,0,0,66,66,0,1,0,1,0
21625,10,19696,9,239,102,137,2,30,1,1
21803,10,22312,9,184,94,90,2,30,1,1
9299,1763,0,0,62,62,0,1,0,1,0
12086,1147,0,0,66,66,0,1,0,1,0
639,2349,0,0,143,143,0,1,0,1,0
8793,28,0,0,70,70,0,1,0,1,0
22480,10,7607,9,732,89,643,2,30,1,1
12418,26,16656,16,117116,5692,111424,153,18,56,97
2094,10,24068,9,208,86,122,2,30,1,1
11405,26,8711,16,132575,6675,125900,206,94,91,115
1233,3216,0,0,62,62,0,1,0,1,0
13071,28,0,0,70,70,0,1,0,1,0
16951,255,0,0,62,62,0,1,0,1,0
497,653,0,0,167,167,0,1,0,1,0
360,3105,0,0,180,180,0,1,0,1,0
14156,10,1224,9,214,110,104,2,30,1,1
20556,1147,0,0,62,62,0,1,0,1,0
14252,10,11562,9,701,88,613,2,30,1,1
13675,26,18958,16,6724,3642,3082,18,133,10,8
20518,26,26061,16,512,166,346,2,30,1,1
11128,28,0,0,70,70,0,1,0,1,0
22537,10,3451,9,180,94,86,2,35,1,1
11583,2256,0,0,62,62,0,1,0,1,0
20737,28,0,0,66,66,0,1,0,1,0
1804,1025,0,0,60,60,0,1,0,1,0
9411,2075,27030,1599,330,330,0,6,1200,6,0
21570,10,21476,9,319,126,193,2,30,1,1
21630,10,9213,9,193,102,91,2,29,1,1
16546,28,0,0,66,66,0,1,0,1,0
22507,10,27037,9,402,118,284,2,30,1,1
14326,10,5357,9,742,88,654,2,31,1,1
16610,28,0,0,70,70,0,1,0,1,0
9266,10,17582,9,179,94,85,2,30,1,1
13644,10,27621,9,166,86,80,2,29,1,1
17136,26,14168,16,383990,15580,368410,490,212,192,298
21767,10,15931,9,168,86,82,2,30,1,1
15716,28,0,0,70,70,0,1,0,1,0
14966,10,9410,9,249,85,164,4,55,2,2
22187,10,9275,9,186,95,91,2,31,1,1
14836,10,14539,9,751,95,656,2,30,1,1
17964,28,0,0,66,66,0,1,0,1,0
536,3216,0,0,62,62,0,1,0,1,0
2322,697,0,0,62,62,0,1,0,1,0
16458,28,0,0,70,70,0,1,0,1,0
11033,2235,0,0,66,66,0,1,0,1,0
19143,28,0,0,70,70,0,1,0,1,0
16374,26,19296,16,1798,1159,639,17,170,10,7
179,10,22566,9,210,78,132,2,30,1,1
8431,26,29000,16,2424,258,2166,9,120,4,5
13747,10,17695,9,194,102,92,2,30,1,1
14791,28,0,0,70,70,0,1,0,1,0
14906,28,0,0,66,66,0,1,0,1,0
9876,28,0,0,66,66,0,1,0,1,0
13710,10,16449,9,177,94,83,2,29,1,1
2744,2664,6980,2071,901,126,775,2,30,1,1
14697,2938,0,0,66,66,0,1,0,1,0
251,155,0,0,62,62,0,1,0,1,0
16980,26,27398,16,6144,939,5205,18,70,9,9
14176,10,9262,9,1417,96,1321,4,30,2,2
11175,1821,25796,1388,316,136,180,6,6,3,3
16021,2403,5556,1869,528,528,0,9,1200,9,0
4894,26,20210,16,2849678,105912,2743766,3255,124,1284,1971
10326,26,23625,16,7647,1917,5730,22,80,13,9
7067,26,6945,16,2293,1592,701,16,21,8,8
7751,26,16609,16,6007,1727,4280,27,1128,15,12
12639,28,0,0,70,70,0,1,0,1,0
14002,10,9046,9,168,86,82,2,31,1,1
5410,391,0,0,60,60,0,1,0,1,0
8507,10,18915,9,94,94,0,1,30,1,0
18047,26,18046,16,2979,914,2065,10,120,5,5
7513,26,4367,16,7068,2016,5052,32,18,17,15
16588,28,0,0,70,70,0,1,0,1,0
18516,1017,0,0,146,146,0,1,0,1,0
12415,905,2386,669,70,70,0,1,4,1,0
419,10,1321,9,231,88,143,2,33,1,1
9159,10,1577,9,99,99,0,1,30,1,0
21910,10,2433,9,168,78,90,2,30,1,1
15234,26,10841,16,1579,988,591,13,24,7,6
12752,1215,0,0,66,66,0,1,0,1,0
7458,10,20096,9,262,106,156,2,31,1,1
13950,10,23743,9,180,94,86,2,30,1,1
21979,28,0,0,70,70,0,1,0,1,0
1079,26,5573,16,5316,488,4828,14,15,7,7
1326,10,4430,9,832,106,726,2,30,1,1
15285,10,25619,9,177,94,83,2,30,1,1
19715,26,5154,16,3698,1049,2649,13,135,6,7
11748,26,15656,16,7118,2239,4879,22,15,12,10
12230,28,0,0,70,70,0,1,0,1,0
22564,10,797,9,197,102,95,2,30,1,1
9151,28,0,0,70,70,0,1,0,1,0
19109,28,0,0,66,66,0,1,0,1,0
14757,10,6282,9,193,102,91,2,30,1,1
20010,28,0,0,66,66,0,1,0,1,0
6475,15,18643,11,1246,533,713,10,20,5,5
13780,10,20895,9,744,95,649,2,30,1,1
8350,10,24573,9,177,94,83,2,30,1,1
8512,15,21441,11,450,246,204,8,142,5,3
7238,26,22323,16,6450,1003,5447,21,360,11,10
17180,26,13975,16,1413,876,537,12,11,6,6
19428,242,0,0,145,145,0,1,0,1,0
18301,28,0,0,66,66,0,1,0,1,0
8402,10,18852,9,164,78,86,2,29,1,1
15282,26,430,16,5928,1558,4370,22,20,13,9
14022,10,27490,9,710,89,621,2,0,1,1
9900,15,22153,11,514,246,268,9,42,5,4
9053,10,7124,9,194,99,95,2,30,1,1
12804,2938,0,0,62,62,0,1,0,1,0
9349,26,24431,16,29124,1724,27400,41,160,16,25
12162,28,0,0,70,70,0,1,0,1,0
13800,10,17036,9,184,94,90,2,30,1,1
4003,26,15649,16,6821,1076,5745,21,27,12,9
15035,28,0,0,70,70,0,1,0,1,0
14939,10,6588,9,104,104,0,1,30,1,0
10625,28,0,0,70,70,0,1,0,1,0
6250,2003,11411,1533,207,85,122,4,29,2,2
19422,28,0,0,70,70,0,1,0,1,0
14874,1147,0,0,66,66,0,1,0,1,0
14607,10,18603,9,177,94,83,2,30,1,1
9244,15,2645,11,3326,684,2642,12,15,7,5
443,1771,0,0,66,66,0,1,0,1,0
9472,104,0,0,60,60,0,1,0,1,0
9911,26,18083,16,6350,1369,4981,18,151,9,9
15298,10,1124,9,198,94,104,2,30,1,1
9348,28,0,0,70,70,0,1,0,1,0
13726,10,12056,9,177,94,83,2,30,1,1
11371,1472,0,0,66,66,0,1,0,1,0
21351,10,10644,9,255,102,153,2,30,1,1
15397,1950,15083,1487,70,70,0,1,5,1,0
12126,28,0,0,70,70,0,1,0,1,0
1682,2256,0,0,62,62,0,1,0,1,0
16951,255,0,0,62,62,0,1,0,1,0
8367,1889,15472,1442,70,70,0,2,8,2,0
21532,10,15582,9,239,94,145,2,30,1,1
18701,28,0,0,70,70,0,1,0,1,0
15764,10,27959,9,195,102,93,2,31,1,1
7211,1147,0,0,62,62,0,1,0,1,0
10700,989,5992,730,1345,679,666,9,30,5,4
9966,26,2780,16,388366,15919,372447,435,219,158,277
1403,2486,0,0,66,66,0,1,0,1,0
18332,1017,0,0,66,66,0,1,0,1,0
10561,28,0,0,66,66,0,1,0,1,0
15603,28,0,0,66,66,0,1,0,1,0
17550,15,26317,11,107838,4143,103695,178,15,59,119
14542,10,18574,9,193,102,91,2,30,1,1
14797,10,3032,9,761,100,661,2,31,1,1
10747,3176,26006,2462,66,66,0,1,5,1,0
8925,10,6610,9,216,110,106,2,29,1,1
5777,10,17988,9,168,78,90,2,29,1,1
12403,28,0,0,66,66,0,1,0,1,0
8941,15,8522,11,1302,849,453,10,126,6,4
20024,28,0,0,70,70,0,1,0,1,0
18898,28,0,0,66,66,0,1,0,1,0
11785,15,10070,11,54968,1915,53053,71,125,24,47
121,2256,0,0,62,62,0,1,0,1,0
13647,28,0,0,70,70,0,1,0,1,0
5606,1989,3495,1519,148,86,62,2,29,1,1
1458,10,5113,9,197,90,107,2,30,1,1
1696,1888,0,0,62,62,0,1,0,1,0
4020,26,2757,16,1558,971,587,14,123,8,6
14486,10,23744,9,189,102,87,2,30,1,1
637,1253,6852,933,1200,1200,0,9,1201,9,0
19362,26,4378,16,12420,4900,7520,47,88,24,23
19,1773,0,0,62,62,0,1,0,1,0
10644,10,13475,9,284,86,198,2,30,1,1
8171,1073,0,0,60,60,0,1,0,1,0
3074,1479,0,0,181,181,0,1,0,1,0
15305,26,3011,16,347884,9284,338600,360,31,125,235
11240,26,14491,16,6294,1716,4578,27,23,16,11
13752,10,967,9,711,87,624,2,30,1,1
22178,1268,15180,948,736,462,274,2,30,1,1
11153,104,0,0,60,60,0,1,0,1,0
13353,28,0,0,70,70,0,1,0,1,0
7789,956,0,0,66,66,0,1,0,1,0
3738,26,14748,16,6397,1590,4807,23,315,12,11
15224,10,13177,9,168,94,74,2,30,1,1
37,2486,0,0,62,62,0,1,0,1,0
19433,10,3770,9,376,86,290,2,29,1,1
17372,2953,0,0,62,62,0,1,0,1,0
10944,232,64,147,5141,2331,2810,41,144,24,17
10051,26,20748,16,6412,1370,5042,19,129,9,10
21647,10,9621,9,181,86,95,2,29,1,1
6250,1993,7039,1523,216,94,122,4,29,2,2
10520,28,0,0,70,70,0,1,0,1,0
4651,26,17530,16,149229,139639,9590,226,256,124,102
705,672,0,0,157,157,0,1,0,1,0
18183,26,26744,16,2357,1467,890,15,140,8,7
21588,10,27467,9,311,94,217,2,30,1,1
3040,10,12638,9,226,89,137,2,30,1,1
7857,1147,0,0,62,62,0,1,0,1,0
8996,1472,0,0,62,62,0,1,0,1,0
4350,155,0,0,62,62,0,1,0,1,0
15738,28,0,0,66,66,0,1,0,1,0
4525,15,4725,11,130,70,60,2,15,1,1
17664,2587,0,0,62,62,0,1,0,1,0
22473,28,0,0,70,70,0,1,0,1,0
18,2938,0,0,62,62,0,1,0,1,0
11228,574,7091,388,70,70,0,1,5,1,0
9929,28,0,0,66,66,0,1,0,1,0
14278,10,1442,9,179,94,85,2,29,1,1
13883,10,5574,9,259,87,172,4,56,2,2
17459,28,0,0,70,70,0,1,0,1,0
11199,15,19254,11,362,240,122,7,17,5,2
15156,26,24255,16,2343,1296,1047,17,196,10,7
14547,28,0,0,66,66,0,1,0,1,0
17548,28,0,0,66,66,0,1,0,1,0
14726,10,10509,9,245,94,151,2,30,1,1
13026,10,5017,9,274,78,196,2,30,1,1
8344,10,11395,9,184,94,90,2,30,1,1
17483,28,0,0,70,70,0,1,0,1,0
12593,28,0,0,66,66,0,1,0,1,0
3214,1147,0,0,66,66,0,1,0,1,0
21953,26,10005,16,18620,15824,2796,31,129,18,13
18,2938,0,0,72,72,0,1,0,1,0
9788,232,13994,147,11661,4442,7219,87,71,41,46
17852,28,0,0,66,66,0,1,0,1,0
11599,28,0,0,66,66,0,1,0,1,0
12388,2256,0,0,62,62,0,1,0,1,0
20851,28,0,0,70,70,0,1,0,1,0
13302,10,16074,9,102,102,0,1,30,1,0
2071,1888,0,0,62,62,0,1,0,1,0
19347,26,12008,16,8947,1130,7817,28,124,13,15
3282,10,13998,9,404,259,145,3,32,2,1
20060,10,4414,9,86,86,0,2,31,2,0
19722,26,28685,16,15246,5574,9672,60,391,27,33
16951,255,0,0,62,62,0,1,0,1,0
15465,10,22452,9,199,102,97,2,31,1,1
1037,2883,0,0,66,66,0,1,0,1,0
20322,2611,0,0,66,66,0,1,0,1,0
9838,15,1736,11,54760,27837,26923,229,175,114,115
8165,15,19865,11,918,461,457,9,15,6,3
21710,10,19710,9,184,94,90,2,30,1,1
10248,15,27743,11,426,240,186,8,21,5,3
14742,1888,0,0,66,66,0,1,0,1,0
20381,28,0,0,70,70,0,1,0,1,0
8171,1073,0,0,60,60,0,1,0,1,0
10295,1888,0,0,62,62,0,1,0,1,0
1909,327,15963,209,490,149,341,2,1200,1,1
12712,26,1540,16,11541,4181,7360,62,283,27,35
21658,10,1653,9,209,102,107,2,30,1,1
8507,26,27859,16,7492336,235716,7256620,8119,428,3022,5097
11694,28,0,0,70,70,0,1,0,1,0
21691,10,28076,9,196,94,102,2,31,1,1
17823,15,26081,11,5326946,116544,5210402,5175,111,1695,3480
7093,676,7208,475,130,70,60,2,5,1,1
8866,26,2393,16,39240,3804,35436,72,133,38,34
10804,1425,0,0,146,146,0,1,0,1,0
16951,255,0,0,62,62,0,1,0,1,0
21128,663,3563,464,66,66,0,2,7,2,0
15173,26,6885,16,8630,2126,6504,20,15,11,9
21397,10,20255,9,255,102,153,2,30,1,1
13374,28,0,0,70,70,0,1,0,1,0
12798,28,0,0,66,66,0,1,0,1,0
352,2953,0,0,66,66,0,1,0,1,0
11845,28,0,0,66,66,0,1,0,1,0
13146,26,24968,16,3970,1726,2244,13,134,6,7
16171,1367,0,0,60,60,0,1,0,1,0
11611,28,0,0,70,70,0,1,0,1,0
13742,15,19977,11,1558,452,1106,11,15,6,5
8982,10,4874,9,167,86,81,2,30,1,1
1428,2636,0,0,62,62,0,1,0,1,0
3158,1017,0,0,62,62,0,1,0,1,0
11242,2619,2805,2030,70,70,0,1,5,1,0
431,2587,0,0,66,66,0,1,0,1,0
19251,28,0,0,70,70,0,1,0,1,0
14849,10,17189,9,170,87,83,2,31,1,1
17268,2953,0,0,62,62,0,1,0,1,0
22055,10,9894,9,196,94,102,2,30,1,1
17209,28,0,0,70,70,0,1,0,1,0
1330,697,0,0,145,145,0,1,0,1,0
21091,10,28362,9,237,91,146,2,33,1,1
22032,10,28999,9,272,93,179,4,32,2,2
8562,26,1696,16,1394,733,661,14,80,8,6
21289,10,27998,9,228,110,118,2,29,1,1
20432,28,0,0,70,70,0,1,0,1,0
22053,10,26445,9,179,94,85,2,30,1,1
14441,10,2586,9,168,86,82,2,31,1,1
21703,10,7281,9,183,94,89,2,30,1,1
17853,255,0,0,60,60,0,1,0,1,0
2784,10,11492,9,194,87,107,2,31,1,1
16471,26,4433,16,5528,3392,2136,31,80,16,15
12429,2189,24172,1694,612,306,306,10,15,5,5
18430,26,2071,16,12979,6398,6581,39,115,22,17
612,25,0,0,60,60,0,1,0,1,0
7357,15,16482,11,5037,1911,3126,18,86,10,8
18333,10,3597,9,233,81,152,2,31,1,1
16951,255,0,0,62,62,0,1,0,1,0
8179,26,9944,16,8504354,221135,8283219,8447,196,2721,5726
15500,10,25181,9,749,94,655,2,31,1,1
12917,28,0,0,70,70,0,1,0,1,0
18912,28,0,0,70,70,0,1,0,1,0
14457,10,13681,9,195,102,93,2,30,1,1
2975,1771,0,0,62,62,0,1,0,1,0
4685,26,27223,16,573,425,148,5,1,3,2
9010,15,23269,11,2644,1918,726,11,89,7,4
19504,28,0,0,70,70,0,1,0,1,0
8152,26,26030,16,12433,4515,7918,32,136,17,15
7191,1,0,0,62,62,0,1,0,1,0
9667,28,0,0,70,70,0,1,0,1,0
639,3269,0,0,143,143,0,1,0,1,0
2372,509,0,0,66,66,0,1,0,1,0
15263,26,16139,16,32780,6864,25916,142,345,57,85
14036,10,2844,9,176,90,86,2,31,1,1
6999,2390,5571,1857,150,150,0,1,1200,1,0
14587,10,14362,9,193,102,91,2,30,1,1
15082,10,3614,9,195,94,101,2,30,1,1
10663,28,0,0,66,66,0,1,0,1,0
8951,28,0,0,66,66,0,1,0,1,0
12136,28,0,0,70,70,0,1,0,1,0
5237,26,27780,16,1768,541,1227,11,20,7,4
5179,10,16718,9,230,99,131,2,30,1,1
10527,28,0,0,70,70,0,1,0,1,0
14776,10,24793,9,233,98,135,2,30,1,1
11603,10,23069,9,414,268,146,3,31,2,1
5720,427,0,0,72,72,0,1,0,1,0
21043,28,0,0,70,70,0,1,0,1,0
6628,26,19898,16,9643,2462,7181,26,146,11,15
24,2256,0,0,146,146,0,1,0,1,0
4915,26,16416,16,14849,2263,12586,29,90,17,12
10842,28,0,0,66,66,0,1,0,1,0
14736,10,7865,9,194,102,92,2,29,1,1
16117,26,25449,16,2512,1466,1046,21,87,10,11
3739,26,21814,16,6396,1589,4807,23,315,12,11
2084,1471,0,0,145,145,0,1,0,1,0
15660,1215,0,0,66,66,0,1,0,1,0
12257,7,0,0,60,60,0,1,0,1,0
2724,1240,21332,920,422,164,258,6,30,3,3
2900,26,18304,16,8805,3429,5376,33,475,16,17
5239,26,1619,16,572,292,280,9,32,5,4
13668,26,1433,16,4962,1352,3610,19,135,9,10
17379,26,25545,16,7398,2209,5189,23,35,11,12
13903,10,3943,9,749,89,660,2,30,1,1
10886,28,0,0,70,70,0,1,0,1,0
10859,2358,16035,1836,70,70,0,2,6,2,0
6507,26,606,16,207714,9731,197983,267,193,120,147
2627,1888,0,0,66,66,0,1,0,1,0
14945,10,14303,9,308,94,214,2,30,1,1
16687,1888,0,0,66,66,0,1,0,1,0
20698,28,0,0,70,70,0,1,0,1,0
13112,295,23877,190,2958,1567,1391,15,15,8,7
10796,26,28232,16,5462,1305,4157,22,121,10,12
14401,345,11179,219,70,70,0,2,8,2,0
8918,2587,0,0,62,62,0,1,0,1,0
1804,192,0,0,60,60,0,1,0,1,0
3074,1479,0,0,181,181,0,1,0,1,0
10646,28,0,0,70,70,0,1,0,1,0
5684,1054,0,0,62,62,0,1,0,1,0
12387,411,0,0,148,148,0,1,0,1,0
19379,26,5734,16,7299,4561,2738,32,193,16,16
22412,10,2373,9,164,84,80,2,31,1,1
21632,2256,0,0,66,66,0,1,0,1,0
10236,15,15225,11,366,240,126,7,21,5,2
10805,2955,26745,2292,70,70,0,2,8,2,0
3031,2611,0,0,62,62,0,1,0,1,0
9237,28,0,0,70,70,0,1,0,1,0
8580,10,6760,9,770,102,668,2,31,1,1
19306,15,13461,11,145440,11034,134406,292,158,135,157
15844,26,8387,16,8960,2778,6182,31,20,16,15
11532,26,7706,16,4479,2526,1953,10,120,6,4
21479,10,13555,9,193,102,91,2,29,1,1
19559,1154,0,0,66,66,0,1,0,1,0
9502,15,13540,11,318,192,126,6,28,4,2
15159,28,0,0,66,66,0,1,0,1,0
8793,10,24416,9,760,97,663,2,30,1,1
16646,3216,0,0,66,66,0,1,0,1,0
18820,923,2148,681,70,70,0,1,5,1,0
6999,689,5256,488,150,150,0,1,1200,1,0
18446,28,0,0,66,66,0,1,0,1,0
16491,26,3590,16,12752,5123,7629,39,90,18,21
10318,26,17616,16,7638,2405,5233,44,17,25,19
20182,2953,0,0,66,66,0,1,0,1,0
12518,26,17440,16,6697,1606,5091,23,24,13,10
9293,10,25771,9,183,94,89,2,29,1,1
12720,26,23658,16,4686,1779,2907,19,30,11,8
5115,26,22339,16,1107678,21465,1086213,1058,16,312,746
12645,1702,9470,1300,70,70,0,1,4,1,0
9214,3256,0,0,60,60,0,1,0,1,0
12002,28,0,0,66,66,0,1,0,1,0
2744,1630,5605,1252,906,126,780,2,30,1,1
12763,26,13703,16,499,425,74,4,0,3,1
16951,255,0,0,62,62,0,1,0,1,0
17064,10,29039,9,268,94,174,2,30,1,1
15336,10,17561,9,788,108,680,2,30,1,1
6172,26,21328,16,2351,1546,805,20,40,11,9
11090,26,7775,16,40726,3421,37305,52,121,20,32
13950,2587,0,0,66,66,0,1,0,1,0
15485,26,7554,16,7618,2859,4759,26,17,14,12
14678,28,0,0,70,70,0,1,0,1,0
1703,3139,0,0,62,62,0,1,0,1,0
10486,1861,0,0,66,66,0,1,0,1,0
5490,7,0,0,60,60,0,1,0,1,0
12395,28,0,0,70,70,0,1,0,1,0
9579,15,5890,11,672,70,602,11,392,2,9
13953,10,7081,9,198,94,104,2,29,1,1
8855,1017,0,0,62,62,0,1,0,1,0
369,1472,0,0,66,66,0,1,0,1,0
20145,299,27784,194,2960,432,2528,11,15,6,5
13280,10,16161,9,197,94,103,2,30,1,1
14441,10,9354,9,184,94,90,2,29,1,1
9370,28,0,0,70,70,0,1,0,1,0
22117,10,28400,9,199,102,97,2,30,1,1
22630,10,1752,9,198,94,104,2,30,1,1
8373,26,2250,16,15982,9199,6783,95,160,40,55
14066,26,10856,16,6292,4834,1458,18,129,11,7
9319,10,17294,9,211,78,133,2,30,1,1
9260,28,0,0,66,66,0,1,0,1,0
7532,26,20194,16,4398,1491,2907,19,29,11,8
7481,10,20121,9,211,80,131,2,30,1,1
21457,10,9686,9,308,110,198,2,29,1,1
15239,26,13619,16,7561,2483,5078,26,20,13,13
11149,2512,22801,1953,160,70,90,2,5,1,1
8584,1318,23085,994,78,78,0,1,30,1,0
8434,26,18392,16,19851,15702,4149,63,109,34,29
10678,15,1250,11,499,192,307,6,38,4,2
3823,10,3152,9,86,86,0,1,30,1,0
11518,26,16236,16,132577,21019,111558,348,236,142,206
13413,28,0,0,66,66,0,1,0,1,0
13375,28,0,0,70,70,0,1,0,1,0
9794,15,3113,11,129929,6216,123713,164,21,74,90
10978,26,12513,16,4876,2559,2317,32,56,18,14
7152,26,3489,16,2814,1454,1360,23,28,12,11
18793,28,0,0,70,70,0,1,0,1,0
12667,254,16897,159,70,70,0,1,4,1,0
1769,1763,0,0,66,66,0,1,0,1,0
17468,10,26258,9,194,87,107,2,30,1,1
16951,255,0,0,62,62,0,1,0,1,0
8588,28,0,0,70,70,0,1,0,1,0
13183,10,0,0,174,79,95,2,30,1,1
13917,10,7106,9,285,103,182,4,50,2,2
21092,28,0,0,70,70,0,1,0,1,0
15083,28,0,0,66,66,0,1,0,1,0
20347,28,0,0,70,70,0,1,0,1,0
16951,255,0,0,62,62,0,1,0,1,0
8674,10,7311,9,199,102,97,2,30,1,1
8914,10,8306,9,763,102,661,2,30,1,1
11306,28,0,0,66,66,0,1,0,1,0
13775,10,10395,9,186,95,91,2,31,1,1
10788,1510,12695,1149,70,70,0,1,5,1,0
9683,15,24317,11,5912,3532,2380,15,31,8,7
3134,2256,0,0,146,146,0,1,0,1,0
14019,10,21199,9,199,102,97,2,30,1,1
3632,2256,0,0,62,62,0,1,0,1,0
0,0,0,0,198,128,70,3,0,2,1
1900,2938,0,0,62,62,0,1,0,1,0
5761,697,0,0,74,74,0,1,0,1,0
10818,15,4913,11,35407,1784,33623,46,20,20,26
12098,15,18512,11,1452,484,968,8,15,5,3
12,120,0,0,97,97,0,1,0,1,0
22069,10,8689,9,199,102,97,2,31,1,1
21111,16,0,0,60,60,0,1,0,1,0
19329,26,10364,16,8005,830,7175,19,27,9,10
15154,3216,0,0,66,66,0,1,0,1,0
9683,28,0,0,66,66,0,1,0,1,0
16982,28,0,0,70,70,0,1,0,1,0
22179,28,0,0,66,66,0,1,0,1,0
1295,10,4335,9,222,90,132,2,30,1,1
16666,28,0,0,70,70,0,1,0,1,0
15220,28,0,0,70,70,0,1,0,1,0
22471,10,15905,9,295,101,194,4,31,2,2
14885,10,13488,9,177,94,83,2,29,1,1
12423,3025,16172,2353,70,70,0,2,8,2,0
18122,26,3156,16,9660,4678,4982,30,144,15,15
22339,10,290,9,339,100,239,4,51,2,2
15120,10,0,0,82,82,0,1,31,1,0
10303,18,20131,13,184,94,90,2,30,1,1
8536,10,28912,9,168,86,82,2,30,1,1
13084,28,0,0,66,66,0,1,0,1,0
19003,28,0,0,70,70,0,1,0,1,0
3151,10,13204,9,227,89,138,2,30,1,1
8843,3216,0,0,62,62,0,1,0,1,0
21519,10,969,9,260,86,174,2,30,1,1
13550,28,0,0,70,70,0,1,0,1,0
10327,1320,19690,996,481,150,331,2,1200,1,1
12527,880,23565,649,64,64,0,1,31,1,0
2536,1167,0,0,62,62,0,1,0,1,0
21605,28,0,0,70,70,0,1,0,1,0
6622,26,20002,16,10015,3476,6539,30,28,19,11
488,2587,0,0,62,62,0,1,0,1,0
13891,10,15687,9,209,110,99,2,30,1,1
8880,15,18253,11,2096,1011,1085,11,130,6,5
20053,188,15181,123,3548,1868,1680,57,87,29,28
10100,28,0,0,70,70,0,1,0,1,0
16557,28,0,0,70,70,0,1,0,1,0
5780,1507,0,0,157,157,0,1,0,1,0
12283,28,0,0,66,66,0,1,0,1,0
2744,1240,26384,920,882,126,756,2,30,1,1
10721,15,23204,11,21064,2772,18292,38,175,18,20
15250,15,15104,11,156,156,0,3,8,3,0
22115,10,17108,9,231,110,121,2,30,1,1
14792,697,0,0,146,146,0,1,0,1,0
21593,10,28593,9,847,110,737,2,30,1,1
5226,10,0,0,82,82,0,2,40,2,0
18728,26,7411,16,4974,836,4138,16,40,8,8
22446,10,18884,9,212,110,102,2,29,1,1
9697,28,0,0,66,66,0,1,0,1,0
18326,28,0,0,70,70,0,1,0,1,0
9961,2587,0,0,66,66,0,1,0,1,0
16444,2881,0,0,90,90,0,1,0,1,0
19742,10,28694,9,374,104,270,4,50,2,2
8359,10,3333,9,212,102,110,2,30,1,1
21806,10,6098,9,194,102,92,2,31,1,1
14099,10,5332,9,188,96,92,2,30,1,1
3429,15,19264,11,1658,1344,314,10,15,5,5
3054,697,0,0,62,62,0,1,0,1,0
2548,2617,0,0,60,60,0,1,0,1,0
455,10,1582,9,300,90,210,2,29,1,1
22526,28,0,0,70,70,0,1,0,1,0
12275,28,0,0,70,70,0,1,0,1,0
14312,28,0,0,70,70,0,1,0,1,0
21127,1501,10772,1141,66,66,0,1,5,1,0
2930,7,0,0,60,60,0,1,0,1,0
21535,10,16971,9,197,102,95,2,29,1,1
15218,26,10007,16,1560,988,572,13,21,7,6
8196,26,16283,16,6353,1075,5278,18,33,10,8
4812,10,641,9,78,78,0,1,30,1,0
12247,28,0,0,70,70,0,1,0,1,0
9835,26,19540,16,152,86,66,2,6,1,1
14564,10,25124,9,184,94,90,2,30,1,1
20206,28,0,0,66,66,0,1,0,1,0
15566,10,21300,9,168,86,82,2,30,1,1
21675,10,18100,9,493,91,402,4,31,2,2
22022,15,3308,11,508,256,252,9,75,5,4
8349,28,0,0,70,70,0,1,0,1,0
9625,28,0,0,66,66,0,1,0,1,0
3219,2573,0,0,145,145,0,1,0,1,0
14208,10,10863,9,190,97,93,2,30,1,1
22121,28,0,0,70,70,0,1,0,1,0
22567,10,27054,9,184,94,90,2,30,1,1
1806,739,21399,530,548,248,300,10,30,5,5
16951,255,0,0,62,62,0,1,0,1,0
22363,1888,0,0,74,74,0,1,0,1,0
21996,28,0,0,70,70,0,1,0,1,0
146,2486,0,0,62,62,0,1,0,1,0
532,247,0,0,3354,1792,1562,46,192,23,23
19921,28,0,0,66,66,0,1,0,1,0
2382,1763,0,0,62,62,0,1,0,1,0
22117,10,171,9,211,102,109,2,30,1,1
22256,10,19861,9,206,91,115,2,30,1,1
14949,26,9855,16,3734,1750,1984,24,203,12,12
6183,26,10482,16,4904,1934,2970,17,135,8,9
1913,2573,0,0,62,62,0,1,0,1,0
14510,28,0,0,66,66,0,1,0,1,0
17328,28,0,0,66,66,0,1,0,1,0
8676,26,17654,16,9571,3757,5814,48,221,26,22
21411,10,27090,9,216,102,114,2,30,1,1
12201,15,8381,11,3483,2072,1411,21,214,17,4
15965,28,0,0,70,70,0,1,0,1,0
14468,10,19747,9,184,102,82,2,30,1,1
1316,1054,0,0,146,146,0,1,0,1,0
11125,2489,12439,1936,66,66,0,1,5,1,0
10944,28,0,0,70,70,0,1,0,1,0
21073,28,0,0,70,70,0,1,0,1,0
0,0,0,0,480,244,236,4,0,2,2
14675,10,382,9,215,102,113,2,30,1,1
10989,28,0,0,66,66,0,1,0,1,0
594,1147,0,0,62,62,0,1,0,1,0
788,2382,0,0,62,62,0,1,0,1,0
17286,28,0,0,70,70,0,1,0,1,0
7053,10,19777,9,86,86,0,1,30,1,0
18100,26,28456,16,1641,730,911,14,18,8,6
22305,28,0,0,70,70,0,1,0,1,0
15656,26,23823,16,5574,999,4575,21,256,11,10
2863,2006,13315,1536,148,86,62,2,30,1,1
20515,10,18532,9,448,166,282,2,30,1,1
12325,183,0,0,62,62,0,1,0,1,0
0,0,0,0,320,320,0,5,0,5,0
15439,10,3453,9,200,102,98,2,30,1,1
4706,26,4222,16,70,70,0,2,5,2,0
22503,10,2172,9,227,110,117,2,30,1,1
2290,1472,0,0,62,62,0,1,0,1,0
12036,2580,18630,2002,70,70,0,1,5,1,0
14726,28,0,0,70,70,0,1,0,1,0
3476,26,11763,16,3244,2042,1202,17,16,9,8
21003,2138,27325,1651,562,380,182,8,15,5,3
18151,509,0,0,66,66,0,1,0,1,0
14849,10,8025,9,177,94,83,2,30,1,1
9560,28,0,0,66,66,0,1,0,1,0
3824,15,15227,11,1056,682,374,10,15,6,4
7326,1649,0,0,60,60,0,1,0,1,0
15131,26,12641,16,6308,829,5479,18,15,9,9
10970,1212,16843,897,70,70,0,2,8,2,0
1735,10,6401,9,199,90,109,2,30,1,1
1332,1147,0,0,66,66,0,1,0,1,0
9000,26,6922,16,6611,2169,4442,20,123,12,8
4034,26,17276,16,7419,2136,5283,23,255,11,12
6625,233,23738,148,139,139,0,2,6,2,0
146,2486,0,0,66,66,0,1,0,1,0
3849,2938,0,0,66,66,0,1,0,1,0
1519,2256,0,0,62,62,0,1,0,1,0
5898,26,5515,16,78,78,0,1,5,1,0
12648,26,22186,16,10785,2147,8638,22,30,10,12
16668,2256,0,0,66,66,0,1,0,1,0
8861,28,0,0,70,70,0,1,0,1,0
9621,26,2544,16,25979,7217,18762,36,15,19,17
9301,28,0,0,70,70,0,1,0,1,0
14181,10,28472,9,180,94,86,2,29,1,1
18392,15,8333,11,2006,1095,911,11,61,6,5
14861,10,16559,9,177,94,83,2,30,1,1
8724,10,27273,9,184,94,90,2,29,1,1
50,1507,0,0,143,143,0,1,0,1,0
15050,10,15482,9,167,86,81,2,31,1,1
7071,26,7140,16,8445,2120,6325,27,107,15,12
1971,7,0,0,60,60,0,1,0,1,0
17515,28,0,0,70,70,0,1,0,1,0
9485,10,7265,9,189,102,87,2,31,1,1
18506,26,261,16,10961,4286,6675,53,320,21,32
8,442,0,0,60,60,0,1,0,1,0
19428,242,0,0,145,145,0,1,0,1,0
14997,10,27936,9,182,93,89,2,30,1,1
8748,15,21520,11,25980,10637,15343,40,42,17,23
22313,10,13481,9,193,102,91,2,31,1,1
22000,28,0,0,66,66,0,1,0,1,0
19837,28,0,0,66,66,0,1,0,1,0
12806,28,0,0,66,66,0,1,0,1,0
2161,1771,0,0,62,62,0,1,0,1,0
10499,26,11821,16,10119,1855,8264,26,28,15,11
5244,26,20518,16,26692,5527,21165,54,31,28,26
21905,28,0,0,66,66,0,1,0,1,0
12951,26,18359,16,1053,566,487,10,16,6,4
5339,26,21561,16,7624,1384,6240,23,17,12,11
18594,28,0,0,70,70,0,1,0,1,0
8383,3191,20111,2475,70,70,0,2,8,2,0
16185,15,1448,11,742,140,602,12,409,3,9
4364,15,28929,11,78,78,0,1,5,1,0
8340,1319,28542,995,70,70,0,1,5,1,0
16907,28,0,0,70,70,0,1,0,1,0
2699,2587,0,0,146,146,0,1,0,1,0
15450,26,25121,16,18542,1778,16764,30,17,15,15
22046,10,26751,9,94,94,0,1,30,1,0
14023,1888,0,0,66,66,0,1,0,1,0
15738,28,0,0,70,70,0,1,0,1,0
9186,10,11242,9,179,94,85,2,31,1,1
1473,561,0,0,62,62,0,1,0,1,0
702,1017,0,0,62,62,0,1,0,1,0
10035,28,0,0,66,66,0,1,0,1,0
9026,10,23209,9,715,94,621,2,31,1,1
612,38,0,0,60,60,0,1,0,1,0
16951,255,0,0,62,62,0,1,0,1,0
10645,26,26466,16,4646,2347,2299,17,34,9,8
20410,1804,0,0,66,66,0,1,0,1,0
10016,15,12770,11,238059,13790,224269,276,141,113,163
9364,10,6249,9,718,94,624,2,29,1,1
13563,28,0,0,70,70,0,1,0,1,0
14148,234,5214,149,2769,1694,1075,20,3600,10,10
10420,1147,0,0,66,66,0,1,0,1,0
18011,26,27899,16,21212,14546,6666,43,362,24,19
3172,1147,0,0,62,62,0,1,0,1,0
21865,10,8127,9,397,102,295,2,30,1,1
12382,10,273,9,391,102,289,2,29,1,1
15578,10,5293,9,199,94,105,2,30,1,1
16021,2373,5370,1846,132,132,0,3,1199,3,0
8344,10,10371,9,184,94,90,2,30,1,1
18704,2953,0,0,66,66,0,1,0,1,0
3371,10,26623,9,816,228,588,8,30,4,4
7926,12,0,0,60,60,0,1,0,1,0
2955,391,0,0,60,60,0,1,0,1,0
14492,272,12277,171,149,149,0,2,1200,2,0
16720,15,14567,11,804,449,355,9,256,5,4
6992,15,20561,11,130,70,60,2,15,1,1
12031,382,6941,246,70,70,0,1,5,1,0
13599,28,0,0,70,70,0,1,0,1,0
3585,26,22034,16,54451,2603,51848,70,16,30,40
21704,10,6816,9,184,94,90,2,31,1,1
12299,2256,0,0,66,66,0,1,0,1,0
14705,28,0,0,70,70,0,1,0,1,0
18797,1356,12600,1029,70,70,0,2,8,2,0
15844,10,19341,9,752,93,659,2,30,1,1
12730,26,19753,16,499,425,74,4,0,3,1
2975,1771,0,0,66,66,0,1,0,1,0
17772,28,0,0,70,70,0,1,0,1,0
16951,255,0,0,62,62,0,1,0,1,0
14414,28,0,0,66,66,0,1,0,1,0
11191,26,7045,16,1461,924,537,13,31,7,6
3740,10,4786,9,168,78,90,2,30,1,1
14274,28,0,0,70,70,0,1,0,1,0
12803,26,427,16,152,78,74,2,5,1,1
14068,28,0,0,70,70,0,1,0,1,0
10328,28,0,0,70,70,0,1,0,1,0
11233,15,25128,11,432,246,186,7,40,4,3
19886,28,0,0,66,66,0,1,0,1,0
16551,7,0,0,60,60,0,1,0,1,0
18266,26,5349,16,9875,1112,8763,21,125,10,11
15403,10,14187,9,211,102,109,2,30,1,1
15103,26,14761,16,5022,973,4049,17,60,9,8
3425,26,24393,16,3598,1118,2480,14,120,7,7
7129,10,19611,9,176,78,98,2,30,1,1
5537,15,13667,11,1948,728,1220,11,150,6,5
1087,26,7756,16,5960,438,5522,16,15,6,10
22562,26,16454,16,34653,2523,32130,65,83,26,39
14770,10,13937,9,200,102,98,2,31,1,1
8436,28,0,0,66,66,0,1,0,1,0
8912,10,10250,9,479,88,391,4,58,2,2
21843,10,1227,9,168,86,82,2,30,1,1
11624,28,0,0,70,70,0,1,0,1,0
19924,28,0,0,66,66,0,1,0,1,0
12702,26,15443,16,499,425,74,4,1,3,1
2744,1248,20973,928,1774,252,1522,5,31,3,2
21824,3216,0,0,62,62,0,1,0,1,0
14776,28,0,0,70,70,0,1,0,1,0
10411,26,18230,16,8407,2034,6373,19,121,8,11
5049,201,0,0,145,145,0,1,0,1,0
16117,26,4632,16,6150,4180,1970,21,95,13,8
11215,28,0,0,70,70,0,1,0,1,0
22019,10,16360,9,183,94,89,2,30,1,1
21811,10,2989,9,514,88,426,4,42,2,2
14064,10,13384,9,200,102,98,2,30,1,1
6348,1,0,0,62,62,0,1,0,1,0
22292,10,8017,9,215,102,113,2,29,1,1
15934,10,28834,9,1165,94,1071,2,30,1,1
9795,28,0,0,70,70,0,1,0,1,0
499,187,0,0,345,345,0,1,0,1,0
14029,10,28106,9,418,94,324,2,30,1,1
4402,26,24126,16,487330,18074,469256,508,122,148,360
7145,15,2834,11,72376,2899,69477,79,16,29,50
19808,26,24475,16,11816,3175,8641,32,46,16,16
22333,26,27326,16,648,648,0,7,15,7,0
4791,10,16286,9,216,90,126,2,30,1,1
14770,10,20938,9,757,98,659,2,31,1,1
1342,697,0,0,62,62,0,1,0,1,0
15378,2683,8560,2083,164,70,94,2,5,1,1
12730,1066,23192,785,70,70,0,2,8,2,0
9367,10,15533,9,165,86,79,2,31,1,1
11040,28,0,0,70,70,0,1,0,1,0
17004,28,0,0,70,70,0,1,0,1,0
13134,7,0,0,60,60,0,1,0,1,0
9900,3216,0,0,62,62,0,1,0,1,0
9915,28,0,0,70,70,0,1,0,1,0
18617,28,0,0,70,70,0,1,0,1,0
9014,26,2810,16,147320,5771,141549,184,72,73,111
9813,15,26134,11,1485,806,679,13,15,7,6
22171,10,26357,9,202,103,99,2,31,1,1
8462,10,26637,9,172,94,78,2,30,1,1
1833,10,10308,9,199,94,105,2,30,1,1
11194,2120,13786,1634,70,70,0,1,5,1,0
15189,26,2860,16,20451,1899,18552,33,17,14,19
20661,26,28110,16,11907,1406,10501,25,22,11,14
1777,2573,0,0,62,62,0,1,0,1,0
17799,1888,0,0,66,66,0,1,0,1,0
2161,1771,0,0,62,62,0,1,0,1,0
12347,26,12145,16,3036,975,2061,14,136,7,7
14484,10,18019,9,177,94,83,2,29,1,1
10911,828,15799,608,414,136,278,6,16,3,3
11771,26,19526,16,130,70,60,2,15,1,1
8896,10,10228,9,211,110,101,2,30,1,1
12,1746,0,0,60,60,0,1,0,1,0
369,1472,0,0,66,66,0,1,0,1,0
14501,10,22227,9,199,102,97,2,29,1,1
12823,1472,0,0,62,62,0,1,0,1,0
10483,15,22467,11,9962,3379,6583,26,26,13,13
16951,255,0,0,62,62,0,1,0,1,0
19593,28,0,0,70,70,0,1,0,1,0
9818,28,0,0,70,70,0,1,0,1,0
11535,790,0,0,74,74,0,1,0,1,0
636,280,0,0,62,62,0,1,0,1,0
15982,11,6060,10,70,70,0,2,8,2,0
21892,28,0,0,70,70,0,1,0,1,0
22421,10,17869,9,199,102,97,2,30,1,1
17268,26,8762,16,5979,3487,2492,21,168,10,11
16261,329,25554,210,138,78,60,2,6,1,1
16703,26,16784,16,11659,1027,10632,25,29,11,14
15415,948,4348,700,70,70,0,2,8,2,0
5502,1017,0,0,62,62,0,1,0,1,0
8720,10,20263,9,541,201,340,6,64,3,3
15500,3216,0,0,145,145,0,1,0,1,0
8,1873,0,0,60,60,0,1,0,1,0
3947,10,15057,9,469,165,304,4,31,2,2
7235,15,8591,11,694,350,344,11,27,6,5
2302,1472,0,0,146,146,0,1,0,1,0
16951,255,0,0,62,62,0,1,0,1,0
8596,10,12115,9,332,99,233,4,45,2,2
10632,26,8270,16,632,158,474,2,30,1,1
5205,10,27060,9,168,78,90,2,30,1,1
13398,28,0,0,70,70,0,1,0,1,0
14776,2938,0,0,62,62,0,1,0,1,0
20877,2587,0,0,66,66,0,1,0,1,0
22550,10,17653,9,194,102,92,2,29,1,1
3066,1516,27213,1154,502,150,352,2,1200,1,1
8757,10,13571,9,198,94,104,2,30,1,1
9113,10,7609,9,193,102,91,2,30,1,1
13551,28,0,0,70,70,0,1,0,1,0
22021,28,0,0,70,70,0,1,0,1,0
7326,180,0,0,60,60,0,1,0,1,0
15980,10,28261,9,197,102,95,2,30,1,1
8756,10,2091,9,458,188,270,6,30,3,3
17971,28,0,0,70,70,0,1,0,1,0
2744,1238,3145,918,912,126,786,2,31,1,1
16146,26,25038,16,25824,14215,11609,65,757,32,33
8441,10,18805,9,212,102,110,2,29,1,1
7375,1594,0,0,74,74,0,1,0,1,0
11901,26,23264,16,17380,7747,9633,52,121,23,29
9728,831,24883,610,1705,536,1169,5,1200,4,1
14886,28,0,0,70,70,0,1,0,1,0
21823,10,24898,9,94,94,0,1,30,1,0
8549,10,22984,9,200,102,98,2,31,1,1
13838,10,7248,9,178,94,84,2,30,1,1
10980,15,27184,11,3648,1775,1873,13,26,7,6
9728,966,27633,714,324,150,174,2,1200,1,1
1277,1054,0,0,62,62,0,1,0,1,0
8896,10,14671,9,539,100,439,4,54,2,2
13695,10,26024,9,234,94,140,2,30,1,1
9628,28,0,0,70,70,0,1,0,1,0
10540,1476,0,0,100,100,0,1,0,1,0
9382,28,0,0,70,70,0,1,0,1,0
20370,1771,0,0,66,66,0,1,0,1,0
4237,26,18478,16,2514,1249,1265,19,76,9,10
8584,1238,14977,918,239,71,168,2,31,1,1
2073,10,8186,9,414,268,146,3,32,2,1
1634,15,5911,11,4591,3155,1436,22,45,13,9
261,1147,0,0,62,62,0,1,0,1,0
11277,28,0,0,70,70,0,1,0,1,0
21381,10,11424,9,195,102,93,2,31,1,1
21846,28,0,0,70,70,0,1,0,1,0
11578,28,0,0,66,66,0,1,0,1,0
13917,10,17285,9,599,198,401,6,50,3,3
7673,26,21725,16,70,70,0,1,5,1,0
7884,26,9138,16,25643,2181,23462,44,363,18,26
13192,28,0,0,66,66,0,1,0,1,0
18802,1147,0,0,66,66,0,1,0,1,0
21372,28,0,0,66,66,0,1,0,1,0
9367,28,0,0,70,70,0,1,0,1,0
8449,10,5951,9,178,94,84,2,30,1,1
2309,427,0,0,62,62,0,1,0,1,0
7270,1472,0,0,146,146,0,1,0,1,0
9221,15,1033,11,405,285,120,5,15,3,2
22392,10,19890,9,180,94,86,2,30,1,1
15525,10,12531,9,193,102,91,2,30,1,1
2408,1017,0,0,146,146,0,1,0,1,0
15003,10,4646,9,170,87,83,2,31,1,1
14057,10,11652,9,177,94,83,2,29,1,1
16642,2702,0,0,62,62,0,1,0,1,0
2659,2611,0,0,78,78,0,1,0,1,0
9153,10,28546,9,755,94,661,2,29,1,1
636,280,25143,177,238,118,120,2,1200,1,1
12700,1683,171,1288,492,306,186,8,16,5,3
9214,3256,0,0,60,60,0,1,0,1,0
22065,1017,0,0,66,66,0,1,0,1,0
20928,26,2506,16,11301,2292,9009,37,165,20,17
2623,10,11049,9,235,90,145,2,33,1,1
13028,26,26597,16,499,425,74,4,0,3,1
5687,1482,0,0,146,146,0,1,0,1,0
12,1962,0,0,74,74,0,1,0,1,0
17798,28,0,0,66,66,0,1,0,1,0
14647,10,17367,9,193,102,91,2,30,1,1
21712,10,25425,9,314,99,215,4,39,2,2
20970,28,0,0,66,66,0,1,0,1,0
6673,2558,0,0,62,62,0,1,0,1,0
603,1888,0,0,62,62,0,1,0,1,0
14112,28,0,0,66,66,0,1,0,1,0
11871,28,0,0,66,66,0,1,0,1,0
12142,26,14726,16,36393,27741,8652,147,210,76,71
7981,2938,0,0,62,62,0,1,0,1,0
14284,1523,8777,1161,70,70,0,2,8,2,0
14316,28,0,0,70,70,0,1,0,1,0
12655,28,0,0,70,70,0,1,0,1,0
12408,1771,0,0,62,62,0,1,0,1,0
9773,10,2456,9,756,94,662,2,30,1,1
9924,2587,0,0,146,146,0,1,0,1,0
8794,10,6703,9,168,86,82,2,31,1,1
14335,10,21917,9,177,94,83,2,29,1,1
21690,10,27827,9,249,94,155,2,30,1,1
16054,26,18827,16,6749,2649,4100,19,142,9,10
9142,10,16627,9,195,102,93,2,29,1,1
21893,28,0,0,70,70,0,1,0,1,0
22052,10,12692,9,167,86,81,2,30,1,1
9911,28,0,0,70,70,0,1,0,1,0
14050,1888,0,0,62,62,0,1,0,1,0
330,3049,0,0,66,66,0,1,91,1,0
6363,15,20412,11,78310,9243,69067,109,93,57,52
17400,2587,0,0,62,62,0,1,0,1,0
15591,10,9959,9,177,94,83,2,31,1,1
14337,1474,14157,1122,70,70,0,2,8,2,0
19976,28,0,0,66,66,0,1,0,1,0
16951,255,0,0,62,62,0,1,0,1,0
8511,10,8564,9,458,188,270,6,29,3,3
16215,10,2707,9,308,118,190,2,29,1,1
8785,26,7180,16,46202,8086,38116,131,243,69,62
5411,15,15792,11,1598,731,867,17,362,8,9
8890,26,8730,16,4139,511,3628,12,15,6,6
21905,10,2926,9,758,93,665,2,31,1,1
12386,3044,7765,2366,70,70,0,1,5,1,0
17513,28,0,0,70,70,0,1,0,1,0
21927,10,28770,9,265,111,154,2,30,1,1
16442,1215,0,0,62,62,0,1,0,1,0
8584,1563,7499,1194,245,78,167,2,30,1,1
16951,255,0,0,62,62,0,1,0,1,0
1117,201,0,0,100,100,0,1,0,1,0
8748,28,0,0,66,66,0,1,0,1,0
13074,185,0,0,60,60,0,1,0,1,0
8171,1074,0,0,60,60,0,1,0,1,0
655,1409,0,0,139,139,0,1,0,1,0
14584,10,11910,9,195,102,93,2,30,1,1
13675,26,27329,16,8042,2104,5938,27,26,15,12
10106,2883,0,0,66,66,0,1,0,1,0
17383,10,0,0,296,76,220,2,30,1,1
2744,1295,23273,973,883,126,757,2,31,1,1
15231,26,16661,16,8006,1986,6020,20,15,11,9
13510,28,0,0,66,66,0,1,0,1,0
18439,2973,19085,2308,624,318,306,10,15,5,5
2791,26,9843,16,3751,1007,2744,35,473,11,24
6218,26,8732,16,6197,942,5255,19,361,10,9
650,2820,0,0,139,139,0,1,0,1,0
11894,28,0,0,70,70,0,1,0,1,0
18589,28,0,0,70,70,0,1,0,1,0
13957,10,13029,9,216,102,114,2,30,1,1
16344,1242,26239,922,802,472,330,8,30,5,3
15202,28,0,0,66,66,0,1,0,1,0
9055,10,13342,9,243,94,149,2,30,1,1
10490,1017,0,0,66,66,0,1,0,1,0
21230,10,8115,9,200,102,98,2,30,1,1
14335,10,13388,9,177,94,83,2,30,1,1
18751,15,56,11,5911,4727,1184,20,16,11,9
10072,28,0,0,70,70,0,1,0,1,0
10328,1771,0,0,66,66,0,1,0,1,0
10722,15,3382,11,19384,2720,16664,36,174,18,18
5793,349,23219,222,78,78,0,1,5,1,0
1216,26,15854,16,22677,11756,10921,45,315,26,19
9017,26,8288,16,11534,2076,9458,43,60,21,22
11692,10,23115,9,197,90,107,2,30,1,1
14953,10,3029,9,172,94,78,2,30,1,1
8320,10,23490,9,280,94,186,2,30,1,1
12956,28,0,0,66,66,0,1,0,1,0
21302,10,4317,9,199,94,105,2,30,1,1
22318,10,11165,9,209,110,99,2,30,1,1
18418,28,0,0,70,70,0,1,0,1,0
10969,28,0,0,70,70,0,1,0,1,0
10327,2627,24306,2037,460,150,310,2,1201,1,1
13271,28,0,0,66,66,0,1,0,1,0
9163,10,27118,9,181,94,87,2,30,1,1
16115,28,0,0,70,70,0,1,0,1,0
13075,28,0,0,70,70,0,1,0,1,0
10765,2593,5217,2012,70,70,0,1,5,1,0
1039,2636,0,0,66,66,0,1,0,1,0
10751,1770,18194,1351,70,70,0,2,8,2,0
12,1776,5,1355,70,70,0,1,4,1,0
16951,255,0,0,62,62,0,1,0,1,0
9115,10,23082,9,525,110,415,2,30,1,1
8817,28,0,0,70,70,0,1,0,1,0
8409,10,227,9,167,86,81,2,29,1,1
6761,5,0,0,60,60,0,1,0,1,0
21816,10,8116,9,252,94,158,2,31,1,1
5161,26,23215,16,140155,6367,133788,173,145,62,111
5201,6,16752,6,5130,2103,3027,28,25,16,12
20205,28,0,0,66,66,0,1,0,1,0
8717,28,0,0,70,70,0,1,0,1,0
8933,28,0,0,70,70,0,1,0,1,0
7108,15,11432,11,1718,1404,314,11,15,6,5
16421,2256,0,0,62,62,0,1,0,1,0
13701,10,17737,9,308,94,214,2,29,1,1
15707,10,238,9,178,94,84,2,29,1,1
15205,26,2171,16,7941,1952,5989,20,15,11,9
9549,28,0,0,66,66,0,1,0,1,0
20878,28,0,0,70,70,0,1,0,1,0
19479,26,8991,16,5663,3258,2405,19,120,9,10
16111,15,25444,11,172548,4355,168193,172,148,53,119
15956,26,1446,16,10169,1957,8212,26,136,11,15
12393,1066,26580,785,70,70,0,1,4,1,0
9083,15,6296,11,992,524,468,10,125,6,4
5545,15,17231,11,6416,997,5419,17,30,8,9
7180,26,27561,16,1314,653,661,13,185,7,6
22717,3139,0,0,62,62,0,1,0,1,0
7837,10,20638,9,414,268,146,3,32,2,1
7526,26,20811,16,3322,1760,1562,19,255,10,9
11754,28,0,0,70,70,0,1,0,1,0
10856,3007,18406,2338,70,70,0,2,9,2,0
8933,10,18986,9,200,102,98,2,31,1,1
15457,10,8708,9,184,94,90,2,30,1,1
12,700,0,0,85,85,0,1,0,1,0
19293,15,27252,11,1917,1468,449,10,19,6,4
12062,28,0,0,70,70,0,1,0,1,0
15186,10,24164,9,170,87,83,2,31,1,1
18972,28,0,0,70,70,0,1,0,1,0
2744,1631,13929,1253,877,126,751,2,31,1,1
8635,10,7139,9,718,94,624,2,30,1,1
15144,10,21298,9,206,105,101,2,30,1,1
14984,3139,0,0,66,66,0,1,0,1,0
14550,28,0,0,70,70,0,1,0,1,0
4569,26,22098,16,70,70,0,1,5,1,0
6429,2709,0,0,62,62,0,1,0,1,0
3133,2337,14558,1821,396,396,0,7,3615,7,0
16238,28,0,0,70,70,0,1,0,1,0
10910,341,6373,217,750,360,390,10,60,5,5
12320,1804,0,0,66,66,0,1,0,1,0
16904,983,0,0,66,66,0,1,0,1,0
9960,26,12656,16,7619,3064,4555,14,121,6,8
0,0,0,0,244,244,0,2,0,2,0
11608,26,8725,16,5042,2002,3040,14,119,7,7
1133,2938,0,0,78,78,0,1,0,1,0
6357,26,11763,16,6826,1804,5022,21,137,11,10
15384,10,25095,9,404,259,145,3,33,2,1
12643,26,26412,16,499,425,74,4,0,3,1
14492,1958,5634,1495,150,150,0,1,1200,1,0
652,674,0,0,100,100,0,1,0,1,0
7713,676,25626,475,138,78,60,2,5,1,1
21623,26,10608,16,5925,3462,2463,13,120,7,6
15739,10,1952,9,174,89,85,2,31,1,1
10612,26,22550,16,1724,916,808,17,128,7,10
7351,26,19944,16,1494,898,596,12,142,6,6
14338,28,0,0,70,70,0,1,0,1,0
11227,28,0,0,66,66,0,1,0,1,0
14765,28,0,0,70,70,0,1,0,1,0
20872,28,0,0,70,70,0,1,0,1,0
571,2824,0,0,74,74,0,1,0,1,0
17600,26,4361,16,2962,1844,1118,16,15,8,8
16000,10,23821,9,177,94,83,2,30,1,1
2744,1238,18910,918,876,126,750,2,30,1,1
2654,15,11120,11,93644,8868,84776,131,31,64,67
18347,28,0,0,70,70,0,1,0,1,0
15167,10,16417,9,200,102,98,2,30,1,1
13443,1888,0,0,66,66,0,1,0,1,0
10513,3216,0,0,66,66,0,1,0,1,0
10470,26,7011,16,1442,721,721,15,122,8,7
22517,10,2404,9,749,94,655,2,30,1,1
15841,10,8136,9,214,110,104,2,30,1,1
17225,1147,0,0,66,66,0,1,0,1,0
16414,26,25037,16,3522,1763,1759,31,32,16,15
20374,26,9623,16,21313,7245,14068,48,128,22,26
14705,10,21707,9,177,94,83,2,29,1,1
331,2739,0,0,66,66,0,1,0,1,0
5326,26,22443,16,10148,2203,7945,37,120,19,18
13987,28,0,0,70,70,0,1,0,1,0
12093,28,0,0,70,70,0,1,0,1,0
16951,255,0,0,62,62,0,1,0,1,0
16951,255,0,0,62,62,0,1,0,1,0
9332,28,0,0,70,70,0,1,0,1,0
15322,26,25063,16,33901,9598,24303,56,61,32,24
10998,15,316,11,366,240,126,7,25,5,2
5997,10,0,0,82,82,0,1,30,1,0
8403,10,17497,9,723,102,621,2,30,1,1
6609,1771,0,0,62,62,0,1,0,1,0
14198,26,17447,16,8867,3511,5356,20,120,9,11
16021,280,10906,177,330,330,0,6,1201,6,0
8797,10,2303,9,198,102,96,2,33,1,1
9806,26,21904,16,4190,1882,2308,17,19,10,7
22464,10,17050,9,216,110,106,2,30,1,1
10876,28,0,0,70,70,0,1,0,1,0
19788,28,0,0,70,70,0,1,0,1,0
19299,2695,0,0,72,72,0,1,0,1,0
17730,10,26423,9,823,98,725,2,29,1,1
16924,28,0,0,70,70,0,1,0,1,0
9640,26,780,16,751676,8792,742884,617,16,123,494
312,7,0,0,60,60,0,1,0,1,0
2670,2938,0,0,62,62,0,1,0,1,0
17069,26,22584,16,3923,2459,1464,17,17,8,9
17764,28,0,0,70,70,0,1,0,1,0
10745,26,26620,16,4887,2346,2541,16,120,8,8
16873,28,0,0,70,70,0,1,0,1,0
22522,28,0,0,70,70,0,1,0,1,0
9523,15,18474,11,1083,653,430,8,16,5,3
15520,28,0,0,66,66,0,1,0,1,0
13955,10,6566,9,196,102,94,2,30,1,1
10473,2636,0,0,66,66,0,1,0,1,0
13152,26,22613,16,6120,1305,4815,20,983,10,10
13391,15,6597,11,1148,599,549,14,318,7,7
22098,10,5843,9,261,102,159,2,29,1,1
3102,2382,0,0,66,66,0,1,0,1,0
14643,10,2558,9,185,102,83,2,30,1,1
6248,26,96,16,10384,4353,6031,29,251,16,13
19382,28,0,0,70,70,0,1,0,1,0
14804,10,12628,9,165,86,79,2,30,1,1
1371,2256,0,0,146,146,0,1,0,1,0
17166,10,24983,9,355,118,237,2,29,1,1
18432,26,26786,16,7939,955,6984,22,107,11,11
19187,28,0,0,66,66,0,1,0,1,0
11142,1017,0,0,66,66,0,1,0,1,0
11900,26,20643,16,22513,15188,7325,69,517,31,38
17170,26,14949,16,21207,14062,7145,50,19,28,22
7850,1662,0,0,106,106,0,1,60,1,0
282,1054,0,0,66,66,0,1,0,1,0
14226,10,20285,9,186,102,84,2,30,1,1
9640,26,11486,16,90570,3437,87133,103,90,34,69
14360,10,24872,9,280,126,154,2,30,1,1
2495,1825,0,0,66,66,0,1,0,1,0
5996,26,23626,16,25342,17809,7533,56,80,28,28
4731,26,1840,16,17842,11204,6638,43,174,24,19
16439,3216,0,0,66,66,0,1,0,1,0
1715,1696,0,0,146,146,0,1,0,1,0
9902,10,27639,9,578,286,292,9,16,5,4
9511,10,23251,9,821,102,719,2,30,1,1
4024,2883,0,0,66,66,0,1,0,1,0
8615,10,16128,9,216,110,106,2,29,1,1
4420,1147,0,0,66,66,0,1,0,1,0
14455,10,16906,9,180,94,86,2,30,1,1
4857,26,17983,16,130,70,60,3,5,2,1
21354,10,15781,9,232,94,138,2,30,1,1
11607,15,5166,11,214,140,74,4,15,3,1
14543,10,18618,9,182,94,88,2,30,1,1
11866,15,16191,11,122572,3630,118942,128,358,46,82
11166,26,22806,16,298081,63335,234746,337,323,145,192
8658,10,4477,9,198,101,97,2,31,1,1
12514,1546,2364,1178,70,70,0,1,4,1,0
19314,28,0,0,70,70,0,1,0,1,0
12709,781,488,567,70,70,0,2,7,2,0
15011,10,16375,9,195,102,93,2,30,1,1
1816,1215,0,0,66,66,0,1,0,1,0
6689,1472,0,0,62,62,0,1,0,1,0
21428,28,0,0,70,70,0,1,0,1,0
21799,10,639,9,214,102,112,2,31,1,1
9264,1482,0,0,66,66,0,1,0,1,0
16021,2722,3637,2116,594,594,0,10,1199,10,0
22655,10,14066,9,200,102,98,2,30,1,1
16951,255,25970,160,66,66,0,1,4,1,0
19,2587,0,0,146,146,0,1,0,1,0
9871,26,27169,16,34661,17810,16851,89,119,40,49
4820,26,4927,16,6202,872,5330,19,361,9,10
10555,26,11639,16,1210,450,760,17,54,5,12
14216,10,14394,9,168,86,82,2,31,1,1
6247,10,2204,9,168,78,90,2,30,1,1
15007,28,0,0,70,70,0,1,0,1,0
21874,10,6203,9,718,94,624,2,30,1,1
12476,2959,24188,2296,70,70,0,1,5,1,0
19385,1888,0,0,66,66,0,1,0,1,0
11427,1017,0,0,62,62,0,1,0,1,0
1871,1017,0,0,146,146,0,1,0,1,0
7712,676,8987,475,138,78,60,2,6,1,1
13091,10,1553,9,168,78,90,2,30,1,1
14333,10,21805,9,209,110,99,2,30,1,1
18462,26,25556,16,8061,1926,6135,24,361,11,13
1215,2938,0,0,62,62,0,1,0,1,0
3047,10,12712,9,215,80,135,2,33,1,1
14721,28,0,0,70,70,0,1,0,1,0
16951,255,0,0,62,62,0,1,0,1,0
14015,10,14375,9,195,102,93,2,30,1,1
10979,241,17271,155,70,70,0,1,5,1,0
8444,10,6398,9,199,102,97,2,31,1,1
14915,10,3539,9,822,102,720,2,29,1,1
9778,15,25965,11,25670,13514,12156,46,36,21,25
18435,10,26780,9,222,90,132,2,30,1,1
17429,10,0,0,426,152,274,4,30,2,2
19087,28,0,0,70,70,0,1,0,1,0
16489,28,0,0,70,70,0,1,0,1,0
21754,10,20900,9,198,102,96,2,30,1,1
14101,10,5046,9,214,110,104,2,30,1,1
17157,26,27274,16,674,130,544,11,129,3,8
2184,2938,0,0,62,62,0,1,0,1,0
8805,28,0,0,66,66,0,1,0,1,0
15509,15,2123,11,1490,886,604,10,75,6,4
10653,983,0,0,66,66,0,1,0,1,0
11288,2998,5918,2331,316,136,180,6,8,3,3
18563,2058,4437,1584,70,70,0,2,8,2,0
18357,387,709,250,324,250,74,5,3605,4,1
22392,1294,18326,972,231,78,153,2,29,1,1
7361,26,23148,16,12395,2182,10213,21,122,10,11
11153,2361,14429,1837,70,70,0,1,4,1,0
21429,28,0,0,70,70,0,1,0,1,0
21570,10,21100,9,264,110,154,2,30,1,1
18324,28,0,0,70,70,0,1,0,1,0
9744,26,8472,16,5035,3194,1841,23,96,12,11
297,2256,0,0,78,78,0,1,0,1,0
15541,28,0,0,70,70,0,1,0,1,0
14098,26,426,16,6314,4856,1458,18,120,11,7
3243,1880,0,0,146,146,0,1,0,1,0
4056,10,2467,9,199,94,105,2,29,1,1
1069,26,5326,16,5691,503,5188,14,15,7,7
6708,1017,0,0,66,66,0,1,0,1,0
7783,26,21429,16,3398,2096,1302,19,16,10,9
11440,2205,0,0,66,66,0,1,0,1,0
20508,26,22616,16,37694,8319,29375,85,153,36,49
17539,10,143,9,260,86,174,2,30,1,1
15574,28,0,0,70,70,0,1,0,1,0
15128,26,4119,16,9518,3057,6461,21,43,12,9
18083,28,0,0,66,66,0,1,0,1,0
14729,10,13044,9,258,118,140,2,30,1,1
10285,28,0,0,70,70,0,1,0,1,0
15363,10,15511,9,198,101,97,2,30,1,1
20229,28,0,0,70,70,0,1,0,1,0
11213,610,27861,420,70,70,0,2,8,2,0
15318,10,6651,9,202,103,99,2,30,1,1
14013,2256,0,0,62,62,0,1,0,1,0
7477,26,1141,16,4568,2057,2511,17,62,9,8
9733,10,1079,9,177,94,83,2,30,1,1
9029,26,10928,16,5708,1025,4683,16,35,9,7
14545,28,0,0,66,66,0,1,0,1,0
14048,10,15085,9,200,94,106,2,30,1,1
5229,26,14827,16,12742,1983,10759,47,123,14,33
1777,2573,0,0,62,62,0,1,0,1,0
6999,922,28432,680,502,150,352,2,1200,1,1
12762,2121,16889,1635,70,70,0,2,8,2,0
18751,26,18288,16,12669,5297,7372,31,188,18,13
15277,28,0,0,70,70,0,1,0,1,0
9426,2938,0,0,78,78,0,1,0,1,0
11107,10,11275,9,199,94,105,2,30,1,1
22574,26,11800,16,839325,38439,800886,1027,94,451,576
17732,28,0,0,70,70,0,1,0,1,0
8720,15,26113,11,1515,481,1034,11,15,6,5
2240,10,9176,9,404,259,145,3,33,2,1
2676,2938,0,0,62,62,0,1,0,1,0
19385,1888,0,0,66,66,0,1,0,1,0
12151,26,1951,16,242149,7606,234543,260,150,92,168
19845,2938,0,0,66,66,0,1,0,1,0
8584,1244,23673,924,232,71,161,2,30,1,1
9787,26,27052,16,1512,844,668,16,64,9,7
15223,28,0,0,70,70,0,1,0,1,0
2006,15,7815,11,1501,652,849,9,15,5,4
16260,28,0,0,70,70,0,1,0,1,0
14653,10,24374,9,1392,85,1307,4,12,2,2
18464,15,10528,11,190,64,126,4,103,2,2
21855,10,10994,9,168,86,82,2,30,1,1
18960,26,11066,16,60331,12765,47566,119,105,57,62
13282,28,0,0,70,70,0,1,0,1,0
6506,936,0,0,62,62,0,1,0,1,0
8836,10,25940,9,168,86,82,2,29,1,1
144,3216,0,0,66,66,0,1,0,1,0
15050,10,0,0,371,77,294,2,30,1,1
11893,10,15470,9,406,94,312,2,30,1,1
11899,28,0,0,70,70,0,1,0,1,0
17823,28,0,0,66,66,0,1,0,1,0
18233,28,0,0,70,70,0,1,0,1,0
2744,1238,13976,918,880,126,754,2,30,1,1
15793,2747,0,0,66,66,0,1,0,1,0
16819,2587,0,0,66,66,0,1,0,1,0
14450,10,4578,9,212,110,102,2,29,1,1
12505,15,26409,11,4417,3685,732,16,15,10,6
17024,26,14286,16,10179,4285,5894,60,272,31,29
9568,10,28480,9,195,102,93,2,29,1,1
2744,1238,28950,918,878,126,752,2,30,1,1
8507,10,25599,9,387,134,253,2,30,1,1
9642,10,15461,9,751,94,657,2,29,1,1
16951,255,0,0,62,62,0,1,0,1,0
21819,10,12604,9,742,88,654,2,30,1,1
21942,10,19,9,195,102,93,2,30,1,1
21837,10,27905,9,212,110,102,2,30,1,1
9018,26,8458,16,5578,2780,2798,14,120,7,7
15789,26,7098,16,51152,3321,47831,81,100,38,43
15285,10,5410,9,195,102,93,2,30,1,1
1741,1215,0,0,62,62,0,1,0,1,0
8294,26,8524,16,130,70,60,3,5,2,1
22643,28,0,0,70,70,0,1,0,1,0
16772,26,108,16,347192,61325,285867,643,191,297,346
5684,1054,0,0,146,146,0,1,0,1,0
19281,15,14809,11,30257,2427,27830,45,255,22,23
13691,26,9033,16,2639,258,2381,9,120,4,5
4330,26,22739,16,1159756,1123031,36725,1206,26,753,453
12133,26,28351,16,57649,2489,55160,66,69,23,43
0,0,0,0,134,64,70,2,0,1,1
11706,18,10768,13,184,94,90,2,30,1,1
11787,26,11644,16,113894,15573,98321,182,119,67,115
360,3105,0,0,921,921,0,1,0,1,0
9434,10,0,0,82,82,0,1,30,1,0
21897,10,26778,9,193,102,91,2,30,1,1
15043,10,4852,9,177,94,83,2,30,1,1
22363,1888,0,0,74,74,0,1,0,1,0
9019,10,23866,9,212,102,110,2,30,1,1
21552,28,0,0,66,66,0,1,0,1,0
20630,1804,0,0,66,66,0,1,0,1,0
14957,10,28969,9,198,102,96,2,30,1,1
7883,2636,0,0,66,66,0,1,0,1,0
11847,26,1519,16,14896,6021,8875,56,115,27,29
690,3216,0,0,62,62,0,1,0,1,0
22280,15,28946,11,250600,11390,239210,268,23,98,170
8210,720,21194,515,513,152,361,2,1200,1,1
663,1888,0,0,66,66,0,1,0,1,0
20013,3265,0,0,145,145,0,1,0,1,0
3314,26,15496,16,8910,2660,6250,24,18,13,11
3087,2256,0,0,62,62,0,1,0,1,0
16616,10,20924,9,648,86,562,4,51,2,2
15531,10,26454,9,816,102,714,2,30,1,1
17532,26,25939,16,16862,7584,9278,97,8912,60,37
636,1738,684,1326,484,150,334,2,1200,1,1
16951,255,0,0,62,62,0,1,0,1,0
12451,2643,20338,2051,70,70,0,1,4,1,0
17557,2938,0,0,66,66,0,1,0,1,0
21822,10,28927,9,209,110,99,2,31,1,1
8584,2664,18367,2071,278,78,200,2,31,1,1
19231,1054,0,0,62,62,0,1,0,1,0
11246,15,25706,11,15824,805,15019,25,18,9,16
14322,10,7372,9,274,85,189,4,35,2,2
21453,28,0,0,70,70,0,1,0,1,0
20703,28,0,0,70,70,0,1,0,1,0
13957,10,9191,9,94,94,0,1,30,1,0
15596,10,20051,9,179,94,85,2,29,1,1
18796,28,0,0,70,70,0,1,0,1,0
13017,28,0,0,70,70,0,1,0,1,0
19527,26,3359,16,8036,3293,4743,32,48,18,14
15638,28,0,0,70,70,0,1,0,1,0
11362,28,0,0,70,70,0,1,0,1,0
1536,7,0,0,60,60,0,1,0,1,0
9562,26,13182,16,4507,744,3763,17,29,7,10
19959,28,0,0,70,70,0,1,0,1,0
13747,10,23750,9,783,96,687,2,30,1,1
5058,26,8232,16,17473899,604274,16869625,22165,408,7731,14434
15594,26,8467,16,227559,47160,180399,379,143,187,192
17053,26,7586,16,10379,2361,8018,27,20,16,11
21653,10,3311,9,102,102,0,2,31,2,0
17230,3049,0,0,66,66,0,1,91,1,0
21687,28,0,0,70,70,0,1,0,1,0
0,0,0,0,182,182,0,1,0,1,0
14099,10,15625,9,579,88,491,4,35,2,2
17709,2587,0,0,66,66,0,1,0,1,0
17849,26,20045,16,303,85,218,2,30,1,1
11668,28,0,0,70,70,0,1,0,1,0
21314,10,751,9,215,94,121,2,29,1,1
15178,10,26410,9,168,86,82,2,31,1,1
451,15,1554,11,23456,1005,22451,32,16,13,19
15996,26,15229,16,8200,2465,5735,30,18,14,16
15162,10,16824,9,177,94,83,2,30,1,1
15330,1548,3377,1179,378,192,186,7,15,4,3
19013,28,0,0,66,66,0,1,0,1,0
20395,28,0,0,70,70,0,1,0,1,0
15380,10,27638,9,815,95,720,2,31,1,1
16568,28,0,0,70,70,0,1,0,1,0
19240,3117,0,0,66,66,0,1,0,1,0
5606,2010,1416,1540,140,78,62,2,29,1,1
12842,28,0,0,70,70,0,1,0,1,0
19883,26,27609,16,28026,5723,22303,62,20,32,30
15917,847,0,0,66,66,0,1,0,1,0
21164,260,11918,164,66,66,0,2,8,2,0
16951,255,0,0,62,62,0,1,0,1,0
14104,10,7261,9,193,102,91,2,29,1,1
8915,15,28787,11,230959,4381,226578,217,91,60,157
15340,10,28621,9,194,102,92,2,29,1,1
4742,2486,0,0,146,146,0,1,0,1,0
10697,28,0,0,70,70,0,1,0,1,0
9782,26,22090,16,4544,1637,2907,19,26,11,8
1631,1888,0,0,62,62,0,1,0,1,0
636,280,12500,177,231,111,120,2,1200,1,1
12301,28,0,0,66,66,0,1,0,1,0
8853,10,6757,9,197,102,95,2,29,1,1
13009,28,0,0,70,70,0,1,0,1,0
15117,10,23494,9,735,88,647,2,30,1,1
9107,10,9731,9,596,90,506,4,59,2,2
10099,26,20775,16,469,403,66,4,0,3,1
14745,10,27170,9,190,97,93,2,31,1,1
22070,10,26805,9,178,94,84,2,30,1,1
15808,26,28870,16,54515,20774,33741,167,36,88,79
9152,10,7842,9,214,102,112,2,30,1,1
14708,10,7744,9,199,102,97,2,30,1,1
17616,28,0,0,70,70,0,1,0,1,0
21483,10,8241,9,262,102,160,2,30,1,1
18180,2636,0,0,62,62,0,1,0,1,0
8866,15,14003,11,56411,2447,53964,58,130,19,39
20,3216,0,0,145,145,0,1,0,1,0
10323,6,22387,6,5806,2153,3653,33,24,18,15
2014,1888,0,0,62,62,0,1,0,1,0
21743,28,0,0,70,70,0,1,0,1,0
14958,10,19802,9,793,101,692,2,31,1,1
21143,1771,0,0,66,66,0,1,0,1,0
12052,28,0,0,66,66,0,1,0,1,0
13281,28,0,0,70,70,0,1,0,1,0
15324,26,11830,16,8058,2038,6020,20,15,11,9
10840,28,0,0,70,70,0,1,0,1,0
532,247,0,0,3562,1936,1626,48,191,24,24
8383,28,0,0,66,66,0,1,0,1,0
21940,10,18177,9,212,102,110,2,30,1,1
7730,1888,0,0,62,62,0,1,0,1,0
15967,10,2775,9,196,102,94,2,30,1,1
8867,10,24288,9,197,102,95,2,30,1,1
21848,10,27779,9,229,94,135,2,30,1,1
15106,3216,0,0,62,62,0,1,0,1,0
1950,1147,0,0,66,66,0,1,0,1,0
12844,1017,0,0,62,62,0,1,0,1,0
640,1327,0,0,146,146,0,1,0,1,0
16578,2953,0,0,66,66,0,1,0,1,0
14611,10,14868,9,177,94,83,2,30,1,1
3914,10,15013,9,194,87,107,2,31,1,1
9558,28,0,0,66,66,0,1,0,1,0
15997,10,14149,9,177,94,83,2,30,1,1
12655,26,25299,16,499,425,74,4,0,3,1
18468,3245,20694,2514,70,70,0,2,8,2,0
2744,1238,13339,918,891,126,765,2,31,1,1
14990,10,21155,9,184,94,90,2,31,1,1
13049,26,23719,16,499,425,74,4,0,3,1
13683,26,4610,16,7682,3198,4484,27,17,16,11
14696,10,27719,9,211,102,109,2,30,1,1
5606,2010,5165,1540,245,182,63,2,30,1,1
959,15,3001,11,318,192,126,6,26,4,2
2744,1300,14799,978,885,126,759,2,30,1,1
22234,10,24942,9,174,89,85,2,31,1,1
7450,26,25404,16,3132,1697,1435,17,15,10,7
10729,28,0,0,66,66,0,1,0,1,0
9122,28,0,0,70,70,0,1,0,1,0
9124,28,0,0,70,70,0,1,0,1,0
18333,1147,0,0,66,66,0,1,0,1,0
7339,170,0,0,60,60,0,1,0,1,0
6444,26,2126,16,795,795,0,2,154,2,0
13911,28,0,0,70,70,0,1,0,1,0
9232,28,0,0,70,70,0,1,0,1,0
17075,28,0,0,66,66,0,1,0,1,0
14745,10,12568,9,195,102,93,2,30,1,1
16325,28,0,0,66,66,0,1,0,1,0
22097,10,11525,9,195,102,93,2,31,1,1
13700,10,15328,9,198,102,96,2,30,1,1
19346,26,23673,16,8673,1722,6951,30,125,18,12
9106,15,21741,11,323714,18296,305418,384,22,165,219
10646,26,16034,16,4598,2312,2286,17,34,9,8
20800,28,0,0,70,70,0,1,0,1,0
1627,344,0,0,148,148,0,1,0,1,0
18848,28,0,0,66,66,0,1,0,1,0
10814,360,25781,231,280,214,66,2,31,1,1
9758,28,0,0,66,66,0,1,0,1,0
18895,26,26462,16,4895,3822,1073,24,49,13,11
21412,28,0,0,70,70,0,1,0,1,0
22195,10,23821,9,177,94,83,2,30,1,1
9627,15,15332,11,374,192,182,7,25,4,3
8879,10,16239,9,177,94,83,2,30,1,1
15272,10,6956,9,198,102,96,2,29,1,1
14150,28,0,0,70,70,0,1,0,1,0
13403,28,0,0,70,70,0,1,0,1,0
8875,26,10404,16,523518,15431,508087,466,210,109,357
6101,15,3727,11,1056,362,694,10,49,6,4
19225,28,0,0,70,70,0,1,0,1,0
12117,26,18743,16,5026,973,4053,19,59,10,9
13749,10,9479,9,474,200,274,6,44,3,3
893,15,271,11,378,192,186,7,29,4,3
13147,26,16858,16,17629,5828,11801,39,41,20,19
21812,10,12505,9,209,110,99,2,30,1,1
4632,26,14027,16,6749,2315,4434,24,46,14,10
15046,10,21500,9,209,110,99,2,30,1,1
8899,26,24660,16,7673,1637,6036,31,23,16,15
10195,1147,0,0,146,146,0,1,0,1,0
14341,1147,0,0,62,62,0,1,0,1,0
20606,1495,24430,1136,70,70,0,2,8,2,0
15370,10,22115,9,177,94,83,2,29,1,1
12610,3216,0,0,66,66,0,1,0,1,0
17183,26,2194,16,5476,3102,2374,42,132,23,19
21942,10,16346,9,190,97,93,2,31,1,1
22299,28,0,0,66,66,0,1,0,1,0
2744,1238,6567,918,906,126,780,2,30,1,1
3336,26,15460,16,1788,968,820,20,15,11,9
283,308,0,0,62,62,0,1,0,1,0
14966,28,0,0,66,66,0,1,0,1,0
6386,26,320,16,8995,2498,6497,40,256,19,21
10864,1771,0,0,66,66,0,1,0,1,0
7465,26,17908,16,10675,4478,6197,25,16,13,12
13404,1888,0,0,62,62,0,1,0,1,0
6027,10,18008,9,257,101,156,2,32,1,1
10978,797,0,0,62,62,0,1,0,1,0
8335,2938,0,0,66,66,0,1,0,1,0
13337,1215,0,0,66,66,0,1,0,1,0
2338,1202,0,0,159,159,0,1,0,1,0
18795,28,0,0,70,70,0,1,0,1,0
271,3216,0,0,62,62,0,1,0,1,0
13105,28,0,0,70,70,0,1,0,1,0
21982,28,0,0,70,70,0,1,0,1,0
6710,26,9563,16,248384,70243,178141,544,588,246,298
601,3216,0,0,62,62,0,1,0,1,0
21456,10,63,9,212,102,110,2,30,1,1
17505,28,0,0,66,66,0,1,0,1,0
14445,10,5043,9,196,102,94,2,30,1,1
9774,28,0,0,70,70,0,1,0,1,0
10997,26,4842,16,21063,13499,7564,47,68,25,22
13981,10,5371,9,770,101,669,2,31,1,1
19662,28,0,0,70,70,0,1,0,1,0
14804,28,0,0,70,70,0,1,0,1,0
15888,10,20589,9,178,94,84,2,31,1,1
2188,1086,0,0,62,62,0,1,0,1,0
13299,10,0,0,188,86,102,2,29,1,1
11210,932,22840,687,70,70,0,2,7,2,0
17195,26,24472,16,148,82,66,2,10,1,1
12675,3139,0,0,62,62,0,1,0,1,0
15788,10,25520,9,168,86,82,2,32,1,1
369,2604,0,0,146,146,0,1,0,1,0
8515,10,28656,9,214,94,120,2,31,1,1
16021,2507,11696,1949,402,132,270,6,1209,3,3
19484,1147,0,0,66,66,0,1,0,1,0
16021,3122,7298,2424,792,792,0,13,1200,13,0
17216,26,1212,16,6376,4098,2278,20,16,10,10
8120,26,23265,16,4922,950,3972,17,34,10,7
16444,2881,0,0,90,90,0,1,0,1,0
14926,10,7448,9,167,86,81,2,30,1,1
8552,10,3920,9,843,285,558,8,56,4,4
18335,28,0,0,70,70,0,1,0,1,0
20103,28,0,0,70,70,0,1,0,1,0
11166,2158,282,1666,70,70,0,1,5,1,0
4297,2636,0,0,62,62,0,1,0,1,0
390,432,0,0,66,66,0,1,0,1,0
13411,28,0,0,70,70,0,1,0,1,0
17587,28,0,0,70,70,0,1,0,1,0
17136,2256,0,0,74,74,0,1,0,1,0
15612,10,15525,9,179,94,85,2,31,1,1
12886,26,7362,16,126027,103934,22093,380,239,237,143
21388,10,2347,9,216,102,114,2,30,1,1
4463,1054,0,0,66,66,0,1,0,1,0
11818,28,0,0,66,66,0,1,0,1,0
14184,1017,0,0,62,62,0,1,0,1,0
9320,10,18109,9,260,86,174,2,30,1,1
14413,10,23961,9,177,94,83,2,30,1,1
8260,10,21161,9,168,78,90,2,30,1,1
13569,28,0,0,70,70,0,1,0,1,0
66,1149,0,0,148,148,0,1,0,1,0
1397,1771,0,0,146,146,0,1,0,1,0
6178,26,5267,16,4295,2123,2172,11,121,6,5
15278,10,27223,9,198,101,97,2,31,1,1
8424,28,0,0,70,70,0,1,0,1,0
8757,234,25317,149,18548,2772,15776,41,3957,17,24
18060,28,0,0,70,70,0,1,0,1,0
21250,10,7868,9,228,110,118,2,30,1,1
22536,10,3955,9,197,102,95,2,30,1,1
7585,10,11567,9,168,78,90,2,30,1,1
15008,26,3810,16,355939,9284,346655,365,121,125,240
18607,28,0,0,66,66,0,1,0,1,0
4882,10,23756,9,199,94,105,2,30,1,1
16951,255,0,0,62,62,0,1,0,1,0
9185,10,26032,9,963,391,572,10,83,5,5
399,1888,0,0,66,66,0,1,0,1,0
6886,2938,0,0,62,62,0,1,0,1,0
16338,28,0,0,66,66,0,1,0,1,0
16140,26,12974,16,2614,1689,925,18,22,10,8
19986,28,0,0,70,70,0,1,0,1,0
20628,28,0,0,70,70,0,1,0,1,0
21226,10,4767,9,216,110,106,2,31,1,1
21410,10,21868,9,192,98,94,2,31,1,1
8900,7,0,0,60,60,0,1,0,1,0
15319,10,19195,9,740,93,647,2,31,1,1
13673,26,23101,16,6484,1915,4569,26,131,14,12
754,10,3043,9,407,261,146,3,32,2,1
15229,26,429,16,8007,1987,6020,20,15,11,9
20846,2486,0,0,62,62,0,1,0,1,0
10583,26,8211,16,262,70,192,5,21,2,3
17922,10,0,0,86,86,0,1,30,1,0
15153,28,0,0,66,66,0,1,0,1,0
1708,10,6268,9,229,89,140,2,30,1,1
5908,2587,0,0,66,66,0,1,0,1,0
17827,2256,0,0,62,62,0,1,0,1,0
22671,10,17536,9,174,89,85,2,31,1,1
21844,10,17547,9,198,94,104,2,30,1,1
15667,10,17882,9,192,90,102,2,31,1,1
20921,28,0,0,70,70,0,1,0,1,0
1500,3216,0,0,62,62,0,1,0,1,0
2068,31,0,0,60,60,0,1,0,1,0
0,0,0,0,98,98,0,1,0,1,0
18757,26,21808,16,12605,5558,7047,42,101,18,24
18229,10,20519,9,218,78,140,2,30,1,1
8924,26,5860,16,17412,6917,10495,38,63,20,18
22085,10,15351,9,164,84,80,2,30,1,1
12068,15,18691,11,1628,828,800,10,25,6,4
0,0,0,0,480,244,236,4,0,2,2
18274,15,26430,11,70,70,0,1,5,1,0
615,23,0,0,82,82,0,1,0,1,0
5546,26,14360,16,3470,1045,2425,13,121,6,7
497,2220,0,0,167,167,0,1,0,1,0
2681,2938,0,0,66,66,0,1,0,1,0
8475,10,12862,9,195,102,93,2,31,1,1
13440,2587,0,0,66,66,0,1,0,1,0
22059,10,8865,9,173,94,79,2,30,1,1
14560,26,22370,16,6490,1789,4701,30,95,16,14
12419,10,21823,9,198,93,105,2,30,1,1
9411,993,25957,732,390,266,124,6,1200,4,2
14122,10,26752,9,199,102,97,2,31,1,1
19386,26,1594,16,27232,3841,23391,42,38,17,25
9042,10,22973,9,262,126,136,2,30,1,1
15501,10,25144,9,823,98,725,2,30,1,1
8697,1215,0,0,66,66,0,1,0,1,0
19314,2938,0,0,66,66,0,1,0,1,0
15301,26,12412,16,7941,1952,5989,20,15,11,9
3307,15,12824,11,14961,937,14024,25,16,11,14
13914,10,22432,9,193,102,91,2,30,1,1
6525,26,1910,16,6951,1333,5618,26,271,14,12
1674,2883,0,0,62,62,0,1,0,1,0
3235,2486,0,0,148,148,0,1,0,1,0
17803,2587,0,0,66,66,0,1,0,1,0
12,2346,0,0,332,332,0,1,0,1,0
15651,10,11622,9,198,102,96,2,30,1,1
15165,10,12541,9,199,102,97,2,30,1,1
8606,10,16259,9,210,102,108,2,29,1,1
4184,26,15209,16,14940,9434,5506,30,105,17,13
397,2852,0,0,66,66,0,1,0,1,0
19283,2205,0,0,62,62,0,1,0,1,0
20810,26,1296,16,3182,1568,1614,8,120,4,4
10122,28,0,0,66,66,0,1,0,1,0
2248,1147,0,0,146,146,0,1,0,1,0
10203,2883,0,0,66,66,0,1,0,1,0
11083,1718,17445,1312,70,70,0,1,4,1,0
18557,281,24532,178,70,70,0,2,8,2,0
9160,10,14536,9,210,102,108,2,30,1,1
14309,1549,933,1180,70,70,0,2,8,2,0
8012,26,12494,16,16198,9822,6376,54,35,28,26
14543,28,0,0,70,70,0,1,0,1,0
8790,10,16289,9,216,94,122,2,30,1,1
636,280,26974,177,150,150,0,1,1200,1,0
18093,26,1814,16,6452,2146,4306,30,125,14,16
14692,28,0,0,70,70,0,1,0,1,0
11458,28,0,0,66,66,0,1,0,1,0
9010,28,0,0,70,70,0,1,0,1,0
18360,15,26696,11,8876,1061,7815,18,144,9,9
11544,28,0,0,70,70,0,1,0,1,0
10858,28,0,0,66,66,0,1,0,1,0
20189,28,0,0,70,70,0,1,0,1,0
2422,2731,0,0,76,76,0,1,0,1,0
19725,28,0,0,70,70,0,1,0,1,0
16703,28,0,0,70,70,0,1,0,1,0
17065,26,10288,16,26158,17265,8893,57,19,31,26
612,262,0,0,60,60,0,1,0,1,0
8912,10,4553,9,236,94,142,2,29,1,1
3792,26,28649,16,9265,4429,4836,23,18,14,9
20569,2256,0,0,66,66,0,1,0,1,0
9834,26,3569,16,152,86,66,2,4,1,1
8232,26,5359,16,6107,2079,4028,19,68,11,8
3230,2587,0,0,66,66,0,1,0,1,0
6795,15,5143,11,3560,1256,2304,22,86,10,12
9571,28,0,0,70,70,0,1,0,1,0
10547,26,19939,16,4945,1060,3885,21,15,12,9
10325,28,0,0,70,70,0,1,0,1,0
0,0,0,0,94,94,0,1,0,1,0
17677,2747,0,0,66,66,0,1,0,1,0
9693,2205,0,0,66,66,0,1,0,1,0
9473,10,8402,9,783,96,687,2,30,1,1
11091,15,3044,11,366,240,126,7,25,5,2
15378,10,21690,9,195,102,93,2,29,1,1
636,280,0,0,62,62,0,1,0,1,0
14228,6,0,0,60,60,0,1,0,1,0
21162,2256,0,0,62,62,0,1,0,1,0
2118,1771,0,0,62,62,0,1,0,1,0
5516,15,19125,11,1779,793,986,17,58,6,11
4684,26,25663,16,573,425,148,5,0,3,2
757,2587,0,0,66,66,0,1,0,1,0
17965,28,0,0,66,66,0,1,0,1,0
21586,10,24709,9,195,102,93,2,30,1,1
11905,26,12764,16,16537,4585,11952,46,96,24,22
7307,26,16092,16,4819,829,3990,15,40,8,7
4303,26,23121,16,1149,709,440,13,38,8,5
10292,28,0,0,66,66,0,1,0,1,0
14472,10,24687,9,197,102,95,2,30,1,1
21653,1147,0,0,62,62,0,1,0,1,0
18871,26,12499,16,3072,2174,898,14,317,8,6
9172,10,713,9,232,94,138,2,29,1,1
10656,2883,0,0,66,66,0,1,0,1,0
18632,1147,0,0,62,62,0,1,0,1,0
8334,15,21349,11,1915,1466,449,10,20,6,4
2346,2256,0,0,62,62,0,1,0,1,0
11278,419,19261,272,210,70,140,4,8,2,2
11864,10,21935,9,168,78,90,2,29,1,1
1219,1336,12563,1011,460,150,310,2,1200,1,1
360,3105,0,0,343,343,0,1,0,1,0
8222,2611,0,0,62,62,0,1,0,1,0
21368,3250,23502,2519,70,70,0,1,4,1,0
5593,26,23656,16,232,172,60,3,5,2,1
8786,10,6685,9,198,110,88,2,29,1,1
15829,26,15142,16,6445,2145,4300,29,33,17,12
10389,26,8344,16,7134,3081,4053,24,121,11,13
20840,1880,0,0,62,62,0,1,0,1,0
9673,2256,0,0,66,66,0,1,0,1,0
2698,6,0,0,60,60,0,1,0,1,0
14620,26,24708,16,4334,1427,2907,19,30,11,8
1320,1888,0,0,62,62,0,1,0,1,0
13667,26,7876,16,7531,1773,5758,30,32,17,13
11457,26,6155,16,5343,1102,4241,22,152,11,11
20579,28,0,0,70,70,0,1,0,1,0
3281,10,26075,9,168,78,90,2,30,1,1
6785,26,19075,16,4401,1494,2907,19,29,11,8
7301,26,4602,16,4201,2089,2112,11,120,6,5
11340,26,22909,16,6727,762,5965,15,25,8,7
15292,26,11730,16,8006,1986,6020,20,15,11,9
2424,2853,0,0,62,62,0,1,0,1,0
1622,2604,0,0,62,62,0,1,0,1,0
20362,28,0,0,70,70,0,1,0,1,0
22235,10,12362,9,786,110,676,2,29,1,1
8577,10,6829,9,190,97,93,2,31,1,1
20490,10,21468,9,243,94,149,2,30,1,1
3361,26,6219,16,75816,2178,73638,72,16,20,52
16951,255,0,0,62,62,0,1,0,1,0
13790,1215,0,0,62,62,0,1,0,1,0
13379,28,0,0,70,70,0,1,0,1,0
9984,28,0,0,66,66,0,1,0,1,0
1762,2883,0,0,62,62,0,1,0,1,0
15251,28,0,0,70,70,0,1,0,1,0
22639,10,2198,9,264,110,154,2,30,1,1
6681,26,2822,16,7698,2373,5325,21,159,12,9
15400,10,943,9,177,94,83,2,30,1,1
16989,28,0,0,70,70,0,1,0,1,0
16951,255,0,0,62,62,0,1,0,1,0
17604,26,25336,16,2914,1780,1134,16,15,8,8
7037,26,19467,16,5469,2222,3247,22,38,13,9
14612,10,17952,9,403,142,261,2,30,1,1
19225,10,8621,9,8616,4944,3672,22,87,11,11
497,82,0,0,103,103,0,1,0,1,0
5979,26,19134,16,4987881,144889,4842992,5257,85,1888,3369
8920,10,24026,9,176,90,86,2,31,1,1
16896,28,0,0,66,66,0,1,0,1,0
12097,847,0,0,62,62,0,1,0,1,0
14502,10,22224,9,186,95,91,2,31,1,1
8865,10,21316,9,209,110,99,2,30,1,1
13215,26,26528,16,9818,2008,7810,23,317,12,11
20046,28,0,0,70,70,0,1,0,1,0
15814,10,4693,9,764,99,665,2,30,1,1
14499,10,23854,9,166,86,80,2,31,1,1
13670,70,15841,53,6723,1881,4842,25,16,15,10
15499,28,0,0,70,70,0,1,0,1,0
14860,10,27321,9,194,99,95,2,30,1,1
8790,28,0,0,70,70,0,1,0,1,0
8500,28,0,0,66,66,0,1,0,1,0
12051,28,0,0,70,70,0,1,0,1,0
4114,26,10693,16,8290,2954,5336,24,361,13,11
21797,10,3106,9,193,102,91,2,29,1,1
360,3105,0,0,1188,1188,0,1,0,1,0
8739,26,4147,16,1326,876,450,11,55,6,5
14302,2488,11908,1935,70,70,0,1,5,1,0
14597,10,12202,9,183,94,89,2,30,1,1
17242,26,12384,16,6611,4273,2338,22,17,11,11
9540,3139,0,0,66,66,0,1,0,1,0
8584,1248,723,928,250,78,172,2,30,1,1
20013,2587,0,0,62,62,0,1,0,1,0
2631,1017,0,0,62,62,0,1,0,1,0
22390,10,8163,9,392,86,306,2,30,1,1
6165,8,0,0,74,74,0,1,0,1,0
10123,1795,0,0,60,60,0,1,0,1,0
16452,28,0,0,70,70,0,1,0,1,0
2744,1238,19844,918,899,126,773,2,30,1,1
6999,280,4576,177,502,150,352,2,1200,1,1
874,26,28750,16,5510,901,4609,15,26,8,7
18123,28,0,0,70,70,0,1,0,1,0
547,1017,0,0,62,62,0,1,0,1,0
20281,28,0,0,66,66,0,1,0,1,0
15887,10,27100,9,177,94,83,2,30,1,1
6,13,0,0,346,346,0,1,0,1,0
21110,2735,11160,2121,66,66,0,2,7,2,0
20379,2587,0,0,66,66,0,1,0,1,0
8475,10,15193,9,320,97,223,4,50,2,2
11734,28,0,0,66,66,0,1,0,1,0
16350,1215,0,0,62,62,0,1,0,1,0
1555,1017,0,0,146,146,0,1,0,1,0
19538,28,0,0,70,70,0,1,0,1,0
20790,28,0,0,70,70,0,1,0,1,0
10321,26,28097,16,7924,3247,4677,32,71,19,13
14653,10,9391,9,177,94,83,2,30,1,1
11072,1895,23276,1448,70,70,0,2,8,2,0
22696,26,896,16,453047,13340,439707,469,16,165,304
7161,10,5759,9,538,328,210,3,29,2,1
9754,28,0,0,66,66,0,1,0,1,0
22090,1861,0,0,66,66,0,1,0,1,0
18143,28,0,0,70,70,0,1,0,1,0
15279,10,14070,9,711,87,624,2,30,1,1
5748,18,19190,13,184,94,90,2,30,1,1
22421,28,0,0,70,70,0,1,0,1,0
20446,28,0,0,66,66,0,1,0,1,0
636,280,0,0,146,146,0,1,0,1,0
1510,339,0,0,62,62,0,1,0,1,0
8210,307,21194,201,479,152,327,2,1200,1,1
8536,28,0,0,70,70,0,1,0,1,0
21936,10,298,9,195,102,93,2,29,1,1
5535,155,0,0,62,62,0,1,0,1,0
10052,26,294,16,24070,16123,7947,82,6308,42,40
13503,26,26408,16,3429,1188,2241,13,134,6,7
13755,26,15925,16,10470,3626,6844,20,131,9,11
17189,26,2191,16,7871,5455,2416,24,18,13,11
2638,15,11090,11,642,338,304,10,32,6,4
13225,3216,0,0,62,62,0,1,0,1,0
18127,26,17659,16,1057,590,467,11,142,6,5
20882,28,0,0,70,70,0,1,0,1,0
20614,28,0,0,66,66,0,1,0,1,0
4623,1017,0,0,62,62,0,1,0,1,0
2744,1298,17809,976,891,126,765,2,30,1,1
19335,26,4279,16,7832,1143,6689,19,31,9,10
16875,28,0,0,66,66,0,1,0,1,0
22451,10,15207,9,321,150,171,2,30,1,1
8171,1073,0,0,60,60,0,1,0,1,0
9457,15,17611,11,2699,1007,1692,14,64,7,7
1460,2938,0,0,62,62,0,1,0,1,0
1649,26,24340,16,2589,1443,1146,18,15,8,10
11842,15,23200,11,98765,5293,93472,131,199,48,83
22125,10,14171,9,183,94,89,2,31,1,1
14378,10,3249,9,216,94,122,2,30,1,1
6910,26,23716,16,1101393,30310,1071083,1137,109,381,756
9426,2938,0,0,78,78,0,1,0,1,0
8165,509,0,0,62,62,0,1,0,1,0
8640,26,13635,16,10315,2018,8297,24,158,12,12
381,2883,0,0,62,62,0,1,0,1,0
8928,10,9615,9,760,97,663,2,30,1,1
13668,10,3544,9,716,95,621,2,31,1,1
16021,1782,10337,1360,132,132,0,3,1200,3,0
10732,1114,21748,819,70,70,0,1,5,1,0
3197,1017,0,0,62,62,0,1,0,1,0
22257,10,6300,9,297,96,201,4,42,2,2
14210,10,4448,9,778,103,675,2,31,1,1
16721,28,0,0,70,70,0,1,0,1,0
10345,28,0,0,70,70,0,1,0,1,0
232,1771,0,0,66,66,0,1,0,1,0
16300,28,0,0,66,66,0,1,0,1,0
11264,3241,18675,2512,136,136,0,3,14,3,0
5957,1472,0,0,146,146,0,1,0,1,0
13712,10,16069,9,216,110,106,2,30,1,1
14165,10,4282,9,168,86,82,2,29,1,1
15461,28,0,0,66,66,0,1,0,1,0
3055,983,0,0,146,146,0,1,0,1,0
13167,28,0,0,70,70,0,1,0,1,0
9547,28,0,0,66,66,0,1,0,1,0
22151,28,0,0,66,66,0,1,0,1,0
10716,15,4459,11,1516,481,1035,11,15,6,5
8421,10,13604,9,814,110,704,2,30,1,1
11052,28,0,0,66,66,0,1,0,1,0
11582,28,0,0,70,70,0,1,0,1,0
9635,26,19854,16,1304,878,426,12,78,7,5
19732,28,0,0,70,70,0,1,0,1,0
19987,15,26618,11,384,384,0,7,34,7,0
9725,28,0,0,70,70,0,1,0,1,0
16528,1820,12237,1387,268,128,140,5,10,3,2
0,0,0,0,98,98,0,1,0,1,0
14800,28,0,0,66,66,0,1,0,1,0
15303,10,3387,9,166,86,80,2,31,1,1
22620,10,5806,9,200,94,106,2,30,1,1
11928,15,27786,11,70,70,0,1,5,1,0
4079,1147,0,0,66,66,0,1,0,1,0
21366,15,28493,11,2244,1505,739,11,146,6,5
8472,10,8588,9,571,181,390,6,73,3,3
11941,28,0,0,66,66,0,1,0,1,0
1938,1147,0,0,62,62,0,1,0,1,0
2548,613,0,0,60,60,0,1,0,1,0
17625,1017,0,0,66,66,0,1,0,1,0
14728,10,26265,9,183,94,89,2,29,1,1
18802,2636,0,0,66,66,0,1,0,1,0
15246,15,13499,11,234,234,0,4,12,4,0
7326,1649,0,0,60,60,0,1,0,1,0
13306,28,0,0,70,70,0,1,0,1,0
9594,15,15301,11,2781,563,2218,11,125,6,5
12228,28,0,0,70,70,0,1,0,1,0
22219,28,0,0,70,70,0,1,0,1,0
7415,15,26545,11,3459,1620,1839,16,186,10,6
8932,15,6608,11,254,128,126,5,15,3,2
21307,1102,10183,809,442,320,122,7,17,5,2
20935,2604,0,0,66,66,0,1,0,1,0
1294,2587,0,0,62,62,0,1,0,1,0
8364,1472,0,0,62,62,0,1,0,1,0
10837,485,20796,318,70,70,0,2,8,2,0
10346,1,0,0,100,100,0,1,0,1,0
15470,296,6113,191,1098,672,426,14,734,8,6
14048,10,14507,9,183,94,89,2,30,1,1
4132,509,0,0,146,146,0,1,0,1,0
4956,2636,0,0,66,66,0,1,0,1,0
6770,295,19030,190,3370,1595,1775,16,15,9,7
13809,10,3710,9,197,102,95,2,30,1,1
18,2573,0,0,62,62,0,1,0,1,0
11116,1286,3064,965,136,136,0,3,14,3,0
13815,10,17266,9,199,102,97,2,30,1,1
3935,509,0,0,62,62,0,1,0,1,0
0,0,0,0,98,98,0,1,0,1,0
6449,356,0,0,62,62,0,1,0,1,0
13875,10,3306,9,173,94,79,2,30,1,1
12462,28,0,0,70,70,0,1,0,1,0
12167,26,8950,16,38395,6930,31465,56,30,27,29
15121,10,27741,9,760,97,663,2,31,1,1
13906,10,23764,9,183,94,89,2,30,1,1
17234,26,28360,16,5167,700,4467,16,15,7,9
748,15,3026,11,25909,3016,22893,40,83,15,25
5570,1017,0,0,62,62,0,1,0,1,0
9635,26,14041,16,28729,1634,27095,40,120,16,24
18078,28,0,0,70,70,0,1,0,1,0
4587,26,9265,16,416,210,206,7,29,4,3
5154,7,0,0,60,60,0,1,0,1,0
14072,1147,0,0,146,146,0,1,0,1,0
20062,28,0,0,66,66,0,1,0,1,0
2476,2256,0,0,146,146,0,1,0,1,0
8515,10,12046,9,312,96,216,4,35,2,2
7667,15,24070,11,1687,951,736,10,93,6,4
17559,1888,0,0,66,66,0,1,0,1,0
11243,28,0,0,66,66,0,1,0,1,0
13537,1888,0,0,62,62,0,1,0,1,0
3133,2332,17118,1816,330,330,0,6,3609,6,0
14969,26,9295,16,11093,2322,8771,40,17,23,17
19016,983,0,0,66,66,0,1,0,1,0
15950,10,6940,9,186,95,91,2,31,1,1
9468,28,0,0,70,70,0,1,0,1,0
21370,10,8258,9,170,87,83,2,30,1,1
17750,28,0,0,70,70,0,1,0,1,0
10113,26,11618,16,8023,3352,4671,19,80,11,8
11836,26,12338,16,5582,1388,4194,19,15,9,10
15820,26,2200,16,7748,3859,3889,20,148,10,10
17996,26,10663,16,4350,2061,2289,18,47,10,8
2010,1543,0,0,74,74,0,1,91,1,0
10999,26,3564,16,15609,5649,9960,58,76,31,27
19775,28,0,0,70,70,0,1,0,1,0
13907,10,24410,9,165,86,79,2,29,1,1
6241,26,18316,16,2052,1187,865,21,76,11,10
21933,28,0,0,70,70,0,1,0,1,0
6968,26,26127,16,7998,1347,6651,49,1647,10,39
19553,28,0,0,66,66,0,1,0,1,0
12239,28,0,0,66,66,0,1,0,1,0
12391,2382,0,0,66,66,0,1,0,1,0
5221,26,16783,16,4425,1518,2907,19,29,11,8
21397,10,4431,9,214,110,104,2,30,1,1
17356,28,0,0,70,70,0,1,0,1,0
19294,28,0,0,70,70,0,1,0,1,0
15218,10,10760,9,195,102,93,2,31,1,1
11761,28,0,0,70,70,0,1,0,1,0
9185,28,0,0,66,66,0,1,0,1,0
11236,26,20074,16,6278,682,5596,17,20,8,9
11148,28,0,0,70,70,0,1,0,1,0
21575,10,21127,9,199,102,97,2,30,1,1
9178,28,0,0,70,70,0,1,0,1,0
20623,28,0,0,70,70,0,1,0,1,0
15023,10,15836,9,730,102,628,2,29,1,1
19477,28,0,0,70,70,0,1,0,1,0
145,509,0,0,62,62,0,1,0,1,0
15599,28,0,0,70,70,0,1,0,1,0
18088,28,0,0,70,70,0,1,0,1,0
13837,28,0,0,70,70,0,1,0,1,0
21922,10,22956,9,193,102,91,2,30,1,1
16149,10,13953,9,164,78,86,2,30,1,1
13608,28,0,0,70,70,0,1,0,1,0
8216,26,27772,16,1348406,28891,1319515,1247,31,340,907
21609,10,25166,9,183,94,89,2,30,1,1
8684,10,14901,9,213,102,111,2,30,1,1
9208,26,12259,16,12134,6888,5246,27,37,15,12
14709,10,19797,9,211,102,109,2,30,1,1
16820,26,25890,16,4593,1616,2977,19,76,10,9
17684,28,0,0,66,66,0,1,0,1,0
13930,1888,0,0,66,66,0,1,0,1,0
706,2587,0,0,66,66,0,1,0,1,0
0,0,0,0,98,98,0,1,0,1,0
3163,2710,0,0,100,100,0,1,0,1,0
16196,10,10485,9,273,94,179,2,30,1,1
16399,1472,0,0,62,62,0,1,0,1,0
16277,28,0,0,66,66,0,1,0,1,0
10262,26,10878,16,5092,2574,2518,14,135,7,7
19476,15,27352,11,48702,2799,45903,74,110,38,36
14942,26,13842,16,3775,1791,1984,24,203,12,12
12089,26,10694,16,1462,965,497,13,18,7,6
16951,255,0,0,62,62,0,1,0,1,0
1924,1054,0,0,66,66,0,1,0,1,0
18672,28,0,0,70,70,0,1,0,1,0
15838,10,24250,9,178,94,84,2,30,1,1
15816,10,18766,9,199,102,97,2,31,1,1
15553,10,14363,9,526,188,338,6,48,3,3
16887,28,0,0,66,66,0,1,0,1,0
840,26,24097,16,62149740,2002795,60146945,62894,211,19380,43514
1502,2697,0,0,66,66,0,1,0,1,0
18098,10,13549,9,481,110,371,2,31,1,1
16086,28,0,0,70,70,0,1,0,1,0
13699,28,0,0,70,70,0,1,0,1,0
13892,26,4970,16,6144,1810,4334,18,45,11,7
9068,10,8990,9,749,94,655,2,30,1,1
10127,26,3610,16,6765,1108,5657,17,18,10,7
15299,10,6171,9,749,89,660,2,31,1,1
4433,26,28074,16,7195,1791,5404,18,99,11,7
13618,28,0,0,66,66,0,1,0,1,0
9805,28,0,0,70,70,0,1,0,1,0
2448,280,0,0,146,146,0,1,0,1,0
17770,1017,0,0,62,62,0,1,0,1,0
17342,2587,0,0,62,62,0,1,0,1,0
13757,28,0,0,70,70,0,1,0,1,0
13938,10,21122,9,295,101,194,4,30,2,2
21427,10,21636,9,370,126,244,2,30,1,1
16765,2587,0,0,146,146,0,1,0,1,0
21582,10,17883,9,210,110,100,2,31,1,1
15650,10,0,0,82,82,0,1,30,1,0
13273,26,1600,16,1574197,46737,1527460,1590,34,557,1033
12956,28,0,0,70,70,0,1,0,1,0
11531,26,13648,16,3530,1002,2528,12,120,6,6
15854,26,3905,16,5614,733,4881,16,15,9,7
8782,28,0,0,70,70,0,1,0,1,0
13937,28,0,0,70,70,0,1,0,1,0
9181,10,24354,9,190,97,93,2,31,1,1
21424,10,18949,9,194,102,92,2,30,1,1
9408,26,28560,16,11220,726,10494,18,75,8,10
14905,10,486,9,209,110,99,2,30,1,1
15406,466,10862,301,70,70,0,1,5,1,0
8692,10,27015,9,402,118,284,2,30,1,1
10975,112,661,86,66,66,0,1,5,1,0
17020,26,2596,16,18880,7831,11049,37,18,19,18
16951,255,0,0,62,62,0,1,0,1,0
12452,1936,0,0,66,66,0,1,0,1,0
16951,255,0,0,62,62,0,1,0,1,0
17717,2938,0,0,66,66,0,1,0,1,0
1525,1444,0,0,145,145,0,1,0,1,0
8611,15,8153,11,1586,808,778,13,45,7,6
22444,10,14635,9,182,93,89,2,31,1,1
21242,10,8847,9,185,93,92,3,58,2,1
17099,1472,0,0,62,62,0,1,0,1,0
10248,28,0,0,66,66,0,1,0,1,0
13428,26,24054,16,4728,1821,2907,19,29,11,8
17901,26,6848,16,6698,1606,5092,23,19,13,10
15076,10,2297,9,199,102,97,2,30,1,1
7618,10,18383,9,326,78,248,2,30,1,1
16951,255,0,0,62,62,0,1,0,1,0
10138,28,0,0,70,70,0,1,0,1,0
21920,28,0,0,70,70,0,1,0,1,0
8599,10,11703,9,173,94,79,2,30,1,1
2548,138,0,0,60,60,0,1,0,1,0
18579,10,24257,9,215,94,121,2,29,1,1
16322,28,0,0,70,70,0,1,0,1,0
9978,28,0,0,70,70,0,1,0,1,0
3449,26,12184,16,9917,3184,6733,30,91,12,18
22446,28,0,0,66,66,0,1,0,1,0
4090,26,352,16,9685,2504,7181,26,153,11,15
2764,39,0,0,60,60,0,1,0,1,0
19863,28,0,0,70,70,0,1,0,1,0
13304,1147,0,0,62,62,0,1,0,1,0
18028,10,2728,9,197,78,119,2,30,1,1
21871,10,12723,9,364,89,275,4,33,2,2
8276,3269,0,0,174,174,0,1,0,1,0
15686,10,1704,9,199,102,97,2,29,1,1
11121,223,5056,144,70,70,0,2,7,2,0
13664,28,0,0,70,70,0,1,0,1,0
9694,234,10138,149,2661,1518,1143,18,3600,9,9
6250,2001,21264,1531,730,548,182,4,30,2,2
16387,26,19630,16,9578079,276384,9301695,9817,153,2984,6833
9012,10,26651,9,260,102,158,2,30,1,1
19776,1017,0,0,66,66,0,1,0,1,0
22501,28,0,0,70,70,0,1,0,1,0
8547,26,4573,16,2382775,72482,2310293,2485,252,843,1642
21259,28,0,0,66,66,0,1,0,1,0
18042,26,5194,16,70,70,0,1,5,1,0
15073,10,12362,9,198,101,97,2,30,1,1
19202,28,0,0,66,66,0,1,0,1,0
15115,26,11099,16,8490,2953,5537,27,569,15,12
8440,10,7220,9,342,110,232,2,30,1,1
9697,28,0,0,66,66,0,1,0,1,0
18529,28,0,0,70,70,0,1,0,1,0
18389,15,6680,11,3697,2062,1635,16,61,9,7
12098,28,0,0,70,70,0,1,0,1,0
22577,28,0,0,66,66,0,1,0,1,0
18742,1017,0,0,62,62,0,1,0,1,0
11798,15,20862,11,5688,2508,3180,36,118,19,17
6192,1804,0,0,66,66,0,1,0,1,0
8220,1880,0,0,146,146,0,1,0,1,0
12198,28,0,0,70,70,0,1,0,1,0
22429,10,24438,9,186,95,91,2,30,1,1
20163,2636,0,0,66,66,0,1,0,1,0
9648,26,27759,16,6051,1149,4902,16,25,9,7
11260,2573,0,0,62,62,0,1,0,1,0
21125,291,9962,187,66,66,0,2,8,2,0
19521,7,0,0,60,60,0,1,0,1,0
10799,3,0,0,60,60,0,1,0,1,0
8210,3220,21194,2497,481,150,331,2,1200,1,1
11117,15,4118,11,2757,648,2109,12,23,7,5
3844,10,27248,9,168,78,90,2,30,1,1
21045,1204,17706,891,70,70,0,1,4,1,0
15244,15,8819,11,234,234,0,4,12,4,0
7878,26,499,16,7576,2983,4593,33,42,18,15
22497,10,9420,9,760,96,664,2,31,1,1
13726,10,13553,9,168,86,82,2,31,1,1
7770,15,10966,11,1737,796,941,12,16,7,5
175,15,27775,11,214,140,74,4,15,3,1
15238,10,18049,9,181,94,87,2,33,1,1
9192,10,28561,9,256,102,154,2,30,1,1
15212,10,14526,9,199,102,97,2,31,1,1
15237,26,3890,16,8007,1987,6020,20,15,11,9
17693,28,0,0,70,70,0,1,0,1,0
16900,10,737,9,294,86,208,2,30,1,1
18486,2662,21565,2069,260,140,120,5,9,3,2
10245,15,2392,11,2794,2075,719,15,30,9,6
1395,2938,0,0,66,66,0,1,0,1,0
13965,28,0,0,70,70,0,1,0,1,0
22006,10,12201,9,195,102,93,2,29,1,1
8943,10,19870,9,166,86,80,2,31,1,1
10985,1973,9591,1506,70,70,0,2,8,2,0
13307,10,23971,9,832,106,726,2,30,1,1
10661,28,0,0,70,70,0,1,0,1,0
22417,10,26557,9,244,94,150,2,30,1,1
10040,28,0,0,70,70,0,1,0,1,0
15264,28,0,0,66,66,0,1,0,1,0
19330,28,0,0,66,66,0,1,0,1,0
8713,28,0,0,70,70,0,1,0,1,0
15387,10,20345,9,767,102,665,2,30,1,1
360,3105,0,0,455,455,0,1,0,1,0
2053,7,0,0,60,60,0,1,0,1,0
16021,3210,11385,2490,1660,677,983,20,1600,10,10
515,1888,0,0,66,66,0,1,0,1,0
9271,2636,0,0,66,66,0,1,0,1,0
6635,146,0,0,60,60,0,1,0,1,0
16951,255,0,0,62,62,0,1,0,1,0
13627,10,6658,9,181,94,87,2,31,1,1
17185,28,0,0,66,66,0,1,0,1,0
73,10,66,9,213,79,134,2,33,1,1
21417,10,2138,9,504,105,399,4,35,2,2
17568,2256,0,0,66,66,0,1,0,1,0
21308,1182,13637,872,436,254,182,7,14,4,3
15314,10,29001,9,195,102,93,2,30,1,1
19120,26,27160,16,4599,1692,2907,19,29,11,8
18335,26,15117,16,5889,2893,2996,45,149,24,21
4528,26,26232,16,17716,5150,12566,48,21,25,23
1883,1147,0,0,66,66,0,1,0,1,0
15018,10,8581,9,177,94,83,2,29,1,1
2090,1017,0,0,62,62,0,1,0,1,0
17813,26,9209,16,13310,4422,8888,47,136,27,20
22309,28,0,0,70,70,0,1,0,1,0
14722,1771,0,0,62,62,0,1,0,1,0
10621,2486,0,0,66,66,0,1,0,1,0
9109,10,5867,9,281,97,184,4,56,2,2
9347,10,21177,9,756,95,661,2,31,1,1
4343,10,15698,9,414,268,146,3,32,2,1
3109,2611,0,0,72,72,0,1,0,1,0
21071,313,8342,204,70,70,0,1,5,1,0
8735,15,17866,11,454,262,192,8,44,5,3
22467,10,7773,9,226,102,124,2,30,1,1
8618,10,27080,9,244,110,134,2,30,1,1
8154,2440,0,0,145,145,0,1,0,1,0
16027,28,0,0,66,66,0,1,0,1,0
20787,28,0,0,70,70,0,1,0,1,0
6365,15,27896,11,63654,7979,55675,90,91,49,41
12510,1553,6250,1184,70,70,0,1,4,1,0
21135,28,0,0,70,70,0,1,0,1,0
12245,3216,0,0,66,66,0,1,0,1,0
12214,104,0,0,60,60,0,1,0,1,0
2744,1283,6958,962,913,126,787,2,31,1,1
11511,15,19446,11,1056,682,374,10,15,6,4
3431,2587,0,0,146,146,0,1,0,1,0
21490,28,0,0,70,70,0,1,0,1,0
11352,26,13678,16,96091,8340,87751,159,205,75,84
16560,1147,0,0,66,66,0,1,0,1,0
2334,432,0,0,62,62,0,1,0,1,0
21362,26,28491,16,150808,48110,102698,173,173,82,91
22032,10,24407,9,272,93,179,4,33,2,2
15603,10,18335,9,283,101,182,4,37,2,2
21206,1888,0,0,62,62,0,1,0,1,0
13498,28,0,0,70,70,0,1,0,1,0
4592,26,24648,16,558,210,348,9,28,4,5
11385,28,0,0,70,70,0,1,0,1,0
15411,28,0,0,70,70,0,1,0,1,0
21218,10,24948,9,182,93,89,2,30,1,1
2548,951,0,0,60,60,0,1,0,1,0
16934,26,6886,16,12164,4840,7324,29,198,16,13
8475,26,17128,16,4256,2975,1281,23,47,12,11
13959,28,0,0,70,70,0,1,0,1,0
14983,28,0,0,66,66,0,1,0,1,0
14059,28,0,0,66,66,0,1,0,1,0
11686,26,19653,16,148418,107579,40839,315,6090,107,208
13244,28,0,0,66,66,0,1,0,1,0
9790,28,0,0,70,70,0,1,0,1,0
12553,15,26025,11,5778,661,5117,17,75,8,9
21119,28,0,0,66,66,0,1,0,1,0
20205,26,15969,16,3931,678,3253,15,140,6,9
9276,26,24028,16,29503,9695,19808,55,34,30,25
22705,10,8322,9,506,204,302,6,57,3,3
19874,1771,0,0,66,66,0,1,0,1,0
9303,15,25177,11,9058,868,8190,18,46,10,8
13452,2581,0,0,66,66,0,1,0,1,0
20301,26,16084,16,22187,14208,7979,52,130,25,27
13291,28,0,0,66,66,0,1,0,1,0
10590,216,22536,139,156,156,0,3,8,3,0
5449,7,0,0,60,60,0,1,0,1,0
8343,26,20325,16,2802,1902,900,22,1118,12,10
10042,28,0,0,70,70,0,1,0,1,0
9137,10,19658,9,309,110,199,2,30,1,1
14107,10,2312,9,197,102,95,2,30,1,1
2548,1734,0,0,60,60,0,1,0,1,0
13556,26,21894,16,1775,169,1606,7,122,3,4
7186,26,25207,16,7710,3375,4335,32,131,18,14
1337,2012,1077,1542,213,89,124,4,32,2,2
3786,10,5770,9,168,78,90,2,30,1,1
16951,255,25970,160,66,66,0,1,5,1,0
14221,10,27746,9,193,102,91,2,30,1,1
9141,2938,0,0,62,62,0,1,0,1,0
16578,26,6187,16,17812,8128,9684,55,343,27,28
17077,26,18315,16,2577,1550,1027,15,16,7,8
17570,10,13479,9,242,78,164,2,30,1,1
9428,26,28739,16,15775,3795,11980,48,18,32,16
14361,10,12852,9,177,94,83,2,30,1,1
16501,15,12119,11,2306,1112,1194,23,76,12,11
16189,2695,0,0,66,66,0,1,0,1,0
16951,255,0,0,62,62,0,1,0,1,0
15104,26,27502,16,7563,3697,3866,19,15,10,9
13089,1017,0,0,66,66,0,1,0,1,0
7169,7,0,0,60,60,0,1,0,1,0
10251,15,190,11,366,240,126,7,21,5,2
17295,28,0,0,70,70,0,1,0,1,0
8954,10,7272,9,198,102,96,2,32,1,1
636,464,27155,300,118,118,0,1,1199,1,0
8772,28,0,0,66,66,0,1,0,1,0
15778,1215,0,0,66,66,0,1,0,1,0
15257,10,3630,9,196,86,110,2,30,1,1
22419,10,22992,9,197,102,95,2,31,1,1
5459,26,5164,16,7259,3893,3366,34,236,18,16
5214,26,26452,16,13623,2693,10930,22,123,10,12
16708,28,0,0,70,70,0,1,0,1,0
5048,1017,0,0,62,62,0,1,0,1,0
21449,28,0,0,70,70,0,1,0,1,0
2079,1461,0,0,62,62,0,1,0,1,0
9336,26,16136,16,6349,1071,5278,18,42,10,8
5219,26,26033,16,7457,1333,6124,18,200,10,8
15784,26,11374,16,7924,2027,5897,23,22,14,9
13703,26,18174,16,5587,3950,1637,26,55,15,11
1788,15,6677,11,14671,951,13720,23,16,10,13
7503,26,5673,16,5241,2026,3215,50,6660,18,32
11419,2362,0,0,66,66,0,1,0,1,0
883,15,1255,11,318,192,126,6,30,4,2
5415,26,1724,16,1784075,46752,1737323,1812,47,606,1206
15338,1338,2208,1013,70,70,0,1,5,1,0
9631,183,22008,121,6312,2620,3692,25,24,12,13
14152,28,0,0,70,70,0,1,0,1,0
9153,10,8053,9,301,85,216,4,53,2,2
5308,10,16893,9,235,90,145,2,33,1,1
10611,26,22549,16,1724,916,808,17,128,7,10
14754,10,11576,9,188,96,92,2,31,1,1
15673,28,0,0,70,70,0,1,0,1,0
10987,28,0,0,70,70,0,1,0,1,0
10739,10,0,0,201,94,107,2,29,1,1
22472,10,5239,9,370,126,244,2,30,1,1
10005,15,4619,11,173653,9305,164348,189,141,73,116
10124,28,0,0,66,66,0,1,0,1,0
9333,26,23846,16,8113,2063,6050,23,255,11,12
15207,26,1927,16,7941,1952,5989,20,15,11,9
14431,28,0,0,66,66,0,1,0,1,0
9746,26,27164,16,3901,1858,2043,19,23,11,8
7589,2573,0,0,74,74,0,1,0,1,0
10327,2933,6589,2276,528,528,0,9,1201,9,0
9725,10,6397,9,185,102,83,2,30,1,1
9126,10,7956,9,184,94,90,2,31,1,1
18893,28,0,0,70,70,0,1,0,1,0
14322,3155,22923,2445,504,318,186,8,15,5,3
5962,2587,0,0,66,66,0,1,0,1,0
2142,909,0,0,78,78,0,1,0,1,0
8409,26,26084,16,638,70,568,10,203,2,8
20721,3139,0,0,62,62,0,1,0,1,0
16670,28,0,0,70,70,0,1,0,1,0
12158,26,22563,16,5766,1925,3841,22,17,14,8
21757,26,1108,16,5981,1902,4079,14,120,7,7
21221,183,28428,121,3347,1458,1889,15,17,8,7
10327,883,7244,652,330,330,0,6,1200,6,0
9549,26,25776,16,612,280,332,10,26,5,5
2744,1238,3259,918,897,126,771,2,30,1,1
5954,26,10979,16,8512,2563,5949,27,24,15,12
10812,475,19924,309,66,66,0,1,5,1,0
9208,28,0,0,70,70,0,1,0,1,0
17436,28,0,0,70,70,0,1,0,1,0
17056,28,0,0,66,66,0,1,0,1,0
343,1054,0,0,66,66,0,1,0,1,0
823,1731,0,0,60,60,0,1,0,1,0
14317,26,24542,16,177498,9805,167693,244,80,119,125
6619,26,12619,16,2316,1280,1036,20,278,11,9
14038,10,10251,9,168,86,82,2,30,1,1
5968,3216,0,0,62,62,0,1,0,1,0
8724,28,0,0,66,66,0,1,0,1,0
9011,10,14080,9,448,184,264,6,29,3,3
5787,983,0,0,62,62,0,1,0,1,0
22156,26,28322,16,48856,4158,44698,65,120,26,39
2744,1238,16513,918,878,126,752,2,30,1,1
10853,28,0,0,70,70,0,1,0,1,0
16578,28,0,0,66,66,0,1,0,1,0
687,3041,0,0,66,66,0,1,0,1,0
20585,1017,0,0,146,146,0,1,0,1,0
21231,10,4674,9,193,102,91,2,30,1,1
13553,28,0,0,70,70,0,1,0,1,0
21592,847,0,0,62,62,0,1,0,1,0
16199,28,0,0,66,66,0,1,0,1,0
9833,28,0,0,70,70,0,1,0,1,0
7148,10,9165,9,86,86,0,1,30,1,0
1577,829,0,0,62,62,0,1,0,1,0
12726,26,15366,16,6074,1579,4495,18,125,11,7
4887,509,0,0,62,62,0,1,0,1,0
11415,15,22537,11,9534,746,8788,18,49,9,9
6865,26,5184,16,15234,2503,12731,45,135,20,25
1804,1765,0,0,60,60,0,1,0,1,0
11619,1017,0,0,146,146,0,1,0,1,0
6675,26,9005,16,11255,7612,3643,36,248,19,17
15094,28,0,0,70,70,0,1,0,1,0
9145,2256,0,0,62,62,0,1,0,1,0
21037,1215,0,0,66,66,0,1,0,1,0
16345,26,20647,16,11947,2436,9511,19,121,9,10
8350,10,12317,9,451,91,360,4,36,2,2
14647,28,0,0,66,66,0,1,0,1,0
17412,1771,0,0,66,66,0,1,0,1,0
17694,28,0,0,66,66,0,1,0,1,0
180,10,7371,9,260,86,174,2,30,1,1
19428,242,0,0,145,145,0,1,0,1,0
13607,10,14854,9,263,94,169,2,30,1,1
22267,10,12864,9,168,86,82,2,31,1,1
12896,26,27138,16,90387,4941,85446,123,170,54,69
18142,15,16836,11,2634,1780,854,14,142,8,6
18876,26,27071,16,10306,3254,7052,32,47,18,14
413,1771,0,0,62,62,0,1,0,1,0
6693,26,20608,16,8060,2001,6059,24,19,14,10
4088,26,18723,16,2981,1719,1262,17,79,10,7
3622,6,0,0,60,60,0,1,0,1,0
2346,2256,0,0,146,146,0,1,0,1,0
5038,26,16592,16,4611,1704,2907,19,28,11,8
4163,26,15404,16,5661,2414,3247,22,39,13,9
1741,1215,0,0,62,62,0,1,0,1,0
11296,2561,0,0,66,66,0,1,0,1,0
14237,1972,3638,1505,70,70,0,2,8,2,0
6001,1147,0,0,66,66,0,1,0,1,0
9470,28,0,0,70,70,0,1,0,1,0
18543,28,0,0,70,70,0,1,0,1,0
9059,15,19956,11,2781,1400,1381,11,87,6,5
15420,10,17327,9,730,102,628,2,30,1,1
12715,2189,15319,1694,70,70,0,2,8,2,0
13815,10,28567,9,775,103,672,2,30,1,1
10439,28,0,0,66,66,0,1,0,1,0
14012,8,24386,8,130,66,64,2,5,1,1
14761,10,8047,9,198,102,96,2,30,1,1
11450,186,0,0,60,60,0,1,0,1,0
9056,26,14202,16,5737,1602,4135,23,86,13,10
2823,1771,0,0,66,66,0,1,0,1,0
92,2486,0,0,145,145,0,1,0,1,0
15361,26,19298,16,9096,4394,4702,26,256,15,11
14948,26,19909,16,3674,1750,1924,23,203,12,11
17827,26,15968,16,6155,1819,4336,18,181,8,10
15420,10,25109,9,825,99,726,2,30,1,1
17074,28,0,0,70,70,0,1,0,1,0
22238,10,5433,9,763,102,661,2,30,1,1
22718,1771,0,0,62,62,0,1,0,1,0
12439,28,0,0,70,70,0,1,0,1,0
19985,28,0,0,70,70,0,1,0,1,0
631,2154,0,0,66,66,0,1,0,1,0
18243,2733,0,0,66,66,0,1,0,1,0
9137,28,0,0,66,66,0,1,0,1,0
8474,26,15007,16,245382,6838,238544,214,31,44,170
6391,26,29111,16,13510,5888,7622,65,86,33,32
14091,28,0,0,70,70,0,1,0,1,0
13407,28,0,0,70,70,0,1,0,1,0
12450,2782,9842,2159,320,140,180,6,6,3,3
22112,10,1753,9,199,102,97,2,31,1,1
4423,10,26766,9,168,78,90,2,31,1,1
9369,28,0,0,66,66,0,1,0,1,0
18377,2938,0,0,74,74,0,1,0,1,0
15429,779,23558,565,70,70,0,2,8,2,0
14121,10,28784,9,212,102,110,2,30,1,1
2744,1240,21308,920,883,126,757,2,30,1,1
13663,28,0,0,70,70,0,1,0,1,0
13964,10,4858,9,762,101,661,2,30,1,1
7071,2486,0,0,109,109,0,1,0,1,0
15969,28,0,0,66,66,0,1,0,1,0
21377,28,0,0,70,70,0,1,0,1,0
9027,349,22076,222,234,234,0,4,11,4,0
13862,26,9744,16,8058,5498,2560,20,120,11,9
7134,3139,0,0,146,146,0,1,0,1,0
10219,15,3695,11,366,240,126,7,20,5,2
14483,10,26681,9,178,94,84,2,31,1,1
6812,10,27785,9,164,78,86,2,30,1,1
4031,26,7449,16,6267,1810,4457,25,18,14,11
22668,10,19873,9,728,102,626,2,29,1,1
1388,3216,0,0,62,62,0,1,0,1,0
22211,1242,27695,922,728,462,266,2,30,1,1
12050,2611,0,0,66,66,0,1,0,1,0
10350,28,0,0,70,70,0,1,0,1,0
16951,255,0,0,62,62,0,1,0,1,0
10964,1802,0,0,62,62,0,1,0,1,0
16021,1960,8233,1497,330,330,0,6,1199,6,0
636,280,0,0,146,146,0,1,0,1,0
22636,10,1723,9,718,94,624,2,30,1,1
5634,391,0,0,60,60,0,1,0,1,0
21147,280,2330,177,66,66,0,2,8,2,0
15211,2205,0,0,66,66,0,1,0,1,0
4981,15,16510,11,6261,833,5428,15,20,8,7
5932,26,17607,16,6989232,188564,6800668,7110,288,2412,4698
12758,28,0,0,70,70,0,1,0,1,0
2727,26,2061,16,7647,2890,4757,23,20,11,12
15821,10,23692,9,197,102,95,2,30,1,1
15926,104,0,0,60,60,0,1,0,1,0
10784,28,0,0,70,70,0,1,0,1,0
11523,28,0,0,70,70,0,1,0,1,0
16951,255,0,0,62,62,0,1,0,1,0
15068,26,13676,16,163763,5320,158443,178,120,60,118
15282,26,9425,16,8005,1985,6020,20,15,11,9
14649,10,1199,9,296,110,186,2,30,1,1
8926,10,26359,9,183,94,89,2,30,1,1
21752,28,0,0,70,70,0,1,0,1,0
1650,26,9012,16,2616,1470,1146,18,16,8,10
16532,26,5930,16,45314943,1391230,43923713,47149,303,15196,31953
22154,28,0,0,70,70,0,1,0,1,0
13678,28,0,0,70,70,0,1,0,1,0
9796,26,28948,16,2477,1505,972,15,20,9,6
22661,10,18659,9,209,110,99,2,30,1,1
9088,28,0,0,66,66,0,1,0,1,0
13480,28,0,0,70,70,0,1,0,1,0
9142,10,5487,9,190,97,93,2,30,1,1
131,1147,0,0,146,146,0,1,0,1,0
12394,2056,5909,1582,492,306,186,8,14,5,3
15189,26,17271,16,8034,2014,6020,20,15,11,9
11349,28,0,0,70,70,0,1,0,1,0
3418,2787,0,0,60,60,0,1,0,1,0
10607,26,22545,16,1654,916,738,16,126,7,9
9163,28,0,0,66,66,0,1,0,1,0
2404,2256,0,0,66,66,0,1,0,1,0
639,1129,0,0,143,143,0,1,0,1,0
13500,10,1459,9,168,78,90,2,30,1,1
14205,10,6374,9,199,102,97,2,31,1,1
3877,1472,0,0,66,66,0,1,0,1,0
12010,2548,10527,1980,70,70,0,1,5,1,0
11359,28,0,0,66,66,0,1,0,1,0
21950,10,4349,9,190,97,93,2,31,1,1
17449,2611,0,0,62,62,0,1,0,1,0
10226,15,6733,11,2794,2075,719,15,30,9,6
12695,26,27195,16,134631,7253,127378,176,171,79,97
8957,26,15357,16,20149,14507,5642,40,355,24,16
8679,26,21530,16,140969,40311,100658,180,68,92,88
21980,10,15173,9,195,102,93,2,30,1,1
16021,3077,27656,2390,527,166,361,2,1200,1,1
16310,28,0,0,70,70,0,1,0,1,0
12598,28,0,0,70,70,0,1,0,1,0
18894,26,6657,16,5089,4217,872,23,47,13,10
20192,28,0,0,70,70,0,1,0,1,0
360,3105,0,0,1188,1188,0,1,0,1,0
16241,28,0,0,70,70,0,1,0,1,0
22629,10,7182,9,332,94,238,2,29,1,1
12090,28,0,0,66,66,0,1,0,1,0
17245,26,10180,16,3990,2586,1404,17,16,9,8
128,391,0,0,62,62,0,1,0,1,0
15819,10,25845,9,180,94,86,2,30,1,1
16021,906,28469,670,132,132,0,3,1199,3,0
19303,1472,0,0,62,62,0,1,0,1,0
14238,10,3798,9,265,91,174,4,36,2,2
14030,2235,0,0,66,66,0,1,0,1,0
11347,28,0,0,70,70,0,1,0,1,0
13378,28,0,0,66,66,0,1,0,1,0
14025,10,4709,9,292,87,205,4,42,2,2
530,400,0,0,495,495,0,1,0,1,0
6379,2938,0,0,62,62,0,1,0,1,0
10654,676,3225,475,130,70,60,2,5,1,1
12570,28,0,0,70,70,0,1,0,1,0
4641,739,2708,530,432,192,240,8,30,4,4
13980,10,2114,9,323,110,213,2,30,1,1
3329,26,13654,16,162,102,60,2,5,1,1
10327,710,28903,508,481,150,331,2,1200,1,1
9691,1019,0,0,66,66,0,1,0,1,0
17147,26,10139,16,3143,1064,2079,18,82,8,10
8584,1509,8617,1148,78,78,0,1,30,1,0
18466,3054,17380,2371,70,70,0,1,5,1,0
11180,28,0,0,66,66,0,1,0,1,0
3224,26,13752,16,5421,2444,2977,20,15,11,9
15039,28,0,0,70,70,0,1,0,1,0
15171,10,18651,9,194,102,92,2,30,1,1
6829,26,17688,16,13019,4593,8426,71,350,34,37
3214,1147,0,0,66,66,0,1,0,1,0
680,697,0,0,66,66,0,1,0,1,0
4734,739,10725,530,130,70,60,2,30,1,1
15228,1017,0,0,66,66,0,1,0,1,0
16046,15,25405,11,343853,13570,330283,445,3,223,222
8816,10,9054,9,216,110,106,2,30,1,1
736,2256,0,0,62,62,0,1,0,1,0
8864,28,0,0,66,66,0,1,0,1,0
21820,26,5021,16,24686,1935,22751,36,17,17,19
5606,2013,8534,1543,164,102,62,2,30,1,1
12129,26,24609,16,14932,1671,13261,31,69,15,16
16192,3216,0,0,66,66,0,1,0,1,0
13392,28,0,0,66,66,0,1,0,1,0
9010,10,16262,9,763,101,662,2,31,1,1
8885,10,14119,9,209,110,99,2,30,1,1
20194,10,7739,9,102,102,0,1,30,1,0
15330,10,5628,9,184,94,90,2,29,1,1
16951,255,0,0,62,62,0,1,0,1,0
19539,15,21011,11,1553,953,600,14,47,8,6
1126,2883,0,0,146,146,0,1,0,1,0
21683,28,0,0,70,70,0,1,0,1,0
9411,2571,8266,1995,3758,2456,1302,52,2355,31,21
9902,10,22154,9,225,106,119,2,30,1,1
17916,26,25345,16,94202,5247,88955,115,37,41,74
17149,3216,0,0,66,66,0,1,0,1,0
14902,28,0,0,66,66,0,1,0,1,0
19540,15,18434,11,1494,954,540,13,51,8,5
12568,26,4513,16,499,425,74,4,0,3,1
12490,15,21653,11,1962,1287,675,13,27,7,6
461,3216,0,0,66,66,0,1,0,1,0
20927,1017,0,0,62,62,0,1,0,1,0
21541,1888,0,0,74,74,0,1,0,1,0
15990,28,0,0,70,70,0,1,0,1,0
0,0,0,0,134,64,70,2,0,1,1
9754,26,8885,16,9469,1273,8196,29,93,15,14
8727,10,23660,9,211,102,109,2,30,1,1
9151,10,22704,9,253,86,167,2,30,1,1
12561,26,18650,16,70,70,0,2,7,2,0
3350,15,14918,11,3483,1578,1905,17,186,10,7
497,653,0,0,66,66,0,1,0,1,0
22295,10,8532,9,199,102,97,2,30,1,1
17671,28,0,0,70,70,0,1,0,1,0
2744,2555,6532,1985,1656,126,1530,4,31,2,2
8925,10,1490,9,381,110,271,4,32,2,2
15540,1771,0,0,66,66,0,1,0,1,0
8293,26,17623,16,8664,2567,6097,20,120,10,10
4951,26,15716,16,5247,3662,1585,21,310,11,10
8576,10,12304,9,177,94,83,2,31,1,1
11283,26,22866,16,429263,14390,414873,449,24,159,290
15252,10,13232,9,767,102,665,2,31,1,1
11818,28,0,0,70,70,0,1,0,1,0
3870,1167,0,0,145,145,0,1,0,1,0
14230,10,27359,9,711,87,624,2,30,1,1
8856,26,28642,16,9107,2174,6933,29,187,14,15
8584,1245,9049,925,71,71,0,1,30,1,0
15266,26,25033,16,4378,1471,2907,19,29,11,8
10545,26,8677,16,55465,11462,44003,89,31,43,46
14447,2148,0,0,66,66,0,1,0,1,0
19492,28,0,0,66,66,0,1,0,1,0
12483,1147,0,0,66,66,0,1,0,1,0
0,0,0,0,156,156,0,2,0,2,0
16819,2587,0,0,66,66,0,1,0,1,0
19738,28,0,0,70,70,0,1,0,1,0
12019,26,27569,16,51742,10734,41008,85,44,33,52
6370,26,16497,16,190,70,120,4,15,2,2
10480,28,0,0,70,70,0,1,0,1,0
2546,2587,0,0,146,146,0,1,0,1,0
13147,28,0,0,70,70,0,1,0,1,0
10101,190,17004,125,258,107,151,2,30,1,1
3647,10,14607,9,217,87,130,2,30,1,1
12756,1078,14371,791,70,70,0,2,7,2,0
16951,255,0,0,62,62,0,1,0,1,0
9755,28,0,0,66,66,0,1,0,1,0
20140,28,0,0,66,66,0,1,0,1,0
13702,10,20959,9,215,94,121,2,29,1,1
94,2256,0,0,146,146,0,1,0,1,0
21276,28,0,0,70,70,0,1,0,1,0
5566,26,3882,16,412322,17503,394819,466,140,167,299
8776,10,3647,9,168,78,90,2,30,1,1
10781,15,1638,11,1854,1360,494,12,15,7,5
13747,28,0,0,66,66,0,1,0,1,0
16951,255,0,0,62,62,0,1,0,1,0
1868,3216,0,0,62,62,0,1,0,1,0
12471,61,12279,44,320,140,180,6,7,3,3
2744,1555,10969,1186,887,126,761,2,30,1,1
5067,26,6484,16,9198,2279,6919,18,18,9,9
10424,28,0,0,70,70,0,1,0,1,0
19190,28,0,0,70,70,0,1,0,1,0
12,1023,0,0,112,112,0,1,0,1,0
6320,10,18420,9,237,91,146,2,32,1,1
21797,10,5464,9,193,102,91,2,30,1,1
14054,10,5968,9,199,102,97,2,30,1,1
21442,28,0,0,70,70,0,1,0,1,0
21762,10,20268,9,182,93,89,2,30,1,1
22417,10,6524,9,994,86,908,2,30,1,1
497,82,0,0,103,103,0,1,0,1,0
14136,10,19090,9,216,110,106,2,30,1,1
11042,3177,18842,2463,316,136,180,6,7,3,3
1747,183,6473,121,3910,1805,2105,20,19,12,8
20948,7,0,0,60,60,0,1,0,1,0
13322,28,0,0,66,66,0,1,0,1,0
1804,304,0,0,60,60,0,1,0,1,0
8876,10,16041,9,179,94,85,2,30,1,1
16188,15,25509,11,1917,1468,449,10,19,6,4
21215,10,11709,9,347,103,244,4,46,2,2
18622,28,0,0,66,66,0,1,0,1,0
9180,15,25646,11,827,687,140,6,32,4,2
17271,15,1599,11,214,140,74,4,15,3,1
17458,1147,0,0,66,66,0,1,0,1,0
10922,26,8430,16,5671,1556,4115,23,274,13,10
13213,28,0,0,66,66,0,1,0,1,0
10773,3216,0,0,62,62,0,1,0,1,0
324,3139,0,0,62,62,0,1,0,1,0
9552,26,12492,16,5638,4258,1380,19,34,11,8
21796,10,21928,9,347,107,240,4,42,2,2
19901,2587,0,0,62,62,0,1,0,1,0
3758,26,28484,16,1402,910,492,11,360,6,5
1304,2256,0,0,62,62,0,1,0,1,0
3092,1202,0,0,159,159,0,1,0,1,0
12,1768,0,0,161,161,0,1,0,1,0
7662,26,20369,16,4657,1750,2907,19,28,11,8
15120,28,0,0,70,70,0,1,0,1,0
9738,15,5068,11,1635,824,811,10,15,5,5
9130,28,0,0,70,70,0,1,0,1,0
8744,10,27012,9,212,102,110,2,29,1,1
7127,26,11571,16,8328,2592,5736,35,34,18,17
10940,26,22949,16,29367,10171,19196,66,184,32,34
16972,10,6155,9,192,90,102,2,30,1,1
10802,3039,4960,2363,70,70,0,2,8,2,0
14012,28,0,0,70,70,0,1,0,1,0
13630,143,0,0,60,60,0,1,0,1,0
18854,28,0,0,70,70,0,1,0,1,0
13129,26,23887,16,4651,1744,2907,19,27,11,8
4725,26,6258,16,9618,7387,2231,30,26,18,12
12782,2036,6122,1564,320,140,180,6,5,3,3
15001,28,0,0,70,70,0,1,0,1,0
8276,2023,0,0,161,161,0,1,0,1,0
11330,15,22901,11,450,246,204,8,29,5,3
17101,28,0,0,70,70,0,1,0,1,0
19842,26,27551,16,3262,256,3006,9,121,4,5
6100,26,5814,16,88503,3914,84589,114,80,44,70
18938,26,23239,16,4960,896,4064,14,18,8,6
8164,2724,0,0,60,60,0,1,0,1,0
6200,26,10675,16,12306,2097,10209,31,360,15,16
16951,255,0,0,62,62,0,1,0,1,0
11803,28,0,0,70,70,0,1,0,1,0
16631,10,25787,9,645,90,555,2,30,1,1
15012,10,10040,9,210,110,100,2,30,1,1
22508,10,20513,9,767,102,665,2,31,1,1
10617,2256,0,0,66,66,0,1,0,1,0
124,3216,0,0,146,146,0,1,0,1,0
21722,28,0,0,70,70,0,1,0,1,0
11074,2256,0,0,146,146,0,1,0,1,0
17865,28,0,0,70,70,0,1,0,1,0
10605,26,23421,16,2888,1566,1322,17,18,9,8
11878,2938,0,0,74,74,0,1,0,1,0
16931,10,0,0,172,78,94,2,30,1,1
9000,10,10963,9,889,404,485,10,29,5,5
1952,7,0,0,60,60,0,1,0,1,0
16460,15,28399,11,14987,10571,4416,40,75,20,20
20006,1215,0,0,66,66,0,1,0,1,0
16220,10,14702,9,70,70,0,1,30,1,0
8455,15,23070,11,1056,682,374,10,15,6,4
3621,15,1233,11,5053,4178,875,17,15,9,8
19699,28,0,0,70,70,0,1,0,1,0
2829,1936,0,0,62,62,0,1,0,1,0
8411,15,21391,11,661753,15722,646031,683,17,235,448
624,2587,0,0,66,66,0,1,0,1,0
18596,15,26858,11,318,120,198,6,25,3,3
15346,10,11038,9,193,102,91,2,31,1,1
20275,26,7214,16,126815,114702,12113,243,86,139,104
18496,280,18275,177,70,70,0,2,8,2,0
9807,26,25644,16,7732,3046,4686,22,26,12,10
774,983,0,0,146,146,0,1,0,1,0
14222,2131,24082,1644,1253,716,537,12,23,7,5
5032,26,23979,16,4961,2148,2813,30,90,13,17
16021,1821,21007,1388,3570,1126,2444,28,1465,16,12
14956,10,20933,9,177,94,83,2,30,1,1
13070,1936,0,0,66,66,0,1,0,1,0
13649,10,3793,9,199,102,97,2,30,1,1
4556,26,1333,16,51402,5964,45438,86,153,32,54
1260,672,0,0,143,143,0,1,0,1,0
10767,28,0,0,66,66,0,1,0,1,0
8225,26,2967,16,38886,2134,36752,55,16,24,31
14607,10,10969,9,177,94,83,2,30,1,1
1995,1472,0,0,66,66,0,1,0,1,0
15809,10,11084,9,229,102,127,2,30,1,1
11413,26,9207,16,11565,5557,6008,52,16,27,25
11350,26,26746,16,15746,4302,11444,17,122,5,12
14276,15,23372,11,70,70,0,2,8,2,0
15278,10,24036,9,183,94,89,2,30,1,1
19061,26,27125,16,18924,5378,13546,33,18,19,14
14454,10,16775,9,184,94,90,2,31,1,1
17990,28,0,0,70,70,0,1,0,1,0
11926,26,21913,16,14051,6332,7719,43,92,21,22
19504,28,0,0,70,70,0,1,0,1,0
15410,10,18945,9,213,102,111,2,30,1,1
2855,1590,0,0,100,100,0,1,0,1,0
0,0,0,0,82,82,0,1,0,1,0
3619,1888,0,0,62,62,0,1,0,1,0
22140,10,4428,9,762,98,664,2,30,1,1
21127,1501,26825,1141,66,66,0,2,8,2,0
2716,10,8209,9,290,110,180,2,30,1,1
14834,10,5991,9,200,102,98,2,30,1,1
9463,10,24134,9,94,94,0,1,30,1,0
21662,10,1417,9,184,94,90,2,30,1,1
22579,2853,0,0,66,66,0,1,0,1,0
16383,15,25631,11,2648,921,1727,12,20,7,5
220,10,518,9,643,88,555,2,30,1,1
109,6,0,0,60,60,0,1,0,1,0
10047,26,28088,16,9599,3465,6134,20,16,11,9
1762,2883,0,0,66,66,0,1,0,1,0
12000,395,25270,256,70,70,0,1,5,1,0
11176,836,28286,615,70,70,0,1,5,1,0
371,362,0,0,145,145,0,1,0,1,0
17391,26,7783,16,9612,1720,7892,32,130,15,17
12662,1147,0,0,66,66,0,1,0,1,0
4871,26,14437,16,22970,12439,10531,61,98,32,29
10713,28,0,0,66,66,0,1,0,1,0
22258,10,14923,9,199,102,97,2,30,1,1
14373,10,27247,9,216,110,106,2,31,1,1
21911,10,20982,9,184,94,90,2,30,1,1
6278,2938,0,0,66,66,0,1,0,1,0
8490,10,22166,9,210,110,100,2,29,1,1
12671,26,16852,16,499,425,74,4,0,3,1
17074,26,18977,16,5167,700,4467,16,15,7,9
8363,10,6492,9,181,94,87,2,33,1,1
21177,26,11046,16,3071,804,2267,15,135,7,8
9727,15,28354,11,2226,1077,1149,13,79,7,6
16951,255,25970,160,130,66,64,2,5,1,1
18438,15,26783,11,172473,8713,163760,205,33,91,114
16951,255,0,0,62,62,0,1,0,1,0
19353,26,27280,16,19070,4830,14240,33,18,18,15
20119,28,0,0,66,66,0,1,0,1,0
13743,10,7348,9,196,102,94,2,30,1,1
8613,28,0,0,70,70,0,1,0,1,0
12129,28,0,0,66,66,0,1,0,1,0
8999,10,11463,9,214,94,120,2,30,1,1
21985,10,14064,9,188,96,92,2,30,1,1
1804,1777,0,0,60,60,0,1,0,1,0
21767,10,28089,9,718,94,624,2,30,1,1
21784,10,11661,9,199,102,97,2,30,1,1
12740,26,6581,16,499,425,74,4,0,3,1
13302,10,27700,9,202,202,0,3,46,3,0
10309,28,0,0,70,70,0,1,0,1,0
8627,10,27028,9,314,102,212,2,30,1,1
5005,10,0,0,82,82,0,2,40,2,0
20476,1017,0,0,66,66,0,1,0,1,0
14045,3216,0,0,66,66,0,1,0,1,0
1150,1017,0,0,62,62,0,1,0,1,0
20910,28,0,0,66,66,0,1,0,1,0
11941,2604,0,0,62,62,0,1,0,1,0
697,2587,0,0,66,66,0,1,0,1,0
4835,280,6633,177,452,248,204,4,1199,2,2
9411,488,21180,321,132,132,0,3,1200,3,0
6131,26,23532,16,9499,3786,5713,31,315,16,15
10760,1653,7553,1270,66,66,0,1,5,1,0
16888,26,1743,16,8626,2156,6470,24,81,14,10
11450,1686,0,0,60,60,0,1,0,1,0
20458,2636,0,0,62,62,0,1,0,1,0
16216,28,0,0,70,70,0,1,0,1,0
14341,2429,10969,1890,70,70,0,1,5,1,0
11636,26,18721,16,34402,2328,32074,55,153,23,32
4947,26,7340,16,424,210,214,7,131,4,3
10035,15,1463,11,8600,1437,7163,18,144,10,8
8311,10,6888,9,199,94,105,2,29,1,1
13279,26,11651,16,13132,7107,6025,45,174,23,22
14145,10,22854,9,184,94,90,2,29,1,1
8802,2256,0,0,62,62,0,1,0,1,0
12631,770,27564,557,70,70,0,2,8,2,0
15291,26,28579,16,8058,2038,6020,20,15,11,9
15431,2426,10836,1887,66,66,0,1,5,1,0
2230,26,9108,16,29203,1859,27344,37,18,14,23
12501,1749,8940,1335,70,70,0,2,8,2,0
4087,983,0,0,146,146,0,1,0,1,0
10993,1017,0,0,62,62,0,1,0,1,0
18,2256,0,0,62,62,0,1,0,1,0
44,2256,0,0,62,62,0,1,0,1,0
9061,26,28405,16,113036,13164,99872,191,144,89,102
16380,26,21373,16,9316,3279,6037,39,186,20,19
2084,1471,0,0,145,145,0,1,0,1,0
16250,28,0,0,66,66,0,1,0,1,0
15952,10,7007,9,212,102,110,2,30,1,1
14753,3139,0,0,66,66,0,1,0,1,0
9842,26,5454,16,24575,6565,18010,86,275,32,54
4835,1029,28567,757,1307,594,713,17,1657,10,7
9520,10,29142,9,164,84,80,2,31,1,1
4042,26,19234,16,7409,1702,5707,23,20,13,10
18185,10,26648,9,193,90,103,2,30,1,1
4336,15,16532,11,51571,48786,2785,74,19,38,36
22062,10,19813,9,733,86,647,2,29,1,1
4068,10,15251,9,194,87,107,2,30,1,1
13459,234,21584,149,12683,1205,11478,27,182,8,19
18601,28,0,0,70,70,0,1,0,1,0
8433,10,3353,9,86,86,0,1,30,1,0
8513,26,29086,16,7292,950,6342,19,75,9,10
8327,2938,0,0,146,146,0,1,0,1,0
13060,28,0,0,70,70,0,1,0,1,0
11784,28,0,0,70,70,0,1,0,1,0
216,10,491,9,217,82,135,2,33,1,1
22294,10,4930,9,413,170,243,6,30,3,3
5483,255,0,0,60,60,0,1,0,1,0
4329,15,15679,11,161054,3432,157622,140,158,24,116
15792,10,1067,9,212,102,110,2,30,1,1
15864,10,6456,9,177,94,83,2,30,1,1
3863,2587,0,0,62,62,0,1,0,1,0
17632,28,0,0,70,70,0,1,0,1,0
11094,15,14116,11,692,300,392,9,25,6,3
2753,10,4393,9,822,466,356,3,30,2,1
7495,10,20142,9,247,98,149,2,32,1,1
11252,513,3049,338,70,70,0,1,5,1,0
8729,26,23998,16,6462,2102,4360,18,180,8,10
16951,255,0,0,62,62,0,1,0,1,0
2141,1888,0,0,62,62,0,1,0,1,0
7577,15,9039,11,1193,451,742,10,15,6,4
17176,2938,0,0,66,66,0,1,0,1,0
8862,26,21617,16,4871,1623,3248,18,137,8,10
22092,28,0,0,66,66,0,1,0,1,0
21095,2430,19784,1891,66,66,0,1,5,1,0
7668,26,20996,16,1786,172,1614,7,120,3,4
8599,10,17938,9,165,86,79,2,30,1,1
9707,10,4667,9,718,94,624,2,30,1,1
17385,28,0,0,70,70,0,1,0,1,0
18847,28,0,0,70,70,0,1,0,1,0
1510,10,5360,9,198,89,109,2,31,1,1
13834,26,19798,16,6649,1556,5093,23,24,13,10
9770,15,11798,11,1366,865,501,8,15,5,3
15302,26,25424,16,7889,1900,5989,20,14,11,9
17194,26,1357,16,152,86,66,2,4,1,1
3127,3216,0,0,62,62,0,1,0,1,0
9762,15,3899,11,25890,3442,22448,33,21,13,20
16124,26,10913,16,2614,1689,925,18,19,10,8
3013,1771,0,0,62,62,0,1,0,1,0
9210,15,23995,11,2140,1030,1110,22,149,8,14
2744,1459,18514,1112,1700,126,1574,4,31,2,2
2283,3216,0,0,62,62,0,1,0,1,0
11374,18,13020,13,184,94,90,2,30,1,1
21544,10,26298,9,274,94,180,2,30,1,1
10908,28,0,0,66,66,0,1,0,1,0
20358,2256,0,0,66,66,0,1,0,1,0
15643,10,7390,9,197,102,95,2,35,1,1
20990,1017,0,0,66,66,0,1,0,1,0
1909,3084,25406,2396,481,150,331,2,1200,1,1
1128,2938,0,0,66,66,0,1,0,1,0
14757,10,6540,9,186,95,91,2,30,1,1
9288,26,26934,16,8162,1364,6798,22,16,11,11
21386,122,7386,92,66,66,0,2,8,2,0
21371,72,6490,55,312,132,180,6,6,3,3
5584,10,0,0,82,82,0,1,31,1,0
4650,26,27454,16,1386,924,462,12,30,7,5
19428,242,0,0,145,145,0,1,0,1,0
14279,10,7218,9,199,102,97,2,30,1,1
17154,26,27234,16,19134,6811,12323,39,83,18,21
13673,26,11097,16,6866,1983,4883,23,330,11,12
16233,28,0,0,66,66,0,1,0,1,0
11606,28,0,0,70,70,0,1,0,1,0
5528,15,6175,11,1151,711,440,10,15,5,5
245,1147,0,0,62,62,0,1,0,1,0
2287,2636,0,0,66,66,0,1,0,1,0
22694,10,6386,9,166,86,80,2,31,1,1
22134,10,28142,9,431,95,336,4,55,2,2
11549,28,0,0,70,70,0,1,0,1,0
2548,2848,0,0,60,60,0,1,0,1,0
11467,26,20912,16,9844,3089,6755,21,133,10,11
4702,26,22957,16,12542,2527,10015,31,48,18,13
15157,28,0,0,66,66,0,1,0,1,0
12611,3228,21018,2503,70,70,0,1,5,1,0
14610,28,0,0,70,70,0,1,0,1,0
14156,10,1997,9,214,110,104,2,30,1,1
16021,3271,5186,2531,773,271,502,4,1200,2,2
13765,26,4836,16,14680,6119,8561,35,152,16,19
21610,28,0,0,70,70,0,1,0,1,0
9830,26,1627,16,1199,618,581,13,29,6,7
14308,1085,9765,796,70,70,0,2,8,2,0
7928,10,0,0,86,86,0,1,30,1,0
20392,40,28437,23,8786,4118,4668,80,200,41,39
9082,10,18096,9,198,102,96,2,30,1,1
20806,26,3112,16,22815,20019,2796,55,81,31,24
22719,10,21739,9,96,96,0,1,30,1,0
10035,15,18436,11,13644327,154437,13489890,11257,134,2201,9056
4652,26,22027,16,214,140,74,4,15,3,1
6469,26,18268,16,6748,1643,5105,26,138,14,12
14451,10,5292,9,177,94,83,2,30,1,1
9437,10,13735,9,86,86,0,1,30,1,0
940,26,401,16,318,192,126,6,17,4,2
14794,10,27278,9,168,86,82,2,30,1,1
12596,2587,0,0,66,66,0,1,0,1,0
10724,1017,0,0,62,62,0,1,0,1,0
17375,28,0,0,70,70,0,1,0,1,0
572,1888,0,0,66,66,0,1,0,1,0
3876,1923,0,0,62,62,0,1,0,1,0
7573,26,11956,16,12787534,288179,12499355,12299,64,4036,8263
1563,1677,0,0,159,159,0,1,0,1,0
14196,10,22710,9,184,80,104,2,0,1,1
5080,26,94,16,2622,1399,1223,18,28,10,8
10837,485,27288,318,70,70,0,1,5,1,0
9985,15,12896,11,1123758,19319,1104439,1037,133,278,759
4396,2636,0,0,146,146,0,1,0,1,0
11212,26,1600,16,237151,13019,224132,251,42,90,161
24,2256,0,0,62,62,0,1,0,1,0
10664,26,5569,16,19743,2133,17610,32,187,11,21
11026,15,21602,11,6518746,206365,6312381,6886,22,2687,4199
4172,26,9689,16,9102,1205,7897,25,14,14,11
3113,1017,0,0,62,62,0,1,0,1,0
10472,26,2356,16,5550,1177,4373,24,80,13,11
16951,255,0,0,62,62,0,1,0,1,0
12735,1829,24893,1392,70,70,0,2,7,2,0
2598,1017,0,0,62,62,0,1,0,1,0
13908,26,14300,16,28633618,753499,27880119,30116,102,8846,21270
4135,15,5245,11,1594,1280,314,10,15,5,5
17583,28,0,0,66,66,0,1,0,1,0
16951,255,0,0,62,62,0,1,0,1,0
21579,1880,0,0,62,62,0,1,0,1,0
6230,1804,0,0,66,66,0,1,0,1,0
9310,28,0,0,70,70,0,1,0,1,0
18501,786,15394,571,70,70,0,1,5,1,0
3058,3262,0,0,60,60,0,1,0,1,0
20838,26,884,16,3942,1406,2536,18,135,8,10
1797,2587,0,0,146,146,0,1,0,1,0
15514,26,4511,16,8304,2968,5336,24,362,13,11
13557,10,24142,9,832,106,726,2,30,1,1
16951,255,0,0,62,62,0,1,0,1,0
21338,1882,20896,1437,66,66,0,2,7,2,0
16980,28,0,0,66,66,0,1,0,1,0
928,15,8547,11,17855,1067,16788,26,35,11,15
14576,10,3728,9,701,88,613,2,30,1,1
9,18,20316,13,184,94,90,2,29,1,1
20724,28,0,0,70,70,0,1,0,1,0
16894,10,13560,9,215,102,113,2,30,1,1
2250,26,9232,16,79787,12741,67046,117,31,65,52
12631,770,761,557,70,70,0,1,5,1,0
14035,28,0,0,70,70,0,1,0,1,0
9,18,21438,13,184,94,90,2,30,1,1
14867,10,21827,9,1335,87,1248,4,59,2,2
11207,975,23848,721,316,136,180,6,5,3,3
22439,10,8514,9,453,186,267,6,30,3,3
5310,1827,0,0,62,62,0,1,0,1,0
14359,28,0,0,70,70,0,1,0,1,0
8956,10,17980,9,195,102,93,2,29,1,1
9184,10,234,9,210,102,108,2,30,1,1
11568,10,0,0,223,91,132,2,30,1,1
13000,509,0,0,66,66,0,1,0,1,0
11609,28,0,0,66,66,0,1,0,1,0
12555,26,26567,16,70,70,0,1,5,1,0
21181,3129,1596,2429,66,66,0,2,8,2,0
2763,1017,0,0,62,62,0,1,0,1,0
15513,255,0,0,60,60,0,1,0,1,0
16182,2883,0,0,66,66,0,1,0,1,0
8743,10,15698,9,242,94,148,2,30,1,1
15459,28,0,0,66,66,0,1,0,1,0
17150,26,14242,16,9035,5883,3152,26,17,14,12
4787,2266,0,0,145,145,0,1,0,1,0
356,2380,0,0,145,145,0,1,0,1,0
18560,28,0,0,70,70,0,1,0,1,0
9728,287,3019,184,1326,300,1026,6,1200,3,3
8064,26,18566,16,7762,2247,5515,21,31,11,10
13202,28,0,0,70,70,0,1,0,1,0
21192,2256,0,0,66,66,0,1,0,1,0
14125,26,24428,16,3080,1018,2062,10,120,5,5
14255,10,26669,9,193,102,91,2,30,1,1
12865,28,0,0,70,70,0,1,0,1,0
15329,10,18308,9,209,110,99,2,30,1,1
16077,2256,0,0,62,62,0,1,0,1,0
13190,28,0,0,70,70,0,1,0,1,0
417,2938,0,0,62,62,0,1,0,1,0
22418,10,4410,9,188,96,92,2,30,1,1
22692,26,19127,16,429890,12640,417250,442,16,155,287
16954,28,0,0,66,66,0,1,0,1,0
1806,739,15138,530,308,128,180,6,30,3,3
9181,10,26829,9,195,102,93,2,30,1,1
22168,10,10940,9,196,102,94,2,30,1,1
21955,15,28786,11,40906,1105,39801,45,142,13,32
8338,26,45,16,15437,8368,7069,40,361,19,21
6579,26,21460,16,9118,1699,7419,24,131,14,10
9565,26,9918,16,562,222,340,9,26,4,5
8632,10,23133,9,184,94,90,2,29,1,1
15340,10,2358,9,194,102,92,2,30,1,1
18178,10,22277,9,297,83,214,2,30,1,1
9538,26,10060,16,60424,4482,55942,101,686,39,62
14808,10,14021,9,762,101,661,2,31,1,1
15134,26,24972,16,4656,1749,2907,19,27,11,8
21067,15,14323,11,314,192,122,6,15,4,2
19630,28,0,0,70,70,0,1,0,1,0
14091,26,14985,16,1784,247,1537,7,120,4,3
9906,1017,0,0,66,66,0,1,0,1,0
16951,255,0,0,62,62,0,1,0,1,0
15675,28,0,0,70,70,0,1,0,1,0
20533,28,0,0,70,70,0,1,0,1,0
18881,26,2216,16,8536,2392,6144,29,45,17,12
14768,10,893,9,807,94,713,2,31,1,1
8329,10,14324,9,183,94,89,2,30,1,1
8903,26,5289,16,37094,22774,14320,125,27,72,53
18312,7,0,0,60,60,0,1,0,1,0
4161,10,5941,9,198,93,105,2,30,1,1
9924,2709,0,0,66,66,0,1,0,1,0
17027,28,0,0,70,70,0,1,0,1,0
8584,1241,23493,921,256,78,178,2,30,1,1
6446,26,6421,16,7681,4711,2970,36,28,17,19
9582,10,24356,9,199,102,97,2,31,1,1
9333,3216,0,0,66,66,0,1,0,1,0
1355,1017,0,0,62,62,0,1,0,1,0
3806,2104,0,0,145,145,0,1,0,1,0
3152,2587,0,0,146,146,0,1,0,1,0
10068,28,0,0,70,70,0,1,0,1,0
12172,28,0,0,70,70,0,1,0,1,0
11597,2930,0,0,66,66,0,1,0,1,0
5809,26,16294,16,11095,2599,8496,45,257,22,23
20008,28,0,0,70,70,0,1,0,1,0
14671,10,27084,9,193,102,91,2,29,1,1
15367,2115,19249,1631,70,70,0,1,5,1,0
18937,28,0,0,70,70,0,1,0,1,0
13811,10,14460,9,186,95,91,2,31,1,1
15346,10,11108,9,166,86,80,2,30,1,1
14449,10,27567,9,181,94,87,2,29,1,1
18759,923,28297,681,70,70,0,2,8,2,0
11080,28,0,0,66,66,0,1,0,1,0
19719,10,28028,9,205,86,119,2,30,1,1
19057,1888,0,0,62,62,0,1,0,1,0
17717,2938,0,0,66,66,0,1,0,1,0
17078,26,20671,16,5168,700,4468,16,15,7,9
14482,10,4043,9,257,94,163,2,30,1,1
12115,28,0,0,70,70,0,1,0,1,0
5862,10,17763,9,197,90,107,2,30,1,1
8210,1170,21194,863,481,150,331,2,1200,1,1
12611,1888,0,0,66,66,0,1,0,1,0
4096,183,15289,121,4575,2400,2175,20,18,11,9
6842,15,19645,11,5584,2543,3041,20,27,11,9
9442,10,5579,9,183,94,89,2,30,1,1
911,26,12273,16,5727,491,5236,14,15,7,7
12320,1804,0,0,62,62,0,1,0,1,0
14738,28,0,0,70,70,0,1,0,1,0
6455,26,6163,16,7467,1522,5945,26,16,14,12
12746,26,25064,16,499,425,74,4,0,3,1
19570,26,1526,16,68851,3430,65421,93,121,35,58
16424,983,0,0,66,66,0,1,0,1,0
16839,28,0,0,70,70,0,1,0,1,0
360,3105,0,0,68,68,0,1,0,1,0
14815,10,21291,9,200,102,98,2,30,1,1
1851,1771,0,0,62,62,0,1,0,1,0
17894,26,9545,16,19311,2432,16879,55,417,24,31
4153,1472,0,0,146,146,0,1,0,1,0
20912,26,16919,16,1882441,60775,1821666,2129,129,795,1334
9009,10,18373,9,168,86,82,2,30,1,1
9748,15,22070,11,1707,1007,700,11,21,6,5
7911,1471,0,0,146,146,0,1,0,1,0
14054,10,13056,9,196,100,96,2,30,1,1
22229,10,8697,9,310,102,208,2,30,1,1
12032,26,10906,16,4962,887,4075,15,28,9,6
12599,28,0,0,70,70,0,1,0,1,0
13846,10,8192,9,202,103,99,2,31,1,1
13555,28,0,0,66,66,0,1,0,1,0
17337,10,4246,9,504,110,394,2,30,1,1
18074,1147,0,0,62,62,0,1,0,1,0
1819,2709,0,0,146,146,0,1,0,1,0
19494,18,12508,13,184,94,90,2,30,1,1
11842,26,5213,16,3517,993,2524,12,120,6,6
21328,28,0,0,66,66,0,1,0,1,0
8830,26,3024,16,134,60,74,3,6,2,1
15694,1787,0,0,145,145,0,1,0,1,0
8559,1472,0,0,66,66,0,1,0,1,0
21729,10,25131,9,280,97,183,4,58,2,2
22162,10,4482,9,326,88,238,4,52,2,2
10889,330,8233,211,8425,6015,2410,73,34,37,36
4676,26,22719,16,9000,2566,6434,29,47,17,12
9371,26,27598,16,9530,2104,7426,18,121,9,9
11276,2701,24175,2098,258,70,188,4,9,2,2
12358,2883,0,0,62,62,0,1,0,1,0
497,1717,0,0,220,220,0,1,0,1,0
10117,26,6125,16,6938,2686,4252,25,27,12,13
11565,28,0,0,66,66,0,1,0,1,0
17825,2853,0,0,62,62,0,1,0,1,0
10928,15,23571,11,366,240,126,7,28,5,2
15497,10,25394,9,177,94,83,2,30,1,1
11047,1193,7719,882,70,70,0,2,9,2,0
571,2824,0,0,74,74,0,1,0,1,0
16446,28,0,0,66,66,0,1,0,1,0
20633,28,0,0,70,70,0,1,0,1,0
22328,10,10829,9,410,110,300,2,30,1,1
11261,2601,0,0,62,62,0,1,0,1,0
5093,26,19333,16,16002,4305,11697,60,138,29,31
8584,1239,13100,919,255,78,177,2,30,1,1
14651,10,19876,9,172,88,84,2,30,1,1
14559,26,4277,16,21852,2269,19583,48,95,23,25
2759,1017,0,0,62,62,0,1,0,1,0
12004,1611,28116,1233,70,70,0,1,5,1,0
14881,10,18761,9,216,110,106,2,30,1,1
8780,10,21024,9,258,110,148,2,30,1,1
2065,1017,0,0,62,62,0,1,0,1,0
10124,10,22288,9,168,78,90,2,30,1,1
16664,28,0,0,70,70,0,1,0,1,0
11445,28,0,0,70,70,0,1,0,1,0
3054,697,0,0,62,62,0,1,0,1,0
8743,10,25814,9,389,134,255,2,29,1,1
21429,28,0,0,66,66,0,1,0,1,0
22549,10,21471,9,199,102,97,2,30,1,1
13779,1147,0,0,66,66,0,1,0,1,0
3172,1202,0,0,148,148,0,1,0,1,0
17919,1017,0,0,62,62,0,1,0,1,0
18792,26,26977,16,4652,1745,2907,19,29,11,8
14679,10,14655,9,740,93,647,2,31,1,1
14165,10,11748,9,168,86,82,2,29,1,1
14662,10,613,9,192,98,94,2,31,1,1
11249,1859,3416,1418,316,136,180,6,8,3,3
5773,26,17190,16,3321,1297,2024,13,32,7,6
22301,10,18724,9,718,94,624,2,30,1,1
14731,10,5554,9,198,101,97,2,30,1,1
15292,10,3864,9,711,87,624,2,30,1,1
18498,28,0,0,66,66,0,1,0,1,0
2381,1539,0,0,146,146,0,1,0,1,0
6651,1129,0,0,156,156,0,1,0,1,0
1445,1539,0,0,62,62,0,1,0,1,0
19767,28,0,0,70,70,0,1,0,1,0
10543,15,8896,11,9524,736,8788,18,131,9,9
10037,15,20584,11,11749346,149441,11599905,10089,147,2116,7973
20272,26,9644,16,3129,782,2347,17,134,8,9
407,1888,0,0,62,62,0,1,0,1,0
3102,2382,0,0,66,66,0,1,0,1,0
21797,10,28800,9,193,102,91,2,30,1,1
8550,28,0,0,66,66,0,1,0,1,0
17706,26,17228,16,7358,2661,4697,22,17,11,11
15150,10,1329,9,198,94,104,2,30,1,1
19592,28,0,0,66,66,0,1,0,1,0
1448,2587,0,0,62,62,0,1,0,1,0
22552,10,2286,9,763,102,661,2,30,1,1
6105,7,0,0,60,60,0,1,0,1,0
12252,28,0,0,70,70,0,1,0,1,0
2926,1215,0,0,66,66,0,1,0,1,0
10346,980,0,0,100,100,0,1,0,1,0
12611,3228,19405,2503,70,70,0,2,8,2,0
17657,1827,0,0,66,66,0,1,0,1,0
13198,10,0,0,195,70,125,2,30,1,1
15582,10,3311,9,177,94,83,2,30,1,1
9514,28,0,0,70,70,0,1,0,1,0
14994,10,14392,9,199,102,97,2,29,1,1
17059,28,0,0,66,66,0,1,0,1,0
12673,28,0,0,66,66,0,1,0,1,0
17966,28,0,0,70,70,0,1,0,1,0
14218,26,24808,16,7906,1569,6337,20,150,9,11
9556,15,4741,11,22200,11865,10335,38,86,24,14
8938,15,16720,11,70,70,0,1,5,1,0
14937,153,7075,108,1222,747,475,10,23,5,5
8346,15,2650,11,2807,587,2220,13,16,7,6
15897,10,899,9,747,92,655,2,31,1,1
9686,26,267,16,5779,1472,4307,22,78,12,10
16951,255,0,0,62,62,0,1,0,1,0
1859,2486,0,0,140,140,0,1,0,1,0
19163,28,0,0,70,70,0,1,0,1,0
15552,15,19982,11,214,140,74,4,35,3,1
3023,3216,0,0,62,62,0,1,0,1,0
16560,1147,0,0,66,66,0,1,0,1,0
9464,26,22106,16,9933,2306,7627,27,82,13,14
16619,28,0,0,66,66,0,1,0,1,0
2172,379,7350,244,490,149,341,2,1200,1,1
19599,28,0,0,70,70,0,1,0,1,0
14709,28,0,0,66,66,0,1,0,1,0
10063,26,8180,16,4178,2310,1868,39,30,23,16
14275,10,20556,9,711,87,624,2,30,1,1
9913,1771,0,0,66,66,0,1,0,1,0
1367,16,0,0,60,60,0,1,0,1,0
14127,10,2848,9,216,110,106,2,29,1,1
19012,28,0,0,66,66,0,1,0,1,0
9025,28,0,0,70,70,0,1,0,1,0
18488,15,23607,11,186,64,122,4,28,2,2
15257,26,17122,16,8735,1819,6916,23,22,14,9
14379,26,23822,16,11823,4029,7794,25,143,12,13
14064,28,0,0,66,66,0,1,0,1,0
12629,2403,19121,1869,70,70,0,2,8,2,0
14862,26,27107,16,513682,20015,493667,523,226,126,397
19533,28,0,0,70,70,0,1,0,1,0
15286,28,0,0,66,66,0,1,0,1,0
31,1888,0,0,62,62,0,1,0,1,0
4282,2587,0,0,62,62,0,1,0,1,0
637,2202,14228,1705,200,111,89,2,1200,1,1
13899,10,28248,9,754,94,660,2,31,1,1
14664,10,8450,9,710,89,621,2,30,1,1
15012,10,11540,9,170,87,83,2,31,1,1
21010,2382,0,0,66,66,0,1,0,1,0
14831,28,0,0,70,70,0,1,0,1,0
22495,28,0,0,70,70,0,1,0,1,0
8210,2922,21194,2267,158,158,0,1,1200,1,0
6456,1147,0,0,66,66,0,1,0,1,0
13954,28,0,0,70,70,0,1,0,1,0
9370,28,0,0,66,66,0,1,0,1,0
17058,26,21459,16,4889,1079,3810,15,25,8,7
2054,1054,0,0,66,66,0,1,0,1,0
15514,10,25030,9,193,102,91,2,30,1,1
18444,26,3740,16,24271,17315,6956,53,107,34,19
9441,26,12692,16,18401,4536,13865,48,27,24,24
21967,10,17466,9,194,94,100,2,31,1,1
9027,349,606,222,78,78,0,1,4,1,0
19521,26,2177,16,5922,1917,4005,24,18,14,10
12554,26,6157,16,9842,4572,5270,22,76,12,10
1838,10,6936,9,832,106,726,2,30,1,1
19924,28,0,0,70,70,0,1,0,1,0
8930,10,14455,9,198,101,97,2,31,1,1
10923,28,0,0,66,66,0,1,0,1,0
3550,2820,0,0,148,148,0,1,0,1,0
17291,26,3990,16,70,70,0,1,4,1,0
9299,1763,0,0,66,66,0,1,0,1,0
21876,10,14015,9,807,94,713,2,30,1,1
1519,2256,0,0,66,66,0,1,0,1,0
11319,10,23852,9,322,102,220,2,30,1,1
2536,1167,0,0,145,145,0,1,0,1,0
16951,255,0,0,62,62,0,1,0,1,0
12198,1017,0,0,66,66,0,1,0,1,0
5633,26,23460,16,9574,2600,6974,29,136,16,13
22576,10,17890,9,259,110,149,2,30,1,1
14222,10,18829,9,167,86,81,2,30,1,1
10308,28,0,0,66,66,0,1,0,1,0
15510,358,22928,229,78,78,0,1,30,1,0
21784,10,10831,9,198,101,97,2,31,1,1
14788,28,0,0,66,66,0,1,0,1,0
18095,28,0,0,70,70,0,1,0,1,0
11931,26,2649,16,16055,5856,10199,97,92,42,55
14384,10,21103,9,177,94,83,2,30,1,1
18101,28,0,0,66,66,0,1,0,1,0
22191,10,27902,9,180,94,86,2,30,1,1
11195,2540,5273,1974,70,70,0,1,5,1,0
13938,10,24337,9,199,102,97,2,30,1,1
5254,1017,0,0,146,146,0,1,0,1,0
22649,10,22257,9,215,102,113,2,29,1,1
11174,684,10824,483,70,70,0,2,8,2,0
13106,1239,12203,919,924,924,0,3,30,3,0
1202,3216,0,0,62,62,0,1,0,1,0
13789,10,24698,9,184,94,90,2,30,1,1
22185,10,9770,9,506,108,398,4,36,2,2
7881,3216,0,0,66,66,0,1,0,1,0
19399,1888,0,0,66,66,0,1,0,1,0
7774,26,23310,16,190,70,120,4,15,2,2
18474,15,20981,11,1589,941,648,11,121,6,5
14199,2256,0,0,66,66,0,1,0,1,0
18792,28,0,0,70,70,0,1,0,1,0
18578,28,0,0,70,70,0,1,0,1,0
1347,2471,0,0,145,145,0,1,0,1,0
15610,10,28423,9,194,102,92,2,33,1,1
6304,26,20543,16,3513,795,2718,11,120,5,6
22269,10,26700,9,733,204,529,6,40,3,3
11266,1147,0,0,62,62,0,1,0,1,0
4550,1147,0,0,146,146,0,1,0,1,0
15697,10,10006,9,195,102,93,2,29,1,1
2910,10,11925,9,235,90,145,2,32,1,1
22613,10,4034,9,753,96,657,2,30,1,1
18110,26,8136,16,8413,3768,4645,25,143,12,13
15290,10,21899,9,807,94,713,2,30,1,1
9198,28,0,0,70,70,0,1,0,1,0
22013,10,6621,9,184,94,90,2,29,1,1
1525,1444,0,0,145,145,0,1,0,1,0
11348,26,22916,16,4453,1546,2907,21,86,11,10
14595,10,11173,9,353,94,259,2,30,1,1
15951,10,28759,9,262,88,174,4,58,2,2
15001,10,7808,9,199,102,97,2,30,1,1
13074,181,0,0,60,60,0,1,0,1,0
19613,183,27430,121,3429,1474,1955,16,16,8,8
511,2883,0,0,146,146,0,1,0,1,0
11091,1783,16342,1361,70,70,0,1,5,1,0
11779,26,6769,16,3633587,34615,3598972,2964,137,514,2450
5701,1054,0,0,62,62,0,1,0,1,0
15283,26,3715,16,6155,919,5236,18,55,10,8
21536,1472,0,0,62,62,0,1,0,1,0
12358,2621,7521,2032,70,70,0,1,4,1,0
8864,10,16381,9,184,102,82,2,30,1,1
14792,697,0,0,146,146,0,1,0,1,0
11797,26,16103,16,4466,1914,2552,32,116,18,14
11783,28,0,0,70,70,0,1,0,1,0
15784,10,1405,9,88,88,0,1,30,1,0
683,1017,0,0,66,66,0,1,0,1,0
1706,1215,0,0,66,66,0,1,0,1,0
8409,15,21389,11,378,180,198,7,53,4,3
21776,10,4762,9,183,94,89,2,29,1,1
21498,10,24281,9,199,86,113,2,30,1,1
9522,10,11000,9,199,102,97,2,29,1,1
7339,2845,0,0,60,60,0,1,0,1,0
9875,1251,28608,931,269,78,191,2,30,1,1
9077,10,6282,9,177,94,83,2,30,1,1
15029,10,19872,9,184,102,82,2,29,1,1
12952,26,19798,16,10046,1394,8652,22,75,13,9
18201,28,0,0,70,70,0,1,0,1,0
12554,281,17955,178,70,70,0,1,4,1,0
16798,28,0,0,70,70,0,1,0,1,0
9732,15,20801,11,9116,7610,1506,22,78,12,10
16951,255,25970,160,156,62,94,2,10,1,1
11800,28,0,0,70,70,0,1,0,1,0
3784,26,26969,16,11549,3378,8171,33,196,16,17
10376,1215,0,0,66,66,0,1,0,1,0
20244,2938,0,0,62,62,0,1,0,1,0
11464,26,20493,16,14713,3210,11503,24,135,9,15
18402,26,8392,16,3648,2251,1397,28,89,16,12
20434,28,0,0,70,70,0,1,0,1,0
9411,2285,14566,1770,330,330,0,6,1200,6,0
16951,255,0,0,62,62,0,1,0,1,0
615,229,0,0,410,410,0,1,0,1,0
15731,28,0,0,66,66,0,1,0,1,0
14868,28,0,0,66,66,0,1,0,1,0
9476,28,0,0,70,70,0,1,0,1,0
17960,26,23313,16,2431,1164,1267,27,46,11,16
20092,26,17385,16,8678,3253,5425,22,25,11,11
2359,1017,0,0,62,62,0,1,0,1,0
20613,28,0,0,70,70,0,1,0,1,0
7775,26,22002,16,7948,1520,6428,21,16,13,8
9484,1147,0,0,146,146,0,1,0,1,0
10544,26,26737,16,8140,5384,2756,15,122,8,7
5464,26,26650,16,922046,41258,880788,1106,218,498,608
22641,10,21523,9,336,110,226,2,30,1,1
10504,26,17123,16,3283,951,2332,13,135,6,7
11625,28,0,0,70,70,0,1,0,1,0
18879,2883,0,0,66,66,0,1,0,1,0
3635,489,0,0,62,62,0,1,0,1,0
4835,1389,10561,1056,479,150,329,2,1199,1,1
16951,255,0,0,62,62,0,1,0,1,0
16558,28,0,0,70,70,0,1,0,1,0
19472,28,0,0,70,70,0,1,0,1,0
18373,1888,0,0,66,66,0,1,0,1,0
22370,28,0,0,70,70,0,1,0,1,0
14225,319,14649,205,70,70,0,1,5,1,0
19244,28,0,0,66,66,0,1,0,1,0
16236,28,0,0,70,70,0,1,0,1,0
8594,28,0,0,66,66,0,1,0,1,0
12573,2039,25219,1566,70,70,0,2,7,2,0
20905,1102,2202,809,70,70,0,1,5,1,0
22066,10,19122,9,216,102,114,2,29,1,1
20602,1147,0,0,66,66,0,1,0,1,0
18778,28,0,0,70,70,0,1,0,1,0
2744,1240,2800,920,882,126,756,2,30,1,1
13855,28,0,0,70,70,0,1,0,1,0
18985,28,0,0,70,70,0,1,0,1,0
9237,26,22188,16,7418,2721,4697,23,17,12,11
9053,26,1724,16,214782,13389,201393,277,50,98,179
8336,28,0,0,70,70,0,1,0,1,0
17059,28,0,0,70,70,0,1,0,1,0
11306,28,0,0,70,70,0,1,0,1,0
17926,26,17217,16,6412,1530,4882,24,255,11,13
12777,28,0,0,70,70,0,1,0,1,0
16084,28,0,0,66,66,0,1,0,1,0
725,7,0,0,60,60,0,1,0,1,0
6007,7,0,0,60,60,0,1,0,1,0
7320,26,18099,16,5718,1527,4191,24,22,13,11
7818,26,2428,16,21782,2823,18959,42,16,20,22
22191,10,2003,9,200,102,98,2,31,1,1
15832,10,6106,9,177,94,83,2,30,1,1
1139,3216,0,0,62,62,0,1,0,1,0
21609,10,15518,9,183,94,89,2,30,1,1
15345,1215,0,0,62,62,0,1,0,1,0
11185,28,0,0,70,70,0,1,0,1,0
11310,1888,0,0,66,66,0,1,0,1,0
14467,26,10502,16,8443,1430,7013,17,141,8,9
2281,1147,0,0,146,146,0,1,0,1,0
22438,26,22021,16,5780,2572,3208,23,120,11,12
20914,28,0,0,70,70,0,1,0,1,0
9191,15,20950,11,3648,2069,1579,16,85,9,7
6902,26,11716,16,16517,3254,13263,37,271,18,19
14700,10,22690,9,210,110,100,2,31,1,1
21001,28,0,0,70,70,0,1,0,1,0
14249,1363,28324,1035,70,70,0,1,5,1,0
7991,15,8804,11,1638,1324,314,10,15,5,5
11752,1017,0,0,62,62,0,1,0,1,0
4010,939,0,0,66,66,0,1,0,1,0
19142,1792,0,0,66,66,0,1,0,1,0
7223,10,19734,9,469,165,304,4,30,2,2
7490,26,14250,16,416,210,206,7,28,4,3
16951,255,0,0,62,62,0,1,0,1,0
20603,28,0,0,70,70,0,1,0,1,0
2581,1215,0,0,66,66,0,1,0,1,0
7817,26,20605,16,4475,1568,2907,19,28,11,8
9025,10,21330,9,196,100,96,2,31,1,1
3066,3237,21865,2508,854,150,704,4,1200,2,2
755,10,3049,9,237,91,146,2,33,1,1
21208,2573,0,0,62,62,0,1,0,1,0
2863,2019,21439,1549,148,86,62,2,30,1,1
8547,10,26059,9,199,102,97,2,31,1,1
18253,26,6072,16,7909,3501,4408,19,181,9,10
22371,10,7345,9,185,102,83,2,30,1,1
18228,28,0,0,70,70,0,1,0,1,0
9994,28,0,0,70,70,0,1,0,1,0
15372,28,0,0,70,70,0,1,0,1,0
12746,1888,0,0,62,62,0,1,0,1,0
18,983,0,0,62,62,0,1,0,1,0
18452,28,0,0,70,70,0,1,0,1,0
2744,69,7988,52,873,126,747,2,30,1,1
12029,28,0,0,70,70,0,1,0,1,0
4712,26,12536,16,4266,1768,2498,18,121,8,10
1444,438,0,0,146,146,0,1,0,1,0
13768,26,6052,16,1350,689,661,14,18,8,6
9591,26,19340,16,12362,3372,8990,34,143,18,16
14477,15,2782,11,104399,8436,95963,122,21,49,73
7562,10,20234,9,209,83,126,2,30,1,1
13726,10,22264,9,177,94,83,2,31,1,1
6213,26,1238,16,15233,9395,5838,33,338,16,17
2090,1017,0,0,66,66,0,1,0,1,0
8576,26,9192,16,87590,6597,80993,129,125,48,81
22193,10,15196,9,195,102,93,2,30,1,1
8476,26,13460,16,4250,2969,1281,23,47,12,11
17701,28,0,0,70,70,0,1,0,1,0
6831,2256,0,0,62,62,0,1,0,1,0
22382,10,24775,9,184,94,90,2,30,1,1
12653,26,26515,16,499,425,74,4,0,3,1
14300,2296,117,1780,70,70,0,1,5,1,0
9370,10,27447,9,173,94,79,2,30,1,1
1348,491,0,0,145,145,0,1,0,1,0
19658,28,0,0,70,70,0,1,0,1,0
20283,26,27873,16,9938,3644,6294,31,18,18,13
13958,10,19994,9,711,87,624,2,31,1,1
5159,26,19785,16,7380,3474,3906,18,16,10,8
15796,10,1734,9,193,102,91,2,30,1,1
7033,7,0,0,60,60,0,1,0,1,0
19355,28,0,0,66,66,0,1,0,1,0
20123,2587,0,0,62,62,0,1,0,1,0
9538,26,10826,16,7584,1848,5736,19,29,10,9
20233,28,0,0,70,70,0,1,0,1,0
12050,28,0,0,66,66,0,1,0,1,0
22690,1215,0,0,66,66,0,1,0,1,0
12619,1888,0,0,66,66,0,1,0,1,0
22216,28,0,0,66,66,0,1,0,1,0
11155,10,13533,9,205,86,119,2,29,1,1
3543,2938,0,0,66,66,0,1,0,1,0
18742,1017,0,0,66,66,0,1,0,1,0
10898,26,24517,16,4375,1230,3145,16,30,8,8
7847,255,0,0,60,60,0,1,0,1,0
16133,15,25463,11,60244,2829,57415,65,144,22,43
8369,1545,11104,1177,70,70,0,1,5,1,0
7089,15,19547,11,24787,1571,23216,40,21,20,20
3256,1017,0,0,62,62,0,1,0,1,0
20568,28,0,0,70,70,0,1,0,1,0
8787,10,3885,9,183,94,89,2,29,1,1
18599,15,26861,11,318,120,198,6,26,3,3
637,197,2804,130,150,150,0,2,1201,2,0
18930,28,0,0,70,70,0,1,0,1,0
1949,7,0,0,60,60,0,1,0,1,0
15062,15,6676,11,97842,4441,93401,109,135,41,68
1534,2256,0,0,66,66,0,1,0,1,0
22508,10,15743,9,94,94,0,1,30,1,0
16389,28,0,0,70,70,0,1,0,1,0
15345,26,25178,16,124,64,60,2,16,1,1
22583,26,24552,16,5939,772,5167,17,27,9,8
9514,15,5161,11,318,192,126,6,28,4,2
2274,2836,0,0,74,74,0,1,0,1,0
20634,28,0,0,66,66,0,1,0,1,0
12209,15,26487,11,9094,5469,3625,22,166,12,10
20325,10,0,0,88,88,0,1,0,1,0
8323,10,26233,9,195,102,93,2,30,1,1
16214,3216,0,0,62,62,0,1,0,1,0
2340,10,9632,9,233,91,142,2,30,1,1
5959,26,1380,16,4858,855,4003,16,64,9,7
14391,10,28403,9,250,94,156,2,30,1,1
12123,2486,0,0,148,148,0,1,0,1,0
570,292,0,0,60,60,0,1,90,1,0
7070,15,14148,11,3720,1663,2057,17,186,10,7
12077,26,3434,16,7878,3197,4681,22,18,11,11
8412,28,0,0,70,70,0,1,0,1,0
17461,28,0,0,66,66,0,1,0,1,0
4322,234,27393,149,21282,7311,13971,96,1216,47,49
21767,10,18793,9,251,102,149,2,30,1,1
13699,10,9113,9,261,102,159,2,30,1,1
13659,10,28710,9,211,102,109,2,30,1,1
13684,10,16362,9,185,102,83,2,30,1,1
21719,10,16837,9,168,86,82,2,29,1,1
14008,26,16561,16,3055,953,2102,23,50,10,13
8553,10,4863,9,332,102,230,2,30,1,1
18116,26,22608,16,134,60,74,3,10,2,1
7555,407,0,0,60,60,0,1,0,1,0
17474,28,0,0,70,70,0,1,0,1,0
17310,1017,0,0,62,62,0,1,0,1,0
21526,10,21560,9,168,86,82,2,31,1,1
8284,26,15859,16,4299,2327,1972,23,315,11,12
11503,15,5270,11,3676,3228,448,11,15,7,4
8463,10,17567,9,322,98,224,4,32,2,2
14156,26,28815,16,5200,2825,2375,18,155,9,9
8180,26,7647,16,5959,1709,4250,27,1211,15,12
5393,15,17958,11,1403,651,752,10,15,6,4
10114,15,13983,11,5823,1570,4253,17,20,10,7
20117,28,0,0,70,70,0,1,0,1,0
15860,28,0,0,70,70,0,1,0,1,0
3342,15,27126,11,1151,711,440,10,15,5,5
19262,26,14091,16,8167,2671,5496,22,69,11,11
0,0,0,0,600,306,294,6,0,3,3
8671,28,0,0,70,70,0,1,0,1,0
8682,10,13261,9,183,94,89,2,29,1,1
10300,1215,0,0,66,66,0,1,0,1,0
22702,28,0,0,70,70,0,1,0,1,0
1058,26,4488,16,5693,499,5194,14,15,7,7
16687,4,25826,4,100132,17467,82665,325,619,168,157
2744,1238,9298,918,869,126,743,2,30,1,1
14054,28,0,0,66,66,0,1,0,1,0
14068,10,22768,9,196,102,94,2,29,1,1
21311,824,5730,604,66,66,0,2,8,2,0
18575,26,5959,16,9456,1987,7469,28,30,15,13
14285,10,23061,9,822,102,720,2,30,1,1
6309,26,602,16,4885,895,3990,16,29,9,7
16524,28,0,0,66,66,0,1,0,1,0
20793,28,0,0,70,70,0,1,0,1,0
425,1771,0,0,66,66,0,1,0,1,0
14231,1592,3988,1220,5982,1890,4092,30,75,15,15
10101,26,3498,16,469,403,66,4,0,3,1
1645,26,1443,16,2589,1443,1146,18,16,8,10
8431,15,21406,11,698,366,332,12,44,7,5
17226,1147,0,0,146,146,0,1,0,1,0
13490,28,0,0,70,70,0,1,0,1,0
22254,26,5588,16,4305,2217,2088,11,120,5,6
3945,26,6340,16,17656,4044,13612,30,122,13,17
15805,26,20114,16,4113,1387,2726,15,36,8,7
15120,26,11103,16,245527,10641,234886,322,405,136,186
7556,26,18807,16,8471,3278,5193,21,120,11,10
22715,10,3671,9,199,102,97,2,30,1,1
12468,10,23541,9,832,106,726,2,29,1,1
1749,10,13718,9,497,83,414,4,30,2,2
11169,1904,11262,1455,70,70,0,1,4,1,0
4829,26,27174,16,69429,16478,52951,156,182,83,73
16026,28,0,0,70,70,0,1,0,1,0
6040,26,11965,16,13106,6413,6693,24,121,12,12
1449,1771,0,0,66,66,0,1,0,1,0
12964,28,0,0,66,66,0,1,0,1,0
17571,10,24701,9,241,118,123,2,29,1,1
14050,1888,0,0,66,66,0,1,0,1,0
10204,15,3149,11,6365,3093,3272,36,130,19,17
19326,26,24954,16,352310,324883,27427,389,300,270,119
16137,15,5087,11,886,886,0,1,120,1,0
10932,28,0,0,66,66,0,1,0,1,0
2503,10,10401,9,222,78,144,2,30,1,1
18078,10,27256,9,168,78,90,2,30,1,1
19802,26,2786,16,12169,4985,7184,34,52,19,15
579,2295,0,0,159,159,0,1,0,1,0
14360,10,17523,9,194,102,92,2,31,1,1
2744,1241,24955,921,1672,126,1546,4,30,2,2
1492,2587,0,0,66,66,0,1,0,1,0
22638,10,19869,9,756,95,661,2,31,1,1
6951,15,29116,11,1658,922,736,10,17,6,4
6433,26,12120,16,6921,1769,5152,22,24,13,9
11382,15,21862,11,234,234,0,4,12,4,0
6152,26,18175,16,214163,29159,185004,242,20,108,134
10673,15,21575,11,19232,1830,17402,35,49,19,16
10790,1817,14648,1386,70,70,0,1,5,1,0
20421,40,14197,23,9484,4222,5262,86,45,40,46
4075,26,28954,16,13136,3596,9540,40,26,21,19
7273,2440,0,0,62,62,0,1,0,1,0
22589,10,11579,9,214,110,104,2,30,1,1
18368,28,0,0,66,66,0,1,0,1,0
22089,28,0,0,66,66,0,1,0,1,0
15640,26,1047,16,18227,6731,11496,63,18,34,29
15536,10,11116,9,210,110,100,2,30,1,1
18372,28,0,0,66,66,0,1,0,1,0
5439,26,16014,16,5518,1323,4195,25,271,14,11
8537,509,0,0,66,66,0,1,0,1,0
9449,26,9682,16,3565,1947,1618,19,15,9,10
2078,2587,0,0,62,62,0,1,0,1,0
15643,2938,0,0,62,62,0,1,0,1,0
16508,15,26926,11,3751,3009,742,14,31,8,6
953,26,10537,16,5955,728,5227,17,15,8,9
1460,2938,0,0,62,62,0,1,0,1,0
9485,15,23660,11,8924,872,8052,19,41,9,10
15112,10,27443,9,200,94,106,2,30,1,1
3511,26,3417,16,12536,1564,10972,30,809,13,17
15897,173,25337,119,24544,10921,13623,171,1095,89,82
16059,26,7506,16,4346,1212,3134,13,120,6,7
19891,28,0,0,70,70,0,1,0,1,0
21451,28,0,0,70,70,0,1,0,1,0
20475,28,0,0,66,66,0,1,0,1,0
13640,10,23563,9,164,78,86,2,30,1,1
11481,26,25573,16,32907,8900,24007,38,16,16,22
16960,28,0,0,70,70,0,1,0,1,0
10348,28,0,0,70,70,0,1,0,1,0
22337,10,19463,9,168,86,82,2,30,1,1
10824,2756,13512,2137,70,70,0,2,8,2,0
8973,28,0,0,70,70,0,1,0,1,0
8567,10,17779,9,258,102,156,2,30,1,1
17191,26,24592,16,7641,5165,2476,25,18,13,12
8745,26,380,16,6629,827,5802,19,53,9,10
1330,804,0,0,62,62,0,1,0,1,0
19767,28,0,0,70,70,0,1,0,1,0
15816,10,18828,9,167,86,81,2,29,1,1
9180,10,15058,9,275,94,181,2,29,1,1
12131,1888,0,0,66,66,0,1,0,1,0
22187,10,17601,9,193,102,91,2,31,1,1
17346,28,0,0,66,66,0,1,0,1,0
6262,26,3392,16,6664,1570,5094,23,18,13,10
9411,1255,17386,935,480,149,331,2,1200,1,1
14111,15,4062,11,350,210,140,6,27,4,2
9562,15,27901,11,12920,6875,6045,25,27,13,12
10579,28,0,0,66,66,0,1,0,1,0
19135,28,0,0,70,70,0,1,0,1,0
3740,2573,0,0,145,145,0,1,0,1,0
8360,15,15981,11,6158,654,5504,15,16,8,7
11678,28,0,0,70,70,0,1,0,1,0
13764,10,27908,9,198,102,96,2,33,1,1
4009,15,18940,11,953,538,415,11,318,6,5
15341,10,6242,9,210,110,100,2,30,1,1
9194,2256,0,0,74,74,0,1,0,1,0
8831,10,6178,9,168,86,82,2,29,1,1
21789,10,3418,9,198,102,96,2,30,1,1
10384,28,0,0,66,66,0,1,0,1,0
16200,2938,0,0,62,62,0,1,0,1,0
2726,1888,0,0,62,62,0,1,0,1,0
2046,1359,5823,1031,468,149,319,2,1200,1,1
9342,10,23149,9,182,102,80,2,30,1,1
18734,26,25517,16,6287,1742,4545,17,19,10,7
16951,255,0,0,62,62,0,1,0,1,0
636,3206,12007,2486,207,118,89,2,1200,1,1
11275,28,0,0,66,66,0,1,0,1,0
10474,2477,0,0,72,72,0,1,0,1,0
8695,983,0,0,62,62,0,1,0,1,0
12566,26,17217,16,499,425,74,4,0,3,1
21558,10,24283,9,258,94,164,2,31,1,1
9273,6,21822,6,146,60,86,2,9,1,1
18029,26,633,16,682,310,372,12,68,6,6
12,2592,0,0,102,102,0,1,0,1,0
9069,26,25091,16,4712,908,3804,18,77,9,9
14233,1311,3780,988,130,70,60,2,4,1,1
10489,28,0,0,70,70,0,1,0,1,0
12655,2256,0,0,62,62,0,1,0,1,0
15288,1147,0,0,62,62,0,1,0,1,0
6123,26,21240,16,282,60,222,5,14,2,3
5478,15,17129,11,17982,4308,13674,30,20,15,15
12754,2226,3038,1725,1729,985,744,16,16,9,7
1614,1797,0,0,66,66,0,1,0,1,0
1525,1444,0,0,145,145,0,1,0,1,0
9117,10,16557,9,757,98,659,2,31,1,1
22376,10,27130,9,508,186,322,6,51,3,3
13985,26,278,16,116686,21822,94864,224,186,112,112
22415,10,24125,9,298,94,204,2,30,1,1
3225,1994,25745,1524,148,86,62,2,30,1,1
11736,2256,0,0,66,66,0,1,0,1,0
20840,28,0,0,66,66,0,1,0,1,0
12336,28,0,0,70,70,0,1,0,1,0
8410,10,4299,9,452,118,334,2,30,1,1
17614,26,27598,16,2854,1732,1122,16,15,8,8
1133,2938,0,0,78,78,0,1,0,1,0
18362,1167,0,0,62,62,0,1,0,1,0
1955,7,0,0,60,60,0,1,0,1,0
1486,2432,0,0,148,148,0,1,0,1,0
2744,1451,18857,1104,1646,126,1520,4,30,2,2
19260,28,0,0,70,70,0,1,0,1,0
19667,1771,0,0,66,66,0,1,0,1,0
8829,10,17802,9,184,102,82,2,30,1,1
8048,676,12716,475,130,70,60,2,5,1,1
9572,28,0,0,70,70,0,1,0,1,0
10066,26,22246,16,5661,2414,3247,22,37,13,9
18798,1989,9641,1519,316,136,180,6,5,3,3
4737,10,16202,9,237,91,146,2,32,1,1
9372,28,0,0,66,66,0,1,0,1,0
15262,26,18321,16,7889,1900,5989,20,15,11,9
8699,10,29033,9,771,101,670,2,30,1,1
8896,28,0,0,70,70,0,1,0,1,0
9158,1215,0,0,62,62,0,1,0,1,0
11681,1147,0,0,66,66,0,1,0,1,0
13404,1888,0,0,62,62,0,1,0,1,0
10366,26,23265,16,190,70,120,4,15,2,2
17721,26,12199,16,24203,14278,9925,168,320,74,94
6398,26,28679,16,9265,2134,7131,24,123,12,12
13572,10,0,0,174,79,95,2,30,1,1
8584,1464,20470,1115,78,78,0,1,30,1,0
14605,697,0,0,146,146,0,1,0,1,0
3636,1472,0,0,62,62,0,1,0,1,0
8672,10,23152,9,200,102,98,2,31,1,1
3066,675,1258,474,501,150,351,2,1200,1,1
0,0,0,0,210,210,0,3,0,3,0
15145,10,18353,9,183,94,89,2,30,1,1
2744,1633,15191,1255,895,126,769,2,31,1,1
12701,2712,24796,2106,70,70,0,1,5,1,0
15162,26,15030,16,7110,2183,4927,22,16,12,10
11718,26,23903,16,1550,834,716,19,141,10,9
16104,26,25437,16,175212,28668,146544,186,180,69,117
8561,28,0,0,66,66,0,1,0,1,0
5994,26,9230,16,1053,566,487,10,48,6,4
8415,28,0,0,70,70,0,1,0,1,0
21468,10,1265,9,186,95,91,2,31,1,1
14863,26,9862,16,154,94,60,2,4,1,1
20310,1147,0,0,146,146,0,1,0,1,0
21768,10,15927,9,194,102,92,2,30,1,1
9127,10,6529,9,279,96,183,4,58,2,2
14314,26,15128,16,319563,13365,306198,344,123,119,225
14050,10,13782,9,216,110,106,2,31,1,1
14492,3238,17999,2509,469,150,319,2,1200,1,1
22067,10,11437,9,167,86,81,2,30,1,1
15109,10,12656,9,291,88,203,4,50,2,2
18635,10,5580,9,180,86,94,2,30,1,1
22505,10,20763,9,180,92,88,2,30,1,1
22097,10,24615,9,195,102,93,2,31,1,1
4421,15,12053,11,18460,3166,15294,34,32,18,16
5789,3216,0,0,62,62,0,1,0,1,0
5787,983,0,0,62,62,0,1,0,1,0
8885,28,0,0,70,70,0,1,0,1,0
13000,26,14431,16,499,425,74,4,0,3,1
16467,28,0,0,70,70,0,1,0,1,0
637,1140,22645,841,509,150,359,2,1200,1,1
13774,10,13818,9,177,94,83,2,31,1,1
9597,28,0,0,66,66,0,1,0,1,0
2487,10,10424,9,247,98,149,2,32,1,1
16473,15,27475,11,378,192,186,7,21,4,3
10132,28,0,0,70,70,0,1,0,1,0
6761,5,0,0,60,60,0,1,0,1,0
9954,28,0,0,70,70,0,1,0,1,0
6378,7,0,0,60,60,0,1,0,1,0
15335,10,26787,9,760,96,664,2,31,1,1
13676,10,12900,9,772,103,669,2,30,1,1
9862,28,0,0,70,70,0,1,0,1,0
8409,1017,0,0,62,62,0,1,0,1,0
18124,28,0,0,70,70,0,1,0,1,0
8990,28,0,0,66,66,0,1,0,1,0
12066,26,713,16,6512167,186944,6325223,6347,1216,2089,4258
19220,28,0,0,70,70,0,1,0,1,0
2724,1240,13018,920,168,82,86,2,30,1,1
8875,15,8186,11,1702,1388,314,10,15,5,5
18091,28,0,0,70,70,0,1,0,1,0
5651,10,17412,9,414,268,146,3,32,2,1
22543,10,27717,9,168,86,82,2,30,1,1
14029,10,16754,9,190,97,93,2,31,1,1
3687,10,7814,9,199,94,105,2,30,1,1
11664,26,5892,16,1369,708,661,14,45,8,6
21146,1440,10233,1094,66,66,0,2,8,2,0
368,3216,0,0,62,62,0,1,0,1,0
1557,2587,0,0,62,62,0,1,0,1,0
8951,26,15078,16,7757,1949,5808,22,126,12,10
21526,10,23273,9,1026,383,643,10,84,5,5
20310,1147,0,0,62,62,0,1,0,1,0
22681,10,19273,9,822,102,720,2,30,1,1
5706,26,18669,16,1352,691,661,14,42,8,6
17265,26,25009,16,2768,1593,1175,22,21,11,11
5443,15,17313,11,1143,401,742,9,360,5,4
18993,2943,0,0,146,146,0,1,0,1,0
7944,26,12530,16,295475,14093,281382,413,469,162,251
7637,676,23964,475,130,70,60,2,6,1,1
1864,2938,0,0,62,62,0,1,0,1,0
5412,26,4997,16,7469,2547,4922,18,135,8,10
446,1880,0,0,62,62,0,1,0,1,0
14806,255,0,0,60,60,0,1,0,1,0
13678,10,24783,9,168,86,82,2,31,1,1
21454,10,4398,9,299,98,201,4,57,2,2
13975,26,24364,16,7710,3932,3778,23,18,14,9
636,573,12452,387,509,150,359,2,1199,1,1
10722,243,4949,156,70,70,0,1,5,1,0
5351,26,25561,16,36154,9709,26445,60,161,27,33
2744,1238,4816,918,901,126,775,2,30,1,1
21329,28,0,0,70,70,0,1,0,1,0
12472,28,0,0,66,66,0,1,0,1,0
18933,15,8928,11,1212,774,438,11,81,7,4
14262,10,20283,9,308,102,206,2,30,1,1
7457,2636,0,0,74,74,0,1,0,1,0
16951,255,0,0,62,62,0,1,0,1,0
12892,26,27006,16,113020,6140,106880,149,202,66,83
13906,28,0,0,70,70,0,1,0,1,0
8395,10,12805,9,193,102,91,2,30,1,1
38,1147,0,0,62,62,0,1,0,1,0
6250,1995,15261,1525,157,94,63,2,30,1,1
21866,183,28733,121,3409,1454,1955,16,16,8,8
22230,10,18336,9,190,97,93,2,31,1,1
8460,10,7556,9,294,88,206,4,57,2,2
4605,26,13050,16,8891,1846,7045,27,147,14,13
12698,26,26518,16,499,425,74,4,1,3,1
15013,28,0,0,66,66,0,1,0,1,0
7049,394,20135,255,4014,2342,1672,42,386,21,21
5225,2382,0,0,62,62,0,1,0,1,0
15245,26,24438,16,8308,3589,4719,25,19,15,10
13822,10,9845,9,195,102,93,2,30,1,1
8562,28,0,0,70,70,0,1,0,1,0
12204,2256,0,0,66,66,0,1,0,1,0
1364,15,4644,11,6967,765,6202,15,16,7,8
19264,26,7272,16,7653,1226,6427,24,18,14,10
3583,15,11844,11,1139,609,530,10,61,6,4
16156,28,0,0,66,66,0,1,0,1,0
1712,16,0,0,60,60,0,1,0,1,0
10933,26,5642,16,1612,1089,523,12,15,7,5
16338,28,0,0,70,70,0,1,0,1,0
231,1054,0,0,62,62,0,1,0,1,0
9441,28,0,0,66,66,0,1,0,1,0
13839,10,4340,9,177,94,83,2,29,1,1
3385,15,17049,11,1114,534,580,12,15,7,5
406,2587,0,0,62,62,0,1,0,1,0
8429,28,0,0,70,70,0,1,0,1,0
21832,10,21314,9,269,110,159,2,30,1,1
15691,28,0,0,70,70,0,1,0,1,0
10130,28,0,0,70,70,0,1,0,1,0
3898,6,0,0,60,60,0,1,0,1,0
15866,10,2453,9,197,102,95,2,29,1,1
491,2953,0,0,66,66,0,1,0,1,0
11426,15,26678,11,2516,1929,587,15,16,9,6
19223,28,0,0,70,70,0,1,0,1,0
3515,15,28077,11,1288,496,792,8,43,5,3
14015,10,19510,9,195,102,93,2,30,1,1
12840,2573,0,0,66,66,0,1,0,1,0
15639,28,0,0,70,70,0,1,0,1,0
14318,26,15658,16,914,444,470,14,29,7,7
11177,26,13812,16,27251,9966,17285,70,73,35,35
14467,28,0,0,70,70,0,1,0,1,0
11804,26,6113,16,130,70,60,2,14,1,1
18542,2938,0,0,62,62,0,1,0,1,0
15671,1613,2165,1235,223,223,0,1,30,1,0
740,1017,0,0,62,62,0,1,0,1,0
21810,28,0,0,70,70,0,1,0,1,0
8456,10,22138,9,322,118,204,2,30,1,1
19,2611,0,0,62,62,0,1,0,1,0
13005,26,18349,16,6500,1064,5436,22,255,12,10
14637,10,12645,9,337,94,243,2,30,1,1
29,1888,0,0,62,62,0,1,0,1,0
8879,10,6960,9,184,94,90,2,30,1,1
8999,10,14994,9,168,86,82,2,30,1,1
11014,2793,11512,2167,70,70,0,1,5,1,0
14976,10,14844,9,199,102,97,2,29,1,1
14742,28,0,0,66,66,0,1,0,1,0
15877,26,8437,16,5989,926,5063,19,14,10,9
20836,10,25147,9,199,86,113,2,29,1,1
2172,780,12910,566,481,150,331,2,1199,1,1
615,23,0,0,82,82,0,1,0,1,0
7283,26,21722,16,3068,1678,1390,17,242,9,8
11452,26,23924,16,16541,4900,11641,62,131,26,36
8891,26,19535,16,7162,780,6382,18,50,8,10
11642,26,431,16,7843,2397,5446,23,256,12,11
7339,140,0,0,60,60,0,1,0,1,0
1168,15,4180,11,2166,600,1566,10,45,6,4
21961,10,1007,9,730,102,628,2,30,1,1
19602,2550,0,0,66,66,0,1,0,1,0
10035,28,0,0,70,70,0,1,0,1,0
8483,10,10405,9,184,94,90,2,31,1,1
10476,26,16526,16,9284,2172,7112,39,83,19,20
12775,257,28646,162,70,70,0,2,7,2,0
14566,10,14472,9,178,94,84,2,30,1,1
14429,15,23155,11,73021,1232,71789,66,80,14,52
10786,10,14418,9,168,78,90,2,30,1,1
22101,3049,0,0,66,66,0,1,91,1,0
22568,10,28515,9,404,95,309,4,49,2,2
16021,46,8195,29,350,163,187,2,1200,1,1
3154,10,13228,9,414,268,146,3,32,2,1
2744,1511,634,1150,1626,126,1500,4,31,2,2
10870,26,18616,16,246,120,126,5,32,3,2
9,18,3115,13,184,94,90,2,30,1,1
17872,10,4683,9,260,86,174,2,30,1,1
14402,10,4833,9,271,93,178,4,32,2,2
112,2778,0,0,66,66,0,1,0,1,0
10746,2928,27887,2272,70,70,0,2,8,2,0
14512,10,5668,9,194,102,92,2,30,1,1
9218,10,16081,9,177,94,83,2,30,1,1
11712,2938,0,0,66,66,0,1,0,1,0
10981,15,22014,11,366,240,126,7,28,5,2
20538,10,5912,9,448,166,282,2,30,1,1
7074,26,15971,16,1392,731,661,14,80,8,6
19171,28,0,0,70,70,0,1,0,1,0
7422,330,22710,211,1440,956,484,15,35,8,7
6326,26,17277,16,14262,5874,8388,31,138,15,16
1657,1888,0,0,62,62,0,1,0,1,0
8970,280,0,0,62,62,0,1,0,1,0
10772,931,12813,686,136,136,0,3,14,3,0
581,7,0,0,60,60,0,1,0,1,0
15278,10,14708,9,199,102,97,2,31,1,1
259,1472,0,0,66,66,0,1,0,1,0
9942,28,0,0,66,66,0,1,0,1,0
21372,26,28499,16,13511,6811,6700,43,159,23,20
18059,8,26585,8,1867,743,1124,24,16,11,13
21932,10,1795,9,179,94,85,2,30,1,1
21449,28,0,0,70,70,0,1,0,1,0
11376,28,0,0,70,70,0,1,0,1,0
16021,280,25527,177,453,251,202,4,1200,2,2
14956,10,1561,9,184,102,82,2,30,1,1
7273,1888,0,0,145,145,0,1,0,1,0
12141,26,11575,16,31843,2847,28996,50,323,20,30
153,3216,0,0,66,66,0,1,0,1,0
14438,10,26883,9,214,110,104,2,31,1,1
15498,28,0,0,66,66,0,1,0,1,0
6615,26,4175,16,5578,1646,3932,23,16,13,10
8896,10,14838,9,194,102,92,2,30,1,1
19381,26,24892,16,5628,1716,3912,26,109,16,10
8410,15,21390,11,378,180,198,7,53,4,3
11596,1804,0,0,66,66,0,1,0,1,0
3443,1888,0,0,62,62,0,1,0,1,0
18805,1989,15147,1519,316,136,180,6,6,3,3
13884,983,0,0,62,62,0,1,0,1,0
6328,3216,0,0,62,62,0,1,0,1,0
6166,1367,0,0,62,62,0,1,0,1,0
12347,26,23475,16,960,539,421,9,35,5,4
11270,2706,26566,2102,70,70,0,2,6,2,0
5126,26,9984,16,1065134,19929,1045205,1009,16,288,721
1330,697,0,0,145,145,0,1,0,1,0
21842,10,6556,9,179,94,85,2,30,1,1
8449,10,25043,9,178,94,84,2,30,1,1
22592,28,0,0,66,66,0,1,0,1,0
16758,28,0,0,70,70,0,1,0,1,0
14076,1888,0,0,66,66,0,1,0,1,0
11231,2216,5276,1717,66,66,0,2,9,2,0
12719,26,9398,16,499,425,74,4,1,3,1
11297,28,0,0,66,66,0,1,0,1,0
9296,10,7198,9,209,110,99,2,30,1,1
14707,10,23312,9,174,89,85,2,31,1,1
16276,28,0,0,70,70,0,1,0,1,0
12294,26,8446,16,10500,2835,7665,34,114,14,20
13909,10,15400,9,170,87,83,2,30,1,1
14975,26,897,16,5019,946,4073,19,34,9,10
9728,1921,18142,1466,1377,300,1077,6,1200,3,3
9185,28,0,0,70,70,0,1,0,1,0
14286,28,0,0,70,70,0,1,0,1,0
797,15,3275,11,48320,1685,46635,57,126,22,35
12045,2947,5965,2286,320,140,180,6,7,3,3
21379,10,315,9,855,311,544,8,79,4,4
15920,10,2484,9,172,88,84,2,31,1,1
15412,10,5896,9,195,102,93,2,33,1,1
21632,10,17504,9,278,102,176,2,30,1,1
2744,1567,1756,1198,877,126,751,2,31,1,1
8551,10,20932,9,193,102,91,2,31,1,1
22116,2604,0,0,62,62,0,1,0,1,0
14696,28,0,0,70,70,0,1,0,1,0
22720,10,18655,9,186,95,91,2,31,1,1
21685,28,0,0,66,66,0,1,0,1,0
10256,26,22349,16,33565,5938,27627,60,128,24,36
17917,28,0,0,70,70,0,1,0,1,0
12734,26,24990,16,499,425,74,4,0,3,1
8210,287,21194,184,480,149,331,2,1200,1,1
21330,10,18139,9,1299,387,912,10,103,5,5
9411,2948,15692,2287,1450,747,703,16,1200,9,7
21399,10,11159,9,182,93,89,2,31,1,1
22649,10,9861,9,184,94,90,2,30,1,1
18167,28,0,0,70,70,0,1,0,1,0
8208,26,14975,16,6478,2684,3794,18,122,8,10
9718,15,23274,11,2734,1250,1484,16,15,10,6
21761,28,0,0,70,70,0,1,0,1,0
1756,2587,0,0,62,62,0,1,0,1,0
15173,28,0,0,70,70,0,1,0,1,0
13941,10,21517,9,308,94,214,2,30,1,1
8616,10,12672,9,758,102,656,2,30,1,1
8276,2495,0,0,161,161,0,1,0,1,0
18972,26,16863,16,1004246,35992,968254,1127,90,451,676
1522,10,5400,9,208,94,114,2,31,1,1
16406,28,0,0,70,70,0,1,0,1,0
15171,10,11302,9,198,101,97,2,30,1,1
14493,10,10095,9,260,102,158,2,29,1,1
8170,232,27617,147,8355,4135,4220,79,616,41,38
9461,1888,0,0,66,66,0,1,0,1,0
22045,10,22622,9,199,102,97,2,30,1,1
15958,28,0,0,66,66,0,1,0,1,0
6099,234,24067,149,7701,2155,5546,30,611,17,13
6209,26,20238,16,162,102,60,2,5,1,1
15913,10,8267,9,199,102,97,2,30,1,1
21656,10,13704,9,286,98,188,4,40,2,2
6481,15,5584,11,1052,612,440,10,15,5,5
12875,1147,0,0,62,62,0,1,0,1,0
21555,10,20968,9,311,118,193,2,30,1,1
13078,26,5575,16,122,62,60,2,15,1,1
16087,28,0,0,70,70,0,1,0,1,0
9022,10,18071,9,177,94,83,2,30,1,1
17295,26,18393,16,9860,5309,4551,25,131,14,11
13698,10,22811,9,196,102,94,2,29,1,1
11028,28,0,0,70,70,0,1,0,1,0
8979,10,12398,9,181,94,87,2,30,1,1
16951,255,0,0,62,62,0,1,0,1,0
21272,821,24758,601,4607,2045,2562,24,45,14,10
12087,10,10018,9,365,86,279,2,30,1,1
15982,26,6142,16,832,268,564,14,37,5,9
3105,2380,0,0,145,145,0,1,0,1,0
22180,28,0,0,70,70,0,1,0,1,0
15136,10,8724,9,198,102,96,2,31,1,1
8781,26,10411,16,48705,7643,41062,146,256,77,69
3452,234,6358,149,12979,2808,10171,46,648,21,25
13773,3212,0,0,66,66,0,1,0,1,0
9537,26,28776,16,1125,595,530,12,29,6,6
17852,26,23481,16,7165,2077,5088,22,105,12,10
1886,3139,0,0,62,62,0,1,0,1,0
7054,26,13740,16,4848,1030,3818,16,26,9,7
15610,10,5422,9,735,88,647,2,30,1,1
15484,10,13497,9,177,94,83,2,30,1,1
8955,10,29113,9,177,94,83,2,30,1,1
16525,509,0,0,62,62,0,1,0,1,0
15370,10,9506,9,177,94,83,2,30,1,1
225,10,4112,9,204,118,86,2,30,1,1
10491,28,0,0,70,70,0,1,0,1,0
11446,26,14850,16,7356,1014,6342,20,75,10,10
17258,28,0,0,70,70,0,1,0,1,0
8668,26,8993,16,26402,2904,23498,56,270,29,27
10778,682,17566,481,70,70,0,2,9,2,0
8852,28,0,0,70,70,0,1,0,1,0
2460,10,10214,9,414,268,146,3,31,2,1
8705,15,21497,11,378,192,186,7,42,4,3
16951,255,0,0,62,62,0,1,0,1,0
12836,28,0,0,70,70,0,1,0,1,0
9597,28,0,0,70,70,0,1,0,1,0
22201,10,8737,9,323,94,229,2,30,1,1
452,7,0,0,60,60,0,1,0,1,0
7452,26,24884,16,10379011,159069,10219942,8727,252,1321,7406
13263,26,12297,16,89702,83941,5761,91,181,66,25
11988,28,0,0,70,70,0,1,0,1,0
17,730,0,0,129,129,0,1,0,1,0
14460,10,15633,9,199,94,105,2,30,1,1
14750,2587,0,0,66,66,0,1,0,1,0
2738,1215,0,0,66,66,0,1,0,1,0
2247,280,0,0,62,62,0,1,0,1,0
8578,26,5252,16,9266,2595,6671,35,123,18,17
13588,28,0,0,70,70,0,1,0,1,0
2538,2938,0,0,62,62,0,1,0,1,0
2908,1820,19557,1387,64,64,0,1,10,1,0
3048,2256,0,0,66,66,0,1,0,1,0
17846,183,26481,121,8409,1841,6568,27,20,11,16
2744,1238,14839,918,899,126,773,2,30,1,1
7717,26,9645,16,6211,1753,4458,43,215,15,28
6431,15,17851,11,234,234,0,4,12,4,0
14966,10,27816,9,402,142,260,2,30,1,1
15969,26,7887,16,16749,7614,9135,74,17,34,40
8676,26,20185,16,1012,495,517,10,26,4,6
9264,1539,0,0,66,66,0,1,0,1,0
6195,26,24347,16,6531,1249,5282,24,286,13,11
13741,10,678,9,186,95,91,2,31,1,1
16701,1017,0,0,62,62,0,1,0,1,0
15841,28,0,0,70,70,0,1,0,1,0
22338,28,0,0,70,70,0,1,0,1,0
7294,15,18467,11,2768,1722,1046,17,20,8,9
8937,10,25617,9,177,94,83,2,29,1,1
22018,10,966,9,184,94,90,2,31,1,1
8687,10,11332,9,182,93,89,2,30,1,1
3672,40,0,0,60,60,0,1,0,1,0
11302,15,22876,11,156876,7015,149861,158,28,49,109
5124,26,28170,16,759586,14873,744713,719,16,209,510
20031,26,27715,16,4378,1471,2907,19,27,11,8
17141,28,0,0,70,70,0,1,0,1,0
15533,10,10997,9,196,102,94,2,30,1,1
8362,352,23691,225,70,70,0,1,5,1,0
12298,26,23441,16,960,539,421,9,30,5,4
16951,255,0,0,62,62,0,1,0,1,0
15128,10,1256,9,195,102,93,2,31,1,1
22312,10,4374,9,193,102,91,2,30,1,1
13879,28,0,0,66,66,0,1,0,1,0
21196,1061,9715,780,564,382,182,9,15,6,3
15890,10,17947,9,258,110,148,2,31,1,1
15286,10,27508,9,209,110,99,2,31,1,1
492,3216,0,0,66,66,0,1,0,1,0
15189,1147,0,0,66,66,0,1,0,1,0
16021,1230,27424,910,480,149,331,2,1200,1,1
14550,10,14371,9,742,88,654,2,30,1,1
9339,10,14738,9,168,78,90,2,30,1,1
9481,10,4555,9,240,76,164,2,30,1,1
15174,10,8823,9,258,110,148,2,30,1,1
3549,26,19041,16,448,78,370,6,25,1,5
9628,26,15965,16,30475,26737,3738,62,26,35,27
10952,15,805,11,52962,3994,48968,71,27,32,39
17987,26,5261,16,302,120,182,6,32,3,3
18785,28,0,0,66,66,0,1,0,1,0
1673,341,26382,217,212,150,62,2,30,1,1
7263,26,5181,16,99276,88410,10866,143,333,78,65
21505,10,223,9,199,102,97,2,31,1,1
22715,1397,0,0,66,66,0,1,0,1,0
9044,28,0,0,70,70,0,1,0,1,0
20039,1936,0,0,62,62,0,1,0,1,0
18587,26,26854,16,1088,641,447,10,26,6,4
3058,3262,0,0,60,60,0,1,0,1,0
10319,28,0,0,66,66,0,1,0,1,0
21703,10,10774,9,183,94,89,2,31,1,1
9087,26,20779,16,7759,2264,5495,19,120,9,10
15097,10,8592,9,167,86,81,2,29,1,1
3255,509,0,0,62,62,0,1,0,1,0
15697,28,0,0,70,70,0,1,0,1,0
14124,10,11270,9,193,102,91,2,30,1,1
16010,26,4076,16,4881,1817,3064,30,135,16,14
9866,28,0,0,66,66,0,1,0,1,0
10528,28,0,0,70,70,0,1,0,1,0
15194,26,5723,16,6895,2273,4622,21,17,12,9
9669,28,0,0,66,66,0,1,0,1,0
4254,3139,0,0,62,62,0,1,0,1,0
14422,10,13734,9,177,94,83,2,30,1,1
7515,10,1662,9,168,78,90,2,30,1,1
18,1861,0,0,62,62,0,1,0,1,0
248,1054,0,0,62,62,0,1,0,1,0
22508,10,9688,9,178,94,84,2,30,1,1
14977,10,27072,9,183,94,89,2,30,1,1
10380,1147,0,0,62,62,0,1,0,1,0
20949,26,20991,16,1296,612,684,18,120,9,9
8210,1007,21194,741,513,152,361,2,1200,1,1
5963,26,28694,16,190,70,120,4,15,2,2
14862,10,20034,9,166,86,80,2,30,1,1
497,1610,0,0,220,220,0,1,0,1,0
16951,255,25970,160,62,62,0,1,5,1,0
1832,3117,0,0,62,62,0,1,0,1,0
12358,26,2641,16,1625,1038,587,14,34,8,6
8290,232,1195,147,6910,3381,3529,50,323,26,24
6023,15,19157,11,2016,552,1464,8,16,5,3
13574,28,0,0,66,66,0,1,0,1,0
4295,26,15626,16,4563,1656,2907,19,28,11,8
16951,255,0,0,62,62,0,1,0,1,0
15809,26,7318,16,12683,4753,7930,59,36,33,26
16904,28,0,0,70,70,0,1,0,1,0
11450,1686,0,0,60,60,0,1,0,1,0
18688,28,0,0,66,66,0,1,0,1,0
2617,2938,0,0,62,62,0,1,0,1,0
844,1590,0,0,146,146,0,1,0,1,0
17036,28,0,0,70,70,0,1,0,1,0
6878,10,19220,9,235,90,145,2,32,1,1
14355,2198,8087,1702,70,70,0,1,5,1,0
13725,10,22485,9,177,94,83,2,30,1,1
7850,1657,0,0,106,106,0,1,60,1,0
18747,28,0,0,70,70,0,1,0,1,0
16021,857,28785,632,166,166,0,1,1200,1,0
22547,10,15162,9,272,94,178,2,31,1,1
18007,26,28617,16,1401,864,537,12,30,6,6
8820,10,25844,9,184,94,90,2,31,1,1
19538,697,0,0,66,66,0,1,0,1,0
54,1888,0,0,62,62,0,1,0,1,0
21547,10,28601,9,199,102,97,2,30,1,1
8951,10,22906,9,211,110,101,2,30,1,1
20437,28,0,0,66,66,0,1,0,1,0
17863,28,0,0,66,66,0,1,0,1,0
16654,28,0,0,70,70,0,1,0,1,0
21856,10,411,9,199,102,97,2,30,1,1
15189,15,28982,11,234,234,0,4,11,4,0
8850,15,26756,11,13889,4084,9805,27,16,13,14
14400,10,14661,9,199,102,97,2,30,1,1
8262,26,21263,16,4657,1750,2907,19,31,11,8
16764,2938,0,0,66,66,0,1,0,1,0
22405,28,0,0,70,70,0,1,0,1,0
17135,28,0,0,70,70,0,1,0,1,0
21562,3216,0,0,66,66,0,1,0,1,0
17825,2853,0,0,62,62,0,1,0,1,0
6075,26,26306,16,9797,1934,7863,21,15,12,9
684,2938,0,0,62,62,0,1,0,1,0
8647,10,21509,9,222,101,121,2,31,1,1
13055,28,0,0,70,70,0,1,0,1,0
6176,26,22849,16,9366,5830,3536,23,121,12,11
12101,26,27676,16,81114,4708,76406,108,66,39,69
10203,2883,0,0,66,66,0,1,0,1,0
9728,2599,3658,2018,166,166,0,1,1199,1,0
8559,1472,0,0,66,66,0,1,0,1,0
9852,28,0,0,66,66,0,1,0,1,0
9433,10,19673,9,177,94,83,2,30,1,1
4315,26,23580,16,78,78,0,1,5,1,0
3133,2294,1183,1779,396,396,0,7,3615,7,0
18265,28,0,0,70,70,0,1,0,1,0
14479,10,6538,9,177,94,83,2,30,1,1
8677,2938,0,0,66,66,0,1,0,1,0
21287,10,13731,9,209,110,99,2,30,1,1
9027,26,13303,16,6057,1038,5019,20,56,11,9
12186,28,0,0,66,66,0,1,0,1,0
9728,28,0,0,70,70,0,1,0,1,0
3510,15,24544,11,70,70,0,1,5,1,0
2744,63,18660,46,867,126,741,2,30,1,1
8528,10,10650,9,184,94,90,2,30,1,1
7375,1594,0,0,74,74,0,1,0,1,0
14936,10,23184,9,184,94,90,2,31,1,1
12452,1936,0,0,66,66,0,1,0,1,0
12675,3139,0,0,62,62,0,1,0,1,0
19783,26,20043,16,356,60,296,6,18,2,4
22621,15,20696,11,306,180,126,6,29,4,2
15734,183,25255,121,3347,1458,1889,15,18,8,7
2863,2016,7749,1546,568,78,490,2,29,1,1
8363,28,0,0,66,66,0,1,0,1,0
2920,10,11970,9,213,87,126,2,30,1,1
21773,2573,0,0,66,66,0,1,0,1,0
14870,10,7406,9,315,102,213,2,30,1,1
8397,28,0,0,66,66,0,1,0,1,0
10238,34,22337,20,320,128,192,6,6,3,3
18672,28,0,0,70,70,0,1,0,1,0
15078,10,17781,9,199,102,97,2,30,1,1
14639,10,3204,9,246,102,144,2,30,1,1
12035,1278,16748,958,1231702,397859,833843,10382,185,4780,5602
8560,26,27669,16,1392,731,661,14,80,8,6
9306,10,16562,9,177,94,83,2,30,1,1
14643,10,1809,9,183,94,89,2,30,1,1
21827,10,20163,9,342,142,200,2,30,1,1
2744,1238,26784,918,878,126,752,2,30,1,1
14970,10,22256,9,279,93,186,4,32,2,2
22639,28,0,0,66,66,0,1,0,1,0
6426,26,20326,16,4999,2845,2154,41,87,22,19
15278,10,27563,9,183,94,89,2,31,1,1
22395,28,0,0,66,66,0,1,0,1,0
19373,26,199,16,23229,1880,21349,46,80,21,25
22672,10,5764,9,701,88,613,2,31,1,1
9036,10,15575,9,331,126,205,2,30,1,1
9130,10,1994,9,168,78,90,2,30,1,1
12253,1147,0,0,66,66,0,1,0,1,0
15162,10,9693,9,170,87,83,2,30,1,1
9447,26,4811,16,11313,2617,8696,27,47,15,12
11768,26,15480,16,5743,1339,4404,18,180,8,10
2744,1242,22358,922,1698,126,1572,4,31,2,2
7221,26,17934,16,130,70,60,2,15,1,1
13406,28,0,0,66,66,0,1,0,1,0
20941,26,2376,16,26835,2611,24224,36,121,14,22
9594,10,3595,9,209,110,99,2,30,1,1
3386,1888,0,0,62,62,0,1,0,1,0
15374,26,13307,16,6496,1340,5156,31,506,10,21
7578,26,9932,16,9723,1780,7943,35,120,17,18
360,3105,0,0,179,179,0,1,0,1,0
4601,10,16088,9,414,268,146,3,32,2,1
16110,28,0,0,70,70,0,1,0,1,0
12228,15,9491,11,2722,1530,1192,12,316,7,5
22446,10,3368,9,197,94,103,2,30,1,1
14471,10,6414,9,749,94,655,2,30,1,1
14669,28,0,0,66,66,0,1,0,1,0
803,1888,0,0,62,62,0,1,0,1,0
17485,10,26269,9,825,99,726,2,31,1,1
9728,59,28052,42,161,161,0,2,1200,2,0
13655,15,12163,11,9249354,297929,8951425,10789,208,4872,5917
12763,1151,27019,849,1724,1157,567,14,17,9,5
8363,1147,0,0,62,62,0,1,0,1,0
1954,1483,0,0,148,148,0,1,0,1,0
12764,2270,7380,1757,70,70,0,1,5,1,0
10776,822,19385,602,136,136,0,3,14,3,0
10746,2256,0,0,62,62,0,1,0,1,0
14803,10,20569,9,200,102,98,2,30,1,1
8498,26,8675,16,4889,763,4126,18,30,8,10
21365,10,4900,9,227,102,125,2,30,1,1
21959,28,0,0,66,66,0,1,0,1,0
10181,28,0,0,66,66,0,1,0,1,0
1369,3216,0,0,145,145,0,1,0,1,0
13204,28,0,0,70,70,0,1,0,1,0
10975,28,0,0,70,70,0,1,0,1,0
4946,26,6981,16,6872,1815,5057,22,318,13,9
15602,10,24188,9,413,170,243,6,30,3,3
8797,26,2818,16,11772,5416,6356,25,49,15,10
20832,26,27676,16,7782,1280,6502,22,79,10,12
16578,2953,0,0,66,66,0,1,0,1,0
4157,15,6811,11,2604,1690,914,20,610,11,9
3653,26,3086,16,6507,1060,5447,22,255,12,10
12594,28,0,0,66,66,0,1,0,1,0
3607,26,27298,16,6419,995,5424,21,361,11,10
3181,899,0,0,62,62,0,1,0,1,0
1143,983,0,0,66,66,0,1,0,1,0
19738,28,0,0,66,66,0,1,0,1,0
14610,28,0,0,66,66,0,1,0,1,0
15423,901,27983,665,70,70,0,2,8,2,0
1479,1771,0,0,146,146,0,1,0,1,0
4327,26,15672,16,8448,2150,6298,39,98,21,18
15986,15,3686,11,4509,2976,1533,13,15,6,7
0,0,0,0,480,244,236,4,0,2,2
14198,26,2256,16,8049,1560,6489,19,151,9,10
19283,2205,0,0,66,66,0,1,0,1,0
7789,1804,0,0,66,66,0,1,0,1,0
3158,1017,0,0,146,146,0,1,0,1,0
8874,10,21397,9,193,102,91,2,30,1,1
21546,26,11555,16,252,70,182,3,120,1,2
6852,26,6894,16,5880,2280,3600,31,76,14,17
15179,797,0,0,66,66,0,1,0,1,0
9656,1129,0,0,145,145,0,1,0,1,0
11777,28,0,0,66,66,0,1,0,1,0
15106,3216,0,0,62,62,0,1,0,1,0
17400,2587,0,0,66,66,0,1,0,1,0
22267,28,0,0,70,70,0,1,0,1,0
12895,2573,0,0,66,66,0,1,0,1,0
1256,1888,0,0,62,62,0,1,0,1,0
6209,26,8629,16,5309,3110,2199,36,81,18,18
14017,10,1053,9,358,102,256,2,30,1,1
2744,1238,13910,918,912,126,786,2,31,1,1
10838,2365,2249,1839,70,70,0,2,8,2,0
8372,28,0,0,70,70,0,1,0,1,0
21367,654,12660,456,66,66,0,1,5,1,0
8483,28,0,0,70,70,0,1,0,1,0
8794,26,6377,16,5600,1187,4413,24,80,13,11
6862,1215,0,0,62,62,0,1,0,1,0
0,0,0,0,600,306,294,6,0,3,3
3394,26,1999,16,37452,28136,9316,56,15,33,23
20311,28,0,0,66,66,0,1,0,1,0
8482,10,6583,9,94,94,0,1,30,1,0
15251,10,21793,9,178,94,84,2,30,1,1
8565,15,7616,11,4382,2084,2298,18,66,10,8
21002,10,28318,9,198,90,108,2,30,1,1
19628,28,0,0,70,70,0,1,0,1,0
19347,28,0,0,70,70,0,1,0,1,0
349,10,1042,9,220,100,120,2,31,1,1
9292,26,13750,16,23193,8487,14706,57,55,28,29
18537,26,20024,16,5888,1175,4713,19,43,11,8
15553,10,19011,9,701,88,613,2,30,1,1
6919,2587,0,0,62,62,0,1,0,1,0
4474,26,3484,16,9273,2731,6542,31,403,10,21
14027,26,24394,16,164571,13257,151314,206,19,95,111
16021,1119,19204,824,870,330,540,12,1501,6,6
11732,28,0,0,70,70,0,1,0,1,0
13509,2883,0,0,66,66,0,1,0,1,0
1129,15,3757,11,6893,704,6189,14,15,6,8
9850,26,19730,16,13948,10445,3503,25,121,14,11
22383,10,13684,9,198,101,97,2,31,1,1
18272,26,13109,16,677029,102078,574951,1152,455,559,593
13880,10,9215,9,177,94,83,2,30,1,1
17262,1472,0,0,66,66,0,1,0,1,0
4215,15,22502,11,41269,2915,38354,62,33,32,30
8848,10,15306,9,341,110,231,2,29,1,1
12018,26,8527,16,14603,4208,10395,39,48,20,19
10479,26,22466,16,4742,1835,2907,19,30,11,8
13891,26,18633,16,7725129,126824,7598305,6259,607,740,5519
3203,10,13618,9,244,98,146,2,33,1,1
16799,233,13239,148,13841,6601,7240,42,622,19,23
14860,10,22392,9,197,102,95,2,33,1,1
16021,2476,19451,1926,166,166,0,1,1200,1,0
18779,28,0,0,70,70,0,1,0,1,0
17042,26,15213,16,5166,700,4466,16,15,7,9
15608,10,4489,9,1414,95,1319,4,41,2,2
4370,3216,0,0,62,62,0,1,0,1,0
16892,10,25802,9,268,86,182,2,30,1,1
17991,812,0,0,66,66,0,1,0,1,0
12337,3139,0,0,66,66,0,1,0,1,0
19728,28,0,0,66,66,0,1,0,1,0
18331,26,22407,16,3285,2009,1276,26,150,16,10
21895,10,10069,9,211,102,109,2,30,1,1
16777,15,12388,11,1088,599,489,13,315,7,6
22486,1147,0,0,66,66,0,1,0,1,0
16773,28,0,0,70,70,0,1,0,1,0
17786,233,24460,148,70,70,0,1,5,1,0
636,2972,12231,2307,228,118,110,2,1200,1,1
21137,28,0,0,66,66,0,1,0,1,0
16570,15,25747,11,348,132,216,6,15,3,3
15888,10,16670,9,166,86,80,2,30,1,1
21362,2573,0,0,145,145,0,1,0,1,0
21240,10,17951,9,172,88,84,2,31,1,1
10991,15,13652,11,26804,11349,15455,45,26,25,20
13063,28,0,0,66,66,0,1,0,1,0
20305,28,0,0,70,70,0,1,0,1,0
13560,427,0,0,66,66,0,1,0,1,0
13764,10,9465,9,177,94,83,2,30,1,1
19412,26,12575,16,138544,7073,131471,165,144,59,106
18504,3226,13408,2502,70,70,0,2,8,2,0
10673,26,24986,16,8176,2082,6094,26,360,12,14
18430,26,19506,16,4847,963,3884,22,63,11,11
14537,15,24667,11,450,246,204,8,29,5,3
22661,28,0,0,70,70,0,1,0,1,0
10346,2926,0,0,100,100,0,1,0,1,0
18033,10,25298,9,320,94,226,2,29,1,1
16578,2953,0,0,66,66,0,1,0,1,0
14107,10,26899,9,310,94,216,2,30,1,1
14390,26,23022,16,48162,46496,1666,59,136,39,20
0,0,0,0,98,98,0,1,0,1,0
8721,10,26688,9,578,286,292,9,15,5,4
6074,26,5369,16,2306249,52358,2253891,2041,239,447,1594
8856,2573,0,0,66,66,0,1,0,1,0
9321,28,0,0,66,66,0,1,0,1,0
15211,15,13067,11,234,234,0,4,12,4,0
19997,10,0,0,633,75,558,2,29,1,1
8385,10,27662,9,190,97,93,2,31,1,1
13848,28,0,0,70,70,0,1,0,1,0
22496,10,7534,9,195,102,93,2,31,1,1
19953,2587,0,0,66,66,0,1,0,1,0
11562,28,0,0,70,70,0,1,0,1,0
15454,10,9819,9,202,103,99,2,31,1,1
15364,26,3294,16,7877,1888,5989,20,15,11,9
295,1771,0,0,66,66,0,1,0,1,0
9728,2765,1650,2144,1377,300,1077,6,1200,3,3
1675,3216,0,0,66,66,0,1,0,1,0
8,629,0,0,66,66,0,1,0,1,0
20888,697,0,0,66,66,0,1,0,1,0
21109,28,0,0,70,70,0,1,0,1,0
17708,28,0,0,70,70,0,1,0,1,0
19590,26,18924,16,4326,2217,2109,14,120,7,7
14835,10,14427,9,209,110,99,2,30,1,1
21080,1361,10051,1033,4536,2883,1653,27,94,15,12
20309,28,0,0,70,70,0,1,0,1,0
4912,26,19484,16,82608,3591,79017,101,15,39,62
15661,10,7595,9,196,102,94,2,31,1,1
6651,1129,0,0,156,156,0,1,0,1,0
16951,255,0,0,62,62,0,1,0,1,0
11214,1017,0,0,66,66,0,1,0,1,0
7172,26,21062,16,88469,3492,84977,104,396,35,69
2587,10,22816,9,226,78,148,2,29,1,1
14476,10,24760,9,199,102,97,2,31,1,1
15839,28,0,0,70,70,0,1,0,1,0
11266,1147,0,0,66,66,0,1,0,1,0
13652,10,9917,9,198,102,96,2,29,1,1
2071,1888,0,0,62,62,0,1,0,1,0
2744,1625,3253,1247,900,126,774,2,31,1,1
10852,28,0,0,70,70,0,1,0,1,0
6177,1804,0,0,62,62,0,1,0,1,0
1363,2883,0,0,66,66,0,1,0,1,0
15552,10,15670,9,176,90,86,2,31,1,1
2897,1888,0,0,145,145,0,1,0,1,0
15255,349,15410,222,78,78,0,1,5,1,0
21231,2828,2205,2195,1277,856,421,9,15,6,3
15228,26,16551,16,8059,2039,6020,20,15,11,9
12817,1205,17090,892,70,70,0,2,7,2,0
16475,28,0,0,66,66,0,1,0,1,0
9521,10,17783,9,214,110,104,2,30,1,1
7525,26,13443,16,332590,15084,317506,341,139,89,252
8597,10,18628,9,194,102,92,2,30,1,1
19633,26,27446,16,56634,10853,45781,76,175,34,42
20663,28,0,0,70,70,0,1,0,1,0
15104,10,18055,9,168,94,74,2,30,1,1
968,26,18305,16,6135,770,5365,17,26,9,8
542,2256,0,0,66,66,0,1,0,1,0
8990,10,7713,9,168,86,82,2,29,1,1
3442,26,28686,16,4152,2734,1418,24,40,14,10
21651,28,0,0,66,66,0,1,0,1,0
346,1771,0,0,66,66,0,1,0,1,0
13297,295,23967,190,4487,2090,2397,15,15,8,7
9816,28,0,0,70,70,0,1,0,1,0
6633,15,18989,11,1449,364,1085,13,15,6,7
11312,41,22887,24,146,82,64,2,5,1,1
3908,1202,0,0,159,159,0,1,0,1,0
10644,10,20124,9,322,102,220,2,29,1,1
22113,10,15800,9,314,102,212,2,29,1,1
1778,2938,0,0,145,145,0,1,0,1,0
687,3041,0,0,66,66,0,1,0,1,0
19951,28,0,0,66,66,0,1,0,1,0
10959,15,11188,11,1213,821,392,8,15,6,2
15826,10,18972,9,183,94,89,2,30,1,1
10344,28,0,0,70,70,0,1,0,1,0
2718,1888,0,0,62,62,0,1,0,1,0
8599,28,0,0,70,70,0,1,0,1,0
11131,28,0,0,70,70,0,1,0,1,0
20359,28,0,0,70,70,0,1,0,1,0
11890,28,0,0,66,66,0,1,0,1,0
11742,26,2029,16,2658,1126,1532,25,120,12,13
12,3146,0,0,332,332,0,1,0,1,0
18528,28,0,0,70,70,0,1,0,1,0
12919,15,8996,11,78,78,0,1,5,1,0
2679,1147,0,0,62,62,0,1,0,1,0
8569,10,11943,9,228,102,126,2,29,1,1
21796,26,2578,16,8573,2039,6534,25,31,14,11
1204,15,24642,11,130,70,60,2,15,1,1
11840,15,11537,11,78,78,0,1,4,1,0
6369,2608,0,0,62,62,0,1,0,1,0
15583,28,0,0,70,70,0,1,0,1,0
15678,1771,0,0,146,146,0,1,0,1,0
11766,28,0,0,70,70,0,1,0,1,0
8828,26,24661,16,9534,4029,5505,22,59,12,10
15316,10,3704,9,814,110,704,2,30,1,1
22421,10,20510,9,199,102,97,2,30,1,1
450,126,0,0,136,136,0,1,0,1,0
12516,193,12411,127,70,70,0,2,7,2,0
5527,1017,0,0,146,146,0,1,0,1,0
18576,1936,0,0,66,66,0,1,0,1,0
8334,26,10881,16,8271,1357,6914,26,17,12,14
8584,1240,20100,920,252,71,181,2,30,1,1
11197,3126,5084,2427,70,70,0,2,8,2,0
13275,28,0,0,66,66,0,1,0,1,0
19354,28,0,0,66,66,0,1,0,1,0
8584,1240,24371,920,275,71,204,2,31,1,1
13996,10,16768,9,183,94,89,2,29,1,1
16951,255,0,0,62,62,0,1,0,1,0
10224,28,0,0,66,66,0,1,0,1,0
4242,26,14627,16,9808,3005,6803,36,255,19,17
15020,15,23887,11,17008,1379,15629,22,25,7,15
21975,10,5752,9,276,102,174,2,30,1,1
11225,2600,23820,2019,70,70,0,1,5,1,0
20750,28,0,0,70,70,0,1,0,1,0
3980,26,9424,16,4113,2625,1488,25,79,13,12
12914,28,0,0,70,70,0,1,0,1,0
22413,28,0,0,70,70,0,1,0,1,0
16951,255,0,0,62,62,0,1,0,1,0
4881,26,9035,16,234,234,0,4,12,4,0
17528,28,0,0,70,70,0,1,0,1,0
16669,28,0,0,70,70,0,1,0,1,0
8772,10,11056,9,231,110,121,2,31,1,1
18896,26,25049,16,22772,8095,14677,46,54,24,22
19567,155,0,0,62,62,0,1,0,1,0
20102,10,27753,9,194,87,107,2,30,1,1
16951,255,0,0,62,62,0,1,0,1,0
14968,1147,0,0,66,66,0,1,0,1,0
9701,10,13870,9,758,93,665,2,31,1,1
11039,26,8778,16,10339,2028,8311,28,46,16,12
8963,28,0,0,66,66,0,1,0,1,0
11912,15,23228,11,210304,4398,205906,225,21,65,160
15927,291,18479,187,70,70,0,1,5,1,0
561,509,0,0,66,66,0,1,0,1,0
13324,28,0,0,70,70,0,1,0,1,0
13719,26,9900,16,13236,4421,8815,28,61,16,12
11412,26,8536,16,9428,3770,5658,54,24,28,26
8244,15,18868,11,1868,1374,494,12,15,7,5
8479,10,14692,9,767,102,665,2,31,1,1
17559,1888,0,0,66,66,0,1,0,1,0
9963,15,19995,11,36051,11695,24356,109,265,55,54
8401,28,0,0,70,70,0,1,0,1,0
10940,15,13198,11,4994,3658,1336,11,26,6,5
9488,15,22558,11,3132,730,2402,13,42,7,6
2892,1804,0,0,62,62,0,1,0,1,0
8370,28,0,0,66,66,0,1,0,1,0
14828,15,24822,11,101707,1824,99883,96,15,26,70
8722,10,26283,9,300,100,200,4,44,2,2
11059,2668,28658,2075,70,70,0,1,5,1,0
8438,10,23890,9,186,102,84,2,30,1,1
8705,10,10737,9,177,94,83,2,30,1,1
13186,28,0,0,70,70,0,1,0,1,0
15231,26,3187,16,7743,3072,4671,18,125,10,8
21733,10,15201,9,232,110,122,2,29,1,1
21743,427,0,0,62,62,0,1,0,1,0
14536,10,14997,9,184,94,90,2,30,1,1
15090,10,3332,9,166,86,80,2,29,1,1
0,0,0,0,70,70,0,1,0,1,0
19992,26,27692,16,1210,637,573,14,51,7,7
7335,1070,0,0,60,60,0,1,0,1,0
21923,1888,0,0,66,66,0,1,0,1,0
8963,1147,0,0,66,66,0,1,0,1,0
21278,10,22009,9,193,102,91,2,29,1,1
21442,28,0,0,66,66,0,1,0,1,0
636,280,0,0,146,146,0,1,0,1,0
18698,26,26922,16,5715,1432,4283,19,15,9,10
10019,15,12729,11,256649,11414,245235,280,141,111,169
10332,15,3388,11,1594,1280,314,10,15,5,5
12558,26,14423,16,318,192,126,6,16,4,2
14683,28,0,0,70,70,0,1,0,1,0
20548,28,0,0,70,70,0,1,0,1,0
21345,10,13677,9,243,94,149,2,31,1,1
10889,1767,20829,1349,70,70,0,2,7,2,0
20439,28,0,0,70,70,0,1,0,1,0
22013,26,23839,16,8580,5765,2815,46,82,22,24
2411,10,9964,9,224,88,136,2,30,1,1
13128,28,0,0,66,66,0,1,0,1,0
9432,28,0,0,66,66,0,1,0,1,0
11125,2876,0,0,66,66,0,1,0,1,0
19197,28,0,0,70,70,0,1,0,1,0
10046,2636,0,0,66,66,0,1,0,1,0
11484,28,0,0,70,70,0,1,0,1,0
6348,1,0,0,62,62,0,1,0,1,0
20395,40,7054,23,9588,4811,4777,85,193,49,36
12606,2636,0,0,66,66,0,1,0,1,0
15521,28,0,0,66,66,0,1,0,1,0
1330,918,0,0,62,62,0,1,0,1,0
3732,26,7423,16,80160,3527,76633,98,76,38,60
11484,26,3915,16,9500,4662,4838,20,16,11,9
9859,2587,0,0,74,74,0,1,0,1,0
9416,26,19566,16,9998,2237,7761,38,121,21,17
13348,28,0,0,70,70,0,1,0,1,0
9330,10,18753,9,172,88,84,2,31,1,1
15883,10,3618,9,180,94,86,2,35,1,1
9001,28,0,0,70,70,0,1,0,1,0
14399,10,3746,9,782,105,677,2,30,1,1
20600,28,0,0,70,70,0,1,0,1,0
7447,26,10977,16,446664,48034,398630,698,223,326,372
21325,47,16549,30,66,66,0,2,7,2,0
15302,10,24387,9,250,86,164,4,52,2,2
5161,26,574,16,7431,3525,3906,18,15,10,8
9477,15,8254,11,2862,1465,1397,11,47,6,5
8415,10,3467,9,211,102,109,2,30,1,1
19701,28,0,0,70,70,0,1,0,1,0
14228,26,6938,16,11891,2141,9750,40,231,19,21
720,2205,0,0,62,62,0,1,0,1,0
1513,1771,0,0,66,66,0,1,0,1,0
8342,26,885,16,4429,2593,1836,34,1126,18,16
16028,28,0,0,66,66,0,1,0,1,0
3577,2495,0,0,145,145,0,1,0,1,0
4201,10,9851,9,86,86,0,1,30,1,0
16175,10,6468,9,265,78,187,2,30,1,1
9748,15,17038,11,1658,1247,411,8,15,5,3
5404,15,1685,11,2749,1732,1017,21,361,12,9
16021,2517,16590,1956,132,132,0,3,1199,3,0
13135,26,16436,16,12594,5098,7496,32,34,17,15
10454,10,22453,9,398,255,143,3,31,2,1
17871,26,18925,16,303,85,218,2,30,1,1
8336,26,27913,16,11168,3827,7341,42,16,20,22
5360,26,1681,16,7531,2720,4811,24,331,13,11
14750,2587,0,0,62,62,0,1,0,1,0
22192,1279,22012,959,1680,1386,294,7,30,4,3
16482,28,0,0,66,66,0,1,0,1,0
9758,26,14136,16,3499,1732,1767,15,16,9,6
10046,2636,0,0,66,66,0,1,0,1,0
4276,26,16537,16,55608,48375,7233,140,95,81,59
17536,28,0,0,70,70,0,1,0,1,0
17230,26,23669,16,70,70,0,1,5,1,0
11575,2256,0,0,66,66,0,1,0,1,0
8586,15,5714,11,1985,657,1328,11,21,6,5
10044,15,25985,11,9578491,119422,9459069,8079,137,1689,6390
21741,10,15582,9,184,86,98,2,30,1,1
13899,28,0,0,70,70,0,1,0,1,0
195,7,0,0,60,60,0,1,0,1,0
2505,3000,0,0,62,62,0,1,0,1,0
3330,23,0,0,15505,6180,9325,50,30,25,25
17780,28,0,0,70,70,0,1,0,1,0
1413,1888,0,0,62,62,0,1,0,1,0
15436,1654,3101,1271,70,70,0,1,5,1,0
9516,28,0,0,70,70,0,1,0,1,0
13616,10,13864,9,188,96,92,2,30,1,1
9359,115,21406,88,70,70,0,2,8,2,0
1568,26,12120,16,8844,949,7895,19,75,9,10
9997,28,0,0,70,70,0,1,0,1,0
22096,10,746,9,184,94,90,2,30,1,1
12398,26,13171,16,3708,1988,1720,20,255,10,10
22322,10,28108,9,200,94,106,2,30,1,1
8879,10,14597,9,198,94,104,2,30,1,1
15231,10,931,9,255,88,167,4,53,2,2
7820,2587,0,0,62,62,0,1,0,1,0
9929,28,0,0,70,70,0,1,0,1,0
643,2486,0,0,139,139,0,1,0,1,0
15739,10,7298,9,179,94,85,2,31,1,1
13930,10,9291,9,194,102,92,2,31,1,1
8818,28,0,0,66,66,0,1,0,1,0
8776,10,16694,9,754,94,660,2,30,1,1
13416,28,0,0,66,66,0,1,0,1,0
18,280,0,0,146,146,0,1,0,1,0
5861,15,17759,11,2118,1493,625,9,82,6,3
7904,26,23699,16,8035,2176,5859,25,331,12,13
22159,10,27452,9,275,96,179,4,41,2,2
11854,28,0,0,70,70,0,1,0,1,0
14437,26,1167,16,8602,1050,7552,16,120,7,9
8327,197,15154,130,854,150,704,4,1200,2,2
3774,26,12572,16,19518,11774,7744,46,168,26,20
20088,983,0,0,62,62,0,1,0,1,0
8373,10,27197,9,174,89,85,2,31,1,1
20292,28,0,0,70,70,0,1,0,1,0
13613,10,7049,9,206,105,101,2,31,1,1
11895,10,23223,9,235,90,145,2,32,1,1
10748,28,0,0,70,70,0,1,0,1,0
10902,2452,1850,1905,70,70,0,2,8,2,0
20223,1147,0,0,62,62,0,1,0,1,0
20204,28,0,0,70,70,0,1,0,1,0
21869,28,0,0,70,70,0,1,0,1,0
16705,26,15815,16,934,506,428,14,29,8,6
19350,26,17592,16,3505,2042,1463,27,82,15,12
22433,10,24304,9,248,110,138,2,29,1,1
9491,28,0,0,70,70,0,1,0,1,0
19369,2938,0,0,62,62,0,1,0,1,0
8536,26,12319,16,7165,1099,6066,16,15,9,7
14460,10,12195,9,177,94,83,2,30,1,1
8086,183,20998,121,4085,1916,2169,21,19,12,9
9205,26,13807,16,6551,2085,4466,25,85,14,11
17751,26,18637,16,4507,1525,2982,24,147,13,11
12268,2587,0,0,66,66,0,1,0,1,0
22640,28,0,0,66,66,0,1,0,1,0
16538,28,0,0,70,70,0,1,0,1,0
12007,1864,10676,1422,70,70,0,2,8,2,0
19142,1792,0,0,66,66,0,1,0,1,0
22539,10,28887,9,183,94,89,2,30,1,1
11433,26,13133,16,384,384,0,7,33,7,0
17321,28,0,0,70,70,0,1,0,1,0
15659,28,0,0,66,66,0,1,0,1,0
12732,28,0,0,70,70,0,1,0,1,0
22548,10,27270,9,741,94,647,2,30,1,1
798,183,3283,121,3910,1805,2105,20,18,12,8
15335,10,14651,9,216,102,114,2,30,1,1
10906,1779,12052,1357,70,70,0,2,8,2,0
14133,10,14007,9,177,94,83,2,31,1,1
10328,1771,0,0,66,66,0,1,0,1,0
3161,7,13314,7,60,60,0,1,5,1,0
21897,10,16479,9,186,95,91,2,31,1,1
20754,10,0,0,75,75,0,1,0,1,0
12955,28,0,0,66,66,0,1,0,1,0
10872,1334,19814,1009,66,66,0,1,5,1,0
22176,10,26398,9,197,102,95,2,31,1,1
21476,10,165,9,337,106,231,4,43,2,2
22682,28,0,0,70,70,0,1,0,1,0
14098,26,16870,16,2341,540,1801,9,121,5,4
16951,255,0,0,62,62,0,1,0,1,0
11876,28,0,0,70,70,0,1,0,1,0
14032,28,0,0,70,70,0,1,0,1,0
18638,28,0,0,70,70,0,1,0,1,0
14861,28,0,0,66,66,0,1,0,1,0
17735,2938,0,0,66,66,0,1,0,1,0
15305,10,12108,9,177,94,83,2,30,1,1
8827,26,27673,16,6950,2484,4466,20,53,11,9
14941,10,28858,9,711,87,624,2,30,1,1
5435,26,8309,16,60,60,0,2,5,2,0
11626,26,13040,16,5406,922,4484,19,360,10,9
9065,10,23717,9,776,102,674,2,30,1,1
13282,28,0,0,70,70,0,1,0,1,0
13731,28,0,0,70,70,0,1,0,1,0
19396,28,0,0,70,70,0,1,0,1,0
4878,26,5861,16,284,164,120,4,15,2,2
12588,28,0,0,70,70,0,1,0,1,0
21253,28,0,0,70,70,0,1,0,1,0
9109,10,1070,9,281,97,184,4,57,2,2
12751,43,19657,26,130,70,60,3,6,2,1
9632,1017,0,0,66,66,0,1,0,1,0
14816,10,11948,9,179,94,85,2,30,1,1
14918,10,14970,9,178,94,84,2,29,1,1
13987,10,17293,9,701,88,613,2,31,1,1
14720,10,24977,9,311,118,193,2,30,1,1
16525,509,0,0,66,66,0,1,0,1,0
16951,255,0,0,62,62,0,1,0,1,0
15899,15,17528,11,1056,682,374,10,15,6,4
22703,10,2357,9,212,108,104,2,31,1,1
11917,15,3629,11,4419,271,4148,13,28,3,10
12471,28,0,0,66,66,0,1,0,1,0
5414,26,26605,16,4477,2605,1872,22,248,12,10
14277,28,0,0,70,70,0,1,0,1,0
16097,28,0,0,70,70,0,1,0,1,0
10179,28,0,0,66,66,0,1,0,1,0
12972,10,14928,9,199,94,105,2,29,1,1
6250,1986,4079,1516,273,73,200,4,29,2,2
8881,10,806,9,734,94,640,2,30,1,1
2829,1936,0,0,62,62,0,1,0,1,0
9077,26,28925,16,976,589,387,10,76,6,4
7949,314,0,0,60,60,0,1,0,1,0
13941,28,0,0,66,66,0,1,0,1,0
11077,2151,3803,1660,164,70,94,3,7,2,1
18008,26,26559,16,5980,1122,4858,18,58,9,9
10772,1482,0,0,66,66,0,1,0,1,0
320,1804,0,0,62,62,0,1,0,1,0
11780,15,22469,11,3150,1478,1672,32,131,17,15
21116,28,0,0,70,70,0,1,0,1,0
21770,10,19091,9,352,107,245,4,37,2,2
16493,15,12889,11,5029,2608,2421,15,25,9,6
14688,10,27808,9,195,94,101,2,30,1,1
21311,10,9114,9,188,96,92,2,31,1,1
10616,26,20195,16,400,70,330,6,25,1,5
19766,1771,0,0,66,66,0,1,0,1,0
2911,26,10854,16,7876,1540,6336,21,124,10,11
20296,28,0,0,70,70,0,1,0,1,0
11054,1147,0,0,66,66,0,1,0,1,0
8999,26,22301,16,8754,2616,6138,34,96,19,15
21144,477,6052,311,66,66,0,2,8,2,0
3678,10,14647,9,217,87,130,2,31,1,1
16951,255,0,0,62,62,0,1,0,1,0
13927,28,0,0,70,70,0,1,0,1,0
6118,10,18878,9,168,78,90,2,30,1,1
293,1771,0,0,62,62,0,1,0,1,0
10843,28,0,0,70,70,0,1,0,1,0
4154,2256,0,0,78,78,0,1,0,1,0
15019,2883,0,0,62,62,0,1,0,1,0
19060,28,0,0,70,70,0,1,0,1,0
15964,10,5606,9,195,102,93,2,33,1,1
22619,10,13406,9,195,102,93,2,31,1,1
15124,10,7651,9,199,102,97,2,30,1,1
17665,15,10108,11,350,210,140,6,26,4,2
8526,10,25554,9,102,102,0,1,60,1,0
15347,10,20162,9,185,102,83,2,31,1,1
21718,10,6286,9,196,102,94,2,30,1,1
21205,10,17539,9,214,102,112,2,30,1,1
14189,10,2912,9,166,86,80,2,30,1,1
8786,10,13628,9,198,110,88,2,30,1,1
13491,28,0,0,66,66,0,1,0,1,0
8794,1771,0,0,66,66,0,1,0,1,0
14494,10,26162,9,184,94,90,2,30,1,1
9169,10,6362,9,199,102,97,2,30,1,1
11461,2611,0,0,74,74,0,1,0,1,0
9520,10,17587,9,196,102,94,2,30,1,1
8642,10,741,9,200,94,106,2,30,1,1
3477,2256,0,0,62,62,0,1,0,1,0
14943,10,6920,9,195,102,93,2,30,1,1
17736,1147,0,0,62,62,0,1,0,1,0
21931,28,0,0,66,66,0,1,0,1,0
13546,28,0,0,70,70,0,1,0,1,0
4210,26,15473,16,79562,17054,62508,111,109,54,57
19688,1017,0,0,66,66,0,1,0,1,0
22577,28,0,0,70,70,0,1,0,1,0
14284,1523,16776,1161,70,70,0,1,5,1,0
16400,28,0,0,66,66,0,1,0,1,0
1769,1763,0,0,66,66,0,1,0,1,0
15309,26,25053,16,373876,52153,321723,424,87,185,239
2896,26,28414,16,7808,2487,5321,34,446,16,18
15560,10,28849,9,196,102,94,2,30,1,1
56,1328,7369,1003,132,70,62,2,30,1,1
4640,739,14596,530,130,70,60,2,30,1,1
16745,26,5136,16,7297,2046,5251,22,29,13,9
15165,10,18858,9,166,86,80,2,31,1,1
496,321,0,0,66,66,0,1,0,1,0
360,3105,0,0,328,328,0,1,0,1,0
6454,2256,0,0,146,146,0,1,0,1,0
8746,10,18786,9,782,110,672,2,30,1,1
20922,28,0,0,66,66,0,1,0,1,0
14553,10,12909,9,448,184,264,6,29,3,3
19174,1017,0,0,66,66,0,1,0,1,0
15989,983,0,0,66,66,0,1,0,1,0
21973,10,1211,9,168,94,74,2,29,1,1
15949,2495,0,0,146,146,0,1,0,1,0
21178,2197,2658,1701,70,70,0,1,4,1,0
6761,5,0,0,60,60,0,1,0,1,0
8837,26,2701,16,1485,940,545,13,57,7,6
14002,10,10946,9,168,86,82,2,31,1,1
8520,10,3956,9,237,94,143,2,30,1,1
17716,1472,0,0,66,66,0,1,0,1,0
10753,474,12148,308,70,70,0,1,5,1,0
9976,2938,0,0,66,66,0,1,0,1,0
4331,171,15681,117,138,78,60,2,6,1,1
14641,28,0,0,70,70,0,1,0,1,0
9700,15,16541,11,378,192,186,7,26,4,3
0,0,0,0,156,156,0,2,0,2,0
14099,10,8251,9,214,110,104,2,29,1,1
19799,28,0,0,66,66,0,1,0,1,0
17941,28,0,0,70,70,0,1,0,1,0
22477,10,15761,9,213,102,111,2,30,1,1
5770,26,22608,16,21024,14637,6387,46,271,26,20
11991,26,16147,16,8071,1789,6282,20,326,10,10
15694,1787,0,0,145,145,0,1,0,1,0
8364,28,0,0,70,70,0,1,0,1,0
16148,15,25479,11,266789,7684,259105,234,25,54,180
20286,3216,0,0,66,66,0,1,0,1,0
9549,10,8505,9,200,102,98,2,29,1,1
14909,2883,0,0,66,66,0,1,0,1,0
9727,10,19711,9,196,102,94,2,30,1,1
22169,10,17918,9,506,131,375,4,41,2,2
12184,1215,0,0,62,62,0,1,0,1,0
14499,10,24363,9,212,94,118,2,30,1,1
21513,10,28054,9,350,94,256,2,29,1,1
5177,26,20378,16,25120,1874,23246,39,171,17,22
17590,26,22760,16,5993,1987,4006,17,26,9,8
3074,1036,0,0,169,169,0,1,0,1,0
0,0,0,0,98,98,0,1,0,1,0
18600,15,26862,11,318,120,198,6,26,3,3
8534,2636,0,0,62,62,0,1,0,1,0
9730,26,2327,16,2756,1594,1162,20,27,11,9
17196,26,9191,16,5168,700,4468,16,15,7,9
14437,28,0,0,70,70,0,1,0,1,0
18140,28,0,0,66,66,0,1,0,1,0
17107,28,0,0,66,66,0,1,0,1,0
18582,28,0,0,66,66,0,1,0,1,0
13359,2256,0,0,74,74,0,1,0,1,0
2486,10,10422,9,215,80,135,2,33,1,1
2744,1240,28918,920,880,126,754,2,30,1,1
2175,1888,0,0,62,62,0,1,0,1,0
14302,28,0,0,66,66,0,1,0,1,0
10040,28,0,0,70,70,0,1,0,1,0
4461,6,15863,6,293,126,167,4,0,2,2
547,1017,0,0,66,66,0,1,0,1,0
14425,10,11827,9,174,89,85,3,36,2,1
18680,28,0,0,66,66,0,1,0,1,0
17507,28,0,0,70,70,0,1,0,1,0
4777,26,16257,16,4294,695,3599,15,20,8,7
17362,28,0,0,70,70,0,1,0,1,0
20986,2938,0,0,145,145,0,1,0,1,0
22511,28,0,0,70,70,0,1,0,1,0
22511,10,6648,9,395,102,293,2,30,1,1
7436,26,4535,16,9938,1398,8540,9,128,1,8
10698,26,28687,16,8783,4321,4462,39,94,19,20
14425,10,27559,9,179,94,85,2,30,1,1
20965,2953,0,0,66,66,0,1,0,1,0
15186,10,7396,9,177,94,83,2,29,1,1
14497,10,24638,9,197,90,107,2,30,1,1
19393,26,6375,16,16708,2331,14377,31,21,14,17
14561,10,747,9,780,104,676,2,31,1,1
1909,569,23240,383,491,150,341,2,1200,1,1
20617,28,0,0,70,70,0,1,0,1,0
16951,255,0,0,62,62,0,1,0,1,0
17106,26,27706,16,10442,6793,3649,30,17,16,14
13114,28,0,0,66,66,0,1,0,1,0
15128,10,14551,9,195,102,93,2,30,1,1
21328,10,28471,9,198,90,108,2,30,1,1
3719,26,28689,16,3603,562,3041,10,15,6,4
14129,10,1681,9,255,102,153,2,30,1,1
10910,2658,17197,2065,582,270,312,8,32,4,4
19091,28,0,0,66,66,0,1,0,1,0
10794,1656,8201,1273,70,70,0,2,8,2,0
743,1147,0,0,66,66,0,1,0,1,0
15594,28,0,0,70,70,0,1,0,1,0
12118,26,23330,16,1402,856,546,12,34,6,6
16951,255,0,0,62,62,0,1,0,1,0
14850,10,20791,9,184,94,90,2,31,1,1
7201,26,16271,16,74123,16210,57913,106,57,52,54
14349,10,1684,9,212,94,118,2,30,1,1
16560,1147,0,0,62,62,0,1,0,1,0
12061,2872,9850,2231,70,70,0,1,5,1,0
14873,10,14845,9,183,94,89,2,30,1,1
4372,26,10736,16,25051,3368,21683,50,313,26,24
15906,28,0,0,66,66,0,1,0,1,0
18764,1989,12886,1519,316,136,180,6,6,3,3
20347,28,0,0,66,66,0,1,0,1,0
19709,1147,0,0,66,66,0,1,0,1,0
21769,10,7763,9,177,94,83,2,29,1,1
431,2587,0,0,66,66,0,1,0,1,0
21730,10,27821,9,402,118,284,2,30,1,1
10882,15,15725,11,182,60,122,4,29,2,2
10403,509,0,0,66,66,0,1,0,1,0
1046,308,0,0,66,66,0,1,0,1,0
10437,28,0,0,66,66,0,1,0,1,0
6850,1147,0,0,146,146,0,1,0,1,0
13395,28,0,0,70,70,0,1,0,1,0
21309,553,20272,369,630,508,122,9,15,7,2
21687,10,15386,9,183,94,89,2,29,1,1
665,10,19885,9,197,94,103,2,30,1,1
15954,10,20806,9,232,110,122,2,30,1,1
22649,10,13074,9,197,102,95,2,30,1,1
16951,255,0,0,62,62,0,1,0,1,0
3780,15,6520,11,1056,682,374,10,15,6,4
9856,15,4064,11,708,384,324,12,195,7,5
21507,28,0,0,66,66,0,1,0,1,0
21397,26,11587,16,5121090,119252,5001838,5000,55,1680,3320
11204,26,22825,16,55503,7279,48224,79,22,32,47
3639,2611,0,0,62,62,0,1,0,1,0
1425,861,0,0,139,139,0,1,0,1,0
15429,28,0,0,70,70,0,1,0,1,0
53,1202,0,0,159,159,0,1,0,1,0
11257,3216,0,0,66,66,0,1,0,1,0
11494,15,1397,11,10889,1117,9772,22,16,12,10
21416,28,0,0,70,70,0,1,0,1,0
8742,15,2255,11,174140,4942,169198,166,65,47,119
17342,2587,0,0,66,66,0,1,0,1,0
6233,1646,0,0,60,60,0,1,0,1,0
8874,10,28881,9,178,94,84,2,30,1,1
18418,28,0,0,66,66,0,1,0,1,0
12030,3215,14159,2493,698,320,378,10,17,6,4
12533,1218,25293,901,70,70,0,1,4,1,0
3886,15,14968,11,2889,1482,1407,10,15,6,4
16951,255,0,0,62,62,0,1,0,1,0
14318,10,8881,9,183,94,89,2,29,1,1
4297,26,13429,16,53365,28404,24961,565,753,302,263
7187,15,15827,11,574,500,74,6,15,5,1
12436,1079,3809,792,70,70,0,1,4,1,0
15528,10,18987,9,183,94,89,2,30,1,1
9421,26,10335,16,708,362,346,11,18,6,5
9412,26,18033,16,49981,15486,34495,269,138,136,133
12829,280,13037,177,70,70,0,2,8,2,0
21727,10,24127,9,244,94,150,2,30,1,1
21424,10,12312,9,188,96,92,2,30,1,1
10485,1472,0,0,66,66,0,1,0,1,0
9160,10,27745,9,183,94,89,2,30,1,1
10943,26,20050,16,13337,10008,3329,47,185,23,24
18835,26,4853,16,7839,2697,5142,21,137,10,11
14854,10,5436,9,193,102,91,2,31,1,1
13951,10,27358,9,298,101,197,4,31,2,2
16768,28,0,0,70,70,0,1,0,1,0
22329,10,10413,9,307,110,197,2,29,1,1
1657,1888,0,0,62,62,0,1,0,1,0
13951,2256,0,0,62,62,0,1,0,1,0
986,26,13324,16,5539,1486,4053,21,23,11,10
1598,2205,0,0,62,62,0,1,0,1,0
20280,28,0,0,70,70,0,1,0,1,0
54,1888,0,0,62,62,0,1,0,1,0
11545,1017,0,0,62,62,0,1,0,1,0
3320,26,11641,16,160,69,91,2,120,1,1
2264,1147,0,0,62,62,0,1,0,1,0
3162,2883,0,0,62,62,0,1,0,1,0
8,3109,0,0,66,66,0,1,0,1,0
22596,28,0,0,70,70,0,1,0,1,0
9350,26,26114,16,8641,2459,6182,22,16,12,10
10347,26,24059,16,9847,4746,5101,43,16,24,19
14041,26,21478,16,70,70,0,1,5,1,0
14720,10,25448,9,168,86,82,2,30,1,1
21940,10,1995,9,250,86,164,4,36,2,2
6228,2604,0,0,66,66,0,1,0,1,0
16835,26,10036,16,25370,5607,19763,40,138,18,22
12042,813,10808,593,698,320,378,10,18,6,4
12109,15,10719,11,17976,840,17136,21,16,6,15
21178,2256,0,0,62,62,0,1,0,1,0
6663,125,0,0,145,145,0,1,0,1,0
15941,26,28030,16,546,280,266,9,28,5,4
2591,2611,0,0,72,72,0,1,0,1,0
2528,2636,0,0,66,66,0,1,0,1,0
2015,3216,0,0,62,62,0,1,0,1,0
16951,255,0,0,62,62,0,1,0,1,0
9676,26,11391,16,7416,1777,5639,23,74,12,11
5604,232,13628,147,5958,2420,3538,40,25,20,20
9535,15,2604,11,300,180,120,6,26,4,2
18470,26,21495,16,8328,1611,6717,25,121,14,11
15247,10,11884,9,199,102,97,2,30,1,1
14636,10,25756,9,213,102,111,2,31,1,1
16021,2764,18267,2143,480,149,331,2,1200,1,1
8613,26,18199,16,790501,27378,763123,858,86,322,536
5353,2380,0,0,146,146,0,1,0,1,0
16951,255,0,0,62,62,0,1,0,1,0
12429,28,0,0,66,66,0,1,0,1,0
13952,3216,0,0,62,62,0,1,0,1,0
22154,10,8478,9,215,94,121,2,30,1,1
13733,15,10794,11,2305712,80795,2224917,2771,52,1293,1478
2964,1888,0,0,62,62,0,1,0,1,0
15046,15,23090,11,214,140,74,4,26,3,1
10866,26,15675,16,4927,986,3941,21,31,12,9
17945,10,10627,9,195,94,101,2,30,1,1
9396,10,28261,9,178,94,84,2,31,1,1
17206,28,0,0,70,70,0,1,0,1,0
11092,3063,27145,2378,70,70,0,2,8,2,0
21274,10,23169,9,212,94,118,2,30,1,1
11006,26,22398,16,14912,9611,5301,36,57,21,15
17554,10,0,0,627,72,555,2,30,1,1
2153,2611,0,0,62,62,0,1,0,1,0
8963,10,22646,9,718,94,624,2,30,1,1
7589,10,17113,9,168,78,90,2,30,1,1
20928,28,0,0,66,66,0,1,0,1,0
8991,10,18166,9,279,95,184,4,59,2,2
10509,26,25682,16,9602,3315,6287,25,37,15,10
11015,15,23681,11,14233438,253696,13979742,12752,54,3515,9237
9752,28,0,0,66,66,0,1,0,1,0
12769,26,24455,16,33489,2768,30721,44,121,17,27
2744,1239,7824,919,884,126,758,2,30,1,1
14000,10,9607,9,374,97,277,4,32,2,2
15444,812,0,0,66,66,0,1,0,1,0
14914,26,1221,16,6028,1958,4070,34,124,14,20
17664,28,0,0,66,66,0,1,0,1,0
12071,26,21112,16,6094,1073,5021,19,15,10,9
18549,73,18754,56,70,70,0,2,8,2,0
16957,28,0,0,70,70,0,1,0,1,0
5466,10,6355,9,86,86,0,1,30,1,0
7425,3216,0,0,62,62,0,1,0,1,0
13098,15,2999,11,552,280,272,9,30,5,4
6233,1647,0,0,60,60,0,1,0,1,0
9063,26,2307,16,1820,1101,719,18,72,10,8
13295,2521,0,0,66,66,0,1,0,1,0
22627,10,21543,9,286,90,196,4,55,2,2
16049,28,0,0,66,66,0,1,0,1,0
10276,26,12089,16,5040,2743,2297,34,185,18,16
14168,10,6424,9,168,86,82,2,30,1,1
9965,26,19170,16,820870,30523,790347,918,218,337,581
14534,15,24664,11,450,246,204,8,28,5,3
14776,10,438,9,196,100,96,2,31,1,1
15015,28,0,0,66,66,0,1,0,1,0
14327,974,22944,720,70,70,0,1,5,1,0
532,247,0,0,3354,1792,1562,46,195,23,23
18794,28,0,0,66,66,0,1,0,1,0
4909,26,27964,16,2568507,98538,2469969,2956,65,1228,1728
11459,26,14156,16,7915,1213,6702,23,50,12,11
2744,1568,6195,1199,881,126,755,2,31,1,1
18783,28,0,0,70,70,0,1,0,1,0
12122,2611,0,0,66,66,0,1,0,1,0
15998,11,21686,10,70,70,0,2,8,2,0
13878,26,4710,16,9619,2504,7115,28,46,15,13
8171,1073,0,0,60,60,0,1,0,1,0
18,1861,0,0,62,62,0,1,0,1,0
15537,10,25640,9,179,94,85,2,30,1,1
18211,28,0,0,70,70,0,1,0,1,0
13609,308,0,0,62,62,0,1,0,1,0
10324,26,9044,16,126,60,66,3,5,2,1
8413,10,7381,9,177,94,83,2,30,1,1
190,2938,0,0,78,78,0,1,0,1,0
14969,10,12802,9,165,86,79,2,30,1,1
17843,10,27997,9,304,86,218,2,30,1,1
8637,15,14127,11,10175,1359,8816,18,78,7,11
11091,1783,3389,1361,70,70,0,2,8,2,0
22352,28,0,0,66,66,0,1,0,1,0
16274,28,0,0,70,70,0,1,0,1,0
8672,10,11214,9,200,102,98,2,31,1,1
11182,15,4170,11,366,240,126,7,32,5,2
1104,7,0,0,60,60,0,1,0,1,0
321,3216,0,0,62,62,0,1,0,1,0
21982,10,19294,9,311,102,209,2,30,1,1
8325,26,11729,16,14490,4227,10263,35,36,19,16
21047,2398,11834,1865,70,70,0,1,4,1,0
14972,10,28425,9,758,93,665,2,31,1,1
2998,295,12334,190,4124,2423,1701,20,16,11,9
747,7,0,0,60,60,0,1,0,1,0
18244,1215,0,0,66,66,0,1,0,1,0
9796,28,0,0,66,66,0,1,0,1,0
19810,3216,0,0,66,66,0,1,0,1,0
18723,28,0,0,70,70,0,1,0,1,0
5206,10,25878,9,86,86,0,1,30,1,0
4099,2477,0,0,62,62,0,1,0,1,0
14328,10,4991,9,337,110,227,2,30,1,1
12578,1175,17081,867,2031,1019,1012,11,16,6,5
13613,10,6057,9,211,110,101,2,30,1,1
14738,10,14701,9,177,94,83,2,30,1,1
16951,255,0,0,62,62,0,1,0,1,0
11248,28,0,0,70,70,0,1,0,1,0
8999,10,4085,9,199,94,105,2,31,1,1
14439,1827,0,0,66,66,0,1,0,1,0
12965,26,26989,16,230997,10675,220322,291,75,122,169
5721,26,753,16,7049,1412,5637,24,16,14,10
9031,10,12261,9,232,110,122,2,30,1,1
13101,28,0,0,66,66,0,1,0,1,0
22390,10,15421,9,199,102,97,2,29,1,1
4324,15,15669,11,1015966,37923,978043,1167,205,468,699
9074,26,16847,16,4712,908,3804,18,75,9,9
6396,15,2935,11,1115,534,581,12,15,7,5
7555,397,0,0,60,60,0,1,0,1,0
8867,10,27315,9,197,102,95,2,30,1,1
17210,28,0,0,70,70,0,1,0,1,0
12103,26,22834,16,526,156,370,8,14,3,5
3113,1017,0,0,66,66,0,1,0,1,0
8331,1147,0,0,62,62,0,1,0,1,0
6192,26,18235,16,9299,1697,7602,21,146,12,9
17644,1880,0,0,66,66,0,1,0,1,0
21665,10,7735,9,386,102,284,2,30,1,1
14141,10,16326,9,215,102,113,2,30,1,1
14058,10,14081,9,200,102,98,2,29,1,1
16951,255,0,0,62,62,0,1,0,1,0
21211,26,8813,16,2940,669,2271,13,122,6,7
6791,26,319,16,7762,2601,5161,18,137,8,10
7917,2636,0,0,66,66,0,1,0,1,0
12520,26,13903,16,7035,2364,4671,18,75,10,8
7289,15,9935,11,47137,10210,36927,80,477,38,42
2178,10,8784,9,208,94,114,2,30,1,1
9026,28,0,0,66,66,0,1,0,1,0
21904,10,4731,9,334,93,241,4,50,2,2
1332,1147,0,0,66,66,0,1,0,1,0
13800,10,19792,9,184,94,90,2,30,1,1
4845,2504,7601,1947,156,156,0,3,7,3,0
14871,10,2718,9,751,95,656,2,31,1,1
269,308,0,0,66,66,0,1,0,1,0
19072,28,0,0,70,70,0,1,0,1,0
18810,1989,25321,1519,316,136,180,6,6,3,3
22425,26,3570,16,3350,2037,1313,25,95,14,11
18472,15,18084,11,10970,7709,3261,24,29,13,11
15004,28,0,0,70,70,0,1,0,1,0
18588,26,26855,16,1462,863,599,15,37,9,6
16285,10,25566,9,825,99,726,2,30,1,1
21878,10,7950,9,196,94,102,2,30,1,1
6029,676,16707,475,130,70,60,2,5,1,1
12577,28,0,0,66,66,0,1,0,1,0
18278,10,16024,9,328,86,242,2,30,1,1
21469,10,20554,9,178,94,84,2,31,1,1
4256,26,15560,16,4625,1718,2907,19,31,11,8
3662,15,1588,11,1280,586,694,10,14,5,5
13984,28,0,0,66,66,0,1,0,1,0
21066,2611,0,0,62,62,0,1,0,1,0
12901,28,0,0,70,70,0,1,0,1,0
17135,26,4992,16,9823,2600,7223,46,195,23,23
14572,28,0,0,66,66,0,1,0,1,0
2591,2611,0,0,72,72,0,1,0,1,0
11178,1414,6841,1075,70,70,0,1,5,1,0
16021,1636,16657,1257,594,594,0,10,1199,10,0
14352,2296,17585,1780,70,70,0,2,8,2,0
9768,15,20781,11,12701,9788,2913,29,52,16,13
514,1589,0,0,62,62,0,1,0,1,0
21018,28,0,0,70,70,0,1,0,1,0
3188,146,0,0,60,60,0,1,0,1,0
8491,3216,0,0,66,66,0,1,0,1,0
16951,255,0,0,62,62,0,1,0,1,0
15175,28,0,0,70,70,0,1,0,1,0
7633,1147,0,0,62,62,0,1,0,1,0
8713,10,14128,9,193,102,91,2,29,1,1
16951,255,25970,160,62,62,0,1,5,1,0
11092,15,2950,11,366,240,126,7,26,5,2
14375,28,0,0,70,70,0,1,0,1,0
14170,10,2039,9,757,98,659,2,31,1,1
9215,28,0,0,70,70,0,1,0,1,0
9300,28,0,0,70,70,0,1,0,1,0
8750,28,0,0,70,70,0,1,0,1,0
21183,28,0,0,66,66,0,1,0,1,0
13599,28,0,0,70,70,0,1,0,1,0
10243,28,0,0,66,66,0,1,0,1,0
7760,26,18481,16,8166,2498,5668,16,120,8,8
1943,1017,0,0,62,62,0,1,0,1,0
6332,26,14714,16,8049,2043,6006,23,360,11,12
18883,28,0,0,66,66,0,1,0,1,0
12921,28,0,0,70,70,0,1,0,1,0
21763,28,0,0,66,66,0,1,0,1,0
14143,28,0,0,70,70,0,1,0,1,0
12600,2296,8528,1780,70,70,0,1,4,1,0
16021,2273,17795,1760,527,166,361,2,1200,1,1
18096,26,27018,16,1641,730,911,14,18,8,6
21502,28,0,0,70,70,0,1,0,1,0
9393,28,0,0,70,70,0,1,0,1,0
13892,28,0,0,66,66,0,1,0,1,0
9601,26,27875,16,3091,1708,1383,15,21,9,6
10882,28,0,0,70,70,0,1,0,1,0
8467,26,28092,16,6101,848,5253,17,21,9,8
8559,1472,0,0,62,62,0,1,0,1,0
22476,10,11842,9,183,94,89,2,31,1,1
1182,15,3148,11,2058,589,1469,10,46,6,4
12245,26,258,16,8557,1755,6802,28,35,14,14
12091,28,0,0,70,70,0,1,0,1,0
14018,10,27036,9,289,97,192,4,45,2,2
6233,1647,0,0,60,60,0,1,0,1,0
3572,15,20162,11,1376,788,588,10,23,6,4
7476,15,8235,11,4674,767,3907,17,15,9,8
22091,10,15380,9,511,92,419,4,45,2,2
5589,26,20083,16,80789,5008,75781,92,128,33,59
10239,26,3120,16,5553,2844,2709,21,30,11,10
17624,1880,0,0,66,66,0,1,0,1,0
21673,28,0,0,70,70,0,1,0,1,0
291,1147,0,0,66,66,0,1,0,1,0
16951,255,0,0,62,62,0,1,0,1,0
15706,28,0,0,66,66,0,1,0,1,0
2067,1202,0,0,159,159,0,1,0,1,0
2744,1241,20067,921,895,126,769,2,30,1,1
9414,26,14283,16,35251,25181,10070,121,123,63,58
7595,10,20282,9,220,90,130,2,30,1,1
637,2368,17240,1842,324,150,174,2,1200,1,1
8953,10,15075,9,193,102,91,2,30,1,1
1403,2486,0,0,66,66,0,1,0,1,0
17559,10,26325,9,283,114,169,2,31,1,1
5583,26,80,16,7000,1799,5201,20,256,12,8
8264,1147,0,0,62,62,0,1,0,1,0
15992,10,4714,9,728,102,626,2,29,1,1
1872,1771,0,0,62,62,0,1,0,1,0
13845,10,26802,9,223,78,145,2,30,1,1
10722,28,0,0,70,70,0,1,0,1,0
7529,26,2127,16,9316,1720,7596,25,16,13,12
3950,10,15061,9,288,83,205,2,31,1,1
20923,1888,0,0,66,66,0,1,0,1,0
6250,1998,7686,1528,597,79,518,2,31,1,1
16210,28,0,0,70,70,0,1,0,1,0
21166,2597,15165,2016,70,70,0,1,5,1,0
17132,28,0,0,70,70,0,1,0,1,0
9728,15,28999,11,1883,995,888,11,47,6,5
19617,2636,0,0,66,66,0,1,0,1,0
16800,10,0,0,1254,160,1094,4,49,2,2
17899,1215,0,0,62,62,0,1,0,1,0
5109,3,0,0,60,60,0,1,0,1,0
17037,26,27181,16,16417,13221,3196,50,74,31,19
12227,1215,0,0,62,62,0,1,0,1,0
15363,10,13090,9,199,102,97,2,30,1,1
1804,2623,0,0,60,60,0,1,0,1,0
3541,26,2099,16,8601,2870,5731,40,225,22,18
22628,10,21771,9,190,97,93,2,30,1,1
12145,26,26149,16,29039,3057,25982,46,323,19,27
1953,2824,0,0,146,146,0,1,0,1,0
21841,10,28723,9,213,87,126,2,30,1,1
2834,10,11669,9,235,90,145,2,32,1,1
7335,1072,0,0,60,60,0,1,0,1,0
21907,10,13733,9,768,99,669,2,30,1,1
519,10,1887,9,645,90,555,2,30,1,1
10404,26,13783,16,2959,793,2166,10,120,5,5
9915,26,3419,16,6074,4349,1725,22,361,11,11
12001,15,11160,11,45904,3904,42000,65,16,33,32
18933,28,0,0,66,66,0,1,0,1,0
15393,3051,0,0,66,66,0,1,0,1,0
9076,10,1707,9,733,94,639,2,29,1,1
14613,10,5786,9,200,102,98,2,30,1,1
14133,10,27801,9,177,94,83,2,30,1,1
15357,2502,23344,1946,70,70,0,1,5,1,0
8137,18,18859,13,184,94,90,2,30,1,1
22170,10,14199,9,395,102,293,2,30,1,1
17666,26,16061,16,6100,580,5520,17,53,5,12
12272,28,0,0,66,66,0,1,0,1,0
691,425,0,0,66,66,0,1,0,1,0
9411,2549,28908,1981,480,149,331,2,1200,1,1
3778,26,12374,16,480624,56231,424393,860,196,427,433
20300,18,4620,13,184,94,90,2,30,1,1
17789,28,0,0,70,70,0,1,0,1,0
22673,10,4218,9,195,86,109,2,30,1,1
10675,15,10718,11,2895,1428,1467,12,38,7,5
22429,10,19577,9,195,102,93,2,31,1,1
21498,2636,0,0,66,66,0,1,0,1,0
12219,28,0,0,70,70,0,1,0,1,0
21719,10,16156,9,300,90,210,4,30,2,2
6724,10,18965,9,203,82,121,2,30,1,1
11669,28,0,0,66,66,0,1,0,1,0
8757,10,2981,9,402,118,284,2,30,1,1
3962,26,24278,16,13838,1370,12468,26,34,13,13
3943,1215,0,0,62,62,0,1,0,1,0
14193,15,13929,11,944,529,415,11,315,6,5
11627,28,0,0,66,66,0,1,0,1,0
5150,26,22540,16,7655,2018,5637,31,93,16,15
15966,1888,0,0,66,66,0,1,0,1,0
17998,26,8926,16,9801,2337,7464,25,47,13,12
9823,26,10025,16,14172,2714,11458,32,637,13,19
13474,28,0,0,66,66,0,1,0,1,0
12527,28,0,0,70,70,0,1,0,1,0
9825,28,0,0,70,70,0,1,0,1,0
16289,28,0,0,66,66,0,1,0,1,0
15880,26,1710,16,5613,733,4880,16,14,9,7
786,15,3243,11,25613,1592,24021,32,22,9,23
9463,10,28087,9,732,89,643,2,30,1,1
4608,10,12922,9,207,86,121,2,30,1,1
1997,1771,0,0,62,62,0,1,0,1,0
9666,26,2396,16,1579,988,591,13,45,7,6
68,2938,0,0,62,62,0,1,0,1,0
16123,10,2993,9,165,78,87,2,30,1,1
20307,28,0,0,70,70,0,1,0,1,0
19023,10,27102,9,214,90,124,2,29,1,1
16861,26,11279,16,13973721,436876,13536845,14039,1629,4929,9110
3101,2382,0,0,62,62,0,1,0,1,0
135,15,1130,11,254,128,126,5,16,3,2
1631,1888,0,0,62,62,0,1,0,1,0
12672,10,11832,9,211,78,133,2,29,1,1
19700,28,0,0,66,66,0,1,0,1,0
16021,858,14729,633,150,150,0,1,1199,1,0
8396,10,19003,9,178,94,84,2,30,1,1
22098,10,1475,9,166,86,80,2,29,1,1
15606,10,26790,9,754,94,660,2,31,1,1
639,2432,0,0,143,143,0,1,0,1,0
9677,28,0,0,66,66,0,1,0,1,0
14627,28,0,0,70,70,0,1,0,1,0
13776,10,17238,9,253,87,166,4,43,2,2
14094,10,28928,9,372,126,246,2,29,1,1
22558,10,4558,9,199,102,97,2,30,1,1
17151,26,11904,16,344,130,214,6,77,3,3
17794,28,0,0,66,66,0,1,0,1,0
11153,104,0,0,60,60,0,1,0,1,0
10101,15,1788,11,1095399,7129,1088270,832,37,106,726
21236,1903,0,0,62,62,0,1,0,1,0
6502,26,12670,16,3117,1867,1250,19,15,9,10
15868,10,23748,9,211,102,109,2,30,1,1
1802,804,0,0,62,62,0,1,0,1,0
11680,697,0,0,66,66,0,1,0,1,0
9260,10,21816,9,216,90,126,2,29,1,1
403,1147,0,0,62,62,0,1,0,1,0
16951,255,0,0,62,62,0,1,0,1,0
12401,42,20825,25,70,70,0,1,4,1,0
2507,1539,0,0,62,62,0,1,0,1,0
21206,1888,0,0,66,66,0,1,0,1,0
6496,1215,0,0,62,62,0,1,0,1,0
11282,2362,0,0,62,62,0,1,0,1,0
2744,1239,7082,919,878,126,752,2,30,1,1
11229,1775,2260,1354,70,70,0,1,5,1,0
4757,10,12155,9,168,78,90,2,30,1,1
15199,10,8456,9,819,102,717,2,30,1,1
19436,1880,0,0,66,66,0,1,0,1,0
10901,1090,28638,800,316,136,180,6,6,3,3
11021,28,0,0,70,70,0,1,0,1,0
17625,1017,0,0,62,62,0,1,0,1,0
22664,26,27663,16,429726,12570,417156,440,16,154,286
6999,2640,3204,2048,509,150,359,2,1200,1,1
8066,10,19414,9,198,93,105,2,31,1,1
14971,28,0,0,70,70,0,1,0,1,0
21416,10,11483,9,193,102,91,2,31,1,1
9442,10,18715,9,183,94,89,2,29,1,1
21844,10,4086,9,195,102,93,2,30,1,1
4790,1888,0,0,62,62,0,1,0,1,0
12138,26,9475,16,12082,5745,6337,32,61,16,16
1632,310,0,0,145,145,0,1,0,1,0
15911,10,1543,9,177,94,83,2,30,1,1
8985,10,17670,9,211,102,109,2,30,1,1
11202,309,22916,202,70,70,0,2,7,2,0
19606,920,0,0,60,60,0,1,0,1,0
17963,28,0,0,66,66,0,1,0,1,0
4248,26,19383,16,656609,25419,631190,752,62,322,430
10213,28,0,0,66,66,0,1,0,1,0
8687,10,17392,9,183,94,89,2,30,1,1
4271,10,18345,9,199,94,105,2,31,1,1
12833,28,0,0,70,70,0,1,0,1,0
21294,10,28597,9,325,103,222,4,45,2,2
12350,28,0,0,70,70,0,1,0,1,0
5257,26,2635,16,11356,4341,7015,33,128,16,17
16951,255,0,0,62,62,0,1,0,1,0
20593,28,0,0,66,66,0,1,0,1,0
9604,26,5208,16,1346,918,428,10,31,6,4
6999,1518,21925,1156,324,150,174,2,1200,1,1
14007,10,27623,9,376,94,282,2,30,1,1
21904,10,5365,9,195,102,93,2,31,1,1
11896,26,1096,16,97763,8230,89533,131,150,49,82
2540,2256,0,0,62,62,0,1,0,1,0
17961,26,16708,16,8368,1360,7008,19,18,7,12
13726,28,0,0,70,70,0,1,0,1,0
22152,28,0,0,66,66,0,1,0,1,0
13807,1880,0,0,66,66,0,1,0,1,0
18486,26,27400,16,6849,1103,5746,23,120,12,11
7197,7,0,0,60,60,0,1,0,1,0
18508,959,16423,707,70,70,0,1,5,1,0
13103,28,0,0,70,70,0,1,0,1,0
14494,10,10352,9,749,94,655,2,30,1,1
9674,28,0,0,66,66,0,1,0,1,0
18348,15,17125,11,1151,711,440,10,16,5,5
10978,1888,0,0,62,62,0,1,0,1,0
10771,2465,20745,1916,136,136,0,3,14,3,0
17911,26,20108,16,408,78,330,6,25,1,5
8838,10,15816,9,718,94,624,2,30,1,1
10716,2938,0,0,62,62,0,1,0,1,0
16655,28,0,0,70,70,0,1,0,1,0
17467,2943,0,0,66,66,0,1,0,1,0
14667,10,8482,9,189,102,87,2,30,1,1
18321,2379,0,0,66,66,0,1,0,1,0
1033,26,28582,16,3835,501,3334,14,15,7,7
16667,233,9363,148,3721,1173,2548,18,20,11,7
18825,26,23480,16,740,222,518,11,3631,4,7
9943,28,0,0,70,70,0,1,0,1,0
20881,28,0,0,70,70,0,1,0,1,0
19194,26,24685,16,19675,8597,11078,137,480,68,69
270,2486,0,0,146,146,0,1,0,1,0
21418,10,22043,9,308,99,209,4,39,2,2
5884,26,7373,16,8949,1938,7011,21,17,12,9
10127,26,8157,16,3482,1985,1497,21,17,10,11
13728,10,17833,9,181,94,87,2,33,1,1
11486,28,0,0,66,66,0,1,0,1,0
5827,26,12296,16,3166,2097,1069,24,46,12,12
241,295,617,190,1236,676,560,13,22,7,6
738,1017,0,0,66,66,0,1,0,1,0
19263,28,0,0,66,66,0,1,0,1,0
15425,3255,17911,2523,70,70,0,1,5,1,0
14587,28,0,0,70,70,0,1,0,1,0
21572,10,1968,9,184,94,90,2,30,1,1
1989,1771,0,0,62,62,0,1,0,1,0
5009,23,0,0,3304,1560,1744,18,30,9,9
4899,26,20160,16,1820,1101,719,18,16,10,8
18350,15,21792,11,1430,754,676,11,146,6,5
3101,1888,0,0,62,62,0,1,0,1,0
10474,465,0,0,139,139,0,1,0,1,0
1572,1499,0,0,60,60,0,1,0,1,0
22510,2611,0,0,78,78,0,1,0,1,0
10620,1017,0,0,66,66,0,1,0,1,0
13136,26,22111,16,9976,3230,6746,22,56,13,9
8803,28,0,0,66,66,0,1,0,1,0
12453,28,0,0,70,70,0,1,0,1,0
11859,28,0,0,70,70,0,1,0,1,0
14327,26,403,16,4170,1901,2269,14,120,7,7
15331,10,27009,9,167,86,81,2,30,1,1
14286,28,0,0,66,66,0,1,0,1,0
9614,15,15471,11,8593,2011,6582,17,23,8,9
18121,26,3573,16,6906,1458,5448,24,16,14,10
8437,15,2609,11,254,128,126,5,15,3,2
14466,10,11728,9,198,102,96,2,30,1,1
7298,1017,0,0,62,62,0,1,0,1,0
18127,28,0,0,66,66,0,1,0,1,0
14430,10,11317,9,179,94,85,2,30,1,1
10106,2883,0,0,66,66,0,1,0,1,0
16951,255,0,0,62,62,0,1,0,1,0
1442,2953,0,0,62,62,0,1,0,1,0
10475,28,0,0,70,70,0,1,0,1,0
15695,10,4784,9,216,110,106,2,31,1,1
10961,26,8512,16,2328,1677,651,17,23,9,8
21999,15,13401,11,4502,1072,3430,15,98,7,8
7451,26,22078,16,9759,2304,7455,28,138,14,14
14698,26,124,16,8577,3450,5127,23,30,13,10
1970,1543,0,0,62,62,0,1,0,1,0
11425,28,0,0,66,66,0,1,0,1,0
10700,1178,867,869,9440,9440,0,11,30,11,0
19,3216,0,0,62,62,0,1,0,1,0
19428,28,0,0,70,70,0,1,0,1,0
8584,2497,5928,1943,270,78,192,2,30,1,1
16089,26,8915,16,7075,2575,4500,21,30,12,9
8694,26,14872,16,5968,985,4983,17,28,8,9
15797,10,13902,9,180,94,86,2,29,1,1
14583,15,24498,11,613,539,74,7,15,6,1
4590,15,23332,11,78,78,0,1,5,1,0
9140,255,0,0,60,60,0,1,0,1,0
11753,28,0,0,70,70,0,1,0,1,0
8866,28,0,0,70,70,0,1,0,1,0
17736,1147,0,0,146,146,0,1,0,1,0
12446,559,11071,375,70,70,0,2,7,2,0
20349,28,0,0,70,70,0,1,0,1,0
16951,255,0,0,62,62,0,1,0,1,0
19267,28,0,0,70,70,0,1,0,1,0
18481,1954,13880,1491,70,70,0,2,8,2,0
12533,1218,23116,901,70,70,0,2,7,2,0
21706,28,0,0,70,70,0,1,0,1,0
3411,15,9685,11,1614,1300,314,10,15,5,5
8173,15,20769,11,1767,751,1016,10,15,6,4
19308,26,4297,16,4933,771,4162,18,28,8,10
9203,26,25343,16,1097,654,443,12,86,7,5
14259,26,21134,16,17521,3850,13671,30,121,13,17
13866,10,3812,9,186,95,91,2,31,1,1
1239,2144,0,0,62,62,0,1,0,1,0
15644,10,854,9,195,102,93,2,30,1,1
11350,28,0,0,70,70,0,1,0,1,0
15976,28,0,0,70,70,0,1,0,1,0
13814,10,9843,9,816,97,719,2,31,1,1
5072,26,26302,16,9741,4687,5054,36,165,21,15
12287,28,0,0,66,66,0,1,0,1,0
15661,10,27334,9,196,102,94,2,30,1,1
13459,26,23675,16,103367,3730,99637,117,170,42,75
18853,15,28769,11,9729,876,8853,21,45,11,10
14348,10,17668,9,774,101,673,2,31,1,1
9609,28,0,0,66,66,0,1,0,1,0
18982,26,18375,16,8019,3298,4721,30,40,17,13
11650,1888,0,0,62,62,0,1,0,1,0
13756,10,7798,9,747,93,654,2,31,1,1
3064,2938,0,0,60,60,0,1,0,1,0
15678,1771,0,0,62,62,0,1,0,1,0
544,15,2017,11,326,186,140,6,29,4,2
21947,10,12577,9,214,110,104,2,30,1,1
17491,28,0,0,70,70,0,1,0,1,0
14428,15,24607,11,424,198,226,7,142,4,3
15849,10,26064,9,395,102,293,2,30,1,1
9171,15,10708,11,2089,1161,928,10,86,6,4
1731,520,1159,344,1188,1188,0,19,2298,19,0
12364,3216,0,0,66,66,0,1,0,1,0
14409,10,28965,9,186,95,91,2,31,1,1
17658,26,19348,16,9310,2994,6316,25,122,11,14
20196,28,0,0,70,70,0,1,0,1,0
8185,26,20818,16,5220,2290,2930,15,121,7,8
17222,2938,0,0,66,66,0,1,0,1,0
11808,15,5548,11,3020,1414,1606,30,118,16,14
6233,1646,0,0,60,60,0,1,0,1,0
22663,10,18238,9,197,94,103,2,29,1,1
7335,1070,0,0,60,60,0,1,0,1,0
15567,15,20596,11,214,140,74,4,35,3,1
11113,1220,4417,902,70,70,0,2,7,2,0
17982,1017,0,0,66,66,0,1,0,1,0
21311,28,0,0,70,70,0,1,0,1,0
12772,965,25682,713,70,70,0,2,7,2,0
14346,1248,7968,928,1778,1386,392,8,30,4,4
13206,3139,0,0,66,66,0,1,0,1,0
22271,10,27860,9,176,90,86,2,31,1,1
15561,10,10772,9,216,110,106,2,30,1,1
2744,1238,10611,918,937,126,811,2,30,1,1
8545,28,0,0,66,66,0,1,0,1,0
8651,299,21513,194,2960,432,2528,11,15,6,5
11749,28,0,0,70,70,0,1,0,1,0
19398,28,0,0,70,70,0,1,0,1,0
9853,28,0,0,70,70,0,1,0,1,0
5705,1100,0,0,74,74,0,1,0,1,0
11729,26,12747,16,4202,1924,2278,27,80,13,14
15469,28,0,0,66,66,0,1,0,1,0
16340,28,0,0,70,70,0,1,0,1,0
1356,10,4609,9,247,98,149,2,32,1,1
21802,10,9879,9,561,104,457,4,57,2,2
14185,28,0,0,70,70,0,1,0,1,0
2196,7,0,0,60,60,0,1,0,1,0
13520,28,0,0,70,70,0,1,0,1,0
20669,28,0,0,70,70,0,1,0,1,0
1482,1888,0,0,62,62,0,1,0,1,0
10830,3195,6270,2477,70,70,0,1,5,1,0
18806,26,13521,16,15013,10159,4854,34,46,19,15
21562,3216,0,0,66,66,0,1,0,1,0
9875,28,0,0,66,66,0,1,0,1,0
8804,26,26140,16,5776,1079,4697,15,52,8,7
14581,10,15479,9,193,102,91,2,30,1,1
468,26,780,16,1191,692,499,12,39,7,5
11919,26,15970,16,6352,1552,4800,23,17,12,11
10996,15,21714,11,366,240,126,7,25,5,2
10482,28,0,0,70,70,0,1,0,1,0
11921,15,23237,11,134273,4066,130207,163,22,59,104
6982,26,15592,16,11158,3338,7820,27,16,16,11
122,10,242,9,197,90,107,2,30,1,1
8441,28,0,0,66,66,0,1,0,1,0
10942,26,18159,16,186,70,116,2,120,1,1
13222,28,0,0,66,66,0,1,0,1,0
2934,15,12035,11,355544,12402,343142,378,26,134,244
1672,2144,0,0,62,62,0,1,0,1,0
7466,26,20109,16,4661,1754,2907,19,30,11,8
21201,26,28743,16,3192,633,2559,17,135,7,10
10346,2943,0,0,100,100,0,1,0,1,0
16291,28,0,0,70,70,0,1,0,1,0
17573,23,26335,15,2085,880,1205,10,31,5,5
4417,15,17069,11,152694,8416,144278,200,32,101,99
4736,26,20880,16,3354,2353,1001,18,45,11,7
201,1590,0,0,146,146,0,1,0,1,0
2046,2069,1858,1595,149,149,0,1,1200,1,0
15010,10,23031,9,323,110,213,2,30,1,1
13725,10,26438,9,177,94,83,2,30,1,1
15055,15,8634,11,95037,3407,91630,103,135,38,65
3214,1147,0,0,62,62,0,1,0,1,0
16444,188,21839,123,312,140,172,4,30,2,2
19069,28,0,0,70,70,0,1,0,1,0
14518,28,0,0,70,70,0,1,0,1,0
22627,10,3372,9,234,94,140,2,29,1,1
9858,15,27729,11,708,384,324,12,195,7,5
13751,28,0,0,70,70,0,1,0,1,0
13658,26,13806,16,1334906,33112,1301794,1315,35,446,869
4422,15,20267,11,1475,837,638,10,15,5,5
10231,28,0,0,66,66,0,1,0,1,0
16928,3139,0,0,66,66,0,1,0,1,0
14152,10,14376,9,188,96,92,2,31,1,1
360,3105,0,0,1162,1162,0,1,0,1,0
16879,28,0,0,66,66,0,1,0,1,0
18977,26,21782,16,7458,2832,4626,26,16,15,11
8327,772,26216,559,868,150,718,4,1200,2,2
16456,15,3876,11,5434,3724,1710,26,76,14,12
14291,919,10111,679,70,70,0,1,5,1,0
360,3105,0,0,164,164,0,1,0,1,0
8948,15,19867,11,130,70,60,2,15,1,1
21630,10,12928,9,196,102,94,2,32,1,1
20573,28,0,0,66,66,0,1,0,1,0
15532,15,23680,11,15752,5736,10016,28,30,14,14
5273,26,19313,16,1238821,42695,1196126,1389,72,535,854
14699,983,0,0,66,66,0,1,0,1,0
8489,26,5090,16,166663,77974,88689,368,2310,123,245
16164,28,0,0,70,70,0,1,0,1,0
636,280,17703,177,238,118,120,2,1200,1,1
6539,26,8754,16,7375,2087,5288,24,255,12,12
8816,28,0,0,70,70,0,1,0,1,0
8575,26,11029,16,6574,2176,4398,28,124,14,14
10051,26,6666,16,5962,1621,4341,16,75,9,7
17541,28,0,0,66,66,0,1,0,1,0
6418,26,11885,16,134,60,74,3,4,2,1
12564,10,23584,9,268,114,154,2,29,1,1
14082,10,17126,9,192,192,0,3,46,3,0
19538,15,9427,11,1495,954,541,13,47,8,5
10309,26,20235,16,7702,2410,5292,26,34,13,13
19057,28,0,0,70,70,0,1,0,1,0
15062,26,6550,16,2948,782,2166,10,121,5,5
16641,28,0,0,70,70,0,1,0,1,0
4676,1827,0,0,146,146,0,1,0,1,0
15360,10,13657,9,193,102,91,2,30,1,1
12319,26,15559,16,3153,2232,921,15,15,8,7
19348,26,10381,16,9577,1475,8102,30,124,14,16
20768,28,0,0,70,70,0,1,0,1,0
18166,2097,0,0,62,62,0,1,0,1,0
17881,26,4076,16,24828,8387,16441,80,111,44,36
15294,26,29141,16,7888,1899,5989,20,15,11,9
19883,10,6633,9,234,94,140,2,29,1,1
20776,28,0,0,66,66,0,1,0,1,0
8870,15,24018,11,2058,589,1469,10,44,6,4
13349,255,0,0,60,60,0,1,0,1,0
12716,2723,20792,2117,70,70,0,1,5,1,0
4400,26,27153,16,7449,2359,5090,15,120,7,8
9660,10,21071,9,772,100,672,2,31,1,1
17593,28,0,0,70,70,0,1,0,1,0
10537,26,7705,16,10453,3977,6476,27,54,15,12
21863,183,28730,121,3424,1710,1714,16,32,8,8
8619,28,0,0,70,70,0,1,0,1,0
12208,26,6,16,5454,1157,4297,15,22,9,6
12949,3216,0,0,66,66,0,1,0,1,0
9024,15,3588,11,6892,2154,4738,22,89,12,10
12797,15,7355,11,23134,15926,7208,53,541,32,21
1781,7,0,0,60,60,0,1,0,1,0
10449,28,0,0,66,66,0,1,0,1,0
19,2023,0,0,146,146,0,1,0,1,0
557,1215,0,0,62,62,0,1,0,1,0
11775,28,0,0,66,66,0,1,0,1,0
14058,10,20534,9,200,102,98,2,30,1,1
11163,26,13915,16,7601,1919,5682,24,76,13,11
9614,3105,0,0,86,86,0,1,0,1,0
8553,3216,0,0,62,62,0,1,0,1,0
6573,26,18494,16,10063,2126,7937,36,120,18,18
1721,2820,0,0,148,148,0,1,0,1,0
0,0,0,0,124,64,60,2,0,1,1
10518,26,20676,16,379,259,120,4,16,2,2
2744,1238,9089,918,877,126,751,2,29,1,1
3594,10,2884,9,168,78,90,2,29,1,1
10672,15,11364,11,378,192,186,7,39,4,3
17081,26,21233,16,6673,4335,2338,22,16,11,11
15876,10,1482,9,189,102,87,2,30,1,1
15826,10,2118,9,183,94,89,2,30,1,1
1377,1147,0,0,62,62,0,1,0,1,0
5467,234,28717,149,7587,2099,5488,26,3602,14,12
13638,10,27733,9,994,86,908,2,30,1,1
18005,28,0,0,70,70,0,1,0,1,0
18903,28,0,0,70,70,0,1,0,1,0
8931,10,24584,9,188,96,92,2,31,1,1
7916,26,19886,16,25864,15150,10714,105,217,54,51
22028,10,442,9,273,94,179,2,30,1,1
9163,10,27622,9,316,91,225,4,46,2,2
0,0,0,0,320,320,0,5,0,5,0
2697,2587,0,0,62,62,0,1,0,1,0
17669,26,12539,16,338,278,60,2,5,1,1
21162,2256,0,0,66,66,0,1,0,1,0
15158,10,19678,9,196,102,94,2,33,1,1
1413,1888,0,0,62,62,0,1,0,1,0
13649,26,27974,16,23418,2454,20964,56,197,26,30
17796,28,0,0,70,70,0,1,0,1,0
13447,28,0,0,70,70,0,1,0,1,0
1553,2636,0,0,66,66,0,1,0,1,0
12019,15,6838,11,5318,685,4633,14,15,7,7
6944,26,26034,16,7013,1092,5921,21,31,12,9
19819,1472,0,0,66,66,0,1,0,1,0
18802,2636,0,0,66,66,0,1,0,1,0
9781,2256,0,0,66,66,0,1,0,1,0
3590,1880,0,0,146,146,0,1,0,1,0
18253,28,0,0,70,70,0,1,0,1,0
4594,26,15101,16,7477,3305,4172,21,400,12,9
14354,1588,8268,1218,70,70,0,1,5,1,0
8816,10,4573,9,216,110,106,2,30,1,1
6450,188,18985,123,452,280,172,5,31,3,2
22181,28,0,0,70,70,0,1,0,1,0
15184,183,24994,121,3327,1438,1889,15,16,8,7
454,263,0,0,70,70,0,1,0,1,0
12784,28,0,0,70,70,0,1,0,1,0
8206,26,14833,16,55560,11338,44222,90,23,41,49
9196,10,3688,9,174,89,85,2,30,1,1
8836,28,0,0,66,66,0,1,0,1,0
17034,26,21012,16,1413,876,537,12,26,6,6
14455,3139,0,0,62,62,0,1,0,1,0
16295,28,0,0,66,66,0,1,0,1,0
22512,10,24000,9,200,94,106,2,30,1,1
14722,28,0,0,66,66,0,1,0,1,0
4133,26,22680,16,6665,3913,2752,33,98,19,14
19453,28,0,0,70,70,0,1,0,1,0
13306,28,0,0,70,70,0,1,0,1,0
19423,10,7640,9,325,86,239,2,30,1,1
17029,26,18179,16,5167,700,4467,16,15,7,9
14726,1880,0,0,66,66,0,1,0,1,0
16635,26,9746,16,7337,1630,5707,23,256,12,11
12,985,0,0,66,66,0,1,0,1,0
21822,10,11873,9,197,94,103,2,30,1,1
12428,3158,10867,2448,70,70,0,2,8,2,0
17527,26,2511,16,12169,4963,7206,60,262,31,29
6231,1147,0,0,66,66,0,1,0,1,0
19519,28,0,0,70,70,0,1,0,1,0
14697,2938,0,0,66,66,0,1,0,1,0
7969,234,11702,149,2988,2036,952,16,3601,8,8
19137,2883,0,0,66,66,0,1,0,1,0
8106,10,23703,9,164,78,86,2,30,1,1
20276,10,755,9,195,78,117,2,29,1,1
4900,26,21823,16,1515436,54168,1461268,1689,16,687,1002
13078,26,22403,16,8603,853,7750,27,92,9,18
11240,2636,0,0,62,62,0,1,0,1,0
19903,28,0,0,70,70,0,1,0,1,0
2744,1238,4641,918,1019,252,767,4,32,3,1
15065,10,27198,9,194,102,92,2,31,1,1
9766,26,4160,16,9215,1795,7420,32,140,16,16
15040,28,0,0,66,66,0,1,0,1,0
13647,10,23674,9,751,95,656,2,31,1,1
5378,15,17000,11,14349,1038,13311,26,20,13,13
14184,1017,0,0,62,62,0,1,0,1,0
21856,10,25319,9,198,101,97,2,31,1,1
19219,28,0,0,70,70,0,1,0,1,0
21234,3069,16198,2384,70,70,0,1,4,1,0
19184,28,0,0,66,66,0,1,0,1,0
22482,2256,0,0,62,62,0,1,0,1,0
17881,28,0,0,70,70,0,1,0,1,0
18934,26,5140,16,1864,250,1614,8,120,4,4
11659,28,0,0,70,70,0,1,0,1,0
21863,10,18478,9,727,223,504,6,70,3,3
18912,26,27538,16,10043,4993,5050,45,15,27,18
2086,1017,0,0,62,62,0,1,0,1,0
8847,26,12570,16,7074,2016,5058,26,187,13,13
1346,2205,0,0,62,62,0,1,0,1,0
14839,1804,0,0,66,66,0,1,0,1,0
6591,10,17089,9,86,86,0,1,30,1,0
14128,15,22172,11,133558,8265,125293,186,31,93,93
1602,26,5773,16,25629,5823,19806,44,179,25,19
1254,1590,0,0,66,66,0,1,0,1,0
13803,308,0,0,66,66,0,1,0,1,0
4754,26,11027,16,2071929,56793,2015136,2088,179,685,1403
8658,15,22068,11,1680,1210,470,9,15,5,4
8669,26,16647,16,1363701,35511,1328190,1382,271,476,906
3343,3009,0,0,774,774,0,1,0,1,0
18936,1147,0,0,62,62,0,1,0,1,0
16195,28,0,0,66,66,0,1,0,1,0
8841,295,21610,190,3132,815,2317,14,15,7,7
16951,255,0,0,62,62,0,1,0,1,0
19256,28,0,0,66,66,0,1,0,1,0
13817,10,3577,9,199,102,97,2,29,1,1
15713,28,0,0,66,66,0,1,0,1,0
6425,26,7584,16,600,156,444,8,25,2,6
2243,223,22179,144,70,70,0,1,30,1,0
8836,10,15912,9,168,86,82,2,30,1,1
11063,2587,0,0,66,66,0,1,0,1,0
14028,10,15254,9,210,110,100,2,31,1,1
16951,255,25970,160,160,66,94,2,9,1,1
22002,26,23272,16,70785,3306,67479,99,80,34,65
392,1147,0,0,62,62,0,1,0,1,0
15356,806,5774,586,70,70,0,1,5,1,0
11026,2106,24637,1622,70,70,0,2,7,2,0
22594,10,11347,9,178,94,84,2,30,1,1
10294,28,0,0,70,70,0,1,0,1,0
14459,26,21054,16,13469,2007,11462,44,256,19,25
8034,2836,0,0,66,66,0,1,0,1,0
14624,10,5671,9,194,102,92,2,30,1,1
1595,983,0,0,62,62,0,1,0,1,0
17040,26,3892,16,5228,700,4528,17,14,7,10
7167,26,9430,16,10480,4949,5531,22,15,12,10
6970,15,19380,11,369759,9557,360202,388,22,137,251
21938,10,211,9,177,94,83,2,30,1,1
4671,26,3644,16,6912,1841,5071,33,27,17,16
5256,255,0,0,60,60,0,1,0,1,0
15559,10,13290,9,177,94,83,2,29,1,1
2744,1244,14345,924,879,126,753,2,30,1,1
18943,28,0,0,66,66,0,1,0,1,0
1219,2627,17562,2037,460,150,310,2,1200,1,1
14287,26,24527,16,25716,7632,18084,52,48,31,21
21128,28,0,0,70,70,0,1,0,1,0
22431,10,18196,9,311,94,217,2,30,1,1
12545,1492,7608,1134,492,306,186,8,15,5,3
0,0,0,0,200,102,98,2,0,1,1
3969,26,2671,16,153,93,60,2,5,1,1
19016,983,0,0,62,62,0,1,0,1,0
13979,28,0,0,66,66,0,1,0,1,0
12154,26,25399,16,4995,1414,3581,21,15,12,9
5465,26,17910,16,65276,4554,60722,82,217,34,48
11611,26,23239,16,4416,1702,2714,19,126,9,10
16951,255,0,0,62,62,0,1,0,1,0
16091,1771,0,0,66,66,0,1,0,1,0
14224,28,0,0,70,70,0,1,0,1,0
15608,10,1826,9,199,102,97,2,30,1,1
2660,1888,0,0,62,62,0,1,0,1,0
15879,10,23508,9,196,102,94,2,29,1,1
8662,10,11459,9,194,102,92,2,30,1,1
18449,15,15187,11,214,140,74,4,15,3,1
17134,28,0,0,70,70,0,1,0,1,0
11838,2205,0,0,62,62,0,1,0,1,0
14612,3216,0,0,62,62,0,1,0,1,0
22161,2256,0,0,62,62,0,1,0,1,0
4364,15,23909,11,78,78,0,2,8,2,0
2084,1471,0,0,145,145,0,1,0,1,0
1597,2587,0,0,66,66,0,1,0,1,0
9357,10,4870,9,189,102,87,2,31,1,1
17477,3,0,0,60,60,0,1,0,1,0
12747,26,17830,16,499,425,74,4,0,3,1
10784,847,0,0,66,66,0,1,0,1,0
15694,1202,0,0,145,145,0,1,0,1,0
9245,10,6723,9,193,102,91,2,30,1,1
7881,3216,0,0,66,66,0,1,0,1,0
492,3216,0,0,66,66,0,1,0,1,0
21969,28,0,0,70,70,0,1,0,1,0
12759,26,27726,16,499,425,74,4,0,3,1
16385,26,18847,16,9662,4079,5583,66,194,30,36
22510,2611,0,0,78,78,0,1,0,1,0
532,247,0,0,3354,1792,1562,46,194,23,23
10665,15,18171,11,7679,5325,2354,15,29,8,7
15418,26,6747,16,54661,36820,17841,266,201,128,138
1693,2938,0,0,72,72,0,1,0,1,0
9819,28,0,0,66,66,0,1,0,1,0
17,2970,0,0,129,129,0,1,0,1,0
14845,28,0,0,66,66,0,1,0,1,0
17619,28,0,0,66,66,0,1,0,1,0
4065,26,19713,16,9032,2244,6788,36,255,17,19
12419,28,0,0,66,66,0,1,0,1,0
9178,28,0,0,70,70,0,1,0,1,0
3407,26,17489,16,4051,2618,1433,21,23,13,8
9314,10,16443,9,165,86,79,2,30,1,1
15492,10,17441,9,177,94,83,2,29,1,1
21478,10,6667,9,183,94,89,2,30,1,1
15430,26,12082,16,8114,2511,5603,19,135,9,10
12,2076,0,0,89,89,0,1,0,1,0
5932,26,18116,16,9168,1596,7572,22,186,11,11
9675,15,15023,11,21782,2162,19620,28,20,11,17
15307,461,20387,297,3090,1706,1384,16,30,10,6
11656,10,1474,9,277,94,183,2,30,1,1
15814,28,0,0,70,70,0,1,0,1,0
1160,1991,23062,1521,261,198,63,2,29,1,1
21550,28,0,0,70,70,0,1,0,1,0
12,700,0,0,85,85,0,1,0,1,0
11557,28,0,0,70,70,0,1,0,1,0
14100,28,0,0,70,70,0,1,0,1,0
8584,1238,6800,918,269,71,198,2,31,1,1
19928,28,0,0,66,66,0,1,0,1,0
10872,26,1132,16,1503,984,519,13,31,8,5
12813,26,9084,16,2845,1694,1151,18,125,10,8
6816,1017,0,0,62,62,0,1,0,1,0
273,1367,0,0,60,60,0,1,0,1,0
11545,28,0,0,70,70,0,1,0,1,0
12760,1745,7807,1333,1781,1103,678,15,17,9,6
8321,15,27481,11,2438,565,1873,10,75,6,4
10867,1888,0,0,66,66,0,1,0,1,0
3535,3139,0,0,66,66,0,1,0,1,0
8531,10,12826,9,183,94,89,2,30,1,1
7024,26,3571,16,2931,1940,991,19,25,10,9
15203,15,17672,11,234,234,0,4,11,4,0
1773,2604,0,0,66,66,0,1,0,1,0
13290,15,15107,11,4162,3455,707,14,15,8,6
9545,26,15650,16,1124,594,530,12,26,6,6
22095,10,21567,9,279,126,153,2,30,1,1
6196,26,20224,16,9173,2080,7093,22,18,13,9
532,247,0,0,3354,1792,1562,46,193,23,23
15058,15,10425,11,289731,8487,281244,294,136,104,190
22407,28,0,0,70,70,0,1,0,1,0
9101,10,20289,9,718,94,624,2,30,1,1
9279,26,25807,16,15011,5619,9392,50,35,26,24
21294,15,23746,11,314,192,122,6,15,4,2
18166,28,0,0,70,70,0,1,0,1,0
16238,28,0,0,70,70,0,1,0,1,0
12037,1209,10258,895,70,70,0,1,5,1,0
7723,234,7559,149,3630,2427,1203,21,3601,11,10
2027,3216,0,0,62,62,0,1,0,1,0
1439,2573,0,0,62,62,0,1,0,1,0
9423,28,0,0,66,66,0,1,0,1,0
8905,10,16042,9,757,102,655,2,30,1,1
15295,10,3017,9,177,94,83,2,30,1,1
10592,28,0,0,70,70,0,1,0,1,0
17433,28,0,0,70,70,0,1,0,1,0
20054,28,0,0,66,66,0,1,0,1,0
16088,28,0,0,70,70,0,1,0,1,0
14016,28,0,0,66,66,0,1,0,1,0
21978,10,28391,9,94,94,0,1,30,1,0
2844,2938,0,0,62,62,0,1,0,1,0
22501,10,28048,9,184,94,90,2,30,1,1
22444,10,1595,9,182,93,89,2,31,1,1
13963,28,0,0,70,70,0,1,0,1,0
9081,10,20236,9,168,78,90,2,29,1,1
7384,26,20494,16,9814,2331,7483,38,255,19,19
16021,2994,16456,2328,166,166,0,1,1199,1,0
9001,10,3853,9,167,86,81,2,30,1,1
6476,26,3792,16,31297,21354,9943,55,363,28,27
7339,170,0,0,60,60,0,1,0,1,0
3193,2852,0,0,62,62,0,1,0,1,0
1739,10,6432,9,209,77,132,2,32,1,1
8519,26,18681,16,2118582,46411,2072171,2066,90,617,1449
9013,15,24719,11,9581,2352,7229,14,89,7,7
16227,28,0,0,66,66,0,1,0,1,0
10868,1426,26226,1082,70,70,0,1,5,1,0
22649,10,18244,9,194,99,95,2,31,1,1
14429,15,24608,11,424,198,226,7,142,4,3
21688,10,8625,9,269,94,175,2,30,1,1
20184,28,0,0,70,70,0,1,0,1,0
21584,10,2149,9,193,102,91,2,30,1,1
1893,10,7203,9,198,90,108,2,30,1,1
9152,26,21760,16,2123,1050,1073,23,120,11,12
18000,26,9148,16,1813,1004,809,16,28,8,8
13901,28,0,0,70,70,0,1,0,1,0
3753,10,14733,9,314,98,216,2,30,1,1
16199,3216,0,0,74,74,0,1,0,1,0
2744,1867,21656,1425,892,126,766,2,30,1,1
17868,10,10386,9,304,86,218,2,29,1,1
21493,28,0,0,70,70,0,1,0,1,0
19873,2883,0,0,66,66,0,1,0,1,0
9498,2883,0,0,66,66,0,1,0,1,0
19428,242,0,0,145,145,0,1,0,1,0
18652,697,0,0,66,66,0,1,0,1,0
2501,3216,0,0,66,66,0,1,0,1,0
13500,1771,0,0,62,62,0,1,0,1,0
17465,28,0,0,66,66,0,1,0,1,0
937,15,25039,11,1701,883,818,14,26,7,7
15582,10,21021,9,177,94,83,2,30,1,1
4084,26,22806,16,9225,2759,6466,27,100,16,11
8901,26,7800,16,1143,672,471,12,129,7,5
22369,28,0,0,70,70,0,1,0,1,0
20277,2611,0,0,66,66,0,1,0,1,0
14909,2883,0,0,66,66,0,1,0,1,0
22553,10,14478,9,760,97,663,2,30,1,1
19044,57,5825,40,1139,878,261,2,30,1,1
12465,28,0,0,70,70,0,1,0,1,0
13182,28,0,0,70,70,0,1,0,1,0
4835,2466,23687,1917,7097,4720,2377,89,3163,55,34
12980,28,0,0,70,70,0,1,0,1,0
11305,15,22879,11,222010,7236,214774,216,28,66,150
14564,10,26346,9,164,86,78,2,30,1,1
2101,3216,0,0,66,66,0,1,0,1,0
78,2636,0,0,62,62,0,1,0,1,0
9585,15,21976,11,79227,5480,73747,89,19,32,57
16951,255,0,0,62,62,0,1,0,1,0
22369,3139,0,0,62,62,0,1,0,1,0
16122,28,0,0,66,66,0,1,0,1,0
4218,1215,0,0,62,62,0,1,0,1,0
6745,26,12209,16,71822,4809,67013,112,241,54,58
22419,10,10550,9,229,102,127,2,29,1,1
11017,28,0,0,70,70,0,1,0,1,0
12564,3254,14290,2522,70,70,0,2,8,2,0
19917,26,27641,16,130836,22940,107896,161,170,72,89
20058,280,25089,177,311,311,0,3,1200,3,0
2101,3216,0,0,62,62,0,1,0,1,0
11007,28,0,0,66,66,0,1,0,1,0
14299,10,13920,9,98,98,0,1,30,1,0
15525,26,15700,16,5601,1203,4398,14,60,9,5
18075,26,3336,16,7820,1344,6476,24,16,13,11
17149,26,13354,16,1366,631,735,14,81,7,7
7,12,0,0,594,594,0,1,0,1,0
17986,26,12976,16,3864,2812,1052,17,112,8,9
12131,26,26699,16,42135,4098,38037,64,323,25,39
2724,1240,14682,920,422,164,258,6,30,3,3
5794,373,17657,241,156,156,0,3,8,3,0
22009,10,1385,9,174,89,85,2,31,1,1
8344,2787,0,0,60,60,0,1,0,1,0
2744,2557,8281,1987,887,126,761,2,31,1,1
15305,10,23506,9,210,110,100,2,30,1,1
16906,28,0,0,70,70,0,1,0,1,0
8867,26,1311,16,28497,1646,26851,31,138,9,22
18879,2883,0,0,66,66,0,1,0,1,0
10407,1476,0,0,109,109,0,1,0,1,0
8437,10,18818,9,216,110,106,2,30,1,1
11784,10,27381,9,184,86,98,2,30,1,1
11081,1443,25671,1097,70,70,0,1,4,1,0
21810,10,26044,9,200,94,106,2,30,1,1
18,280,0,0,146,146,0,1,0,1,0
14985,1017,0,0,62,62,0,1,0,1,0
293,1771,0,0,62,62,0,1,0,1,0
12,658,0,0,131,131,0,1,0,1,0
14542,10,4375,9,193,102,91,2,29,1,1
11814,28,0,0,70,70,0,1,0,1,0
16951,255,0,0,62,62,0,1,0,1,0
17683,28,0,0,70,70,0,1,0,1,0
360,3105,0,0,1044,1044,0,1,0,1,0
21575,10,16832,9,197,94,103,2,29,1,1
21518,10,1701,9,261,94,167,2,30,1,1
13449,26,9761,16,273283,194709,78574,1567,3312,746,821
9576,28,0,0,66,66,0,1,0,1,0
6752,376,0,0,148,148,0,1,0,1,0
8698,10,1670,9,190,97,93,2,31,1,1
15791,983,0,0,66,66,0,1,0,1,0
7289,26,7385,16,1625,1038,587,14,25,8,6
13657,28,0,0,70,70,0,1,0,1,0
15839,26,20000,16,11721,2230,9491,39,31,22,17
22660,10,21848,9,498,204,294,6,31,3,3
18564,3108,27677,2415,1628,1037,591,14,16,8,6
19695,805,0,0,66,66,0,1,0,1,0
5502,1017,0,0,62,62,0,1,0,1,0
11689,1215,0,0,62,62,0,1,0,1,0
5943,245,0,0,60,60,0,1,0,1,0
11440,2205,0,0,66,66,0,1,0,1,0
11278,26,25145,16,190,70,120,4,15,2,2
15282,28,0,0,70,70,0,1,0,1,0
11401,28,0,0,70,70,0,1,0,1,0
15932,10,28066,9,198,102,96,2,30,1,1
8584,1237,21573,917,235,71,164,2,31,1,1
19325,15,2568,11,214,140,74,4,41,3,1
14300,28,0,0,70,70,0,1,0,1,0
6064,10,19031,9,168,78,90,2,30,1,1
3183,1771,0,0,146,146,0,1,0,1,0
15208,10,20377,9,342,99,243,4,32,2,2
9049,28,0,0,70,70,0,1,0,1,0
8338,10,985,9,199,102,97,2,30,1,1
19356,28,0,0,70,70,0,1,0,1,0
8344,2787,0,0,60,60,0,1,0,1,0
3208,26,13645,16,28195,6044,22151,58,17,30,28
9518,26,25153,16,5359,705,4654,15,25,8,7
6846,26,6267,16,14478,1815,12663,30,170,14,16
9926,28,0,0,70,70,0,1,0,1,0
8499,26,5000,16,4425,1910,2515,36,3656,12,24
1975,2241,0,0,62,62,0,1,0,1,0
14896,10,11440,9,198,102,96,2,30,1,1
19545,1771,0,0,66,66,0,1,0,1,0
3301,26,13493,16,867883,29498,838385,922,58,328,594
8327,764,28941,552,854,150,704,4,1200,2,2
18141,28,0,0,66,66,0,1,0,1,0
14873,10,19768,9,200,102,98,2,31,1,1
12166,28,0,0,70,70,0,1,0,1,0
22201,2836,0,0,66,66,0,1,0,1,0
1965,1888,0,0,62,62,0,1,0,1,0
9273,6,21822,6,66,66,0,1,5,1,0
22290,10,1510,9,718,94,624,2,29,1,1
3133,2297,24768,1781,330,330,0,6,3609,6,0
14362,10,12657,9,733,94,639,2,30,1,1
13730,10,18324,9,179,94,85,2,30,1,1
17575,28,0,0,70,70,0,1,0,1,0
1699,10,6217,9,210,98,112,2,29,1,1
158,1147,0,0,146,146,0,1,0,1,0
14259,28,0,0,66,66,0,1,0,1,0
19589,2938,0,0,146,146,0,1,0,1,0
7825,10,7970,9,164,78,86,2,30,1,1
1736,2377,0,0,66,66,0,1,0,1,0
15363,10,13713,9,199,102,97,2,30,1,1
11153,2361,14536,1837,70,70,0,2,7,2,0
22217,10,19199,9,763,102,661,2,30,1,1
13627,28,0,0,70,70,0,1,0,1,0
14065,26,28453,16,74784,4781,70003,122,171,55,67
16551,10,0,0,178,79,99,2,30,1,1
3921,26,13921,16,7105,1924,5181,20,25,10,10
14332,10,27846,9,193,102,91,2,30,1,1
1822,10,6834,9,233,91,142,2,30,1,1
8412,10,14580,9,376,126,250,2,29,1,1
19595,28,0,0,70,70,0,1,0,1,0
13648,10,10728,9,209,110,99,2,31,1,1
22496,10,7246,9,329,88,241,4,50,2,2
15238,10,14835,9,178,91,87,2,31,1,1
18549,28,0,0,66,66,0,1,0,1,0
4153,1472,0,0,62,62,0,1,0,1,0
12,2914,0,0,85,85,0,1,0,1,0
10571,26,22523,16,138679,4142,134537,141,173,33,108
8584,1236,22777,916,230,71,159,2,31,1,1
12611,1888,0,0,66,66,0,1,0,1,0
9873,28,0,0,70,70,0,1,0,1,0
22390,1285,13137,964,268,78,190,2,30,1,1
16021,2627,20721,2037,543,166,377,2,1199,1,1
12381,26,20436,16,7901,3483,4418,24,30,13,11
17,2802,0,0,66,66,0,1,0,1,0
15272,10,14810,9,198,102,96,2,30,1,1
6871,26,19212,16,7123,1020,6103,19,151,11,8
7425,3216,0,0,62,62,0,1,0,1,0
8970,28,0,0,70,70,0,1,0,1,0
8682,10,11701,9,182,93,89,2,31,1,1
14508,10,13447,9,168,86,82,2,30,1,1
16951,255,0,0,62,62,0,1,0,1,0
9359,10,17711,9,86,86,0,1,30,1,0
19357,1017,0,0,62,62,0,1,0,1,0
60,1888,0,0,62,62,0,1,0,1,0
18562,28,0,0,66,66,0,1,0,1,0
1502,2676,0,0,66,66,0,1,0,1,0
3066,1076,24671,789,502,150,352,2,1200,1,1
9075,28,0,0,70,70,0,1,0,1,0
14326,2311,25446,1795,70,70,0,1,5,1,0
4920,26,15531,16,6150,914,5236,18,16,10,8
15213,28,0,0,66,66,0,1,0,1,0
6908,15,19275,11,84030,4287,79743,107,145,47,60
14919,26,7567,16,9683,2173,7510,35,26,17,18
11101,28,0,0,66,66,0,1,0,1,0
11654,26,16366,16,164840,5975,158865,179,122,61,118
20030,28,0,0,70,70,0,1,0,1,0
21346,28,0,0,70,70,0,1,0,1,0
4650,26,9777,16,499,425,74,4,0,3,1
14950,10,26203,9,193,102,91,2,31,1,1
2885,26,11692,16,6756,2587,4169,19,16,10,9
3566,26,6800,16,9449,3441,6008,27,41,17,10
6044,983,0,0,62,62,0,1,0,1,0
18,3216,0,0,62,62,0,1,0,1,0
14927,26,16927,16,39990,1989,38001,50,147,17,33
13154,10,3362,9,200,86,114,2,30,1,1
22508,10,10855,9,172,88,84,2,30,1,1
9989,28,0,0,66,66,0,1,0,1,0
9057,28,0,0,66,66,0,1,0,1,0
1965,1888,0,0,62,62,0,1,0,1,0
16951,255,0,0,62,62,0,1,0,1,0
6194,2787,0,0,60,60,0,1,0,1,0
16069,10,15992,9,585,192,393,6,54,3,3
636,280,0,0,62,62,0,1,0,1,0
7122,26,9773,16,33924,26047,7877,73,403,33,40
21862,10,2170,9,211,102,109,2,29,1,1
13336,28,0,0,66,66,0,1,0,1,0
16951,255,0,0,62,62,0,1,0,1,0
18405,28,0,0,70,70,0,1,0,1,0
13912,10,11355,9,214,102,112,2,29,1,1
14242,1435,715,1089,70,70,0,2,8,2,0
2744,1241,17256,921,891,126,765,2,31,1,1
8637,28,0,0,70,70,0,1,0,1,0
21481,10,6056,9,403,94,309,4,38,2,2
15511,341,19764,217,110,110,0,1,30,1,0
12396,28,0,0,70,70,0,1,0,1,0
8929,10,13048,9,258,110,148,2,30,1,1
12474,3247,27955,2516,70,70,0,2,7,2,0
13933,10,20746,9,446,94,352,4,44,2,2
18365,15,4847,11,1343,846,497,11,145,6,5
10124,28,0,0,70,70,0,1,0,1,0
14441,10,4958,9,184,94,90,2,30,1,1
11446,28,0,0,66,66,0,1,0,1,0
21037,1215,0,0,62,62,0,1,0,1,0
13712,15,7375,11,48751,3044,45707,57,60,23,34
21817,2205,0,0,66,66,0,1,0,1,0
18424,2938,0,0,66,66,0,1,0,1,0
22418,26,375,16,2767,681,2086,10,120,5,5
6734,26,26470,16,6516,3085,3431,33,80,17,16
13951,10,6465,9,298,101,197,4,31,2,2
18468,255,0,0,60,60,0,1,0,1,0
12895,10,4166,9,207,86,121,2,30,1,1
21948,10,25930,9,214,110,104,2,30,1,1
12107,2883,0,0,66,66,0,1,0,1,0
16371,26,15822,16,1865,1226,639,18,176,11,7
13809,28,0,0,70,70,0,1,0,1,0
2133,1147,0,0,62,62,0,1,0,1,0
21059,2949,21516,2288,312,132,180,6,6,3,3
1636,26,16703,16,1857,1218,639,18,95,11,7
17958,26,7325,16,23856,3218,20638,40,18,16,24
22701,10,16363,9,265,102,163,2,30,1,1
10986,28,0,0,66,66,0,1,0,1,0
9717,26,8477,16,6575,1995,4580,26,100,13,13
18975,28,0,0,70,70,0,1,0,1,0
4790,1888,0,0,62,62,0,1,0,1,0
2357,7,0,0,60,60,0,1,0,1,0
18884,26,23387,16,12278,1931,10347,32,56,18,14
20300,28,0,0,70,70,0,1,0,1,0
1848,2953,0,0,146,146,0,1,0,1,0
16489,26,24923,16,4132,2158,1974,35,255,17,18
21682,10,3796,9,184,94,90,2,29,1,1
7335,1070,0,0,60,60,0,1,0,1,0
14456,10,17926,9,181,94,87,2,33,1,1
17847,28,0,0,66,66,0,1,0,1,0
10228,15,26387,11,1524,1028,496,10,20,7,3
12713,2667,8041,2074,70,70,0,1,4,1,0
21234,10,2239,9,289,102,187,2,30,1,1
8584,1241,10152,921,240,78,162,2,30,1,1
22116,10,6713,9,210,110,100,2,30,1,1
8650,28,0,0,66,66,0,1,0,1,0
21892,10,24333,9,181,94,87,2,31,1,1
22684,10,3856,9,202,103,99,2,31,1,1
17808,15,11059,11,3437462,77916,3359546,3384,134,1140,2244
13964,10,4478,9,210,110,100,2,31,1,1
3375,26,27520,16,7442,1260,6182,19,15,10,9
9193,10,7441,9,209,110,99,2,30,1,1
11154,26,17574,16,78269,5330,72939,127,313,57,70
9073,26,6989,16,6754,2219,4535,21,75,11,10
11077,2151,23599,1660,70,70,0,1,4,1,0
18189,28,0,0,70,70,0,1,0,1,0
2576,1147,0,0,66,66,0,1,0,1,0
20596,2859,16623,2218,1426,964,462,7,15,4,3
18075,26,16453,16,354,140,214,6,130,3,3
12,1060,0,0,100,100,0,1,0,1,0
17611,26,21341,16,2898,1700,1198,16,15,8,8
16490,15,13049,11,100364,4917,95447,133,241,67,66
15409,10,2459,9,178,94,84,2,31,1,1
21825,10,6317,9,215,86,129,2,30,1,1
20731,10,3241,9,315,102,213,2,31,1,1
290,3216,0,0,66,66,0,1,0,1,0
612,262,0,0,60,60,0,1,0,1,0
17534,26,1478,16,17547,11857,5690,34,159,20,14
1330,697,0,0,62,62,0,1,0,1,0
14708,10,962,9,198,101,97,2,31,1,1
29,1888,0,0,62,62,0,1,0,1,0
21553,10,13170,9,215,94,121,2,29,1,1
14328,1231,864,911,70,70,0,1,5,1,0
1618,1017,0,0,62,62,0,1,0,1,0
14880,26,10931,16,8550,1880,6670,22,376,12,10
21349,10,12734,9,209,110,99,2,29,1,1
10799,2636,0,0,62,62,0,1,0,1,0
14027,10,13797,9,778,103,675,2,31,1,1
3856,15,14931,11,2148,918,1230,10,20,6,4
15881,28,0,0,70,70,0,1,0,1,0
11703,28,0,0,70,70,0,1,0,1,0
12215,10,23492,9,168,78,90,2,30,1,1
19975,28,0,0,66,66,0,1,0,1,0
16645,2587,0,0,66,66,0,1,0,1,0
21516,10,24019,9,211,102,109,2,30,1,1
13519,28,0,0,66,66,0,1,0,1,0
19565,2587,0,0,66,66,0,1,0,1,0
6922,1589,0,0,146,146,0,1,0,1,0
4454,2587,0,0,62,62,0,1,0,1,0
977,15,12257,11,318,192,126,6,26,4,2
1124,2256,0,0,62,62,0,1,0,1,0
21945,10,3313,9,381,98,283,4,51,2,2
21858,10,16331,9,350,94,256,2,30,1,1
3877,1472,0,0,66,66,0,1,0,1,0
16951,255,0,0,62,62,0,1,0,1,0
2917,1167,0,0,62,62,0,1,0,1,0
10222,15,24703,11,1524,1028,496,10,21,7,3
13070,1872,0,0,66,66,0,1,0,1,0
8976,10,4216,9,763,102,661,2,29,1,1
18220,28,0,0,70,70,0,1,0,1,0
18174,28,0,0,70,70,0,1,0,1,0
9645,18,15661,13,184,94,90,2,30,1,1
11066,28,0,0,70,70,0,1,0,1,0
22508,10,15245,9,178,94,84,2,29,1,1
10540,2581,0,0,100,100,0,1,0,1,0
1813,1880,0,0,66,66,0,1,0,1,0
1446,15,5055,11,6835,961,5874,17,27,9,8
12968,26,18950,16,5008,2097,2911,13,121,6,7
603,1888,0,0,62,62,0,1,0,1,0
15725,10,19582,9,209,110,99,2,30,1,1
21506,28,0,0,70,70,0,1,0,1,0
19832,28,0,0,70,70,0,1,0,1,0
20241,28,0,0,66,66,0,1,0,1,0
4119,15,18296,11,1151,711,440,10,16,5,5
9757,10,26955,9,814,110,704,2,30,1,1
21737,10,8775,9,199,102,97,2,30,1,1
2859,1147,0,0,62,62,0,1,0,1,0
17314,3212,0,0,62,62,0,1,0,1,0
10100,2256,0,0,62,62,0,1,0,1,0
22329,10,952,9,193,102,91,2,29,1,1
20651,28,0,0,66,66,0,1,0,1,0
13070,1936,0,0,62,62,0,1,0,1,0
195,1590,0,0,62,62,0,1,0,1,0
22073,10,1774,9,819,102,717,2,30,1,1
19905,28,0,0,70,70,0,1,0,1,0
16312,28,0,0,70,70,0,1,0,1,0
4286,15,15617,11,514,246,268,9,76,5,4
17833,28,0,0,70,70,0,1,0,1,0
15660,28,0,0,66,66,0,1,0,1,0
8908,15,13868,11,103346,1476,101870,87,17,16,71
13697,10,25127,9,167,86,81,2,29,1,1
8684,10,14705,9,299,90,209,4,49,2,2
12570,26,6311,16,499,425,74,4,0,3,1
11070,15,19714,11,4185,3462,723,14,16,7,7
6999,825,5231,605,502,150,352,2,1200,1,1
3486,26,26419,16,81954,13611,68343,174,34,79,95
2724,1240,27309,920,422,164,258,6,31,3,3
8442,10,15218,9,195,102,93,2,31,1,1
13748,10,6010,9,177,94,83,2,29,1,1
4019,26,23172,16,255313,6947,248366,253,123,74,179
10336,26,3488,16,31736,1463,30273,43,32,14,29
2980,10,12278,9,220,90,130,2,30,1,1
2703,2953,0,0,62,62,0,1,0,1,0
17236,15,26731,11,10003,5095,4908,21,76,12,9
20048,1797,0,0,62,62,0,1,0,1,0
21986,28,0,0,66,66,0,1,0,1,0
4085,1888,0,0,62,62,0,1,0,1,0
14911,1804,0,0,66,66,0,1,0,1,0
21831,10,8054,9,184,94,90,2,30,1,1
4552,983,0,0,66,66,0,1,0,1,0
10160,28,0,0,66,66,0,1,0,1,0
22719,10,21420,9,381,88,293,4,31,2,2
12741,26,18961,16,499,425,74,4,0,3,1
3781,26,23879,16,135231,5033,130198,149,216,55,94
14484,28,0,0,70,70,0,1,0,1,0
13844,28,0,0,70,70,0,1,0,1,0
17542,28,0,0,70,70,0,1,0,1,0
7951,18,11476,13,184,94,90,2,30,1,1
15311,26,14025,16,7890,1901,5989,20,15,11,9
16951,255,0,0,62,62,0,1,0,1,0
15519,15,26058,11,214,140,74,4,30,3,1
225,10,21649,9,826,826,0,8,44,8,0
15597,28,0,0,70,70,0,1,0,1,0
15633,10,14881,9,177,94,83,2,30,1,1
20533,10,2726,9,304,86,218,2,30,1,1
14252,15,24986,11,70,70,0,1,5,1,0
22589,300,0,0,66,66,0,1,0,1,0
18337,28,0,0,70,70,0,1,0,1,0
15311,10,26050,9,283,94,189,4,41,2,2
15289,26,4585,16,579769,15036,564733,578,61,199,379
13710,10,13773,9,177,94,83,2,31,1,1
10590,2587,0,0,62,62,0,1,0,1,0
9436,10,638,9,211,110,101,2,30,1,1
1444,509,0,0,62,62,0,1,0,1,0
22331,28,0,0,70,70,0,1,0,1,0
8946,15,28913,11,1429,931,498,10,126,6,4
7018,7,0,0,60,60,0,1,0,1,0
18949,26,19618,16,62583,3743,58840,88,32,40,48
15555,10,11019,9,193,94,99,2,30,1,1
17667,28,0,0,70,70,0,1,0,1,0
10523,26,16134,16,318,70,248,5,17,1,4
8402,15,20833,11,1783342,58977,1724365,1613,162,445,1168
14895,10,12522,9,195,102,93,2,29,1,1
19834,28,0,0,70,70,0,1,0,1,0
21291,2938,0,0,74,74,0,1,0,1,0
639,2486,0,0,143,143,0,1,0,1,0
11133,15,27500,11,68083,5515,62568,90,38,40,50
17319,1147,0,0,66,66,0,1,0,1,0
12631,26,3625,16,499,425,74,4,0,3,1
12570,1888,0,0,66,66,0,1,0,1,0
16753,10,1929,9,174,81,93,2,30,1,1
8822,26,18770,16,19544,4428,15116,79,119,39,40
13655,26,18911,16,8182,3793,4389,27,37,16,11
3333,26,1293,16,118,118,0,1,30,1,0
753,10,3037,9,226,90,136,2,29,1,1
13464,8,24080,8,194,66,128,3,15,1,2
12093,26,12750,16,3655,2344,1311,18,17,9,9
15419,28,0,0,70,70,0,1,0,1,0
18170,28,0,0,70,70,0,1,0,1,0
10727,28,0,0,70,70,0,1,0,1,0
8584,1453,17072,1106,244,71,173,2,30,1,1
22573,10,21118,9,301,108,193,4,55,2,2
18338,28,0,0,70,70,0,1,0,1,0
14089,10,27204,9,184,94,90,2,30,1,1
2373,1694,0,0,62,62,0,1,0,1,0
20019,28,0,0,66,66,0,1,0,1,0
9410,28,0,0,70,70,0,1,0,1,0
18586,3216,0,0,66,66,0,1,0,1,0
15808,1888,0,0,62,62,0,1,0,1,0
9536,28,0,0,70,70,0,1,0,1,0
10276,3216,0,0,66,66,0,1,0,1,0
14957,15,12449,11,1635,945,690,15,72,8,7
19943,155,0,0,66,66,0,1,0,1,0
18995,1888,0,0,145,145,0,1,0,1,0
12442,2028,26338,1556,70,70,0,1,4,1,0
20072,28,0,0,70,70,0,1,0,1,0
10069,28,0,0,70,70,0,1,0,1,0
15394,10,26588,9,202,103,99,2,31,1,1
16111,26,23488,16,4752,2561,2191,32,256,16,16
9773,15,22085,11,6210,2976,3234,16,20,9,7
532,247,0,0,3498,1872,1626,48,205,24,24
15176,26,17080,16,8978,3243,5735,22,45,13,9
9464,10,2917,9,814,110,704,2,30,1,1
21669,10,12831,9,211,102,109,2,30,1,1
8837,10,15994,9,182,93,89,2,31,1,1
499,187,0,0,345,345,0,1,0,1,0
14014,28,0,0,70,70,0,1,0,1,0
4889,26,16646,16,190,70,120,4,15,2,2
18138,28,0,0,70,70,0,1,0,1,0
14234,28,0,0,66,66,0,1,0,1,0
2744,1238,29085,918,891,126,765,2,31,1,1
14371,28,0,0,70,70,0,1,0,1,0
5506,26,19468,16,9355,3422,5933,56,16,28,28
17019,15,26003,11,106571,3881,102690,128,16,56,72
13998,26,17153,16,6379,1762,4617,27,27,14,13
18164,15,19538,11,10676,6719,3957,23,141,12,11
9532,10,15832,9,177,94,83,2,30,1,1
22473,10,28823,9,195,86,109,2,30,1,1
606,1017,0,0,146,146,0,1,0,1,0
15003,10,10011,9,711,87,624,2,0,1,1
21301,1017,0,0,66,66,0,1,0,1,0
8500,26,3215,16,50226,4284,45942,76,75,31,45
7622,10,24616,9,391,102,289,2,30,1,1
19793,509,0,0,66,66,0,1,0,1,0
13143,28,0,0,70,70,0,1,0,1,0
128,391,0,0,62,62,0,1,0,1,0
5221,26,8156,16,67063,17409,49654,94,274,48,46
12093,28,0,0,70,70,0,1,0,1,0
14305,28,0,0,70,70,0,1,0,1,0
21848,10,24008,9,174,89,85,2,31,1,1
16951,255,0,0,62,62,0,1,0,1,0
8688,10,6917,9,688,185,503,6,45,3,3
19902,28,0,0,70,70,0,1,0,1,0
21813,10,10540,9,174,89,85,2,30,1,1
3418,2787,0,0,60,60,0,1,0,1,0
12433,28,0,0,70,70,0,1,0,1,0
22643,10,7915,9,196,102,94,2,30,1,1
10503,28,0,0,66,66,0,1,0,1,0
2744,1242,8473,922,2024,504,1520,7,33,5,2
8573,10,15348,9,774,101,673,2,30,1,1
22219,28,0,0,66,66,0,1,0,1,0
21822,10,13395,9,209,110,99,2,30,1,1
21616,10,14867,9,323,110,213,2,30,1,1
8361,3260,1084,2525,624,318,306,10,15,5,5
13763,10,8866,9,245,94,151,2,30,1,1
21769,10,4883,9,177,94,83,2,30,1,1
14549,10,18634,9,193,102,91,2,30,1,1
18817,28,0,0,70,70,0,1,0,1,0
4835,3189,18954,2474,1294,594,700,20,1781,10,10
17055,10,18746,9,277,102,175,2,30,1,1
417,2938,0,0,62,62,0,1,0,1,0
19522,15,15856,11,1804,884,920,12,49,6,6
21959,1771,0,0,62,62,0,1,0,1,0
18489,15,28915,11,4515,3889,626,11,27,6,5
14145,10,386,9,184,94,90,2,30,1,1
22187,10,23636,9,193,102,91,2,29,1,1
22327,26,21303,16,11416,4745,6671,45,256,22,23
12404,28,0,0,70,70,0,1,0,1,0
21718,3216,0,0,62,62,0,1,0,1,0
17959,26,10981,16,11950,1590,10360,33,90,16,17
17334,10,16322,9,199,94,105,2,30,1,1
1281,2543,0,0,60,60,0,1,0,1,0
2665,2256,0,0,66,66,0,1,0,1,0
13043,28,0,0,70,70,0,1,0,1,0
11644,15,23096,11,7237,2578,4659,19,16,9,10
10552,26,12044,16,10204,5034,5170,45,16,25,20
21809,10,25108,9,178,94,84,2,30,1,1
8572,28,0,0,70,70,0,1,0,1,0
15659,10,9393,9,756,95,661,2,31,1,1
12035,2243,11933,1736,70,70,0,2,8,2,0
10172,10,0,0,82,82,0,1,30,1,0
10620,805,0,0,66,66,0,1,0,1,0
21332,2615,1180,2027,66,66,0,1,5,1,0
14997,2093,0,0,143,143,0,1,0,1,0
15101,26,24243,16,8130,2093,6037,17,120,9,8
3556,26,18058,16,7760,2646,5114,24,16,13,11
14961,1827,0,0,66,66,0,1,0,1,0
8584,2938,0,0,66,66,0,1,0,1,0
8420,10,0,0,218,78,140,2,30,1,1
8049,676,13820,475,130,70,60,2,5,1,1
15832,26,2331,16,22074,3005,19069,58,31,31,27
17160,10,23529,9,209,102,107,2,29,1,1
6487,26,10573,16,7028,2558,4470,19,16,11,8
15457,28,0,0,66,66,0,1,0,1,0
18324,28,0,0,66,66,0,1,0,1,0
941,26,26623,16,5399,368,5031,18,31,5,13
9738,1147,0,0,66,66,0,1,0,1,0
15417,1108,5030,813,70,70,0,2,8,2,0
4050,26,14927,16,2270,1303,967,20,102,11,9
7327,26,9337,16,4306,1107,3199,17,30,9,8
1042,10,3691,9,237,91,146,2,32,1,1
15208,10,7972,9,197,102,95,2,30,1,1
9052,10,26130,9,363,97,266,4,34,2,2
2744,1238,3715,918,887,126,761,2,30,1,1
3849,2938,0,0,66,66,0,1,0,1,0
8038,2953,0,0,146,146,0,1,0,1,0
14318,10,16019,9,183,94,89,2,30,1,1
2924,1771,0,0,66,66,0,1,0,1,0
22346,28,0,0,70,70,0,1,0,1,0
14753,10,1720,9,817,102,715,2,30,1,1
8393,10,1035,9,194,102,92,2,30,1,1
4059,15,26644,11,841,715,126,5,15,3,2
12773,2460,27510,1912,320,140,180,6,6,3,3
14282,26,21718,16,186406,10415,175991,218,123,79,139
20992,28,0,0,66,66,0,1,0,1,0
11948,28,0,0,70,70,0,1,0,1,0
18550,1331,16611,1006,70,70,0,1,5,1,0
15568,10,26077,9,168,86,82,2,31,1,1
12599,2056,1073,1582,492,306,186,8,15,5,3
14318,2769,1965,2148,320,140,180,6,6,3,3
22641,28,0,0,66,66,0,1,0,1,0
2744,1631,14438,1253,877,126,751,2,30,1,1
10399,26,22579,16,59889,7472,52417,83,145,32,51
16021,2060,12662,1586,535,163,372,2,1200,1,1
87,26,5220,16,448,256,192,8,25,5,3
20116,26,8970,16,10390,7057,3333,27,33,15,12
7059,15,19496,11,2091,1642,449,10,20,6,4
14697,10,28707,9,194,102,92,2,30,1,1
18804,1989,14407,1519,316,136,180,6,5,3,3
4264,26,4494,16,678861,22499,656362,749,19,290,459
8279,10,5680,9,168,78,90,2,29,1,1
14452,10,1666,9,183,94,89,2,30,1,1
15138,10,1629,9,183,94,89,2,29,1,1
16644,2747,0,0,66,66,0,1,0,1,0
13735,28,0,0,66,66,0,1,0,1,0
2578,510,0,0,62,62,0,1,0,1,0
21710,10,16950,9,184,94,90,2,31,1,1
13690,28,0,0,66,66,0,1,0,1,0
22604,28,0,0,70,70,0,1,0,1,0
14447,2148,0,0,66,66,0,1,0,1,0
8909,28,0,0,70,70,0,1,0,1,0
9308,28,0,0,66,66,0,1,0,1,0
13230,2883,0,0,66,66,0,1,0,1,0
16394,26,14932,16,13736,1702,12034,26,15,12,14
22591,1804,0,0,66,66,0,1,0,1,0
9551,10,22358,9,749,89,660,2,31,1,1
8853,10,5379,9,197,102,95,2,31,1,1
15045,10,21296,9,578,286,292,9,15,5,4
9424,26,21964,16,36958,2966,33992,48,120,18,30
12116,26,23328,16,4107,2486,1621,20,24,10,10
8890,10,20719,9,183,94,89,2,30,1,1
1631,1888,0,0,62,62,0,1,0,1,0
8362,352,4530,225,70,70,0,2,8,2,0
13890,10,1892,9,186,102,84,2,29,1,1
12,3227,0,0,131,131,0,1,0,1,0
8947,10,13269,9,194,102,92,2,29,1,1
16833,28,0,0,70,70,0,1,0,1,0
4479,15,21157,11,1143,401,742,9,360,5,4
4536,2486,0,0,159,159,0,1,0,1,0
2582,5,0,0,60,60,0,1,0,1,0
12529,2145,21860,1657,70,70,0,1,4,1,0
9424,26,20146,16,6466,2862,3604,21,163,11,10
15248,10,16779,9,183,94,89,2,30,1,1
2744,1561,12381,1192,883,126,757,2,31,1,1
10057,28,0,0,66,66,0,1,0,1,0
8477,10,18410,9,816,102,714,2,30,1,1
20993,28,0,0,70,70,0,1,0,1,0
3863,2587,0,0,62,62,0,1,0,1,0
549,3269,0,0,146,146,0,1,0,1,0
13474,2587,0,0,66,66,0,1,0,1,0
21315,28,0,0,66,66,0,1,0,1,0
12238,10,23397,9,237,98,139,2,30,1,1
22143,10,1992,9,179,94,85,2,30,1,1
20801,10,28207,9,216,90,126,2,30,1,1
9835,15,27570,11,4237,3610,627,15,31,8,7
15906,28,0,0,70,70,0,1,0,1,0
11429,2573,0,0,66,66,0,1,0,1,0
22344,10,23980,9,443,182,261,6,30,3,3
6643,15,3714,11,10597,2910,7687,24,47,14,10
398,2636,0,0,62,62,0,1,0,1,0
11163,28,0,0,70,70,0,1,0,1,0
17472,28,0,0,70,70,0,1,0,1,0
3560,26,6416,16,7298,2661,4637,21,21,11,10
14698,10,1046,9,757,98,659,2,0,1,1
11190,28,0,0,70,70,0,1,0,1,0
22616,15,16462,11,366,180,186,7,29,4,3
14100,10,17002,9,816,102,714,2,29,1,1
4593,26,16080,16,4624,1717,2907,19,27,11,8
3100,10,12986,9,241,98,143,2,30,1,1
21974,10,9042,9,227,110,117,2,30,1,1
4098,15,15293,11,7040,5744,1296,16,158,9,7
15070,10,27569,9,184,94,90,2,30,1,1
14208,10,25528,9,195,102,93,2,31,1,1
13803,308,0,0,66,66,0,1,0,1,0
20219,2154,0,0,66,66,0,1,0,1,0
5466,26,24901,16,131171,10346,120825,183,150,93,90
16747,26,19429,16,46992,4773,42219,89,160,36,53
8501,10,6105,9,184,94,90,2,30,1,1
17051,427,0,0,62,62,0,1,0,1,0
18659,28,0,0,70,70,0,1,0,1,0
9786,10,26928,9,173,94,79,2,30,1,1
8531,10,10859,9,307,307,0,4,61,4,0
9924,2709,0,0,66,66,0,1,0,1,0
15106,26,21202,16,158084,6138,151946,173,95,64,109
18365,28,0,0,70,70,0,1,0,1,0
2735,26,5690,16,6861,2224,4637,19,19,9,10
91,2938,0,0,72,72,0,1,0,1,0
20131,26,3056,16,1326,876,450,11,32,6,5
21216,28,0,0,66,66,0,1,0,1,0
21025,28,0,0,66,66,0,1,0,1,0
19360,26,22028,16,6265,1185,5080,24,89,14,10
12525,10,0,0,547,97,450,4,40,2,2
21636,10,6632,9,359,99,260,4,54,2,2
21776,2938,0,0,66,66,0,1,0,1,0
16094,26,1398,16,42986,7555,35431,69,125,29,40
10444,28,0,0,70,70,0,1,0,1,0
15199,26,14826,16,7940,1951,5989,20,16,11,9
21889,28,0,0,66,66,0,1,0,1,0
2417,10,9994,9,220,100,120,2,31,1,1
15209,26,12853,16,8654,2150,6504,20,15,11,9
1137,10,0,0,304,94,210,2,30,1,1
7171,26,14490,16,33357,26315,7042,65,273,38,27
3574,2938,0,0,74,74,0,1,0,1,0
10970,28,0,0,66,66,0,1,0,1,0
21998,26,28808,16,4559,1652,2907,19,27,11,8
13918,10,20950,9,197,94,103,2,30,1,1
20208,28,0,0,66,66,0,1,0,1,0
7091,26,15702,16,5082,969,4113,18,30,10,8
17971,28,0,0,70,70,0,1,0,1,0
9411,2501,1688,1945,132,132,0,3,1200,3,0
5518,26,16515,16,1964,1171,793,20,25,11,9
2724,1240,28771,920,422,164,258,6,30,3,3
11351,28,0,0,70,70,0,1,0,1,0
18535,392,22950,254,1370,750,620,21,329,11,10
10420,1147,0,0,66,66,0,1,0,1,0
12817,26,8927,16,3566,871,2695,11,120,5,6
12754,26,13450,16,499,425,74,4,0,3,1
3252,1888,0,0,62,62,0,1,0,1,0
19699,28,0,0,66,66,0,1,0,1,0
14451,26,19212,16,62,62,0,1,5,1,0
2798,232,24367,147,3833,1007,2826,27,68,11,16
11599,26,17442,16,46502,33690,12812,93,234,55,38
15454,10,5988,9,216,102,114,2,30,1,1
18264,28,0,0,70,70,0,1,0,1,0
636,287,2786,184,228,118,110,2,1200,1,1
13626,15,18698,11,1074,691,383,12,66,7,5
18,3216,0,0,62,62,0,1,0,1,0
18427,28,0,0,66,66,0,1,0,1,0
19471,28,0,0,66,66,0,1,0,1,0
18362,1167,0,0,62,62,0,1,0,1,0
5185,26,3517,16,5993,2348,3645,15,120,8,7
13996,28,0,0,70,70,0,1,0,1,0
2548,1396,0,0,60,60,0,1,0,1,0
9133,10,23962,9,356,105,251,4,49,2,2
16951,255,0,0,62,62,0,1,0,1,0
2744,1239,18193,919,893,126,767,2,31,1,1
14054,10,17438,9,179,94,85,2,30,1,1
2744,1240,23363,920,881,126,755,2,31,1,1
10396,3216,0,0,66,66,0,1,0,1,0
14997,10,12276,9,183,94,89,2,31,1,1
6128,10,18141,9,233,90,143,2,33,1,1
4409,26,3023,16,2866,1674,1192,14,15,8,6
2744,1243,1674,923,898,126,772,2,30,1,1
19375,26,22402,16,107901,5004,102897,127,46,53,74
1330,697,0,0,62,62,0,1,0,1,0
21197,28,0,0,70,70,0,1,0,1,0
19806,26,28287,16,11582,2503,9079,33,47,17,16
14121,10,24456,9,720,94,626,2,29,1,1
21630,10,19078,9,98,98,0,1,30,1,0
21052,3172,16511,2458,66,66,0,2,8,2,0
12936,1147,0,0,62,62,0,1,0,1,0
16021,3246,10345,2515,1577,594,983,20,1582,10,10
627,1215,0,0,62,62,0,1,0,1,0
9019,10,13364,9,170,87,83,2,30,1,1
20178,28,0,0,70,70,0,1,0,1,0
18068,26,23340,16,7165,1312,5853,22,16,12,10
15285,10,23138,9,177,94,83,2,30,1,1
16060,10,22508,9,168,78,90,2,30,1,1
15151,28,0,0,70,70,0,1,0,1,0
11181,1497,825,1138,70,70,0,2,8,2,0
9077,26,103,16,4275,2222,2053,24,15,14,10
6850,1147,0,0,62,62,0,1,0,1,0
9932,26,22458,16,144115,19017,125098,229,400,112,117
3931,6,0,0,60,60,0,1,0,1,0
9442,28,0,0,66,66,0,1,0,1,0
6956,26,23991,16,1648,813,835,17,185,9,8
4682,26,17517,16,19917,8751,11166,51,56,32,19
8829,10,29082,9,195,102,93,2,30,1,1
20415,40,25777,23,8832,3647,5185,77,41,35,42
15199,26,9654,16,8536,3817,4719,25,20,15,10
15644,10,9473,9,195,102,93,2,30,1,1
16749,255,0,0,60,60,0,1,0,1,0
9005,28,0,0,66,66,0,1,0,1,0
1454,2573,0,0,146,146,0,1,0,1,0
6668,15,12941,11,1151,711,440,10,15,5,5
12049,26,22932,16,2738,1904,834,18,28,10,8
138,15,300,11,318813,10418,308395,314,95,102,212
13383,280,9705,177,705,583,122,6,26,4,2
10103,509,0,0,66,66,0,1,0,1,0
8874,10,5932,9,185,102,83,2,30,1,1
12331,26,4944,16,5913,4482,1431,30,30,20,10
15117,28,0,0,66,66,0,1,0,1,0
8764,15,13657,11,372,192,180,7,41,4,3
7761,26,18648,16,9930,3002,6928,34,120,17,17
8768,15,6734,11,378,192,186,7,41,4,3
10397,28,0,0,66,66,0,1,0,1,0
18443,26,15858,16,24243,17180,7063,52,97,33,19
15486,10,12769,9,772,103,669,2,31,1,1
16199,3216,0,0,74,74,0,1,0,1,0
8416,28,0,0,70,70,0,1,0,1,0
16951,255,25970,160,126,62,64,2,5,1,1
6250,2001,11485,1531,156,94,62,2,30,1,1
21399,26,25023,16,1411,852,559,13,25,7,6
9671,15,7136,11,261781,16421,245360,330,156,137,193
19366,28,0,0,70,70,0,1,0,1,0
21196,28,0,0,70,70,0,1,0,1,0
10098,15,23860,11,921711,12229,909482,780,37,172,608
17847,10,18964,9,304,86,218,2,30,1,1
20389,3139,0,0,62,62,0,1,0,1,0
17832,28,0,0,66,66,0,1,0,1,0
2384,10,10817,9,219,86,133,2,30,1,1
11182,2965,17329,2301,70,70,0,2,8,2,0
46,747,0,0,60,60,0,1,0,1,0
9381,10,5508,9,242,78,164,2,30,1,1
16819,2587,0,0,66,66,0,1,0,1,0
16439,28,0,0,70,70,0,1,0,1,0
22559,10,2344,9,251,94,157,2,30,1,1
742,2486,0,0,146,146,0,1,0,1,0
22633,10,11468,9,760,97,663,2,31,1,1
21818,10,15993,9,186,95,91,2,31,1,1
9157,26,6110,16,14857,1138,13719,26,17,10,16
14962,10,23970,9,196,102,94,2,30,1,1
7556,349,610,222,78,78,0,1,4,1,0
9055,10,20293,9,199,102,97,2,30,1,1
11518,28,0,0,66,66,0,1,0,1,0
8760,10,21571,9,199,90,109,2,30,1,1
16641,26,12361,16,2484,330,2154,12,135,5,7
12523,26,18131,16,9880,1687,8193,23,15,12,11
16725,26,11335,16,31515,26798,4717,91,82,49,42
9871,1251,18585,931,269,78,191,2,31,1,1
8407,10,11927,9,198,101,97,2,30,1,1
10737,1147,0,0,66,66,0,1,0,1,0
8605,26,6103,16,9495,2281,7214,22,78,11,11
17232,15,22073,11,2424,529,1895,11,75,6,5
1330,918,0,0,62,62,0,1,0,1,0
16021,280,2147,177,755,275,480,4,1200,2,2
8401,10,9804,9,206,97,109,2,30,1,1
10670,2573,0,0,66,66,0,1,0,1,0
21819,10,27799,9,814,110,704,2,29,1,1
21662,10,20133,9,184,94,90,2,31,1,1
2724,1240,18020,920,422,164,258,6,30,3,3
18891,28,0,0,70,70,0,1,0,1,0
18294,15,21250,11,1987,1593,394,10,151,6,4
21408,10,21310,9,225,110,115,2,30,1,1
13340,28,0,0,66,66,0,1,0,1,0
11145,26,9180,16,11551,3870,7681,29,37,16,13
14621,10,17224,9,195,102,93,2,30,1,1
390,432,0,0,66,66,0,1,0,1,0
8351,10,17823,9,199,94,105,2,30,1,1
5936,15,17877,11,230861,5063,225798,227,18,74,153
14114,10,24013,9,177,94,83,2,30,1,1
22146,28,0,0,66,66,0,1,0,1,0
15162,10,2310,9,170,87,83,2,30,1,1
8759,28,0,0,70,70,0,1,0,1,0
1303,1795,0,0,60,60,0,1,0,1,0
14013,28,0,0,70,70,0,1,0,1,0
3316,1888,0,0,66,66,0,1,0,1,0
21289,26,10886,16,4196,1407,2789,19,135,9,10
7946,26,13347,16,9323,2192,7131,25,25,13,12
15800,10,12247,9,168,78,90,2,30,1,1
559,1017,0,0,62,62,0,1,0,1,0
20104,28,0,0,70,70,0,1,0,1,0
14188,10,2573,9,182,94,88,2,29,1,1
21027,28,0,0,70,70,0,1,0,1,0
3501,26,4805,16,1784,1010,774,16,185,9,7
22197,10,22651,9,734,94,640,2,29,1,1
12088,1472,0,0,66,66,0,1,0,1,0
15166,1147,0,0,66,66,0,1,0,1,0
12434,405,9411,263,1207,605,602,10,25,5,5
9728,2647,28788,2055,166,166,0,1,1200,1,0
20915,28,0,0,70,70,0,1,0,1,0
9440,15,10267,11,1515,481,1034,11,15,6,5
5192,26,16742,16,23553,2583,20970,46,103,19,27
12083,26,28284,16,1462,965,497,13,18,7,6
12751,26,22718,16,499,425,74,4,0,3,1
19323,26,9115,16,7276,1763,5513,22,77,12,10
14825,26,11202,16,9597,2488,7109,32,287,16,16
5933,26,10913,16,6332,944,5388,19,66,10,9
13735,1147,0,0,66,66,0,1,0,1,0
5276,2256,0,0,62,62,0,1,0,1,0
19812,1017,0,0,62,62,0,1,0,1,0
18105,26,16601,16,185169,75281,109888,426,111,209,217
372,2636,0,0,62,62,0,1,0,1,0
10776,1147,0,0,66,66,0,1,0,1,0
22610,1215,0,0,62,62,0,1,0,1,0
10723,40,24069,23,11462,4282,7180,61,37,28,33
13831,10,11695,9,758,93,665,2,30,1,1
1935,1147,0,0,62,62,0,1,0,1,0
17985,15,3867,11,1306,557,749,10,25,6,4
9275,26,19219,16,10557,2063,8494,40,144,22,18
15864,10,25432,9,170,87,83,2,31,1,1
14785,28,0,0,66,66,0,1,0,1,0
14206,28,0,0,70,70,0,1,0,1,0
15619,28,0,0,70,70,0,1,0,1,0
162,2938,0,0,146,146,0,1,0,1,0
12034,28,0,0,70,70,0,1,0,1,0
1824,2853,0,0,62,62,0,1,0,1,0
11891,28,0,0,70,70,0,1,0,1,0
21630,10,2139,9,193,102,91,2,30,1,1
21236,2235,0,0,145,145,0,1,0,1,0
15150,26,11706,16,75732,15030,60702,137,138,56,81
14318,10,25187,9,183,94,89,2,30,1,1
225,10,893,9,826,826,0,8,44,8,0
1874,1017,0,0,62,62,0,1,0,1,0
15391,10,9544,9,233,94,139,2,30,1,1
21267,10,16820,9,190,97,93,2,30,1,1
9728,280,28216,177,1320,300,1020,6,1200,3,3
22067,10,18480,9,192,98,94,2,31,1,1
13102,28,0,0,66,66,0,1,0,1,0
19537,26,28985,16,12613,2946,9667,38,50,18,20
20782,28,0,0,70,70,0,1,0,1,0
10948,1238,0,0,67,67,0,1,0,1,0
12663,1152,16392,850,320,140,180,6,6,3,3
7180,15,11553,11,4886,1260,3626,17,17,10,7
21260,28,0,0,70,70,0,1,0,1,0
11508,1472,0,0,66,66,0,1,0,1,0
8568,10,6578,9,185,102,83,2,31,1,1
16447,28,0,0,66,66,0,1,0,1,0
18130,28,0,0,66,66,0,1,0,1,0
17854,26,4502,16,512,166,346,2,29,1,1
22146,10,3899,9,216,94,122,2,30,1,1
16883,10,0,0,86,86,0,1,29,1,0
12,3053,0,0,74,74,0,1,0,1,0
2494,1147,0,0,62,62,0,1,0,1,0
8808,10,1205,9,302,110,192,2,30,1,1
20968,28,0,0,66,66,0,1,0,1,0
4468,465,0,0,159,159,0,1,0,1,0
16526,28,0,0,70,70,0,1,0,1,0
13731,26,24237,16,4401,1494,2907,19,30,11,8
9513,2587,0,0,66,66,0,1,0,1,0
15035,26,4136,16,3528,1162,2366,10,120,5,5
13211,28,0,0,66,66,0,1,0,1,0
13681,28,0,0,70,70,0,1,0,1,0
2127,2938,0,0,62,62,0,1,0,1,0
9104,10,12609,9,197,94,103,2,29,1,1
10238,28,0,0,66,66,0,1,0,1,0
22678,28,0,0,70,70,0,1,0,1,0
7003,2975,0,0,62,62,0,1,0,1,0
6999,2169,18598,1675,150,150,0,1,1200,1,0
12960,26,22796,16,118,118,0,1,120,1,0
225,10,15275,9,204,118,86,2,30,1,1
13636,10,25880,9,282,96,186,4,47,2,2
3097,2853,0,0,145,145,0,1,0,1,0
14666,10,8349,9,212,110,102,2,30,1,1
9852,1017,0,0,62,62,0,1,0,1,0
15050,10,19402,9,177,94,83,2,30,1,1
11719,26,7379,16,21915,3929,17986,40,31,23,17
8700,10,23384,9,168,86,82,2,30,1,1
7631,1804,0,0,66,66,0,1,0,1,0
19636,28,0,0,70,70,0,1,0,1,0
14802,1215,0,0,66,66,0,1,0,1,0
8530,10,7940,9,212,110,102,2,29,1,1
4456,1215,0,0,62,62,0,1,0,1,0
5377,697,0,0,74,74,0,1,0,1,0
19314,26,6538,16,6661,862,5799,18,28,9,9
13906,10,15353,9,183,94,89,2,30,1,1
21206,877,29102,646,66,66,0,2,8,2,0
6043,26,14453,16,6356,1857,4499,48,229,20,28
9002,10,13380,9,183,94,89,2,31,1,1
12,3146,0,0,332,332,0,1,0,1,0
5388,26,10068,16,3655,2308,1347,18,15,10,8
21609,28,0,0,70,70,0,1,0,1,0
16951,255,0,0,62,62,0,1,0,1,0
7339,140,0,0,60,60,0,1,0,1,0
10892,1339,23489,1014,70,70,0,1,5,1,0
11800,1880,0,0,66,66,0,1,0,1,0
11439,28,0,0,70,70,0,1,0,1,0
16951,255,0,0,62,62,0,1,0,1,0
1541,1771,0,0,66,66,0,1,0,1,0
13158,2883,0,0,66,66,0,1,0,1,0
2594,2883,0,0,146,146,0,1,0,1,0
9716,15,4119,11,318,192,126,6,26,4,2
9651,28,0,0,70,70,0,1,0,1,0
1480,1888,0,0,66,66,0,1,0,1,0
10544,28,0,0,66,66,0,1,0,1,0
15092,26,5765,16,5084,969,4115,18,32,10,8
15192,10,6673,9,286,94,192,2,30,1,1
1909,2829,27142,2196,481,150,331,2,1200,1,1
14105,28,0,0,70,70,0,1,0,1,0
9824,28,0,0,66,66,0,1,0,1,0
15869,10,6389,9,212,110,102,2,30,1,1
5002,26,17355,16,9299,2445,6854,25,81,14,11
14916,10,17902,9,767,102,665,2,31,1,1
21150,28,0,0,70,70,0,1,0,1,0
18675,28,0,0,70,70,0,1,0,1,0
15276,10,8776,9,211,110,101,2,30,1,1
7737,420,27853,273,179194,19657,159537,415,149,202,213
17408,28,0,0,70,70,0,1,0,1,0
13299,28,0,0,70,70,0,1,0,1,0
15088,26,15917,16,8742,2483,6259,41,114,22,19
9182,183,21773,121,3413,1458,1955,16,18,8,8
11476,26,8015,16,7165,1099,6066,16,18,9,7
22629,26,26821,16,572,320,252,10,28,6,4
13805,10,8444,9,200,102,98,2,29,1,1
16951,255,0,0,62,62,0,1,0,1,0
19266,28,0,0,70,70,0,1,0,1,0
15788,10,19957,9,168,86,82,2,30,1,1
14598,10,23604,9,182,93,89,2,30,1,1
3852,10,28553,9,168,78,90,2,30,1,1
14989,26,22807,16,16167,1392,14775,25,105,12,13
12594,10,23600,9,257,114,143,2,30,1,1
12511,3066,18455,2381,70,70,0,2,7,2,0
14258,10,10362,9,197,102,95,2,30,1,1
13191,28,0,0,70,70,0,1,0,1,0
15927,28,0,0,70,70,0,1,0,1,0
18504,255,0,0,60,60,0,1,0,1,0
22642,10,18970,9,172,88,84,2,31,1,1
22181,10,7439,9,329,118,211,2,30,1,1
8210,670,21194,471,481,150,331,2,1200,1,1
16580,28,0,0,66,66,0,1,0,1,0
14955,10,16528,9,770,102,668,2,31,1,1
15055,10,5615,9,199,102,97,2,30,1,1
22482,2587,0,0,66,66,0,1,0,1,0
15723,10,27797,9,196,94,102,2,30,1,1
12480,26,2770,16,8473,1099,7374,20,119,9,11
8599,10,16729,9,167,86,81,2,30,1,1
360,3105,0,0,1275,1275,0,1,0,1,0
22579,15,16261,11,1498,392,1106,10,16,5,5
2264,1147,0,0,66,66,0,1,0,1,0
13591,28,0,0,70,70,0,1,0,1,0
8550,10,28333,9,226,110,116,2,30,1,1
1508,1147,0,0,62,62,0,1,0,1,0
4228,360,4890,231,280,214,66,2,29,1,1
2420,10,19964,9,223,86,137,2,29,1,1
21153,2222,69,1721,66,66,0,2,7,2,0
10218,28,0,0,70,70,0,1,0,1,0
9961,26,14595,16,89322,8569,80753,102,316,31,71
22035,10,11523,9,176,90,86,2,30,1,1
16848,10,25909,9,204,92,112,2,30,1,1
15480,10,16758,9,293,102,191,2,29,1,1
21293,10,23841,9,183,94,89,2,30,1,1
12091,26,16333,16,6043,1568,4475,11,120,4,7
17417,28,0,0,70,70,0,1,0,1,0
14101,1017,0,0,146,146,0,1,0,1,0
1525,1444,0,0,145,145,0,1,0,1,0
21156,2190,27862,1695,66,66,0,2,7,2,0
3605,10,14525,9,462,158,304,4,30,2,2
15980,10,26326,9,197,102,95,2,29,1,1
13600,28,0,0,70,70,0,1,0,1,0
7949,315,0,0,60,60,0,1,0,1,0
15415,948,798,700,66,66,0,1,5,1,0
2965,2587,0,0,66,66,0,1,0,1,0
8774,15,26363,11,145752,3240,142512,128,61,23,105
10115,28,0,0,70,70,0,1,0,1,0
15130,28,0,0,70,70,0,1,0,1,0
9782,26,27749,16,14401,2712,11689,52,19,23,29
225,10,20033,9,204,118,86,2,31,1,1
2744,554,23827,370,898,126,772,2,30,1,1
15018,10,16370,9,196,100,96,2,31,1,1
13891,10,10510,9,193,102,91,2,30,1,1
19006,3216,0,0,66,66,0,1,0,1,0
9434,28,0,0,66,66,0,1,0,1,0
9658,26,10093,16,11554,3028,8526,34,86,19,15
4509,26,19682,16,1835,1190,645,17,26,10,7
8397,26,21378,16,123041,10988,112053,185,67,86,99
11335,26,6013,16,24304,2974,21330,57,34,31,26
14499,10,18570,9,164,84,80,2,31,1,1
22516,10,8480,9,193,102,91,2,30,1,1
14602,10,6419,9,182,94,88,2,29,1,1
9570,28,0,0,66,66,0,1,0,1,0
7172,15,20296,11,806,463,343,9,15,6,3
8769,10,28842,9,733,94,639,2,30,1,1
10925,28,0,0,70,70,0,1,0,1,0
640,497,0,0,146,146,0,1,0,1,0
18274,26,24112,16,8894,1633,7261,18,15,9,9
13945,10,28470,9,711,87,624,2,30,1,1
10401,1888,0,0,62,62,0,1,0,1,0
21361,26,28490,16,79107,10743,68364,96,172,42,54
1666,1804,0,0,66,66,0,1,0,1,0
16485,26,1066,16,1312,651,661,13,185,7,6
5701,1054,0,0,66,66,0,1,0,1,0
85,2587,0,0,66,66,0,1,0,1,0
21301,2938,0,0,66,66,0,1,0,1,0
9273,6,21822,6,184,120,64,4,10,3,1
21085,843,17252,621,66,66,0,2,8,2,0
14828,10,5808,9,180,94,86,2,30,1,1
22497,10,11864,9,94,94,0,1,29,1,0
20753,10,0,0,75,75,0,1,0,1,0
9634,28,0,0,66,66,0,1,0,1,0
15507,10,18310,9,216,110,106,2,31,1,1
6840,15,17391,11,2982,2565,417,12,15,7,5
19852,28,0,0,70,70,0,1,0,1,0
21478,10,4613,9,182,93,89,2,30,1,1
18461,2379,0,0,74,74,0,1,0,1,0
18981,28,0,0,70,70,0,1,0,1,0
18727,26,19800,16,24145,5933,18212,55,549,27,28
6626,26,23032,16,9685,2330,7355,23,15,12,11
21834,1147,0,0,62,62,0,1,0,1,0
16951,255,0,0,62,62,0,1,0,1,0
21283,2460,13681,1912,70,70,0,1,4,1,0
15524,10,3720,9,199,102,97,2,30,1,1
13227,28,0,0,66,66,0,1,0,1,0
2239,2256,0,0,146,146,0,1,0,1,0
12053,26,19356,16,38442,16213,22229,67,46,30,37
6803,26,12051,16,6235,1562,4673,21,191,12,9
17906,26,2028,16,6695,2021,4674,23,45,11,12
22686,10,24525,9,197,102,95,2,29,1,1
9277,10,1808,9,152,78,74,2,30,1,1
7091,26,15267,16,2227,1018,1209,17,16,8,9
18463,2887,11879,2242,70,70,0,2,8,2,0
8787,26,24497,16,46983,4167,42816,66,44,28,38
11669,15,2021,11,23509,14666,8843,70,553,38,32
615,23,0,0,82,82,0,1,0,1,0
9348,3216,0,0,62,62,0,1,0,1,0
12584,450,18990,289,320,140,180,6,5,3,3
18040,28,0,0,70,70,0,1,0,1,0
7260,26,22577,16,55844,3452,52392,85,255,38,47
13862,28,0,0,70,70,0,1,0,1,0
14859,26,24842,16,4550,1643,2907,19,28,11,8
18541,1147,0,0,66,66,0,1,0,1,0
19258,3216,0,0,62,62,0,1,0,1,0
3876,1923,0,0,62,62,0,1,0,1,0
8654,10,12120,9,194,102,92,2,31,1,1
14838,28,0,0,70,70,0,1,0,1,0
14915,10,7352,9,199,102,97,2,30,1,1
7499,10,11725,9,199,94,105,2,30,1,1
8985,10,12496,9,193,102,91,2,31,1,1
20094,10,18790,9,429,102,327,2,31,1,1
14737,10,22164,9,177,94,83,2,30,1,1
6229,2938,0,0,78,78,0,1,0,1,0
10668,15,1583,11,502,256,246,9,39,5,4
17,2794,0,0,66,66,0,1,90,1,0
4394,15,7946,11,1792,703,1089,12,16,7,5
16975,28,0,0,70,70,0,1,0,1,0
10503,26,15581,16,70,70,0,1,5,1,0
16431,10,25661,9,371,237,134,3,32,2,1
19456,28,0,0,66,66,0,1,0,1,0
9015,15,3730,11,11936,2198,9738,22,88,9,13
11222,26,17781,16,13948,1150,12798,29,15,14,15
13460,10,0,0,86,86,0,1,30,1,0
8852,2256,0,0,66,66,0,1,0,1,0
1157,10,3956,9,235,90,145,2,32,1,1
14482,10,0,0,86,86,0,1,30,1,0
22203,10,16883,9,177,94,83,2,29,1,1
12400,28,0,0,66,66,0,1,0,1,0
21275,26,7859,16,122293139,3727246,118565893,125460,331,39649,85811
2477,1968,0,0,60,60,0,1,0,1,0
16638,28,0,0,70,70,0,1,0,1,0
16021,457,21564,295,924,924,0,15,1200,15,0
12135,26,14736,16,30174,2792,27382,47,323,19,28
11245,15,26542,11,1009,506,503,10,16,5,5
15327,26,16315,16,8007,1987,6020,20,15,11,9
16060,28,0,0,70,70,0,1,0,1,0
21387,10,13721,9,281,94,187,2,30,1,1
225,10,7807,9,204,118,86,2,30,1,1
16658,26,16389,16,4192,2267,1925,12,120,6,6
13687,10,16064,9,182,94,88,2,31,1,1
557,1215,0,0,62,62,0,1,0,1,0
4944,1880,0,0,62,62,0,1,0,1,0
2341,1147,0,0,62,62,0,1,0,1,0
20537,26,10142,16,12008,2367,9641,32,151,18,14
19162,28,0,0,70,70,0,1,0,1,0
8985,28,0,0,70,70,0,1,0,1,0
13877,26,10703,16,10684454,328574,10355880,11599,77,3693,7906
18445,28,0,0,70,70,0,1,0,1,0
13697,2938,0,0,78,78,0,1,0,1,0
14333,10,5795,9,209,110,99,2,30,1,1
9698,26,16076,16,7343,1707,5636,26,134,14,12
22449,10,21078,9,198,101,97,2,30,1,1
523,983,0,0,66,66,0,1,0,1,0
20523,26,24733,16,384,166,218,2,30,1,1
12564,3254,28418,2522,70,70,0,1,5,1,0
12208,26,20014,16,3701,1232,2469,13,136,6,7
9112,10,13575,9,755,102,653,2,30,1,1
3887,15,3412,11,1150,465,685,14,268,5,9
8531,10,27113,9,779,86,693,2,30,1,1
6862,1215,0,0,62,62,0,1,0,1,0
14555,10,21619,9,177,94,83,2,31,1,1
12244,28,0,0,66,66,0,1,0,1,0
8401,10,24714,9,177,94,83,2,30,1,1
10020,28,0,0,70,70,0,1,0,1,0
10301,697,0,0,66,66,0,1,0,1,0
20501,28,0,0,66,66,0,1,0,1,0
2470,26,10270,16,5198,2221,2977,19,16,10,9
9788,26,10231,16,1514,852,662,16,86,9,7
17013,15,3422,11,4176,3453,723,14,15,7,7
3609,15,24754,11,1951,731,1220,11,150,6,5
16951,255,0,0,62,62,0,1,0,1,0
3101,2382,0,0,62,62,0,1,0,1,0
9468,15,25568,11,2074,793,1281,11,48,6,5
9326,28,0,0,70,70,0,1,0,1,0
215,2573,0,0,145,145,0,1,0,1,0
11122,15,29048,11,3163,716,2447,12,28,7,5
8407,26,21387,16,8448,3368,5080,25,48,15,10
8617,26,27239,16,12802,1977,10825,32,25,14,18
16592,921,0,0,60,60,0,1,0,1,0
20722,28,0,0,70,70,0,1,0,1,0
15524,10,10443,9,198,101,97,2,31,1,1
17003,15,5609,11,2424,529,1895,11,75,6,5
14076,10,4631,9,177,94,83,2,30,1,1
17173,26,19986,16,5166,700,4466,16,15,7,9
10598,26,20854,16,4263,671,3592,14,75,8,6
844,2486,0,0,146,146,0,1,0,1,0
13414,10,7623,9,236,86,150,2,30,1,1
14666,10,5645,9,184,102,82,2,30,1,1
210,295,481,190,3374,1535,1839,16,15,8,8
18235,1215,0,0,62,62,0,1,0,1,0
13489,26,7419,16,18814,10011,8803,42,129,21,21
19194,28,0,0,70,70,0,1,0,1,0
22358,10,5244,9,196,94,102,2,30,1,1
22138,10,8714,9,166,86,80,2,31,1,1
9025,15,25226,11,4892,1157,3735,16,89,8,8
9480,28,0,0,66,66,0,1,0,1,0
14233,1311,16500,988,130,70,60,3,5,2,1
18479,28,0,0,66,66,0,1,0,1,0
17731,10,27419,9,256,102,154,2,29,1,1
17982,28,0,0,66,66,0,1,0,1,0
17329,1771,0,0,66,66,0,1,0,1,0
15006,10,18320,9,166,86,80,2,30,1,1
13271,26,23695,16,8413,2503,5910,23,16,13,10
9243,1224,0,0,62,62,0,1,0,1,0
15734,10,4347,9,196,102,94,2,31,1,1
21945,10,26364,9,192,98,94,2,30,1,1
11360,28,0,0,66,66,0,1,0,1,0
20136,1147,0,0,146,146,0,1,0,1,0
664,1147,0,0,66,66,0,1,0,1,0
8565,10,6366,9,775,102,673,2,30,1,1
22676,26,22483,16,3641,886,2755,13,136,6,7
636,280,16116,177,259,150,109,2,1200,1,1
16732,10,25848,9,847,110,737,2,30,1,1
4891,26,22306,16,8884,4067,4817,24,19,11,13
11741,28,0,0,66,66,0,1,0,1,0
12652,26,17659,16,2966,801,2165,13,135,6,7
11214,1017,0,0,66,66,0,1,0,1,0
14925,10,20167,9,177,94,83,2,30,1,1
9622,2636,0,0,62,62,0,1,0,1,0
9766,28,0,0,66,66,0,1,0,1,0
22397,10,18974,9,181,94,87,2,29,1,1
9887,26,9279,16,6854,1380,5474,18,161,9,9
8531,10,7168,9,307,307,0,4,60,4,0
12791,1232,5074,912,70,70,0,2,8,2,0
6807,7,0,0,60,60,0,1,0,1,0
21560,10,17681,9,1054,293,761,8,94,4,4
17228,26,26451,16,6548,4210,2338,23,18,12,11
10118,28,0,0,66,66,0,1,0,1,0
20182,2953,0,0,66,66,0,1,0,1,0
21586,10,10272,9,374,96,278,4,55,2,2
8368,26,9609,16,13738,6378,7360,70,981,33,37
8614,26,14642,16,1574,921,653,14,15,7,7
19616,28,0,0,66,66,0,1,0,1,0
8464,26,20780,16,5341,3636,1705,30,76,16,14
20818,28,0,0,66,66,0,1,0,1,0
17229,28,0,0,70,70,0,1,0,1,0
21942,10,1797,9,718,94,624,2,30,1,1
13578,28,0,0,70,70,0,1,0,1,0
15421,1223,5092,904,70,70,0,2,8,2,0
2430,2938,0,0,62,62,0,1,0,1,0
15048,10,24034,9,198,102,96,2,31,1,1
13962,10,8633,9,178,94,84,2,30,1,1
16839,1883,0,0,146,146,0,1,0,1,0
14925,26,14903,16,350,210,140,6,27,4,2
13679,10,9369,9,183,94,89,2,30,1,1
9491,10,3482,9,756,95,661,2,30,1,1
14921,28,0,0,70,70,0,1,0,1,0
22430,10,9924,9,200,102,98,2,31,1,1
12549,28,0,0,70,70,0,1,0,1,0
15575,10,16741,9,731,85,646,2,30,1,1
11024,1162,5196,858,66,66,0,1,5,1,0
2744,1238,22444,918,884,126,758,2,30,1,1
11724,26,11645,16,1942,1281,661,22,228,16,6
12185,26,23367,16,4406,1499,2907,19,30,11,8
15394,26,26582,16,79878,10479,69399,138,120,68,70
11571,833,23051,612,66,66,0,1,5,1,0
16727,178,0,0,60,60,0,1,0,1,0
13730,10,21467,9,394,94,300,2,30,1,1
14728,10,1938,9,183,94,89,2,29,1,1
9043,15,505,11,2087,1215,872,8,88,5,3
22696,10,20633,9,167,86,81,2,30,1,1
10763,28,0,0,70,70,0,1,0,1,0
19842,1771,0,0,66,66,0,1,0,1,0
16951,255,0,0,62,62,0,1,0,1,0
18458,26,23529,16,10672,1729,8943,24,81,12,12
13937,28,0,0,70,70,0,1,0,1,0
2468,10,10263,9,209,77,132,2,33,1,1
16021,280,28725,177,577,251,326,4,1200,2,2
21912,10,4942,9,534,193,341,6,78,3,3
16605,28,0,0,70,70,0,1,0,1,0
1525,1444,0,0,145,145,0,1,0,1,0
11023,2830,11727,2197,316,136,180,6,7,3,3
12119,28,0,0,70,70,0,1,0,1,0
14575,2953,0,0,62,62,0,1,0,1,0
17496,15,26275,11,94514,14468,80046,152,15,41,111
19131,26,5424,16,4862,1820,3042,14,120,7,7
9875,28,0,0,70,70,0,1,0,1,0
14534,10,2154,9,711,87,624,2,31,1,1
17906,26,12643,16,103556,8767,94789,144,48,75,69
8584,1454,28731,1107,242,71,171,2,30,1,1
9518,26,10711,16,4749,859,3890,18,30,9,9
8700,15,13323,11,1702,611,1091,8,30,4,4
799,15,3288,11,572,240,332,10,84,5,5
18677,28,0,0,70,70,0,1,0,1,0
21327,10,5850,9,430,172,258,6,60,3,3
5815,255,0,0,60,60,0,1,0,1,0
12799,3090,5589,2400,552,306,246,9,14,5,4
10956,15,27710,11,36720,3404,33316,51,25,22,29
14675,26,25094,16,5640,3241,2399,22,120,11,11
9706,10,22042,9,216,82,134,2,32,1,1
22498,10,13592,9,195,102,93,2,29,1,1
11566,1147,0,0,66,66,0,1,0,1,0
9379,26,10257,16,7292,950,6342,19,75,9,10
10475,6,0,0,60,60,0,1,0,1,0
14094,10,5049,9,177,94,83,2,30,1,1
21844,28,0,0,70,70,0,1,0,1,0
15818,28,0,0,70,70,0,1,0,1,0
22702,10,6183,9,195,102,93,2,31,1,1
9804,28,0,0,66,66,0,1,0,1,0
9141,2938,0,0,62,62,0,1,0,1,0
12029,2575,18055,1997,320,140,180,6,6,3,3
19762,26,26406,16,5017,1969,3048,14,136,7,7
9696,28,0,0,66,66,0,1,0,1,0
12717,28,0,0,66,66,0,1,0,1,0
20059,2587,0,0,66,66,0,1,0,1,0
17764,26,13306,16,5682,1565,4117,23,66,13,10
21391,10,26550,9,177,94,83,2,31,1,1
7627,1147,0,0,146,146,0,1,0,1,0
13130,26,12291,16,9976,3230,6746,22,58,13,9
9994,26,10566,16,1501,590,911,12,26,6,6
7715,676,9839,475,138,78,60,2,6,1,1
15172,10,22371,9,711,87,624,2,30,1,1
562,10,2108,9,231,90,141,2,31,1,1
11220,26,26633,16,570322,21029,549293,569,46,181,388
7413,15,3626,11,3711,1806,1905,17,186,10,7
2206,2938,0,0,74,74,0,1,0,1,0
7335,1072,0,0,60,60,0,1,0,1,0
15920,28,0,0,70,70,0,1,0,1,0
22257,10,24168,9,754,94,660,2,31,1,1
10104,15,7961,11,24781,3304,21477,43,21,24,19
1225,15,4035,11,450,246,204,8,24,5,3
13352,1202,0,0,145,145,0,1,0,1,0
8584,1240,5175,920,283,71,212,2,31,1,1
15144,10,19558,9,211,110,101,2,30,1,1
10471,26,107,16,619870,220857,399013,1045,123,531,514
9042,26,23129,16,5997,978,5019,19,53,10,9
15567,28,0,0,66,66,0,1,0,1,0
8982,26,8543,16,4504,839,3665,16,125,8,8
7003,2975,0,0,146,146,0,1,0,1,0
13655,28,0,0,70,70,0,1,0,1,0
12300,28,0,0,66,66,0,1,0,1,0
8677,26,21528,16,150713,27113,123600,199,82,104,95
12501,28,0,0,70,70,0,1,0,1,0
15592,10,23880,9,193,102,91,2,30,1,1
15151,10,22126,9,732,89,643,2,31,1,1
4419,10,19242,9,243,86,157,2,30,1,1
12317,26,15172,16,7866,2625,5241,25,120,11,14
7335,1070,0,0,60,60,0,1,0,1,0
16164,15,25494,11,147506,3521,143985,125,32,23,102
16021,1519,5752,1157,132,132,0,3,1199,3,0
6250,2005,3896,1535,212,90,122,4,30,2,2
13774,10,25371,9,170,87,83,2,31,1,1
757,2587,0,0,66,66,0,1,0,1,0
10798,3120,7649,2422,70,70,0,2,8,2,0
16224,28,0,0,70,70,0,1,0,1,0
15535,10,17578,9,177,94,83,2,31,1,1
8777,10,10066,9,177,94,83,2,30,1,1
16951,255,0,0,62,62,0,1,0,1,0
1133,2938,0,0,78,78,0,1,0,1,0
6975,1017,0,0,62,62,0,1,0,1,0
5591,26,23358,16,5360,4048,1312,22,265,11,11
2251,26,9233,16,10793,2049,8744,23,30,14,9
20345,2883,0,0,62,62,0,1,0,1,0
14916,10,8104,9,177,94,83,2,30,1,1
3659,3,0,0,60,60,0,1,0,1,0
11518,2953,0,0,62,62,0,1,0,1,0
19,2360,0,0,145,145,0,1,0,1,0
12684,28,0,0,70,70,0,1,0,1,0
13567,28,0,0,70,70,0,1,0,1,0
2407,1215,0,0,62,62,0,1,0,1,0
8088,26,2110,16,9157,3805,5352,39,100,18,21
9855,15,25034,11,708,384,324,12,195,7,5
8342,10,4761,9,193,102,91,2,29,1,1
15032,1888,0,0,66,66,0,1,0,1,0
1150,1017,0,0,66,66,0,1,0,1,0
2744,1299,6021,977,868,126,742,2,31,1,1
14796,10,20879,9,711,87,624,2,30,1,1
15199,26,20123,16,12807,129,12678,13,147,2,11
22677,10,1686,9,232,110,122,2,29,1,1
8938,15,10706,11,1155,781,374,10,15,6,4
2525,7,0,0,60,60,0,1,0,1,0
14238,1068,9751,787,70,70,0,2,8,2,0
14432,28,0,0,66,66,0,1,0,1,0
12561,3139,0,0,146,146,0,1,0,1,0
21535,1215,0,0,66,66,0,1,0,1,0
19167,26,4937,16,1775,169,1606,7,120,3,4
21260,10,21246,9,225,102,123,2,30,1,1
18754,28,0,0,70,70,0,1,0,1,0
34,2486,0,0,136,136,0,1,0,1,0
16951,255,0,0,62,62,0,1,0,1,0
2744,1240,22510,920,901,126,775,2,30,1,1
10125,26,3375,16,3536,2039,1497,22,18,11,11
14575,1771,0,0,66,66,0,1,0,1,0
14184,1017,0,0,146,146,0,1,0,1,0
12473,28,0,0,70,70,0,1,0,1,0
12291,264,16394,165,245,245,0,2,30,2,0
12053,28,0,0,66,66,0,1,0,1,0
10861,1201,14024,889,70,70,0,2,6,2,0
12,3227,0,0,131,131,0,1,0,1,0
21149,15,16008,11,314,192,122,6,15,4,2
4807,1017,0,0,66,66,0,1,0,1,0
13720,15,25488,11,2554,1742,812,15,77,8,7
14402,10,4441,9,272,110,162,2,29,1,1
9855,15,7883,11,1658,1247,411,8,15,5,3
18801,1989,20734,1519,316,136,180,6,5,3,3
21261,10,28200,9,198,101,97,2,30,1,1
11510,28,0,0,66,66,0,1,0,1,0
5810,26,17317,16,12243,6818,5425,30,314,16,14
11013,1489,9829,1131,70,70,0,2,8,2,0
21654,10,7676,9,232,110,122,2,29,1,1
19666,15,23054,11,9747,537,9210,14,16,6,8
15034,28,0,0,66,66,0,1,0,1,0
12613,26,8266,16,499,425,74,4,0,3,1
15694,333,0,0,145,145,0,1,0,1,0
360,3105,0,0,1109,1109,0,1,0,1,0
10905,26,20861,16,1852,1103,749,16,31,9,7
11308,28,0,0,66,66,0,1,0,1,0
6649,697,0,0,74,74,0,1,0,1,0
16135,28,0,0,70,70,0,1,0,1,0
7690,2235,0,0,62,62,0,1,0,1,0
11729,2883,0,0,62,62,0,1,0,1,0
20550,10,8904,9,304,86,218,2,30,1,1
11291,2457,6343,1909,70,70,0,2,8,2,0
19958,28,0,0,66,66,0,1,0,1,0
19486,1888,0,0,66,66,0,1,0,1,0
9531,346,21940,220,7241,3224,4017,23,61,14,9
11065,15,27215,11,4185,3462,723,14,15,7,7
7335,1070,0,0,60,60,0,1,0,1,0
15967,10,13728,9,196,102,94,2,29,1,1
20389,26,28995,16,8097,2684,5413,22,248,12,10
14487,28,0,0,70,70,0,1,0,1,0
8377,10,14515,9,410,93,317,4,30,2,2
9695,15,22036,11,4780,1925,2855,16,22,8,8
9411,1679,6083,1284,132,132,0,3,1200,3,0
8863,10,19019,9,195,94,101,2,30,1,1
11596,280,11608,177,719,413,306,10,14,5,5
11637,983,0,0,66,66,0,1,0,1,0
8854,26,19207,16,318,192,126,6,53,4,2
11566,1147,0,0,66,66,0,1,0,1,0
13470,28,0,0,66,66,0,1,0,1,0
22271,10,26564,9,340,94,246,2,30,1,1
8773,1147,0,0,66,66,0,1,0,1,0
21284,10,14215,9,226,102,124,2,30,1,1
4729,233,18379,148,142,142,0,1,5,1,0
11597,2930,0,0,62,62,0,1,0,1,0
3772,26,16115,16,11771,2624,9147,50,20,25,25
9072,28,0,0,66,66,0,1,0,1,0
8942,26,14436,16,214,140,74,4,15,3,1
2726,1215,0,0,62,62,0,1,0,1,0
7707,697,0,0,146,146,0,1,0,1,0
3003,295,12354,190,4731,2270,2461,18,15,10,8
15636,26,5485,16,556770,88286,468484,777,202,314,463
10945,1751,1455,1337,316,136,180,6,6,3,3
9530,346,21939,220,5533,2632,2901,20,46,12,8
13608,26,10191,16,469752,21060,448692,589,64,265,324
22705,10,1397,9,290,94,196,4,41,2,2
18666,3216,0,0,62,62,0,1,0,1,0
17653,28,0,0,70,70,0,1,0,1,0
15138,10,18467,9,183,94,89,2,30,1,1
11244,1325,5057,1001,70,70,0,2,6,2,0
8480,10,12766,9,199,102,97,2,30,1,1
21517,10,1920,9,334,94,240,2,31,1,1
15330,10,15929,9,184,94,90,2,31,1,1
2724,1240,24143,920,758,328,430,10,30,5,5
19925,28,0,0,66,66,0,1,0,1,0
20134,28,0,0,70,70,0,1,0,1,0
15479,2587,0,0,146,146,0,1,0,1,0
8584,1239,1224,919,242,78,164,2,30,1,1
9958,26,9654,16,1663508,63528,1599980,1853,251,692,1161
6890,1086,0,0,66,66,0,1,0,1,0
19051,18,17849,13,184,94,90,2,30,1,1
8584,1238,4614,918,248,78,170,2,30,1,1
9054,26,6379,16,5597,1462,4135,21,86,11,10
15384,10,16181,9,167,86,81,2,30,1,1
17575,2636,0,0,62,62,0,1,0,1,0
9344,10,7589,9,770,101,669,2,30,1,1
17213,26,21046,16,5264,3357,1907,21,17,11,10
21855,10,23597,9,305,101,204,4,44,2,2
22702,10,10482,9,178,94,84,2,30,1,1
10188,15,10158,11,254,128,126,5,15,3,2
8614,10,16794,9,195,94,101,2,30,1,1
15569,15,11800,11,214,140,74,4,35,3,1
17071,15,27078,11,3312,1569,1743,12,135,7,5
6010,26,593,16,2227,1018,1209,17,15,8,9
14262,10,26834,9,204,104,100,2,31,1,1
10005,26,22731,16,350,210,140,6,26,4,2
543,1771,0,0,66,66,0,1,0,1,0
20303,28,0,0,70,70,0,1,0,1,0
1499,1147,0,0,146,146,0,1,0,1,0
1821,2256,0,0,146,146,0,1,0,1,0
13238,1880,0,0,66,66,0,1,0,1,0
8681,15,7405,11,5101,2867,2234,15,38,8,7
22307,10,27415,9,402,118,284,2,30,1,1
19230,28,0,0,66,66,0,1,0,1,0
8932,28,0,0,70,70,0,1,0,1,0
8794,10,21108,9,168,86,82,2,31,1,1
14228,6,0,0,60,60,0,1,0,1,0
3289,7,0,0,60,60,0,1,0,1,0
11234,28,0,0,70,70,0,1,0,1,0
7224,10,13078,9,168,78,90,2,30,1,1
8767,10,12759,9,88,88,0,1,31,1,0
16951,255,0,0,62,62,0,1,0,1,0
15539,1771,0,0,66,66,0,1,0,1,0
13608,28,0,0,66,66,0,1,0,1,0
10818,1788,22972,1365,70,70,0,2,8,2,0
17422,28,0,0,70,70,0,1,0,1,0
3668,15,4122,11,672,300,372,12,30,6,6
10237,28,0,0,66,66,0,1,0,1,0
10452,26,20711,16,4209,1570,2639,14,136,7,7
8606,26,26539,16,5141,896,4245,17,69,8,9
7326,180,0,0,60,60,0,1,0,1,0
14064,10,12050,9,772,103,669,2,30,1,1
2301,1946,0,0,60,60,0,1,0,1,0
15970,26,17376,16,103144,2997,100147,114,16,36,78
9966,15,3139,11,35970,11674,24296,108,265,55,53
5046,26,16600,16,225915,9896,216019,283,80,128,155
15534,15,11033,11,5885,3796,2089,16,30,10,6
12532,758,948,546,320,140,180,6,6,3,3
9643,15,18706,11,318,192,126,6,25,4,2
12308,26,11990,16,26693,2059,24634,42,30,18,24
15243,15,1977,11,234,234,0,4,12,4,0
13989,28,0,0,66,66,0,1,0,1,0
126,7,0,0,60,60,0,1,0,1,0
4358,233,19990,148,4336,1518,2818,23,3005,14,9
15952,26,21475,16,362,302,60,2,5,1,1
22577,10,20063,9,168,86,82,2,29,1,1
13969,10,1456,9,216,102,114,2,30,1,1
10532,1147,0,0,66,66,0,1,0,1,0
17632,28,0,0,70,70,0,1,0,1,0
13805,10,25401,9,168,86,82,2,30,1,1
18025,28,0,0,66,66,0,1,0,1,0
70,847,0,0,146,146,0,1,0,1,0
13432,1017,0,0,62,62,0,1,0,1,0
16318,28,0,0,70,70,0,1,0,1,0
19871,1017,0,0,66,66,0,1,0,1,0
22121,10,22280,9,304,94,210,2,30,1,1
14593,1215,0,0,66,66,0,1,0,1,0
7626,2604,0,0,146,146,0,1,0,1,0
99,1462,0,0,62,62,0,1,0,1,0
10153,28,0,0,70,70,0,1,0,1,0
13465,2587,0,0,62,62,0,1,0,1,0
8652,10,14419,9,170,87,83,2,31,1,1
16951,255,0,0,62,62,0,1,0,1,0
19682,28,0,0,70,70,0,1,0,1,0
10410,28,0,0,70,70,0,1,0,1,0
15814,10,17747,9,173,94,79,2,29,1,1
16847,26,14888,16,1638,829,809,18,43,10,8
9028,26,5486,16,5930,910,5020,18,56,9,9
21828,28,0,0,66,66,0,1,0,1,0
14430,10,23605,9,730,102,628,2,30,1,1
22369,3139,0,0,66,66,0,1,0,1,0
18767,2144,0,0,66,66,0,1,0,1,0
19735,10,4424,9,222,94,128,2,30,1,1
22332,10,26867,9,718,94,624,2,30,1,1
15953,10,18342,9,256,93,163,2,31,1,1
22337,10,1661,9,168,86,82,2,30,1,1
11880,28,0,0,70,70,0,1,0,1,0
9035,28,0,0,70,70,0,1,0,1,0
1288,1397,0,0,62,62,0,1,0,1,0
14281,10,23103,9,94,94,0,1,29,1,0
20200,28,0,0,70,70,0,1,0,1,0
1474,2938,0,0,145,145,0,1,0,1,0
22210,10,4665,9,757,98,659,2,31,1,1
22676,10,455,9,210,110,100,2,29,1,1
17568,2256,0,0,62,62,0,1,0,1,0
13582,28,0,0,66,66,0,1,0,1,0
12704,10,0,0,181,86,95,2,30,1,1
15610,10,13456,9,194,102,92,2,30,1,1
15533,10,8721,9,196,102,94,2,31,1,1
13733,10,4814,9,173,94,79,2,29,1,1
14130,10,11660,9,210,110,100,2,30,1,1
9,18,5478,13,184,94,90,2,29,1,1
14172,10,2032,9,170,87,83,2,30,1,1
18299,28,0,0,66,66,0,1,0,1,0
9582,183,21974,121,3429,1474,1955,16,16,8,8
9908,2938,0,0,66,66,0,1,0,1,0
7604,15,2318,11,2066,1369,697,13,84,7,6
9634,15,22409,11,318,192,126,6,25,4,2
13361,1804,0,0,66,66,0,1,0,1,0
14334,10,27403,9,209,110,99,2,30,1,1
12,2568,0,0,331,331,0,1,0,1,0
10910,342,13853,218,86,86,0,1,30,1,0
9708,28,0,0,70,70,0,1,0,1,0
15279,15,11080,11,1146417,29701,1116716,1218,54,422,796
3060,1888,0,0,72,72,0,1,0,1,0
18653,28,0,0,66,66,0,1,0,1,0
2956,183,12121,121,3910,1805,2105,20,19,12,8
9751,26,17187,16,25263,2606,22657,41,90,19,22
6669,26,18889,16,4683,1776,2907,19,29,11,8
15774,28,0,0,70,70,0,1,0,1,0
15859,26,24596,16,5614,733,4881,16,15,9,7
12583,1096,12183,804,70,70,0,2,8,2,0
2744,1240,2639,920,877,126,751,3,31,2,1
8971,10,28063,9,242,118,124,2,30,1,1
7690,2235,0,0,62,62,0,1,0,1,0
11607,28,0,0,70,70,0,1,0,1,0
11075,767,3548,555,66,66,0,1,5,1,0
14041,28,0,0,70,70,0,1,0,1,0
11250,6,22847,6,8248,3445,4803,57,38,26,31
13649,28,0,0,70,70,0,1,0,1,0
9774,10,4850,9,209,110,99,2,29,1,1
14106,28,0,0,70,70,0,1,0,1,0
1281,2543,0,0,60,60,0,1,0,1,0
18439,26,17251,16,6608,1843,4765,44,120,23,21
14156,10,9808,9,212,108,104,2,31,1,1
13972,10,7377,9,199,102,97,2,31,1,1
17621,26,12635,16,12756,3596,9160,31,299,16,15
2484,1147,0,0,146,146,0,1,0,1,0
21139,28,0,0,70,70,0,1,0,1,0
5933,26,2864,16,153,93,60,2,5,1,1
9371,28,0,0,70,70,0,1,0,1,0
22525,2883,0,0,66,66,0,1,0,1,0
8794,1771,0,0,66,66,0,1,0,1,0
16011,18,10396,13,184,94,90,2,29,1,1
22117,10,27024,9,198,101,97,2,31,1,1
8428,15,1871,11,3802643,113349,3689294,3463,206,982,2481
17751,28,0,0,70,70,0,1,0,1,0
22305,10,9476,9,199,102,97,2,31,1,1
17350,2938,0,0,74,74,0,1,0,1,0
17898,26,9770,16,546,180,366,10,28,4,6
5823,15,20443,11,1052,612,440,10,15,5,5
20686,28,0,0,70,70,0,1,0,1,0
21962,10,22524,9,757,98,659,2,0,1,1
11246,28,0,0,70,70,0,1,0,1,0
21375,28,0,0,70,70,0,1,0,1,0
21518,10,21982,9,168,86,82,2,31,1,1
3168,1888,0,0,62,62,0,1,0,1,0
16951,255,0,0,62,62,0,1,0,1,0
8584,1238,20781,918,214,71,143,2,30,1,1
10910,26,14772,16,4358,1056,3302,16,30,9,7
9273,6,21822,6,152,66,86,2,9,1,1
19602,2550,0,0,66,66,0,1,0,1,0
19,2587,0,0,62,62,0,1,0,1,0
16951,255,0,0,62,62,0,1,0,1,0
14851,10,21451,9,701,88,613,2,30,1,1
15493,10,21060,9,184,78,106,2,30,1,1
21476,28,0,0,66,66,0,1,0,1,0
14115,10,9857,9,184,94,90,2,31,1,1
6389,26,2276,16,4353,687,3666,14,25,8,6
22086,10,11274,9,380,110,270,2,30,1,1
13570,28,0,0,66,66,0,1,0,1,0
22637,10,4476,9,168,86,82,2,30,1,1
16030,2883,0,0,66,66,0,1,0,1,0
2308,3216,0,0,62,62,0,1,0,1,0
7540,2938,0,0,66,66,0,1,0,1,0
5670,1147,0,0,66,66,0,1,0,1,0
15826,28,0,0,70,70,0,1,0,1,0
3183,1771,0,0,62,62,0,1,0,1,0
3700,10,23364,9,168,78,90,2,29,1,1
1252,3216,0,0,62,62,0,1,0,1,0
15136,10,21049,9,198,102,96,2,30,1,1
4986,15,22985,11,52105,1615,50490,61,18,24,37
21582,10,28587,9,243,100,143,2,30,1,1
3005,1771,0,0,62,62,0,1,0,1,0
8749,28,0,0,66,66,0,1,0,1,0
10860,26,22677,16,17899,5015,12884,33,36,14,19
9843,28,0,0,70,70,0,1,0,1,0
978,1888,0,0,62,62,0,1,0,1,0
19872,1086,0,0,66,66,0,1,0,1,0
10478,28,0,0,70,70,0,1,0,1,0
9238,26,11474,16,20880,7976,12904,41,47,22,19
20997,28,0,0,70,70,0,1,0,1,0
12933,263,0,0,66,66,0,1,0,1,0
21503,10,1135,9,180,94,86,2,30,1,1
14732,10,9653,9,177,94,83,2,30,1,1
21921,28,0,0,70,70,0,1,0,1,0
296,26,824,16,6915,882,6033,16,134,9,7
22670,26,4740,16,138507,5990,132517,156,16,60,96
13723,10,5539,9,195,102,93,2,31,1,1
6494,26,24611,16,20846,11163,9683,55,318,30,25
10119,26,9455,16,6090,2628,3462,21,24,11,10
8998,26,22939,16,8332,3418,4914,31,95,17,14
8613,26,25676,16,11281,5398,5883,21,125,11,10
6963,15,22384,11,1998,1422,576,10,15,6,4
19088,15,27140,11,1382,855,527,11,20,6,5
21418,10,7863,9,212,102,110,2,29,1,1
21964,10,7071,9,178,94,84,2,30,1,1
14058,28,0,0,70,70,0,1,0,1,0
11988,26,7029,16,7013,1718,5295,18,326,9,9
9078,28,0,0,66,66,0,1,0,1,0
7007,26,20604,16,8779,1861,6918,34,120,17,17
11838,2205,0,0,66,66,0,1,0,1,0
16216,28,0,0,70,70,0,1,0,1,0
10859,1800,0,0,66,66,0,1,0,1,0
1020,2938,0,0,62,62,0,1,0,1,0
19893,28,0,0,66,66,0,1,0,1,0
17205,26,178,16,6370,706,5664,19,16,7,12
10622,26,5420,16,12641,5741,6900,26,362,12,14
17174,26,17119,16,21478,2212,19266,47,86,19,28
2724,1240,12125,920,422,164,258,6,30,3,3
13916,28,0,0,66,66,0,1,0,1,0
9494,28,0,0,66,66,0,1,0,1,0
10556,26,17066,16,4869,699,4170,14,15,8,6
15471,28,0,0,70,70,0,1,0,1,0
13592,28,0,0,66,66,0,1,0,1,0
9586,15,21977,11,52791,4087,48704,66,24,26,40
21232,2591,23946,2011,66,66,0,2,8,2,0
8731,26,15927,16,378,192,186,7,14,4,3
13292,26,7178,16,6680,3784,2896,18,135,9,9
15974,10,11372,9,758,96,662,2,31,1,1
16644,2747,0,0,66,66,0,1,0,1,0
15474,10,9993,9,710,89,621,2,31,1,1
21339,1442,14036,1096,66,66,0,1,5,1,0
7908,2581,0,0,62,62,0,1,0,1,0
20828,28,0,0,70,70,0,1,0,1,0
1395,2938,0,0,66,66,0,1,0,1,0
19545,1771,0,0,62,62,0,1,0,1,0
9009,15,28469,11,31466,852,30614,32,89,9,23
16465,15,25045,11,2549,1595,954,21,75,11,10
10560,26,9708,16,1047,560,487,10,16,6,4
20427,28,0,0,66,66,0,1,0,1,0
12,1768,0,0,97,97,0,1,0,1,0
1330,918,0,0,62,62,0,1,0,1,0
8834,26,28836,16,1288,754,534,13,50,5,8
479,3147,0,0,66,66,0,1,0,1,0
8562,10,26898,9,216,102,114,2,30,1,1
22508,28,0,0,70,70,0,1,0,1,0
16951,255,25970,160,126,62,64,2,5,1,1
20641,28,0,0,70,70,0,1,0,1,0
4652,26,5565,16,1702,861,841,19,110,10,9
8584,1617,12870,1239,78,78,0,1,30,1,0
12393,28,0,0,66,66,0,1,0,1,0
18333,1147,0,0,66,66,0,1,0,1,0
5230,26,4308,16,38459,27564,10895,97,189,49,48
11179,28,0,0,66,66,0,1,0,1,0
10650,676,21306,475,130,70,60,2,5,1,1
20369,28,0,0,66,66,0,1,0,1,0
10421,15,29005,11,1056,682,374,10,15,6,4
12661,336,17477,214,70,70,0,1,5,1,0
20155,28,0,0,66,66,0,1,0,1,0
10558,216,22512,139,156,156,0,3,8,3,0
11181,28,0,0,70,70,0,1,0,1,0
22382,10,23039,9,184,94,90,2,30,1,1
18067,1804,0,0,66,66,0,1,0,1,0
15350,10,28892,9,177,94,83,2,29,1,1
17486,28,0,0,70,70,0,1,0,1,0
15658,28,0,0,66,66,0,1,0,1,0
22645,3113,0,0,66,66,0,1,0,1,0
14247,10,19374,9,183,94,89,2,29,1,1
16120,26,16850,16,3724,1963,1761,24,95,13,11
8734,15,11002,11,1515,481,1034,11,15,6,5
12,837,0,0,66,66,0,1,0,1,0
13845,28,0,0,70,70,0,1,0,1,0
18062,15,7604,11,1052,612,440,10,16,5,5
19936,26,25747,16,9251,6353,2898,25,120,13,12
13856,10,28309,9,969,86,883,2,30,1,1
8307,26,28275,16,361013,18864,342149,392,296,110,282
12572,1043,6295,767,70,70,0,1,5,1,0
10529,15,22879,11,1410,797,613,10,302,6,4
18312,10,23295,9,219,102,117,2,30,1,1
7076,1888,0,0,62,62,0,1,0,1,0
16139,26,27044,16,2614,1689,925,18,20,10,8
41,2938,0,0,62,62,0,1,0,1,0
4393,10,0,0,138,69,69,2,30,1,1
15203,26,21532,16,7941,1952,5989,20,15,11,9
20022,28,0,0,70,70,0,1,0,1,0
4268,295,15578,190,3578,1967,1611,16,16,8,8
15265,26,2673,16,7914,1925,5989,20,15,11,9
12423,2144,0,0,66,66,0,1,0,1,0
13818,26,23311,16,25605,3359,22246,47,82,26,21
22085,28,0,0,70,70,0,1,0,1,0
6022,15,3741,11,1860,712,1148,8,15,5,3
20419,40,13490,23,7974,4175,3799,65,32,40,25
17615,28,0,0,70,70,0,1,0,1,0
22625,28,0,0,66,66,0,1,0,1,0
21360,28,0,0,66,66,0,1,0,1,0
21629,10,27211,9,333,94,239,2,30,1,1
8812,26,11580,16,12279,4202,8077,33,43,16,17
22268,10,15764,9,761,100,661,2,30,1,1
1026,26,28354,16,5200,499,4701,13,15,7,6
8070,15,11963,11,12110,3853,8257,35,1075,13,22
12056,1015,328,749,70,70,0,2,8,2,0
18359,15,26406,11,1463,865,598,11,144,6,5
1218,983,0,0,62,62,0,1,0,1,0
16951,255,0,0,62,62,0,1,0,1,0
22105,10,19,9,751,95,656,2,30,1,1
15247,15,7781,11,234,234,0,4,11,4,0
1075,26,17665,16,5693,499,5194,14,15,7,7
20334,28,0,0,66,66,0,1,0,1,0
14954,10,3716,9,200,102,98,2,30,1,1
9161,10,23152,9,418,75,343,2,31,1,1
7241,26,1196,16,69614,5520,64094,100,21,52,48
15202,10,5999,9,193,102,91,2,30,1,1
15965,10,17889,9,232,94,138,2,30,1,1
11893,2636,0,0,66,66,0,1,0,1,0
8521,26,16337,16,22643,7456,15187,32,15,17,15
9411,3002,9642,2333,132,132,0,3,1200,3,0
17424,28,0,0,70,70,0,1,0,1,0
13718,28,0,0,70,70,0,1,0,1,0
18082,26,25353,16,180817,9921,170896,241,21,116,125
10815,1641,28003,1261,70,70,0,1,5,1,0
15331,10,9345,9,711,87,624,2,30,1,1
21765,10,15170,9,214,110,104,2,30,1,1
17847,255,0,0,60,60,0,1,0,1,0
8638,10,18401,9,210,110,100,2,31,1,1
9325,26,18318,16,152228,30166,122062,215,153,92,123
2744,1238,21425,918,868,126,742,2,30,1,1
9492,26,18621,16,1385,868,517,12,30,6,6
8488,28,0,0,70,70,0,1,0,1,0
21970,10,4446,9,196,94,102,2,31,1,1
3985,26,15111,16,24155,3115,21040,55,98,27,28
19062,28,0,0,70,70,0,1,0,1,0
21399,10,15082,9,183,94,89,2,30,1,1
15236,10,23459,9,297,102,195,4,34,2,2
21891,10,3061,9,168,86,82,2,32,1,1
7949,314,0,0,60,60,0,1,0,1,0
2139,2938,0,0,62,62,0,1,0,1,0
15178,10,12128,9,179,94,85,2,30,1,1
2724,1240,26677,920,422,164,258,6,30,3,3
15980,10,8337,9,170,87,83,2,31,1,1
10642,26,24618,16,8095,3030,5065,27,95,14,13
12746,797,0,0,145,145,0,1,0,1,0
360,3105,0,0,1148,1148,0,1,0,1,0
9012,10,13372,9,167,86,81,2,30,1,1
16804,28,0,0,70,70,0,1,0,1,0
8368,10,22746,9,200,102,98,2,30,1,1
637,3222,15508,2499,228,118,110,2,1200,1,1
2724,1240,28421,920,422,164,258,6,30,3,3
9796,28,0,0,70,70,0,1,0,1,0
12614,26,1372,16,499,425,74,4,0,3,1
22165,28,0,0,70,70,0,1,0,1,0
19649,28,0,0,70,70,0,1,0,1,0
8434,10,24677,9,184,94,90,2,30,1,1
8895,26,14405,16,8322,2585,5737,23,16,12,11
9691,26,24598,16,5895,1068,4827,22,149,12,10
18732,10,13891,9,211,78,133,2,30,1,1
9160,10,2414,9,183,94,89,2,30,1,1
14593,1215,0,0,66,66,0,1,0,1,0
21761,10,7784,9,261,87,174,4,45,2,2
9071,10,19075,9,198,101,97,2,31,1,1
19707,28,0,0,70,70,0,1,0,1,0
20291,28,0,0,66,66,0,1,0,1,0
17948,26,8100,16,1587,924,663,15,27,7,8
226,1147,0,0,62,62,0,1,0,1,0
15023,28,0,0,70,70,0,1,0,1,0
19154,28,0,0,70,70,0,1,0,1,0
12,837,0,0,66,66,0,1,0,1,0
12410,2990,1479,2324,70,70,0,1,5,1,0
15616,10,6687,9,177,94,83,2,30,1,1
3,2254,2,1745,1427,1170,257,8,15,4,4
10758,2256,0,0,66,66,0,1,0,1,0
13975,10,3219,9,294,106,188,4,56,2,2
15224,26,16763,16,8060,2040,6020,20,15,11,9
612,139,0,0,60,60,0,1,0,1,0
14985,1017,0,0,62,62,0,1,0,1,0
12979,2587,0,0,62,62,0,1,0,1,0
13214,28,0,0,70,70,0,1,0,1,0
9905,28,0,0,66,66,0,1,0,1,0
18560,26,26841,16,8233,948,7285,18,30,10,8
2744,1238,6244,918,889,126,763,2,30,1,1
9096,10,21734,9,404,259,145,3,32,2,1
9578,28,0,0,70,70,0,1,0,1,0
22163,10,26866,9,230,102,128,2,30,1,1
157,1147,0,0,66,66,0,1,0,1,0
14363,10,18346,9,199,102,97,2,30,1,1
7464,26,15891,16,11035,8438,2597,39,95,23,16
22688,28,0,0,66,66,0,1,0,1,0
1288,1397,0,0,66,66,0,1,0,1,0
12556,26,20615,16,70,70,0,2,8,2,0
2783,280,0,0,62,62,0,1,0,1,0
14174,28,0,0,66,66,0,1,0,1,0
6552,2093,0,0,145,145,0,1,0,1,0
8587,234,4496,149,8399,1901,6498,39,1562,16,23
8598,10,10755,9,309,94,215,4,32,2,2
9137,15,26330,11,1352,364,988,13,15,6,7
15988,10,15209,9,193,102,91,2,29,1,1
14210,28,0,0,70,70,0,1,0,1,0
10087,28,0,0,70,70,0,1,0,1,0
19075,1262,13381,942,1680,1386,294,7,30,4,3
21267,2181,1168,1686,624,382,242,10,15,6,4
2254,1472,0,0,66,66,0,1,0,1,0
14814,10,3499,9,194,102,92,2,29,1,1
22450,10,21704,9,249,102,147,2,30,1,1
22397,10,12018,9,196,94,102,2,29,1,1
18221,2883,0,0,66,66,0,1,0,1,0
13769,28,0,0,70,70,0,1,0,1,0
16342,28,0,0,66,66,0,1,0,1,0
17222,28,0,0,70,70,0,1,0,1,0
14918,28,0,0,70,70,0,1,0,1,0
6965,26,11871,16,24317,1518,22799,38,218,16,22
8931,26,19241,16,17982,2337,15645,34,127,16,18
22545,10,9933,9,416,102,314,2,30,1,1
16465,28,0,0,70,70,0,1,0,1,0
9610,28,0,0,70,70,0,1,0,1,0
8688,983,0,0,62,62,0,1,0,1,0
13908,28,0,0,70,70,0,1,0,1,0
2744,1239,4017,919,887,126,761,2,30,1,1
1133,2938,0,0,78,78,0,1,0,1,0
16951,255,0,0,62,62,0,1,0,1,0
11416,26,13756,16,2007,1152,855,14,15,8,6
7935,26,20492,16,70,70,0,1,5,1,0
21200,15,11099,11,314,192,122,6,15,4,2
13247,26,10892,16,4967,2482,2485,26,271,13,13
19758,28,0,0,70,70,0,1,0,1,0
2744,1239,1253,919,889,126,763,2,30,1,1
8833,10,14846,9,183,94,89,2,29,1,1
9619,15,21999,11,26023,3118,22905,38,24,18,20
13509,2883,0,0,62,62,0,1,0,1,0
16548,459,0,0,66,66,0,1,0,1,0
22323,10,1741,9,196,100,96,2,31,1,1
14395,26,18505,16,5263,2534,2729,16,120,8,8
12873,28,0,0,70,70,0,1,0,1,0
8878,10,27634,9,178,94,84,2,30,1,1
22442,10,11035,9,177,94,83,2,31,1,1
6384,18,21442,13,184,94,90,2,30,1,1
532,247,0,0,3354,1792,1562,46,194,23,23
9267,10,23064,9,198,110,88,2,31,1,1
2933,7,12025,7,152,66,86,2,7,1,1
4439,10,13225,9,86,86,0,1,30,1,0
11822,155,0,0,66,66,0,1,0,1,0
15293,15,17560,11,1462,703,759,8,15,5,3
9322,28,0,0,70,70,0,1,0,1,0
14708,10,28056,9,199,102,97,2,30,1,1
15555,15,14386,11,3817,829,2988,11,16,7,4
4012,26,21809,16,1864,250,1614,8,120,4,4
12136,26,9992,16,10542,1216,9326,26,44,10,16
9833,26,21861,16,152,86,66,2,4,1,1
11826,28,0,0,66,66,0,1,0,1,0
21690,1472,0,0,62,62,0,1,0,1,0
17064,28,0,0,70,70,0,1,0,1,0
2744,1240,27967,920,1658,126,1532,4,30,2,2
7978,10,0,0,82,82,0,1,30,1,0
3038,1888,0,0,62,62,0,1,0,1,0
14190,10,25614,9,313,102,211,2,30,1,1
8210,287,21194,184,158,158,0,1,1200,1,0
3181,899,0,0,62,62,0,1,0,1,0
13986,10,5804,9,332,94,238,2,29,1,1
12601,26,17155,16,499,425,74,4,0,3,1
5924,2604,0,0,62,62,0,1,0,1,0
10483,26,22467,16,4399,1492,2907,19,27,11,8
14597,28,0,0,70,70,0,1,0,1,0
8391,10,2177,9,170,87,83,2,31,1,1
2724,1240,19988,920,422,164,258,6,30,3,3
8916,28,0,0,70,70,0,1,0,1,0
12135,26,13359,16,6066,1046,5020,20,69,11,9
12752,405,22565,263,1869,1009,860,15,18,9,6
10968,498,22155,327,70,70,0,2,8,2,0
9221,26,14958,16,4819,2004,2815,22,80,11,11
8193,15,21164,11,19937,2162,17775,36,24,19,17
10301,697,0,0,66,66,0,1,0,1,0
17091,697,0,0,66,66,0,1,0,1,0
10905,1143,13153,843,70,70,0,2,7,2,0
7949,314,0,0,60,60,0,1,0,1,0
14443,28,0,0,70,70,0,1,0,1,0
19724,28,0,0,70,70,0,1,0,1,0
10059,2256,0,0,62,62,0,1,0,1,0
19812,1017,0,0,62,62,0,1,0,1,0
17994,28,0,0,70,70,0,1,0,1,0
8413,15,21393,11,378,180,198,7,53,4,3
13704,26,19725,16,1480,1029,451,11,151,6,5
3457,3216,0,0,62,62,0,1,0,1,0
22230,28,0,0,66,66,0,1,0,1,0
14548,10,21361,9,780,93,687,2,30,1,1
3115,1804,0,0,146,146,0,1,0,1,0
18303,28,0,0,66,66,0,1,0,1,0
12673,1215,0,0,66,66,0,1,0,1,0
3198,10,6771,9,268,94,174,2,30,1,1
12102,26,22634,16,8451,2320,6131,25,104,13,12
21611,10,5639,9,230,102,128,2,30,1,1
21208,10,550,9,374,101,273,4,33,2,2
22642,10,2258,9,188,96,92,2,31,1,1
4362,26,23412,16,2239099,75601,2163498,2512,71,983,1529
11137,10,0,0,210,77,133,2,29,1,1
10707,10,10412,9,168,78,90,2,29,1,1
10808,3078,10468,2391,70,70,0,2,8,2,0
14053,28,0,0,70,70,0,1,0,1,0
19116,26,10793,16,8637,5348,3289,37,738,15,22
8605,28,0,0,66,66,0,1,0,1,0
4856,26,4353,16,11784,6760,5024,50,247,30,20
11690,28,0,0,66,66,0,1,0,1,0
13778,10,12172,9,754,94,660,2,31,1,1
6229,2938,0,0,78,78,0,1,0,1,0
9746,26,14232,16,572966,109738,463228,1277,624,639,638
13741,10,22283,9,177,94,83,2,29,1,1
2907,2636,0,0,146,146,0,1,0,1,0
20561,28,0,0,70,70,0,1,0,1,0
9536,15,11869,11,306,180,126,6,26,4,2
15608,10,1243,9,199,102,97,2,30,1,1
22676,10,28883,9,184,94,90,2,31,1,1
17887,26,15951,16,7316,1933,5383,27,16,15,12
10646,28,0,0,70,70,0,1,0,1,0
4835,2627,21656,2037,789,152,637,4,1199,2,2
3496,26,21523,16,9490,1158,8332,24,256,13,11
6394,1017,0,0,146,146,0,1,0,1,0
10553,26,18610,16,9239,4472,4767,37,39,21,16
10909,26,19018,16,4418,1116,3302,17,30,10,7
15222,15,24343,11,234,234,0,4,12,4,0
1524,2604,0,0,62,62,0,1,0,1,0
2301,1946,0,0,60,60,0,1,0,1,0
16323,10,25490,9,231,231,0,4,47,4,0
19483,1173,27360,866,3828,1516,2312,29,5271,18,11
11512,28,0,0,66,66,0,1,0,1,0
13963,28,0,0,70,70,0,1,0,1,0
17057,232,8579,147,3815,2065,1750,37,309,19,18
9719,26,10210,16,5197,3181,2016,50,261,26,24
2744,1239,18450,919,1010,252,758,4,33,3,1
10534,10,8493,9,168,78,90,2,30,1,1
15195,10,22748,9,322,110,212,4,30,2,2
18199,1017,0,0,66,66,0,1,0,1,0
21578,10,16781,9,190,97,93,2,31,1,1
2724,1240,26527,920,422,164,258,6,30,3,3
12959,26,19567,16,5736,1990,3746,25,16,14,11
18414,2636,0,0,66,66,0,1,0,1,0
19095,28,0,0,66,66,0,1,0,1,0
5269,26,8975,16,2853588,73973,2779615,2907,129,994,1913
13123,26,26135,16,79305,3202,76103,98,347,32,66
22456,10,13328,9,193,102,91,2,31,1,1
17108,28,0,0,66,66,0,1,0,1,0
16991,10,25812,9,184,78,106,2,30,1,1
5233,26,25955,16,5176,861,4315,16,26,9,7
4835,2454,21284,1906,490,149,341,3,1199,2,1
16415,28,0,0,70,70,0,1,0,1,0
3900,1179,0,0,74,74,0,1,0,1,0
22198,28,0,0,66,66,0,1,0,1,0
8828,10,15935,9,268,93,175,4,59,2,2
13346,26,8719,16,36109,16793,19316,62,19,32,30
14958,2636,0,0,66,66,0,1,0,1,0
9286,10,15599,9,179,94,85,2,30,1,1
14968,10,3463,9,757,98,659,2,31,1,1
7681,26,21003,16,3847,2650,1197,22,32,13,9
8500,1147,0,0,62,62,0,1,0,1,0
5774,26,25557,16,1093,662,431,10,46,6,4
14492,74,3886,57,489,149,340,2,1200,1,1
1415,2883,0,0,66,66,0,1,0,1,0
16411,28,0,0,66,66,0,1,0,1,0
15158,28,0,0,66,66,0,1,0,1,0
5902,26,12213,16,1741,1048,693,15,25,8,7
19103,1017,0,0,62,62,0,1,0,1,0
15830,28,0,0,66,66,0,1,0,1,0
10232,1147,0,0,66,66,0,1,0,1,0
19243,26,26473,16,31648,6288,25360,62,247,25,37
15901,10,29057,9,177,94,83,2,30,1,1
2744,63,3784,46,867,126,741,2,30,1,1
16257,1147,0,0,62,62,0,1,0,1,0
15879,10,11472,9,192,98,94,2,31,1,1
16951,255,0,0,62,62,0,1,0,1,0
6328,3216,0,0,62,62,0,1,0,1,0
13327,28,0,0,66,66,0,1,0,1,0
17293,26,17621,16,9569,2606,6963,22,135,11,11
15538,28,0,0,66,66,0,1,0,1,0
15888,10,21791,9,178,94,84,2,30,1,1
22191,10,11805,9,199,102,97,2,29,1,1
360,3105,0,0,164,164,0,1,0,1,0
14099,10,18127,9,194,102,92,2,33,1,1
9,18,5644,13,184,94,90,2,30,1,1
8141,1086,0,0,66,66,0,1,0,1,0
20532,28,0,0,70,70,0,1,0,1,0
125,1147,0,0,146,146,0,1,0,1,0
12,1380,0,0,82,82,0,1,0,1,0
9071,10,23863,9,199,102,97,2,29,1,1
2744,1238,1249,918,876,126,750,2,31,1,1
8822,10,23429,9,193,102,91,2,30,1,1
11435,1792,0,0,74,74,0,1,0,1,0
13726,10,16604,9,86,86,0,1,30,1,0
11566,1147,0,0,62,62,0,1,0,1,0
12698,287,10635,184,372,186,186,6,16,3,3
7206,15,19703,11,42171,1901,40270,57,16,26,31
20038,28,0,0,70,70,0,1,0,1,0
11108,699,13745,497,70,70,0,1,4,1,0
2386,10,9827,9,220,90,130,2,30,1,1
14054,10,18296,9,179,94,85,2,30,1,1
9,18,25944,13,184,94,90,2,30,1,1
15322,15,2788,11,194,128,66,4,25,3,1
15354,10,11679,9,165,86,79,2,30,1,1
2089,1771,0,0,62,62,0,1,0,1,0
15727,1697,0,0,66,66,0,1,0,1,0
16951,255,0,0,62,62,0,1,0,1,0
7476,1771,0,0,66,66,0,1,0,1,0
13650,26,22891,16,8637,2889,5748,40,41,23,17
7896,15,14681,11,1571,877,694,11,180,6,5
11273,28,0,0,66,66,0,1,0,1,0
16239,26,10568,16,3345,823,2522,12,120,6,6
15548,28,0,0,70,70,0,1,0,1,0
10996,1147,0,0,146,146,0,1,0,1,0
15450,509,0,0,66,66,0,1,0,1,0
2744,1629,22253,1251,889,126,763,2,31,1,1
21222,10,18595,9,253,102,151,2,30,1,1
3158,1017,0,0,62,62,0,1,0,1,0
8528,10,21652,9,166,86,80,2,30,1,1
11031,567,28887,381,70,70,0,2,7,2,0
21143,1147,0,0,146,146,0,1,0,1,0
2965,2587,0,0,62,62,0,1,0,1,0
14062,1888,0,0,66,66,0,1,0,1,0
7335,1070,0,0,60,60,0,1,0,1,0
15078,10,9780,9,199,102,97,2,30,1,1
17834,28,0,0,66,66,0,1,0,1,0
21017,28,0,0,70,70,0,1,0,1,0
471,509,0,0,146,146,0,1,0,1,0
11496,28,0,0,70,70,0,1,0,1,0
19717,28,0,0,70,70,0,1,0,1,0
15052,847,0,0,62,62,0,1,0,1,0
22715,1397,0,0,62,62,0,1,0,1,0
21434,10,13725,9,229,102,127,2,30,1,1
15384,10,3394,9,232,94,138,2,30,1,1
8920,1771,0,0,146,146,0,1,0,1,0
3868,26,1327,16,414843,13933,400910,459,136,160,299
22655,26,5720,16,478996,13760,465236,490,16,171,319
19428,242,0,0,145,145,0,1,0,1,0
11171,28,0,0,66,66,0,1,0,1,0
14017,26,11462,16,13679,7277,6402,35,262,15,20
16951,255,0,0,62,62,0,1,0,1,0
3435,2486,0,0,146,146,0,1,0,1,0
8547,28,0,0,70,70,0,1,0,1,0
8871,15,26230,11,132198,5466,126732,140,109,45,95
8449,280,15100,177,709,523,186,6,16,3,3
508,265,3281,166,217199,128,217071,316,37,3,313
16951,255,0,0,62,62,0,1,0,1,0
12997,26,7678,16,17821,7006,10815,95,448,48,47
17587,10,18666,9,184,86,98,2,31,1,1
20605,551,2984,367,70,70,0,2,8,2,0
21379,28,0,0,70,70,0,1,0,1,0
19607,28,0,0,70,70,0,1,0,1,0
13532,26,23586,16,5252,3392,1860,22,316,12,10
7090,1936,0,0,74,74,0,1,0,1,0
2744,1620,2764,1242,887,126,761,2,31,1,1
15311,26,25055,16,120441,7846,112595,167,61,76,91
14163,15,14519,11,12971,971,12000,22,15,12,10
13864,10,25159,9,402,142,260,2,30,1,1
8876,28,0,0,66,66,0,1,0,1,0
16863,2587,0,0,62,62,0,1,0,1,0
13876,26,20031,16,42376115,1180708,41195407,45399,148,13976,31423
13177,28,0,0,70,70,0,1,0,1,0
8687,26,21537,16,25081,3001,22080,55,75,29,26
15919,10,20771,9,183,86,97,2,30,1,1
15321,26,25062,16,68504,9909,58595,93,62,46,47
21895,10,13791,9,772,103,669,2,31,1,1
15236,10,9136,9,288,93,195,4,32,2,2
17033,28,0,0,70,70,0,1,0,1,0
14744,10,7707,9,194,102,92,2,30,1,1
17123,26,18340,16,25195,16739,8456,60,20,35,25
181,15,12446,11,214,140,74,4,15,3,1
5127,26,21403,16,1117339,17881,1099458,1006,16,256,750
21795,26,25601,16,24984,2042,22942,41,33,19,22
8487,28,0,0,70,70,0,1,0,1,0
11428,2573,0,0,62,62,0,1,0,1,0
8879,10,17974,9,233,94,139,2,30,1,1
14338,3179,22774,2465,504,318,186,8,15,5,3
15380,10,15143,9,172,88,84,2,30,1,1
3058,3262,0,0,60,60,0,1,0,1,0
12975,26,27024,16,2430,1416,1014,18,34,9,9
1068,26,22191,16,8672,1863,6809,22,46,11,11
13749,10,14151,9,474,200,274,6,44,3,3
13776,10,7769,9,253,87,166,4,44,2,2
9287,26,6786,16,12716,2575,10141,55,141,27,28
18541,28,0,0,70,70,0,1,0,1,0
5699,2938,0,0,74,74,0,1,0,1,0
9803,28,0,0,70,70,0,1,0,1,0
6228,2604,0,0,66,66,0,1,0,1,0
17912,26,2309,16,120014,7352,112662,155,37,64,91
21910,10,19247,9,370,126,244,2,30,1,1
5857,15,2721,11,1056,682,374,10,15,6,4
6631,10,11070,9,168,78,90,2,30,1,1
3541,1017,0,0,62,62,0,1,0,1,0
19545,15,24492,11,4448,2223,2225,18,49,10,8
18946,28,0,0,66,66,0,1,0,1,0
15319,1522,6314,1160,1703,524,1179,9,30,5,4
21573,10,19693,9,183,94,89,2,30,1,1
14392,26,23772,16,4660,1915,2745,23,120,12,11
9626,26,9060,16,2520,1267,1253,17,83,9,8
20271,7,0,0,60,60,0,1,0,1,0
2142,909,0,0,78,78,0,1,0,1,0
2133,1147,0,0,62,62,0,1,0,1,0
22476,10,25374,9,183,94,89,2,30,1,1
2023,2899,0,0,78,78,0,1,0,1,0
286,1147,0,0,62,62,0,1,0,1,0
7243,26,3893,16,570475,25559,544916,712,32,341,371
15199,10,15729,9,177,94,83,2,31,1,1
12532,2235,0,0,66,66,0,1,0,1,0
1238,1054,0,0,62,62,0,1,0,1,0
15310,2720,13156,2114,4188,1648,2540,17,19,9,8
6708,1017,0,0,62,62,0,1,0,1,0
11010,15,24213,11,4247,699,3548,13,46,7,6
12142,26,15500,16,8662,1469,7193,28,66,15,13
12014,2707,11354,2103,70,70,0,1,5,1,0
12651,28,0,0,66,66,0,1,0,1,0
5125,26,26555,16,4478,1133,3345,13,27,8,5
22041,28,0,0,66,66,0,1,0,1,0
3800,26,22528,16,3521,516,3005,12,15,6,6
8392,346,21374,220,43790,20134,23656,73,400,45,28
13712,10,13408,9,216,110,106,2,30,1,1
82,1202,0,0,143,143,0,1,0,1,0
2996,2573,0,0,62,62,0,1,0,1,0
5751,26,14991,16,44004,3909,40095,80,135,38,42
5132,26,26403,16,774099,15769,758330,743,16,223,520
2391,847,0,0,62,62,0,1,0,1,0
8922,10,9882,9,264,89,175,4,48,2,2
21972,10,16835,9,216,94,122,2,29,1,1
19164,1017,0,0,66,66,0,1,0,1,0
9775,7,0,0,60,60,0,1,0,1,0
1136,183,3819,121,3441,1552,1889,17,21,10,7
22242,10,5152,9,214,94,120,2,30,1,1
13984,10,6268,9,199,94,105,2,30,1,1
3271,305,3742,199,1564,560,1004,23,38,9,14
18,280,0,0,62,62,0,1,0,1,0
9728,2850,28356,2212,2268,1050,1218,15,5442,8,7
17342,26,16521,16,16775,1879,14896,36,16,17,19
21640,10,3852,9,209,102,107,2,29,1,1
6098,346,0,0,60,60,0,1,0,1,0
17907,28,0,0,70,70,0,1,0,1,0
9850,28,0,0,70,70,0,1,0,1,0
15636,10,23373,9,778,103,675,2,30,1,1
21971,28,0,0,70,70,0,1,0,1,0
15610,10,6887,9,188,96,92,2,30,1,1
8002,715,0,0,62,62,0,1,0,1,0
21021,28,0,0,66,66,0,1,0,1,0
4693,10,25189,9,199,94,105,2,30,1,1
21378,28,0,0,70,70,0,1,0,1,0
15521,10,27474,9,183,94,89,2,30,1,1
18651,10,8166,9,451,86,365,2,30,1,1
314,1393,0,0,148,148,0,1,0,1,0
341,15,22638,11,2338,1419,919,10,15,5,5
4406,15,5586,11,2272,1679,593,10,34,6,4
1286,2587,0,0,62,62,0,1,0,1,0
8703,10,26301,9,269,96,173,4,59,2,2
18261,28,0,0,66,66,0,1,0,1,0
13941,28,0,0,70,70,0,1,0,1,0
21279,28,0,0,70,70,0,1,0,1,0
10327,2598,26741,2017,490,149,341,2,1200,1,1
11010,2279,4902,1764,70,70,0,2,7,2,0
4672,26,14591,16,499,425,74,4,0,3,1
1337,10,4522,9,197,90,107,2,30,1,1
7337,1017,0,0,62,62,0,1,0,1,0
12087,26,584,16,1462,965,497,13,18,7,6
20935,2604,0,0,62,62,0,1,0,1,0
6268,26,28323,16,494,198,296,8,17,4,4
9369,26,8155,16,9582,2201,7381,28,99,14,14
3111,1482,0,0,62,62,0,1,0,1,0
10572,26,18837,16,190,70,120,4,15,2,2
8584,1240,9253,920,271,78,193,2,31,1,1
15329,10,11291,9,182,93,89,2,31,1,1
2740,26,16709,16,7547,2728,4819,26,20,13,13
10646,1880,0,0,66,66,0,1,0,1,0
19325,1888,0,0,66,66,0,1,0,1,0
15427,2535,16867,1971,130,70,60,2,5,1,1
7211,1147,0,0,62,62,0,1,0,1,0
15149,28,0,0,70,70,0,1,0,1,0
14773,28,0,0,70,70,0,1,0,1,0
15213,3216,0,0,62,62,0,1,0,1,0
22118,10,6635,9,245,94,151,2,30,1,1
15384,10,16247,9,178,94,84,2,30,1,1
17158,697,0,0,66,66,0,1,0,1,0
191,1215,0,0,62,62,0,1,0,1,0
21581,28,0,0,70,70,0,1,0,1,0
2014,1888,0,0,62,62,0,1,0,1,0
15204,15,25883,11,234,234,0,4,12,4,0
13029,26,17024,16,499,425,74,4,0,3,1
17151,26,16773,16,5166,700,4466,16,15,7,9
15568,10,7664,9,168,86,82,2,30,1,1
8121,2256,0,0,62,62,0,1,0,1,0
12337,28,0,0,70,70,0,1,0,1,0
16773,10,25866,9,404,259,145,3,33,2,1
11523,26,23020,16,4487,1580,2907,19,26,11,8
16021,826,2020,606,402,132,270,6,1209,3,3
15269,10,25197,9,196,102,94,2,30,1,1
10506,28,0,0,66,66,0,1,0,1,0
22425,10,8334,9,822,102,720,2,30,1,1
15838,28,0,0,66,66,0,1,0,1,0
3984,1819,0,0,74,74,0,1,0,1,0
8799,10,8872,9,168,86,82,2,30,1,1
5397,10,5125,9,78,78,0,1,30,1,0
1177,26,13544,16,3409,1599,1810,24,80,12,12
49,1147,0,0,146,146,0,1,0,1,0
5438,10,12770,9,168,78,90,2,30,1,1
14277,10,27693,9,216,110,106,2,30,1,1
17126,28,0,0,70,70,0,1,0,1,0
12586,1804,0,0,66,66,0,1,0,1,0
14461,10,6726,9,458,188,270,6,31,3,3
4913,10,16414,9,404,259,145,3,32,2,1
22428,10,0,0,88,88,0,1,0,1,0
22333,26,16176,16,146,64,82,3,9,2,1
22414,10,15514,9,230,102,128,2,30,1,1
16990,578,0,0,143,143,0,1,0,1,0
2172,2627,11415,2037,460,150,310,2,1199,1,1
3926,26,7715,16,78,78,0,1,5,1,0
20745,28,0,0,70,70,0,1,0,1,0
15679,10,20718,9,172,88,84,2,30,1,1
1973,2883,0,0,62,62,0,1,0,1,0
496,1607,0,0,66,66,0,1,0,1,0
12276,1367,0,0,60,60,0,1,0,1,0
18255,28,0,0,70,70,0,1,0,1,0
14246,2883,0,0,66,66,0,1,0,1,0
4937,15,14482,11,190,70,120,4,14,2,2
10315,26,6050,16,3477,1216,2261,16,136,8,8
15381,26,6169,16,8072,2052,6020,20,15,11,9
978,15,4072,11,318,192,126,6,26,4,2
9687,28,0,0,70,70,0,1,0,1,0
21986,10,12507,9,728,96,632,2,30,1,1
16957,28,0,0,70,70,0,1,0,1,0
1342,1176,0,0,159,159,0,1,0,1,0
1804,375,0,0,60,60,0,1,0,1,0
14770,10,16220,9,200,102,98,2,30,1,1
19008,28,0,0,66,66,0,1,0,1,0
5864,10,14893,9,78,78,0,1,30,1,0
603,1888,0,0,62,62,0,1,0,1,0
13728,10,23860,9,181,94,87,2,33,1,1
14389,10,12444,9,249,94,155,2,29,1,1
13248,28,0,0,70,70,0,1,0,1,0
11130,2762,36,2141,70,70,0,1,4,1,0
1116,7,3737,7,66,66,0,1,5,1,0
8867,10,27294,9,197,102,95,2,30,1,1
2235,1147,0,0,62,62,0,1,0,1,0
11238,2205,0,0,66,66,0,1,0,1,0
912,26,7407,16,5658,501,5157,14,15,7,7
22490,10,12756,9,349,110,239,2,30,1,1
17765,2382,0,0,66,66,0,1,0,1,0
22245,10,12241,9,214,110,104,2,30,1,1
1123,26,162,16,1313,876,437,11,26,6,5
22631,10,16712,9,240,86,154,2,29,1,1
8400,10,2600,9,819,102,717,2,29,1,1
20391,28,0,0,70,70,0,1,0,1,0
3416,2587,0,0,66,66,0,1,0,1,0
18524,26,12779,16,18515,2899,15616,32,148,15,17
16951,255,0,0,62,62,0,1,0,1,0
17596,28,0,0,66,66,0,1,0,1,0
15460,10,25648,9,170,87,83,2,30,1,1
14961,1827,0,0,66,66,0,1,0,1,0
14430,10,19902,9,738,86,652,2,31,1,1
5255,26,14019,16,11360,8326,3034,36,22,19,17
7385,26,5621,16,6255,1125,5130,26,413,9,17
6530,234,18203,149,10588,2455,8133,46,5724,19,27
19029,28,0,0,66,66,0,1,0,1,0
22442,28,0,0,66,66,0,1,0,1,0
1334,10,4503,9,197,90,107,2,30,1,1
67,10,19677,9,278,86,192,2,29,1,1
10962,26,9635,16,3207,2430,777,21,26,11,10
8583,1919,0,0,66,66,0,1,0,1,0
18667,28,0,0,70,70,0,1,0,1,0
13753,15,17834,11,46215,1615,44600,57,18,24,33
9812,26,1746,16,2881,642,2239,13,135,6,7
8915,26,3872,16,438048,86860,351188,491,420,213,278
1525,1444,0,0,145,145,0,1,0,1,0
12006,28,0,0,70,70,0,1,0,1,0
13622,10,18990,9,198,101,97,2,30,1,1
22404,28,0,0,70,70,0,1,0,1,0
434,10,18685,9,217,86,131,2,30,1,1
22550,28,0,0,70,70,0,1,0,1,0
4758,26,9946,16,8604,2228,6376,36,739,19,17
14334,26,12583,16,5259,1203,4056,19,41,10,9
9776,15,239,11,1559,1107,452,9,22,5,4
8419,28,0,0,66,66,0,1,0,1,0
20051,28,0,0,70,70,0,1,0,1,0
11844,26,20254,16,1769338,65258,1704080,1935,1200,735,1200
17054,26,5055,16,7674,4959,2715,24,16,13,11
22079,10,17913,9,423,102,321,2,30,1,1
21575,10,27184,9,199,102,97,2,30,1,1
12184,28,0,0,66,66,0,1,0,1,0
21310,1441,6607,1095,70,70,0,1,5,1,0
13737,10,3729,9,177,94,83,2,31,1,1
4662,26,16444,16,499,425,74,4,0,3,1
22461,10,23275,9,232,110,122,2,30,1,1
6353,10,4887,9,168,78,90,2,30,1,1
22676,10,8808,9,184,94,90,2,30,1,1
9430,15,15697,11,8269,1423,6846,20,75,10,10
1219,3067,27773,2382,479,150,329,2,1200,1,1
22289,1215,0,0,66,66,0,1,0,1,0
9055,10,27644,9,822,102,720,2,30,1,1
7315,26,25702,16,275011,235921,39090,651,350,363,288
16830,2943,0,0,66,66,0,1,0,1,0
13022,2938,0,0,66,66,0,1,0,1,0
14613,10,24924,9,200,102,98,2,30,1,1
15214,2486,0,0,66,66,0,1,0,1,0
9399,10,9667,9,167,86,81,2,31,1,1
21725,28,0,0,70,70,0,1,0,1,0
22033,2611,0,0,62,62,0,1,0,1,0
12423,2144,0,0,66,66,0,1,0,1,0
21225,1472,0,0,66,66,0,1,0,1,0
6132,18,14617,13,184,94,90,2,30,1,1
14931,28,0,0,66,66,0,1,0,1,0
7136,15,19627,11,144717,5580,139137,180,20,81,99
21326,10,26377,9,389,94,295,2,30,1,1
4288,26,27324,16,1209,709,500,14,26,8,6
13764,10,27830,9,177,94,83,2,30,1,1
14055,10,17063,9,168,86,82,2,31,1,1
9158,26,5134,16,378,82,296,5,17,1,4
12035,28,0,0,70,70,0,1,0,1,0
16558,28,0,0,66,66,0,1,0,1,0
7339,141,0,0,60,60,0,1,0,1,0
14481,10,26241,9,192,98,94,2,31,1,1
9862,26,9415,16,17803069,497380,17305689,17583,219,5899,11684
18265,28,0,0,70,70,0,1,0,1,0
10408,28,0,0,70,70,0,1,0,1,0
15905,1147,0,0,62,62,0,1,0,1,0
570,2414,0,0,60,60,0,1,90,1,0
13450,28,0,0,70,70,0,1,0,1,0
17552,10,24888,9,187,78,109,2,30,1,1
3077,2636,0,0,62,62,0,1,0,1,0
15510,10,27978,9,181,94,87,2,30,1,1
2800,10,11532,9,194,87,107,2,31,1,1
18318,1147,0,0,62,62,0,1,0,1,0
22111,10,5138,9,487,201,286,6,42,3,3
15172,10,3719,9,197,197,0,3,60,3,0
14714,10,3980,9,199,102,97,2,33,1,1
15269,10,20599,9,196,102,94,2,29,1,1
8979,10,6018,9,189,102,87,2,30,1,1
21843,10,27076,9,168,86,82,2,31,1,1
16951,255,0,0,62,62,0,1,0,1,0
13312,28,0,0,70,70,0,1,0,1,0
22436,10,16572,9,733,86,647,2,30,1,1
15376,26,6745,16,8022,2002,6020,20,15,11,9
22548,10,9568,9,321,102,219,2,30,1,1
20787,28,0,0,70,70,0,1,0,1,0
16661,28,0,0,70,70,0,1,0,1,0
15712,10,28864,9,177,94,83,2,30,1,1
15308,28,0,0,70,70,0,1,0,1,0
12544,676,28031,475,70,70,0,1,4,1,0
16542,26,4332,16,7252,1150,6102,22,199,11,11
9959,10,0,0,371,77,294,2,30,1,1
15706,10,22170,9,184,94,90,2,30,1,1
22149,10,5070,9,210,110,100,2,30,1,1
11756,28,0,0,66,66,0,1,0,1,0
10845,28,0,0,70,70,0,1,0,1,0
11729,15,1626,11,1465,729,736,12,16,7,5
1352,155,0,0,66,66,0,1,0,1,0
8855,28,0,0,70,70,0,1,0,1,0
15000,10,25183,9,177,94,83,2,30,1,1
14950,10,911,9,193,102,91,2,31,1,1
17946,15,28295,11,943291,17238,926053,869,72,249,620
9170,10,24643,9,378,94,284,2,30,1,1
7329,26,12178,16,12351,7584,4767,38,48,22,16
7125,2256,0,0,66,66,0,1,0,1,0
17223,26,28382,16,5167,700,4467,16,14,7,9
22113,10,24386,9,778,103,675,2,30,1,1
394,2049,0,0,160,160,0,1,0,1,0
14223,28,0,0,70,70,0,1,0,1,0
8448,26,10999,16,7655,2377,5278,20,135,11,9
5615,10,28158,9,258,78,180,4,30,2,2
4383,1771,0,0,62,62,0,1,0,1,0
18923,26,14665,16,9869,2448,7421,61,1253,24,37
14005,10,17408,9,195,102,93,2,30,1,1
9283,28,0,0,66,66,0,1,0,1,0
8349,983,0,0,66,66,0,1,0,1,0
8042,26,15435,16,283034,39462,243572,536,224,257,279
7333,26,15343,16,4592,697,3895,14,25,8,6
11883,28,0,0,70,70,0,1,0,1,0
15879,10,28316,9,196,102,94,2,31,1,1
13091,28,0,0,70,70,0,1,0,1,0
15323,10,16072,9,184,94,90,2,30,1,1
15029,10,3285,9,168,86,82,2,30,1,1
2141,1086,0,0,66,66,0,1,0,1,0
22693,10,14164,9,193,102,91,2,30,1,1
4470,18,19363,13,184,94,90,2,30,1,1
9497,26,15347,16,7397,1784,5613,27,306,13,14
11659,1792,0,0,62,62,0,1,0,1,0
21979,28,0,0,70,70,0,1,0,1,0
16891,26,1448,16,114852,43911,70941,248,69,132,116
6250,2018,17381,1548,211,89,122,4,30,2,2
225,10,24098,9,204,118,86,2,30,1,1
14898,18,21052,13,184,94,90,2,30,1,1
15672,3216,0,0,66,66,0,1,0,1,0
11039,28,0,0,66,66,0,1,0,1,0
10811,2206,21435,1708,66,66,0,1,5,1,0
14332,604,1021,415,564,318,246,9,15,5,4
6011,10,6247,9,168,78,90,2,30,1,1
13817,10,19240,9,199,102,97,2,30,1,1
6269,2477,0,0,60,60,0,1,0,1,0
9536,26,24351,16,1125,595,530,12,29,6,6
8438,10,27793,9,178,94,84,2,30,1,1
11834,3216,0,0,62,62,0,1,0,1,0
2290,1472,0,0,66,66,0,1,0,1,0
17796,28,0,0,66,66,0,1,0,1,0
20107,28,0,0,66,66,0,1,0,1,0
5662,26,28643,16,8105,2278,5827,27,196,15,12
14283,28,0,0,70,70,0,1,0,1,0
13881,10,28420,9,178,94,84,2,30,1,1
5701,1054,0,0,66,66,0,1,0,1,0
9361,28,0,0,70,70,0,1,0,1,0
16964,28,0,0,66,66,0,1,0,1,0
6930,26,18745,16,30773,9123,21650,90,104,48,42
8544,26,7004,16,11627,4670,6957,37,155,16,21
9518,26,27091,16,8485,1804,6681,30,316,14,16
15871,10,27398,9,190,97,93,2,31,1,1
19740,28,0,0,70,70,0,1,0,1,0
21817,2205,0,0,66,66,0,1,0,1,0
1524,2604,0,0,66,66,0,1,0,1,0
17036,28,0,0,70,70,0,1,0,1,0
1561,7,0,0,60,60,0,1,0,1,0
19,2611,0,0,62,62,0,1,0,1,0
22120,10,8923,9,247,86,161,3,31,2,1
11204,2165,18485,1672,258,70,188,4,9,2,2
10429,28,0,0,70,70,0,1,0,1,0
18917,15,19770,11,613,539,74,7,15,6,1
9528,28,0,0,70,70,0,1,0,1,0
4011,26,20521,16,13168,2505,10663,21,121,9,12
5702,26,596,16,21750,1903,19847,39,154,20,19
20893,1888,0,0,66,66,0,1,0,1,0
2744,1623,26290,1245,885,126,759,2,31,1,1
17616,2611,0,0,66,66,0,1,0,1,0
5915,26,12073,16,7238,2601,4637,20,17,10,10
14589,10,24459,9,168,78,90,2,30,1,1
6296,26,28770,16,6381,3801,2580,19,135,10,9
16950,28,0,0,70,70,0,1,0,1,0
14180,28,0,0,70,70,0,1,0,1,0
21778,28,0,0,70,70,0,1,0,1,0
12733,504,16642,332,70,70,0,1,5,1,0
19983,28,0,0,70,70,0,1,0,1,0
1351,2938,0,0,66,66,0,1,0,1,0
16744,3216,0,0,72,72,0,1,0,1,0
8171,1073,0,0,60,60,0,1,0,1,0
778,1888,0,0,146,146,0,1,0,1,0
15925,308,0,0,66,66,0,1,0,1,0
18540,26,7385,16,5045,2009,3036,14,120,7,7
21522,10,21157,9,295,110,185,2,30,1,1
5251,26,28412,16,8028,5439,2589,32,27,16,16
10817,1781,3806,1359,70,70,0,1,5,1,0
10779,28,0,0,66,66,0,1,0,1,0
13386,28,0,0,70,70,0,1,0,1,0
4647,26,22803,16,499,425,74,4,0,3,1
13964,10,1880,9,199,102,97,2,30,1,1
16162,2587,0,0,62,62,0,1,0,1,0
14767,10,23934,9,177,94,83,2,30,1,1
5070,26,932,16,9606,1228,8378,20,115,9,11
13638,26,4633,16,68519,3801,64718,93,31,40,53
1861,1147,0,0,66,66,0,1,0,1,0
6842,234,25655,149,19678,4762,14916,98,9851,54,44
16951,255,0,0,62,62,0,1,0,1,0
4494,2636,0,0,62,62,0,1,0,1,0
5081,2611,0,0,62,62,0,1,0,1,0
17001,28,0,0,66,66,0,1,0,1,0
19103,1017,0,0,66,66,0,1,0,1,0
17609,26,12972,16,2854,1700,1154,16,16,8,8
21146,1440,18144,1094,66,66,0,1,5,1,0
8344,2787,0,0,60,60,0,1,0,1,0
12859,1888,0,0,66,66,0,1,0,1,0
10592,28,0,0,70,70,0,1,0,1,0
11749,1147,0,0,62,62,0,1,0,1,0
21796,10,11032,9,194,102,92,2,29,1,1
22654,28,0,0,70,70,0,1,0,1,0
12054,26,6006,16,7434,1695,5739,23,27,12,11
273,1367,0,0,60,60,0,1,0,1,0
18985,26,4878,16,15561,8186,7375,44,47,26,18
7769,26,11930,16,4609,763,3846,14,14,8,6
15332,28,0,0,66,66,0,1,0,1,0
8736,10,6711,9,196,94,102,2,29,1,1
6902,26,8619,16,7464,1869,5595,29,409,11,18
13674,26,11149,16,7239,2934,4305,26,16,15,11
15072,10,28907,9,793,101,692,2,31,1,1
8504,10,19260,9,199,102,97,2,30,1,1
19489,28,0,0,70,70,0,1,0,1,0
18417,26,16025,16,10223,3933,6290,49,115,22,27
8584,2664,2162,2071,257,71,186,2,30,1,1
15552,10,1089,9,180,94,86,2,30,1,1
12600,15,19831,11,1667,619,1048,10,45,6,4
14284,10,16162,9,214,110,104,2,30,1,1
19776,28,0,0,66,66,0,1,0,1,0
9369,28,0,0,70,70,0,1,0,1,0
21513,10,494,9,199,102,97,2,29,1,1
10523,15,4349,11,913,410,503,10,15,5,5
14103,28,0,0,70,70,0,1,0,1,0
22149,10,18473,9,204,104,100,2,31,1,1
22501,10,14403,9,365,94,271,4,58,2,2
15158,1888,0,0,66,66,0,1,0,1,0
15891,10,18856,9,210,110,100,2,30,1,1
9303,15,19435,11,17314,6865,10449,50,79,24,26
9313,28,0,0,70,70,0,1,0,1,0
11913,28,0,0,70,70,0,1,0,1,0
14356,28,0,0,66,66,0,1,0,1,0
21033,3112,17135,2417,312,132,180,6,6,3,3
17667,10,1944,9,168,78,90,2,30,1,1
14795,10,6483,9,240,110,130,2,30,1,1
18480,2819,27938,2188,164,70,94,2,5,1,1
469,10,1645,9,825,99,726,2,0,1,1
6245,26,21168,16,16985,7850,9135,39,121,19,20
6971,26,16221,16,6220,1790,4430,19,120,10,9
9555,28,0,0,66,66,0,1,0,1,0
15560,10,8848,9,196,102,94,2,30,1,1
20781,183,28195,121,293,223,70,4,0,3,1
12421,1792,0,0,66,66,0,1,0,1,0
8669,26,5386,16,9678,4552,5126,22,76,12,10
7028,26,7603,16,414,140,274,7,27,3,4
22392,1238,19450,918,255,78,177,2,30,1,1
909,26,26450,16,5727,491,5236,14,15,7,7
19353,26,13192,16,9073,2899,6174,36,94,19,17
14364,10,0,0,623,70,553,2,30,1,1
8888,10,21145,9,200,102,98,2,30,1,1
17909,15,3007,11,1453540,37280,1416260,1552,96,507,1045
11263,15,6037,11,1674,708,966,18,392,6,12
13825,10,20491,9,178,94,84,2,30,1,1
21249,28,0,0,70,70,0,1,0,1,0
3002,1936,0,0,62,62,0,1,0,1,0
21621,10,26452,9,240,110,130,2,30,1,1
16951,255,0,0,62,62,0,1,0,1,0
1804,927,0,0,60,60,0,1,0,1,0
20261,28,0,0,70,70,0,1,0,1,0
13822,10,26910,9,195,102,93,2,30,1,1
15360,26,21588,16,7905,1916,5989,20,15,11,9
4365,1054,0,0,62,62,0,1,0,1,0
17522,28,0,0,70,70,0,1,0,1,0
14712,28,0,0,66,66,0,1,0,1,0
9214,3256,0,0,60,60,0,1,0,1,0
21948,10,7823,9,384,94,290,4,42,2,2
8574,26,20688,16,4728,2928,1800,28,95,15,13
22094,28,0,0,66,66,0,1,0,1,0
1066,26,11310,16,7353,1570,5783,22,39,11,11
738,1017,0,0,66,66,0,1,0,1,0
10980,28,0,0,70,70,0,1,0,1,0
15090,26,19569,16,155750,151462,4288,169,215,112,57
22578,26,17804,16,2289,1583,706,14,18,8,6
1134,714,0,0,60,60,0,1,0,1,0
8655,26,25872,16,3170,977,2193,13,135,6,7
17006,28,0,0,70,70,0,1,0,1,0
17899,1215,0,0,62,62,0,1,0,1,0
10242,28,0,0,66,66,0,1,0,1,0
8430,10,7321,9,178,94,84,2,30,1,1
20053,188,10137,123,140,140,0,1,30,1,0
12218,26,7785,16,82909,70964,11945,139,283,71,68
10952,849,22692,624,70,70,0,1,5,1,0
15867,28,0,0,66,66,0,1,0,1,0
22293,28,0,0,66,66,0,1,0,1,0
2166,10,8729,9,216,98,118,2,30,1,1
532,247,0,0,3498,1872,1626,48,197,24,24
8015,26,15712,16,7395,1514,5881,26,225,11,15
2648,3216,0,0,62,62,0,1,0,1,0
6999,280,26513,177,484,150,334,2,1200,1,1
10416,28,0,0,66,66,0,1,0,1,0
18321,1472,0,0,66,66,0,1,0,1,0
6048,10,8654,9,240,76,164,2,30,1,1
14954,10,26577,9,200,102,98,2,30,1,1
1401,2938,0,0,62,62,0,1,0,1,0
14513,10,13950,9,226,110,116,2,30,1,1
2406,1215,0,0,62,62,0,1,0,1,0
13176,28,0,0,70,70,0,1,0,1,0
13030,26,24781,16,499,425,74,4,0,3,1
9736,28,0,0,66,66,0,1,0,1,0
5325,26,17115,16,12825,8114,4711,63,269,25,38
11983,26,25660,16,8071,1789,6282,20,326,10,10
19774,28,0,0,70,70,0,1,0,1,0
19827,383,0,0,62,62,0,1,0,1,0
7776,26,3262,16,190,70,120,4,15,2,2
316,10,887,9,199,90,109,2,30,1,1
2984,1589,0,0,66,66,0,1,0,1,0
19302,26,2147,16,6248,829,5419,17,29,9,8
14076,28,0,0,70,70,0,1,0,1,0
9153,28,0,0,70,70,0,1,0,1,0
16293,28,0,0,66,66,0,1,0,1,0
18121,465,0,0,159,159,0,1,0,1,0
19073,28,0,0,66,66,0,1,0,1,0
18298,28,0,0,70,70,0,1,0,1,0
11491,10,22598,9,168,78,90,2,30,1,1
8330,1017,0,0,146,146,0,1,0,1,0
13930,10,16383,9,194,102,92,2,29,1,1
16435,28,0,0,66,66,0,1,0,1,0
2724,1240,6584,920,422,164,258,6,30,3,3
16021,15,10187,11,230,82,148,4,1199,2,2
4455,10,15857,9,237,91,146,2,33,1,1
1664,280,0,0,66,66,0,1,0,1,0
16021,3253,28064,2521,594,594,0,10,1199,10,0
15436,28,0,0,70,70,0,1,0,1,0
12673,1215,0,0,62,62,0,1,0,1,0
3955,1472,0,0,66,66,0,1,0,1,0
8342,10,7420,9,193,102,91,2,30,1,1
9132,28,0,0,70,70,0,1,0,1,0
9065,10,14995,9,186,95,91,2,31,1,1
2488,1307,0,0,60,60,0,1,0,1,0
2172,1330,16353,1005,481,150,331,2,1199,1,1
20212,1888,0,0,62,62,0,1,0,1,0
2796,15,13578,11,1550,850,700,10,18,5,5
18940,26,26688,16,1373,712,661,14,18,8,6
13338,28,0,0,70,70,0,1,0,1,0
15942,28,0,0,70,70,0,1,0,1,0
14008,28,0,0,70,70,0,1,0,1,0
13210,28,0,0,70,70,0,1,0,1,0
9867,26,21063,16,12515,5891,6624,42,166,22,20
652,980,0,0,100,100,0,1,0,1,0
18260,1539,0,0,62,62,0,1,0,1,0
8490,10,19809,9,192,98,94,2,30,1,1
1443,23,0,0,85,85,0,1,0,1,0
7597,2587,0,0,146,146,0,1,0,1,0
22684,509,0,0,62,62,0,1,0,1,0
10740,2161,12243,1669,70,70,0,1,5,1,0
14554,10,21267,9,762,98,664,2,30,1,1
17024,2205,0,0,66,66,0,1,0,1,0
1425,2104,0,0,139,139,0,1,0,1,0
18018,26,13405,16,7763,1354,6409,25,82,13,12
4531,15,10199,11,941,526,415,11,315,6,5
21714,188,15741,123,189,79,110,2,301,1,1
861,1888,0,0,62,62,0,1,0,1,0
5586,10,17305,9,404,259,145,3,32,2,1
15891,10,8157,9,210,110,100,2,30,1,1
249,1880,0,0,66,66,0,1,0,1,0
13466,28,0,0,70,70,0,1,0,1,0
9832,232,26548,147,402,342,60,2,15,1,1
17705,28,0,0,70,70,0,1,0,1,0
8869,26,1709,16,421435,16499,404936,388,210,95,293
14760,10,12676,9,749,94,655,2,30,1,1
18802,15,5441,11,1638,1324,314,10,15,5,5
2744,1239,25385,919,885,126,759,2,30,1,1
5046,26,18394,16,10853,8227,2626,30,360,15,15
14205,10,19726,9,198,101,97,2,31,1,1
10483,166,22467,114,156,156,0,3,8,3,0
4978,2611,0,0,66,66,0,1,0,1,0
22452,28,0,0,70,70,0,1,0,1,0
15819,26,16439,16,43771,18333,25438,105,126,49,56
1384,1909,0,0,86,86,0,1,0,1,0
453,1797,0,0,62,62,0,1,0,1,0
20486,10,1822,9,304,86,218,2,30,1,1
5940,15,21951,11,2426,1540,886,14,23,8,6
564,2256,0,0,66,66,0,1,0,1,0
9718,28,0,0,70,70,0,1,0,1,0
13423,28,0,0,66,66,0,1,0,1,0
21846,10,4226,9,301,102,199,2,30,1,1
2904,2587,0,0,66,66,0,1,0,1,0
9730,15,22057,11,5320,3428,1892,22,21,12,10
9540,28,0,0,70,70,0,1,0,1,0
19351,28,0,0,70,70,0,1,0,1,0
845,280,0,0,66,66,0,1,0,1,0
20791,28,0,0,70,70,0,1,0,1,0
11040,10,12167,9,218,85,133,2,30,1,1
8323,10,5373,9,199,94,105,2,29,1,1
5252,26,16299,16,3221,1299,1922,15,19,9,6
16050,2256,0,0,66,66,0,1,0,1,0
3791,15,17237,11,1013,504,509,10,17,6,4
10939,26,25508,16,8801,2032,6769,28,361,14,14
636,280,0,0,62,62,0,1,0,1,0
7356,26,3292,16,13661,2246,11415,28,256,14,14
15084,10,1033,9,184,94,90,2,30,1,1
21912,10,8194,9,535,100,435,4,36,2,2
19208,28,0,0,70,70,0,1,0,1,0
9109,10,9512,9,821,102,719,2,30,1,1
15209,26,18713,16,8865,1819,7046,24,30,14,10
15080,10,21883,9,726,85,641,2,31,1,1
14469,10,8774,9,190,97,93,2,31,1,1
10487,28,0,0,66,66,0,1,0,1,0
12858,10,18038,9,578,286,292,9,0,5,4
19452,26,27332,16,4672,1765,2907,19,28,11,8
8210,2627,21194,2037,460,150,310,2,1200,1,1
9621,15,22001,11,20873,1203,19670,30,21,13,17
14938,10,27575,9,168,86,82,2,30,1,1
22127,10,11694,9,168,86,82,2,30,1,1
2666,1017,0,0,62,62,0,1,0,1,0
19648,28,0,0,70,70,0,1,0,1,0
22603,10,12248,9,782,105,677,2,31,1,1
5623,26,28002,16,21525,15159,6366,43,315,25,18
16951,255,0,0,62,62,0,1,0,1,0
20938,3216,0,0,66,66,0,1,0,1,0
9998,26,13257,16,9517,1897,7620,21,130,11,10
4209,10,3196,9,168,78,90,2,30,1,1
415,1054,0,0,66,66,0,1,0,1,0
11190,1,0,0,145,145,0,1,0,1,0
14722,10,2241,9,167,86,81,2,30,1,1
12708,10,16626,9,164,78,86,2,30,1,1
13861,26,7440,16,3717,2233,1484,34,80,20,14
10260,26,27156,16,7124,2457,4667,23,120,10,13
22342,10,15611,9,438,180,258,6,30,3,3
16192,28,0,0,70,70,0,1,0,1,0
950,26,13321,16,5146,960,4186,17,25,9,8
22443,10,4154,9,479,98,381,4,57,2,2
9974,28,0,0,70,70,0,1,0,1,0
16951,255,0,0,62,62,0,1,0,1,0
21306,28,0,0,70,70,0,1,0,1,0
1559,1147,0,0,62,62,0,1,0,1,0
5453,26,20764,16,7123,1331,5792,22,81,11,11
9029,26,10470,16,6177,1038,5139,22,56,11,11
18757,15,2943,11,254,128,126,5,16,3,2
5590,1147,0,0,66,66,0,1,0,1,0
22511,10,28122,9,294,94,200,4,51,2,2
19491,28,0,0,66,66,0,1,0,1,0
10639,1017,0,0,66,66,0,1,0,1,0
13644,10,15188,9,168,86,82,2,31,1,1
19638,28,0,0,66,66,0,1,0,1,0
4664,26,18157,16,24810,10597,14213,51,123,22,29
9411,2151,14186,1660,480,149,331,2,1200,1,1
6096,26,4705,16,28899,3134,25765,66,271,32,34
17276,232,6293,147,16545,8556,7989,69,69,30,39
20253,28,0,0,66,66,0,1,0,1,0
11063,28,0,0,70,70,0,1,0,1,0
9435,15,2669,11,7166,1086,6080,18,87,9,9
10111,28,0,0,66,66,0,1,0,1,0
16611,28,0,0,66,66,0,1,0,1,0
17561,2636,0,0,66,66,0,1,0,1,0
15316,26,10174,16,9868,2027,7841,24,20,12,12
14494,10,13822,9,200,94,106,2,30,1,1
15466,10,15940,9,170,87,83,2,31,1,1
12589,2740,19429,2124,492,306,186,8,15,5,3
123,2739,0,0,66,66,0,1,0,1,0
20737,28,0,0,70,70,0,1,0,1,0
15197,10,8681,9,174,89,85,2,31,1,1
4751,15,11831,11,1190,591,599,8,15,5,3
15628,10,759,9,167,86,81,2,31,1,1
16916,2938,0,0,62,62,0,1,0,1,0
8100,10,21017,9,220,90,130,2,30,1,1
11977,26,7010,16,16024,3168,12856,56,76,31,25
9139,28,0,0,70,70,0,1,0,1,0
209,295,480,190,3022,1567,1455,16,15,8,8
10293,28,0,0,70,70,0,1,0,1,0
22375,10,10513,9,306,110,196,2,30,1,1
10511,15,16175,11,214,140,74,4,15,3,1
2731,7,0,0,60,60,0,1,0,1,0
8546,10,22810,9,260,102,158,2,30,1,1
20477,28,0,0,66,66,0,1,0,1,0
15902,26,13781,16,55537,4477,51060,81,22,38,43
22460,28,0,0,66,66,0,1,0,1,0
13571,28,0,0,70,70,0,1,0,1,0
20704,28,0,0,70,70,0,1,0,1,0
15027,10,2750,9,200,102,98,2,30,1,1
8531,10,8339,9,183,94,89,2,30,1,1
15851,10,26125,9,387,134,253,2,30,1,1
12624,762,13470,550,70,70,0,1,4,1,0
9178,26,2653,16,5644,3210,2434,22,86,13,9
21854,10,13546,9,326,102,224,2,30,1,1
10865,26,20810,16,546,300,246,10,31,6,4
13270,1147,0,0,62,62,0,1,0,1,0
22601,26,21674,16,2494,1643,851,17,25,9,8
9679,28,0,0,70,70,0,1,0,1,0
11011,28,0,0,70,70,0,1,0,1,0
17253,10,7998,9,213,89,124,2,30,1,1
20631,28,0,0,70,70,0,1,0,1,0
14192,10,20512,9,194,102,92,2,31,1,1
497,1610,0,0,66,66,0,1,0,1,0
5018,26,16564,16,279067,22871,256196,327,90,145,182
16510,15,21698,11,254,128,126,5,15,3,2
8,328,0,0,66,66,0,1,0,1,0
5743,26,2836,16,5721,3240,2481,35,147,14,21
5513,10,23140,9,198,93,105,2,31,1,1
17867,28,0,0,70,70,0,1,0,1,0
11061,944,22154,696,66,66,0,1,5,1,0
21208,2573,0,0,62,62,0,1,0,1,0
22162,10,29018,9,193,102,91,2,30,1,1
21822,10,26051,9,209,110,99,2,30,1,1
8965,10,507,9,183,94,89,2,31,1,1
4202,10,20252,9,198,93,105,2,31,1,1
11859,15,16472,11,6266,4430,1836,22,358,13,9
16020,142,25392,101,156,156,0,3,8,3,0
21411,10,24427,9,228,94,134,2,30,1,1
8581,26,14094,16,29561,4857,24704,44,44,15,29
9748,10,696,9,752,93,659,2,31,1,1
16265,28,0,0,70,70,0,1,0,1,0
14492,2416,5024,1880,491,150,341,2,1200,1,1
16951,255,0,0,62,62,0,1,0,1,0
8603,10,21324,9,498,204,294,6,30,3,3
21118,644,16713,448,70,70,0,1,4,1,0
21079,28,0,0,66,66,0,1,0,1,0
21784,10,17808,9,199,102,97,2,30,1,1
14994,10,5375,9,199,102,97,2,29,1,1
2814,10,11564,9,233,90,143,2,32,1,1
20097,28,0,0,70,70,0,1,0,1,0
2609,357,0,0,66,66,0,1,0,1,0
17505,28,0,0,70,70,0,1,0,1,0
22065,1017,0,0,66,66,0,1,0,1,0
10878,28,0,0,66,66,0,1,0,1,0
11105,15,12358,11,422,240,182,8,25,5,3
7694,15,4028,11,613,539,74,7,15,6,1
225,10,7504,9,204,118,86,2,31,1,1
8584,1447,7519,1100,239,78,161,2,30,1,1
4273,1147,0,0,146,146,0,1,0,1,0
14407,10,1058,9,238,87,151,2,30,1,1
4835,698,5054,496,481,150,331,2,1199,1,1
5672,10,20203,9,168,78,90,2,30,1,1
636,280,0,0,146,146,0,1,0,1,0
16027,28,0,0,70,70,0,1,0,1,0
703,2883,0,0,62,62,0,1,0,1,0
15109,10,15945,9,164,86,78,2,30,1,1
19918,26,27642,16,197342,62255,135087,232,170,110,122
22369,3139,0,0,66,66,0,1,0,1,0
6991,1827,0,0,62,62,0,1,0,1,0
8610,26,17936,16,2293735,61874,2231861,2321,87,764,1557
6948,15,18161,11,1298,624,674,12,16,5,7
8533,28,0,0,70,70,0,1,0,1,0
21983,28,0,0,70,70,0,1,0,1,0
9617,15,21997,11,78355,11395,66960,122,27,62,60
10696,26,1712,16,7532,3051,4481,13,121,6,7
21243,2587,0,0,66,66,0,1,0,1,0
614,983,0,0,62,62,0,1,0,1,0
5928,509,0,0,146,146,0,1,0,1,0
7998,2174,0,0,66,66,0,1,0,1,0
12010,15,23285,11,26927,1133,25794,36,15,16,20
19818,26,244,16,17761,7207,10554,44,46,25,19
8910,28,0,0,70,70,0,1,0,1,0
22031,10,20749,9,312,78,234,2,30,1,1
8524,15,1728,11,3014,1052,1962,14,97,9,5
21834,10,25546,9,183,94,89,2,29,1,1
19823,28,0,0,70,70,0,1,0,1,0
13907,10,17464,9,716,95,621,2,31,1,1
8518,10,5433,9,166,86,80,2,30,1,1
22608,2256,0,0,66,66,0,1,0,1,0
16534,28,0,0,70,70,0,1,0,1,0
10882,28,0,0,70,70,0,1,0,1,0
16779,2256,0,0,66,66,0,1,0,1,0
16149,15,25480,11,542818,11392,531426,466,25,106,360
14594,10,9404,9,733,85,648,2,0,1,1
18472,26,733,16,7925,1878,6047,26,66,12,14
12299,26,23442,16,960,539,421,9,30,5,4
15137,10,13316,9,216,110,106,2,31,1,1
21666,10,14603,9,178,94,84,2,30,1,1
11995,3098,16375,2406,70,70,0,1,5,1,0
11085,28,0,0,70,70,0,1,0,1,0
11702,28,0,0,70,70,0,1,0,1,0
14906,2938,0,0,74,74,0,1,0,1,0
2744,1236,12163,916,1628,126,1502,4,31,2,2
14834,10,20720,9,200,102,98,2,30,1,1
9361,2604,0,0,62,62,0,1,0,1,0
17996,26,11936,16,1401,864,537,12,28,6,6
10860,2144,0,0,66,66,0,1,0,1,0
1904,7,0,0,60,60,0,1,0,1,0
13857,10,13981,9,183,94,89,2,30,1,1
4929,26,6469,16,9807,2542,7265,47,19,24,23
17851,26,19173,16,34866,3347,31519,55,54,22,33
13411,26,25887,16,5220,922,4298,17,100,10,7
1070,26,8160,16,5691,503,5188,14,15,7,7
18377,15,20603,11,2390,532,1858,11,75,6,5
11230,28,0,0,70,70,0,1,0,1,0
21313,10,4305,9,182,93,89,2,31,1,1
8918,10,27532,9,182,94,88,2,30,1,1
14370,10,2444,9,748,106,642,2,31,1,1
18332,28,0,0,66,66,0,1,0,1,0
22176,1256,25567,936,996,462,534,4,31,2,2
21504,10,16434,9,257,102,155,2,30,1,1
21849,10,22262,9,166,86,80,2,30,1,1
638,2856,0,0,139,139,0,1,0,1,0
245,1147,0,0,62,62,0,1,0,1,0
15579,10,5493,9,196,102,94,2,29,1,1
566,1017,0,0,62,62,0,1,0,1,0
14214,28,0,0,70,70,0,1,0,1,0
2744,1238,18967,918,868,126,742,2,30,1,1
16951,255,0,0,62,62,0,1,0,1,0
20078,26,19565,16,28183,7016,21167,51,45,23,28
18715,28,0,0,66,66,0,1,0,1,0
20886,15,15988,11,578,518,60,2,5,1,1
15148,26,21220,16,10325,2594,7731,28,27,16,12
12563,26,23092,16,70,70,0,2,8,2,0
18639,28,0,0,70,70,0,1,0,1,0
14749,28,0,0,70,70,0,1,0,1,0
17830,28,0,0,70,70,0,1,0,1,0
16978,2205,0,0,66,66,0,1,0,1,0
21484,10,74,9,264,94,170,2,30,1,1
2744,1245,8796,925,890,126,764,2,31,1,1
14394,28,0,0,70,70,0,1,0,1,0
9253,2587,0,0,66,66,0,1,0,1,0
19424,28,0,0,70,70,0,1,0,1,0
9285,28,0,0,70,70,0,1,0,1,0
5731,26,2131,16,9869,2395,7474,36,129,20,16
10409,28,0,0,66,66,0,1,0,1,0
3133,2326,25505,1810,396,396,0,7,3615,7,0
22464,10,23445,9,233,102,131,2,29,1,1
21500,28,0,0,66,66,0,1,0,1,0
20258,26,27856,16,4788,1881,2907,19,31,11,8
19995,28,0,0,70,70,0,1,0,1,0
2555,3216,0,0,62,62,0,1,0,1,0
4381,26,29127,16,466,392,74,4,0,3,1
21166,28,0,0,70,70,0,1,0,1,0
9755,15,2515,11,2933,1237,1696,12,20,7,5
13686,3139,0,0,62,62,0,1,0,1,0
15278,10,8278,9,199,102,97,2,30,1,1
17965,28,0,0,70,70,0,1,0,1,0
3552,26,1238,16,18875,13913,4962,116,788,60,56
11013,1489,2156,1131,70,70,0,1,5,1,0
11380,28,0,0,70,70,0,1,0,1,0
6399,26,16611,16,2766,1907,859,17,25,10,7
18044,2587,0,0,66,66,0,1,0,1,0
2484,1147,0,0,62,62,0,1,0,1,0
8513,10,9595,9,228,110,118,2,30,1,1
15660,10,13997,9,711,87,624,2,30,1,1
11130,26,18432,16,14433889,278906,14154983,13633,66,4079,9554
14508,10,29044,9,184,94,90,2,30,1,1
4302,26,21803,16,1149,709,440,13,38,8,5
14332,10,25542,9,193,102,91,2,30,1,1
15921,10,25346,9,213,79,134,2,32,1,1
9499,26,27051,16,4137,2232,1905,13,132,8,5
14067,28,0,0,70,70,0,1,0,1,0
14261,28,0,0,70,70,0,1,0,1,0
14210,10,25413,9,177,94,83,2,30,1,1
18157,28,0,0,70,70,0,1,0,1,0
8369,10,9172,9,498,204,294,6,29,3,3
1700,1147,0,0,62,62,0,1,0,1,0
15694,1787,0,0,145,145,0,1,0,1,0
16934,10,11801,9,168,78,90,2,30,1,1
9705,28,0,0,66,66,0,1,0,1,0
9881,28,0,0,70,70,0,1,0,1,0
10220,15,13439,11,2794,2075,719,15,30,9,6
22248,10,1259,9,302,102,200,2,30,1,1
21430,28,0,0,70,70,0,1,0,1,0
16569,28,0,0,70,70,0,1,0,1,0
19513,26,27376,16,76863,6096,70767,103,17,49,54
8756,2938,0,0,78,78,0,1,0,1,0
9630,26,3452,16,5791,3692,2099,21,78,13,8
21977,10,12398,9,195,102,93,2,30,1,1
5658,2938,0,0,62,62,0,1,0,1,0
21804,10,28691,9,388,95,293,4,32,2,2
22288,10,4804,9,209,110,99,2,30,1,1
3870,10,14950,9,825,99,726,2,30,1,1
15316,26,13134,16,8059,2039,6020,20,15,11,9
11461,28,0,0,70,70,0,1,0,1,0
10867,1888,0,0,66,66,0,1,0,1,0
22684,10,11595,9,209,110,99,2,30,1,1
15512,10,17873,9,216,110,106,2,31,1,1
9108,10,16933,9,196,102,94,2,31,1,1
3528,26,17352,16,9551,2173,7378,33,27,17,16
4623,1017,0,0,62,62,0,1,0,1,0
11057,26,17407,16,8698,1393,7305,22,16,12,10
3387,10,13636,9,177,86,91,2,30,1,1
13818,28,0,0,70,70,0,1,0,1,0
22644,10,9620,9,311,94,217,2,30,1,1
22287,10,14897,9,272,94,178,2,30,1,1
14810,28,0,0,66,66,0,1,0,1,0
16932,26,8853,16,154,94,60,2,5,1,1
13753,28,0,0,70,70,0,1,0,1,0
14177,28,0,0,70,70,0,1,0,1,0
18263,26,22934,16,26293,7740,18553,55,121,26,29
21936,10,13248,9,190,97,93,2,30,1,1
15069,26,23120,16,6066,1016,5050,20,26,11,9
14976,26,21096,16,77506,2940,74566,100,80,38,62
5371,15,955,11,2088,472,1616,15,155,3,12
8518,10,24722,9,166,86,80,2,29,1,1
12202,28,0,0,70,70,0,1,0,1,0
22379,10,15613,9,193,102,91,2,31,1,1
20556,10,28357,9,303,85,218,2,30,1,1
5569,139,0,0,60,60,0,1,0,1,0
17173,10,22079,9,168,78,90,2,30,1,1
8797,26,21146,16,8558,1006,7552,16,121,7,9
13021,28,0,0,70,70,0,1,0,1,0
1143,983,0,0,66,66,0,1,0,1,0
19413,28,0,0,66,66,0,1,0,1,0
15299,26,16107,16,7941,1952,5989,20,15,11,9
4759,26,20525,16,13986,9199,4787,59,94,24,35
21449,10,1428,9,180,94,86,2,30,1,1
15286,10,10666,9,209,110,99,2,30,1,1
13985,26,15540,16,3811,2320,1491,33,735,18,15
13409,26,14373,16,4851,1269,3582,21,148,9,12
20042,697,0,0,146,146,0,1,0,1,0
12412,3216,0,0,66,66,0,1,0,1,0
405,10,1266,9,235,90,145,2,32,1,1
6989,26,331,16,22366,9583,12783,50,37,25,25
15598,10,6668,9,168,86,82,2,30,1,1
11367,28,0,0,70,70,0,1,0,1,0
6846,8,0,0,74,74,0,1,0,1,0
13651,1215,0,0,62,62,0,1,0,1,0
6556,2587,0,0,146,146,0,1,0,1,0
363,7,0,0,60,60,0,1,0,1,0
10327,1527,11152,1164,2274,924,1350,30,3293,15,15
12006,1552,12554,1183,698,320,378,10,17,6,4
9112,10,13587,9,177,94,83,2,30,1,1
18624,28,0,0,66,66,0,1,0,1,0
18190,1472,0,0,66,66,0,1,0,1,0
2429,2883,0,0,66,66,0,1,0,1,0
14522,10,1677,9,199,102,97,2,31,1,1
11964,1147,0,0,66,66,0,1,0,1,0
8584,1457,26083,1110,238,71,167,2,30,1,1
9212,26,3244,16,7912,3269,4643,23,95,12,11
17510,26,12988,16,5413,968,4445,20,15,11,9
7998,2174,0,0,62,62,0,1,0,1,0
10506,2943,0,0,100,100,0,1,0,1,0
11827,28,0,0,70,70,0,1,0,1,0
4578,983,0,0,62,62,0,1,0,1,0
3866,26,15255,16,70,70,0,1,5,1,0
15258,26,28983,16,268,120,148,5,11,3,2
10331,28,0,0,70,70,0,1,0,1,0
12783,1065,13705,784,1740,834,906,16,16,10,6
7253,26,25913,16,8487,2231,6256,26,350,12,14
21542,28,0,0,70,70,0,1,0,1,0
4778,15,9543,11,2293,1576,717,12,15,6,6
22679,26,19774,16,405489,12010,393479,416,16,146,270
9375,10,15671,9,173,94,79,2,30,1,1
582,1147,0,0,62,62,0,1,0,1,0
4146,15,17315,11,34712,2489,32223,52,19,27,25
19454,15,299,11,124,64,60,2,16,1,1
17572,28,0,0,70,70,0,1,0,1,0
21902,28,0,0,66,66,0,1,0,1,0
16021,2760,8569,2139,150,150,0,1,1199,1,0
15598,28,0,0,66,66,0,1,0,1,0
12330,28,0,0,66,66,0,1,0,1,0
20113,28,0,0,70,70,0,1,0,1,0
17490,28,0,0,66,66,0,1,0,1,0
4631,1888,0,0,66,66,0,1,0,1,0
8463,10,23319,9,193,102,91,2,31,1,1
11603,28,0,0,70,70,0,1,0,1,0
15218,10,9302,9,190,97,93,2,31,1,1
8466,26,6003,16,6681,1950,4731,24,45,14,10
669,2636,0,0,62,62,0,1,0,1,0
8417,10,8523,9,731,85,646,2,30,1,1
9411,2542,11826,1976,402,132,270,6,1209,3,3
14732,10,389,9,783,96,687,2,31,1,1
20536,26,9888,16,303,85,218,2,30,1,1
8924,10,28349,9,243,102,141,2,30,1,1
17179,26,1507,16,5168,700,4468,16,15,7,9
22517,10,9945,9,748,94,654,2,30,1,1
1298,1147,0,0,62,62,0,1,0,1,0
12507,15,6610,11,5090,4357,733,17,15,11,6
9703,10,5597,9,216,110,106,2,29,1,1
10008,15,22966,11,121344,7345,113999,144,141,61,83
14383,10,9968,9,311,94,217,2,30,1,1
15357,10,22459,9,197,94,103,2,30,1,1
14137,10,8613,9,199,94,105,2,30,1,1
16205,10,23377,9,243,94,149,2,30,1,1
6359,183,18480,121,4930,2691,2239,24,19,14,10
8679,10,8335,9,391,102,289,4,31,2,2
4628,26,3185,16,5516,1774,3742,21,46,13,8
19937,1054,0,0,66,66,0,1,0,1,0
395,2695,0,0,62,62,0,1,0,1,0
11086,15,27058,11,3641,846,2795,18,44,7,11
8273,26,8958,16,5952,1328,4624,19,76,11,8
19040,28,0,0,66,66,0,1,0,1,0
2629,1147,0,0,66,66,0,1,0,1,0
13662,983,0,0,62,62,0,1,0,1,0
18443,28,0,0,70,70,0,1,0,1,0
14332,10,3438,9,177,94,83,2,31,1,1
4026,10,19459,9,168,78,90,2,30,1,1
16116,15,12861,11,370,222,148,6,48,4,2
7326,26,15959,16,507235,15454,491781,534,136,188,346
16951,255,0,0,62,62,0,1,0,1,0
166,2486,0,0,62,62,0,1,0,1,0
14474,28,0,0,70,70,0,1,0,1,0
20520,28,0,0,70,70,0,1,0,1,0
153,3216,0,0,66,66,0,1,0,1,0
10789,28,0,0,66,66,0,1,0,1,0
19237,28,0,0,70,70,0,1,0,1,0
15147,10,19321,9,211,102,109,2,30,1,1
5040,2636,0,0,62,62,0,1,0,1,0
6738,26,27447,16,6600,1174,5426,23,62,13,10
14906,10,2025,9,152,78,74,2,30,1,1
190,2938,0,0,78,78,0,1,0,1,0
10394,28,0,0,66,66,0,1,0,1,0
11569,28,0,0,70,70,0,1,0,1,0
10910,342,20965,218,86,86,0,1,29,1,0
14428,10,19030,9,200,102,98,2,32,1,1
8990,10,18616,9,168,86,82,2,30,1,1
14231,26,24494,16,4684,1777,2907,19,12,11,8
17227,26,14755,16,5168,700,4468,16,15,7,9
22421,10,27928,9,199,102,97,2,30,1,1
3136,10,13151,9,197,76,121,2,30,1,1
4357,15,19528,11,1114,534,580,12,15,7,5
9511,28,0,0,70,70,0,1,0,1,0
16512,26,8051,16,6821,1076,5745,21,38,12,9
13291,26,26406,16,4867,1208,3659,16,23,10,6
9844,15,2608,11,142,142,0,1,5,1,0
18796,15,1824,11,1248,516,732,9,15,4,5
21535,10,601,9,354,102,252,2,30,1,1
16182,2883,0,0,62,62,0,1,0,1,0
8526,10,7768,9,216,110,106,2,30,1,1
636,280,19428,177,238,118,120,2,1200,1,1
15663,28,0,0,66,66,0,1,0,1,0
13757,10,18102,9,177,94,83,2,30,1,1
18618,28,0,0,66,66,0,1,0,1,0
21972,28,0,0,70,70,0,1,0,1,0
21789,10,18920,9,168,86,82,2,30,1,1
14305,28,0,0,70,70,0,1,0,1,0
21255,28,0,0,70,70,0,1,0,1,0
532,247,0,0,3354,1792,1562,46,196,23,23
14043,1147,0,0,66,66,0,1,0,1,0
13951,10,16767,9,298,101,197,4,31,2,2
2042,10,8010,9,229,98,131,2,30,1,1
5766,10,0,0,82,82,0,1,30,1,0
1196,26,16687,16,822903,35544,787359,1068,153,463,605
13736,10,65,9,216,110,106,2,30,1,1
14264,15,24511,11,1916,1467,449,10,19,6,4
8938,15,16411,11,70,70,0,2,8,2,0
9461,1167,0,0,66,66,0,1,0,1,0
1107,26,3837,16,3613,433,3180,11,16,6,5
17280,28,0,0,70,70,0,1,0,1,0
9912,28,0,0,70,70,0,1,0,1,0
9611,15,21993,11,886702,38812,847890,1134,23,558,576
2511,10,10535,9,240,98,142,2,30,1,1
12586,10,27554,9,164,78,86,2,31,1,1
13720,10,11676,9,180,94,86,2,30,1,1
18494,2704,13518,2100,70,70,0,2,8,2,0
21417,28,0,0,66,66,0,1,0,1,0
17902,26,5737,16,1077274,41232,1036042,1152,49,455,697
1541,1771,0,0,62,62,0,1,0,1,0
12926,28,0,0,70,70,0,1,0,1,0
10068,15,27817,11,10423067,111935,10311132,8558,119,1601,6957
19031,2256,0,0,66,66,0,1,0,1,0
11381,28,0,0,70,70,0,1,0,1,0
12815,26,9772,16,3330,1694,1636,15,30,8,7
9174,28,0,0,70,70,0,1,0,1,0
10007,15,26925,11,141059,7791,133268,168,140,72,96
12825,2938,0,0,66,66,0,1,0,1,0
14641,2587,0,0,62,62,0,1,0,1,0
13564,1804,0,0,66,66,0,1,0,1,0
10116,451,19111,290,217,157,60,2,5,1,1
7112,26,27287,16,6357,1546,4811,26,17,14,12
22424,10,12360,9,232,110,122,2,30,1,1
19590,2256,0,0,66,66,0,1,0,1,0
17501,28,0,0,66,66,0,1,0,1,0
10939,280,0,0,66,66,0,1,0,1,0
9723,15,21178,11,265114,13651,251463,346,76,161,185
21056,28,0,0,66,66,0,1,0,1,0
15310,26,13966,16,7942,1953,5989,20,15,11,9
13245,15,7777,11,130,70,60,2,15,1,1
7023,255,19458,160,130,66,64,2,4,1,1
11023,1147,0,0,66,66,0,1,0,1,0
10686,28,0,0,70,70,0,1,0,1,0
14853,10,24806,9,213,94,119,2,30,1,1
14082,10,24856,9,711,87,624,2,30,1,1
21521,10,17589,9,230,86,144,2,30,1,1
657,2471,0,0,139,139,0,1,0,1,0
15783,10,28346,9,177,94,83,2,30,1,1
12434,28,0,0,70,70,0,1,0,1,0
15433,1584,26576,1214,66,66,0,1,5,1,0
5795,26,5971,16,6450,1003,5447,21,360,11,10
14835,28,0,0,70,70,0,1,0,1,0
12507,2883,0,0,62,62,0,1,0,1,0
18663,26,23754,16,154465,11473,142992,244,212,101,143
22256,10,26916,9,184,102,82,2,30,1,1
18943,26,1199,16,1373,712,661,14,18,8,6
5457,15,17300,11,680,70,610,11,392,2,9
3989,26,740,16,22457,12680,9777,65,20,34,31
4640,738,27108,529,130,70,60,2,30,1,1
15438,15,17008,11,13608,783,12825,21,45,9,12
21293,10,22931,9,184,94,90,2,30,1,1
11958,28,0,0,66,66,0,1,0,1,0
20888,697,0,0,62,62,0,1,0,1,0
12253,1147,0,0,66,66,0,1,0,1,0
13515,26,24117,16,306802,26705,280097,395,21,190,205
15009,26,19653,16,10956,4863,6093,47,82,22,25
2721,1888,0,0,66,66,0,1,0,1,0
7143,26,3060,16,3094,2048,1046,18,16,9,9
15566,15,23263,11,214,140,74,4,35,3,1
22707,252,0,0,62,62,0,1,0,1,0
22460,10,20508,9,216,110,106,2,30,1,1
15667,10,12015,9,180,94,86,2,31,1,1
18993,697,0,0,146,146,0,1,0,1,0
18287,28,0,0,70,70,0,1,0,1,0
22488,10,10305,9,195,102,93,2,30,1,1
658,491,0,0,143,143,0,1,0,1,0
13161,10,23896,9,414,268,146,3,33,2,1
5367,26,3385,16,903603,21528,882075,858,57,234,624
9411,2913,20725,2262,480,149,331,2,1200,1,1
12576,28,0,0,66,66,0,1,0,1,0
927,15,21370,11,2066,651,1415,11,35,6,5
1281,2543,0,0,60,60,0,1,0,1,0
15052,10,26711,9,209,110,99,2,29,1,1
22687,10,11064,9,209,110,99,2,30,1,1
16138,1590,0,0,62,62,0,1,0,1,0
15574,10,22261,9,210,110,100,2,30,1,1
5949,104,0,0,60,60,0,1,0,1,0
11299,26,22873,16,1615,941,674,15,20,7,8
8839,26,13730,16,6404,829,5575,18,57,9,9
3716,26,1575,16,402051,17714,384337,520,83,228,292
7302,2604,0,0,66,66,0,1,0,1,0
17797,26,24715,16,9055,2404,6651,24,126,13,11
3747,10,23792,9,199,94,105,2,30,1,1
10818,1788,10778,1365,70,70,0,1,4,1,0
12,207,0,0,320,320,0,1,0,1,0
21789,10,10233,9,182,94,88,2,30,1,1
6250,2007,17284,1537,563,86,477,2,30,1,1
21635,10,9098,9,307,105,202,4,47,2,2
15706,10,18538,9,184,94,90,2,30,1,1
5232,15,7203,11,1114,534,580,12,15,7,5
13710,2883,0,0,62,62,0,1,0,1,0
14988,26,25261,16,25302,1733,23569,35,121,16,19
18156,26,28724,16,432803,9264,423539,427,141,135,292
15138,10,21115,9,182,93,89,2,31,1,1
19927,28,0,0,66,66,0,1,0,1,0
13697,2938,0,0,78,78,0,1,0,1,0
637,2636,0,0,66,66,0,1,0,1,0
8499,10,16818,9,740,93,647,2,31,1,1
22379,10,15166,9,182,93,89,2,30,1,1
2578,510,0,0,66,66,0,1,0,1,0
17190,10,0,0,180,82,98,2,31,1,1
1398,2261,0,0,60,60,0,1,0,1,0
14205,10,11151,9,199,102,97,2,30,1,1
2744,85,10235,65,860,126,734,2,30,1,1
2124,2610,0,0,72,72,0,1,0,1,0
2030,2899,0,0,78,78,0,1,0,1,0
16885,28,0,0,66,66,0,1,0,1,0
10611,28,0,0,70,70,0,1,0,1,0
15015,15,14786,11,17067,1439,15628,23,25,8,15
20419,28,0,0,70,70,0,1,0,1,0
22087,28,0,0,70,70,0,1,0,1,0
15495,10,28289,9,168,86,82,2,31,1,1
9713,15,1800,11,318,192,126,6,26,4,2
9668,26,8954,16,1389,868,521,12,25,6,6
11528,26,13198,16,4362,1826,2536,18,134,8,10
612,133,0,0,60,60,0,1,0,1,0
20517,28,0,0,70,70,0,1,0,1,0
2744,1241,5007,921,879,126,753,2,30,1,1
2744,1868,19185,1426,886,126,760,2,30,1,1
11450,1686,0,0,60,60,0,1,0,1,0
360,3105,0,0,804,804,0,1,0,1,0
15347,10,20575,9,168,86,82,2,30,1,1
5639,2836,0,0,62,62,0,1,0,1,0
9409,28,0,0,70,70,0,1,0,1,0
1083,26,26633,16,2581,1602,979,17,20,9,8
16467,28,0,0,70,70,0,1,0,1,0
13743,10,14717,9,196,102,94,2,29,1,1
15484,10,9358,9,211,78,133,2,30,1,1
10706,28,0,0,70,70,0,1,0,1,0
20846,2486,0,0,66,66,0,1,0,1,0
17211,26,21547,16,23915,4341,19574,37,120,15,22
14364,28,0,0,70,70,0,1,0,1,0
5983,2587,0,0,66,66,0,1,0,1,0
13957,28,0,0,70,70,0,1,0,1,0
19051,2938,0,0,145,145,0,1,0,1,0
14261,10,26461,9,195,102,93,2,30,1,1
4686,26,23468,16,8493,2314,6179,33,16,18,15
18626,1215,0,0,62,62,0,1,0,1,0
15950,10,17104,9,193,102,91,2,31,1,1
5258,26,1508,16,3589,1251,2338,15,20,9,6
20088,983,0,0,66,66,0,1,0,1,0
17657,1827,0,0,62,62,0,1,0,1,0
21908,10,2020,9,86,86,0,1,60,1,0
9604,26,21988,16,1159,668,491,11,31,6,5
10142,15,12347,11,2654,796,1858,12,18,7,5
14003,10,18185,9,184,94,90,2,31,1,1
21123,28,0,0,70,70,0,1,0,1,0
4510,26,14190,16,1753,1108,645,16,26,9,7
4370,3216,0,0,62,62,0,1,0,1,0
8781,10,25301,9,199,102,97,2,30,1,1
16951,255,0,0,62,62,0,1,0,1,0
10095,26,14964,16,6350,1072,5278,18,40,10,8
15847,26,19666,16,2693,1361,1332,17,19,10,7
21812,26,21159,16,24686,1935,22751,36,19,17,19
8833,26,27180,16,334,140,194,6,25,3,3
21756,10,8475,9,274,94,180,4,33,2,2
10989,26,7660,16,20648,4726,15922,40,48,19,21
17085,10,26037,9,216,90,126,2,30,1,1
360,3105,0,0,1305,1305,0,1,0,1,0
22157,10,19160,9,243,94,149,2,30,1,1
15470,510,0,0,66,66,0,1,0,1,0
8514,10,9874,9,342,91,251,4,54,2,2
5634,391,0,0,60,60,0,1,0,1,0
17087,7,0,0,60,60,0,1,0,1,0
1808,697,0,0,62,62,0,1,0,1,0
4360,26,3368,16,6506,1532,4974,28,16,14,14
11884,28,0,0,70,70,0,1,0,1,0
16951,255,0,0,62,62,0,1,0,1,0
11128,26,16592,16,3015,2037,978,15,15,9,6
10273,28,0,0,70,70,0,1,0,1,0
15419,26,21040,16,10878,4815,6063,60,196,31,29
14722,1888,0,0,66,66,0,1,0,1,0
3157,10,13249,9,407,261,146,3,32,2,1
8897,26,5787,16,13155,3815,9340,29,24,13,16
21501,2587,0,0,66,66,0,1,0,1,0
12141,28,0,0,66,66,0,1,0,1,0
10917,28,0,0,70,70,0,1,0,1,0
15492,10,9606,9,423,95,328,4,34,2,2
2308,3216,0,0,66,66,0,1,0,1,0
13702,10,26240,9,780,104,676,2,30,1,1
11026,1771,0,0,66,66,0,1,0,1,0
21758,10,4597,9,377,94,283,2,30,1,1
14469,10,1113,9,889,404,485,10,30,5,5
4488,2144,0,0,62,62,0,1,0,1,0
15374,15,28348,11,1514,481,1033,11,15,6,5
2744,1238,27465,918,888,126,762,2,30,1,1
12,1387,0,0,74,74,0,1,0,1,0
21542,10,15278,9,306,94,212,2,29,1,1
14903,10,16910,9,182,93,89,2,31,1,1
13134,10,26560,9,168,78,90,2,29,1,1
6975,1017,0,0,146,146,0,1,0,1,0
15317,26,20462,16,8007,1987,6020,20,15,11,9
16684,26,19244,16,42792,12402,30390,98,370,45,53
18441,26,16440,16,130,70,60,2,15,1,1
5923,15,23404,11,1056,682,374,10,15,6,4
3724,1147,0,0,62,62,0,1,0,1,0
8550,28,0,0,70,70,0,1,0,1,0
9186,10,1642,9,198,110,88,2,29,1,1
9518,28,0,0,66,66,0,1,0,1,0
7403,26,28203,16,4182,2874,1308,17,361,9,8
14902,28,0,0,70,70,0,1,0,1,0
22141,10,20049,9,168,86,82,2,31,1,1
15288,1147,0,0,146,146,0,1,0,1,0
906,26,19716,16,5734,498,5236,14,15,7,7
13990,10,2561,9,216,110,106,2,31,1,1
11731,26,23094,16,70,70,0,2,154,2,0
8643,10,3742,9,271,88,183,4,59,2,2
12622,28,0,0,66,66,0,1,0,1,0
14361,10,20089,9,177,94,83,2,29,1,1
16951,255,0,0,62,62,0,1,0,1,0
8623,28,0,0,66,66,0,1,0,1,0
6889,1888,0,0,62,62,0,1,0,1,0
13901,1888,0,0,146,146,0,1,0,1,0
21851,1827,0,0,62,62,0,1,0,1,0
4063,26,22890,16,7298,2601,4697,21,26,10,11
17082,10,26036,9,310,94,216,2,30,1,1
9546,15,7544,11,5981,3589,2392,15,32,8,7
14402,10,5596,9,182,93,89,3,33,2,1
21678,10,12635,9,214,102,112,2,30,1,1
12144,28,0,0,70,70,0,1,0,1,0
18464,28,0,0,70,70,0,1,0,1,0
22424,28,0,0,66,66,0,1,0,1,0
17202,28,0,0,70,70,0,1,0,1,0
15804,28,0,0,66,66,0,1,0,1,0
9224,28,0,0,70,70,0,1,0,1,0
16951,255,0,0,62,62,0,1,0,1,0
14247,28,0,0,70,70,0,1,0,1,0
4581,15,23842,11,1115,562,553,13,362,6,7
18512,28,0,0,70,70,0,1,0,1,0
15903,28,0,0,70,70,0,1,0,1,0
0,0,0,0,98,98,0,1,0,1,0
22036,10,28187,9,212,102,110,2,30,1,1
20796,28,0,0,70,70,0,1,0,1,0
14538,15,24668,11,17982,2112,15870,35,28,18,17
18782,28,0,0,66,66,0,1,0,1,0
7013,26,21615,16,296,78,218,4,19,1,3
1575,2938,0,0,66,66,0,1,0,1,0
14422,28,0,0,70,70,0,1,0,1,0
8663,28,0,0,70,70,0,1,0,1,0
9330,10,26453,9,178,94,84,2,29,1,1
19770,3216,0,0,145,145,0,1,0,1,0
4178,346,6891,220,170,110,60,2,5,1,1
2229,697,0,0,62,62,0,1,0,1,0
12,1060,0,0,100,100,0,1,0,1,0
4188,26,24293,16,2959,793,2166,10,120,5,5
9460,28,0,0,66,66,0,1,0,1,0
7908,2581,0,0,62,62,0,1,0,1,0
22551,10,24542,9,193,102,91,2,30,1,1
18437,26,5828,16,15475,7059,8416,33,97,18,15
19704,15,10785,11,2170,472,1698,10,125,6,4
3209,2611,0,0,66,66,0,1,0,1,0
11725,26,27382,16,7203,2188,5015,23,186,11,12
6210,26,11596,16,4117,1026,3091,15,31,9,6
15876,10,20333,9,353,94,259,2,30,1,1
20544,28,0,0,70,70,0,1,0,1,0
10651,1147,0,0,62,62,0,1,0,1,0
7867,2636,0,0,62,62,0,1,0,1,0
15221,28,0,0,70,70,0,1,0,1,0
6362,26,17915,16,10170,2072,8098,37,255,19,18
16951,255,0,0,62,62,0,1,0,1,0
12203,1763,0,0,62,62,0,1,0,1,0
10285,15,26024,11,1658,1344,314,10,15,5,5
8313,26,11889,16,6150,914,5236,18,97,10,8
17745,28,0,0,66,66,0,1,0,1,0
11918,15,23234,11,184725,5028,179697,217,25,75,142
15443,10,28118,9,752,93,659,2,30,1,1
9728,2627,6611,2037,475,150,325,2,1200,1,1
1028,26,1528,16,674,128,546,12,45,3,9
8584,1624,24644,1246,244,78,166,2,30,1,1
13396,26,7105,16,5747,1892,3855,19,17,11,8
9439,28,0,0,70,70,0,1,0,1,0
18067,1804,0,0,66,66,0,1,0,1,0
13509,26,24114,16,158092,23051,135041,216,21,110,106
12,848,0,0,74,74,0,1,0,1,0
7375,26,24601,16,14746,3097,11649,34,19,19,15
7073,15,9855,11,1539,553,986,10,14,6,4
7335,1070,0,0,60,60,0,1,0,1,0
10641,26,14245,16,19611,6865,12746,46,37,24,22
8234,26,16800,16,8105,1902,6203,24,26,14,10
11243,2908,24199,2257,66,66,0,1,5,1,0
18,3145,0,0,148,148,0,1,0,1,0
11790,26,10610,16,89335,4699,84636,107,118,32,75
8798,10,5866,9,199,102,97,2,30,1,1
11089,15,8277,11,426,240,186,8,25,5,3
16643,28,0,0,66,66,0,1,0,1,0
13235,26,23933,16,101021,6173,94848,142,18,65,77
9879,28,0,0,66,66,0,1,0,1,0
12648,26,13054,16,499,425,74,4,0,3,1
11953,28,0,0,70,70,0,1,0,1,0
6526,1590,0,0,145,145,0,1,0,1,0
10443,28,0,0,66,66,0,1,0,1,0
21347,28,0,0,66,66,0,1,0,1,0
8652,10,6965,9,177,94,83,2,30,1,1
13724,10,20795,9,195,102,93,2,31,1,1
9643,10,9848,9,718,94,624,2,30,1,1
9734,10,23611,9,889,404,485,10,30,5,5
15895,26,13267,16,222159,52803,169356,361,26,173,188
16874,28,0,0,66,66,0,1,0,1,0
13707,26,16727,16,23234,3906,19328,40,61,19,21
9113,26,2709,16,4712,908,3804,18,89,9,9
15584,2545,0,0,66,66,0,1,0,1,0
4204,26,15458,16,4585,1678,2907,19,29,11,8
17376,10,19999,9,195,94,101,2,30,1,1
10131,26,25736,16,3536,2198,1338,18,332,9,9
21379,10,19573,9,288,101,187,4,28,2,2
4456,1215,0,0,62,62,0,1,0,1,0
15138,26,21705,16,8821,3228,5593,25,60,15,10
14948,10,23049,9,188,96,92,2,31,1,1
10656,2883,0,0,62,62,0,1,0,1,0
4798,26,16979,16,25928,15100,10828,59,39,37,22
694,1147,0,0,66,66,0,1,0,1,0
6676,26,4271,16,13212,9431,3781,41,238,21,20
13752,10,22849,9,197,102,95,2,31,1,1
18783,1356,28577,1029,70,70,0,2,8,2,0
5599,26,11334,16,7221,2940,4281,30,23,16,14
13436,28,0,0,66,66,0,1,0,1,0
2580,2853,0,0,66,66,0,1,0,1,0
20006,28,0,0,70,70,0,1,0,1,0
22411,28,0,0,70,70,0,1,0,1,0
13406,28,0,0,70,70,0,1,0,1,0
745,1017,0,0,62,62,0,1,0,1,0
13495,15,27280,11,6098,1916,4182,31,357,16,15
460,10,1624,9,213,87,126,2,30,1,1
8210,3198,21194,2479,513,152,361,2,1200,1,1
9502,26,15812,16,1786,172,1614,7,121,3,4
10619,10,3689,9,199,94,105,2,30,1,1
2706,2440,0,0,62,62,0,1,0,1,0
15399,183,25101,121,3910,1805,2105,20,18,12,8
8759,10,25220,9,212,94,118,2,29,1,1
19790,28,0,0,66,66,0,1,0,1,0
5718,26,21454,16,9462,6402,3060,32,394,11,21
11776,26,23167,16,313243,267937,45306,456,5925,210,246
20530,10,7236,9,304,86,218,2,30,1,1
22506,28,0,0,70,70,0,1,0,1,0
20412,40,4812,23,9122,4055,5067,84,67,39,45
7161,26,2842,16,2593,1394,1199,20,13,11,9
18199,1017,0,0,66,66,0,1,0,1,0
10929,2417,24162,1881,70,70,0,2,8,2,0
17376,28,0,0,66,66,0,1,0,1,0
22444,28,0,0,66,66,0,1,0,1,0
8950,28,0,0,66,66,0,1,0,1,0
9080,26,5768,16,2970,1793,1177,20,15,12,8
11158,1880,0,0,66,66,0,1,0,1,0
21278,473,5347,307,66,66,0,2,8,2,0
15514,10,13876,9,212,102,110,2,30,1,1
16951,255,0,0,62,62,0,1,0,1,0
9112,10,7878,9,380,110,270,2,30,1,1
7471,26,29043,16,12982,7168,5814,50,165,23,27
13205,26,17497,16,716056,89267,626789,952,300,368,584
21162,2256,0,0,66,66,0,1,0,1,0
7757,26,27038,16,11085,2554,8531,48,19,24,24
7624,2938,0,0,62,62,0,1,0,1,0
8649,10,1983,9,273,94,179,2,30,1,1
16704,26,15182,16,5995,3536,2459,31,20,17,14
1730,1017,0,0,62,62,0,1,0,1,0
20857,2587,0,0,66,66,0,1,0,1,0
9214,3256,0,0,60,60,0,1,0,1,0
2459,1771,0,0,62,62,0,1,0,1,0
8584,1449,22180,1102,242,71,171,2,30,1,1
13206,26,9459,16,8198,1975,6223,24,361,11,13
11055,28,0,0,66,66,0,1,0,1,0
17020,28,0,0,70,70,0,1,0,1,0
1309,1017,0,0,146,146,0,1,0,1,0
5709,1215,0,0,62,62,0,1,0,1,0
9392,2256,0,0,66,66,0,1,0,1,0
360,3105,0,0,780,780,0,1,0,1,0
16057,18,20668,13,184,94,90,2,29,1,1
15113,26,3555,16,8866,2743,6123,23,139,11,12
8380,10,19388,9,211,102,109,2,30,1,1
17322,28,0,0,66,66,0,1,0,1,0
22541,10,15893,9,170,87,83,2,30,1,1
13253,28,0,0,70,70,0,1,0,1,0
8491,26,23052,16,6147,943,5204,17,16,9,8
20644,2573,0,0,62,62,0,1,0,1,0
12934,28,0,0,66,66,0,1,0,1,0
12,3050,0,0,60,60,0,1,0,1,0
12178,26,1894,16,494,288,206,8,26,5,3
11062,2842,25107,2206,70,70,0,2,8,2,0
12575,26,14750,16,499,425,74,4,0,3,1
8925,10,13121,9,216,110,106,2,31,1,1
6010,26,2542,16,5954,1607,4347,27,215,14,13
351,797,0,0,66,66,0,1,0,1,0
8937,10,11902,9,177,94,83,2,29,1,1
20788,2938,0,0,66,66,0,1,0,1,0
22227,10,28192,9,215,94,121,2,29,1,1
5093,676,24102,475,138,78,60,2,5,1,1
14579,10,7935,9,760,97,663,2,31,1,1
12855,28,0,0,70,70,0,1,0,1,0
20559,10,6705,9,512,166,346,2,30,1,1
5296,26,15921,16,6328,850,5478,26,289,9,17
1081,26,23870,16,5695,505,5190,14,15,7,7
8499,10,22213,9,281,98,183,4,57,2,2
4842,2504,6720,1947,156,156,0,3,8,3,0
16830,1888,0,0,66,66,0,1,0,1,0
14219,10,9278,9,195,102,93,2,30,1,1
22247,10,10675,9,165,86,79,2,30,1,1
9609,15,15213,11,8499,2011,6488,17,21,8,9
22354,26,24041,16,2963,1304,1659,28,120,14,14
844,697,0,0,146,146,0,1,0,1,0
6662,10,6773,9,199,94,105,2,30,1,1
10857,2883,0,0,66,66,0,1,0,1,0
19245,28,0,0,66,66,0,1,0,1,0
3963,183,15083,121,3424,1710,1714,16,33,8,8
5945,26,14134,16,27475,5634,21841,76,145,35,41
9707,28,0,0,70,70,0,1,0,1,0
9005,15,22712,11,3126,469,2657,9,75,5,4
532,247,0,0,3562,1936,1626,48,194,24,24
16844,2938,0,0,66,66,0,1,0,1,0
22605,10,14609,9,197,102,95,2,30,1,1
8054,346,0,0,368,156,212,5,13,3,2
20115,28,0,0,70,70,0,1,0,1,0
22392,1308,24759,985,232,78,154,2,29,1,1
277,1539,0,0,62,62,0,1,0,1,0
12118,26,25645,16,91414,11700,79714,174,59,65,109
21264,10,28220,9,264,110,154,2,30,1,1
22567,26,14631,16,55500,40540,14960,137,131,72,65
5907,15,22776,11,234,234,0,4,12,4,0
18944,28,0,0,66,66,0,1,0,1,0
15201,10,9442,9,710,89,621,2,31,1,1
20869,28,0,0,66,66,0,1,0,1,0
21851,28,0,0,66,66,0,1,0,1,0
15108,10,7157,9,309,94,215,2,30,1,1
6419,26,12626,16,134,60,74,3,4,2,1
9877,15,22395,11,1114,534,580,12,16,7,5
22675,10,4459,9,760,97,663,2,30,1,1
21861,10,8517,9,255,102,153,2,30,1,1
8837,15,9910,11,2122,1018,1104,13,41,7,6
15908,10,15046,9,184,94,90,2,30,1,1
8433,26,23052,16,183,70,113,2,120,1,1
14029,28,0,0,70,70,0,1,0,1,0
11094,15,27836,11,65658,3155,62503,76,621,26,50
11813,26,14337,16,13263,7381,5882,51,118,26,25
1841,2953,0,0,66,66,0,1,0,1,0
17318,1147,0,0,62,62,0,1,0,1,0
14253,10,2595,9,94,94,0,1,30,1,0
15002,15,5094,11,33937,628,33309,31,104,6,25
16661,1147,0,0,146,146,0,1,0,1,0
8672,26,5428,16,6002,1965,4037,23,270,11,12
8502,26,27557,16,125790,4516,121274,118,55,28,90
11941,26,1001,16,11020,3760,7260,56,92,25,31
15214,26,11883,16,7849,1860,5989,20,16,11,9
9961,15,6967,11,550,476,74,6,15,5,1
0,0,0,0,320,320,0,5,0,5,0
13278,26,366,16,33625519,489773,33135746,29877,243,6803,23074
8486,10,27807,9,199,102,97,2,30,1,1
7820,2587,0,0,62,62,0,1,0,1,0
9322,1147,0,0,62,62,0,1,0,1,0
10995,26,24078,16,12738,5385,7353,37,67,21,16
4181,234,28631,149,6776,1542,5234,21,3600,12,9
3564,1719,0,0,137,137,0,1,0,1,0
11700,28,0,0,70,70,0,1,0,1,0
613,3197,0,0,145,145,0,1,0,1,0
16986,15,1366,11,1345,726,619,16,362,8,8
6665,10,5374,9,86,86,0,1,30,1,0
2461,1888,0,0,62,62,0,1,0,1,0
5200,10,16845,9,223,78,145,2,30,1,1
22067,10,6984,9,196,102,94,2,30,1,1
16951,255,0,0,62,62,0,1,0,1,0
21573,10,26520,9,182,93,89,2,31,1,1
13867,28,0,0,66,66,0,1,0,1,0
1109,26,8460,16,3615,435,3180,11,15,6,5
7742,676,20886,475,130,70,60,2,5,1,1
1045,26,18505,16,5697,503,5194,14,15,7,7
13669,10,11745,9,733,94,639,2,30,1,1
21976,10,14359,9,178,94,84,2,30,1,1
15637,10,7416,9,183,94,89,2,29,1,1
1165,26,23345,16,3811,1846,1965,20,330,9,11
10346,28,0,0,70,70,0,1,0,1,0
8079,26,22173,16,940826,59470,881356,1101,190,412,689
16951,255,0,0,62,62,0,1,0,1,0
12796,1771,0,0,146,146,0,1,0,1,0
11165,28,0,0,66,66,0,1,0,1,0
12464,28,0,0,70,70,0,1,0,1,0
8403,346,21383,220,4458,1336,3122,13,53,7,6
2326,2486,0,0,62,62,0,1,0,1,0
20908,26,11430,16,2537,1268,1269,23,186,12,11
9100,10,26369,9,216,110,106,2,31,1,1
1594,1017,0,0,62,62,0,1,0,1,0
13776,28,0,0,70,70,0,1,0,1,0
22337,10,13463,9,168,86,82,2,30,1,1
2172,287,28390,184,481,150,331,2,1199,1,1
13057,10,23837,9,216,82,134,2,33,1,1
121,2256,0,0,62,62,0,1,0,1,0
12537,268,9062,168,70,70,0,2,8,2,0
22501,10,26309,9,184,94,90,2,29,1,1
8582,15,1857,11,318,192,126,6,28,4,2
14010,10,2946,9,448,184,264,6,30,3,3
21634,10,20166,9,350,94,256,2,30,1,1
3379,7,0,0,60,60,0,1,0,1,0
22348,10,7491,9,184,94,90,2,30,1,1
15901,10,4451,9,969,86,883,2,30,1,1
8562,15,19775,11,13738839,196158,13542681,11272,248,2231,9041
21335,1472,0,0,62,62,0,1,0,1,0
15401,1528,3378,1165,70,70,0,1,5,1,0
2218,1936,0,0,66,66,0,1,0,1,0
16720,28,0,0,66,66,0,1,0,1,0
12936,26,23768,16,184574,24037,160537,209,84,87,122
612,183,0,0,60,60,0,1,0,1,0
4289,15,12236,11,78,78,0,2,8,2,0
9045,15,2722,11,1965,1450,515,7,87,5,2
8462,10,26661,9,194,102,92,2,32,1,1
3337,26,7895,16,268582,23654,244928,341,190,128,213
13569,28,0,0,66,66,0,1,0,1,0
14228,10,2250,9,209,110,99,2,29,1,1
8825,10,23308,9,730,102,628,2,30,1,1
19211,28,0,0,70,70,0,1,0,1,0
21156,1797,0,0,66,66,0,1,0,1,0
15613,28,0,0,70,70,0,1,0,1,0
2205,2117,0,0,66,66,0,1,0,1,0
13710,2883,0,0,66,66,0,1,0,1,0
19796,26,8340,16,10596,3874,6722,30,62,17,13
7805,15,3066,11,9083,1822,7261,20,257,5,15
20540,10,8525,9,384,166,218,2,30,1,1
9405,28,0,0,70,70,0,1,0,1,0
14806,10,29072,9,711,87,624,2,30,1,1
17190,15,21931,11,23867,3316,20551,38,135,20,18
8457,10,27592,9,184,94,90,2,30,1,1
17864,1147,0,0,62,62,0,1,0,1,0
2818,2587,0,0,62,62,0,1,0,1,0
10945,26,455,16,362,180,182,7,28,4,3
10497,15,15434,11,1703,538,1165,8,177,5,3
1506,15,5330,11,32613,1160,31453,38,16,13,25
13091,28,0,0,70,70,0,1,0,1,0
1349,3216,0,0,62,62,0,1,0,1,0
17537,26,13536,16,4573,2614,1959,25,80,13,12
8964,10,3366,9,196,102,94,2,30,1,1
21504,10,22304,9,258,102,156,2,30,1,1
8,230,0,0,78,78,0,1,0,1,0
22551,10,22659,9,731,91,640,2,30,1,1
14023,28,0,0,70,70,0,1,0,1,0
16951,255,0,0,62,62,0,1,0,1,0
10149,1861,0,0,62,62,0,1,0,1,0
5519,26,10629,16,18127,8010,10117,41,116,24,17
22577,26,12535,16,5405,4034,1371,25,43,10,15
11011,1905,27388,1456,206,136,70,4,13,3,1
12650,405,6783,263,320,140,180,6,5,3,3
348,2256,0,0,78,78,0,1,0,1,0
3617,1827,0,0,146,146,0,1,0,1,0
14029,10,8222,9,195,102,93,2,31,1,1
10475,6,0,0,60,60,0,1,0,1,0
9412,26,23950,16,21634,11226,10408,54,402,35,19
21810,10,1112,9,180,94,86,2,30,1,1
20210,26,20493,16,5311,1546,3765,15,122,7,8
305,295,845,190,3398,947,2451,18,27,9,9
21818,10,20492,9,165,86,79,2,30,1,1
12808,42,4771,25,260,140,120,5,6,3,2
13795,10,17363,9,776,102,674,2,30,1,1
4049,15,16954,11,1270,387,883,16,392,4,12
11029,28,0,0,70,70,0,1,0,1,0
12627,1,27920,1,320,140,180,6,6,3,3
22699,10,20199,9,229,102,127,2,30,1,1
9146,10,23127,9,206,105,101,2,31,1,1
2311,2611,0,0,62,62,0,1,0,1,0
19686,28,0,0,70,70,0,1,0,1,0
16951,255,0,0,62,62,0,1,0,1,0
14879,10,24855,9,229,89,140,2,31,1,1
13529,26,2249,16,32544,28348,4196,63,332,31,32
11157,26,14084,16,18360,1198,17162,27,25,9,18
16057,28,0,0,70,70,0,1,0,1,0
17269,2938,0,0,66,66,0,1,0,1,0
15952,10,8559,9,807,94,713,2,30,1,1
10967,1892,21582,1445,66,66,0,1,5,1,0
13857,28,0,0,70,70,0,1,0,1,0
22023,28,0,0,70,70,0,1,0,1,0
9550,26,20122,16,6470,897,5573,24,55,9,15
7113,7,0,0,60,60,0,1,0,1,0
2744,1242,23046,922,1007,252,755,4,32,3,1
7949,314,0,0,60,60,0,1,0,1,0
13057,28,0,0,70,70,0,1,0,1,0
7339,652,0,0,60,60,0,1,0,1,0
2172,867,60,641,150,150,0,1,1200,1,0
15005,10,16012,9,184,94,90,2,31,1,1
12661,336,7864,214,70,70,0,2,8,2,0
4432,26,19501,16,9115,1269,7846,21,31,12,9
3309,15,18977,11,480,258,222,8,12,5,3
739,183,2999,121,4166,2141,2025,18,18,9,9
17041,26,16976,16,5168,700,4468,16,15,7,9
18438,1580,26823,1210,70,70,0,1,5,1,0
10120,28,0,0,66,66,0,1,0,1,0
2430,2938,0,0,62,62,0,1,0,1,0
2659,2611,0,0,78,78,0,1,0,1,0
9834,28,0,0,70,70,0,1,0,1,0
14223,26,25260,16,448,166,282,2,30,1,1
10997,15,24920,11,426,240,186,8,25,5,3
22153,28,0,0,66,66,0,1,0,1,0
3482,631,0,0,78,78,0,1,0,1,0
10855,26,6676,16,4943,936,4007,21,32,11,10
9043,28,0,0,70,70,0,1,0,1,0
17811,1880,0,0,66,66,0,1,0,1,0
17919,1017,0,0,146,146,0,1,0,1,0
8328,10,25778,9,168,86,82,2,30,1,1
22168,10,10564,9,192,98,94,2,30,1,1
1337,1997,25569,1527,213,89,124,4,31,2,2
10504,26,19132,16,7658,1309,6349,24,75,13,11
15764,26,27834,16,340,140,200,6,25,3,3
5557,26,10611,16,2651,1331,1320,18,17,10,8
17303,28,0,0,66,66,0,1,0,1,0
7457,2636,0,0,70,70,0,1,0,1,0
15417,1108,19850,813,70,70,0,1,5,1,0
15600,28,0,0,66,66,0,1,0,1,0
16805,3242,0,0,74,74,0,1,0,1,0
6524,15,19119,11,1972,1464,508,15,16,7,8
7790,7,0,0,60,60,0,1,0,1,0
10682,15,27346,11,3227,2425,802,9,31,5,4
7676,26,15020,16,3847,2650,1197,22,35,13,9
5,1903,0,0,66,66,0,1,0,1,0
10417,10,9005,9,199,94,105,2,30,1,1
9614,10,4541,9,770,102,668,2,30,1,1
14608,28,0,0,70,70,0,1,0,1,0
3306,15,20776,11,234,234,0,4,12,4,0
15089,10,22184,9,200,102,98,2,30,1,1
2491,1771,0,0,66,66,0,1,0,1,0
8382,2694,2429,2093,70,70,0,1,5,1,0
15901,10,9088,9,177,94,83,2,30,1,1
10101,190,6589,125,258,107,151,2,30,1,1
9933,26,6905,16,9721,3096,6625,30,122,13,17
2744,1238,10368,918,878,126,752,2,30,1,1
496,982,0,0,66,66,0,1,0,1,0
13865,10,22627,9,181,94,87,2,32,1,1
9240,2938,0,0,66,66,0,1,0,1,0
18297,1017,0,0,62,62,0,1,0,1,0
12037,1888,0,0,62,62,0,1,0,1,0
19556,28,0,0,66,66,0,1,0,1,0
20006,28,0,0,70,70,0,1,0,1,0
4696,15,27293,11,1399,406,993,15,43,5,10
9428,28,0,0,70,70,0,1,0,1,0
2744,1241,24302,921,881,126,755,2,30,1,1
8532,28,0,0,70,70,0,1,0,1,0
21582,10,14382,9,204,104,100,2,31,1,1
20042,697,0,0,146,146,0,1,0,1,0
22285,10,14135,9,734,86,648,2,30,1,1
8343,26,26676,16,533295,14310,518985,552,18,201,351
22010,10,9795,9,168,86,82,2,30,1,1
17747,3139,0,0,146,146,0,1,0,1,0
8370,10,19981,9,168,86,82,2,31,1,1
14108,10,11721,9,256,93,163,2,30,1,1
16951,255,0,0,62,62,0,1,0,1,0
3153,1017,0,0,146,146,0,1,0,1,0
8004,10,17446,9,199,94,105,2,30,1,1
8021,26,28006,16,4342,2152,2190,19,255,10,9
15537,10,5590,9,267,87,180,4,57,2,2
20605,551,17199,367,70,70,0,1,5,1,0
15730,10,8644,9,760,96,664,2,30,1,1
3001,357,0,0,62,62,0,1,0,1,0
16460,104,0,0,60,60,0,1,0,1,0
7308,26,15215,16,1134,490,644,18,42,8,10
9020,15,4845,11,13992,1645,12347,23,89,10,13
18457,10,7444,9,330,94,236,2,30,1,1
9718,26,3840,16,9191,2003,7188,25,100,13,12
16024,7,0,0,60,60,0,1,0,1,0
12,2638,0,0,100,100,0,1,0,1,0
16140,26,17623,16,11986,3075,8911,60,4981,31,29
11558,28,0,0,70,70,0,1,0,1,0
1601,1771,0,0,62,62,0,1,0,1,0
20476,28,0,0,66,66,0,1,0,1,0
19495,28,0,0,70,70,0,1,0,1,0
11818,26,21032,16,9303,3133,6170,26,22,13,13
21411,10,20211,9,276,126,150,2,30,1,1
22577,10,9467,9,184,102,82,2,29,1,1
12266,28,0,0,70,70,0,1,0,1,0
14303,28,0,0,66,66,0,1,0,1,0
21357,10,7005,9,356,97,259,4,58,2,2
8772,15,10465,11,454,262,192,8,41,5,3
17806,28,0,0,70,70,0,1,0,1,0
11259,2799,20053,2172,136,136,0,3,14,3,0
12505,1415,22010,1076,70,70,0,2,8,2,0
1400,10,5427,9,268,94,174,2,30,1,1
8492,26,28906,16,6141,949,5192,17,21,9,8
15946,10,6637,9,193,102,91,2,31,1,1
8584,1450,18629,1103,71,71,0,1,30,1,0
20416,40,26049,23,9056,4223,4833,82,35,42,40
15963,10,8483,9,755,94,661,2,31,1,1
8943,10,11856,9,216,110,106,2,30,1,1
12,2568,0,0,286,286,0,1,0,1,0
15302,28,0,0,70,70,0,1,0,1,0
15412,28,0,0,66,66,0,1,0,1,0
1844,183,6987,121,4085,1916,2169,21,18,12,9
19295,3216,0,0,66,66,0,1,0,1,0
11167,44,18631,27,196,136,60,4,8,3,1
18097,28,0,0,66,66,0,1,0,1,0
8748,26,9895,16,29241,2457,26784,48,171,24,24
12379,26,8551,16,7639,1831,5808,29,76,15,14
16135,26,27317,16,2614,1689,925,18,20,10,8
11118,10,14759,9,168,78,90,2,30,1,1
11293,28,0,0,70,70,0,1,0,1,0
4969,676,57,475,130,70,60,2,6,1,1
8698,15,2966,11,4577,3951,626,11,25,6,5
9306,10,10372,9,177,94,83,2,30,1,1
491,15,1804,11,33443,797,32646,33,16,9,24
11998,28,0,0,66,66,0,1,0,1,0
5874,15,25826,11,1711,786,925,12,16,7,5
532,247,0,0,3354,1792,1562,46,193,23,23
18778,10,19601,9,198,86,112,2,29,1,1
17053,28,0,0,66,66,0,1,0,1,0
14345,611,27515,421,70,70,0,2,8,2,0
12327,26,14567,16,21476,1330,20146,32,137,12,20
15847,28,0,0,70,70,0,1,0,1,0
8271,676,8355,475,130,70,60,2,5,1,1
21631,28,0,0,70,70,0,1,0,1,0
8828,10,17395,9,268,93,175,4,58,2,2
13433,1462,0,0,62,62,0,1,0,1,0
15714,10,25244,9,241,98,143,2,30,1,1
8733,10,15878,9,184,102,82,2,29,1,1
1385,10,4749,9,237,91,146,2,33,1,1
21193,843,5631,621,1295,926,369,13,17,9,4
22417,1771,0,0,66,66,0,1,0,1,0
17168,26,10821,16,1826093,48237,1777856,1873,71,599,1274
22168,10,17437,9,402,118,284,2,29,1,1
9020,26,4341,16,5512,978,4534,20,60,10,10
13574,1590,0,0,66,66,0,1,0,1,0
16124,10,26256,9,260,86,174,2,30,1,1
8759,10,10583,9,253,102,151,2,30,1,1
136,1888,0,0,145,145,0,1,0,1,0
11483,26,11513,16,787462,10645,776817,653,131,87,566
13803,10,25888,9,711,87,624,2,30,1,1
22675,10,3351,9,193,102,91,2,30,1,1
16606,26,22495,16,8000,1760,6240,32,43,16,16
18424,2938,0,0,66,66,0,1,0,1,0
10721,40,16499,23,15022,5202,9820,113,36,53,60
13915,26,5800,16,6098,778,5320,17,15,8,9
11500,1771,0,0,66,66,0,1,0,1,0
16951,255,0,0,62,62,0,1,0,1,0
17570,1771,0,0,66,66,0,1,0,1,0
4102,26,26096,16,295458,11828,283630,339,185,137,202
8508,10,8009,9,199,102,97,2,29,1,1
19583,28,0,0,70,70,0,1,0,1,0
570,1845,0,0,60,60,0,1,90,1,0
9395,28,0,0,70,70,0,1,0,1,0
17115,26,2229,16,11773,7687,4086,31,17,16,15
15600,10,16017,9,177,94,83,2,30,1,1
21321,28,0,0,70,70,0,1,0,1,0
2211,2567,0,0,62,62,0,1,0,1,0
13742,10,338,9,199,102,97,2,30,1,1
18044,2587,0,0,62,62,0,1,0,1,0
2597,10,10945,9,245,98,147,2,30,1,1
5186,26,16734,16,4747,1840,2907,19,28,11,8
21620,28,0,0,70,70,0,1,0,1,0
15534,10,28871,9,757,102,655,2,30,1,1
8592,2938,0,0,66,66,0,1,0,1,0
17129,28,0,0,66,66,0,1,0,1,0
14269,10,18915,9,70,70,0,1,30,1,0
15703,28,0,0,66,66,0,1,0,1,0
11157,28,0,0,66,66,0,1,0,1,0
8465,26,25752,16,3949,2535,1414,24,75,12,12
22105,28,0,0,66,66,0,1,0,1,0
16322,10,179,9,70,70,0,1,29,1,0
14918,10,7621,9,192,98,94,2,30,1,1
2880,26,28036,16,6435,1089,5346,18,75,9,9
12952,28,0,0,70,70,0,1,0,1,0
8647,10,2132,9,232,102,130,2,30,1,1
16678,2205,0,0,66,66,0,1,0,1,0
2744,1240,15240,920,873,126,747,2,31,1,1
9522,10,21191,9,184,94,90,2,30,1,1
21,3216,0,0,62,62,0,1,0,1,0
12472,2584,15774,2005,70,70,0,1,4,1,0
22680,10,13297,9,193,102,91,2,33,1,1
7977,26,22510,16,1429,1295,134,10,29,8,2
13012,3212,0,0,66,66,0,1,0,1,0
14366,10,18933,9,215,102,113,2,30,1,1
19022,26,27101,16,4886,1530,3356,17,17,10,7
11176,26,23073,16,774806,25835,748971,772,52,253,519
14168,10,2548,9,168,86,82,2,30,1,1
3207,1888,0,0,62,62,0,1,0,1,0
13198,28,0,0,70,70,0,1,0,1,0
102,2091,21125,1612,70,70,0,2,8,2,0
11536,697,0,0,74,74,0,1,0,1,0
8330,26,18161,16,2529,1230,1299,17,16,9,8
9779,15,26767,11,3722,1504,2218,13,20,7,6
16597,26,16914,16,30845,9943,20902,172,133,73,99
14343,1709,12477,1305,260,140,120,5,8,3,2
21726,28,0,0,70,70,0,1,0,1,0
16530,26,25653,16,646,358,288,10,133,6,4
4342,26,28662,16,6805,1662,5143,25,17,13,12
9766,28,0,0,70,70,0,1,0,1,0
2854,10,11756,9,240,96,144,2,31,1,1
9626,28,0,0,70,70,0,1,0,1,0
2365,1472,0,0,62,62,0,1,0,1,0
17199,26,14090,16,3690,2585,1105,17,16,9,8
13930,10,11146,9,268,87,181,4,35,2,2
12,2247,0,0,83,83,0,1,0,1,0
15778,1215,0,0,62,62,0,1,0,1,0
1339,2738,0,0,143,143,0,1,0,1,0
1582,2587,0,0,66,66,0,1,0,1,0
15358,10,18529,9,199,102,97,2,30,1,1
9707,28,0,0,70,70,0,1,0,1,0
3756,15,6909,11,2913,633,2280,15,16,8,7
21879,10,23609,9,198,94,104,2,30,1,1
17043,26,10407,16,14819,3993,10826,80,330,36,44
18478,10,0,0,82,82,0,1,30,1,0
6999,1466,12759,1116,150,150,0,1,1200,1,0
8478,28,0,0,70,70,0,1,0,1,0
2942,10,12063,9,194,87,107,2,30,1,1
11681,10,13817,9,218,81,137,2,31,1,1
7212,26,21757,16,1636,827,809,18,43,10,8
22321,10,10330,9,186,95,91,2,30,1,1
6583,26,27509,16,146374,13143,133231,238,131,116,122
8720,10,22135,9,210,110,100,2,30,1,1
8499,26,19121,16,142684,5997,136687,134,48,31,103
823,3160,0,0,60,60,0,1,0,1,0
15953,10,10814,9,182,93,89,2,31,1,1
8798,26,11031,16,3618,961,2657,13,121,6,7
299,2953,0,0,62,62,0,1,0,1,0
13936,10,14142,9,211,102,109,2,31,1,1
1330,697,0,0,62,62,0,1,0,1,0
21778,28,0,0,66,66,0,1,0,1,0
8780,10,2337,9,183,94,89,2,30,1,1
11826,28,0,0,70,70,0,1,0,1,0
1072,26,10130,16,5691,503,5188,14,15,7,7
9976,28,0,0,70,70,0,1,0,1,0
14835,28,0,0,66,66,0,1,0,1,0
11938,28,0,0,66,66,0,1,0,1,0
2781,280,0,0,66,66,0,1,0,1,0
6265,26,6867,16,4181,998,3183,14,26,7,7
197,1017,0,0,62,62,0,1,0,1,0
8846,10,13596,9,749,94,655,2,30,1,1
11260,2573,0,0,66,66,0,1,0,1,0
5753,163,0,0,62,62,0,1,0,1,0
5272,2587,0,0,62,62,0,1,0,1,0
14548,10,19245,9,209,110,99,2,30,1,1
8080,15,4307,11,1878,1444,434,14,15,7,7
1626,2883,0,0,62,62,0,1,0,1,0
17598,10,26350,9,216,90,126,2,29,1,1
8102,26,28460,16,9744,1958,7786,25,18,13,12
13500,28,0,0,70,70,0,1,0,1,0
8928,10,5591,9,335,142,193,2,30,1,1
1462,6,0,0,60,60,0,1,0,1,0
13154,26,1281,16,16029,6377,9652,46,37,24,22
1903,2587,0,0,62,62,0,1,0,1,0
1890,1147,0,0,62,62,0,1,0,1,0
8761,15,5687,11,1285,772,513,11,53,6,5
15737,28,0,0,70,70,0,1,0,1,0
19973,10,27679,9,259,108,151,2,31,1,1
12789,28,0,0,70,70,0,1,0,1,0
3422,2154,0,0,62,62,0,1,0,1,0
16886,28,0,0,66,66,0,1,0,1,0
12817,15,18234,11,64091,62467,1624,61,16,48,13
20456,2256,0,0,62,62,0,1,0,1,0
13863,26,18459,16,8690,4119,4571,26,31,14,12
15418,10,28145,9,177,94,83,2,30,1,1
14682,10,6324,9,271,88,183,4,37,2,2
11063,2587,0,0,66,66,0,1,0,1,0
636,280,2237,177,253,118,135,2,1200,1,1
10892,1339,13990,1014,70,70,0,2,7,2,0
18314,28,0,0,70,70,0,1,0,1,0
22323,10,372,9,198,102,96,2,30,1,1
5851,15,2388,11,613,539,74,7,15,6,1
6657,26,19339,16,47048,9293,37755,63,412,28,35
8210,1234,21194,914,839,296,543,4,1200,2,2
22380,10,18920,9,258,110,148,2,30,1,1
1977,1,0,0,66,66,0,1,0,1,0
5457,26,24870,16,5150,853,4297,16,34,9,7
16951,255,0,0,62,62,0,1,0,1,0
2838,10,11687,9,235,90,145,2,32,1,1
22580,28,0,0,66,66,0,1,0,1,0
11686,3216,0,0,66,66,0,1,0,1,0
12577,28,0,0,70,70,0,1,0,1,0
15441,10,22976,9,194,102,92,2,30,1,1
15924,26,10306,16,7498,2799,4699,24,17,13,11
22643,10,5185,9,819,102,717,2,30,1,1
16910,2587,0,0,62,62,0,1,0,1,0
16242,28,0,0,70,70,0,1,0,1,0
15700,10,721,9,279,96,183,4,31,2,2
8026,26,9449,16,1515,568,947,14,82,6,8
18,2486,0,0,148,148,0,1,0,1,0
3747,15,1754,11,2913,633,2280,15,15,8,7
13593,28,0,0,70,70,0,1,0,1,0
3714,1017,0,0,146,146,0,1,0,1,0
20926,28,0,0,66,66,0,1,0,1,0
4365,1054,0,0,62,62,0,1,0,1,0
21338,10,13400,9,339,110,229,2,29,1,1
14320,10,1672,9,198,102,96,2,29,1,1
823,3235,0,0,60,60,0,1,0,1,0
22703,26,12892,16,92638,4519,88119,105,15,39,66
13592,26,3997,16,10198,3881,6317,46,146,26,20
10146,26,10342,16,26189,8238,17951,72,18,39,33
10490,26,2601,16,8804,1597,7207,25,50,14,11
15131,10,18411,9,348,94,254,2,30,1,1
14242,28,0,0,70,70,0,1,0,1,0
21344,10,15191,9,183,86,97,2,29,1,1
15243,10,4848,9,199,94,105,2,30,1,1
4316,15,11896,11,1325,336,989,10,15,5,5
21692,10,11003,9,363,92,271,4,31,2,2
11345,26,8404,16,4939,2553,2386,51,72,28,23
14306,10,12429,9,270,88,182,4,53,2,2
3250,2820,0,0,145,145,0,1,0,1,0
16841,28,0,0,66,66,0,1,0,1,0
21172,28,0,0,66,66,0,1,0,1,0
10651,676,14071,475,130,70,60,2,5,1,1
10978,1888,0,0,62,62,0,1,0,1,0
11104,2956,4005,2293,70,70,0,2,8,2,0
21945,28,0,0,70,70,0,1,0,1,0
16021,280,12090,177,396,396,0,7,1200,7,0
1233,3216,0,0,66,66,0,1,0,1,0
13359,26,3337,16,130,70,60,3,5,2,1
19522,28,0,0,70,70,0,1,0,1,0
13728,346,0,0,60,60,0,1,0,1,0
19015,28,0,0,70,70,0,1,0,1,0
18110,26,1613,16,11061,2230,8831,40,109,23,17
18849,10,22058,9,255,86,169,2,31,1,1
21975,10,10298,9,193,102,91,2,29,1,1
15279,28,0,0,66,66,0,1,0,1,0
8473,26,20092,16,83411,4586,78825,94,47,30,64
17997,28,0,0,66,66,0,1,0,1,0
9291,2587,0,0,62,62,0,1,0,1,0
21671,10,20758,9,289,101,188,4,50,2,2
15299,28,0,0,70,70,0,1,0,1,0
9071,10,13839,9,199,102,97,2,30,1,1
14690,10,14707,9,177,94,83,2,30,1,1
16951,255,0,0,62,62,0,1,0,1,0
4643,738,9259,529,556,256,300,10,30,5,5
21666,28,0,0,66,66,0,1,0,1,0
10847,26,10216,16,2811130,115323,2695807,3382,206,1445,1937
11916,3216,0,0,62,62,0,1,0,1,0
16187,28,0,0,66,66,0,1,0,1,0
12755,26,1317,16,499,425,74,4,0,3,1
7516,3197,0,0,148,148,0,1,0,1,0
15928,10,3904,9,755,93,662,2,31,1,1
7570,26,14573,16,416,210,206,7,28,4,3
13594,28,0,0,70,70,0,1,0,1,0
13887,26,13988,16,8080,2630,5450,24,45,12,12
20719,28,0,0,70,70,0,1,0,1,0
14192,10,18348,9,177,94,83,2,30,1,1
14398,10,19839,9,283,98,185,4,51,2,2
21824,10,24568,9,167,86,81,2,30,1,1
21772,10,20675,9,234,94,140,2,29,1,1
2744,1240,1719,920,881,126,755,2,30,1,1
11682,1147,0,0,66,66,0,1,0,1,0
532,247,0,0,3354,1792,1562,46,193,23,23
12149,26,20904,16,4885,983,3902,21,53,10,11
18086,26,15438,16,55132,17147,37985,126,150,55,71
0,0,0,0,320,320,0,5,0,5,0
9001,10,19372,9,734,86,648,2,30,1,1
355,6,0,0,60,60,0,1,0,1,0
9516,26,5040,16,456,390,66,4,0,3,1
22677,26,28585,16,92286,4799,87487,107,16,43,64
15243,10,13589,9,198,101,97,2,31,1,1
16440,26,16504,16,7966,3102,4864,18,75,10,8
2406,1215,0,0,62,62,0,1,0,1,0
440,2587,0,0,62,62,0,1,0,1,0
8484,10,6857,9,166,86,80,2,31,1,1
18067,15,14393,11,1638,1324,314,10,15,5,5
8798,10,13067,9,198,101,97,2,30,1,1
496,3234,0,0,1514,1514,0,1,0,1,0
15166,1147,0,0,66,66,0,1,0,1,0
2356,26,9701,16,50236,37417,12819,67,19,41,26
20808,28,0,0,70,70,0,1,0,1,0
18551,28,0,0,70,70,0,1,0,1,0
4569,15,16091,11,1056,682,374,10,15,6,4
21968,28,0,0,70,70,0,1,0,1,0
8171,1073,0,0,60,60,0,1,0,1,0
17558,28,0,0,70,70,0,1,0,1,0
22120,10,28937,9,168,86,82,2,29,1,1
160,1888,0,0,62,62,0,1,0,1,0
8131,10,2083,9,215,86,129,2,30,1,1
15337,26,27495,16,8005,1985,6020,20,15,11,9
16951,255,0,0,62,62,0,1,0,1,0
17168,26,26111,16,239435,36478,202957,319,111,133,186
22505,10,23147,9,182,94,88,2,30,1,1
18155,10,27389,9,168,78,90,2,30,1,1
22456,26,7143,16,6043,1568,4475,11,120,4,7
19863,10,1791,9,291,78,213,2,30,1,1
12384,2256,0,0,66,66,0,1,0,1,0
14702,10,7578,9,193,102,91,2,30,1,1
8210,2112,21194,1628,479,152,327,2,1200,1,1
8414,15,21394,11,378,180,198,7,53,4,3
12424,26,25310,16,4669,2251,2418,14,137,7,7
22430,10,16036,9,200,102,98,2,31,1,1
4914,26,10667,16,84884,5896,78988,128,36,66,62
12135,28,0,0,70,70,0,1,0,1,0
10238,28,0,0,70,70,0,1,0,1,0
15504,28,0,0,70,70,0,1,0,1,0
9843,28,0,0,66,66,0,1,0,1,0
11833,26,5297,16,5583,1390,4193,19,15,9,10
10075,28,0,0,70,70,0,1,0,1,0
19154,548,0,0,148,148,0,1,0,1,0
22690,10,6779,9,443,182,261,6,29,3,3
20535,509,0,0,66,66,0,1,0,1,0
15573,15,22405,11,214,140,74,4,35,3,1
6250,2006,12484,1536,144,82,62,2,30,1,1
20286,3216,0,0,66,66,0,1,0,1,0
4796,26,16293,16,4691,1784,2907,19,27,11,8
22295,10,11981,9,199,102,97,2,30,1,1
12407,405,21741,263,320,140,180,6,6,3,3
8813,26,16669,16,11011,4522,6489,35,43,17,18
4836,26,16348,16,5763,2553,3210,24,80,14,10
13325,28,0,0,70,70,0,1,0,1,0
15529,10,5699,9,183,94,89,2,30,1,1
636,1759,11664,1344,509,150,359,2,1199,1,1
8959,10,24876,9,271,102,169,2,30,1,1
21838,10,8253,9,168,86,82,2,30,1,1
17317,26,22874,16,10079,2210,7869,36,120,19,17
7416,15,27680,11,3578,1673,1905,16,186,9,7
3610,26,24575,16,7804,2108,5696,24,32,14,10
7043,26,15871,16,6359,4441,1918,33,80,17,16
13852,1017,0,0,66,66,0,1,0,1,0
9618,15,18989,11,19357,10244,9113,36,27,19,17
11223,1615,22325,1237,70,70,0,1,5,1,0
21855,10,7251,9,198,101,97,2,30,1,1
1410,3014,0,0,148,148,0,1,0,1,0
8551,28,0,0,70,70,0,1,0,1,0
19488,28,0,0,70,70,0,1,0,1,0
15145,10,23191,9,94,94,0,1,30,1,0
22139,28,0,0,70,70,0,1,0,1,0
22133,28,0,0,70,70,0,1,0,1,0
6563,26,20617,16,6448,1982,4466,22,16,11,11
587,1888,0,0,62,62,0,1,0,1,0
19469,28,0,0,70,70,0,1,0,1,0
15497,10,21886,9,170,87,83,2,31,1,1
3888,26,11357,16,8211,2165,6046,25,361,13,12
17415,28,0,0,70,70,0,1,0,1,0
2225,2587,0,0,146,146,0,1,0,1,0
2235,1147,0,0,146,146,0,1,0,1,0
15010,10,15726,9,778,103,675,2,31,1,1
10766,1713,22737,1308,70,70,0,1,5,1,0
7709,15,17515,11,1614,1300,314,10,15,5,5
9538,1147,0,0,62,62,0,1,0,1,0
13664,10,3616,9,195,102,93,2,31,1,1
9077,28,0,0,70,70,0,1,0,1,0
15336,28,0,0,66,66,0,1,0,1,0
13278,2256,0,0,66,66,0,1,0,1,0
18839,28,0,0,66,66,0,1,0,1,0
104,1017,0,0,146,146,0,1,0,1,0
22631,15,3284,11,366,180,186,7,28,4,3
14778,28,0,0,70,70,0,1,0,1,0
12,1529,0,0,97,97,0,1,0,1,0
15081,10,3486,9,916,86,830,2,31,1,1
2744,1622,8355,1244,888,126,762,2,31,1,1
7078,1147,0,0,62,62,0,1,0,1,0
6233,1647,0,0,60,60,0,1,0,1,0
4885,509,0,0,62,62,0,1,0,1,0
1804,3191,0,0,60,60,0,1,0,1,0
2153,2611,0,0,62,62,0,1,0,1,0
20188,295,27809,190,2163,676,1487,14,15,7,7
1544,697,0,0,66,66,0,1,0,1,0
20401,40,2245,23,12900,4980,7920,91,117,51,40
1525,1444,0,0,145,145,0,1,0,1,0
22481,28,0,0,70,70,0,1,0,1,0
8715,26,26949,16,5903,1270,4633,14,17,8,6
10250,15,7600,11,254,128,126,5,15,3,2
12625,1648,17374,1265,70,70,0,2,7,2,0
13108,26,6975,16,14649,11393,3256,49,99,22,27
8372,10,16402,9,188,96,92,2,31,1,1
14651,10,19202,9,178,94,84,2,30,1,1
9728,405,3987,263,161,161,0,1,1200,1,0
10503,26,4747,16,4773,2454,2319,14,135,7,7
8500,1147,0,0,146,146,0,1,0,1,0
13918,10,535,9,168,78,90,2,30,1,1
16732,28,0,0,66,66,0,1,0,1,0
834,2883,0,0,62,62,0,1,0,1,0
10127,28,0,0,70,70,0,1,0,1,0
12317,28,0,0,70,70,0,1,0,1,0
18561,2627,875,2037,70,70,0,2,8,2,0
18436,15,26781,11,116680,5773,110907,126,21,46,80
8498,10,16749,9,200,94,106,2,29,1,1
13151,28,0,0,70,70,0,1,0,1,0
14793,10,7787,9,283,102,181,2,29,1,1
4081,234,24172,149,3235,1448,1787,26,811,8,18
13900,10,4986,9,195,102,93,2,30,1,1
4383,26,8135,16,10753,1585,9168,24,120,10,14
11268,2496,18992,1942,70,70,0,1,5,1,0
17984,2256,0,0,66,66,0,1,0,1,0
14024,28,0,0,70,70,0,1,0,1,0
7213,26,23409,16,1568,759,809,17,43,9,8
8441,28,0,0,70,70,0,1,0,1,0
17162,26,11191,16,5167,700,4467,16,15,7,9
8876,10,14462,9,183,102,81,2,30,1,1
16392,26,13966,16,21293,7315,13978,85,188,37,48
8171,1073,0,0,60,60,0,1,0,1,0
1505,1804,0,0,66,66,0,1,0,1,0
11297,2867,13447,2226,70,70,0,2,6,2,0
1195,26,2023,16,4984,892,4092,18,185,9,9
10358,1771,0,0,62,62,0,1,0,1,0
15480,10,12937,9,186,95,91,2,30,1,1
8907,10,5109,9,211,102,109,2,30,1,1
21822,10,16232,9,202,103,99,2,31,1,1
11127,26,287,16,11181,7329,3852,39,53,20,19
18898,2587,0,0,62,62,0,1,0,1,0
6434,26,10350,16,232,172,60,3,5,2,1
3932,10,3781,9,371,94,277,2,30,1,1
14277,234,27476,149,5378,2359,3019,35,3786,16,19
14492,2874,21556,2233,469,150,319,2,1200,1,1
15006,10,10547,9,178,94,84,2,29,1,1
2724,1240,18980,920,422,164,258,6,29,3,3
8760,28,0,0,70,70,0,1,0,1,0
2275,104,9337,81,146,60,86,2,9,1,1
8,1873,0,0,60,60,0,1,0,1,0
11000,871,6409,642,70,70,0,1,5,1,0
11012,2893,21170,2246,70,70,0,2,8,2,0
9466,2486,0,0,143,143,0,1,0,1,0
21156,3216,0,0,62,62,0,1,0,1,0
14425,28,0,0,70,70,0,1,0,1,0
18576,1936,0,0,66,66,0,1,0,1,0
17602,28,0,0,70,70,0,1,0,1,0
6877,3202,0,0,62,62,0,1,0,1,0
16527,983,0,0,66,66,0,1,0,1,0
22532,10,13718,9,193,102,91,2,29,1,1
11138,15,11547,11,182,60,122,4,25,2,2
15616,10,517,9,177,94,83,2,30,1,1
14794,10,20885,9,195,102,93,2,30,1,1
20273,28,0,0,70,70,0,1,0,1,0
13821,15,24286,11,7452,1052,6400,20,22,11,9
13804,28,0,0,66,66,0,1,0,1,0
9679,6,22027,6,6292,2375,3917,35,20,19,16
15584,2545,0,0,62,62,0,1,0,1,0
12677,676,12684,475,130,70,60,2,6,1,1
14085,28,0,0,70,70,0,1,0,1,0
21223,28,0,0,70,70,0,1,0,1,0
7609,10,20300,9,214,82,132,2,30,1,1
5497,1804,0,0,66,66,0,1,0,1,0
14575,1771,0,0,62,62,0,1,0,1,0
16130,28,0,0,70,70,0,1,0,1,0
18428,26,12654,16,13649,6567,7082,29,127,14,15
8327,280,9309,177,490,150,340,2,1200,1,1
9742,28,0,0,70,70,0,1,0,1,0
10533,28,0,0,70,70,0,1,0,1,0
14512,28,0,0,70,70,0,1,0,1,0
12116,26,20319,16,5430,687,4743,15,73,6,9
22482,10,13194,9,294,102,192,2,30,1,1
15265,28,0,0,66,66,0,1,0,1,0
10518,26,23510,16,202,70,132,3,11,1,2
18008,28,0,0,66,66,0,1,0,1,0
7090,1936,0,0,74,74,0,1,0,1,0
15113,28,0,0,66,66,0,1,0,1,0
8833,15,2959,11,27534,4859,22675,34,41,14,20
19409,28,0,0,70,70,0,1,0,1,0
21,2953,0,0,62,62,0,1,0,1,0
18083,15,28392,11,207418,4580,202838,194,143,50,144
15404,10,21266,9,199,102,97,2,30,1,1
8536,10,9007,9,168,86,82,2,30,1,1
22089,10,25688,9,737,94,643,2,30,1,1
10317,2587,0,0,146,146,0,1,0,1,0
1101,15,20312,11,1579,421,1158,9,15,4,5
15922,1906,0,0,62,62,0,1,0,1,0
7449,10,11186,9,199,94,105,2,30,1,1
4282,2587,0,0,62,62,0,1,0,1,0
8927,10,4132,9,182,93,89,2,31,1,1
3553,26,3894,16,12521,6232,6289,43,80,22,21
12049,1147,0,0,62,62,0,1,0,1,0
14242,10,18227,9,309,110,199,2,30,1,1
11897,26,28867,16,16229,3316,12913,23,125,9,14
7949,315,0,0,60,60,0,1,0,1,0
22211,28,0,0,66,66,0,1,0,1,0
13684,28,0,0,66,66,0,1,0,1,0
9171,10,26362,9,216,110,106,2,30,1,1
8973,26,9222,16,1101,654,447,12,126,7,5
11031,15,13845,11,7578,4652,2926,49,323,30,19
9873,28,0,0,66,66,0,1,0,1,0
7497,26,25956,16,4921,2134,2787,21,95,10,11
17820,26,9925,16,1867,250,1617,8,120,4,4
8892,26,8483,16,5393,1263,4130,21,18,11,10
9616,26,21117,16,251744,9600,242144,302,23,129,173
8667,28,0,0,70,70,0,1,0,1,0
8447,10,3371,9,167,86,81,2,30,1,1
9726,10,19545,9,216,110,106,2,30,1,1
8395,26,21377,16,32952,11546,21406,60,71,36,24
21922,10,4806,9,193,102,91,2,30,1,1
19612,1771,0,0,66,66,0,1,0,1,0
15638,28,0,0,70,70,0,1,0,1,0
11711,1888,0,0,66,66,0,1,0,1,0
9065,295,21720,190,3310,1535,1775,15,15,8,7
10495,26,19776,16,12291742,358717,11933025,12485,181,3846,8639
16301,329,25577,210,138,78,60,3,6,2,1
12269,28,0,0,70,70,0,1,0,1,0
18435,28,0,0,70,70,0,1,0,1,0
1697,139,0,0,60,60,0,1,0,1,0
2172,2182,28807,1687,480,149,331,2,1200,1,1
4848,2504,22595,1947,156,156,0,3,8,3,0
7619,26,20062,16,8277,1368,6909,31,120,14,17
6933,26,11201,16,16341,3306,13035,42,17,24,18
18,2573,0,0,62,62,0,1,0,1,0
12905,28,0,0,70,70,0,1,0,1,0
22429,10,29149,9,443,182,261,6,30,3,3
9327,10,22618,9,819,102,717,2,30,1,1
4813,18,27083,13,184,94,90,2,30,1,1
12365,1865,12544,1423,70,70,0,1,4,1,0
16951,255,0,0,62,62,0,1,0,1,0
8423,28,0,0,66,66,0,1,0,1,0
12022,1423,11921,1081,70,70,0,2,8,2,0
5705,1100,0,0,74,74,0,1,0,1,0
9795,1147,0,0,62,62,0,1,0,1,0
17680,3265,0,0,148,148,0,1,0,1,0
9746,28,0,0,66,66,0,1,0,1,0
22488,10,25400,9,195,102,93,2,29,1,1
11216,2944,8652,2283,70,70,0,2,9,2,0
15270,10,2766,9,183,94,89,2,30,1,1
18536,405,16306,263,70,70,0,2,8,2,0
4570,26,26687,16,70,70,0,1,5,1,0
14484,10,16894,9,458,188,270,6,29,3,3
2555,3216,0,0,62,62,0,1,0,1,0
1966,2636,0,0,66,66,0,1,0,1,0
12226,28,0,0,70,70,0,1,0,1,0
8810,1472,0,0,66,66,0,1,0,1,0
13511,28,0,0,70,70,0,1,0,1,0
9108,10,8348,9,192,98,94,2,31,1,1
5630,10,2682,9,168,78,90,2,30,1,1
22069,10,25414,9,814,110,704,2,29,1,1
9012,26,12264,16,33314,1722,31592,40,88,14,26
1091,26,19767,16,5699,505,5194,14,15,7,7
14523,10,743,9,177,94,83,2,30,1,1
5650,411,0,0,145,145,0,1,0,1,0
15349,1956,8157,1493,66,66,0,1,5,1,0
12135,26,6252,16,134,60,74,3,11,2,1
13733,10,5713,9,165,86,79,2,29,1,1
18022,28,0,0,66,66,0,1,0,1,0
16183,28,0,0,66,66,0,1,0,1,0
2015,3216,0,0,62,62,0,1,0,1,0
1623,3216,0,0,62,62,0,1,0,1,0
14671,10,13938,9,193,102,91,2,31,1,1
10727,643,5407,447,70,70,0,1,5,1,0
14961,10,1775,9,177,94,83,2,30,1,1
11514,10,3180,9,242,78,164,2,30,1,1
639,1184,0,0,143,143,0,1,0,1,0
8991,10,18859,9,466,192,274,6,83,3,3
15876,26,18940,16,134,60,74,3,5,2,1
14228,6,0,0,60,60,0,1,0,1,0
16938,28,0,0,70,70,0,1,0,1,0
1830,1017,0,0,146,146,0,1,0,1,0
8801,10,6679,9,458,188,270,6,30,3,3
15944,10,17089,9,178,94,84,2,30,1,1
12468,311,24704,203,70,70,0,1,5,1,0
31,1888,0,0,62,62,0,1,0,1,0
1984,2587,0,0,62,62,0,1,0,1,0
2341,1147,0,0,146,146,0,1,0,1,0
3066,3015,566,2343,1794,750,1044,12,4220,6,6
11518,1888,0,0,66,66,0,1,0,1,0
15022,10,3947,9,168,86,82,2,31,1,1
2154,10,8656,9,825,99,726,2,30,1,1
11450,1686,0,0,60,60,0,1,0,1,0
2999,1543,0,0,145,145,0,1,0,1,0
17272,2205,0,0,62,62,0,1,0,1,0
22428,10,0,0,88,88,0,1,0,1,0
14576,28,0,0,70,70,0,1,0,1,0
19261,28,0,0,70,70,0,1,0,1,0
3549,26,8362,16,130,70,60,2,15,1,1
14662,10,24447,9,196,102,94,2,30,1,1
14384,10,24741,9,177,94,83,2,29,1,1
15541,28,0,0,66,66,0,1,0,1,0
13165,234,2781,149,7019,1592,5427,25,3600,14,11
19378,26,12328,16,7036,2247,4789,39,141,19,20
3507,1804,0,0,146,146,0,1,0,1,0
1852,2747,0,0,66,66,0,1,0,1,0
9877,1888,0,0,62,62,0,1,0,1,0
18275,10,0,0,88,88,0,1,0,1,0
17357,28,0,0,66,66,0,1,0,1,0
22110,146,0,0,60,60,0,1,0,1,0
14873,10,10985,9,200,102,98,2,31,1,1
4835,2650,17677,2058,481,150,331,2,1199,1,1
10474,26,24300,16,695,575,120,4,6,2,2
6378,26,18321,16,6131,1399,4732,20,983,10,10
14006,26,22143,16,8551,2955,5596,28,423,15,13
10468,26,25214,16,202,70,132,3,11,1,2
2159,10,28510,9,223,78,145,2,30,1,1
17206,15,27344,11,742,350,392,12,28,6,6
8515,15,21444,11,450,246,204,8,142,5,3
8210,283,21194,180,479,277,202,4,1200,2,2
866,26,22832,16,6177,969,5208,17,26,9,8
8368,28,0,0,66,66,0,1,0,1,0
11125,2876,0,0,66,66,0,1,0,1,0
17924,28,0,0,70,70,0,1,0,1,0
21762,28,0,0,66,66,0,1,0,1,0
17530,26,17270,16,233778,8502,225276,276,34,109,167
2313,2883,0,0,62,62,0,1,0,1,0
4653,26,24534,16,120566,15345,105221,173,125,72,101
2206,2938,0,0,74,74,0,1,0,1,0
3838,26,19328,16,21905,3249,18656,38,271,18,20
8404,10,21645,9,735,88,647,2,31,1,1
12,2088,0,0,60,60,0,1,0,1,0
8548,10,125,9,209,110,99,2,30,1,1
14343,10,25354,9,168,86,82,2,30,1,1
7133,26,22417,16,9908271,123308,9784963,8531,359,1708,6823
678,10,2692,9,233,91,142,2,31,1,1
14225,10,19700,9,168,86,82,2,30,1,1
4723,26,24187,16,11821,3643,8178,30,45,17,13
463,2256,0,0,62,62,0,1,0,1,0
22099,10,19403,9,199,102,97,2,29,1,1
2946,3216,0,0,62,62,0,1,0,1,0
15893,28,0,0,70,70,0,1,0,1,0
20712,2702,0,0,66,66,0,1,0,1,0
22274,10,28942,9,240,98,142,2,30,1,1
1388,3216,0,0,62,62,0,1,0,1,0
8460,6,0,0,60,60,0,1,0,1,0
20224,28,0,0,66,66,0,1,0,1,0
205,295,476,190,3006,1615,1391,15,15,8,7
11167,28,0,0,70,70,0,1,0,1,0
17440,1147,0,0,66,66,0,1,0,1,0
15026,10,17136,9,403,110,293,2,30,1,1
13524,28,0,0,66,66,0,1,0,1,0
12310,28,0,0,70,70,0,1,0,1,0
10643,26,11194,16,2895,2046,849,14,134,8,6
1392,26,4785,16,1452,817,635,16,29,9,7
8706,10,6913,9,279,94,185,2,30,1,1
7557,26,1422,16,4037,1058,2979,12,120,6,6
8061,15,2013,11,14038,3554,10484,45,1142,16,29
8424,10,670,9,198,101,97,2,30,1,1
7599,26,4481,16,11876848,256539,11620309,11266,74,3584,7682
3118,1888,0,0,62,62,0,1,0,1,0
16553,28,0,0,70,70,0,1,0,1,0
8877,28,0,0,66,66,0,1,0,1,0
9025,10,11457,9,198,102,96,2,31,1,1
21393,28,0,0,66,66,0,1,0,1,0
1082,15,23056,11,1641,483,1158,10,15,5,5
10145,28,0,0,70,70,0,1,0,1,0
1502,2697,0,0,66,66,0,1,0,1,0
12812,1189,1082,878,70,70,0,2,8,2,0
10091,255,0,0,60,60,0,1,0,1,0
8486,10,17045,9,199,102,97,2,29,1,1
8526,10,11937,9,718,94,624,2,30,1,1
15495,10,18944,9,86,86,0,1,30,1,0
13748,28,0,0,66,66,0,1,0,1,0
14268,10,15983,9,797,208,589,6,67,3,3
15202,10,18483,9,186,95,91,2,31,1,1
17777,305,17159,199,448,78,370,6,25,1,5
497,337,0,0,66,66,0,1,0,1,0
22562,10,17219,9,198,101,97,2,31,1,1
3173,7,0,0,60,60,0,1,0,1,0
21370,10,17289,9,177,94,83,2,30,1,1
10926,28,0,0,66,66,0,1,0,1,0
823,1684,3465,1289,124,60,64,2,30,1,1
22222,10,8449,9,183,94,89,2,29,1,1
14317,1888,0,0,66,66,0,1,0,1,0
8815,28,0,0,66,66,0,1,0,1,0
17071,10,20158,9,168,78,90,2,30,1,1
12719,2194,13583,1699,320,140,180,6,6,3,3
16021,280,22341,177,594,594,0,10,1200,10,0
809,2883,0,0,66,66,0,1,0,1,0
15662,10,19161,9,170,87,83,2,30,1,1
9116,28,0,0,66,66,0,1,0,1,0
16951,255,0,0,62,62,0,1,0,1,0
14920,26,3356,16,11148,3099,8049,26,24,15,11
2203,15,0,0,60,60,0,1,0,1,0
497,82,0,0,66,66,0,1,0,1,0
20849,28,0,0,70,70,0,1,0,1,0
10924,15,22312,11,7434,3830,3604,17,26,9,8
7917,2636,0,0,66,66,0,1,0,1,0
1714,1888,0,0,66,66,0,1,0,1,0
22033,10,28307,9,446,93,353,4,55,2,2
19459,28,0,0,66,66,0,1,0,1,0
7097,26,25286,16,5398,3277,2121,30,80,16,14
12,2553,0,0,82,82,0,1,0,1,0
7402,26,26868,16,9753,1572,8181,22,362,11,11
4095,12,0,0,60,60,0,1,0,1,0
9010,28,0,0,66,66,0,1,0,1,0
15448,12,0,0,60,60,0,1,0,1,0
15386,10,406,9,762,97,665,2,30,1,1
12591,28,0,0,70,70,0,1,0,1,0
12316,2938,0,0,62,62,0,1,0,1,0
14060,10,27365,9,711,87,624,2,31,1,1
22403,10,1783,9,214,110,104,2,30,1,1
2566,308,0,0,62,62,0,1,0,1,0
16951,255,0,0,62,62,0,1,0,1,0
17144,26,3208,16,5167,700,4467,16,15,7,9
15249,26,19483,16,237,177,60,3,5,2,1
11898,28,0,0,70,70,0,1,0,1,0
13452,2581,0,0,66,66,0,1,0,1,0
617,1888,0,0,66,66,0,1,0,1,0
15270,10,800,9,183,94,89,2,30,1,1
14672,10,27129,9,199,102,97,2,30,1,1
9006,15,19398,11,70094,1629,68465,63,89,16,47
10795,15,22004,11,5569,3270,2299,21,74,13,8
19405,6,27308,6,7306,2583,4723,36,25,19,17
612,714,0,0,60,60,0,1,0,1,0
8,2758,0,0,60,60,0,1,0,1,0
16936,15,17082,11,1056,682,374,10,15,6,4
9586,1880,0,0,66,66,0,1,0,1,0
19777,10,0,0,229,85,144,2,31,1,1
9440,10,9743,9,178,94,84,2,30,1,1
4465,10,12739,9,78,78,0,1,30,1,0
8631,28,0,0,70,70,0,1,0,1,0
1816,1215,0,0,62,62,0,1,0,1,0
10953,1017,0,0,146,146,0,1,0,1,0
2147,10,18973,9,191,86,105,2,30,1,1
10950,1595,19576,1222,70,70,0,2,8,2,0
17890,10,4467,9,218,78,140,2,31,1,1
22142,10,12567,9,193,102,91,2,29,1,1
19744,2581,0,0,62,62,0,1,0,1,0
14573,28,0,0,70,70,0,1,0,1,0
14533,10,23254,9,177,94,83,2,30,1,1
18306,26,11180,16,1868,1229,639,18,151,11,7
7299,232,12186,147,5723,3023,2700,58,548,32,26
11004,15,20498,11,38272,2881,35391,54,54,26,28
12629,10,21072,9,168,78,90,2,30,1,1
8408,28,0,0,70,70,0,1,0,1,0
21733,28,0,0,70,70,0,1,0,1,0
6186,26,16974,16,13704,2379,11325,47,279,22,25
22491,10,18744,9,173,94,79,2,30,1,1
435,1883,0,0,146,146,0,1,0,1,0
16451,26,13430,16,10027,2130,7897,27,27,16,11
15538,15,17239,11,526,304,222,8,30,5,3
22670,10,26782,9,168,86,82,2,30,1,1
5825,983,0,0,66,66,0,1,0,1,0
14093,10,25659,9,711,87,624,2,30,1,1
19428,242,0,0,145,145,0,1,0,1,0
6204,26,10742,16,4819,2903,1916,29,81,15,14
9746,10,21002,9,761,100,661,2,30,1,1
22516,28,0,0,66,66,0,1,0,1,0
22443,10,9119,9,184,102,82,2,30,1,1
16951,255,0,0,62,62,0,1,0,1,0
17660,28,0,0,66,66,0,1,0,1,0
7530,2953,0,0,62,62,0,1,0,1,0
2744,1238,12168,918,879,126,753,2,29,1,1
15951,10,25359,9,208,82,126,2,30,1,1
1355,1017,0,0,66,66,0,1,0,1,0
11621,2747,0,0,66,66,0,1,0,1,0
11328,15,22899,11,14704,1558,13146,25,29,11,14
11108,15,25812,11,366,240,126,7,25,5,2
3997,2256,0,0,66,66,0,1,0,1,0
7,12,0,0,346,346,0,1,0,1,0
8605,10,4556,9,197,102,95,2,30,1,1
21617,10,13680,9,234,94,140,2,30,1,1
18541,1147,0,0,62,62,0,1,0,1,0
11220,1438,26414,1092,70,70,0,1,4,1,0
15490,26,10587,16,14033,1591,12442,26,132,10,16
636,2609,6198,2023,324,150,174,2,1203,1,1
9633,26,18670,16,8389,1077,7312,24,140,12,12
11206,809,3912,589,70,70,0,1,5,1,0
12,658,0,0,131,131,0,1,0,1,0
21823,10,20102,9,258,102,156,2,30,1,1
16021,1586,22567,1216,527,166,361,2,1199,1,1
18452,26,25065,16,8166,1734,6432,23,81,12,11
21940,10,1120,9,168,86,82,2,31,1,1
21165,2627,11157,2037,564,382,182,9,18,6,3
7714,676,11822,475,138,78,60,2,5,1,1
2165,2573,0,0,66,66,0,1,0,1,0
21174,1147,0,0,66,66,0,1,0,1,0
13742,10,25154,9,199,102,97,2,30,1,1
8926,15,6565,11,2113,1181,932,10,127,6,4
12624,762,21336,550,70,70,0,2,7,2,0
8067,26,9170,16,6606,2153,4453,22,95,13,9
5858,26,19805,16,8185,1381,6804,22,831,11,11
3251,10,25789,9,218,78,140,2,30,1,1
2370,26,9752,16,5368,1609,3759,21,75,12,9
3747,26,3212,16,1701,1048,653,15,38,8,7
10755,1601,17141,1225,70,70,0,2,8,2,0
16951,255,0,0,62,62,0,1,0,1,0
2157,3072,0,0,60,60,0,1,0,1,0
4684,10,16171,9,260,106,154,2,32,1,1
9858,26,23072,16,9477,1950,7527,31,181,14,17
5354,10,0,0,82,82,0,1,31,1,0
10725,15,24883,11,1307,649,658,8,75,5,3
15233,10,10948,9,193,102,91,2,30,1,1
20549,28,0,0,70,70,0,1,0,1,0
16951,255,0,0,62,62,0,1,0,1,0
8896,28,0,0,70,70,0,1,0,1,0
14651,10,26719,9,178,94,84,2,30,1,1
16723,3139,0,0,62,62,0,1,0,1,0
5358,15,8455,11,1325,442,883,16,414,4,12
2145,3216,0,0,62,62,0,1,0,1,0
3027,1880,0,0,62,62,0,1,0,1,0
16728,28,0,0,70,70,0,1,0,1,0
17399,15,26217,11,104133,2163,101970,103,15,32,71
22271,10,23027,9,180,94,86,2,30,1,1
19953,2587,0,0,62,62,0,1,0,1,0
22392,1239,15488,919,78,78,0,1,29,1,0
12844,28,0,0,66,66,0,1,0,1,0
11070,149,3314,106,70,70,0,2,7,2,0
18290,15,2381,11,21073,15881,5192,47,151,30,17
16951,255,0,0,62,62,0,1,0,1,0
9948,28,0,0,66,66,0,1,0,1,0
16995,10,12074,9,199,94,105,2,30,1,1
3693,1888,0,0,62,62,0,1,0,1,0
12959,28,0,0,70,70,0,1,0,1,0
8401,15,12561,11,1103248,36317,1066931,1001,162,276,725
10692,15,11337,11,39464,2150,37314,81,20,26,55
13720,28,0,0,70,70,0,1,0,1,0
9470,15,12233,11,19438,12019,7419,53,312,30,23
12205,26,26950,16,6988,1214,5774,29,315,13,16
6133,26,5665,16,8634,3251,5383,24,17,14,10
558,1017,0,0,66,66,0,1,0,1,0
12647,28,0,0,70,70,0,1,0,1,0
9679,15,12984,11,62768,25796,36972,75,34,33,42
18388,28,0,0,70,70,0,1,0,1,0
9816,26,14766,16,6202,1828,4374,25,18,12,13
11940,26,5824,16,5452,1545,3907,22,16,13,9
9182,10,19264,9,270,102,168,2,30,1,1
8506,26,21257,16,3191,2313,878,17,42,10,7
4801,18,7201,13,184,94,90,2,30,1,1
13536,26,24131,16,125282,21435,103847,162,20,80,82
8616,26,13849,16,9704,2335,7369,20,26,10,10
14431,10,27942,9,731,85,646,2,31,1,1
14319,28,0,0,66,66,0,1,0,1,0
11243,2908,8849,2257,70,70,0,2,6,2,0
11462,28,0,0,66,66,0,1,0,1,0
9411,622,4381,429,330,330,0,6,1200,6,0
14316,26,24541,16,115875,6637,109238,158,80,71,87
15516,15,19762,11,2817,2024,793,12,75,7,5
1806,738,25171,529,556,256,300,10,31,5,5
21174,1147,0,0,62,62,0,1,0,1,0
19902,1017,0,0,62,62,0,1,0,1,0
16256,28,0,0,70,70,0,1,0,1,0
2755,1147,0,0,146,146,0,1,0,1,0
20878,28,0,0,70,70,0,1,0,1,0
11194,2120,12836,1634,70,70,0,2,8,2,0
21370,132,26471,98,70,70,0,1,5,1,0
8276,2486,0,0,160,160,0,1,0,1,0
16948,28,0,0,70,70,0,1,0,1,0
15988,10,23040,9,186,95,91,2,31,1,1
9766,10,25398,9,185,102,83,2,30,1,1
1212,26,23885,16,6334,910,5424,20,360,10,10
13914,10,15313,9,193,102,91,2,31,1,1
12779,10,16211,9,70,70,0,1,30,1,0
14048,10,20656,9,183,94,89,2,30,1,1
13847,1017,0,0,62,62,0,1,0,1,0
12581,2201,12784,1704,70,70,0,1,5,1,0
6229,2938,0,0,78,78,0,1,0,1,0
5400,453,0,0,137,137,0,1,0,1,0
21727,28,0,0,66,66,0,1,0,1,0
9786,10,16296,9,775,102,673,2,30,1,1
16300,28,0,0,70,70,0,1,0,1,0
5054,15,26332,11,2586,832,1754,14,16,7,7
15946,10,3582,9,193,102,91,2,31,1,1
560,1017,0,0,62,62,0,1,0,1,0
12164,26,8408,16,364,142,222,6,10,3,3
22511,10,7353,9,184,94,90,2,31,1,1
11302,28,0,0,70,70,0,1,0,1,0
15075,10,1810,9,214,110,104,2,30,1,1
15833,28,0,0,70,70,0,1,0,1,0
18926,28,0,0,70,70,0,1,0,1,0
1228,146,0,0,60,60,0,1,0,1,0
10939,1668,19472,1276,70,70,0,2,8,2,0
3133,2318,7110,1802,330,330,0,6,3608,6,0
18414,2636,0,0,66,66,0,1,0,1,0
18008,183,26559,121,3489,1534,1955,17,18,9,8
12647,1390,23634,1057,70,70,0,2,8,2,0
15919,10,1114,9,177,94,83,2,30,1,1
13167,1386,0,0,66,66,0,1,0,1,0
528,7,0,0,60,60,0,1,0,1,0
10105,15,16248,11,3030,1372,1658,13,21,8,5
16951,255,0,0,62,62,0,1,0,1,0
8615,15,2084,11,1948,912,1036,13,56,7,6
22607,10,6664,9,213,102,111,2,30,1,1
14157,28,0,0,70,70,0,1,0,1,0
4342,26,14976,16,3319,2176,1143,21,15,11,10
15985,26,2795,16,15017,8283,6734,47,18,24,23
10822,1027,18879,756,316,136,180,6,5,3,3
19996,28,0,0,66,66,0,1,0,1,0
1216,1086,0,0,146,146,0,1,0,1,0
8376,10,26503,9,199,102,97,2,30,1,1
14188,10,6669,9,182,94,88,2,30,1,1
130,10,268,9,217,90,127,2,30,1,1
17185,26,25225,16,5167,700,4467,16,15,7,9
14025,10,11998,9,177,94,83,2,30,1,1
14943,26,6662,16,3734,1750,1984,24,203,12,12
22154,10,1675,9,284,102,182,4,37,2,2
8461,10,2918,9,287,94,193,2,30,1,1
9818,15,778,11,3325,598,2727,12,15,6,6
11357,3216,0,0,66,66,0,1,0,1,0
17781,28,0,0,70,70,0,1,0,1,0
21233,28,0,0,66,66,0,1,0,1,0
14933,28,0,0,70,70,0,1,0,1,0
15389,10,13032,9,816,102,714,2,30,1,1
21135,2741,19336,2125,312,132,180,6,6,3,3
14348,2641,27537,2049,70,70,0,2,8,2,0
11234,28,0,0,70,70,0,1,0,1,0
12849,2144,0,0,66,66,0,1,0,1,0
8682,10,26842,9,183,94,89,2,29,1,1
15738,10,21973,9,178,94,84,2,29,1,1
18491,1147,0,0,66,66,0,1,0,1,0
15313,10,9996,9,264,87,177,4,37,2,2
15990,2587,0,0,62,62,0,1,0,1,0
14215,2205,0,0,62,62,0,1,0,1,0
10097,26,2025,16,7532,3051,4481,13,120,6,7
12166,15,14614,11,4374,1724,2650,16,150,9,7
22615,10,1763,9,210,110,100,2,31,1,1
12657,26,4838,16,7443,2043,5400,34,255,17,17
14485,10,21646,9,196,102,94,2,30,1,1
20433,28,0,0,66,66,0,1,0,1,0
636,596,4410,407,324,150,174,2,1201,1,1
15927,10,9255,9,347,110,237,2,30,1,1
17776,28,0,0,70,70,0,1,0,1,0
8954,104,0,0,60,60,0,1,0,1,0
15924,10,13833,9,177,94,83,2,30,1,1
637,405,21307,263,238,118,120,2,1200,1,1
16951,255,0,0,62,62,0,1,0,1,0
21368,26,28495,16,5663,2416,3247,26,159,14,12
20081,28,0,0,70,70,0,1,0,1,0
22186,28,0,0,66,66,0,1,0,1,0
7420,10,6434,9,308,118,190,2,30,1,1
3133,2308,9182,1792,330,330,0,6,3609,6,0
15410,1792,0,0,66,66,0,1,0,1,0
14258,2198,3068,1702,70,70,0,1,5,1,0
0,0,0,0,156,156,0,2,0,2,0
21924,10,6376,9,763,102,661,2,30,1,1
2744,1559,4278,1190,876,126,750,2,30,1,1
21781,10,716,9,354,94,260,2,30,1,1
13291,26,6442,16,4552,2230,2322,14,134,7,7
1245,16,0,0,60,60,0,1,0,1,0
864,1017,0,0,62,62,0,1,0,1,0
22148,10,901,9,193,102,91,2,30,1,1
4155,15,3320,11,1114,534,580,12,15,7,5
588,2611,0,0,78,78,0,1,0,1,0
1814,1147,0,0,66,66,0,1,0,1,0
8627,28,0,0,66,66,0,1,0,1,0
12398,144,22258,102,70,70,0,1,4,1,0
17070,10,22602,9,168,78,90,2,31,1,1
18462,15,15836,11,1168,815,353,10,122,6,4
9,18,21608,13,184,94,90,2,29,1,1
9077,10,27216,9,177,94,83,2,29,1,1
9095,1147,0,0,66,66,0,1,0,1,0
22370,10,11089,9,212,102,110,2,29,1,1
6347,26,9481,16,167,107,60,2,5,1,1
4950,26,18507,16,6737,1006,5731,20,162,11,9
17795,28,0,0,70,70,0,1,0,1,0
20855,28,0,0,70,70,0,1,0,1,0
17874,28,0,0,70,70,0,1,0,1,0
22705,10,10917,9,202,103,99,2,31,1,1
15010,10,17144,9,177,94,83,2,30,1,1
6122,26,580,16,2594,1280,1314,17,17,9,8
22356,10,26665,9,177,94,83,2,30,1,1
14596,26,24697,16,4378,1471,2907,19,29,11,8
16951,255,0,0,62,62,0,1,0,1,0
15176,10,6839,9,239,94,145,2,31,1,1
19104,28,0,0,70,70,0,1,0,1,0
15143,10,8765,9,194,102,92,2,30,1,1
0,0,0,0,152,78,74,2,0,1,1
7183,26,16516,16,970804,44459,926345,1113,200,446,667
9604,10,27464,9,753,96,657,2,31,1,1
1330,918,0,0,62,62,0,1,0,1,0
15559,28,0,0,70,70,0,1,0,1,0
3205,83,0,0,145,145,0,1,0,1,0
15028,26,4184,16,3182,1568,1614,8,120,4,4
8872,15,16822,11,118813,4128,114685,122,108,38,84
8743,15,20032,11,147113,4021,143092,144,65,41,103
5332,3216,0,0,62,62,0,1,0,1,0
2932,1017,0,0,146,146,0,1,0,1,0
5576,26,2044,16,416,210,206,7,34,4,3
16681,26,10692,16,1786,172,1614,7,121,3,4
15952,10,2938,9,184,94,90,2,30,1,1
761,2256,0,0,66,66,0,1,0,1,0
2301,1946,0,0,60,60,0,1,0,1,0
16947,28,0,0,66,66,0,1,0,1,0
22158,10,28888,9,233,90,143,2,33,1,1
9358,115,18684,88,70,70,0,1,5,1,0
8746,26,16672,16,442,262,180,8,42,5,3
15966,10,28487,9,711,87,624,2,30,1,1
21314,28,0,0,66,66,0,1,0,1,0
18964,956,0,0,66,66,0,1,0,1,0
16813,804,0,0,66,66,0,1,0,1,0
18605,10,16213,9,199,94,105,2,30,1,1
14815,10,3239,9,284,96,188,4,31,2,2
5866,15,14676,11,1937,1193,744,12,16,7,5
17240,28,0,0,70,70,0,1,0,1,0
22067,28,0,0,70,70,0,1,0,1,0
20594,28,0,0,66,66,0,1,0,1,0
12,2784,0,0,82,82,0,1,0,1,0
21361,10,13544,9,241,94,147,2,29,1,1
7297,26,15033,16,7847,1591,6256,23,186,13,10
22563,10,23055,9,330,91,239,4,44,2,2
12107,2883,0,0,66,66,0,1,0,1,0
3075,1215,0,0,62,62,0,1,0,1,0
8350,10,18627,9,592,198,394,6,78,3,3
1694,1590,0,0,145,145,0,1,0,1,0
16021,2124,23141,1638,1782,1782,0,28,1559,28,0
11799,15,2702,11,5688,2508,3180,36,118,19,17
22051,10,12828,9,216,110,106,2,31,1,1
16036,26,3006,16,17065,11570,5495,76,218,39,37
17092,26,6393,16,9278,6126,3152,27,16,15,12
15092,28,0,0,70,70,0,1,0,1,0
2744,1238,5651,918,881,126,755,2,30,1,1
254,10,651,9,235,90,145,2,33,1,1
2744,1238,21340,918,919,126,793,2,30,1,1
13780,28,0,0,70,70,0,1,0,1,0
8501,10,9604,9,184,94,90,2,31,1,1
16951,255,0,0,62,62,0,1,0,1,0
14202,28,0,0,70,70,0,1,0,1,0
18855,28,0,0,66,66,0,1,0,1,0
10327,468,6434,303,528,528,0,9,1201,9,0
1725,1017,0,0,66,66,0,1,0,1,0
21523,28,0,0,66,66,0,1,0,1,0
11993,376,0,0,148,148,0,1,0,1,0
8536,10,8759,9,183,94,89,2,30,1,1
22592,28,0,0,70,70,0,1,0,1,0
8341,10,13568,9,199,102,97,2,33,1,1
2744,1238,18796,918,884,126,758,2,30,1,1
9947,28,0,0,70,70,0,1,0,1,0
22323,28,0,0,66,66,0,1,0,1,0
11447,28,0,0,66,66,0,1,0,1,0
10269,28,0,0,70,70,0,1,0,1,0
12133,28,0,0,70,70,0,1,0,1,0
15230,10,12260,9,168,86,82,2,29,1,1
1180,10,3973,9,215,98,117,2,29,1,1
128,391,0,0,62,62,0,1,0,1,0
19158,28,0,0,70,70,0,1,0,1,0
22270,10,20712,9,229,110,119,2,30,1,1
22508,10,15766,9,300,99,201,4,30,2,2
8734,26,12820,16,6408,2531,3877,21,16,11,10
14124,10,23910,9,186,95,91,2,31,1,1
8836,10,6395,9,168,86,82,2,31,1,1
20039,1936,0,0,62,62,0,1,0,1,0
16519,28,0,0,70,70,0,1,0,1,0
12493,1843,23412,1404,70,70,0,2,8,2,0
12057,15,19948,11,1501,958,543,10,323,6,4
15497,10,12907,9,216,110,106,2,31,1,1
9547,346,21954,220,2203,575,1628,10,15,6,4
694,1147,0,0,66,66,0,1,0,1,0
14068,10,674,9,196,102,94,2,31,1,1
18450,15,15836,11,214,140,74,4,15,3,1
9826,15,13076,11,5036,4332,704,11,25,6,5
7339,140,0,0,60,60,0,1,0,1,0
13723,2256,0,0,62,62,0,1,0,1,0
7556,349,5314,222,78,78,0,1,4,1,0
14011,1,0,0,66,66,0,1,0,1,0
9602,28,0,0,70,70,0,1,0,1,0
15315,10,7016,9,716,95,621,2,30,1,1
21539,10,19842,9,214,110,104,2,31,1,1
1286,2587,0,0,62,62,0,1,0,1,0
18864,26,12062,16,11687,2565,9122,46,66,25,21
8853,10,26672,9,197,102,95,2,31,1,1
13758,10,26843,9,816,102,714,2,30,1,1
11025,2560,16923,1989,70,70,0,2,8,2,0
11595,28,0,0,70,70,0,1,0,1,0
12072,28,0,0,66,66,0,1,0,1,0
20212,1888,0,0,66,66,0,1,0,1,0
9273,6,21822,6,184,120,64,4,10,3,1
16951,255,0,0,62,62,0,1,0,1,0
5637,12,0,0,60,60,0,1,0,1,0
14407,10,16303,9,728,96,632,2,30,1,1
2636,15,11088,11,642,338,304,10,33,6,4
14572,10,8262,9,316,94,222,2,30,1,1
6400,26,17505,16,1241645,28525,1213120,1200,65,328,872
12067,1215,0,0,62,62,0,1,0,1,0
10973,28,0,0,66,66,0,1,0,1,0
636,2051,22630,1577,509,150,359,2,1199,1,1
204,10,475,9,212,98,114,2,30,1,1
16263,28,0,0,70,70,0,1,0,1,0
11823,28,0,0,70,70,0,1,0,1,0
2744,1242,28776,922,1624,126,1498,4,31,2,2
19394,26,10399,16,4820,863,3957,18,31,10,8
22118,10,9532,9,458,188,270,6,29,3,3
13719,15,25077,11,306,180,126,6,28,4,2
9495,28,0,0,70,70,0,1,0,1,0
10645,28,0,0,66,66,0,1,0,1,0
9653,26,12419,16,9535,1246,8289,29,77,15,14
8247,234,11743,149,11007,2491,8516,44,4411,18,26
14379,10,29053,9,177,94,83,2,30,1,1
15323,15,4607,11,946,531,415,11,296,6,5
15329,10,103,9,751,95,656,2,30,1,1
21816,10,543,9,173,94,79,2,30,1,1
15454,10,3380,9,209,110,99,2,31,1,1
18393,295,26753,190,3959,1738,2221,15,15,8,7
21716,10,13004,9,276,126,150,2,30,1,1
1756,2587,0,0,62,62,0,1,0,1,0
17353,28,0,0,70,70,0,1,0,1,0
14643,10,11559,9,174,89,85,2,31,1,1
18218,1,0,0,66,66,0,1,0,1,0
22386,1285,9269,964,268,78,190,2,30,1,1
2120,10,8440,9,203,82,121,2,30,1,1
5461,26,8035,16,6219,4130,2089,29,221,16,13
12991,28,0,0,66,66,0,1,0,1,0
22601,10,17246,9,229,110,119,2,31,1,1
16021,2627,14654,2037,508,163,345,2,1200,1,1
5162,26,17177,16,7407,3501,3906,18,15,10,8
12626,28,0,0,70,70,0,1,0,1,0
16390,2256,0,0,66,66,0,1,0,1,0
2676,1147,0,0,66,66,0,1,0,1,0
4505,26,18156,16,2419,1461,958,18,170,10,8
2001,2256,0,0,66,66,0,1,0,1,0
12408,1771,0,0,66,66,0,1,0,1,0
360,3105,0,0,1094,1094,0,1,0,1,0
12679,26,13462,16,499,425,74,4,0,3,1
8327,287,10510,184,834,150,684,4,1200,2,2
14936,10,5445,9,184,94,90,2,30,1,1
15003,10,3376,9,177,94,83,2,29,1,1
18470,26,6585,16,7298,1737,5561,21,79,11,10
14181,10,23677,9,180,94,86,2,30,1,1
16951,255,0,0,62,62,0,1,0,1,0
11584,10,0,0,232,77,155,2,33,1,1
15251,10,3951,9,178,94,84,2,30,1,1
5122,26,1820,16,90001,3161,86840,91,15,26,65
11693,28,0,0,70,70,0,1,0,1,0
8653,28,0,0,70,70,0,1,0,1,0
21329,2429,24122,1890,66,66,0,2,7,2,0
21210,2466,5516,1917,70,70,0,1,5,1,0
10393,28,0,0,66,66,0,1,0,1,0
16939,28,0,0,66,66,0,1,0,1,0
21445,2901,0,0,66,66,0,1,0,1,0
19515,26,27378,16,8512,2483,6029,21,18,12,9
7409,10,20041,9,194,87,107,2,30,1,1
15786,10,20598,9,199,102,97,2,30,1,1
17422,1936,0,0,62,62,0,1,0,1,0
18026,28,0,0,66,66,0,1,0,1,0
17618,28,0,0,70,70,0,1,0,1,0
16860,26,9884,16,3386,1894,1492,20,25,10,10
18275,10,0,0,88,88,0,1,0,1,0
9568,10,20559,9,195,102,93,2,30,1,1
365,1147,0,0,66,66,0,1,0,1,0
7067,26,20858,16,10427,2928,7499,34,106,16,18
21456,10,1893,9,197,94,103,2,30,1,1
8423,10,14608,9,174,89,85,2,31,1,1
16951,255,0,0,62,62,0,1,0,1,0
14625,10,20026,9,199,102,97,2,30,1,1
11975,28,0,0,70,70,0,1,0,1,0
12622,2153,17726,1662,70,70,0,2,8,2,0
15082,10,10384,9,198,102,96,2,32,1,1
15337,10,4397,9,168,86,82,2,30,1,1
15629,28,0,0,70,70,0,1,0,1,0
15988,26,16807,16,2714,336,2378,10,120,5,5
10700,15,1828,11,20457,4742,15715,37,139,20,17
185,10,9835,9,210,78,132,2,30,1,1
11990,26,8098,16,472,406,66,4,0,3,1
5668,107,17435,83,156,156,0,3,8,3,0
21239,711,12225,509,2136,1536,600,18,22,12,6
16546,2362,0,0,72,72,0,1,0,1,0
10195,15,22314,11,8170,844,7326,17,42,7,10
22320,10,18438,9,380,86,294,2,30,1,1
10102,28,0,0,70,70,0,1,0,1,0
570,2439,0,0,60,60,0,1,91,1,0
2584,1677,0,0,160,160,0,1,0,1,0
9247,28,0,0,70,70,0,1,0,1,0
10609,28,0,0,66,66,0,1,0,1,0
13053,18,0,0,234,234,0,1,0,1,0
19030,28,0,0,70,70,0,1,0,1,0
14177,10,25151,9,738,86,652,2,30,1,1
9623,28,0,0,66,66,0,1,0,1,0
15879,10,26399,9,196,102,94,2,30,1,1
10391,28,0,0,66,66,0,1,0,1,0
16495,28,0,0,66,66,0,1,0,1,0
11242,15,2213,11,366,246,120,6,34,4,2
273,1367,0,0,60,60,0,1,0,1,0
992,26,19137,16,3792,488,3304,14,16,7,7
11453,28,0,0,70,70,0,1,0,1,0
10746,2928,8321,2272,70,70,0,1,5,1,0
13122,1054,0,0,66,66,0,1,0,1,0
12323,3,0,0,60,60,0,1,0,1,0
15914,10,4345,9,231,94,137,2,30,1,1
6883,10,19224,9,197,90,107,2,30,1,1
22434,10,14305,9,209,110,99,2,31,1,1
16482,15,10972,11,454,262,192,8,21,5,3
16951,255,0,0,62,62,0,1,0,1,0
21661,10,24893,9,291,110,181,2,30,1,1
9267,10,27507,9,768,99,669,2,30,1,1
837,15,3498,11,326,186,140,6,29,4,2
1447,1147,0,0,146,146,0,1,0,1,0
2928,3216,0,0,66,66,0,1,0,1,0
13751,10,11192,9,178,94,84,2,31,1,1
12518,1540,757,1173,70,70,0,2,8,2,0
8428,10,8330,9,453,186,267,6,30,3,3
17436,28,0,0,70,70,0,1,0,1,0
5125,26,23309,16,40207,7892,32315,59,152,23,36
18400,26,25401,16,6613,4394,2219,50,122,29,21
11035,26,16660,16,4802,866,3936,19,26,10,9
12747,28,0,0,66,66,0,1,0,1,0
18216,28,0,0,70,70,0,1,0,1,0
15570,18,6743,13,184,94,90,2,30,1,1
10620,1017,0,0,66,66,0,1,0,1,0
11337,26,2519,16,9453,2797,6656,46,32,25,21
4680,2587,0,0,66,66,0,1,0,1,0
14097,28,0,0,70,70,0,1,0,1,0
15193,26,25380,16,8034,2014,6020,20,15,11,9
9949,28,0,0,70,70,0,1,0,1,0
21995,3216,0,0,62,62,0,1,0,1,0
3485,26,11946,16,9032,2162,6870,34,34,18,16
7163,26,12371,16,2438,1442,996,21,20,12,9
13230,2883,0,0,66,66,0,1,0,1,0
15725,26,23650,16,4694,2454,2240,14,135,7,7
11617,26,2255,16,18814,2623,16191,54,25,26,28
2181,3145,0,0,146,146,0,1,0,1,0
21789,28,0,0,70,70,0,1,0,1,0
3384,26,11849,16,21805,2081,19724,38,34,19,19
15803,10,3830,9,183,94,89,2,30,1,1
18034,28,0,0,70,70,0,1,0,1,0
22373,10,26881,9,771,102,669,2,30,1,1
8706,15,16908,11,374,192,182,7,42,4,3
18292,28,0,0,70,70,0,1,0,1,0
21442,10,27229,9,361,99,262,4,54,2,2
666,1017,0,0,146,146,0,1,0,1,0
5292,15,18489,11,62592,60966,1626,63,16,47,16
22316,28,0,0,70,70,0,1,0,1,0
22570,1017,0,0,62,62,0,1,0,1,0
12526,405,11229,263,70,70,0,1,4,1,0
19406,1086,0,0,66,66,0,1,0,1,0
12500,26,2972,16,9028,3897,5131,24,83,15,9
9208,1017,0,0,66,66,0,1,0,1,0
22392,1369,27676,1040,259,78,181,2,29,1,1
14961,1827,0,0,66,66,0,1,0,1,0
18059,26,22046,16,2162,1113,1049,18,16,10,8
14263,28,0,0,70,70,0,1,0,1,0
10486,10,0,0,194,87,107,2,30,1,1
11160,51,1652,34,70,70,0,2,8,2,0
13862,10,25167,9,179,94,85,2,30,1,1
3422,2154,0,0,62,62,0,1,0,1,0
5065,26,10613,16,97751,9140,88611,115,82,39,76
9602,15,23547,11,1426,865,561,9,15,5,4
11661,28,0,0,66,66,0,1,0,1,0
2117,2938,0,0,146,146,0,1,0,1,0
11596,713,0,0,66,66,0,1,0,1,0
14540,28,0,0,70,70,0,1,0,1,0
4659,26,4790,16,11095,3227,7868,30,47,17,13
19532,26,10700,16,8696,3245,5451,36,47,16,20
15046,10,3169,9,176,90,86,2,30,1,1
4154,2256,0,0,78,78,0,1,0,1,0
22565,26,4051,16,629017,29841,599176,758,162,331,427
20706,28,0,0,70,70,0,1,0,1,0
6987,26,660,16,3467,2186,1281,16,15,9,7
15136,10,1547,9,199,102,97,2,30,1,1
21174,2938,0,0,62,62,0,1,0,1,0
18978,28,0,0,70,70,0,1,0,1,0
4414,15,15759,11,129896,7448,122448,172,32,87,85
21249,2945,4572,2284,504,382,122,8,17,6,2
11205,28,0,0,70,70,0,1,0,1,0
5572,26,25881,16,4564,3204,1360,19,348,10,9
9737,26,21462,16,6292,1492,4800,22,16,11,11
8643,295,21506,190,5910,4455,1455,19,15,11,8
16769,28,0,0,66,66,0,1,0,1,0
13923,28,0,0,70,70,0,1,0,1,0
19380,26,2760,16,4561,1129,3432,22,109,13,9
9999,28,0,0,66,66,0,1,0,1,0
6994,529,0,0,148,148,0,1,0,1,0
4348,7,0,0,60,60,0,1,0,1,0
6601,15,19709,11,3863,875,2988,12,16,8,4
14709,10,7966,9,817,102,715,2,30,1,1
21439,10,4266,9,202,103,99,2,30,1,1
8739,26,10579,16,1820,1101,719,18,16,10,8
21609,10,16728,9,469,103,366,4,43,2,2
20253,28,0,0,70,70,0,1,0,1,0
11334,26,20143,16,3448,1612,1836,31,36,17,14
4014,10,0,0,82,82,0,1,30,1,0
7939,26,20798,16,4672,1765,2907,18,28,10,8
9910,26,11339,16,6882,1377,5505,19,151,9,10
9256,28,0,0,70,70,0,1,0,1,0
9902,26,10200,16,19782,3596,16186,38,256,21,17
15233,10,4565,9,186,95,91,2,31,1,1
11340,1215,0,0,62,62,0,1,0,1,0
3665,26,14368,16,5341,1386,3955,19,649,11,8
15735,28,0,0,66,66,0,1,0,1,0
19200,1215,0,0,62,62,0,1,0,1,0
11219,1105,26433,811,70,70,0,1,5,1,0
18802,28,0,0,70,70,0,1,0,1,0
548,3216,0,0,66,66,0,1,0,1,0
12625,1648,3369,1265,70,70,0,1,4,1,0
100,2611,0,0,62,62,0,1,0,1,0
21548,10,24222,9,192,98,94,2,31,1,1
13532,2636,0,0,66,66,0,1,0,1,0
22139,10,603,9,315,110,205,2,30,1,1
22529,10,6150,9,732,89,643,2,31,1,1
19397,26,5494,16,215490,8471,207019,194,45,45,149
12123,28,0,0,70,70,0,1,0,1,0
18357,300,0,0,62,62,0,1,0,1,0
17989,26,27376,16,302,120,182,6,31,3,3
13040,26,27637,16,499,425,74,4,0,3,1
9696,26,17738,16,8311,3156,5155,29,17,16,13
9480,15,7377,11,3855,828,3027,11,15,5,6
8276,2023,0,0,161,161,0,1,0,1,0
10998,2191,13129,1696,70,70,0,1,4,1,0
19881,28,0,0,70,70,0,1,0,1,0
22493,10,22998,9,241,118,123,2,30,1,1
11150,2146,19514,1658,70,70,0,1,5,1,0
10275,28,0,0,70,70,0,1,0,1,0
16951,255,0,0,62,62,0,1,0,1,0
8584,1631,7504,1253,237,78,159,2,30,1,1
22517,28,0,0,70,70,0,1,0,1,0
19317,15,20244,11,214,140,74,4,41,3,1
9240,26,2596,16,18754,5240,13514,31,16,15,16
5799,7,0,0,60,60,0,1,0,1,0
11602,2256,0,0,66,66,0,1,0,1,0
9248,2573,0,0,62,62,0,1,0,1,0
11751,15,9952,11,2078,726,1352,10,15,5,5
4399,15,15789,11,514,246,268,9,75,5,4
9001,26,24217,16,4685,2421,2264,10,119,5,5
8812,28,0,0,70,70,0,1,0,1,0
15770,377,25273,243,138,78,60,2,5,1,1
5243,26,15463,16,10831,1381,9450,22,19,12,10
13341,28,0,0,70,70,0,1,0,1,0
594,1147,0,0,146,146,0,1,0,1,0
9695,15,19231,11,374,192,182,7,26,4,3
6983,26,24504,16,9608,1958,7650,21,15,11,10
18053,15,17458,11,730296,15564,714732,723,57,218,505
10558,26,24155,16,98292,24468,73824,179,52,81,98
9618,26,21349,16,17449456,390704,17058752,16816,383,4917,11899
3518,41,0,0,60,60,0,1,0,1,0
9877,1888,0,0,62,62,0,1,0,1,0
11044,955,2646,705,70,70,0,1,5,1,0
2136,10,8540,9,229,89,140,2,31,1,1
15882,1888,0,0,62,62,0,1,0,1,0
2724,1240,18075,920,422,164,258,6,30,3,3
1793,2256,0,0,62,62,0,1,0,1,0
15703,28,0,0,70,70,0,1,0,1,0
3569,10,0,0,86,86,0,1,30,1,0
10123,28,0,0,66,66,0,1,0,1,0
2515,2938,0,0,62,62,0,1,0,1,0
7853,26,20168,16,12572,3471,9101,34,363,14,20
18715,28,0,0,70,70,0,1,0,1,0
8812,10,18090,9,209,102,107,2,30,1,1
1651,1147,0,0,62,62,0,1,0,1,0
15200,10,24616,9,193,102,91,2,30,1,1
9237,26,5356,16,12035,9784,2251,41,92,22,19
10124,26,7906,16,3115,1849,1266,18,16,8,10
2491,1771,0,0,62,62,0,1,0,1,0
13724,28,0,0,66,66,0,1,0,1,0
4689,26,3190,16,499,425,74,4,0,3,1
16192,26,22307,16,12569,8228,4341,28,256,16,12
14104,28,0,0,70,70,0,1,0,1,0
15400,28,0,0,70,70,0,1,0,1,0
16021,742,8264,533,726,726,0,12,1200,12,0
11266,28,0,0,66,66,0,1,0,1,0
14199,2256,0,0,62,62,0,1,0,1,0
1857,10,7022,9,220,90,130,2,30,1,1
166,2486,0,0,62,62,0,1,0,1,0
18773,28,0,0,70,70,0,1,0,1,0
13893,26,13062,16,9656,3460,6196,22,46,12,10
7480,15,18004,11,1155,781,374,10,15,6,4
1427,2611,0,0,62,62,0,1,0,1,0
1704,1215,0,0,62,62,0,1,0,1,0
22257,10,2971,9,194,102,92,2,30,1,1
21355,523,17746,346,66,66,0,1,5,1,0
4485,26,7925,16,6646,2747,3899,20,134,10,10
22688,10,16426,9,166,86,80,2,29,1,1
9511,1888,0,0,66,66,0,1,0,1,0
15553,10,14244,9,267,87,180,4,38,2,2
7202,26,123,16,8034,400,7634,14,193,2,12
11924,28,0,0,70,70,0,1,0,1,0
5317,26,5950,16,6891,1421,5470,20,127,12,8
10893,28,0,0,70,70,0,1,0,1,0
566,1017,0,0,62,62,0,1,0,1,0
18576,1936,0,0,62,62,0,1,0,1,0
7431,26,528,16,1053,566,487,10,41,6,4
14877,10,17776,9,194,99,95,2,30,1,1
2018,15,7890,11,12650,889,11761,20,16,9,11
14411,10,11107,9,231,110,121,2,30,1,1
9599,28,0,0,70,70,0,1,0,1,0
14271,10,16980,9,182,93,89,2,0,1,1
706,2587,0,0,66,66,0,1,0,1,0
22047,10,21549,9,184,94,90,2,31,1,1
14814,10,24657,9,183,94,89,2,31,1,1
12735,26,6154,16,390740,13639,377101,441,132,152,289
10093,28,0,0,70,70,0,1,0,1,0
5240,26,19511,16,25034,7042,17992,58,21,29,29
10999,1866,14278,1424,70,70,0,1,4,1,0
9610,15,21992,11,78335,7114,71221,114,22,60,54
13666,3216,0,0,62,62,0,1,0,1,0
11342,28,0,0,70,70,0,1,0,1,0
414,3188,0,0,66,66,0,1,0,1,0
8390,153,10877,108,3492,3432,60,12,36,11,1
16534,28,0,0,70,70,0,1,0,1,0
15096,10,1180,9,177,94,83,2,31,1,1
895,15,22319,11,378,192,186,7,30,4,3
844,2853,0,0,146,146,0,1,0,1,0
15641,10,26336,9,166,86,80,2,30,1,1
22392,1238,430,918,260,78,182,2,30,1,1
14358,28,0,0,66,66,0,1,0,1,0
11200,26,15564,16,7228,1589,5639,22,362,11,11
18593,15,20949,11,2122,1559,563,13,16,7,6
11079,2690,15003,2089,70,70,0,2,8,2,0
1804,2921,0,0,60,60,0,1,0,1,0
12814,26,23108,16,1591,1004,587,15,125,8,7
2424,2853,0,0,62,62,0,1,0,1,0
11206,26,22827,16,126525,6370,120155,147,22,56,91
14897,10,9162,9,183,94,89,2,30,1,1
11220,26,6851,16,7942,870,7072,22,15,10,12
6832,1215,0,0,62,62,0,1,0,1,0
14971,28,0,0,70,70,0,1,0,1,0
15378,10,4336,9,195,102,93,2,30,1,1
12352,28,0,0,70,70,0,1,0,1,0
21233,28,0,0,70,70,0,1,0,1,0
4381,2104,0,0,148,148,0,1,0,1,0
9759,10,13391,9,785,110,675,2,30,1,1
5333,26,15954,16,1396,735,661,14,80,8,6
15444,28,0,0,70,70,0,1,0,1,0
11216,2944,18249,2283,66,66,0,1,5,1,0
16062,28,0,0,70,70,0,1,0,1,0
13947,10,17185,9,177,94,83,2,30,1,1
11839,26,24075,16,21194,5779,15415,118,115,47,71
12694,28,0,0,70,70,0,1,0,1,0
15856,28,0,0,70,70,0,1,0,1,0
15221,10,12888,9,177,94,83,2,30,1,1
16821,28,0,0,66,66,0,1,0,1,0
6352,26,7822,16,218298,5904,212394,220,120,63,157
1496,3216,0,0,62,62,0,1,0,1,0
634,7,0,0,60,60,0,1,0,1,0
15742,10,6983,9,753,96,657,2,31,1,1
15180,26,27415,16,7863,1874,5989,20,15,11,9
14910,10,8981,9,178,94,84,2,29,1,1
15145,10,29079,9,91,91,0,1,31,1,0
11073,2188,19852,1693,316,136,180,6,6,3,3
8712,10,659,9,357,106,251,4,36,2,2
7335,1070,0,0,60,60,0,1,0,1,0
13389,1804,0,0,66,66,0,1,0,1,0
11632,28,0,0,66,66,0,1,0,1,0
12293,28,0,0,66,66,0,1,0,1,0
21682,10,1364,9,184,94,90,2,30,1,1
6893,15,16203,11,1114,534,580,12,16,7,5
12897,28,0,0,66,66,0,1,0,1,0
15376,1005,5940,739,316,136,180,6,7,3,3
12734,162,16589,112,70,70,0,1,5,1,0
3225,1994,9622,1524,188,70,118,2,31,1,1
11651,15,23098,11,2012,1423,589,12,48,6,6
18548,28,0,0,66,66,0,1,0,1,0
9569,28,0,0,66,66,0,1,0,1,0
12167,26,8536,16,12634,1635,10999,26,322,11,15
22470,10,28578,9,226,102,124,2,30,1,1
22666,10,26779,9,182,93,89,2,31,1,1
2204,10,8934,9,230,90,140,2,30,1,1
20296,28,0,0,66,66,0,1,0,1,0
20078,28,0,0,66,66,0,1,0,1,0
21101,2082,10376,1604,66,66,0,1,5,1,0
14819,234,3206,149,2564,1546,1018,18,3600,9,9
12294,26,15717,16,28728581,857403,27871178,29322,132,8944,20378
10464,28,0,0,66,66,0,1,0,1,0
11529,26,9131,16,5696,2392,3304,23,135,10,13
19933,28,0,0,66,66,0,1,0,1,0
8374,2993,2515,2327,70,70,0,2,8,2,0
9882,26,27941,16,6335,1376,4959,19,165,9,10
16086,28,0,0,70,70,0,1,0,1,0
1423,1888,0,0,62,62,0,1,0,1,0
11742,28,0,0,70,70,0,1,0,1,0
11886,1147,0,0,146,146,0,1,0,1,0
11640,1147,0,0,62,62,0,1,0,1,0
11127,15,15055,11,1621,896,725,11,19,7,4
1583,1422,0,0,62,62,0,1,0,1,0
16796,26,14752,16,6020,2493,3527,29,80,14,15
14175,10,9145,9,177,94,83,2,30,1,1
18391,15,14629,11,2125,1159,966,13,61,7,6
21449,10,14523,9,296,91,205,4,55,2,2
13656,10,4664,9,196,102,94,2,31,1,1
22410,26,5038,16,8188,2769,5419,22,611,12,10
16951,255,0,0,62,62,0,1,0,1,0
16967,10,26098,9,167,78,89,2,30,1,1
16162,28,0,0,70,70,0,1,0,1,0
11764,15,18838,11,3626,1778,1848,36,143,19,17
12484,757,16433,545,70,70,0,2,7,2,0
11907,28,0,0,70,70,0,1,0,1,0
17745,1888,0,0,66,66,0,1,0,1,0
22576,28,0,0,70,70,0,1,0,1,0
6250,2002,7481,1532,1531,729,802,10,31,5,5
8788,28,0,0,70,70,0,1,0,1,0
21460,10,3584,9,270,110,160,2,29,1,1
1672,2144,0,0,62,62,0,1,0,1,0
10736,1017,0,0,66,66,0,1,0,1,0
18913,26,2033,16,5150,3651,1499,34,46,18,16
9535,26,7098,16,5968,985,4983,17,29,8,9
13886,26,12002,16,6902,1936,4966,22,45,11,11
16181,1771,0,0,66,66,0,1,0,1,0
22116,2604,0,0,66,66,0,1,0,1,0
15100,26,19416,16,43823,7381,36442,84,38,42,42
22052,10,6144,9,166,85,81,2,31,1,1
18781,28,0,0,66,66,0,1,0,1,0
6356,491,0,0,148,148,0,1,0,1,0
9618,28,0,0,66,66,0,1,0,1,0
3051,1804,0,0,62,62,0,1,0,1,0
14552,10,6407,9,197,102,95,2,30,1,1
13582,28,0,0,70,70,0,1,0,1,0
12,972,0,0,83,83,0,1,0,1,0
9249,10,16155,9,183,94,89,2,30,1,1
10970,15,27581,11,278312,9722,268590,323,61,135,188
21274,694,2814,493,66,66,0,2,7,2,0
21498,10,21435,9,227,110,117,2,31,1,1
1950,1147,0,0,66,66,0,1,0,1,0
9058,104,0,0,60,60,0,1,0,1,0
14431,26,20557,16,62,62,0,1,4,1,0
9828,15,16333,11,66772,4924,61848,110,19,60,50
13157,28,0,0,70,70,0,1,0,1,0
21935,10,23824,9,338,110,228,2,29,1,1
15230,10,25328,9,209,110,99,2,29,1,1
14711,10,16985,9,278,96,182,4,53,2,2
4028,26,18815,16,154,94,60,2,5,1,1
12358,2883,0,0,62,62,0,1,0,1,0
2695,183,11252,121,293,223,70,4,1,3,1
9009,26,9496,16,10396,4585,5811,38,54,21,17
22142,10,4681,9,317,96,221,4,32,2,2
9178,15,14154,11,810,670,140,6,34,4,2
14893,28,0,0,70,70,0,1,0,1,0
13154,1215,0,0,62,62,0,1,0,1,0
12469,3216,0,0,66,66,0,1,0,1,0
12,658,0,0,85,85,0,1,0,1,0
2803,1872,0,0,62,62,0,1,0,1,0
8394,10,17493,9,340,89,251,4,44,2,2
8976,10,14000,9,308,110,198,2,29,1,1
13827,10,22317,9,815,95,720,2,31,1,1
16741,28,0,0,66,66,0,1,0,1,0
17968,26,20404,16,2069,1044,1025,22,44,9,13
11935,28,0,0,66,66,0,1,0,1,0
10900,2033,22732,1561,70,70,0,1,5,1,0
11810,28,0,0,70,70,0,1,0,1,0
5,3216,0,0,66,66,0,1,0,1,0
16024,28,0,0,70,70,0,1,0,1,0
20013,2587,0,0,66,66,0,1,0,1,0
2744,1238,7960,918,892,126,766,2,30,1,1
3215,2235,0,0,62,62,0,1,0,1,0
10765,2593,18978,2012,70,70,0,2,8,2,0
22077,28,0,0,66,66,0,1,0,1,0
15083,26,23808,16,78426,3219,75207,98,96,37,61
11771,15,22427,11,7502,3168,4334,41,140,22,19
5447,26,6507,16,5663,4227,1436,27,47,16,11
9629,15,22958,11,318,192,126,6,26,4,2
7812,1147,0,0,62,62,0,1,0,1,0
21969,28,0,0,66,66,0,1,0,1,0
4835,793,7629,577,481,150,331,2,1199,1,1
8123,308,0,0,146,146,0,1,0,1,0
9037,26,25825,16,14476,2843,11633,45,55,22,23
15895,15,16248,11,1420,715,705,12,16,7,5
13630,465,0,0,159,159,0,1,0,1,0
15306,26,21457,16,7907,1918,5989,20,15,11,9
10327,2627,7133,2037,460,150,310,2,1200,1,1
8777,10,5904,9,184,94,90,2,30,1,1
7335,1070,0,0,60,60,0,1,0,1,0
13730,10,8032,9,277,90,187,4,32,2,2
15263,26,11873,16,19185,2445,16740,40,25,20,20
1804,2513,0,0,60,60,0,1,0,1,0
19454,1017,0,0,146,146,0,1,0,1,0
11008,2940,10449,2280,70,70,0,2,8,2,0
15570,10,10304,9,337,107,230,4,34,2,2
15262,26,4474,16,21086,2515,18571,42,25,21,21
8416,26,18636,16,35406,17785,17621,79,141,40,39
16021,1137,3576,838,1386,1386,0,22,1544,22,0
22484,1827,0,0,146,146,0,1,0,1,0
20132,28,0,0,70,70,0,1,0,1,0
7076,1888,0,0,62,62,0,1,0,1,0
17031,26,2030,16,2383,1460,923,18,201,10,8
21665,10,21214,9,294,95,199,4,42,2,2
14224,10,27382,9,170,87,83,2,30,1,1
21340,28,0,0,70,70,0,1,0,1,0
9243,1224,0,0,62,62,0,1,0,1,0
15949,28,0,0,70,70,0,1,0,1,0
13896,10,12933,9,416,102,314,2,30,1,1
2075,1771,0,0,146,146,0,1,0,1,0
16396,28,0,0,70,70,0,1,0,1,0
12789,1564,23722,1195,70,70,0,1,4,1,0
13805,10,10580,9,199,102,97,2,29,1,1
9385,28,0,0,70,70,0,1,0,1,0
9432,26,925,16,8773,1538,7235,25,15,14,11
11751,26,23149,16,4613,1706,2907,19,30,11,8
12438,1332,11591,1007,552,306,246,9,15,5,4
9291,2587,0,0,146,146,0,1,0,1,0
19902,26,6992,16,3937,1210,2727,18,134,8,10
11474,26,11014,16,57366,41661,15705,111,440,66,45
13875,10,14280,9,173,94,79,2,30,1,1
1020,2938,0,0,62,62,0,1,0,1,0
22458,10,28126,9,184,94,90,2,30,1,1
16951,255,0,0,62,62,0,1,0,1,0
12,2568,0,0,331,331,0,1,0,1,0
8820,15,27846,11,1506,914,592,9,16,5,4
14616,10,1498,9,232,94,138,2,30,1,1
1349,3216,0,0,62,62,0,1,0,1,0
14207,2977,19332,2311,70,70,0,1,5,1,0
17691,1888,0,0,62,62,0,1,0,1,0
11924,28,0,0,66,66,0,1,0,1,0
21674,10,18146,9,217,94,123,2,30,1,1
17881,1167,0,0,66,66,0,1,0,1,0
12,2150,0,0,74,74,0,1,0,1,0
16602,28,0,0,66,66,0,1,0,1,0
15749,10,12222,9,193,102,91,2,29,1,1
612,261,0,0,60,60,0,1,0,1,0
9197,10,8290,9,308,102,206,2,29,1,1
362,7,0,0,60,60,0,1,0,1,0
17787,2440,0,0,66,66,0,1,0,1,0
17866,26,16857,16,8789,1592,7197,25,75,13,12
19159,1888,0,0,66,66,0,1,0,1,0
10949,462,9153,298,70,70,0,2,8,2,0
2744,1238,28330,918,889,126,763,2,30,1,1
10141,3216,0,0,62,62,0,1,0,1,0
19727,28,0,0,66,66,0,1,0,1,0
263,805,0,0,62,62,0,1,0,1,0
10366,2447,9174,1900,70,70,0,1,5,1,0
20920,28,0,0,70,70,0,1,0,1,0
9582,28,0,0,70,70,0,1,0,1,0
604,7,0,0,60,60,0,1,0,1,0
8451,10,8811,9,177,94,83,2,30,1,1
14969,10,12208,9,193,102,91,2,29,1,1
9103,15,5893,11,1130,613,517,11,15,6,5
0,0,0,0,60,60,0,1,0,1,0
8164,2726,0,0,60,60,0,1,0,1,0
15439,28,0,0,70,70,0,1,0,1,0
1804,3243,0,0,60,60,0,1,0,1,0
13892,1539,0,0,66,66,0,1,0,1,0
7647,26,12754,16,40443,5300,35143,88,134,38,50
9161,10,17922,9,284,94,190,2,29,1,1
7339,431,0,0,60,60,0,1,0,1,0
21219,1196,26319,884,70,70,0,1,4,1,0
13162,28,0,0,70,70,0,1,0,1,0
532,247,0,0,3562,1936,1626,48,193,24,24
3472,10,9602,9,168,78,90,2,31,1,1
10,20,17382,14,114,114,0,2,32,2,0
15808,1888,0,0,62,62,0,1,0,1,0
18142,26,8405,16,229060,38515,190545,283,135,113,170
21969,10,27301,9,770,102,668,2,29,1,1
6649,697,0,0,74,74,0,1,0,1,0
16490,15,2857,11,4168,2906,1262,11,15,6,5
15809,10,20003,9,182,93,89,2,31,1,1
16019,28,0,0,70,70,0,1,0,1,0
16059,28,0,0,66,66,0,1,0,1,0
2903,1771,0,0,146,146,0,1,0,1,0
15943,10,9618,9,193,102,91,2,29,1,1
14633,28,0,0,70,70,0,1,0,1,0
14811,10,18758,9,168,78,90,2,30,1,1
2913,15,11941,11,303421,10894,292527,324,26,116,208
10610,28,0,0,66,66,0,1,0,1,0
8922,15,16385,11,20926,3231,17695,37,51,17,20
20322,2611,0,0,66,66,0,1,0,1,0
12469,3216,0,0,62,62,0,1,0,1,0
6851,10,11382,9,240,76,164,2,31,1,1
4613,10,16109,9,214,82,132,2,30,1,1
13754,10,9662,9,392,92,300,4,55,2,2
612,714,0,0,60,60,0,1,0,1,0
16299,10,25575,9,213,79,134,2,33,1,1
8335,2938,0,0,66,66,0,1,0,1,0
20424,28,0,0,66,66,0,1,0,1,0
9667,10,2674,9,168,86,82,2,31,1,1
20689,28,0,0,66,66,0,1,0,1,0
413,1771,0,0,62,62,0,1,0,1,0
11005,15,19426,11,426,240,186,8,25,5,3
1119,1590,0,0,62,62,0,1,0,1,0
18036,15,11657,11,1272,786,486,8,31,5,3
18218,1,0,0,66,66,0,1,0,1,0
15271,26,11685,16,3140,1782,1358,18,17,10,8
19605,28,0,0,70,70,0,1,0,1,0
12191,26,25091,16,11114,3066,8048,41,119,22,19
13700,10,4716,9,198,102,96,2,29,1,1
3604,26,26277,16,11404,1948,9456,30,81,15,15
224,26,552,16,11489,1827,9662,25,23,15,10
11002,616,6636,424,258,70,188,4,8,2,2
6651,1129,0,0,156,156,0,1,0,1,0
9351,2256,0,0,74,74,0,1,0,1,0
8904,26,26952,16,5572,1446,4126,17,129,10,7
3133,2313,2629,1797,330,330,0,6,3610,6,0
13717,15,8618,11,2776,1333,1443,12,37,7,5
17082,28,0,0,70,70,0,1,0,1,0
14739,28,0,0,70,70,0,1,0,1,0
19145,28,0,0,66,66,0,1,0,1,0
16619,7,0,0,60,60,0,1,0,1,0
13540,1771,0,0,146,146,0,1,0,1,0
19859,28,0,0,70,70,0,1,0,1,0
15154,10,18105,9,219,86,133,2,31,1,1
10848,1888,0,0,66,66,0,1,0,1,0
15239,15,21947,11,234,234,0,4,11,4,0
9728,2134,4116,1647,161,161,0,2,1199,2,0
10610,26,22548,16,11204,3773,7431,29,132,12,17
15210,15,1551,11,234,234,0,4,12,4,0
9990,1215,0,0,66,66,0,1,0,1,0
12862,26,3267,16,350,210,140,6,25,4,2
5802,18,15495,13,184,94,90,2,31,1,1
10840,1682,7851,1287,70,70,0,2,8,2,0
16021,2680,16686,2081,594,594,0,10,1199,10,0
15157,26,7319,16,4884,1015,3869,17,25,9,8
16021,2627,7727,2037,604,275,329,4,1199,2,2
1330,918,0,0,62,62,0,1,0,1,0
21662,10,4371,9,231,102,129,2,30,1,1
20898,2256,0,0,66,66,0,1,0,1,0
2969,1804,0,0,62,62,0,1,0,1,0
21977,10,19005,9,210,94,116,2,30,1,1
3254,1147,0,0,62,62,0,1,0,1,0
10115,26,22165,16,67798,17043,50755,202,146,110,92
7339,140,0,0,60,60,0,1,0,1,0
14556,10,924,9,762,98,664,2,31,1,1
6381,2558,0,0,62,62,0,1,0,1,0
22128,10,10837,9,98,98,0,1,31,1,0
16021,280,2267,177,453,251,202,4,1200,2,2
20540,26,5470,16,2570995,60656,2510339,2538,34,844,1694
18802,1147,0,0,66,66,0,1,0,1,0
17235,28,0,0,66,66,0,1,0,1,0
21281,159,5773,110,66,66,0,1,5,1,0
9394,26,15604,16,8882,3013,5869,29,137,14,15
8039,26,12647,16,9759,3896,5863,28,230,15,13
570,887,0,0,60,60,0,1,91,1,0
636,2866,22492,2225,228,118,110,2,1200,1,1
16568,15,25744,11,23462,3780,19682,49,47,24,25
15715,28,0,0,70,70,0,1,0,1,0
1909,293,22196,188,150,150,0,1,1200,1,0
13849,26,23053,16,12947,4309,8638,29,152,15,14
3570,1942,0,0,162,162,0,1,0,1,0
16991,10,25987,9,235,92,143,2,30,1,1
10827,15,4088,11,9897,4338,5559,27,58,16,11
15329,26,6458,16,8006,1986,6020,20,16,11,9
8498,10,2116,9,182,94,88,2,31,1,1
11380,28,0,0,70,70,0,1,0,1,0
8433,10,2446,9,199,102,97,2,29,1,1
21484,28,0,0,70,70,0,1,0,1,0
14154,28,0,0,70,70,0,1,0,1,0
7190,15,4185,11,1155,781,374,10,15,6,4
11090,1443,12502,1097,70,70,0,1,5,1,0
1726,10,6353,9,216,82,134,2,33,1,1
15487,10,15396,9,100,100,0,2,35,2,0
10104,28,0,0,66,66,0,1,0,1,0
347,2587,0,0,62,62,0,1,0,1,0
16826,28,0,0,70,70,0,1,0,1,0
6509,26,28745,16,9329,2900,6429,27,135,15,12
17542,2938,0,0,74,74,0,1,0,1,0
9754,15,23416,11,3726,1504,2222,13,21,7,6
19057,1888,0,0,62,62,0,1,0,1,0
16951,255,0,0,62,62,0,1,0,1,0
15235,15,22351,11,234,234,0,4,12,4,0
13869,10,13356,9,168,86,82,2,30,1,1
18393,26,4272,16,2859,1499,1360,20,315,10,10
6999,280,1014,177,501,150,351,2,1200,1,1
8074,1147,0,0,146,146,0,1,0,1,0
20478,28,0,0,70,70,0,1,0,1,0
16777,1017,0,0,66,66,0,1,0,1,0
17770,1017,0,0,66,66,0,1,0,1,0
10835,687,4594,486,70,70,0,2,8,2,0
17101,28,0,0,70,70,0,1,0,1,0
15840,10,8601,9,185,102,83,2,29,1,1
17502,28,0,0,70,70,0,1,0,1,0
10027,26,27151,16,130,70,60,3,5,2,1
15221,2486,0,0,62,62,0,1,0,1,0
5385,26,10459,16,11226,3340,7886,28,16,16,12
21838,10,3147,9,404,95,309,4,43,2,2
18887,3216,0,0,74,74,0,1,0,1,0
22090,10,25849,9,182,93,89,2,30,1,1
791,369,4677,237,66,66,0,1,30,1,0
9626,26,14316,16,6904692,144860,6759832,6483,140,1783,4700
15435,2554,21270,1984,70,70,0,1,5,1,0
6194,2787,0,0,60,60,0,1,0,1,0
18836,1147,0,0,66,66,0,1,0,1,0
0,0,0,0,134,64,70,2,0,1,1
13726,10,22933,9,168,86,82,2,30,1,1
12012,15,23287,11,19237,829,18408,29,15,13,16
16182,28,0,0,66,66,0,1,0,1,0
463,2256,0,0,62,62,0,1,0,1,0
2744,1618,14901,1240,864,126,738,2,31,1,1
10338,28,0,0,66,66,0,1,0,1,0
13755,10,5286,9,733,85,648,2,31,1,1
1748,10,6481,9,241,95,146,2,31,1,1
7324,10,7885,9,168,78,90,2,30,1,1
13766,10,20144,9,313,110,203,4,35,2,2
8739,10,4044,9,770,102,668,2,30,1,1
14283,10,20848,9,304,110,194,4,35,2,2
2926,2587,0,0,62,62,0,1,0,1,0
7339,2845,0,0,60,60,0,1,0,1,0
18363,26,14029,16,9565,3317,6248,25,144,14,11
6575,16,0,0,60,60,0,1,0,1,0
15450,509,0,0,66,66,0,1,0,1,0
12535,26,5920,16,4045,439,3606,11,15,5,6
14914,10,413,9,209,110,99,2,31,1,1
20795,28,0,0,70,70,0,1,0,1,0
10600,1888,0,0,72,72,0,1,0,1,0
12,447,0,0,60,60,0,1,0,1,0
13301,3216,0,0,62,62,0,1,0,1,0
10807,28,0,0,70,70,0,1,0,1,0
18279,155,0,0,62,62,0,1,0,1,0
7075,26,2445,16,7536,1915,5621,31,20,17,14
9998,28,0,0,70,70,0,1,0,1,0
19516,28,0,0,66,66,0,1,0,1,0
7734,2587,0,0,62,62,0,1,0,1,0
14563,28,0,0,70,70,0,1,0,1,0
11928,15,5187,11,3470,1464,2006,21,190,10,11
15528,10,6196,9,183,94,89,2,30,1,1
2056,1936,0,0,62,62,0,1,0,1,0
1817,1017,0,0,62,62,0,1,0,1,0
13501,2440,0,0,66,66,0,1,0,1,0
11094,1017,0,0,66,66,0,1,0,1,0
9676,28,0,0,66,66,0,1,0,1,0
13607,26,24472,16,9996,2043,7953,42,271,20,22
7859,26,7001,16,280,140,140,5,151,3,2
9724,15,22051,11,18727,8262,10465,44,18,23,21
2409,1472,0,0,62,62,0,1,0,1,0
15433,28,0,0,70,70,0,1,0,1,0
21812,28,0,0,70,70,0,1,0,1,0
12078,15,25579,11,1873,713,1160,10,15,5,5
22312,10,26667,9,438,180,258,6,30,3,3
13511,28,0,0,70,70,0,1,0,1,0
19807,26,7509,16,21959,8954,13005,65,63,33,32
13825,10,18306,9,172,88,84,2,31,1,1
750,26,3028,16,6593,3073,3520,27,82,14,13
2724,1240,25224,920,422,164,258,6,30,3,3
21815,10,22375,9,210,110,100,2,30,1,1
15001,10,15265,9,716,95,621,2,30,1,1
7707,697,0,0,62,62,0,1,0,1,0
16997,28,0,0,70,70,0,1,0,1,0
18192,26,27528,16,7243,4797,2446,42,136,23,19
2744,1239,13701,919,1648,126,1522,4,30,2,2
7396,15,3993,11,5443,2529,2914,14,515,8,6
9054,26,16009,16,9545,2433,7112,24,142,10,14
2496,10,10468,9,214,82,132,2,32,1,1
21548,28,0,0,66,66,0,1,0,1,0
10502,26,22250,16,15321,3760,11561,56,170,23,33
13952,3216,0,0,66,66,0,1,0,1,0
8990,10,10008,9,814,110,704,2,29,1,1
11847,3212,0,0,66,66,0,1,0,1,0
9898,15,28571,11,1783,1346,437,7,15,5,2
7841,346,0,0,184,78,106,3,10,2,1
8821,10,14274,9,209,110,99,2,30,1,1
360,3105,0,0,1248,1248,0,1,0,1,0
14414,28,0,0,70,70,0,1,0,1,0
18359,1472,0,0,66,66,0,1,0,1,0
15539,1771,0,0,66,66,0,1,0,1,0
12835,28,0,0,70,70,0,1,0,1,0
233,1147,0,0,66,66,0,1,0,1,0
20329,1880,0,0,66,66,0,1,0,1,0
14386,10,25370,9,170,87,83,2,30,1,1
17026,26,19625,16,39202,21598,17604,72,20,39,33
22561,10,4227,9,193,102,91,2,30,1,1
14002,10,80,9,168,86,82,2,31,1,1
9837,15,16139,11,56849,29352,27497,239,175,120,119
1330,2943,0,0,62,62,0,1,0,1,0
10647,28,0,0,70,70,0,1,0,1,0
8506,15,3239,11,1467,361,1106,10,15,5,5
13538,28,0,0,70,70,0,1,0,1,0
11120,3249,13047,2518,634,568,66,8,29,7,1
2744,1281,7964,961,883,126,757,2,31,1,1
14068,10,71,9,196,102,94,2,31,1,1
7239,234,21967,149,29298,3627,25671,67,5346,25,42
8800,10,2640,9,257,102,155,2,30,1,1
5468,26,13098,16,10457,3150,7307,25,217,13,12
9237,10,7971,9,185,102,83,2,29,1,1
6343,26,28617,16,3137,1986,1151,15,15,8,7
22397,10,3663,9,265,91,174,4,36,2,2
17868,28,0,0,70,70,0,1,0,1,0
5069,26,20186,16,6231,1151,5080,23,109,13,10
7339,2845,0,0,60,60,0,1,0,1,0
9473,1017,0,0,66,66,0,1,0,1,0
11786,28,0,0,70,70,0,1,0,1,0
15279,10,625,9,318,94,224,2,30,1,1
22194,10,24049,9,181,94,87,2,30,1,1
1244,1167,0,0,66,66,0,1,0,1,0
15019,15,16736,11,17008,1379,15629,22,25,7,15
13826,10,12517,9,209,110,99,2,30,1,1
15533,15,13946,11,6363,3790,2573,16,30,10,6
6456,1147,0,0,66,66,0,1,0,1,0
5196,15,22587,11,2057,1263,794,10,15,6,4
8742,28,0,0,70,70,0,1,0,1,0
15514,10,24978,9,193,102,91,2,30,1,1
12495,26,24480,16,11041,3217,7824,26,24,15,11
17991,28,0,0,70,70,0,1,0,1,0
8843,1147,0,0,66,66,0,1,0,1,0
15340,26,8302,16,12038195,322404,11715791,12026,153,3435,8591
1545,10,5509,9,244,98,146,2,32,1,1
12465,28,0,0,66,66,0,1,0,1,0
8536,10,5059,9,168,86,82,2,31,1,1
360,3105,0,0,1188,1188,0,1,0,1,0
15385,10,8555,9,438,180,258,6,30,3,3
9458,10,21908,9,202,91,111,2,30,1,1
9099,28,0,0,70,70,0,1,0,1,0
14997,10,2319,9,183,94,89,2,29,1,1
21057,28,0,0,66,66,0,1,0,1,0
12978,1147,0,0,66,66,0,1,0,1,0
9814,28,0,0,66,66,0,1,0,1,0
15541,10,14683,9,762,97,665,2,30,1,1
12367,1103,21898,810,70,70,0,1,4,1,0
17295,15,9220,11,1266,383,883,16,393,4,12
8388,1798,22510,1371,1941,1009,932,10,16,6,4
15461,26,26261,16,10384,2236,8148,28,186,15,13
13724,10,6449,9,195,94,101,2,30,1,1
19285,15,19283,11,17407,1529,15878,30,255,16,14
2700,26,20291,16,7697,2940,4757,25,18,13,12
732,1590,0,0,62,62,0,1,0,1,0
1133,2938,0,0,78,78,0,1,0,1,0
19545,28,0,0,70,70,0,1,0,1,0
1146,1472,0,0,62,62,0,1,0,1,0
649,1771,0,0,66,66,0,1,0,1,0
15864,10,1898,9,177,94,83,2,30,1,1
15625,28,0,0,66,66,0,1,0,1,0
13391,28,0,0,70,70,0,1,0,1,0
8777,10,26683,9,170,87,83,2,31,1,1
13684,15,4103,11,2954,671,2283,12,15,7,5
5037,26,895,16,70,70,0,1,5,1,0
13581,28,0,0,70,70,0,1,0,1,0
11743,28,0,0,70,70,0,1,0,1,0
21413,28,0,0,70,70,0,1,0,1,0
4397,26,1134,16,27009,7414,19595,46,122,21,25
15797,10,158,9,180,94,86,2,30,1,1
8457,10,6425,9,760,97,663,2,31,1,1
3636,1472,0,0,62,62,0,1,0,1,0
13481,28,0,0,70,70,0,1,0,1,0
9084,26,19571,16,8888,2265,6623,18,15,9,9
22438,10,29011,9,231,90,141,2,30,1,1
13630,143,0,0,60,60,0,1,0,1,0
829,26,21990,16,7594,1457,6137,26,404,10,16
14266,10,27447,9,184,86,98,2,30,1,1
2744,1238,12189,918,873,126,747,2,30,1,1
6694,10,27828,9,168,78,90,2,30,1,1
13070,1936,0,0,66,66,0,1,0,1,0
1344,183,4551,121,3850,1745,2105,19,18,11,8
1909,2984,27857,2318,150,150,0,1,1200,1,0
7947,26,16301,16,2766,1907,859,17,24,10,7
21114,28,0,0,70,70,0,1,0,1,0
14939,26,24880,16,4674,1767,2907,19,29,11,8
15154,1147,0,0,66,66,0,1,0,1,0
19065,28,0,0,70,70,0,1,0,1,0
4100,1017,0,0,62,62,0,1,0,1,0
8843,3216,0,0,62,62,0,1,0,1,0
21368,28,0,0,70,70,0,1,0,1,0
21700,10,27802,9,192,98,94,2,31,1,1
8819,28,0,0,70,70,0,1,0,1,0
10938,26,24740,16,8481,1976,6505,23,25,13,10
14715,10,19177,9,177,94,83,2,30,1,1
21815,15,28709,11,405673,21057,384616,519,26,252,267
15029,10,13214,9,177,94,83,2,30,1,1
14667,10,4777,9,189,102,87,2,31,1,1
21130,15,22591,11,314,192,122,6,15,4,2
4345,26,960,16,4322,797,3525,14,64,8,6
20244,28,0,0,70,70,0,1,0,1,0
14410,28,0,0,70,70,0,1,0,1,0
10804,774,3565,561,70,70,0,1,5,1,0
8164,2727,21131,2118,124,60,64,3,5,2,1
8991,28,0,0,70,70,0,1,0,1,0
19436,1880,0,0,62,62,0,1,0,1,0
20929,28,0,0,70,70,0,1,0,1,0
10540,28,0,0,66,66,0,1,0,1,0
1330,804,0,0,62,62,0,1,0,1,0
7144,3216,0,0,62,62,0,1,0,1,0
15764,10,25919,9,183,94,89,2,30,1,1
6649,697,0,0,74,74,0,1,0,1,0
22671,10,27921,9,374,91,283,4,33,2,2
9214,3256,0,0,60,60,0,1,0,1,0
12820,1107,21919,812,70,70,0,2,7,2,0
612,21,0,0,60,60,0,1,0,1,0
20517,10,22931,9,448,166,282,2,30,1,1
532,247,0,0,3498,1872,1626,48,195,24,24
14668,10,536,9,752,93,659,2,30,1,1
3054,697,0,0,62,62,0,1,0,1,0
12487,28,0,0,70,70,0,1,0,1,0
18494,28,0,0,70,70,0,1,0,1,0
21768,26,26760,16,4658,1652,3006,10,121,5,5
17980,26,11421,16,6239,800,5439,18,32,8,10
19763,2934,0,0,159,159,0,1,0,1,0
1733,10,6383,9,227,88,139,2,30,1,1
5036,26,10385,16,40928,36006,4922,59,16,34,25
8556,104,0,0,60,60,0,1,0,1,0
10475,6,0,0,60,60,0,1,0,1,0
14553,10,1771,9,1415,94,1321,4,31,2,2
6804,18,28610,13,184,94,90,2,30,1,1
4933,26,21868,16,7173,1419,5754,32,383,11,21
15145,10,15259,9,199,102,97,2,30,1,1
2534,7,10641,7,66,66,0,1,5,1,0
18570,2870,6027,2229,70,70,0,2,8,2,0
5381,1054,0,0,66,66,0,1,0,1,0
0,0,0,0,320,320,0,5,0,5,0
14914,10,15549,9,193,102,91,2,31,1,1
15458,10,11381,9,177,94,83,2,30,1,1
21318,10,10363,9,200,102,98,2,29,1,1
15756,10,22223,9,182,93,89,2,30,1,1
11713,28,0,0,70,70,0,1,0,1,0
21608,28,0,0,66,66,0,1,0,1,0
7671,26,329,16,45264,4281,40983,59,120,24,35
16416,26,3397,16,2791,1800,991,26,185,15,11
532,247,0,0,3562,1936,1626,48,195,24,24
11072,10,22771,9,81,81,0,1,30,1,0
15254,10,1875,9,216,102,114,2,30,1,1
16951,255,0,0,62,62,0,1,0,1,0
21267,10,21894,9,559,193,366,6,67,3,3
14389,28,0,0,70,70,0,1,0,1,0
8856,10,27542,9,322,110,212,4,30,2,2
16951,255,25970,160,66,66,0,1,4,1,0
10119,1093,0,0,66,66,0,1,0,1,0
21990,2611,0,0,62,62,0,1,0,1,0
20202,28,0,0,66,66,0,1,0,1,0
19010,28,0,0,66,66,0,1,0,1,0
11675,28,0,0,70,70,0,1,0,1,0
14546,10,432,9,177,94,83,2,29,1,1
18589,1771,0,0,66,66,0,1,0,1,0
15212,26,7020,16,8865,1819,7046,24,30,14,10
13588,26,9479,16,2349,258,2091,10,120,4,6
22501,10,15498,9,811,94,717,2,29,1,1
14859,10,26329,9,167,86,81,2,31,1,1
11765,28,0,0,70,70,0,1,0,1,0
9756,28,0,0,66,66,0,1,0,1,0
11760,28,0,0,70,70,0,1,0,1,0
8651,15,22784,11,1155,781,374,10,15,6,4
21759,10,26035,9,228,102,126,2,30,1,1
10832,26,8038,16,4426,1518,2908,12,120,6,6
8361,26,22013,16,159850,5338,154512,179,200,64,115
12298,28,0,0,70,70,0,1,0,1,0
2660,1147,0,0,62,62,0,1,0,1,0
3980,26,9008,16,2388,1628,760,18,294,11,7
15404,10,23162,9,185,102,83,2,30,1,1
20510,10,19872,9,304,86,218,2,29,1,1
22298,10,22557,9,263,94,169,2,30,1,1
17355,1147,0,0,62,62,0,1,0,1,0
10234,15,10949,11,14873,8100,6773,36,32,19,17
9342,28,0,0,70,70,0,1,0,1,0
9047,10,7473,9,170,87,83,2,30,1,1
21239,10,23746,9,246,102,144,2,31,1,1
11173,1880,0,0,62,62,0,1,0,1,0
8460,15,23955,11,75982,15645,60337,88,158,31,57
20438,28,0,0,66,66,0,1,0,1,0
13741,28,0,0,70,70,0,1,0,1,0
8432,10,10727,9,211,102,109,2,30,1,1
15218,28,0,0,66,66,0,1,0,1,0
12639,26,11427,16,499,425,74,4,0,3,1
532,247,0,0,3354,1792,1562,46,192,23,23
9136,10,10485,9,328,110,218,4,57,2,2
8956,10,10434,9,190,97,93,2,30,1,1
10253,15,413,11,124,64,60,2,15,1,1
13710,28,0,0,70,70,0,1,0,1,0
21682,7,0,0,60,60,0,1,0,1,0
11281,15,22864,11,1838,1319,519,11,48,6,5
15144,10,4782,9,306,306,0,4,47,4,0
16951,255,0,0,62,62,0,1,0,1,0
6259,26,9872,16,6397,2103,4294,17,26,9,8
15972,10,6262,9,193,102,91,2,30,1,1
13690,26,14495,16,36364,9639,26725,62,53,31,31
8449,10,20016,9,172,88,84,2,31,1,1
9201,10,8176,9,261,110,151,2,30,1,1
4093,26,26378,16,5611,1559,4052,22,648,13,9
9673,15,3923,11,12874,6770,6104,26,28,13,13
10025,15,14103,11,149442,8423,141019,177,140,76,101
10798,28,0,0,66,66,0,1,0,1,0
8584,1191,2430,880,78,78,0,1,30,1,0
22449,10,8154,9,819,102,717,2,30,1,1
14992,2611,0,0,62,62,0,1,0,1,0
7063,1017,0,0,146,146,0,1,0,1,0
12746,797,0,0,62,62,0,1,0,1,0
1909,1155,22798,852,491,150,341,2,1200,1,1
16188,28,0,0,70,70,0,1,0,1,0
15612,10,22708,9,236,94,142,2,30,1,1
18536,10,15480,9,195,94,101,2,30,1,1
2555,3216,0,0,62,62,0,1,0,1,0
12585,859,7512,634,70,70,0,1,5,1,0
18416,15,22333,11,1679,1269,410,8,15,5,3
21568,10,17927,9,225,110,115,2,30,1,1
14946,10,2311,9,199,102,97,2,30,1,1
13757,10,23182,9,184,94,90,2,31,1,1
3848,1017,0,0,66,66,0,1,0,1,0
8036,232,3446,147,14939,1037,13902,35,579,11,24
16222,28,0,0,70,70,0,1,0,1,0
7518,2256,0,0,62,62,0,1,0,1,0
11919,15,23235,11,182677,4908,177769,213,25,73,140
1268,1224,0,0,60,60,0,1,0,1,0
3263,10,1545,9,86,86,0,1,30,1,0
15388,10,18066,9,753,96,657,2,31,1,1
16951,255,0,0,62,62,0,1,0,1,0
3590,1880,0,0,62,62,0,1,0,1,0
22234,10,4233,9,196,94,102,2,30,1,1
5916,26,17212,16,8119,1411,6708,20,200,11,9
8802,10,4950,9,180,94,86,2,30,1,1
3683,1827,0,0,146,146,0,1,0,1,0
2744,1272,28479,952,915,126,789,2,31,1,1
18249,1771,0,0,66,66,0,1,0,1,0
18514,799,11545,581,504,318,186,8,17,5,3
7335,1070,0,0,60,60,0,1,0,1,0
2391,847,0,0,62,62,0,1,0,1,0
21867,10,7301,9,249,94,155,2,30,1,1
1515,1888,0,0,62,62,0,1,0,1,0
17638,28,0,0,70,70,0,1,0,1,0
3466,242,0,0,143,143,0,1,0,1,0
12443,28,0,0,70,70,0,1,0,1,0
8847,15,15096,11,4584,3642,942,15,15,8,7
1330,918,0,0,62,62,0,1,0,1,0
20929,2256,0,0,66,66,0,1,0,1,0
1429,1017,0,0,146,146,0,1,0,1,0
7794,465,0,0,159,159,0,1,0,1,0
22271,10,21812,9,180,94,86,2,30,1,1
10556,26,23145,16,584947,21842,563105,678,36,286,392
9012,28,0,0,70,70,0,1,0,1,0
3060,1888,0,0,72,72,0,1,0,1,0
18611,28,0,0,70,70,0,1,0,1,0
9268,10,21516,9,172,88,84,2,31,1,1
7814,26,10418,16,13920,5009,8911,34,30,18,16
14060,10,22584,9,177,94,83,2,30,1,1
13633,10,4591,9,183,94,89,2,30,1,1
9002,28,0,0,66,66,0,1,0,1,0
14152,26,5318,16,272841,13586,259255,353,176,164,189
22035,295,28824,190,1300,676,624,14,15,7,7
10802,15,2124,11,93693,4469,89224,115,24,53,62
14183,1888,0,0,66,66,0,1,0,1,0
2004,10,7794,9,237,91,146,2,32,1,1
16591,28,0,0,70,70,0,1,0,1,0
14108,28,0,0,70,70,0,1,0,1,0
14317,1888,0,0,66,66,0,1,0,1,0
13372,28,0,0,70,70,0,1,0,1,0
18451,28,0,0,66,66,0,1,0,1,0
11587,1472,0,0,66,66,0,1,0,1,0
3974,26,27769,16,232,172,60,3,5,2,1
9532,10,5858,9,177,94,83,2,29,1,1
12550,26,24391,16,499,425,74,4,0,3,1
15844,28,0,0,70,70,0,1,0,1,0
6580,26,18783,16,46356,1595,44761,52,17,15,37
532,247,0,0,3354,1792,1562,46,195,23,23
22409,10,5488,9,330,118,212,2,30,1,1
17164,26,11354,16,312852,8845,304007,317,45,99,218
11118,1778,11495,1356,70,70,0,1,5,1,0
16091,1771,0,0,62,62,0,1,0,1,0
16565,26,9359,16,3179,954,2225,10,120,5,5
1886,3139,0,0,66,66,0,1,0,1,0
16400,10,0,0,294,86,208,2,30,1,1
7502,3216,0,0,62,62,0,1,0,1,0
12996,28,0,0,66,66,0,1,0,1,0
9728,977,16999,723,1356,300,1056,6,1200,3,3
10663,26,6735,16,8084,2509,5575,36,195,19,17
19093,2573,0,0,62,62,0,1,0,1,0
17199,28,0,0,70,70,0,1,0,1,0
16951,255,0,0,62,62,0,1,0,1,0
15335,2462,3723,1913,268,70,198,4,19,1,3
21666,10,23337,9,398,88,310,4,54,2,2
10276,26,17404,16,7569,2113,5456,26,361,14,12
14269,3119,13972,2421,70,70,0,2,8,2,0
10139,28,0,0,70,70,0,1,0,1,0
14115,10,17450,9,184,94,90,2,31,1,1
17469,509,0,0,62,62,0,1,0,1,0
14032,10,19803,9,767,102,665,2,31,1,1
22191,10,95,9,199,102,97,2,31,1,1
637,2637,9793,2046,238,118,120,2,1200,1,1
19594,28,0,0,66,66,0,1,0,1,0
15334,28,0,0,66,66,0,1,0,1,0
22277,28,0,0,66,66,0,1,0,1,0
3610,26,20659,16,7804,1583,6221,26,981,13,13
497,653,0,0,220,220,0,1,0,1,0
21781,28,0,0,66,66,0,1,0,1,0
9323,28,0,0,70,70,0,1,0,1,0
8427,10,11629,9,177,86,91,2,29,1,1
497,653,0,0,119,119,0,1,0,1,0
15511,10,24906,9,199,102,97,2,31,1,1
8581,10,23906,9,188,96,92,2,31,1,1
15959,10,14297,9,764,99,665,2,31,1,1
8782,15,8887,11,314,192,122,6,42,4,2
16112,26,14938,16,13999,3478,10521,33,134,15,18
22489,28,0,0,66,66,0,1,0,1,0
10652,26,24979,16,62241,4598,57643,82,170,35,47
11299,28,0,0,70,70,0,1,0,1,0
15847,10,23836,9,178,94,84,2,30,1,1
8523,10,13443,9,209,102,107,2,30,1,1
1669,26,6030,16,95958,6670,89288,139,80,68,71
20535,509,0,0,66,66,0,1,0,1,0
9186,10,898,9,179,94,85,2,30,1,1
18547,601,24434,412,70,70,0,1,5,1,0
22124,10,19732,9,209,110,99,2,30,1,1
574,2636,0,0,66,66,0,1,0,1,0
3481,1147,0,0,146,146,0,1,0,1,0
9047,10,18195,9,177,94,83,2,30,1,1
9079,1771,0,0,62,62,0,1,0,1,0
11722,1147,0,0,66,66,0,1,0,1,0
14823,28,0,0,70,70,0,1,0,1,0
4064,26,2549,16,5198,973,4225,16,17,10,6
8164,2729,0,0,60,60,0,1,0,1,0
14821,28,0,0,70,70,0,1,0,1,0
8545,10,11303,9,210,94,116,2,30,1,1
16021,2627,14246,2037,460,150,310,2,1199,1,1
1382,2587,0,0,62,62,0,1,0,1,0
14316,10,10810,9,184,94,90,2,31,1,1
16916,2938,0,0,62,62,0,1,0,1,0
9919,26,28586,16,3247,1630,1617,8,120,4,4
21571,10,4588,9,322,102,220,2,30,1,1
14817,10,20204,9,711,87,624,2,30,1,1
190,2938,0,0,78,78,0,1,0,1,0
18,3216,0,0,62,62,0,1,0,1,0
12090,1383,6736,1052,862,562,300,13,145,8,5
17740,1888,0,0,62,62,0,1,0,1,0
11450,1686,0,0,60,60,0,1,0,1,0
13118,28,0,0,66,66,0,1,0,1,0
5331,26,10670,16,1394,733,661,14,81,8,6
7642,15,4735,11,662,600,62,12,495,11,1
8570,10,17031,9,253,102,151,2,30,1,1
12756,1078,6976,791,70,70,0,1,5,1,0
3015,26,12435,16,29861,6027,23834,65,37,34,31
3274,26,19683,16,11455,5836,5619,40,317,20,20
12430,2236,16432,1732,678,432,246,10,15,6,4
16123,26,1162,16,2614,1689,925,18,23,10,8
10996,1147,0,0,62,62,0,1,0,1,0
21900,280,0,0,66,66,0,1,0,1,0
20306,28,0,0,70,70,0,1,0,1,0
117,2636,0,0,62,62,0,1,0,1,0
20561,26,19526,16,512,166,346,2,30,1,1
2676,2938,0,0,62,62,0,1,0,1,0
11909,26,1204,16,2651,1504,1147,24,68,13,11
16972,3216,0,0,66,66,0,1,0,1,0
9838,26,7704,16,3097,1708,1389,15,19,9,6
5148,26,26283,16,13181,5856,7325,23,135,11,12
9931,10,22171,9,231,90,141,2,30,1,1
9944,1,0,0,62,62,0,1,0,1,0
360,3105,0,0,822,822,0,1,0,1,0
771,15,3132,11,282487,10736,271751,315,52,124,191
15090,28,0,0,66,66,0,1,0,1,0
10920,1521,17701,1159,70,70,0,2,8,2,0
10103,509,0,0,66,66,0,1,0,1,0
2697,280,0,0,62,62,0,1,0,1,0
19301,28,0,0,70,70,0,1,0,1,0
17,869,0,0,129,129,0,1,0,1,0
19002,28,0,0,70,70,0,1,0,1,0
16093,3216,0,0,62,62,0,1,0,1,0
21815,26,20098,16,24686,1935,22751,36,18,17,19
9024,10,5510,9,550,129,421,4,57,2,2
3676,15,16457,11,656,398,258,11,39,7,4
532,247,0,0,3354,1792,1562,46,193,23,23
14255,10,14006,9,179,94,85,2,30,1,1
6995,10,0,0,82,82,0,1,30,1,0
2540,2256,0,0,62,62,0,1,0,1,0
18753,28,0,0,70,70,0,1,0,1,0
12590,1147,0,0,66,66,0,1,0,1,0
16951,255,0,0,62,62,0,1,0,1,0
21624,10,11344,9,554,96,458,4,60,2,2
17045,1472,0,0,66,66,0,1,0,1,0
20126,26,23664,16,1332,876,456,11,26,6,5
16478,106,0,0,60,60,0,1,0,1,0
19980,28,0,0,66,66,0,1,0,1,0
9136,10,8829,9,184,94,90,2,30,1,1
18336,26,17618,16,11048,3161,7887,26,24,15,11
18,2256,0,0,62,62,0,1,0,1,0
3,685,2,484,130,70,60,2,15,1,1
21052,28,0,0,70,70,0,1,0,1,0
20933,1017,0,0,62,62,0,1,0,1,0
3721,26,15953,16,17372,10352,7020,91,422,52,39
22392,1238,15828,918,257,78,179,2,30,1,1
14236,798,18904,580,320,140,180,6,7,3,3
10993,997,27825,734,70,70,0,2,8,2,0
9411,600,24037,411,2118,858,1260,28,1267,14,14
19312,15,7532,11,214,140,74,4,55,3,1
15639,10,1197,9,177,94,83,2,30,1,1
1219,524,22369,347,481,150,331,2,1200,1,1
2678,3216,0,0,62,62,0,1,0,1,0
9013,10,7699,9,173,94,79,2,30,1,1
377,509,0,0,62,62,0,1,0,1,0
2744,1267,5972,947,1684,126,1558,4,31,2,2
16513,10,28212,9,168,78,90,2,29,1,1
5025,26,15708,16,13608,3518,10090,48,217,24,24
5183,10,28666,9,168,78,90,2,30,1,1
9300,10,2619,9,184,94,90,2,30,1,1
8681,10,27334,9,195,102,93,2,31,1,1
22190,1267,22881,947,735,462,273,2,30,1,1
3543,2938,0,0,66,66,0,1,0,1,0
9369,28,0,0,70,70,0,1,0,1,0
12549,26,14166,16,7356,1014,6342,20,75,10,10
15038,10,21009,9,177,94,83,2,30,1,1
636,2627,14700,2037,207,118,89,2,1199,1,1
3133,2334,3787,1818,66,66,0,1,3600,1,0
10226,10,28523,9,168,78,90,2,30,1,1
2287,2636,0,0,66,66,0,1,0,1,0
10079,28,0,0,66,66,0,1,0,1,0
14397,28,0,0,70,70,0,1,0,1,0
18376,2883,0,0,62,62,0,1,0,1,0
15122,26,5371,16,19236,2292,16944,45,55,23,22
6711,183,18940,121,3910,1805,2105,20,18,12,8
21976,26,21375,16,507753,8795,498958,463,195,122,341
15994,10,7148,9,782,105,677,2,30,1,1
14249,10,20776,9,453,186,267,6,30,3,3
7099,1147,0,0,62,62,0,1,0,1,0
16478,343,0,0,60,60,0,1,0,1,0
12,2568,0,0,331,331,0,1,0,1,0
14625,10,10288,9,168,86,82,2,31,1,1
15734,3,0,0,60,60,0,1,0,1,0
14696,10,25200,9,216,110,106,2,31,1,1
13720,10,27879,9,180,94,86,2,30,1,1
3163,1824,0,0,100,100,0,1,0,1,0
21306,10,14879,9,180,94,86,2,30,1,1
8584,1241,5418,921,259,78,181,2,30,1,1
18743,28,0,0,66,66,0,1,0,1,0
20895,15,28252,11,1232,481,751,10,15,5,5
8646,26,25780,16,1160,638,522,13,113,7,6
11134,2654,22243,2061,66,66,0,1,5,1,0
10879,976,22293,722,316,136,180,6,7,3,3
14240,1805,28783,1375,320,140,180,6,5,3,3
15534,28,0,0,70,70,0,1,0,1,0
71,3216,0,0,62,62,0,1,0,1,0
16568,1215,0,0,62,62,0,1,0,1,0
21379,1017,0,0,66,66,0,1,0,1,0
10947,1186,3508,875,70,70,0,2,8,2,0
17001,26,13005,16,8124,1079,7045,16,26,8,8
15837,28,0,0,66,66,0,1,0,1,0
11002,15,13015,11,426,240,186,8,26,5,3
21537,10,12373,9,177,94,83,2,29,1,1
21501,10,8901,9,256,110,146,2,30,1,1
14115,10,1308,9,789,110,679,2,30,1,1
9056,26,28966,16,1820,1101,719,18,73,10,8
1754,183,0,0,60,60,0,1,0,1,0
22344,10,7714,9,216,110,106,2,29,1,1
9033,10,23586,9,202,103,99,2,31,1,1
15855,26,8284,16,8313,2850,5463,42,15,24,18
7340,15,27069,11,1114,534,580,12,16,7,5
14531,2205,0,0,62,62,0,1,0,1,0
7509,218,0,0,60,60,0,1,0,1,0
10762,28,0,0,70,70,0,1,0,1,0
17272,2205,0,0,66,66,0,1,0,1,0
10045,26,11659,16,5057,851,4206,15,16,9,6
8722,10,17443,9,300,100,200,4,44,2,2
9733,10,5826,9,786,110,676,2,30,1,1
714,26,2830,16,4265,1184,3081,18,16,9,9
15348,1358,18765,1030,70,70,0,1,5,1,0
2744,1256,4722,936,891,126,765,2,31,1,1
13001,28,0,0,66,66,0,1,0,1,0
12538,355,22281,228,70,70,0,2,8,2,0
12547,26,15214,16,350,210,140,6,25,4,2
16209,28,0,0,66,66,0,1,0,1,0
13006,10,1152,9,578,286,292,9,16,5,4
10156,28,0,0,70,70,0,1,0,1,0
6232,509,0,0,66,66,0,1,0,1,0
21243,10,24834,9,262,86,176,4,46,2,2
15633,10,6613,9,186,95,91,2,31,1,1
12176,26,28113,16,4448,1654,2794,13,121,6,7
20621,28,0,0,70,70,0,1,0,1,0
10475,6,0,0,60,60,0,1,0,1,0
12824,2761,8716,2140,70,70,0,2,7,2,0
15145,28,0,0,70,70,0,1,0,1,0
7860,10,20690,9,212,98,114,2,30,1,1
18117,3216,0,0,62,62,0,1,0,1,0
21657,26,8900,16,23357,2589,20768,33,120,13,20
8758,15,14230,11,4173,2324,1849,14,42,8,6
3796,7,0,0,60,60,0,1,0,1,0
22429,10,21890,9,195,102,93,2,30,1,1
9255,28,0,0,70,70,0,1,0,1,0
9885,28,0,0,70,70,0,1,0,1,0
14965,28,0,0,66,66,0,1,0,1,0
15695,10,16839,9,216,110,106,2,30,1,1
11237,15,12538,11,372,246,126,6,27,4,2
11196,15,1298,11,2110,1066,1044,12,15,7,5
18120,28,0,0,70,70,0,1,0,1,0
18938,28,0,0,70,70,0,1,0,1,0
13175,26,26367,16,1786,172,1614,7,120,3,4
12740,2296,9928,1780,492,306,186,8,15,5,3
13735,28,0,0,70,70,0,1,0,1,0
20379,2587,0,0,66,66,0,1,0,1,0
388,797,0,0,62,62,0,1,0,1,0
9539,28,0,0,66,66,0,1,0,1,0
14642,28,0,0,70,70,0,1,0,1,0
13180,28,0,0,70,70,0,1,0,1,0
12986,28,0,0,70,70,0,1,0,1,0
22512,28,0,0,66,66,0,1,0,1,0
16951,255,0,0,62,62,0,1,0,1,0
15666,28,0,0,70,70,0,1,0,1,0
13813,28,0,0,70,70,0,1,0,1,0
7697,1147,0,0,62,62,0,1,0,1,0
10848,1888,0,0,66,66,0,1,0,1,0
11708,28,0,0,66,66,0,1,0,1,0
496,2481,0,0,66,66,0,1,0,1,0
16244,676,434,475,130,70,60,2,5,1,1
20174,1797,0,0,66,66,0,1,0,1,0
5767,2938,0,0,62,62,0,1,0,1,0
15682,15,2969,11,2404,568,1836,10,75,6,4
8646,10,20607,9,184,94,90,2,30,1,1
16017,10,0,0,86,86,0,1,30,1,0
6677,1888,0,0,62,62,0,1,0,1,0
8344,10,23453,9,735,88,647,2,30,1,1
7339,170,0,0,60,60,0,1,0,1,0
16126,15,25457,11,3118,689,2429,13,144,6,7
2151,3216,0,0,66,66,0,1,0,1,0
15286,26,9312,16,1207531,28695,1178836,1184,45,400,784
19198,2883,0,0,62,62,0,1,0,1,0
20693,28,0,0,66,66,0,1,0,1,0
12588,2627,16584,2037,70,70,0,2,7,2,0
11615,15,392,11,1272,633,639,9,150,5,4
7335,1072,0,0,60,60,0,1,0,1,0
18388,28,0,0,66,66,0,1,0,1,0
20343,28,0,0,66,66,0,1,0,1,0
22193,2587,0,0,146,146,0,1,0,1,0
7273,2440,0,0,62,62,0,1,0,1,0
14937,26,12420,16,3734,1750,1984,24,203,12,12
8351,26,3847,16,493152,13222,479930,509,19,184,325
13950,10,6926,9,180,94,86,2,30,1,1
10316,26,28592,16,84768,21103,63665,136,133,58,78
1926,1215,0,0,66,66,0,1,0,1,0
22529,10,5702,9,782,105,677,2,31,1,1
17936,2883,0,0,62,62,0,1,0,1,0
1718,3051,0,0,62,62,0,1,0,1,0
8210,1602,21194,1226,152,152,0,1,1200,1,0
22433,10,26045,9,193,102,91,2,31,1,1
9728,2062,6164,1588,166,166,0,1,1199,1,0
13222,28,0,0,70,70,0,1,0,1,0
21443,28,0,0,70,70,0,1,0,1,0
11281,28,0,0,70,70,0,1,0,1,0
2744,1568,842,1199,881,126,755,2,31,1,1
20341,28,0,0,70,70,0,1,0,1,0
12709,2883,0,0,62,62,0,1,0,1,0
19311,26,14712,16,6437,1994,4443,22,87,12,10
21240,10,13283,9,178,94,84,2,30,1,1
9053,15,22343,11,1376,946,430,8,87,5,3
8489,28,0,0,70,70,0,1,0,1,0
4450,12,0,0,60,60,0,1,0,1,0
16951,255,0,0,62,62,0,1,0,1,0
6317,10,18409,9,235,90,145,2,32,1,1
16951,255,25970,160,66,66,0,1,4,1,0
22103,2608,0,0,66,66,0,1,0,1,0
1011,26,17347,16,3649,424,3225,12,15,6,6
22012,10,21475,9,182,93,89,2,31,1,1
14184,28,0,0,70,70,0,1,0,1,0
11077,15,24404,11,27784,13980,13804,44,35,22,22
12061,28,0,0,66,66,0,1,0,1,0
15368,2883,0,0,66,66,0,1,0,1,0
3102,2382,0,0,66,66,0,1,0,1,0
4835,1939,15883,1480,1056,1056,0,17,1550,17,0
13263,15,27013,11,254,128,126,5,15,3,2
15575,28,0,0,66,66,0,1,0,1,0
14289,10,18194,9,213,102,111,2,30,1,1
21300,10,12486,9,179,94,85,2,30,1,1
2744,1241,18298,921,881,126,755,2,30,1,1
10669,26,16594,16,3174,346,2828,12,121,5,7
11823,1888,0,0,66,66,0,1,0,1,0
2842,2883,0,0,62,62,0,1,0,1,0
14492,2767,17007,2146,490,149,341,2,1200,1,1
9126,10,20981,9,184,94,90,2,30,1,1
5558,15,17257,11,424,198,226,7,142,4,3
9143,10,21496,9,197,94,103,2,30,1,1
13208,1215,0,0,66,66,0,1,0,1,0
0,0,0,0,124,64,60,2,0,1,1
14461,10,19311,9,265,86,179,4,58,2,2
14487,10,2508,9,196,102,94,2,30,1,1
19759,28,0,0,70,70,0,1,0,1,0
13387,26,1842,16,18311,11567,6744,43,363,21,22
2833,1888,0,0,62,62,0,1,0,1,0
10769,3134,13727,2432,70,70,0,1,5,1,0
14357,10,1102,9,199,102,97,2,30,1,1
6005,15,17978,11,120443,1965,118478,108,20,21,87
21764,10,24742,9,183,102,81,2,29,1,1
10494,15,22476,11,12796,1635,11161,21,15,8,13
9331,28,0,0,70,70,0,1,0,1,0
21448,10,7923,9,212,102,110,2,30,1,1
5071,2611,0,0,66,66,0,1,0,1,0
8885,26,3855,16,40332,2476,37856,57,130,26,31
9082,15,8246,11,751,455,296,8,125,5,3
3125,10,13107,9,227,89,138,2,30,1,1
21262,1147,0,0,66,66,0,1,0,1,0
10675,28,0,0,66,66,0,1,0,1,0
615,229,0,0,410,410,0,1,0,1,0
19652,28,0,0,70,70,0,1,0,1,0
6790,26,23068,16,8998,1684,7314,24,170,12,12
15888,10,26417,9,172,88,84,2,30,1,1
14237,10,19642,9,172,88,84,2,30,1,1
13740,28,0,0,66,66,0,1,0,1,0
15977,28,0,0,70,70,0,1,0,1,0
17991,812,0,0,66,66,0,1,0,1,0
0,0,0,0,244,244,0,2,0,2,0
949,2938,0,0,66,66,0,1,0,1,0
18000,28,0,0,70,70,0,1,0,1,0
10733,1666,14801,1275,70,70,0,1,5,1,0
9469,15,9998,11,1083,653,430,8,15,5,3
9041,26,14067,16,37364,16799,20565,189,53,87,102
9838,15,22779,11,3481,1576,1905,17,187,10,7
11999,2096,16493,1616,320,140,180,6,8,3,3
3193,2852,0,0,62,62,0,1,0,1,0
11460,26,28774,16,8398,1552,6846,27,50,14,13
16346,26,17503,16,1373,734,639,17,125,10,7
21844,10,5682,9,386,134,252,2,30,1,1
13982,10,26224,9,212,110,102,2,30,1,1
10880,15,23591,11,2188,1421,767,11,61,7,4
3201,2938,0,0,60,60,0,1,0,1,0
21563,10,5124,9,463,90,373,4,34,2,2
14574,10,21647,9,184,94,90,2,30,1,1
14082,28,0,0,66,66,0,1,0,1,0
16951,255,0,0,62,62,0,1,0,1,0
13639,10,19907,9,177,94,83,2,30,1,1
3058,3262,0,0,60,60,0,1,0,1,0
22249,10,4323,9,180,94,86,2,31,1,1
4128,15,15336,11,158890,11318,147572,182,30,74,108
9439,10,10640,9,740,93,647,2,31,1,1
19889,28,0,0,70,70,0,1,0,1,0
13698,28,0,0,70,70,0,1,0,1,0
8755,28,0,0,66,66,0,1,0,1,0
10828,28,0,0,70,70,0,1,0,1,0
8883,2938,0,0,62,62,0,1,0,1,0
15327,2256,0,0,66,66,0,1,0,1,0
9062,26,23242,16,44110,4769,39341,90,108,46,44
19130,2787,0,0,62,62,0,1,0,1,0
20332,28,0,0,70,70,0,1,0,1,0
685,2587,0,0,146,146,0,1,0,1,0
8598,10,27531,9,312,94,218,2,30,1,1
12247,26,26552,16,4317,1134,3183,16,26,9,7
3457,3216,0,0,62,62,0,1,0,1,0
8975,10,5567,9,244,94,150,2,30,1,1
12405,26,14732,16,10823,1626,9197,27,28,15,12
8660,26,3579,16,4168,1018,3150,16,27,8,8
2724,1240,16506,920,422,164,258,6,30,3,3
6099,2573,0,0,146,146,0,1,0,1,0
8693,10,12798,9,165,86,79,2,30,1,1
719,1482,0,0,62,62,0,1,0,1,0
21692,28,0,0,70,70,0,1,0,1,0
15256,26,28599,16,19154,11130,8024,40,102,24,16
16583,28,0,0,70,70,0,1,0,1,0
11392,28,0,0,70,70,0,1,0,1,0
8421,10,14550,9,214,102,112,2,30,1,1
4307,15,6568,11,5046,4132,914,31,15,16,15
8893,26,16230,16,5037,1135,3902,16,18,9,7
17003,28,0,0,66,66,0,1,0,1,0
21928,10,4536,9,760,97,663,2,31,1,1
12180,28,0,0,70,70,0,1,0,1,0
22257,10,10220,9,396,84,312,4,54,2,2
10793,1698,22024,1297,70,70,0,1,5,1,0
12678,1827,0,0,62,62,0,1,0,1,0
18762,28,0,0,66,66,0,1,0,1,0
22051,10,26284,9,216,110,106,2,30,1,1
1727,1147,0,0,146,146,0,1,0,1,0
21572,10,20061,9,184,94,90,2,31,1,1
22526,10,6530,9,197,94,103,2,29,1,1
2736,1482,0,0,62,62,0,1,0,1,0
2484,1147,0,0,62,62,0,1,0,1,0
7335,1070,0,0,60,60,0,1,0,1,0
13224,28,0,0,70,70,0,1,0,1,0
3133,2304,18282,1788,330,330,0,6,3610,6,0
3194,1688,0,0,66,66,0,1,0,1,0
15056,10,28575,9,200,102,98,2,30,1,1
12724,28,0,0,70,70,0,1,0,1,0
21297,10,20376,9,302,118,184,2,29,1,1
16981,1392,897,1059,1806,1806,0,22,225,22,0
16407,28,0,0,66,66,0,1,0,1,0
18706,28,0,0,66,66,0,1,0,1,0
13761,10,25555,9,770,102,668,2,30,1,1
17504,28,0,0,66,66,0,1,0,1,0
10249,28,0,0,66,66,0,1,0,1,0
22223,1589,0,0,66,66,0,1,0,1,0
1181,26,21285,16,7915,1634,6281,25,315,11,14
6557,26,15306,16,6645,1668,4977,21,31,12,9
7522,797,0,0,145,145,0,1,0,1,0
9033,10,12571,9,209,110,99,2,30,1,1
22083,3269,0,0,148,148,0,1,0,1,0
2988,7,0,0,60,60,0,1,0,1,0
10613,28,0,0,66,66,0,1,0,1,0
647,2695,0,0,100,100,0,1,0,1,0
14860,10,25784,9,197,102,95,2,30,1,1
11881,1539,0,0,62,62,0,1,0,1,0
9469,28,0,0,70,70,0,1,0,1,0
8524,10,963,9,211,102,109,2,30,1,1
20438,28,0,0,70,70,0,1,0,1,0
10870,15,22684,11,525257,17273,507984,531,26,183,348
18655,10,1881,9,275,86,189,2,30,1,1
15782,10,8400,9,532,198,334,6,50,3,3
18106,26,3272,16,7040,1933,5107,32,110,19,13
21991,10,13093,9,78,78,0,1,30,1,0
14288,10,13258,9,177,94,83,2,30,1,1
5083,26,26521,16,2634,1411,1223,18,28,10,8
17542,2938,0,0,74,74,0,1,0,1,0
8429,15,21404,11,515211,10976,504235,506,49,169,337
11390,28,0,0,70,70,0,1,0,1,0
888,15,3628,11,318,192,126,6,29,4,2
15883,10,6870,9,180,94,86,2,35,1,1
0,0,0,0,98,98,0,1,0,1,0
10950,1472,0,0,66,66,0,1,0,1,0
8730,10,5364,9,193,102,91,2,29,1,1
9324,28,0,0,66,66,0,1,0,1,0
11215,599,14032,410,70,70,0,2,7,2,0
15936,28,0,0,70,70,0,1,0,1,0
15518,10,27630,9,180,94,86,2,30,1,1
9125,26,28901,16,16890,7125,9765,33,98,19,14
19984,28,0,0,66,66,0,1,0,1,0
741,2486,0,0,133,133,0,1,0,1,0
9703,15,27733,11,318,192,126,6,26,4,2
8432,10,12166,9,181,94,87,2,29,1,1
10029,15,1684,11,13981183,155668,13825515,11482,136,2194,9288
14370,10,25649,9,165,86,79,2,30,1,1
392,1147,0,0,146,146,0,1,0,1,0
16951,255,0,0,62,62,0,1,0,1,0
18464,1463,17434,1114,70,70,0,1,5,1,0
9035,28,0,0,66,66,0,1,0,1,0
21453,10,13710,9,403,110,293,2,31,1,1
5829,465,0,0,148,148,0,1,0,1,0
21400,10,7641,9,199,102,97,2,30,1,1
16951,255,0,0,62,62,0,1,0,1,0
20250,28,0,0,70,70,0,1,0,1,0
10404,26,20528,16,2019,1219,800,15,17,8,7
12810,3018,7869,2346,70,70,0,1,4,1,0
7321,26,14056,16,1160457,45088,1115369,1320,315,518,802
21262,1147,0,0,66,66,0,1,0,1,0
7962,26,20290,16,8903,3095,5808,31,121,16,15
22324,28,0,0,70,70,0,1,0,1,0
12048,28,0,0,66,66,0,1,0,1,0
11226,28,0,0,70,70,0,1,0,1,0
8562,10,14028,9,177,94,83,2,29,1,1
21391,10,26328,9,87,87,0,1,31,1,0
2662,2938,0,0,66,66,0,1,0,1,0
21416,28,0,0,66,66,0,1,0,1,0
20337,28,0,0,66,66,0,1,0,1,0
18025,28,0,0,70,70,0,1,0,1,0
853,26,18569,16,19816,13030,6786,80,159,40,40
21018,2800,21990,2173,70,70,0,1,4,1,0
8538,28,0,0,70,70,0,1,0,1,0
13892,1539,0,0,62,62,0,1,0,1,0
532,247,0,0,3354,1792,1562,46,193,23,23
3674,15,4893,11,1056,682,374,10,15,6,4
2145,3216,0,0,62,62,0,1,0,1,0
12416,26,21581,16,5935,342,5593,12,120,5,7
17336,28,0,0,66,66,0,1,0,1,0
19195,28,0,0,70,70,0,1,0,1,0
8210,2629,21194,2039,485,158,327,2,1200,1,1
12404,3010,2881,2340,70,70,0,2,7,2,0
9993,28,0,0,70,70,0,1,0,1,0
15796,10,28249,9,186,95,91,2,31,1,1
12673,10,20245,9,211,78,133,2,30,1,1
14069,26,26307,16,256189,15094,241095,316,122,120,196
7339,152,0,0,60,60,0,1,0,1,0
18710,10,3736,9,199,94,105,2,30,1,1
8319,10,21378,9,211,110,101,2,31,1,1
22045,10,21119,9,210,102,108,2,30,1,1
13346,1880,0,0,62,62,0,1,0,1,0
12599,2154,0,0,74,74,0,1,0,1,0
12855,26,5248,16,7653,1188,6465,21,16,12,9
15819,10,19088,9,176,90,86,2,30,1,1
5713,26,15684,16,2965,1650,1315,24,275,12,12
9158,1215,0,0,66,66,0,1,0,1,0
19271,28,0,0,70,70,0,1,0,1,0
17975,28,0,0,66,66,0,1,0,1,0
15034,10,23855,9,183,94,89,2,31,1,1
10533,28,0,0,70,70,0,1,0,1,0
14361,2636,0,0,66,66,0,1,0,1,0
3150,1472,0,0,66,66,0,1,0,1,0
6935,3216,0,0,66,66,0,1,0,1,0
21108,26,26257,16,25707,7559,18148,53,121,24,29
19241,28,0,0,66,66,0,1,0,1,0
3313,2205,0,0,146,146,0,1,0,1,0
10461,26,11950,16,642,582,60,2,5,1,1
12551,26,10366,16,499,425,74,4,0,3,1
15179,183,24991,121,3424,1710,1714,16,31,8,8
10462,26,13613,16,6537,3702,2835,34,170,17,17
12812,26,12119,16,3330,1694,1636,15,30,8,7
8716,15,11199,11,3531,1965,1566,14,29,8,6
16951,255,0,0,62,62,0,1,0,1,0
16951,255,0,0,62,62,0,1,0,1,0
14234,1002,9016,737,320,140,180,6,5,3,3
2560,2486,0,0,140,140,0,1,0,1,0
5616,26,13141,16,10401,3375,7026,33,22,17,16
21224,10,10195,9,509,176,333,6,56,3,3
14352,28,0,0,70,70,0,1,0,1,0
21446,2256,0,0,66,66,0,1,0,1,0
8536,10,15887,9,183,94,89,2,30,1,1
8381,26,28002,16,7177,2666,4511,20,15,11,9
14932,28,0,0,70,70,0,1,0,1,0
16694,26,25830,16,7356,1014,6342,20,76,10,10
2429,2883,0,0,66,66,0,1,0,1,0
7139,26,686,16,6864,1633,5231,20,315,10,10
17810,26,10642,16,13551,5488,8063,33,95,16,17
14701,28,0,0,70,70,0,1,0,1,0
165,2205,0,0,66,66,0,1,0,1,0
2283,3216,0,0,66,66,0,1,0,1,0
2744,90,15019,70,858,126,732,2,29,1,1
17163,26,13106,16,4546411,95150,4451261,4312,109,1197,3115
13851,10,24882,9,167,86,81,2,30,1,1
17085,26,703,16,37165,2164,35001,58,29,28,30
14976,10,11282,9,177,94,83,2,29,1,1
5578,10,14915,9,168,78,90,2,30,1,1
22214,2938,0,0,78,78,0,1,0,1,0
10096,28,0,0,70,70,0,1,0,1,0
11606,10,21073,9,302,210,92,3,30,2,1
1407,1888,0,0,66,66,0,1,0,1,0
1071,26,4811,16,5693,499,5194,14,15,7,7
5868,10,10087,9,168,78,90,2,30,1,1
12602,10,23046,9,168,78,90,2,30,1,1
12752,26,15275,16,1346,918,428,10,33,6,4
18486,1771,0,0,146,146,0,1,0,1,0
4227,26,20359,16,130,70,60,2,15,1,1
1337,2012,17026,1542,213,89,124,4,49,2,2
14292,10,9867,9,177,94,83,2,30,1,1
15548,10,16751,9,197,102,95,2,29,1,1
4136,26,26532,16,6777,1527,5250,24,201,13,11
9961,2587,0,0,62,62,0,1,0,1,0
22619,15,26176,11,366,180,186,7,29,4,3
15604,10,3863,9,170,87,83,2,31,1,1
18209,26,5652,16,6485,1957,4528,22,16,11,11
931,26,4708,16,5955,728,5227,17,15,8,9
280,10,762,9,244,98,146,2,32,1,1
8888,10,23667,9,873,280,593,8,80,4,4
10786,2084,25895,1606,70,70,0,1,5,1,0
9540,28,0,0,70,70,0,1,0,1,0
17906,28,0,0,70,70,0,1,0,1,0
1354,2611,0,0,66,66,0,1,0,1,0
12,443,0,0,669,669,0,1,0,1,0
19906,1888,0,0,66,66,0,1,0,1,0
13552,2636,0,0,66,66,0,1,0,1,0
14132,10,21272,9,168,86,82,2,30,1,1
21409,28,0,0,70,70,0,1,0,1,0
8329,10,26610,9,182,93,89,2,31,1,1
735,1147,0,0,62,62,0,1,0,1,0
9438,3139,0,0,62,62,0,1,0,1,0
10703,26,16421,16,1143,703,440,13,38,8,5
19846,28,0,0,70,70,0,1,0,1,0
16457,3,25677,3,66,66,0,1,30,1,0
15242,10,10622,9,250,86,164,4,29,2,2
19104,28,0,0,66,66,0,1,0,1,0
8609,26,7233,16,70988,47020,23968,152,652,79,73
16951,255,0,0,62,62,0,1,0,1,0
12356,2991,16071,2325,492,306,186,8,16,5,3
295,1771,0,0,66,66,0,1,0,1,0
10269,26,23704,16,5378,1423,3955,19,22,11,8
60,1888,0,0,62,62,0,1,0,1,0
426,1147,0,0,62,62,0,1,0,1,0
13644,10,3181,9,168,86,82,2,31,1,1
14587,10,10204,9,168,86,82,2,30,1,1
1158,460,0,0,62,62,0,1,0,1,0
12944,28,0,0,70,70,0,1,0,1,0
5565,15,12288,11,1298,370,928,12,15,6,6
5350,26,15630,16,46113,6913,39200,86,34,41,45
17163,26,9684,16,3873,2469,1404,17,16,9,8
8883,36,0,0,60,60,0,1,0,1,0
20363,28,0,0,70,70,0,1,0,1,0
22076,10,13954,9,206,105,101,2,30,1,1
13193,983,0,0,66,66,0,1,0,1,0
3555,10,0,0,82,82,0,1,30,1,0
2084,1471,0,0,145,145,0,1,0,1,0
22636,15,27026,11,1279,714,565,11,19,6,5
14795,2636,0,0,66,66,0,1,0,1,0
2960,2587,0,0,66,66,0,1,0,1,0
20248,28,0,0,66,66,0,1,0,1,0
10911,26,9915,16,4418,1116,3302,17,30,10,7
7164,26,4270,16,918,358,560,14,40,6,8
17484,28,0,0,70,70,0,1,0,1,0
22200,10,3592,9,183,102,81,2,30,1,1
14254,10,1226,9,319,126,193,2,29,1,1
11060,2160,12709,1668,66,66,0,1,5,1,0
21905,10,18936,9,289,102,187,2,30,1,1
2981,1880,0,0,146,146,0,1,0,1,0
5635,26,1804,16,7586,3785,3801,20,30,11,9
21105,2041,17749,1568,504,382,122,8,15,6,2
15490,10,3312,9,424,104,320,4,30,2,2
16462,15,15858,11,14927,10571,4356,39,75,20,19
20448,28,0,0,66,66,0,1,0,1,0
9352,15,16487,11,5015,2123,2892,25,96,14,11
15944,28,0,0,70,70,0,1,0,1,0
15506,15,20628,11,486,280,206,8,26,5,3
16288,28,0,0,70,70,0,1,0,1,0
16951,255,0,0,62,62,0,1,0,1,0
9024,10,19947,9,212,102,110,2,30,1,1
14340,10,28799,9,164,86,78,2,30,1,1
13663,10,22420,9,241,78,163,2,30,1,1
13697,2938,0,0,78,78,0,1,0,1,0
22645,10,15169,9,218,86,132,2,31,1,1
12628,10,11791,9,213,78,135,2,30,1,1
21932,10,2510,9,179,94,85,2,30,1,1
1203,26,18361,16,7243,1860,5383,26,330,14,12
2023,2953,0,0,62,62,0,1,0,1,0
7300,26,5891,16,21950,3632,18318,46,140,20,26
11540,15,23033,11,93783,3885,89898,105,167,37,68
18889,28,0,0,70,70,0,1,0,1,0
7613,26,343,16,7298,2661,4637,21,18,11,10
2724,1240,26709,920,422,164,258,6,30,3,3
9588,26,5648,16,5593,996,4597,22,127,11,11
1843,38,0,0,60,60,0,1,0,1,0
14869,183,24848,121,3425,1470,1955,16,16,8,8
547,1017,0,0,66,66,0,1,0,1,0
15595,28,0,0,70,70,0,1,0,1,0
8584,1623,6591,1245,237,78,159,2,30,1,1
11756,1771,0,0,66,66,0,1,0,1,0
14522,28,0,0,70,70,0,1,0,1,0
16572,28,0,0,70,70,0,1,0,1,0
21683,10,15102,9,199,102,97,2,31,1,1
13710,10,3344,9,170,87,83,2,30,1,1
7834,7,0,0,60,60,0,1,0,1,0
3458,1238,0,0,67,67,0,1,0,1,0
12959,295,23784,190,3018,1627,1391,16,15,9,7
21534,10,20742,9,192,90,102,2,31,1,1
2536,1167,0,0,62,62,0,1,0,1,0
9812,3000,0,0,62,62,0,1,0,1,0
17188,28,0,0,70,70,0,1,0,1,0
15896,10,18756,9,184,80,104,2,30,1,1
11059,28,0,0,66,66,0,1,0,1,0
11972,26,4434,16,8233,5537,2696,40,84,21,19
11070,149,20973,106,70,70,0,1,5,1,0
2269,899,0,0,66,66,0,1,0,1,0
12609,405,26756,263,70,70,0,1,5,1,0
3081,2354,0,0,60,60,0,1,0,1,0
20768,28,0,0,66,66,0,1,0,1,0
8531,26,11097,16,8376,2198,6178,25,81,14,11
2548,1347,0,0,60,60,0,1,0,1,0
13836,28,0,0,70,70,0,1,0,1,0
14149,26,24450,16,274414,45529,228885,359,170,186,173
21126,28,0,0,70,70,0,1,0,1,0
1628,3216,0,0,62,62,0,1,0,1,0
10785,28,0,0,66,66,0,1,0,1,0
16225,10,25531,9,233,90,143,2,32,1,1
18752,26,131,16,193520,11019,182501,280,276,140,140
9688,10,2565,9,193,102,91,2,30,1,1
10466,15,9833,11,1510,481,1029,11,20,6,5
13533,26,10436,16,6677,1006,5671,19,26,11,8
8211,26,4829,16,4167,1669,2498,23,15,12,11
1221,15,4031,11,6714,929,5785,17,33,8,9
12563,26,22670,16,70,70,0,1,5,1,0
9614,3105,0,0,86,86,0,1,0,1,0
8308,26,21242,16,9551,2173,7378,33,27,17,16
22147,10,18303,9,313,94,219,2,29,1,1
2051,2587,0,0,62,62,0,1,0,1,0
16021,2281,14444,1766,792,792,0,13,1201,13,0
21846,10,13765,9,756,95,661,2,30,1,1
2747,3111,0,0,753,753,0,1,0,1,0
22025,10,7701,9,403,142,261,2,31,1,1
15897,26,13227,16,1169,616,553,12,16,7,5
14166,15,2470,11,18450,1862,16588,29,17,15,14
7874,183,20700,121,4575,2400,2175,20,19,11,9
4640,739,28342,530,556,256,300,10,30,5,5
15369,2382,0,0,66,66,0,1,0,1,0
12969,3216,0,0,66,66,0,1,0,1,0
21194,28,0,0,70,70,0,1,0,1,0
13811,28,0,0,70,70,0,1,0,1,0
11125,26,2098,16,3023,2045,978,15,15,9,6
15628,10,12302,9,167,86,81,2,30,1,1
11214,2932,7180,2275,66,66,0,1,5,1,0
8472,2938,0,0,66,66,0,1,0,1,0
4807,1017,0,0,66,66,0,1,0,1,0
14566,10,15397,9,178,94,84,2,29,1,1
8171,1073,0,0,60,60,0,1,0,1,0
8857,26,14314,16,1183,659,524,13,56,7,6
21817,10,15731,9,167,86,81,2,31,1,1
15562,15,12016,11,526,304,222,8,35,5,3
19947,28,0,0,66,66,0,1,0,1,0
823,160,0,0,60,60,0,1,0,1,0
20318,28,0,0,66,66,0,1,0,1,0
7244,26,4129,16,1473,988,485,12,25,7,5
8704,10,25028,9,258,102,156,2,30,1,1
9383,26,6359,16,5858,791,5067,19,22,10,9
18602,10,20196,9,260,86,174,2,30,1,1
4712,26,10017,16,9406,2044,7362,27,21,16,11
1385,10,4749,9,216,98,118,2,30,1,1
8373,547,20539,364,70,70,0,1,5,1,0
17144,2636,0,0,66,66,0,1,0,1,0
18405,15,10321,11,2005,1094,911,11,87,6,5
15988,11,2544,10,70,70,0,2,8,2,0
21260,224,11836,145,66,66,0,2,8,2,0
97,10,4692,9,256,94,162,2,30,1,1
3353,10,19277,9,86,86,0,1,29,1,0
2068,31,0,0,60,60,0,1,0,1,0
15341,2092,7829,1613,1639,460,1179,8,30,4,4
19133,983,0,0,62,62,0,1,0,1,0
8367,28,0,0,66,66,0,1,0,1,0
2897,376,0,0,148,148,0,1,0,1,0
11752,26,26300,16,12577,3687,8890,63,415,30,33
10067,15,1060,11,8167195,108448,8058747,7107,121,1531,5576
17187,15,7197,11,1493,765,728,10,90,6,4
22553,10,9441,9,249,94,155,2,30,1,1
5973,146,0,0,60,60,0,1,0,1,0
8350,10,23456,9,194,102,92,2,30,1,1
16310,586,0,0,74,74,0,1,0,1,0
8517,15,21446,11,450,246,204,8,142,5,3
19929,26,27653,16,58141,3051,55090,78,78,29,49
19390,28,0,0,70,70,0,1,0,1,0
8,442,0,0,60,60,0,1,0,1,0
9769,28,0,0,70,70,0,1,0,1,0
8826,26,6932,16,3721,1477,2244,15,121,8,7
17111,26,996,16,10704,7055,3649,29,17,15,14
22595,1804,0,0,62,62,0,1,0,1,0
2463,1147,0,0,146,146,0,1,0,1,0
13562,28,0,0,70,70,0,1,0,1,0
9490,28,0,0,70,70,0,1,0,1,0
18274,15,11345,11,3059,1869,1190,17,105,13,4
8819,28,0,0,66,66,0,1,0,1,0
3312,26,18680,16,5327,963,4364,19,15,11,8
22542,28,0,0,70,70,0,1,0,1,0
11864,26,3099,16,38149,4388,33761,68,113,26,42
16021,2627,5383,2037,490,163,327,2,1200,1,1
743,1147,0,0,66,66,0,1,0,1,0
13652,10,860,9,196,100,96,2,31,1,1
15558,10,17014,9,165,86,79,2,30,1,1
17598,28,0,0,70,70,0,1,0,1,0
11009,2854,894,2214,70,70,0,1,4,1,0
15265,10,7857,9,802,104,698,2,30,1,1
15515,10,11024,9,170,87,83,2,31,1,1
20445,1927,21077,1471,18963,9580,9383,211,348,109,102
9112,10,13020,9,214,94,120,2,30,1,1
1895,7,0,0,60,60,0,1,0,1,0
12813,26,3250,16,9782,1996,7786,30,31,14,16
14796,10,13268,9,211,102,109,2,30,1,1
9,18,17978,13,184,94,90,2,30,1,1
14393,26,23598,16,1864,250,1614,8,120,4,4
12736,2443,13017,1898,70,70,0,1,5,1,0
5408,306,9713,200,1142,558,584,16,16,8,8
21584,10,13953,9,186,95,91,2,31,1,1
9849,5,14451,5,2222,983,1239,27,18,13,14
7867,26,23654,16,1058,571,487,10,24,6,4
11777,10,6734,9,164,78,86,2,30,1,1
3563,26,14937,16,8084,2638,5446,26,20,14,12
16128,26,27478,16,291,171,120,4,15,2,2
3650,26,10129,16,14923,1978,12945,32,49,17,15
10208,15,20362,11,10434,1041,9393,20,45,11,9
8597,10,16457,9,767,102,665,2,30,1,1
8682,10,13791,9,183,94,89,2,31,1,1
13005,28,0,0,70,70,0,1,0,1,0
7326,1649,0,0,60,60,0,1,0,1,0
18185,1017,0,0,66,66,0,1,0,1,0
14857,10,25008,9,326,126,200,2,30,1,1
360,3105,0,0,857,857,0,1,0,1,0
15823,28,0,0,70,70,0,1,0,1,0
20067,1888,0,0,66,66,0,1,0,1,0
20510,28,0,0,70,70,0,1,0,1,0
22284,10,22497,9,215,94,121,2,29,1,1
15041,1888,0,0,62,62,0,1,0,1,0
1425,2104,0,0,139,139,0,1,0,1,0
22111,10,12898,9,167,86,81,2,29,1,1
1909,1948,23071,1485,481,150,331,2,1200,1,1
18202,26,6046,16,9454,2307,7147,40,19,17,23
81,7,0,0,60,60,0,1,0,1,0
15797,26,25288,16,4623,1716,2907,19,26,11,8
19352,15,4611,11,1507,1184,323,11,79,7,4
11834,245,0,0,60,60,0,1,0,1,0
15135,10,6338,9,731,85,646,2,30,1,1
14335,10,22062,9,177,94,83,2,30,1,1
17639,28,0,0,70,70,0,1,0,1,0
9228,28,0,0,70,70,0,1,0,1,0
11360,28,0,0,70,70,0,1,0,1,0
14170,26,13978,16,10458,5272,5186,24,76,13,11
22474,10,21102,9,199,102,97,2,30,1,1
14309,10,22833,9,711,87,624,2,30,1,1
15887,10,13393,9,228,94,134,2,30,1,1
17504,28,0,0,70,70,0,1,0,1,0
21280,28,0,0,70,70,0,1,0,1,0
18679,28,0,0,70,70,0,1,0,1,0
6166,1367,0,0,62,62,0,1,0,1,0
11040,15,2346,11,1327,822,505,11,21,7,4
7509,218,0,0,60,60,0,1,0,1,0
10894,28,0,0,70,70,0,1,0,1,0
15116,26,6163,16,52465,2787,49678,66,80,26,40
8345,153,24158,108,70,70,0,2,7,2,0
8584,1239,20126,919,249,71,178,2,30,1,1
21927,10,23871,9,195,94,101,2,30,1,1
10249,183,22344,121,4213,2429,1784,18,32,9,9
13975,10,12032,9,196,100,96,2,30,1,1
12065,28,0,0,66,66,0,1,0,1,0
16021,1046,24550,770,2224,1852,372,33,1565,27,6
12659,28,0,0,66,66,0,1,0,1,0
22072,28,0,0,70,70,0,1,0,1,0
9880,28,0,0,70,70,0,1,0,1,0
10578,28,0,0,70,70,0,1,0,1,0
12,929,0,0,83,83,0,1,0,1,0
22522,10,8357,9,278,102,176,2,29,1,1
3788,26,16992,16,130,70,60,2,15,1,1
15041,28,0,0,70,70,0,1,0,1,0
9025,28,0,0,70,70,0,1,0,1,0
8522,10,11470,9,193,102,91,2,30,1,1
20730,28,0,0,70,70,0,1,0,1,0
14015,10,20802,9,190,97,93,2,31,1,1
16417,26,13879,16,5914,1514,4400,23,15,12,11
14685,26,13573,16,6817,3598,3219,32,143,15,17
2281,1147,0,0,62,62,0,1,0,1,0
9167,26,13908,16,13812,3042,10770,29,16,15,14
8102,10,21023,9,216,82,134,2,32,1,1
15201,26,22038,16,8240,3521,4719,25,18,15,10
15056,10,27972,9,200,102,98,2,30,1,1
9131,10,10702,9,445,95,350,4,50,2,2
5880,26,27082,16,8949,1938,7011,21,17,12,9
13794,10,20660,9,277,110,167,2,30,1,1
15004,10,0,0,82,82,0,1,30,1,0
20110,26,24914,16,1326,876,450,11,26,6,5
18046,15,13604,11,2241,1549,692,9,15,5,4
8943,28,0,0,70,70,0,1,0,1,0
15207,10,25005,9,235,90,145,2,33,1,1
15309,28,0,0,66,66,0,1,0,1,0
20558,10,21824,9,448,166,282,2,30,1,1
14786,10,16377,9,214,110,104,2,30,1,1
21824,10,25086,9,182,93,89,2,30,1,1
21753,10,6528,9,518,185,333,6,60,3,3
17162,26,16143,16,1068717,27931,1040786,1093,45,351,742
22070,10,23790,9,260,102,158,2,30,1,1
11555,28,0,0,70,70,0,1,0,1,0
22350,10,28618,9,338,110,228,2,30,1,1
21311,824,16273,604,66,66,0,1,5,1,0
306,1147,0,0,62,62,0,1,0,1,0
12182,28,0,0,70,70,0,1,0,1,0
14595,26,8158,16,14754,7879,6875,37,231,20,17
8780,10,21264,9,183,94,89,2,29,1,1
21299,3087,16029,2398,66,66,0,2,7,2,0
8914,28,0,0,70,70,0,1,0,1,0
18912,28,0,0,66,66,0,1,0,1,0
8050,676,18882,475,130,70,60,2,5,1,1
2744,64,22778,47,822,126,696,2,29,1,1
8788,2587,0,0,62,62,0,1,0,1,0
19102,26,8250,16,8580941,269463,8311478,9202,122,3016,6186
203,295,474,190,5194,3739,1455,18,15,10,8
7283,26,17362,16,130,70,60,3,6,2,1
615,250,0,0,60,60,0,1,0,1,0
7798,26,24011,16,2725,1153,1572,19,208,8,11
11716,26,14404,16,5806,1059,4747,16,63,8,8
8,442,0,0,60,60,0,1,0,1,0
15210,28,0,0,70,70,0,1,0,1,0
2172,1099,15911,807,481,150,331,2,1200,1,1
15615,10,15050,9,197,102,95,2,30,1,1
4700,26,2996,16,6169,4980,1189,28,16,15,13
9535,28,0,0,70,70,0,1,0,1,0
8667,10,19314,9,186,95,91,2,31,1,1
12556,26,20657,16,499,425,74,4,0,3,1
3066,605,1208,416,501,150,351,2,1200,1,1
9052,10,7292,9,198,102,96,2,29,1,1
15450,10,10893,9,283,110,173,2,29,1,1
22245,10,24546,9,199,102,97,2,29,1,1
22665,26,15855,16,93073,4939,88134,111,16,45,66
8697,10,8826,9,740,93,647,2,31,1,1
19387,26,11092,16,15302,2355,12947,30,32,14,16
20861,2144,0,0,66,66,0,1,0,1,0
14450,10,11665,9,177,94,83,2,29,1,1
13921,10,16253,9,215,94,121,2,30,1,1
15514,28,0,0,70,70,0,1,0,1,0
8846,26,21787,16,63100,10145,52955,87,147,37,50
9728,405,7483,263,1356,300,1056,6,1200,3,3
16577,28,0,0,70,70,0,1,0,1,0
13965,10,3270,9,170,87,83,2,30,1,1
10335,28,0,0,70,70,0,1,0,1,0
19577,28,0,0,70,70,0,1,0,1,0
22073,10,381,9,227,102,125,2,30,1,1
475,137,0,0,66,66,0,1,0,1,0
21311,10,16643,9,194,102,92,2,29,1,1
10836,26,17425,16,3182,1568,1614,8,121,4,4
16106,26,25439,16,181333,21870,159463,187,175,65,122
22707,10,8051,9,701,88,613,2,30,1,1
18902,26,13737,16,10104,1643,8461,28,46,15,13
19,1147,0,0,62,62,0,1,0,1,0
14873,10,20567,9,200,102,98,2,30,1,1
19993,26,27693,16,1210,637,573,14,51,7,7
5357,697,0,0,74,74,0,1,0,1,0
9181,10,28916,9,741,94,647,2,30,1,1
14164,15,2243,11,3386,2365,1021,19,39,11,8
14968,26,3502,16,9569,2225,7344,28,15,15,13
9688,26,10165,16,8592,1152,7440,25,150,13,12
3579,1147,0,0,62,62,0,1,0,1,0
9811,15,1691,11,3778,2082,1696,12,21,7,5
11002,616,18934,424,160,70,90,2,5,1,1
291,1147,0,0,66,66,0,1,0,1,0
14949,28,0,0,70,70,0,1,0,1,0
13348,3216,0,0,62,62,0,1,0,1,0
18959,28,0,0,70,70,0,1,0,1,0
17703,15,11083,11,3892,1824,2068,21,187,12,9
11530,2256,0,0,66,66,0,1,0,1,0
12260,28,0,0,66,66,0,1,0,1,0
376,10,1141,9,235,90,145,2,32,1,1
13102,28,0,0,70,70,0,1,0,1,0
13158,28,0,0,66,66,0,1,0,1,0
3789,15,3744,11,1540,553,987,10,15,6,4
16390,2256,0,0,62,62,0,1,0,1,0
1852,2747,0,0,66,66,0,1,0,1,0
0,0,0,0,707,707,0,2,0,2,0
12011,404,18117,262,70,70,0,2,8,2,0
17125,26,119,16,6357,4318,2039,22,16,11,11
12640,28,0,0,66,66,0,1,0,1,0
8837,10,22119,9,335,117,218,4,36,2,2
4195,26,2351,16,68705,5084,63621,93,172,36,57
6667,15,7094,11,2000,710,1290,8,15,5,3
2284,1472,0,0,146,146,0,1,0,1,0
12861,26,22926,16,249900,26024,223876,450,167,183,267
20777,28,0,0,66,66,0,1,0,1,0
11046,2974,18201,2309,66,66,0,1,5,1,0
19138,10,27171,9,213,79,134,2,32,1,1
7731,10,22789,9,199,94,105,2,30,1,1
14803,10,20446,9,200,102,98,2,33,1,1
21832,1694,0,0,66,66,0,1,90,1,0
9716,26,10215,16,5867,1782,4085,21,80,12,9
15892,10,26107,9,177,94,83,2,30,1,1
12,1818,0,0,60,60,0,1,0,1,0
9130,15,13322,11,1210,788,422,9,33,5,4
8334,909,0,0,66,66,0,1,0,1,0
15276,28,0,0,70,70,0,1,0,1,0
10666,26,23162,16,36602,1919,34683,58,80,19,39
9264,10,27163,9,209,110,99,2,30,1,1
3785,2477,0,0,60,60,0,1,0,1,0
1299,2636,0,0,62,62,0,1,0,1,0
17276,26,12622,16,6400453,202937,6197516,6806,226,2259,4547
8210,2628,21194,2038,150,150,0,1,1200,1,0
2754,15,11384,11,6337,947,5390,15,17,8,7
14989,28,0,0,66,66,0,1,0,1,0
21847,28,0,0,66,66,0,1,0,1,0
8649,295,21511,190,755531,16955,738576,785,16,265,520
20991,28,0,0,70,70,0,1,0,1,0
2141,1888,0,0,62,62,0,1,0,1,0
16367,28,0,0,70,70,0,1,0,1,0
14926,10,621,9,199,102,97,2,30,1,1
8915,28,0,0,70,70,0,1,0,1,0
18812,28,0,0,70,70,0,1,0,1,0
22573,28,0,0,70,70,0,1,0,1,0
16969,26,21702,16,2956,790,2166,10,120,5,5
14640,10,10127,9,177,94,83,2,30,1,1
16021,280,20750,177,330,330,0,6,1200,6,0
3832,183,14883,121,3910,1805,2105,20,18,12,8
8863,10,2697,9,195,94,101,2,30,1,1
13729,10,18818,9,183,94,89,2,30,1,1
16951,255,0,0,62,62,0,1,0,1,0
8908,10,22372,9,216,110,106,2,30,1,1
8521,10,6771,9,196,102,94,2,30,1,1
9,18,6066,13,184,94,90,2,29,1,1
2615,1472,0,0,62,62,0,1,0,1,0
16138,1590,0,0,62,62,0,1,0,1,0
16757,26,28475,16,78832,12408,66424,109,162,46,63
3187,2636,0,0,62,62,0,1,0,1,0
11016,15,11817,11,1420,888,532,11,49,7,4
17140,26,11530,16,5108,700,4408,15,15,7,8
14496,10,8390,9,189,102,87,2,30,1,1
20653,427,0,0,66,66,0,1,0,1,0
5449,305,13253,199,8822,1485,7337,26,15,13,13
12324,28,0,0,70,70,0,1,0,1,0
9635,15,26547,11,318,192,126,6,25,4,2
12359,405,8690,263,70,70,0,1,5,1,0
15935,10,2038,9,350,94,256,2,30,1,1
14427,15,24606,11,424,198,226,7,141,4,3
22472,10,5759,9,168,86,82,2,31,1,1
18140,15,21757,11,1455,965,490,10,142,6,4
19397,28,0,0,70,70,0,1,0,1,0
18098,28,0,0,70,70,0,1,0,1,0
5074,26,3292,16,12339,2392,9947,36,287,15,21
16084,1147,0,0,66,66,0,1,0,1,0
21846,28,0,0,70,70,0,1,0,1,0
8865,10,13992,9,266,89,177,4,58,2,2
21884,10,15221,9,370,96,274,4,39,2,2
2744,1241,1369,921,881,126,755,2,30,1,1
16951,255,0,0,62,62,0,1,0,1,0
21248,10,27872,9,200,102,98,2,30,1,1
6353,26,3979,16,6039,1327,4712,19,121,11,8
16951,255,0,0,62,62,0,1,0,1,0
636,281,11171,178,231,111,120,2,1200,1,1
19355,26,3679,16,11355,3474,7881,45,93,22,23
14642,28,0,0,70,70,0,1,0,1,0
6930,10,8963,9,199,94,105,2,30,1,1
21949,10,19841,9,329,118,211,2,30,1,1
0,0,0,0,244,244,0,2,0,2,0
10045,28,0,0,70,70,0,1,0,1,0
1388,3216,0,0,62,62,0,1,0,1,0
21966,10,8204,9,420,110,310,2,30,1,1
13768,28,0,0,70,70,0,1,0,1,0
17691,28,0,0,70,70,0,1,0,1,0
5686,1797,0,0,62,62,0,1,0,1,0
16377,28,0,0,70,70,0,1,0,1,0
8420,10,8627,9,198,101,97,2,30,1,1
17392,28,0,0,70,70,0,1,0,1,0
8774,10,15565,9,177,94,83,2,31,1,1
2708,10,11280,9,209,77,132,2,33,1,1
11229,1775,11971,1354,66,66,0,2,10,2,0
8584,1239,28517,919,270,78,192,2,30,1,1
20431,28,0,0,66,66,0,1,0,1,0
11067,15,1781,11,366,240,126,7,25,5,2
17291,26,17223,16,3576,2319,1257,21,23,11,10
10584,3216,0,0,62,62,0,1,0,1,0
12912,28,0,0,70,70,0,1,0,1,0
7237,26,19752,16,4617,1710,2907,19,26,11,8
9584,15,17979,11,318,192,126,6,26,4,2
13975,10,17726,9,198,102,96,2,29,1,1
21204,3020,2732,2348,66,66,0,2,7,2,0
8405,28,0,0,70,70,0,1,0,1,0
9496,15,22340,11,2537,783,1754,13,25,7,6
13736,10,18931,9,751,95,656,2,30,1,1
16951,255,0,0,62,62,0,1,0,1,0
2463,1147,0,0,62,62,0,1,0,1,0
11954,28,0,0,70,70,0,1,0,1,0
10516,26,21717,16,642,582,60,2,15,1,1
8687,10,12848,9,183,94,89,2,30,1,1
15875,26,25321,16,10504,1787,8717,27,364,12,15
9142,10,24578,9,195,102,93,2,30,1,1
12679,676,27206,475,130,70,60,2,5,1,1
14522,10,20374,9,184,94,90,2,30,1,1
3979,18,19541,13,184,94,90,2,30,1,1
6802,104,0,0,60,60,0,1,0,1,0
11303,15,22877,11,852970,14195,838775,769,28,207,562
13573,28,0,0,66,66,0,1,0,1,0
20707,28,0,0,70,70,0,1,0,1,0
5867,26,16810,16,7067,2430,4637,18,17,8,10
13334,10,13019,9,168,78,90,2,30,1,1
8882,26,24720,16,4653,785,3868,14,52,6,8
6411,26,5247,16,2337,1394,943,17,275,9,8
14461,10,9407,9,265,86,179,4,59,2,2
9469,10,255,9,754,94,660,2,31,1,1
15107,28,0,0,66,66,0,1,0,1,0
14742,1888,0,0,66,66,0,1,0,1,0
20124,26,6192,16,10393,7059,3334,27,26,15,12
2744,1238,6444,918,876,126,750,2,30,1,1
10730,28,0,0,66,66,0,1,0,1,0
11086,2578,3233,2000,70,70,0,1,5,1,0
22510,2611,0,0,78,78,0,1,0,1,0
14623,10,22780,9,762,97,665,2,30,1,1
8584,1238,8664,918,302,78,224,2,30,1,1
2774,10,11455,9,213,87,126,2,31,1,1
8665,28,0,0,70,70,0,1,0,1,0
15660,1215,0,0,66,66,0,1,0,1,0
15772,10,8178,9,780,104,676,2,31,1,1
12857,26,12454,16,7653,1188,6465,21,16,12,9
21704,10,17766,9,548,194,354,6,63,3,3
10450,23,22451,15,2315,979,1336,10,30,5,5
20038,15,27721,11,548903,4452,544451,440,20,58,382
13237,15,14695,11,13695,1377,12318,26,255,14,12
21593,28,0,0,66,66,0,1,0,1,0
6684,26,9394,16,40598,5313,35285,83,97,43,40
4655,10,8269,9,164,78,86,2,30,1,1
12,3140,0,0,199,199,0,1,0,1,0
1464,1147,0,0,146,146,0,1,0,1,0
5688,1017,0,0,66,66,0,1,0,1,0
15198,15,24773,11,234,234,0,4,12,4,0
11137,10,0,0,621,77,544,2,29,1,1
15280,10,15754,9,711,87,624,2,30,1,1
5502,12,0,0,60,60,0,1,0,1,0
8644,15,15747,11,28629,4862,23767,33,39,13,20
13364,1215,0,0,62,62,0,1,0,1,0
14326,2311,11033,1795,70,70,0,2,8,2,0
12687,26,11993,16,499,425,74,4,0,3,1
21343,28,0,0,70,70,0,1,0,1,0
12098,347,5679,221,5349,1928,3421,17,114,10,7
14155,2360,0,0,62,62,0,1,0,1,0
11148,26,10458,16,22072,2166,19906,44,49,22,22
9657,26,19139,16,9766,1810,7956,30,86,16,14
13627,10,8394,9,181,94,87,2,30,1,1
21445,2901,0,0,66,66,0,1,0,1,0
7423,330,24929,211,1440,956,484,15,36,8,7
18113,28,0,0,70,70,0,1,0,1,0
18357,300,0,0,62,62,0,1,0,1,0
8369,28,0,0,66,66,0,1,0,1,0
4264,10,15572,9,216,90,126,2,30,1,1
10949,462,25357,298,70,70,0,1,5,1,0
10157,28,0,0,66,66,0,1,0,1,0
15170,28,0,0,66,66,0,1,0,1,0
11007,855,10156,630,70,70,0,2,8,2,0
15562,10,10790,9,168,94,74,2,30,1,1
21959,10,28446,9,889,404,485,10,30,5,5
22216,10,11509,9,776,102,674,2,30,1,1
1843,38,0,0,60,60,0,1,0,1,0
17600,10,26352,9,237,91,146,2,32,1,1
16649,28,0,0,70,70,0,1,0,1,0
17200,1880,0,0,66,66,0,1,0,1,0
10083,28,0,0,70,70,0,1,0,1,0
20456,2256,0,0,66,66,0,1,0,1,0
1313,6,4390,6,9240,3413,5827,59,37,26,33
22125,10,20699,9,183,94,89,2,30,1,1
11158,28,0,0,70,70,0,1,0,1,0
14179,10,24469,9,228,90,138,2,30,1,1
17268,15,28486,11,943,513,430,9,14,6,3
15767,10,24242,9,195,102,93,2,30,1,1
14552,10,15521,9,197,102,95,2,30,1,1
18235,1215,0,0,62,62,0,1,0,1,0
8852,2256,0,0,66,66,0,1,0,1,0
11955,28,0,0,70,70,0,1,0,1,0
8439,28,0,0,66,66,0,1,0,1,0
7084,18,27979,13,184,94,90,2,30,1,1
15962,10,27010,9,188,96,92,2,30,1,1
2113,188,2354,123,443,294,149,2,300,1,1
9200,10,0,0,275,85,190,2,31,1,1
15697,10,17892,9,195,102,93,2,30,1,1
21299,10,775,9,197,102,95,2,30,1,1
10711,28,0,0,70,70,0,1,0,1,0
16579,28,0,0,70,70,0,1,0,1,0
9160,28,0,0,70,70,0,1,0,1,0
19764,28,0,0,70,70,0,1,0,1,0
12404,28,0,0,66,66,0,1,0,1,0
18143,26,14480,16,12254,3186,9068,27,171,13,14
11194,26,233,16,161883,8848,153035,177,54,64,113
15606,26,15441,16,1092898,42451,1050447,1213,155,423,790
20925,28,0,0,66,66,0,1,0,1,0
411,2636,0,0,62,62,0,1,0,1,0
8622,28,0,0,66,66,0,1,0,1,0
832,26,10626,16,7685,1016,6669,29,413,11,18
21420,1017,0,0,66,66,0,1,0,1,0
19418,28,0,0,66,66,0,1,0,1,0
11427,1771,0,0,62,62,0,1,0,1,0
21364,941,21463,693,66,66,0,1,5,1,0
22211,28,0,0,70,70,0,1,0,1,0
15027,10,14112,9,200,102,98,2,30,1,1
114,1017,0,0,62,62,0,1,0,1,0
17204,28,0,0,66,66,0,1,0,1,0
8459,10,28059,9,323,94,229,2,31,1,1
8551,10,7144,9,181,94,87,2,31,1,1
18744,28,0,0,70,70,0,1,0,1,0
16824,28,0,0,70,70,0,1,0,1,0
1213,2695,0,0,62,62,0,1,0,1,0
12156,26,14498,16,6156,2009,4147,26,18,14,12
10844,28,0,0,66,66,0,1,0,1,0
22433,10,15200,9,193,102,91,2,30,1,1
19488,28,0,0,66,66,0,1,0,1,0
21818,10,1948,9,264,102,162,2,30,1,1
2744,1239,15517,919,883,126,757,2,30,1,1
15041,1888,0,0,66,66,0,1,0,1,0
19768,28,0,0,70,70,0,1,0,1,0
1406,1804,0,0,66,66,0,1,0,1,0
19054,28,0,0,66,66,0,1,0,1,0
22498,10,23094,9,194,86,108,2,29,1,1
6345,26,28639,16,2378,1126,1252,14,982,7,7
7283,3216,0,0,62,62,0,1,0,1,0
15900,10,13895,9,181,94,87,2,31,1,1
16727,178,0,0,60,60,0,1,0,1,0
18037,26,312,16,333535,35190,298345,555,285,257,298
14093,26,1821,16,7409,2302,5107,19,135,9,10
4125,847,0,0,146,146,0,1,0,1,0
17510,2604,0,0,66,66,0,1,0,1,0
9658,28,0,0,70,70,0,1,0,1,0
16951,255,0,0,62,62,0,1,0,1,0
11867,15,19016,11,82011,2937,79074,91,358,34,57
20996,28,0,0,66,66,0,1,0,1,0
7211,1147,0,0,146,146,0,1,0,1,0
20284,26,12212,16,50000,36438,13562,98,336,61,37
360,3105,0,0,1188,1188,0,1,0,1,0
6680,15,19670,11,696,378,318,12,35,7,5
14270,1228,23693,908,70,70,0,2,8,2,0
16104,26,26073,16,6226,4213,2013,30,79,18,12
22425,10,25990,9,199,102,97,2,30,1,1
21215,10,16378,9,209,110,99,2,30,1,1
9692,26,21776,16,9277,2865,6412,31,200,18,13
13748,10,1264,9,324,102,222,4,42,2,2
16396,26,7916,16,43126,33414,9712,214,220,108,106
12668,146,0,0,60,60,0,1,0,1,0
7065,26,5655,16,11771,2624,9147,50,20,25,25
9602,10,6765,9,458,188,270,6,30,3,3
12542,28,0,0,66,66,0,1,0,1,0
1303,1795,0,0,60,60,0,1,0,1,0
8643,10,10816,9,183,86,97,2,30,1,1
12299,28,0,0,66,66,0,1,0,1,0
636,280,5717,177,150,150,0,1,1200,1,0
16951,255,0,0,62,62,0,1,0,1,0
16021,2253,19641,1744,132,132,0,3,1200,3,0
7106,26,19573,16,282,140,142,5,152,3,2
22186,1254,22161,934,734,462,272,2,30,1,1
9538,28,0,0,70,70,0,1,0,1,0
22293,28,0,0,70,70,0,1,0,1,0
4921,26,19932,16,6136,1404,4732,20,979,10,10
8496,26,11537,16,460,394,66,4,0,3,1
21281,697,0,0,146,146,0,1,0,1,0
5329,26,10405,16,6933,2226,4707,33,140,18,15
8759,10,8898,9,762,98,664,2,31,1,1
1460,2938,0,0,62,62,0,1,0,1,0
12265,26,24692,16,38342,14090,24252,83,159,40,43
11918,26,16058,16,15038,4142,10896,48,108,24,24
14386,10,24166,9,756,95,661,2,30,1,1
10137,28,0,0,66,66,0,1,0,1,0
18479,1888,0,0,66,66,0,1,0,1,0
17554,28,0,0,66,66,0,1,0,1,0
18433,28,0,0,66,66,0,1,0,1,0
5930,26,22910,16,4555,2276,2279,27,244,9,18
14471,10,18246,9,277,110,167,2,30,1,1
10854,2711,10592,2105,66,66,0,2,8,2,0
21040,1370,26244,1041,66,66,0,2,7,2,0
3133,2293,10168,1778,396,396,0,7,3616,7,0
15204,1147,0,0,66,66,0,1,0,1,0
8436,10,1830,9,198,110,88,2,29,1,1
13500,1771,0,0,62,62,0,1,0,1,0
11096,3056,21301,2373,70,70,0,1,5,1,0
14460,10,3622,9,170,87,83,2,30,1,1
15712,10,26785,9,177,94,83,2,29,1,1
6323,1017,0,0,62,62,0,1,0,1,0
9801,28,0,0,70,70,0,1,0,1,0
18769,1356,4281,1029,70,70,0,1,5,1,0
10327,95,5279,74,132,132,0,3,1200,3,0
9586,15,3360,11,378,192,186,7,19,4,3
11728,26,16675,16,8308,3201,5107,36,1401,19,17
8816,10,18418,9,248,110,138,2,30,1,1
15214,10,20761,9,168,86,82,2,32,1,1
17176,26,18248,16,19357,12948,6409,47,18,26,21
5799,26,13771,16,4014,1592,2422,17,147,9,8
6084,26,18083,16,23344,2097,21247,39,15,18,21
8590,10,15751,9,210,102,108,2,30,1,1
14355,10,740,9,195,102,93,2,31,1,1
22293,1017,0,0,66,66,0,1,0,1,0
7000,2370,0,0,74,74,0,1,0,1,0
14707,10,1861,9,179,94,85,2,30,1,1
11977,28,0,0,70,70,0,1,0,1,0
14196,10,24479,9,216,90,126,2,30,1,1
6793,26,12866,16,3947,1744,2203,16,361,8,8
21381,10,22805,9,195,102,93,2,29,1,1
8888,10,21871,9,168,78,90,2,30,1,1
9123,15,1902,11,9763,749,9014,17,15,8,9
17219,26,12411,16,5166,700,4466,16,15,7,9
14942,28,0,0,70,70,0,1,0,1,0
8615,10,6343,9,216,110,106,2,30,1,1
10060,28,0,0,66,66,0,1,0,1,0
9749,15,22071,11,2909,1798,1111,14,23,8,6
13753,10,17584,9,190,97,93,2,30,1,1
441,1590,0,0,66,66,0,1,0,1,0
9071,10,9488,9,199,102,97,2,30,1,1
21125,1147,0,0,62,62,0,1,0,1,0
5790,1147,0,0,146,146,0,1,0,1,0
22448,10,5205,9,900,110,790,2,30,1,1
9145,10,7626,9,200,94,106,2,30,1,1
21322,843,13841,621,3197,1526,1671,19,26,12,7
17899,10,9129,9,168,78,90,2,30,1,1
7603,26,13633,16,90614,3825,86789,108,214,42,66
13666,10,21838,9,275,110,165,2,30,1,1
21102,28,0,0,70,70,0,1,0,1,0
16021,1035,10570,761,726,726,0,12,1200,12,0
21563,10,15137,9,241,94,147,2,30,1,1
9728,830,14414,609,851,369,482,5,1200,3,2
15259,10,1762,9,194,94,100,2,30,1,1
3637,26,14348,16,9932,1987,7945,22,16,12,10
13219,28,0,0,66,66,0,1,0,1,0
10794,26,11784,16,5660,3864,1796,27,95,14,13
14748,10,3828,9,199,102,97,2,30,1,1
7694,1,0,0,62,62,0,1,0,1,0
9050,26,26039,16,77867,2411,75456,82,87,27,55
20153,28,0,0,66,66,0,1,0,1,0
12098,26,24949,16,11086,2564,8522,42,186,21,21
8985,10,4866,9,186,95,91,2,31,1,1
9429,15,18142,11,5689,1015,4674,16,45,8,8
12045,28,0,0,70,70,0,1,0,1,0
243,3142,0,0,66,66,0,1,0,1,0
6001,1147,0,0,66,66,0,1,0,1,0
15817,2611,0,0,66,66,0,1,0,1,0
8078,26,28543,16,2588313,95154,2493159,2645,190,811,1834
3691,983,0,0,146,146,0,1,0,1,0
10742,26,618,16,66148,6145,60003,116,80,60,56
10049,28,0,0,66,66,0,1,0,1,0
4446,15,12744,11,114410,3755,110655,128,38,47,81
22640,10,18557,9,723,102,621,2,30,1,1
8790,15,12657,11,3314,1478,1836,16,41,9,7
5891,1472,0,0,62,62,0,1,0,1,0
495,2256,0,0,66,66,0,1,0,1,0
10912,704,16705,502,70,70,0,2,8,2,0
8684,26,24771,16,7834,1758,6076,26,171,13,13
6577,26,14822,16,7767,1069,6698,23,3971,7,16
22093,28,0,0,70,70,0,1,0,1,0
20595,28,0,0,70,70,0,1,0,1,0
3257,1147,0,0,62,62,0,1,0,1,0
4919,10,16424,9,216,89,127,2,30,1,1
17253,28,0,0,66,66,0,1,0,1,0
16951,255,0,0,62,62,0,1,0,1,0
9147,10,756,9,211,110,101,2,30,1,1
15536,10,16152,9,199,102,97,2,29,1,1
13703,26,4090,16,12851,3808,9043,30,61,16,14
5,3216,0,0,66,66,0,1,0,1,0
21206,877,5126,646,70,70,0,1,4,1,0
22272,10,28896,9,197,94,103,2,30,1,1
1128,2938,0,0,62,62,0,1,0,1,0
5079,26,6846,16,2540,1317,1223,17,28,9,8
22155,10,7310,9,341,110,231,2,29,1,1
9513,26,8558,16,8048,1189,6859,19,25,10,9
12767,2406,13646,1871,612,306,306,10,14,5,5
14014,10,28754,9,198,101,97,2,31,1,1
3570,2675,0,0,162,162,0,1,0,1,0
9461,15,17663,11,2062,872,1190,13,83,7,6
22515,26,8540,16,8429792,268889,8160903,8985,135,2983,6002
17946,28,0,0,70,70,0,1,0,1,0
4224,26,15412,16,5901,1324,4577,25,50,14,11
2948,1888,0,0,62,62,0,1,0,1,0
22438,10,25605,9,489,185,304,6,73,3,3
18288,28,0,0,70,70,0,1,0,1,0
14162,15,18274,11,3277,2255,1022,18,39,10,8
9011,28,0,0,70,70,0,1,0,1,0
1874,1017,0,0,62,62,0,1,0,1,0
17792,28,0,0,70,70,0,1,0,1,0
13894,28,0,0,70,70,0,1,0,1,0
612,5,0,0,60,60,0,1,0,1,0
20920,26,4935,16,5759,1721,4038,20,78,11,9
17031,28,0,0,70,70,0,1,0,1,0
8729,10,3174,9,200,102,98,2,30,1,1
612,139,0,0,60,60,0,1,0,1,0
11582,1147,0,0,62,62,0,1,0,1,0
16206,28,0,0,66,66,0,1,0,1,0
8113,26,21040,16,4381,1474,2907,19,26,11,8
10149,28,0,0,70,70,0,1,0,1,0
17908,28,0,0,66,66,0,1,0,1,0
19895,28,0,0,66,66,0,1,0,1,0
15536,15,10646,11,6974,3906,3068,19,30,11,8
3660,26,11084,16,7341,2121,5220,18,135,8,10
22128,10,17909,9,177,94,83,2,31,1,1
1554,697,0,0,62,62,0,1,0,1,0
21264,707,19172,505,1344,819,525,14,15,8,6
12844,2256,0,0,66,66,0,1,0,1,0
13748,10,29085,9,170,87,83,2,31,1,1
7680,26,4595,16,2809,1884,925,19,27,11,8
14183,10,5632,9,199,94,105,2,29,1,1
10871,28,0,0,70,70,0,1,0,1,0
22030,10,14546,9,239,94,145,2,30,1,1
10747,28,0,0,70,70,0,1,0,1,0
15233,10,14974,9,458,188,270,6,30,3,3
19776,1804,0,0,66,66,0,1,0,1,0
12753,1379,27549,1049,70,70,0,2,7,2,0
21006,28,0,0,70,70,0,1,0,1,0
11149,26,4502,16,10583,3353,7230,32,83,16,16
14881,10,16205,9,216,110,106,2,30,1,1
938,15,5704,11,60838,1648,59190,68,27,25,43
14055,10,13964,9,168,86,82,2,30,1,1
15792,26,15657,16,8954,3404,5550,34,46,19,15
6525,2587,0,0,146,146,0,1,0,1,0
7933,26,24149,16,7816,2371,5445,34,255,18,16
20463,28,0,0,70,70,0,1,0,1,0
19691,28,0,0,70,70,0,1,0,1,0
10465,28,0,0,70,70,0,1,0,1,0
10502,26,27187,16,4591,3237,1354,18,271,10,8
12214,28,0,0,70,70,0,1,0,1,0
9883,28,0,0,70,70,0,1,0,1,0
6187,7,0,0,60,60,0,1,0,1,0
7462,1804,0,0,66,66,0,1,0,1,0
16951,255,0,0,62,62,0,1,0,1,0
1579,6,0,0,60,60,0,1,0,1,0
14160,2256,0,0,66,66,0,1,0,1,0
8534,26,26988,16,22639,7456,15183,32,16,17,15
15320,26,5047,16,8058,2038,6020,20,15,11,9
13242,28,0,0,70,70,0,1,0,1,0
16951,255,0,0,62,62,0,1,0,1,0
19839,26,2790,16,9652,2914,6738,22,124,11,11
20,1472,0,0,62,62,0,1,0,1,0
9578,15,13572,11,318,192,126,6,26,4,2
19005,26,11742,16,56191,3435,52756,81,271,37,44
22417,1771,0,0,66,66,0,1,0,1,0
4159,26,15395,16,4481,1574,2907,19,26,11,8
855,26,3138,16,11738,6980,4758,34,81,19,15
20095,28,0,0,66,66,0,1,0,1,0
7339,170,0,0,60,60,0,1,0,1,0
22286,28,0,0,66,66,0,1,0,1,0
18496,280,15014,177,70,70,0,1,5,1,0
21789,10,13670,9,193,102,91,2,29,1,1
7401,26,3167,16,9805,1642,8163,24,362,12,12
13543,10,4596,9,578,286,292,9,15,5,4
17606,1888,0,0,62,62,0,1,0,1,0
12,278,0,0,169,169,0,2,90,2,0
22048,28,0,0,70,70,0,1,0,1,0
1160,15,3328,11,3759,741,3018,15,45,8,7
6680,26,11179,16,5903,1367,4536,18,16,10,8
6924,255,0,0,60,60,0,1,0,1,0
21854,2587,0,0,62,62,0,1,0,1,0
15162,10,21995,9,177,94,83,2,29,1,1
22363,10,10560,9,286,103,183,4,52,2,2
18,1792,0,0,62,62,0,1,0,1,0
11141,2256,0,0,66,66,0,1,0,1,0
22486,10,2999,9,179,94,85,2,31,1,1
1811,1147,0,0,66,66,0,1,0,1,0
15136,10,14858,9,196,100,96,2,31,1,1
9411,1766,12597,1348,1386,1386,0,22,2342,22,0
15089,28,0,0,70,70,0,1,0,1,0
15998,11,16646,10,70,70,0,1,5,1,0
9022,26,910,16,16232,3319,12913,23,124,9,14
19744,2581,0,0,66,66,0,1,0,1,0
11999,28,0,0,66,66,0,1,0,1,0
16292,15,10413,11,2762,2628,134,8,17,6,2
15238,15,2285,11,234,234,0,4,12,4,0
15221,2486,0,0,62,62,0,1,0,1,0
15892,10,11876,9,185,102,83,2,30,1,1
14484,10,12575,9,198,110,88,2,29,1,1
9422,28,0,0,66,66,0,1,0,1,0
16533,2938,0,0,62,62,0,1,0,1,0
13737,10,28620,9,177,94,83,2,29,1,1
11059,28,0,0,70,70,0,1,0,1,0
8763,10,13924,9,168,86,82,2,31,1,1
13766,26,9745,16,1348,687,661,14,18,8,6
8668,10,25870,9,193,102,91,2,30,1,1
13222,26,20913,16,282,148,134,5,27,3,2
21341,1086,0,0,66,66,0,1,0,1,0
8559,28,0,0,70,70,0,1,0,1,0
19240,28,0,0,70,70,0,1,0,1,0
13950,10,17361,9,168,78,90,2,29,1,1
14122,10,17598,9,199,102,97,2,30,1,1
6424,26,26645,16,448,78,370,6,25,1,5
14881,10,11797,9,216,110,106,2,30,1,1
15735,10,5247,9,216,110,106,2,31,1,1
14229,28,0,0,70,70,0,1,0,1,0
14845,15,12941,11,25043,1750,23293,44,30,23,21
806,1797,0,0,62,62,0,1,0,1,0
13005,26,24566,16,499,425,74,4,0,3,1
7326,1649,0,0,60,60,0,1,0,1,0
2687,2587,0,0,62,62,0,1,0,1,0
4404,26,1129,16,6112,1553,4559,18,16,10,8
10652,676,11687,475,130,70,60,2,6,1,1
2608,2883,0,0,66,66,0,1,0,1,0
17251,26,15459,16,5166,700,4466,16,15,7,9
13946,10,9110,9,94,94,0,1,30,1,0
19589,28,0,0,70,70,0,1,0,1,0
9637,26,24210,16,8164,1206,6958,24,139,12,12
9217,1241,21797,921,546,390,156,6,30,4,2
2527,7,0,0,60,60,0,1,0,1,0
15902,28,0,0,66,66,0,1,0,1,0
20350,1,0,0,66,66,0,1,0,1,0
15856,10,26716,9,338,110,228,2,30,1,1
21174,2938,0,0,62,62,0,1,0,1,0
15739,10,5309,9,179,94,85,2,30,1,1
7363,26,14420,16,11019,4673,6346,32,423,17,15
16019,26,25391,16,4373,1466,2907,19,27,11,8
13797,28,0,0,70,70,0,1,0,1,0
18100,26,69,16,34450,1943,32507,47,144,16,31
14958,2636,0,0,66,66,0,1,0,1,0
11288,28,0,0,70,70,0,1,0,1,0
7537,1086,0,0,66,66,0,1,0,1,0
8435,10,3774,9,200,94,106,2,30,1,1
18117,26,12962,16,8127,1796,6331,21,79,12,9
15942,10,3041,9,197,102,95,2,30,1,1
15215,26,23732,16,8735,1819,6916,23,30,14,9
8820,10,20050,9,775,102,673,2,30,1,1
14969,26,17840,16,15485,8351,7134,71,130,40,31
20562,28,0,0,70,70,0,1,0,1,0
16737,28,0,0,70,70,0,1,0,1,0
20606,1495,10406,1136,70,70,0,1,5,1,0
1016,26,1610,16,26959,1764,25195,42,48,18,24
21513,10,15779,9,198,101,97,2,31,1,1
11080,1542,16719,1175,70,70,0,1,5,1,0
14835,10,4262,9,816,97,719,2,31,1,1
12013,3023,13958,2351,70,70,0,2,8,2,0
13428,28,0,0,66,66,0,1,0,1,0
8852,26,27024,16,8475,1661,6814,32,76,14,18
2701,228,0,0,145,145,0,1,0,1,0
347,2587,0,0,66,66,0,1,0,1,0
13978,10,4514,9,184,94,90,2,30,1,1
2686,26,10173,16,7283,2586,4697,22,19,11,11
12248,1017,0,0,62,62,0,1,0,1,0
1163,2001,2856,1531,151,89,62,2,30,1,1
18276,28,0,0,70,70,0,1,0,1,0
14544,10,21050,9,196,102,94,2,30,1,1
18028,10,26570,9,365,233,132,3,33,2,1
9448,28,0,0,66,66,0,1,0,1,0
19105,28,0,0,66,66,0,1,0,1,0
3958,26,8564,16,7447,2133,5314,27,348,14,13
4809,10,0,0,86,86,0,1,30,1,0
8369,15,16621,11,3223,605,2618,13,15,7,6
21822,26,28477,16,24682,1935,22747,36,17,17,19
8578,26,24711,16,46271,6834,39437,63,47,19,44
12439,1406,28552,1069,492,306,186,8,15,5,3
9924,2587,0,0,62,62,0,1,0,1,0
18693,28,0,0,70,70,0,1,0,1,0
4841,2504,11647,1947,156,156,0,3,7,3,0
4290,2636,0,0,62,62,0,1,0,1,0
7487,10,13724,9,222,78,144,2,30,1,1
20828,28,0,0,66,66,0,1,0,1,0
7144,3216,0,0,62,62,0,1,0,1,0
1815,3216,0,0,145,145,0,1,0,1,0
15065,10,5080,9,188,96,92,2,30,1,1
16951,255,0,0,62,62,0,1,0,1,0
18809,923,649,681,70,70,0,1,5,1,0
20828,28,0,0,70,70,0,1,0,1,0
17807,28,0,0,70,70,0,1,0,1,0
19702,10,27496,9,298,114,184,2,30,1,1
15001,15,1163,11,35833,938,34895,37,104,11,26
20609,771,3524,558,618,318,300,10,16,5,5
12408,1771,0,0,66,66,0,1,0,1,0
6283,26,17156,16,4844,1099,3745,18,25,10,8
11834,26,9646,16,5582,1388,4194,19,15,9,10
18504,26,15639,16,3211,1964,1247,25,263,13,12
21848,10,10833,9,179,94,85,2,31,1,1
13209,28,0,0,70,70,0,1,0,1,0
19043,28,0,0,70,70,0,1,0,1,0
21242,454,10771,292,66,66,0,1,5,1,0
3810,15,14857,11,3530,2851,679,13,20,8,5
3726,26,18730,16,1053,566,487,10,16,6,4
20679,28,0,0,70,70,0,1,0,1,0
16856,2938,0,0,62,62,0,1,0,1,0
2543,1795,0,0,62,62,0,1,0,1,0
1608,2477,0,0,60,60,0,1,0,1,0
10572,28,0,0,70,70,0,1,0,1,0
4117,18,12650,13,94,94,0,1,30,1,0
18137,26,23441,16,1015,572,443,11,142,6,5
18386,26,5154,16,1743,1164,579,16,25,10,6
16325,10,25596,9,225,87,138,2,30,1,1
11794,26,1008,16,130,70,60,2,15,1,1
2529,7,0,0,60,60,0,1,0,1,0
1330,918,0,0,62,62,0,1,0,1,0
18086,2938,0,0,66,66,0,1,0,1,0
11096,15,12707,11,692,300,392,9,26,6,3
8820,28,0,0,66,66,0,1,0,1,0
16951,255,0,0,62,62,0,1,0,1,0
2744,2559,3505,1988,877,126,751,2,31,1,1
9777,15,3061,11,1717,1247,470,9,15,5,4
6148,26,28991,16,5838,1840,3998,20,80,12,8
6868,26,25620,16,502,288,214,8,131,5,3
15460,10,22667,9,177,94,83,2,30,1,1
19736,28,0,0,66,66,0,1,0,1,0
12891,26,28121,16,307208,13249,293959,367,202,153,214
14208,10,8443,9,195,102,93,2,30,1,1
10048,28,0,0,70,70,0,1,0,1,0
15412,26,16668,16,2349,258,2091,10,120,4,6
8412,10,1296,9,190,97,93,2,31,1,1
14951,28,0,0,70,70,0,1,0,1,0
13680,10,22532,9,164,86,78,2,30,1,1
21963,10,14541,9,402,118,284,2,30,1,1
14082,10,3506,9,102,102,0,1,30,1,0
8715,26,6114,16,19491,14463,5028,50,224,26,24
16973,28,0,0,66,66,0,1,0,1,0
8710,15,6814,11,10192,3818,6374,20,16,9,11
18364,28,0,0,70,70,0,1,0,1,0
18383,7,0,0,60,60,0,1,0,1,0
11256,28,0,0,70,70,0,1,0,1,0
10811,28,0,0,70,70,0,1,0,1,0
8151,26,8444,16,42910,5005,37905,72,136,36,36
15863,10,25320,9,220,90,130,2,30,1,1
8349,10,1219,9,199,102,97,2,29,1,1
12895,28,0,0,70,70,0,1,0,1,0
11435,28,0,0,70,70,0,1,0,1,0
12164,983,0,0,66,66,0,1,0,1,0
16090,26,7551,16,7323,2654,4669,23,30,13,10
20373,26,25099,16,86513,10300,76213,131,137,54,77
532,247,0,0,3354,1792,1562,46,196,23,23
15182,26,14076,16,21604,12969,8635,49,112,28,21
20011,15,11461,11,2328,580,1748,12,16,6,6
11094,2178,2035,1683,70,70,0,2,7,2,0
9986,28,0,0,70,70,0,1,0,1,0
9082,10,24368,9,396,88,308,4,59,2,2
12927,3145,0,0,148,148,0,1,0,1,0
19437,2256,0,0,66,66,0,1,0,1,0
18366,28,0,0,70,70,0,1,0,1,0
21244,28,0,0,70,70,0,1,0,1,0
12702,28,0,0,66,66,0,1,0,1,0
12817,1205,12392,892,70,70,0,1,4,1,0
16249,1888,0,0,62,62,0,1,0,1,0
10327,2924,4373,2269,481,150,331,2,1200,1,1
15067,26,23751,16,75930,4291,71639,90,120,32,58
12704,1136,3217,837,320,140,180,6,6,3,3
9746,15,16790,11,1658,1247,411,8,15,5,3
14047,10,11699,9,711,87,624,2,30,1,1
4219,15,15491,11,514,246,268,9,76,5,4
15074,28,0,0,70,70,0,1,0,1,0
18432,28,0,0,66,66,0,1,0,1,0
12426,2061,3011,1587,492,306,186,8,16,5,3
8584,1238,14291,918,71,71,0,1,30,1,0
8584,2938,0,0,62,62,0,1,0,1,0
9029,26,77,16,8535,1936,6599,22,87,12,10
19769,28,0,0,70,70,0,1,0,1,0
11795,28,0,0,70,70,0,1,0,1,0
10708,26,10573,16,90135,76061,14074,251,247,132,119
12848,28,0,0,70,70,0,1,0,1,0
11174,684,24441,483,70,70,0,1,5,1,0
14597,10,17364,9,182,93,89,2,30,1,1
7850,1658,0,0,106,106,0,1,60,1,0
20967,28,0,0,66,66,0,1,0,1,0
11561,28,0,0,66,66,0,1,0,1,0
11270,2706,794,2102,66,66,0,1,5,1,0
8479,28,0,0,66,66,0,1,0,1,0
10070,28,0,0,66,66,0,1,0,1,0
19033,28,0,0,70,70,0,1,0,1,0
17345,28,0,0,66,66,0,1,0,1,0
10478,28,0,0,70,70,0,1,0,1,0
12,3074,0,0,60,60,0,1,0,1,0
13527,28,0,0,70,70,0,1,0,1,0
15528,10,25576,9,182,93,89,2,31,1,1
15899,10,16073,9,166,85,81,2,31,1,1
16760,28,0,0,70,70,0,1,0,1,0
18812,1356,9319,1029,70,70,0,2,8,2,0
2744,1240,25838,920,883,126,757,2,30,1,1
16230,28,0,0,70,70,0,1,0,1,0
8328,10,25964,9,184,102,82,2,30,1,1
10768,295,22632,190,3550,1983,1567,15,16,8,7
15694,26,7572,16,6489,1065,5424,22,255,12,10
8682,10,17469,9,183,94,89,2,30,1,1
22241,10,21304,9,184,94,90,2,31,1,1
15138,2256,0,0,62,62,0,1,0,1,0
10623,26,10491,16,2840,330,2510,12,135,5,7
12019,1912,20873,1458,70,70,0,2,8,2,0
21631,10,1479,9,168,86,82,2,32,1,1
17681,3216,0,0,62,62,0,1,0,1,0
8133,1888,0,0,62,62,0,1,0,1,0
21766,10,5970,9,763,101,662,2,30,1,1
19503,28,0,0,70,70,0,1,0,1,0
8872,10,14555,9,296,102,194,4,41,2,2
21388,28,0,0,70,70,0,1,0,1,0
22429,10,29067,9,190,97,93,2,31,1,1
637,1111,14552,816,228,118,110,2,1200,1,1
437,308,0,0,66,66,0,1,0,1,0
10051,28,0,0,70,70,0,1,0,1,0
13925,10,18098,9,236,94,142,2,30,1,1
10208,28,0,0,70,70,0,1,0,1,0
18070,28,0,0,70,70,0,1,0,1,0
360,3105,0,0,942,942,0,1,0,1,0
16727,177,0,0,60,60,0,1,0,1,0
4040,1771,0,0,62,62,0,1,0,1,0
14005,10,4788,9,195,102,93,2,30,1,1
3648,26,7395,16,4897,850,4047,15,15,9,6
13382,28,0,0,70,70,0,1,0,1,0
18589,1771,0,0,66,66,0,1,0,1,0
2744,1449,21867,1102,1780,252,1528,5,44,3,2
3244,2611,0,0,62,62,0,1,0,1,0
13583,188,829,123,312,140,172,4,30,2,2
18078,1472,0,0,66,66,0,1,0,1,0
14115,10,21920,9,184,94,90,2,31,1,1
22504,10,1856,9,198,94,104,2,30,1,1
16530,183,25717,121,3564,1850,1714,18,32,10,8
2081,3216,0,0,62,62,0,1,0,1,0
6617,26,2201,16,6990,2019,4971,29,20,16,13
16298,10,25574,9,222,90,132,2,30,1,1
18437,2938,0,0,62,62,0,1,0,1,0
12572,1043,28454,767,70,70,0,2,8,2,0
16925,28,0,0,70,70,0,1,0,1,0
15913,10,24887,9,815,95,720,2,30,1,1
8764,28,0,0,66,66,0,1,0,1,0
8653,10,11222,9,183,94,89,2,31,1,1
16642,2702,0,0,62,62,0,1,0,1,0
9411,2173,8350,1679,481,150,331,2,1200,1,1
13450,1539,0,0,66,66,0,1,0,1,0
20454,28,0,0,70,70,0,1,0,1,0
2724,1240,3295,920,422,164,258,6,29,3,3
3673,40,0,0,60,60,0,1,0,1,0
12528,784,5469,569,70,70,0,1,4,1,0
533,1888,0,0,66,66,0,1,0,1,0
17946,28,0,0,70,70,0,1,0,1,0
19006,28,0,0,66,66,0,1,0,1,0
2700,26,22667,16,7343,2586,4757,23,20,11,12
0,0,0,0,480,244,236,4,0,2,2
8405,10,27256,9,274,94,180,2,30,1,1
9069,26,16356,16,798502,33164,765338,927,103,379,548
7632,10,4857,9,168,78,90,2,30,1,1
2881,26,4410,16,5576,1388,4188,19,15,9,10
16951,255,25970,160,130,66,64,2,5,1,1
19839,28,0,0,66,66,0,1,0,1,0
16984,28,0,0,66,66,0,1,0,1,0
9150,10,15066,9,209,94,115,2,30,1,1
21589,26,24734,16,230615,48569,182046,379,176,157,222
20939,26,13885,16,10050,1802,8248,30,39,16,14
11644,2154,0,0,66,66,0,1,0,1,0
15882,1888,0,0,62,62,0,1,0,1,0
13991,10,200,9,168,86,82,2,30,1,1
4196,18,12386,13,184,94,90,2,30,1,1
17511,15,26289,11,72354,14398,57956,123,15,40,83
350,1147,0,0,66,66,0,1,0,1,0
14432,10,5128,9,182,93,89,2,30,1,1
5883,26,22720,16,8869,1938,6931,21,17,12,9
17904,26,26505,16,5525,2278,3247,22,40,13,9
12648,2885,1446,2240,70,70,0,1,4,1,0
13868,28,0,0,66,66,0,1,0,1,0
1470,3139,0,0,66,66,0,1,0,1,0
10635,2876,0,0,66,66,0,1,0,1,0
12827,28,0,0,66,66,0,1,0,1,0
11432,10,1305,9,216,78,138,2,29,1,1
15744,10,2454,9,178,94,84,2,31,1,1
16913,28,0,0,70,70,0,1,0,1,0
8584,1242,11359,922,242,78,164,2,30,1,1
16951,255,0,0,62,62,0,1,0,1,0
16329,2587,0,0,66,66,0,1,0,1,0
8584,1238,24069,918,78,78,0,1,29,1,0
16951,255,0,0,62,62,0,1,0,1,0
3175,3216,0,0,62,62,0,1,0,1,0
17140,28,0,0,70,70,0,1,0,1,0
7645,1880,0,0,146,146,0,1,0,1,0
22474,10,24690,9,167,86,81,2,30,1,1
6549,15,18729,11,6776,692,6084,16,20,8,8
1977,1,0,0,66,66,0,1,0,1,0
15542,10,23267,9,196,94,102,2,29,1,1
11595,280,21378,177,1106,800,306,10,14,5,5
7857,1147,0,0,62,62,0,1,0,1,0
21746,10,616,9,524,91,433,4,34,2,2
17261,15,2783,11,5541,4758,783,16,16,8,8
22046,1827,0,0,62,62,0,1,0,1,0
13057,26,26323,16,11356,5509,5847,84,544,44,40
18969,26,11360,16,333131,17461,315670,435,72,211,224
12100,28,0,0,70,70,0,1,0,1,0
9602,10,10757,9,177,94,83,2,30,1,1
3860,26,8401,16,80828,20592,60236,124,180,54,70
14518,28,0,0,70,70,0,1,0,1,0
4813,1086,0,0,62,62,0,1,0,1,0
7610,234,10766,149,3775,2029,1746,30,3637,13,17
21209,10,501,9,376,126,250,2,30,1,1
12726,2532,20347,1968,492,306,186,8,16,5,3
9696,15,22037,11,2887,1776,1111,14,22,8,6
22279,28,0,0,66,66,0,1,0,1,0
15059,10,1617,9,193,102,91,2,30,1,1
9727,15,22054,11,17375,11554,5821,52,27,32,20
3651,2587,0,0,146,146,0,1,0,1,0
16951,255,0,0,62,62,0,1,0,1,0
5784,2587,0,0,62,62,0,1,0,1,0
21084,1771,0,0,66,66,0,1,0,1,0
22095,2205,0,0,66,66,0,1,0,1,0
77,183,82,121,3910,1805,2105,20,19,12,8
10733,28,0,0,66,66,0,1,0,1,0
3098,2573,0,0,62,62,0,1,0,1,0
5610,2573,0,0,62,62,0,1,0,1,0
12543,743,16639,534,70,70,0,1,4,1,0
3952,10,15065,9,235,90,145,2,32,1,1
17369,28,0,0,70,70,0,1,0,1,0
22424,26,12299,16,18887,8273,10614,42,62,22,20
9770,2205,0,0,62,62,0,1,0,1,0
7017,26,21888,16,232,172,60,3,4,2,1
22198,10,11777,9,198,102,96,2,29,1,1
12,929,0,0,83,83,0,1,0,1,0
8564,10,5183,9,226,86,140,2,31,1,1
14575,10,27825,9,747,92,655,2,30,1,1
6492,255,0,0,60,60,0,1,0,1,0
16946,28,0,0,66,66,0,1,0,1,0
22170,10,6058,9,197,102,95,2,30,1,1
12415,905,21850,669,70,70,0,2,7,2,0
12606,28,0,0,70,70,0,1,0,1,0
14835,15,24829,11,101654,1739,99915,95,15,25,70
15573,10,10092,9,194,102,92,2,30,1,1
2233,10,9130,9,220,90,130,2,30,1,1
8951,10,28294,9,211,110,101,2,30,1,1
20381,28,0,0,66,66,0,1,0,1,0
16023,2256,0,0,66,66,0,1,0,1,0
