Source Port,Destination Port,NAT Source Port,NAT Destination Port,Bytes,Bytes Sent,Bytes Received,Packets,Elapsed Time (sec),pkts_sent,pkts_received
42587,53,63043,53,199,94,105,2,30,1,1
27005,27021,28946,27021,879,126,753,2,31,1,1
51102,443,51987,443,13990,9102,4888,28,15,16,12
50584,51413,45972,51413,1275,300,975,6,1200,3,3
44206,53,19423,53,202,83,119,2,30,1,1
48975,443,52782,443,130,70,60,3,5,2,1
56448,53,42442,53,177,94,83,2,30,1,1
50929,443,35060,443,9571,2966,6605,52,35,29,23
49359,53,64327,53,412,122,290,4,45,2,2
64724,53,45753,53,336,110,226,2,30,1,1
57009,53,27487,53,1435,98,1337,4,34,2,2
37613,443,61713,443,10042,3117,6925,28,47,16,12
49904,80,22359,80,1647,508,1139,8,138,5,3
49615,53,49539,53,199,102,97,2,30,1,1
52850,443,50911,443,4982,3414,1568,19,362,9,10
56529,443,43021,443,266757,6935,259822,274,19,97,177
49240,53,11212,53,199,102,97,2,29,1,1
56940,53,28824,53,200,102,98,2,30,1,1
50662,443,7273,443,4606,3263,1343,19,304,10,9
37526,443,48276,443,10637,4761,5876,30,145,17,13
54792,443,48996,443,9515,2231,7284,25,22,14,11
53527,443,25088,443,127391,26326,101065,179,172,76,103
55284,53,36720,53,193,102,91,2,29,1,1
63473,443,25564,443,4490,1234,3256,20,122,9,11
51688,47961,35098,47961,66,66,0,1,5,1,0
52064,443,64308,443,9003,2598,6405,33,345,15,18
64935,53,55369,53,198,102,96,2,30,1,1
54214,443,38557,443,499,425,74,4,0,3,1
60476,55100,33461,55100,70,70,0,1,5,1,0
53621,443,63130,443,2005,1100,905,16,17,9,7
60068,443,63784,443,10192,5090,5102,43,15,24,19
52174,43106,3385,43106,160,70,90,2,8,1,1
56195,53,13348,53,194,94,100,2,30,1,1
64555,53,23004,53,297,102,195,4,48,2,2
62995,3389,62995,3389,4213,2429,1784,18,32,9,9
57255,443,56046,443,36865,3692,33173,61,47,30,31
123,123,55557,123,184,94,90,2,29,1,1
62705,443,33676,443,178,118,60,2,15,1,1
52096,55854,62191,55854,70,70,0,1,5,1,0
53634,443,2193,443,2005,1100,905,16,17,9,7
32645,53,32645,53,404,259,145,3,33,2,1
33849,53,34954,53,336,231,105,3,30,2,1
53547,27759,47610,27759,684,432,252,10,16,6,4
51176,53,44581,53,236,86,150,2,30,1,1
27005,27015,6059,27015,881,126,755,2,30,1,1
57142,53,22612,53,165,86,79,2,31,1,1
65476,53,44080,53,226,110,116,2,29,1,1
55841,443,33701,443,9333,2019,7314,41,255,19,22
37135,443,52476,443,16921,7469,9452,40,138,19,21
57829,443,7967,443,981499,39775,941724,1109,291,439,670
65478,443,30120,443,92279,4799,87480,107,16,43,64
35341,443,55051,443,1473,988,485,12,26,7,5
49704,80,31664,80,217502,6597,210905,211,109,62,149
60370,80,40899,80,1243,769,474,9,123,6,3
56023,53,18673,53,195,102,93,2,30,1,1
57470,24451,64687,24451,166,166,0,1,1200,1,0
56658,443,31194,443,8007,1987,6020,20,15,11,9
0,0,0,0,124,64,60,2,0,1,1
49892,53,17000,53,525,110,415,4,43,2,2
27005,1106,25259,1106,903,126,777,2,29,1,1
60767,443,60767,443,2406,1218,1188,21,16,11,10
60709,443,60709,443,1092,645,447,10,34,6,4
64029,53,40003,53,180,94,86,2,30,1,1
53737,51456,15956,51456,70,70,0,2,8,2,0
63683,20299,57737,20299,502,380,122,7,19,5,2
53132,443,53588,443,7271,2540,4731,32,20,18,14
50745,80,27446,80,2977,680,2297,11,161,6,5
64376,53,46569,53,247,94,153,2,30,1,1
50673,443,61982,443,14723,2606,12117,54,19,22,32
56094,53,60857,53,764,99,665,2,31,1,1
53715,62348,45392,62348,672,306,366,11,14,5,6
38535,443,55811,443,910,358,552,14,47,6,8
57083,53,56856,53,755,94,661,2,31,1,1
56793,53,56695,53,192,98,94,2,0,1,1
50587,80,51672,80,378,192,186,7,20,4,3
49546,53,57576,53,208,106,102,2,31,1,1
50384,443,60892,443,7723,2591,5132,23,49,12,11
49044,443,55687,443,5150,853,4297,16,27,9,7
51823,15843,53132,15843,66,66,0,2,9,2,0
37965,33622,23125,33622,132,132,0,3,1199,3,0
57305,443,15646,443,1574,1089,485,13,15,8,5
55461,53,35895,53,198,110,88,2,30,1,1
65244,53,54645,53,177,94,83,2,30,1,1
65102,53,16634,53,210,102,108,2,30,1,1
64212,53,41326,53,215,102,113,2,30,1,1
65477,53,50858,53,209,110,99,2,30,1,1
19557,53,19557,53,194,87,107,2,30,1,1
56586,53,32780,53,177,94,83,2,31,1,1
55594,53,11300,53,753,96,657,2,31,1,1
53238,443,11082,443,27650,12347,15303,47,53,24,23
56293,53,53658,53,166,86,80,2,30,1,1
10101,443,13897,443,7563,1536,6027,26,316,14,12
53660,443,62189,443,2955,864,2091,11,119,5,6
55318,53,32183,53,167,86,81,2,31,1,1
60453,24369,18318,24369,70,70,0,1,5,1,0
53763,443,53593,443,499,425,74,4,0,3,1
50656,80,17387,80,318,192,126,6,25,4,2
53088,443,43774,443,161938,137946,23992,412,384,227,185
44993,53,47761,53,168,78,90,2,30,1,1
64877,53,24531,53,309,110,199,2,30,1,1
46087,123,1853,123,184,94,90,2,30,1,1
5588,5588,0,0,3562,1936,1626,48,195,24,24
64381,53,26257,53,198,102,96,2,30,1,1
51952,50967,20758,50967,70,70,0,1,5,1,0
50578,80,35081,80,367162,17367,349795,470,143,214,256
49412,53,45661,53,761,102,659,2,29,1,1
49913,53,6290,53,216,110,106,2,30,1,1
56919,53,21784,53,177,94,83,2,29,1,1
49396,53,24683,53,170,87,83,2,30,1,1
49981,53,44663,53,360,102,258,2,30,1,1
56200,53,9546,53,206,105,101,2,30,1,1
56063,53,23721,53,196,102,94,2,31,1,1
40988,80,28753,80,19112,2192,16920,46,90,23,23
27005,27016,31585,27016,876,126,750,2,30,1,1
50920,443,55566,443,6273,1375,4898,18,127,9,9
56088,53,23327,53,256,93,163,2,31,1,1
54816,443,23557,443,130,70,60,3,4,2,1
52163,443,4704,443,4187,773,3414,16,30,9,7
55697,53,39982,53,186,95,91,2,31,1,1
64811,53,21833,53,193,102,91,2,30,1,1
60505,53,0,0,340,90,250,2,31,1,1
49933,53,13874,53,186,102,84,2,30,1,1
9307,443,6375,443,4458,1022,3436,16,26,9,7
27005,27015,40148,27015,886,126,760,2,31,1,1
27739,7000,27739,7000,2163,676,1487,14,15,7,7
64073,53,23568,53,199,102,97,2,30,1,1
10151,38030,53424,38030,481,150,331,2,1200,1,1
49558,443,48351,443,12704,3459,9245,50,1336,18,32
58993,443,47340,443,6414,1614,4800,24,17,13,11
51550,53,60452,53,168,78,90,2,30,1,1
57600,80,57600,80,3164,815,2349,12,144,6,6
59005,443,56215,443,6306,1780,4526,28,33,14,14
55071,53,10472,53,170,87,83,2,31,1,1
55754,53,55090,53,199,102,97,2,30,1,1
49728,443,36312,443,5037,1135,3902,16,18,9,7
49902,443,36938,443,109400,8787,100613,159,81,78,81
61422,443,38584,443,8360,1781,6579,23,77,12,11
49498,53,33432,53,211,102,109,2,30,1,1
56365,53,14208,53,199,102,97,2,30,1,1
61698,80,14302,80,7712,4248,3464,23,51,12,11
51833,47388,62543,47388,70,70,0,1,5,1,0
53856,443,18832,443,495,421,74,4,0,3,1
51774,80,22011,80,240,120,120,5,27,3,2
55216,53,52646,53,179,94,85,2,30,1,1
56486,443,16895,443,2673671,30446,2643225,2145,125,234,1911
59882,443,38875,443,10017,3031,6986,30,45,17,13
59570,443,54074,443,6713,3052,3661,49,5974,15,34
60469,53,22418,53,78,78,0,1,30,1,0
64728,443,31234,443,25423484,377367,25046117,21027,1082,2865,18162
55656,53,48878,53,212,108,104,2,31,1,1
50600,80,53751,80,1658,1247,411,8,15,5,3
56366,443,31914,443,3715,1791,1924,23,203,12,11
9249,443,2759,443,6132,767,5365,17,26,9,8
62995,53,21772,53,102,102,0,1,30,1,0
6881,30279,63096,30279,150,150,0,1,1200,1,0
43032,443,42506,443,2940,1721,1219,17,361,9,8
50723,80,33475,80,1546,1109,437,7,15,5,2
55729,63805,38910,63805,70,70,0,2,8,2,0
50523,53,17417,53,199,102,97,2,30,1,1
51771,80,34714,80,76066,3663,72403,92,24,40,52
40800,443,27923,443,19403,4043,15360,36,48,19,17
59637,53,37515,53,273,94,179,2,30,1,1
53140,80,7682,80,9602,814,8788,19,129,10,9
43223,443,31934,443,836939,25380,811559,864,64,302,562
48817,51413,48817,51413,460,150,310,2,1200,1,1
55584,53,28071,53,177,94,83,2,30,1,1
64407,53,28727,53,291,94,197,2,30,1,1
50022,53,19595,53,182,94,88,2,30,1,1
52716,443,35091,443,69951,4941,65010,95,351,45,50
56644,443,57838,443,7862,1873,5989,20,15,11,9
32578,443,32578,443,25033,2433,22600,42,25,21,21
51448,80,39374,80,214,140,74,4,15,3,1
56935,53,38764,53,179,94,85,2,30,1,1
52713,443,22767,443,26235,2216,24019,39,318,17,22
48831,443,51436,443,10129,5016,5113,18,120,9,9
59516,443,21075,443,9943,1882,8061,32,33,15,17
57318,53,50520,53,418,88,330,4,41,2,2
6881,13929,23344,13929,502,150,352,2,1200,1,1
37330,53,37330,53,237,91,146,2,31,1,1
6881,33969,15980,33969,509,150,359,2,1200,1,1
52003,80,22055,80,16479,1820,14659,31,26,17,14
49741,53,17465,53,177,94,83,2,30,1,1
51378,3027,51378,3027,156,156,0,3,8,3,0
13699,53,13699,53,194,87,107,2,30,1,1
50181,80,60161,80,2149,1165,984,15,77,8,7
46232,53,46232,53,216,90,126,2,30,1,1
49328,53,46932,53,748,94,654,2,30,1,1
56612,53,25011,53,274,87,187,4,31,2,2
37664,443,11325,443,3338,2337,1001,18,45,11,7
53769,443,28627,443,499,425,74,4,0,3,1
65313,53,7915,53,166,86,80,2,30,1,1
54225,443,6300,443,499,425,74,4,0,3,1
53528,20485,38765,20485,70,70,0,2,7,2,0
64956,53,29274,53,196,102,94,2,30,1,1
58732,443,10734,443,1038,502,536,16,33,8,8
58869,443,7982,443,4052,2588,1464,18,16,9,9
51975,11998,29831,11998,66,66,0,1,5,1,0
49418,27015,26438,27015,78,78,0,1,30,1,0
49840,53,47224,53,463,87,376,4,38,2,2
65298,53,43096,53,246,102,144,2,30,1,1
55795,53,49814,53,177,94,83,2,30,1,1
47034,443,4001,443,4531,3268,1263,23,27,13,10
64235,53,36798,53,194,99,95,2,30,1,1
65377,443,4212,443,4864,2496,2368,33,121,17,16
53878,55950,30797,55950,70,70,0,1,5,1,0
46770,80,34528,80,2068,1371,697,13,83,7,6
49363,53,12270,53,208,106,102,2,30,1,1
56986,53,63697,53,177,94,83,2,30,1,1
5176,53,35292,53,86,86,0,1,30,1,0
49433,53,5828,53,167,86,81,2,29,1,1
37637,53,37222,53,168,78,90,2,30,1,1
49745,53,63902,53,1472,98,1374,4,54,2,2
64266,53,14538,53,255,102,153,2,30,1,1
49235,53,6024,53,164,86,78,2,31,1,1
56369,53,59261,53,193,102,91,2,29,1,1
65206,53,37251,53,193,102,91,2,30,1,1
45341,443,7736,443,2754,1394,1360,22,36,11,11
56496,53,41605,53,193,102,91,2,30,1,1
44052,80,38453,80,282,60,222,5,12,2,3
50581,53,22242,53,177,94,83,2,30,1,1
40404,443,18265,443,280,140,140,5,130,3,2
56040,53,54233,53,761,100,661,2,30,1,1
41981,80,51523,80,1556,1236,320,10,15,5,5
50907,443,12062,443,124,64,60,2,15,1,1
65487,53,56832,53,210,110,100,2,30,1,1
57626,443,3957,443,3858,1277,2581,12,120,6,6
56351,53,53304,53,195,102,93,2,33,1,1
55377,53,19699,53,1428,103,1325,4,32,2,2
51861,23919,4159,23919,70,70,0,1,5,1,0
49863,443,52855,443,7280,1441,5839,17,89,9,8
64941,53,8617,53,199,102,97,2,30,1,1
53731,443,61889,443,499,425,74,4,0,3,1
60474,443,49891,443,5888,1175,4713,19,76,11,8
57265,443,12728,443,9633,4368,5265,32,71,18,14
57334,53,51470,53,184,94,90,2,29,1,1
52539,80,47321,80,1152,712,440,10,15,5,5
65229,53,47918,53,195,102,93,2,30,1,1
37579,443,43995,443,499,425,74,4,0,3,1
64758,443,35347,443,5066,2558,2508,26,127,13,13
57025,53,3380,53,168,86,82,2,31,1,1
54079,443,33342,443,1050267,44816,1005451,1276,177,580,696
55195,443,41833,443,907774,32911,874863,898,460,195,703
52040,53,52040,53,251,98,153,2,31,1,1
37116,80,37116,80,2971,1509,1462,10,15,6,4
55667,19667,52444,19667,70,70,0,2,8,2,0
55928,443,33892,443,5433,3275,2158,16,135,8,8
50002,53,11892,53,196,102,94,2,31,1,1
53869,17089,38908,17089,70,70,0,1,4,1,0
51911,14543,57115,14543,70,70,0,2,8,2,0
55704,53,11582,53,260,102,158,2,30,1,1
57038,53,18190,53,240,86,154,2,30,1,1
50069,53,45809,53,764,102,662,2,29,1,1
50478,443,64929,443,36345,2308,34037,52,83,23,29
55865,53,14766,53,325,98,227,4,40,2,2
49508,53,13388,53,199,102,97,2,30,1,1
53113,8372,13040,8372,758,320,438,11,17,6,5
64120,443,47176,443,3767437,87322,3680115,3675,52,1230,2445
34319,443,65277,443,15358,11148,4210,93,423,51,42
53806,37267,20623,37267,70,70,0,1,4,1,0
55285,53,1660,53,268,95,173,4,45,2,2
60951,443,8364,443,11464,5499,5965,54,15,29,25
58760,443,37477,443,5927,794,5133,17,25,8,9
54472,443,49806,443,6732,2308,4424,21,141,9,12
55618,45341,55864,45341,70,70,0,2,8,2,0
56938,53,41054,53,198,101,97,2,30,1,1
44682,443,42842,443,2750,1891,859,17,25,10,7
51963,21638,43079,21638,70,70,0,1,5,1,0
25776,53,25776,53,233,90,143,2,32,1,1
1100,27540,42086,27540,132,70,62,2,29,1,1
27005,27017,57092,27017,900,126,774,2,30,1,1
60355,443,30669,443,5341,2434,2907,19,135,9,10
49668,53,59883,53,200,94,106,2,29,1,1
53126,443,9290,443,5604,2738,2866,20,325,10,10
56804,33375,39167,33375,70,70,0,2,8,2,0
64986,53,17110,53,183,94,89,2,31,1,1
56646,80,51204,80,234,234,0,4,12,4,0
49531,443,58024,443,8107,2474,5633,24,25,12,12
64181,53,18587,53,194,102,92,2,31,1,1
51100,443,10929,443,9429,1978,7451,27,46,14,13
55999,443,53262,443,45632,2078,43554,58,120,22,36
57185,53,50357,53,784,94,690,2,30,1,1
51982,443,54748,443,9010,2779,6231,30,361,15,15
32805,443,65246,443,438124,21529,416595,481,398,138,343
52781,443,23345,443,1581,924,657,15,125,7,8
49795,443,22996,443,7243,777,6466,17,126,8,9
55032,443,19722,443,8965,3021,5944,39,360,22,17
49564,53,46836,53,186,95,91,2,31,1,1
55056,80,55056,80,2959,1505,1454,10,16,6,4
56628,443,13354,443,8240,3521,4719,25,18,15,10
65469,53,36424,53,308,110,198,2,30,1,1
56594,53,29926,53,788,108,680,2,30,1,1
55077,53,1629,53,174,89,85,2,31,1,1
52898,80,52898,80,1916,1467,449,10,19,6,4
57470,55000,8797,55000,726,726,0,12,1200,12,0
59928,80,12349,80,5755,3943,1812,24,31,13,11
56871,53,27631,53,198,86,112,2,30,1,1
47330,443,38110,443,9297,2727,6570,27,80,15,12
49665,80,5154,80,2237,508,1729,10,125,6,4
49354,443,56660,443,4379,2565,1814,24,81,11,13
53577,8999,47694,8999,372,186,186,6,15,3,3
56756,443,1855,443,7565,2187,5378,27,24,15,12
56562,53,8442,53,726,85,641,2,30,1,1
62329,53,9486,53,268,86,182,2,30,1,1
36471,443,15597,443,83203,3599,79604,101,138,41,60
27005,27016,20035,27016,903,126,777,2,31,1,1
55039,443,64407,443,10961,2666,8295,35,237,16,19
5588,5588,0,0,3354,1792,1562,46,194,23,23
50872,80,50084,80,54441,4387,50054,75,140,37,38
50471,80,51148,80,1658,1247,411,8,15,5,3
0,0,0,0,480,244,236,4,0,2,2
52786,443,4838,443,9032,2673,6359,30,142,16,14
62071,443,12103,443,134,60,74,3,4,2,1
55057,53,26203,53,211,110,101,2,30,1,1
61631,443,61631,443,4748,1841,2907,19,26,11,8
53438,443,53438,443,2511,1465,1046,21,102,10,11
40238,443,22315,443,7283,2384,4899,25,361,12,13
65070,53,45301,53,821,102,719,2,30,1,1
56747,42333,2469,42333,66,66,0,1,5,1,0
55101,53,1606,53,197,102,95,2,30,1,1
49446,53,1735,53,403,142,261,2,30,1,1
51883,16325,58501,16325,316,136,180,6,6,3,3
46617,53,46617,53,213,87,126,2,30,1,1
63093,443,45246,443,304,86,218,2,30,1,1
57416,53,52623,53,186,95,91,2,30,1,1
9193,443,3894,443,5043,432,4611,12,16,6,6
35112,443,57886,443,3242,1248,1994,26,362,7,19
49839,53,21176,53,315,102,213,2,30,1,1
57371,443,2707,443,5619,927,4692,17,15,10,7
56644,443,7171,443,12924,3689,9235,31,82,17,14
49645,80,12574,80,318,192,126,6,41,4,2
65113,53,56187,53,232,102,130,2,29,1,1
53682,20884,50647,20884,70,70,0,1,4,1,0
46009,53,4263,53,199,94,105,2,30,1,1
51903,35904,40844,35904,70,70,0,1,5,1,0
51798,37020,7892,37020,70,70,0,1,5,1,0
1928,53,30597,53,210,78,132,2,29,1,1
58761,443,45887,443,318,192,126,6,26,4,2
50349,443,62395,443,1385,868,517,12,30,6,6
49352,443,51520,443,10055,1184,8871,21,76,9,12
43918,5228,35546,5228,2276,1356,920,15,3601,7,8
55695,53,46724,53,209,102,107,2,30,1,1
53904,1024,55644,1024,70,70,0,1,4,1,0
54307,443,65534,443,5661,1444,4217,19,135,11,8
19037,53,19037,53,227,89,138,2,31,1,1
56617,3389,56617,3389,3425,1470,1955,16,17,8,8
56649,443,46574,443,4628,1035,3593,19,25,11,8
39133,5223,14877,5223,4113,1213,2900,22,713,12,10
54627,80,54627,80,12385,1831,10554,20,20,9,11
61281,443,15563,443,3169,979,2190,14,135,7,7
49839,443,44506,443,7021,1767,5254,26,224,13,13
63018,53,50611,53,384,166,218,2,29,1,1
60868,443,49136,443,9660,2402,7258,27,46,15,12
53557,39731,46000,39731,70,70,0,2,8,2,0
57242,53,53275,53,184,86,98,2,29,1,1
53846,443,62098,443,499,425,74,4,0,3,1
49812,53,36103,53,1411,98,1313,4,52,2,2
63366,30365,36289,30365,70,70,0,1,4,1,0
49418,27080,21881,27080,238,78,160,2,30,1,1
51734,59825,40402,59825,70,70,0,2,8,2,0
8949,53,8949,53,832,106,726,2,30,1,1
54330,443,28162,443,7329,3011,4318,30,127,14,16
58177,443,64098,443,810,340,470,13,34,6,7
34990,80,36946,80,1534,996,538,10,35,6,4
57349,53,0,0,222,86,136,2,30,1,1
57096,53,45247,53,198,102,96,2,30,1,1
63592,443,55191,443,6485,1871,4614,27,140,14,13
57321,53,25115,53,498,204,294,6,29,3,3
50695,80,16857,80,1426,865,561,9,15,5,4
43910,443,49945,443,10506,2984,7522,30,15,17,13
55267,53,45498,53,168,78,90,2,29,1,1
45627,443,47069,443,7092,1883,5209,21,21,12,9
37433,443,8364,443,8641,955,7686,19,259,8,11
56924,53,46939,53,177,94,83,2,30,1,1
27005,27016,64097,27016,880,126,754,2,30,1,1
9130,80,10198,80,318,192,126,6,30,4,2
55384,53,24803,53,194,102,92,2,30,1,1
49656,443,4978,443,182624,7130,175494,212,132,77,135
55454,53,60200,53,202,103,99,2,31,1,1
51221,9869,40891,9869,870,330,540,12,1298,6,6
52093,443,48994,443,3687037,41923,3645114,3002,34,534,2468
65189,53,20195,53,176,90,86,2,31,1,1
59877,443,61626,443,9024,1533,7491,25,110,11,14
60346,53,60346,53,241,98,143,2,30,1,1
49743,53,1715,53,210,94,116,2,30,1,1
56320,53,53678,53,183,94,89,2,30,1,1
6666,21,6666,21,66,66,0,1,5,1,0
10010,40029,17242,40029,148,86,62,2,29,1,1
55261,53,37106,53,177,94,83,2,30,1,1
52096,443,13873,443,4747,3601,1146,18,15,10,8
53705,443,11151,443,499,425,74,4,0,3,1
56645,443,46847,443,7914,1925,5989,20,15,11,9
58638,5900,58638,5900,66,66,0,1,4,1,0
65468,443,32669,443,421329,12430,408899,433,16,152,281
65319,53,30506,53,285,103,182,4,44,2,2
65115,53,32763,53,167,86,81,2,30,1,1
36886,443,32940,443,2907,1637,1270,20,364,11,9
65220,53,61957,53,811,94,717,2,30,1,1
53505,8102,48744,8102,1495,843,652,10,30,5,5
48286,443,48286,443,4621,1714,2907,19,26,11,8
65029,53,39227,53,214,102,112,2,29,1,1
59902,443,47216,443,6196,746,5450,17,28,8,9
56662,443,60423,443,1233,730,503,12,25,7,5
56565,53,34463,53,164,86,78,2,30,1,1
57749,15000,61462,15000,130,70,60,2,6,1,1
55214,53,41945,53,711,87,624,2,31,1,1
58638,5900,58638,5900,66,66,0,1,4,1,0
56520,53,53336,53,177,94,83,2,31,1,1
49159,53,5839,53,195,86,109,2,30,1,1
58911,443,55607,443,5168,700,4468,16,16,7,9
65316,53,63877,53,780,93,687,2,30,1,1
58856,443,44646,443,4552,2750,1802,27,95,15,12
61406,443,61406,443,4529,1622,2907,19,27,11,8
50493,443,36062,443,2147464,35144,2112320,1951,72,540,1411
64789,53,51641,53,199,102,97,2,30,1,1
49676,53,9085,53,200,94,106,2,30,1,1
40599,443,12842,443,89724,81316,8408,148,404,69,79
59894,443,37643,443,1537,934,603,14,33,7,7
57470,51413,19647,51413,740725,699740,40985,1031,1411,616,415
49972,53,55153,53,216,110,106,2,30,1,1
56740,443,56740,443,41851,2810,39041,66,45,31,35
47504,443,4278,443,6496,3631,2865,71,606,39,32
33367,80,33367,80,424,198,226,7,141,4,3
54248,443,24435,443,499,425,74,4,0,3,1
55525,53,40797,53,210,102,108,2,30,1,1
14429,443,41458,443,4118,2905,1213,27,87,16,11
56366,443,56718,443,7234,4345,2889,27,235,15,12
49827,443,50182,443,5863,1580,4283,17,15,9,8
50481,443,29111,443,16160,13969,2191,42,80,23,19
51535,443,24359,443,322,262,60,2,4,1,1
57341,53,40485,53,296,97,199,4,41,2,2
40329,80,42227,80,2128,798,1330,14,46,7,7
49936,53,12720,53,754,94,660,2,30,1,1
64396,53,1161,53,211,102,109,2,30,1,1
56009,53,46044,53,178,94,84,2,30,1,1
49418,53,2882,53,165,86,79,2,30,1,1
49355,53,58716,53,193,102,91,2,29,1,1
49899,7000,49899,7000,758568,17631,740937,772,17,269,503
49949,53,15582,53,193,102,91,2,30,1,1
43776,7000,43776,7000,3174,1617,1557,17,18,9,8
37786,443,52361,443,5544,2626,2918,28,145,15,13
56006,53,22097,53,200,102,98,2,30,1,1
57438,53,26523,53,340,110,230,2,29,1,1
55034,443,13403,443,7969,4870,3099,36,360,20,16
63062,53,18913,53,70,70,0,1,30,1,0
51927,63309,55046,63309,70,70,0,2,8,2,0
59982,443,64265,443,7693,1284,6409,24,81,12,12
50472,80,63342,80,12222,3865,8357,23,22,11,12
57356,53,43032,53,780,93,687,2,30,1,1
50582,53,14787,53,216,110,106,2,30,1,1
64567,443,55637,443,272081,11032,261049,304,139,107,197
50332,53,12740,53,193,102,91,2,29,1,1
0,0,0,0,320,320,0,5,0,5,0
54008,443,44994,443,4249,724,3525,13,15,7,6
49567,443,55321,443,6408,2531,3877,21,15,11,10
53166,39564,63800,39564,70,70,0,1,5,1,0
41813,443,58792,443,33072,3479,29593,71,98,38,33
63672,53,63672,53,198,90,108,2,30,1,1
55619,53,46483,53,183,94,89,2,30,1,1
27005,50019,16642,50019,877,126,751,2,30,1,1
57470,50321,46751,50321,538,166,372,2,1199,1,1
42156,80,50916,80,1323,335,988,10,15,5,5
55921,443,24781,443,4348,1536,2812,14,121,6,8
49954,53,40035,53,211,102,109,2,31,1,1
57167,53,27604,53,195,102,93,2,30,1,1
48786,80,30638,80,1834,1520,314,14,15,9,5
58346,443,42517,443,5571,1518,4053,22,614,13,9
32971,443,32971,443,18895,2061,16834,34,17,18,16
27005,27333,40989,27333,890,126,764,2,30,1,1
60914,53,60914,53,180,82,98,2,29,1,1
63033,443,16495,443,6869,3059,3810,30,123,15,15
49418,30000,55086,30000,280,78,202,2,30,1,1
65389,53,2887,53,215,102,113,2,30,1,1
57406,53,8433,53,194,102,92,2,31,1,1
49341,53,42621,53,198,101,97,2,30,1,1
58263,443,17697,443,12494,5331,7163,48,122,21,27
59955,25,59955,25,1656,677,979,21,16,10,11
55706,53,23729,53,209,110,99,2,30,1,1
41592,443,47156,443,2913,1752,1161,15,15,9,6
51775,57887,37993,57887,66,66,0,1,5,1,0
56773,53,53330,53,183,94,89,2,29,1,1
57610,443,60687,443,4327,674,3653,14,25,8,6
49509,443,19603,443,4091,1015,3076,15,27,8,7
54023,443,2526,443,7653,1188,6465,21,16,12,9
29268,53,40863,53,220,78,142,2,30,1,1
65007,53,49517,53,330,94,236,4,55,2,2
27005,12345,8943,12345,898,126,772,2,31,1,1
49418,27015,40733,27015,242,78,164,2,30,1,1
59893,80,45322,80,130,70,60,2,15,1,1
58186,443,61282,443,5086,3296,1790,36,56,18,18
61286,443,41653,443,248071,7320,240751,269,268,89,180
49686,53,55592,53,183,94,89,2,30,1,1
59242,443,7294,443,7192,2002,5190,24,360,11,13
49631,53,37899,53,184,102,82,2,30,1,1
55382,53,44759,53,738,86,652,2,31,1,1
49272,53,2689,53,198,102,96,2,29,1,1
49575,80,43723,80,318,192,126,6,43,4,2
55748,53,59262,53,188,96,92,2,31,1,1
56838,53,39774,53,177,94,83,2,30,1,1
52323,443,4848,443,454059,23387,430672,602,76,275,327
53745,443,56954,443,499,425,74,4,0,3,1
26900,27017,38519,27017,422,164,258,6,30,3,3
36993,443,63240,443,7768,3071,4697,23,17,12,11
32813,53,32813,53,414,268,146,3,33,2,1
50134,53,12196,53,768,99,669,2,30,1,1
55913,53,19739,53,177,94,83,2,30,1,1
57366,53,63370,53,745,93,652,2,31,1,1
61707,80,47062,80,134,60,74,3,4,2,1
45237,53,45237,53,235,90,145,2,33,1,1
57363,53,3624,53,193,102,91,2,30,1,1
2267,53,13184,53,826,826,0,8,44,8,0
51794,53911,18093,53911,70,70,0,1,5,1,0
54246,80,56298,80,506,292,214,8,16,5,3
55372,53,41205,53,271,93,178,4,43,2,2
44383,443,25298,443,14780,11289,3491,59,219,32,27
65516,53,16518,53,209,110,99,2,31,1,1
64093,64828,28561,64828,66,66,0,2,7,2,0
57790,443,14547,443,6321,3341,2980,19,135,9,10
49826,443,11659,443,6105,852,5253,17,77,9,8
65503,53,29061,53,177,94,83,2,30,1,1
51432,80,62424,80,1675,539,1136,8,178,5,3
56114,53,31669,53,194,86,108,2,30,1,1
59259,80,59259,80,101244,15308,85936,165,15,53,112
37075,80,59950,80,1597,783,814,10,15,5,5
51808,46390,34181,46390,70,70,0,1,4,1,0
37460,443,55415,443,2885,1732,1153,16,256,9,7
34179,80,3058,80,2137,1258,879,11,150,6,5
50934,80,52977,80,10213447,100765,10112682,8215,121,1412,6803
61527,443,62594,443,17161,1619,15542,18,143,4,14
55258,443,6481,443,1786,172,1614,7,120,3,4
59422,53,43330,53,168,78,90,2,30,1,1
55058,53,43398,53,216,110,106,2,31,1,1
50379,443,5364,443,6748,1843,4905,21,29,11,10
64063,37832,22712,37832,70,70,0,1,4,1,0
53512,23280,49318,23280,1950,957,993,17,17,10,7
57127,53,41259,53,195,102,93,2,30,1,1
57147,53,3974,53,166,86,80,2,31,1,1
64074,53,3754,53,202,103,99,2,31,1,1
41047,443,9579,443,6423,744,5679,16,16,9,7
49602,53,1592,53,178,94,84,2,30,1,1
9058,443,18160,443,5655,934,4721,16,130,8,8
53890,23310,38031,23310,70,70,0,1,4,1,0
64790,53,60024,53,178,94,84,2,29,1,1
60447,36396,58005,36396,70,70,0,1,5,1,0
50301,80,40498,80,7979,802,7177,17,39,8,9
64637,53,50285,53,188,96,92,2,30,1,1
63074,443,53301,443,384,166,218,2,29,1,1
50383,443,21192,443,452,386,66,4,1,3,1
25309,53,25309,53,371,237,134,3,33,2,1
64154,53,35293,53,194,102,92,2,29,1,1
49665,53,61260,53,361,118,243,4,33,2,2
59219,80,51900,80,1658,1344,314,10,15,5,5
57137,53,36481,53,279,96,183,4,31,2,2
49982,53,15818,53,322,94,228,4,49,2,2
35608,443,39608,443,5007,3053,1954,24,394,8,16
54355,443,13555,443,15334,4707,10627,28,24,14,14
53152,443,44569,443,16706,6162,10544,39,29,19,20
61229,443,47952,443,12708,2798,9910,36,258,13,23
59442,53,59442,53,235,90,145,2,33,1,1
56219,53,57925,53,177,94,83,2,30,1,1
53580,48066,12026,48066,70,70,0,1,5,1,0
52200,42430,1127,42430,70,70,0,1,5,1,0
64850,53,36878,53,196,102,94,2,31,1,1
56993,53,24692,53,184,102,82,2,29,1,1
62924,993,52929,993,9376,4359,5017,86,19,44,42
52230,47803,46448,47803,136,136,0,3,14,3,0
54130,53,45665,53,168,78,90,2,30,1,1
36998,80,39862,80,130,70,60,2,15,1,1
49532,443,49532,443,20488,16649,3839,30,24,18,12
53236,443,39010,443,41247,1363,39884,51,37,13,38
55744,80,6834,80,5146,3694,1452,20,249,10,10
49350,80,17216,80,2485,529,1956,12,17,6,6
63171,5228,60967,5228,3535,1973,1562,36,3961,18,18
49562,443,58637,443,9908,4692,5216,30,92,16,14
65365,53,21509,53,178,94,84,2,29,1,1
49323,53,40976,53,196,102,94,2,31,1,1
52740,443,65500,443,168753,7954,160799,212,26,95,117
49519,443,20384,443,7086,1913,5173,29,270,16,13
49664,80,19625,80,7561,3181,4380,16,41,8,8
57372,53,20962,53,177,94,83,2,30,1,1
55548,53,25199,53,194,99,95,2,30,1,1
65352,53,63363,53,321,102,219,2,29,1,1
56432,53,34927,53,458,188,270,6,30,3,3
50825,443,30672,443,252960,10277,242683,301,209,119,182
53476,443,9051,443,3182,1568,1614,8,121,4,4
55687,53,59046,53,186,95,91,2,31,1,1
56072,80,56072,80,23248,1600,21648,35,31,17,18
65485,53,20874,53,718,94,624,2,30,1,1
59262,5228,3053,5228,7054,2076,4978,32,5115,11,21
6881,55085,23823,55085,509,150,359,2,1199,1,1
55535,53,57254,53,199,102,97,2,30,1,1
65497,443,27033,443,392197,11800,380397,406,16,143,263
49826,80,54409,80,6311,4340,1971,20,186,12,8
58847,443,48579,443,5167,700,4467,16,15,7,9
64787,53,58679,53,179,94,85,2,29,1,1
55373,53,47253,53,164,86,78,2,31,1,1
51666,443,12470,443,30210,2106,28104,46,201,17,29
56094,443,60801,443,5616,3106,2510,22,223,13,9
53245,80,62504,80,2071,1305,766,10,256,6,4
64194,53,10058,53,262,126,136,2,30,1,1
65413,53,65505,53,266,110,156,2,30,1,1
61338,443,62752,443,39067,7713,31354,74,247,29,45
30960,45743,2927,45743,330,330,0,6,3609,6,0
56192,53,42935,53,177,94,83,2,30,1,1
64279,53,15836,53,170,87,83,2,30,1,1
52247,49278,31090,49278,316,136,180,6,6,3,3
52730,7000,52730,7000,2163,676,1487,14,15,7,7
46439,443,34571,443,8246,1739,6507,21,17,11,10
53641,16605,52302,16605,70,70,0,1,5,1,0
64883,53,13274,53,184,94,90,2,31,1,1
52092,80,44323,80,426,240,186,8,25,5,3
60224,443,54670,443,9079,3570,5509,68,152,34,34
57455,443,26313,443,9124,5296,3828,54,120,29,25
65521,443,8234,443,92427,4519,87908,105,15,39,66
52073,80,46138,80,482,300,182,9,26,6,3
57352,53,35179,53,196,102,94,2,30,1,1
48209,53,48209,53,628,82,546,2,30,1,1
50480,443,52040,443,14848,6716,8132,32,30,17,15
61479,443,17440,443,104543,5227,99316,130,47,57,73
56076,443,18045,443,1786,172,1614,7,120,3,4
57398,443,53104,443,1056,569,487,10,24,6,4
65451,53,9650,53,194,102,92,2,31,1,1
35408,53,57895,53,168,78,90,2,30,1,1
51599,443,24581,443,25546,5284,20262,48,149,26,22
49372,53,37424,53,216,110,106,2,30,1,1
57956,443,29445,443,7842,2164,5678,48,5441,20,28
54367,3389,54367,3389,4365,2581,1784,20,32,11,9
13956,53,13956,53,244,98,146,2,34,1,1
33109,443,18483,443,6749,1593,5156,23,123,12,11
51986,41982,32620,41982,70,70,0,1,5,1,0
51401,443,9077,443,130,70,60,2,4,1,1
55392,53,8146,53,195,102,93,2,30,1,1
56560,53,3085,53,199,102,97,2,30,1,1
38680,443,52567,443,90091,3481,86610,95,15,31,64
48422,53,48422,53,229,89,140,2,30,1,1
55087,53,19901,53,183,94,89,2,31,1,1
64766,53,31618,53,195,102,93,2,29,1,1
58858,443,41294,443,318,192,126,6,26,4,2
49759,53,54195,53,164,84,80,2,31,1,1
52957,80,46330,80,156378,5406,150972,165,383,60,105
50938,53,64544,53,209,81,128,2,30,1,1
37737,443,61948,443,190013,14784,175229,238,206,101,137
62910,993,51747,993,9108,4045,5063,84,72,39,45
63795,52376,52814,52376,70,70,0,1,4,1,0
41389,443,45580,443,280,140,140,5,131,3,2
43897,443,6897,443,6259,1816,4443,30,2615,16,14
55454,53,60300,53,168,86,82,2,33,1,1
64975,53,43514,53,198,94,104,2,30,1,1
55618,45341,56428,45341,70,70,0,1,5,1,0
50076,80,29026,80,26128,9214,16914,81,512,40,41
50579,53,23674,53,179,94,85,2,30,1,1
60435,443,42755,443,38888447,473172,38415275,31568,128,5708,25860
57300,53,21469,53,184,94,90,2,30,1,1
55046,53,20538,53,300,102,198,4,40,2,2
64124,53,27285,53,294,93,201,4,42,2,2
10216,80,10216,80,7548,1586,5962,18,21,8,10
56986,80,18351,80,214,140,74,4,35,3,1
44628,80,44628,80,2898,1485,1413,10,15,6,4
57031,443,21412,443,2963,797,2166,10,120,5,5
59732,443,8520,443,7310,967,6343,18,25,10,8
63675,123,55630,123,184,94,90,2,29,1,1
54101,443,19141,443,4013,2840,1173,23,27,13,10
28592,53,28592,53,216,90,126,2,31,1,1
55069,53,19618,53,195,102,93,2,31,1,1
27005,27015,63024,27015,897,126,771,2,31,1,1
56782,53,60829,53,227,94,133,2,29,1,1
57834,443,16694,443,6214,1733,4481,13,121,6,7
49225,53,32550,53,295,101,194,4,49,2,2
60204,80,20326,80,70,70,0,2,8,2,0
58797,443,26512,443,3311,1069,2242,13,135,6,7
54681,443,46461,443,4417,2187,2230,16,135,8,8
50326,80,17692,80,7979,802,7177,17,47,8,9
62498,443,43471,443,14786,3978,10808,32,26,15,17
49842,443,3993,443,6212,1823,4389,16,75,9,7
55199,443,3846,443,18132,8636,9496,40,176,23,17
57122,53,3566,53,216,110,106,2,30,1,1
56963,53,36385,53,199,102,97,2,30,1,1
50848,80,48215,80,1213557,27203,1186354,1120,133,327,793
56185,443,34268,443,5415,1730,3685,20,120,9,11
55043,53,56264,53,274,110,164,2,30,1,1
39232,53,39232,53,215,80,135,2,32,1,1
55655,53,55322,53,304,110,194,4,34,2,2
38728,443,11034,443,560,280,280,9,27,5,4
42811,80,59018,80,1114,534,580,12,16,7,5
20341,53,20341,53,225,90,135,2,30,1,1
60729,443,20106,443,5737,1929,3808,19,201,11,8
58814,443,65401,443,6508,4230,2278,22,16,12,10
59756,53,64652,53,571,166,405,2,29,1,1
61412,53,24202,53,225,78,147,2,30,1,1
56560,53,17987,53,199,102,97,2,30,1,1
56303,53,63690,53,177,94,83,2,29,1,1
57117,53,8258,53,209,102,107,2,31,1,1
41958,5222,34545,5222,2380,1500,880,24,130,13,11
56327,53,60019,53,199,102,97,2,30,1,1
55152,53,27991,53,176,90,86,2,30,1,1
49497,443,3660,443,8816,4876,3940,23,31,12,11
64642,53,40634,53,265,94,171,2,30,1,1
50843,443,54645,443,6337,1378,4959,19,135,9,10
56215,53,24448,53,216,110,106,2,30,1,1
42479,80,8740,80,696,413,283,7,15,5,2
47042,80,50684,80,1122,682,440,11,15,6,5
49837,53,16345,53,214,110,104,2,30,1,1
53107,44060,27368,44060,70,70,0,1,5,1,0
64537,443,9854,443,3182,1568,1614,8,120,4,4
55094,53,26727,53,754,94,660,2,31,1,1
52618,80,60049,80,1141,529,612,10,18,6,4
52136,42939,50885,42939,70,70,0,2,8,2,0
50645,443,5664,443,1514,852,662,16,86,9,7
57395,53,14755,53,262,88,174,4,59,2,2
65002,27064,63916,27064,735,462,273,2,30,1,1
50589,80,50589,80,1714,1014,700,11,21,6,5
50949,443,50949,443,4453,1546,2907,19,29,11,8
9520,443,43478,443,3614,434,3180,11,15,6,5
64987,53,43588,53,198,102,96,2,30,1,1
39888,53,65133,53,168,78,90,2,30,1,1
51937,38056,36648,38056,70,70,0,2,8,2,0
36701,53,35437,53,199,94,105,2,30,1,1
65284,53,18214,53,758,96,662,2,31,1,1
44949,443,16538,443,4093,2830,1263,21,24,11,10
17176,443,17176,443,6311,1229,5082,18,16,8,10
55401,53,40210,53,168,86,82,2,31,1,1
53771,53,15804,53,168,78,90,2,30,1,1
60383,16881,9133,16881,564,318,246,9,18,5,4
54962,53,15807,53,194,102,92,2,30,1,1
58745,443,47699,443,14654,9694,4960,36,17,19,17
65445,53,12722,53,254,102,152,2,30,1,1
34418,443,25762,443,6402,1595,4807,23,316,12,11
56878,53,24786,53,168,86,82,2,31,1,1
59839,443,29303,443,93467,4007,89460,107,22,33,74
57106,53,23546,53,214,94,120,2,29,1,1
64238,53,6347,53,215,102,113,2,30,1,1
47823,443,63568,443,9842,2224,7618,20,122,10,10
51511,443,55401,443,213140,10321,202819,260,33,108,152
56030,53,56239,53,815,95,720,2,31,1,1
65291,53,61483,53,190,97,93,2,31,1,1
63999,53,43877,53,186,95,91,2,30,1,1
50523,53,12561,53,168,86,82,2,29,1,1
55021,53,26465,53,94,94,0,1,30,1,0
49520,53,1147,53,209,110,99,2,30,1,1
27005,27018,28436,27018,895,126,769,2,31,1,1
39762,123,46956,123,184,94,90,2,30,1,1
50584,58516,43586,58516,161,161,0,1,1200,1,0
55745,53,9375,53,199,102,97,2,29,1,1
36762,443,56086,443,13119,3359,9760,39,120,19,20
38759,443,29453,443,8057,2726,5331,27,239,13,14
36986,53,36986,53,234,93,141,2,31,1,1
24009,53,24009,53,825,99,726,2,30,1,1
49586,53,25001,53,212,94,118,2,29,1,1
50894,80,58930,80,5900,751,5149,15,130,7,8
53538,33791,33383,33791,618,432,186,9,17,6,3
63366,30365,45991,30365,738,318,420,12,163,5,7
55911,53,35640,53,211,110,101,2,30,1,1
49812,53,11228,53,166,86,80,2,30,1,1
56337,53,7280,53,268,89,179,4,44,2,2
60474,8999,5230,8999,70,70,0,1,5,1,0
52093,80,65106,80,366,240,126,7,26,5,2
55051,53,44193,53,167,86,81,2,31,1,1
64843,53,27388,53,772,103,669,2,30,1,1
55877,56299,54578,56299,481,150,331,2,1200,1,1
56550,53,64220,53,183,94,89,2,31,1,1
65260,53,28900,53,184,94,90,2,30,1,1
55211,53,36249,53,183,94,89,2,30,1,1
36781,443,37104,443,1798,1223,575,13,26,8,5
55156,53,47092,53,256,87,169,4,36,2,2
56031,53,65070,53,177,94,83,2,30,1,1
56661,53,2934,53,288,93,195,4,32,2,2
58794,443,45135,443,20298,11977,8321,85,139,45,40
50912,443,28892,443,8527,2387,6140,21,31,11,10
55684,53,54861,53,193,102,91,2,31,1,1
49993,53,48809,53,212,102,110,2,30,1,1
56632,80,25180,80,234,234,0,4,12,4,0
64573,53,28615,53,380,110,270,2,30,1,1
51725,32787,46505,32787,70,70,0,1,5,1,0
60521,443,45323,443,45001,3799,41202,74,331,35,39
60409,44739,64818,44739,70,70,0,1,5,1,0
49655,80,10831,80,6485767,147003,6338764,6221,320,2024,4197
49234,53,14008,53,177,94,83,2,30,1,1
64322,53,46298,53,273,90,183,4,32,2,2
57397,53,60967,53,177,94,83,2,30,1,1
49901,443,3004,443,4949,1047,3902,22,33,11,11
55627,26192,18323,26192,70,70,0,1,5,1,0
60422,62456,45228,62456,341,215,126,5,16,3,2
55588,53,19559,53,168,86,82,2,30,1,1
52540,443,62112,443,153,93,60,2,5,1,1
59757,443,13672,443,11663,1141,10522,30,41,14,16
45315,80,28283,80,6087687,127446,5960241,5920,28,1981,3939
43025,443,51895,443,25223,13115,12108,63,116,33,30
64299,53,26079,53,268,84,184,4,42,2,2
50125,443,44397,443,9798,3571,6227,43,143,23,20
64746,53,10441,53,260,86,174,2,30,1,1
49679,80,26556,80,7256,1682,5574,14,40,6,8
50377,53,24974,53,753,94,659,2,30,1,1
49305,53,42044,53,177,94,83,2,30,1,1
49955,80,63565,80,9810,819,8991,19,15,9,10
43210,443,51289,443,5960402,99613,5860789,5017,133,952,4065
64494,53,52141,53,337,110,227,2,29,1,1
55450,443,1835,443,4275,2479,1796,22,316,11,11
55223,53,54493,53,168,86,82,2,31,1,1
49521,80,17385,80,1653,831,822,13,93,7,6
55596,53,49236,53,177,94,83,2,30,1,1
64060,53,33741,53,258,110,148,2,30,1,1
55808,53,32888,53,183,94,89,2,30,1,1
50265,48982,51729,48982,480,149,331,2,1200,1,1
50287,443,51254,443,14559,2721,11838,31,16,17,14
60167,80,41576,80,6017,5209,808,12,30,7,5
49911,80,3385,80,1519,787,732,10,110,6,4
46866,80,59082,80,662,600,62,12,495,11,1
45897,443,62629,443,2267946,70852,2197094,2429,316,859,1570
49287,53,21721,53,405,90,315,4,59,2,2
64282,53,55682,53,215,94,121,2,30,1,1
36387,443,45505,443,7139,1751,5388,32,1372,10,22
55179,80,55179,80,374,240,134,7,15,5,2
56527,53,0,0,206,83,123,2,31,1,1
65114,53,6427,53,253,87,166,4,31,2,2
65204,53,23706,53,183,94,89,2,30,1,1
42566,443,31210,443,10127,4193,5934,30,24,17,13
56882,53,12251,53,87,87,0,2,60,2,0
55770,53,35170,53,166,85,81,2,30,1,1
53681,31466,64750,31466,70,70,0,2,8,2,0
64149,53,6477,53,301,108,193,4,49,2,2
55057,53,28590,53,188,80,108,2,31,1,1
63463,443,46376,443,3182,1568,1614,8,120,4,4
53631,43562,1567,43562,492,306,186,8,15,5,3
49706,53,17646,53,296,102,194,4,42,2,2
57074,53,27906,53,259,78,181,2,30,1,1
52055,20019,40122,20019,316,136,180,6,7,3,3
57284,53,51341,53,214,110,104,2,30,1,1
53284,443,5586,443,4579,2245,2334,12,122,6,6
56400,53,1687,53,196,102,94,2,30,1,1
51411,443,3217,443,1444,723,721,15,121,8,7
58685,443,52844,443,165763,5072,160691,181,120,61,120
64712,53,32542,53,181,98,83,2,31,1,1
50287,53,47633,53,177,94,83,2,30,1,1
56750,53,47077,53,711,87,624,2,30,1,1
50484,80,53622,80,318,192,126,6,26,4,2
53156,51689,64576,51689,546,306,240,9,142,5,4
51789,80,62386,80,28433,1668,26765,39,20,18,21
57291,53,9525,53,178,94,84,2,30,1,1
54100,80,44998,80,78,78,0,1,5,1,0
20641,53,20641,53,240,98,142,2,29,1,1
47808,53,24079,53,168,78,90,2,30,1,1
57113,53,7922,53,215,102,113,2,30,1,1
49234,53,17767,53,167,86,81,2,30,1,1
65340,53,10565,53,226,102,124,2,30,1,1
49872,80,54932,80,31938,3363,28575,38,88,15,23
64853,53,20032,53,199,102,97,2,30,1,1
49774,443,35552,443,26623,5756,20867,42,126,18,24
26815,80,16585,80,2894,1095,1799,15,131,8,7
57136,53,3723,53,177,94,83,2,30,1,1
38428,443,25567,443,9483,2964,6519,23,17,13,10
9321,443,54415,443,3345,432,2913,11,15,6,5
60798,40010,54476,40010,316,136,180,6,6,3,3
56293,53,53120,53,164,84,80,2,31,1,1
64381,53,50743,53,198,102,96,2,31,1,1
53814,6725,2877,6725,70,70,0,2,7,2,0
42298,40005,47580,40005,211,89,122,4,29,2,2
49188,8108,9022,8108,1788,1016,772,15,15,8,7
65380,53,10002,53,180,94,86,2,30,1,1
61155,443,61155,443,4575,1668,2907,19,27,11,8
50491,443,13045,443,11995,3850,8145,44,120,23,21
55443,443,53890,443,12806,2828,9978,55,2983,24,31
50013,53,57171,53,258,102,156,2,30,1,1
58841,443,21745,443,18238,3980,14258,61,152,27,34
49703,53,62145,53,228,110,118,2,30,1,1
52148,80,27900,80,366,240,126,7,33,5,2
49466,53,63958,53,324,103,221,4,46,2,2
51496,443,41580,443,1177,624,553,12,16,7,5
57409,53,63027,53,168,86,82,2,30,1,1
65020,53,14135,53,184,94,90,2,31,1,1
53136,443,65509,443,3028365,2245986,782379,11999,627,7647,4352
56661,53,1967,53,900,110,790,2,30,1,1
57157,53,58237,53,458,188,270,6,30,3,3
61232,443,38058,443,1786,172,1614,7,120,3,4
64251,53,51222,53,170,87,83,2,31,1,1
61706,80,6564,80,1840,1242,598,11,16,6,5
42868,443,8590,443,10049,2289,7760,35,27,19,16
57487,443,43988,443,1786,172,1614,7,121,3,4
56913,53,31255,53,193,102,91,2,29,1,1
31201,53,38511,53,197,78,119,2,30,1,1
55590,53,49633,53,177,94,83,2,29,1,1
55733,53,35309,53,170,87,83,2,31,1,1
65409,53,26325,53,753,93,660,2,31,1,1
46259,80,22858,80,3574,1669,1905,17,186,10,7
49827,443,61208,443,5523,3016,2507,36,75,20,16
60304,443,14746,443,3982,2461,1521,28,144,14,14
33684,443,39270,443,6829,1261,5568,21,197,11,10
56830,53,57872,53,190,97,93,2,31,1,1
55598,53,62889,53,186,102,84,2,30,1,1
8204,53,48850,53,86,86,0,1,30,1,0
55233,443,14491,443,10226,3230,6996,28,47,16,12
49850,443,7132,443,7371,1564,5807,18,89,9,9
56007,53,28468,53,197,102,95,2,33,1,1
58785,53,54759,53,211,86,125,2,30,1,1
40785,443,32724,443,646,292,354,10,41,5,5
52100,443,14481,443,7711,1717,5994,26,361,13,13
40236,443,44776,443,4945,1401,3544,21,25,11,10
50453,80,44692,80,5978,3592,2386,15,34,8,7
56584,53,11866,53,214,102,112,2,30,1,1
56709,443,54114,443,8007,1987,6020,20,15,11,9
56695,53,39577,53,93,93,0,1,30,1,0
50647,443,3164,443,3201,1812,1389,15,19,9,6
56556,443,40496,443,8908,1849,7059,31,105,17,14
65206,443,20256,443,7525,3267,4258,36,120,17,19
56475,80,2240,80,36057,2080,33977,45,134,19,26
37606,443,47206,443,6277,1868,4409,22,45,13,9
49698,80,3522,80,140258,1720,138538,117,52,18,99
55910,53,63749,53,183,94,89,2,31,1,1
49660,53,56463,53,193,102,91,2,31,1,1
55348,53,40546,53,184,80,104,2,30,1,1
51737,54691,48488,54691,316,136,180,6,5,3,3
49407,80,27843,80,2408,1466,942,10,124,6,4
55067,443,14245,443,1146,360,786,20,75,7,13
51936,17650,3009,17650,70,70,0,2,8,2,0
50520,80,14281,80,1615,793,822,13,91,7,6
33521,80,30889,80,3429,1679,1750,14,22,8,6
53629,51413,42166,51413,70,70,0,1,4,1,0
65078,53,19268,53,177,94,83,2,30,1,1
37965,8272,8707,8272,1577,594,983,20,1740,10,10
8836,53,8836,53,203,82,121,2,30,1,1
53259,443,6892,443,5513,929,4584,20,360,10,10
56617,443,38005,443,5325,1074,4251,18,25,10,8
56388,53,39602,53,173,94,79,2,30,1,1
60258,80,44486,80,3348,2437,911,12,150,7,5
62995,53,20908,53,202,202,0,3,46,3,0
47787,53,24914,53,198,93,105,2,31,1,1
56009,53,53982,53,178,94,84,2,30,1,1
52453,443,8871,443,6650,950,5700,18,75,9,9
49171,53,63019,53,301,102,199,2,30,1,1
52007,37732,15176,37732,70,70,0,2,8,2,0
55002,443,31651,443,469783,461079,8704,444,167,329,115
46503,443,50192,443,6492,1764,4728,56,996,20,36
44780,80,17326,80,120,120,0,3,122,3,0
60399,161,0,0,18789,5169,13620,54,30,27,27
49181,2710,52440,2710,66,66,0,1,5,1,0
50017,443,23366,443,56408,47400,9008,88,138,49,39
54145,7000,54145,7000,3370,1595,1775,16,15,9,7
56478,53,58747,53,200,102,98,2,31,1,1
57169,53,55765,53,458,188,270,6,31,3,3
33546,53,33546,53,400,257,143,3,32,2,1
57143,53,17926,53,184,94,90,2,30,1,1
62877,53,36980,53,248,78,170,2,30,1,1
36379,443,4482,443,4041,2623,1418,22,94,12,10
64169,53,20022,53,209,110,99,2,30,1,1
62326,443,62326,443,1210,637,573,14,51,7,7
61425,80,54723,80,214,140,74,4,41,3,1
64569,443,62686,443,9157,2109,7048,27,32,15,12
63930,44330,64385,44330,66,66,0,2,7,2,0
64297,53,33648,53,199,94,105,2,30,1,1
41270,443,43404,443,14659,5023,9636,46,400,14,32
55463,53,33769,53,216,110,106,2,29,1,1
64274,53,5372,53,197,102,95,2,32,1,1
63795,52376,47084,52376,66,66,0,2,8,2,0
35609,443,35165,443,237,177,60,3,5,2,1
52520,443,9446,443,4463,1215,3248,16,121,8,8
27005,27015,16145,27015,879,126,753,2,29,1,1
55903,53,28482,53,177,94,83,2,30,1,1
49669,53,30235,53,197,94,103,2,30,1,1
39927,443,15384,443,7787,2370,5417,23,242,11,12
51870,40490,10666,40490,70,70,0,2,8,2,0
64979,53,62369,53,754,94,660,2,30,1,1
55687,47613,14281,47613,164,70,94,2,5,1,1
56504,443,16127,443,4467051,102279,4364772,4340,46,1452,2888
49257,53,41185,53,166,86,80,2,30,1,1
27005,27999,21376,27999,913,126,787,2,31,1,1
54106,80,38158,80,78,78,0,1,5,1,0
39718,443,11292,443,10186,3128,7058,26,16,13,13
51967,12110,53548,12110,70,70,0,1,4,1,0
32515,443,32515,443,34885,6636,28249,74,51,38,36
65011,53,28977,53,183,94,89,2,31,1,1
53712,80,11675,80,2424,529,1895,11,75,6,5
44928,443,35200,443,9345,2224,7121,40,112,22,18
56975,53,16815,53,413,170,243,6,31,3,3
49514,53,50895,53,780,93,687,2,30,1,1
52096,443,15286,443,283,163,120,4,15,2,2
65313,53,20235,53,802,288,514,8,75,4,4
55835,53,25257,53,180,94,86,2,30,1,1
49292,443,18411,443,80199,66182,14017,134,163,87,47
37346,443,8413,443,7814,2339,5475,26,316,12,14
49270,53,46560,53,322,110,212,4,30,2,2
53260,53,10585,53,199,94,105,2,30,1,1
54117,443,30153,443,661695,28430,633265,779,118,335,444
50584,8999,33361,8999,1237,369,868,6,1199,3,3
50410,443,7615,443,14049,602,13447,19,35,6,13
65353,53,24740,53,177,94,83,2,30,1,1
65171,53,47372,53,760,97,663,2,31,1,1
25463,53,62402,53,827,91,736,4,29,2,2
56534,53,33541,53,276,94,182,2,30,1,1
56623,53,18777,53,771,101,670,2,30,1,1
48009,443,46874,443,4015,1813,2202,17,256,9,8
50324,443,12034,443,13002,1895,11107,31,202,17,14
52039,38541,32643,38541,66,66,0,1,5,1,0
50057,53,32757,53,718,94,624,2,30,1,1
41426,443,52242,443,3396,1964,1432,16,361,8,8
21846,53,21846,53,247,98,149,2,33,1,1
54583,443,25809,443,11307,7633,3674,25,163,18,7
49921,53,38148,53,212,108,104,2,31,1,1
54630,53,54630,53,825,99,726,2,30,1,1
9190,443,45715,443,4943,429,4514,12,15,6,6
64089,53,25036,53,188,96,92,2,31,1,1
34642,53,34642,53,220,90,130,2,30,1,1
64797,53,45567,53,216,102,114,2,30,1,1
64954,53,8799,53,94,94,0,1,30,1,0
27005,27015,55025,27015,1624,126,1498,4,31,2,2
49614,53,25029,53,380,110,270,2,29,1,1
40363,80,1315,80,3566,1637,1929,18,81,11,7
54835,443,59753,443,678,280,398,11,26,5,6
40471,80,40471,80,1917,1468,449,10,20,6,4
42279,443,42279,443,3414,1979,1435,22,69,11,11
57288,53,13037,53,177,94,83,2,30,1,1
56727,53,26195,53,762,101,661,2,31,1,1
62961,53,49359,53,209,102,107,2,30,1,1
49923,53,8519,53,702,194,508,6,67,3,3
44861,443,26247,443,1053,566,487,10,47,6,4
64559,53,44867,53,168,86,82,2,31,1,1
64204,53,12423,53,211,102,109,2,30,1,1
56912,53,9519,53,198,101,97,2,31,1,1
55889,53,31264,53,177,94,83,2,29,1,1
56621,53,7810,53,760,96,664,2,31,1,1
57544,7000,57544,7000,3502,1935,1567,15,15,8,7
50971,80,41640,80,1094437,6233,1088204,817,36,92,725
56733,53,1965,53,177,94,83,2,30,1,1
49635,53,38499,53,210,110,100,2,29,1,1
49699,53,23875,53,202,103,99,2,31,1,1
63929,53,15311,53,195,94,101,2,30,1,1
55008,443,6262,443,7679,2605,5074,26,45,15,11
56419,53,51375,53,199,102,97,2,30,1,1
36417,443,64743,443,8611,2046,6565,31,394,10,21
53532,8569,14217,8569,546,306,240,9,143,5,4
63869,34368,37141,34368,70,70,0,1,4,1,0
55000,443,57257,443,16063,2691,13372,38,38,18,20
55199,443,36951,443,4086,1248,2838,24,140,11,13
48731,443,51910,443,769074,31261,737813,876,165,356,520
57605,80,57605,80,36471,5174,31297,57,38,23,34
51923,11542,38262,11542,70,70,0,2,8,2,0
40600,53,40600,53,228,90,138,2,30,1,1
52121,58933,17101,58933,70,70,0,2,8,2,0
41398,443,9003,443,3135,1968,1167,22,72,12,10
65376,53,47204,53,184,94,90,2,29,1,1
63228,443,36281,443,3749,2597,1152,25,134,15,10
54987,443,54987,443,3154,2012,1142,16,18,10,6
54538,443,10842,443,2936,1546,1390,17,70,10,7
33498,25,33498,25,7825,2062,5763,36,17,17,19
27005,27017,63290,27017,917,126,791,2,30,1,1
55673,53,34311,53,179,94,85,2,31,1,1
49638,53,6600,53,210,110,100,2,30,1,1
64735,53,29173,53,350,118,232,2,29,1,1
58920,80,59955,80,318,192,126,6,37,4,2
64714,53,29165,53,168,86,82,2,32,1,1
52274,443,52274,443,6679,2408,4271,23,20,10,13
55760,53,35277,53,182,94,88,2,31,1,1
65023,53,34897,53,587,104,483,4,40,2,2
42749,53,42749,53,847,110,737,2,30,1,1
50685,80,30111,80,60374,30984,29390,250,175,123,127
44242,5228,42163,5228,10823,1636,9187,32,591,11,21
1938,53,25817,53,210,78,132,2,30,1,1
55890,53,46214,53,711,87,624,2,30,1,1
56495,53,40690,53,199,102,97,2,30,1,1
56583,53,53516,53,170,87,83,2,31,1,1
57444,53,22248,53,170,87,83,2,30,1,1
61347,443,30207,443,5589,2260,3329,36,217,17,19
55367,53,46146,53,195,102,93,2,31,1,1
65262,53,62763,53,216,110,106,2,30,1,1
49916,53,53241,53,118,118,0,1,30,1,0
64722,53,22432,53,184,94,90,2,31,1,1
65186,53,51165,53,521,90,431,4,43,2,2
49450,443,58155,443,8411,2042,6369,25,251,13,12
49784,443,6049,443,7805,1949,5856,22,126,12,10
56655,443,40290,443,8058,2038,6020,20,15,11,9
53237,80,8152,80,194,128,66,4,55,3,1
54887,443,19441,443,4364,2141,2223,15,137,7,8
60393,443,18640,443,3371,2029,1342,16,360,8,8
65183,53,12672,53,381,89,292,4,43,2,2
40080,80,40080,80,424,198,226,7,142,4,3
55608,53,12316,53,195,102,93,2,30,1,1
56358,53,65243,53,210,110,100,2,33,1,1
48817,45919,48817,45919,334,158,176,2,1200,1,1
56442,53,30750,53,167,86,81,2,30,1,1
47478,443,52438,443,4019,1462,2557,21,120,11,10
51977,18504,5519,18504,70,70,0,1,5,1,0
43900,443,13168,443,442,250,192,8,25,5,3
33231,443,11220,443,1067,650,417,10,35,6,4
58386,443,54159,443,17470103,920642,16549461,18410,181,6438,11972
27005,27020,57425,27020,890,126,764,2,30,1,1
53814,443,6695,443,499,425,74,4,0,3,1
14092,80,14092,80,3182,2082,1100,18,86,10,8
65153,53,31638,53,184,86,98,2,29,1,1
53826,443,31854,443,499,425,74,4,0,3,1
6929,53,6929,53,197,90,107,2,30,1,1
56465,443,52483,443,6081,844,5237,17,15,9,8
56511,53,19992,53,200,102,98,2,31,1,1
49479,53,55939,53,213,94,119,2,29,1,1
64942,53,56338,53,803,390,413,9,71,5,4
49667,53,65196,53,183,94,89,2,30,1,1
52867,443,11328,443,15730,2196,13534,32,436,17,15
62329,443,62329,443,1210,637,573,14,51,7,7
46052,443,47336,443,9815,5382,4433,51,237,20,31
64677,53,37767,53,182,93,89,2,31,1,1
57452,53,57452,53,203,82,121,2,30,1,1
56281,53,38618,53,177,94,83,2,31,1,1
64459,53,56371,53,251,94,157,2,29,1,1
36949,443,20544,443,7474,1298,6176,25,81,11,14
55336,443,52055,443,209596,37190,172406,378,79,184,194
49354,53,61914,53,196,102,94,2,30,1,1
56853,443,46609,443,7092,1795,5297,25,32,14,11
52211,56648,11346,56648,70,70,0,1,4,1,0
49723,443,17483,443,11181,3795,7386,50,20,23,27
41317,53,41317,53,217,87,130,2,30,1,1
27005,27015,62315,27015,1006,252,754,4,32,3,1
53234,443,19776,443,21571,8604,12967,38,34,19,19
10001,443,23014,443,8370,2798,5572,31,315,15,16
57396,53,31064,53,183,94,89,2,30,1,1
48646,80,48646,80,1916,1467,449,10,20,6,4
59748,53,27175,53,304,86,218,2,29,1,1
65361,53,5566,53,764,102,662,2,30,1,1
49798,53,59206,53,192,98,94,2,31,1,1
51935,443,8500,443,2780,1797,983,21,35,11,10
50584,11888,51615,11888,1356,300,1056,6,1200,3,3
54685,53,54685,53,832,106,726,2,30,1,1
36936,443,13188,443,490,210,280,8,131,4,4
53910,1024,45263,1024,70,70,0,1,4,1,0
65312,53,9346,53,182,94,88,2,30,1,1
50967,443,6506,443,612314,25589,586725,676,127,234,442
9515,443,54612,443,318,192,126,6,34,4,2
53726,26083,18088,26083,70,70,0,2,8,2,0
57179,53,11960,53,325,94,231,2,30,1,1
60443,50284,16097,50284,258,70,188,4,8,2,2
47450,443,22297,443,162,102,60,2,5,1,1
55238,53,7598,53,168,86,82,2,31,1,1
49238,8080,49238,8080,378,180,198,7,53,4,3
59891,443,7306,443,1813,1004,809,16,28,8,8
55932,53,16236,53,202,103,99,2,31,1,1
55066,53,26532,53,815,95,720,2,31,1,1
57294,53,3249,53,760,97,663,2,31,1,1
36657,443,2188,443,10985,3186,7799,29,204,14,15
47820,443,39799,443,1132,596,536,17,28,9,8
50689,80,50689,80,450,246,204,8,25,5,3
63806,443,63806,443,4651,1744,2907,19,30,11,8
39831,443,37659,443,7656,4286,3370,38,86,19,19
57594,80,6266,80,486,280,206,8,25,5,3
56983,80,30863,80,214,140,74,4,35,3,1
49787,53,19694,53,193,102,91,2,30,1,1
52114,64853,12974,64853,70,70,0,2,8,2,0
49945,80,12569,80,4215,620,3595,14,15,7,7
50542,53,12388,53,782,110,672,2,30,1,1
56192,53,54480,53,177,94,83,2,30,1,1
60478,30889,28285,30889,1303,903,400,12,16,7,5
51995,50031,29706,50031,70,70,0,1,5,1,0
53135,80,21609,80,2959,610,2349,12,15,6,6
27005,27013,23327,27013,869,126,743,2,30,1,1
9431,443,45231,443,8693,2545,6148,26,34,13,13
56342,443,42448,443,1463,988,475,12,27,7,5
48817,26484,48817,26484,513,152,361,2,1200,1,1
48738,443,11931,443,131514,7190,124324,183,53,72,111
57139,53,26096,53,181,86,95,2,30,1,1
60936,443,44472,443,4621,3079,1542,24,52,13,11
59086,53,59086,53,235,90,145,2,32,1,1
51179,53,60232,53,86,86,0,1,30,1,0
16403,16386,26193,16386,308,128,180,6,30,3,3
56741,53,5499,53,370,94,276,2,30,1,1
50592,443,18630,443,1304,878,426,12,96,7,5
49674,443,62205,443,8656,2060,6596,20,57,10,10
65196,53,4463,53,177,94,83,2,30,1,1
58077,36653,11744,36653,204,64,140,4,11,2,2
52661,80,52661,80,1950,1338,612,11,14,5,6
6881,32056,50769,32056,509,150,359,2,1199,1,1
49968,53,43611,53,751,94,657,2,30,1,1
9142,80,13917,80,54219,1884,52335,61,37,23,38
49788,53,44900,53,196,100,96,2,30,1,1
49731,443,10101,443,4484,1063,3421,15,25,7,8
47638,443,5364,443,1056,569,487,10,38,6,4
39486,80,4046,80,1184,524,660,7,78,4,3
59997,443,42772,443,1571,660,911,13,18,7,6
49932,53,19133,53,237,86,151,2,30,1,1
54525,80,24122,80,50436663,1205750,49230913,49415,198,16827,32588
38238,443,28773,443,33229,5348,27881,55,125,26,29
43732,443,60967,443,5719,1339,4380,19,361,9,10
57207,53,13941,53,190,97,93,2,30,1,1
60389,80,65223,80,2499,531,1968,11,125,6,5
56395,53,20688,53,170,87,83,2,31,1,1
50233,53,42089,53,748,94,654,2,30,1,1
51103,5223,3221,5223,4968,1304,3664,26,1190,13,13
49757,53,24825,53,212,94,118,2,29,1,1
64439,53,36450,53,199,102,97,2,30,1,1
53619,443,9096,443,24190,18242,5948,43,330,25,18
55933,53,2538,53,180,92,88,2,30,1,1
55134,53,13756,53,214,110,104,2,30,1,1
50523,443,11789,443,1579,988,591,13,45,7,6
60229,443,63035,443,8297,1280,7017,15,135,7,8
55801,53,42672,53,222,102,120,2,30,1,1
61817,80,50485,80,3373,591,2782,11,45,6,5
65196,53,20787,53,164,86,78,2,30,1,1
9231,443,14526,443,4942,429,4513,12,15,6,6
53661,443,31154,443,8267,1779,6488,23,150,13,10
64525,53,63463,53,199,102,97,2,30,1,1
63782,6969,48433,6969,70,70,0,1,5,1,0
56546,53,1301,53,177,94,83,2,30,1,1
56953,443,23008,443,66324,17448,48876,86,331,39,47
63945,28291,25473,28291,504,382,122,8,15,6,2
49211,15576,51582,15576,70,70,0,2,8,2,0
26448,80,26448,80,642,338,304,10,32,6,4
40151,5228,21276,5228,19172,3089,16083,43,3601,20,23
57384,53,45393,53,752,93,659,2,31,1,1
65046,53,1859,53,211,94,117,2,31,1,1
65321,53,58472,53,167,86,81,2,29,1,1
6881,7560,34838,7560,509,150,359,2,1199,1,1
36828,53,40804,53,168,78,90,2,30,1,1
55739,443,5145,443,47102,3841,43261,59,121,25,34
37965,7765,33226,7765,460,150,310,2,1199,1,1
60492,11339,16258,11339,70,70,0,2,8,2,0
56589,53,14177,53,166,86,80,2,30,1,1
45338,443,42439,443,2719,1454,1265,22,34,12,10
53768,443,3588,443,499,425,74,4,0,3,1
27005,28515,30330,28515,1660,126,1534,4,30,2,2
55028,443,52319,443,6791,1415,5376,19,51,12,7
30960,45701,51481,45701,330,330,0,6,3609,6,0
65048,443,9174,443,3283,1019,2264,10,120,5,5
56776,18318,59158,18318,70,70,0,1,5,1,0
55979,53,60691,53,193,102,91,2,30,1,1
62102,443,56889,443,3466,821,2645,11,121,5,6
64546,53,63352,53,889,404,485,10,30,5,5
53716,6881,40646,6881,70,70,0,2,7,2,0
53128,29593,28307,29593,70,70,0,2,9,2,0
49863,8100,10467,8100,78,78,0,1,4,1,0
8583,443,8583,443,19994,4745,15249,47,82,21,26
58042,80,52870,80,318,192,126,6,20,4,2
50698,80,39680,80,318,192,126,6,27,4,2
51906,17491,64843,17491,70,70,0,2,8,2,0
47725,443,52489,443,502,250,252,9,32,5,4
65026,53,34108,53,193,102,91,2,29,1,1
57119,80,41470,80,5774,783,4991,17,75,10,7
40025,443,22559,443,10012,3016,6996,40,133,19,21
64816,53,50725,53,166,86,80,2,30,1,1
55580,53,4575,53,195,102,93,2,31,1,1
62766,443,11804,443,3370,1226,2144,13,135,6,7
49380,53,64533,53,199,102,97,2,30,1,1
56975,53,33537,53,197,102,95,2,30,1,1
64656,53,17241,53,387,102,285,2,29,1,1
34698,443,50104,443,16164,3053,13111,31,18,16,15
26900,27017,17453,27017,172,86,86,2,29,1,1
54530,443,34587,443,6202,3033,3169,28,167,13,15
38857,443,38857,443,115031,5628,109403,143,104,55,88
64461,53,2582,53,177,94,83,2,30,1,1
55563,53,39714,53,194,102,92,2,30,1,1
57219,5223,28908,5223,9687,5105,4582,30,298,16,14
51434,53,0,0,202,93,109,2,30,1,1
34325,80,9980,80,2243,1115,1128,14,152,7,7
50526,80,52180,80,259593,12828,246765,308,156,118,190
64093,53,55556,53,213,94,119,2,30,1,1
1937,53,32884,53,210,78,132,2,30,1,1
50077,80,42513,80,804,380,424,9,15,5,4
56532,443,17749,443,8381,2848,5533,26,572,14,12
38524,443,15396,443,5846879,177697,5669182,6043,41,2261,3782
60012,443,29771,443,6438,2599,3839,21,144,10,11
65075,53,61185,53,172,94,78,2,30,1,1
56351,53,13734,53,306,99,207,2,31,1,1
57265,53,15033,53,200,102,98,2,30,1,1
43693,443,24547,443,6389,1439,4950,22,18,11,11
52097,443,17045,443,7246,3017,4229,21,15,11,10
56766,53,34150,53,204,104,100,2,30,1,1
56349,53,28965,53,216,110,106,2,31,1,1
37138,80,13348,80,1658,1344,314,10,16,5,5
56066,53,46856,53,208,106,102,2,30,1,1
65221,53,28071,53,196,86,110,2,30,1,1
64569,53,4728,53,413,170,243,6,30,3,3
9289,443,57036,443,9051,3480,5571,31,23,17,14
38579,80,3885,80,996,507,489,10,200,5,5
43226,443,42884,443,1583877,43930,1539947,1405,93,297,1108
51423,80,51423,80,7610,2737,4873,23,26,12,11
52489,53,54304,53,302,78,224,2,29,1,1
57144,53,55905,53,178,94,84,2,30,1,1
37877,80,30834,80,991,483,508,9,181,5,4
49406,443,41618,443,7808,2879,4929,36,186,19,17
55011,53,15618,53,760,96,664,2,31,1,1
63988,53,36168,53,195,102,93,2,30,1,1
60332,443,37835,443,5413,3344,2069,32,87,16,16
49203,53,34232,53,195,102,93,2,30,1,1
60762,40010,40997,40010,316,136,180,6,6,3,3
24276,53,24276,53,233,90,143,2,33,1,1
55547,53,1923,53,339,94,245,2,30,1,1
50584,26433,35868,26433,166,166,0,1,1200,1,0
37997,49152,15013,49152,156,156,0,3,8,3,0
49552,53,25565,53,194,102,92,2,30,1,1
65144,53,2841,53,210,110,100,2,29,1,1
49297,80,62329,80,16249,1328,14921,28,45,14,14
50316,53,18070,53,816,102,714,2,30,1,1
37567,443,17651,443,499,425,74,4,0,3,1
64653,53,37901,53,755,93,662,2,31,1,1
54195,443,37622,443,499,425,74,4,0,3,1
63968,53,37221,53,200,102,98,2,30,1,1
37965,4546,34269,4546,3957,2324,1633,51,1720,29,22
55892,80,55892,80,1917,1468,449,10,20,6,4
50575,53,41966,53,184,94,90,2,30,1,1
60921,443,60921,443,4886,1530,3356,17,17,10,7
55638,32765,61121,32765,564,318,246,9,15,5,4
56751,53,17361,53,752,93,659,2,30,1,1
27005,27111,30399,27111,893,126,767,2,30,1,1
56446,443,39205,443,15813,5998,9815,30,120,14,16
64869,53,31516,53,195,94,101,2,30,1,1
55619,53,64151,53,183,94,89,2,30,1,1
49160,40527,18392,40527,854,150,704,4,1201,2,2
54963,53,11032,53,210,110,100,2,30,1,1
53161,443,60488,443,9458,4646,4812,26,25,14,12
51823,15843,1473,15843,70,70,0,1,5,1,0
1165,53,1165,53,196,88,108,2,30,1,1
55638,53,63082,53,168,86,82,2,30,1,1
50876,443,55719,443,1786,172,1614,7,120,3,4
61699,443,44016,443,16358,3103,13255,39,19,19,20
34431,443,7506,443,1701,1048,653,15,39,8,7
56556,53,50468,53,184,94,90,2,30,1,1
50670,443,29531,443,11940,3585,8355,43,16,24,19
57464,80,36285,80,234,234,0,4,11,4,0
53810,443,53810,443,7656,4622,3034,24,139,12,12
55719,443,5079,443,2936,343,2593,12,120,5,7
53281,80,26227,80,124,64,60,3,5,2,1
64835,53,7153,53,174,89,85,2,30,1,1
44454,443,1457,443,7092,1495,5597,22,31,12,10
56800,1,46367,1,70,70,0,1,5,1,0
49448,443,41135,443,186882,17018,169864,206,29,84,122
49622,443,38378,443,11139,3031,8108,30,176,14,16
57470,20014,49843,20014,528,528,0,9,1200,9,0
65359,53,19133,53,193,102,91,2,31,1,1
49157,53,42050,53,184,94,90,2,29,1,1
50169,53,12431,53,211,78,133,2,30,1,1
38338,443,60739,443,499,425,74,4,0,3,1
60472,20273,1767,20273,70,70,0,2,8,2,0
55887,53,55834,53,166,86,80,2,30,1,1
28034,443,40574,443,5456,1388,4068,17,15,9,8
50369,53,17923,53,166,86,80,2,29,1,1
56606,3389,56606,3389,4130,2105,2025,18,16,9,9
53843,443,32315,443,499,425,74,4,0,3,1
51984,54606,5412,54606,70,70,0,2,8,2,0
2527,53,2527,53,371,237,134,3,34,2,1
49564,53,57263,53,168,78,90,2,30,1,1
51805,443,60178,443,6339,1901,4438,16,120,8,8
64892,53,50035,53,252,102,150,2,29,1,1
8412,8412,23033,8412,66,66,0,1,30,1,0
49296,80,39063,80,1515,481,1034,11,15,6,5
49410,53,65177,53,172,88,84,2,31,1,1
60476,80,59400,80,613,539,74,7,15,6,1
49839,443,39363,443,17843,13076,4767,27,134,17,10
34782,443,56417,443,15321,1796,13525,26,326,11,15
64204,53,37090,53,193,102,91,2,31,1,1
53561,35885,5770,35885,70,70,0,1,5,1,0
48817,47005,48817,47005,158,158,0,1,1200,1,0
51924,28016,53313,28016,70,70,0,1,5,1,0
55927,53,11810,53,711,87,624,2,30,1,1
55038,443,38606,443,30239,8906,21333,61,32,34,27
49611,53,44426,53,184,94,90,2,30,1,1
53161,30013,6313,30013,70,70,0,2,7,2,0
49740,53,35003,53,167,86,81,2,30,1,1
42438,443,37580,443,7747,1737,6010,27,316,13,14
56553,53,20095,53,701,88,613,2,30,1,1
45105,443,12616,443,3607,2257,1350,22,19,12,10
57470,16288,57203,16288,924,924,0,15,1200,15,0
54198,443,37713,443,499,425,74,4,0,3,1
40204,40012,25675,40012,148,86,62,2,30,1,1
65073,80,65073,80,169702,10513,159189,187,23,72,115
53260,443,64697,443,6136,1916,4220,28,15,16,12
51221,1950,25491,1950,870,330,540,12,1316,6,6
35967,443,11420,443,3870,1743,2127,13,120,6,7
51912,45007,7239,45007,1345,679,666,9,30,5,4
50827,443,49837,443,7298,2661,4637,21,17,11,10
64517,53,41461,53,211,102,109,2,30,1,1
39844,443,3106,443,2042,1022,1020,17,80,9,8
64231,443,45459,443,2227,1018,1209,17,16,8,9
56896,80,32594,80,2684,2550,134,7,16,5,2
55993,53,52586,53,199,102,97,2,30,1,1
38695,443,12020,443,1185199,19993,1165206,1088,16,289,799
65411,53,34611,53,354,102,252,2,30,1,1
52069,80,30929,80,362,240,122,7,25,5,2
51845,80,46640,80,502,310,192,9,31,6,3
60959,443,46440,443,17149,2543,14606,40,46,22,18
60739,40010,46673,40010,316,136,180,6,6,3,3
54991,53,42971,53,253,87,166,4,29,2,2
51033,443,39133,443,14697,3801,10896,52,120,24,28
56059,80,49532,80,1151,711,440,10,15,5,5
27005,27015,65142,27015,883,126,757,2,30,1,1
56637,53,46210,53,199,102,97,2,30,1,1
49173,53,47440,53,234,94,140,2,30,1,1
60593,80,43950,80,130,70,60,2,15,1,1
56070,53,55660,53,186,95,91,2,31,1,1
49954,53,47734,53,228,110,118,2,30,1,1
52698,80,54306,80,8280,5678,2602,25,111,14,11
64486,53,21384,53,290,102,188,2,30,1,1
64573,53,39960,53,184,94,90,2,30,1,1
49418,27017,15205,27017,252,78,174,2,30,1,1
65026,53,32654,53,186,95,91,2,30,1,1
56006,53,57116,53,183,102,81,2,29,1,1
53592,23578,40087,23578,70,70,0,2,7,2,0
64791,53,19745,53,763,102,661,2,29,1,1
54927,443,30686,443,7148,1924,5224,35,364,19,16
55830,53,64690,53,183,94,89,2,30,1,1
43937,123,21193,123,184,94,90,2,30,1,1
55962,53,39113,53,186,95,91,2,31,1,1
53698,8120,60768,8120,70,70,0,1,5,1,0
49993,53,3383,53,211,102,109,2,30,1,1
49626,443,38035,443,8266,1963,6303,28,175,14,14
55405,53,37369,53,199,102,97,2,30,1,1
50487,80,25708,80,378,192,186,7,21,4,3
57889,443,40826,443,1851,1212,639,18,177,11,7
55283,53,5653,53,754,94,660,2,31,1,1
55366,53,65278,53,79,79,0,2,35,2,0
52077,80,35958,80,366,240,126,7,26,5,2
49662,443,39223,443,2690,1342,1348,23,19,12,11
40806,8000,37524,8000,195,71,124,4,58,2,2
54998,53,27657,53,198,102,96,2,31,1,1
49429,53,19123,53,204,104,100,2,31,1,1
57903,80,16780,80,6457,1210,5247,14,17,8,6
56303,53,13622,53,170,87,83,2,30,1,1
52239,443,55922,443,6564,3283,3281,19,140,10,9
57314,53,2474,53,195,102,93,2,31,1,1
40926,53,16373,53,168,78,90,2,30,1,1
48070,53,48070,53,197,90,107,2,30,1,1
53069,443,18651,443,13074,8472,4602,31,135,16,15
55817,53,51311,53,177,94,83,2,30,1,1
60534,80,60534,80,84558,3469,81089,94,16,34,60
35266,53,50904,53,164,78,86,2,30,1,1
56341,443,32673,443,49417,5511,43906,108,439,54,54
65323,53,29690,53,816,102,714,2,30,1,1
49253,53,38638,53,727,86,641,2,29,1,1
65132,53,40938,53,167,86,81,2,31,1,1
48163,443,22836,443,20124,12085,8039,54,385,29,25
55274,53,15789,53,711,87,624,2,30,1,1
63917,57826,39527,57826,70,70,0,1,5,1,0
46085,443,28925,443,13018,2021,10997,34,95,14,20
35577,443,21477,443,15162,8505,6657,55,197,29,26
53140,443,40797,443,8349,1987,6362,23,30,12,11
51902,55933,35723,55933,316,136,180,6,5,3,3
65175,53,9313,53,778,103,675,2,30,1,1
37511,443,37511,443,4673,1766,2907,19,26,11,8
56767,53,58838,53,177,94,83,2,30,1,1
61506,443,7741,443,15255,2304,12951,30,31,13,17
53112,29258,48583,29258,70,70,0,1,5,1,0
65401,53,57745,53,235,102,133,2,29,1,1
52178,443,8092,443,414,140,274,7,26,3,4
56945,443,12296,443,7818,2136,5682,31,322,14,17
15503,7750,61935,7750,858,858,0,14,1200,14,0
64540,53,29410,53,94,94,0,1,30,1,0
49874,443,49241,443,15358,8278,7080,47,19,24,23
52141,443,17579,443,15637,4217,11420,42,83,19,23
60112,443,25865,443,572,280,292,9,16,5,4
35755,80,35755,80,201552,13184,188368,245,30,111,134
55726,32463,13679,32463,70,70,0,2,8,2,0
58145,1433,58145,1433,60,60,0,2,5,2,0
65246,53,37552,53,183,94,89,2,30,1,1
53790,443,36167,443,499,425,74,4,0,3,1
49295,443,9529,443,4179,2599,1580,27,75,13,14
49880,53,5726,53,194,102,92,2,30,1,1
49301,53,26968,53,353,118,235,2,31,1,1
55806,53,53227,53,200,102,98,2,30,1,1
38223,443,38223,443,4782,1875,2907,19,29,11,8
64763,53,55818,53,212,108,104,2,31,1,1
46582,80,45383,80,540,540,0,10,194,10,0
52481,443,46031,443,6270,1368,4902,22,15,12,10
55229,53,60362,53,720,94,626,2,30,1,1
49507,53,65329,53,177,94,83,2,30,1,1
49966,53,36472,53,182,102,80,2,30,1,1
50464,80,22574,80,8453,2011,6442,17,21,8,9
37593,443,32259,443,21234,9602,11632,48,70,28,20
49869,443,47117,443,7910,1967,5943,30,55,15,15
56185,53,12663,53,183,102,81,2,29,1,1
64288,53,3103,53,183,94,89,2,31,1,1
55692,443,55692,443,7516,1498,6018,25,79,11,14
60442,49556,41273,49556,624,318,306,10,15,5,5
37639,53,37639,53,245,106,139,2,29,1,1
53898,12172,10905,12172,70,70,0,2,7,2,0
42936,53,47625,53,199,94,105,2,30,1,1
53092,443,35345,443,7676,1577,6099,28,395,9,19
41852,443,11364,443,22648,14673,7975,96,245,45,51
56470,53,21021,53,196,100,96,2,31,1,1
49638,53,28303,53,331,88,243,4,32,2,2
64827,53,50756,53,291,86,205,2,30,1,1
49791,53,6212,53,777,87,690,2,30,1,1
56388,53,20730,53,275,95,180,4,44,2,2
49211,80,44277,80,8971,1094,7877,17,15,7,10
59418,443,6727,443,2946,1812,1134,16,15,8,8
9511,443,26929,443,318,192,126,6,34,4,2
41152,443,5083,443,1848,1139,709,14,579,8,6
54776,443,51403,443,9501,1502,7999,24,29,13,11
56654,53,47578,53,102,102,0,1,30,1,0
53249,443,17659,443,3292049,87705,3204344,3470,232,1188,2282
60587,443,60587,443,4572,1665,2907,19,27,11,8
49518,53,65191,53,167,86,81,2,30,1,1
52090,80,61372,80,2774,703,2071,12,22,7,5
53664,80,23809,80,3741,3008,733,16,15,10,6
49628,53,54412,53,168,86,82,2,30,1,1
56269,53,36395,53,102,102,0,1,30,1,0
64041,53,42434,53,198,94,104,2,30,1,1
61382,443,28176,443,32082,12801,19281,62,150,25,37
53216,443,19039,443,26702,3270,23432,40,136,16,24
55002,443,46892,443,6953,2447,4506,26,37,15,11
43164,443,24293,443,10030,3002,7028,24,16,13,11
56092,53,54654,53,177,94,83,2,30,1,1
56275,53,62167,53,177,94,83,2,29,1,1
56448,53,60650,53,177,94,83,2,29,1,1
49276,80,4660,80,254,128,126,5,16,3,2
55232,53,4973,53,177,94,83,2,30,1,1
45210,443,36516,443,1699,1038,661,16,276,9,7
11801,443,11801,443,19187,5127,14060,38,22,23,15
49212,53,34127,53,1188,94,1094,2,29,1,1
34489,443,45344,443,8363,1573,6790,24,49,14,10
55481,53,52263,53,793,101,692,2,31,1,1
60894,443,20427,443,34862,6364,28498,64,54,31,33
53851,23650,26484,23650,320,140,180,6,5,3,3
49502,53,35075,53,179,86,93,2,29,1,1
0,0,0,0,480,244,236,4,0,2,2
58345,123,37586,123,184,94,90,2,30,1,1
56965,53,39310,53,183,94,89,2,30,1,1
49197,53,27457,53,751,95,656,2,30,1,1
39500,443,7473,443,6517,2048,4469,21,90,12,9
60387,32087,24462,32087,320,140,180,6,7,3,3
57291,443,9776,443,2685,1353,1332,17,19,10,7
52406,443,64172,443,13978,8842,5136,46,52,26,20
63117,7000,63117,7000,4067,1750,2317,16,15,9,7
56794,443,16368,443,8073,2053,6020,20,15,11,9
50028,53,56615,53,323,110,213,2,29,1,1
56909,443,38825,443,31860,21778,10082,84,190,42,42
50239,53,26724,53,183,94,89,2,30,1,1
19962,53,19962,53,832,106,726,2,30,1,1
55454,53,12163,53,168,86,82,2,32,1,1
65355,53,46648,53,592,105,487,4,50,2,2
55516,53,62536,53,211,102,109,2,30,1,1
55417,53,62498,53,198,102,96,2,32,1,1
55329,53,39839,53,210,102,108,2,29,1,1
52629,53,0,0,418,154,264,4,33,2,2
9149,443,28137,443,6128,763,5365,17,29,9,8
63715,29834,21653,29834,70,70,0,1,4,1,0
49977,53,37356,53,212,94,118,2,30,1,1
55907,53,49379,53,184,94,90,2,30,1,1
50042,53,35274,53,738,86,652,2,29,1,1
52108,20175,5769,20175,70,70,0,2,8,2,0
55044,53,10792,53,196,102,94,2,31,1,1
49418,27015,38933,27015,78,78,0,1,29,1,0
58753,443,55994,443,5167,700,4467,16,14,7,9
51773,80,63744,80,40993,2984,38009,57,24,28,29
57202,53,47171,53,184,94,90,2,30,1,1
38346,80,22623,80,1818,1504,314,13,16,8,5
49713,53,44635,53,177,94,83,2,30,1,1
54360,443,26291,443,12260,3870,8390,52,283,27,25
65527,53,57886,53,194,94,100,2,30,1,1
49180,53,27807,53,359,118,241,2,30,1,1
53750,27352,15975,27352,70,70,0,1,4,1,0
54021,443,39071,443,7653,1188,6465,21,16,12,9
56637,53,18660,53,214,110,104,2,30,1,1
60709,53,36089,53,260,86,174,2,30,1,1
49346,80,49346,80,450,246,204,8,142,5,3
55489,53,44022,53,185,102,83,2,30,1,1
56652,53,11062,53,177,94,83,2,30,1,1
57275,53,1884,53,186,95,91,2,31,1,1
65380,53,28417,53,180,94,86,2,30,1,1
56941,443,33358,443,4581,2831,1750,29,96,15,14
35132,53,35132,53,86,86,0,1,30,1,0
56777,443,21273,443,8654,2150,6504,20,16,11,9
49337,53,51649,53,258,126,132,2,30,1,1
56991,80,27805,80,1638,1324,314,10,15,5,5
52020,80,57766,80,426,240,186,8,24,5,3
65263,53,26647,53,356,88,268,4,55,2,2
56821,53,60054,53,199,102,97,2,30,1,1
53102,443,30366,443,7149,1719,5430,18,326,9,9
55697,14795,5674,14795,564,318,246,9,15,5,4
49844,53,62050,53,368,118,250,2,30,1,1
59329,53,2601,53,199,94,105,2,30,1,1
49894,443,43523,443,5597,1462,4135,21,86,11,10
56415,53,58262,53,174,89,85,2,31,1,1
55549,53,9583,53,209,110,99,2,30,1,1
53437,6057,55735,6057,245,245,0,2,30,2,0
59957,443,65089,443,8677,2714,5963,21,114,13,8
51934,443,29764,443,550,310,240,10,35,6,4
59905,443,11259,443,343,163,180,6,15,3,3
50190,53,51481,53,754,94,660,2,30,1,1
56373,53,29361,53,200,102,98,2,31,1,1
64643,443,21220,443,3433,1192,2241,13,136,6,7
65393,443,57467,443,5121,936,4185,17,27,9,8
56843,64277,53228,64277,70,70,0,1,5,1,0
49745,443,54598,443,4043,1781,2262,19,128,11,8
50293,443,61876,443,12677,3097,9580,37,26,19,18
65533,53,35566,53,277,134,143,2,30,1,1
56141,53,48700,53,277,134,143,2,30,1,1
57470,6969,5895,6969,132,132,0,3,1199,3,0
55993,53,8187,53,199,102,97,2,29,1,1
57877,443,6198,443,9256443,112898,9143545,7609,178,1428,6181
55752,8060,62936,8060,70,70,0,2,8,2,0
51706,30673,17118,30673,70,70,0,1,5,1,0
56594,53,16703,53,167,86,81,2,30,1,1
50584,51413,47261,51413,1275,300,975,6,1200,3,3
64677,53,61310,53,183,94,89,2,31,1,1
49364,53,61563,53,182,94,88,2,30,1,1
56160,53,58234,53,195,102,93,2,31,1,1
27005,27017,47971,27017,1616,126,1490,4,30,2,2
64998,27037,61288,27037,3287,2072,1215,12,30,6,6
57277,5223,45346,5223,4339,1521,2818,23,3002,14,9
49911,53,3623,53,200,94,106,2,30,1,1
35066,443,6201,443,33823,28233,5590,84,102,47,37
64320,53,33961,53,198,101,97,2,30,1,1
49890,443,3826,443,6370237,150385,6219852,6047,138,1688,4359
63720,55027,38364,55027,1233,902,331,12,17,8,4
52312,443,50036,443,1574859,55851,1519008,1758,185,656,1102
9331,443,37171,443,3616,429,3187,11,15,6,5
58925,443,39506,443,5167,700,4467,16,15,7,9
64382,443,26649,443,4017,978,3039,14,53,8,6
63079,443,63360,443,304,86,218,2,30,1,1
53239,443,22787,443,982624,22331,960293,976,137,293,683
27005,27015,44783,27015,939,126,813,2,30,1,1
51890,31122,11914,31122,70,70,0,1,5,1,0
56673,53,13818,53,186,95,91,2,31,1,1
50704,80,48490,80,1082,896,186,18,214,15,3
49835,443,4788,443,10066,4676,5390,27,123,15,12
50377,53,9572,53,167,78,89,2,30,1,1
55838,443,19179,443,7034,2039,4995,37,255,18,19
56561,53,15305,53,216,110,106,2,30,1,1
56423,53,58524,53,168,86,82,2,30,1,1
52949,443,60761,443,9564,2054,7510,42,114,20,22
65432,80,46367,80,486,240,246,9,28,5,4
64493,53,34209,53,280,97,183,4,59,2,2
54959,53,28413,53,211,110,101,2,30,1,1
61670,443,47830,443,5943,1991,3952,23,17,14,9
42050,53,28616,53,168,78,90,2,30,1,1
24891,53,42889,53,168,78,90,2,30,1,1
55570,53,24983,53,168,86,82,2,29,1,1
55730,53,15730,53,196,102,94,2,30,1,1
51764,443,51764,443,4632,1725,2907,19,27,11,8
49512,53,26273,53,195,102,93,2,30,1,1
56657,443,37201,443,1342,918,424,10,25,6,4
65060,53,21160,53,324,97,227,4,52,2,2
29972,53,62142,53,300,94,206,2,30,1,1
9195,80,8495,80,2819,541,2278,12,31,6,6
50501,80,58618,80,318,192,126,6,25,4,2
49855,443,64909,443,28887,9850,19037,96,60,41,55
53947,867,6908,867,70,70,0,1,5,1,0
55179,53,63963,53,194,102,92,2,30,1,1
57470,51413,6363,51413,493,166,327,2,1200,1,1
52888,443,11223,443,12876,2739,10137,44,118,21,23
50552,53,56537,53,710,89,621,2,30,1,1
9109,443,23310,443,4400,433,3967,12,15,6,6
1848,53,1848,53,832,106,726,2,29,1,1
56738,80,55725,80,1462,703,759,8,16,5,3
56054,53,43314,53,740,93,647,2,31,1,1
64173,53,16220,53,210,94,116,2,30,1,1
53912,443,42597,443,499,425,74,4,0,3,1
50574,443,63021,443,7352,1023,6329,19,16,11,8
50084,80,12971,80,2173,616,1557,10,15,6,4
50076,80,31297,80,1052,612,440,10,15,5,5
62895,993,31409,993,10457,4879,5578,98,186,50,48
57833,443,7309,443,215996,13055,202941,265,127,96,169
49277,53,5788,53,199,86,113,2,29,1,1
55704,53,41998,53,193,102,91,2,30,1,1
55824,80,14752,80,1281,398,883,16,393,4,12
58910,443,57868,443,27575,18478,9097,64,22,36,28
56479,53,28725,53,775,103,672,2,30,1,1
53465,80,64691,80,1360,540,820,20,187,10,10
40214,443,5611,443,3910,2223,1687,24,3676,8,16
42298,40039,27373,40039,148,86,62,2,30,1,1
56050,53,62054,53,178,94,84,2,30,1,1
60482,2924,18303,2924,320,140,180,6,7,3,3
65189,27255,47951,27255,278,71,207,2,30,1,1
60874,443,9716,443,4479,788,3691,17,25,9,8
55088,53,55518,53,193,102,91,2,30,1,1
57498,443,57498,443,4546,1639,2907,19,27,11,8
49563,53,57038,53,199,94,105,2,29,1,1
54943,443,33087,443,7118,2618,4500,21,30,12,9
54080,443,18578,443,6673,1531,5142,22,341,10,12
51272,12210,19987,12210,70,70,0,2,8,2,0
55637,53,24847,53,202,103,99,2,31,1,1
49312,53,27461,53,772,102,670,2,30,1,1
28618,53,13005,53,236,86,150,2,30,1,1
55640,53,50783,53,742,88,654,2,31,1,1
35595,80,11916,80,1566,684,882,10,15,5,5
60345,80,36242,80,2124,1158,966,13,87,7,6
49418,27015,22382,27015,243,78,165,2,31,1,1
64292,53,46657,53,199,94,105,2,30,1,1
60421,6882,25350,6882,70,70,0,1,5,1,0
9394,443,24044,443,3613,433,3180,11,15,6,5
52236,15313,26526,15313,70,70,0,1,5,1,0
64945,53,47640,53,292,126,166,2,29,1,1
56765,53,13979,53,188,96,92,2,31,1,1
64950,53,1692,53,183,94,89,2,30,1,1
6881,37957,48141,37957,509,150,359,2,1199,1,1
52588,443,7205,443,3523,518,3005,12,15,6,6
51261,53,15838,53,259,86,173,2,30,1,1
65201,53,5294,53,216,110,106,2,30,1,1
44890,443,40961,443,2134,1397,737,18,1162,10,8
59583,53,59583,53,229,89,140,2,31,1,1
43018,443,63361,443,4664,962,3702,15,120,7,8
51894,26116,8093,26116,70,70,0,1,5,1,0
50687,443,7518,443,1199,618,581,13,29,6,7
51990,42127,1528,42127,66,66,0,1,5,1,0
40765,443,6306,443,1093,662,431,10,41,6,4
50838,53,8440,53,70,70,0,1,30,1,0
59003,443,53579,443,10196,6897,3299,39,121,20,19
49160,6889,21794,6889,311,311,0,3,1200,3,0
61810,443,52096,443,3109,812,2297,13,136,6,7
49178,53,11567,53,822,102,720,2,29,1,1
53822,443,12016,443,499,425,74,4,0,3,1
65379,443,37475,443,76625,63648,12977,139,83,79,60
55026,53,39957,53,164,86,78,2,29,1,1
35485,443,29586,443,1633,1038,595,14,34,8,6
58749,443,22893,443,6246,4267,1979,21,16,11,10
54703,53,49581,53,168,78,90,2,30,1,1
55216,53,59483,53,711,87,624,2,30,1,1
59779,443,38576,443,142,142,0,1,5,1,0
50080,5223,34413,5223,10876,5991,4885,39,93,22,17
36943,443,59404,443,15329,7087,8242,108,310,61,47
27005,27444,51395,27444,893,126,767,2,30,1,1
56200,53,42161,53,211,110,101,2,30,1,1
64503,53,37724,53,209,102,107,2,30,1,1
50386,80,26554,80,6718,3126,3592,16,77,8,8
46851,443,41590,443,3998,1986,2012,20,255,10,10
64689,53,60672,53,183,94,89,2,30,1,1
27515,53,18456,53,224,78,146,2,30,1,1
53266,443,13911,443,12822,4426,8396,42,18,24,18
64055,53,9885,53,265,91,174,4,37,2,2
56934,53,16279,53,216,110,106,2,29,1,1
65380,53,11853,53,176,90,86,2,31,1,1
45232,80,45232,80,2895,1484,1411,10,15,6,4
54666,443,61385,443,3648,1080,2568,18,135,8,10
40474,1488,40474,1488,156,156,0,3,8,3,0
65189,27257,41492,27257,252,78,174,2,29,1,1
49432,53,40864,53,338,118,220,2,29,1,1
36036,443,36036,443,261234,32183,229051,326,212,153,173
55675,49271,26954,49271,504,318,186,8,16,5,3
56663,53,10723,53,181,94,87,2,33,1,1
41973,443,27764,443,26109,3251,22858,60,256,31,29
53545,443,54715,443,7330,2295,5035,19,135,9,10
63966,443,14721,443,22930,2512,20418,37,75,17,20
56015,53,12325,53,195,102,93,2,31,1,1
46082,443,8016,443,137024,6442,130582,171,109,61,110
56225,53,43887,53,183,94,89,2,30,1,1
49418,27017,35147,27017,78,78,0,1,30,1,0
55585,48063,46430,48063,70,70,0,2,8,2,0
30960,45692,4911,45692,330,330,0,6,3609,6,0
42790,443,55460,443,13859,3232,10627,50,256,21,29
49999,53,5056,53,178,91,87,2,31,1,1
63832,6969,32926,6969,70,70,0,1,5,1,0
55591,53,39527,53,195,102,93,2,31,1,1
54000,53,38105,53,294,86,208,2,30,1,1
56082,53,33966,53,807,94,713,2,29,1,1
57470,32517,51554,32517,166,166,0,1,1199,1,0
55896,53,48962,53,168,86,82,2,30,1,1
56351,53,9188,53,190,97,93,2,30,1,1
60946,443,58938,443,1373,712,661,14,18,8,6
46970,443,52704,443,8394,3155,5239,28,271,16,12
62339,443,17791,443,9125,2616,6509,30,76,14,16
55589,53,12456,53,177,94,83,2,30,1,1
53752,443,21616,443,499,425,74,4,0,3,1
27005,27222,26856,27222,890,126,764,2,30,1,1
50276,443,53649,443,9984,2917,7067,49,102,28,21
52067,46837,56641,46837,70,70,0,1,5,1,0
49667,53,38974,53,261,94,167,2,30,1,1
64721,53,12160,53,466,108,358,4,45,2,2
44847,37005,6154,37005,150,150,0,1,1200,1,0
6881,6992,61749,6992,150,150,0,1,1200,1,0
56846,53,23614,53,192,98,94,2,31,1,1
65497,53,26978,53,197,102,95,2,30,1,1
49878,53,64175,53,327,102,225,2,30,1,1
64292,53,10616,53,387,94,293,4,51,2,2
60014,443,21323,443,10021,3035,6986,30,46,17,13
50604,443,49840,443,7470,2479,4991,20,135,9,11
65460,80,65460,80,48356,4069,44287,55,48,19,36
49954,443,61436,443,25995,13597,12398,53,186,28,25
53548,23310,1766,23310,70,70,0,2,8,2,0
47595,33441,0,0,106,106,0,1,60,1,0
64628,53,26706,53,753,93,660,2,30,1,1
42298,40007,30822,40007,143,81,62,2,31,1,1
56590,53,44528,53,305,94,211,2,30,1,1
49703,53,23224,53,288,102,186,2,31,1,1
34717,53,24183,53,168,78,90,2,31,1,1
64085,443,64085,443,140818,8751,132067,156,168,57,99
51989,29736,40433,29736,258,70,188,4,8,2,2
52049,443,18143,443,7710,2476,5234,18,135,8,10
50440,53,52778,53,458,188,270,6,29,3,3
56663,443,10408,443,8057,2037,6020,20,15,11,9
34325,443,18256,443,2450,1451,999,19,315,10,9
51462,3027,51462,3027,156,156,0,3,8,3,0
64140,53,60265,53,184,94,90,2,31,1,1
37633,443,4674,443,8493,2314,6179,33,16,18,15
58035,80,60635,80,130,70,60,2,15,1,1
43087,443,6969,443,4909,1007,3902,14,35,8,6
55836,53,51304,53,177,94,83,2,30,1,1
64048,53,43496,53,209,110,99,2,29,1,1
59692,443,65414,443,6129,3123,3006,12,120,7,5
49418,27015,63355,27015,244,78,166,2,30,1,1
50891,80,64394,80,136656,9764,126892,162,140,70,92
37236,53,35776,53,223,78,145,2,30,1,1
49164,443,45916,443,7292,950,6342,19,75,9,10
64485,53,6047,53,183,94,89,2,30,1,1
56912,53,3525,53,199,102,97,2,30,1,1
35889,443,19640,443,6982,1728,5254,23,27,13,10
55675,53,47376,53,198,102,96,2,30,1,1
64949,53,23952,53,208,106,102,2,31,1,1
49946,80,45099,80,31517,1203,30314,38,15,15,23
63022,53,50452,53,384,166,218,2,29,1,1
49522,80,55749,80,6908,1652,5256,26,225,12,14
49853,80,30133,80,15055,6439,8616,26,89,14,12
56983,53,62235,53,221,94,127,2,29,1,1
50108,53,31749,53,174,89,85,2,30,1,1
57470,17984,29715,17984,870,330,540,12,1496,6,6
63697,25010,4091,25010,504,382,122,8,16,6,2
39827,443,61705,443,6128,3746,2382,48,46,25,23
46263,7700,25323,7700,1440,956,484,15,35,8,7
42971,3478,30766,3478,312,140,172,4,30,2,2
43096,443,6267,443,7098,2628,4470,20,16,12,8
49394,443,39992,443,6211,1869,4342,18,181,8,10
62736,80,60766,80,1516,481,1035,11,15,6,5
56759,55201,4487,55201,70,70,0,2,8,2,0
44847,6881,3655,6881,324,150,174,2,1201,1,1
56804,33375,57101,33375,70,70,0,1,5,1,0
53649,26085,23135,26085,612,306,306,10,15,5,5
50017,80,11643,80,827,687,140,6,32,4,2
2267,53,43002,53,204,118,86,2,30,1,1
58614,53,27670,53,218,78,140,2,31,1,1
64385,53,23181,53,179,94,85,2,30,1,1
64614,53,56180,53,193,102,91,2,30,1,1
57032,53,17045,53,166,86,80,2,31,1,1
50584,13560,50803,13560,166,166,0,1,1200,1,0
55171,53,26173,53,762,97,665,2,31,1,1
42520,53,41857,53,168,78,90,2,30,1,1
59962,443,64092,443,19201,1566,17635,34,16,16,18
49917,53,18720,53,209,110,99,2,30,1,1
57115,53,57910,53,788,108,680,2,30,1,1
15503,57141,65001,57141,481,150,331,2,1200,1,1
55291,53,55867,53,243,94,149,2,31,1,1
50269,443,37644,443,8272,2455,5817,29,391,10,19
65183,53,44616,53,718,94,624,2,31,1,1
56813,37092,33767,37092,70,70,0,1,5,1,0
49626,53,39799,53,969,86,883,2,30,1,1
51910,60443,64340,60443,70,70,0,2,8,2,0
49435,443,28726,443,8602,1050,7552,16,120,7,9
63073,53,51318,53,304,86,218,2,30,1,1
63818,19291,22268,19291,70,70,0,1,4,1,0
56588,53,28936,53,194,99,95,2,30,1,1
53536,34200,55904,34200,70,70,0,2,7,2,0
57494,443,51749,443,2435128,54736,2380392,2151,346,331,1820
49332,443,62500,443,27727,1971,25756,51,80,21,30
9153,443,27123,443,6059,773,5286,17,29,9,8
49790,53,34832,53,195,102,93,2,30,1,1
49844,53,1140,53,762,98,664,2,31,1,1
51973,5222,53843,5222,9184,4142,5042,72,53,40,32
56767,53,32268,53,177,94,83,2,30,1,1
53790,21011,61681,21011,70,70,0,2,8,2,0
37612,443,15502,443,499,425,74,4,0,3,1
57470,12383,34199,12383,5728,4818,910,87,4485,74,13
5588,5588,0,0,3354,1792,1562,46,194,23,23
65436,53,35308,53,332,98,234,3,58,2,1
42601,443,52311,443,3238,2021,1217,16,16,8,8
46101,80,15092,80,70,70,0,2,5,2,0
56751,443,1821,443,8059,2039,6020,20,15,11,9
51621,443,45721,443,5964,1007,4957,18,16,11,7
55563,443,55563,443,4628,1721,2907,19,30,11,8
64726,53,24139,53,178,94,84,2,30,1,1
5588,5588,0,0,3354,1792,1562,46,194,23,23
55271,53,11109,53,168,86,82,2,31,1,1
33651,53,33651,53,197,90,107,2,30,1,1
49470,443,50216,443,2772,1777,995,16,124,9,7
60601,443,55669,443,6180,926,5254,18,36,10,8
8861,443,39985,443,42890,30849,12041,214,420,106,108
56489,53,35362,53,178,94,84,2,29,1,1
50825,443,14787,443,6601,1120,5481,17,116,9,8
58461,443,33796,443,6100,1233,4867,21,17,11,10
52223,11979,45106,11979,70,70,0,1,5,1,0
49572,443,30462,443,7538,4953,2585,21,54,12,9
55581,53,6275,53,167,86,81,2,30,1,1
56477,53,18413,53,386,101,285,4,31,2,2
49995,53,30507,53,197,102,95,2,33,1,1
52107,11191,10065,11191,70,70,0,1,4,1,0
39886,443,46428,443,315567,15410,300157,404,46,189,215
54966,53,31791,53,254,87,167,4,31,2,2
50688,80,50688,80,167293,8028,159265,186,26,68,118
57368,53,45045,53,167,86,81,2,29,1,1
38655,443,22510,443,498,210,288,8,26,4,4
63112,443,43251,443,3695,2713,982,21,82,12,9
22327,53,22327,53,237,91,146,2,32,1,1
27005,33060,38657,33060,928,126,802,2,31,1,1
59974,443,48312,443,200862,57949,142913,361,24,172,189
53258,443,49616,443,26995,3729,23266,40,137,16,24
55478,53,56587,53,177,94,83,2,30,1,1
56825,16648,32548,16648,164,70,94,2,7,1,1
49302,53,61464,53,234,94,140,2,30,1,1
56231,53,14277,53,268,94,174,2,30,1,1
49767,53,47243,53,185,102,83,2,30,1,1
49951,80,49951,80,24361943,451235,23910708,22804,63,6533,16271
56938,9600,62767,9600,86,86,0,1,30,1,0
55271,53,59088,53,168,86,82,2,29,1,1
53782,42855,3816,42855,70,70,0,1,5,1,0
55346,53,65324,53,177,94,83,2,29,1,1
60232,443,3016,443,1868,1229,639,18,151,11,7
51727,1024,54726,1024,66,66,0,1,5,1,0
56702,53,49433,53,168,78,90,2,30,1,1
57445,66,60334,66,70,70,0,1,5,1,0
63201,53,63201,53,262,106,156,2,32,1,1
53138,15048,65155,15048,70,70,0,1,4,1,0
49626,443,3697,443,35474,2800,32674,56,135,27,29
56846,443,26374,443,9370,3805,5565,43,181,21,22
56929,53,14776,53,177,94,83,2,30,1,1
50006,80,59669,80,2087,1159,928,10,86,6,4
64986,53,9099,53,183,94,89,2,30,1,1
49926,53,10749,53,266,110,156,2,30,1,1
55217,53,21902,53,189,102,87,2,30,1,1
56340,53,44693,53,198,102,96,2,30,1,1
50290,53,11389,53,211,110,101,2,30,1,1
37918,443,25153,443,6123,860,5263,18,361,9,9
56680,8100,18544,8100,78,78,0,1,4,1,0
60109,443,54198,443,268,120,148,5,10,3,2
54955,443,20454,443,10265,1831,8434,34,319,17,17
51797,30712,39713,30712,70,70,0,2,8,2,0
56609,443,31583,443,7982,1962,6020,20,15,11,9
55697,53,51781,53,193,102,91,2,30,1,1
65228,53,51061,53,267,93,174,4,46,2,2
34365,443,34038,443,223826,45909,177917,356,44,176,180
56680,443,53449,443,7889,1900,5989,20,15,11,9
65514,53,51532,53,177,94,83,2,30,1,1
55629,53,22449,53,168,86,82,2,30,1,1
46201,443,55008,443,16666,4851,11815,58,150,27,31
37614,53,37614,53,209,98,111,2,30,1,1
50488,443,22994,443,9765,2106,7659,27,83,14,13
49230,53,46684,53,168,86,82,2,30,1,1
51926,58664,36241,58664,70,70,0,2,8,2,0
59595,80,6644,80,1052,612,440,10,15,5,5
51951,65387,33774,65387,70,70,0,1,5,1,0
5588,5588,0,0,3562,1936,1626,48,194,24,24
63040,53,20975,53,512,166,346,2,29,1,1
54998,53,24555,53,168,78,90,2,30,1,1
51826,58925,47237,58925,70,70,0,1,4,1,0
59793,443,44894,443,41635,3977,37658,63,121,25,38
50567,443,27568,443,198,120,78,4,15,3,1
55596,53,31644,53,194,102,92,2,30,1,1
16403,16386,35244,16386,426,186,240,8,30,4,4
37846,443,26954,443,30620,20855,9765,91,112,45,46
56432,53,16819,53,195,102,93,2,30,1,1
42117,80,40456,80,1056,682,374,10,15,6,4
17052,53,17052,53,235,90,145,2,32,1,1
51221,33295,49216,33295,528,528,0,9,1200,9,0
56770,53,63283,53,208,106,102,2,30,1,1
56304,53,54200,53,184,94,90,2,31,1,1
55688,33958,47150,33958,70,70,0,2,8,2,0
49589,80,33481,80,314,128,186,6,26,3,3
61279,443,45971,443,4076,1378,2698,14,136,7,7
55893,443,18162,443,6176,908,5268,17,15,8,9
49888,53,39344,53,198,102,96,2,30,1,1
57314,443,14727,443,134,60,74,3,6,2,1
51908,38446,5874,38446,316,136,180,6,6,3,3
61714,443,1566,443,2484,330,2154,12,135,5,7
26900,27017,19370,27017,422,164,258,6,29,3,3
55617,18319,24832,18319,320,140,180,6,7,3,3
55311,53,55274,53,298,101,197,4,31,2,2
65506,53,15371,53,197,102,95,2,30,1,1
64444,53,59792,53,93,93,0,1,30,1,0
60377,443,34261,443,8678,2974,5704,50,123,27,23
53804,24067,52480,24067,70,70,0,2,7,2,0
55790,53,39330,53,177,94,83,2,30,1,1
49476,53,34696,53,764,102,662,2,30,1,1
53888,443,38577,443,499,425,74,4,0,3,1
50285,443,10190,443,18009,7378,10631,58,62,33,25
49418,27017,45242,27017,259,78,181,2,31,1,1
60885,443,31610,443,887,542,345,11,15,6,5
53170,20259,44123,20259,70,70,0,2,8,2,0
52922,443,7305,443,5583,1390,4193,19,15,9,10
57418,53,45442,53,165,86,79,2,30,1,1
56965,53,30276,53,182,93,89,2,31,1,1
51432,80,51432,80,42247,4067,38180,58,25,23,35
53816,42459,30480,42459,552,306,246,9,16,5,4
55466,53,45668,53,177,94,83,2,30,1,1
49807,53,0,0,218,77,141,2,30,1,1
49279,80,12266,80,254,128,126,5,15,3,2
41472,443,2469,443,4500,2769,1731,29,80,14,15
54213,443,30339,443,7498,2799,4699,24,17,13,11
52052,80,13756,80,2308,1541,767,11,18,7,4
56942,443,55057,443,8172,2656,5516,29,330,15,14
50019,80,29484,80,814,674,140,6,28,4,2
50544,443,14371,443,11083,4570,6513,24,35,13,11
59792,443,33674,443,12836,2016,10820,48,361,20,28
49667,53,65184,53,448,184,264,6,30,3,3
41906,443,20652,443,181961,40579,141382,247,238,101,146
56899,443,29729,443,29904,3111,26793,68,164,35,33
65266,53,41690,53,216,110,106,2,31,1,1
53210,80,7510,80,1726,940,786,8,51,5,3
63822,14382,65355,14382,66,66,0,2,8,2,0
60927,443,47688,443,3642,606,3036,13,119,6,7
53687,51471,5153,51471,70,70,0,1,5,1,0
65189,28125,44608,28125,78,78,0,1,29,1,0
49972,80,64274,80,95065,52092,42973,148,259,77,71
56660,53,34940,53,183,94,89,2,30,1,1
56586,53,7577,53,754,94,660,2,31,1,1
43827,443,64958,443,130,70,60,2,14,1,1
9248,80,12948,80,844,778,66,6,15,5,1
64895,53,65185,53,199,102,97,2,30,1,1
56288,53,30293,53,183,94,89,2,30,1,1
49872,443,32419,443,4595,1038,3557,19,54,11,8
49325,443,26750,443,5749,3401,2348,29,76,15,14
58845,443,51619,443,22402,14820,7582,52,20,29,23
53788,1,8231,1,70,70,0,2,8,2,0
22394,53,22394,53,233,91,142,2,31,1,1
53284,80,44514,80,6995,783,6212,14,317,7,7
57096,53,50734,53,177,94,83,2,29,1,1
57252,53,53666,53,183,94,89,2,30,1,1
63016,443,62521,443,303,85,218,2,31,1,1
49447,53,53080,53,168,78,90,2,30,1,1
50466,53,28614,53,199,102,97,2,30,1,1
35229,443,14508,443,9488,4114,5374,27,363,14,13
54963,53,30866,53,210,110,100,2,30,1,1
27005,27018,26444,27018,1634,126,1508,4,30,2,2
30188,15370,58525,15370,10190,4774,5416,64,1490,32,32
50052,53,23158,53,789,102,687,2,30,1,1
56082,53,58517,53,271,88,183,4,38,2,2
64254,53,25297,53,211,78,133,2,30,1,1
36157,53,43020,53,164,78,86,2,31,1,1
37572,443,25877,443,499,425,74,4,0,3,1
62236,443,62236,443,28126,3114,25012,50,77,22,28
46949,53,11241,53,168,78,90,2,29,1,1
56445,53,12217,53,711,87,624,2,30,1,1
53801,47933,40487,47933,320,140,180,6,6,3,3
63240,443,14470,443,1433,734,699,18,125,10,8
56752,443,27500,443,11771,2624,9147,50,20,25,25
57210,53,57210,53,628,82,546,2,30,1,1
63094,53,39482,53,384,166,218,2,30,1,1
9097,5228,6402,5228,6138,1256,4882,22,58,11,11
27005,27015,56487,27015,892,126,766,2,30,1,1
50291,443,61794,443,11617,4358,7259,48,86,26,22
51099,443,34189,443,11482,3696,7786,28,62,15,13
56775,53,28683,53,170,87,83,2,30,1,1
52946,80,25585,80,2043,1331,712,13,17,7,6
65176,53,64926,53,183,94,89,2,29,1,1
50699,443,40507,443,9382,3057,6325,35,1220,17,18
54994,53,62711,53,209,110,99,2,30,1,1
51867,48059,33998,48059,258,70,188,4,8,2,2
60902,443,20935,443,924886,40519,884367,1075,65,442,633
53036,443,2888,443,3039,1089,1950,9,120,5,4
49183,443,49342,443,473744,13158,460586,495,20,183,312
48893,443,17087,443,16227,2037,14190,40,109,19,21
61567,53,3917,53,183,86,97,2,30,1,1
37981,80,45214,80,1572,755,817,11,15,6,5
59762,53,43399,53,401,86,315,2,30,1,1
57969,53,57969,53,194,87,107,2,31,1,1
49501,80,23659,80,183116,16652,166464,279,486,59,220
57363,53,32810,53,178,94,84,2,30,1,1
57023,443,30630,443,10514,2031,8483,28,149,12,16
55836,53,33356,53,177,94,83,2,30,1,1
45211,443,19368,443,1629,968,661,15,275,8,7
58196,53,55117,53,578,286,292,9,16,5,4
49346,53,28098,53,212,102,110,2,30,1,1
65036,53,9458,53,199,102,97,2,29,1,1
57043,53,20251,53,166,86,80,2,31,1,1
50400,443,29231,443,1124,594,530,12,26,6,6
65466,53,9762,53,298,102,196,4,39,2,2
14752,53,14752,53,229,98,131,2,30,1,1
48872,443,20108,443,8143,3033,5110,26,18,14,12
55886,443,32004,443,161,101,60,2,5,1,1
63950,53,31406,53,200,102,98,2,30,1,1
64609,53,57916,53,146,75,71,2,31,1,1
64670,53,49938,53,228,94,134,2,30,1,1
53162,60352,6170,60352,70,70,0,1,5,1,0
53645,62348,1333,62348,2395,1145,1250,13,16,6,7
65512,53,60205,53,744,95,649,2,31,1,1
50428,443,32117,443,9844,4554,5290,24,92,13,11
27005,27015,29834,27015,1634,126,1508,4,30,2,2
53877,32737,64789,32737,320,140,180,6,7,3,3
53012,443,44779,443,13938,3220,10718,44,93,21,23
32934,443,9755,443,7623,3362,4261,26,31,14,12
60853,443,17952,443,126,60,66,3,4,2,1
56204,53,64652,53,168,86,82,2,29,1,1
38060,443,63699,443,27679,15839,11840,75,103,39,36
27302,443,50050,443,9046,1414,7632,25,84,10,15
64216,53,64216,53,220,100,120,2,30,1,1
50165,53,36668,53,211,78,133,2,30,1,1
52176,443,22865,443,8048,1360,6688,24,23,12,12
40906,8434,40906,8434,156,156,0,3,8,3,0
59759,53,58276,53,211,78,133,2,30,1,1
50077,443,55619,443,1786,172,1614,7,0,3,4
65251,53,36655,53,277,98,179,4,36,2,2
64097,53,23639,53,308,91,217,4,56,2,2
47982,443,20773,443,83558,8567,74991,180,171,92,88
45977,53,27186,53,164,78,86,2,30,1,1
49228,53,7287,53,193,102,91,2,30,1,1
64938,53,18539,53,210,102,108,2,30,1,1
53865,443,28083,443,499,425,74,4,1,3,1
26900,27017,22476,27017,422,164,258,6,30,3,3
53534,40960,13903,40960,320,140,180,6,6,3,3
42500,443,20918,443,8932,2039,6893,23,24,12,11
65357,53,15221,53,176,90,86,2,30,1,1
53909,443,45501,443,499,425,74,4,0,3,1
61935,443,10080,443,5214,2561,2653,14,136,7,7
16403,16385,45121,16385,182,62,120,4,30,2,2
63638,53,10182,53,286,78,208,2,30,1,1
37666,443,8330,443,3354,2353,1001,18,45,11,7
37858,443,14705,443,10281,2251,8030,25,17,14,11
56583,53,33992,53,177,94,83,2,29,1,1
64700,53,51210,53,458,188,270,6,29,3,3
49601,53,48706,53,762,97,665,2,30,1,1
64344,53,14813,53,568,192,376,6,71,3,3
51858,44647,20973,44647,66,66,0,1,5,1,0
65248,53,6844,53,446,106,340,4,47,2,2
39674,443,32592,443,2828,1800,1028,27,184,15,12
64835,53,33008,53,200,102,98,2,29,1,1
50298,80,48126,80,166956,16834,150122,187,161,72,115
55857,53,27164,53,192,98,94,2,30,1,1
50575,53,5901,53,766,102,664,2,30,1,1
50639,443,28987,443,15714,2748,12966,58,21,23,35
27005,27025,58786,27025,1634,126,1508,4,31,2,2
55384,53,37937,53,188,96,92,2,31,1,1
45694,80,47472,80,154671,9533,145138,227,38,121,106
64105,53,29112,53,300,102,198,2,30,1,1
49566,80,39778,80,10134,1142,8992,24,46,12,12
49592,53,33191,53,177,94,83,2,30,1,1
33257,443,43255,443,19341,4612,14729,38,21,19,19
59889,443,40054,443,8305,2325,5980,24,46,13,11
56733,53,5825,53,177,94,83,2,29,1,1
55100,53,1559,53,178,94,84,2,30,1,1
49821,53,3854,53,265,94,171,2,30,1,1
40232,53,19769,53,205,86,119,2,29,1,1
52707,443,49592,443,39551,4663,34888,60,357,27,33
35980,443,35980,443,4398,1491,2907,19,26,11,8
47625,53,55385,53,168,78,90,2,30,1,1
56496,53,60823,53,186,95,91,2,30,1,1
60449,28260,44457,28260,70,70,0,2,8,2,0
55620,20795,23864,20795,70,70,0,2,8,2,0
59925,443,55867,443,10302,3853,6449,27,61,16,11
59897,443,39118,443,9919,4495,5424,53,118,30,23
49825,53,56726,53,168,86,82,2,30,1,1
52269,443,52269,443,1615,941,674,15,20,7,8
49935,80,29909,80,1130,613,517,11,15,6,5
56866,53,6471,53,194,102,92,2,30,1,1
49240,53,19807,53,330,101,229,4,47,2,2
50238,53,50499,53,438,180,258,6,30,3,3
55657,37273,33354,37273,70,70,0,2,8,2,0
64230,53,48297,53,193,94,99,2,30,1,1
47711,443,57619,443,11793,7188,4605,34,128,17,17
57913,443,36692,443,10457,4216,6241,70,194,31,39
55549,53,31074,53,202,103,99,2,31,1,1
51838,29448,55370,29448,70,70,0,2,7,2,0
56936,53,1448,53,244,94,150,2,30,1,1
50306,53,23964,53,814,110,704,2,30,1,1
63384,53,63384,53,198,90,108,2,30,1,1
64000,14441,58412,14441,70,70,0,1,4,1,0
36560,3142,36560,3142,138,78,60,2,5,1,1
63981,53,11790,53,199,102,97,2,30,1,1
52051,29868,56419,29868,70,70,0,2,8,2,0
30188,1381,10671,1381,324,150,174,2,1200,1,1
58025,80,19163,80,708,384,324,12,23,7,5
55605,53,59793,53,198,102,96,2,33,1,1
53721,443,9349,443,499,425,74,4,0,3,1
56691,443,29213,443,7862,1873,5989,20,15,11,9
55704,53,48604,53,186,95,91,2,31,1,1
50265,25490,26928,25490,1766,1332,434,22,1200,15,7
55145,443,65048,443,13231,6169,7062,38,120,19,19
26500,80,26500,80,57276,6978,50298,77,30,34,43
64374,53,21599,53,211,94,117,2,30,1,1
51863,22038,18854,22038,70,70,0,2,7,2,0
63064,443,8160,443,448,166,282,2,30,1,1
50424,443,50613,443,5713,1079,4634,15,26,8,7
57062,80,49519,80,864,507,357,8,38,5,3
64493,53,5722,53,353,101,252,4,54,2,2
19473,28867,41961,28867,480,149,331,2,1200,1,1
49180,80,59682,80,6158,654,5504,15,16,8,7
57063,53,6247,53,193,102,91,2,29,1,1
49756,53,1585,53,264,89,175,4,48,2,2
50463,80,10843,80,287874,13215,274659,346,204,136,210
36688,443,22490,443,86101,7312,78789,145,128,63,82
54159,443,5303,443,10945,2478,8467,39,18,19,20
42298,40042,61783,40042,273,73,200,4,29,2,2
39148,443,64587,443,6818,1800,5018,30,271,16,14
49608,53,46552,53,177,94,83,2,30,1,1
62061,443,61994,443,53531,5139,48392,75,47,34,41
13003,3389,13003,3389,3424,1710,1714,16,33,8,8
49901,53,7736,53,272,122,150,2,30,1,1
63765,3389,63765,3389,3444,1730,1714,16,33,8,8
65387,53,24725,53,272,122,150,2,30,1,1
49524,443,52573,443,52864,3584,49280,86,95,39,47
42298,25161,56288,25161,138,70,68,2,30,1,1
59835,443,54646,443,13306,9499,3807,32,23,17,15
53130,443,53130,443,3121,1764,1357,19,181,10,9
63961,53,2242,53,373,171,202,5,40,3,2
48733,443,64638,443,316457,19287,297170,382,80,157,225
44136,53,62801,53,220,78,142,2,30,1,1
53114,443,33125,443,15277,10027,5250,36,46,21,15
29647,53,29647,53,197,76,121,2,30,1,1
49843,53,21434,53,193,102,91,2,30,1,1
50527,53,64659,53,969,86,883,2,30,1,1
49591,80,27431,80,314,128,186,6,27,3,3
50479,443,65060,443,25979,7217,18762,36,16,19,17
57356,443,8609,443,7644,3087,4557,26,46,15,11
52297,80,4278,80,1061,574,487,13,256,7,6
57246,443,63215,443,360050,17258,342792,432,68,185,247
49812,53,21383,53,164,84,80,2,31,1,1
65469,53,34501,53,195,102,93,2,29,1,1
59538,80,24164,80,3835,1767,2068,21,187,12,9
64922,53,12906,53,255,102,153,2,30,1,1
41482,443,54813,443,1062197,37438,1024759,1129,31,416,713
56793,53,12485,53,196,102,94,2,30,1,1
50421,53,19651,53,762,98,664,2,30,1,1
58736,443,28275,443,7978,1143,6835,19,26,9,10
40755,123,40939,123,184,94,90,2,30,1,1
49421,443,23073,443,301494,6917,294577,306,48,101,205
59793,443,27595,443,840,456,384,14,25,8,6
42954,443,44795,443,6813,2515,4298,30,58,16,14
60971,443,16884,443,4548,2858,1690,42,111,22,20
31750,53,31750,53,200,90,110,2,30,1,1
49901,53,27916,53,349,108,241,4,35,2,2
48817,63615,48817,63615,765,296,469,4,1200,2,2
38358,80,53485,80,409,289,120,5,15,3,2
65437,53,38141,53,195,102,93,2,29,1,1
56907,53,11065,53,193,102,91,2,31,1,1
55038,443,25937,443,11429,4904,6525,33,156,18,15
36834,443,25361,443,7251,5852,1399,34,75,18,16
57108,53,37838,53,193,102,91,2,30,1,1
61465,80,64777,80,17320,9430,7890,67,93,35,32
55306,53,44864,53,177,94,83,2,31,1,1
56561,443,49349,443,26334,2210,24124,49,66,22,27
49456,53,3975,53,199,102,97,2,30,1,1
64603,53,6564,53,258,102,156,2,30,1,1
58805,443,39224,443,9030,2311,6719,24,362,13,11
55542,443,7716,443,11550,3336,8214,52,130,25,27
33317,53,33317,53,231,88,143,2,32,1,1
60801,40010,50650,40010,316,136,180,6,6,3,3
62856,443,62856,443,3743,1654,2089,10,120,5,5
56450,53,63813,53,177,94,83,2,30,1,1
59222,53,30617,53,181,86,95,2,30,1,1
64695,53,40312,53,193,102,91,2,29,1,1
61614,53,61614,53,257,101,156,2,33,1,1
55222,53,13241,53,181,94,87,2,29,1,1
55735,53,13880,53,198,101,97,2,31,1,1
64815,123,8798,123,184,94,90,2,31,1,1
53911,1025,4663,1025,70,70,0,1,4,1,0
56940,53,50066,53,200,102,98,2,30,1,1
53976,52534,6002,52534,70,70,0,1,5,1,0
58797,443,17991,443,5167,700,4467,16,15,7,9
63935,51413,5308,51413,312,132,180,6,7,3,3
52078,443,12860,443,9757,2051,7706,34,256,15,19
64658,53,8151,53,195,102,93,2,30,1,1
64091,53,62313,53,178,94,84,2,30,1,1
27005,27016,57250,27016,1784,252,1532,5,31,3,2
65201,53,5254,53,288,94,194,2,30,1,1
56497,443,18628,443,1343,763,580,14,26,8,6
50696,80,3909,80,55872,28838,27034,234,175,117,117
58638,5900,58638,5900,156,62,94,2,10,1,1
62343,443,28448,443,13709,1675,12034,25,31,11,14
60377,443,48988,443,8588,2020,6568,20,76,10,10
49642,443,30931,443,17163,6197,10966,44,43,22,22
63804,52520,33916,52520,66,66,0,2,8,2,0
57275,53,32208,53,177,94,83,2,31,1,1
64588,53,11970,53,193,102,91,2,29,1,1
60297,80,29320,80,1463,865,598,11,144,6,5
53471,8118,42759,8118,1745,1091,654,10,31,5,5
53554,8999,45352,8999,130,70,60,2,5,1,1
52252,443,52252,443,221672,9306,212366,249,21,97,152
63709,21989,3950,21989,696,508,188,10,16,7,3
38675,443,37452,443,13929,2854,11075,43,128,22,21
49266,53,11642,53,330,97,233,4,33,2,2
52209,443,18180,443,502469,15202,487267,580,97,193,387
57052,443,57052,443,4616,1709,2907,19,28,11,8
53776,37650,27111,37650,70,70,0,2,7,2,0
54375,443,15828,443,5642,3872,1770,32,81,17,15
49837,443,60962,443,9634,2232,7402,24,123,12,12
60114,443,25008,443,268,120,148,5,10,3,2
40707,443,1072,443,1969,1195,774,18,122,11,7
64604,53,45485,53,429,109,320,4,37,2,2
39776,443,45893,443,6283,1439,4844,25,316,13,12
49508,443,20014,443,13719,5017,8702,40,283,20,20
49418,27016,30078,27016,78,78,0,1,30,1,0
37994,49152,32893,49152,156,156,0,3,8,3,0
34798,53,14935,53,199,94,105,2,30,1,1
50849,80,37869,80,1218354,26709,1191645,1128,133,332,796
55927,53,41588,53,720,94,626,2,29,1,1
57023,53,45929,53,179,94,85,2,31,1,1
58841,443,62984,443,5168,700,4468,16,15,7,9
52208,80,51352,80,372,246,126,6,28,4,2
42348,53,29230,53,199,94,105,2,30,1,1
65258,53,48935,53,193,102,91,2,30,1,1
55473,53,63957,53,186,102,84,2,30,1,1
64699,53,61689,53,338,110,228,2,30,1,1
58182,443,50635,443,15327,8305,7022,49,137,24,25
56889,53,35698,53,177,94,83,2,30,1,1
65009,53,23695,53,152,78,74,2,30,1,1
55810,53,11576,53,183,94,89,2,29,1,1
62670,443,51023,443,6179,3326,2853,26,186,12,14
50972,3544,28007,3544,258,107,151,2,31,1,1
50884,443,50884,443,187790,7733,180057,229,128,90,139
41764,443,65468,443,9028,5092,3936,36,257,12,24
50661,443,13443,443,298067,6719,291348,307,17,98,209
60335,443,9738,443,1853,1214,639,18,77,11,7
56468,53,40699,53,1421,97,1324,4,55,2,2
52122,43073,9475,43073,70,70,0,2,8,2,0
64299,53,64888,53,166,86,80,2,29,1,1
47276,443,16535,443,7613,2230,5383,22,360,11,11
55990,53,6469,53,183,94,89,2,30,1,1
53968,17904,18186,17904,320,140,180,6,7,3,3
57241,443,46273,443,1167125,49170,1117955,1459,92,635,824
6960,53,6960,53,186,83,103,2,30,1,1
53892,25933,31211,25933,552,306,246,9,15,5,4
38211,123,28193,123,184,94,90,2,29,1,1
56682,53,37640,53,168,86,82,2,30,1,1
41902,443,1832,443,6511,1866,4645,21,17,12,9
53248,443,53248,443,1588,817,771,20,121,10,10
49944,53,58340,53,334,90,244,4,38,2,2
44979,443,29869,443,130,70,60,3,5,2,1
51979,55803,35511,55803,70,70,0,2,7,2,0
50112,123,33230,123,184,94,90,2,30,1,1
50975,80,56708,80,1095845,7641,1088204,839,35,114,725
49558,80,45042,80,39679,7315,32364,45,24,17,28
52058,80,14075,80,362,240,122,7,25,5,2
60339,7010,60339,7010,3322,2027,1295,16,16,9,7
24270,53,24270,53,825,99,726,2,30,1,1
59065,443,57168,443,25840,18434,7406,45,171,26,19
42295,443,63348,443,9164,2473,6691,22,17,13,9
49439,53,40925,53,197,102,95,2,30,1,1
50049,443,21285,443,7912,3269,4643,23,96,12,11
11295,40033,17184,40033,156,94,62,2,30,1,1
49623,53,34250,53,790,110,680,2,29,1,1
49740,53,20655,53,793,101,692,2,31,1,1
54973,53,61675,53,711,87,624,2,30,1,1
47516,80,2518,80,956,541,415,11,316,6,5
53101,443,16538,443,27964,15805,12159,204,904,120,84
45546,80,52456,80,1213,471,742,10,255,6,4
56624,53,64033,53,199,102,97,2,30,1,1
40204,5222,16908,5222,5097,2196,2901,36,25,18,18
15503,62336,46736,62336,127653507,122661116,4992391,161030,2162,82907,78123
41283,53,41283,53,247,98,149,2,31,1,1
56762,53,42811,53,168,86,82,2,30,1,1
56288,53,63412,53,210,110,100,2,30,1,1
37472,443,30492,443,17764,5080,12684,46,121,22,24
36520,3142,36520,3142,138,78,60,2,5,1,1
50432,5222,28391,5222,28281,9813,18468,196,608,100,96
50414,80,48434,80,1657,1246,411,8,15,5,3
50795,443,7705,443,18444,12288,6156,36,149,20,16
64598,53,18969,53,222,94,128,2,29,1,1
123,123,40397,123,184,94,90,2,30,1,1
53669,59056,24869,59056,70,70,0,2,7,2,0
56143,53,46074,53,177,94,83,2,30,1,1
55339,443,4853,443,2552065,30474,2521591,2074,129,236,1838
52171,443,52171,443,154883,8710,146173,182,23,69,113
48040,53,11212,53,168,78,90,2,30,1,1
62062,443,21250,443,134,60,74,3,5,2,1
52187,38153,27552,38153,70,70,0,1,4,1,0
56607,443,1098,443,7862,1873,5989,20,15,11,9
65294,53,10566,53,165,86,79,2,30,1,1
58279,443,21713,443,3878,1156,2722,14,136,7,7
52609,443,37495,443,24091,7349,16742,75,162,36,39
65052,53,65052,53,240,98,142,2,30,1,1
55759,53,16569,53,177,94,83,2,30,1,1
49845,53,35831,53,168,86,82,2,30,1,1
65422,53,8384,53,448,84,364,4,54,2,2
49501,53,50538,53,229,110,119,2,30,1,1
60132,443,39833,443,350,210,140,6,25,4,2
35832,443,34150,443,9276,1884,7392,23,32,13,10
59809,443,46540,443,35140,3700,31440,67,76,30,37
60425,60425,17270,60425,1728,1031,697,14,17,8,6
44984,443,57604,443,4499,2807,1692,24,95,13,11
56715,53,5613,53,1384,88,1296,4,32,2,2
55205,53,36429,53,166,85,81,2,31,1,1
53609,38060,54791,38060,70,70,0,1,5,1,0
56971,53,47465,53,195,102,93,2,30,1,1
60571,443,5687,443,8728,4031,4697,23,17,12,11
56800,443,5999,443,8337,2820,5517,19,30,10,9
53125,10693,11015,10693,954,454,500,14,21,8,6
55252,53,15058,53,212,102,110,2,30,1,1
57470,5254,14927,5254,453,251,202,4,1200,2,2
32900,443,53581,443,14739,1296,13443,30,306,9,21
51994,25509,30907,25509,70,70,0,2,8,2,0
57008,123,60959,123,184,94,90,2,30,1,1
56639,443,6220,443,10138,2213,7925,27,30,16,11
57470,47004,40280,47004,152,152,0,2,1200,2,0
43628,53,19035,53,168,78,90,2,29,1,1
64576,443,9952,443,7069,1210,5859,13,120,6,7
56588,53,38290,53,305,99,206,4,49,2,2
56759,55201,40009,55201,66,66,0,1,5,1,0
28033,443,38606,443,6305,2124,4181,20,16,10,10
43834,443,19453,443,4824,671,4153,13,29,7,6
54980,443,53564,443,1541965,48559,1493406,1663,51,623,1040
43104,443,41004,443,3067,1817,1250,18,15,8,10
64366,443,7841,443,6205,1316,4889,27,301,14,13
51965,80,35850,80,106904,5958,100946,139,66,62,77
49419,53,29016,53,252,102,150,2,30,1,1
34338,443,23040,443,8152,3395,4757,27,18,15,12
51937,80,32427,80,37552,16143,21409,54,28,26,28
64946,53,40387,53,202,95,107,2,31,1,1
50360,80,16489,80,318,192,126,6,28,4,2
58929,443,63640,443,6160,4121,2039,22,17,11,11
60430,443,49199,443,5696,1143,4553,23,119,12,11
58748,443,31963,443,5167,700,4467,16,15,7,9
43095,443,16830,443,3067,1817,1250,18,16,8,10
49370,443,33059,443,5782,1008,4774,17,1,8,9
64814,53,5615,53,243,94,149,2,30,1,1
56078,53,23353,53,168,86,82,2,30,1,1
56750,443,39492,443,8006,1986,6020,20,15,11,9
46277,443,48047,443,15670,12575,3095,51,37,30,21
56668,53,54886,53,177,94,83,2,29,1,1
46000,53,44521,53,164,78,86,2,31,1,1
49730,443,62541,443,400810,14719,386091,506,39,164,342
32914,5222,62781,5222,8702,4668,4034,92,626,50,42
65451,53,62075,53,194,102,92,2,30,1,1
36394,443,63478,443,6485,1692,4793,23,170,13,10
53739,53,43732,53,168,78,90,2,30,1,1
60452,62582,61377,62582,70,70,0,2,8,2,0
6881,6882,61481,6882,238,118,120,2,1199,1,1
55601,53,58800,53,177,94,83,2,30,1,1
44812,443,17089,443,6152,420,5732,13,120,6,7
49281,53,58920,53,345,110,235,2,29,1,1
56169,53,21391,53,210,110,100,2,30,1,1
57073,53,4074,53,99,99,0,1,31,1,0
59585,443,47956,443,4815,2461,2354,47,58,26,21
48655,80,39370,80,956,541,415,11,315,6,5
49245,53,64738,53,195,102,93,2,30,1,1
64999,53,33322,53,178,94,84,2,29,1,1
33850,443,55796,443,6987,2005,4982,18,16,9,9
30127,53,30127,53,197,90,107,2,30,1,1
56354,443,18179,443,3775,1791,1984,24,203,12,12
53755,443,8268,443,499,425,74,4,0,3,1
65339,53,24574,53,193,102,91,2,30,1,1
56477,53,54398,53,199,102,97,2,30,1,1
50121,443,39430,443,29425,9485,19940,54,35,27,27
55834,53,17845,53,184,94,90,2,30,1,1
37680,443,37680,443,4592,1685,2907,19,29,11,8
35247,80,59441,80,1614,1300,314,10,15,5,5
50710,443,45536,443,1786,172,1614,7,120,3,4
64064,29856,35804,29856,66,66,0,2,8,2,0
10006,80,62598,80,1142,636,506,10,45,6,4
58467,53,16449,53,235,95,140,2,31,1,1
56307,53,64603,53,168,78,90,2,30,1,1
10167,80,10167,80,450,246,204,8,25,5,3
44145,443,29432,443,8746,2844,5902,26,315,13,13
33734,53,33734,53,257,101,156,2,33,1,1
27005,27080,13244,27080,926,126,800,2,31,1,1
49543,53,52836,53,200,102,98,2,30,1,1
49337,53,4969,53,303,97,206,4,56,2,2
49724,53,30037,53,470,131,339,4,32,2,2
37437,443,24632,443,4809,818,3991,15,15,8,7
56485,80,57235,80,46400,3639,42761,59,135,25,34
55082,53,13671,53,755,93,662,2,31,1,1
64980,53,3433,53,200,102,98,2,30,1,1
64145,53,59140,53,177,94,83,2,30,1,1
58696,443,11326,443,6889,4719,2170,25,330,14,11
54979,443,32141,443,643217,29500,613717,787,53,338,449
49390,53,24759,53,204,104,100,2,31,1,1
49562,443,59931,443,3380,346,3034,12,120,5,7
34487,443,45811,443,8363,1573,6790,24,49,14,10
56893,53,7619,53,177,94,83,2,30,1,1
49615,53,23958,53,199,102,97,2,30,1,1
53873,443,46663,443,499,425,74,4,1,3,1
62062,443,17723,443,13499,2333,11166,24,137,10,14
55738,53,4750,53,309,94,215,2,30,1,1
60500,44739,45783,44739,70,70,0,2,8,2,0
50708,80,15427,80,3114,1695,1419,15,196,11,4
55835,53,7338,53,176,90,86,2,31,1,1
62208,443,62208,443,4497,1590,2907,19,29,11,8
52127,44198,61078,44198,70,70,0,1,5,1,0
57512,80,20735,80,1377,881,496,12,48,7,5
55205,53,50575,53,167,86,81,2,30,1,1
51004,53,15547,53,194,94,100,2,30,1,1
57259,53,43508,53,199,102,97,2,30,1,1
37646,53,37646,53,832,106,726,2,30,1,1
19924,53,19924,53,235,90,145,2,32,1,1
55951,53,63735,53,197,102,95,2,31,1,1
27005,27016,24190,27016,1696,126,1570,4,31,2,2
56600,80,32176,80,234,234,0,4,12,4,0
57625,443,18316,443,4751,909,3842,15,16,9,6
58381,53,27908,53,199,94,105,2,31,1,1
64742,53,7062,53,338,110,228,2,30,1,1
53778,6881,15801,6881,70,70,0,1,5,1,0
49555,53,24625,53,193,102,91,2,30,1,1
63560,443,29520,443,2773,1570,1203,22,275,11,11
56905,53,61024,53,239,110,129,2,30,1,1
56482,443,53337,443,10788,6521,4267,61,134,31,30
57006,80,58727,80,214,140,74,4,30,3,1
59676,53,12870,53,195,94,101,2,30,1,1
61353,443,57410,443,4401,1654,2747,10,120,5,5
54973,53,46622,53,178,91,87,2,31,1,1
55912,53,61558,53,184,94,90,2,30,1,1
39328,80,5790,80,78,78,0,1,5,1,0
65322,53,59723,53,235,94,141,2,30,1,1
49500,443,11255,443,16888,2692,14196,42,150,22,20
65246,53,35369,53,179,94,85,2,30,1,1
49792,53,58447,53,339,110,229,2,30,1,1
51265,63960,52529,63960,70,70,0,2,8,2,0
26386,53,26386,53,231,90,141,2,30,1,1
57364,53,42885,53,177,94,83,2,29,1,1
63971,53,59567,53,358,94,264,4,45,2,2
55883,53,56307,53,181,94,87,2,31,1,1
48269,443,55381,443,4800,3396,1404,19,60,10,9
60512,6881,33887,6881,320,140,180,6,6,3,3
52959,443,64973,443,9257,2079,7178,39,113,19,20
43865,443,4892,443,560,280,280,9,26,5,4
55890,53,43973,53,193,102,91,2,30,1,1
60794,443,17248,443,796772,27151,769621,878,137,302,576
64229,53,36573,53,266,110,156,2,31,1,1
60180,53,36445,53,225,110,115,2,30,1,1
62730,443,41025,443,12539,6472,6067,81,406,37,44
55520,53,61056,53,194,102,92,2,29,1,1
49964,53,9082,53,760,97,663,2,30,1,1
65419,53,45268,53,199,102,97,2,30,1,1
48150,443,17947,443,502,222,280,8,28,4,4
56470,53,41515,53,198,102,96,2,30,1,1
47147,443,62760,443,70,70,0,1,5,1,0
64586,80,64586,80,123115,6863,116252,160,29,76,84
10039,443,49424,443,12579,1722,10857,29,171,12,17
64056,51266,62758,51266,66,66,0,2,8,2,0
49418,27222,49485,27222,245,78,167,2,30,1,1
38570,443,8181,443,6260,1587,4673,21,191,12,9
49922,53,18616,53,583,105,478,4,42,2,2
63932,53,27137,53,179,94,85,2,30,1,1
56636,443,16823,443,8865,1819,7046,24,30,14,10
49204,443,40475,443,1786,172,1614,7,120,3,4
64667,53,24129,53,353,118,235,2,30,1,1
43376,443,45691,443,7123,1331,5792,22,81,11,11
53901,44425,38536,44425,1686,890,796,10,15,6,4
56705,53,17593,53,168,78,90,2,30,1,1
55244,53,54182,53,186,102,84,2,30,1,1
38779,80,43301,80,540,540,0,10,186,10,0
56322,80,56322,80,27189,4515,22674,34,23,14,20
42386,443,56294,443,12516,2906,9610,41,427,17,24
50700,80,20685,80,55825,28792,27033,234,174,117,117
49775,53,55039,53,399,93,306,4,41,2,2
57424,53,8409,53,210,102,108,2,30,1,1
56613,443,6770,443,6016,1284,4732,18,984,8,10
59595,53,23581,53,164,78,86,2,30,1,1
50867,443,9876,443,2782,1480,1302,17,15,9,8
63630,53,44818,53,278,94,184,2,30,1,1
56079,53,1064,53,199,102,97,2,31,1,1
55154,53,5239,53,184,94,90,2,30,1,1
57275,53,57643,53,199,102,97,2,30,1,1
42860,80,52081,80,1346,842,504,13,123,8,5
60964,443,25466,443,2080,1376,704,17,30,9,8
60419,53,60419,53,217,87,130,2,30,1,1
54982,53,63300,53,282,96,186,4,48,2,2
56994,53,32105,53,177,94,83,2,30,1,1
59815,443,31852,443,4586,955,3631,17,28,9,8
57273,443,35041,443,10926,3915,7011,50,33,28,22
42847,443,14614,443,162,102,60,2,4,1,1
63864,44139,53899,44139,70,70,0,1,5,1,0
52120,42751,65345,42751,70,70,0,2,8,2,0
49905,53,25136,53,180,94,86,2,30,1,1
36261,443,56856,443,1269784,41489,1228295,1339,37,478,861
46780,443,9186,443,9801,3049,6752,29,20,15,14
41228,443,9093,443,9161,2210,6951,23,187,11,12
65162,53,50444,53,328,102,226,2,30,1,1
52063,7886,55344,7886,70,70,0,2,8,2,0
57266,443,58500,443,10174,2163,8011,25,81,14,11
49456,53,39013,53,198,101,97,2,31,1,1
52114,64853,36038,64853,70,70,0,1,5,1,0
51413,443,36557,443,202,70,132,3,11,1,2
49985,53,62790,53,227,102,125,2,29,1,1
55315,53,5468,53,196,102,94,2,31,1,1
49504,53,3816,53,198,94,104,2,30,1,1
56611,80,46294,80,4296,2076,2220,31,128,15,16
54379,80,23086,80,1466,729,737,12,16,7,5
63941,80,15778,80,314,192,122,6,15,4,2
50306,443,54494,443,9889,2800,7089,28,82,17,11
42298,40005,13329,40005,148,86,62,2,29,1,1
59937,443,7727,443,8852,1428,7424,22,199,11,11
57437,53,57480,53,193,102,91,2,30,1,1
51935,38639,36468,38639,70,70,0,1,5,1,0
37965,63402,11159,63402,2118,858,1260,28,1283,14,14
49344,443,51198,443,272627,89686,182941,461,149,220,241
56422,53,39106,53,195,102,93,2,30,1,1
49168,53,25368,53,196,102,94,2,30,1,1
51838,443,42521,443,9329,3898,5431,21,39,12,9
56119,443,4138,443,144290,9387,134903,217,42,110,107
37965,20926,65479,20926,481,150,331,2,1199,1,1
53201,443,51458,443,3655,2344,1311,18,17,9,9
49761,53,14047,53,183,94,89,2,30,1,1
49369,53,33288,53,232,110,122,2,30,1,1
46413,443,45352,443,8106,4839,3267,61,449,32,29
49413,53,52444,53,231,110,121,2,30,1,1
56998,443,56998,443,4577,1670,2907,19,26,11,8
60422,443,51829,443,7274,1925,5349,24,138,12,12
65526,53,17062,53,198,101,97,2,31,1,1
43882,443,18318,443,10494,2409,8085,21,137,9,12
56791,53,43251,53,250,87,163,4,58,2,2
49888,443,12324,443,1072526,64733,1007793,1501,232,690,811
48110,443,9219,443,537031,23421,513610,622,43,258,364
56497,53,23071,53,214,110,104,2,30,1,1
54610,443,65041,443,9948,2463,7485,41,27,22,19
63967,53,14948,53,283,97,186,4,36,2,2
56852,443,47368,443,8215,2882,5333,32,90,16,16
53872,24710,13948,24710,70,70,0,1,5,1,0
65244,53,43768,53,170,87,83,2,30,1,1
59250,443,54786,443,12632,3678,8954,42,27,23,19
58139,443,5557,443,9521,5450,4071,30,120,15,15
49983,53,22293,53,206,105,101,2,31,1,1
58706,80,52999,80,4175,3452,723,14,15,7,7
58885,443,39873,443,354,294,60,2,15,1,1
19473,13315,3345,13315,460,150,310,2,1200,1,1
56269,53,62645,53,816,102,714,2,30,1,1
53395,50321,40284,50321,7546,4168,3378,37,53,24,13
65189,27207,3306,27207,230,78,152,2,30,1,1
30960,45691,5004,45691,330,330,0,6,3609,6,0
58818,443,11066,443,1413,876,537,12,25,6,6
64433,53,21792,53,257,94,163,2,30,1,1
55179,53,32980,53,183,94,89,2,30,1,1
49917,443,56620,443,5899,732,5167,16,41,8,8
64482,53,10257,53,192,98,94,2,31,1,1
65363,53,1138,53,181,94,87,2,31,1,1
42386,443,40078,443,10424,3393,7031,31,274,16,15
45155,443,55125,443,4000,1726,2274,13,135,6,7
53632,58037,4206,58037,70,70,0,2,8,2,0
28132,53,28132,53,176,78,98,2,30,1,1
56748,80,43315,80,194,128,66,4,25,3,1
46256,443,26728,443,15090,9197,5893,33,97,19,14
47828,443,14141,443,143399,8522,134877,208,153,101,107
56196,53,30280,53,214,110,104,2,29,1,1
56616,443,54486,443,8033,2013,6020,20,15,11,9
46838,443,19080,443,10876,3774,7102,12,145,5,7
52476,443,35367,443,7787,3056,4731,19,87,10,9
50477,443,60268,443,130,70,60,2,15,1,1
43595,443,60251,443,31194,5024,26170,44,121,18,26
27005,27999,8243,27999,913,126,787,2,31,1,1
26900,27017,22133,27017,422,164,258,6,30,3,3
48265,443,59042,443,4138,2416,1722,31,80,16,15
58320,53,15987,53,331,86,245,2,30,1,1
55551,53,65057,53,180,94,86,2,30,1,1
58906,443,27261,443,2896,1492,1404,17,17,9,8
52459,33899,52459,33899,66,66,0,1,5,1,0
60492,11339,45509,11339,70,70,0,1,5,1,0
52292,80,52292,80,1914,1302,612,11,14,5,6
43039,53,27551,53,168,78,90,2,29,1,1
53158,17234,26675,17234,70,70,0,2,8,2,0
10461,53,10461,53,220,90,130,2,30,1,1
56266,53,6584,53,245,102,143,2,30,1,1
60501,40829,17093,40829,70,70,0,1,5,1,0
56141,53,40551,53,713,94,619,4,54,2,2
52183,443,15080,443,69339,4124,65215,96,22,45,51
51221,64767,41578,64767,330,330,0,6,1200,6,0
55217,53,28752,53,189,102,87,2,30,1,1
55671,17758,7518,17758,422,140,282,6,15,3,3
33640,443,55083,443,10558,2530,8028,25,186,14,11
54195,443,39081,443,1786,172,1614,7,120,3,4
37998,49152,32246,49152,156,156,0,3,8,3,0
57957,80,26267,80,3524,1945,1579,32,131,17,15
59957,25,59957,25,1721,681,1040,22,17,10,12
54677,443,15752,443,3704,1428,2276,14,135,7,7
56706,443,32876,443,8057,2037,6020,20,15,11,9
55288,53,47176,53,192,98,94,2,31,1,1
9519,443,34920,443,3910,370,3540,16,34,5,11
55080,53,5647,53,330,86,244,2,30,1,1
60238,80,26979,80,1176,701,475,9,150,6,3
55258,53,48782,53,177,94,83,2,30,1,1
39297,443,18589,443,21690,2882,18808,59,197,30,29
2362,53,2362,53,225,90,135,2,30,1,1
53581,53,57842,53,231,94,137,2,30,1,1
47512,443,61793,443,8785,2057,6728,31,396,10,21
49482,80,49482,80,2444,1148,1296,14,48,7,7
59116,53,59116,53,203,82,121,2,30,1,1
55068,443,46144,443,5611,3720,1891,28,54,16,12
51942,443,54861,443,2646,1322,1324,28,36,15,13
53978,27091,3798,27091,320,140,180,6,7,3,3
64568,443,63585,443,25404,2462,22942,47,32,25,22
54744,443,54744,443,4737,2854,1883,25,117,13,12
56357,53,52220,53,172,88,84,2,30,1,1
63997,53,40711,53,676,192,484,6,84,3,3
56710,53,54162,53,355,97,258,4,60,2,2
33013,443,50966,443,88895,4807,84088,104,136,37,67
57416,66,12942,66,70,70,0,1,4,1,0
57333,53,18124,53,342,110,232,2,30,1,1
56678,443,56425,443,7889,1900,5989,20,15,11,9
52236,15313,56383,15313,70,70,0,2,5,2,0
56762,25080,40998,25080,70,70,0,1,5,1,0
57067,53,21723,53,183,94,89,2,31,1,1
49781,53,21515,53,194,102,92,2,30,1,1
57241,53,26543,53,224,102,122,2,30,1,1
57441,53,9760,53,177,94,83,2,29,1,1
43809,443,45485,443,9842,2961,6881,31,19,16,15
49894,80,26822,80,1409,735,674,12,17,5,7
57136,53,51914,53,202,103,99,2,31,1,1
43221,443,25236,443,72183,3193,68990,89,20,34,55
58824,53,47620,53,358,96,262,4,50,2,2
44173,53,9700,53,168,78,90,2,30,1,1
55776,53,11863,53,216,110,106,2,29,1,1
49418,27015,2773,27015,243,78,165,2,30,1,1
56837,53,4890,53,195,102,93,2,29,1,1
50633,443,56668,443,6673,1791,4882,22,72,12,10
64731,53,27701,53,403,142,261,2,30,1,1
61415,80,27732,80,28257,2893,25364,64,138,30,34
0,0,0,0,480,244,236,4,0,2,2
57341,53,29078,53,184,94,90,2,31,1,1
56431,443,60135,443,55149,7806,47343,134,108,61,73
55238,53,60752,53,168,86,82,2,29,1,1
52082,14804,24933,14804,70,70,0,1,4,1,0
64800,53,3701,53,343,92,251,4,50,2,2
56536,53,9836,53,202,103,99,2,31,1,1
65294,53,37568,53,168,86,82,2,30,1,1
55903,53,1701,53,170,87,83,2,30,1,1
38448,443,13312,443,18512,3109,15403,45,48,22,23
9404,443,30760,443,5693,499,5194,14,15,7,7
65241,53,55089,53,200,102,98,2,31,1,1
57379,443,26122,443,7211,823,6388,16,15,10,6
57470,8999,23972,8999,1577,594,983,20,1616,10,10
55127,53,60626,53,253,87,166,4,44,2,2
62463,443,34613,443,4203,2748,1455,18,33,10,8
56433,53,3210,53,177,94,83,2,30,1,1
50711,443,37437,443,2952,1548,1404,18,16,9,9
64641,53,5011,53,260,102,158,2,30,1,1
56836,1,16144,1,130,70,60,2,5,1,1
50285,80,56429,80,4064,607,3457,12,45,6,6
58047,80,5646,80,7453,2953,4500,19,21,10,9
50535,53,65134,53,210,110,100,2,29,1,1
49813,443,15951,443,10103,3140,6963,29,126,16,13
54970,443,62898,443,251620,16028,235592,353,371,159,194
49418,33071,57943,33071,78,78,0,1,30,1,0
65011,53,38944,53,182,93,89,2,30,1,1
56262,53,63670,53,177,94,83,2,30,1,1
55208,443,24176,443,7224,114,7110,9,122,2,7
60221,80,44120,80,17981,13577,4404,41,151,26,15
49646,80,33279,80,318,192,126,6,42,4,2
54221,443,30270,443,8327,4890,3437,23,316,12,11
55085,80,12175,80,306,180,126,6,85,4,2
5588,5588,0,0,3562,1936,1626,48,194,24,24
55948,5223,3545,5223,10038,5272,4766,36,196,20,16
49635,80,43715,80,318,192,126,6,42,4,2
49883,53,5470,53,177,94,83,2,29,1,1
40204,40028,12239,40028,143,81,62,2,30,1,1
56091,53,8508,53,771,101,670,2,31,1,1
53857,22796,40353,22796,492,306,186,8,15,5,3
42213,443,21488,443,4622,926,3696,18,255,10,8
49476,80,51976,80,5000,4058,942,15,15,8,7
60857,443,19971,443,18385,7771,10614,47,48,27,20
53795,22719,46314,22719,164,70,94,2,6,1,1
57366,53,36112,53,711,87,624,2,31,1,1
53264,443,4162,443,41321,1491,39830,52,41,15,37
55224,53,5980,53,209,110,99,2,30,1,1
55435,443,60769,443,684908,25994,658914,762,141,263,499
15503,38120,41177,38120,481,150,331,2,1200,1,1
61335,443,41509,443,42437,8035,34402,79,247,30,49
44948,443,65427,443,4792,3072,1720,31,80,16,15
52170,443,6811,443,11716,7393,4323,47,146,21,26
5588,5588,0,0,3354,1792,1562,46,194,23,23
64886,53,49173,53,199,102,97,2,29,1,1
55845,443,55416,443,505207,16025,489182,464,139,97,367
64627,53,12613,53,184,102,82,2,31,1,1
54975,443,15865,443,441892,86941,354951,716,73,343,373
50534,53,27625,53,168,86,82,2,30,1,1
61099,443,1871,443,82,82,0,1,5,1,0
65428,53,7407,53,731,85,646,2,31,1,1
55620,20795,41932,20795,70,70,0,1,5,1,0
55887,53,35825,53,339,98,241,4,47,2,2
60703,443,30992,443,66716,4091,62625,98,278,43,55
55019,53,27465,53,299,110,189,4,31,2,2
45628,80,45628,80,1243,530,713,10,20,5,5
55633,53,30545,53,195,102,93,2,30,1,1
49402,53,18505,53,214,110,104,2,30,1,1
51939,34393,42807,34393,70,70,0,2,8,2,0
56619,80,59686,80,234,234,0,4,12,4,0
59999,443,56048,443,3047,1277,1770,16,144,8,8
61499,443,53254,443,15584,2626,12958,34,37,18,16
55439,53,12410,53,738,86,652,2,30,1,1
64053,53,7121,53,186,95,91,2,31,1,1
37538,443,35991,443,14826,7220,7606,53,94,29,24
50463,80,9327,80,1718,1247,471,9,15,5,4
49802,53,5262,53,755,93,662,2,31,1,1
55318,53,26417,53,167,86,81,2,29,1,1
64289,53,50043,53,199,102,97,2,30,1,1
55142,53,43974,53,889,404,485,10,30,5,5
35461,5228,26150,5228,8648,2111,6537,40,7038,21,19
58488,3389,58488,3389,3428,1714,1714,16,31,8,8
49930,443,24713,443,16631,7072,9559,50,134,29,21
56508,80,35273,80,318,192,126,6,30,4,2
58414,53,7367,53,245,118,127,2,29,1,1
55822,53,10353,53,324,126,198,2,30,1,1
64473,53,9936,53,184,94,90,2,30,1,1
52073,16316,63189,16316,70,70,0,1,5,1,0
55682,32765,50295,32765,3529,1769,1760,11,15,6,5
55521,53,35090,53,701,88,613,2,30,1,1
53436,443,59367,443,7941,2678,5263,25,122,12,13
65277,53,20067,53,196,102,94,2,30,1,1
49767,53,22379,53,177,94,83,2,31,1,1
44300,443,36814,443,7746,2015,5731,29,15,16,13
50452,80,41109,80,318,192,126,6,29,4,2
56644,53,3506,53,199,94,105,2,30,1,1
64132,53,20663,53,381,102,279,4,42,2,2
27005,27023,64597,27023,875,126,749,2,31,1,1
51566,443,53596,443,3051,990,2061,14,135,7,7
27005,27017,60411,27017,1644,126,1518,4,30,2,2
59407,443,31789,443,3298,2132,1166,16,15,8,8
50290,443,41228,443,6662,3336,3326,37,142,17,20
58239,80,32964,80,2444,2444,0,3,191,3,0
55454,53,16777,53,168,78,90,2,30,1,1
58024,80,1081,80,318,192,126,6,20,4,2
55720,51610,5460,51610,70,70,0,1,5,1,0
57173,53,19613,53,216,110,106,2,31,1,1
64275,53,47631,53,324,90,234,4,35,2,2
55836,53,8077,53,170,87,83,2,31,1,1
63978,53,11123,53,212,108,104,2,31,1,1
55673,53,33131,53,174,89,85,2,31,1,1
65447,53,29961,53,330,105,225,4,37,2,2
56368,53,19580,53,711,87,624,2,30,1,1
44881,53,62824,53,212,78,134,2,30,1,1
56072,53,56771,53,199,102,97,2,30,1,1
59787,443,61520,443,20036,2088,17948,51,334,21,30
62293,443,13135,443,4755,1142,3613,15,273,8,7
55952,443,28479,443,24272,12428,11844,70,213,32,38
51089,80,45189,80,6240,4510,1730,40,131,22,18
63379,443,51286,443,2649,330,2319,12,134,5,7
46525,53,46525,53,404,259,145,3,32,2,1
64023,53,57287,53,179,94,85,2,30,1,1
51130,80,19465,80,366,240,126,7,21,5,2
53271,443,53446,443,34908,2650,32258,52,45,23,29
49804,53,30225,53,209,102,107,2,30,1,1
64330,53,52470,53,193,102,91,2,31,1,1
54245,443,40246,443,499,425,74,4,0,3,1
56689,53,4538,53,177,91,86,3,38,2,1
64531,53,56972,53,183,94,89,2,29,1,1
60484,52001,52870,52001,320,140,180,6,8,3,3
61494,443,60069,443,14558,2653,11905,33,27,18,15
62348,443,31303,443,1592,965,627,15,20,7,8
58967,443,57759,443,9225,1878,7347,28,21,14,14
49786,443,41630,443,10079,2855,7224,23,126,12,11
64124,80,34060,80,1517,481,1036,11,15,6,5
49097,80,63676,80,1739,740,999,17,235,5,12
56769,53,28212,53,182,93,89,2,30,1,1
64502,53,7896,53,374,101,273,4,42,2,2
56998,80,16426,80,214,140,74,4,35,3,1
5588,5588,0,0,3354,1792,1562,46,193,23,23
39442,443,24613,443,6420,1513,4907,25,26,14,11
65059,53,56951,53,197,94,103,2,29,1,1
56988,80,5679,80,214,140,74,4,35,3,1
51801,33531,27515,33531,70,70,0,2,8,2,0
64493,53,11797,53,199,102,97,2,30,1,1
55843,53,63569,53,177,94,83,2,30,1,1
55533,53,56018,53,182,93,89,2,31,1,1
56332,53,27865,53,209,110,99,2,30,1,1
49832,443,25686,443,8589,2871,5718,26,46,14,12
49562,53,45656,53,380,90,290,4,48,2,2
59179,80,14130,80,1399,762,637,10,76,6,4
34331,53,34331,53,404,259,145,3,32,2,1
47894,443,25578,443,52038,3333,48705,74,157,30,44
50376,53,42212,53,819,102,717,2,30,1,1
57334,53,10038,53,184,94,90,2,30,1,1
65218,53,38514,53,194,102,92,2,31,1,1
55942,53,46906,53,194,99,95,2,31,1,1
52058,8329,7251,8329,66,66,0,1,5,1,0
37991,443,2941,443,9566,2592,6974,29,134,16,13
51502,80,42285,80,1515,481,1034,11,15,6,5
55019,53,59602,53,299,110,189,4,31,2,2
52407,443,53495,443,100194,6406,93788,171,24,85,86
51540,443,24638,443,957715,36759,920956,1075,161,378,697
55184,53,59449,53,183,94,89,2,30,1,1
60326,80,6892,80,3697,2062,1635,16,61,9,7
48565,53,48565,53,197,90,107,2,30,1,1
48574,443,45361,443,9336,1153,8183,27,34,14,13
63025,443,40805,443,304,86,218,2,30,1,1
56941,53,44223,53,196,102,94,2,30,1,1
27005,27035,7636,27035,891,126,765,2,30,1,1
51675,8245,24099,8245,346,214,132,3,29,1,2
44886,443,1331,443,7775,2973,4802,36,57,19,17
64614,53,3667,53,186,95,91,2,30,1,1
55307,53,50101,53,1415,101,1314,4,51,2,2
50336,443,6025,443,8814,1579,7235,24,41,12,12
58102,443,20475,443,14197,9283,4914,28,122,15,13
26900,27017,37191,27017,422,164,258,6,30,3,3
64926,53,43197,53,192,98,94,2,40,1,1
61445,443,34767,443,97211,3043,94168,109,121,37,72
59759,443,40820,443,13342,1221,12121,33,41,15,18
49418,27015,24745,27015,270,78,192,2,30,1,1
65155,53,9340,53,613,200,413,6,59,3,3
60431,443,1098,443,3260,1646,1614,9,120,5,4
37759,53,22729,53,164,78,86,2,30,1,1
49687,53,24599,53,775,103,672,2,31,1,1
54542,443,54542,443,150554,18764,131790,192,117,95,97
5416,53,5416,53,213,79,134,2,33,1,1
54653,6881,28676,6881,658,412,246,9,15,5,4
49247,53,61621,53,817,102,715,2,30,1,1
56366,53,46809,53,754,94,660,2,31,1,1
41940,443,2811,443,26974,22004,4970,80,216,42,38
51221,49683,21900,49683,870,330,540,12,1316,6,6
58755,443,6984,443,4827,2244,2583,16,135,8,8
56922,53,64459,53,168,86,82,2,30,1,1
38627,443,6493,443,32864,2590,30274,41,82,14,27
57470,59216,60669,59216,594,594,0,10,1200,10,0
19573,53,49198,53,183,78,105,2,30,1,1
50940,443,10678,443,6888,1774,5114,25,210,14,11
65287,53,18878,53,180,94,86,2,31,1,1
63914,32805,13245,32805,70,70,0,1,4,1,0
57431,53,54427,53,181,94,87,2,30,1,1
65402,53,33102,53,297,110,187,2,30,1,1
57651,80,10587,80,1151,711,440,10,15,5,5
3851,53,3851,53,235,90,145,2,33,1,1
49387,53,43855,53,323,102,221,2,30,1,1
61314,443,62611,443,3320,2053,1267,27,318,14,13
56261,53,65402,53,199,94,105,2,30,1,1
56301,443,56301,443,4378,1471,2907,19,30,11,8
56811,443,16024,443,8020,2000,6020,20,15,11,9
49469,443,50617,443,6416,1302,5114,20,119,10,10
56759,443,10401,443,8058,2038,6020,20,15,11,9
57470,52215,48091,52215,528,528,0,9,1200,9,0
33017,443,62492,443,11008,4624,6384,36,322,19,17
49675,5900,49675,5900,124,60,64,2,5,1,1
56459,53,30479,53,209,110,99,2,30,1,1
50947,80,65255,80,5427472,61630,5365842,4509,79,894,3615
56032,443,63053,443,1775,169,1606,7,120,3,4
60340,80,29761,80,9406,1913,7493,14,16,7,7
38666,443,18669,443,94827,3328,91499,97,16,30,67
52694,443,37161,443,10384,4563,5821,34,436,17,17
63854,53,30633,53,578,286,292,9,15,5,4
37965,8999,11644,8999,402,132,270,6,1208,3,3
50584,12899,63307,12899,166,166,0,1,1200,1,0
56896,53,58642,53,177,94,83,2,30,1,1
46776,443,41505,443,7389,1786,5603,26,211,14,12
45343,443,52570,443,2312,1382,930,19,26,11,8
52013,80,47338,80,27271,12050,15221,45,38,24,21
49211,443,58097,443,9739,3414,6325,59,928,30,29
49418,31000,56556,31000,260,78,182,2,30,1,1
27005,1304,58771,1304,859,126,733,2,29,1,1
27761,53,27761,53,832,106,726,2,30,1,1
53948,7370,61393,7370,70,70,0,2,8,2,0
60638,53,31002,53,337,86,251,2,29,1,1
6189,53,29429,53,229,86,143,2,30,1,1
5819,53,5819,53,197,90,107,2,30,1,1
57288,53,1558,53,354,94,260,2,30,1,1
55808,53,41787,53,183,94,89,2,30,1,1
65386,53,26119,53,1160,392,768,10,66,5,5
55667,19667,61736,19667,70,70,0,1,5,1,0
49250,53,39996,53,225,110,115,2,29,1,1
59325,53,7735,53,211,78,133,2,30,1,1
64326,53,30580,53,196,102,94,2,29,1,1
43215,443,55751,443,3245691,49693,3195998,2856,38,666,2190
9313,443,38695,443,4618,840,3778,16,26,9,7
49621,53,59180,53,287,93,194,4,56,2,2
54241,443,12202,443,499,425,74,4,0,3,1
49498,443,65049,443,5394,2785,2609,14,134,7,7
62234,443,62234,443,187597,6822,180775,203,92,67,136
57470,14806,59723,14806,132,132,0,3,1199,3,0
63116,53,14772,53,578,286,292,9,15,5,4
50465,80,51689,80,3688274,86827,3601447,3622,32,1228,2394
36368,80,54133,80,78,78,0,1,5,1,0
49947,53,36871,53,264,102,162,2,30,1,1
56262,53,64499,53,170,87,83,2,31,1,1
64980,53,51851,53,180,94,86,2,30,1,1
52259,25011,50909,25011,70,70,0,2,8,2,0
56786,443,13825,443,5698,906,4792,19,27,11,8
49198,443,22902,443,533813,25885,507928,678,50,308,370
65053,53,65053,53,235,90,145,2,31,1,1
49773,80,19021,80,70,70,0,2,8,2,0
38502,443,34798,443,2378,1126,1252,14,978,7,7
6882,4443,56989,4443,600,600,0,5,1200,5,0
59623,161,0,0,11212,5520,5692,58,30,29,29
64996,27034,9075,27034,1761,924,837,6,30,3,3
52764,443,33185,443,14001,2908,11093,35,150,18,17
57096,53,49643,53,443,182,261,6,29,3,3
59762,443,29034,443,382,164,218,2,31,1,1
53155,28206,56023,28206,70,70,0,1,5,1,0
42298,40008,62209,40008,148,86,62,2,30,1,1
56071,53,41864,53,186,95,91,2,31,1,1
57254,443,23704,443,6000,1578,4422,22,36,12,10
52952,443,15638,443,9381,3074,6307,47,114,24,23
53140,443,26358,443,6401,1225,5176,18,324,9,9
64484,53,57722,53,168,86,82,2,30,1,1
57382,53,23125,53,184,94,90,2,29,1,1
62678,53,62678,53,216,90,126,2,30,1,1
49321,53,38287,53,184,94,90,2,29,1,1
33243,443,33380,443,1067,650,417,10,31,6,4
55487,53,4696,53,732,89,643,2,30,1,1
40410,443,37656,443,2975,719,2256,14,136,7,7
56332,53,61425,53,193,102,91,2,31,1,1
65115,53,24571,53,193,102,91,2,29,1,1
57011,80,37769,80,214,140,74,4,30,3,1
63834,27037,60626,27037,1592,1386,206,6,31,4,2
49475,80,53528,80,1548,847,701,10,16,5,5
50291,80,56837,80,442,250,192,8,45,5,3
56672,53,28355,53,198,101,97,2,31,1,1
57243,53,64536,53,165,86,79,2,31,1,1
64056,53,57608,53,383,94,289,2,30,1,1
61234,443,50660,443,1786,172,1614,7,120,3,4
48070,443,9695,443,10240,2295,7945,38,121,20,18
39609,53,46701,53,168,78,90,2,30,1,1
64073,53,51133,53,361,86,275,2,30,1,1
55004,53,63304,53,270,102,168,2,30,1,1
55947,53,33524,53,311,108,203,4,42,2,2
56004,443,46384,443,130,70,60,3,4,2,1
49374,53,26610,53,307,102,205,4,35,2,2
63906,36909,30978,36909,66,66,0,2,7,2,0
54432,53,45895,53,168,78,90,2,30,1,1
59653,80,58858,80,1139,609,530,10,34,6,4
49889,53,3966,53,310,99,211,4,40,2,2
61502,443,14539,443,580643,7944,572699,475,41,86,389
65277,53,40483,53,167,86,81,2,30,1,1
40953,443,21244,443,4093,1595,2498,23,15,12,11
64174,53,10238,53,180,94,86,2,31,1,1
54344,443,13534,443,10015,6047,3968,22,122,12,10
49178,2710,40497,2710,70,70,0,1,5,1,0
65516,443,35348,443,451899,13130,438769,463,16,162,301
37965,11102,8568,11102,132,132,0,3,1200,3,0
43718,53,43718,53,209,77,132,2,34,1,1
64731,53,43372,53,241,110,131,2,30,1,1
51635,80,51635,80,699944,13137,686807,676,20,195,481
57470,6887,18117,6887,471,269,202,4,1199,2,2
55728,53,39278,53,190,97,93,2,31,1,1
47832,80,56253,80,1151,711,440,10,15,5,5
53743,443,64755,443,495,421,74,4,1,3,1
56478,53,29572,53,177,94,83,2,29,1,1
56389,53,11725,53,774,101,673,2,31,1,1
58386,443,63968,443,15705,3421,12284,53,360,23,30
64067,53,52701,53,329,94,235,2,29,1,1
36661,53,36661,53,237,93,144,2,30,1,1
49449,443,30580,443,1574,921,653,14,15,7,7
49159,53,48232,53,213,102,111,2,29,1,1
26900,27017,4107,27017,422,164,258,6,29,3,3
50316,53,39379,53,193,102,91,2,30,1,1
65009,53,11589,53,152,78,74,2,30,1,1
56765,53,28041,53,194,102,92,2,30,1,1
64679,53,60915,53,178,94,84,2,30,1,1
50523,443,53596,443,6676,1074,5602,22,84,12,10
46694,443,30947,443,3680,1777,1903,18,34,8,10
0,0,0,0,244,244,0,2,0,2,0
57054,53,38199,53,164,78,86,2,30,1,1
53402,443,53402,443,4582,1675,2907,19,29,11,8
60903,443,18682,443,333062,18123,314939,420,88,182,238
123,123,5546,123,184,94,90,2,29,1,1
35078,443,15189,443,7222,1768,5454,22,81,13,9
51873,19311,58554,19311,70,70,0,2,7,2,0
57588,53,31636,53,165,78,87,2,30,1,1
21424,53,21424,53,225,90,135,2,29,1,1
59754,80,41353,80,1352,848,504,13,83,8,5
63807,38976,41497,38976,66,66,0,1,5,1,0
62441,443,36404,443,4651,3116,1535,19,44,10,9
55363,53,15445,53,228,110,118,2,30,1,1
46531,53,8725,53,209,86,123,2,30,1,1
53546,443,23696,443,7268,3166,4102,19,136,10,9
64585,53,62482,53,821,102,719,2,30,1,1
55063,5223,9362,5223,4336,1518,2818,23,3002,14,9
65388,53,55189,53,764,99,665,2,31,1,1
47739,5228,19332,5228,2852,2143,709,16,121,8,8
40680,5228,59129,5228,234,174,60,2,4,1,1
40401,80,34965,80,1603,1179,424,10,124,6,4
49777,53,60241,53,272,84,188,4,60,2,2
57368,53,6129,53,701,88,613,2,30,1,1
54200,443,47040,443,499,425,74,4,0,3,1
56731,53,12750,53,165,86,79,2,30,1,1
49907,53,29279,53,308,92,216,2,30,1,1
55581,53,16064,53,167,86,81,2,30,1,1
51971,80,13099,80,60753,2612,58141,76,46,34,42
50552,53,38940,53,164,78,86,2,30,1,1
60397,43129,42698,43129,70,70,0,1,5,1,0
56947,443,19771,443,5601,1203,4398,14,60,9,5
57072,53,1078,53,190,97,93,2,31,1,1
48952,443,47489,443,15944,6988,8956,135,324,72,63
64516,53,9042,53,216,110,106,2,30,1,1
65167,53,20946,53,219,94,125,2,30,1,1
49208,53,22620,53,578,286,292,9,15,5,4
35973,443,21497,443,4665045,113088,4551957,4511,421,1285,3226
64041,53,58555,53,200,102,98,2,31,1,1
49205,53,3818,53,720,94,626,2,30,1,1
56725,443,7873,443,6481,972,5509,17,52,10,7
57301,53,40888,53,177,94,83,2,29,1,1
59723,443,40207,443,304,86,218,2,30,1,1
61409,443,48164,443,7839,1726,6113,21,77,11,10
55905,53,39225,53,754,94,660,2,30,1,1
56752,43888,19580,43888,70,70,0,1,5,1,0
38083,443,10081,443,2465,1356,1109,18,180,8,10
49767,53,20343,53,177,94,83,2,29,1,1
60895,443,6009,443,9387,2961,6426,38,18,23,15
56176,443,9976,443,1312,651,661,13,185,7,6
57452,53,53868,53,776,102,674,2,30,1,1
64746,53,35675,53,193,102,91,2,30,1,1
55625,443,33412,443,96323,4044,92279,113,139,44,69
56753,443,16519,443,8058,2038,6020,20,15,11,9
55917,53,40255,53,177,94,83,2,30,1,1
65405,53,15243,53,210,102,108,2,30,1,1
37645,443,51983,443,23266,18300,4966,56,27,33,23
59400,443,43611,443,6489,2731,3758,19,16,10,9
51543,53,3333,53,78,78,0,1,30,1,0
64425,53,6282,53,182,86,96,2,29,1,1
60166,443,38227,443,8198,2252,5946,29,318,14,15
56216,5228,61293,5228,2495,1477,1018,17,3600,8,9
50391,80,25680,80,2837,582,2255,12,17,7,5
50977,80,25806,80,1111949,11633,1100316,906,37,173,733
43286,80,30144,80,1638,1324,314,10,15,5,5
46285,443,47233,443,40877,5947,34930,81,56,39,42
61358,3389,61358,3389,3488,1774,1714,17,33,9,8
55856,53,9134,53,1410,93,1317,4,59,2,2
55232,53,12562,53,177,94,83,2,29,1,1
52065,52021,26408,52021,70,70,0,2,7,2,0
53695,21965,20178,21965,2044,1143,901,19,16,9,10
65332,53,55664,53,94,94,0,1,30,1,0
60371,443,40685,443,7202,2596,4606,24,83,12,12
57949,5228,62651,5228,2655,1540,1115,19,3601,9,10
64319,53,63281,53,193,102,91,2,29,1,1
58971,443,47268,443,2702,1593,1109,21,23,11,10
56992,80,9421,80,214,140,74,4,35,3,1
55368,53,50855,53,760,97,663,2,31,1,1
56782,49135,47020,49135,70,70,0,2,8,2,0
48348,443,49861,443,20838,2211,18627,40,14,20,20
64929,53,8681,53,168,86,82,2,31,1,1
53270,443,30676,443,6894,1556,5338,23,3601,13,10
49155,443,35211,443,8941,1776,7165,22,136,12,10
64813,53,44563,53,180,94,86,2,30,1,1
60742,20010,30698,20010,70,70,0,1,5,1,0
0,0,0,0,600,306,294,6,0,3,3
51904,51883,62551,51883,70,70,0,2,8,2,0
40204,40027,54251,40027,245,182,63,2,30,1,1
57137,53,7336,53,711,87,624,2,30,1,1
49926,80,8028,80,1126,609,517,11,15,6,5
64903,53,57537,53,210,110,100,2,30,1,1
56960,53,36561,53,196,102,94,2,30,1,1
49429,53,3365,53,199,102,97,2,29,1,1
57470,49160,41673,49160,132,132,0,3,1199,3,0
51439,443,29374,443,396,66,330,7,17,2,5
56660,53,40707,53,183,94,89,2,30,1,1
64811,53,22274,53,195,102,93,2,29,1,1
46339,443,43068,443,4392,1781,2611,21,20,12,9
59424,443,28784,443,2288,1131,1157,25,119,12,13
54324,27016,3441,27016,924,924,0,3,30,3,0
49996,53,8571,53,183,94,89,2,30,1,1
49214,443,4327,443,17273,11238,6035,73,919,36,37
37630,443,19874,443,10000,2634,7366,28,46,16,12
65127,53,26912,53,188,96,92,2,31,1,1
56192,53,12282,53,282,87,195,4,45,2,2
57239,5228,64844,5228,16135,7514,8621,173,9115,72,101
38610,443,57889,443,19092095,654744,18437351,24079,407,8531,15548
55427,443,18604,443,9255,2064,7191,43,78,18,25
43268,443,16959,443,8954,2755,6199,23,143,10,13
38645,443,41278,443,2535,1177,1358,16,28,7,9
50265,12656,39117,12656,402,132,270,6,1209,3,3
55240,53,47282,53,193,102,91,2,30,1,1
55776,53,24282,53,168,78,90,2,30,1,1
51975,443,63500,443,35746,4732,31014,68,67,33,35
51091,53,0,0,325,75,250,2,30,1,1
57606,80,57606,80,11536,3264,8272,29,37,15,14
56411,53,42159,53,184,94,90,2,31,1,1
56767,53,17852,53,170,87,83,2,31,1,1
53174,41442,6472,41442,70,70,0,2,8,2,0
55939,53,57194,53,193,102,91,2,31,1,1
64049,1029,15442,1029,70,70,0,1,5,1,0
63789,443,32462,443,4407024,140001,4267023,4628,124,1546,3082
55325,53,50233,53,210,110,100,2,30,1,1
57470,10714,2677,10714,132,132,0,3,1199,3,0
60986,443,43448,443,7231,2305,4926,32,40,18,14
57328,53,13021,53,1427,101,1326,4,48,2,2
56640,80,54626,80,234,234,0,4,11,4,0
51787,80,42388,80,26626,1555,25071,36,20,16,20
53251,443,19794,443,5025,973,4052,19,66,10,9
65189,28015,14178,28015,240,78,162,2,29,1,1
57449,80,1245,80,4508,2978,1530,13,15,6,7
42298,40023,34639,40023,1188,567,621,6,31,3,3
64685,53,55702,53,193,102,91,2,30,1,1
64566,53,24742,53,194,102,92,2,30,1,1
0,0,0,0,480,244,236,4,0,2,2
57305,53,33562,53,177,94,83,2,30,1,1
56837,53,43966,53,176,90,86,2,31,1,1
56435,80,7640,80,17248,1619,15629,26,25,11,15
58701,80,43595,80,12499310,161518,12337792,10496,70,2325,8171
47740,443,62722,443,6234,4369,1865,25,316,12,13
53986,443,26855,443,6734,2264,4470,19,16,11,8
50615,80,48256,80,190675,79205,111470,237,41,104,133
50356,53,30610,53,180,94,86,2,30,1,1
49317,53,61782,53,194,102,92,2,30,1,1
51982,56306,51670,56306,70,70,0,1,5,1,0
51847,53,49805,53,164,78,86,2,31,1,1
55711,53,26039,53,177,94,83,2,29,1,1
57177,53,20677,53,179,94,85,2,29,1,1
63012,443,56934,443,3707,1245,2462,11,119,6,5
51972,80,28549,80,7001170,112187,6888983,6101,29,1546,4555
48817,13259,48817,13259,460,150,310,2,1200,1,1
64255,53,15083,53,260,86,174,2,30,1,1
56946,443,38559,443,10408,4790,5618,34,322,16,18
64169,53,8733,53,209,110,99,2,30,1,1
54044,53,15773,53,224,86,138,2,29,1,1
64128,53,22207,53,194,94,100,2,31,1,1
49418,27015,5163,27015,265,78,187,2,31,1,1
21839,443,21839,443,13003,1226,11777,25,19,12,13
60873,443,24507,443,10707,2969,7738,32,47,18,14
49677,53,61420,53,373,126,247,2,29,1,1
37313,443,31778,443,1364815,60410,1304405,1401,901,341,1060
62486,53,33326,53,303,303,0,4,47,4,0
41061,5222,19047,5222,107717,16808,90909,301,618,148,153
57134,53,30351,53,190,97,93,2,30,1,1
65498,443,2400,443,92290,4799,87491,107,16,43,64
49518,53,63252,53,186,95,91,2,30,1,1
63831,31539,8065,31539,312,132,180,6,7,3,3
65433,80,53822,80,486,240,246,9,28,5,4
55618,53,36676,53,199,94,105,2,30,1,1
49555,443,34197,443,740109,22948,717161,800,54,311,489
61661,53,61661,53,235,90,145,2,33,1,1
56754,53,65237,53,183,94,89,2,30,1,1
51895,17172,52457,17172,70,70,0,2,8,2,0
57470,8100,10100,8100,3281,894,2387,14,1200,7,7
39915,443,44120,443,6922156,117604,6804552,6122,50,1519,4603
65222,53,38822,53,197,94,103,2,29,1,1
54519,443,46768,443,70,70,0,1,5,1,0
49202,31719,45347,31719,70,70,0,2,8,2,0
53754,25306,12188,25306,70,70,0,2,8,2,0
53722,443,28671,443,70,70,0,1,5,1,0
65075,53,3072,53,278,100,178,4,31,2,2
60813,443,60813,443,1386,751,635,15,182,8,7
35099,53,35099,53,225,106,119,2,30,1,1
49390,53,56282,53,210,110,100,2,30,1,1
49282,53,18906,53,197,94,103,2,30,1,1
64746,53,23146,53,193,102,91,2,30,1,1
49670,443,18797,443,16957,6203,10754,30,52,14,16
46660,443,53403,443,13699,2575,11124,30,135,15,15
47947,80,61494,80,2917,870,2047,14,16,8,6
64507,53,28479,53,382,102,280,2,29,1,1
27005,27001,28063,27001,887,126,761,2,31,1,1
49721,443,52287,443,4588,843,3745,14,52,7,7
49296,443,32357,443,50454,5259,45195,52,105,17,35
48740,443,37273,443,7868,2194,5674,26,36,13,13
27005,27015,49049,27015,1610,126,1484,4,30,2,2
43976,80,46864,80,130,70,60,2,15,1,1
57034,443,8240,443,30645,2719,27926,60,153,25,35
49828,443,43122,443,7284,1353,5931,26,186,14,12
32940,443,60631,443,13056,4233,8823,27,121,12,15
51818,43942,60184,43942,156,66,90,2,5,1,1
55321,53,63193,53,193,102,91,2,30,1,1
56887,53,19033,53,177,94,83,2,31,1,1
8167,443,8167,443,1474,697,777,18,82,8,10
49777,443,42531,443,35152,27056,8096,56,104,31,25
58894,443,36068,443,5168,700,4468,16,15,7,9
42578,443,22827,443,68806,2442,66364,71,215,19,52
64607,53,58592,53,211,110,101,2,31,1,1
55792,53,52460,53,199,102,97,2,29,1,1
44638,443,36875,443,20062,11233,8829,48,94,29,19
38766,53,38766,53,371,237,134,3,32,2,1
53225,443,9099,443,6597,1798,4799,28,80,12,16
64324,53,12173,53,174,89,85,2,30,1,1
53702,51413,55761,51413,70,70,0,1,5,1,0
10307,53,10307,53,213,87,126,2,30,1,1
49835,53,4123,53,250,86,164,4,30,2,2
58886,15000,23434,15000,138,78,60,2,5,1,1
55795,53,50908,53,177,94,83,2,30,1,1
60385,59696,6029,59696,70,70,0,1,5,1,0
27005,27019,28419,27019,880,126,754,2,30,1,1
0,0,0,0,244,244,0,2,0,2,0
40288,80,46706,80,1195,763,432,10,32,6,4
64677,53,35002,53,190,97,93,2,31,1,1
64772,53,2611,53,633,231,402,6,47,3,3
55261,53,19096,53,177,94,83,2,29,1,1
50579,53,55360,53,174,89,85,2,31,1,1
57639,80,57639,80,104868,1493,103375,90,31,17,73
59950,53,40733,53,168,78,90,2,31,1,1
28479,53,28479,53,235,90,145,2,33,1,1
6882,9220,16555,9220,654,150,504,3,1200,1,2
57071,53,47529,53,274,110,164,2,31,1,1
56359,443,2986,443,3734,1750,1984,24,203,12,12
49546,53,5497,53,212,110,102,2,30,1,1
56113,53,57844,53,194,102,92,2,30,1,1
58556,80,23584,80,884,529,355,10,255,6,4
64674,53,13295,53,183,94,89,2,29,1,1
53019,80,53019,80,181759,5146,176613,216,25,77,139
50867,443,26907,443,6351,1370,4981,18,131,9,9
53706,59208,33732,59208,258,70,188,4,8,2,2
52153,12673,40206,12673,316,136,180,6,6,3,3
49670,443,17269,443,98424,28850,69574,508,2054,274,234
50698,80,42687,80,54871,28320,26551,231,174,116,115
50376,443,64568,443,7738,879,6859,19,27,10,9
64256,53,36499,53,211,78,133,2,29,1,1
48658,443,56881,443,6799,4474,2325,38,85,20,18
56559,53,54013,53,177,94,83,2,30,1,1
42156,80,29548,80,891,536,355,10,255,6,4
47167,15000,34015,15000,130,70,60,2,6,1,1
56417,80,64869,80,38188,688,37500,35,104,7,28
49604,53,54196,53,179,94,85,2,29,1,1
49099,53,46349,53,238,94,144,2,30,1,1
64117,53,64117,53,209,77,132,2,32,1,1
65382,53,24981,53,301,108,193,4,54,2,2
48533,443,47218,443,160,69,91,2,121,1,1
51666,45702,58433,45702,1201,577,624,8,30,4,4
63242,443,5586,443,9042,4612,4430,31,175,17,14
54775,443,18687,443,12150,2950,9200,35,341,17,18
58207,443,31795,443,10209,2530,7679,33,223,17,16
39060,443,26337,443,8554,2353,6201,29,138,14,15
44307,443,62796,443,92044,19483,72561,147,186,55,92
50379,53,49959,53,197,102,95,2,29,1,1
64979,53,10691,53,194,102,92,2,30,1,1
55020,443,50900,443,670633,656612,14021,657,146,465,192
30960,45736,51969,45736,396,396,0,7,3616,7,0
53233,443,34879,443,6059,1040,5019,20,58,11,9
60210,80,21481,80,5141,3706,1435,17,151,10,7
64109,53,30318,53,225,102,123,2,30,1,1
57885,80,59656,80,32460,9354,23106,67,71,40,27
53737,51456,42714,51456,70,70,0,1,5,1,0
46902,443,9815,443,1312,651,661,13,184,7,6
57509,443,8553,443,5150,3987,1163,18,38,11,7
60906,443,59580,443,11543,5375,6168,45,47,24,21
33633,443,34965,443,5698,1585,4113,23,1108,13,10
49418,12345,11846,12345,249,71,178,2,30,1,1
55922,53,13122,53,184,94,90,2,29,1,1
55454,53,51580,53,168,86,82,2,33,1,1
57117,53,45575,53,366,102,264,4,46,2,2
56429,53,7462,53,762,98,664,2,31,1,1
49940,443,49940,443,13342,2357,10985,25,18,14,11
49418,27016,40313,27016,71,71,0,1,30,1,0
55791,53,26721,53,770,101,669,2,30,1,1
50258,443,57201,443,7975,1974,6001,31,210,15,16
56161,53,11132,53,199,94,105,2,30,1,1
34305,80,22535,80,2443,1794,649,11,76,6,5
55032,53,0,0,288,79,209,2,31,1,1
53633,443,6086,443,8473,1099,7374,20,18,9,11
64388,53,41426,53,258,110,148,2,30,1,1
55376,53,1208,53,199,102,97,2,30,1,1
41316,443,15056,443,4997074,153969,4843105,5249,343,1861,3388
55012,443,47170,443,3388,2236,1152,28,904,16,12
49564,53,39263,53,193,102,91,2,30,1,1
35053,80,19912,80,71843,2833,69010,83,15,36,47
51670,443,38480,443,1203,703,500,14,38,8,6
8531,53,8531,53,213,87,126,2,30,1,1
48652,443,38749,443,6388,964,5424,21,255,11,10
38689,443,13215,443,1264333,25315,1239018,1197,16,355,842
50294,443,54513,443,9999,2316,7683,30,26,15,15
58120,53,58120,53,825,99,726,2,30,1,1
64618,53,13340,53,410,102,308,2,29,1,1
27345,53,27345,53,398,255,143,3,33,2,1
56615,53,39007,53,177,94,83,2,29,1,1
65343,53,45519,53,328,99,229,4,45,2,2
61489,443,63810,443,4624,1191,3433,23,75,14,9
57987,3478,61463,3478,60483,25857,34626,136,47,63,73
33327,53,12719,53,199,94,105,2,29,1,1
55727,53,51328,53,190,97,93,2,30,1,1
50606,80,30995,80,83795,22317,61478,117,43,52,65
52292,443,35142,443,21680,2897,18783,35,120,15,20
65486,53,61924,53,216,102,114,2,30,1,1
61807,443,12289,443,6244,1855,4389,16,75,9,7
51502,443,41545,443,7211,823,6388,16,15,10,6
53458,443,17930,443,144165,6110,138055,170,31,67,103
49760,53,45249,53,183,94,89,2,29,1,1
45392,443,53669,443,1312,651,661,13,185,7,6
49477,53,44035,53,168,78,90,2,30,1,1
54122,443,54122,443,186718,24971,161747,253,84,127,126
54188,443,5906,443,2895,1646,1249,17,16,8,9
61459,80,3928,80,4671,2593,2078,15,85,9,6
65174,53,23443,53,214,110,104,2,30,1,1
49794,443,25276,443,7307,841,6466,18,126,9,9
55337,53,22307,53,294,106,188,4,55,2,2
48220,443,48220,443,4627,1720,2907,18,26,10,8
49411,53,17691,53,195,102,93,2,31,1,1
52223,11979,36766,11979,70,70,0,2,9,2,0
55514,53,24000,53,216,94,122,2,30,1,1
52069,443,58319,443,8593,2221,6372,31,232,17,14
57208,53,46583,53,183,94,89,2,31,1,1
36887,443,63451,443,10922,2532,8390,27,28,13,14
57588,443,16925,443,9109,2044,7065,25,22,14,11
35439,443,50661,443,3730,2455,1275,18,256,10,8
57176,53,43366,53,178,94,84,2,30,1,1
52917,443,43916,443,7148,2358,4790,40,116,18,22
9462,443,5144,443,4717,2929,1788,23,26,13,10
40501,443,64068,443,6517,1812,4705,21,255,11,10
50408,7000,50408,7000,3132,815,2317,14,18,7,7
53161,30013,56221,30013,70,70,0,1,5,1,0
64530,53,5563,53,264,110,154,2,30,1,1
54983,53,35853,53,728,102,626,2,30,1,1
52375,80,39641,80,78,78,0,1,5,1,0
51951,443,35308,443,3854,1151,2703,20,135,10,10
60431,52867,18137,52867,70,70,0,1,5,1,0
50353,443,5439,443,130,70,60,3,4,2,1
41385,53,41385,53,244,98,146,2,34,1,1
123,123,48945,123,184,94,90,2,29,1,1
57184,53,36086,53,272,94,178,2,29,1,1
50347,443,6764,443,1385,868,517,12,30,6,6
54992,53,12659,53,190,97,93,2,31,1,1
46563,443,26794,443,127147,41867,85280,198,240,91,107
38001,49152,63633,49152,156,156,0,3,8,3,0
49997,80,20317,80,2863,604,2259,11,15,6,5
55619,53,10755,53,182,93,89,2,31,1,1
50920,443,56379,443,3440,2371,1069,17,96,10,7
50921,443,40184,443,9516,1896,7620,21,127,11,10
52209,37241,61696,37241,136,136,0,3,14,3,0
51978,80,13488,80,24474,2101,22373,38,48,19,19
57274,443,44033,443,11536,2572,8964,41,33,24,17
27005,23333,41916,23333,890,126,764,3,32,2,1
65377,53,55727,53,207,86,121,2,30,1,1
56684,443,53117,443,7907,1918,5989,20,15,11,9
49920,443,51438,443,10526,811,9715,20,135,8,12
58249,443,60364,443,4220,2048,2172,11,122,6,5
50377,53,58981,53,214,110,104,2,30,1,1
64565,53,48582,53,226,110,116,2,30,1,1
55689,37558,21710,37558,70,70,0,2,8,2,0
50584,6881,18955,6881,502,150,352,2,1200,1,1
33706,80,48762,80,1265,473,792,8,15,5,3
58819,443,22154,443,5168,700,4468,16,14,7,9
49858,80,51229,80,1539,674,865,11,89,6,5
56632,53,26751,53,200,94,106,2,29,1,1
64716,53,43003,53,195,102,93,2,31,1,1
56167,53,20756,53,461,94,367,2,30,1,1
56198,443,56198,443,27729,5508,22221,60,18,31,29
53760,443,44529,443,499,425,74,4,0,3,1
62288,443,20087,443,1638,776,862,22,120,11,11
57339,53,58719,53,248,94,154,2,30,1,1
65319,53,28841,53,285,103,182,4,43,2,2
49555,53,37709,53,199,102,97,2,30,1,1
58932,53,21682,53,168,78,90,2,31,1,1
56717,53,46335,53,178,94,84,2,31,1,1
52239,1172,16970,1172,256,136,120,5,5,3,2
56603,53,17293,53,179,94,85,2,30,1,1
49501,443,9020,443,15456,2581,12875,28,31,10,18
50077,53,56181,53,261,97,164,4,44,2,2
56603,53,24241,53,179,94,85,2,30,1,1
62306,53,46053,53,387,94,293,2,30,1,1
53986,54070,39036,54070,70,70,0,1,5,1,0
53060,1433,53060,1433,60,60,0,1,5,1,0
53643,8118,59357,8118,2104,1209,895,15,16,7,8
60067,443,11544,443,14085,1879,12206,27,141,12,15
9311,443,26204,443,4082,958,3124,14,26,8,6
57082,53,9901,53,239,94,145,2,30,1,1
50825,80,41226,80,35970,11674,24296,108,265,55,53
57470,43155,32052,43155,594,594,0,10,1199,10,0
8160,80,8160,80,1670,1044,626,15,84,8,7
53005,443,10690,443,13028,4115,8913,45,95,23,22
51975,443,14807,443,29510,15378,14132,76,216,35,41
34814,80,10830,80,9105,1930,7175,18,16,9,9
51783,12296,8284,12296,316,136,180,6,6,3,3
55786,53,64576,53,193,102,91,2,29,1,1
53169,44707,23330,44707,1078,518,560,16,21,9,7
49563,53,41117,53,200,102,98,2,29,1,1
41821,80,46291,80,1056,362,694,10,49,6,4
64895,53,11867,53,198,101,97,2,30,1,1
49173,53,27694,53,214,110,104,2,30,1,1
44949,53,44949,53,198,90,108,2,30,1,1
59951,80,3769,80,1221,339,882,9,16,5,4
60807,40010,25177,40010,316,136,180,6,5,3,3
57334,53,29836,53,204,104,100,2,31,1,1
53861,53065,16335,53065,70,70,0,2,8,2,0
51675,443,51675,443,4539,1632,2907,19,27,11,8
65496,53,50374,53,183,94,89,2,30,1,1
52172,7353,21812,7353,70,70,0,1,5,1,0
50265,32988,60132,32988,1488,930,558,21,1200,12,9
56648,443,4719,443,7080,2136,4944,18,121,8,10
56483,80,37968,80,82266,4947,77319,94,136,37,57
37643,443,56932,443,10517,2926,7591,29,20,16,13
51792,80,21440,80,3840,2265,1575,16,47,10,6
50584,11830,62858,11830,2118,900,1218,14,4232,7,7
35005,53,35005,53,233,90,143,2,33,1,1
42112,443,17056,443,11459,2165,9294,29,259,11,18
64833,53,41021,53,167,86,81,2,31,1,1
40220,443,35161,443,5448,989,4459,22,84,10,12
53166,39564,27898,39564,70,70,0,2,8,2,0
49594,53,57290,53,301,102,199,2,30,1,1
58748,80,58748,80,6516,564,5952,16,25,7,9
5924,53,5924,53,220,90,130,2,30,1,1
58362,443,29130,443,13272,2360,10912,37,208,19,18
39417,53,53271,53,224,78,146,2,30,1,1
35556,443,35556,443,7201,1167,6034,16,131,8,8
55985,53,19393,53,738,86,652,2,30,1,1
53803,17637,39254,17637,70,70,0,1,5,1,0
51788,443,22272,443,3679,1712,1967,14,135,7,7
49978,53,47119,53,774,101,673,2,31,1,1
52203,1024,52908,1024,136,136,0,3,14,3,0
0,0,0,0,600,306,294,6,0,3,3
50455,53,22933,53,756,95,661,2,30,1,1
42727,443,63558,443,4813,970,3843,12,135,6,6
64505,53,53732,53,388,134,254,2,30,1,1
55179,53,20932,53,194,102,92,2,35,1,1
62233,443,62233,443,41941,3388,38553,67,77,26,41
56504,53,22416,53,198,102,96,2,33,1,1
53163,443,28652,443,12979,4609,8370,27,25,15,12
55646,14420,49852,14420,70,70,0,2,8,2,0
49862,53,40662,53,180,94,86,2,30,1,1
57150,53,42037,53,166,86,80,2,29,1,1
50412,80,26565,80,1524,341,1183,11,36,4,7
55003,53,14075,53,192,98,94,2,31,1,1
49699,53,53158,53,209,110,99,2,30,1,1
49367,53,30708,53,389,94,295,4,55,2,2
23514,53,23514,53,245,98,147,2,30,1,1
49867,53,63133,53,177,94,83,2,30,1,1
64324,53,40799,53,179,94,85,2,29,1,1
56693,443,44446,443,3886,2545,1341,18,18,10,8
43156,53,17212,53,168,78,90,2,29,1,1
10344,80,10344,80,6705,702,6003,13,16,6,7
34170,80,19669,80,1298,473,825,16,392,5,11
53203,443,27595,443,3656,2345,1311,18,17,9,9
38520,53,38520,53,231,88,143,2,34,1,1
52522,80,14593,80,3290,2776,514,12,15,7,5
49452,443,53461,443,13184,2507,10677,27,64,14,13
51907,80,10230,80,9189,3144,6045,19,28,11,8
56753,38028,14806,38028,156,66,90,2,5,1,1
41643,443,51338,443,16032,13508,2524,37,36,19,18
52043,80,5658,80,1484,805,679,11,25,7,4
49805,53,26905,53,296,102,194,2,30,1,1
51808,443,51808,443,1466,856,610,13,27,6,7
57053,53,14001,53,211,102,109,2,30,1,1
50939,443,29204,443,134,60,74,3,5,2,1
55336,53,7329,53,199,102,97,2,30,1,1
60336,5222,43827,5222,32653,15160,17493,307,506,160,147
30960,45730,17923,45730,330,330,0,6,3610,6,0
54431,443,24894,443,9398,2027,7371,33,270,14,19
50305,53,8454,53,209,110,99,2,30,1,1
64720,53,3807,53,216,102,114,2,30,1,1
56670,443,11392,443,8006,1986,6020,20,15,11,9
55747,53,47798,53,199,94,105,2,29,1,1
53377,443,17654,443,4814,1207,3607,17,75,10,7
59729,53,2967,53,303,85,218,2,30,1,1
34388,443,29047,443,7002,1252,5750,28,258,15,13
49598,53,15528,53,214,102,112,2,30,1,1
49168,53,10918,53,192,98,94,2,31,1,1
65365,53,19962,53,192,98,94,2,30,1,1
64898,53,64087,53,487,201,286,6,39,3,3
64874,53,41940,53,324,94,230,2,30,1,1
56062,53,16578,53,744,89,655,2,31,1,1
57594,80,57594,80,110070,5374,104696,112,156,36,76
8802,80,39611,80,4999,1313,3686,36,667,8,28
32160,53,32160,53,233,90,143,2,32,1,1
34352,53,34352,53,240,98,142,2,30,1,1
50082,53,42387,53,774,101,673,2,30,1,1
49690,53,46468,53,198,94,104,2,30,1,1
49446,443,57880,443,1280822,27768,1253054,1241,40,365,876
57470,6890,10619,6890,520,166,354,2,1199,1,1
65472,53,51115,53,209,110,99,2,30,1,1
39416,443,35535,443,32732,6260,26472,69,217,34,35
49765,53,13036,53,194,102,92,2,31,1,1
56769,53,51571,53,183,94,89,2,31,1,1
26900,27017,48615,27017,422,164,258,6,30,3,3
56292,443,38026,443,162,102,60,2,5,1,1
50938,443,19392,443,37198,29093,8105,64,17,34,30
65493,443,45559,443,438968,12780,426188,449,16,157,292
30434,53,30434,53,197,90,107,2,30,1,1
59715,3389,59715,3389,3331,1442,1889,15,17,8,7
52117,20600,3356,20600,70,70,0,1,5,1,0
56654,53,36546,53,209,110,99,2,30,1,1
64843,443,36183,443,13583,4157,9426,26,120,11,15
64086,443,16892,443,3289,1031,2258,13,121,6,7
56314,53,2805,53,182,93,89,2,30,1,1
50277,443,12688,443,3937,1191,2746,20,163,9,11
64191,443,64191,443,18608,1844,16764,31,16,16,15
47149,443,19883,443,5995,1092,4903,22,72,12,10
49844,53,30878,53,755,102,653,2,30,1,1
42469,80,53240,80,2169,1419,750,10,15,6,4
56367,53,31807,53,194,102,92,2,30,1,1
56586,53,54269,53,177,94,83,2,30,1,1
52934,443,64385,443,5584,1390,4194,19,14,9,10
58322,53,48798,53,320,94,226,2,30,1,1
57470,19853,37734,19853,132,132,0,3,1200,3,0
62417,443,4381,443,79513,7480,72033,106,122,39,67
49545,443,58325,443,7189,1694,5495,31,131,14,17
47463,53,25330,53,167,78,89,2,30,1,1
34910,443,51247,443,18452,11429,7023,39,64,23,16
55372,53,36344,53,199,102,97,2,30,1,1
55082,443,25259,443,8944,4006,4938,31,16,18,13
53456,443,13197,443,25555,2220,23335,44,30,20,24
64567,53,38980,53,199,102,97,2,30,1,1
64968,53,62769,53,767,102,665,2,30,1,1
53983,40500,9041,40500,70,70,0,1,4,1,0
57731,53,26408,53,237,86,151,2,30,1,1
56568,53,6901,53,365,105,260,4,47,2,2
46298,443,58260,443,52438,4244,48194,77,23,37,40
64053,53,64602,53,276,94,182,4,55,2,2
49172,53,13814,53,305,94,211,2,30,1,1
53165,18504,40263,18504,444,192,252,8,17,4,4
60666,123,38509,123,184,94,90,2,30,1,1
51795,443,38241,443,4209,2221,1988,25,157,12,13
52729,80,27175,80,2255,997,1258,16,152,8,8
61488,53,0,0,314,93,221,2,30,1,1
56641,53,52292,53,453,186,267,6,30,3,3
53895,443,53348,443,499,425,74,4,0,3,1
63961,51641,64148,51641,504,382,122,8,16,6,2
49516,53,51751,53,182,93,89,2,30,1,1
44792,443,44086,443,9700,2137,7563,21,16,12,9
55244,53,24318,53,184,102,82,2,30,1,1
65185,27126,57830,27126,268,78,190,2,30,1,1
43314,443,48162,443,6102,782,5320,17,67,8,9
60957,443,60957,443,70839,5466,65373,98,19,47,51
51871,443,4793,443,554,310,244,10,30,6,4
9180,443,3139,443,5731,495,5236,14,15,7,7
53864,53,19118,53,168,78,90,2,30,1,1
56365,443,26003,443,3734,1750,1984,24,203,12,12
49234,8080,49234,8080,2604,848,1756,13,136,7,6
52068,80,54676,80,362,240,122,7,25,5,2
56323,53,21945,53,168,94,74,2,30,1,1
57356,53,60821,53,198,101,97,2,30,1,1
53791,53,19031,53,102,102,0,1,30,1,0
65068,53,6356,53,336,111,225,4,29,2,2
50362,80,15549,80,3907,880,3027,11,15,5,6
63583,443,3577,443,7339,2638,4701,33,167,18,15
49330,443,57448,443,137414,6004,131410,170,80,59,111
59418,443,19462,443,7222,1633,5589,24,201,13,11
56988,53,29456,53,216,110,106,2,30,1,1
43039,53,37075,53,241,78,163,2,30,1,1
39570,443,62469,443,70,70,0,1,5,1,0
58886,443,31172,443,3404,2124,1280,18,135,10,8
60055,443,24328,443,2314,1232,1082,15,141,8,7
64845,53,4147,53,289,110,179,2,30,1,1
56754,53,54310,53,182,93,89,2,31,1,1
50734,80,62871,80,3498,2696,802,9,26,5,4
53006,80,12227,80,1988,742,1246,10,334,6,4
37523,443,28556,443,154,94,60,2,4,1,1
64913,53,33116,53,194,102,92,2,30,1,1
56768,443,55318,443,7889,1900,5989,20,16,11,9
6881,666,16595,666,268,150,118,2,1199,1,1
56997,53,44658,53,168,86,82,2,30,1,1
65356,53,36098,53,199,102,97,2,30,1,1
53095,443,22543,443,7014,1719,5295,18,326,9,9
49835,53,4982,53,146,75,71,2,30,1,1
56001,53,33036,53,196,94,102,2,30,1,1
64048,44918,54494,44918,70,70,0,1,4,1,0
50604,443,50604,443,4716,1809,2907,19,30,11,8
36677,443,38465,443,712,374,338,11,26,6,5
9257,443,25692,443,6327,833,5494,19,26,10,9
56046,53,4218,53,186,95,91,2,31,1,1
56652,53,9807,53,177,94,83,2,30,1,1
56846,53,43478,53,196,102,94,2,30,1,1
57441,443,53245,443,9774,3034,6740,29,19,14,15
46212,443,28562,443,190,70,120,4,15,2,2
55602,22005,13936,22005,504,318,186,8,15,5,3
49418,27015,55530,27015,244,78,166,2,30,1,1
51574,443,46080,443,400,70,330,6,25,1,5
60107,443,49027,443,9766,3290,6476,40,57,20,20
45021,53,45021,53,213,79,134,2,32,1,1
64745,3389,64745,3389,3413,1458,1955,16,18,8,8
55822,80,1122,80,1052,612,440,10,16,5,5
58648,443,61974,443,7509,1262,6247,22,16,12,10
49487,53,6709,53,182,93,89,2,30,1,1
58600,53,58600,53,217,82,135,2,32,1,1
50257,3389,50257,3389,3473,1518,1955,17,18,9,8
64323,53,18965,53,195,102,93,2,30,1,1
40432,443,35104,443,12022,2731,9291,53,20,26,27
64414,53,3637,53,193,102,91,2,30,1,1
41095,443,28178,443,108842,88940,19902,313,255,159,154
49772,53,60667,53,178,91,87,2,30,1,1
40736,443,40736,443,4380,1473,2907,19,26,11,8
50485,443,22667,443,6028,2012,4016,25,16,14,11
64075,1026,16814,1026,66,66,0,2,7,2,0
49429,443,33645,443,8861,3484,5377,19,120,9,10
49438,443,56354,443,13740,5392,8348,35,134,18,17
49514,53,53009,53,749,94,655,2,30,1,1
56004,53,60416,53,178,94,84,2,29,1,1
56221,53,31091,53,177,94,83,2,29,1,1
56118,53,56118,53,233,91,142,2,30,1,1
56732,443,23589,443,7855,1866,5989,20,15,11,9
35797,443,35797,443,4378,1471,2907,19,27,11,8
49439,53,62852,53,194,99,95,2,31,1,1
55931,53,41701,53,294,118,176,2,29,1,1
52525,80,56526,80,3951,3437,514,13,15,8,5
10963,53,10963,53,216,90,126,2,30,1,1
60223,80,32982,80,17923,13519,4404,41,151,26,15
56620,53,43601,53,762,98,664,2,30,1,1
37576,443,21717,443,11777,4005,7772,35,44,15,20
63698,59517,14181,59517,504,382,122,8,15,6,2
50543,443,11342,443,11275,4454,6821,24,36,13,11
27005,27015,11118,27015,881,126,755,2,30,1,1
57432,53,57432,53,247,98,149,2,34,1,1
62919,993,20862,993,134,60,74,3,11,2,1
57577,443,27380,443,39421,4980,34441,57,144,23,34
64036,53,62200,53,183,94,89,2,29,1,1
50401,443,63156,443,256,136,120,5,9,3,2
49258,53,9142,53,228,102,126,2,30,1,1
37736,443,59185,443,16925,11562,5363,36,363,19,17
49769,443,1740,443,13455,1982,11473,29,31,16,13
65212,53,6232,53,196,102,94,2,31,1,1
40375,443,13030,443,130,70,60,3,5,2,1
33705,443,51177,443,4610,918,3692,15,135,7,8
65131,53,35643,53,168,86,82,2,30,1,1
53276,80,53276,80,42664,1998,40666,53,27,20,33
64578,53,31792,53,193,102,91,2,31,1,1
40249,443,14843,443,70,70,0,1,5,1,0
57385,53,42061,53,177,94,83,2,30,1,1
65398,53,64225,53,214,110,104,2,30,1,1
14829,443,14829,443,214215,11945,202270,260,94,110,150
53984,57077,2292,57077,70,70,0,1,5,1,0
56729,53,56729,53,229,89,140,2,31,1,1
56086,53,3323,53,172,94,78,2,29,1,1
47928,443,47928,443,4564,1657,2907,19,27,11,8
53496,443,54389,443,3155,2234,921,15,16,8,7
55921,53,64539,53,177,94,83,2,29,1,1
65220,53,42472,53,245,94,151,2,30,1,1
60045,443,35524,443,17161,1619,15542,18,151,4,14
9336,443,60185,443,4702,674,4028,15,15,8,7
49424,53,32316,53,100,100,0,1,0,1,0
56153,53,6546,53,742,88,654,2,31,1,1
56393,53,59869,53,197,94,103,2,30,1,1
55222,53,63142,53,181,94,87,2,29,1,1
58866,443,35097,443,5166,700,4466,16,15,7,9
56787,443,7195,443,7877,1888,5989,20,15,11,9
56830,53,25316,53,195,102,93,2,29,1,1
56816,53,44842,53,754,94,660,2,31,1,1
49782,443,62911,443,70,70,0,1,5,1,0
45292,443,27457,443,26444,2671,23773,52,363,25,27
56722,80,63327,80,41658,23230,18428,114,798,66,48
49886,7000,49886,7000,1236,676,560,13,15,7,6
33445,53,19899,53,168,78,90,2,29,1,1
53460,443,30062,443,30688,2660,28028,51,31,23,28
60805,443,29197,443,7983,4398,3585,17,121,8,9
60580,53,20280,53,181,86,95,2,30,1,1
49187,2710,53094,2710,70,70,0,1,5,1,0
42607,443,6741,443,10221,3259,6962,36,120,18,18
2267,53,10522,53,204,118,86,2,30,1,1
52214,27480,63759,27480,70,70,0,1,5,1,0
42040,5228,65521,5228,3467,1977,1490,29,3742,14,15
53800,53,27732,53,260,86,174,2,30,1,1
40204,40007,54780,40007,140,78,62,2,31,1,1
56231,53,22476,53,779,86,693,2,30,1,1
55658,443,55658,443,26504,10384,16120,58,48,37,21
58874,443,12303,443,10630,6981,3649,31,17,17,14
35844,443,58126,443,5196,1875,3321,45,5922,12,33
55410,53,52970,53,212,102,110,2,30,1,1
49820,123,49820,123,184,94,90,2,30,1,1
38275,443,49031,443,448,78,370,6,25,1,5
55126,53,18152,53,193,102,91,2,30,1,1
2267,53,29941,53,204,118,86,2,31,1,1
38863,443,38863,443,36313,5931,30382,72,108,36,36
45159,443,45159,443,5329,2082,3247,22,40,13,9
42298,40034,23763,40034,588,86,502,2,30,1,1
51991,56980,61136,56980,316,136,180,6,7,3,3
55622,53,55622,53,235,98,137,2,30,1,1
64121,443,64564,443,1411,852,559,13,24,7,6
45052,443,46441,443,6084,1723,4361,23,201,13,10
49198,53,18910,53,164,78,86,2,31,1,1
49986,53,37815,53,312,93,219,4,37,2,2
23216,53,23216,53,235,90,145,2,33,1,1
53602,12395,5014,12395,70,70,0,1,5,1,0
49787,53,45265,53,196,94,102,2,30,1,1
49921,443,56889,443,11831,1466,10365,24,135,11,13
36932,443,8229,443,280,140,140,5,130,3,2
58992,443,6436,443,3049,1857,1192,20,21,9,11
49790,53,8407,53,229,110,119,2,30,1,1
51836,37753,15245,37753,70,70,0,2,7,2,0
51865,14732,26909,14732,70,70,0,2,7,2,0
51910,60443,42638,60443,66,66,0,1,5,1,0
37961,443,30943,443,10229,2777,7452,30,361,15,15
50031,53,53719,53,178,91,87,2,31,1,1
51142,443,51142,443,261206,9686,251520,308,128,121,187
51810,443,51810,443,1536,856,680,14,27,6,8
55992,80,41926,80,57401,3150,54251,84,109,43,41
51221,44710,11229,44710,481,150,331,2,1200,1,1
55441,443,55441,443,4423,1516,2907,19,30,11,8
6881,37232,47143,37232,502,150,352,2,1199,1,1
56374,53,9778,53,212,102,110,2,30,1,1
64381,53,47350,53,196,100,96,2,30,1,1
54973,53,49914,53,811,94,717,2,29,1,1
55688,53,29682,53,183,94,89,2,31,1,1
35579,443,33211,443,130,70,60,2,15,1,1
53974,26108,47325,26108,70,70,0,1,4,1,0
59401,443,58968,443,3010,1892,1118,16,15,8,8
57836,443,52669,443,15844,1691,14153,18,138,5,13
49894,443,19598,443,7418,2721,4697,23,20,12,11
41458,443,29775,443,13059,5161,7898,34,84,19,15
64797,53,54337,53,182,93,89,2,30,1,1
49218,53,12399,53,195,102,93,2,31,1,1
56611,53,12492,53,177,94,83,2,29,1,1
49317,53,7671,53,657,187,470,6,72,3,3
56745,53,50042,53,900,110,790,2,30,1,1
0,0,0,0,244,244,0,2,0,2,0
56563,53,56693,53,177,94,83,2,30,1,1
49341,443,40823,443,484,210,274,8,135,4,4
52007,80,41883,80,83736,4405,79331,114,19,48,66
35742,53,48792,53,199,94,105,2,30,1,1
65209,53,37823,53,166,86,80,2,31,1,1
51689,53,34111,53,198,86,112,2,30,1,1
50169,53,35420,53,223,78,145,2,30,1,1
57470,6881,62721,6881,150,150,0,1,1200,1,0
34616,53,34616,53,197,90,107,2,30,1,1
64583,443,48873,443,9150,2109,7041,27,32,15,12
5385,22,5385,22,66,66,0,1,4,1,0
56354,53,44261,53,182,102,80,2,29,1,1
54194,443,16208,443,499,425,74,4,0,3,1
27777,80,27777,80,12281469,369857,11911612,13837,31,5536,8301
44938,443,27497,443,46323,1563,44760,49,30,15,34
50724,443,63657,443,3171,1369,1802,9,120,5,4
53962,16251,51780,16251,70,70,0,1,4,1,0
50444,80,3294,80,378,192,186,7,19,4,3
56622,443,50835,443,8302,3583,4719,24,17,14,10
56342,53,27382,53,733,93,640,2,31,1,1
49420,53,26234,53,364,102,262,2,30,1,1
63732,40642,2876,40642,70,70,0,1,5,1,0
64585,53,40349,53,210,110,100,2,30,1,1
52027,49743,23707,49743,70,70,0,1,4,1,0
53245,443,26528,443,7705,2005,5700,26,120,13,13
55673,54815,52506,54815,316,190,126,5,15,3,2
57607,443,42010,443,2614,1689,925,18,20,10,8
55855,53,27713,53,182,102,80,2,30,1,1
37965,54777,17164,54777,158,158,0,1,1200,1,0
60290,53,25533,53,199,94,105,2,29,1,1
52165,443,19255,443,289596,9131,280465,283,48,85,198
53521,443,40751,443,130,70,60,2,14,1,1
15016,443,15016,443,21083,3108,17975,45,80,24,21
49898,53,38099,53,184,94,90,2,31,1,1
7946,23,7946,23,130,66,64,2,5,1,1
57410,443,21541,443,7435,2697,4738,23,30,13,10
9295,443,22317,443,3837,488,3349,15,15,7,8
65228,53,28840,53,200,102,98,2,30,1,1
50495,53,47068,53,195,102,93,2,30,1,1
61938,443,24031,443,3663,1097,2566,13,136,6,7
37649,443,13055,443,32391,21443,10948,69,47,41,28
55164,53,64984,53,177,94,83,2,30,1,1
44013,53,44013,53,197,76,121,2,30,1,1
64404,53,27516,53,250,102,148,2,30,1,1
50078,53,55714,53,177,94,83,2,29,1,1
53233,443,53233,443,4114,2535,1579,25,139,13,12
49978,53,54478,53,760,97,663,2,31,1,1
56783,443,28364,443,7904,1915,5989,20,16,11,9
53902,55298,4313,55298,70,70,0,2,8,2,0
27005,27017,40278,27017,891,126,765,2,30,1,1
57255,443,53541,443,4769,2622,2147,14,135,7,7
58961,80,54182,80,1674,1360,314,11,15,6,5
52140,53155,46318,53155,70,70,0,1,5,1,0
9120,80,19755,80,326320,11951,314369,346,36,122,224
55494,80,14370,80,188544,9826,178718,241,32,113,128
64838,53,23821,53,338,110,228,2,30,1,1
5588,5588,0,0,3562,1936,1626,48,193,24,24
53794,443,48669,443,499,425,74,4,0,3,1
52635,443,48519,443,8993,5205,3788,48,167,25,23
50680,443,36184,443,2993,866,2127,10,120,5,5
57575,443,3355,443,707158,36853,670305,902,148,310,592
52786,443,34018,443,8160,2216,5944,22,38,14,8
46327,25903,54070,25903,134,64,70,2,10,1,1
52317,5223,5494,5223,6070,1779,4291,17,3600,8,9
65423,443,16318,443,5854,1796,4058,21,142,10,11
49141,443,32844,443,2595,1230,1365,18,16,9,9
49257,53,43950,53,579,181,398,6,84,3,3
57115,53,44854,53,728,102,626,2,30,1,1
60089,443,5576,443,1000,557,443,11,141,6,5
49418,27015,7927,27015,295,78,217,2,31,1,1
48717,443,44246,443,232,172,60,3,5,2,1
57040,53,44476,53,174,89,85,2,31,1,1
57294,443,36134,443,5614,733,4881,16,15,9,7
56322,53,19228,53,209,110,99,2,29,1,1
62330,443,31152,443,21361086,218978,21142108,16512,170,2203,14309
49708,443,3133,443,7772,2563,5209,18,121,9,9
64005,53,59576,53,402,125,277,4,37,2,2
63069,53,35959,53,384,166,218,2,30,1,1
65408,53,49701,53,817,98,719,2,30,1,1
50202,53,23143,53,166,86,80,2,30,1,1
53593,32022,37169,32022,320,140,180,6,6,3,3
33387,80,58397,80,9105,1930,7175,18,16,9,9
49635,53,59666,53,210,110,100,2,30,1,1
42578,443,53109,443,3857,2757,1100,27,22,14,13
49657,443,3247,443,6181,833,5348,19,52,9,10
51977,443,5724,443,2497,1528,969,22,46,13,9
33473,443,49097,443,146684,25233,121451,183,189,75,108
65345,53,26359,53,782,105,677,2,31,1,1
54991,443,64659,443,15109,5866,9243,71,362,29,42
50597,443,31048,443,8031,1915,6116,24,17,12,12
55450,53,10732,53,193,102,91,2,29,1,1
55770,53,22601,53,177,94,83,2,30,1,1
50540,80,53400,80,2175,1539,636,13,27,8,5
64767,443,64767,443,4507,1600,2907,19,31,11,8
54249,443,37595,443,499,425,74,4,0,3,1
57470,46487,30671,46487,527,166,361,2,1200,1,1
50390,80,49086,80,360,180,180,7,26,4,3
49927,80,35490,80,1126,609,517,11,15,6,5
6040,53,41772,53,323,94,229,2,30,1,1
52763,53,0,0,641,87,554,2,30,1,1
49920,80,51045,80,3649288,78688,3570600,2923,179,528,2395
30389,53,30389,53,235,90,145,2,33,1,1
49216,53,31679,53,789,110,679,2,29,1,1
52201,443,3597,443,5681,1441,4240,21,51,11,10
53768,19067,41942,19067,70,70,0,2,8,2,0
65049,53,41682,53,184,94,90,2,29,1,1
48016,443,47269,443,138,78,60,2,5,1,1
55837,443,59967,443,39628,2279,37349,63,255,23,40
55475,53,23006,53,784,94,690,2,30,1,1
56962,80,49373,80,8730,5681,3049,21,31,12,9
57312,443,4774,443,134,60,74,3,5,2,1
49913,53,48535,53,493,94,399,4,40,2,2
27005,27017,53289,27017,900,126,774,2,31,1,1
34996,5222,11344,5222,8140,2222,5918,42,201,22,20
65006,53,63104,53,994,86,908,2,30,1,1
64205,53,39534,53,327,88,239,4,52,2,2
57402,443,10569,443,6649,1556,5093,23,21,13,10
56131,53,17639,53,238,87,151,2,30,1,1
52324,443,60831,443,295493,16052,279441,394,68,186,208
56951,443,25621,443,4679,2071,2608,14,135,7,7
64686,53,47974,53,214,102,112,2,29,1,1
56793,14902,9937,14902,264,70,194,4,19,1,3
63729,6969,28915,6969,70,70,0,1,5,1,0
32897,443,57512,443,3166,936,2230,18,120,9,9
55370,53,23288,53,711,87,624,2,30,1,1
58812,443,22392,443,5167,700,4467,16,15,7,9
64867,53,35181,53,184,86,98,2,30,1,1
64319,53,2772,53,193,102,91,2,30,1,1
56636,53,19411,53,302,86,216,2,30,1,1
38720,5222,21758,5222,6262,2015,4247,35,48,17,18
52405,443,45940,443,227267,18022,209245,424,38,239,185
64266,53,26877,53,180,94,86,2,35,1,1
60309,443,17740,443,130,70,60,3,5,2,1
64947,53,23514,53,275,96,179,4,41,2,2
37661,443,23960,443,3226,2225,1001,18,46,11,7
64780,53,55734,53,186,95,91,2,31,1,1
63891,51350,44570,51350,312,132,180,6,7,3,3
53502,443,53502,443,960,539,421,9,35,5,4
53108,7003,16327,7003,512,326,186,9,22,6,3
50584,51414,36185,51414,475,150,325,2,1200,1,1
58021,443,29855,443,8075,4109,3966,42,91,19,23
56120,443,26246,443,551795,18805,532990,603,43,220,383
51241,443,60698,443,8083,2502,5581,40,16,22,18
49206,12242,32509,12242,70,70,0,2,8,2,0
42186,443,43705,443,10165,2433,7732,19,49,10,9
65416,443,30210,443,3219,2242,977,19,25,9,10
64785,80,45125,80,2107,1131,976,13,97,7,6
65049,53,51039,53,184,94,90,2,30,1,1
57990,443,7309,443,3182,1568,1614,8,120,4,4
49569,53,17630,53,213,94,119,2,30,1,1
49211,53,35833,53,484,100,384,4,56,2,2
65443,53,23920,53,172,94,78,2,30,1,1
30960,45761,37537,45761,462,462,0,8,3632,8,0
64416,53,53808,53,211,94,117,2,30,1,1
64128,53,50271,53,606,182,424,6,71,3,3
58192,443,58192,443,4381,1474,2907,19,29,11,8
57138,443,59763,443,70379,4205,66174,101,403,51,50
65473,443,51323,443,91831,4379,87452,101,15,37,64
50309,53,52592,53,816,102,714,2,29,1,1
57022,443,20898,443,4228,1470,2758,19,131,9,10
39895,443,43258,443,10727,3308,7419,33,503,15,18
45663,53,45663,53,507,129,378,2,30,1,1
56458,53,47423,53,196,102,94,2,30,1,1
42298,40028,3543,40028,148,86,62,2,29,1,1
65246,53,9355,53,179,94,85,2,29,1,1
57257,80,32555,80,1369,495,874,12,361,6,6
42753,443,38036,443,10114,3154,6960,27,20,16,11
57397,53,24712,53,183,94,89,2,30,1,1
49242,53,51879,53,183,94,89,2,30,1,1
64787,53,13133,53,299,101,198,4,34,2,2
62721,443,47170,443,5718309,117049,5601260,5287,155,1390,3897
52145,80,50375,80,366,240,126,7,32,5,2
50440,53,45707,53,216,110,106,2,30,1,1
49766,443,21804,443,12026,1450,10576,27,127,12,15
41151,443,41151,443,4713,1806,2907,19,30,11,8
63836,14791,37606,14791,70,70,0,1,4,1,0
52483,443,4472,443,12863,8410,4453,22,31,13,9
52118,33515,33825,33515,70,70,0,1,5,1,0
65007,53,25080,53,180,86,94,2,30,1,1
44414,123,11306,123,184,94,90,2,30,1,1
57015,80,24329,80,214,140,74,4,31,3,1
37965,23215,60797,23215,537,158,379,2,1199,1,1
50362,53,33305,53,214,110,104,2,29,1,1
53031,443,28915,443,2399,1799,600,15,120,10,5
27005,27015,46152,27015,875,126,749,2,30,1,1
27164,53,27164,53,208,94,114,2,30,1,1
59658,443,33900,443,5433,925,4508,19,360,10,9
55844,443,40826,443,6881,2073,4808,37,255,18,19
54236,443,22668,443,499,425,74,4,0,3,1
53884,48754,60851,48754,70,70,0,2,7,2,0
51814,55393,29283,55393,70,70,0,1,4,1,0
55551,53,29205,53,176,90,86,2,30,1,1
60053,443,33088,443,3190,1599,1591,17,142,9,8
49246,443,11384,443,29705,9203,20502,41,18,21,20
27988,40029,26130,40029,140,78,62,2,30,1,1
54025,443,49847,443,7653,1188,6465,21,16,12,9
35921,443,62122,443,9667,4709,4958,27,88,14,13
51135,80,13103,80,366,240,126,7,21,5,2
58046,443,58046,443,4682,1775,2907,19,29,11,8
55527,80,13344,80,20513,1960,18553,39,21,18,21
38700,443,49227,443,130,70,60,2,14,1,1
60808,40010,35600,40010,316,136,180,6,6,3,3
61733,443,10616,443,168812,5693,163119,186,21,68,118
55388,53,60267,53,170,87,83,2,31,1,1
45154,53,45154,53,236,108,128,2,31,1,1
64547,53,37211,53,762,97,665,2,30,1,1
55049,5228,10544,5228,9193,2770,6423,51,5193,28,23
49402,443,59952,443,7965,4044,3921,63,464,30,33
9150,443,24673,443,16023,3677,12346,42,37,21,21
49181,443,9716,443,50097,3666,46431,79,256,36,43
58725,443,25110,443,9279,5062,4217,56,259,25,31
52194,443,38386,443,12374,1090,11284,27,15,13,14
65304,53,37771,53,190,97,93,2,30,1,1
59887,443,6975,443,1576,973,603,14,28,7,7
51795,60258,28772,60258,70,70,0,1,5,1,0
44797,53,29838,53,179,86,93,2,29,1,1
51986,443,52647,443,7567,3038,4529,35,15,21,14
57834,80,57834,80,2106,1657,449,10,20,6,4
65530,53,2612,53,102,102,0,1,30,1,0
62524,123,21935,123,184,94,90,2,31,1,1
65371,53,1608,53,199,102,97,2,30,1,1
56654,53,59245,53,202,103,99,2,31,1,1
61431,443,2753,443,1401,940,461,11,28,7,4
56847,53,58381,53,252,102,150,2,30,1,1
59774,443,17301,443,846,420,426,15,29,8,7
54828,443,24747,443,6296,1556,4740,22,16,12,10
55183,53,52172,53,177,94,83,2,30,1,1
55594,53,28823,53,168,78,90,2,30,1,1
52730,443,26039,443,8040,2587,5453,39,16,23,16
38464,443,38464,443,33734,3007,30727,53,90,29,24
57173,53,42104,53,216,110,106,2,31,1,1
55673,53,41151,53,179,94,85,2,30,1,1
55664,53,44957,53,190,97,93,2,30,1,1
59405,443,49077,443,10726,4848,5878,79,588,40,39
49963,53,30474,53,279,96,183,4,58,2,2
63974,80,35530,80,314,192,122,6,15,4,2
49462,53,10345,53,86,86,0,1,30,1,0
49202,53,58969,53,295,86,209,2,30,1,1
50444,53,27303,53,256,93,163,2,31,1,1
57331,53,30032,53,172,94,78,2,30,1,1
47362,443,49001,443,8263,2100,6163,34,255,16,18
65513,53,35186,53,190,97,93,2,31,1,1
40039,80,11580,80,1112,534,578,12,16,7,5
55748,53,57713,53,194,102,92,2,31,1,1
56437,53,9819,53,749,94,655,2,30,1,1
53836,15000,1937,15000,130,70,60,2,5,1,1
51270,48061,59473,48061,70,70,0,2,8,2,0
9442,443,1324,443,6100,777,5323,17,25,9,8
55375,53,40220,53,222,102,120,2,30,1,1
53233,443,40528,443,47830,23388,24442,74,51,37,37
60856,443,12085,443,8201,2795,5406,43,18,26,17
49776,53,56083,53,180,92,88,2,30,1,1
50203,80,15124,80,4020,1978,2042,16,66,9,7
65129,53,27603,53,213,102,111,2,30,1,1
49447,53,25197,53,248,102,146,2,29,1,1
50578,443,12552,443,13595,7140,6455,39,116,24,15
62275,443,20241,443,18482489,568378,17914111,19386,214,6466,12920
64812,16384,57833,16384,556,256,300,10,30,5,5
64108,53,41542,53,296,126,170,2,30,1,1
57750,15000,45543,15000,130,70,60,2,5,1,1
47272,443,40986,443,6318,1025,5293,17,35,9,8
57047,53,31984,53,198,94,104,2,31,1,1
64719,53,54824,53,196,102,94,2,30,1,1
61295,443,61295,443,5014,1722,3292,17,18,10,7
38660,443,61188,443,7031,1824,5207,23,60,12,11
56611,80,8801,80,1114,534,580,12,16,7,5
50972,3544,44578,3544,409,107,302,4,30,2,2
55434,53,17321,53,1335,87,1248,4,38,2,2
64587,53,13030,53,167,86,81,2,30,1,1
43785,443,28083,443,6017,1285,4732,18,984,8,10
49212,53,38007,53,183,94,89,2,29,1,1
55553,443,62763,443,6639,3918,2721,16,135,8,8
27005,27015,31216,27015,939,126,813,2,30,1,1
49534,53,17481,53,315,84,231,4,40,2,2
55776,53,52683,53,216,110,106,2,30,1,1
53720,443,39047,443,11338,7078,4260,19,16,12,7
51148,443,35605,443,4332,1907,2425,18,136,8,10
50037,53,65320,53,195,102,93,2,31,1,1
51809,443,51809,443,1466,856,610,13,27,6,7
55046,80,10209,80,2775,1332,1443,12,34,7,5
53141,443,52504,443,37389,3972,33417,69,133,32,37
55362,53,39798,53,195,102,93,2,30,1,1
52209,80,41464,80,372,246,126,6,27,4,2
55353,53,50896,53,311,86,225,4,55,2,2
59733,443,63033,443,7310,967,6343,18,25,10,8
51604,443,15214,443,2911,2062,849,14,134,8,6
49866,443,6704,443,7128,865,6263,19,87,9,10
46592,53,27919,53,168,78,90,2,30,1,1
65426,80,28723,80,65980,5156,60824,86,23,39,47
50273,53,27219,53,718,94,624,2,30,1,1
46799,443,46799,443,22215,2460,19755,39,198,15,24
57296,53,12062,53,200,102,98,2,31,1,1
64038,53,4227,53,321,102,219,2,30,1,1
57259,53,28924,53,167,86,81,2,29,1,1
43357,443,31552,443,6392,1099,5293,18,33,10,8
55043,80,21312,80,306,180,126,6,34,4,2
64752,53,32902,53,186,102,84,2,30,1,1
49203,53,26385,53,240,94,146,2,29,1,1
57802,443,19538,443,37181,32491,4690,93,81,54,39
64880,53,46886,53,164,84,80,2,30,1,1
53268,443,17713,443,22541,2143,20398,38,322,16,22
50648,80,55586,80,132,132,0,2,8,2,0
57309,53,8457,53,197,102,95,2,30,1,1
56712,53,47464,53,177,94,83,2,30,1,1
46212,443,38830,443,67265,57889,9376,174,102,98,76
48372,8100,19668,8100,234,234,0,4,11,4,0
13826,443,17437,443,7356,1014,6342,20,75,10,10
52062,60388,22555,60388,70,70,0,1,5,1,0
54968,53,43253,53,199,102,97,2,30,1,1
60435,80,13780,80,5518,527,4991,13,75,6,7
53241,443,12408,443,6058,1038,5020,20,69,11,9
51850,11981,61118,11981,316,136,180,6,7,3,3
50461,443,13300,443,78333,12774,65559,140,128,59,81
51634,80,59507,80,378,192,186,7,39,4,3
64125,53,26967,53,199,102,97,2,30,1,1
65384,53,35279,53,197,102,95,2,33,1,1
55584,53,38540,53,177,94,83,2,29,1,1
57075,53,41557,53,443,182,261,6,31,3,3
49438,443,56148,443,180,60,120,4,15,2,2
37573,443,61773,443,499,425,74,4,0,3,1
64439,53,3142,53,199,102,97,2,30,1,1
63032,53,34881,53,304,86,218,2,30,1,1
57376,443,40721,443,7211,823,6388,16,15,10,6
62547,443,41349,443,54095,6413,47682,151,450,61,90
9175,443,52821,443,6331,837,5494,19,28,10,9
52265,32078,35097,32078,70,70,0,2,7,2,0
52405,443,59113,443,10506,2063,8443,31,46,17,14
61363,443,19587,443,7653,1226,6427,24,18,14,10
56121,53,26656,53,338,110,228,2,30,1,1
63102,443,30669,443,8848,3081,5767,56,335,26,30
63585,443,56391,443,123421,11745,111676,267,125,108,159
56611,53,59791,53,181,94,87,2,31,1,1
64842,53,17214,53,802,104,698,2,31,1,1
57425,443,33540,443,130,70,60,2,15,1,1
46587,443,46587,443,30701,1538,29163,40,16,14,26
64123,443,56759,443,1411,852,559,13,25,7,6
41750,443,14251,443,4636,792,3844,16,15,8,8
60899,7275,19563,7275,2875,449,2426,12,16,7,5
56447,53,59083,53,758,96,662,2,31,1,1
65404,53,47407,53,334,226,108,3,29,2,1
58864,443,14029,443,5167,700,4467,16,15,7,9
32866,443,34870,443,23467,16522,6945,51,161,29,22
50640,443,7427,443,1533,950,583,14,85,8,6
64833,53,62978,53,167,86,81,2,30,1,1
65078,53,48280,53,339,110,229,2,29,1,1
64913,53,27503,53,183,94,89,2,30,1,1
49518,80,62849,80,11011,7675,3336,21,26,11,10
50653,80,33144,80,124643,7017,117626,163,21,75,88
59392,443,2075,443,105190,30835,74355,372,589,169,203
52257,6712,42589,6712,70,70,0,2,8,2,0
55660,42459,61425,42459,1717,1129,588,17,25,10,7
40992,443,49820,443,8705,3570,5135,35,100,20,15
49326,53,62713,53,193,102,91,2,30,1,1
62334,443,24621,443,3244,1630,1614,8,120,4,4
56081,53,46764,53,186,102,84,2,29,1,1
50311,443,2014,443,133674,20935,112739,206,350,105,101
50023,53,38403,53,164,84,80,2,31,1,1
6881,6881,30399,6881,238,118,120,2,1199,1,1
64016,53,50450,53,183,94,89,2,30,1,1
46069,80,2181,80,2684,2550,134,7,17,5,2
52012,443,5821,443,126,60,66,3,10,2,1
55087,53,26632,53,183,94,89,2,30,1,1
51433,443,11382,443,194,70,124,3,11,1,2
55292,53,15138,53,274,94,180,2,30,1,1
53638,443,29587,443,2090,1100,990,17,119,9,8
41543,443,55490,443,234,234,0,4,12,4,0
37202,53,37202,53,216,90,126,2,30,1,1
51646,80,56559,80,378,192,186,7,38,4,3
55362,53,21893,53,195,102,93,2,29,1,1
49329,53,8761,53,258,102,156,2,30,1,1
49815,53,3379,53,789,110,679,2,31,1,1
49341,443,6648,443,6882,1788,5094,15,16,9,6
61424,443,36108,443,1119,589,530,12,28,6,6
57051,53,10858,53,354,90,264,4,50,2,2
65056,53,16740,53,168,94,74,2,30,1,1
53176,58851,59130,58851,70,70,0,2,8,2,0
45019,443,10530,443,33865,6559,27306,67,67,34,33
56563,53,35411,53,177,94,83,2,29,1,1
60403,443,3192,443,5567,1589,3978,20,80,11,9
65249,53,14438,53,1579,94,1485,4,36,2,2
34539,80,34539,80,22098,1602,20496,24,57,6,18
15503,42638,40530,42638,1367,664,703,16,1200,9,7
48462,80,48462,80,19738,890,18848,25,20,9,16
41787,443,37748,443,34237,22442,11795,86,131,41,45
54181,443,63427,443,9283,2154,7129,22,15,12,10
55095,53,28399,53,194,102,92,2,30,1,1
38360,53,56266,53,168,78,90,2,30,1,1
53751,53,53289,53,578,286,292,9,16,5,4
38517,53,38517,53,214,82,132,2,32,1,1
51820,53738,51101,53738,66,66,0,2,8,2,0
55877,42466,20270,42466,481,150,331,2,1200,1,1
57127,53,61936,53,193,102,91,2,31,1,1
41610,443,48992,443,9488,2196,7292,25,26,14,11
50393,80,25546,80,366,180,186,7,26,4,3
53788,1,42504,1,70,70,0,1,5,1,0
44847,31381,18131,31381,150,150,0,1,1200,1,0
64439,53,36419,53,359,134,225,2,30,1,1
14441,443,20256,443,2629,1470,1159,18,15,8,10
49525,80,7498,80,454,262,192,8,38,5,3
49620,443,27552,443,13241,2865,10376,60,242,26,34
5588,5588,0,0,3354,1792,1562,46,194,23,23
55379,53,30186,53,256,93,163,2,31,1,1
26458,80,26458,80,490,264,226,8,32,5,3
54973,53,14051,53,181,94,87,2,30,1,1
62914,993,49276,993,9285,4057,5228,80,45,39,41
49749,53,2042,53,200,102,98,2,30,1,1
61429,443,58099,443,9504,3379,6125,28,77,15,13
42066,443,21363,443,377544,10569,366975,414,221,152,262
57470,40794,36042,40794,132,132,0,3,1199,3,0
51962,443,60648,443,8600,1735,6865,27,25,14,13
55538,53,14832,53,195,102,93,2,30,1,1
59747,443,56102,443,1991,1190,801,21,32,11,10
56561,53,57177,53,183,94,89,2,30,1,1
56956,53,28771,53,182,93,89,2,30,1,1
52516,80,41641,80,3224,2776,448,11,15,7,4
49247,53,7662,53,478,196,282,6,63,3,3
63952,53,35871,53,289,102,187,2,30,1,1
64381,443,33769,443,4838,1059,3779,16,54,8,8
54820,443,53134,443,16366,4160,12206,41,55,20,21
53871,443,15841,443,7797,1807,5990,15,135,7,8
57599,80,57241,80,1526,972,554,10,75,6,4
51858,44647,64567,44647,70,70,0,2,8,2,0
60324,443,7520,443,1743,1164,579,16,25,10,6
55721,53,26269,53,177,94,83,2,30,1,1
52232,35126,34717,35126,70,70,0,1,5,1,0
49787,53,40556,53,258,110,148,2,29,1,1
56953,53,15670,53,421,78,343,2,31,1,1
56068,53,7794,53,152,78,74,2,30,1,1
55610,53,57817,53,181,94,87,2,30,1,1
6881,55980,18375,55980,226,118,108,2,1199,1,1
64766,53,59121,53,212,108,104,2,31,1,1
52013,35185,52958,35185,70,70,0,2,9,2,0
34529,443,30445,443,62652,30891,31761,158,381,67,91
49898,80,5457,80,1550,1157,393,8,86,5,3
54125,443,18046,443,170665,9296,161369,227,116,102,125
49225,53,22731,53,295,101,194,4,48,2,2
52077,51638,8361,51638,70,70,0,1,4,1,0
41169,443,56459,443,8805,1938,6867,21,17,12,9
55018,53,50628,53,179,94,85,2,30,1,1
51918,41488,54208,41488,70,70,0,2,8,2,0
49776,53,43757,53,182,94,88,2,29,1,1
53298,443,6587,443,5601,1187,4414,24,80,13,11
38469,80,38469,80,555104,4582,550522,446,20,60,386
57270,53,64569,53,200,102,98,2,30,1,1
56202,53,48899,53,749,94,655,2,30,1,1
57470,1,59410,1,132,132,0,3,1199,3,0
50767,80,50767,80,30767,854,29913,38,15,13,25
64287,53,53632,53,181,94,87,2,30,1,1
49475,53,56421,53,196,102,94,2,30,1,1
49312,53,8379,53,216,94,122,2,29,1,1
37738,443,1957,443,6470,1931,4539,27,32,14,13
65171,53,41753,53,752,110,642,2,30,1,1
56472,53,54930,53,167,86,81,2,30,1,1
49744,53,33458,53,193,102,91,2,30,1,1
52038,80,27418,80,366,240,126,7,25,5,2
26054,80,26054,80,1798,540,1258,10,15,6,4
65403,53,11897,53,199,102,97,2,31,1,1
59749,443,34617,443,304,86,218,2,29,1,1
57334,53,14690,53,210,110,100,2,30,1,1
63133,80,57043,80,18055,904,17151,22,15,7,15
41748,443,37689,443,4570,792,3778,15,15,8,7
47123,443,37885,443,1053,566,487,10,43,6,4
41295,443,40323,443,7661,1115,6546,19,35,10,9
65064,53,44516,53,338,110,228,2,30,1,1
65220,53,7048,53,184,94,90,2,29,1,1
55066,53,18793,53,176,90,86,2,31,1,1
56756,53,46487,53,166,85,81,2,31,1,1
49488,53,56220,53,194,102,92,2,31,1,1
57096,53,51826,53,177,94,83,2,30,1,1
55937,53,13424,53,177,94,83,2,30,1,1
41613,80,21847,80,6003,691,5312,13,16,7,6
27350,80,31798,80,3943,1809,2134,21,82,11,10
57444,443,62310,443,7975,1742,6233,24,81,14,10
56266,53,65060,53,193,102,91,2,30,1,1
56215,53,5017,53,216,110,106,2,30,1,1
56951,53,31366,53,168,86,82,2,29,1,1
49989,53,14607,53,778,103,675,2,30,1,1
40858,53,40858,53,200,90,110,2,30,1,1
56622,53,31873,53,214,110,104,2,30,1,1
55158,53,42446,53,239,102,137,2,30,1,1
54889,443,50379,443,4600,2214,2386,13,134,7,6
53838,443,50005,443,499,425,74,4,0,3,1
33545,443,31253,443,9737,3353,6384,27,32,13,14
53076,443,8791,443,96850,6037,90813,150,177,55,95
65482,443,24363,443,92212,4799,87413,107,16,43,64
57263,53,12000,53,167,86,81,2,30,1,1
59760,53,48696,53,384,166,218,2,29,1,1
56783,53,7045,53,193,102,91,2,30,1,1
56186,53,36968,53,198,102,96,2,30,1,1
65290,53,6842,53,181,94,87,2,29,1,1
52626,80,56571,80,2820,1466,1354,20,534,11,9
43214,443,49896,443,1563663,41030,1522633,1538,40,479,1059
56509,53,27088,53,1164,93,1071,2,30,1,1
55524,53,46955,53,413,170,243,6,30,3,3
56586,53,7181,53,177,94,83,2,30,1,1
54800,443,4050,443,9612,4324,5288,31,400,11,20
53834,15000,23428,15000,130,70,60,2,6,1,1
62724,443,47821,443,87797,47766,40031,754,453,303,451
52196,25336,19782,25336,316,136,180,6,6,3,3
57470,34879,21991,34879,1914,1914,0,30,1766,30,0
64796,53,58063,53,184,94,90,2,30,1,1
36307,53,54070,53,200,86,114,2,30,1,1
56841,53,54383,53,177,94,83,2,29,1,1
55782,53,43309,53,245,94,151,2,29,1,1
51761,19136,25240,19136,70,70,0,1,5,1,0
62112,443,63604,443,4655,1649,3006,10,120,5,5
57348,443,22476,443,6250,1312,4938,23,315,12,11
49374,53,26527,53,199,94,105,2,30,1,1
55906,53,30212,53,264,110,154,2,30,1,1
53151,34935,46356,34935,698,320,378,10,17,6,4
57896,443,11349,443,7332,3746,3586,37,176,19,18
39328,80,62636,80,234,234,0,4,12,4,0
53287,80,8055,80,2881,1001,1880,12,52,7,5
49582,53,29592,53,168,78,90,2,30,1,1
64019,53,58991,53,267,94,173,2,30,1,1
53454,443,37572,443,10416,3195,7221,32,46,18,14
40780,80,6352,80,1155,781,374,10,16,6,4
50549,53,21467,53,199,94,105,2,30,1,1
37659,443,25278,443,3354,2353,1001,18,45,11,7
49820,53,34423,53,193,102,91,2,30,1,1
55017,443,32512,443,7627,2734,4893,26,16,15,11
57297,53,52793,53,242,102,140,2,30,1,1
61686,80,38395,80,4004,1513,2491,20,47,10,10
49647,80,48193,80,318,192,126,6,42,4,2
49275,7000,49275,7000,2163,676,1487,14,15,7,7
10080,443,4270,443,130,70,60,3,5,2,1
53553,53,53553,53,229,98,131,2,30,1,1
56631,80,19501,80,234,234,0,4,12,4,0
64073,53,37819,53,520,211,309,6,39,3,3
53799,6881,35241,6881,70,70,0,2,7,2,0
49539,53,44717,53,170,87,83,2,31,1,1
53195,443,48069,443,1462,965,497,13,18,7,6
56520,53,14015,53,757,98,659,2,30,1,1
57306,53,15056,53,177,94,83,2,31,1,1
50584,56112,8598,56112,1377,300,1077,6,1200,3,3
57292,443,37855,443,18591,5839,12752,78,18,44,34
50649,443,16928,443,15295,1755,13540,31,77,15,16
36241,443,45879,443,7768,3776,3992,21,132,11,10
27005,27022,35280,27022,1654,126,1528,4,31,2,2
50584,47174,17468,47174,300,300,0,3,1200,3,0
57884,443,2033,443,3981,1811,2170,26,177,14,12
59393,443,45183,443,1664,914,750,15,275,7,8
51913,443,51764,443,190,70,120,4,15,2,2
49566,443,65424,443,1394,540,854,24,36,10,14
53648,31637,13598,31637,744,618,126,10,28,8,2
55872,53,55616,53,177,94,83,2,30,1,1
9254,443,60082,443,6135,770,5365,17,26,9,8
49436,443,51591,443,784271,38715,745556,1017,183,465,552
28755,80,28755,80,21270,2178,19092,35,29,15,20
57992,80,4887,80,10247,3696,6551,32,33,16,16
56698,443,19362,443,106055,8460,97595,168,26,79,89
65139,53,19988,53,216,110,106,2,31,1,1
49163,36069,48102,36069,5990,5698,292,17,51,14,3
38065,443,63801,443,911697,74083,837614,1247,343,459,788
54238,443,21116,443,499,425,74,4,0,3,1
27988,40002,58461,40002,144,82,62,2,31,1,1
51117,80,26474,80,5040,3914,1126,19,32,12,7
49490,443,58298,443,1627,884,743,12,27,6,6
6881,6889,18694,6889,221,111,110,2,1200,1,1
64268,53,55887,53,679,179,500,6,69,3,3
36697,443,4687,443,21563,17259,4304,70,78,37,33
6881,38554,27434,38554,221,111,110,2,1200,1,1
63975,24874,47562,24874,70,70,0,1,5,1,0
57398,53,10527,53,770,102,668,2,31,1,1
33240,443,43731,443,7375,4769,2606,24,16,14,10
56482,80,53743,80,180583,6825,173758,188,136,68,120
56665,53,14967,53,223,86,137,2,30,1,1
65257,53,65257,53,176,78,98,2,30,1,1
63921,23758,6337,23758,312,132,180,6,7,3,3
49445,443,22095,443,462587,17396,445191,527,130,198,329
52718,53,15399,53,164,78,86,2,30,1,1
52173,44632,6542,44632,156,66,90,2,5,1,1
54998,53,32757,53,195,102,93,2,29,1,1
60493,55172,57169,55172,320,140,180,6,7,3,3
65197,53,14120,53,177,86,91,2,30,1,1
45319,443,29767,443,9284,2430,6854,25,82,14,11
56424,53,21857,53,177,94,83,2,30,1,1
27005,27015,58222,27015,901,126,775,2,30,1,1
55196,443,1122,443,13568,2119,11449,35,316,17,18
6881,6881,3673,6881,237,118,119,2,1200,1,1
56274,53,29071,53,177,94,83,2,29,1,1
38643,443,11641,443,1468,893,575,15,62,8,7
27005,27025,27504,27025,895,126,769,2,30,1,1
54306,443,20116,443,13053,5216,7837,25,135,11,14
50700,80,7989,80,142,142,0,1,5,1,0
64955,53,11149,53,761,100,661,2,0,1,1
63932,63241,5696,63241,436,254,182,7,15,4,3
65065,53,58024,53,209,110,99,2,30,1,1
56088,53,17141,53,774,101,673,2,30,1,1
36692,443,41344,443,996,526,470,15,30,8,7
50257,53,13525,53,199,102,97,2,30,1,1
52088,443,13388,443,16165,3877,12288,53,186,25,28
62640,53,62640,53,414,268,146,3,32,2,1
55849,53,54594,53,195,102,93,2,30,1,1
40940,443,13530,443,12685,7319,5366,36,398,15,21
44603,53,44603,53,229,98,131,2,29,1,1
46750,80,46750,80,27124,1455,25669,41,15,20,21
36631,443,36631,443,4568,1661,2907,19,29,11,8
51978,80,26908,80,4612,3409,1203,14,25,9,5
56927,53,28530,53,183,94,89,2,29,1,1
58754,53,0,0,627,80,547,2,30,1,1
49418,27015,51226,27015,274,78,196,2,30,1,1
44861,443,14296,443,1625,1038,587,14,27,8,6
53748,51413,19666,51413,70,70,0,1,5,1,0
49260,53,23458,53,199,86,113,2,30,1,1
50584,16455,26852,16455,1356,300,1056,6,1200,3,3
26450,80,26450,80,642,338,304,10,32,6,4
41803,53,41803,53,243,104,139,2,30,1,1
41832,5222,27749,5222,3823,1878,1945,39,309,22,17
56330,53,9857,53,271,95,176,4,48,2,2
53443,123,34007,123,184,94,90,2,30,1,1
53570,24874,32383,24874,70,70,0,2,7,2,0
65189,53,21618,53,734,94,640,2,29,1,1
27988,40003,22369,40003,148,86,62,2,30,1,1
49352,53,51513,53,216,102,114,2,29,1,1
49640,443,55755,443,2809,1729,1080,18,80,10,8
49561,53,39252,53,754,94,660,2,30,1,1
59763,443,40613,443,304,86,218,2,30,1,1
57013,80,43644,80,5696,703,4993,14,75,8,6
6881,60026,38643,60026,509,150,359,2,1199,1,1
55194,53,53010,53,190,97,93,2,31,1,1
55032,5222,63875,5222,138,64,74,3,5,2,1
65487,53,41710,53,210,110,100,2,29,1,1
51918,80,52022,80,426,240,186,8,29,5,3
53866,443,56444,443,499,425,74,4,1,3,1
56438,3389,56438,3389,3425,1470,1955,16,17,8,8
64650,53,46019,53,193,94,99,2,30,1,1
56838,53,18546,53,177,94,83,2,29,1,1
50213,80,50213,80,1723391,21750,1701641,1450,16,326,1124
56598,80,2431,80,234,234,0,4,12,4,0
65336,53,55246,53,200,102,98,2,30,1,1
57012,80,14292,80,214,140,74,4,31,3,1
65042,53,25956,53,182,93,89,2,31,1,1
49794,53,12589,53,197,102,95,2,30,1,1
50265,37083,2868,37083,490,150,340,2,1200,1,1
64762,53,20987,53,194,102,92,2,31,1,1
56664,443,21855,443,8005,1985,6020,20,15,11,9
64233,53,2922,53,257,126,131,2,29,1,1
65229,53,50750,53,193,102,91,2,31,1,1
57852,7635,57852,7635,216,156,60,4,8,3,1
35428,443,14497,443,9592,2361,7231,25,15,14,11
52085,80,49733,80,360,240,120,7,25,5,2
63076,443,26735,443,304,86,218,2,31,1,1
44380,443,20721,443,5624,2556,3068,29,80,15,14
49734,53,21745,53,216,110,106,2,30,1,1
49418,27054,42342,27054,272,78,194,2,30,1,1
50008,53,29808,53,186,95,91,2,30,1,1
36255,53,36255,53,197,90,107,2,30,1,1
50012,53,54567,53,208,106,102,2,30,1,1
42820,443,51976,443,25721,8999,16722,38,121,18,20
56766,443,14480,443,10137,4019,6118,42,8169,24,18
46858,15000,17792,15000,130,70,60,2,5,1,1
55544,3389,55544,3389,3657,1638,2019,20,18,11,9
9250,443,1319,443,6331,837,5494,19,26,10,9
54363,443,18639,443,23766,10707,13059,80,42,41,39
57044,53,54820,53,177,94,83,2,31,1,1
53941,53739,11665,53739,70,70,0,2,8,2,0
50448,443,27905,443,10382,3262,7120,30,142,16,14
43701,443,61661,443,1201,707,494,12,26,7,5
64318,53,51027,53,183,94,89,2,30,1,1
56754,14715,43516,14715,66,66,0,1,5,1,0
58795,443,29024,443,19700,12992,6708,44,18,23,21
3497,53,3497,53,222,90,132,2,30,1,1
22583,53,22583,53,213,82,131,2,30,1,1
60543,53,6634,53,211,78,133,2,30,1,1
64584,443,62186,443,24682,1935,22747,36,19,17,19
58000,80,21507,80,48253,13664,34589,66,75,25,41
38717,443,31292,443,958865,18695,940170,908,16,266,642
49765,443,5454,443,11588,4383,7205,39,46,22,17
53157,34841,3594,34841,698,320,378,10,16,6,4
42298,40002,3434,40002,241,178,63,2,31,1,1
64143,53,9554,53,174,89,85,2,31,1,1
60524,443,60524,443,1088,641,447,10,26,6,4
56799,53,3973,53,353,94,259,2,30,1,1
52956,443,14626,443,15659,3294,12365,60,114,25,35
64935,53,11961,53,186,95,91,2,31,1,1
54889,443,57896,443,5541,3309,2232,19,61,11,8
47289,443,7853,443,16114,7882,8232,37,104,15,22
55451,53,63000,53,751,95,656,2,30,1,1
59848,53,28215,53,239,102,137,2,30,1,1
55965,53,59955,53,184,94,90,2,29,1,1
53777,443,29327,443,495,421,74,4,0,3,1
50664,443,64015,443,7767,1421,6346,20,15,8,12
64299,53,27762,53,164,84,80,2,31,1,1
60920,53,22139,53,268,86,182,2,30,1,1
60980,443,25213,443,134,60,74,3,6,2,1
49512,443,31852,443,7626,1741,5885,35,256,17,18
65330,53,53724,53,723,102,621,2,30,1,1
21133,26205,8150,26205,480,149,331,2,1200,1,1
55626,63805,23725,63805,70,70,0,1,5,1,0
55735,53,28047,53,184,94,90,2,30,1,1
50147,443,13714,443,9915,1833,8082,22,46,13,9
61792,443,46504,443,12526,7202,5324,28,99,15,13
63939,24867,28601,24867,312,132,180,6,6,3,3
55028,443,55949,443,6015,3964,2051,32,361,18,14
53897,443,53988,443,499,425,74,4,0,3,1
49661,53,62903,53,344,102,242,2,30,1,1
49546,443,43053,443,1346,918,428,10,23,6,4
54952,5228,14099,5228,12140,3028,9112,54,4653,28,26
55742,53,41755,53,186,95,91,2,31,1,1
49652,80,41270,80,1854,945,909,13,106,7,6
55225,53,48958,53,822,102,720,2,30,1,1
60854,443,16841,443,10447,2417,8030,26,16,15,11
49914,53,39261,53,815,95,720,2,30,1,1
58849,443,61655,443,36920,24591,12329,80,24,47,33
64122,53,64122,53,220,90,130,2,30,1,1
58974,80,55839,80,214,140,74,4,15,3,1
52175,1101,39473,1101,70,70,0,2,8,2,0
39802,443,21011,443,3025,1958,1067,26,49,14,12
49277,80,55324,80,254,128,126,5,16,3,2
55600,53,56237,53,168,78,90,2,30,1,1
57170,53,13134,53,298,102,196,4,36,2,2
64639,53,49663,53,199,102,97,2,31,1,1
9432,443,6777,443,6094,771,5323,17,26,9,8
48755,53,17288,53,168,78,90,2,30,1,1
38143,443,38143,443,36902,3203,33699,57,90,31,26
57140,53,49322,53,177,94,83,2,30,1,1
55372,53,55372,53,216,90,126,2,30,1,1
50584,6881,26330,6881,502,150,352,2,1200,1,1
55843,53,38678,53,177,94,83,2,30,1,1
65507,53,44287,53,199,102,97,2,30,1,1
54993,443,50582,443,38985,4250,34735,58,19,27,31
64394,53,6864,53,226,102,124,2,30,1,1
55915,53,47313,53,86,86,0,1,30,1,0
57689,443,27070,443,10855,1786,9069,32,180,15,17
55036,53,7624,53,177,94,83,2,30,1,1
49736,443,25787,443,8028,1787,6241,32,28,17,15
46703,443,29330,443,4589,2090,2499,15,120,7,8
30960,45684,7454,45684,330,330,0,6,3609,6,0
55441,53,20150,53,216,110,106,2,31,1,1
53570,24874,57819,24874,70,70,0,1,4,1,0
52193,33027,31412,33027,70,70,0,2,8,2,0
22807,443,22807,443,4518,1665,2853,19,25,11,8
40204,40039,52941,40039,152,90,62,2,31,1,1
51987,23136,41339,23136,70,70,0,1,5,1,0
45764,443,11581,443,57543,2347,55196,68,16,26,42
51421,443,61384,443,9345,3051,6294,22,15,13,9
50018,53,63073,53,350,91,259,4,41,2,2
56726,53,58672,53,223,102,121,2,30,1,1
53779,24874,46162,24874,70,70,0,1,5,1,0
51328,443,46063,443,6021,1981,4040,21,15,9,12
53692,53,53692,53,262,82,180,2,29,1,1
39802,443,46895,443,2863801,103667,2760134,3193,182,1240,1953
56513,53,43170,53,184,86,98,2,30,1,1
49843,53,43292,53,193,102,91,2,30,1,1
51776,14645,62934,14645,70,70,0,1,5,1,0
57067,53,57189,53,182,93,89,2,30,1,1
65106,53,42197,53,193,102,91,2,30,1,1
49665,53,16462,53,168,86,82,2,32,1,1
53012,443,30523,443,4073,2039,2034,14,135,7,7
49205,53,36921,53,194,102,92,2,30,1,1
57433,443,58515,443,11243,4236,7007,47,15,22,25
30960,45742,3769,45742,330,330,0,6,3609,6,0
49527,53,33639,53,173,94,79,2,30,1,1
49398,80,11997,80,3651,2020,1631,16,65,9,7
30960,45731,48545,45731,330,330,0,6,3610,6,0
55146,53,47251,53,181,94,87,2,30,1,1
56529,53,60444,53,711,87,624,2,31,1,1
64595,53,8174,53,305,94,211,4,60,2,2
55919,53,46329,53,177,94,83,2,31,1,1
56612,53,46131,53,184,94,90,2,29,1,1
52917,443,10403,443,5583,1390,4193,19,14,9,10
52227,27904,24192,27904,316,136,180,6,9,3,3
49510,53,6465,53,329,118,211,2,29,1,1
49538,53,59762,53,754,94,660,2,30,1,1
64332,53,12232,53,195,102,93,2,30,1,1
49176,53,17276,53,264,110,154,2,30,1,1
49420,53,3179,53,170,87,83,2,31,1,1
55010,53,35689,53,195,102,93,2,29,1,1
35567,443,35567,443,5413,2166,3247,22,39,13,9
56799,443,34365,443,5057,880,4177,16,70,8,8
63038,53,49856,53,303,85,218,2,31,1,1
65056,53,26315,53,199,102,97,2,29,1,1
64704,53,49716,53,213,102,111,2,29,1,1
55649,42266,57482,42266,70,70,0,1,5,1,0
64012,40642,7765,40642,70,70,0,1,5,1,0
51901,443,44241,443,6215,948,5267,18,15,9,9
55748,53,53147,53,194,102,92,2,31,1,1
25803,53,25803,53,231,88,143,2,33,1,1
65097,53,14229,53,718,94,624,2,30,1,1
20495,53,20495,53,217,90,127,2,30,1,1
54076,443,7008,443,55394,4535,50859,91,170,47,44
53765,16178,52610,16178,70,70,0,2,7,2,0
61360,443,42103,443,7653,1226,6427,24,18,14,10
33119,80,62481,80,1638,1324,314,10,14,5,5
64484,53,55455,53,168,86,82,2,31,1,1
59951,53,55881,53,237,86,151,2,30,1,1
53949,42301,56593,42301,1396,719,677,15,15,8,7
52491,53,62857,53,289,86,203,2,30,1,1
57239,53,64762,53,193,102,91,2,31,1,1
12433,53,7842,53,208,86,122,2,30,1,1
5588,5588,0,0,3354,1792,1562,46,193,23,23
30960,45756,31120,45756,396,396,0,7,3616,7,0
33825,443,12586,443,15400,12233,3167,75,995,38,37
35437,443,7147,443,53756,46525,7231,82,275,51,31
9478,443,35302,443,6092,775,5317,17,28,9,8
61475,443,7125,443,198481,12339,186142,247,64,112,135
56795,53,37529,53,776,102,674,2,30,1,1
9303,443,49206,443,3616,429,3187,11,16,6,5
52067,46837,12452,46837,70,70,0,2,8,2,0
50063,53,53923,53,173,94,79,2,30,1,1
57196,53,25390,53,183,94,89,2,30,1,1
50122,443,28442,443,130,70,60,2,15,1,1
49313,53,49710,53,199,102,97,2,30,1,1
53251,443,22293,443,24116,2677,21439,42,323,17,25
55365,53,11222,53,214,110,104,2,29,1,1
55834,53,32935,53,184,94,90,2,31,1,1
64252,53,63394,53,381,101,280,4,43,2,2
53916,443,57375,443,499,425,74,4,0,3,1
60323,443,19514,443,1743,1164,579,16,25,10,6
10019,443,53412,443,1497912,26236,1471676,1321,121,299,1022
55285,53,22135,53,268,95,173,4,45,2,2
60772,40010,29000,40010,316,136,180,6,5,3,3
60220,80,36816,80,21108,15948,5160,47,151,30,17
52888,5223,32740,5223,12302,5509,6793,43,1061,16,27
61430,443,43160,443,7288,1763,5525,22,77,12,10
56169,53,27417,53,210,110,100,2,29,1,1
51772,443,20083,443,2320,327,1993,11,135,5,6
5612,53,5612,53,227,89,138,2,30,1,1
27005,27203,54242,27203,871,126,745,2,29,1,1
60481,40075,5787,40075,70,70,0,2,8,2,0
55240,53,36394,53,816,102,714,2,30,1,1
53894,443,60349,443,6375,1019,5356,21,16,11,10
61744,443,1594,443,3743,1654,2089,10,121,5,5
55910,53,42664,53,183,94,89,2,30,1,1
57470,29137,36773,29137,1386,1386,0,22,1610,22,0
49230,53,32099,53,195,94,101,2,30,1,1
55209,53,33482,53,196,102,94,2,33,1,1
56667,53,23608,53,168,86,82,2,31,1,1
64737,53,9334,53,269,110,159,2,30,1,1
55728,53,52425,53,195,102,93,2,30,1,1
10037,443,24188,443,6061,1884,4177,27,16,15,12
47387,443,50220,443,3930,392,3538,9,15,4,5
64665,53,63171,53,91,91,0,1,30,1,0
56826,53,57035,53,94,94,0,1,29,1,0
49291,443,62267,443,18607,4906,13701,47,255,20,27
46774,80,26120,80,2074,1375,699,13,83,7,6
38405,443,30504,443,9876,1976,7900,27,27,13,14
54997,443,59177,443,10817,4402,6415,31,23,17,14
58744,443,27181,443,2576,1549,1027,15,15,7,8
45103,80,17939,80,1748,716,1032,19,409,6,13
56149,53,1500,53,179,94,85,2,30,1,1
49288,53,48281,53,322,102,220,2,30,1,1
57275,53,22195,53,199,102,97,2,31,1,1
41039,443,10141,443,1053,566,487,10,31,6,4
52168,443,14996,443,73105,13398,59707,220,374,108,112
38858,443,38858,443,226465,10306,216159,292,104,135,157
58004,80,58289,80,14922,10566,4356,39,75,20,19
57049,53,52014,53,755,93,662,2,31,1,1
55740,8060,53740,8060,70,70,0,1,5,1,0
65415,443,12568,443,2494,1643,851,17,26,9,8
57139,53,12753,53,816,102,714,2,30,1,1
64052,38119,11965,38119,312,132,180,6,6,3,3
56487,53,32287,53,194,102,92,2,30,1,1
49687,53,12525,53,194,99,95,2,31,1,1
59933,80,6671,80,582,138,444,9,25,3,6
64872,53,24466,53,730,102,628,2,29,1,1
65004,53,23515,53,323,94,229,2,30,1,1
49364,53,15202,53,182,94,88,2,30,1,1
56803,53,37278,53,183,94,89,2,29,1,1
52887,80,9477,80,5694,2514,3180,36,118,19,17
52161,19897,37234,19897,70,70,0,1,4,1,0
24929,53,24929,53,217,87,130,2,31,1,1
36307,80,3965,80,1368,920,448,12,20,7,5
39785,443,37102,443,7967,2261,5706,18,121,8,10
59615,53,32493,53,320,94,226,2,30,1,1
51647,443,26913,443,6400,1830,4570,26,316,13,13
56216,53,54561,53,177,94,83,2,30,1,1
63084,443,51859,443,571,166,405,2,30,1,1
63224,443,7611,443,1373,734,639,17,155,10,7
38566,443,54032,443,4108,1272,2836,11,121,5,6
50709,80,40115,80,1658,1247,411,8,15,5,3
55649,42266,41427,42266,70,70,0,2,8,2,0
48550,443,45303,443,778,358,420,12,43,6,6
59420,53,63231,53,224,78,146,2,30,1,1
50265,24387,44902,24387,330,330,0,6,1200,6,0
58794,5222,61380,5222,47445,16812,30633,144,870,65,79
50871,443,47245,443,9241,2001,7240,24,28,14,10
45273,80,45273,80,18685,7141,11544,33,28,17,16
50369,53,47601,53,166,86,80,2,30,1,1
56272,53,1689,53,167,86,81,2,30,1,1
62323,443,8004,443,6383,2838,3545,17,135,9,8
8282,40200,5762,40200,133,64,69,3,30,2,1
56340,53,20646,53,780,104,676,2,30,1,1
56970,443,2688,443,20635942,626393,20009549,21680,138,6969,14711
45627,443,27902,443,6410,1610,4800,24,17,13,11
55394,53,55394,53,197,76,121,2,30,1,1
49543,53,5363,53,200,102,98,2,30,1,1
44911,443,42749,443,10194,2176,8018,25,186,14,11
51499,443,54241,443,1610,1073,537,14,15,8,6
10011,443,63236,443,14565,3464,11101,59,151,31,28
43835,443,28215,443,11422,2361,9061,26,505,10,16
56352,53,18136,53,177,94,83,2,30,1,1
60242,80,7986,80,1493,737,756,11,150,6,5
64424,53,20113,53,194,94,100,2,30,1,1
49646,53,51164,53,353,118,235,2,30,1,1
63913,24806,2171,24806,630,508,122,9,15,7,2
49418,27017,24547,27017,258,78,180,2,29,1,1
51880,18468,34831,18468,70,70,0,1,5,1,0
53263,443,15903,443,14269,5761,8508,43,18,23,20
61592,443,6581,443,19544,8237,11307,29,121,13,16
56271,53,40470,53,195,102,93,2,30,1,1
49313,53,6801,53,295,101,194,4,31,2,2
57102,53,62083,53,761,100,661,2,31,1,1
50584,61421,62887,61421,166,166,0,1,1199,1,0
64394,443,20424,443,3182,1568,1614,8,120,4,4
57353,443,37638,443,150,150,0,1,5,1,0
50693,80,54649,80,4465,3390,1075,14,30,8,6
55721,53,41720,53,177,94,83,2,30,1,1
56330,53,48374,53,271,95,176,4,47,2,2
54964,443,18537,443,24232,10141,14091,74,76,39,35
57027,53,59688,53,177,94,83,2,31,1,1
39892,443,8583,443,2186,1319,867,23,20,13,10
64128,53,31311,53,193,102,91,2,31,1,1
51419,443,59979,443,13049,4849,8200,31,31,15,16
57378,53,2616,53,756,95,661,2,31,1,1
45174,443,32047,443,6196,1417,4779,21,665,11,10
57363,53,63578,53,193,102,91,2,30,1,1
49300,5228,46650,5228,12589,6479,6110,172,4146,86,86
49702,80,20428,80,2014,1216,798,13,130,8,5
27005,27019,17502,27019,873,126,747,2,30,1,1
56176,53,4646,53,188,96,92,2,30,1,1
56497,53,37841,53,177,94,83,2,30,1,1
16403,16386,51369,16386,122,62,60,2,29,1,1
64344,53,51510,53,286,102,184,4,45,2,2
63976,53,54023,53,200,102,98,2,33,1,1
51768,61765,15043,61765,66,66,0,1,5,1,0
52728,80,55587,80,13372,7598,5774,29,555,18,11
51760,36558,43821,36558,70,70,0,2,8,2,0
56363,53,60359,53,269,94,175,2,30,1,1
56341,53,28637,53,213,102,111,2,29,1,1
57206,443,4994,443,1798,1223,575,13,28,8,5
53910,1024,52372,1024,70,70,0,2,8,2,0
65372,53,29268,53,198,102,96,2,30,1,1
50315,80,20802,80,1030,310,720,11,56,6,5
42595,443,31051,443,1093,606,487,11,15,7,4
63103,53,6941,53,222,86,136,2,30,1,1
51897,57057,49158,57057,70,70,0,2,8,2,0
58429,53,0,0,360,160,200,4,49,2,2
53612,1032,48115,1032,130,70,60,2,6,1,1
57470,1073,4669,1073,402,132,270,6,1209,3,3
54932,443,37338,443,84306,6712,77594,156,236,58,98
53292,443,45740,443,4028,2584,1444,18,80,10,8
60448,443,25494,443,17060,10614,6446,52,132,25,27
50670,80,2254,80,1658,1247,411,8,15,5,3
50411,80,65137,80,1657,1246,411,8,15,5,3
0,0,0,0,124,64,60,2,0,1,1
57737,443,13855,443,15625,4662,10963,25,123,11,14
50108,53,30433,53,969,86,883,2,30,1,1
50086,53,18970,53,816,102,714,2,30,1,1
57096,53,22814,53,196,100,96,2,31,1,1
60438,53,64563,53,78,78,0,1,30,1,0
50915,80,27954,80,10548172,142265,10405907,9105,134,1982,7123
49858,443,16431,443,2027955,75406,1952549,2104,60,564,1540
56258,53,19240,53,167,86,81,2,30,1,1
55052,53,42687,53,198,102,96,2,30,1,1
57323,53,27696,53,194,102,92,2,30,1,1
49839,443,14297,443,5026,973,4053,19,72,10,9
55238,443,54700,443,6165,1407,4758,21,45,12,9
49365,443,8370,443,3598,1145,2453,15,120,7,8
50281,53,4430,53,767,102,665,2,30,1,1
16980,53,16980,53,197,90,107,2,30,1,1
51252,443,8705,443,9600,4628,4972,41,16,24,17
50584,49001,15411,49001,889,161,728,3,1200,2,1
34661,53,34661,53,414,268,146,3,33,2,1
52002,80,8270,80,7480,4670,2810,47,324,30,17
57018,53,4073,53,209,110,99,2,30,1,1
57837,443,45626,443,9767,2606,7161,23,120,11,12
32975,443,44703,443,4648,1885,2763,20,95,10,10
55192,53,1273,53,760,97,663,2,31,1,1
60455,65054,62710,65054,624,318,306,10,16,5,5
51073,443,51073,443,1210,637,573,14,25,7,7
49707,443,44929,443,593578,18531,575047,531,210,128,403
51317,443,42808,443,3565,640,2925,16,153,7,9
55448,53,23931,53,184,94,90,2,29,1,1
57346,443,28545,443,72170,4208,67962,102,186,48,54
56298,53,16841,53,173,94,79,2,29,1,1
47169,15000,52806,15000,130,70,60,2,5,1,1
50669,53,9177,53,578,286,292,9,16,5,4
58369,443,52510,443,12779517,343310,12436207,12837,162,4589,8248
41029,80,41029,80,12386,2651,9735,24,126,12,12
65287,53,9876,53,176,90,86,2,31,1,1
64950,53,55366,53,183,94,89,2,30,1,1
50308,443,46748,443,44311,4535,39776,55,121,21,34
49200,38001,12165,38001,70,70,0,1,5,1,0
49653,80,47758,80,2815,1605,1210,17,166,9,8
53177,8595,28264,8595,70,70,0,2,9,2,0
60889,443,46801,443,9959,2430,7529,27,46,16,11
64637,53,20905,53,810,108,702,2,30,1,1
50531,80,18243,80,1704,799,905,11,83,6,5
37427,443,40807,443,26069,12062,14007,46,123,21,25
65209,53,43414,53,585,206,379,6,79,3,3
39423,80,5862,80,234,234,0,4,12,4,0
50508,443,43933,443,5938,1012,4926,20,77,11,9
55276,53,58176,53,177,94,83,2,30,1,1
49657,53,23289,53,198,94,104,2,30,1,1
59010,53,59010,53,832,106,726,2,29,1,1
27005,27018,6738,27018,888,126,762,2,30,1,1
49506,53,12143,53,200,102,98,2,30,1,1
31096,53,31096,53,216,82,134,2,32,1,1
49668,443,23437,443,7978,2204,5774,20,58,10,10
1558,80,1558,80,6377,703,5674,13,15,6,7
48276,15000,65405,15000,130,70,60,2,5,1,1
46715,443,4396,443,2945,779,2166,10,121,5,5
58477,443,37357,443,10026,5706,4320,20,120,10,10
57470,20433,47061,20433,726,726,0,12,1200,12,0
55893,53,33227,53,267,94,173,4,56,2,2
49976,53,44388,53,245,110,135,2,30,1,1
42172,443,15822,443,7071,1908,5163,29,944,14,15
40941,443,61408,443,9794,2178,7616,26,48,16,10
54983,443,42126,443,865636,22536,843100,903,50,309,594
56379,53,17881,53,94,94,0,1,29,1,0
56911,53,39355,53,177,94,83,2,30,1,1
52932,443,63575,443,13165,3626,9539,56,115,30,26
60416,55998,54141,55998,70,70,0,1,5,1,0
59537,443,51089,443,3351,841,2510,13,136,6,7
64091,443,50015,443,3258,1197,2061,14,136,7,7
56004,53,53891,53,177,94,83,2,30,1,1
60760,20010,54790,20010,70,70,0,2,8,2,0
52066,60118,24886,60118,70,70,0,2,8,2,0
60548,53,24812,53,199,94,105,2,29,1,1
27005,27001,29327,27001,883,126,757,2,30,1,1
57604,443,23765,443,2614,1689,925,18,21,10,8
55220,53,48038,53,193,102,91,2,31,1,1
61837,443,61837,443,18398,2360,16038,39,75,17,22
46758,123,10814,123,184,94,90,2,30,1,1
44550,80,64720,80,3577,1983,1594,18,153,9,9
49632,7000,49632,7000,1236,676,560,13,15,7,6
58895,443,48917,443,13440,8354,5086,39,20,20,19
51432,443,60618,443,194,70,124,3,11,1,2
31925,53,31925,53,237,91,146,2,33,1,1
39223,80,40485,80,1052,612,440,10,15,5,5
60415,40829,46260,40829,70,70,0,1,5,1,0
55026,443,35367,443,17336,5332,12004,33,121,18,15
49774,53,49900,53,225,110,115,2,30,1,1
56906,53,48411,53,167,86,81,2,29,1,1
55413,53,59906,53,216,110,106,2,31,1,1
49898,443,38870,443,8191,2343,5848,33,394,11,22
59734,443,48585,443,1312,651,661,13,184,7,6
37610,443,1253,443,499,425,74,4,0,3,1
7797,443,7797,443,1474,697,777,18,82,8,10
43275,443,50486,443,9093,4719,4374,52,310,24,28
57204,53,35848,53,183,94,89,2,30,1,1
44227,443,19248,443,7491,1930,5561,26,263,14,12
53939,9504,53453,9504,492,306,186,8,15,5,3
65026,53,29362,53,193,102,91,2,31,1,1
57010,53,26340,53,199,102,97,2,30,1,1
50646,80,29942,80,1328,917,411,10,25,6,4
59444,53,35195,53,489,114,375,2,31,1,1
54144,443,15023,443,2227,1018,1209,17,16,8,9
64420,53,21949,53,362,94,268,2,30,1,1
49980,53,9358,53,168,94,74,2,31,1,1
57903,443,20952,443,4823,708,4115,19,240,6,13
40379,53,38675,53,168,78,90,2,30,1,1
55810,53,35208,53,183,94,89,2,29,1,1
55926,53,60455,53,184,94,90,2,30,1,1
57053,53,14057,53,173,94,79,2,29,1,1
56154,53,34116,53,291,94,197,2,29,1,1
33933,80,56054,80,1988,1072,916,12,515,7,5
56245,53,57808,53,200,102,98,2,31,1,1
37984,443,32167,443,3149,1829,1320,22,315,12,10
21909,53,21909,53,197,90,107,2,30,1,1
52240,443,52240,443,1615,941,674,15,21,7,8
63595,443,51163,443,8062,2186,5876,29,136,15,14
57202,53,54278,53,293,94,199,4,43,2,2
51841,443,41534,443,1686,984,702,15,32,8,7
60404,37869,39714,37869,258,70,188,4,8,2,2
57207,53,1667,53,195,102,93,2,29,1,1
63938,53,63032,53,385,110,275,2,30,1,1
49609,53,44822,53,754,94,660,2,30,1,1
64438,53,59049,53,184,94,90,2,30,1,1
65427,443,32092,443,14205,1527,12678,13,147,2,11
49570,443,15727,443,8058,1806,6252,22,15,12,10
50729,443,32293,443,10440,3521,6919,42,119,20,22
5773,53,5773,53,229,90,139,2,30,1,1
53425,443,1934,443,7208,2237,4971,26,32,16,10
56783,53,44833,53,193,102,91,2,30,1,1
49160,51839,39818,51839,868,150,718,4,1200,2,2
55677,53,59623,53,177,94,83,2,30,1,1
65498,53,57439,53,209,110,99,2,30,1,1
54998,53,17431,53,711,87,624,2,30,1,1
38001,443,11115,443,1652,817,835,17,186,9,8
56747,53,24392,53,172,94,78,2,30,1,1
49376,53,53542,53,209,110,99,2,30,1,1
65496,53,42568,53,96,96,0,1,31,1,0
35743,443,39300,443,560,280,280,9,28,5,4
21184,53,21184,53,194,87,107,2,30,1,1
51956,443,47122,443,8256,3157,5099,28,46,16,12
49907,443,10260,443,3787,2434,1353,29,72,16,13
63458,443,33627,443,7934,1372,6562,25,63,12,13
42920,443,33787,443,883886,26396,857490,947,444,340,607
5111,53,5111,53,235,90,145,2,33,1,1
49778,53,15143,53,255,102,153,2,29,1,1
64080,443,11837,443,75064,64938,10126,147,277,71,76
64219,53,37826,53,264,102,162,2,30,1,1
37208,443,37628,443,9621,7389,2232,33,256,14,19
39771,443,64614,443,6903,1273,5630,25,255,13,12
55088,53,58589,53,193,102,91,2,30,1,1
62893,993,15179,993,8883,4621,4262,76,191,47,29
56912,53,5094,53,199,102,97,2,29,1,1
63239,443,35910,443,5725,3290,2435,34,125,19,15
47368,443,14689,443,7057,2186,4871,25,316,13,12
34744,443,31137,443,13175,2432,10743,52,3587,23,29
57470,21158,39017,21158,2182,798,1384,19,1199,10,9
19473,14168,34740,14168,491,150,341,2,1200,1,1
38619,443,65221,443,469799,14616,455183,474,129,155,319
60104,80,20513,80,18480,7940,10540,48,71,27,21
52195,443,42007,443,3470,1776,1694,20,48,10,10
64549,53,44048,53,273,86,187,2,30,1,1
50545,443,13694,443,10127,1872,8255,26,27,13,13
46484,22,46484,22,7922,3413,4509,55,38,26,29
65112,53,30397,53,202,103,99,2,31,1,1
54644,443,51226,443,6440,3492,2948,19,135,9,10
56457,53,47112,53,731,91,640,2,31,1,1
17206,53,17206,53,240,98,142,2,29,1,1
50004,443,10108,443,8745,2603,6142,19,15,11,8
49157,53,54699,53,184,94,90,2,30,1,1
58259,53,23484,53,168,78,90,2,30,1,1
55733,53,46441,53,463,128,335,4,41,2,2
64595,53,24899,53,167,86,81,2,29,1,1
57603,80,57603,80,4373,2985,1388,21,37,11,10
47821,443,31829,443,71624,60795,10829,194,131,110,84
59723,443,10674,443,70,70,0,2,5,2,0
55865,53,34168,53,807,94,713,2,30,1,1
20850,53,20850,53,245,98,147,2,30,1,1
47120,443,47120,443,4604,1697,2907,19,29,11,8
56707,443,58509,443,40263,17490,22773,75,403,35,40
4184,53,4184,53,216,90,126,2,29,1,1
53778,6881,23099,6881,70,70,0,2,8,2,0
50490,443,43169,443,1353,903,450,12,78,7,5
47310,443,33854,443,3541,616,2925,19,165,8,11
34434,80,45920,80,2913,633,2280,15,15,8,7
53868,53,29458,53,86,86,0,1,30,1,0
61806,443,30997,443,7439,1156,6283,19,75,11,8
57301,443,1829,443,5614,733,4881,16,15,9,7
64431,53,35945,53,177,94,83,2,31,1,1
60994,443,7195,443,13145,6129,7016,37,34,19,18
57747,15000,28219,15000,130,70,60,2,6,1,1
40631,53,40631,53,262,107,155,2,30,1,1
48568,443,2828,443,56258,45661,10597,165,244,88,77
50191,53,41237,53,182,102,80,2,29,1,1
53980,443,7192,443,4957,1627,3330,17,120,8,9
57888,443,62185,443,9802,5628,4174,56,225,29,27
65281,53,27234,53,216,94,122,2,30,1,1
58747,443,20889,443,5167,700,4467,16,15,7,9
57411,53,35330,53,196,102,94,2,30,1,1
55208,53,14602,53,177,94,83,2,30,1,1
57051,53,59033,53,711,87,624,2,30,1,1
9328,443,4611,443,5198,504,4694,13,15,7,6
56257,53,40398,53,177,94,83,2,29,1,1
27005,32063,51455,32063,889,126,763,3,31,2,1
62073,443,18581,443,7989,4098,3891,34,136,15,19
50000,53,12799,53,216,110,106,2,31,1,1
64463,53,2430,53,183,94,89,2,29,1,1
52425,80,64946,80,1630,918,712,12,16,7,5
64290,53,4374,53,196,102,94,2,30,1,1
36151,443,3051,443,22856,2980,19876,43,116,19,24
9316,443,33323,443,3649,424,3225,12,15,6,6
60848,53,46740,53,168,78,90,2,30,1,1
64324,53,8144,53,179,94,85,2,30,1,1
60457,16881,27690,16881,1948,891,1057,16,18,8,8
65041,53,3296,53,200,94,106,2,29,1,1
37640,443,4915,443,11442,3116,8326,32,46,19,13
34070,53,34070,53,250,108,142,2,30,1,1
64708,53,55981,53,294,134,160,2,30,1,1
50975,53,27923,53,199,94,105,2,30,1,1
53961,13067,41847,13067,70,70,0,2,8,2,0
50253,53,52044,53,167,86,81,2,29,1,1
49690,53,31414,53,216,110,106,2,30,1,1
49686,53,23134,53,183,94,89,2,30,1,1
57312,53,15136,53,212,110,102,2,29,1,1
60020,443,30222,443,495428,22440,472988,692,106,316,376
50502,80,37094,80,318,192,126,6,25,4,2
63757,51413,50296,51413,70,70,0,1,4,1,0
50448,443,19311,443,1346,918,428,10,35,6,4
56234,80,56234,80,44817,885,43932,46,15,13,33
49466,53,63344,53,807,94,713,2,30,1,1
44847,42103,11973,42103,502,150,352,2,1200,1,1
53888,39204,30742,39204,70,70,0,2,8,2,0
55646,53,54569,53,182,93,89,2,30,1,1
56336,53,12124,53,196,102,94,2,30,1,1
59986,53,15041,53,186,86,100,2,30,1,1
56068,53,21388,53,214,102,112,2,30,1,1
65496,53,41450,53,280,96,184,4,34,2,2
60775,40010,2313,40010,316,136,180,6,6,3,3
51984,80,5183,80,48285,2659,45626,65,15,32,33
56611,443,45204,443,7983,1963,6020,20,15,11,9
60374,80,60374,80,118413,7486,110927,151,33,70,81
49648,443,58904,443,11011,4522,6489,35,45,17,18
56126,53,16372,53,774,101,673,2,31,1,1
54977,53,19132,53,275,93,182,4,32,2,2
65067,53,2919,53,214,110,104,2,30,1,1
14667,80,14667,80,3197,2167,1030,17,72,10,7
50578,123,63477,123,184,94,90,2,30,1,1
49289,53,43256,53,177,94,83,2,30,1,1
52164,443,54936,443,4187,773,3414,16,30,9,7
50033,53,63649,53,533,184,349,6,76,3,3
50134,53,55373,53,748,106,642,2,30,1,1
2885,443,2885,443,28717,3437,25280,45,23,23,22
58994,443,40125,443,4989,1014,3975,16,27,9,7
60286,443,29238,443,7576,1897,5679,23,136,13,10
57040,53,4133,53,810,108,702,2,31,1,1
55914,53,21562,53,212,102,110,2,30,1,1
60414,80,46472,80,5124,3499,1625,14,121,8,6
45340,443,58208,443,2504,1442,1062,22,29,12,10
49209,52030,40486,52030,70,70,0,2,8,2,0
56927,80,6442,80,214,140,74,4,35,3,1
49308,53,20210,53,190,97,93,2,30,1,1
9087,53,9087,53,178,82,96,2,30,1,1
57470,56250,44821,56250,330,330,0,6,1199,6,0
65082,53,43263,53,183,94,89,2,30,1,1
56765,1841,2876,1841,70,70,0,1,5,1,0
65456,53,31398,53,364,102,262,2,29,1,1
61467,443,56685,443,130792,4916,125876,161,89,69,92
64693,53,60951,53,766,102,664,2,30,1,1
50047,443,14680,443,4612,947,3665,18,85,10,8
65313,53,63714,53,164,84,80,2,31,1,1
53376,443,49944,443,4814,1207,3607,17,75,10,7
49959,443,21643,443,102240,4349,97891,128,136,46,82
123,123,35980,123,184,94,90,2,30,1,1
60476,55100,21039,55100,70,70,0,2,8,2,0
64279,53,4406,53,177,94,83,2,30,1,1
63904,18268,33783,18268,70,70,0,1,4,1,0
60711,443,38043,443,12258,1451,10807,27,360,13,14
56986,53,20950,53,259,87,172,4,37,2,2
38278,443,39999,443,448,78,370,6,25,1,5
44704,443,31142,443,7228,3478,3750,37,164,17,20
64303,53,50389,53,253,87,166,4,31,2,2
54005,443,23305,443,4253,726,3527,13,15,7,6
65248,53,20664,53,208,106,102,2,30,1,1
27005,27025,44976,27025,893,126,767,2,30,1,1
55600,80,5814,80,70,70,0,1,5,1,0
59252,443,29438,443,8442,1134,7308,23,15,13,10
53686,8999,46759,8999,70,70,0,2,7,2,0
55620,53,14188,53,170,87,83,2,30,1,1
34452,80,18909,80,6260,696,5564,17,16,9,8
63020,443,53282,443,512,166,346,2,30,1,1
44784,443,49876,443,12834,7868,4966,60,463,38,22
56973,443,44291,443,7481,2264,5217,22,135,10,12
53131,443,19273,443,10705,5303,5402,36,650,16,20
48817,6881,48817,6881,494,152,342,2,1200,1,1
56878,443,56878,443,27657,5506,22151,58,46,30,28
49385,53,7961,53,214,102,112,2,30,1,1
64581,53,40086,53,214,110,104,2,30,1,1
65189,27015,25952,27015,281,78,203,2,30,1,1
49181,80,37044,80,6158,654,5504,15,16,8,7
57392,443,58743,443,12347,6378,5969,39,208,20,19
64396,53,16886,53,231,102,129,2,30,1,1
54080,443,47688,443,1173681,52597,1121084,1428,177,642,786
38420,80,16840,80,4535,1637,2898,23,2899,14,9
55025,53,42219,53,183,94,89,2,30,1,1
9298,443,38844,443,4216,771,3445,16,26,9,7
39532,443,10682,443,345779,9537,336242,359,26,123,236
56810,443,52495,443,8072,2052,6020,20,16,11,9
56355,53,30971,53,184,94,90,2,31,1,1
56316,53,62474,53,733,93,640,2,31,1,1
26852,443,37860,443,6701,2064,4637,19,19,9,10
56552,53,47161,53,195,102,93,2,29,1,1
55276,80,42794,80,1594,1280,314,10,15,5,5
55281,53,62349,53,94,94,0,1,30,1,0
53912,443,53912,443,4447,1540,2907,19,30,11,8
64642,53,2609,53,307,94,213,2,30,1,1
50235,53,32276,53,768,99,669,2,30,1,1
60334,443,17024,443,7506,4789,2717,28,130,16,12
41772,80,18406,80,738,70,668,12,394,2,10
64021,53,7172,53,402,97,305,4,31,2,2
49343,53,21551,53,209,110,99,2,30,1,1
57000,53,6517,53,194,102,92,2,30,1,1
50779,443,59788,443,16067,4838,11229,43,121,21,22
53804,24067,28773,24067,70,70,0,1,4,1,0
56602,53,21237,53,197,102,95,2,30,1,1
58681,443,24073,443,22576,10533,12043,61,200,35,26
50665,443,30090,443,22544,1481,21063,31,16,9,22
49934,53,18444,53,478,107,371,4,39,2,2
51452,443,19936,443,6936,1761,5175,17,16,11,6
51778,60565,33068,60565,70,70,0,1,5,1,0
59464,443,49741,443,7333,1933,5400,27,16,15,12
49629,53,36000,53,196,100,96,2,31,1,1
53558,30815,59383,30815,492,306,186,8,16,5,3
57983,443,8445,443,315701,12378,303323,358,137,129,229
57810,80,62948,80,104397,8436,95961,122,21,49,73
56590,53,27360,53,760,97,663,2,30,1,1
49663,53,12596,53,190,97,93,2,31,1,1
52214,443,59996,443,10898,3170,7728,33,331,14,19
55602,443,15216,443,7360,2298,5062,22,255,12,10
56343,53,54537,53,177,94,83,2,30,1,1
48022,5228,46270,5228,10096,2251,7845,41,3747,16,25
49642,80,32526,80,312,192,120,6,41,4,2
65184,53,54868,53,164,84,80,2,31,1,1
61027,80,42775,80,9483,767,8716,18,14,10,8
49374,53,36144,53,193,102,91,2,30,1,1
50632,443,47511,443,4158,1021,3137,15,26,8,7
65471,443,32170,443,92569,4939,87630,111,15,45,66
41801,53,41801,53,213,87,126,2,30,1,1
49484,80,9940,80,3333,672,2661,12,15,7,5
42487,443,53584,443,4887,895,3992,16,29,9,7
50396,80,52675,80,487,180,307,6,26,4,2
42106,443,29417,443,5361,973,4388,18,15,10,8
35400,443,23133,443,11083,4080,7003,38,40,14,24
55069,53,8912,53,190,97,93,2,31,1,1
54706,443,10559,443,5612,1051,4561,20,16,11,9
0,0,0,0,480,244,236,4,0,2,2
52008,49383,19063,49383,70,70,0,1,5,1,0
32833,53,32833,53,227,88,139,2,30,1,1
53459,443,23457,443,88210,4564,83646,115,46,50,65
56288,53,3353,53,200,102,98,2,30,1,1
49418,27015,8182,27015,252,78,174,2,29,1,1
55652,443,58286,443,6672,2258,4414,19,16,10,9
42993,443,7986,443,10692,4532,6160,31,134,16,15
57330,443,48576,443,36551,3569,32982,57,46,28,29
49791,53,47745,53,226,94,132,2,30,1,1
36586,3142,36586,3142,138,78,60,2,6,1,1
51932,36498,31404,36498,70,70,0,2,8,2,0
51885,64546,64002,64546,70,70,0,2,8,2,0
42105,53,20788,53,168,78,90,2,30,1,1
55831,53,12169,53,182,93,89,2,31,1,1
53799,6881,10719,6881,70,70,0,1,4,1,0
59890,443,5968,443,1401,864,537,12,28,6,6
35667,80,40101,80,1638,1324,314,10,15,5,5
37983,443,26799,443,15668921,169545,15499376,12539,161,1284,11255
60184,443,18301,443,3915,1934,1981,14,122,7,7
52876,443,52876,443,5045,2187,2858,16,136,8,8
55577,53,64711,53,198,101,97,2,31,1,1
48038,5222,35034,5222,49279,23110,26169,459,384,239,220
52746,443,40862,443,104383,5038,99345,135,25,62,73
27988,40013,46561,40013,148,86,62,2,30,1,1
50584,53743,42258,53743,1356,300,1056,6,1201,3,3
56667,53,55956,53,199,102,97,2,29,1,1
50357,80,43010,80,764,698,66,6,15,5,1
40196,443,61662,443,24750,1845,22905,39,171,17,22
55375,53,30516,53,214,110,104,2,30,1,1
57312,53,30289,53,212,110,102,2,31,1,1
49812,53,48839,53,392,101,291,4,39,2,2
39097,443,24428,443,6747,2827,3920,19,399,11,8
37580,443,1520,443,499,425,74,4,0,3,1
52162,443,20113,443,1461,924,537,13,31,7,6
50495,53,56662,53,195,102,93,2,30,1,1
33960,22,33960,22,5468,1991,3477,27,34,15,12
58897,443,22242,443,5167,700,4467,16,14,7,9
55908,53,13210,53,389,110,279,2,30,1,1
56597,443,50431,443,10135129,248530,9886599,9808,64,3124,6684
58452,5228,20449,5228,2855,1780,1075,20,3600,10,10
65045,53,38314,53,339,105,234,4,53,2,2
50000,53,56621,53,216,102,114,2,29,1,1
51951,80,24462,80,1265,642,623,12,45,7,5
54429,443,55314,443,9970,3706,6264,44,272,21,23
57470,58125,57009,58125,1572,664,908,14,1200,9,5
0,0,0,0,200,102,98,2,0,1,1
50721,443,49373,443,5828,1439,4389,16,75,9,7
50888,80,61019,80,538995,15959,523036,552,140,201,351
49256,443,30277,443,10619,3257,7362,29,361,13,16
56647,443,45722,443,8059,2039,6020,20,15,11,9
55130,27046,9695,27046,1798,1386,412,8,29,4,4
65340,53,2059,53,313,110,203,4,32,2,2
53539,443,34866,443,2385,1462,923,18,200,10,8
53094,443,6776,443,6726,3603,3123,34,80,17,17
26989,80,26989,80,256062,8754,247308,297,18,124,173
56583,53,58946,53,177,94,83,2,31,1,1
64991,443,64991,443,9107,1499,7608,20,75,11,9
63804,52520,44580,52520,66,66,0,1,5,1,0
59670,443,52276,443,11549,6152,5397,28,156,16,12
53793,53,24147,53,213,78,135,2,30,1,1
52014,20524,1318,20524,70,70,0,2,8,2,0
53796,48019,39849,48019,70,70,0,2,7,2,0
52438,443,56919,443,70,70,0,1,4,1,0
56557,53,49880,53,214,110,104,2,29,1,1
62053,443,33820,443,134,60,74,3,5,2,1
38692,443,1550,443,1188751,17817,1170934,1053,16,255,798
9297,443,46735,443,4216,771,3445,16,26,9,7
57033,53,22099,53,216,110,106,2,30,1,1
56635,443,56247,443,8654,2150,6504,20,15,11,9
65014,53,57511,53,193,102,91,2,30,1,1
32317,53,32317,53,823,98,725,2,30,1,1
43733,443,15802,443,27525,2389,25136,47,27,22,25
42843,53,7011,53,168,78,90,2,30,1,1
34656,443,55937,443,3521,516,3005,12,15,6,6
48778,443,13282,443,6770,2047,4723,26,16,14,12
49685,80,12171,80,1548,847,701,10,16,5,5
49744,80,36258,80,2455,475,1980,9,81,5,4
9057,443,55377,443,7769,3958,3811,17,121,9,8
51661,443,59276,443,11558,3964,7594,37,17,15,22
27005,27015,22209,27015,1654,126,1528,4,30,2,2
51787,35661,32624,35661,70,70,0,2,8,2,0
65091,80,65091,80,18499242,314733,18184509,19253,37,4700,14553
44014,53,29782,53,199,94,105,2,30,1,1
38693,443,23499,443,16959,8920,8039,46,33,24,22
55922,53,5571,53,807,94,713,2,29,1,1
49710,443,57720,443,9772,1954,7818,23,130,12,11
53777,62955,56420,62955,70,70,0,1,4,1,0
49217,53,36290,53,209,110,99,2,30,1,1
57170,53,47776,53,200,102,98,2,30,1,1
49418,27015,12745,27015,227,78,149,2,30,1,1
57353,443,32586,443,150,150,0,1,5,1,0
57281,53,14335,53,178,94,84,2,30,1,1
56100,53,9631,53,177,94,83,2,30,1,1
64792,443,39397,443,16199,7657,8542,58,127,28,30
41677,443,61867,443,7292,1489,5803,21,187,11,10
61425,443,50113,443,9380,3315,6065,26,93,14,12
49154,53,7041,53,763,204,559,6,40,3,3
62453,443,7833,443,8698,3272,5426,22,26,11,11
51971,20347,9863,20347,70,70,0,2,8,2,0
56730,53,30044,53,170,87,83,2,31,1,1
53881,11513,24027,11513,320,140,180,6,5,3,3
64820,53,5211,53,195,102,93,2,29,1,1
52415,443,3677,443,14050,4805,9245,30,158,17,13
51925,80,55386,80,51645,3868,47777,67,28,30,37
51786,37832,29443,37832,70,70,0,1,5,1,0
54235,443,28529,443,4665,2167,2498,23,16,12,11
27005,27015,61503,27015,868,126,742,3,31,2,1
51086,443,36949,443,11749,5336,6413,32,153,18,14
50521,80,1574,80,454,262,192,8,25,5,3
56612,53,23653,53,172,88,84,2,31,1,1
63936,14832,6153,14832,312,190,122,5,16,3,2
49859,80,31286,80,1529,677,852,11,89,6,5
58402,53,52417,53,578,286,292,9,15,5,4
57247,443,40506,443,93673,74276,19397,194,67,111,83
56196,53,24743,53,498,204,294,6,31,3,3
44912,80,52893,80,1602,1282,320,10,15,5,5
57351,53,34146,53,184,94,90,2,30,1,1
26900,27017,37818,27017,422,164,258,6,30,3,3
51791,56116,1472,56116,70,70,0,2,8,2,0
38678,443,20008,443,380978,8857,372121,373,16,115,258
55224,53,2332,53,182,94,88,2,30,1,1
19502,53,19502,53,198,89,109,2,31,1,1
56613,443,45386,443,4378,1140,3238,14,26,9,5
44583,443,45015,443,6834,3797,3037,48,97,23,25
47845,53,47845,53,243,94,149,2,32,1,1
55158,443,7666,443,7963,2657,5306,29,333,13,16
61059,80,61059,80,16824,810,16014,22,15,8,14
52607,443,23239,443,2860,258,2602,9,121,4,5
64862,53,39051,53,211,110,101,2,30,1,1
56418,53,19002,53,183,94,89,2,30,1,1
55152,53,56189,53,177,94,83,2,30,1,1
6881,41019,41697,41019,150,150,0,1,1200,1,0
56819,37372,7815,37372,70,70,0,1,5,1,0
57204,53,13761,53,183,94,89,2,30,1,1
9152,443,16352,443,15550,1508,14042,28,19,13,15
50462,80,58102,80,4603,2152,2451,14,22,8,6
50156,53,35377,53,178,94,84,2,29,1,1
62918,993,34205,993,8324,3635,4689,76,53,35,41
59925,80,15613,80,2287,1534,753,11,16,6,5
55440,53,49182,53,752,93,659,2,31,1,1
57371,53,40591,53,728,96,632,2,30,1,1
37297,443,18068,443,4514,1928,2586,17,240,8,9
63917,57826,24551,57826,66,66,0,2,7,2,0
56304,53,49255,53,184,94,90,2,30,1,1
60018,443,59209,443,117023,8825,108198,138,143,49,89
38710,80,33174,80,190,70,120,4,17,2,2
58887,443,25823,443,5167,700,4467,16,15,7,9
64393,53,12221,53,183,94,89,2,31,1,1
60769,443,60769,443,13423,1386,12037,33,17,14,19
56056,53,42855,53,164,86,78,2,29,1,1
64879,53,48255,53,356,118,238,2,30,1,1
50894,80,18419,80,53024,5569,47455,72,140,35,37
64347,53,53125,53,193,102,91,2,29,1,1
49777,53,49271,53,168,78,90,2,31,1,1
50281,5223,28986,5223,208,60,148,4,11,2,2
60360,443,62556,443,5212,1101,4111,22,123,12,10
49795,53,44891,53,263,94,169,2,30,1,1
41786,443,30860,443,174542,9281,165261,227,78,104,123
53615,867,2680,867,70,70,0,1,5,1,0
64038,28187,34899,28187,66,66,0,2,8,2,0
43227,443,35933,443,1139403,49178,1090225,1155,108,353,802
50257,53,50801,53,199,102,97,2,29,1,1
48889,443,65230,443,87648,6895,80753,131,364,66,65
53746,7546,50898,7546,70,70,0,1,4,1,0
63764,12343,45903,12343,504,382,122,8,15,6,2
64877,53,56552,53,183,94,89,2,29,1,1
58726,53,60102,53,247,102,145,2,30,1,1
65233,53,6826,53,448,130,318,4,44,2,2
49870,53,59356,53,194,102,92,2,30,1,1
49201,53,35149,53,200,102,98,2,30,1,1
53971,18810,57788,18810,70,70,0,1,5,1,0
44162,80,44162,80,457843,10253,447590,452,26,152,300
53161,443,30923,443,2731,1895,836,18,28,10,8
50659,80,44031,80,24433,3378,21055,31,21,12,19
38783,443,19297,443,584,370,214,9,25,6,3
53837,443,2999,443,499,425,74,4,0,3,1
37952,80,16690,80,1372,868,504,13,35,8,5
58944,443,12374,443,5166,700,4466,16,15,7,9
65435,80,40330,80,11239,7307,3932,19,25,10,9
42947,443,14067,443,11377,7703,3674,26,161,19,7
49284,53,55787,53,185,102,83,2,30,1,1
50970,80,61956,80,11340,3061,8279,31,115,12,19
55945,53,36008,53,760,97,663,2,30,1,1
63943,53,44134,53,196,94,102,2,30,1,1
57914,80,49885,80,6527,1210,5317,15,18,8,7
49418,32038,58741,32038,235,78,157,2,30,1,1
58783,443,56867,443,5166,700,4466,16,15,7,9
57232,53,8301,53,198,102,96,2,30,1,1
49314,443,60912,443,8599,4862,3737,47,195,26,21
49932,53,55615,53,195,102,93,2,30,1,1
56814,56255,27834,56255,70,70,0,1,5,1,0
59843,443,50473,443,1427,726,701,17,46,8,9
46029,80,61068,80,111564,6775,104789,160,85,86,74
54986,443,39292,443,5684,3042,2642,32,46,18,14
49144,443,40050,443,130,70,60,3,5,2,1
62228,443,62228,443,296688,57600,239088,332,96,141,191
38945,443,48637,443,20511,4206,16305,24,134,7,17
56558,443,2694,443,7702,2155,5547,19,39,11,8
56380,80,20906,80,1466,729,737,12,16,7,5
64071,53,46762,53,194,102,92,2,29,1,1
52071,80,35224,80,1284,780,504,12,360,7,5
36857,80,4468,80,11216,2684,8532,28,163,11,17
57546,443,50936,443,34428,22220,12208,84,122,41,43
51801,33531,13546,33531,70,70,0,1,5,1,0
51098,443,32791,443,7250,2813,4437,21,62,12,9
58889,443,61172,443,3956,2519,1437,18,80,10,8
55563,53,20716,53,290,118,172,2,30,1,1
55678,52879,22607,52879,70,70,0,1,5,1,0
49754,80,3257,80,1793,634,1159,11,15,6,5
58392,3389,58392,3389,4624,1524,3100,17,17,9,8
55133,53,17544,53,443,182,261,6,31,3,3
51221,49857,1668,49857,791,266,525,8,1200,4,4
60368,443,14990,443,10483,4072,6411,20,26,9,11
64226,53,55510,53,211,102,109,2,30,1,1
64793,53,59763,53,168,86,82,2,31,1,1
56905,80,13949,80,78,78,0,2,8,2,0
2348,3389,2348,3389,4145,1976,2169,22,19,13,9
61740,443,10410,443,9854,2716,7138,36,49,20,16
45755,80,26274,80,52352,11192,41160,90,476,44,46
52050,443,62804,443,9896,3586,6310,27,134,13,14
47046,80,21371,80,1114,534,580,12,15,7,5
36816,1812,36816,1812,204,138,66,2,29,1,1
9251,443,22776,443,6132,767,5365,17,26,9,8
64454,3389,64454,3389,4350,2261,2089,21,18,11,10
27318,443,31101,443,16040,2126,13914,40,50,21,19
49636,53,5352,53,790,110,680,2,30,1,1
56837,53,27740,53,195,102,93,2,32,1,1
57258,53,33746,53,215,102,113,2,30,1,1
49220,2710,38165,2710,70,70,0,1,5,1,0
60417,443,24567,443,8590,1987,6603,23,86,12,11
50299,443,56417,443,86,86,0,1,4,1,0
49364,53,13056,53,307,307,0,4,60,4,0
56015,53,32700,53,190,97,93,2,31,1,1
49712,53,30095,53,178,94,84,2,29,1,1
57020,53,49369,53,738,86,652,2,31,1,1
55354,53,63415,53,214,110,104,2,30,1,1
56292,443,36478,443,10839,2145,8694,32,140,14,18
56268,53,11800,53,711,87,624,2,31,1,1
47370,443,20985,443,350,210,140,6,75,4,2
51709,40705,29645,40705,66,66,0,1,5,1,0
63901,42053,50757,42053,2980,1647,1333,16,31,10,6
52115,10012,9221,10012,70,70,0,2,8,2,0
63885,6969,58102,6969,70,70,0,1,5,1,0
58562,3389,58562,3389,5387,1909,3478,22,21,10,12
65507,53,22060,53,167,86,81,2,29,1,1
49743,443,63725,443,157156,3872,153284,160,128,48,112
49625,443,57635,443,4252,726,3526,13,16,7,6
49227,443,49227,443,155471,20626,134845,193,95,92,101
58782,443,19890,443,5397,3496,1901,20,16,10,10
64582,53,25024,53,202,103,99,2,30,1,1
56953,443,22328,443,7245,1282,5963,16,135,7,9
56426,53,49161,53,184,94,90,2,30,1,1
37222,443,49931,443,2394,1365,1029,18,275,9,9
53160,80,36074,80,1213,725,488,10,323,6,4
46999,53,31962,53,168,78,90,2,30,1,1
55786,53,55786,53,247,98,149,2,32,1,1
60456,58675,9788,58675,1307,786,521,15,16,8,7
56242,80,56242,80,101354,1343,100011,89,15,19,70
7068,53,7068,53,197,90,107,2,30,1,1
30472,53,56482,53,223,86,137,2,30,1,1
51800,63796,36885,63796,70,70,0,2,8,2,0
54677,443,30863,443,72676,12694,59982,144,127,64,80
51221,6881,43660,6881,479,150,329,2,1200,1,1
55556,53,12940,53,302,78,224,2,30,1,1
40932,443,14613,443,4435,2949,1486,25,80,14,11
45839,80,2983,80,1638,1324,314,10,15,5,5
49866,443,16607,443,6058,1038,5020,20,56,11,9
41583,443,3597,443,4168,2503,1665,20,255,11,9
64488,53,54282,53,356,98,258,4,35,2,2
49665,53,45405,53,197,102,95,2,30,1,1
56677,53,50989,53,286,103,183,4,49,2,2
57819,443,40837,443,6161,925,5236,18,28,10,8
2089,7000,2089,7000,2227,676,1551,15,14,7,8
54348,443,11963,443,8863,3511,5352,20,120,9,11
53629,443,28491,443,123122,115571,7551,161,23,93,68
43176,53,34266,53,168,78,90,2,30,1,1
9291,443,14472,443,3944,902,3042,14,26,8,6
38091,7275,44065,7275,350,210,140,6,15,4,2
52080,9554,2824,9554,70,70,0,2,7,2,0
49294,53,26484,53,723,102,621,2,30,1,1
55055,443,60639,443,14492,3190,11302,34,16,19,15
56243,53,64458,53,762,101,661,2,30,1,1
54536,80,14992,80,4096,3455,641,13,15,8,5
53490,5228,31385,5228,7188,2098,5090,38,113,22,16
55902,53,9062,53,178,91,87,2,31,1,1
56232,443,31381,443,9920,3980,5940,24,40,12,12
49415,53,4512,53,194,102,92,2,30,1,1
61693,443,50704,443,12203,3519,8684,65,18,35,30
65443,53,21010,53,164,86,78,2,30,1,1
51189,53,6847,53,312,78,234,2,30,1,1
65111,53,19274,53,355,96,259,4,38,2,2
49751,53,48975,53,232,92,140,2,30,1,1
54797,80,8308,80,8957,4075,4882,32,416,17,15
57253,53,58310,53,199,102,97,2,30,1,1
58884,15000,25949,15000,138,78,60,2,5,1,1
35601,443,47260,443,6419,995,5424,21,360,11,10
36897,443,23482,443,6351,4202,2149,35,94,18,17
57367,53,51549,53,177,94,83,2,29,1,1
64585,53,5921,53,198,102,96,2,30,1,1
27005,1105,38006,1105,855,126,729,2,30,1,1
49365,53,39023,53,195,102,93,2,30,1,1
41466,443,58480,443,3356,2158,1198,21,82,11,10
62080,443,19549,443,2902,1562,1340,22,46,12,10
56397,53,62027,53,179,94,85,2,30,1,1
39666,443,38106,443,7522,2433,5089,16,120,8,8
49295,53,11197,53,280,96,184,4,36,2,2
61925,80,57280,80,2418,495,1923,11,125,6,5
42280,443,42280,443,2052,1187,865,21,76,11,10
49631,80,18406,80,1446,914,532,8,16,5,3
56864,15646,57596,15646,70,70,0,1,5,1,0
64425,53,23618,53,289,134,155,2,30,1,1
57258,53,22772,53,821,102,719,2,30,1,1
36464,443,36464,443,4373,1466,2907,19,29,11,8
55376,53,7206,53,199,102,97,2,31,1,1
51994,443,26093,443,330,190,140,6,15,4,2
54252,443,11078,443,499,425,74,4,0,3,1
3615,53,3615,53,231,90,141,2,30,1,1
56328,53,20002,53,214,102,112,2,31,1,1
53733,443,35168,443,499,425,74,4,0,3,1
53417,443,8874,443,9193,6294,2899,27,121,14,13
51582,443,29660,443,9080,2186,6894,27,108,14,13
56560,53,37508,53,172,94,78,2,29,1,1
29744,53,29744,53,235,90,145,2,33,1,1
50283,53,31898,53,767,102,665,2,29,1,1
49206,53,41774,53,301,89,212,4,48,2,2
65020,53,48553,53,184,94,90,2,30,1,1
56487,53,25181,53,788,108,680,2,31,1,1
49872,53,49872,53,218,90,128,2,29,1,1
53953,34661,36111,34661,552,306,246,9,15,5,4
57292,53,56725,53,170,87,83,2,31,1,1
60780,28080,48359,28080,70,70,0,1,5,1,0
56533,443,15782,443,306579,19447,287132,335,105,129,206
55592,443,17919,443,8049,1560,6489,19,150,9,10
37556,16384,16862,16384,556,256,300,10,30,5,5
56652,53,23903,53,821,102,719,2,30,1,1
60413,43555,1703,43555,70,70,0,1,5,1,0
49861,53,56690,53,198,102,96,2,31,1,1
56656,443,24919,443,1342,918,424,10,25,6,4
56015,53,29304,53,195,102,93,2,30,1,1
49178,53,26968,53,199,102,97,2,29,1,1
52918,443,11338,443,326078,45627,280451,737,116,252,485
49939,53,35198,53,231,102,129,2,29,1,1
64722,53,55455,53,214,110,104,2,30,1,1
55430,443,62629,443,805321,15163,790158,752,171,204,548
59148,443,64998,443,26615,22329,4286,52,272,30,22
55704,53,41065,53,752,93,659,2,30,1,1
64000,53,28661,53,241,102,139,2,30,1,1
57430,53,32678,53,200,102,98,2,30,1,1
47976,443,55009,443,16187,11705,4482,33,159,19,14
63870,6881,42274,6881,66,66,0,2,7,2,0
64583,53,5543,53,426,89,337,4,58,2,2
50613,80,37228,80,21942,2323,19619,28,21,11,17
54018,443,16505,443,13330,3836,9494,53,255,29,24
64811,53,2888,53,186,95,91,2,30,1,1
64573,443,63298,443,29112,2866,26246,53,31,28,25
53298,80,1119,80,12660,7492,5168,27,274,14,13
57192,53,42489,53,177,94,83,2,30,1,1
64327,53,41700,53,210,110,100,2,30,1,1
45540,8100,64668,8100,78,78,0,1,4,1,0
56363,443,61094,443,3734,1750,1984,24,203,12,12
64119,53,14375,53,259,102,157,2,30,1,1
57045,53,5353,53,177,94,83,2,29,1,1
62619,3389,62619,3389,3504,1790,1714,17,34,9,8
51531,443,29173,443,898,460,438,12,39,5,7
65292,53,3636,53,195,102,93,2,30,1,1
56997,53,45686,53,168,86,82,2,30,1,1
41480,443,25670,443,6004,1688,4316,22,29,13,9
63849,16632,35962,16632,66,66,0,2,8,2,0
64033,29834,57709,29834,66,66,0,2,8,2,0
61526,443,1145,443,13977,5303,8674,48,152,20,28
60196,80,43098,80,70,70,0,2,8,2,0
49713,53,55679,53,734,94,640,2,30,1,1
49609,80,50781,80,318,192,126,6,41,4,2
53713,443,10339,443,33323,3349,29974,45,123,18,27
49567,53,58916,53,244,94,150,2,29,1,1
57140,53,58402,53,177,94,83,2,29,1,1
64114,53,8208,53,251,102,149,2,30,1,1
49366,443,29757,443,5777400,184445,5592955,6224,332,2268,3956
56306,53,41144,53,228,94,134,2,30,1,1
49158,443,3923,443,23613,13099,10514,79,1341,36,43
43923,5222,15090,5222,3007,1354,1653,28,83,15,13
49068,443,37354,443,98965,16634,82331,187,30,82,105
50561,53,34475,53,763,102,661,2,30,1,1
56925,80,48459,80,214,140,74,4,25,3,1
55669,53,4616,53,784,94,690,2,30,1,1
19473,45556,7986,45556,469,150,319,2,1200,1,1
59789,443,31655,443,5520,1212,4308,18,28,9,9
60384,443,3369,443,4315,928,3387,16,15,10,6
49168,443,13015,443,17765,1565,16200,29,16,12,17
55722,53,19688,53,226,110,116,2,30,1,1
40907,443,19035,443,7183,1824,5359,27,316,14,13
59335,80,59335,80,107776,4213,103563,177,16,60,117
14394,443,16776,443,4649,2928,1721,40,415,21,19
28238,443,59283,443,8456,3501,4955,20,90,11,9
60497,443,60497,443,12727,948,11779,21,30,10,11
56026,53,37730,53,181,94,87,2,31,1,1
33304,443,15471,443,1067,650,417,10,73,6,4
43014,53,60826,53,198,93,105,2,30,1,1
49746,53,29622,53,185,102,83,2,30,1,1
55628,13343,19881,13343,634,388,246,10,18,6,4
3694,80,3582,80,6919,1220,5699,20,104,12,8
53686,19010,53686,19010,70,70,0,1,30,1,0
33818,443,39799,443,16265,3132,13133,54,276,26,28
60388,80,19317,80,214,140,74,4,15,3,1
57470,58973,26085,58973,330,330,0,6,1200,6,0
49942,53,42485,53,177,94,83,2,31,1,1
51852,18636,28064,18636,136,136,0,3,13,3,0
56239,53,30874,53,180,94,86,2,31,1,1
51459,53,51459,53,256,114,142,2,30,1,1
54955,53,57414,53,170,87,83,2,30,1,1
55413,53,9671,53,216,110,106,2,31,1,1
50820,443,59076,443,6133,1655,4478,12,121,5,7
55593,53,39878,53,288,288,0,4,47,4,0
56222,5228,31508,5228,2531,1513,1018,17,3601,8,9
37748,80,57196,80,1090,609,481,13,329,7,6
64724,53,63918,53,319,97,222,4,31,2,2
53107,44060,63943,44060,70,70,0,2,8,2,0
49268,53,5165,53,353,118,235,2,30,1,1
55271,53,23423,53,168,86,82,2,30,1,1
55613,53,57785,53,177,94,83,2,30,1,1
49634,443,60698,443,20860,1618,19242,35,122,15,20
50100,53,47683,53,216,110,106,2,30,1,1
65292,53,10766,53,385,106,279,4,33,2,2
55065,53,19490,53,711,87,624,2,30,1,1
43057,80,9462,80,1195,401,794,9,16,5,4
52127,80,9783,80,2412,1750,662,13,36,9,4
51955,80,57774,80,366,240,126,7,27,5,2
57830,7635,57830,7635,138,78,60,2,5,1,1
56891,53,21983,53,200,94,106,2,30,1,1
61336,443,63223,443,34919,6979,27940,68,247,27,41
49293,5223,22335,5223,202,142,60,2,15,1,1
57106,53,8204,53,760,97,663,2,31,1,1
40218,443,5218,443,5254,927,4327,20,84,9,11
40906,443,50326,443,8138,2333,5805,26,106,14,12
60292,80,43938,80,1462,864,598,11,144,6,5
50922,443,21315,443,6180,1241,4939,18,982,8,10
38820,80,32872,80,1150,613,537,10,16,6,4
54455,443,54455,443,324001,46592,277409,409,177,203,206
62333,443,8530,443,4019,2219,1800,33,186,17,16
59403,443,13461,443,2866,1684,1182,16,15,8,8
61736,443,61172,443,148467,8298,140169,192,17,93,99
51929,53371,7224,53371,70,70,0,2,8,2,0
60708,53,53667,53,291,86,205,2,29,1,1
61942,3389,61942,3389,3347,1458,1889,15,18,8,7
53146,443,41053,443,29874004,955051,28918953,31844,303,10580,21264
49429,53,36318,53,210,110,100,2,30,1,1
50375,53,45862,53,211,110,101,2,30,1,1
64683,53,5338,53,376,95,281,4,36,2,2
56060,53,26992,53,224,102,122,2,30,1,1
56340,53,42393,53,198,102,96,2,30,1,1
57309,53,11380,53,194,99,95,2,30,1,1
54991,443,1653,443,20604,3530,17074,40,19,21,19
45720,443,24721,443,1625,1038,587,14,26,8,6
19229,53,19229,53,213,87,126,2,31,1,1
55604,53,44456,53,758,93,665,2,31,1,1
49377,443,6065,443,6350,1550,4800,23,19,12,11
61876,443,60944,443,3776,1446,2330,20,153,9,11
57043,53,5336,53,166,86,80,2,31,1,1
55346,53,62620,53,177,94,83,2,31,1,1
56111,53,50559,53,168,94,74,2,30,1,1
1294,53,1294,53,216,82,134,2,32,1,1
52138,443,52138,443,80933,20860,60073,121,324,66,55
49323,53,12095,53,790,110,680,2,30,1,1
50578,80,29631,80,1791,900,891,14,79,7,7
56812,443,43977,443,11568,9158,2410,42,80,23,19
51619,443,5811,443,3894,863,3031,15,16,9,6
49323,53,60402,53,210,110,100,2,31,1,1
55605,53,6586,53,195,102,93,2,30,1,1
53273,443,62514,443,17169,6566,10603,52,37,24,28
49418,27017,19640,27017,78,78,0,1,30,1,0
49901,53,49901,53,194,87,107,2,30,1,1
45457,443,33286,443,11989,7908,4081,61,120,31,30
65199,53,15810,53,215,94,121,2,30,1,1
42298,40042,16142,40042,148,86,62,2,30,1,1
63990,53,19922,53,270,94,176,2,30,1,1
58869,443,38937,443,4657,2146,2511,14,135,7,7
63241,443,59120,443,5248,2550,2698,21,178,10,11
51848,28960,25741,28960,70,70,0,2,9,2,0
59726,53,53950,53,304,86,218,2,30,1,1
49557,53,61895,53,1298,100,1198,4,32,2,2
63972,53,24077,53,193,102,91,2,29,1,1
34760,443,55387,443,70,70,0,1,4,1,0
49355,53,45330,53,184,102,82,2,30,1,1
34988,53,12799,53,199,94,105,2,30,1,1
38701,443,3001,443,4478,1133,3345,13,27,8,5
52101,443,56883,443,5706850,104758,5602092,5170,41,1379,3791
65241,53,47217,53,198,102,96,2,29,1,1
47582,443,49001,443,6214,1733,4481,13,120,6,7
59626,443,63020,443,5837,1982,3855,19,18,11,8
51825,25501,31893,25501,66,66,0,1,5,1,0
49479,443,58848,443,4591,2492,2099,20,113,11,9
51762,443,40334,443,5048,2345,2703,13,121,7,6
63460,443,27370,443,502,250,252,9,63,5,4
64999,53,64999,53,230,90,140,2,30,1,1
57339,443,47908,443,1495,768,727,16,26,9,7
52182,60769,63523,60769,70,70,0,2,8,2,0
55447,53,22356,53,194,102,92,2,29,1,1
37965,1025,42195,1025,158,158,0,1,1200,1,0
55046,53,27327,53,300,102,198,4,39,2,2
55059,80,26318,80,306,180,126,6,26,4,2
34076,53,22329,53,168,78,90,2,30,1,1
63227,443,37596,443,1373,734,639,17,125,10,7
64524,53,34078,53,184,94,90,2,31,1,1
65465,53,18720,53,293,102,191,2,29,1,1
14442,443,28353,443,2601,1455,1146,18,15,8,10
57470,6969,29118,6969,528,528,0,9,1199,9,0
64792,53,60591,53,166,86,80,2,30,1,1
50495,53,55393,53,166,86,80,2,30,1,1
57086,53,16252,53,711,87,624,2,30,1,1
51777,63497,24893,63497,316,136,180,6,6,3,3
45900,443,8565,443,1277649,37293,1240356,1337,303,459,878
38861,443,38861,443,90303,5838,84465,140,103,68,72
59011,443,8442,443,9619,6442,3177,33,122,15,18
35585,53,60283,53,168,78,90,2,29,1,1
49186,53,28433,53,821,102,719,2,30,1,1
56519,53,28431,53,167,86,81,2,30,1,1
37572,443,26829,443,30365,21942,8423,58,50,32,26
57288,443,16066,443,7427,2084,5343,24,361,12,12
58649,443,35795,443,7701,2215,5486,28,373,14,14
65131,53,1840,53,168,86,82,2,29,1,1
49658,443,46695,443,11880,2839,9041,30,48,16,14
57679,443,35639,443,13034,3324,9710,35,120,15,20
65463,53,23022,53,177,94,83,2,30,1,1
38011,443,43234,443,6900,4387,2513,37,98,19,18
52109,80,35580,80,422,240,182,8,26,5,3
47822,80,47822,80,1435,1293,142,5,15,3,2
56219,53,60572,53,177,94,83,2,30,1,1
55719,13302,2915,13302,70,70,0,1,5,1,0
51962,80,39391,80,422,240,182,8,25,5,3
56431,53,62997,53,170,87,83,2,30,1,1
63797,47784,12377,47784,66,66,0,2,8,2,0
63589,443,25041,443,19134,2422,16712,49,120,22,27
27331,443,27331,443,1251,722,529,11,147,6,5
62724,443,24098,443,11195,2218,8977,36,80,18,18
51858,443,51858,443,12505,3792,8713,48,255,24,24
56051,53,2559,53,249,102,147,2,29,1,1
53192,80,30945,80,814,335,479,10,15,5,5
49288,443,26857,443,7332,2907,4425,50,122,22,28
56963,53,56853,53,198,101,97,2,31,1,1
49854,80,32743,80,14603,5117,9486,24,89,12,12
64937,53,3891,53,360,118,242,2,30,1,1
63129,47117,14419,47117,574,448,126,10,25,8,2
51799,58416,38209,58416,316,136,180,6,6,3,3
50269,443,40163,443,7543,2533,5010,26,55,14,12
50418,53,14403,53,177,94,83,2,30,1,1
49936,53,39032,53,216,110,106,2,29,1,1
58995,443,49054,443,8826,2860,5966,21,9,10,11
56602,80,9300,80,234,234,0,4,11,4,0
5588,5588,0,0,3498,1872,1626,48,204,24,24
2138,53,2138,53,235,90,145,2,34,1,1
50478,80,50478,80,28032,3868,24164,47,24,23,24
41812,443,33083,443,6617,1705,4912,24,331,11,13
64231,53,19664,53,196,94,102,2,30,1,1
49756,53,28013,53,264,89,175,4,47,2,2
27005,27016,41906,27016,882,126,756,2,30,1,1
39094,443,50838,443,828718,43410,785308,1071,347,479,592
45202,443,49520,443,15153,8118,7035,45,271,22,23
64094,1024,11634,1024,66,66,0,2,8,2,0
53795,53,11623,53,224,86,138,2,30,1,1
44176,443,60900,443,3327,1940,1387,19,22,10,9
65119,53,47223,53,568,188,380,6,60,3,3
50575,53,21343,53,184,94,90,2,30,1,1
53151,53,29237,53,168,78,90,2,31,1,1
57849,443,35072,443,11893,6064,5829,29,92,15,14
55318,53,29370,53,215,102,113,2,30,1,1
51779,3389,21341,3389,62242217,4119315,58122902,123738,4772,43917,79821
50027,53,20964,53,264,110,154,2,30,1,1
59850,443,34758,443,10260,1360,8900,22,18,7,15
52921,443,13055,443,5581,1388,4193,19,15,9,10
10099,80,20785,80,130,70,60,2,15,1,1
41059,443,46382,443,1248874,30382,1218492,1261,111,425,836
51407,443,24262,443,22626,10213,12413,35,57,20,15
50402,8080,50402,8080,378,180,198,7,78,4,3
49521,53,3193,53,183,94,89,2,30,1,1
43026,443,33561,443,138,78,60,2,4,1,1
53773,15459,17716,15459,70,70,0,1,4,1,0
27005,27017,49884,27017,877,126,751,2,31,1,1
36410,53,36410,53,268,114,154,2,30,1,1
50026,53,4265,53,395,99,296,4,57,2,2
7634,80,7634,80,1845,523,1322,10,15,6,4
6881,8229,31730,8229,150,150,0,1,1200,1,0
39077,443,60900,443,24631,1902,22729,37,215,17,20
60518,80,21543,80,1915,797,1118,8,16,5,3
50565,443,52646,443,1313,876,437,11,27,6,5
46865,443,9898,443,416,210,206,7,32,4,3
63819,18445,64902,18445,66,66,0,2,7,2,0
56815,443,53722,443,7903,1914,5989,20,15,11,9
56439,53,22707,53,177,94,83,2,29,1,1
33409,53,54982,53,79268,76966,2302,936,88,923,13
43680,53,64871,53,271,102,169,2,30,1,1
59457,53,59457,53,213,87,126,2,30,1,1
52228,49974,17167,49974,230,136,94,4,14,3,1
56798,443,60246,443,8073,2053,6020,20,15,11,9
50420,80,36435,80,5048,4344,704,11,26,6,5
50459,53,40007,53,811,94,717,2,30,1,1
51172,443,45149,443,1472,965,507,13,20,7,6
51869,25355,58736,25355,70,70,0,2,8,2,0
42224,123,27890,123,184,94,90,2,30,1,1
49929,53,57396,53,212,108,104,2,31,1,1
49573,53,33204,53,738,86,652,2,30,1,1
50009,80,24998,80,186,64,122,4,29,2,2
65146,53,65321,53,335,102,233,2,30,1,1
53258,443,34531,443,5916,1774,4142,25,15,14,11
54976,443,15305,443,10335,2317,8018,24,188,13,11
49451,53,64804,53,211,102,109,2,30,1,1
56667,53,35767,53,168,86,82,2,29,1,1
64784,53,13638,53,226,102,124,2,30,1,1
55688,53,38445,53,183,94,89,2,29,1,1
56958,53,40535,53,193,102,91,2,30,1,1
44037,5223,40215,5223,5096,1030,4066,25,1751,9,16
64805,53,48699,53,278,102,176,2,31,1,1
56020,53,29198,53,711,87,624,2,30,1,1
50279,443,56387,443,1786,172,1614,7,119,3,4
56568,5228,36431,5228,2387,1435,952,16,3600,8,8
64104,53,54315,53,288,101,187,4,58,2,2
27839,53,27839,53,213,87,126,2,31,1,1
55996,443,19878,443,5323,2482,2841,31,19,15,16
55902,53,8610,53,181,94,87,2,31,1,1
61256,443,47931,443,2680,255,2425,9,120,4,5
34424,443,56503,443,773546,29906,743640,881,1166,350,531
37582,443,5548,443,15901,7016,8885,37,49,22,15
50381,443,49531,443,316,136,180,6,6,3,3
18157,53,35666,53,215,94,121,2,30,1,1
64939,53,4454,53,199,94,105,2,29,1,1
56624,80,12583,80,234,234,0,4,12,4,0
55054,80,54288,80,67750,4451,63299,78,60,32,46
52155,80,42520,80,1056,682,374,10,15,6,4
56534,53,47047,53,177,94,83,2,29,1,1
49112,443,21171,443,6319,877,5442,23,396,8,15
55502,53,15110,53,194,102,92,2,30,1,1
54371,80,58322,80,3623,1718,1905,17,186,10,7
53838,15000,39426,15000,130,70,60,2,5,1,1
44034,80,44034,80,18510,706,17804,22,16,6,16
39617,80,39617,80,419378,16035,403343,506,132,226,280
55323,443,19578,443,229587,8510,221077,245,121,82,163
3254,3389,3254,3389,3790,1685,2105,18,17,10,8
54962,53,60392,53,194,102,92,2,29,1,1
57416,53,53137,53,193,102,91,2,29,1,1
50802,443,32989,443,207859,77557,130302,849,753,312,537
64791,53,19786,53,526,197,329,6,49,3,3
27454,53,27454,53,244,98,146,2,32,1,1
44062,443,39025,443,4614,853,3761,16,127,9,7
48656,80,8880,80,1114,534,580,12,15,7,5
35954,443,60270,443,6406,1614,4792,24,17,13,11
57272,53,3406,53,373,107,266,4,45,2,2
49435,53,45474,53,720,94,626,2,30,1,1
54418,443,37950,443,3350,1804,1546,19,255,10,9
56809,53,35484,53,178,94,84,2,30,1,1
55171,53,21824,53,198,101,97,2,31,1,1
65518,443,8967,443,92157,4519,87638,105,15,39,66
57072,53,34434,53,193,102,91,2,30,1,1
59416,443,53026,443,10642,3654,6988,26,125,14,12
41628,15000,25474,15000,130,70,60,2,6,1,1
55661,49671,9206,49671,70,70,0,2,8,2,0
64858,53,57701,53,196,102,94,2,30,1,1
58874,443,22621,443,4738,1023,3715,18,66,10,8
57401,53,55696,53,179,94,85,2,31,1,1
50022,53,39220,53,174,89,85,2,30,1,1
63139,53,20764,53,234,234,0,4,47,4,0
59470,443,18542,443,3726,688,3038,14,119,7,7
53122,443,25117,443,23067,5901,17166,43,73,21,22
9477,443,41654,443,7461,1448,6013,22,35,11,11
63933,443,50085,443,6822,3370,3452,21,135,10,11
53640,28937,28393,28937,70,70,0,1,5,1,0
63011,443,30939,443,304,86,218,2,30,1,1
5588,5588,0,0,3354,1792,1562,46,193,23,23
56743,53,46707,53,209,110,99,2,30,1,1
50524,53,62327,53,193,102,91,2,30,1,1
60290,53,35403,53,213,86,127,2,30,1,1
55237,53,28991,53,193,102,91,2,30,1,1
52210,15604,53741,15604,70,70,0,1,5,1,0
37485,161,0,0,6435,2535,3900,22,30,11,11
57306,53,25248,53,177,94,83,2,29,1,1
57985,443,21475,443,140109,5229,134880,159,46,59,100
60079,80,9698,80,31418,1784,29634,37,126,14,23
63587,443,60950,443,10576,3685,6891,46,92,24,22
65176,53,19712,53,299,99,200,4,45,2,2
35917,443,52534,443,13480,8545,4935,35,94,19,16
52033,37905,61391,37905,70,70,0,2,8,2,0
4544,3478,63036,3478,338,110,228,2,299,1,1
56928,53,33620,53,172,88,84,2,30,1,1
54960,53,7818,53,448,184,264,6,30,3,3
63837,14023,26076,14023,70,70,0,1,4,1,0
49234,53,59585,53,177,94,83,2,30,1,1
56387,53,17582,53,183,94,89,2,30,1,1
49886,53,25717,53,275,94,181,2,30,1,1
58856,443,16403,443,4005,1421,2584,14,136,7,7
9514,443,6699,443,318,192,126,6,34,4,2
64440,53,9584,53,270,110,160,2,30,1,1
57965,443,27190,443,8366,2018,6348,32,104,17,15
49219,51237,3510,51237,624,318,306,10,15,5,5
41139,443,57233,443,9152383,160511,8991872,8428,252,2261,6167
48135,443,38274,443,6426,1858,4568,22,16,12,10
5588,5588,0,0,3498,1872,1626,48,200,24,24
60659,443,57729,443,8175,3047,5128,26,165,12,14
57382,53,10173,53,184,94,90,2,29,1,1
55438,443,39653,443,6686,923,5763,19,15,11,8
55294,53,64912,53,199,102,97,2,29,1,1
5886,80,5886,80,138678,5557,133121,152,16,58,94
27005,27022,10825,27022,890,126,764,2,31,1,1
40710,5228,9746,5228,4065,2585,1480,28,40,14,14
45863,53,45863,53,229,90,139,2,30,1,1
52064,80,49794,80,2125,709,1416,11,16,5,6
56261,53,2901,53,184,94,90,2,30,1,1
51846,80,21384,80,366,240,126,7,31,5,2
55826,53,63992,53,168,86,82,2,30,1,1
57221,53,53360,53,184,102,82,2,30,1,1
57598,80,57598,80,40484,2008,38476,47,145,17,30
64245,53,8045,53,198,101,97,2,31,1,1
32959,443,7767,443,9262,2792,6470,53,616,28,25
51688,123,9497,123,184,94,90,2,29,1,1
64546,53,12738,53,182,93,89,2,31,1,1
37592,443,5868,443,499,425,74,4,0,3,1
55380,53,36013,53,289,97,192,4,45,2,2
46862,15000,28105,15000,130,70,60,2,5,1,1
60471,19776,35509,19776,70,70,0,2,8,2,0
49652,80,63583,80,372,192,180,7,42,4,3
39135,443,24335,443,8286,2195,6091,24,256,12,12
57001,53,51576,53,177,94,83,2,31,1,1
58054,25,23956,25,1370,496,874,16,16,8,8
60211,53,51487,53,205,86,119,2,30,1,1
56998,53,18836,53,711,87,624,2,30,1,1
50419,80,40888,80,3664,1440,2224,12,23,6,6
51813,443,18719,443,130,70,60,3,5,2,1
55581,53,6182,53,166,85,81,2,30,1,1
55622,33342,17108,33342,70,70,0,1,5,1,0
37310,443,2394,443,3950,2949,1001,26,69,15,11
53607,51631,7980,51631,70,70,0,2,8,2,0
56026,53,28063,53,183,94,89,2,30,1,1
52336,443,7480,443,134,60,74,3,10,2,1
27005,27212,63313,27212,889,126,763,2,30,1,1
42699,5222,6919,5222,420,156,264,7,18,3,4
45547,53,15973,53,199,94,105,2,30,1,1
27005,27015,1536,27015,883,126,757,2,30,1,1
57027,53,20222,53,198,94,104,2,30,1,1
65474,443,34045,443,355358,10960,344398,369,16,131,238
53875,443,27415,443,499,425,74,4,1,3,1
48778,80,16126,80,130,70,60,2,15,1,1
57470,29633,40389,29633,1660,677,983,20,1595,10,10
51988,443,46112,443,10492,3167,7325,40,15,24,16
63231,443,12369,443,7124,3843,3281,42,126,20,22
47140,443,13289,443,7669,3355,4314,33,38,19,14
55344,53,62039,53,212,110,102,2,30,1,1
53029,443,57596,443,9246,1808,7438,35,92,17,18
49229,8112,22492,8112,2049,1276,773,15,15,8,7
57470,31566,19027,31566,481,150,331,2,1199,1,1
46697,5228,40766,5228,9263,549,8714,17,3638,5,12
56491,53,2856,53,165,86,79,2,30,1,1
50405,8080,50405,8080,3985,2010,1975,17,51,10,7
55238,53,27709,53,168,86,82,2,31,1,1
55699,53,3858,53,271,103,168,4,59,2,2
9061,80,4144,80,639,279,360,8,121,4,4
26452,80,26452,80,642,338,304,10,33,6,4
42298,40031,35344,40031,1346,662,684,8,32,4,4
60038,80,60038,80,12881,767,12114,21,21,9,12
49932,53,43257,53,195,102,93,2,30,1,1
65331,53,36726,53,193,102,91,2,30,1,1
49547,443,10107,443,6180,1249,4931,14,20,8,6
57193,53,40448,53,229,110,119,2,30,1,1
40334,443,51232,443,8296,3123,5173,40,132,14,26
51878,9999,7906,9999,66,66,0,1,5,1,0
30960,45700,20531,45700,330,330,0,6,3609,6,0
12150,443,12150,443,6981,948,6033,17,27,10,7
63128,443,30036,443,4994,379,4615,9,15,4,5
65495,53,16317,53,209,110,99,2,30,1,1
41451,53,15515,53,359,86,273,2,30,1,1
39916,53,62317,53,168,78,90,2,30,1,1
60395,6890,18737,6890,70,70,0,1,5,1,0
55728,53,18036,53,195,102,93,2,29,1,1
38892,443,57044,443,83444,15305,68139,121,148,51,70
38057,443,24418,443,9486,2668,6818,26,81,14,12
60390,56494,54167,56494,70,70,0,1,5,1,0
41753,443,5130,443,11570,3005,8565,43,255,20,23
49432,5228,59843,5228,10635,3087,7548,41,3661,22,19
9170,80,30007,80,318,192,126,6,29,4,2
65386,53,25163,53,194,99,95,2,30,1,1
64722,443,16301,443,61890,2830,59060,73,120,27,46
60833,443,43148,443,1157,817,340,10,26,5,5
56873,53,37492,53,184,94,90,2,30,1,1
12939,53,12939,53,216,82,134,2,32,1,1
56689,53,22159,53,738,86,652,2,30,1,1
56747,443,3267,443,19030,7323,11707,51,122,23,28
51341,7000,51341,7000,3132,815,2317,14,16,7,7
64172,53,13713,53,197,102,95,2,29,1,1
51934,443,39970,443,9735,2891,6844,36,82,17,19
12573,53,12573,53,235,90,145,2,32,1,1
123,123,22929,123,184,94,90,2,29,1,1
44960,443,32145,443,306066,33556,272510,414,196,162,252
57595,80,64244,80,2769,1396,1373,11,29,7,4
51426,443,3125,443,15947,5526,10421,38,622,16,22
47655,53,46246,53,168,78,90,2,29,1,1
64850,53,55584,53,167,86,81,2,30,1,1
123,123,42021,123,184,94,90,2,30,1,1
19473,51413,8434,51413,459,149,310,2,1200,1,1
48919,443,27329,443,10338,3346,6992,27,19,15,12
50557,80,9717,80,318,192,126,6,26,4,2
56477,53,34733,53,198,101,97,2,31,1,1
55039,443,27278,443,8209,2789,5420,24,42,14,10
50489,443,45489,443,1268,638,630,12,17,7,5
53969,13156,32626,13156,70,70,0,1,4,1,0
55072,53,7801,53,177,94,83,2,30,1,1
56619,443,13830,443,7982,1962,6020,20,15,11,9
49574,53,12004,53,337,110,227,2,30,1,1
58703,443,1950,443,15202,6356,8846,40,119,22,18
59395,443,39581,443,5817,1995,3822,19,16,10,9
64353,53,31104,53,225,102,123,2,29,1,1
64029,38651,56654,38651,66,66,0,2,7,2,0
6881,52563,53881,52563,228,118,110,2,1199,1,1
55376,53,17349,53,199,102,97,2,30,1,1
49411,53,5629,53,764,99,665,2,31,1,1
56626,53,17271,53,224,102,122,2,30,1,1
63264,53,63264,53,197,90,107,2,30,1,1
56735,80,63370,80,194,128,66,4,25,3,1
53640,443,55622,443,3201,1057,2144,13,135,6,7
63929,443,53771,443,14647,2365,12282,22,136,10,12
64798,53,14494,53,178,94,84,2,30,1,1
50895,80,56986,80,9046,1139,7907,20,255,11,9
53669,59056,20109,59056,70,70,0,1,5,1,0
57013,53,50114,53,178,94,84,2,29,1,1
60773,20010,34411,20010,70,70,0,2,8,2,0
49634,53,57122,53,718,94,624,2,30,1,1
65384,53,41711,53,197,102,95,2,30,1,1
55615,13826,16730,13826,70,70,0,1,5,1,0
13084,53,13084,53,224,88,136,2,30,1,1
55707,26816,41675,26816,320,140,180,6,6,3,3
50265,61668,33376,61668,132,132,0,3,1201,3,0
51968,443,14636,443,122815,48545,74270,164,95,76,88
46762,443,18994,443,565251,13665,551586,542,30,173,369
38276,443,11817,443,600,156,444,8,25,2,6
55940,53,15244,53,168,86,82,2,30,1,1
58034,80,58034,80,21684,903,20781,30,41,12,18
50685,80,6959,80,63891,26626,37265,86,34,39,47
17428,3389,17428,3389,4695,2520,2175,22,19,13,9
56863,53,12002,53,177,94,83,2,31,1,1
55877,56148,26245,56148,481,150,331,2,1200,1,1
49205,53,19317,53,194,102,92,2,31,1,1
55918,53,24727,53,184,94,90,2,30,1,1
65322,53,28599,53,395,102,293,2,30,1,1
60866,443,47757,443,14519,9445,5074,35,15,20,15
55917,53,58501,53,371,109,262,4,59,2,2
54828,443,1359,443,150,150,0,1,5,1,0
9310,443,7475,443,4458,1022,3436,16,26,9,7
63134,80,1605,80,18032,904,17128,22,15,7,15
51467,443,51893,443,194,70,124,3,11,1,2
39328,80,54036,80,78,78,0,1,5,1,0
51438,443,45079,443,42419,28515,13904,108,246,53,55
32895,443,18670,443,76969,3534,73435,97,34,40,57
36097,443,29806,443,6131,1384,4747,27,50,15,12
49554,443,18292,443,7540,1840,5700,18,15,10,8
52076,28895,29171,28895,66,66,0,1,5,1,0
56562,53,61427,53,183,94,89,2,30,1,1
55334,53,36263,53,199,102,97,2,30,1,1
49272,53,7753,53,196,100,96,2,30,1,1
52237,16801,7817,16801,70,70,0,1,5,1,0
51959,42269,57888,42269,70,70,0,2,8,2,0
56100,53,6720,53,216,110,106,2,30,1,1
20898,53,20898,53,233,90,143,2,32,1,1
38673,443,39946,443,379440,8281,371159,362,16,106,256
49917,443,38114,443,7645,2967,4678,23,15,13,10
50572,80,46272,80,62,62,0,1,5,1,0
53900,53,54773,53,270,168,102,3,30,2,1
51667,25826,43054,25826,9415,9415,0,11,30,11,0
56730,53,28037,53,177,94,83,2,30,1,1
53792,1,12742,1,70,70,0,2,7,2,0
27005,27015,18205,27015,888,126,762,3,32,2,1
54223,443,38222,443,499,425,74,4,0,3,1
53799,53,39316,53,213,78,135,2,30,1,1
38115,443,13490,443,281978,16098,265880,405,67,204,201
32966,53,20380,53,199,94,105,2,30,1,1
56000,53,8849,53,177,94,83,2,31,1,1
55117,53,60693,53,756,95,661,2,31,1,1
56127,443,17365,443,6103,2710,3393,58,212,28,30
63924,26328,57332,26328,66,66,0,2,8,2,0
49730,443,40154,443,3233,1141,2092,14,135,7,7
56543,443,33644,443,8659,1687,6972,30,55,16,14
51946,443,31314,443,2666,1542,1124,17,17,9,8
57451,443,58507,443,19175423,168230,19007193,15129,313,2298,12831
64280,53,51701,53,211,94,117,2,30,1,1
27005,27015,3156,27015,878,126,752,2,30,1,1
65315,53,56097,53,216,110,106,2,30,1,1
36665,443,51014,443,5814771,76275,5738496,4959,154,976,3983
33906,80,51887,80,1248,660,588,8,15,4,4
64393,53,13343,53,183,94,89,2,31,1,1
57386,53,9687,53,186,95,91,2,31,1,1
50265,60276,27315,60276,481,150,331,2,1200,1,1
65165,53,64230,53,177,94,83,2,30,1,1
39966,53,39966,53,235,90,145,2,32,1,1
57892,443,36599,443,6394,3923,2471,42,176,22,20
58035,53,58035,53,237,91,146,2,32,1,1
49201,17852,9879,17852,70,70,0,2,8,2,0
52124,11296,48870,11296,66,66,0,1,5,1,0
62113,443,7270,443,3262,256,3006,9,121,4,5
60602,5222,39358,5222,5564,2206,3358,50,310,20,30
41246,443,49001,443,78,78,0,1,5,1,0
47322,80,21803,80,75931,3459,72472,97,43,38,59
37616,443,9088,443,702409,17257,685152,698,32,233,465
53130,10168,25089,10168,320,140,180,6,5,3,3
47817,443,22532,443,190,70,120,4,14,2,2
51892,46647,34851,46647,70,70,0,2,8,2,0
41472,443,61400,443,680618,28384,652234,828,84,356,472
63078,53,5697,53,304,86,218,2,30,1,1
49198,64509,42217,64509,70,70,0,2,8,2,0
51993,80,56681,80,482,300,182,9,25,6,3
37383,443,62473,443,11389,4837,6552,27,120,13,14
57108,53,22880,53,186,95,91,2,30,1,1
54336,443,1774,443,172701,6397,166304,202,246,72,130
57166,53,52593,53,177,94,83,2,30,1,1
61637,53,50085,53,246,246,0,4,47,4,0
35202,443,16914,443,10848,4083,6765,37,16,21,16
46412,53,4555,53,164,78,86,2,31,1,1
36266,443,8453,443,6043,1568,4475,11,119,4,7
49212,53,2222,53,183,94,89,2,30,1,1
54959,53,55132,53,211,110,101,2,31,1,1
55637,53,12301,53,209,110,99,2,30,1,1
56599,443,36954,443,348780,9144,339636,358,32,123,235
45273,53,45273,53,213,79,134,2,32,1,1
56317,53,56317,53,216,82,134,2,32,1,1
56127,53,41688,53,167,86,81,2,30,1,1
57172,53,34011,53,196,102,94,2,31,1,1
52166,57975,20041,57975,66,66,0,1,5,1,0
56983,53,28765,53,424,108,316,4,55,2,2
52162,15104,33803,15104,70,70,0,2,7,2,0
56777,53,34621,53,210,94,116,2,30,1,1
55955,53,53026,53,184,94,90,2,30,1,1
62121,443,9258,443,1864,250,1614,8,120,4,4
43601,443,18392,443,10274,3806,6468,26,413,14,12
63779,12226,36658,12226,66,66,0,2,7,2,0
51825,80,15500,80,540,540,0,10,194,10,0
53816,443,52923,443,499,425,74,4,0,3,1
49449,53,12310,53,216,110,106,2,30,1,1
49558,53,38507,53,193,102,91,2,29,1,1
1927,53,62865,53,210,78,132,2,30,1,1
53450,443,18001,443,5931,1750,4181,24,48,14,10
53800,443,21628,443,499,425,74,4,0,3,1
55740,8060,29494,8060,70,70,0,2,7,2,0
64613,53,44378,53,179,94,85,2,30,1,1
65496,53,1852,53,198,94,104,2,31,1,1
63999,53,20780,53,193,102,91,2,31,1,1
48817,27294,48817,27294,150,150,0,1,1200,1,0
56261,53,26001,53,184,94,90,2,29,1,1
57665,5228,43757,5228,2391,1434,957,16,3601,8,8
56492,53,4383,53,212,102,110,2,30,1,1
41554,53,50330,53,199,94,105,2,30,1,1
64414,53,43076,53,193,102,91,2,30,1,1
51795,80,9427,80,3955,2325,1630,18,47,11,7
64083,63666,21856,63666,66,66,0,2,8,2,0
54371,443,18994,443,11828,2811,9017,31,76,16,15
55174,53,1640,53,774,101,673,2,0,1,1
56492,443,36078,443,3715,1659,2056,35,188,18,17
38321,80,40490,80,543,469,74,6,16,5,1
49710,53,1886,53,183,102,81,2,30,1,1
63225,443,50090,443,4882,2412,2470,32,155,16,16
55250,443,44147,443,1271,918,353,9,15,6,3
65189,27015,11223,27015,275,78,197,2,29,1,1
49501,53,46075,53,343,92,251,4,32,2,2
56424,53,45965,53,177,94,83,2,29,1,1
58002,80,62017,80,2362,1608,754,22,80,12,10
65191,53,21889,53,196,94,102,2,29,1,1
49825,53,30889,53,336,110,226,2,31,1,1
59488,80,65175,80,1114,534,580,12,16,7,5
38290,443,29490,443,6978,1169,5809,22,163,12,10
64309,53,10386,53,308,94,214,2,30,1,1
56421,53,33128,53,177,94,83,2,29,1,1
5588,5588,0,0,3562,1936,1626,48,196,24,24
53144,58987,40200,58987,70,70,0,1,5,1,0
50497,80,3021,80,19946,10573,9373,29,25,14,15
49985,443,2510,443,10737,3664,7073,20,137,10,10
64737,53,22713,53,285,94,191,2,31,1,1
45753,80,11896,80,48495,10969,37526,83,477,39,44
47893,443,63291,443,172,172,0,2,4,2,0
48808,443,13852,443,8192,2071,6121,23,361,10,13
63932,53,25694,53,179,94,85,2,31,1,1
38936,80,38936,80,8429,1098,7331,16,20,8,8
51901,15860,21103,15860,316,136,180,6,6,3,3
53110,8830,31632,8830,70,70,0,2,8,2,0
51794,80,29436,80,5480,3236,2244,19,47,12,7
39402,443,48958,443,6417,1255,5162,24,360,12,12
56876,53,55574,53,711,87,624,2,31,1,1
40273,53,38821,53,164,78,86,2,30,1,1
51207,443,64631,443,12171,2763,9408,53,17,30,23
50500,53,25369,53,166,86,80,2,30,1,1
56927,53,57127,53,183,94,89,2,30,1,1
37924,80,11096,80,214,140,74,4,15,3,1
40349,443,1831,443,7128,1336,5792,22,83,11,11
46861,15000,42443,15000,130,70,60,2,5,1,1
53540,34134,25153,34134,70,70,0,1,5,1,0
65428,53,65157,53,516,86,430,4,32,2,2
63985,43081,42263,43081,66,66,0,2,7,2,0
64742,443,6500,443,6372,1582,4790,32,195,15,17
49418,27015,56301,27015,258,71,187,2,30,1,1
57283,443,46704,443,7792,2318,5474,38,27,22,16
65177,53,32886,53,256,93,163,2,31,1,1
49580,53,21716,53,192,98,94,2,30,1,1
65299,53,60442,53,177,94,83,2,30,1,1
58638,5900,58638,5900,66,66,0,1,4,1,0
49531,80,57829,80,78,78,0,1,5,1,0
54147,443,52345,443,3334,331,3003,10,120,5,5
53142,47933,51357,47933,698,320,378,10,17,6,4
36325,443,45107,443,2930,1614,1316,16,249,9,7
64979,53,11759,53,254,102,152,2,30,1,1
36100,443,53812,443,812,440,372,14,25,8,6
42012,443,37519,443,14271,2106,12165,42,227,17,25
56351,53,2881,53,195,102,93,2,30,1,1
50629,443,10461,443,1048,1048,0,9,17,9,0
49673,53,51744,53,421,88,333,4,39,2,2
61835,443,61835,443,21703,2433,19270,44,76,18,26
65212,53,35167,53,192,98,94,2,31,1,1
60774,40010,46436,40010,316,136,180,6,7,3,3
50898,443,4601,443,8480,2236,6244,27,81,15,12
53893,443,15377,443,499,425,74,4,0,3,1
44791,443,29863,443,3181,1647,1534,18,31,10,8
44355,80,33572,80,26085,2508,23577,52,38,29,23
49045,80,27391,80,1105,624,481,13,316,7,6
53710,80,64568,80,2499,531,1968,11,75,6,5
56272,53,41462,53,193,102,91,2,30,1,1
61834,443,61834,443,220115,6038,214077,231,76,78,153
65335,53,50606,53,216,102,114,2,30,1,1
55098,53,38857,53,474,200,274,6,43,3,3
55087,53,1147,53,183,94,89,2,31,1,1
65224,53,46834,53,197,102,95,2,30,1,1
59433,53,26803,53,218,78,140,2,29,1,1
56166,53,54206,53,193,102,91,2,29,1,1
54219,443,4743,443,10323,2834,7489,44,256,21,23
35924,443,41677,443,4310,1640,2670,22,159,10,12
50440,53,43767,53,216,110,106,2,30,1,1
60888,443,18783,443,7454,3131,4323,23,46,13,10
57339,443,64003,443,1778020,204978,1573042,2589,987,1006,1583
41210,443,11454,443,234,234,0,4,11,4,0
39180,443,51621,443,3221,2218,1003,16,15,8,8
51326,443,48019,443,6250,1422,4828,20,17,10,10
64853,53,19289,53,198,101,97,2,31,1,1
60473,8765,34134,8765,199,75,124,4,59,2,2
47141,443,51949,443,2011,1238,773,16,330,9,7
56497,53,27099,53,177,94,83,2,30,1,1
56033,443,32455,443,3250,1058,2192,13,136,6,7
64950,53,10318,53,765,102,663,2,30,1,1
60958,443,2953,443,1547,960,587,14,17,8,6
50263,53,56865,53,164,86,78,2,29,1,1
45287,53,10390,53,198,93,105,2,30,1,1
64583,53,34573,53,179,94,85,2,30,1,1
49418,27015,62235,27015,258,78,180,2,30,1,1
55951,53,16889,53,194,99,95,2,31,1,1
50584,34393,36839,34393,509,150,359,2,1200,1,1
64887,53,53065,53,209,110,99,2,30,1,1
55288,443,7334,443,15679,1532,14147,16,139,3,13
37569,443,45273,443,11226,3029,8197,36,55,18,18
50080,443,5025,443,15595,3264,12331,26,35,14,12
53860,53,53860,53,197,90,107,2,30,1,1
43382,443,40551,443,9624,2231,7393,24,22,14,10
58497,443,60144,443,1640,831,809,18,43,10,8
64124,53,4238,53,183,94,89,2,30,1,1
64775,53,35140,53,445,86,359,2,29,1,1
59282,123,52231,123,184,94,90,2,30,1,1
55320,53,12991,53,239,102,137,2,30,1,1
42298,40030,5035,40030,146,84,62,2,31,1,1
64989,53,13455,53,167,86,81,2,30,1,1
64180,53,16774,53,176,90,86,2,31,1,1
57262,53,12912,53,180,94,86,2,30,1,1
55868,53,11909,53,198,110,88,2,29,1,1
57600,53,41878,53,168,78,90,2,30,1,1
56629,53,25209,53,183,94,89,2,30,1,1
33281,53,7345,53,86,86,0,1,30,1,0
49343,53,32839,53,202,103,99,2,31,1,1
60039,53,37317,53,312,82,230,2,31,1,1
50999,443,57620,443,6765,1108,5657,17,18,10,7
52079,80,61511,80,366,240,126,7,25,5,2
65106,53,25747,53,772,102,670,2,30,1,1
63796,60557,4607,60557,70,70,0,1,5,1,0
51842,27665,50059,27665,70,70,0,1,5,1,0
60578,443,8619,443,27150,3104,24046,55,157,24,31
64114,53,0,0,200,90,110,2,30,1,1
64607,53,1706,53,211,110,101,2,30,1,1
51869,443,60062,443,4435,1290,3145,17,31,9,8
49989,443,4666,443,300,168,132,4,6,2,2
56859,32185,46564,32185,70,70,0,1,5,1,0
64460,53,29713,53,196,102,94,2,30,1,1
65264,53,2001,53,738,86,652,2,30,1,1
5238,36298,39762,36298,179518,128,179390,173,37,3,170
39818,443,44736,443,2211,1181,1030,23,40,11,12
63980,443,5737,443,5237,2844,2393,14,135,7,7
53802,443,44070,443,499,425,74,4,0,3,1
46512,443,4517,443,22641,10532,12109,62,200,35,27
54453,443,45461,443,4227,1086,3141,15,29,8,7
50334,80,53374,80,442,250,192,8,47,5,3
44847,6881,46281,6881,150,150,0,1,1200,1,0
27005,27015,27381,27015,887,126,761,2,30,1,1
50578,80,53375,80,1114,534,580,12,16,7,5
57139,443,39822,443,2162,1317,845,16,25,9,7
51671,53,51671,53,200,90,110,2,30,1,1
42315,443,13240,443,13090,9437,3653,43,188,14,29
41409,80,32220,80,1484,877,607,11,34,6,5
62616,443,35713,443,32504,1730,30774,44,122,17,27
63945,53,52680,53,216,110,106,2,31,1,1
56553,53,8293,53,199,102,97,2,30,1,1
46893,443,27910,443,622,70,552,10,180,2,8
56586,53,17774,53,177,94,83,2,29,1,1
59811,443,39338,443,36149,11297,24852,56,29,25,31
56463,53,28170,53,368,118,250,2,30,1,1
56312,53,11008,53,190,97,93,2,31,1,1
53332,443,6381,443,23215,18990,4225,44,405,24,20
49198,53,53619,53,308,118,190,2,30,1,1
47274,5223,2647,5223,4269,1451,2818,22,3002,13,9
55630,53,11814,53,197,102,95,2,30,1,1
50404,80,8357,80,4242,3615,627,15,32,8,7
49929,53,22603,53,214,110,104,2,29,1,1
32909,443,28727,443,160821,7879,152942,201,141,88,113
8291,23,8291,23,66,66,0,1,4,1,0
57250,443,30751,443,345315,16365,328950,459,36,206,253
49369,53,3787,53,182,93,89,2,31,1,1
60350,443,44026,443,5242,861,4381,17,16,9,8
64913,53,27699,53,182,93,89,2,31,1,1
50234,53,30924,53,775,102,673,2,30,1,1
60781,443,56303,443,5964,3582,2382,17,136,8,9
60384,64170,40565,64170,504,318,186,8,16,5,3
49867,53,7070,53,177,94,83,2,29,1,1
64524,53,53824,53,235,102,133,2,30,1,1
58936,443,15489,443,10014,6664,3350,28,17,14,14
45063,80,24999,80,1892,1014,878,10,21,6,4
54805,80,8562,80,448,78,370,6,24,1,5
55821,53,64842,53,192,98,94,2,30,1,1
27005,33052,31448,33052,873,126,747,2,30,1,1
55594,53,22728,53,167,86,81,2,30,1,1
48817,8621,48817,8621,152,152,0,1,1200,1,0
64994,443,32046,443,3547,1351,2196,17,135,8,9
9338,443,8556,443,4462,500,3962,13,15,7,6
52024,80,44508,80,422,240,182,8,25,5,3
51873,19311,22096,19311,70,70,0,1,5,1,0
56127,53,58620,53,167,86,81,2,29,1,1
65515,443,2957,443,419763,12080,407683,429,16,147,282
50002,443,45848,443,25358,6778,18580,31,16,13,18
65244,53,58540,53,378,99,279,4,45,2,2
55185,443,43469,443,6389,1163,5226,19,25,11,8
14950,53,14950,53,414,268,146,3,32,2,1
55809,443,31063,443,62,62,0,1,4,1,0
49418,27001,35049,27001,256,78,178,2,30,1,1
49540,53,42804,53,754,94,660,2,31,1,1
56561,53,19091,53,216,110,106,2,30,1,1
50264,443,26394,443,25435,5293,20142,104,138,54,50
56163,53,10376,53,624,188,436,6,60,3,3
61471,443,26685,443,18168,2973,15195,46,88,21,25
65099,53,63994,53,198,101,97,2,31,1,1
55385,443,7012,443,11771,2624,9147,50,20,25,25
49861,53,42147,53,198,102,96,2,30,1,1
49422,53,49422,53,247,98,149,2,32,1,1
55051,53,56758,53,167,86,81,2,30,1,1
64986,53,30082,53,180,94,86,2,30,1,1
58666,53,17306,53,167,78,89,2,29,1,1
63773,443,33011,443,9693,2010,7683,18,130,9,9
55057,80,24701,80,306,180,126,6,26,4,2
38433,443,38484,443,33344,25806,7538,105,130,56,49
55857,53,31762,53,196,102,94,2,30,1,1
55596,53,19558,53,177,94,83,2,30,1,1
54435,443,54824,443,18802,3386,15416,54,293,28,26
63964,53,46604,53,190,97,93,2,31,1,1
56681,443,56377,443,8654,2150,6504,20,15,11,9
64196,53,65372,53,262,94,168,2,30,1,1
64403,53,2916,53,193,102,91,2,29,1,1
48017,443,12876,443,198,78,120,4,6,2,2
65493,53,48274,53,266,110,156,2,30,1,1
27005,23010,35544,23010,881,126,755,2,29,1,1
42298,40013,37939,40013,205,83,122,4,30,2,2
55786,53,21732,53,170,87,83,2,30,1,1
52176,17572,27555,17572,70,70,0,2,8,2,0
57252,53,37679,53,183,94,89,2,30,1,1
26805,443,51742,443,21055,15996,5059,39,22,22,17
56143,53,42893,53,195,94,101,2,30,1,1
52089,16543,21777,16543,70,70,0,2,9,2,0
38693,443,10334,443,90177,3481,86696,96,15,31,65
54348,443,26587,443,12594,5098,7496,32,35,17,15
51226,7275,28428,7275,416,210,206,7,16,4,3
19473,40959,26703,40959,491,150,341,2,1200,1,1
47935,443,5335,443,12403,2139,10264,38,22,19,19
49418,27016,27118,27016,231,71,160,2,30,1,1
55673,53,34197,53,179,94,85,2,31,1,1
55023,443,26981,443,8527,2218,6309,30,26,17,13
56728,53,40582,53,744,95,649,2,31,1,1
63927,53,30501,53,196,94,102,2,30,1,1
51037,80,32981,80,134,60,74,3,4,2,1
59788,443,40327,443,134688,7027,127661,166,37,64,102
49714,53,19961,53,490,101,389,4,45,2,2
57470,50321,43161,50321,9414,7249,2165,91,3838,76,15
57641,80,57641,80,35197,3040,32157,40,32,14,26
65218,53,61017,53,193,102,91,2,31,1,1
59261,80,59261,80,109128,4773,104355,197,15,68,129
37587,5228,8359,5228,5509,2203,3306,22,3600,10,12
56479,443,37707,443,3041,1995,1046,17,16,8,9
49241,8080,49241,8080,12477,3635,8842,23,55,13,10
49552,53,40374,53,760,97,663,2,31,1,1
27005,1108,29177,1108,873,126,747,2,30,1,1
56985,443,5059,443,2281,1126,1155,25,120,12,13
64950,53,22680,53,182,93,89,2,31,1,1
64099,53,12065,53,227,110,117,2,30,1,1
56618,80,46340,80,234,234,0,4,12,4,0
55820,53,19644,53,194,102,92,2,30,1,1
52731,80,58843,80,1029,567,462,10,17,6,4
35542,23,35542,23,124,60,64,2,5,1,1
64966,53,51667,53,458,188,270,6,31,3,3
56795,443,62237,443,8021,2001,6020,20,15,11,9
59734,443,60915,443,512,166,346,2,29,1,1
56484,53,39719,53,214,110,104,2,30,1,1
51755,24236,52970,24236,136,136,0,3,13,3,0
47326,443,40388,443,6318,1025,5293,17,33,9,8
58695,53,54969,53,392,86,306,2,30,1,1
55043,443,34590,443,37068,4085,32983,66,48,33,33
61594,53,61594,53,235,90,145,2,33,1,1
35554,443,35554,443,4378,1471,2907,19,28,11,8
56434,53,6758,53,701,88,613,2,31,1,1
64095,443,64095,443,17046,2620,14426,42,159,19,23
15241,53,62094,53,215,86,129,2,30,1,1
63976,443,11736,443,1270998,514773,756225,3073,2384,1413,1660
41249,443,56931,443,2080,1126,954,17,150,10,7
37780,443,60477,443,134,60,74,3,5,2,1
65385,53,9523,53,227,110,117,2,30,1,1
65366,53,65366,53,244,98,146,2,33,1,1
46684,80,18811,80,4294,1112,3182,15,199,4,11
56739,443,22996,443,795,795,0,2,169,2,0
56588,53,41777,53,197,102,95,2,29,1,1
64971,27026,15730,27026,1012,462,550,4,30,2,2
49969,53,31598,53,199,102,97,2,30,1,1
55384,53,19331,53,94,94,0,1,30,1,0
55463,53,8245,53,193,102,91,2,30,1,1
41165,443,56150,443,8949,1938,7011,21,17,12,9
51804,31012,6657,31012,70,70,0,2,8,2,0
53162,60352,25976,60352,70,70,0,2,8,2,0
59750,443,51830,443,2633,1179,1454,20,74,8,12
46731,443,46731,443,4603,1696,2907,19,30,11,8
27005,27019,44528,27019,880,126,754,2,30,1,1
50949,80,11302,80,942,527,415,11,342,6,5
50497,443,10813,443,1642025,26957,1615068,1478,17,406,1072
27005,27015,33669,27015,876,126,750,2,30,1,1
58434,443,57588,443,170342,10231,160111,264,136,130,134
50338,443,61638,443,6441,1651,4790,22,53,12,10
53897,443,3893,443,10781,3635,7146,27,221,15,12
57507,7000,57507,7000,3562,1995,1567,16,15,9,7
58751,443,12034,443,10505,6856,3649,29,16,15,14
49459,443,9422,443,39932,34025,5907,52,21,34,18
63877,53,63877,53,247,98,149,2,32,1,1
49505,443,22158,443,3182,1568,1614,8,120,4,4
44219,443,26012,443,35920,26656,9264,60,128,30,30
51443,443,35232,443,322,66,256,6,16,2,4
58744,53,27095,53,368,86,282,2,30,1,1
60021,443,37470,443,346221,14712,331509,474,107,211,263
64739,53,12107,53,172,94,78,2,30,1,1
55688,53,29259,53,184,94,90,2,31,1,1
51535,443,59853,443,122,62,60,2,16,1,1
55233,53,15536,53,215,102,113,2,30,1,1
64573,443,4149,443,4158,2117,2041,11,120,6,5
57422,80,40149,80,10454,4931,5523,21,30,10,11
50579,443,37078,443,2707,1383,1324,29,36,16,13
56889,53,24379,53,177,94,83,2,30,1,1
57321,53,57606,53,199,102,97,2,30,1,1
56649,443,48324,443,3469,1006,2463,15,121,7,8
61226,443,29248,443,3135,1603,1532,22,632,7,15
6881,34190,52438,34190,509,150,359,2,1200,1,1
55283,443,55908,443,2964,1657,1307,18,47,9,9
63965,53,1139,53,214,102,112,2,30,1,1
64804,53,31085,53,182,102,80,2,30,1,1
51060,80,61015,80,4632,2660,1972,49,193,26,23
56529,80,56529,80,1915,1466,449,10,20,6,4
45423,80,20264,80,2259,1830,429,11,150,6,5
56533,53,7408,53,199,102,97,2,29,1,1
40204,40029,46066,40029,148,86,62,2,30,1,1
49418,27015,32130,27015,260,78,182,2,30,1,1
61713,80,49521,80,134,60,74,3,5,2,1
49610,80,55235,80,378,192,186,7,41,4,3
55237,53,51535,53,259,87,172,4,56,2,2
45571,443,60221,443,3974,2015,1959,21,345,10,11
43103,443,44934,443,3149,1899,1250,19,15,9,10
50340,53,41286,53,181,94,87,2,29,1,1
63955,53,0,0,219,81,138,2,30,1,1
50930,443,14420,443,1786,172,1614,7,121,3,4
59470,53,45081,53,184,86,98,2,29,1,1
53799,3478,23545,3478,3736,1944,1792,58,91,29,29
56354,53,51631,53,200,94,106,2,30,1,1
53561,35885,64999,35885,70,70,0,2,7,2,0
39385,443,14896,443,89229,6918,82311,131,33,63,68
56633,443,38597,443,7889,1900,5989,20,15,11,9
53666,50321,61664,50321,736,490,246,8,17,4,4
63782,6969,33183,6969,66,66,0,2,8,2,0
50624,443,1028,443,12712,3662,9050,32,140,17,15
33811,443,49179,443,17406,8237,9169,53,165,21,32
10056,443,53947,443,12677,10470,2207,42,80,23,19
49895,443,62049,443,493316,12157,481159,470,94,122,348
65294,53,15570,53,710,89,621,2,30,1,1
51247,443,62660,443,5747,1892,3855,19,16,11,8
56601,53,46710,53,177,94,83,2,30,1,1
49235,8080,49235,8080,2600,844,1756,13,136,7,6
42732,53,10027,53,86,86,0,1,30,1,0
59906,443,52197,443,13657,5248,8409,33,171,17,16
53794,39607,26801,39607,70,70,0,1,5,1,0
50346,443,6974,443,1385,868,517,12,30,6,6
51765,52862,26786,52862,70,70,0,2,7,2,0
53540,443,65354,443,20948,4141,16807,76,616,37,39
65341,53,19741,53,200,102,98,2,29,1,1
58796,443,44743,443,14463,9503,4960,34,17,17,17
57352,53,28583,53,193,102,91,2,30,1,1
57063,53,54503,53,177,94,83,2,30,1,1
34878,53,44059,53,339,94,245,2,30,1,1
56803,53,3207,53,429,93,336,4,44,2,2
22131,53,22131,53,172,76,96,2,31,1,1
56509,53,41875,53,747,90,657,2,31,1,1
37569,443,62678,443,214,140,74,4,15,3,1
56422,53,41175,53,199,102,97,2,30,1,1
49953,53,45166,53,214,110,104,2,30,1,1
50234,53,63121,53,720,94,626,2,30,1,1
46438,443,46438,443,5337,2090,3247,22,39,13,9
64266,53,18916,53,180,94,86,2,31,1,1
65049,53,13947,53,199,102,97,2,29,1,1
53179,12502,28254,12502,70,70,0,2,7,2,0
56138,53,42749,53,259,86,173,2,30,1,1
32346,53,32346,53,194,87,107,2,30,1,1
48371,53,57320,53,198,93,105,2,30,1,1
64414,53,56894,53,182,93,89,2,31,1,1
9786,53,9786,53,230,91,139,2,30,1,1
60342,80,14869,80,2005,1094,911,11,87,6,5
55443,53,14783,53,194,102,92,2,30,1,1
50106,53,56744,53,296,94,202,2,30,1,1
50031,53,40045,53,181,94,87,2,30,1,1
55937,443,21508,443,3363,797,2566,14,135,7,7
48553,443,14731,443,49428,2702,46726,70,136,30,40
46985,443,26507,443,4957,3488,1469,25,51,15,10
40009,443,48154,443,21785,5577,16208,35,362,16,19
64155,53,25938,53,183,94,89,2,30,1,1
1924,80,29370,80,214,140,74,4,15,3,1
53498,3389,53498,3389,3549,1594,1955,18,18,10,8
50980,443,12783,443,3964,1908,2056,23,94,13,10
50625,443,24719,443,9588,1204,8384,29,93,15,14
60211,443,55686,443,126490514,2726981,123763533,123275,553,41466,81809
50584,39812,60344,39812,161,161,0,1,1200,1,0
56235,80,56235,80,44756,824,43932,45,15,12,33
53262,443,44480,443,7608,1340,6268,27,53,13,14
56330,53,49598,53,199,102,97,2,30,1,1
50193,3389,50193,3389,3473,1518,1955,17,19,9,8
56258,53,45112,53,166,85,81,2,31,1,1
42776,443,39063,443,4353,687,3666,14,25,8,6
51708,21278,38128,21278,70,70,0,1,5,1,0
61692,443,18049,443,126,60,66,3,10,2,1
57570,443,12758,443,21267,5407,15860,36,361,17,19
49210,443,19575,443,9530,2183,7347,45,256,21,24
57007,53,22184,53,182,93,89,2,31,1,1
56556,53,39317,53,762,97,665,2,30,1,1
49376,53,15412,53,391,134,257,2,30,1,1
59416,443,46812,443,2834,1700,1134,16,15,8,8
49192,53,18280,53,747,93,654,2,30,1,1
49562,80,14517,80,318,192,126,6,45,4,2
65144,53,24637,53,210,110,100,2,30,1,1
65506,443,5450,443,92243,4519,87724,105,16,39,66
49262,53,60170,53,168,86,82,2,30,1,1
49295,53,61148,53,164,86,78,2,29,1,1
49872,53,15358,53,216,94,122,2,30,1,1
33637,443,44559,443,24214,18131,6083,81,118,44,37
3580,53,3580,53,832,106,726,2,30,1,1
13237,53,13237,53,823,98,725,2,30,1,1
60380,55125,53805,55125,70,70,0,2,8,2,0
49418,27015,65524,27015,287,78,209,2,30,1,1
55878,53,54979,53,760,97,663,2,31,1,1
51108,80,61739,80,6504,3994,2510,26,47,14,12
64053,53,8111,53,276,94,182,4,56,2,2
27005,27015,42995,27015,1758,252,1506,5,32,3,2
53574,23650,56670,23650,320,140,180,6,5,3,3
53907,45622,15618,45622,70,70,0,1,4,1,0
52856,443,43323,443,5495,1303,4192,17,15,9,8
30188,58770,26804,58770,14172,5733,8439,79,1531,37,42
44633,443,21223,443,5715,1536,4179,24,16,13,11
52100,80,3260,80,30068,3203,26865,43,35,19,24
58848,443,23115,443,1362,627,735,14,81,7,7
49183,53,24061,53,209,110,99,2,31,1,1
64969,27044,17492,27044,741,462,279,2,30,1,1
57380,443,31912,443,5553,927,4626,16,15,10,6
56215,53,1097,53,216,110,106,2,30,1,1
65505,443,12963,443,458741,13270,445471,469,16,164,305
49152,53,17272,53,307,105,202,4,31,2,2
65115,53,63102,53,301,95,206,4,36,2,2
52961,5228,16793,5228,1410,933,477,11,3600,6,5
64113,443,11350,443,14057427,329652,13727775,13768,110,4655,9113
29791,53,29791,53,213,87,126,2,31,1,1
55022,443,12848,443,14634,1801,12833,28,46,14,14
49933,53,6937,53,178,94,84,2,31,1,1
63089,53,1694,53,512,166,346,2,30,1,1
55075,53,35995,53,181,94,87,2,30,1,1
56761,443,28881,443,8057,2037,6020,20,15,11,9
56698,80,23963,80,176644,9435,167209,266,65,104,162
55619,443,51009,443,13144,7075,6069,33,161,16,17
64483,53,3911,53,168,86,82,2,30,1,1
58917,80,56785,80,4107,3453,654,13,16,7,6
58638,5900,58638,5900,66,66,0,1,4,1,0
48755,80,48755,80,630,264,366,10,44,5,5
2267,53,1779,53,204,118,86,2,31,1,1
49418,27015,52265,27015,266,78,188,2,30,1,1
55985,53,10494,53,711,87,624,2,30,1,1
27179,53,27179,53,398,255,143,3,34,2,1
56314,53,18925,53,733,86,647,2,31,1,1
9454,443,57468,443,5699,505,5194,14,15,7,7
51827,443,46992,443,11946,8904,3042,42,42,26,16
33939,443,3295,443,3191,1047,2144,13,135,6,7
55898,53,25351,53,757,102,655,2,30,1,1
46966,5222,45433,5222,12521,2892,9629,64,356,27,37
55664,53,52942,53,711,87,624,2,31,1,1
56660,443,12588,443,1579,988,591,13,25,7,6
56524,443,14904,443,344632,9074,335558,354,121,122,232
59487,53,59487,53,211,80,131,2,30,1,1
55560,53,36102,53,166,86,80,2,30,1,1
56652,53,12784,53,198,102,96,2,30,1,1
55739,443,29426,443,10875114,348643,10526471,11702,194,3853,7849
37635,443,51413,443,4883,1327,3556,18,135,9,9
43319,53,43319,53,237,91,146,2,32,1,1
55680,23711,32600,23711,70,70,0,1,5,1,0
49234,53,62807,53,167,86,81,2,29,1,1
56618,443,44259,443,22938,14436,8502,43,41,23,20
65152,53,43515,53,170,87,83,2,30,1,1
56628,443,8752,443,6654,3821,2833,60,3037,30,30
64919,53,28952,53,199,102,97,2,29,1,1
61464,80,54948,80,366,180,186,7,93,4,3
25833,53,31276,53,404,261,143,3,30,2,1
57189,53,13765,53,78,78,0,1,30,1,0
56726,443,54514,443,4221,666,3555,13,15,7,6
56715,443,60472,443,8005,1985,6020,20,15,11,9
49198,64509,55959,64509,70,70,0,1,5,1,0
49864,53,25609,53,186,95,91,2,31,1,1
9319,443,38033,443,5687,499,5188,14,16,7,7
27005,27015,11891,27015,885,126,759,2,30,1,1
37833,53,37833,53,222,90,132,2,30,1,1
51791,80,21497,80,1934,1083,851,9,15,5,4
58077,443,14905,443,9138,4704,4434,24,315,13,11
65529,53,6825,53,198,102,96,2,29,1,1
64993,53,50463,53,748,95,653,2,30,1,1
64016,53,59779,53,184,94,90,2,31,1,1
54350,443,59930,443,15567,5964,9603,27,21,14,13
37589,443,25099,443,499,425,74,4,0,3,1
52734,443,39307,443,257777,12962,244815,347,41,162,185
51732,54299,38142,54299,70,70,0,1,5,1,0
64200,53,53095,53,193,102,91,2,30,1,1
56827,53,56181,53,195,102,93,2,30,1,1
50446,80,5062,80,318,192,126,6,27,4,2
55709,30217,48170,30217,70,70,0,1,5,1,0
51700,80,43241,80,30853,2456,28397,48,78,25,23
55041,80,12804,80,486,240,246,9,35,5,4
56622,53,10987,53,214,110,104,2,30,1,1
19850,53,19850,53,404,259,145,3,32,2,1
54270,443,64669,443,29945,19086,10859,98,736,50,48
64575,443,61163,443,24686,1935,22751,36,16,17,19
56728,53,35265,53,164,84,80,2,31,1,1
56100,53,43759,53,701,88,613,2,30,1,1
64820,53,3092,53,195,102,93,2,30,1,1
64490,53,23595,53,280,118,162,2,30,1,1
50863,80,47507,80,5874,744,5130,14,131,7,7
27242,443,3447,443,19477,14323,5154,45,309,22,23
52079,1024,34017,1024,70,70,0,2,8,2,0
64345,53,39290,53,499,94,405,2,29,1,1
65189,27015,46211,27015,267,78,189,2,30,1,1
6881,6889,14083,6889,228,118,110,2,1199,1,1
55704,53,43154,53,177,94,83,2,30,1,1
2267,53,32396,53,204,118,86,2,30,1,1
55180,53,64280,53,780,93,687,2,31,1,1
49669,443,57280,443,6911,897,6014,22,28,10,12
45275,443,27366,443,130,70,60,3,5,2,1
59103,443,51275,443,4209,2056,2153,50,277,24,26
56951,53,25030,53,168,86,82,2,29,1,1
30960,45763,2134,45763,330,330,0,6,3609,6,0
52260,52142,32000,52142,70,70,0,2,8,2,0
64336,443,26343,443,10099,4296,5803,30,124,13,17
61745,443,5419,443,8123,5308,2815,18,134,9,9
63427,443,12602,443,15135,12791,2344,43,81,22,21
64658,53,60447,53,195,102,93,2,29,1,1
45458,80,54981,80,138,78,60,2,5,1,1
50968,443,54503,443,13683,6075,7608,58,5113,23,35
33446,80,33446,80,1753,833,920,10,20,6,4
51526,4545,51526,4545,156,156,0,3,8,3,0
42298,40001,45646,40001,156,94,62,2,30,1,1
62324,443,62324,443,2882,1622,1260,20,86,10,10
49940,80,46739,80,1130,613,517,11,15,6,5
53530,53,6923,53,164,78,86,2,30,1,1
42345,443,8962,443,7593,2146,5447,21,10,12,9
65519,53,27344,53,321,102,219,2,30,1,1
51891,23238,33315,23238,70,70,0,2,8,2,0
58638,5900,58638,5900,62,62,0,1,5,1,0
65268,53,12409,53,395,107,288,4,46,2,2
60191,80,55591,80,2589,1231,1358,9,28,5,4
59134,443,19073,443,6857,1727,5130,23,316,13,10
55375,53,47639,53,214,110,104,2,30,1,1
56120,53,56120,53,237,91,146,2,33,1,1
49396,53,18429,53,177,94,83,2,29,1,1
49840,443,49840,443,4645,1738,2907,19,30,11,8
64880,53,31529,53,166,86,80,2,30,1,1
56978,80,63683,80,214,140,74,4,35,3,1
51567,443,62736,443,400,70,330,7,17,2,5
5048,53,5048,53,247,98,149,2,34,1,1
49378,53,56071,53,268,94,174,2,30,1,1
63084,53,54059,53,86,86,0,1,30,1,0
57661,53,46284,53,70,70,0,1,30,1,0
49952,53,48831,53,195,102,93,2,30,1,1
33261,443,59567,443,14176,1843,12333,30,201,16,14
60401,30046,28995,30046,70,70,0,2,8,2,0
46654,80,33249,80,1518,954,564,14,320,8,6
56426,53,8485,53,184,94,90,2,30,1,1
33246,443,57032,443,8340,2896,5444,28,16,16,12
56862,443,9641,443,7819,1662,6157,20,76,11,9
53225,443,23994,443,6659,1215,5444,17,15,9,8
38095,443,38095,443,247172,58810,188362,325,90,174,151
56864,53,65006,53,200,102,98,2,31,1,1
55148,53,64223,53,711,87,624,2,30,1,1
49778,443,56574,443,10105,1951,8154,24,126,13,11
57195,53,17608,53,195,102,93,2,30,1,1
55156,53,48355,53,256,87,169,4,37,2,2
60397,43129,12174,43129,70,70,0,2,8,2,0
49418,27015,40892,27015,250,78,172,2,30,1,1
64045,7426,45943,7426,66,66,0,2,7,2,0
49625,53,64446,53,251,102,149,2,30,1,1
52018,80,60048,80,4988,2667,2321,15,38,10,5
52155,63867,61917,63867,70,70,0,1,5,1,0
57275,53,22434,53,193,102,91,2,30,1,1
29076,53,29076,53,231,90,141,2,31,1,1
57032,53,53093,53,166,86,80,2,29,1,1
51754,1182,55646,1182,70,70,0,2,7,2,0
49394,443,40363,443,7129,1853,5276,27,316,13,14
49499,443,5486,443,8848,4908,3940,23,42,12,11
56322,53,0,0,629,73,556,2,30,1,1
56360,53,50871,53,814,110,704,2,30,1,1
64200,53,27722,53,193,102,91,2,30,1,1
54998,53,35657,53,174,89,85,2,31,1,1
64403,53,9122,53,199,102,97,2,31,1,1
55388,53,5023,53,720,94,626,2,30,1,1
56079,53,14640,53,199,102,97,2,31,1,1
55123,53,64230,53,196,100,96,2,31,1,1
49639,443,62054,443,5776,1079,4697,15,53,8,7
51737,53,3505,53,231,78,153,2,30,1,1
62778,443,47503,443,6676,2316,4360,34,318,16,18
60901,443,55846,443,622058,33681,588377,765,65,327,438
57320,53,17715,53,802,104,698,2,30,1,1
37559,443,47158,443,9845,2815,7030,26,37,15,11
55264,53,44429,53,177,94,83,2,30,1,1
49621,443,59596,443,14888,3555,11333,58,256,23,35
55772,53,24055,53,269,110,159,2,30,1,1
65437,53,6994,53,173,94,79,2,30,1,1
64801,53,33594,53,728,96,632,2,30,1,1
46887,443,50848,443,118,118,0,1,30,1,0
50440,53,39485,53,216,110,106,2,30,1,1
65117,53,55253,53,542,100,442,4,51,2,2
27005,27216,33781,27216,872,126,746,2,30,1,1
49512,53,36100,53,195,102,93,2,30,1,1
63944,8999,41992,8999,70,70,0,1,5,1,0
54960,443,1507,443,17670,2044,15626,53,316,21,32
52780,53,38802,53,338,94,244,2,30,1,1
38922,80,38922,80,20984,1380,19604,34,15,18,16
6881,47488,39178,47488,150,150,0,2,1200,2,0
65036,53,31003,53,209,94,115,2,30,1,1
49331,53,64999,53,180,92,88,2,31,1,1
56775,9200,31796,9200,8223,3066,5157,30,33,15,15
53020,443,6371,443,3183,2180,1003,16,15,8,8
37669,443,48889,443,24415,3924,20491,45,48,22,23
53129,38413,41585,38413,70,70,0,1,5,1,0
49257,53,65016,53,164,84,80,2,30,1,1
20727,53,20727,53,217,82,135,2,32,1,1
27005,33070,2152,33070,883,126,757,2,30,1,1
49924,53,19826,53,718,94,624,2,30,1,1
51929,53371,28667,53371,70,70,0,1,5,1,0
49927,80,6147,80,1141,636,505,10,45,6,4
54985,80,44594,80,2452,680,1772,9,17,6,3
60809,40010,63910,40010,316,136,180,6,6,3,3
56664,53,62279,53,774,101,673,2,31,1,1
56757,443,47194,443,6205,986,5219,16,25,10,6
64154,53,27741,53,194,102,92,2,31,1,1
49326,53,56279,53,765,102,663,2,30,1,1
55548,53,2209,53,197,102,95,2,29,1,1
62578,53,27363,53,343,168,175,3,30,2,1
60013,443,65408,443,145369,7769,137600,224,21,106,118
64040,53,17235,53,226,102,124,2,29,1,1
42993,443,4203,443,7821,3237,4584,39,149,19,20
61431,80,8546,80,214,140,74,4,41,3,1
52222,11516,64024,11516,70,70,0,2,8,2,0
55326,53,27995,53,177,94,83,2,30,1,1
52907,80,17763,80,1659,653,1006,10,16,6,4
55346,53,11251,53,396,102,294,2,30,1,1
54437,80,15743,80,95298,61941,33357,182,929,95,87
56673,443,23897,443,6693,1072,5621,18,26,10,8
64569,53,52034,53,258,102,156,2,30,1,1
64364,53,21283,53,193,94,99,2,31,1,1
62883,53,56502,53,205,86,119,2,29,1,1
49861,53,46345,53,261,94,167,2,30,1,1
51649,80,42317,80,1965,1402,563,13,16,7,6
58814,443,50784,443,1549485,41822,1507663,1612,179,520,1092
37672,443,48728,443,3338,2337,1001,18,45,11,7
43014,443,37896,443,134,60,74,3,5,2,1
64573,53,7328,53,184,94,90,2,31,1,1
65153,53,43651,53,168,86,82,2,31,1,1
51498,443,51057,443,29265,2836,26429,47,16,21,26
40488,443,48919,443,3635,2114,1521,22,515,13,9
34141,53,34141,53,217,87,130,2,30,1,1
55745,53,20797,53,199,102,97,2,30,1,1
49270,53,27956,53,216,110,106,2,31,1,1
43324,22,43324,22,8157,3445,4712,59,43,28,31
51940,80,37296,80,366,240,126,7,27,5,2
26900,27017,45404,27017,422,164,258,6,30,3,3
45101,443,3854,443,7912,2739,5173,26,516,14,12
64116,53,50037,53,184,94,90,2,31,1,1
64503,53,62802,53,477,87,390,4,37,2,2
56369,53,8270,53,186,95,91,2,31,1,1
64380,53,29472,53,186,95,91,2,31,1,1
41475,443,20491,443,1251209,30056,1221153,1238,85,386,852
59099,443,44771,443,7066,1861,5205,32,1262,17,15
41734,443,42617,443,153,93,60,2,5,1,1
55083,53,24986,53,325,110,215,4,44,2,2
58288,443,58288,443,4661,1754,2907,19,26,11,8
55533,53,40009,53,183,94,89,2,30,1,1
52165,80,35107,80,1945,1002,943,11,19,7,4
64157,53,10043,53,323,90,233,4,48,2,2
52160,443,26040,443,956,420,536,15,26,7,8
55261,53,52795,53,183,94,89,2,30,1,1
55613,53,1186,53,177,94,83,2,30,1,1
53518,29500,52778,29500,320,140,180,6,7,3,3
57374,53,58495,53,216,102,114,2,30,1,1
56919,53,26686,53,170,87,83,2,30,1,1
56972,53,28054,53,177,94,83,2,30,1,1
51425,80,51425,80,11369,3404,7965,28,26,14,14
64216,53,1409,53,183,94,89,2,30,1,1
50185,443,5992,443,6350,1071,5279,18,42,10,8
52076,80,2859,80,366,240,126,7,26,5,2
50584,17991,30598,17991,161,161,0,2,1199,2,0
55757,53,46754,53,170,87,83,2,30,1,1
55786,53,25615,53,816,102,714,2,29,1,1
64949,53,27237,53,744,89,655,2,30,1,1
56966,80,60389,80,214,140,74,4,30,3,1
55153,443,47094,443,5897,1982,3915,20,18,11,9
6881,6881,38605,6881,502,150,352,2,1199,1,1
57013,80,33223,80,526,304,222,8,30,5,3
55594,53,15652,53,202,83,119,2,31,1,1
49162,53,42033,53,182,93,89,2,30,1,1
55724,45682,6518,45682,70,70,0,1,5,1,0
6881,39927,58260,39927,228,118,110,2,1199,1,1
63817,50808,64390,50808,70,70,0,1,4,1,0
58810,443,59123,443,5167,700,4467,16,15,7,9
53036,443,40328,443,249145,4184,244961,218,107,40,178
53739,443,35645,443,499,425,74,4,0,3,1
41810,443,22241,443,7474,2385,5089,15,121,7,8
52020,28704,45681,28704,70,70,0,2,9,2,0
22352,443,22352,443,6899,3403,3496,27,76,16,11
40204,40016,39697,40016,140,78,62,2,30,1,1
57727,443,62460,443,54944,4374,50570,88,361,44,44
49671,53,2651,53,166,86,80,2,31,1,1
52154,4635,6285,4635,66,66,0,1,5,1,0
49800,53,22865,53,182,93,89,2,31,1,1
55222,53,4063,53,181,94,87,2,30,1,1
52322,53,58058,53,86,86,0,1,30,1,0
55866,53,14599,53,168,78,90,2,30,1,1
64289,53,28932,53,199,102,97,2,30,1,1
55760,53,53617,53,180,92,88,2,31,1,1
59538,80,28530,80,1895,755,1140,11,14,6,5
63142,443,9605,443,4994,379,4615,9,15,4,5
56813,53,39428,53,711,87,624,2,30,1,1
55425,5222,24173,5222,9151,4417,4734,84,77,44,40
55964,443,21962,443,4455,798,3657,17,136,7,10
54956,53,14576,53,194,102,92,2,31,1,1
52149,80,41444,80,1638,1324,314,10,15,5,5
50210,1688,10212,1688,70,70,0,1,5,1,0
56225,53,65429,53,194,102,92,2,29,1,1
51221,65264,24402,65264,870,330,540,12,1573,6,6
49708,53,5780,53,172,88,84,2,31,1,1
53222,443,42780,443,4531,974,3557,18,65,10,8
64779,80,26888,80,82972,2084,80888,85,98,26,59
57375,53,3463,53,198,102,96,2,30,1,1
61964,443,61964,443,4378,1471,2907,19,30,11,8
57206,53,29989,53,292,85,207,4,50,2,2
58436,443,57353,443,18290,3012,15278,46,136,24,22
58804,443,5956,443,5167,700,4467,16,15,7,9
65165,53,27998,53,783,96,687,2,31,1,1
49845,53,33096,53,194,102,92,2,30,1,1
52108,20175,4699,20175,66,66,0,1,5,1,0
5588,5588,0,0,3354,1792,1562,46,194,23,23
64272,53,63528,53,626,190,436,6,60,3,3
55589,443,3953,443,7894,1557,6337,20,150,9,11
52963,80,22153,80,1600,581,1019,10,15,6,4
36786,443,50412,443,1798,1223,575,13,26,8,5
53863,8999,11307,8999,70,70,0,2,7,2,0
42025,443,50486,443,70,70,0,1,5,1,0
64898,53,23347,53,487,201,286,6,37,3,3
54986,53,11167,53,212,108,104,2,31,1,1
49599,53,2987,53,732,86,646,2,29,1,1
49431,53,39469,53,817,102,715,2,30,1,1
53972,443,53972,443,4380,1473,2907,19,29,11,8
62424,443,60409,443,4650,3116,1534,19,44,10,9
56854,17067,27330,17067,70,70,0,1,5,1,0
59984,443,19518,443,1527,940,587,14,21,8,6
55746,53,18233,53,302,84,218,4,46,2,2
63131,34880,2031,34880,316,190,126,5,15,3,2
49418,27015,10254,27015,78,78,0,1,30,1,0
55628,53,5942,53,821,102,719,2,30,1,1
50908,80,37284,80,14077960,171956,13906004,11755,133,2437,9318
57664,443,45877,443,5111,2193,2918,19,120,9,10
49547,53,39009,53,193,102,91,2,30,1,1
40476,443,53143,443,17360,5578,11782,71,281,39,32
53109,80,20052,80,8176,1443,6733,20,15,10,10
57293,443,65420,443,7057,2815,4242,37,18,21,16
52788,53,56727,53,196,94,102,2,30,1,1
54051,53,54051,53,617,67,550,2,30,1,1
49416,443,60402,443,625995,31468,594527,722,199,256,466
64323,53,30451,53,195,102,93,2,31,1,1
60486,8999,61783,8999,70,70,0,2,8,2,0
50584,6881,12157,6881,166,166,0,1,1200,1,0
56498,80,33330,80,174021,11443,162578,197,63,81,116
40512,80,26257,80,2543,691,1852,13,17,8,5
52195,443,11275,443,13948,1150,12798,29,15,14,15
61711,443,17336,443,7485,1962,5523,27,95,13,14
63898,13205,50081,13205,70,70,0,1,4,1,0
63591,443,24703,443,11746,3874,7872,44,141,22,22
51213,443,22292,443,6333,2018,4315,25,17,15,10
64053,53,32861,53,276,94,182,4,54,2,2
49153,53,32682,53,214,102,112,2,29,1,1
38031,80,38031,80,37629,3025,34604,51,24,22,29
50081,443,5325,443,11958,2983,8975,28,48,15,13
37595,443,31654,443,34423,3999,30424,52,46,24,28
50533,80,13873,80,3672,1976,1696,12,26,7,5
58730,443,58122,443,5110,950,4160,21,48,10,11
49991,53,62734,53,257,102,155,2,29,1,1
49864,53,49733,53,193,102,91,2,29,1,1
58853,443,20470,443,155516,6298,149218,174,107,49,125
49237,53,48024,53,216,110,106,2,30,1,1
64978,53,11316,53,198,102,96,2,30,1,1
56104,53,19874,53,210,110,100,2,30,1,1
27005,27015,48748,27015,894,126,768,2,30,1,1
49491,443,28351,443,1627,884,743,12,27,6,6
51221,64509,12506,64509,3564,3564,0,55,4073,55,0
64576,443,6624,443,8503,1969,6534,24,32,13,11
52093,40828,29609,40828,160,70,90,2,5,1,1
50056,27018,38815,27018,468,390,78,5,29,4,1
52129,55550,34471,55550,66,66,0,1,5,1,0
57150,53,61382,53,166,86,80,2,31,1,1
51767,80,59527,80,2169,1263,906,13,75,8,5
65425,53,21278,53,473,94,379,4,36,2,2
53542,50321,25266,50321,320,140,180,6,6,3,3
48658,53,48919,53,368,80,288,4,30,2,2
9433,443,31139,443,3299,441,2858,11,15,6,5
39175,80,7841,80,1712,1324,388,11,16,5,6
39205,53,46384,53,489,94,395,2,30,1,1
60754,40010,30483,40010,316,136,180,6,6,3,3
60956,443,57163,443,13342,9687,3655,53,17,28,25
65420,443,40711,443,3213,2242,971,19,25,9,10
49418,27017,34824,27017,255,71,184,2,31,1,1
9414,443,33463,443,5689,501,5188,14,15,7,7
65504,53,13937,53,216,94,122,2,30,1,1
49931,53,19319,53,190,97,93,2,31,1,1
56627,443,41594,443,4499,947,3552,14,25,8,6
56101,53,38415,53,194,102,92,2,31,1,1
39943,80,39943,80,424,198,226,7,142,4,3
52652,443,42861,443,283768,16167,267601,384,116,148,236
54020,443,45905,443,17529,8138,9391,39,31,17,22
36339,443,4245,443,7295,1830,5465,23,316,13,10
52128,21294,46936,21294,70,70,0,2,8,2,0
56778,443,16345,443,8654,2150,6504,20,15,11,9
47993,443,45711,443,5272,1535,3737,17,35,12,5
46140,443,48726,443,172,172,0,2,5,2,0
55771,53,49572,53,283,98,185,4,51,2,2
59282,80,59282,80,181627,17128,164499,277,15,79,198
62082,443,37456,443,2826,1618,1208,21,45,12,9
49327,443,21395,443,116686,4968,111718,116,53,31,85
43807,80,36292,80,138,78,60,2,4,1,1
56544,443,41897,443,39717,3740,35977,76,53,39,37
53127,443,49935,443,68982,15774,53208,113,45,42,71
55115,53,50368,53,313,110,203,4,35,2,2
10151,54168,22661,54168,479,150,329,2,1200,1,1
51854,13923,55002,13923,136,136,0,3,13,3,0
34720,443,52073,443,6453,2318,4135,32,84,16,16
49481,80,30554,80,11436,5021,6415,38,126,20,18
56771,53,50189,53,166,86,80,2,30,1,1
34469,53,59263,53,226,78,148,2,30,1,1
53132,29384,35704,29384,70,70,0,1,5,1,0
40500,53,40500,53,203,82,121,2,30,1,1
56479,80,1802,80,460182,11717,448465,462,135,162,300
60199,443,24633,443,5858,1511,4347,20,21,11,9
56344,53,55607,53,167,86,81,2,30,1,1
53720,443,24279,443,499,425,74,4,0,3,1
65042,53,26467,53,183,94,89,2,29,1,1
56046,53,55070,53,193,102,91,2,31,1,1
53719,443,17807,443,499,425,74,4,0,3,1
56887,53,15011,53,312,94,218,2,30,1,1
30188,17677,54608,17677,11116,4642,6474,64,1457,30,34
16230,53,64249,53,223,78,145,2,30,1,1
17860,53,17860,53,216,90,126,2,30,1,1
56038,53,12140,53,177,94,83,2,30,1,1
33643,443,12343,443,163835,28514,135321,310,153,162,148
64128,53,2686,53,193,102,91,2,30,1,1
55872,53,18177,53,177,94,83,2,30,1,1
57807,80,6054,80,1013,566,447,8,162,5,3
49529,53,23720,53,211,94,117,2,30,1,1
49176,53,50257,53,528,178,350,6,43,3,3
63235,443,19696,443,1373,734,639,17,96,10,7
52324,443,52324,443,6727,762,5965,15,26,8,7
51615,53,53355,53,207,86,121,2,30,1,1
63916,56318,49851,56318,66,66,0,2,7,2,0
49339,443,31744,443,208,70,138,4,25,2,2
51893,63924,11081,63924,70,70,0,2,8,2,0
65375,443,53764,443,2458316,102393,2355923,2942,241,1261,1681
37965,51413,17500,51413,848,252,596,4,1199,2,2
55138,53,34483,53,173,94,79,2,30,1,1
57470,22070,58715,22070,559,198,361,5,1200,4,1
60194,443,58489,443,8894,1633,7261,18,16,9,9
2267,53,57413,53,204,118,86,2,31,1,1
50363,53,11154,53,214,110,104,2,30,1,1
56437,53,21787,53,731,91,640,2,31,1,1
64685,53,31549,53,199,102,97,2,30,1,1
65461,443,11386,443,396698,11870,384828,409,16,144,265
51644,53,17659,53,195,78,117,2,30,1,1
64997,53,25843,53,166,86,80,2,30,1,1
50091,53,1529,53,172,94,78,2,31,1,1
58798,443,46435,443,5167,700,4467,16,15,7,9
44059,53,51061,53,199,94,105,2,30,1,1
56000,53,40530,53,170,87,83,2,31,1,1
57188,53,44023,53,186,95,91,2,30,1,1
55006,443,44050,443,2900,2007,893,20,36,12,8
49315,443,55462,443,160961,7302,153659,171,87,49,122
50367,443,43632,443,1630,916,714,12,25,7,5
59775,443,41953,443,4951,711,4240,15,29,8,7
27005,27444,25309,27444,893,126,767,2,30,1,1
38130,443,8733,443,717020,36766,680254,939,60,449,490
54179,443,27953,443,5037,2002,3035,14,120,7,7
50609,443,29620,443,1738,1061,677,18,94,10,8
42298,40025,58686,40025,140,78,62,2,31,1,1
65264,80,41866,80,7440,4032,3408,48,629,25,23
50273,443,63017,443,13363,4645,8718,54,241,32,22
48440,53,22120,53,198,93,105,2,30,1,1
56710,53,40167,53,195,102,93,2,31,1,1
65206,53,7490,53,816,102,714,2,30,1,1
60730,443,25640,443,5518,1221,4297,16,90,10,6
56285,443,32543,443,185763,7360,178403,201,120,68,133
53995,41985,42236,41985,70,70,0,2,7,2,0
46299,443,43257,443,648083,28117,619966,751,30,323,428
60405,64722,55660,64722,70,70,0,1,5,1,0
64631,443,8739,443,8701,3408,5293,48,256,22,26
50432,80,29144,80,318,192,126,6,27,4,2
65291,53,62097,53,247,118,129,2,30,1,1
54592,80,24898,80,1113,534,579,12,16,7,5
50907,80,50964,80,16037318,218904,15818414,13595,136,2976,10619
64404,53,7876,53,251,110,141,2,30,1,1
38122,443,65050,443,191454,11241,180213,262,42,128,134
51766,48169,32212,48169,70,70,0,1,5,1,0
55075,53,27475,53,168,78,90,2,30,1,1
49990,443,43414,443,622,210,412,10,21,4,6
55962,53,7744,53,193,102,91,2,30,1,1
40204,40003,21367,40003,156,94,62,2,30,1,1
56288,53,18039,53,210,110,100,2,30,1,1
55075,53,29760,53,178,91,87,2,30,1,1
26979,443,43734,443,7343,2586,4757,23,19,11,12
55232,53,52840,53,177,94,83,2,30,1,1
2080,7000,2080,7000,754151,15395,738756,762,16,239,523
60408,55557,8506,55557,70,70,0,1,5,1,0
50502,443,59383,443,11323,3376,7947,29,77,16,13
50541,53,14016,53,458,188,270,6,30,3,3
64560,53,45431,53,807,94,713,2,30,1,1
49752,53,46099,53,180,92,88,2,31,1,1
56149,53,12166,53,174,89,85,2,30,1,1
49539,443,38043,443,5106,1861,3245,21,143,10,11
56501,80,5186,80,300370,14101,286269,313,63,116,197
35985,443,7017,443,6250,1312,4938,23,28,12,11
56786,443,23041,443,7929,1940,5989,20,16,11,9
51914,20777,59494,20777,256,136,120,5,8,3,2
65024,53,47698,53,179,94,85,2,30,1,1
57432,53,25990,53,193,102,91,2,30,1,1
58723,443,11514,443,24079,11282,12797,44,17,22,22
41051,443,30990,443,37711,4074,33637,69,32,31,38
55048,443,61796,443,12799,3662,9137,40,50,22,18
55046,443,8809,443,23425,10763,12662,57,48,31,26
53127,30467,24380,30467,314,128,186,6,18,3,3
56752,53,41172,53,183,94,89,2,30,1,1
56217,53,53375,53,183,94,89,2,30,1,1
59786,443,7763,443,170002,17069,152933,229,48,118,111
55024,53,16229,53,179,94,85,2,30,1,1
57631,443,50238,443,16277,3466,12811,46,1801,22,24
64937,53,22410,53,182,93,89,2,31,1,1
43863,80,21010,80,2025,805,1220,12,46,7,5
64995,53,32093,53,199,102,97,2,30,1,1
56229,53,12969,53,165,86,79,2,30,1,1
37805,443,65176,443,5577,1977,3600,29,56,16,13
50409,443,27908,443,5386,4374,1012,18,34,11,7
59828,443,44871,443,306,180,126,6,29,4,2
5588,5588,0,0,3498,1872,1626,48,200,24,24
58763,53,58763,53,228,90,138,2,29,1,1
55251,53,49536,53,212,110,102,2,30,1,1
64002,53,17468,53,796,105,691,4,59,2,2
56397,53,11047,53,179,94,85,2,30,1,1
53887,443,39424,443,499,425,74,4,0,3,1
56864,53,28207,53,200,102,98,2,30,1,1
39058,443,50860,443,70,70,0,1,5,1,0
56667,53,35653,53,199,102,97,2,29,1,1
64482,53,36400,53,322,95,227,4,39,2,2
53651,47758,20351,47758,70,70,0,2,7,2,0
53822,18716,19485,18716,70,70,0,1,4,1,0
60863,443,21124,443,24452,12758,11694,39,129,23,16
60504,443,51319,443,1875,1165,710,13,28,7,6
60445,20555,43690,20555,70,70,0,2,8,2,0
58902,5223,20774,5223,308,86,222,4,13,1,3
55288,53,5668,53,196,102,94,2,30,1,1
59340,53,59340,53,215,90,125,2,30,1,1
53143,443,21953,443,4962,887,4075,15,28,9,6
50478,80,50478,80,2086,1637,449,10,19,6,4
43166,80,43166,80,26540,1137,25403,36,136,15,21
56919,53,23336,53,193,102,91,2,30,1,1
53235,443,2490,443,11111,1014,10097,24,37,10,14
49444,53,27495,53,199,94,105,2,30,1,1
52742,443,24275,443,69884,4367,65517,96,26,44,52
47821,53,47821,53,228,97,131,2,30,1,1
60792,443,58920,443,5037,1343,3694,18,45,11,7
62470,443,10717,443,38402253,1191239,37211014,39088,243,12126,26962
49823,53,25346,53,502,103,399,4,51,2,2
55706,53,9851,53,258,102,156,2,30,1,1
50900,80,32944,80,14423569,189925,14233644,12194,135,2586,9608
46159,443,12485,443,124567,6787,117780,175,263,82,93
50407,80,54250,80,1388,917,471,11,26,6,5
56476,80,31067,80,5342,1304,4038,14,134,8,6
64812,53,57206,53,347,91,256,4,56,2,2
65166,53,40990,53,211,102,109,2,30,1,1
49732,443,42008,443,27125,14251,12874,99,23,57,42
42298,40022,41026,40022,717,551,166,4,31,2,2
54644,443,54644,443,103968,5475,98493,141,18,63,78
55675,53,10351,53,195,102,93,2,30,1,1
56403,443,13577,443,1710,976,734,16,81,8,8
61571,53,17660,53,211,78,133,2,30,1,1
49709,53,49112,53,466,93,373,4,50,2,2
55013,53,33517,53,821,102,719,2,30,1,1
56363,2710,2278,2710,1222,747,475,10,25,5,5
49876,53,41654,53,199,102,97,2,30,1,1
59468,80,3821,80,1594,1280,314,10,15,5,5
57019,53,12115,53,186,95,91,2,30,1,1
64505,53,32135,53,214,102,112,2,30,1,1
63026,53,55076,53,304,86,218,2,30,1,1
53898,12172,38766,12172,70,70,0,1,4,1,0
50587,443,51277,443,1198,716,482,12,98,7,5
55757,53,45063,53,177,94,83,2,30,1,1
55833,53,32426,53,177,94,83,2,30,1,1
62043,80,35524,80,3466,665,2801,14,16,7,7
39820,443,15397,443,2642442,95056,2547386,2730,3629,999,1731
57938,443,57938,443,27787,5566,22221,60,47,31,29
49326,53,56607,53,193,102,91,2,31,1,1
53706,80,53481,80,1398,590,808,9,111,6,3
53647,16194,38859,16194,70,70,0,1,5,1,0
55251,53,62666,53,208,106,102,2,31,1,1
27186,53,27186,53,821,97,724,2,30,1,1
61474,443,20361,443,114674,4457,110217,127,48,46,81
59888,80,59888,80,55739,967,54772,53,15,13,40
50510,53,6283,53,734,94,640,2,30,1,1
63930,44330,31365,44330,70,70,0,1,5,1,0
49597,80,42235,80,130,70,60,2,15,1,1
52173,443,52173,443,201007,10015,190992,239,22,100,139
56955,53,2081,53,182,93,89,2,31,1,1
57290,53,13860,53,178,94,84,2,30,1,1
49298,53,53447,53,230,102,128,2,30,1,1
61583,80,61583,80,12301,1642,10659,20,20,9,11
52838,443,32099,443,207289,9233,198056,234,136,83,151
64648,53,9787,53,215,94,121,2,30,1,1
9486,443,47731,443,3642,421,3221,12,16,6,6
56364,443,6103,443,3775,1791,1984,24,203,12,12
55337,53,11833,53,294,106,188,4,56,2,2
65343,53,12113,53,184,94,90,2,30,1,1
50826,80,48832,80,35970,11674,24296,108,265,55,53
49869,80,37142,80,2125,1041,1084,11,87,6,5
56733,443,4067,443,7941,1952,5989,20,15,11,9
56126,53,5534,53,177,94,83,2,30,1,1
50584,51413,41920,51413,475,150,325,2,1200,1,1
56440,53,62063,53,212,102,110,2,30,1,1
59279,80,59279,80,108786,4563,104223,192,16,65,127
50007,53,43367,53,216,110,106,2,30,1,1
49418,23010,54751,23010,288,78,210,2,30,1,1
21859,53,21859,53,242,98,144,2,30,1,1
56560,443,46506,443,84111,3300,80811,104,54,41,63
55754,53,39478,53,177,94,83,2,30,1,1
55877,53546,37144,53546,481,150,331,2,1200,1,1
52079,443,42023,443,4735,3589,1146,18,15,10,8
49772,53,51587,53,531,188,343,6,58,3,3
64831,53,56461,53,216,110,106,2,30,1,1
9418,443,37541,443,5691,503,5188,14,15,7,7
26900,27017,18355,27017,422,164,258,6,31,3,3
52788,443,21903,443,1550,834,716,19,141,10,9
48550,80,64861,80,811,671,140,6,22,4,2
56166,53,32897,53,193,102,91,2,31,1,1
39292,80,43537,80,1655,1341,314,10,16,5,5
55545,53,1793,53,821,102,719,2,30,1,1
65398,53,61803,53,212,108,104,2,30,1,1
45124,80,4219,80,1808,636,1172,16,16,8,8
55193,53,27254,53,177,94,83,2,30,1,1
64631,53,5606,53,193,102,91,2,30,1,1
9205,443,26795,443,318,192,126,6,18,4,2
65524,53,59878,53,183,94,89,2,30,1,1
60199,443,60774,443,8958,1697,7261,18,15,9,9
56892,53,3600,53,198,101,97,2,31,1,1
60796,53,56563,53,296,94,202,2,29,1,1
59018,443,37679,443,1786,172,1614,7,120,3,4
28012,443,23129,443,6388,1112,5276,18,75,9,9
50612,443,9041,443,6782,3367,3415,25,139,15,10
47744,443,50454,443,7761,2376,5385,24,256,12,12
64580,53,23762,53,199,102,97,2,30,1,1
56272,53,13597,53,193,102,91,2,31,1,1
57917,443,1119,443,6520,1550,4970,19,54,11,8
37965,16253,55858,16253,5892,3784,2108,81,3115,47,34
56245,80,56245,80,101179,1296,99883,88,15,18,70
41322,53,41322,53,244,98,146,2,32,1,1
47996,80,47996,80,1920,1471,449,10,19,6,4
52566,443,55072,443,8594,1042,7552,16,120,7,9
49537,80,13843,80,5514,3156,2358,21,66,15,6
51824,53021,41842,53021,70,70,0,1,5,1,0
57288,53,62463,53,770,101,669,2,30,1,1
45846,443,47275,443,2227,1018,1209,17,15,8,9
49439,53,56004,53,197,102,95,2,31,1,1
56964,53,17076,53,267,87,180,4,53,2,2
30960,45670,41313,45670,462,462,0,8,3632,8,0
56240,53,1263,53,226,94,132,2,29,1,1
49897,53,22937,53,384,94,290,2,30,1,1
64984,53,22465,53,177,94,83,2,30,1,1
54985,53,30088,53,177,94,83,2,30,1,1
40204,40038,53758,40038,585,86,499,2,30,1,1
50319,53,65506,53,194,102,92,2,30,1,1
64462,53,14604,53,179,94,85,2,29,1,1
48788,443,25045,443,6254,1075,5179,22,34,10,12
65300,53,9182,53,195,102,93,2,31,1,1
35101,443,31000,443,4988930,161289,4827641,5384,290,1964,3420
42597,443,21561,443,6131,1399,4732,20,979,10,10
49701,53,24977,53,197,102,95,2,30,1,1
60864,80,22050,80,10629,1104,9525,23,46,12,11
49626,53,57027,53,226,110,116,2,30,1,1
59904,53,31184,53,312,78,234,2,29,1,1
51719,13715,9141,13715,66,66,0,1,5,1,0
54787,443,54787,443,18160,6539,11621,37,19,22,15
55044,53,9273,53,192,98,94,2,30,1,1
53138,443,15464,443,6760,1346,5414,18,325,9,9
56248,53,47475,53,767,102,665,2,30,1,1
51904,51883,50262,51883,70,70,0,1,5,1,0
61676,443,64478,443,6353,1520,4833,20,17,12,8
51409,443,49977,443,394,70,324,7,31,2,5
49788,53,26549,53,302,97,205,4,43,2,2
64167,53,3978,53,211,102,109,2,29,1,1
63962,10115,10126,10115,66,66,0,2,8,2,0
30188,53,30188,53,238,95,143,2,30,1,1
65346,53,19469,53,183,94,89,2,30,1,1
51920,32678,28612,32678,70,70,0,1,5,1,0
50628,80,46976,80,1658,1247,411,8,14,5,3
64153,53,31839,53,213,94,119,2,30,1,1
51861,23919,9665,23919,70,70,0,2,7,2,0
37965,61872,44512,61872,1548,265,1283,4,1201,2,2
56847,443,59529,443,35160,6404,28756,82,196,31,51
58170,443,59368,443,12391,6068,6323,52,133,24,28
65348,53,2839,53,177,94,83,2,30,1,1
34167,80,27156,80,3643,1738,1905,17,187,10,7
65064,53,46432,53,198,102,96,2,30,1,1
64790,53,30667,53,182,93,89,2,30,1,1
50777,53,12522,53,199,94,105,2,30,1,1
49418,27016,34441,27016,263,78,185,2,29,1,1
50547,53,45838,53,210,110,100,2,30,1,1
27005,33035,15064,33035,864,126,738,2,31,1,1
57174,53,49148,53,210,94,116,2,30,1,1
53648,80,65465,80,2162,1608,554,10,34,6,4
65007,53,7048,53,165,86,79,2,30,1,1
50400,443,40237,443,316,136,180,6,6,3,3
57235,15187,23276,15187,1269359015,948477220,320881795,1036116,9283,747520,288596
57370,6969,42046,6969,70,70,0,2,8,2,0
34672,53,34672,53,213,87,126,2,30,1,1
55586,17332,8583,17332,70,70,0,1,5,1,0
56965,53,26904,53,183,94,89,2,30,1,1
56312,443,54503,443,564,292,272,9,25,5,4
60848,443,33330,443,6513,1863,4650,28,255,15,13
61409,80,63776,80,201243,14555,186688,357,158,145,212
53808,56215,39390,56215,70,70,0,2,7,2,0
53896,443,17824,443,499,425,74,4,0,3,1
59977,443,64573,443,7971,2647,5324,38,15,24,14
59936,80,54096,80,1281,399,882,10,16,6,4
55587,32217,8141,32217,320,140,180,6,6,3,3
56559,53,54246,53,711,87,624,2,31,1,1
9132,80,49560,80,318,192,126,6,30,4,2
65419,53,4348,53,295,101,194,4,31,2,2
61414,80,32431,80,22368,2947,19421,53,137,24,29
52341,80,52341,80,1928,1339,589,12,48,6,6
49156,53,49438,53,195,102,93,2,30,1,1
49589,53,21247,53,198,94,104,2,30,1,1
64941,53,34820,53,295,101,194,4,31,2,2
52023,80,55578,80,366,240,126,7,24,5,2
49915,53,47403,53,225,102,123,2,30,1,1
62791,443,22999,443,17411,8921,8490,98,291,41,57
42430,443,21880,443,3927,1425,2502,18,121,8,10
57109,53,37634,53,168,86,82,2,31,1,1
49870,53,21637,53,188,96,92,2,31,1,1
56569,443,12304,443,340595,9013,331582,345,80,119,226
56198,53,50578,53,184,102,82,2,30,1,1
56041,53,17868,53,179,94,85,2,31,1,1
50017,3389,50017,3389,3428,1714,1714,16,34,8,8
51855,443,29819,443,11894,2661,9233,32,32,18,14
42298,443,10335,443,64,64,0,1,31,1,0
65147,53,63811,53,194,102,92,2,31,1,1
50270,443,3425,443,868,514,354,13,18,8,5
65265,3389,65265,3389,4213,2429,1784,18,31,9,9
64715,53,60812,53,202,103,99,2,31,1,1
64085,53,40904,53,195,94,101,2,31,1,1
37636,443,48056,443,9658,2602,7056,32,66,14,18
54369,443,44287,443,11876,2769,9107,30,77,15,15
51887,16514,22575,16514,70,70,0,2,8,2,0
63848,80,63848,80,555419,4827,550592,451,21,64,387
26900,27017,18578,27017,422,164,258,6,30,3,3
65152,53,2972,53,763,102,661,2,30,1,1
64415,53,14789,53,228,102,126,2,30,1,1
11295,40002,59394,40002,209,85,124,4,34,2,2
27005,27018,47282,27018,891,126,765,2,31,1,1
60438,17148,53794,17148,70,70,0,2,8,2,0
64714,53,62163,53,289,134,155,2,30,1,1
57201,53,44480,53,165,86,79,2,30,1,1
63944,8999,33141,8999,66,66,0,2,8,2,0
50454,80,32603,80,4185,3618,567,14,34,8,6
35515,53,35515,53,235,98,137,2,30,1,1
50368,80,46672,80,318,192,126,6,28,4,2
50985,443,12787,443,8007,3336,4671,19,78,11,8
37570,443,49846,443,499,425,74,4,0,3,1
55107,53,25498,53,184,94,90,2,30,1,1
49286,53,40231,53,184,94,90,2,31,1,1
63758,443,30040,443,3263,1643,1620,9,119,5,4
49418,30008,26844,30008,236,78,158,2,30,1,1
52102,19604,31294,19604,66,66,0,1,5,1,0
1929,53,20387,53,260,86,174,2,30,1,1
56596,53,31877,53,350,94,256,2,30,1,1
36144,443,36144,443,170890,13800,157090,246,97,123,123
56711,53,8899,53,209,110,99,2,30,1,1
59283,53,37048,53,359,86,273,2,30,1,1
55475,53,28600,53,757,102,655,2,29,1,1
64967,53,49030,53,184,94,90,2,31,1,1
39630,443,32291,443,70,70,0,1,5,1,0
56044,80,25395,80,1515,481,1034,11,16,6,5
60758,53,57238,53,199,94,105,2,30,1,1
55224,53,43043,53,182,94,88,2,30,1,1
64903,53,4073,53,210,110,100,2,30,1,1
50584,9301,1872,9301,498,150,348,4,2396,2,2
12011,443,12011,443,6981,948,6033,17,27,10,7
49428,53,23705,53,200,94,106,2,30,1,1
8917,443,55362,443,7308,864,6444,26,394,9,17
53895,36849,47178,36849,70,70,0,1,4,1,0
34440,53,34440,53,235,90,145,2,32,1,1
64709,53,47288,53,353,118,235,2,30,1,1
55170,53,27773,53,250,94,156,2,30,1,1
37564,443,36169,443,499,425,74,4,0,3,1
6881,6889,31599,6889,221,111,110,2,1200,1,1
49944,80,49944,80,220279,13007,207272,266,22,115,151
53128,29593,52824,29593,70,70,0,1,4,1,0
60405,443,60867,443,6570,1988,4582,19,57,10,9
15164,53,15164,53,217,82,135,2,31,1,1
55636,443,29047,443,13506,5979,7527,39,127,20,19
56747,443,61148,443,8059,2039,6020,20,16,11,9
54497,443,48697,443,8318,2068,6250,32,270,16,16
60489,53151,11462,53151,70,70,0,1,5,1,0
52332,443,52332,443,960,539,421,9,52,5,4
55133,53,36178,53,184,102,82,2,31,1,1
55224,53,33137,53,209,110,99,2,30,1,1
58174,443,55907,443,11141,2777,8364,33,58,14,19
49939,53,36312,53,384,103,281,4,50,2,2
56711,53,31656,53,202,103,99,2,31,1,1
57622,7000,57622,7000,2343,856,1487,17,16,10,7
64114,443,8780,443,1411,852,559,13,24,7,6
57447,443,62052,443,7847,1377,6470,27,15,12,15
50524,80,58944,80,102242,12176,90066,149,156,68,81
56755,53,26920,53,184,94,90,2,31,1,1
50463,80,63271,80,214,140,74,4,15,3,1
55462,53,64670,53,214,110,104,2,29,1,1
49751,80,48363,80,1876,998,878,12,15,7,5
52101,80,34628,80,55117,3792,51325,69,36,29,40
50679,80,21512,80,132,132,0,2,8,2,0
17932,53,17932,53,213,87,126,2,30,1,1
61645,443,61645,443,4702,1795,2907,19,28,11,8
62873,443,13983,443,3049,988,2061,14,135,7,7
43719,53,43719,53,295,90,205,2,30,1,1
57139,53,32218,53,166,86,80,2,30,1,1
49564,443,50036,443,180388,3938,176450,145,161,20,125
9435,443,2463,443,5693,499,5194,14,15,7,7
49160,51413,10192,51413,800,150,650,4,1200,2,2
10102,443,2452,443,5415,864,4551,19,360,9,10
41157,443,35776,443,78535,3648,74887,94,30,41,53
30188,56962,59522,56962,2746,1487,1259,21,2495,14,7
36386,443,8343,443,1209,709,500,14,28,8,6
65164,53,40444,53,265,102,163,2,29,1,1
49517,80,14591,80,6123,3105,3018,16,38,8,8
55934,53,39869,53,196,102,94,2,31,1,1
48689,443,50166,443,9681,2243,7438,35,24,18,17
51862,80,9823,80,6106,5420,686,13,30,7,6
57444,53,35555,53,177,94,83,2,29,1,1
49349,80,16332,80,2391,532,1859,11,76,6,5
48346,443,9051,443,2272788,106549,2166239,2492,190,850,1642
43057,443,23412,443,7725,1980,5745,25,20,14,11
59476,443,42006,443,4697,923,3774,13,120,6,7
52396,443,30033,443,1253628,61672,1191956,1875,220,939,936
57007,53,19153,53,183,94,89,2,31,1,1
49523,53,19380,53,314,93,221,4,43,2,2
55363,443,55363,443,5458,2211,3247,22,39,13,9
56930,53,11324,53,297,94,203,2,30,1,1
54627,443,30890,443,182017,6621,175396,189,181,55,134
64403,53,35591,53,186,95,91,2,31,1,1
53975,40978,50066,40978,1946,1019,927,10,15,6,4
49416,53,31346,53,177,94,83,2,31,1,1
50589,53,31342,53,177,94,83,2,29,1,1
64935,53,15324,53,193,102,91,2,31,1,1
56660,443,63035,443,8006,1986,6020,20,15,11,9
64531,53,13391,53,754,94,660,2,30,1,1
37715,53,37715,53,235,90,145,2,32,1,1
64839,53,42360,53,212,110,102,2,30,1,1
64694,53,22388,53,289,82,207,4,46,2,2
49413,443,7382,443,44505,6962,37543,64,48,21,43
57009,80,12239,80,214,140,74,4,30,3,1
57584,443,53316,443,915797,52405,863392,1231,269,604,627
55254,443,18680,443,13275,3587,9688,38,27,20,18
49672,80,15007,80,3749,2453,1296,15,41,9,6
57054,53,52774,53,241,94,147,2,29,1,1
44385,53,19261,53,212,78,134,2,30,1,1
49297,53,44299,53,183,94,89,2,30,1,1
50048,443,29440,443,6887,2473,4414,20,15,11,9
50128,80,27649,80,20575,11455,9120,92,966,47,45
65349,53,30593,53,772,103,669,2,31,1,1
50517,80,63449,80,5997,1327,4670,18,157,10,8
51307,80,27411,80,5912,5182,730,15,23,9,6
35754,80,35754,80,141193,10612,130581,165,30,69,96
56665,443,57309,443,1299,730,569,13,25,7,6
39994,80,41282,80,2387,930,1457,14,16,7,7
55570,53,55501,53,341,134,207,2,30,1,1
57007,5333,59200,5333,7194101,1949033,5245068,50585,1008,24913,25672
52001,12514,13607,12514,66,66,0,1,5,1,0
46624,80,46624,80,34504,2526,31978,45,156,16,29
49996,53,3311,53,458,188,270,6,31,3,3
49812,53,4769,53,166,86,80,2,30,1,1
64289,53,24247,53,198,101,97,2,30,1,1
64823,53,30935,53,508,102,406,2,30,1,1
37297,443,46820,443,232,172,60,3,5,2,1
36672,53,36672,53,234,93,141,2,30,1,1
56615,443,31008,443,7982,1962,6020,20,15,11,9
64305,53,21382,53,598,196,402,6,71,3,3
6755,53,6755,53,247,98,149,2,32,1,1
56688,53,52079,53,196,102,94,2,31,1,1
53867,443,58511,443,499,425,74,4,1,3,1
51874,43161,26415,43161,66,66,0,1,5,1,0
54818,3389,54818,3389,3409,1454,1955,16,16,8,8
49673,5223,52043,5223,4266,1448,2818,22,3088,13,9
56785,443,18418,443,288525,15601,272924,383,33,193,190
51464,443,62248,443,7269,1978,5291,28,39,14,14
51612,443,60658,443,5677,918,4759,18,15,10,8
45987,123,19536,123,184,94,90,2,30,1,1
50436,443,10408,443,18959,3307,15652,33,19,16,17
55437,443,17546,443,6622,859,5763,18,15,10,8
64930,53,64696,53,186,95,91,2,31,1,1
42076,443,63627,443,22106,5214,16892,23,128,9,14
53009,80,53009,80,378,180,198,7,17,4,3
57430,53,14392,53,200,102,98,2,29,1,1
56385,53,50019,53,249,85,164,4,56,2,2
62765,443,43288,443,52223,3318,48905,75,321,30,45
2085,7010,2085,7010,3342,1983,1359,16,15,8,8
41031,80,41031,80,2791,1259,1532,13,125,7,6
49523,53,10736,53,728,96,632,2,30,1,1
48883,53,16845,53,168,78,90,2,30,1,1
58601,53,45683,53,198,86,112,2,30,1,1
56367,53,12261,53,900,110,790,2,29,1,1
50211,1688,3994,1688,70,70,0,1,4,1,0
65379,443,56474,443,4514,2844,1670,29,84,14,15
64917,53,1366,53,243,94,149,2,30,1,1
44545,443,4712,443,546,280,266,9,26,5,4
58768,17,58768,17,66,66,0,1,30,1,0
42520,443,59710,443,6795,2090,4705,27,21,15,12
6881,26171,65454,26171,219,118,101,2,1199,1,1
41000,443,2288,443,6237,1811,4426,22,22,12,10
49420,443,10802,443,4932,1046,3886,21,173,10,11
47832,443,4961,443,130090,7064,123026,184,200,92,92
65003,27046,30438,27046,1749,924,825,6,31,3,3
50583,53,30118,53,783,96,687,2,30,1,1
52130,1035,52488,1035,66,66,0,1,5,1,0
9138,80,8999,80,318,192,126,6,29,4,2
43112,443,7009,443,3197,1931,1266,19,15,9,10
49616,443,57635,443,7238,2601,4637,20,17,10,10
56370,443,46541,443,3715,1791,1924,23,203,12,11
55646,53,7208,53,216,94,122,2,30,1,1
27005,32056,54567,32056,886,126,760,2,31,1,1
55582,53,15587,53,168,86,82,2,30,1,1
51650,80,8862,80,2681,1044,1637,22,255,12,10
51329,443,55771,443,2019,1219,800,15,17,8,7
49500,443,37954,443,1197,620,577,13,27,6,7
27005,27015,51947,27015,879,126,753,2,30,1,1
33108,22,33108,22,7930,3351,4579,56,38,27,29
43818,80,62769,80,2005,715,1290,8,15,5,3
55705,53,57706,53,202,103,99,2,31,1,1
60779,40010,64094,40010,316,136,180,6,5,3,3
65220,53,8622,53,178,94,84,2,29,1,1
65061,53,31774,53,299,103,196,4,33,2,2
34436,80,7684,80,6260,696,5564,17,15,9,8
50673,80,12286,80,20265,5748,14517,34,23,16,18
50236,443,16316,443,4954,1768,3186,18,143,9,9
51950,17499,60701,17499,66,66,0,1,5,1,0
65114,53,28927,53,196,102,94,2,30,1,1
49730,53,58094,53,767,102,665,2,30,1,1
64266,53,27142,53,168,86,82,2,30,1,1
53257,443,20854,443,7422,1563,5859,32,53,15,17
52571,80,52571,80,10947,876,10071,21,142,9,12
46280,443,46280,443,4754,1847,2907,19,26,11,8
64994,53,18089,53,216,102,114,2,30,1,1
49747,53,62194,53,355,102,253,2,30,1,1
49535,53,29045,53,771,102,669,2,30,1,1
53829,443,25937,443,499,425,74,4,0,3,1
28699,53,53419,53,278,86,192,2,30,1,1
60443,50284,54263,50284,164,70,94,2,5,1,1
50548,80,23213,80,378,192,186,7,21,4,3
43674,53,36130,53,199,94,105,2,30,1,1
56408,443,36804,443,17704,1456,16248,25,123,11,14
56500,80,50985,80,177736,11174,166562,198,63,77,121
56725,443,10503,443,7889,1900,5989,20,15,11,9
49418,443,14696,443,318,192,126,6,16,4,2
52020,28704,61808,28704,70,70,0,1,5,1,0
50586,80,48187,80,6718,3126,3592,16,78,8,8
9522,443,6233,443,6146,709,5437,18,29,8,10
27005,30002,14816,30002,1652,126,1526,4,31,2,2
50678,80,40361,80,300,174,126,5,15,3,2
50603,80,50603,80,1706,1006,700,11,21,6,5
65414,53,56360,53,216,102,114,2,30,1,1
57470,32554,26489,32554,726,726,0,12,1199,12,0
63942,53,65464,53,214,102,112,2,30,1,1
55747,53,24250,53,258,102,156,2,30,1,1
54501,80,17667,80,254,128,126,5,16,3,2
38084,443,21809,443,2697,1520,1177,21,182,10,11
49800,53,49800,53,235,90,145,2,33,1,1
56806,46903,25071,46903,3060,1569,1491,12,17,7,5
44564,22,44564,22,5130,2103,3027,28,21,16,12
58115,53,48692,53,578,286,292,9,15,5,4
50688,5222,17560,5222,622,284,338,10,29,5,5
55821,53,40940,53,168,86,82,2,30,1,1
52142,443,7937,443,9911,2041,7870,34,120,17,17
57470,43836,52896,43836,402,132,270,6,1209,3,3
49780,53,7446,53,182,93,89,2,31,1,1
52075,37919,58563,37919,70,70,0,2,8,2,0
55699,53,30470,53,271,103,168,4,59,2,2
51981,80,47640,80,48165,2605,45560,63,15,31,32
56813,53,9920,53,516,136,380,4,40,2,2
49750,443,8728,443,7370,1474,5896,19,128,10,9
55102,53,47869,53,195,102,93,2,30,1,1
37087,80,29544,80,946,531,415,11,296,6,5
49844,53,19437,53,734,102,632,2,30,1,1
55179,53,2667,53,178,94,84,2,31,1,1
53844,16925,27697,16925,940,502,438,14,18,7,7
63714,48477,18811,48477,70,70,0,1,4,1,0
49891,53,6545,53,375,126,249,2,30,1,1
54449,443,31656,443,128477,6347,122130,155,276,56,99
62768,443,53717,443,30902,6307,24595,86,269,36,50
53230,443,53230,443,1462,916,546,13,34,7,6
50684,80,24128,80,57576,29602,27974,239,175,118,121
49520,53,8068,53,209,110,99,2,29,1,1
55910,53,26815,53,183,94,89,2,30,1,1
51111,80,8917,80,366,240,126,7,21,5,2
63381,443,50807,443,11344,5681,5663,34,3601,20,14
64711,53,52164,53,178,94,84,2,29,1,1
55040,53,40859,53,762,98,664,2,31,1,1
57016,53,13360,53,266,110,156,2,30,1,1
49205,80,50738,80,890,411,479,11,15,6,5
54573,80,38100,80,2091,823,1268,12,45,7,5
58050,80,17128,80,318,192,126,6,20,4,2
49818,53,37745,53,86,86,0,1,30,1,0
39719,443,7093,443,450036,17745,432291,541,217,241,300
53197,443,58160,443,1462,965,497,13,18,7,6
60303,443,13935,443,3928,2467,1461,27,144,14,13
55051,443,30290,443,6975,1243,5732,29,254,14,15
60989,443,11071,443,7592,2966,4626,26,15,15,11
55101,53,47277,53,197,102,95,2,30,1,1
50343,80,49722,80,22233,10123,12110,37,28,16,21
56127,53,8590,53,166,85,81,2,31,1,1
27005,27018,44540,27018,882,126,756,2,30,1,1
51635,80,49291,80,318,192,126,6,39,4,2
63787,18318,22110,18318,70,70,0,1,5,1,0
26900,27017,30872,27017,422,164,258,6,29,3,3
41861,5223,49797,5223,5169,1103,4066,26,214,10,16
50031,53,36003,53,386,134,252,2,30,1,1
60414,52559,64596,52559,70,70,0,2,8,2,0
49646,53,5301,53,199,102,97,2,30,1,1
52270,3708,62556,3708,316,136,180,6,6,3,3
64967,27051,5112,27051,1020,462,558,4,29,2,2
65026,53,1071,53,194,102,92,2,30,1,1
48817,51413,48817,51413,479,152,327,2,1200,1,1
60413,443,19866,443,9398,2320,7078,24,77,13,11
56799,443,47229,443,8021,2001,6020,20,15,11,9
52892,443,17240,443,41925,30922,11003,68,186,38,30
35506,80,16634,80,120,60,60,3,3600,2,1
64287,53,8601,53,181,94,87,2,31,1,1
55999,53,41388,53,774,101,673,2,30,1,1
56134,53,39668,53,93,93,0,1,30,1,0
41230,443,4213,443,234,234,0,4,11,4,0
56679,443,4543,443,7941,1952,5989,20,15,11,9
52802,53,8957,53,350,210,140,6,14,4,2
64813,16385,22226,16385,432,192,240,8,30,4,4
36716,53,54815,53,224,78,146,2,31,1,1
64281,53,44626,53,214,110,104,2,30,1,1
56407,53,58288,53,216,102,114,2,29,1,1
60235,443,27735,443,7990,1730,6260,25,151,13,12
65398,53,64087,53,811,94,717,2,29,1,1
58044,80,31147,80,2742,1116,1626,11,20,6,5
41002,53,33121,53,164,78,86,2,30,1,1
50584,54741,14563,54741,868,150,718,4,1200,2,2
26229,80,26229,80,7372,954,6418,17,18,9,8
33610,443,59796,443,9490,1158,8332,24,257,13,11
55578,45682,64868,45682,70,70,0,1,5,1,0
50076,443,58457,443,9920,5013,4907,41,15,25,16
50265,40448,36258,40448,2118,858,1260,28,1274,14,14
47749,53,47749,53,248,106,142,2,30,1,1
60763,40010,33856,40010,316,136,180,6,6,3,3
52065,443,43327,443,7851,2487,5364,35,383,16,19
57296,53,58059,53,200,102,98,2,29,1,1
56743,53,42878,53,816,97,719,2,30,1,1
57275,53,57275,53,217,86,131,2,30,1,1
57470,51745,40205,51745,3214,1260,1954,33,1371,17,16
55039,443,37835,443,19775,1890,17885,40,80,17,23
56994,53,35888,53,177,94,83,2,30,1,1
49843,53,31745,53,186,95,91,2,31,1,1
50537,80,34758,80,4186,3559,627,15,31,8,7
56673,53,29686,53,193,102,91,2,30,1,1
58794,443,62373,443,5166,700,4466,16,15,7,9
59409,443,2486,443,7775,3174,4601,25,16,11,14
51813,63933,44889,63933,66,66,0,1,5,1,0
57267,443,26309,443,126,60,66,3,6,2,1
48513,443,48513,443,4566,1659,2907,19,27,11,8
50265,18417,40558,18417,7282,4118,3164,57,1696,35,22
64571,443,18253,443,9155,2109,7046,27,31,15,12
27005,27017,27810,27017,890,126,764,2,30,1,1
64955,443,38956,443,2279,1129,1150,25,120,12,13
27005,27015,45876,27015,886,126,760,2,30,1,1
55840,53,8081,53,177,94,83,2,30,1,1
27005,1103,38860,1103,822,126,696,2,30,1,1
55862,53,22118,53,177,94,83,2,30,1,1
65037,53,26531,53,210,110,100,2,29,1,1
56950,53,2496,53,183,94,89,2,30,1,1
64550,53,62266,53,221,94,127,2,29,1,1
27005,32073,35249,32073,884,126,758,2,31,1,1
55050,443,54563,443,126,60,66,3,5,2,1
56616,80,15252,80,234,234,0,4,12,4,0
55996,53,10816,53,168,86,82,2,30,1,1
54444,443,16103,443,6275,3787,2488,17,147,8,9
49250,53,62470,53,298,87,211,4,48,2,2
55644,53,55094,53,184,94,90,2,30,1,1
57563,443,58695,443,10044,2134,7910,42,34,23,19
49800,53,17712,53,87,87,0,1,30,1,0
56340,53,14544,53,196,100,96,2,31,1,1
49291,53,35462,53,212,102,110,2,29,1,1
58926,443,61395,443,5329,3428,1901,20,16,10,10
65428,53,15132,53,195,102,93,2,29,1,1
52173,44632,63328,44632,258,70,188,4,9,2,2
50730,53,50730,53,228,97,131,2,30,1,1
65020,53,8823,53,184,94,90,2,31,1,1
49896,53,58946,53,772,102,670,2,30,1,1
65114,53,35237,53,192,98,94,2,30,1,1
50405,53,35754,53,200,102,98,2,30,1,1
63948,53,52448,53,366,102,264,4,60,2,2
52048,44059,61296,44059,258,70,188,4,8,2,2
53922,42285,1496,42285,70,70,0,1,4,1,0
10014,443,17937,443,3876,2012,1864,21,315,10,11
55044,53,47229,53,168,78,90,2,30,1,1
47971,443,15056,443,130,70,60,2,15,1,1
57862,443,61289,443,448344,11729,436615,474,157,128,346
60434,11339,49665,11339,70,70,0,2,8,2,0
55877,53,16386,53,164,84,80,2,30,1,1
49888,53,1710,53,198,102,96,2,29,1,1
44586,443,61467,443,122708,5797,116911,169,132,75,94
49840,443,9507,443,58656,12994,45662,148,71,64,84
55245,53,61157,53,209,110,99,2,29,1,1
63459,443,63459,443,4506,1599,2907,19,28,11,8
54968,53,59501,53,199,102,97,2,30,1,1
55615,53,40819,53,225,110,115,2,30,1,1
57188,53,2618,53,744,89,655,2,30,1,1
50584,64027,41636,64027,166,166,0,1,1199,1,0
57441,53,16567,53,177,94,83,2,29,1,1
55729,53,41477,53,256,96,160,4,41,2,2
35702,443,51381,443,13428,5815,7613,42,995,22,20
57565,443,12958,443,3586,1074,2512,17,137,8,9
60506,56243,34455,56243,70,70,0,2,8,2,0
55989,53,12782,53,821,102,719,2,30,1,1
53581,12169,27472,12169,492,306,186,8,15,5,3
63937,43443,33286,43443,246,66,180,4,7,2,2
49818,53,62354,53,751,94,657,2,30,1,1
48713,80,15220,80,3588672,75353,3513319,3500,154,1175,2325
56925,53,26704,53,275,110,165,2,29,1,1
64780,53,56336,53,203,86,117,2,29,1,1
52226,48784,61623,48784,70,70,0,1,5,1,0
39924,443,50465,443,5229,1002,4227,21,16,11,10
50645,53,43858,53,256,93,163,2,31,1,1
52030,443,43838,443,9090,1914,7176,24,25,13,11
26929,443,8333,443,7487,2728,4759,25,19,13,12
57004,80,5611,80,214,140,74,4,30,3,1
50134,53,40420,53,733,86,647,2,31,1,1
53832,56005,63005,56005,70,70,0,1,4,1,0
0,0,0,0,244,244,0,2,0,2,0
49003,53,49003,53,262,106,156,2,32,1,1
45898,443,17048,443,814431,31637,782794,913,315,346,567
65071,53,11229,53,93,93,0,2,60,2,0
50336,80,50336,80,2143,676,1467,12,25,7,5
55600,80,11201,80,70,70,0,2,8,2,0
55596,53,37319,53,188,96,92,2,31,1,1
36145,443,14544,443,1439,878,561,15,17,10,5
60427,80,8033,80,186,64,122,4,28,2,2
49256,53,47190,53,177,94,83,2,30,1,1
56063,53,29074,53,196,102,94,2,31,1,1
57258,53,12137,53,757,98,659,2,31,1,1
57265,53,29608,53,200,102,98,2,31,1,1
43163,443,21681,443,10100,3072,7028,25,16,14,11
65374,53,60025,53,261,102,159,2,30,1,1
65511,443,62661,443,430254,12640,417614,442,16,155,287
56975,53,53582,53,194,99,95,2,30,1,1
60461,10138,55813,10138,70,70,0,2,8,2,0
55056,443,30880,443,5233,3384,1849,21,62,11,10
65443,80,29432,80,366,180,186,7,28,4,3
1736,80,1736,80,101959,5508,96451,111,95,41,70
57044,53,35705,53,197,102,95,2,30,1,1
51738,47483,28405,47483,70,70,0,2,8,2,0
6259,25,6259,25,130,66,64,2,5,1,1
63593,443,12181,443,36819,3967,32852,59,152,30,29
11906,53,11906,53,220,90,130,2,30,1,1
65037,53,14259,53,243,94,149,2,30,1,1
39622,53,25768,53,168,78,90,2,30,1,1
56268,443,24537,443,10226,4435,5791,50,256,24,26
137,137,54849,137,96,96,0,2,31,2,0
64385,53,34139,53,174,89,85,2,30,1,1
60984,443,58411,443,12163,4876,7287,35,50,20,15
55786,53,42852,53,200,102,98,2,30,1,1
53717,443,48427,443,318,192,126,6,15,4,2
57290,53,48036,53,758,93,665,2,30,1,1
57470,50321,60490,50321,5231,5231,0,79,5173,79,0
58890,53,58890,53,198,90,108,2,30,1,1
50521,443,9816,443,11880,1972,9908,29,78,15,14
63937,53,1528,53,183,94,89,2,29,1,1
64127,53,58268,53,177,94,83,2,30,1,1
52089,443,56891,443,4408,801,3607,16,34,8,8
49722,53,40518,53,200,102,98,2,31,1,1
62005,80,62005,80,11822,1162,10660,22,20,11,11
38056,443,15075,443,9528,2738,6790,27,81,15,12
65448,443,34387,443,3224,2373,851,17,23,9,8
56808,443,31717,443,7981,1961,6020,20,15,11,9
49781,53,14753,53,194,102,92,2,30,1,1
52059,47363,50172,47363,70,70,0,2,8,2,0
59740,53,42403,53,304,86,218,2,30,1,1
30960,45665,23931,45665,462,462,0,8,3632,8,0
57097,443,3043,443,3578432,133577,3444855,4291,426,1634,2657
65425,53,4149,53,402,142,260,2,30,1,1
56376,53,45759,53,196,100,96,2,30,1,1
65099,53,38778,53,199,102,97,2,29,1,1
57615,80,57615,80,126266,7980,118286,126,25,37,89
56275,53,11893,53,170,87,83,2,30,1,1
36889,80,51153,80,1584,1130,454,15,39,10,5
60217,80,28538,80,21163,16003,5160,47,151,30,17
51943,80,43908,80,306,120,186,6,27,3,3
49349,80,23734,80,185645,6753,178892,213,81,89,124
63009,443,26712,443,304,86,218,2,29,1,1
49490,53,51051,53,246,94,152,2,30,1,1
64649,53,56977,53,184,94,90,2,30,1,1
62685,443,28394,443,7023,2352,4671,18,75,10,8
65486,443,40088,443,375786,11380,364406,388,16,137,251
50504,53,13475,53,168,86,82,2,31,1,1
49740,53,60867,53,341,85,256,4,42,2,2
51723,10622,43836,10622,70,70,0,2,8,2,0
53246,443,53246,443,1419,788,631,15,121,8,7
49928,53,49928,53,229,90,139,2,30,1,1
54894,443,28940,443,9829,2313,7516,37,25,19,18
57089,53,22992,53,239,94,145,2,29,1,1
53963,6882,6880,6882,70,70,0,1,5,1,0
55088,53,21749,53,177,94,83,2,30,1,1
63950,53,3217,53,348,102,246,4,39,2,2
53969,13156,38324,13156,70,70,0,2,7,2,0
55622,33342,63556,33342,70,70,0,2,8,2,0
65176,53,35354,53,511,195,316,6,56,3,3
38017,7275,45146,7275,4615,664,3951,15,15,9,6
27005,27016,47379,27016,882,126,756,2,30,1,1
37857,443,49755,443,7051,5086,1965,32,100,18,14
57909,80,13139,80,6510,1210,5300,15,18,8,7
45992,443,45992,443,1494,898,596,12,142,6,6
49283,53,8368,53,251,102,149,2,30,1,1
49418,27016,14268,27016,236,71,165,2,30,1,1
64959,53,64959,53,398,255,143,3,33,2,1
49418,27015,26832,27015,248,78,170,2,30,1,1
51798,443,51798,443,14904,6448,8456,33,30,18,15
56896,53,19605,53,256,87,169,2,30,1,1
55635,53,55478,53,177,94,83,2,29,1,1
47264,443,35933,443,7201,3870,3331,33,315,17,16
55166,53,22324,53,177,94,83,2,30,1,1
50574,80,28738,80,318,192,126,6,25,4,2
64252,53,2072,53,199,102,97,2,30,1,1
65204,443,43176,443,1786,172,1614,7,120,3,4
64721,53,36880,53,212,108,104,2,30,1,1
60033,443,16938,443,2845,1765,1080,15,142,8,7
55209,53,7531,53,196,102,94,2,33,1,1
51839,27256,26214,27256,70,70,0,2,7,2,0
60382,62582,18649,62582,70,70,0,2,8,2,0
55605,53,8941,53,711,87,624,2,30,1,1
56658,53,20785,53,177,94,83,2,29,1,1
49170,443,23155,443,7743,1601,6142,18,16,10,8
56738,53,38791,53,821,102,719,2,30,1,1
51886,35965,10726,35965,70,70,0,2,8,2,0
49206,53,42939,53,179,94,85,2,31,1,1
50861,3389,50861,3389,4241,2521,1720,18,32,10,8
49597,53,64001,53,216,102,114,2,30,1,1
42298,40029,56928,40029,208,86,122,4,29,2,2
49285,53,48057,53,168,78,90,2,30,1,1
36815,443,48632,443,416,210,206,7,29,4,3
50619,80,32397,80,499,192,307,6,26,4,2
64217,53,33943,53,193,102,91,2,30,1,1
6882,6889,19915,6889,492,150,342,2,1200,1,1
51877,13472,45197,13472,66,66,0,1,5,1,0
55664,53,37409,53,195,102,93,2,30,1,1
49601,53,30637,53,178,94,84,2,30,1,1
50083,80,45276,80,38045,26409,11636,105,476,68,37
15986,8000,55980,8000,274,150,124,4,60,2,2
45721,443,58682,443,1925,1120,805,16,25,9,7
42298,40009,56378,40009,148,86,62,2,29,1,1
55312,53,10081,53,190,97,93,2,30,1,1
63949,53,59282,53,190,97,93,2,31,1,1
56621,53,30051,53,177,94,83,2,31,1,1
56417,53,7039,53,389,126,263,2,30,1,1
37965,35771,32766,35771,481,150,331,2,1199,1,1
64055,53,48031,53,501,94,407,4,52,2,2
55072,53,58133,53,168,86,82,2,30,1,1
49703,80,27292,80,71256,962,70294,63,52,11,52
49248,53,1565,53,301,90,211,4,46,2,2
55179,443,6638,443,5839,1984,3855,19,18,11,8
57804,443,57804,443,4378,1471,2907,19,26,11,8
54796,443,9714,443,6668,1926,4742,20,15,11,9
55581,64301,29198,64301,316,190,126,5,15,3,2
49563,80,54340,80,1515,481,1034,11,15,6,5
50118,443,10177,443,125395,8711,116684,178,143,83,95
49997,53,42691,53,209,110,99,2,29,1,1
59165,53,3627,53,320,94,226,2,30,1,1
55655,53,4325,53,524,214,310,6,57,3,3
64046,53,35754,53,259,110,149,2,29,1,1
26900,27017,24961,27017,168,82,86,2,30,1,1
42770,443,4955,443,8820,2996,5824,27,95,14,13
56281,53,7565,53,177,94,83,2,30,1,1
63793,48970,37925,48970,66,66,0,2,7,2,0
56488,80,17378,80,64702,3709,60993,76,135,30,46
53765,443,24226,443,16482,9312,7170,39,141,19,20
54977,443,46620,443,322265,12756,309509,409,270,173,236
2267,53,1505,53,204,118,86,2,30,1,1
54557,80,41721,80,2091,799,1292,10,15,6,4
60896,53,29321,53,168,78,90,2,31,1,1
35422,443,35422,443,5172,1925,3247,22,39,13,9
60899,443,59717,443,847673,42767,804906,1045,89,441,604
60392,1134,52281,1134,70,70,0,2,8,2,0
54982,53,55508,53,282,96,186,4,48,2,2
59574,443,1442,443,2582500,86854,2495646,2678,84,986,1692
30188,51419,27819,51419,502,150,352,2,1200,1,1
54658,443,29655,443,40096,3155,36941,50,135,19,31
62042,80,65130,80,10924,548,10376,17,48,6,11
49301,443,5775,443,6550,1836,4714,25,46,15,10
27005,27013,37862,27013,869,126,743,2,30,1,1
46671,53,46671,53,832,106,726,2,30,1,1
50456,80,33099,80,4473,3398,1075,14,34,8,6
50967,80,65454,80,1439,697,742,12,35,6,6
6881,35179,42052,35179,228,118,110,2,1199,1,1
65106,53,17651,53,354,94,260,2,29,1,1
44815,443,9189,443,7570,1955,5615,24,1179,12,12
64787,53,24820,53,740,93,647,2,31,1,1
55555,53,24469,53,194,102,92,2,30,1,1
48935,443,24879,443,12753,6074,6679,44,88,23,21
49319,53,3849,53,198,101,97,2,30,1,1
64312,53,26634,53,202,103,99,2,31,1,1
59826,443,57652,443,7284,1079,6205,29,53,13,16
53279,443,22916,443,36459,6736,29723,54,29,24,30
33243,443,3619,443,35991,3996,31995,58,17,26,32
55929,53,16714,53,760,97,663,2,30,1,1
42318,443,52319,443,10723,2046,8677,29,116,10,19
54104,443,3216,443,190,70,120,4,15,2,2
64740,53,21372,53,204,96,108,2,0,1,1
50516,53,58230,53,168,86,82,2,30,1,1
43463,443,25009,443,6919,1449,5470,21,186,12,9
46310,443,24043,443,172,172,0,2,5,2,0
55571,53,22113,53,70,70,0,1,29,1,0
27480,443,15079,443,11716,1007,10709,42,383,11,31
59383,80,59383,80,1915,1466,449,10,19,6,4
51645,80,57006,80,318,192,126,6,38,4,2
60400,56243,17811,56243,70,70,0,1,5,1,0
56413,53,33044,53,338,110,228,2,30,1,1
10151,49001,62928,49001,481,150,331,2,1201,1,1
17018,53,17018,53,217,87,130,2,30,1,1
56333,53,31573,53,209,110,99,2,30,1,1
56515,53,36823,53,177,94,83,2,30,1,1
42298,40021,40004,40021,148,86,62,2,31,1,1
65180,53,33252,53,751,95,656,2,30,1,1
55115,53,54899,53,758,96,662,2,31,1,1
55530,80,60637,80,3334,2314,1020,19,39,11,8
65087,53,63765,53,230,110,120,2,30,1,1
56170,53,63567,53,198,102,96,2,30,1,1
65189,27237,9524,27237,234,78,156,2,30,1,1
56688,53,38230,53,192,98,94,2,30,1,1
63992,53,62838,53,199,102,97,2,30,1,1
19648,7000,19648,7000,3610,2043,1567,16,15,9,7
51450,80,49507,80,214,140,74,4,15,3,1
55503,53,55222,53,200,102,98,2,30,1,1
23151,53,23151,53,194,87,107,2,31,1,1
60462,47821,34484,47821,70,70,0,2,8,2,0
37827,443,64403,443,424,210,214,7,131,4,3
49242,53,7199,53,166,85,81,2,31,1,1
64085,53,10076,53,351,102,249,4,43,2,2
53434,53,32877,53,261,261,0,4,47,4,0
41460,443,23165,443,13890,5926,7964,36,84,20,16
64093,53,8656,53,225,110,115,2,30,1,1
58638,5900,58638,5900,62,62,0,1,5,1,0
43568,80,8531,80,2277,1521,756,16,16,10,6
15680,53,61838,53,464,287,177,3,30,2,1
56770,52920,52041,52920,70,70,0,2,8,2,0
53092,443,13048,443,97276,2756,94520,96,96,21,75
55896,53,34756,53,168,86,82,2,30,1,1
57887,53,44516,53,174,81,93,2,30,1,1
60301,443,3566,443,7515,2022,5493,21,144,11,10
55487,53,39202,53,195,102,93,2,30,1,1
53640,28937,48559,28937,70,70,0,2,8,2,0
56512,53,17535,53,166,86,80,2,30,1,1
27005,1106,55769,1106,903,126,777,2,30,1,1
50175,53,55281,53,196,102,94,2,30,1,1
54957,53,36470,53,99,99,0,1,30,1,0
42853,443,43627,443,3508,2120,1388,20,241,10,10
55482,53,16639,53,822,102,720,2,30,1,1
64502,53,19448,53,198,101,97,2,31,1,1
64684,53,47246,53,184,94,90,2,30,1,1
65218,53,25461,53,833,290,543,8,88,4,4
61418,80,59402,80,31954,2972,28982,71,138,36,35
64791,53,42823,53,184,94,90,2,31,1,1
56964,53,45347,53,267,87,180,4,54,2,2
49284,53,32626,53,245,102,143,2,29,1,1
57384,443,57610,443,1054,567,487,10,38,6,4
46477,443,29699,443,4900,904,3996,16,97,9,7
51712,53203,62336,53203,70,70,0,1,5,1,0
56572,53,22035,53,177,94,83,2,29,1,1
52212,51343,6977,51343,70,70,0,2,6,2,0
53373,53,58629,53,242,78,164,2,29,1,1
64525,53,31849,53,198,101,97,2,31,1,1
57271,53,58158,53,288,94,194,2,30,1,1
37183,443,43656,443,9631,4184,5447,33,271,17,16
50664,443,33919,443,9666,1682,7984,25,16,13,12
49214,53,64649,53,227,102,125,2,30,1,1
50226,80,43900,80,9659,1454,8205,28,278,13,15
59737,53,18837,53,382,164,218,2,31,1,1
55372,53,7749,53,271,93,178,4,43,2,2
60214,80,20902,80,8317,6126,2191,23,151,14,9
51793,12210,25465,12210,70,70,0,1,5,1,0
39640,53,64225,53,168,78,90,2,30,1,1
42108,80,8576,80,8370,1025,7345,18,80,10,8
64515,53,64413,53,231,86,145,2,30,1,1
50025,53,43960,53,536,120,416,4,59,2,2
55830,53,41012,53,184,94,90,2,30,1,1
50593,80,24582,80,2365,1068,1297,13,79,7,6
47051,443,3373,443,3304,2161,1143,21,16,11,10
49606,53,17957,53,258,110,148,2,30,1,1
56313,53,23049,53,198,102,96,2,30,1,1
49527,53,42526,53,268,94,174,2,29,1,1
56121,53,17284,53,207,86,121,2,30,1,1
50515,80,58648,80,7871,1409,6462,17,75,7,10
31683,53,31683,53,197,90,107,2,30,1,1
56368,53,19422,53,817,98,719,2,30,1,1
64145,53,46343,53,177,94,83,2,30,1,1
37739,443,17741,443,138037,13843,124194,197,206,94,103
49508,443,35365,443,4151,1015,3136,16,27,8,8
40811,80,13530,80,31286,2032,29254,50,30,26,24
56469,53,63453,53,177,94,83,2,31,1,1
65532,53,19828,53,819,102,717,2,30,1,1
42904,53,51732,53,308,118,190,2,30,1,1
54873,443,62397,443,9238,3472,5766,43,75,24,19
49628,53,6846,53,168,86,82,2,31,1,1
64687,53,62553,53,182,93,89,2,31,1,1
56138,53,30181,53,284,94,190,2,29,1,1
56149,80,45182,80,1286,403,883,16,400,4,12
56134,53,7161,53,167,86,81,2,30,1,1
52277,443,52277,443,1880,941,939,17,21,7,10
37654,443,34226,443,12531,5566,6965,34,46,20,14
42162,53,42162,53,227,88,139,2,31,1,1
11295,40002,5818,40002,356,170,186,6,53,3,3
55262,53,4967,53,193,102,91,2,30,1,1
55217,53,15991,53,744,89,655,2,31,1,1
61815,80,10742,80,4268,653,3615,13,45,7,6
58048,80,12048,80,5171,3018,2153,16,30,8,8
50965,443,11513,443,8949,1200,7749,21,85,10,11
52166,57975,14625,57975,70,70,0,2,8,2,0
64094,443,64094,443,5647,2402,3245,26,159,14,12
51921,80,46796,80,35092,3319,31773,48,31,21,27
49663,53,4720,53,195,102,93,2,29,1,1
53512,53,23746,53,168,78,90,2,30,1,1
57189,53,16894,53,179,94,85,2,30,1,1
54087,443,2699,443,2637658,83234,2554424,2794,140,929,1865
65226,53,19267,53,79,79,0,2,34,2,0
51595,443,49515,443,10614,5312,5302,25,91,14,11
51814,55393,12935,55393,70,70,0,2,7,2,0
49620,53,15285,53,211,110,101,2,30,1,1
57470,41013,23995,41013,2128,875,1253,26,1980,13,13
52347,443,62894,443,7847,2985,4862,30,337,16,14
51811,20740,15988,20740,66,66,0,1,5,1,0
65516,53,21286,53,209,110,99,2,30,1,1
43487,443,8725,443,6886,1291,5595,27,285,15,12
46991,443,46408,443,2809,1884,925,19,26,11,8
52021,32202,58767,32202,70,70,0,2,8,2,0
54817,443,47884,443,12861,6761,6100,34,164,20,14
57332,443,64135,443,2687,1728,959,23,15,12,11
60320,443,16711,443,1743,1164,579,16,25,10,6
55062,53,13920,53,733,86,647,2,31,1,1
49220,2710,39360,2710,70,70,0,2,8,2,0
51206,443,30642,443,12274,2677,9597,51,17,29,22
56356,53,2062,53,758,96,662,2,31,1,1
55463,53,21645,53,216,110,106,2,30,1,1
37653,5223,25600,5223,142,142,0,1,5,1,0
56596,53,50700,53,199,102,97,2,30,1,1
36551,443,34195,443,8674,2101,6573,25,15,13,12
46674,53,59897,53,168,78,90,2,30,1,1
49483,53,61034,53,319,94,225,2,29,1,1
58939,443,28561,443,6403,4065,2338,22,16,11,11
49746,443,2591,443,54014,2565,51449,65,128,24,41
65264,53,51558,53,198,94,104,2,29,1,1
53350,80,3605,80,1712,913,799,12,273,7,5
56252,53,46494,53,531,90,441,4,41,2,2
54981,443,51323,443,36008,2548,33460,55,69,26,29
64417,53,37642,53,184,94,90,2,31,1,1
10014,40026,21058,40026,156,94,62,2,30,1,1
51411,443,64614,443,7842,1155,6687,19,105,10,9
26900,27017,31530,27017,168,82,86,2,30,1,1
60597,53,0,0,344,94,250,2,29,1,1
56624,53,60055,53,328,87,241,4,52,2,2
64403,53,16361,53,783,197,586,6,70,3,3
55477,53,62006,53,183,94,89,2,30,1,1
54990,53,46533,53,166,86,80,2,31,1,1
50125,443,38569,443,15687,3764,11923,32,34,18,14
48885,53,48885,53,215,80,135,2,32,1,1
55836,53,20362,53,177,94,83,2,30,1,1
42298,443,6175,443,70,70,0,1,30,1,0
64068,53,64068,53,1184,83,1101,4,59,2,2
56810,53,28804,53,177,94,83,2,30,1,1
55482,53,39470,53,199,102,97,2,30,1,1
60544,53,63580,53,211,78,133,2,30,1,1
15503,51508,42580,51508,481,150,331,2,1200,1,1
24412,53,24412,53,200,90,110,2,30,1,1
59061,443,25060,443,5464,3984,1480,35,221,20,15
45119,15000,61352,15000,130,70,60,2,5,1,1
34471,53,34471,53,253,99,154,2,32,1,1
62843,53,62843,53,235,90,145,2,32,1,1
63925,53,47553,53,388,134,254,2,30,1,1
51798,37020,11736,37020,70,70,0,2,8,2,0
42522,443,26969,443,7352,1592,5760,25,16,15,10
51759,55308,19017,55308,70,70,0,1,5,1,0
53935,42874,31408,42874,1973,1021,952,10,15,6,4
55106,443,7279,443,3411,887,2524,12,120,6,6
51819,59208,38763,59208,70,70,0,1,5,1,0
64349,53,48163,53,392,102,290,2,30,1,1
64595,53,64819,53,166,85,81,2,31,1,1
60832,5222,60932,5222,3848,1039,2809,37,662,11,26
53852,443,26865,443,499,425,74,4,0,3,1
49907,53,31143,53,363,98,265,4,54,2,2
56646,443,12579,443,7862,1873,5989,20,15,11,9
49952,80,46004,80,4023,620,3403,14,15,7,7
56622,53,41480,53,179,94,85,2,31,1,1
53756,61137,24650,61137,672,306,366,11,16,5,6
62731,443,8633,443,27905,17646,10259,131,308,73,58
41033,443,54265,443,4974,2311,2663,29,79,15,14
49666,80,13546,80,7270,3119,4151,14,41,7,7
27988,40031,63445,40031,140,78,62,2,30,1,1
53732,443,58255,443,499,425,74,4,0,3,1
47509,443,17369,443,7769,2586,5183,18,121,9,9
45607,53,29195,53,168,78,90,2,30,1,1
34879,443,57316,443,167,107,60,2,5,1,1
64872,53,61410,53,166,86,80,2,29,1,1
57910,80,25307,80,6453,1210,5243,14,24,8,6
55958,53,14434,53,177,94,83,2,30,1,1
50494,443,62791,443,5331564,43954,5287610,4171,80,672,3499
52745,443,60430,443,19919,2270,17649,38,26,21,17
19328,53,26253,53,236,86,150,2,29,1,1
51221,53239,19108,53239,1487,594,893,19,1571,10,9
56332,53,13726,53,202,103,99,2,31,1,1
36430,443,7560,443,9423,2105,7318,31,26,16,15
55644,45579,38445,45579,70,70,0,2,8,2,0
65132,53,29079,53,167,86,81,2,30,1,1
26457,80,26457,80,17147,1829,15318,28,17,15,13
56574,443,10843,443,6974,1513,5461,21,81,11,10
49591,53,36017,53,168,86,82,2,31,1,1
64619,53,39601,53,179,94,85,2,31,1,1
56546,53,5266,53,177,94,83,2,30,1,1
49991,443,60218,443,622,210,412,10,21,4,6
56928,53,11160,53,178,94,84,2,31,1,1
49888,53,54251,53,196,100,96,2,30,1,1
57013,53,60365,53,172,88,84,2,30,1,1
64798,53,2925,53,172,88,84,2,30,1,1
49418,27017,63792,27017,256,71,185,2,30,1,1
57236,53,14592,53,748,95,653,2,30,1,1
57360,53,29113,53,231,110,121,2,30,1,1
53617,1056,21327,1056,320,140,180,6,6,3,3
54104,80,15819,80,214,140,74,4,15,3,1
63985,43081,52828,43081,70,70,0,1,5,1,0
53929,443,27958,443,499,425,74,4,0,3,1
37583,443,36088,443,499,425,74,4,0,3,1
56717,53,4326,53,183,94,89,2,29,1,1
60136,443,31780,443,21278,12533,8745,57,183,36,21
65061,53,50134,53,297,101,196,4,33,2,2
51959,443,27606,443,2648,1797,851,19,23,11,8
64512,53,55792,53,244,118,126,2,30,1,1
55643,53,36774,53,183,94,89,2,30,1,1
64986,53,34295,53,183,94,89,2,30,1,1
46225,53,7961,53,199,94,105,2,30,1,1
59758,53,7104,53,211,78,133,2,30,1,1
23683,53,23683,53,338,225,113,3,30,2,1
50494,80,52508,80,18059,13615,4444,29,27,16,13
52955,443,58633,443,23572,2063,21509,46,114,20,26
41462,443,16265,443,3467,2269,1198,21,82,11,10
38685,443,17432,443,749731,23099,726632,823,16,326,497
41699,443,36765,443,40273,3243,37030,60,77,28,32
49984,53,11243,53,373,88,285,4,58,2,2
64951,53,46883,53,224,86,138,2,30,1,1
59791,443,43640,443,6603,1085,5518,23,28,11,12
44368,53,44368,53,233,91,142,2,30,1,1
53320,443,39301,443,30796,3050,27746,60,30,32,28
64178,53,3511,53,276,94,182,2,30,1,1
39861,80,23505,80,1056,682,374,10,15,6,4
56038,53,20578,53,177,94,83,2,29,1,1
33688,80,62587,80,1638,1324,314,10,16,5,5
0,0,0,0,124,64,60,2,0,1,1
55036,443,41925,443,10001,2547,7454,27,35,14,13
47002,53,47002,53,244,98,146,2,31,1,1
64467,53,4748,53,184,94,90,2,30,1,1
51715,443,35378,443,4175264,89546,4085718,4141,532,1111,3030
49125,53,10970,53,168,78,90,2,30,1,1
54601,443,45945,443,28386,15864,12522,59,471,31,28
48817,11602,48817,11602,152,152,0,1,1200,1,0
63762,41373,27152,41373,70,70,0,1,4,1,0
56513,443,40120,443,4989,1014,3975,16,32,9,7
62119,53,18352,53,239,102,137,2,30,1,1
19872,53,19872,53,235,90,145,2,32,1,1
52361,53,7907,53,186,78,108,2,29,1,1
26900,27017,12522,27017,422,164,258,6,30,3,3
26900,27017,40342,27017,422,164,258,6,30,3,3
56115,53,60323,53,167,86,81,2,30,1,1
50347,80,44018,80,1671,862,809,10,15,5,5
52975,443,20822,443,291803,6522,285281,284,113,58,226
57470,6881,10823,6881,132,132,0,3,1200,3,0
27005,27054,38944,27054,921,126,795,2,30,1,1
55141,53,48144,53,744,89,655,2,30,1,1
65020,443,45828,443,5507,3397,2110,13,120,7,6
50690,80,20479,80,4805,3639,1166,16,31,9,7
52180,443,15332,443,11127,1324,9803,24,75,12,12
49568,53,32071,53,168,86,82,2,31,1,1
52477,443,18110,443,8788,2185,6603,15,134,7,8
60343,443,27332,443,36547,3840,32707,88,241,43,45
51522,443,24413,443,8517,2719,5798,24,360,12,12
64051,53,63556,53,275,102,173,2,30,1,1
56509,53,49839,53,1165,94,1071,2,30,1,1
49663,443,52474,443,8161,1929,6232,26,46,15,11
58602,53,5583,53,197,86,111,2,29,1,1
56759,53,42507,53,338,118,220,2,30,1,1
65220,53,7032,53,371,97,274,4,53,2,2
51318,443,40980,443,11191,4657,6534,32,129,14,18
53765,443,33408,443,499,425,74,4,0,3,1
51762,12747,31596,12747,70,70,0,1,5,1,0
49883,443,3067,443,4960,1114,3846,21,51,12,9
56717,80,40230,80,3894448,104279,3790169,4041,97,1411,2630
49242,53,36950,53,183,94,89,2,30,1,1
58255,123,13070,123,184,94,90,2,30,1,1
37569,443,62296,443,97539,6936,90603,160,597,74,86
6437,53,6437,53,229,90,139,2,30,1,1
53259,443,63565,443,27501,3878,23623,57,54,24,33
52096,80,38227,80,366,240,126,7,25,5,2
49855,80,46269,80,41720,6568,35152,47,89,17,30
43628,443,48034,443,13974,3774,10200,29,120,12,17
64836,53,53586,53,241,94,147,2,30,1,1
57978,80,62070,80,4402,2878,1524,29,105,15,14
61308,443,22375,443,44341,5858,38483,102,195,42,60
49174,53,10035,53,264,110,154,2,30,1,1
49722,53,64718,53,200,102,98,2,29,1,1
56330,53,40178,53,271,95,176,4,48,2,2
50859,443,27316,443,6886,1380,5506,19,132,9,10
34710,53,34710,53,244,98,146,2,33,1,1
28035,443,12518,443,5458,1390,4068,17,15,9,8
50368,53,63672,53,763,102,661,2,30,1,1
49270,53,41673,53,735,88,647,2,30,1,1
50038,53,24889,53,177,94,83,2,30,1,1
52720,443,21173,443,11732,4753,6979,41,397,17,24
52376,443,24814,443,33906,25094,8812,63,447,36,27
54973,53,47397,53,731,91,640,2,31,1,1
57995,80,53962,80,4065,2650,1415,25,75,13,12
64790,53,58871,53,88,88,0,1,30,1,0
49199,53,25125,53,193,102,91,2,30,1,1
59896,443,22952,443,1537,934,603,14,32,7,7
17752,53,17752,53,230,90,140,2,30,1,1
57370,443,5735,443,7211,823,6388,16,15,10,6
61433,443,33532,443,41274,18956,22318,90,171,43,47
54973,53,3418,53,308,102,206,2,30,1,1
40219,443,6179,443,2387,979,1408,15,36,6,9
53907,45622,50876,45622,70,70,0,2,7,2,0
55218,443,17111,443,17915,7421,10494,39,61,21,18
55102,53,6205,53,195,102,93,2,30,1,1
65154,443,37170,443,5753,3034,2719,52,281,25,27
27005,30006,10243,30006,888,126,762,3,31,2,1
55746,53,54887,53,216,110,106,2,30,1,1
33017,443,34545,443,130,70,60,3,4,2,1
42956,443,56970,443,11435,2668,8767,38,233,14,24
60213,80,54393,80,47483,13980,33503,69,151,35,34
50682,80,52857,80,5237,680,4557,12,170,6,6
53134,42369,37708,42369,70,70,0,1,5,1,0
64432,53,46411,53,168,86,82,2,30,1,1
43368,443,39927,443,190,70,120,4,15,2,2
41799,443,41969,443,10518,3356,7162,24,121,11,13
64896,53,10637,53,716,95,621,2,31,1,1
65121,53,39585,53,440,94,346,4,37,2,2
49552,53,59587,53,188,96,92,2,30,1,1
39636,80,39636,80,4774,553,4221,13,20,6,7
39032,443,17584,443,5819,1571,4248,26,58,14,12
51898,50677,8224,50677,70,70,0,1,5,1,0
55194,53,9824,53,195,102,93,2,31,1,1
49558,53,59753,53,186,95,91,2,30,1,1
53378,443,65278,443,5090,1692,3398,19,82,11,8
55808,53,19839,53,182,93,89,2,31,1,1
63951,53,53032,53,345,106,239,4,38,2,2
39839,443,5588,443,5829,1408,4421,21,188,11,10
64432,53,45713,53,168,86,82,2,30,1,1
59938,443,3054,443,70,70,0,1,5,1,0
45406,80,51652,80,573,499,74,6,15,5,1
49199,53,34176,53,816,102,714,2,30,1,1
49663,53,0,0,86,86,0,1,30,1,0
52125,49224,3384,49224,70,70,0,1,5,1,0
52037,45647,32087,45647,316,136,180,6,7,3,3
32914,80,9670,80,1542,831,711,7,15,5,2
64911,53,61645,53,202,103,99,2,31,1,1
56257,53,40578,53,177,94,83,2,31,1,1
51720,51388,35731,51388,70,70,0,1,5,1,0
64750,53,43856,53,193,102,91,2,30,1,1
52098,5228,3628,5228,3117,1602,1515,31,66,16,15
64670,53,61851,53,193,102,91,2,29,1,1
60411,58131,27448,58131,70,70,0,1,5,1,0
49608,80,48854,80,318,192,126,6,41,4,2
52003,80,10916,80,7464,4661,2803,47,323,30,17
56236,53,43042,53,241,94,147,2,30,1,1
52115,10012,62951,10012,66,66,0,1,5,1,0
56125,53,8463,53,168,86,82,2,31,1,1
61421,443,24287,443,7206,1897,5309,20,21,11,9
30960,45689,37422,45689,330,330,0,6,3609,6,0
58293,443,58293,443,7134,2478,4656,18,75,10,8
34153,443,49528,443,7037,1282,5755,21,30,11,10
5588,5588,0,0,3354,1792,1562,46,194,23,23
64849,53,57025,53,340,110,230,2,29,1,1
57591,443,27521,443,2614,1689,925,18,20,10,8
51402,443,14600,443,7788,2581,5207,39,70,19,20
49852,80,47954,80,8868,3774,5094,20,89,10,10
52517,80,63047,80,4297,3719,578,14,15,8,6
42298,40030,21853,40030,546,486,60,2,30,1,1
51967,12110,50176,12110,70,70,0,2,7,2,0
62956,443,13888,443,829275,26662,802613,884,129,295,589
37990,49152,47344,49152,156,156,0,3,7,3,0
56703,53,53438,53,199,102,97,2,30,1,1
37680,443,40317,443,16742,3383,13359,57,309,28,29
49363,53,56997,53,309,94,215,2,29,1,1
49605,80,22223,80,454,262,192,8,41,5,3
49324,53,24551,53,258,94,164,2,30,1,1
49774,53,5014,53,236,94,142,2,30,1,1
50671,80,18183,80,1658,1247,411,8,15,5,3
50550,443,50550,443,5642,2395,3247,22,38,13,9
38474,28678,45201,28678,1806,1806,0,22,224,22,0
56496,53,21788,53,164,86,78,2,30,1,1
64934,53,64886,53,197,102,95,2,30,1,1
54167,53,8254,53,210,94,116,2,30,1,1
60439,47783,39683,47783,70,70,0,1,5,1,0
34942,443,50978,443,4317,2189,2128,29,82,15,14
49380,53,50592,53,377,110,267,2,31,1,1
49732,80,4505,80,2052,711,1341,10,130,6,4
56242,53,42071,53,711,87,624,2,30,1,1
56648,53,44024,53,199,102,97,2,30,1,1
57172,53,55364,53,192,98,94,2,31,1,1
64376,443,64376,443,4592,1685,2907,19,29,11,8
44129,53,44129,53,182,81,101,2,30,1,1
49505,443,2441,443,35158,5065,30093,53,42,18,35
51103,80,39889,80,2792,2073,719,15,30,9,6
43872,53,52878,53,199,94,105,2,30,1,1
65507,53,53628,53,199,102,97,2,30,1,1
37780,443,20085,443,1403708,31893,1371815,1301,162,292,1009
40334,53,40334,53,213,87,126,2,30,1,1
15503,48319,24114,48319,481,150,331,2,1199,1,1
49876,53,54830,53,199,102,97,2,30,1,1
55725,14704,2998,14704,70,70,0,2,8,2,0
44949,443,55206,443,190,70,120,4,15,2,2
55144,443,25818,443,6918,2826,4092,26,21,16,10
65404,53,9178,53,198,110,88,2,30,1,1
8283,52443,34417,52443,130,70,60,2,30,1,1
56506,53,36137,53,227,102,125,2,30,1,1
55548,53,43983,53,197,102,95,2,33,1,1
36531,443,53488,443,123782,10685,113097,157,180,65,92
50502,123,1103,123,184,94,90,2,30,1,1
61691,53,19669,53,256,94,162,2,30,1,1
59972,443,22705,443,7152,1299,5853,22,16,12,10
65363,53,30865,53,178,91,87,2,31,1,1
64132,53,36663,53,179,94,85,2,31,1,1
64608,53,18292,53,212,110,102,2,30,1,1
51654,80,36290,80,170875,6864,164011,255,35,93,162
55945,53,48545,53,177,94,83,2,30,1,1
57613,80,57613,80,349583,9149,340434,298,25,62,236
34734,5222,46866,5222,7064,2904,4160,68,88,33,35
49478,443,45550,443,4241,1161,3080,17,152,9,8
58908,443,8392,443,5166,700,4466,16,16,7,9
57225,53,35274,53,177,94,83,2,30,1,1
15503,26886,1778,26886,481,150,331,2,1200,1,1
49781,53,57974,53,188,96,92,2,30,1,1
49152,53,51402,53,206,105,101,2,31,1,1
65321,53,63779,53,283,103,180,4,54,2,2
53927,443,24116,443,495,421,74,4,0,3,1
55074,53,55407,53,770,101,669,2,0,1,1
49296,443,51414,443,7419,2173,5246,17,16,9,8
57318,443,48526,443,5612,733,4879,16,15,9,7
56820,53,17754,53,199,94,105,2,30,1,1
64357,53,37789,53,183,94,89,2,31,1,1
56860,53,63586,53,184,102,82,2,30,1,1
51996,443,3596,443,2648,1797,851,19,22,11,8
56611,53,8939,53,91,91,0,1,30,1,0
56239,53,49542,53,180,94,86,2,30,1,1
56809,53,41798,53,178,94,84,2,31,1,1
52458,443,42668,443,4550,1777,2773,17,135,8,9
50480,80,36021,80,318,192,126,6,25,4,2
33664,80,64127,80,3667,1654,2013,20,189,11,9
61279,443,14356,443,7424,3871,3553,26,160,12,14
30960,45741,31412,45741,330,330,0,6,3609,6,0
49201,80,60094,80,2986,825,2161,10,135,6,4
64194,443,64194,443,27723,5572,22151,59,46,31,28
49023,5223,36604,5223,139,139,0,1,5,1,0
44911,80,9577,80,1492,1050,442,7,15,5,2
64116,53,5820,53,184,94,90,2,31,1,1
53871,43266,32431,43266,70,70,0,1,5,1,0
61229,53,16392,53,261,261,0,4,47,4,0
60711,443,10147,443,10569,3485,7084,27,515,15,12
49051,443,25390,443,7683,1817,5866,42,3089,15,27
49474,53,54970,53,224,86,138,2,29,1,1
65019,53,46989,53,195,102,93,2,31,1,1
35719,443,27839,443,9736,4347,5389,23,361,11,12
35207,53,52779,53,168,78,90,2,30,1,1
50172,443,41441,443,161,101,60,2,5,1,1
50707,80,44331,80,16427,3830,12597,28,25,12,16
45414,80,30413,80,2873,753,2120,12,15,7,5
43488,443,22133,443,6817,1221,5596,26,285,14,12
54985,443,28045,443,23913,3495,20418,50,48,24,26
56782,53,33216,53,197,102,95,2,33,1,1
38675,443,44099,443,90810,3417,87393,94,16,30,64
50966,443,44457,443,7975,3304,4671,19,86,11,8
38446,443,2799,443,46008,3750,42258,77,48,39,38
56467,80,52250,80,22601,1621,20980,35,142,18,17
27005,27015,30434,27015,877,126,751,2,30,1,1
55440,443,52938,443,6622,859,5763,18,15,10,8
65135,53,23354,53,312,102,210,2,30,1,1
49969,53,53673,53,789,102,687,2,30,1,1
53867,60272,19562,60272,70,70,0,2,8,2,0
58707,80,41124,80,2542,1879,663,12,14,6,6
56357,443,45710,443,3674,1750,1924,23,203,12,11
50599,443,63618,443,11301,5604,5697,29,139,17,12
49944,80,31108,80,3695,550,3145,12,15,6,6
55675,53,42703,53,196,100,96,2,31,1,1
53143,24796,50959,24796,698,320,378,10,16,6,4
37580,443,37580,443,1452,817,635,16,20,9,7
38133,53,38133,53,194,87,107,2,30,1,1
19302,443,26733,443,2227,1018,1209,17,15,8,9
50242,80,35975,80,2793,1071,1722,14,105,7,7
50284,443,42928,443,13168,2875,10293,48,99,27,21
64021,53,10744,53,339,118,221,2,29,1,1
51969,80,59733,80,366,240,126,7,25,5,2
56717,53,63655,53,178,94,84,2,30,1,1
51001,53,26424,53,183,86,97,2,30,1,1
51939,34393,16792,34393,70,70,0,1,5,1,0
61361,443,58250,443,7653,1226,6427,24,18,14,10
55609,53,6401,53,178,94,84,2,30,1,1
53820,7488,11201,7488,70,70,0,2,8,2,0
56771,443,16357,443,7941,1952,5989,20,15,11,9
64462,53,60220,53,329,94,235,4,31,2,2
64963,27037,16564,27037,741,462,279,2,31,1,1
50902,80,26223,80,12578792,132594,12446198,10198,133,1845,8353
35337,443,49436,443,6550678,172191,6378487,6426,82,2117,4309
9244,80,12299,80,318,192,126,6,26,4,2
61178,53,58018,53,290,86,204,2,30,1,1
49764,443,46462,443,114197,7285,106912,177,77,85,92
3229,53,3229,53,244,98,146,2,31,1,1
53118,56839,5832,56839,70,70,0,2,8,2,0
56610,80,6975,80,1604,700,904,15,116,7,8
36542,3142,36542,3142,138,78,60,2,6,1,1
41972,5222,18449,5222,5709,2977,2732,62,621,31,31
55619,42873,30146,42873,422,140,282,6,16,3,3
65216,53,41251,53,292,94,198,2,30,1,1
55667,53,30119,53,305,126,179,2,30,1,1
50077,443,40548,443,7976,3333,4643,23,25,12,11
65165,53,21302,53,200,102,98,2,31,1,1
9256,443,44390,443,6327,833,5494,19,26,10,9
55890,53,15703,53,193,102,91,2,29,1,1
57490,80,59652,80,1614,1300,314,10,15,5,5
58610,53,58610,53,244,98,146,2,32,1,1
65409,53,62247,53,200,94,106,2,30,1,1
65072,53,64909,53,338,110,228,2,29,1,1
53314,443,30512,443,12053,6627,5426,47,1043,26,21
49876,53,33233,53,199,102,97,2,30,1,1
64531,53,60188,53,183,94,89,2,30,1,1
56565,53,24401,53,164,86,78,2,30,1,1
27005,27013,56795,27013,879,126,753,2,30,1,1
65292,53,4110,53,195,102,93,2,30,1,1
50370,443,23415,443,316,136,180,6,6,3,3
56903,53,50850,53,232,94,138,2,30,1,1
55184,53,41873,53,183,94,89,2,31,1,1
50039,7000,50039,7000,3050,1659,1391,16,15,9,7
55036,53,30063,53,733,93,640,2,31,1,1
60391,47212,11970,47212,164,70,94,2,5,1,1
51941,19333,28791,19333,70,70,0,2,8,2,0
49649,80,26716,80,378,192,186,7,41,4,3
65269,53,55640,53,273,134,139,2,30,1,1
55959,53,27240,53,216,102,114,2,29,1,1
55491,80,9905,80,204936,10932,194004,277,31,140,137
55068,53,58274,53,192,98,94,2,31,1,1
6455,80,6455,80,326,186,140,6,29,4,2
56291,53,26835,53,177,94,83,2,30,1,1
53544,22051,5953,22051,70,70,0,2,7,2,0
55454,53,12071,53,209,110,99,2,31,1,1
60430,51413,63647,51413,70,70,0,2,8,2,0
63800,80,60637,80,314,192,122,6,15,4,2
52919,443,28761,443,7573,1986,5587,40,115,19,21
65497,53,35507,53,194,99,95,2,31,1,1
39687,443,29168,443,10412,5123,5289,36,236,19,17
36146,443,34524,443,1147,660,487,11,17,7,4
6881,6881,14892,6881,502,150,352,2,1200,1,1
38140,443,56534,443,11484,3842,7642,30,31,16,14
51966,80,56206,80,83302,3780,79522,105,66,47,58
55588,49737,20798,49737,504,318,186,8,15,5,3
58918,443,16774,443,5166,700,4466,16,16,7,9
49991,80,45821,80,2668,543,2125,12,28,6,6
56786,443,61415,443,238132,13988,224144,317,32,161,156
52000,10491,3122,10491,70,70,0,2,8,2,0
47824,53,65037,53,199,94,105,2,30,1,1
30960,45732,62764,45732,330,330,0,6,3610,6,0
53950,123,31431,123,184,94,90,2,30,1,1
27005,27015,22389,27015,879,126,753,2,30,1,1
41027,80,41027,80,18224,2763,15461,29,126,14,15
58176,5223,41893,5223,15152,5747,9405,46,56,20,26
51743,40358,22101,40358,136,136,0,3,14,3,0
59982,443,1995,443,1467,880,587,13,21,7,6
51123,443,33422,443,6625,1673,4952,20,20,10,10
50900,80,42676,80,26867,2743,24124,45,140,23,22
64862,53,53283,53,211,110,101,2,30,1,1
44849,443,64447,443,13791,7866,5925,35,46,20,15
27005,32038,39933,32038,868,126,742,2,30,1,1
58932,443,14070,443,1413,876,537,12,28,6,6
41133,443,38649,443,6964782,246690,6718092,7203,184,2494,4709
58850,53,58850,53,231,90,141,2,29,1,1
64637,53,39523,53,194,102,92,2,31,1,1
64361,53,3934,53,194,94,100,2,30,1,1
50279,53,54207,53,749,94,655,2,29,1,1
49286,53,16984,53,184,94,90,2,31,1,1
52070,443,55434,443,8971,4228,4743,20,95,12,8
65056,53,43061,53,211,102,109,2,30,1,1
57269,53,41250,53,182,93,89,2,31,1,1
55343,53,44963,53,366,94,272,2,30,1,1
55836,443,63316,443,320,140,180,6,15,3,3
65127,53,53558,53,194,102,92,2,29,1,1
55739,53,37345,53,458,188,270,6,29,3,3
52189,53,52189,53,825,99,726,2,30,1,1
33161,80,27979,80,604,530,74,7,15,6,1
64477,443,32832,443,8965,3771,5194,33,124,14,19
49323,53,47360,53,196,102,94,2,29,1,1
61437,443,53093,443,4872,771,4101,17,28,8,9
56532,53,65053,53,164,86,78,2,29,1,1
54977,443,65082,443,263411,11905,251506,318,144,118,200
49983,53,51189,53,749,89,660,2,30,1,1
65316,80,11827,80,2430,531,1899,10,133,6,4
49418,27016,22907,27016,254,71,183,2,30,1,1
49792,443,37527,443,9841,3185,6656,25,186,14,11
50202,443,56858,443,8415,3119,5296,26,73,9,17
51585,80,50569,80,3192,624,2568,10,155,5,5
63771,7426,29432,7426,66,66,0,2,7,2,0
56369,53,3400,53,168,86,82,2,30,1,1
37965,1,53190,1,330,330,0,6,1199,6,0
50640,80,59027,80,2374,936,1438,13,45,7,6
50931,80,59351,80,7978844,97517,7881327,6752,120,1393,5359
41936,443,58038,443,7118,2386,4732,18,133,10,8
64619,53,61367,53,438,89,349,4,44,2,2
57183,53,5484,53,199,94,105,2,29,1,1
64520,53,30136,53,198,102,96,2,31,1,1
60394,11136,28099,11136,7512,2276,5236,39,94,21,18
44211,53,44211,53,850,114,736,2,30,1,1
56023,53,4937,53,338,106,232,4,37,2,2
64670,53,9827,53,183,86,97,2,30,1,1
65449,53,22193,53,177,94,83,2,30,1,1
65370,53,60115,53,186,95,91,2,31,1,1
58057,80,11789,80,2708,1386,1322,23,75,12,11
56339,53,35770,53,280,78,202,2,30,1,1
27005,27018,40971,27018,882,126,756,2,30,1,1
50648,80,8370,80,62,62,0,1,5,1,0
52765,443,14674,443,283,163,120,4,16,2,2
55452,53,8362,53,184,94,90,2,29,1,1
56217,53,54817,53,182,93,89,2,31,1,1
65123,53,59199,53,816,102,714,2,29,1,1
60501,443,35631,443,12006,3698,8308,23,15,13,10
50265,63104,28604,63104,330,330,0,6,1200,6,0
56597,80,61984,80,234,234,0,4,12,4,0
55889,53,19175,53,177,94,83,2,29,1,1
53812,443,19260,443,499,425,74,4,0,3,1
45377,443,49244,443,5291,3987,1304,19,255,11,8
55627,53,4823,53,193,102,91,2,30,1,1
52183,443,6530,443,3560269,64410,3495859,2930,132,383,2547
46324,443,40837,443,24465,3945,20520,39,18,18,21
51137,443,57006,443,9269,5449,3820,70,460,33,37
54237,443,5337,443,499,425,74,4,0,3,1
35371,443,55003,443,304294,8535,295759,302,132,90,212
42890,80,22504,80,2030,586,1444,10,30,6,4
56680,53,24501,53,711,87,624,2,30,1,1
52402,53,52402,53,212,98,114,2,30,1,1
44718,80,25526,80,4336,2408,1928,18,21,10,8
52262,14418,18744,14418,70,70,0,2,8,2,0
65485,53,57081,53,184,94,90,2,31,1,1
48817,37028,48817,37028,513,152,361,2,1200,1,1
50581,80,61624,80,2573,1859,714,9,47,5,4
49671,53,15823,53,166,86,80,2,29,1,1
54610,443,15531,443,19810,7047,12763,54,438,28,26
54961,53,50012,53,211,102,109,2,29,1,1
39758,53,26339,53,86,86,0,1,30,1,0
49497,53,38810,53,297,102,195,2,29,1,1
56593,443,58940,443,1165,662,503,11,25,6,5
44798,443,42874,443,3239,2220,1019,16,15,9,7
47783,80,47783,80,1904,1455,449,10,19,6,4
56917,53,28541,53,194,102,92,2,30,1,1
37565,443,6723,443,499,425,74,4,0,3,1
42298,40042,19672,40042,148,86,62,2,30,1,1
52191,443,40696,443,7018,1766,5252,23,19,13,10
56144,53,15210,53,177,94,83,2,30,1,1
49971,53,63730,53,198,102,96,2,30,1,1
49180,53,47398,53,402,102,300,2,30,1,1
56887,53,8046,53,250,87,163,4,57,2,2
58446,443,26245,443,111535,9830,101705,141,192,62,79
64576,53,63457,53,194,102,92,2,31,1,1
65287,53,16028,53,180,94,86,2,30,1,1
59863,443,41870,443,622,310,312,11,28,6,5
64414,53,36942,53,183,94,89,2,29,1,1
64706,53,4952,53,174,89,85,2,30,1,1
53817,59216,6687,59216,258,70,188,4,8,2,2
38647,443,52794,443,15266,12916,2350,42,81,24,18
40738,443,14631,443,1656,114,1542,5,120,2,3
57200,53,22685,53,770,102,668,2,31,1,1
52955,443,44904,443,3617,2035,1582,30,346,15,15
64338,53,13922,53,298,102,196,4,43,2,2
49723,443,63349,443,6780,710,6070,16,50,7,9
60477,30889,55230,30889,70,70,0,2,8,2,0
65194,53,10314,53,178,91,87,2,31,1,1
52648,443,16992,443,64748,15327,49421,87,273,39,48
27005,27020,41783,27020,898,126,772,2,30,1,1
49295,53,50273,53,280,96,184,4,34,2,2
45390,80,63396,80,16713,1698,15015,31,32,17,14
56675,443,33305,443,7941,1952,5989,20,15,11,9
57200,53,48391,53,711,87,624,2,30,1,1
55074,443,36824,443,3143,2172,971,19,25,9,10
50661,80,15216,80,1658,1247,411,8,15,5,3
57470,13332,8538,13332,166,166,0,1,1199,1,0
57587,443,15184,443,7150,1958,5192,28,144,14,14
57288,53,40505,53,177,94,83,2,30,1,1
58101,53,38765,53,86,86,0,1,30,1,0
63995,443,63995,443,4673,1766,2907,19,29,11,8
45994,443,45994,443,1494,898,596,12,142,6,6
27005,33076,26025,33076,889,126,763,2,31,1,1
57134,53,50387,53,1425,97,1328,4,53,2,2
34044,161,0,0,18549,5061,13488,54,30,27,27
65460,53,26483,53,197,102,95,2,30,1,1
55317,443,24510,443,5692,1239,4453,23,16,13,10
56362,53,31120,53,195,102,93,2,29,1,1
48015,443,20608,443,138,78,60,2,4,1,1
50482,443,60480,443,7653,1188,6465,21,15,12,9
50892,443,40533,443,8057,1135,6922,19,129,9,10
54063,443,37024,443,1313,652,661,13,185,7,6
50150,80,7592,80,73454,5461,67993,74,79,22,52
51759,55308,58744,55308,70,70,0,2,8,2,0
64283,53,27743,53,193,102,91,2,30,1,1
39127,6555,15189,6555,922,428,494,10,15,5,5
55330,53,28011,53,194,102,92,2,29,1,1
56356,53,24415,53,184,102,82,2,30,1,1
54870,443,33932,443,424,210,214,7,131,4,3
51800,80,7944,80,2169,472,1697,10,77,6,4
56973,53,12553,53,186,95,91,2,31,1,1
64633,53,57902,53,231,110,121,2,30,1,1
49838,443,6189,443,8555,1821,6734,24,123,13,11
50927,80,64147,80,876,519,357,10,75,6,4
46092,443,17410,443,130,70,60,2,15,1,1
55635,38649,60618,38649,70,70,0,2,8,2,0
6722,80,6722,80,326,186,140,6,29,4,2
9324,443,33759,443,3255,430,2825,11,15,6,5
60432,54312,22904,54312,701,455,246,8,15,4,4
49812,53,26847,53,193,102,91,2,31,1,1
33252,443,7874,443,89817,21083,68734,148,36,77,71
65449,53,65266,53,507,193,314,6,57,3,3
1658,443,1658,443,12030,1282,10748,23,17,9,14
64931,53,32751,53,174,89,85,2,31,1,1
49654,53,53040,53,214,110,104,2,30,1,1
53226,443,20634,443,5993,974,5019,19,59,10,9
50357,443,38830,443,1786,172,1614,7,121,3,4
42216,53,45740,53,199,94,105,2,30,1,1
55727,43736,4643,43736,70,70,0,2,8,2,0
49748,443,24833,443,7084,1703,5381,19,128,10,9
38018,443,11782,443,1851,1222,629,16,27,10,6
50179,80,50179,80,1473,920,553,9,137,6,3
26783,443,21530,443,22489,15918,6571,39,26,21,18
58037,80,32783,80,2339,1122,1217,11,20,6,5
50660,443,1887,443,3845,1814,2031,19,38,11,8
53706,59208,42614,59208,164,70,94,2,8,1,1
50520,53,48841,53,183,94,89,2,30,1,1
55687,47613,13232,47613,258,70,188,4,8,2,2
42971,3478,30951,3478,312,140,172,4,30,2,2
56779,43137,58075,43137,70,70,0,2,8,2,0
27005,27255,55228,27255,879,126,753,2,30,1,1
49608,53,63386,53,198,110,88,2,29,1,1
37671,53,37671,53,180,82,98,2,30,1,1
37565,123,4980,123,184,94,90,2,30,1,1
51902,443,16953,443,6155,888,5267,17,15,8,9
54391,80,1850,80,1378,808,570,13,361,7,6
65082,53,20499,53,183,94,89,2,31,1,1
52011,80,26180,80,23580,10536,13044,36,39,18,18
56379,53,29859,53,166,86,80,2,31,1,1
36099,443,40194,443,48494,10293,38201,71,129,26,45
64160,53,55275,53,258,110,148,2,30,1,1
49885,7000,49885,7000,3132,815,2317,14,15,7,7
58996,443,63733,443,4979,1505,3474,21,40,11,10
64792,53,58723,53,768,99,669,2,31,1,1
64551,53,37333,53,495,127,368,4,33,2,2
56443,53,60191,53,168,86,82,2,30,1,1
55841,53,32658,53,265,86,179,4,58,2,2
50584,12754,22956,12754,161,161,0,2,1200,2,0
46422,80,48489,80,1447,468,979,9,181,5,4
49723,53,26637,53,209,110,99,2,30,1,1
52183,443,6084,443,10107,1324,8783,22,75,12,10
57440,53,36326,53,198,101,97,2,31,1,1
64734,53,19737,53,383,90,293,4,43,2,2
37145,443,8419,443,4578,2334,2244,21,16,12,9
55008,53,25566,53,762,98,664,2,30,1,1
27005,27016,26467,27016,885,126,759,2,30,1,1
53902,55298,56516,55298,70,70,0,1,4,1,0
62985,8920,45375,8920,823,577,246,9,15,5,4
64797,80,54604,80,378,192,186,7,71,4,3
50584,62833,22282,62833,1275,300,975,6,1200,3,3
29029,53,43871,53,323,77,246,4,30,2,2
50359,80,14465,80,1770,961,809,10,15,5,5
61572,53,61572,53,213,79,134,2,33,1,1
49722,443,49212,443,28376,3058,25318,42,63,17,25
61552,443,61552,443,38146,3555,34591,57,16,28,29
55404,53,28730,53,711,87,624,2,30,1,1
49342,53,61829,53,402,118,284,2,30,1,1
52111,80,49500,80,1582,866,716,11,20,7,4
57430,53,3513,53,200,102,98,2,31,1,1
65283,53,11652,53,333,102,231,2,29,1,1
53807,443,54173,443,499,425,74,4,0,3,1
56672,53,64193,53,177,94,83,2,30,1,1
44125,5222,56837,5222,6329,3447,2882,67,841,34,33
51839,80,34402,80,3240,1194,2046,14,20,9,5
49701,80,18933,80,6132,634,5498,13,130,6,7
50544,53,44871,53,969,86,883,2,30,1,1
61217,53,50317,53,281,94,187,2,30,1,1
48817,58518,48817,58518,580,121,459,4,1199,2,2
37965,15357,58016,15357,481,150,331,2,1200,1,1
63513,53,63513,53,236,94,142,2,30,1,1
58838,443,31088,443,5167,700,4467,16,15,7,9
37339,443,37972,443,130,70,60,3,5,2,1
56714,443,39694,443,8057,2037,6020,20,15,11,9
53662,443,56042,443,7471,2800,4671,21,76,13,8
60840,443,45920,443,54975,32043,22932,71,319,40,31
27005,26258,35412,26258,886,126,760,2,30,1,1
57647,80,36132,80,1530,1216,314,10,15,5,5
27005,27015,24386,27015,882,126,756,3,31,2,1
64095,53,51473,53,269,110,159,2,30,1,1
49476,53,24497,53,402,118,284,2,29,1,1
43743,53,43743,53,240,98,142,2,29,1,1
65010,53,7971,53,758,102,656,2,29,1,1
49825,443,10152,443,15401,3011,12390,37,65,21,16
64602,53,18957,53,185,102,83,2,30,1,1
51992,22670,31187,22670,70,70,0,1,4,1,0
49488,443,58643,443,90030,13137,76893,92,47,29,63
65534,53,65534,53,414,268,146,3,31,2,1
34220,443,12969,443,7946,2731,5215,27,18,15,12
65192,53,4438,53,172,88,84,2,30,1,1
42550,5222,16634,5222,2060,981,1079,21,15,11,10
36866,443,19337,443,6798,2901,3897,22,151,13,9
55543,53,20770,53,402,118,284,2,30,1,1
49903,53,18446,53,215,102,113,2,29,1,1
65067,53,43932,53,411,115,296,4,38,2,2
57792,53,57792,53,215,87,128,2,31,1,1
65408,53,61605,53,764,99,665,2,30,1,1
39527,443,33957,443,8447,3506,4941,28,333,15,13
13743,80,13743,80,724,366,358,11,142,6,5
49668,53,14674,53,214,102,112,2,29,1,1
50180,443,51713,443,6349,1071,5278,18,42,10,8
51762,80,41389,80,3945,2315,1630,18,74,11,7
53213,80,60340,80,18040,904,17136,22,15,7,15
52053,80,43263,80,27839,14036,13803,46,36,24,22
49538,53,45151,53,748,94,654,2,30,1,1
57288,53,40155,53,170,87,83,2,30,1,1
50864,443,18823,443,6663,1556,5107,21,132,10,11
34341,28678,47024,28678,1806,1806,0,22,224,22,0
64937,53,10087,53,182,93,89,2,31,1,1
55027,53,65292,53,343,86,257,4,58,2,2
55684,53,56434,53,193,102,91,2,30,1,1
50229,443,13758,443,6846,2479,4367,41,256,19,22
64001,53,1260,53,183,94,89,2,30,1,1
41528,161,0,0,14381,5620,8761,50,30,25,25
55918,53,15697,53,184,94,90,2,31,1,1
10012,40009,21244,40009,253,190,63,2,30,1,1
49714,53,21823,53,767,102,665,2,30,1,1
50265,16082,44635,16082,858,858,0,14,1200,14,0
45935,25,35960,25,511,191,320,9,60,4,5
38761,123,12089,123,184,94,90,2,30,1,1
50298,53,38554,53,164,86,78,2,30,1,1
49190,80,2197,80,6158,654,5504,15,15,8,7
55489,53,32876,53,193,102,91,2,29,1,1
58638,5900,58638,5900,66,66,0,1,4,1,0
65101,53,44970,53,749,94,655,2,30,1,1
49775,80,50741,80,254,128,126,5,16,3,2
55754,53,48167,53,177,94,83,2,29,1,1
56492,443,53818,443,6066,1016,5050,20,26,11,9
45676,123,45676,123,184,94,90,2,30,1,1
49932,443,32840,443,8428,1889,6539,25,16,13,12
56808,54393,38896,54393,70,70,0,1,5,1,0
58006,80,48045,80,318,192,126,6,21,4,2
55365,53,5213,53,214,110,104,2,29,1,1
50684,80,2387,80,132,132,0,2,8,2,0
50627,443,54044,443,5427,3497,1930,23,141,13,10
1737,80,1737,80,424934,9929,415005,411,95,129,282
52211,80,22459,80,8559,5109,3450,23,160,12,11
55850,53,58369,53,816,97,719,2,30,1,1
50265,38978,6940,38978,481,150,331,2,1200,1,1
60244,443,61797,443,17829,9658,8171,92,150,46,46
49679,53,54923,53,166,86,80,2,30,1,1
56415,80,5751,80,38339,808,37531,37,104,9,28
53064,443,10926,443,8095,2586,5509,38,90,19,19
47276,443,9154,443,9503,5267,4236,56,218,31,25
53603,53796,21410,53796,70,70,0,1,4,1,0
52724,80,24269,80,9532,745,8787,18,113,9,9
61808,443,43689,443,4625,2292,2333,14,135,7,7
47087,443,29605,443,7187,2550,4637,20,18,10,10
27005,27021,42135,27021,1708,126,1582,4,31,2,2
60890,443,40246,443,15081,6817,8264,31,34,14,17
53831,53,28587,53,260,86,174,2,30,1,1
37675,53,37675,53,197,90,107,2,30,1,1
57319,53,20750,53,180,94,86,2,29,1,1
64202,53,3004,53,316,89,227,4,50,2,2
51118,80,26346,80,1952,1118,834,21,365,11,10
49923,80,28185,80,1126,609,517,11,15,6,5
54368,443,18976,443,10707,2548,8159,27,39,15,12
25849,53,25849,53,404,259,145,3,32,2,1
61686,53,52741,53,196,86,110,2,30,1,1
57243,443,49244,443,27444,3840,23604,58,161,28,30
60556,28678,33348,28678,1806,1806,0,22,224,22,0
58886,443,39424,443,3989,2585,1404,17,15,9,8
57952,443,57780,443,480591,8786,471805,442,46,102,340
27005,33056,50628,33056,885,126,759,2,31,1,1
57284,53,57366,53,165,86,79,2,30,1,1
56937,53,49569,53,181,94,87,2,33,1,1
57275,53,56267,53,177,94,83,2,30,1,1
9235,80,17442,80,318,192,126,6,26,4,2
59742,53,55013,53,448,166,282,2,30,1,1
40453,443,6651,443,5655,1614,4041,22,30,11,11
56928,53,51278,53,178,94,84,2,30,1,1
57362,53,38084,53,177,94,83,2,30,1,1
49845,53,18683,53,168,86,82,2,31,1,1
65491,53,33767,53,193,102,91,2,31,1,1
56669,443,61657,443,8058,2038,6020,20,15,11,9
40781,443,27911,443,362,302,60,2,5,1,1
49411,53,10560,53,195,102,93,2,31,1,1
64514,53,39075,53,437,88,349,4,41,2,2
48724,443,22721,443,4371,2036,2335,18,24,10,8
55056,53,39813,53,209,110,99,2,30,1,1
49241,53,22091,53,785,110,675,2,30,1,1
36785,443,22172,443,1799,1224,575,13,26,8,5
51765,52862,65009,52862,66,66,0,1,5,1,0
56433,53,47561,53,210,110,100,2,30,1,1
49328,443,48321,443,77821,4380,73441,82,53,23,59
6881,6881,46331,6881,259,150,109,2,1201,1,1
39029,53,55192,53,198,93,105,2,31,1,1
49274,53,26954,53,560,199,361,6,82,3,3
61660,443,61660,443,18829,1995,16834,33,17,17,16
25295,53,30242,53,200,94,106,2,30,1,1
56550,53,53287,53,166,86,80,2,29,1,1
55276,53,25720,53,177,94,83,2,29,1,1
49715,443,3770,443,7681,1658,6023,21,130,11,10
55577,53,12118,53,199,102,97,2,30,1,1
54979,53,4787,53,102,102,0,1,59,1,0
49667,80,52853,80,1165,468,697,8,125,5,3
9263,80,41010,80,318,192,126,6,26,4,2
63584,443,24147,443,3182,1568,1614,8,120,4,4
64556,53,11651,53,195,102,93,2,29,1,1
47975,443,46443,443,8301,2172,6129,25,255,12,13
44421,443,9990,443,2548,1565,983,20,330,11,9
34488,443,33891,443,8363,1573,6790,24,49,14,10
55634,53,10243,53,210,110,100,2,30,1,1
63769,47661,26406,47661,70,70,0,1,5,1,0
49418,27017,57316,27017,262,78,184,2,30,1,1
54976,443,13251,443,8156,3281,4875,43,71,21,22
50700,80,35384,80,142,142,0,1,4,1,0
40453,443,22159,443,114,114,0,2,120,2,0
50584,32808,19666,32808,166,166,0,1,1199,1,0
55539,53,25818,53,249,94,155,2,31,1,1
46176,53,12412,53,168,78,90,2,30,1,1
55083,53,35659,53,216,110,106,2,30,1,1
59596,3389,59596,3389,3523,1714,1809,17,34,8,9
56487,53,4784,53,194,102,92,2,30,1,1
52667,443,52477,443,4797,2794,2003,20,271,11,9
64913,53,45280,53,188,96,92,2,30,1,1
38145,443,38145,443,4599,1692,2907,19,29,11,8
50559,53,4402,53,216,110,106,2,31,1,1
39422,443,26393,443,557795,16003,541792,528,76,139,389
57470,60080,37928,60080,12668,8506,4162,117,3745,74,43
57409,53,6816,53,168,86,82,2,31,1,1
55579,53,62219,53,178,94,84,2,30,1,1
43105,443,31281,443,3115,1849,1266,18,16,8,10
38712,443,31171,443,382972,9177,373795,378,16,120,258
35195,443,32117,443,3672,1259,2413,16,120,8,8
50616,443,60964,443,8643,1918,6725,21,26,11,10
55205,53,45357,53,167,86,81,2,29,1,1
53723,443,16354,443,499,425,74,4,0,3,1
51268,47662,5610,47662,70,70,0,2,8,2,0
39296,80,42810,80,740,452,288,11,17,7,4
38011,443,55120,443,6732,885,5847,24,368,7,17
65040,53,27133,53,256,88,168,4,32,2,2
55423,53,64857,53,177,94,83,2,30,1,1
52095,443,20736,443,325846,10609,315237,326,38,106,220
49797,53,55138,53,767,102,665,2,31,1,1
56973,443,43404,443,22953,5010,17943,38,123,14,24
64561,53,6022,53,209,110,99,2,30,1,1
52838,443,36112,443,14518,10453,4065,43,120,21,22
55705,53,38579,53,209,110,99,2,29,1,1
51727,1024,33037,1024,70,70,0,2,8,2,0
49567,443,12074,443,6260,3089,3171,27,142,13,14
51155,443,21340,443,54411,4588,49823,74,131,30,44
55163,53,4604,53,197,102,95,2,31,1,1
48936,443,24863,443,494,280,214,8,49,5,3
52041,80,18599,80,2901,1407,1494,15,38,9,6
51237,443,50232,443,9668,4698,4970,42,16,25,17
64890,53,55634,53,210,110,100,2,29,1,1
49531,53,38676,53,183,94,89,2,29,1,1
50584,49001,53256,49001,480,150,330,2,1200,1,1
33970,443,28633,443,2586,832,1754,14,15,7,7
49206,80,5739,80,57497,913,56584,52,75,11,41
65295,53,41511,53,944,205,739,6,45,3,3
52039,38541,31838,38541,70,70,0,2,7,2,0
49262,53,46554,53,168,86,82,2,30,1,1
35087,443,32747,443,6053,3586,2467,17,135,8,9
50075,443,63297,443,4701,2758,1943,41,93,22,19
52011,10722,20939,10722,70,70,0,2,7,2,0
56111,53,49193,53,179,94,85,2,31,1,1
57181,53,65198,53,733,93,640,2,31,1,1
64408,53,53381,53,199,94,105,2,29,1,1
59559,443,17669,443,6328,1536,4792,23,17,12,11
59790,443,41784,443,238429,14932,223497,314,48,159,155
26900,27017,44727,27017,422,164,258,6,30,3,3
41320,443,41281,443,1743946,54876,1689070,1870,360,678,1192
60754,53,60754,53,198,90,108,2,30,1,1
50987,443,24921,443,3278,1962,1316,20,20,9,11
49196,443,53527,443,789207,20847,768360,812,23,294,518
56768,10880,3397,10880,70,70,0,1,5,1,0
45963,443,45963,443,4592,1685,2907,19,27,11,8
35897,443,1439,443,6692,1642,5050,24,275,11,13
27005,27022,12480,27022,1882,378,1504,6,31,4,2
59770,443,53384,443,9630,1304,8326,28,30,14,14
51221,51413,20920,51413,459,149,310,2,1200,1,1
53282,443,19856,443,13300,1695,11605,27,321,12,15
49548,443,37968,443,1346,918,428,10,22,6,4
55453,443,3812,443,3015948,160028,2855920,3852,218,1499,2353
43542,53,13639,53,168,78,90,2,30,1,1
64903,53,49771,53,777,87,690,2,31,1,1
44007,123,12438,123,184,94,90,2,30,1,1
56717,53,10005,53,183,94,89,2,30,1,1
9225,443,21069,443,5510,901,4609,15,25,8,7
51507,443,1531,443,584465,23057,561408,694,36,303,391
55853,53,62979,53,228,110,118,2,30,1,1
26782,443,49572,443,7407,2650,4757,24,20,12,12
56108,53,60144,53,298,92,206,4,41,2,2
64070,53,45355,53,337,89,248,4,38,2,2
56658,53,12429,53,229,94,135,2,30,1,1
60306,443,16522,443,2866,623,2243,13,136,6,7
43368,80,43368,80,232198,9152,223046,290,21,134,156
64899,53,16096,53,199,102,97,2,30,1,1
57470,5382,65418,5382,2411,1328,1083,19,1200,11,8
55310,53,54905,53,180,94,86,2,31,1,1
49446,80,49446,80,5724,3966,1758,25,38,14,11
55445,443,10778,443,1373295,46189,1327106,1448,31,527,921
26900,27017,53527,27017,254,82,172,4,30,2,2
57202,53,37225,53,184,94,90,2,29,1,1
58715,80,58715,80,5140,4161,979,17,28,10,7
55000,53,36007,53,193,102,91,2,31,1,1
65049,53,59454,53,184,94,90,2,31,1,1
35196,5222,52205,5222,3376,1509,1867,32,83,16,16
64805,53,57151,53,215,102,113,2,30,1,1
53016,80,53016,80,265868,5026,260842,277,24,75,202
56758,443,1030,443,8005,1985,6020,20,16,11,9
60392,1134,49045,1134,70,70,0,1,5,1,0
57188,53,35661,53,193,102,91,2,29,1,1
46822,443,53756,443,71073,4403,66670,99,116,41,58
52009,1035,48428,1035,316,136,180,6,7,3,3
39807,443,25771,443,1684,1031,653,16,92,9,7
55223,1053,57960,1053,1210,950,260,2,30,1,1
40457,443,34174,443,5630,3451,2179,39,67,20,19
46285,443,49897,443,36209,28887,7322,65,364,34,31
55610,53,39164,53,199,102,97,2,30,1,1
49857,443,36785,443,4221,1038,3183,19,59,11,8
56273,53,30021,53,200,102,98,2,30,1,1
56713,53,30137,53,226,110,116,2,30,1,1
27005,37569,24806,37569,892,126,766,2,30,1,1
56666,443,31326,443,1299,730,569,13,25,7,6
60407,443,48240,443,308771,8699,300072,322,30,112,210
50425,443,27749,443,4600,667,3933,14,17,7,7
57207,53,1251,53,195,102,93,2,30,1,1
39055,53,10136,53,289,86,203,2,30,1,1
53806,37267,15309,37267,70,70,0,2,8,2,0
64992,53,63333,53,170,87,83,2,30,1,1
60944,443,23317,443,8264,4269,3995,17,31,9,8
57341,3389,57341,3389,3428,1714,1714,16,33,8,8
52280,995,52280,995,142,78,64,2,5,1,1
51840,34678,44195,34678,70,70,0,1,5,1,0
65199,53,63329,53,793,207,586,6,59,3,3
65189,27015,29892,27015,295,78,217,2,30,1,1
65131,53,28562,53,443,98,345,4,57,2,2
34092,53,13668,53,168,78,90,2,30,1,1
52261,5222,10119,5222,5380,2214,3166,55,503,26,29
57441,53,7425,53,177,94,83,2,30,1,1
50050,53,17602,53,253,87,166,4,52,2,2
50636,53,31294,53,772,100,672,2,31,1,1
49629,53,59085,53,216,102,114,2,30,1,1
56041,53,56903,53,179,94,85,2,30,1,1
55675,53,34777,53,287,91,196,4,60,2,2
56696,53,25639,53,757,98,659,2,31,1,1
59758,443,17824,443,4114,2557,1557,22,418,9,13
35012,80,6218,80,1295,572,723,12,15,7,5
55423,53,7848,53,170,87,83,2,30,1,1
50386,443,59778,443,1346,918,428,10,26,6,4
2839,53,2839,53,229,94,135,2,30,1,1
49334,53,34104,53,194,102,92,2,30,1,1
47966,443,16155,443,10895,2151,8744,26,362,11,15
49956,80,11904,80,10819,819,10000,19,15,9,10
38660,15000,20760,15000,138,78,60,2,5,1,1
65262,53,52236,53,216,110,106,2,30,1,1
8881,443,2247,443,27459,19126,8333,67,402,30,37
50642,443,51887,443,10981,2295,8686,32,63,16,16
49418,27015,11221,27015,240,78,162,2,30,1,1
33936,443,61935,443,9880,2011,7869,38,256,17,21
56654,53,22372,53,209,110,99,2,30,1,1
53114,443,28454,443,3796,1523,2273,20,135,10,10
55670,31056,18384,31056,70,70,0,2,8,2,0
57231,53,16422,53,168,86,82,2,31,1,1
63075,53,54531,53,571,166,405,2,29,1,1
51954,12380,41427,12380,70,70,0,1,5,1,0
27005,32078,44538,32078,871,126,745,2,31,1,1
60513,47094,45469,47094,320,140,180,6,7,3,3
52175,1101,27107,1101,70,70,0,1,5,1,0
57298,8765,45553,8765,2466,1350,1116,37,569,19,18
55588,53,17857,53,168,86,82,2,34,1,1
64320,53,46178,53,199,102,97,2,30,1,1
60330,80,20724,80,374,192,182,7,61,4,3
55749,53,21707,53,413,170,243,6,30,3,3
54517,443,8632,443,11460,2522,8938,19,122,9,10
52034,48856,38527,48856,66,66,0,1,5,1,0
60782,20010,60186,20010,70,70,0,2,8,2,0
59920,443,55787,443,3063,1068,1995,12,134,6,6
57681,53,57681,53,220,100,120,2,31,1,1
42203,443,25522,443,6345,1024,5321,21,361,11,10
64753,53,4084,53,287,102,185,2,30,1,1
55659,37787,47813,37787,70,70,0,2,8,2,0
37555,16386,23177,16386,130,70,60,2,30,1,1
37965,6224,9493,6224,38098,12284,25814,207,2433,100,107
53983,443,37079,443,2571,330,2241,12,135,5,7
56969,53,8130,53,754,94,660,2,31,1,1
2267,53,48892,53,204,118,86,2,30,1,1
64145,53,55779,53,170,87,83,2,30,1,1
33424,53,33424,53,233,91,142,2,30,1,1
49526,53,27945,53,272,97,175,4,57,2,2
55669,62781,37625,62781,320,140,180,6,7,3,3
55285,53,18984,53,268,95,173,4,46,2,2
58945,443,49273,443,5168,700,4468,16,15,7,9
27005,30008,3198,30008,890,126,764,2,31,1,1
49361,53,37385,53,184,94,90,2,29,1,1
51786,37832,38503,37832,70,70,0,2,8,2,0
53981,29500,46111,29500,320,140,180,6,7,3,3
49696,53,54642,53,172,88,84,2,30,1,1
49837,53,4839,53,180,94,86,2,29,1,1
64560,53,36010,53,184,94,90,2,29,1,1
48817,45682,48817,45682,513,152,361,2,1200,1,1
50129,443,15530,443,9199,2329,6870,30,133,17,13
54958,53,54115,53,1413,85,1328,4,47,2,2
58151,53,58151,53,241,98,143,2,30,1,1
57328,443,39932,443,134,60,74,3,4,2,1
55496,80,55496,80,1099,578,521,10,15,6,4
50069,53,5416,53,174,89,85,2,30,1,1
39265,443,4436,443,46879,2864,44015,74,179,34,40
64982,53,7315,53,195,102,93,2,30,1,1
49724,53,16397,53,183,94,89,2,30,1,1
54612,443,39989,443,6110,857,5253,17,16,9,8
53556,1024,53867,1024,70,70,0,2,8,2,0
56755,53,24589,53,184,94,90,2,30,1,1
13971,53,13971,53,220,90,130,2,30,1,1
64955,53,63777,53,210,110,100,2,30,1,1
52330,443,52330,443,11451,5432,6019,34,86,17,17
14885,53,14885,53,220,100,120,2,30,1,1
64045,53,1404,53,1011,232,779,6,55,3,3
55239,53,38143,53,272,94,178,2,30,1,1
55877,38597,28809,38597,481,150,331,2,1200,1,1
56783,53,44308,53,193,102,91,2,30,1,1
50072,53,22723,53,779,86,693,2,30,1,1
65224,53,48832,53,758,93,665,2,30,1,1
60163,443,56805,443,8929,3204,5725,25,80,14,11
57397,53,11845,53,183,94,89,2,29,1,1
56856,47715,33664,47715,70,70,0,2,8,2,0
51885,64546,12386,64546,66,66,0,1,5,1,0
56611,443,65034,443,1473,868,605,10,25,6,4
49753,80,62550,80,32910,18450,14460,143,1647,75,68
56375,53,32161,53,216,110,106,2,31,1,1
56450,53,26592,53,170,87,83,2,30,1,1
58865,443,15727,443,10775,7126,3649,31,17,17,14
27005,27017,14487,27017,882,126,756,2,31,1,1
64786,53,39238,53,810,108,702,2,31,1,1
55421,53,63396,53,168,78,90,2,30,1,1
49254,53,55219,53,265,110,155,2,30,1,1
37906,443,56891,443,11293,3979,7314,29,125,17,12
37802,80,16566,80,1702,1388,314,10,16,5,5
56136,53,4435,53,733,94,639,2,30,1,1
49655,443,10531,443,31956,13344,18612,64,65,36,28
49754,443,12620,443,17243,5482,11761,82,316,41,41
52004,80,9207,80,84657,4275,80382,105,19,45,60
57602,80,57602,80,4226,2910,1316,19,38,10,9
64982,53,55675,53,215,102,113,2,30,1,1
56980,53,42285,53,267,87,180,4,38,2,2
49589,53,16073,53,214,102,112,2,31,1,1
63866,17623,15201,17623,66,66,0,1,5,1,0
55562,53,27476,53,239,94,145,2,29,1,1
51140,80,51140,80,514,246,268,9,42,5,4
54657,443,15364,443,7070,1030,6040,19,33,11,8
51837,80,11115,80,242,120,122,5,31,3,2
64651,443,22018,443,317618,11688,305930,350,164,118,232
21133,21689,35631,21689,481,150,331,2,1199,1,1
49571,443,45165,443,3972,887,3085,13,31,6,7
60767,40010,24332,40010,316,136,180,6,6,3,3
49578,80,61645,80,25846,2486,23360,39,50,16,23
51958,51322,1745,51322,70,70,0,1,4,1,0
56202,53,30224,53,916,86,830,2,30,1,1
37906,443,31579,443,416,210,206,7,26,4,3
14433,443,47619,443,2589,1443,1146,18,15,8,10
51941,80,19964,80,82496,3881,78615,104,61,47,57
49949,53,12218,53,193,102,91,2,29,1,1
65224,53,24023,53,994,86,908,2,31,1,1
40711,53,40711,53,200,90,110,2,30,1,1
51864,38544,39396,38544,1345,679,666,9,30,5,4
52406,443,12118,443,11463,850,10613,23,25,7,16
27005,27015,27620,27015,880,126,754,2,30,1,1
56104,53,20610,53,194,99,95,2,31,1,1
49388,53,27609,53,215,102,113,2,30,1,1
63598,443,20938,443,164604,5676,158928,188,39,70,118
49790,80,49818,80,1769,1271,498,10,126,6,4
63440,53,0,0,206,95,111,2,30,1,1
56387,53,7178,53,182,93,89,2,31,1,1
54535,443,39884,443,9859,3252,6607,24,74,12,12
49539,53,50465,53,177,94,83,2,30,1,1
50962,53,0,0,229,85,144,2,29,1,1
50241,53,51739,53,184,102,82,2,30,1,1
56601,53,60579,53,168,78,90,2,30,1,1
55711,10480,9991,10480,564,318,246,9,18,5,4
63954,53,25119,53,352,102,250,2,29,1,1
49418,27026,25116,27026,71,71,0,1,30,1,0
58901,443,21819,443,5168,700,4468,16,15,7,9
50444,443,31610,443,47752,21819,25933,119,704,59,60
56086,443,37563,443,7535,1003,6532,24,304,7,17
48817,61613,48817,61613,490,149,341,2,1200,1,1
55067,53,59893,53,178,94,84,2,30,1,1
39293,443,5290,443,70,70,0,1,4,1,0
56982,53,54411,53,177,94,83,2,29,1,1
56716,80,53461,80,3742344,115431,3626913,3995,79,1382,2613
56199,53,59192,53,227,110,117,2,30,1,1
50171,53,22623,53,211,78,133,2,30,1,1
64415,53,15855,53,221,94,127,2,30,1,1
65018,53,40867,53,198,94,104,2,30,1,1
64245,53,16068,53,344,94,250,2,30,1,1
56551,53,25599,53,225,102,123,2,30,1,1
54234,443,2984,443,499,425,74,4,0,3,1
55351,53,4702,53,1497,108,1389,4,53,2,2
50464,80,50464,80,218570,13559,205011,291,22,146,145
39452,123,25633,123,184,94,90,2,30,1,1
37567,443,42814,443,214,140,74,4,15,3,1
56180,53,31487,53,200,102,98,2,30,1,1
56446,443,26551,443,8620,2018,6602,34,80,18,16
38709,443,40146,443,398925,9369,389556,391,16,123,268
55923,53,7980,53,177,94,83,2,30,1,1
9968,53,9968,53,370,238,132,3,32,2,1
56522,53,58867,53,322,134,188,2,30,1,1
50621,53,54722,53,256,93,163,2,31,1,1
53301,11000,8510,11000,1642,822,820,5,30,1,4
50961,5222,36046,5222,8318,2850,5468,54,255,27,27
50036,53,50623,53,353,118,235,2,31,1,1
2070,53,2070,53,233,90,143,2,32,1,1
64715,53,47413,53,209,110,99,2,30,1,1
44979,443,39259,443,10311,2186,8125,26,186,14,12
65493,443,24258,443,7975,423,7552,15,120,6,9
56078,53,50373,53,178,94,84,2,29,1,1
52667,80,52667,80,2011,1422,589,12,48,6,6
50303,443,52524,443,208,60,148,4,11,2,2
52993,53,60182,53,70,70,0,1,29,1,0
43726,443,52371,443,1201,707,494,12,35,7,5
51120,53,11316,53,168,78,90,2,30,1,1
52625,53,52625,53,231,88,143,2,32,1,1
49418,27015,50177,27015,78,78,0,1,30,1,0
59884,443,44531,443,6622,2246,4376,21,46,12,9
64347,53,35603,53,321,109,212,4,47,2,2
49302,443,8225,443,3182,1568,1614,8,120,4,4
54427,443,64059,443,2878,1252,1626,16,361,9,7
60444,47094,7095,47094,320,140,180,6,7,3,3
64673,53,43122,53,213,94,119,2,30,1,1
55627,26192,42431,26192,70,70,0,2,8,2,0
49574,443,40939,443,16191,13348,2843,30,55,17,13
49551,80,48076,80,1769,873,896,11,15,6,5
55426,53,25381,53,177,94,83,2,30,1,1
50241,443,61373,443,27900,6291,21609,46,515,23,23
22263,53,22263,53,288,83,205,2,30,1,1
53770,443,15341,443,499,425,74,4,0,3,1
50803,443,13145,443,98472,44922,53550,491,658,181,310
49242,53,5506,53,167,86,81,2,30,1,1
65266,53,21692,53,216,110,106,2,30,1,1
37569,443,25156,443,499,425,74,4,0,3,1
57620,443,56080,443,5177,3010,2167,37,83,17,20
56503,53,37647,53,578,286,292,9,15,5,4
35989,443,62539,443,2840032,64781,2775251,2709,292,769,1940
63037,443,11934,443,303,85,218,2,31,1,1
56072,53,35892,53,199,102,97,2,31,1,1
64381,53,43493,53,168,86,82,2,31,1,1
48354,5222,3961,5222,7786,1403,6383,44,434,15,29
51444,3027,51444,3027,156,156,0,3,8,3,0
64308,53,43760,53,181,86,95,2,30,1,1
48817,51413,48817,51413,485,158,327,2,1200,1,1
34316,53,37625,53,168,78,90,2,29,1,1
51198,443,22207,443,8075,2723,5352,42,117,24,18
27005,27023,20750,27023,875,126,749,3,32,2,1
39096,443,59336,443,1268772,32833,1235939,1288,81,409,879
64326,53,28923,53,192,98,94,2,31,1,1
64581,53,16875,53,214,110,104,2,29,1,1
65477,53,46159,53,209,110,99,2,30,1,1
38100,53,30457,53,168,78,90,2,30,1,1
15503,6881,43362,6881,2310,2310,0,36,3136,36,0
49599,80,35878,80,312,192,120,6,41,4,2
55026,443,23738,443,11413,6823,4590,34,18,19,15
57949,443,49783,443,19190,13041,6149,64,389,33,31
56647,443,58814,443,1327,918,409,10,25,6,4
48186,443,28155,443,1947,688,1259,18,82,8,10
55061,80,17010,80,486,240,246,9,28,5,4
56232,80,56232,80,44752,820,43932,45,15,12,33
51905,65253,13795,65253,70,70,0,2,8,2,0
55935,53,44322,53,196,102,94,2,30,1,1
53147,26330,14316,26330,70,70,0,2,8,2,0
9279,443,53983,443,4275,760,3515,15,27,8,7
57891,443,65008,443,1856,1217,639,18,176,11,7
46965,53,4424,53,199,94,105,2,30,1,1
49633,53,11968,53,168,86,82,2,30,1,1
49659,80,54132,80,1937,885,1052,13,42,7,6
49531,80,9012,80,78,78,0,1,5,1,0
53136,41442,29017,41442,70,70,0,2,8,2,0
49935,53,50105,53,177,94,83,2,30,1,1
65251,53,54208,53,183,98,85,3,36,2,1
56771,53,7291,53,270,95,175,4,60,2,2
55965,53,4442,53,184,94,90,2,30,1,1
50516,443,44017,443,1575,771,804,16,47,9,7
49390,53,61910,53,210,110,100,2,30,1,1
57905,80,48820,80,12974,3246,9728,29,29,16,13
57165,53,9169,53,216,102,114,2,30,1,1
64517,53,41974,53,194,102,92,2,29,1,1
45079,443,33534,443,7298,2661,4637,21,18,11,10
54454,5222,49306,5222,9568,1982,7586,44,345,17,27
36841,443,36841,443,4401,1494,2907,19,27,11,8
50892,80,51133,80,256436,14131,242305,283,141,111,172
53959,39097,20337,39097,1450,761,689,14,15,8,6
53259,123,17557,123,184,94,90,2,31,1,1
55821,53,40795,53,196,102,94,2,30,1,1
63848,48560,32430,48560,70,70,0,1,4,1,0
52599,443,49618,443,2044,1024,1020,17,80,9,8
49941,53,57941,53,193,102,91,2,31,1,1
51230,443,29300,443,33489,19602,13887,98,43,51,47
53262,443,28483,443,4385,2869,1516,32,19,18,14
56803,53,60073,53,190,97,93,2,30,1,1
36101,53,61383,53,168,78,90,2,30,1,1
49509,443,10156,443,8248,2508,5740,31,271,13,18
9300,443,62109,443,4216,771,3445,16,26,9,7
55156,53,26617,53,194,102,92,2,31,1,1
60399,123,27117,123,184,94,90,2,30,1,1
56643,443,30724,443,8167,1980,6187,22,80,12,10
58151,443,48543,443,6563,1656,4907,22,318,13,9
57263,53,62100,53,166,85,81,2,30,1,1
51167,443,46694,443,13777,1743,12034,26,31,12,14
52929,443,62112,443,5582,1388,4194,19,15,9,10
50377,443,39949,443,7738,879,6859,19,27,10,9
65127,443,50841,443,48029,4540,43489,91,120,40,51
55687,53,38089,53,193,102,91,2,30,1,1
53199,443,19271,443,1582,965,617,15,18,7,8
55100,53,34612,53,182,102,80,2,30,1,1
62899,993,51481,993,9385,3246,6139,53,118,31,22
57470,20015,34460,20015,150,150,0,1,1199,1,0
55156,53,47566,53,256,87,169,4,37,2,2
50165,80,3536,80,17387,9304,8083,30,56,19,11
53626,33194,63366,33194,70,70,0,1,4,1,0
60319,80,61391,80,194,128,66,4,25,3,1
52181,443,64436,443,7855,815,7040,21,15,9,12
53873,52055,21698,52055,70,70,0,2,8,2,0
54853,443,64447,443,7689,3574,4115,65,308,32,33
58875,53,56659,53,370,86,284,2,30,1,1
65439,53,10579,53,228,110,118,2,30,1,1
49516,53,19547,53,183,94,89,2,31,1,1
60583,443,60583,443,1315,786,529,12,36,7,5
27005,30008,53621,30008,890,126,764,2,31,1,1
57304,53,22240,53,292,110,182,2,30,1,1
65417,53,53892,53,183,94,89,2,30,1,1
56262,53,55550,53,177,94,83,2,31,1,1
53150,80,13371,80,2398,2024,374,12,15,6,6
54012,443,7741,443,4318,726,3592,14,16,7,7
55531,53,2010,53,322,110,212,4,30,2,2
53868,443,61364,443,499,425,74,4,1,3,1
49418,27016,62306,27016,261,78,183,2,30,1,1
123,123,62754,123,184,94,90,2,30,1,1
14435,443,15912,443,2569,1470,1099,17,15,8,9
49644,80,40102,80,318,192,126,6,41,4,2
53272,443,50136,443,5544,1703,3841,19,31,11,8
53120,49860,38739,49860,70,70,0,2,8,2,0
49564,80,48576,80,318,192,126,6,45,4,2
54763,443,60297,443,7136,5777,1359,22,200,13,9
56925,443,10686,443,33095,18485,14610,73,185,43,30
53122,29070,40660,29070,758,320,438,11,16,6,5
57596,443,20240,443,8154,1791,6363,21,187,11,10
57430,53,65274,53,177,94,83,2,30,1,1
64283,53,39891,53,337,110,227,2,29,1,1
64226,53,54672,53,245,94,151,2,30,1,1
41632,443,56228,443,8507,4462,4045,27,141,14,13
56199,53,15227,53,256,93,163,2,31,1,1
56621,53,63745,53,177,94,83,2,29,1,1
58933,443,10888,443,5167,700,4467,16,15,7,9
52034,80,13450,80,4185,3462,723,14,16,7,7
64706,443,64706,443,274,132,142,5,76,3,2
64132,53,49481,53,179,94,85,2,29,1,1
60033,443,2482,443,4223,2828,1395,23,28,13,10
14272,53,14272,53,1415,689,726,3,31,2,1
49866,53,19774,53,225,110,115,2,30,1,1
65481,53,51485,53,168,86,82,2,31,1,1
49857,443,44578,443,18811,1868,16943,22,139,7,15
58536,53,40631,53,522,162,360,6,64,3,3
51424,53,58777,53,269,94,175,2,30,1,1
41890,443,5361,443,7014,1958,5056,31,18,19,12
57871,443,42705,443,7716,3991,3725,50,125,25,25
55107,53,32486,53,193,102,91,2,30,1,1
63762,123,63358,123,184,94,90,2,29,1,1
64068,53,56393,53,168,86,82,2,31,1,1
50550,53,58594,53,168,78,90,2,30,1,1
36687,53,34461,53,168,78,90,2,31,1,1
27005,27015,15539,27015,881,126,755,2,30,1,1
64892,53,23593,53,772,102,670,2,30,1,1
64432,53,49029,53,168,86,82,2,30,1,1
41857,443,32439,443,1633,1010,623,14,2424,7,7
50020,3389,50020,3389,3347,1458,1889,15,18,8,7
64009,80,25096,80,314,192,122,6,15,4,2
47168,15000,16770,15000,130,70,60,2,5,1,1
51716,5223,22569,5223,4524,1489,3035,26,1327,15,11
54467,80,25502,80,17572,1518,16054,30,255,16,14
49567,5223,11151,5223,9705,5123,4582,29,74,15,14
57351,53,37431,53,184,94,90,2,31,1,1
64025,26826,1858,26826,70,70,0,1,4,1,0
64721,443,45723,443,5552,927,4625,16,15,10,6
49838,443,59419,443,6915,3106,3809,21,144,10,11
58768,443,60756,443,18568,12357,6211,43,18,24,19
65449,53,31955,53,177,94,83,2,30,1,1
53171,443,14871,443,3220,2010,1210,20,19,10,10
51898,443,2125,443,7866,1549,6317,21,321,10,11
64818,53,60686,53,179,94,85,2,30,1,1
49845,53,47352,53,194,102,92,2,30,1,1
64870,53,42981,53,200,102,98,2,33,1,1
49179,443,25006,443,686176,17574,668602,702,18,252,450
53202,443,64942,443,3655,2344,1311,18,17,9,9
40932,8434,40932,8434,156,156,0,3,8,3,0
38897,443,50921,443,11019,4204,6815,23,49,13,10
52458,53,52458,53,231,88,143,2,33,1,1
48742,443,35072,443,5378,1423,3955,19,49,11,8
55321,53,4307,53,193,102,91,2,31,1,1
49866,443,40314,443,2937,717,2220,14,136,6,8
50588,80,50588,80,2765,1835,930,14,21,8,6
57885,443,33287,443,1792,1153,639,17,177,10,7
38664,443,9528,443,6887,1076,5811,22,50,12,10
55141,53,24444,53,184,94,90,2,30,1,1
10151,55051,56267,55051,468,149,319,2,1200,1,1
41542,23,41542,23,66,66,0,1,5,1,0
55593,53,41754,53,749,89,660,2,30,1,1
44155,53,24482,53,168,78,90,2,29,1,1
61099,443,33626,443,492,492,0,7,15,7,0
49451,443,37319,443,1855625,57182,1798443,1981,70,703,1278
37591,443,4877,443,62657,4444,58213,83,46,37,46
51831,80,34274,80,486,300,186,9,31,6,3
35187,443,10629,443,13057,1460,11597,28,255,14,14
56361,80,32552,80,9997,1306,8691,17,25,8,9
60051,80,25182,80,1327,839,488,10,142,6,4
53790,21011,8352,21011,70,70,0,1,5,1,0
65498,53,36093,53,202,103,99,2,31,1,1
64980,53,40885,53,274,88,186,4,35,2,2
59534,53,0,0,627,72,555,2,30,1,1
56728,53,16534,53,166,86,80,2,30,1,1
65231,53,56850,53,200,102,98,2,30,1,1
52182,60769,21483,60769,70,70,0,1,5,1,0
59960,443,41281,443,1953,1223,730,16,16,9,7
33087,53,33087,53,228,97,131,2,31,1,1
56919,443,47014,443,54568,32686,21882,69,161,40,29
49887,443,18602,443,977,590,387,10,87,6,4
50388,53,43330,53,94,94,0,1,29,1,0
56082,53,1185,53,730,102,628,2,29,1,1
26900,27017,16696,27017,168,82,86,2,30,1,1
52920,443,42636,443,6253,2132,4121,19,16,10,9
65000,53,40784,53,168,86,82,2,30,1,1
56922,53,56922,53,219,98,121,2,30,1,1
38369,15000,42954,15000,130,70,60,2,6,1,1
49368,443,53544,443,14412,3279,11133,33,19,17,16
58980,123,62249,123,184,94,90,2,30,1,1
57860,443,46825,443,1786,172,1614,7,120,3,4
59713,3389,59713,3389,4213,2429,1784,18,32,9,9
39252,53,39252,53,197,90,107,2,29,1,1
54370,443,2250,443,11876,2769,9107,30,76,15,15
53719,443,60186,443,70,70,0,1,5,1,0
52099,28401,4027,28401,70,70,0,2,8,2,0
51109,80,7098,80,366,240,126,7,20,5,2
43735,53,12080,53,168,78,90,2,30,1,1
63132,80,36171,80,19934,920,19014,23,15,7,16
60068,443,30976,443,2227,1018,1209,17,16,8,9
55896,53,45886,53,184,94,90,2,31,1,1
64941,53,15219,53,199,102,97,2,30,1,1
51931,19416,65025,19416,70,70,0,2,8,2,0
46404,53,46404,53,237,91,146,2,32,1,1
55742,53,11069,53,193,102,91,2,31,1,1
64958,53,60361,53,197,102,95,2,30,1,1
65524,53,9019,53,386,122,264,4,52,2,2
64798,53,6106,53,177,94,83,2,29,1,1
55003,53,31448,53,196,102,94,2,30,1,1
49177,443,60972,443,654956,17062,637894,673,18,244,429
64985,53,50795,53,412,97,315,4,58,2,2
58007,80,40862,80,318,192,126,6,21,4,2
56739,80,48782,80,1462,703,759,8,16,5,3
53077,80,56021,80,1352,625,727,8,75,5,3
57470,16721,16664,16721,163,163,0,1,1200,1,0
30188,63236,11932,63236,11247,4773,6474,66,1454,32,34
51413,443,51090,443,63766,32148,31618,103,42,51,52
58060,80,29313,80,1854,735,1119,8,16,5,3
35685,123,34944,123,184,94,90,2,30,1,1
30960,45752,44974,45752,462,462,0,8,3631,8,0
64484,53,23929,53,86,86,0,1,30,1,0
50710,80,11292,80,708,384,324,12,195,7,5
51443,443,42123,443,322,262,60,2,15,1,1
49174,53,58915,53,198,101,97,2,30,1,1
59752,443,31611,443,12150,1262,10888,29,41,13,16
56004,53,58058,53,178,94,84,2,30,1,1
55548,443,42567,443,12205,2036,10169,33,138,18,15
57470,41315,64435,41315,792,792,0,13,1199,13,0
59756,53,24009,53,211,78,133,2,29,1,1
50552,53,61704,53,757,102,655,2,30,1,1
53931,55300,33330,55300,492,306,186,8,15,5,3
50930,443,59751,443,9354,2370,6984,24,16,13,11
50699,80,24288,80,7292,3171,4121,19,21,11,8
62763,443,43714,443,7755,4481,3274,17,135,9,8
50408,8080,50408,8080,378,180,198,7,32,4,3
50562,443,27211,443,1313,876,437,11,27,6,5
49519,53,62256,53,264,94,170,2,30,1,1
39994,80,39994,80,2919,1492,1427,10,15,6,4
55171,53,4183,53,79,79,0,2,34,2,0
56496,80,21274,80,458684,19849,438835,488,66,185,303
51807,443,44757,443,3561,1098,2463,10,121,5,5
61075,53,61075,53,244,98,146,2,32,1,1
49204,54530,41547,54530,316,136,180,6,6,3,3
64886,53,27053,53,295,101,194,4,31,2,2
55694,53,60951,53,167,86,81,2,30,1,1
53084,443,55326,443,490914,83866,407048,1048,332,526,522
36644,443,15948,443,9329,3935,5394,30,405,17,13
64469,53,32950,53,342,97,245,4,42,2,2
44870,80,28005,80,1119,1045,74,7,14,6,1
42892,443,39711,443,448,78,370,6,25,1,5
60753,40010,14923,40010,316,136,180,6,6,3,3
49740,53,20760,53,166,85,81,2,30,1,1
51752,31677,14033,31677,70,70,0,1,5,1,0
46451,443,47700,443,350492,17722,332770,449,125,169,280
12934,53,12934,53,237,91,146,2,33,1,1
64977,53,18612,53,334,94,240,2,30,1,1
55350,53,18566,53,315,95,220,4,50,2,2
49183,53,29477,53,209,110,99,2,30,1,1
56484,53,42861,53,214,110,104,2,31,1,1
56827,53,18397,53,195,102,93,2,30,1,1
57866,53,0,0,627,80,547,2,29,1,1
56674,53,43592,53,182,93,89,2,31,1,1
46000,443,62571,443,2583,334,2249,7,90,3,4
52931,80,5991,80,234,234,0,4,11,4,0
58750,443,9806,443,3776,2372,1404,17,15,9,8
56556,53,6278,53,184,94,90,2,31,1,1
50909,80,20271,80,12826704,145724,12680980,10558,133,2024,8534
57389,53,29962,53,193,102,91,2,30,1,1
49319,53,53546,53,260,102,158,2,30,1,1
37695,443,3343,443,1134364,30994,1103370,1170,175,403,767
64145,53,4283,53,177,94,83,2,31,1,1
64359,53,14911,53,196,102,94,2,30,1,1
57415,53,16994,53,223,86,137,2,30,1,1
64875,53,51837,53,211,102,109,2,30,1,1
49430,443,49430,443,4377,1470,2907,19,30,11,8
38653,443,4233,443,9664,1703,7961,22,15,11,11
56779,43137,15198,43137,70,70,0,1,5,1,0
63989,20939,6044,20939,504,382,122,8,15,6,2
50582,80,62835,80,53959,2683,51276,69,16,30,39
52255,16087,20036,16087,70,70,0,2,8,2,0
52102,443,62995,443,343074,14649,328425,390,41,159,231
58248,53,0,0,633,83,550,2,30,1,1
50109,53,42164,53,198,110,88,2,30,1,1
44076,443,35127,443,202384,47621,154763,307,198,112,195
49146,443,26817,443,47589,17003,30586,283,238,128,155
65028,53,18830,53,182,93,89,2,30,1,1
49302,443,39111,443,454,262,192,8,27,5,3
65422,53,59464,53,208,94,114,2,30,1,1
49889,53,48150,53,197,102,95,2,31,1,1
9021,53,9021,53,216,90,126,2,30,1,1
50614,80,59659,80,318,192,126,6,25,4,2
64158,53,28086,53,211,102,109,2,30,1,1
57760,80,57760,80,2934,1497,1437,10,16,6,4
49767,53,52894,53,727,86,641,2,30,1,1
55616,42929,13566,42929,70,70,0,1,5,1,0
53716,443,22368,443,7055,1261,5794,21,82,10,11
60418,39537,10622,39537,70,70,0,1,5,1,0
64335,53,18778,53,186,95,91,2,30,1,1
14137,443,14137,443,155070,7155,147915,186,81,74,112
64936,53,18480,53,749,94,655,2,29,1,1
51878,9999,48543,9999,70,70,0,2,8,2,0
57863,443,39260,443,2342,1341,1001,15,19,8,7
58935,443,64941,443,5167,700,4467,16,15,7,9
57470,41024,3847,41024,330,330,0,6,1200,6,0
37475,443,1375,443,4403,2160,2243,14,136,7,7
27005,32036,64099,32036,876,126,750,2,31,1,1
56975,53,65042,53,197,102,95,2,31,1,1
49630,443,54596,443,7776,2266,5510,17,35,9,8
33538,80,33538,80,424,198,226,7,141,4,3
50731,27029,22129,27029,269,78,191,2,31,1,1
50810,443,16412,443,10682,4653,6029,28,33,15,13
63069,443,57757,443,2523249,58976,2464273,2483,33,820,1663
57257,53,4922,53,173,94,79,2,30,1,1
57470,61467,29646,61467,479,150,329,2,1199,1,1
50433,53,63561,53,193,102,91,2,29,1,1
57344,443,60771,443,3872,1641,2231,14,125,6,8
56131,53,35553,53,199,94,105,2,29,1,1
53663,80,16666,80,149148,7515,141633,197,20,95,102
51795,60258,12488,60258,70,70,0,2,8,2,0
56180,53,15802,53,200,102,98,2,30,1,1
65245,53,59048,53,193,102,91,2,30,1,1
64146,53,41885,53,194,99,95,2,31,1,1
49730,443,47083,443,4484,1063,3421,15,10,7,8
59281,80,59281,80,108922,4633,104289,194,16,66,128
49898,53,31342,53,184,94,90,2,30,1,1
49589,443,40471,443,327575,8400,319175,334,316,113,221
47932,443,21603,443,9467,2741,6726,24,20,15,9
38065,443,63899,443,15799,7457,8342,42,98,22,20
62912,53,42026,53,214,76,138,2,30,1,1
50519,443,37665,443,7967,1647,6320,25,85,14,11
55193,53,45543,53,200,102,98,2,30,1,1
53933,20801,53397,20801,70,70,0,1,4,1,0
56546,443,24280,443,134,60,74,3,5,2,1
55684,53,10799,53,186,95,91,2,30,1,1
65136,53,1364,53,86,86,0,1,30,1,0
52207,443,22846,443,74711,8646,66065,150,89,70,80
33006,80,33006,80,6582,886,5696,15,16,7,8
56951,53,44679,53,168,86,82,2,29,1,1
64174,53,47378,53,438,130,308,4,35,2,2
49227,53,18246,53,179,94,85,2,31,1,1
50373,443,34130,443,5422,707,4715,16,25,8,8
56429,443,13104,443,227145,7409,219736,252,146,86,166
64956,53,13763,53,565,92,473,4,38,2,2
56648,53,49574,53,199,102,97,2,30,1,1
42310,443,52115,443,6673,2151,4522,27,125,13,14
51398,443,32490,443,322,262,60,2,5,1,1
5643,53,5643,53,237,91,146,2,33,1,1
57512,443,32314,443,4265,2639,1626,34,31,16,18
49265,53,12727,53,181,94,87,2,31,1,1
65020,53,52884,53,289,102,187,2,30,1,1
60438,53,27899,53,154,154,0,3,46,3,0
52883,53,22567,53,339,94,245,2,30,1,1
51690,443,24259,443,9320,4615,4705,25,120,12,13
65055,53,55759,53,1426,98,1328,4,55,2,2
37886,443,62818,443,134,60,74,3,5,2,1
56161,53,2092,53,194,102,92,2,30,1,1
55594,53,44459,53,752,93,659,2,31,1,1
49247,53,4260,53,194,102,92,2,31,1,1
50479,80,2241,80,312,192,120,6,25,4,2
50626,443,22681,443,1604,987,617,16,93,9,7
41995,80,63213,80,1105,634,471,11,15,6,5
64703,53,47599,53,306,142,164,2,30,1,1
50817,443,46052,443,17161,1619,15542,18,153,4,14
60194,80,35341,80,70,70,0,2,8,2,0
60716,443,27537,443,31452,6667,24785,54,32,29,25
42854,443,46516,443,4268,2836,1432,25,19,13,12
53102,53,13819,53,70,70,0,1,30,1,0
37662,443,57596,443,4428,2241,2187,19,46,11,8
65419,53,59811,53,200,102,98,2,30,1,1
50651,80,37006,80,1555,1103,452,9,21,5,4
64799,443,56278,443,1671,1004,667,16,76,8,8
64257,53,54453,53,168,86,82,2,31,1,1
59864,443,10819,443,6066,833,5233,19,26,10,9
60293,80,44550,80,1462,864,598,11,144,6,5
53249,443,44486,443,11150,2012,9138,29,67,14,15
49577,443,34979,443,6947,833,6114,20,53,9,11
56164,53,3250,53,226,110,116,2,30,1,1
49931,53,55078,53,195,102,93,2,30,1,1
53776,37650,38223,37650,70,70,0,1,4,1,0
52102,443,38740,443,6903,3076,3827,20,136,10,10
54374,443,53616,443,7402,1350,6052,24,16,13,11
62139,53,5028,53,298,102,196,2,30,1,1
55413,53,7034,53,779,86,693,2,30,1,1
60348,80,15161,80,10335,1617,8718,19,124,9,10
56764,443,62218,443,8006,1986,6020,20,16,11,9
53734,22051,59968,22051,70,70,0,2,7,2,0
59731,443,4869,443,384,166,218,2,31,1,1
43161,443,23414,443,10102,3072,7030,25,16,14,11
53576,23505,46519,23505,70,70,0,1,5,1,0
55535,53,24278,53,199,102,97,2,29,1,1
46269,123,16380,123,184,94,90,2,30,1,1
56884,53,35715,53,199,102,97,2,30,1,1
58415,443,47391,443,145249,142210,3039,143,185,106,37
60814,443,39150,443,740,222,518,11,3631,4,7
54262,53,54262,53,198,90,108,2,30,1,1
37965,61282,39357,61282,402,132,270,6,1208,3,3
48991,80,63971,80,121475,5644,115831,163,145,81,82
5497,53,2342,53,208,78,130,2,30,1,1
52397,443,10007,443,9680,2399,7281,47,136,27,20
60130,80,60130,80,23216,1806,21410,40,28,20,20
65189,28115,45956,28115,284,78,206,2,29,1,1
56565,443,50266,443,52157,3066,49091,65,80,26,39
55936,53,21289,53,177,94,83,2,30,1,1
65373,443,38852,443,3104883,106687,2998196,3406,190,1320,2086
64919,53,63713,53,822,102,720,2,29,1,1
55718,16805,42718,16805,70,70,0,2,8,2,0
49765,53,24395,53,194,102,92,2,31,1,1
15503,50321,53712,50321,490,149,341,2,1200,1,1
60166,443,54772,443,7639,2673,4966,36,255,17,19
38131,443,7949,443,85590,4656,80934,111,37,47,64
55131,53,55323,53,244,94,150,2,30,1,1
53254,443,33543,443,4498,916,3582,18,17,9,9
37601,443,50258,443,573,425,148,5,0,3,2
41690,443,19019,443,1478937,62961,1415976,1678,148,649,1029
21147,53,21147,53,1413,688,725,3,30,2,1
58440,53,59026,53,305,102,203,2,31,1,1
49418,27017,33582,27017,71,71,0,1,30,1,0
46002,443,21932,443,6299,1424,4875,27,291,10,17
58858,443,49748,443,208,60,148,4,10,2,2
55337,53,8844,53,198,102,96,2,31,1,1
53254,443,47275,443,9949,4623,5326,45,150,23,22
56224,53,54618,53,221,102,119,2,30,1,1
58390,53,44510,53,240,76,164,2,31,1,1
64944,53,42030,53,228,94,134,2,30,1,1
56137,53,23667,53,199,102,97,2,31,1,1
52106,80,35207,80,422,240,182,8,26,5,3
23066,443,23066,443,5573,2434,3139,21,25,12,9
37673,443,65454,443,3226,2225,1001,18,47,11,7
37334,443,47156,443,6592,1735,4857,23,360,11,12
47681,443,29966,443,6790,1336,5454,20,187,11,9
65057,53,8165,53,211,94,117,2,30,1,1
55449,443,46191,443,480989,16896,464093,507,22,178,329
57340,53,43547,53,370,94,276,2,30,1,1
51886,35965,55520,35965,66,66,0,1,5,1,0
28481,53,51837,53,205,86,119,2,30,1,1
57840,53,57840,53,183,82,101,2,30,1,1
49921,53,58309,53,214,110,104,2,30,1,1
64403,53,60359,53,198,101,97,2,30,1,1
50657,443,9730,443,3339,2205,1134,21,38,13,8
54534,443,41952,443,7153,2581,4572,28,74,15,13
51851,48605,8820,48605,136,136,0,3,14,3,0
55615,13826,16063,13826,70,70,0,2,8,2,0
27005,27056,32268,27056,908,126,782,2,30,1,1
60608,53,20949,53,199,94,105,2,30,1,1
65053,53,62092,53,197,94,103,2,30,1,1
56561,53,8736,53,183,94,89,2,29,1,1
52142,54954,48530,54954,66,66,0,1,5,1,0
50307,443,61889,443,1786,172,1614,7,120,3,4
49920,443,59929,443,6489,2137,4352,28,143,14,14
55252,443,43197,443,16179,1763,14416,38,46,17,21
45416,80,25189,80,2713,753,1960,12,15,7,5
49717,53,61877,53,781,94,687,2,30,1,1
57029,53,63160,53,246,94,152,2,30,1,1
56293,53,1963,53,166,86,80,2,30,1,1
64705,53,6395,53,213,102,111,2,30,1,1
49417,53,32052,53,211,110,101,2,30,1,1
56956,53,61460,53,183,94,89,2,30,1,1
26900,27017,55434,27017,422,164,258,6,29,3,3
50002,53,33820,53,192,98,94,2,31,1,1
30960,45721,23609,45721,66,66,0,1,3600,1,0
64934,53,51307,53,197,102,95,2,33,1,1
51932,36498,40161,36498,70,70,0,1,5,1,0
43931,53,36161,53,168,78,90,2,31,1,1
57356,443,4225,443,7802,4189,3613,22,136,11,11
50896,80,56677,80,11459959,142694,11317265,9719,135,1994,7725
60591,53,64106,53,78,78,0,1,29,1,0
60363,443,34155,443,2962,796,2166,10,120,5,5
42379,443,33462,443,1622,1137,485,11,26,7,4
55646,14420,30714,14420,70,70,0,1,5,1,0
56468,53,30389,53,180,94,86,2,30,1,1
59614,53,24145,53,417,78,339,2,30,1,1
43098,443,63074,443,3133,1883,1250,19,16,9,10
53889,19002,16357,19002,552,306,246,9,15,5,4
65138,53,7886,53,418,94,324,2,30,1,1
64326,53,53148,53,323,107,216,4,38,2,2
64322,53,52794,53,250,94,156,2,30,1,1
49602,53,44779,53,247,102,145,2,30,1,1
56829,53,58561,53,170,87,83,2,30,1,1
64360,53,15501,53,350,88,262,4,31,2,2
57115,53,18402,53,178,94,84,2,30,1,1
43146,80,15239,80,1102,545,557,10,16,6,4
53904,443,54254,443,495,421,74,4,0,3,1
57436,53,43639,53,733,85,648,2,30,1,1
49701,80,63516,80,70321,956,69365,62,52,11,51
64438,53,41293,53,184,94,90,2,31,1,1
44679,80,35749,80,3180,2317,863,12,11,7,5
49365,53,27288,53,195,102,93,2,29,1,1
55723,80,12672,80,70,70,0,2,8,2,0
53738,443,58635,443,499,425,74,4,0,3,1
22452,443,22452,443,5785,2575,3210,24,76,14,10
32185,53,63584,53,86,86,0,1,30,1,0
60069,443,60069,443,5610,2363,3247,22,40,13,9
33923,443,55200,443,4472,1666,2806,13,121,6,7
56441,80,25376,80,130,70,60,2,15,1,1
37815,443,28606,443,6226,4834,1392,17,125,11,6
27416,53,27416,53,214,82,132,2,32,1,1
52189,443,16564,443,36007,4328,31679,65,217,33,32
57010,53,46777,53,199,102,97,2,30,1,1
56233,53,2635,53,399,97,302,4,59,2,2
65258,53,21767,53,178,94,84,2,30,1,1
65371,53,53875,53,356,101,255,4,55,2,2
51733,5228,35376,5228,6967,1929,5038,25,128,14,11
50329,80,27783,80,1550,728,822,13,47,7,6
64326,53,26486,53,196,102,94,2,30,1,1
48480,443,23315,443,10409,2670,7739,94,5805,17,77
65470,443,40363,443,372361,11310,361051,385,16,136,249
49181,2710,53031,2710,70,70,0,2,8,2,0
57117,80,29144,80,1049,679,370,8,16,5,3
55340,53,17205,53,184,94,90,2,30,1,1
57408,53,37720,53,195,102,93,2,30,1,1
58784,443,22318,443,5168,700,4468,16,15,7,9
57984,80,44496,80,5474,3658,1816,27,76,14,13
49206,53,44411,53,179,94,85,2,30,1,1
57998,80,49916,80,318,192,126,6,21,4,2
57061,53,26951,53,711,87,624,2,30,1,1
64091,53,24113,53,178,94,84,2,30,1,1
64783,53,41526,53,561,99,462,4,38,2,2
51805,15298,5839,15298,70,70,0,1,5,1,0
64095,53,63030,53,177,94,83,2,29,1,1
5757,80,5757,80,104444,4047,100397,122,126,52,70
53215,443,56280,443,6983,1629,5354,17,15,9,8
63530,3389,63530,3389,3489,1534,1955,17,19,9,8
60702,443,49529,443,13618,5262,8356,54,101,26,28
65469,53,29881,53,195,102,93,2,31,1,1
56853,53,30375,53,167,86,81,2,29,1,1
56147,53,61785,53,258,110,148,2,30,1,1
55492,53,58378,53,760,96,664,2,31,1,1
57464,443,33460,443,7715,1772,5943,25,275,13,12
37965,56605,48626,56605,847,152,695,4,1201,2,2
55871,53,26416,53,181,94,87,2,29,1,1
55057,53,53863,53,211,110,101,2,30,1,1
15503,51413,47539,51413,459,149,310,2,1200,1,1
51754,7000,51754,7000,4727,2346,2381,19,16,12,7
56151,53,10029,53,194,102,92,2,30,1,1
58380,80,42000,80,3130,2290,840,15,135,8,7
54983,80,49933,80,27816,7362,20454,69,240,41,28
57263,53,2666,53,167,86,81,2,29,1,1
64028,53,51007,53,293,134,159,2,30,1,1
53893,11344,37839,11344,70,70,0,2,8,2,0
56529,53,10690,53,378,94,284,2,30,1,1
64974,53,53114,53,214,110,104,2,30,1,1
45204,53,45204,53,237,91,146,2,33,1,1
52039,80,22816,80,4185,3462,723,14,15,7,7
27005,27015,34776,27015,882,126,756,2,31,1,1
63707,28423,64677,28423,564,382,182,9,16,6,3
56163,53,45369,53,265,85,180,4,41,2,2
51427,80,51427,80,22364,4125,18239,41,26,19,22
65435,53,59924,53,196,94,102,2,29,1,1
49448,80,49448,80,3193,2163,1030,17,79,10,7
54887,443,54887,443,5573,2326,3247,22,40,13,9
64882,53,14352,53,180,94,86,2,30,1,1
33568,443,55064,443,9180,2197,6983,36,34,20,16
58832,443,61522,443,274798,9459,265339,343,201,136,207
49560,80,60008,80,318,192,126,6,45,4,2
55330,53,61986,53,194,102,92,2,31,1,1
65437,53,4286,53,165,86,79,2,30,1,1
50038,53,5932,53,170,87,83,2,31,1,1
56697,53,31729,53,196,100,96,2,31,1,1
35050,80,51635,80,350,210,140,6,30,4,2
63062,53,6744,53,303,85,218,2,30,1,1
53917,35885,30826,35885,70,70,0,2,8,2,0
5234,28162,61929,28162,449555,320,449235,719,50,6,713
62102,443,60782,443,3182,1568,1614,8,121,4,4
65418,53,64332,53,211,102,109,2,30,1,1
34658,80,20483,80,6094,954,5140,15,3601,8,7
49636,53,15924,53,180,94,86,2,31,1,1
49874,53,62950,53,196,94,102,2,30,1,1
3195,53,3195,53,197,90,107,2,29,1,1
52763,443,13803,443,256711,14141,242570,367,96,152,215
53436,443,53436,443,2505,1460,1045,21,102,10,11
53985,26515,51989,26515,70,70,0,2,7,2,0
10151,11888,57602,11888,491,150,341,2,1200,1,1
52426,443,50838,443,782,428,354,12,28,7,5
48941,443,29294,443,7437,2128,5309,22,33,13,9
52501,443,44230,443,163226,10147,153079,233,101,101,132
56960,53,22344,53,192,98,94,2,31,1,1
62287,443,17565,443,3644,610,3034,13,119,6,7
50692,443,11802,443,152,86,66,2,5,1,1
49491,443,61216,443,33157,17446,15711,66,135,38,28
50329,443,35211,443,12026,3494,8532,28,82,14,14
50577,80,17204,80,2350,896,1454,13,25,7,6
60800,40010,5284,40010,316,136,180,6,5,3,3
39785,53,39785,53,229,98,131,2,30,1,1
59810,443,33915,443,630054,19786,610268,711,381,261,450
64617,53,31755,53,389,102,287,4,33,2,2
60969,443,65231,443,1373,712,661,14,105,8,6
57464,80,18705,80,78,78,0,1,5,1,0
59757,443,52007,443,384,166,218,2,29,1,1
49493,80,3964,80,143422,12598,130824,226,487,52,174
50999,443,48896,443,33716,17750,15966,134,329,72,62
50961,80,36404,80,5730066,61301,5668765,4686,81,891,3795
37027,443,52306,443,90706,5324,85382,128,262,66,62
5236,35120,49591,35120,23369,64,23305,65,31,2,63
50483,443,61825,443,12462,2612,9850,37,80,19,18
53404,443,26776,443,8437,4827,3610,50,180,25,25
27005,27016,18663,27016,892,126,766,2,30,1,1
55232,53,45264,53,170,87,83,2,30,1,1
56492,53,1811,53,94,94,0,1,30,1,0
49483,53,48622,53,178,94,84,2,30,1,1
55308,53,65535,53,194,94,100,2,30,1,1
48994,443,64205,443,46452,6817,39635,103,299,45,58
33254,443,31595,443,4838,2974,1864,21,17,13,8
55653,53,34737,53,199,102,97,2,30,1,1
49806,443,11715,443,37255,2202,35053,46,125,17,29
63139,53,8265,53,78,78,0,2,31,2,0
56441,53,35817,53,209,110,99,2,29,1,1
57418,443,57418,443,4736,1759,2977,20,26,11,9
60291,53,5136,53,78,78,0,1,30,1,0
55144,53,13694,53,316,94,222,2,29,1,1
35921,443,5709,443,5207,1058,4149,21,150,12,9
49418,27020,19032,27020,246,71,175,2,31,1,1
55723,80,48588,80,70,70,0,1,5,1,0
60006,80,32015,80,1836,816,1020,12,143,7,5
56643,53,48653,53,195,102,93,2,30,1,1
57248,443,32420,443,1021056,38101,982955,1183,64,501,682
64945,53,11913,53,760,97,663,2,30,1,1
51867,48059,47188,48059,160,70,90,2,5,1,1
56519,80,41989,80,370,222,148,6,32,4,2
51843,45702,23719,45702,1261,637,624,9,30,5,4
63855,80,40243,80,4529,1221,3308,14,75,8,6
65366,443,3510,443,4319,2473,1846,24,85,10,14
38705,443,49826,443,1248170,26899,1221271,1212,16,382,830
52082,80,6337,80,4560,3934,626,11,29,6,5
55386,53,64239,53,822,102,720,2,30,1,1
43218,443,34506,443,2683108,71922,2611186,2467,150,623,1844
49410,53,14771,53,167,86,81,2,30,1,1
57352,53,8029,53,192,98,94,2,31,1,1
22678,443,22678,443,18172,3573,14599,39,26,20,19
57470,2710,46091,2710,124,124,0,3,1199,3,0
27005,29999,55945,29999,887,126,761,2,31,1,1
55875,53,42726,53,228,110,118,2,30,1,1
56405,53,42424,53,226,102,124,2,30,1,1
5588,5588,0,0,3562,1936,1626,48,194,24,24
57067,53,11799,53,183,94,89,2,30,1,1
44903,80,37166,80,918,461,457,9,16,6,3
56523,53,57340,53,168,86,82,2,30,1,1
43818,53,4303,53,168,78,90,2,30,1,1
49595,53,47380,53,180,94,86,2,30,1,1
55702,80,56730,80,70,70,0,2,8,2,0
58172,80,64584,80,12618,1038,11580,28,50,13,15
56420,443,5096,443,9876,5607,4269,66,122,35,31
60804,40010,37467,40010,316,136,180,6,5,3,3
63985,53,11526,53,351,103,248,4,46,2,2
55271,53,6211,53,168,86,82,2,30,1,1
38406,443,5076,443,564,292,272,9,26,5,4
55154,443,34870,443,2251,1098,1153,25,120,12,13
40333,80,15004,80,1049,975,74,6,15,5,1
57171,53,25491,53,214,102,112,2,30,1,1
52112,53559,37444,53559,316,136,180,6,6,3,3
46987,443,53868,443,8688,3211,5477,24,343,11,13
49713,80,27859,80,5029,1986,3043,16,130,8,8
55958,53,60321,53,170,87,83,2,31,1,1
54596,443,49824,443,4510,2210,2300,14,136,7,7
32869,53,32869,53,197,90,107,2,30,1,1
38010,443,65428,443,5474,2239,3235,31,80,14,17
57086,53,59882,53,228,102,126,2,29,1,1
65525,443,9387,443,92247,4799,87448,107,15,43,64
55034,443,40095,443,14671,2953,11718,31,31,17,14
44320,443,12809,443,7244,1861,5383,26,330,14,12
49604,80,21319,80,454,262,192,8,41,5,3
50265,18659,34655,18659,481,150,331,2,1200,1,1
56627,53,58271,53,193,102,91,2,29,1,1
28039,443,43641,443,5576,1388,4188,19,15,9,10
49925,80,49556,80,1126,609,517,11,15,6,5
53764,6881,51389,6881,1463,821,642,15,15,8,7
57470,44667,49855,44667,480,149,331,2,1200,1,1
51974,443,51489,443,11486,5080,6406,24,121,12,12
50974,80,38911,80,181877,8980,172897,207,22,87,120
51933,80,57196,80,717,651,66,7,15,6,1
55464,53,43920,53,216,94,122,2,30,1,1
42283,443,51990,443,16831,14003,2828,31,63,18,13
62063,443,35010,443,25511,1260,24251,34,121,13,21
53669,80,61903,80,1119,665,454,12,15,7,5
49384,53,27649,53,181,94,87,2,30,1,1
59831,53,14617,53,198,93,105,2,30,1,1
54956,53,60675,53,194,102,92,2,31,1,1
27005,27015,57738,27015,1638,126,1512,4,30,2,2
35615,443,10957,443,6179,1242,4937,22,42,11,11
49607,53,13201,53,259,102,157,2,29,1,1
50451,80,26551,80,378,192,186,7,28,4,3
65445,53,31304,53,199,102,97,2,30,1,1
50023,53,26218,53,166,86,80,2,31,1,1
55010,53,1751,53,245,94,151,2,29,1,1
52920,443,54361,443,31161,4934,26227,73,115,32,41
41030,80,41030,80,80261,4766,75495,91,126,35,56
63760,37264,26706,37264,504,382,122,8,16,6,2
54974,53,5978,53,212,102,110,2,30,1,1
62075,443,48853,443,9318,3002,6316,28,46,16,12
49971,53,19251,53,779,110,669,2,30,1,1
53572,22754,38870,22754,70,70,0,2,8,2,0
56217,53,16338,53,183,94,89,2,29,1,1
55635,53,27124,53,170,87,83,2,30,1,1
59964,443,21876,443,1346200,44765,1301435,1428,128,479,949
55192,53,55863,53,178,94,84,2,30,1,1
37965,52608,29898,52608,1577,594,983,20,2766,10,10
19698,502,19698,502,60,60,0,1,5,1,0
5588,5588,0,0,3354,1792,1562,46,195,23,23
46236,53,38054,53,199,94,105,2,30,1,1
49898,53,22442,53,184,94,90,2,30,1,1
57285,443,38646,443,21198,9647,11551,97,20,52,45
51781,43909,29947,43909,70,70,0,2,8,2,0
49705,80,19257,80,2733,591,2142,11,45,6,5
27005,27015,38295,27015,874,126,748,2,30,1,1
55254,53,23493,53,195,102,93,2,30,1,1
58049,443,10248,443,8242,1641,6601,22,360,12,10
55204,53,12205,53,263,94,169,2,30,1,1
55155,53,2864,53,183,94,89,2,29,1,1
55872,53,55193,53,819,102,717,2,30,1,1
49675,53,53697,53,199,102,97,2,30,1,1
65192,53,25403,53,249,102,147,2,30,1,1
49197,53,13288,53,777,87,690,2,30,1,1
53745,18569,48041,18569,70,70,0,2,8,2,0
57396,443,32290,443,152,78,74,2,4,1,1
65336,53,9283,53,200,102,98,2,29,1,1
51944,80,27996,80,2120,1080,1040,17,55,10,7
55613,56511,52356,56511,504,318,186,8,15,5,3
55937,53,58356,53,179,94,85,2,30,1,1
55208,53,2198,53,177,94,83,2,30,1,1
6882,6889,43478,6889,221,111,110,2,1200,1,1
50869,80,23647,80,28291,3346,24945,46,144,25,21
60398,443,6115,443,8060,1868,6192,28,16,15,13
51917,80,25082,80,43399,5061,38338,55,29,24,31
56624,53,45708,53,170,87,83,2,30,1,1
55926,80,55926,80,450,246,204,8,29,5,3
64053,53,64715,53,276,94,182,4,55,2,2
57470,52177,52924,52177,1980,1980,0,31,2321,31,0
60681,443,60681,443,5667,1393,4274,19,16,9,10
45484,443,14429,443,5766,1575,4191,24,589,13,11
51845,80,51845,80,28037,2069,25968,40,26,16,24
64397,53,47942,53,658,186,472,6,51,3,3
34424,53,34424,53,235,90,145,2,33,1,1
62928,443,42185,443,52219,4148,48071,75,125,33,42
46963,443,17005,443,70,70,0,1,5,1,0
58805,80,4161,80,1702,1388,314,10,16,5,5
55703,13836,54739,13836,70,70,0,2,8,2,0
55946,443,34803,443,9274,5282,3992,42,186,22,20
50308,80,8289,80,1083,653,430,8,16,5,3
64184,443,64184,443,4561,1654,2907,19,28,11,8
56587,53,37194,53,184,94,90,2,30,1,1
53819,9472,3134,9472,70,70,0,1,5,1,0
64513,53,7726,53,396,102,294,2,31,1,1
38662,443,42991,443,6525,1695,4830,19,51,8,11
59755,443,15018,443,448,166,282,2,30,1,1
50449,443,5504,443,7588,1850,5738,19,25,10,9
50940,443,27136,443,29500,27698,1802,51,17,29,22
13088,80,11600,80,4079,3203,876,12,97,8,4
50547,80,14282,80,378,192,186,7,21,4,3
61376,443,37067,443,31612,3374,28238,59,271,29,30
36762,443,46444,443,560,280,280,9,25,5,4
49570,443,54043,443,1013,492,521,10,30,4,6
57337,443,40846,443,1169,616,553,12,16,7,5
58536,53,15925,53,177,86,91,2,30,1,1
50343,80,37536,80,1192,658,534,11,41,6,5
48174,443,2102,443,3889,1992,1897,19,255,10,9
54955,53,32337,53,177,94,83,2,30,1,1
50660,80,5489,80,875,327,548,9,15,5,4
56664,80,24275,80,1056,682,374,10,15,6,4
50603,443,4652,443,3443,2189,1254,23,72,13,10
43927,443,42119,443,3410,1249,2161,16,136,8,8
51338,443,48161,443,424,210,214,7,131,4,3
55835,53,15423,53,180,94,86,2,29,1,1
56651,80,31520,80,11855,7269,4586,28,115,15,13
55940,53,24862,53,168,86,82,2,30,1,1
41292,443,17156,443,7644,1098,6546,19,35,10,9
53271,443,21027,443,1544,1073,471,13,15,8,5
56704,53,35730,53,210,94,116,2,30,1,1
62293,443,17682,443,598,598,0,8,40,8,0
55029,443,56750,443,35270,2782,32488,48,51,22,26
38317,443,31937,443,9834,4297,5537,26,326,12,14
64852,53,45042,53,209,110,99,2,30,1,1
56625,53,47756,53,193,102,91,2,30,1,1
55830,53,32937,53,183,94,89,2,30,1,1
51962,1024,18199,1024,316,136,180,6,5,3,3
54576,443,43696,443,5670,3091,2579,16,121,8,8
56492,53,39207,53,177,94,83,2,30,1,1
60272,443,24375,443,1853,1214,639,18,87,11,7
55076,53,14239,53,183,94,89,2,30,1,1
56873,53,25069,53,184,94,90,2,30,1,1
64367,443,15536,443,4741,1306,3435,26,300,14,12
48817,23944,48817,23944,513,152,361,2,1201,1,1
57798,443,21508,443,12877,5188,7689,27,130,12,15
57470,44573,53035,44573,883,288,595,4,1200,2,2
62349,443,37822,443,3942042,47512,3894530,3167,53,526,2641
35716,53,38842,53,168,78,90,2,30,1,1
49313,53,45650,53,199,102,97,2,30,1,1
50585,80,63970,80,1726,963,763,13,80,7,6
51960,443,28367,443,2648,1797,851,19,23,11,8
35742,443,2430,443,5612,1251,4361,22,65,12,10
55512,53,3521,53,458,188,270,6,30,3,3
9105,443,49589,443,4077,438,3639,12,15,6,6
50263,53,58515,53,771,102,669,2,30,1,1
55774,443,58031,443,6092,3093,2999,16,120,8,8
34095,53,34095,53,243,104,139,2,30,1,1
48857,53,48857,53,213,82,131,2,30,1,1
56258,53,50751,53,772,103,669,2,30,1,1
49434,53,25380,53,183,86,97,2,29,1,1
59758,443,28743,443,384,166,218,2,29,1,1
64595,53,62622,53,167,86,81,2,30,1,1
55517,53,64032,53,179,94,85,2,29,1,1
49928,53,15390,53,243,102,141,2,30,1,1
55353,53,50744,53,168,86,82,2,30,1,1
56169,53,17161,53,916,86,830,2,30,1,1
56996,53,54322,53,177,94,83,2,30,1,1
55113,53,62881,53,198,102,96,2,33,1,1
7665,80,7665,80,110567,7016,103551,135,46,60,75
65189,27212,4653,27212,254,78,176,2,29,1,1
60297,53,6955,53,227,86,141,2,30,1,1
53774,58433,12540,58433,320,140,180,6,7,3,3
2267,53,13385,53,204,118,86,2,31,1,1
49953,80,9395,80,11209,819,10390,19,15,9,10
57470,1337,6563,1337,330,330,0,6,1200,6,0
50537,5223,31982,5223,12710,4688,8022,44,2961,19,25
30834,53,30834,53,194,87,107,2,30,1,1
65523,443,11792,443,92518,4869,87649,109,15,44,65
64322,53,60744,53,273,90,183,4,33,2,2
64576,53,33878,53,188,96,92,2,31,1,1
63567,443,49835,443,2467,1198,1269,22,186,11,11
64710,53,5594,53,195,102,93,2,29,1,1
52514,80,2585,80,3224,2776,448,11,15,7,4
49578,443,49511,443,6947,833,6114,20,54,9,11
49337,53,52249,53,199,102,97,2,30,1,1
56430,443,5643,443,2274816,85295,2189521,2305,127,825,1480
63820,27441,46760,27441,70,70,0,1,4,1,0
65513,53,49907,53,186,102,84,2,30,1,1
27005,27019,28663,27019,1652,126,1526,4,31,2,2
49418,27016,42028,27016,246,71,175,2,30,1,1
49424,53,53979,53,228,110,118,2,30,1,1
27005,30000,27515,30000,913,126,787,2,31,1,1
6881,6881,37919,6881,238,118,120,2,1200,1,1
53465,443,55749,443,3166,2245,921,15,15,8,7
55197,53,53428,53,701,88,613,2,31,1,1
60591,53,16493,53,218,78,140,2,31,1,1
56104,53,22926,53,197,102,95,2,30,1,1
56779,53,7300,53,757,98,659,2,30,1,1
56296,53,12716,53,216,110,106,2,29,1,1
51813,443,19561,443,3182,1568,1614,8,121,4,4
36873,80,37820,80,1115,534,581,12,16,7,5
10052,443,12703,443,1832,1113,719,18,110,10,8
56176,53,62297,53,102,102,0,1,30,1,0
55591,53,62499,53,195,102,93,2,31,1,1
27005,27017,42100,27017,891,126,765,2,30,1,1
60433,123,65242,123,184,94,90,2,29,1,1
57470,23848,47855,23848,545,166,379,2,1199,1,1
50881,80,32099,80,128327,7366,120961,154,141,67,87
57078,3389,57078,3389,3407,1518,1889,16,17,9,7
8892,443,11185,443,8106,1626,6480,31,341,11,20
48817,6889,48817,6889,480,149,331,2,1200,1,1
62488,443,33482,443,1326,876,450,11,32,6,5
53392,53,29793,53,164,78,86,2,31,1,1
55635,53,55876,53,177,94,83,2,30,1,1
50479,443,28335,443,1654,1011,643,16,82,9,7
63817,50808,9849,50808,66,66,0,2,8,2,0
43616,5228,36276,5228,2322,1296,1026,15,3600,6,9
50458,443,34106,443,44532,3294,41238,56,128,21,35
54635,443,11319,443,11955,1861,10094,30,172,14,16
57438,443,63629,443,7720,2815,4905,22,20,10,12
56940,53,36969,53,200,102,98,2,31,1,1
55830,53,20748,53,177,94,83,2,30,1,1
64467,80,64467,80,5570,699,4871,14,22,7,7
64274,53,21757,53,299,104,195,4,35,2,2
58848,443,1963,443,5168,700,4468,16,15,7,9
44847,20101,53137,20101,150,150,0,1,1200,1,0
51077,13021,36103,13021,154976,25739,129237,605,387,321,284
63934,53,45085,53,202,103,99,2,30,1,1
64095,443,63841,443,9895,2094,7801,52,262,23,29
61410,80,27494,80,297783,19995,277788,543,158,229,314
64525,53,61457,53,199,102,97,2,30,1,1
56742,443,19670,443,1327,918,409,10,34,6,4
50599,80,5247,80,8601,6265,2336,18,26,10,8
61230,53,16263,53,177,94,83,2,29,1,1
56216,53,35008,53,177,94,83,2,29,1,1
51718,55003,38571,55003,70,70,0,2,8,2,0
59936,443,30573,443,10879,3057,7822,38,32,21,17
57144,8525,57144,8525,138,78,60,2,5,1,1
64839,53,19060,53,208,106,102,2,31,1,1
55164,53,14668,53,177,94,83,2,30,1,1
57010,53,64390,53,199,102,97,2,30,1,1
49240,53,18179,53,199,102,97,2,30,1,1
52479,443,31867,443,9326,1833,7493,24,131,12,12
57574,443,57574,443,164451,18310,146141,163,175,52,111
53897,46913,50139,46913,552,306,246,9,15,5,4
26900,27017,1204,27017,422,164,258,6,30,3,3
57888,443,55452,443,113115,8327,104788,184,177,77,107
55809,443,23452,443,180,180,0,4,11,4,0
57008,80,59299,80,214,140,74,4,31,3,1
37957,443,45183,443,7280,2250,5030,15,120,7,8
51566,443,47460,443,9451,3719,5732,45,76,25,20
63741,36776,9191,36776,70,70,0,1,4,1,0
49967,53,55984,53,303,100,203,4,40,2,2
52677,53,52677,53,233,91,142,2,31,1,1
55273,53,29396,53,167,86,81,2,30,1,1
49418,27018,3626,27018,71,71,0,1,30,1,0
49416,443,60307,443,27484,4857,22627,42,46,15,27
55742,53,55832,53,193,102,91,2,30,1,1
49308,53,0,0,627,80,547,2,29,1,1
60987,443,57213,443,9029,2323,6706,31,16,17,14
65465,53,17852,53,755,102,653,2,29,1,1
62101,443,33220,443,1867,250,1617,8,120,4,4
35176,80,37365,80,1987,1329,658,10,136,6,4
52354,443,50559,443,10417,5338,5079,22,135,11,11
64698,53,34866,53,211,102,109,2,30,1,1
50116,80,62862,80,10094,1100,8994,20,33,10,10
46899,443,24525,443,70,70,0,1,5,1,0
45109,443,9498,443,190,70,120,4,15,2,2
54512,80,54512,80,1923,1474,449,10,20,6,4
65514,53,50854,53,170,87,83,2,30,1,1
55267,53,18171,53,168,86,82,2,31,1,1
50584,6881,21374,6881,161,161,0,1,1200,1,0
53868,52706,33006,52706,70,70,0,2,7,2,0
53653,17436,48182,17436,70,70,0,2,8,2,0
34059,80,37168,80,1151,711,440,10,15,5,5
44187,443,10571,443,12382,2688,9694,37,361,19,18
55242,443,59852,443,214,140,74,4,15,3,1
16693,53,16693,53,217,87,130,2,31,1,1
53463,29500,1810,29500,877,577,300,10,143,5,5
53911,443,57422,443,1346,918,428,10,33,6,4
38670,443,55536,443,501559,13849,487710,527,15,193,334
55868,53,18445,53,177,94,83,2,30,1,1
58820,443,32869,443,5167,700,4467,16,15,7,9
57045,53,27906,53,170,87,83,2,30,1,1
51457,443,1251,443,334,70,264,5,17,1,4
3697,80,55800,80,6688,1208,5480,20,104,12,8
51490,5223,60793,5223,9801,5352,4449,28,473,16,12
7701,80,7701,80,900,519,381,7,141,4,3
50466,53,25118,53,295,101,194,4,30,2,2
35267,80,35004,80,613,539,74,7,15,6,1
52144,80,16896,80,366,240,126,7,33,5,2
49767,53,3628,53,177,94,83,2,29,1,1
52524,80,48631,80,3224,2776,448,11,15,7,4
53028,443,47549,443,12081,2070,10011,33,620,12,21
50317,80,30399,80,5438,2832,2606,18,56,10,8
65220,53,41846,53,184,94,90,2,30,1,1
55193,53,9970,53,200,102,98,2,30,1,1
57470,62314,37389,62314,1188,1188,0,19,2338,19,0
57432,53,10564,53,193,102,91,2,31,1,1
64242,53,41761,53,180,94,86,2,30,1,1
0,0,0,0,244,244,0,2,0,2,0
64632,53,26914,53,224,94,130,2,30,1,1
27988,40017,42811,40017,148,86,62,2,30,1,1
49838,53,52067,53,183,94,89,2,31,1,1
65264,53,8238,53,256,88,168,4,35,2,2
49424,443,6642,443,77408,4295,73113,106,271,52,54
61408,80,60964,80,420720,29056,391664,771,159,325,446
42298,40010,33875,40010,148,86,62,2,31,1,1
61696,443,54803,443,9097,2123,6974,25,16,15,10
49941,53,34590,53,186,95,91,2,31,1,1
56775,20617,21189,20617,70,70,0,1,5,1,0
65144,53,32702,53,653,86,567,4,46,2,2
56550,53,42634,53,166,86,80,2,30,1,1
52100,54130,10499,54130,70,70,0,2,8,2,0
64599,53,12199,53,767,102,665,2,30,1,1
49826,53,60102,53,466,192,274,6,83,3,3
55990,53,30769,53,183,94,89,2,30,1,1
53578,34129,11045,34129,70,70,0,2,7,2,0
64821,53,30415,53,775,102,673,2,30,1,1
53853,443,32341,443,1966450,57437,1909013,1885,338,544,1341
9121,80,6298,80,318,192,126,6,29,4,2
55552,53,38672,53,767,102,665,2,30,1,1
52711,443,64979,443,107997,3957,104040,135,80,51,84
65049,53,32515,53,204,104,100,2,31,1,1
65114,53,53193,53,177,94,83,2,29,1,1
50186,443,39007,443,6440,1603,4837,23,361,11,12
46273,5228,19288,5228,5239,1558,3681,27,4020,9,18
50630,443,47610,443,5013,968,4045,20,87,11,9
55003,53,40085,53,196,102,94,2,30,1,1
42764,53,15953,53,164,78,86,2,31,1,1
51812,15279,9004,15279,70,70,0,2,8,2,0
56082,53,20820,53,184,94,90,2,30,1,1
27005,27055,18786,27055,915,126,789,2,30,1,1
55045,53,38947,53,747,92,655,2,30,1,1
27005,27202,9481,27202,872,126,746,2,29,1,1
45455,443,59423,443,17237,2632,14605,34,420,18,16
53736,443,20137,443,499,425,74,4,0,3,1
41629,15000,21496,15000,130,70,60,2,5,1,1
27005,27015,14961,27015,884,126,758,2,30,1,1
57780,53,53500,53,70,70,0,1,30,1,0
55087,53,55975,53,182,93,89,2,31,1,1
57132,53,52410,53,216,110,106,2,31,1,1
53098,30840,23341,30840,898,454,444,13,22,8,5
64726,53,58493,53,352,94,258,2,30,1,1
27005,27015,7639,27015,919,126,793,2,30,1,1
42460,443,50577,443,2907,1719,1188,17,361,9,8
9416,443,41034,443,6090,773,5317,17,25,9,8
51880,8000,3169,8000,172,94,78,2,29,1,1
55066,443,25317,443,12715,3716,8999,28,62,16,12
50703,80,64252,80,1082,896,186,18,214,15,3
51997,14398,36359,14398,130,70,60,2,5,1,1
59005,443,25143,443,4921,2525,2396,14,135,7,7
64090,443,49482,443,7360,2435,4925,19,135,9,10
9304,443,28860,443,3922,552,3370,16,16,8,8
55609,53,4360,53,178,94,84,2,30,1,1
48340,443,49643,443,18198,13269,4929,47,324,20,27
58938,443,4576,443,6035,770,5265,18,15,8,10
49890,443,49782,443,2513598,90400,2423198,2658,280,896,1762
57470,46941,64707,46941,899,288,611,4,1199,2,2
52159,16297,7644,16297,70,70,0,2,8,2,0
51773,23728,8041,23728,70,70,0,1,5,1,0
55005,53,53050,53,183,94,89,2,29,1,1
49662,53,31424,53,268,93,175,4,58,2,2
49650,53,14821,53,821,102,719,2,29,1,1
56137,53,49352,53,199,102,97,2,29,1,1
60449,80,21730,80,50477,10880,39597,69,16,33,36
38135,80,24108,80,111328,4904,106424,145,240,66,79
55949,53,62692,53,774,101,673,2,30,1,1
61426,80,34225,80,214,140,74,4,41,3,1
37321,53,37321,53,197,90,107,2,30,1,1
60491,38789,32066,38789,320,140,180,6,7,3,3
49740,53,58621,53,167,86,81,2,29,1,1
56979,53,43376,53,180,94,86,2,31,1,1
56382,53,40376,53,195,102,93,2,29,1,1
64029,53,26038,53,180,94,86,2,30,1,1
64995,53,18804,53,204,104,100,2,31,1,1
56995,53,19045,53,196,94,102,2,30,1,1
54652,53,54652,53,216,98,118,2,30,1,1
41931,443,53560,443,8579,2273,6306,17,136,8,9
38101,443,19198,443,350,210,140,6,15,4,2
58046,443,22923,443,1536,1089,447,11,56,7,4
53867,60272,36955,60272,70,70,0,1,5,1,0
56491,80,30431,80,37154,2381,34773,50,135,23,27
56600,443,35329,443,7941,1952,5989,20,15,11,9
56743,53,5034,53,209,110,99,2,30,1,1
64273,53,19409,53,256,102,154,2,30,1,1
54707,443,60614,443,5826,1199,4627,21,42,11,10
56822,53,57328,53,184,94,90,2,29,1,1
58835,443,42835,443,5166,700,4466,16,15,7,9
51768,80,6690,80,211684,9903,201781,247,27,109,138
64064,53,52675,53,257,94,163,2,30,1,1
49247,53,64384,53,776,283,493,8,82,4,4
55812,443,35991,443,9398,2478,6920,26,82,14,12
15503,58675,42815,58675,2227,1224,1003,20,1200,11,9
55672,45682,48139,45682,70,70,0,2,8,2,0
56615,443,28312,443,4425,2899,1526,24,34,14,10
58900,5223,13059,5223,160,86,74,2,6,1,1
37564,443,37233,443,1386,924,462,12,30,7,5
46230,53,46230,53,257,101,156,2,33,1,1
49922,443,6981,443,11466,1320,10146,22,135,10,12
51797,30712,27964,30712,70,70,0,1,5,1,0
50265,64304,32485,64304,970,598,372,14,1201,8,6
65460,53,1825,53,177,94,83,2,30,1,1
27005,32055,61239,32055,878,126,752,2,31,1,1
49406,80,42946,80,2074,1309,765,10,124,6,4
57246,53,12706,53,752,93,659,2,31,1,1
56715,443,19932,443,1207531,28695,1178836,1184,46,400,784
12945,53,12945,53,233,90,143,2,32,1,1
56808,53,41016,53,90,90,0,1,30,1,0
60970,80,26224,80,912,472,440,8,15,3,5
60306,53,57588,53,168,78,90,2,29,1,1
54961,443,58980,443,1015861,30762,985099,1147,257,421,726
55457,53,25879,53,177,94,83,2,30,1,1
50034,53,20576,53,179,94,85,2,30,1,1
49418,27015,26473,27015,280,71,209,2,31,1,1
56712,443,63256,443,8058,2038,6020,20,15,11,9
52156,18238,30723,18238,70,70,0,1,5,1,0
56202,53,15464,53,196,102,94,2,29,1,1
50589,443,28626,443,10257,6305,3952,31,134,19,12
50395,80,11837,80,487,180,307,6,26,4,2
52297,443,5562,443,3055,1931,1124,16,16,9,7
20,64488,20,50706,624666,17676,606990,671,14,267,404
58714,53,58714,53,197,76,121,2,30,1,1
56472,53,22766,53,177,94,83,2,30,1,1
57418,53,1554,53,165,86,79,2,31,1,1
59865,443,51225,443,502,250,252,9,26,5,4
51756,41471,23556,41471,70,70,0,2,8,2,0
36306,53,36306,53,229,89,140,2,30,1,1
42336,443,36600,443,4181,998,3183,14,26,7,7
54995,53,57538,53,199,102,97,2,30,1,1
55483,443,25400,443,4496,2369,2127,15,136,7,8
65228,53,60799,53,267,93,174,4,47,2,2
38993,443,34045,443,7089,1290,5799,24,16,12,12
51100,80,29611,80,12300,4454,7846,26,30,13,13
43423,443,64524,443,130,70,60,2,15,1,1
52261,53,10393,53,195,94,101,2,29,1,1
50585,443,60446,443,1594,951,643,15,97,8,7
47165,15000,50664,15000,130,70,60,2,5,1,1
55664,45682,37882,45682,320,140,180,6,6,3,3
9158,53,9158,53,237,91,146,2,33,1,1
50637,80,36749,80,175050,8089,166961,167,48,48,119
49277,53,3822,53,821,102,719,2,30,1,1
12230,53,12230,53,216,90,126,2,29,1,1
38011,443,62208,443,14337,3375,10962,47,121,23,24
64959,53,9017,53,209,110,99,2,30,1,1
65185,53,26657,53,453,186,267,6,30,3,3
55740,53,13751,53,228,110,118,2,30,1,1
32908,443,31863,443,1780845,46018,1734827,1751,141,546,1205
46812,80,23325,80,1137,679,458,10,15,6,4
49884,53,44954,53,232,110,122,2,30,1,1
56654,443,29055,443,18544,4402,14142,31,191,14,17
55640,54435,42654,54435,70,70,0,1,5,1,0
25237,53,25237,53,216,82,134,2,33,1,1
0,0,0,0,320,320,0,5,0,5,0
55629,53,49009,53,208,94,114,2,30,1,1
56317,53,26526,53,183,94,89,2,30,1,1
65340,53,38317,53,313,110,203,4,33,2,2
51041,80,59300,80,1514,480,1034,11,15,6,5
54360,443,12392,443,7723,2282,5441,22,255,11,11
60217,80,16783,80,4050,2838,1212,14,16,7,7
61113,27045,20306,27045,1778,1386,392,8,30,4,4
49304,7010,49304,7010,6247,4138,2109,21,15,13,8
27005,27016,44583,27016,898,126,772,3,31,2,1
65176,53,64803,53,299,103,196,4,51,2,2
59559,443,47582,443,3255,1089,2166,10,122,5,5
57590,80,57590,80,1165239,13055,1152184,977,149,193,784
57146,53,5349,53,199,102,97,2,29,1,1
49450,53,42470,53,330,118,212,2,30,1,1
63926,53,50565,53,260,102,158,2,31,1,1
55196,53,52555,53,711,87,624,2,30,1,1
56391,443,8649,443,13706,5958,7748,78,202,42,36
60423,443,39132,443,11488,7258,4230,47,122,27,20
55817,53,47066,53,177,94,83,2,30,1,1
63968,53,26432,53,200,102,98,2,30,1,1
55182,53,17791,53,199,102,97,2,30,1,1
49349,53,14349,53,183,94,89,2,30,1,1
57165,53,7622,53,498,204,294,6,30,3,3
65115,53,14088,53,167,86,81,2,30,1,1
43934,443,29568,443,2548,1257,1291,15,416,8,7
50895,443,56217,443,6354,1373,4981,18,129,9,9
61811,443,37922,443,214,140,74,4,15,3,1
57470,11696,14471,11696,353,166,187,2,1199,1,1
64338,443,59182,443,1786,172,1614,7,120,3,4
50627,443,16215,443,8256,1674,6582,31,75,15,16
53163,443,16194,443,7432,1694,5738,23,27,12,11
50622,53,8191,53,177,94,83,2,31,1,1
64303,53,57962,53,177,94,83,2,29,1,1
38366,15000,19494,15000,130,70,60,2,6,1,1
63090,53,11762,53,510,164,346,2,31,1,1
63922,32305,41561,32305,312,132,180,6,6,3,3
56881,53,21712,53,181,86,95,2,30,1,1
50089,443,48630,443,12446,2347,10099,44,190,23,21
50056,27018,7128,27018,468,390,78,5,30,4,1
63991,443,63991,443,4597,1690,2907,19,28,11,8
50265,7205,64572,7205,1488,930,558,21,1200,12,9
49631,53,56350,53,198,102,96,2,30,1,1
64924,53,49056,53,292,126,166,2,30,1,1
57432,443,22941,443,26468,3325,23143,41,147,16,25
53696,50321,25044,50321,70,70,0,2,7,2,0
37621,443,45461,443,27993,2483,25510,51,48,25,26
55126,53,7380,53,177,94,83,2,30,1,1
55186,443,62291,443,7375,1549,5826,31,353,10,21
38139,443,10441,443,49386,4604,44782,82,32,43,39
49496,443,45834,443,15404,11220,4184,29,27,16,13
60569,443,44105,443,10385,4932,5453,21,135,9,12
58802,443,37884,443,8591,2275,6316,37,137,21,16
59007,443,65066,443,2608,1523,1085,19,15,10,9
50672,80,28058,80,1515,481,1034,11,16,6,5
49480,7000,49480,7000,3050,1659,1391,16,15,9,7
61688,443,16509,443,14462,3625,10837,31,63,16,15
55144,53,47771,53,209,102,107,2,30,1,1
6881,6881,34169,6881,502,150,352,2,1200,1,1
51925,29587,42996,29587,70,70,0,2,8,2,0
64546,53,39505,53,183,94,89,2,31,1,1
52215,16937,53036,16937,136,136,0,3,12,3,0
49824,53,50073,53,198,94,104,2,30,1,1
49762,80,8921,80,2114,1182,932,10,127,6,4
57914,443,40977,443,17285,4005,13280,26,120,11,15
56331,443,61535,443,1786,172,1614,7,121,3,4
46278,443,29099,443,6685,4843,1842,29,17,18,11
16223,443,54966,443,7461,1034,6427,21,16,11,10
50289,443,30139,443,9571,2811,6760,45,87,24,21
56587,53,8172,53,184,94,90,2,31,1,1
49804,443,24644,443,5938,1521,4417,20,125,10,10
64613,53,60043,53,179,94,85,2,30,1,1
50587,80,50587,80,1711,1011,700,11,21,6,5
50433,443,11749,443,134,60,74,3,10,2,1
55037,443,19621,443,10640,3171,7469,28,45,15,13
38369,443,64342,443,434,226,208,7,28,4,3
49173,80,62950,80,254,128,126,5,15,3,2
30201,53,30201,53,235,90,145,2,33,1,1
52197,19845,30024,19845,70,70,0,2,7,2,0
49418,27111,53348,27111,258,78,180,2,30,1,1
37965,58609,35622,58609,15544,7978,7566,132,3153,72,60
41775,443,57658,443,7036547,93047,6943500,5816,186,995,4821
57322,443,7352,443,8237,2784,5453,35,16,21,14
9067,443,32087,443,11768028,275478,11492550,12305,77,4158,8147
60001,443,64771,443,10580,2487,8093,28,16,16,12
55620,53,6956,53,178,94,84,2,31,1,1
53137,35111,13746,35111,70,70,0,2,8,2,0
51814,443,41543,443,6133,1655,4478,12,120,5,7
54489,80,6564,80,2828,1710,1118,10,255,6,4
39378,443,56513,443,494,342,152,4,5,2,2
49516,53,42173,53,183,94,89,2,30,1,1
9479,443,13111,443,6100,777,5323,17,25,9,8
48790,443,60676,443,7298,2661,4637,21,19,11,10
64602,53,34002,53,184,94,90,2,30,1,1
53245,443,53245,443,1220,659,561,13,120,7,6
41670,80,41670,80,3571,2892,679,13,23,8,5
49759,53,54239,53,166,86,80,2,30,1,1
64235,53,18011,53,197,102,95,2,30,1,1
51971,80,56168,80,426,240,186,8,26,5,3
64599,53,27573,53,398,102,296,2,30,1,1
39473,443,53063,443,9590,3811,5779,20,122,10,10
57157,53,38785,53,173,94,79,2,30,1,1
56654,53,7518,53,306,306,0,4,47,4,0
65139,53,1458,53,216,110,106,2,30,1,1
49296,53,40772,53,193,102,91,2,30,1,1
50330,443,24584,443,9585,2138,7447,26,82,13,13
64082,53,61850,53,329,102,227,2,30,1,1
64822,53,9057,53,200,94,106,2,30,1,1
57222,53,51448,53,177,94,83,2,30,1,1
50755,80,50755,80,450,246,204,8,25,5,3
39475,443,29487,443,3310,2291,1019,17,16,10,7
55265,53,19057,53,740,93,647,2,31,1,1
53886,443,40309,443,499,425,74,4,0,3,1
27005,27018,49128,27018,879,126,753,2,30,1,1
35751,80,35751,80,336615,15190,321425,383,31,159,224
55100,53,15692,53,182,102,80,2,30,1,1
52039,80,39126,80,366,240,126,7,25,5,2
50127,80,7047,80,164773,6196,158577,200,135,83,117
56891,53,55899,53,226,110,116,2,30,1,1
53081,443,13924,443,16157,6478,9679,46,83,23,23
52151,53,52151,53,198,89,109,2,31,1,1
47950,443,47950,443,9159,1627,7532,19,150,11,8
49429,53,51638,53,199,102,97,2,29,1,1
57357,443,47242,443,126,60,66,3,11,2,1
40940,443,19885,443,9856,1973,7883,32,140,17,15
45844,443,26065,443,44232,11223,33009,97,460,50,47
51764,33432,6081,33432,70,70,0,1,5,1,0
64113,53,33491,53,294,134,160,2,30,1,1
55027,53,14460,53,177,94,83,2,29,1,1
44850,443,60943,443,4502,895,3607,15,25,9,6
49885,53,38127,53,377,94,283,2,30,1,1
63974,53,33864,53,618,111,507,4,30,2,2
39158,53,23110,53,168,78,90,2,30,1,1
59019,53,48512,53,179,86,93,2,30,1,1
64422,53,60156,53,180,94,86,2,29,1,1
51657,80,10496,80,318,192,126,6,37,4,2
65496,123,10878,123,184,94,90,2,30,1,1
43591,443,23363,443,4680,2835,1845,33,80,16,17
57262,53,45135,53,94,94,0,1,30,1,0
55342,443,55342,443,5593,2346,3247,22,39,13,9
55903,53,48648,53,177,94,83,2,30,1,1
54934,443,9475,443,11700,3386,8314,63,362,33,30
49573,443,16183,443,7332,2197,5135,18,135,8,10
55417,53,34497,53,198,102,96,2,33,1,1
63970,28423,20673,28423,564,382,182,9,15,6,3
54753,443,7702,443,84945,5052,79893,120,360,61,59
48965,443,50088,443,9519,4377,5142,33,354,17,16
55820,53,60004,53,194,102,92,2,31,1,1
44893,53,32339,53,199,94,105,2,30,1,1
55598,41565,5694,41565,70,70,0,1,5,1,0
37168,443,5501,443,4871,923,3948,19,360,10,9
43564,53,37702,53,199,94,105,2,30,1,1
52944,53,19420,53,168,78,90,2,30,1,1
27988,40012,43574,40012,253,190,63,2,30,1,1
49897,443,23230,443,33013,21249,11764,151,492,79,72
64929,53,16910,53,168,86,82,2,31,1,1
53601,30160,62732,30160,70,70,0,1,4,1,0
55956,443,61641,443,6058,1749,4309,22,200,13,9
65416,53,1423,53,758,102,656,2,30,1,1
58876,80,60067,80,32098,2435,29663,47,75,24,23
58760,443,41927,443,45482,2178,43304,56,15,22,34
49219,80,41190,80,2010,664,1346,11,84,7,4
39053,443,36119,443,6699,4494,2205,27,29,14,13
51813,63933,50803,63933,70,70,0,2,8,2,0
59275,443,56019,443,242735602,5306961,237428641,238334,3604,81340,156994
53801,443,63448,443,499,425,74,4,0,3,1
52072,25595,25464,25595,70,70,0,2,8,2,0
64303,53,3497,53,212,102,110,2,30,1,1
49543,80,13855,80,1548,847,701,10,15,5,5
53392,53,53392,53,832,106,726,2,30,1,1
49786,53,59022,53,752,110,642,2,30,1,1
39224,53,62138,53,168,78,90,2,29,1,1
56890,443,61166,443,6935,1415,5520,22,186,12,10
56928,53,10586,53,178,94,84,2,30,1,1
55010,53,42242,53,195,102,93,2,29,1,1
59752,443,56734,443,2233,1237,996,18,75,9,9
58056,443,56911,443,866223,30135,836088,916,138,300,616
58409,53,57147,53,307,86,221,2,30,1,1
56878,53,49284,53,168,86,82,2,31,1,1
64303,443,22839,443,3205,781,2424,17,135,8,9
56640,53,60510,53,733,93,640,2,31,1,1
21133,33447,47731,33447,481,150,331,2,1199,1,1
49183,53,46145,53,817,102,715,2,30,1,1
49891,80,47196,80,1376,946,430,8,86,5,3
49580,53,62367,53,196,102,94,2,30,1,1
60755,443,57914,443,61151,2474,58677,61,25,16,45
16384,443,23910,443,2227,1018,1209,17,16,8,9
46248,443,47277,443,979612,946319,33293,1091,25,690,401
53853,443,28816,443,3692,2154,1538,25,81,12,13
49432,53,21540,53,199,94,105,2,30,1,1
50479,443,34516,443,5491,2608,2883,17,122,8,9
49450,443,10791,443,5792,1511,4281,19,77,11,8
56252,53,39340,53,228,110,118,2,30,1,1
53117,37529,38733,37529,70,70,0,1,5,1,0
49361,53,51044,53,184,94,90,2,31,1,1
60996,443,58632,443,6043,1568,4475,11,120,4,7
49214,58485,20411,58485,70,70,0,1,5,1,0
60760,20010,11977,20010,70,70,0,1,5,1,0
56247,53,6224,53,215,102,113,2,30,1,1
43113,443,54317,443,3083,1817,1266,18,15,8,10
65427,53,2149,53,238,94,144,2,30,1,1
46440,443,14076,443,8465,3202,5263,23,120,10,13
64801,7000,64801,7000,2269,815,1454,14,15,7,7
49540,443,8159,443,7454,2377,5077,33,130,15,18
63882,49163,63966,49163,66,66,0,1,5,1,0
60036,53,52040,53,86,86,0,1,30,1,0
64974,53,31114,53,214,110,104,2,30,1,1
49735,443,60036,443,378,256,122,7,18,5,2
59350,443,59350,443,4401,1494,2907,19,27,11,8
64949,53,27960,53,472,124,348,4,39,2,2
59948,80,1436,80,1756,414,1342,12,15,6,6
10003,40811,32278,40811,292,158,134,2,30,1,1
51995,443,36323,443,9966,5049,4917,41,15,25,16
64244,53,63345,53,199,102,97,2,31,1,1
56453,53,58094,53,243,94,149,2,30,1,1
64613,53,11249,53,212,102,110,2,30,1,1
2582,80,2582,80,8395,700,7695,17,15,8,9
39827,53,39827,53,247,98,149,2,33,1,1
49490,53,6765,53,364,92,272,4,38,2,2
50063,443,44505,443,39888,5010,34878,60,104,32,28
52886,443,7611,443,26307,17595,8712,52,498,29,23
54941,80,51171,80,2513,567,1946,10,75,6,4
59298,80,59298,80,85989,14398,71591,143,15,40,103
59522,443,54778,443,8743,2676,6067,30,25,16,14
65035,53,56043,53,234,102,132,2,30,1,1
60995,443,11816,443,7583,2669,4914,31,17,16,15
14420,443,3846,443,5103,3164,1939,32,168,17,15
49817,53,35154,53,286,110,176,2,30,1,1
57259,443,65344,443,6439,1702,4737,21,68,13,8
56456,53,8981,53,195,102,93,2,30,1,1
49636,443,58848,443,9790,1841,7949,24,136,12,12
52607,443,60417,443,18341,14819,3522,59,1044,31,28
49480,53,49480,53,213,79,134,2,32,1,1
35292,8100,19734,8100,234,234,0,4,11,4,0
52202,443,56757,443,3036,818,2218,12,119,6,6
4956,53,4956,53,203,82,121,2,30,1,1
57015,53,61760,53,279,94,185,2,30,1,1
35810,443,45947,443,9276,1884,7392,23,94,13,10
50564,443,39683,443,8182,1488,6694,23,133,13,10
54743,80,43064,80,6453,1316,5137,16,315,9,7
64946,53,45329,53,210,102,108,2,30,1,1
64460,53,1617,53,196,102,94,2,30,1,1
60479,53928,56520,53928,70,70,0,1,5,1,0
55107,53,60741,53,184,94,90,2,29,1,1
44847,6892,1040,6892,279,161,118,3,1200,2,1
59031,80,8208,80,4119,611,3508,12,18,4,8
57470,8621,39581,8621,469,150,319,2,1199,1,1
57350,53,19217,53,771,101,670,2,31,1,1
50971,443,37029,443,469,403,66,4,0,3,1
50017,443,54344,443,51055,17321,33734,147,612,77,70
59725,443,21996,443,304,86,218,2,31,1,1
33748,443,24979,443,70,70,0,2,5,2,0
51589,80,62521,80,2091,1098,993,21,300,11,10
56775,53,53871,53,177,94,83,2,30,1,1
44907,80,29624,80,1514,962,552,7,16,5,2
61054,53,61054,53,237,91,146,2,33,1,1
56557,443,11082,443,36053,3513,32540,54,96,25,29
52002,80,36032,80,546,300,246,10,24,6,4
56160,53,10248,53,94,94,0,1,30,1,0
65514,53,61722,53,291,98,193,4,33,2,2
49360,53,44969,53,263,102,161,2,29,1,1
57022,80,30750,80,77115,5003,72112,110,35,56,54
53252,443,33448,443,41435,6615,34820,85,193,46,39
48840,443,52863,443,3297,2327,970,22,51,11,11
52119,49239,18789,49239,258,70,188,4,8,2,2
43228,443,18463,443,1527,940,587,14,22,8,6
50906,80,26380,80,13949172,164502,13784670,11537,135,2287,9250
57109,53,44560,53,711,87,624,2,31,1,1
49584,80,44285,80,318,192,126,6,42,4,2
57893,80,44001,80,318,192,126,6,26,4,2
50668,80,30546,80,24370,5713,18657,37,26,17,20
64519,53,14591,53,195,102,93,2,29,1,1
56336,53,29646,53,178,94,84,2,30,1,1
49519,443,49519,443,15064,2611,12453,43,76,23,20
47534,443,60052,443,291717,11752,279965,319,137,123,196
39683,443,12229,443,101895,6430,95465,152,175,66,86
55153,53,36786,53,733,94,639,2,30,1,1
64422,53,12114,53,180,94,86,2,31,1,1
57470,6881,50879,6881,1806,726,1080,24,2426,12,12
27997,80,36977,80,3683,591,3092,11,45,6,5
64578,53,53350,53,186,95,91,2,31,1,1
65382,443,15464,443,15607,5238,10369,36,126,19,17
55315,53,24638,53,196,102,94,2,31,1,1
65470,53,21136,53,226,94,132,2,30,1,1
65515,53,18334,53,195,102,93,2,29,1,1
56674,53,17434,53,183,94,89,2,31,1,1
33771,53,38746,53,506,316,190,3,30,2,1
53608,1024,20573,1024,70,70,0,1,5,1,0
53460,443,38830,443,25079,5739,19340,39,337,18,21
49305,53,59053,53,177,94,83,2,29,1,1
50378,443,14135,443,7738,879,6859,19,27,10,9
56984,53,7040,53,199,102,97,2,29,1,1
48817,6889,48817,6889,502,158,344,2,1200,1,1
46460,443,35545,443,5117,3501,1616,29,80,15,14
65292,53,23690,53,190,97,93,2,31,1,1
58077,36653,53473,36653,204,64,140,4,11,2,2
33922,443,8890,443,6084,1842,4242,26,329,14,12
46774,53,46774,53,235,90,145,2,33,1,1
49580,53,60391,53,196,102,94,2,30,1,1
51982,80,47547,80,14487990,289826,14198164,13259,54,3839,9420
62069,443,28586,443,38455,5252,33203,71,60,41,30
56266,53,11208,53,193,102,91,2,30,1,1
50862,443,14909,443,9930,2085,7845,21,318,11,10
34351,53,57036,53,202,83,119,2,31,1,1
50438,53,44786,53,296,101,195,4,31,2,2
61440,443,7179,443,7896,1207,6689,20,26,10,10
57288,443,50391,443,840,420,420,14,39,7,7
49320,53,28326,53,185,102,83,2,30,1,1
57143,53,34750,53,184,94,90,2,31,1,1
54819,443,17467,443,70,70,0,1,4,1,0
65404,53,11597,53,182,94,88,2,30,1,1
56279,53,33232,53,228,110,118,2,30,1,1
59778,443,33771,443,6723,1014,5709,19,29,10,9
46500,443,37783,443,494,280,214,8,29,5,3
55021,443,46013,443,31237,2116,29121,57,195,24,33
34163,443,6967,443,5035,768,4267,14,15,8,6
39724,443,28049,443,45852,4123,41729,61,17,25,36
57077,53,61276,53,166,86,80,2,30,1,1
55896,53,29667,53,733,94,639,2,30,1,1
35925,443,8324,443,1092248,9101,1083147,860,195,111,749
53589,40281,44450,40281,70,70,0,1,4,1,0
27005,30006,1523,30006,888,126,762,2,31,1,1
40768,443,17418,443,3287,2049,1238,12,32,7,5
50553,443,23117,443,1632,1023,609,16,133,9,7
63892,8080,57373,8080,1269,548,721,10,15,6,4
64572,443,16176,443,24918,2042,22876,40,16,19,21
55469,443,55469,443,4579,1672,2907,19,29,11,8
49791,53,7553,53,216,94,122,2,30,1,1
58453,443,9103,443,9972,2138,7834,39,130,19,20
49349,53,12679,53,405,110,295,4,38,2,2
57301,53,33321,53,170,87,83,2,31,1,1
58921,443,58921,443,4627,1720,2907,19,28,11,8
61414,443,14574,443,5020,860,4160,18,28,9,9
52489,443,60427,443,32975,9028,23947,39,15,18,21
65040,53,64754,53,749,94,655,2,30,1,1
34657,443,29815,443,3521,516,3005,12,15,6,6
49867,443,24010,443,7461,2841,4620,19,103,11,8
44351,53,3058,53,168,78,90,2,30,1,1
56709,53,55050,53,211,102,109,2,30,1,1
56569,53,5839,53,181,94,87,2,32,1,1
35515,80,62151,80,841,715,126,5,15,3,2
49528,53,57566,53,177,94,83,2,30,1,1
60295,53,27114,53,224,94,130,2,30,1,1
57132,443,41283,443,6489,1065,5424,22,255,12,10
55912,53,3506,53,184,94,90,2,30,1,1
63937,53,8865,53,183,94,89,2,30,1,1
64758,53,8387,53,734,94,640,2,30,1,1
41269,443,9096,443,78,78,0,1,5,1,0
33642,443,1036,443,8533,4446,4087,65,160,32,33
55754,53,35474,53,177,94,83,2,30,1,1
28010,443,22569,443,5515,1388,4127,18,15,9,9
62923,993,4264,993,9848,4639,5209,83,41,42,41
63728,11785,52016,11785,66,66,0,2,8,2,0
56519,53,32715,53,711,87,624,2,30,1,1
50567,443,48889,443,7367,1149,6218,18,26,9,9
49466,53,56538,53,202,103,99,2,31,1,1
49547,443,61463,443,7817,1780,6037,26,172,13,13
52005,33191,35955,33191,70,70,0,1,5,1,0
52014,80,24294,80,30427,2131,28296,66,32,25,41
49233,53,56407,53,196,102,94,2,29,1,1
56661,53,7946,53,297,102,195,4,33,2,2
64811,53,37013,53,193,102,91,2,29,1,1
64288,53,10803,53,182,93,89,2,31,1,1
64047,16221,34665,16221,66,66,0,2,8,2,0
49898,53,13665,53,184,94,90,2,30,1,1
64937,53,49091,53,94,94,0,1,30,1,0
52513,443,40002,443,5096,810,4286,15,15,8,7
64520,53,59126,53,196,100,96,2,30,1,1
64143,53,33110,53,179,94,85,2,30,1,1
53756,443,48419,443,499,425,74,4,0,3,1
50239,53,39194,53,183,94,89,2,30,1,1
65249,53,21680,53,182,102,80,2,30,1,1
53712,44822,45976,44822,320,140,180,6,5,3,3
9329,443,17986,443,3255,430,2825,11,15,6,5
55027,53,18719,53,168,86,82,2,30,1,1
56725,53,37417,53,176,90,86,3,55,2,1
49516,80,21754,80,1256,746,510,11,70,6,5
55479,53,49461,53,232,94,138,2,30,1,1
8890,443,57332,443,4367,1108,3259,37,426,11,26
51491,443,61886,443,343,163,180,6,15,3,3
53815,17290,25400,17290,70,70,0,1,4,1,0
49880,80,21728,80,2087,1215,872,8,88,5,3
49569,53,26958,53,821,102,719,2,30,1,1
55671,53,24025,53,196,102,94,2,33,1,1
56777,42486,21252,42486,70,70,0,1,5,1,0
54680,443,15778,443,1786,172,1614,7,120,3,4
49489,53,23234,53,241,118,123,2,30,1,1
49896,443,43604,443,5996,976,5020,19,35,10,9
27910,53,18233,53,211,94,117,2,30,1,1
58266,443,20650,443,5619,1387,4232,18,205,10,8
50985,80,61422,80,613,539,74,7,15,6,1
55199,53,58104,53,212,108,104,2,30,1,1
57898,443,41076,443,240332,6623,233709,258,170,92,166
55996,53,61146,53,196,86,110,2,30,1,1
63529,53,63529,53,217,91,126,2,30,1,1
33136,443,16239,443,6648,1556,5092,23,29,13,10
50008,53,59037,53,359,95,264,4,46,2,2
6775,53,6775,53,228,90,138,2,32,1,1
38753,443,17390,443,29887852,586245,29301607,27419,299,7975,19444
64751,53,29777,53,172,88,84,2,30,1,1
50980,443,34954,443,7959,3288,4671,19,97,11,8
56998,53,64754,53,177,94,83,2,30,1,1
41751,443,36135,443,4570,792,3778,15,15,8,7
58492,443,51321,443,5611,1560,4051,22,266,13,9
57427,53,45535,53,363,94,269,2,30,1,1
48981,15000,58211,15000,130,70,60,2,5,1,1
57095,53,33152,53,177,94,83,2,30,1,1
55039,53,21186,53,177,94,83,2,30,1,1
62187,443,25960,443,36473,7710,28763,63,124,27,36
38175,443,55489,443,10208,2219,7989,37,125,19,18
63908,33945,27378,33945,312,132,180,6,7,3,3
50319,53,41804,53,188,96,92,2,31,1,1
53876,53380,35736,53380,70,70,0,2,8,2,0
56660,53,55953,53,183,94,89,2,31,1,1
33982,80,37305,80,1152,712,440,10,15,5,5
57164,443,51715,443,522,78,444,8,22,2,6
56835,53,37097,53,170,87,83,2,31,1,1
40290,22,40290,22,66,66,0,1,5,1,0
44691,53,43758,53,199,94,105,2,30,1,1
37965,32305,6845,32305,1650,1650,0,26,1537,26,0
56507,80,59986,80,1583,712,871,10,136,6,4
60222,443,18964,443,4308,1658,2650,14,16,7,7
52090,443,7071,443,6383,5237,1146,19,16,11,8
57192,53,34742,53,170,87,83,2,31,1,1
38703,443,53775,443,90561,3481,87080,96,16,31,65
58431,443,11477,443,5771,3201,2570,22,161,10,12
57335,443,56068,443,56199,3856,52343,81,216,39,42
53435,443,53435,443,2503,1457,1046,21,102,10,11
55973,53,5208,53,939,678,261,2,30,1,1
5588,5588,0,0,3562,1936,1626,48,195,24,24
51818,80,64733,80,366,240,126,7,25,5,2
49831,53,24463,53,364,102,262,2,30,1,1
55308,443,1473,443,4981,943,4038,20,360,10,10
58302,443,37691,443,4611,3176,1435,26,30,15,11
1739,80,1739,80,198357,5070,193287,197,95,63,134
58970,80,38149,80,1521,967,554,10,75,6,4
57721,443,65259,443,1019,644,375,10,37,6,4
59248,443,51315,443,8332,1024,7308,21,25,11,10
55656,53,30150,53,413,102,311,2,30,1,1
49418,23333,56641,23333,244,71,173,2,30,1,1
52181,1038,23058,1038,70,70,0,2,8,2,0
36003,443,8954,443,70007,4677,65330,92,172,36,56
49351,53,27652,53,166,86,80,2,30,1,1
51221,55497,24312,55497,330,330,0,6,1200,6,0
41184,53,29887,53,168,78,90,2,30,1,1
49900,443,19208,443,52800,13228,39572,134,154,64,70
56711,443,47786,443,8005,1985,6020,20,15,11,9
61060,53,61060,53,257,106,151,2,30,1,1
52110,80,18812,80,422,240,182,8,26,5,3
44687,443,14376,443,3054,1741,1313,20,27,8,12
27005,30009,8020,30009,889,126,763,3,31,2,1
49326,53,16602,53,186,95,91,2,30,1,1
65222,53,8527,53,212,102,110,2,30,1,1
38708,443,36955,443,90166,3481,86685,96,15,31,65
65274,53,19286,53,295,101,194,4,32,2,2
52142,54954,50454,54954,70,70,0,2,8,2,0
59366,443,63784,443,59122,7352,51770,85,322,41,44
52018,2425,48269,2425,70,70,0,1,5,1,0
56221,443,24462,443,129824,16359,113465,185,459,79,106
50992,443,14898,443,49212,42366,6846,109,147,59,50
56490,80,11731,80,43084,3056,40028,60,135,27,33
57329,443,20931,443,7472,2014,5458,29,16,16,13
2588,53,2588,53,197,76,121,2,30,1,1
53834,443,62616,443,499,425,74,4,0,3,1
65241,53,65497,53,196,100,96,2,30,1,1
54036,443,30085,443,43295,8391,34904,66,49,32,34
13826,53,57057,53,200,94,106,2,31,1,1
49636,53,21781,53,176,90,86,2,31,1,1
50563,443,65476,443,1313,876,437,11,26,6,5
54818,443,9214,443,13069,6969,6100,37,164,23,14
58855,443,45547,443,5168,700,4468,16,14,7,9
34856,443,47870,443,7524,1903,5621,31,22,18,13
49737,443,48877,443,35419,29471,5948,42,31,27,15
55163,53,35742,53,194,99,95,2,31,1,1
52008,49383,8718,49383,70,70,0,2,8,2,0
56811,44008,31634,44008,3034,1547,1487,12,16,7,5
56308,443,13053,443,1622,1137,485,11,26,7,4
65532,53,6977,53,255,102,153,2,29,1,1
37889,53,32762,53,199,94,105,2,30,1,1
51815,28665,41311,28665,70,70,0,2,7,2,0
56198,53,15932,53,789,110,679,2,31,1,1
55624,53,62232,53,244,94,150,2,29,1,1
50623,443,64489,443,1350,773,577,15,107,8,7
60632,53,3971,53,179,86,93,2,29,1,1
11044,443,11044,443,6981,948,6033,17,27,10,7
49776,53,15280,53,289,92,197,4,31,2,2
49773,53,17034,53,199,94,105,2,30,1,1
56748,53,55168,53,184,94,90,2,30,1,1
50599,80,50599,80,4228,3295,933,17,19,9,8
54242,443,22470,443,499,425,74,4,0,3,1
30188,27772,64348,27772,502,150,352,2,1200,1,1
41395,443,34255,443,6292,1492,4800,22,17,11,11
52774,80,57936,80,432,240,192,8,101,5,3
27005,32055,20958,32055,878,126,752,2,31,1,1
37606,443,60055,443,499,425,74,4,0,3,1
27005,1401,26580,1401,864,126,738,2,30,1,1
64378,53,28947,53,273,94,179,2,30,1,1
65110,53,12122,53,754,191,563,6,51,3,3
55447,53,41152,53,194,102,92,2,30,1,1
64882,53,8935,53,246,94,152,2,30,1,1
50356,53,7944,53,176,90,86,2,31,1,1
39057,53,39057,53,222,90,132,2,30,1,1
58827,443,27580,443,5167,700,4467,16,15,7,9
51038,443,30038,443,7263,1830,5433,27,16,15,12
56419,53,27801,53,199,102,97,2,30,1,1
52077,51638,13368,51638,70,70,0,2,8,2,0
53135,14297,19034,14297,70,70,0,2,8,2,0
5908,3389,5908,3389,3850,1745,2105,19,18,11,8
51753,15038,53015,15038,66,66,0,1,5,1,0
60053,53,50009,53,199,94,105,2,30,1,1
50801,443,41271,443,6893,1384,5509,19,140,9,10
55353,53,65240,53,168,86,82,2,30,1,1
49857,53,44627,53,165,86,79,2,29,1,1
56812,49600,3950,49600,3060,1569,1491,12,16,7,5
56963,53,8410,53,199,102,97,2,31,1,1
49917,53,29420,53,209,110,99,2,29,1,1
49523,80,32458,80,1399,826,573,11,38,6,5
52487,443,29392,443,13734,3206,10528,26,150,13,13
50665,443,2947,443,2626,1638,988,19,83,11,8
57174,53,65010,53,755,94,661,2,30,1,1
55046,443,52512,443,3804,1099,2705,19,137,8,11
50697,80,53956,80,2525,1403,1122,22,272,12,10
56674,80,12315,80,156,156,0,3,8,3,0
49436,53,51466,53,765,102,663,2,30,1,1
59940,80,29186,80,1169137,23501,1145636,1104,22,344,760
56652,443,7084,443,8006,1986,6020,20,15,11,9
40695,53,6681,53,168,78,90,2,29,1,1
56332,53,50254,53,186,95,91,2,30,1,1
50945,80,50945,80,78911,2499,76412,88,26,32,56
55455,443,13171,443,1786,172,1614,7,120,3,4
56538,443,45521,443,7760,1599,6161,23,80,13,10
54695,80,64600,80,2001,1107,894,13,150,7,6
46625,80,46625,80,51574,3466,48108,63,156,23,40
60047,443,35596,443,1350,689,661,14,44,8,6
47595,33438,0,0,106,106,0,1,60,1,0
53828,51354,58095,51354,70,70,0,1,4,1,0
60398,443,27669,443,2847,1797,1050,24,85,13,11
55727,53,65316,53,711,87,624,2,31,1,1
58771,53,58771,53,226,106,120,2,30,1,1
56889,53,34075,53,177,94,83,2,30,1,1
49372,53,16928,53,210,110,100,2,30,1,1
34338,443,58177,443,4542,2358,2184,20,20,11,9
59328,80,59328,80,24437,12718,11719,41,15,16,25
53785,53,12230,53,167,78,89,2,31,1,1
50803,443,31091,443,6417,1376,5041,19,140,9,10
58764,443,5482,443,21960,14378,7582,49,18,26,23
49359,53,8497,53,216,110,106,2,30,1,1
53670,80,8760,80,950,502,448,12,15,7,5
45964,59999,45964,59999,60,60,0,1,5,1,0
53231,443,2130,443,8906,1533,7373,32,58,16,16
50584,51748,57588,51748,1356,300,1056,6,1200,3,3
55609,443,14768,443,13039,4388,8651,93,1191,47,46
56152,53,35520,53,195,102,93,2,29,1,1
56607,443,26886,443,133596,5859,127737,148,120,51,97
59964,443,4370,443,48525,4928,43597,111,660,55,56
50748,443,45400,443,12166,8765,3401,52,561,25,27
55317,53,36634,53,711,87,624,2,31,1,1
26504,80,26504,80,13592,1419,12173,25,31,13,12
49542,80,57907,80,1012,531,481,8,25,5,3
44967,443,36379,443,7474,1946,5528,33,270,18,15
50298,443,51193,443,11984,6772,5212,52,222,30,22
26496,80,26496,80,160989,10162,150827,189,31,81,108
64414,53,29559,53,193,102,91,2,31,1,1
43674,80,54012,80,3714,1646,2068,18,186,9,9
60026,443,10175,443,8382,2454,5928,44,86,26,18
65384,53,4009,53,443,182,261,6,30,3,3
49900,443,38776,443,8417,1173,7244,18,86,9,9
11786,53,11786,53,194,87,107,2,30,1,1
56701,443,57052,443,8007,1987,6020,20,15,11,9
56375,53,31585,53,177,94,83,2,31,1,1
56942,53,10682,53,177,94,83,2,31,1,1
55582,53,5858,53,177,94,83,2,30,1,1
26447,80,26447,80,12599,1479,11120,28,16,15,13
64217,53,23995,53,193,102,91,2,30,1,1
49783,443,33987,443,10095,2871,7224,23,126,12,11
53603,53796,63183,53796,70,70,0,2,7,2,0
56428,80,32588,80,17247,1619,15628,26,25,11,15
64256,53,29163,53,244,94,150,2,30,1,1
56004,53,42302,53,172,88,84,2,30,1,1
48014,80,51000,80,4006,3572,434,14,15,7,7
55236,53,12241,53,819,102,717,2,29,1,1
55850,443,57703,443,4344,2189,2155,15,126,7,8
49426,53,14946,53,492,91,401,4,56,2,2
57442,53,59819,53,411,110,301,2,30,1,1
27005,27015,60875,27015,881,126,755,2,30,1,1
50584,29040,20008,29040,509,150,359,2,1200,1,1
64999,27034,10678,27034,735,462,273,2,29,1,1
49913,443,31997,443,5570,901,4669,16,27,8,8
64516,53,13798,53,216,110,106,2,30,1,1
41603,443,56421,443,16028,3246,12782,37,272,19,18
65140,53,46396,53,199,102,97,2,29,1,1
53523,5362,54435,5362,320,140,180,6,6,3,3
49526,53,35749,53,272,97,175,4,58,2,2
65087,53,28763,53,229,94,135,2,30,1,1
49360,443,11814,443,5782,1008,4774,17,16,8,9
55694,53,54062,53,166,85,81,2,31,1,1
65241,53,34581,53,198,102,96,2,30,1,1
60412,80,59747,80,958,543,415,11,315,6,5
57536,443,25705,443,232,172,60,3,5,2,1
49455,443,62985,443,12386,1821,10565,23,33,11,12
49480,53,58009,53,184,94,90,2,31,1,1
56762,53,35908,53,168,86,82,2,31,1,1
55031,5222,39174,5222,6192,3767,2425,53,64,29,24
56629,443,57154,443,7889,1900,5989,20,15,11,9
50218,53,12883,53,165,86,79,2,29,1,1
55820,53,26876,53,184,94,90,2,30,1,1
27005,33058,7981,33058,884,126,758,2,31,1,1
53035,443,43721,443,3473,881,2592,13,121,6,7
10031,443,14432,443,34551,3731,30820,54,112,23,31
50932,80,42211,80,11381441,121813,11259628,9309,119,1741,7568
58853,443,38782,443,59754,9493,50261,131,367,68,63
56464,53,56163,53,177,94,83,2,30,1,1
55009,1114,14128,1114,6562,1873,4689,25,16,15,10
55354,53,26809,53,212,108,104,2,31,1,1
65030,53,52927,53,785,110,675,2,30,1,1
55166,53,19784,53,177,94,83,2,30,1,1
52074,57947,9698,57947,70,70,0,1,5,1,0
55784,53,64875,53,330,94,236,4,48,2,2
58780,443,38855,443,8661,1687,6974,30,244,16,14
52322,443,52322,443,6926,828,6098,17,26,9,8
35713,443,23137,443,5315,2861,2454,16,135,8,8
55056,443,52975,443,8309,1561,6748,26,204,14,12
52059,47363,55015,47363,70,70,0,1,5,1,0
50172,443,51694,443,3756,1914,1842,19,361,9,10
49498,443,36900,443,267319,11446,255873,336,192,117,219
50467,53,38713,53,758,93,665,2,31,1,1
51979,80,40174,80,366,240,126,7,25,5,2
48024,443,44709,443,9194,1066,8128,21,27,12,9
50620,443,5914,443,1277,851,426,12,92,7,5
56896,53,21578,53,177,94,83,2,30,1,1
49323,53,9705,53,210,110,100,2,30,1,1
37174,443,43183,443,752907,69016,683891,1372,231,537,835
42841,53,47596,53,168,78,90,2,30,1,1
50000,53,40875,53,263,110,153,2,30,1,1
49568,443,58538,443,7180,4959,2221,34,81,18,16
57915,443,51000,443,4103,2950,1153,26,131,16,10
49246,53,63715,53,286,102,184,2,31,1,1
61453,443,29702,443,8052,1307,6745,27,125,16,11
59753,27016,15718,27016,1718,1386,332,8,30,4,4
57171,3389,57171,3389,3428,1714,1714,16,33,8,8
56995,443,35339,443,8721,2518,6203,29,159,13,16
57824,443,57824,443,4669,1762,2907,19,30,11,8
56058,53,33400,53,200,94,106,2,30,1,1
46385,53,10375,53,199,94,105,2,30,1,1
56743,443,64118,443,8060,2040,6020,20,15,11,9
63039,443,48295,443,448,166,282,2,29,1,1
53792,443,8707,443,499,425,74,4,0,3,1
55851,53,30574,53,183,102,81,2,30,1,1
50596,53,52895,53,168,86,82,2,29,1,1
63799,13835,2064,13835,66,66,0,2,8,2,0
53231,443,26059,443,11825,4129,7696,39,40,21,18
49658,53,2388,53,195,102,93,2,30,1,1
9157,443,57140,443,5734,498,5236,14,15,7,7
53555,57861,41718,57861,492,306,186,8,15,5,3
56871,53,58198,53,745,93,652,2,30,1,1
33069,80,38685,80,1899,1172,727,17,284,10,7
57431,53,12541,53,181,94,87,2,29,1,1
55019,443,64416,443,13326,1847,11479,27,31,14,13
55165,53,15099,53,199,102,97,2,30,1,1
49293,53,24281,53,178,94,84,2,30,1,1
63978,63776,45573,63776,66,66,0,2,8,2,0
27005,33058,40872,33058,884,126,758,2,31,1,1
57334,53,42427,53,184,94,90,2,30,1,1
54979,53,30018,53,207,97,110,3,64,2,1
44080,443,25950,443,7476,2315,5161,18,135,8,10
19473,6881,31231,6881,490,149,341,2,1200,1,1
49586,443,54181,443,5879,870,5009,18,53,9,9
51911,443,51829,443,4456,2972,1484,38,211,20,18
52004,55711,7662,55711,70,70,0,1,5,1,0
49988,443,49988,443,1466,696,770,20,120,10,10
52793,443,12880,443,130,70,60,2,14,1,1
55806,53,2252,53,200,102,98,2,30,1,1
51909,33509,56937,33509,70,70,0,1,5,1,0
13554,53,13554,53,404,259,145,3,33,2,1
57139,53,34151,53,166,86,80,2,29,1,1
56754,53,50250,53,209,110,99,2,30,1,1
56426,80,33168,80,17008,1379,15629,22,25,7,15
56606,443,53334,443,9679,1633,8046,25,20,14,11
59817,443,40958,443,1401,864,537,12,29,6,6
49518,53,53885,53,193,102,91,2,30,1,1
27005,23333,15007,23333,890,126,764,2,30,1,1
28989,53,28989,53,197,90,107,2,29,1,1
55349,53,28852,53,744,89,655,2,30,1,1
54239,443,8377,443,499,425,74,4,0,3,1
56804,443,56989,443,8074,2054,6020,20,15,11,9
51965,48708,36849,48708,66,66,0,1,5,1,0
64912,53,12678,53,182,93,89,2,31,1,1
60302,443,30801,443,39850,4375,35475,73,80,31,42
64653,53,13693,53,241,94,147,2,30,1,1
52021,80,35964,80,422,240,182,8,25,5,3
41390,443,29292,443,7240,2035,5205,25,316,12,13
27005,27015,43445,27015,882,126,756,2,30,1,1
27005,27246,16977,27246,865,126,739,2,30,1,1
65443,53,31902,53,730,102,628,2,30,1,1
40001,53,40001,53,218,90,128,2,30,1,1
50346,80,22819,80,502,250,252,9,41,5,4
61484,443,59400,443,9479,3507,5972,24,16,12,12
57352,53,30931,53,711,87,624,2,31,1,1
27005,50003,14417,50003,887,126,761,2,31,1,1
56669,443,3032,443,7458,4186,3272,24,102,14,10
59407,443,59407,443,4736,1829,2907,19,29,11,8
22,37469,22,37469,178,118,60,2,4,1,1
49245,53,23757,53,195,102,93,2,30,1,1
64823,53,7121,53,199,102,97,2,31,1,1
55605,53,56113,53,196,100,96,2,30,1,1
59340,80,59340,80,24437,12718,11719,41,15,16,25
55513,53,13816,53,184,94,90,2,30,1,1
50022,53,51786,53,179,94,85,2,30,1,1
51822,12637,54729,12637,136,136,0,3,14,3,0
53809,443,5069,443,499,425,74,4,0,3,1
60433,443,40567,443,7113,3977,3136,23,136,12,11
61401,443,65147,443,33774,1880,31894,58,195,19,39
51447,443,8869,443,202,70,132,3,11,1,2
65375,53,14200,53,196,94,102,2,31,1,1
51925,443,7342,443,16797,8530,8267,53,82,30,23
56415,53,16835,53,740,93,647,2,30,1,1
55718,27025,38370,27025,1778,1386,392,8,30,4,4
58052,25,34376,25,540,256,284,9,30,5,4
49355,53,60733,53,193,102,91,2,30,1,1
65292,53,37185,53,195,102,93,2,30,1,1
55510,53,10819,53,578,286,292,9,15,5,4
37642,443,20516,443,69348,4180,65168,86,45,37,49
56521,53,59104,53,310,126,184,2,30,1,1
65005,53,2818,53,239,94,145,2,30,1,1
60166,53,7820,53,258,94,164,2,30,1,1
50584,6881,48204,6881,161,161,0,1,1200,1,0
56668,443,3930,443,8005,1985,6020,20,15,11,9
63072,443,30970,443,304,86,218,2,30,1,1
63017,443,7644,443,571,166,405,2,29,1,1
50228,443,34666,443,1775,169,1606,7,120,3,4
39434,5228,17809,5228,3505,2006,1499,30,3744,15,15
41886,53,64973,53,168,78,90,2,31,1,1
52033,443,12817,443,9609,3239,6370,25,143,12,13
45565,443,30523,443,1784491,72960,1711531,1872,113,687,1185
57537,443,24448,443,130,70,60,3,5,2,1
49209,52030,14863,52030,66,66,0,1,5,1,0
56373,53,63287,53,200,102,98,2,30,1,1
49351,53,18900,53,212,102,110,2,30,1,1
56995,53,60804,53,167,86,81,2,30,1,1
49961,53,61953,53,322,110,212,4,31,2,2
52874,443,59388,443,392514,41757,350757,626,118,209,417
40147,443,40147,443,1092,575,517,10,145,5,5
37052,53,37052,53,259,104,155,2,30,1,1
55040,443,46427,443,62,62,0,1,4,1,0
56405,443,34557,443,6202,1212,4990,27,1197,8,19
56652,80,38597,80,234,234,0,4,12,4,0
62861,443,20935,443,4777,2262,2515,10,122,5,5
49829,443,43793,443,3026,1775,1251,23,74,14,9
43444,53,43444,53,314,98,216,2,30,1,1
36503,443,18047,443,3549,899,2650,13,120,6,7
55161,53,36813,53,197,94,103,2,30,1,1
42298,40036,17125,40036,141,79,62,2,30,1,1
52056,80,64858,80,4562,3936,626,11,28,6,5
60774,443,14767,443,29739,1164,28575,40,120,15,25
56548,53,28244,53,199,102,97,2,31,1,1
55325,53,2560,53,210,110,100,2,30,1,1
60416,443,11714,443,4953,1111,3842,22,104,12,10
64827,53,64827,53,288,83,205,2,30,1,1
65516,53,35992,53,305,89,216,4,41,2,2
53864,443,31491,443,3124,1556,1568,21,275,11,10
47050,443,20550,443,10868,2200,8668,32,44,14,18
64078,443,31734,443,4458,1569,2889,24,138,10,14
50705,80,25198,80,499,192,307,6,26,4,2
52644,6881,4484,6881,719,413,306,10,14,5,5
54076,53,54076,53,243,94,149,2,32,1,1
33065,443,50330,443,6746,2826,3920,19,399,11,8
56654,443,53376,443,4972,2136,2836,21,24,12,9
55593,80,19208,80,3276,404,2872,11,15,5,6
57401,53,48123,53,179,94,85,2,30,1,1
57346,53,4986,53,204,104,100,2,31,1,1
60553,443,11360,443,7981,1867,6114,32,313,17,15
49953,53,27349,53,214,110,104,2,29,1,1
55655,53,10525,53,304,110,194,4,34,2,2
57597,80,57597,80,80556,2669,77887,84,144,28,56
64723,53,15149,53,229,110,119,2,30,1,1
49418,27015,38880,27015,78,78,0,1,30,1,0
64467,53,11977,53,184,94,90,2,30,1,1
55441,53,20729,53,216,110,106,2,30,1,1
52733,443,22448,443,613606,29392,584214,757,42,337,420
55411,53,60848,53,182,93,89,2,31,1,1
50611,443,62610,443,11152,2086,9066,33,93,17,16
52860,443,7208,443,7683,2076,5607,42,131,21,21
63628,53,35423,53,289,86,203,2,30,1,1
63991,53,7605,53,193,102,91,2,30,1,1
60222,80,61233,80,1989,1365,624,11,151,6,5
49708,53,32399,53,178,94,84,2,30,1,1
51973,80,57539,80,426,240,186,8,26,5,3
65382,53,33350,53,301,108,193,4,55,2,2
52998,443,44367,443,22480,2705,19775,49,109,22,27
58574,443,3429,443,3447,788,2659,13,135,6,7
53587,32029,60710,32029,70,70,0,2,8,2,0
60612,443,17628,443,117190,11380,105810,171,212,67,104
34378,443,1903,443,11269403,319214,10950189,11392,382,3773,7619
60490,62336,7987,62336,504,318,186,8,15,5,3
64741,53,9431,53,715,94,621,2,29,1,1
50164,53,36057,53,260,86,174,2,29,1,1
55680,53,52561,53,749,94,655,2,31,1,1
37574,443,27983,443,499,425,74,4,0,3,1
59666,53,55387,53,497,118,379,2,30,1,1
37653,443,30565,443,9605,2939,6666,29,46,17,12
59754,53,13358,53,303,85,218,2,30,1,1
56526,443,31407,443,5082,973,4109,18,60,9,9
56612,53,64503,53,184,94,90,2,31,1,1
53521,443,50004,443,130,70,60,2,15,1,1
55920,53,34293,53,810,108,702,2,31,1,1
55336,53,49932,53,199,102,97,2,30,1,1
42154,80,50458,80,73277,3302,69975,102,16,52,50
47136,53,53463,53,222,78,144,2,30,1,1
45300,443,4696,443,11748,7422,4326,59,113,31,28
65467,443,32500,443,92244,4799,87445,107,15,43,64
60458,61473,34807,61473,1587,935,652,14,16,8,6
48817,6882,48817,6882,152,152,0,1,1200,1,0
51197,443,47968,443,3211,781,2430,17,135,8,9
64816,53,50363,53,166,86,80,2,30,1,1
42384,443,3442,443,101952,6925,95027,143,333,72,71
40189,80,30791,80,5043,1656,3387,18,205,10,8
50463,80,50463,80,210639,12949,197690,287,23,147,140
48745,443,43215,443,229628,10653,218975,263,49,103,160
53885,50379,49864,50379,492,306,186,8,15,5,3
53762,9587,1266,9587,70,70,0,2,7,2,0
49862,53,51904,53,194,102,92,2,30,1,1
57421,80,60577,80,4507,2978,1529,13,15,6,7
56473,80,3557,80,48910,2361,46549,63,135,29,34
57340,53,29949,53,216,110,106,2,30,1,1
23414,53,23414,53,197,90,107,2,30,1,1
62504,443,1666,443,10385,7051,3334,27,33,15,12
49883,53,14693,53,177,94,83,2,30,1,1
49270,443,33027,443,10367,2273,8094,43,730,22,21
57492,443,47894,443,380975,82011,298964,804,171,343,461
65275,53,62237,53,184,94,90,2,30,1,1
38634,443,57626,443,9398,4241,5157,22,135,11,11
56202,53,55288,53,819,102,717,2,29,1,1
49953,53,46343,53,214,110,104,2,30,1,1
57599,80,28045,80,808,485,323,8,75,5,3
11295,40002,55023,40002,209,85,124,4,54,2,2
19473,12430,61068,12430,491,150,341,2,1200,1,1
53707,44209,9971,44209,1513,989,524,17,16,10,7
56354,53,56354,53,214,97,117,2,30,1,1
56204,53,36998,53,168,86,82,2,30,1,1
49720,443,3612,443,180777,5704,175073,204,105,67,137
65039,53,20269,53,258,94,164,2,31,1,1
57439,443,32851,443,5502,1543,3959,17,20,9,8
64127,53,25934,53,177,94,83,2,30,1,1
51860,443,38045,443,6577,1938,4639,14,121,7,7
55466,53,37366,53,177,94,83,2,30,1,1
63932,53,54885,53,174,89,85,2,31,1,1
52773,443,22036,443,19594,11977,7617,48,100,25,23
56582,53,45513,53,98,98,0,1,30,1,0
56713,443,15450,443,8006,1986,6020,20,15,11,9
36690,443,36517,443,1520,1058,462,12,29,8,4
43921,443,8788,443,8324,1658,6666,24,83,14,10
48589,443,15567,443,15400,9133,6267,40,272,22,18
49650,53,58699,53,539,97,442,4,58,2,2
51930,80,17993,80,1669,865,804,13,76,8,5
49838,53,62523,53,866,221,645,6,56,3,3
59933,80,46618,80,1756,414,1342,12,15,6,6
51208,443,57276,443,8886,2767,6119,52,17,28,24
63981,34250,52912,34250,70,70,0,1,4,1,0
50460,443,36423,443,5572,4252,1320,18,34,11,7
58638,5900,58638,5900,130,66,64,2,4,1,1
40905,443,30832,443,6982,1535,5447,30,26,15,15
55796,53,45006,53,192,98,94,2,31,1,1
33038,443,55545,443,7338,2419,4919,19,35,12,7
57137,53,9212,53,279,96,183,4,32,2,2
49337,53,49651,53,199,102,97,2,30,1,1
49658,53,46008,53,195,102,93,2,29,1,1
65074,53,29931,53,284,118,166,2,30,1,1
52062,443,2872,443,61141,52577,8564,102,363,50,52
57356,53,7268,53,199,102,97,2,29,1,1
49472,53,52589,53,209,102,107,2,30,1,1
56941,53,63824,53,196,102,94,2,30,1,1
60449,443,18490,443,26571,2432,24139,42,30,21,21
39978,443,51684,443,6834,2189,4645,40,29,26,14
60473,443,60473,443,18018,4407,13611,36,100,19,17
64659,53,14647,53,464,99,365,4,39,2,2
37096,443,16174,443,130,70,60,2,15,1,1
56458,53,38538,53,196,102,94,2,30,1,1
64540,53,58172,53,174,89,85,2,30,1,1
64381,53,3642,53,198,102,96,2,30,1,1
50295,3389,50295,3389,5936,2690,3246,25,20,15,10
56535,443,1772,443,185925,12445,173480,210,105,82,128
65257,53,51798,53,266,110,156,2,30,1,1
53553,2297,8843,2297,70,70,0,2,7,2,0
50584,6889,32589,6889,311,311,0,3,1200,3,0
50388,8080,50388,8080,4417,2499,1918,18,56,10,8
49768,443,40344,443,12934,1419,11515,27,127,11,16
36516,443,59096,443,70,70,0,1,4,1,0
53261,443,49163,443,12912,4288,8624,43,20,22,21
65343,53,2539,53,184,94,90,2,31,1,1
50503,443,44653,443,9295,3094,6201,24,82,12,12
50591,443,54685,443,5611,3452,2159,22,133,13,9
47876,443,34439,443,996037,37114,958923,1187,271,459,728
50671,443,30836,443,5409,1834,3575,25,17,12,13
52179,443,47721,443,414,140,274,7,25,3,4
61828,443,61828,443,317388,25904,291484,338,200,128,210
53825,58968,36842,58968,70,70,0,1,4,1,0
49267,53,55057,53,209,94,115,2,30,1,1
49767,53,48677,53,200,102,98,2,30,1,1
49696,53,25941,53,178,94,84,2,31,1,1
42989,443,61280,443,9878,1936,7942,36,121,18,18
26778,443,2994,443,7407,2650,4757,24,20,12,12
49435,443,3627,443,10377,3140,7237,23,52,11,12
65274,53,29709,53,295,101,194,4,31,2,2
26842,443,13375,443,7219,2522,4697,21,20,10,11
63980,4804,25300,4804,70,70,0,1,4,1,0
55590,53,20424,53,177,94,83,2,30,1,1
21519,443,21519,443,14483,1152,13331,27,19,12,15
26900,27017,49635,27017,422,164,258,6,30,3,3
55474,80,42098,80,25970,2371,23599,52,17,26,26
50468,80,2157,80,314,192,122,6,28,4,2
36228,80,25190,80,1114,540,574,17,191,10,7
56491,53,1431,53,711,87,624,2,30,1,1
58894,443,56665,443,354,294,60,2,4,1,1
65339,53,4097,53,775,102,673,2,30,1,1
61542,443,4330,443,6049,1986,4063,23,19,12,11
65224,53,18679,53,197,102,95,2,30,1,1
49216,53,15355,53,181,94,87,2,30,1,1
62045,443,52563,443,10467,4259,6208,65,56,38,27
36649,53,5716,53,198,93,105,2,30,1,1
49379,53,1311,53,198,101,97,2,30,1,1
36924,53,36924,53,257,106,151,2,30,1,1
64685,53,52958,53,186,95,91,2,30,1,1
60815,443,60815,443,1320,685,635,14,181,7,7
64685,53,47182,53,193,102,91,2,30,1,1
56745,56518,23267,56518,1556,588,968,11,16,6,5
65386,53,20616,53,762,101,661,2,30,1,1
50098,53,35550,53,199,102,97,2,31,1,1
56834,53,24622,53,178,94,84,2,29,1,1
52973,443,33521,443,9294,2728,6566,43,113,22,21
50618,443,50618,443,4351,1444,2907,19,28,11,8
50663,443,7277,443,7136,1421,5715,18,15,8,10
49548,443,63354,443,8912,2297,6615,43,255,20,23
51612,443,45282,443,6777,3431,3346,27,15,14,13
38860,443,38860,443,15584,2721,12863,44,103,21,23
53282,443,7574,443,604924,37384,567540,846,154,315,531
59944,80,15920,80,1052,612,440,10,15,5,5
51169,443,52987,443,21686,7655,14031,77,379,40,37
55787,53,59622,53,229,102,127,2,29,1,1
47750,443,44039,443,70,70,0,1,5,1,0
65482,53,43448,53,179,94,85,2,30,1,1
65245,53,31425,53,184,102,82,2,30,1,1
53102,443,27329,443,983,496,487,9,16,5,4
40931,443,31983,443,7399,3328,4071,76,4153,33,43
51538,443,33433,443,262,70,192,5,21,2,3
6881,35045,1586,35045,475,150,325,2,1200,1,1
50393,8080,50393,8080,378,180,198,7,31,4,3
37650,443,41900,443,6898,5202,1696,25,25,15,10
64472,53,59070,53,183,94,89,2,31,1,1
56336,53,24893,53,172,88,84,2,30,1,1
56642,80,4720,80,234,234,0,4,12,4,0
10016,443,37717,443,6575,1263,5312,22,315,12,10
59178,53,27947,53,260,86,174,2,30,1,1
51874,443,24684,443,1852,1103,749,16,31,9,7
49187,2710,40478,2710,70,70,0,2,7,2,0
27005,27025,23287,27025,895,126,769,2,30,1,1
63061,443,64217,443,304,86,218,2,30,1,1
51966,18716,18361,18716,66,66,0,1,5,1,0
5588,5588,0,0,3562,1936,1626,48,194,24,24
35688,53,49808,53,199,94,105,2,30,1,1
52188,443,37924,443,1768,1034,734,16,65,8,8
52282,80,3560,80,7603,1651,5952,24,16,13,11
55237,53,24870,53,259,87,172,4,56,2,2
56892,53,40383,53,210,102,108,2,30,1,1
52961,443,6824,443,925322,25097,900225,971,113,287,684
44847,2499,58207,2499,502,150,352,2,1200,1,1
49700,80,44971,80,71320,1026,70294,64,52,12,52
55265,53,4151,53,199,102,97,2,30,1,1
57946,443,19612,443,2791,1800,991,26,185,15,11
57161,53,1657,53,711,87,624,2,30,1,1
58834,443,42035,443,7880,5105,2775,25,17,13,12
60384,443,14731,443,130,70,60,2,15,1,1
48604,53,57366,53,164,78,86,2,30,1,1
50294,53,34116,53,178,94,84,2,29,1,1
50183,443,52770,443,6348,1071,5277,18,42,10,8
64140,53,44344,53,184,94,90,2,31,1,1
33459,80,37833,80,1658,1344,314,10,14,5,5
35271,443,35271,443,134405,6968,127437,187,97,85,102
34765,5222,48630,5222,10109,3480,6629,72,615,38,34
56491,53,20777,53,165,86,79,2,31,1,1
49408,443,34465,443,7967,2176,5791,27,125,14,13
49553,443,65490,443,6074,865,5209,16,15,9,7
50365,80,49822,80,300,180,120,6,29,4,2
2075,7000,2075,7000,5850,4395,1455,18,15,10,8
57044,53,19964,53,194,99,95,2,31,1,1
46423,443,25968,443,1340,760,580,14,39,8,6
52204,36387,46788,36387,136,136,0,3,13,3,0
50677,80,32544,80,3664,1440,2224,12,20,6,6
1100,27540,2700,27540,132,70,62,2,31,1,1
58746,443,54765,443,5107,700,4407,15,15,7,8
40243,443,64916,443,284,164,120,4,15,2,2
55119,53,12117,53,994,86,908,2,29,1,1
49773,80,31365,80,70,70,0,1,5,1,0
60367,53,22365,53,233,110,123,2,30,1,1
49216,53,56828,53,274,94,180,2,30,1,1
49674,443,19357,443,5917,1570,4347,20,53,10,10
51779,49525,20031,49525,70,70,0,1,5,1,0
55591,53,58697,53,190,97,93,2,31,1,1
49501,443,35522,443,13077,4380,8697,34,1881,17,17
51073,443,23186,443,7343,2672,4671,20,76,12,8
57017,53,16260,53,177,94,83,2,30,1,1
56336,53,36932,53,198,93,105,2,30,1,1
50367,53,23115,53,198,102,96,2,30,1,1
46531,123,21322,123,184,94,90,2,30,1,1
55694,53,12759,53,167,86,81,2,30,1,1
50111,443,14390,443,60978,3794,57184,73,137,26,47
54486,443,15577,443,3170,1036,2134,13,135,6,7
52122,80,30528,80,4137,1236,2901,27,418,14,13
56569,53,13010,53,183,94,89,2,30,1,1
57117,443,28755,443,8997,1155,7842,19,76,11,8
56878,53,21554,53,168,86,82,2,31,1,1
55376,53,48930,53,789,110,679,2,31,1,1
49418,27018,42742,27018,274,78,196,2,31,1,1
49631,53,31277,53,196,100,96,2,31,1,1
38049,80,38049,80,2180,1555,625,9,86,6,3
49936,53,28353,53,211,102,109,2,31,1,1
54425,443,49600,443,1648,813,835,17,186,9,8
55958,53,14478,53,212,102,110,2,30,1,1
38306,443,65032,443,4580,1210,3370,17,28,10,7
49272,53,51922,53,266,94,172,2,30,1,1
9474,53,9474,53,237,91,146,2,33,1,1
65169,53,4248,53,211,102,109,2,30,1,1
55808,53,55808,53,257,106,151,2,30,1,1
50530,80,18434,80,3561,1337,2224,13,20,7,6
42934,443,36835,443,4514,1928,2586,17,241,8,9
64522,53,42718,53,230,102,128,2,31,1,1
60308,443,13749,443,5445,1072,4373,24,80,11,13
55921,53,12219,53,747,92,655,2,31,1,1
51403,443,43951,443,334,70,264,5,17,1,4
58528,443,58528,443,4672,1765,2907,19,29,11,8
52058,8329,19334,8329,70,70,0,2,9,2,0
53580,48066,41215,48066,70,70,0,2,8,2,0
37590,443,21881,443,499,425,74,4,0,3,1
46271,443,30209,443,70,70,0,2,4,2,0
55716,36989,39721,36989,320,140,180,6,6,3,3
2077,7000,2077,7000,3054,1599,1455,16,15,8,8
6881,20326,20950,20326,509,150,359,2,1200,1,1
46769,80,58026,80,3589,2432,1157,17,86,9,8
57431,53,4214,53,733,94,639,2,30,1,1
56662,443,10328,443,318,192,126,6,15,4,2
52103,7172,60174,7172,70,70,0,1,5,1,0
49906,443,34595,443,159116,5586,153530,191,47,77,114
42377,443,33699,443,1622,1137,485,11,26,7,4
50467,80,31924,80,197269,14917,182352,254,204,107,147
27988,40023,43847,40023,143,81,62,2,31,1,1
50702,80,54989,80,55224,28254,26970,230,174,114,116
53872,53,43483,53,70,70,0,1,30,1,0
61291,53,61291,53,261,106,155,2,29,1,1
55156,53,28197,53,256,87,169,4,36,2,2
65249,53,43445,53,733,94,639,2,30,1,1
48458,53,36064,53,289,86,203,2,29,1,1
51324,443,31259,443,2359,1283,1076,17,17,9,8
57870,7635,57870,7635,138,78,60,2,6,1,1
6881,6881,62439,6881,502,150,352,2,1200,1,1
49500,53,31434,53,248,118,130,2,29,1,1
56655,53,35529,53,210,110,100,2,30,1,1
56650,53,58049,53,253,102,151,2,30,1,1
61981,443,61981,443,4533,1626,2907,19,29,11,8
55912,53,49501,53,198,101,97,2,31,1,1
56785,28902,26302,28902,66,66,0,1,5,1,0
51105,80,8408,80,366,240,126,7,20,5,2
56433,53,16233,53,204,104,100,2,30,1,1
53478,443,15802,443,7692,2183,5509,24,224,14,10
49557,443,57017,443,38022,18448,19574,53,57,27,26
50403,80,8423,80,4332,3596,736,14,32,8,6
49874,53,37266,53,173,94,79,2,30,1,1
33894,80,31956,80,1376,788,588,10,35,6,4
51539,443,19176,443,262,70,192,5,21,2,3
35989,161,0,0,18741,9242,9499,96,31,48,48
49162,53,28701,53,183,94,89,2,30,1,1
56674,443,42391,443,7889,1900,5989,20,15,11,9
64001,53,52493,53,183,94,89,2,29,1,1
49546,53,28213,53,212,110,102,2,30,1,1
47191,443,13970,443,8756,2298,6458,39,314,18,21
56544,53,44845,53,183,86,97,2,31,1,1
49762,53,6291,53,196,102,94,2,29,1,1
55257,80,57672,80,3564,1625,1939,12,131,6,6
53619,11513,10996,11513,320,140,180,6,6,3,3
53551,60444,1391,60444,492,306,186,8,15,5,3
57593,28678,11489,28678,1806,1806,0,22,225,22,0
53266,443,29507,443,30264,2794,27470,47,322,19,28
49480,80,65349,80,6811,3791,3020,23,115,13,10
36405,443,39984,443,466,392,74,4,0,3,1
57128,53,45410,53,755,93,662,2,31,1,1
55025,53,14358,53,183,94,89,2,31,1,1
65455,53,29477,53,564,108,456,4,50,2,2
57238,443,50721,443,7549,2807,4742,42,78,22,20
64509,53,38948,53,385,134,251,2,30,1,1
58520,443,24680,443,9429,3621,5808,60,80,26,34
59601,443,24962,443,162,102,60,2,5,1,1
36406,5228,24879,5228,17762,4403,13359,92,616,47,45
37460,443,43570,443,5674,3900,1774,29,80,15,14
54401,443,33851,443,11527127,373718,11153409,12286,144,4090,8196
56671,443,62348,443,8300,3581,4719,25,19,15,10
61417,443,25149,443,652760,608740,44020,734,432,496,238
52041,48103,59658,48103,70,70,0,1,5,1,0
44467,53,44467,53,211,80,131,2,30,1,1
55641,61762,29914,61762,70,70,0,1,5,1,0
57135,53,40947,53,443,182,261,6,30,3,3
51175,443,19417,443,2132473,55149,2077324,2144,63,731,1413
56020,53,53467,53,198,101,97,2,31,1,1
51971,53,51971,53,240,98,142,2,30,1,1
21133,63622,33830,63622,150,150,0,1,1199,1,0
64045,7426,33466,7426,70,70,0,1,4,1,0
19763,53,19763,53,216,82,134,2,32,1,1
56752,53,57000,53,182,93,89,2,30,1,1
65067,80,65067,80,342198,13793,328405,355,23,126,229
9162,443,30671,443,5658,501,5157,14,15,7,7
65332,53,1654,53,226,86,140,2,29,1,1
60868,80,60868,80,5973,779,5194,17,16,9,8
52029,52093,47612,52093,70,70,0,2,7,2,0
49901,53,39046,53,193,102,91,2,29,1,1
63091,443,18908,443,382,164,218,2,30,1,1
40498,443,31302,443,9807,2542,7265,47,19,24,23
59597,443,2305,443,10310,2469,7841,35,255,18,17
49450,53,27588,53,227,94,133,2,29,1,1
56310,53,55159,53,760,97,663,2,31,1,1
49622,443,43494,443,15336,2803,12533,47,202,24,23
56176,53,8371,53,194,102,92,2,30,1,1
40801,443,33203,443,3289,1265,2024,13,32,7,6
48349,443,46666,443,42932,2883,40049,63,14,31,32
62044,443,20776,443,10530,2001,8529,29,47,14,15
55457,443,34189,443,130,70,60,3,5,2,1
56970,443,55404,443,16378,3002,13376,35,17,17,18
64016,53,18748,53,184,94,90,2,31,1,1
63232,443,26677,443,4496,2346,2150,28,124,15,13
56096,443,56096,443,5493,2246,3247,22,39,13,9
55821,53,13953,53,196,102,94,2,29,1,1
55135,53,55135,53,220,90,130,2,29,1,1
65019,53,36796,53,195,102,93,2,30,1,1
49274,53,46367,53,194,99,95,2,31,1,1
57170,53,64269,53,200,102,98,2,31,1,1
51928,443,37238,443,18581,9681,8900,62,103,33,29
56615,80,9225,80,234,234,0,4,11,4,0
62335,443,30924,443,73341,3336,70005,85,48,27,58
9445,443,7220,443,6094,771,5323,17,25,9,8
60480,443,16166,443,6511,2810,3701,34,3665,12,22
39236,80,55447,80,190,70,120,4,16,2,2
41858,443,41858,443,4350,1443,2907,19,26,11,8
56720,53,20064,53,177,94,83,2,30,1,1
64438,53,23542,53,211,102,109,2,30,1,1
50492,80,56917,80,318,192,126,6,25,4,2
65127,53,38412,53,194,102,92,2,30,1,1
49180,443,17664,443,888019,22655,865364,902,18,322,580
44722,80,3568,80,3162,1159,2003,14,16,8,6
55222,443,38278,443,5312,1510,3802,18,45,11,7
64686,53,28216,53,811,94,717,2,30,1,1
60974,443,22731,443,166465,9498,156967,220,72,100,120
38082,443,40503,443,9037,1851,7186,26,180,14,12
45120,15000,54128,15000,130,70,60,2,6,1,1
65107,53,32581,53,266,110,156,2,30,1,1
51705,59244,12307,59244,66,66,0,1,5,1,0
57013,53,1233,53,178,94,84,2,30,1,1
42993,443,2255,443,14451,3012,11439,33,32,18,15
51502,443,63032,443,6559,2158,4401,30,17,16,14
59833,443,63196,443,15252,5376,9876,35,154,16,19
48287,443,53104,443,416,210,206,7,96,4,3
41371,53,41371,53,220,90,130,2,30,1,1
53821,443,16981,443,7980,1434,6546,24,19,13,11
55803,53,50944,53,760,97,663,2,30,1,1
33947,443,18903,443,25302,10587,14715,88,123,37,51
49444,53,22362,53,212,102,110,2,30,1,1
55879,53,9895,53,184,94,90,2,29,1,1
64578,443,29592,443,9156,2109,7047,27,32,15,12
49721,80,41494,80,340,140,200,6,15,3,3
49996,443,63041,443,19523,5346,14177,37,87,17,20
39051,443,15445,443,7082,4527,2555,31,31,16,15
55053,443,17178,443,6906,1283,5623,29,248,14,15
44558,443,44558,443,5480,2503,2977,20,15,11,9
33507,443,18740,443,194174,11657,182517,258,31,124,134
42300,53,40798,53,168,78,90,2,29,1,1
55147,53,27402,53,184,94,90,2,31,1,1
49177,53,40047,53,184,94,90,2,31,1,1
9177,443,23456,443,6331,837,5494,19,28,10,9
41627,15000,9881,15000,130,70,60,2,5,1,1
64514,53,1734,53,209,102,107,2,30,1,1
64485,53,11274,53,183,94,89,2,30,1,1
52473,443,5513,443,1625,1038,587,14,28,8,6
49525,443,29311,443,14786,2845,11941,32,121,17,15
56160,53,63340,53,190,97,93,2,30,1,1
57284,53,3184,53,212,108,104,2,31,1,1
60406,80,16333,80,1370,704,666,23,105,12,11
65521,53,52937,53,167,86,81,2,30,1,1
50422,443,13716,443,1389,868,521,12,25,6,6
64055,53,3603,53,233,94,139,2,30,1,1
56396,53,42377,53,183,94,89,2,30,1,1
50433,80,24726,80,318,192,126,6,26,4,2
54805,443,42817,443,19635,9923,9712,165,588,72,93
56423,443,49453,443,6294,1494,4800,22,17,11,11
57470,54343,65136,54343,330,330,0,6,1200,6,0
37965,62918,1138,62918,489,149,340,2,1200,1,1
55693,45341,14771,45341,70,70,0,2,8,2,0
57417,53,7685,53,199,102,97,2,30,1,1
56397,53,29734,53,174,89,85,2,31,1,1
57282,53,14101,53,199,102,97,2,30,1,1
60280,443,7130,443,46713,2661,44052,55,120,21,34
56119,53,14584,53,199,102,97,2,33,1,1
64694,53,58763,53,361,107,254,4,37,2,2
63711,47951,19949,47951,70,70,0,1,4,1,0
56076,80,28614,80,5055,3100,1955,34,17,28,6
41889,443,23289,443,6516,1722,4794,26,17,15,11
65429,80,58851,80,366,180,186,7,29,4,3
46202,443,10482,443,19149,2846,16303,41,25,20,21
42895,53,15137,53,168,78,90,2,30,1,1
49950,443,56465,443,6770,2219,4551,21,89,11,10
64044,21989,15782,21989,816,508,308,12,27,7,5
60337,7000,60337,7000,2163,676,1487,14,16,7,7
55620,53,33396,53,172,88,84,2,31,1,1
52250,443,52250,443,162355,8745,153610,178,22,66,112
55095,53,63653,53,194,102,92,2,29,1,1
55854,443,29147,443,3387,1672,1715,24,270,11,13
51412,443,11649,443,8933,1958,6975,25,81,14,11
46999,993,56009,993,45153,20621,24532,323,43,165,158
49608,53,10158,53,170,87,83,2,31,1,1
53211,80,10536,80,194,128,66,4,51,3,1
51714,123,49877,123,184,94,90,2,30,1,1
52208,47300,20128,47300,70,70,0,2,9,2,0
51866,23431,28853,23431,70,70,0,1,5,1,0
49891,443,20308,443,1820,1101,719,18,73,10,8
56950,443,41087,443,5601,1203,4398,14,60,9,5
49701,53,52830,53,488,110,378,4,32,2,2
50107,53,50107,53,216,89,127,2,30,1,1
64689,53,47457,53,763,102,661,2,30,1,1
56678,53,61385,53,760,97,663,2,30,1,1
41943,443,27053,443,8385,3143,5242,35,98,18,17
53845,443,42345,443,499,425,74,4,0,3,1
61049,53,17729,53,525,150,375,6,33,3,3
55503,53,6618,53,216,110,106,2,29,1,1
57423,53,20278,53,774,101,673,2,30,1,1
35817,443,2802,443,3120,1862,1258,18,15,11,7
58877,443,18145,443,2577,1550,1027,15,15,7,8
59813,443,22135,443,23244,13793,9451,50,29,26,24
55027,53,44978,53,177,94,83,2,29,1,1
65246,53,13640,53,767,102,665,2,30,1,1
51807,443,51807,443,1466,856,610,13,27,6,7
51855,23268,62200,23268,70,70,0,2,7,2,0
64249,53,6288,53,181,94,87,2,33,1,1
52044,5824,26075,5824,70,70,0,1,5,1,0
55190,53,57289,53,311,94,217,2,30,1,1
65024,53,20074,53,199,102,97,2,30,1,1
59945,80,11723,80,1197,419,778,9,16,5,4
49418,27015,38539,27015,249,78,171,2,30,1,1
37965,34591,32228,34591,820,152,668,4,1199,2,2
27005,32065,28721,32065,877,126,751,2,31,1,1
59486,53,24146,53,316,86,230,2,29,1,1
64999,53,20323,53,515,86,429,4,45,2,2
63742,26305,43986,26305,66,66,0,2,7,2,0
56369,53,50667,53,168,86,82,2,29,1,1
27005,27017,29678,27017,917,126,791,2,30,1,1
56643,53,21130,53,195,102,93,2,31,1,1
51724,25807,54569,25807,70,70,0,2,8,2,0
60180,443,13880,443,3667,2243,1424,22,80,11,11
52118,33515,33207,33515,70,70,0,2,7,2,0
49397,53,28669,53,365,94,271,2,30,1,1
52784,443,37799,443,16022,3217,12805,25,138,11,14
45587,443,45587,443,5523,2276,3247,22,28,13,9
64955,53,3638,53,210,110,100,2,29,1,1
53758,63975,2179,63975,2016,1076,940,14,17,8,6
57122,53,58221,53,198,94,104,2,30,1,1
56326,53,54656,53,170,87,83,2,30,1,1
57382,53,8955,53,184,94,90,2,31,1,1
51880,8000,42444,8000,582,270,312,8,32,4,4
49927,53,25486,53,763,102,661,2,30,1,1
53399,53,53399,53,414,268,146,3,32,2,1
42557,443,48761,443,123082,8734,114348,200,84,101,99
60092,443,60092,443,4700,1793,2907,19,28,11,8
30188,51403,44357,51403,502,150,352,2,1200,1,1
63733,47013,29294,47013,70,70,0,1,5,1,0
56986,53,50579,53,259,87,172,4,37,2,2
35065,443,35065,443,5537,2290,3247,22,39,13,9
65100,53,63534,53,199,102,97,2,30,1,1
52098,29067,64917,29067,70,70,0,1,5,1,0
37608,443,17459,443,499,425,74,4,0,3,1
55631,53,42735,53,422,96,326,4,42,2,2
27005,49000,16886,49000,887,126,761,2,31,1,1
49103,443,44063,443,6725,505,6220,20,181,5,15
56403,53,56403,53,244,98,146,2,32,1,1
49415,53,16500,53,194,102,92,2,30,1,1
55280,53,18692,53,258,110,148,2,30,1,1
55179,53,34684,53,182,93,89,2,31,1,1
56289,53,22157,53,351,110,241,2,29,1,1
53722,443,52101,443,327838,13327,314511,355,127,121,234
63082,443,41312,443,303,85,218,2,30,1,1
49418,27015,49804,27015,248,78,170,2,30,1,1
64850,53,29250,53,167,86,81,2,30,1,1
55350,53,12521,53,185,102,83,2,29,1,1
49160,33586,34033,33586,1377,300,1077,6,1200,3,3
49348,80,58488,80,2695,601,2094,14,17,7,7
55479,53,22790,53,184,94,90,2,30,1,1
34256,443,33618,443,67835,6280,61555,96,108,45,51
36837,443,3546,443,9311,1387,7924,20,31,10,10
65124,53,53068,53,243,102,141,2,30,1,1
64011,53,28636,53,288,94,194,2,29,1,1
49936,53,34115,53,318,110,208,4,50,2,2
61427,443,64293,443,7288,1763,5525,22,77,12,10
65351,53,49727,53,228,110,118,2,30,1,1
56081,53,27644,53,186,102,84,2,29,1,1
56633,53,17988,53,194,99,95,2,31,1,1
40492,1488,40492,1488,156,156,0,3,8,3,0
64268,53,45536,53,334,103,231,4,54,2,2
56512,53,52518,53,889,404,485,10,31,5,5
60012,443,58670,443,8127,1796,6331,21,79,12,9
55179,53,31015,53,178,94,84,2,30,1,1
52990,443,9852,443,7093,2235,4858,39,111,20,19
37626,443,10434,443,7766,1810,5956,24,46,14,10
56076,53,58265,53,311,94,217,2,30,1,1
61386,80,24052,80,17583,1529,16054,30,255,16,14
64001,53,4323,53,183,94,89,2,30,1,1
8430,53,61822,53,239209,233954,5255,2850,88,2822,28
50645,53,59508,53,177,94,83,2,30,1,1
56421,53,8309,53,177,94,83,2,30,1,1
11962,53,11962,53,194,87,107,2,30,1,1
59210,80,59210,80,1990,833,1157,10,21,6,4
64287,53,8913,53,280,91,189,4,33,2,2
51077,443,51077,443,32010,3207,28803,52,128,20,32
49321,53,55835,53,184,94,90,2,31,1,1
64243,53,24679,53,244,94,150,2,30,1,1
49341,53,41507,53,199,102,97,2,30,1,1
9206,443,23255,443,5043,432,4611,12,15,6,6
55473,53,5965,53,186,102,84,2,30,1,1
54924,3478,25286,3478,312,140,172,4,31,2,2
50616,53,45129,53,177,94,83,2,30,1,1
65462,53,17722,53,102,102,0,1,30,1,0
56227,53,50602,53,278,102,176,2,30,1,1
49708,53,16944,53,178,94,84,2,30,1,1
64893,53,31080,53,232,102,130,2,30,1,1
50507,443,55208,443,7171,1729,5442,24,78,13,11
49622,53,47185,53,185,102,83,2,30,1,1
63135,443,47015,443,7127,1737,5390,18,16,10,8
56655,53,21531,53,209,110,99,2,30,1,1
49844,443,42026,443,6117,976,5141,21,72,10,11
50213,53,31929,53,774,102,672,2,30,1,1
38019,443,55149,443,884,464,420,13,28,7,6
62344,80,50382,80,1892,583,1309,12,16,6,6
55721,53,57546,53,170,87,83,2,31,1,1
51385,443,10522,443,8388,760,7628,20,145,6,14
57266,53,10699,53,753,96,657,2,31,1,1
30960,45718,62760,45718,330,330,0,6,3609,6,0
52948,443,49245,443,9629,2119,7510,42,114,20,22
36811,53,36811,53,227,90,137,2,29,1,1
49009,53,49009,53,172,76,96,2,30,1,1
49701,53,39669,53,197,102,95,2,31,1,1
49224,53,17208,53,185,102,83,2,30,1,1
41193,443,45935,443,6035,782,5253,16,109,8,8
50915,53,63317,53,168,78,90,2,30,1,1
56532,53,39559,53,193,102,91,2,30,1,1
8896,123,46598,123,94,94,0,1,30,1,0
54998,53,51168,53,195,102,93,2,30,1,1
53247,443,42679,443,7461,1789,5672,25,69,14,11
56396,53,48729,53,338,110,228,2,30,1,1
56894,53,54448,53,178,94,84,2,29,1,1
56818,45179,49960,45179,70,70,0,1,5,1,0
46445,443,57162,443,13942,8293,5649,59,172,31,28
37965,14259,39595,14259,150,150,0,1,1199,1,0
44517,53,22276,53,306,212,94,3,29,2,1
49817,53,29101,53,401,91,310,4,29,2,2
49781,443,43148,443,7877,1949,5928,24,126,12,12
48744,443,35880,443,2098,1239,859,22,20,12,10
65040,53,33364,53,178,94,84,2,30,1,1
60272,443,56856,443,13199834,344312,12855522,13125,121,3739,9386
60884,443,60884,443,4918,1626,3292,17,17,10,7
64989,53,14791,53,756,95,661,2,31,1,1
49459,443,42939,443,2572,330,2242,12,135,5,7
52797,443,2237,443,6876,3332,3544,22,140,11,11
52005,80,9480,80,46046,2705,43341,60,15,29,31
65446,53,2812,53,184,102,82,2,30,1,1
53804,443,53478,443,499,425,74,4,0,3,1
57580,443,3612,443,4049,1992,2057,23,96,13,10
38633,443,28633,443,4393,1151,3242,22,165,13,9
54731,443,46644,443,9498,2578,6920,28,19,16,12
52106,41632,33294,41632,66,66,0,1,5,1,0
51803,33973,12809,33973,70,70,0,2,8,2,0
53579,59332,61782,59332,70,70,0,1,5,1,0
55035,443,52274,443,13310,3162,10148,31,46,16,15
49421,443,54717,443,5422,801,4621,21,173,9,12
42631,443,38369,443,153,93,60,2,5,1,1
50265,2710,57990,2710,320,320,0,6,1200,6,0
33397,443,15065,443,1348,687,661,14,42,8,6
50601,443,53899,443,5035,3194,1841,23,72,12,11
49776,53,49776,53,256,114,142,2,30,1,1
50700,80,14024,80,648,256,392,8,27,5,3
64895,53,61625,53,199,102,97,2,30,1,1
64475,53,62342,53,184,94,90,2,29,1,1
64921,53,46383,53,238,102,136,2,31,1,1
39575,53,26625,53,198,93,105,2,30,1,1
51816,27721,33144,27721,70,70,0,2,8,2,0
35370,443,45689,443,87183,4177,83006,104,126,34,70
65499,443,30170,443,410116,12150,397966,421,16,148,273
55454,53,64127,53,168,86,82,2,32,1,1
56787,53,13426,53,209,110,99,2,30,1,1
53010,443,23300,443,31660,3248,28412,58,93,23,35
49255,7000,49255,7000,2163,676,1487,14,14,7,7
60741,443,38588,443,2042,559,1483,20,89,6,14
56478,53,14582,53,200,102,98,2,30,1,1
41011,443,63172,443,175097,9838,165259,244,106,120,124
49374,53,42809,53,197,94,103,2,30,1,1
65250,53,37683,53,353,98,255,4,32,2,2
56864,53,5721,53,200,102,98,2,30,1,1
51806,49530,42413,49530,66,66,0,1,5,1,0
50646,443,35425,443,6789,1020,5769,20,101,11,9
38409,443,38409,443,1452,817,635,16,20,9,7
64390,53,22708,53,225,110,115,2,30,1,1
51715,29358,11619,29358,414,136,278,6,16,3,3
51221,47391,14393,47391,323,150,173,2,1203,1,1
56855,53,37174,53,775,103,672,2,31,1,1
55564,53,55564,53,215,88,127,2,30,1,1
65501,53,1213,53,226,94,132,2,29,1,1
53017,80,55649,80,1658,1344,314,10,15,5,5
64888,53,40321,53,767,102,665,2,30,1,1
64312,53,28741,53,209,110,99,2,29,1,1
56239,53,9531,53,179,86,93,2,29,1,1
55478,443,16411,443,23029908,732047,22297861,24550,183,8143,16407
64743,53,57022,53,210,102,108,2,30,1,1
59736,53,9602,53,571,166,405,2,29,1,1
6881,13487,50124,13487,228,118,110,2,1199,1,1
50429,80,32057,80,318,192,126,6,26,4,2
60761,40010,63900,40010,316,136,180,6,6,3,3
56341,443,63475,443,8325,1483,6842,24,47,13,11
50469,443,24709,443,3049,1569,1480,17,19,10,7
49527,443,43125,443,5968,985,4983,17,26,8,9
26751,443,19482,443,11513,2842,8671,31,18,15,16
57997,80,61005,80,318,192,126,6,21,4,2
65299,53,37280,53,177,94,83,2,30,1,1
37965,16881,45844,16881,448,246,202,4,1199,2,2
60961,443,5669,443,75122,4244,70878,101,45,48,53
53241,443,45177,443,1950,1176,774,18,103,11,7
49869,80,36356,80,43386,3876,39510,79,22,42,37
49191,51253,24345,51253,504,318,186,8,15,5,3
52743,443,59107,443,1547,960,587,14,26,8,6
49761,53,31558,53,183,94,89,2,30,1,1
53121,443,1605,443,10893,7149,3744,31,45,18,13
15503,55878,37795,55878,481,150,331,2,1200,1,1
59342,80,59342,80,107768,4073,103695,177,15,58,119
53761,54363,63571,54363,618,432,186,9,16,6,3
58602,443,31018,443,3182,1568,1614,8,121,4,4
51835,29778,4690,29778,70,70,0,2,7,2,0
41207,80,55374,80,79441,3092,76349,103,16,48,55
55715,443,55715,443,4575,1668,2907,19,30,11,8
49226,53,53578,53,765,102,663,2,30,1,1
56929,53,47625,53,177,94,83,2,30,1,1
55223,443,26672,443,12583,2945,9638,31,47,16,15
57367,53,52070,53,177,94,83,2,30,1,1
55184,53,64437,53,182,93,89,2,31,1,1
49965,53,21038,53,285,110,175,2,30,1,1
57695,443,41532,443,9493,2266,7227,24,14,13,11
64660,53,61374,53,278,94,184,2,30,1,1
55219,53,47738,53,91,91,0,1,30,1,0
27005,52013,10619,52013,901,126,775,2,31,1,1
7660,443,7660,443,5640,2394,3246,25,82,13,12
4960,53,26982,53,222,86,136,2,30,1,1
33730,443,53132,443,5947,1579,4368,22,315,12,10
56321,443,18769,443,4704,2423,2281,16,135,8,8
22,51051,22,51051,109,109,0,1,5,1,0
59177,443,33565,443,280,140,140,5,130,3,2
61510,80,61510,80,17105,750,16355,21,15,7,14
43394,53,50886,53,168,78,90,2,31,1,1
49577,53,54563,53,384,94,290,2,30,1,1
49632,53,31125,53,288,94,194,2,30,1,1
49699,53,28371,53,209,110,99,2,31,1,1
64586,53,51199,53,183,94,89,2,29,1,1
64290,53,4027,53,302,98,204,4,47,2,2
55276,53,62860,53,177,94,83,2,30,1,1
49364,53,62830,53,180,92,88,2,31,1,1
51498,443,13741,443,134,60,74,3,4,2,1
64191,53,17402,53,264,110,154,2,30,1,1
49801,443,19605,443,44380,1589,42791,48,126,14,34
52098,80,42506,80,1955,913,1042,10,15,6,4
65451,53,45725,53,178,94,84,2,30,1,1
55641,53,45216,53,184,94,90,2,31,1,1
48817,51413,48817,51413,479,152,327,2,1200,1,1
46360,443,51396,443,1053,566,487,10,16,6,4
55566,53,37015,53,740,93,647,2,30,1,1
60565,443,42590,443,6483,3687,2796,18,135,9,9
49160,14387,38901,14387,854,150,704,4,1200,2,2
58955,80,51848,80,3037,2276,761,12,28,7,5
53824,41482,6861,41482,70,70,0,1,4,1,0
57065,53,34013,53,272,110,162,2,29,1,1
56833,28571,3493,28571,5436,3022,2414,17,32,11,6
49983,53,57759,53,211,110,101,2,30,1,1
48541,80,51953,80,812,672,140,6,28,4,2
61427,80,27068,80,214,140,74,4,41,3,1
65451,53,9414,53,178,94,84,2,30,1,1
64934,53,52297,53,197,102,95,2,33,1,1
65265,53,37973,53,821,102,719,2,30,1,1
6881,6881,7756,6881,501,150,351,2,1200,1,1
50669,443,37355,443,12463,2350,10113,46,20,19,27
55248,443,36636,443,30281,3919,26362,44,62,21,23
51218,5223,10817,5223,11005,5789,5216,34,23,18,16
56796,443,60351,443,8074,2054,6020,20,15,11,9
49756,53,23582,53,264,89,175,4,47,2,2
53734,443,22403,443,499,425,74,4,0,3,1
53369,80,53369,80,81339,4340,76999,84,57,22,62
49655,80,18992,80,1056,682,374,10,15,6,4
59573,443,39847,443,289380,13628,275752,335,70,142,193
50121,53,43532,53,152,78,74,2,31,1,1
56893,53,56270,53,177,94,83,2,30,1,1
54099,80,63919,80,214,140,74,4,15,3,1
57436,53,1607,53,183,94,89,2,30,1,1
53552,8999,43016,8999,70,70,0,1,4,1,0
55340,53,25572,53,324,110,214,2,29,1,1
49216,63752,26927,63752,70,70,0,1,5,1,0
64650,53,46185,53,257,126,131,2,30,1,1
64835,53,60535,53,200,102,98,2,31,1,1
63950,53,13148,53,200,102,98,2,31,1,1
53258,443,42318,443,31919,3528,28391,49,323,19,30
52135,46475,48450,46475,70,70,0,2,8,2,0
65260,53,38236,53,184,94,90,2,30,1,1
55715,53,53520,53,168,86,82,2,30,1,1
56532,443,14584,443,198167,11702,186465,220,105,84,136
50945,80,53857,80,6920116,91852,6828264,6765,79,1277,5488
53628,50514,20883,50514,70,70,0,2,7,2,0
56875,53,33833,53,167,86,81,2,30,1,1
49977,53,38356,53,209,110,99,2,30,1,1
52007,443,2667,443,10217,8266,1951,33,39,20,13
51965,80,11220,80,306,120,186,6,25,3,3
56419,53,8331,53,198,101,97,2,30,1,1
49508,53,61449,53,370,102,268,2,30,1,1
56472,80,20215,80,45108,2309,42799,60,134,28,32
50584,53,23534,53,744,89,655,2,31,1,1
50679,80,31597,80,62,62,0,1,4,1,0
64081,443,44288,443,7280,2277,5003,19,136,9,10
44389,443,27883,443,3067,1817,1250,18,16,8,10
50095,53,54067,53,146,75,71,2,31,1,1
26849,443,35279,443,20979,15982,4997,38,36,22,16
51517,443,20075,443,590874,19818,571056,669,42,271,398
50326,443,7479,443,7819,2474,5345,25,82,13,12
55125,53,47085,53,177,94,83,2,30,1,1
56572,53,63633,53,177,94,83,2,31,1,1
50584,53,19282,53,738,86,652,2,30,1,1
51989,80,9142,80,1344,899,445,8,15,6,2
47748,161,0,0,6387,2535,3852,22,30,11,11
48980,15000,3233,15000,130,70,60,2,5,1,1
19789,53,19789,53,371,237,134,3,33,2,1
57051,53,63796,53,783,96,687,2,30,1,1
57264,53,9791,53,214,102,112,2,30,1,1
56829,53,59229,53,199,102,97,2,30,1,1
57470,6885,1463,6885,616,414,202,5,1200,3,2
45525,53,45525,53,86,86,0,1,30,1,0
53887,6881,31498,6881,552,306,246,9,15,5,4
52264,43015,38341,43015,70,70,0,2,7,2,0
59480,443,64952,443,5058,2667,2391,25,92,13,12
65530,53,20918,53,167,86,81,2,29,1,1
61077,443,19799,443,4970,2272,2698,12,121,6,6
64915,443,15491,443,4659604,120303,4539301,4651,74,1586,3065
49876,80,23793,80,24764,4454,20310,30,88,12,18
46767,443,3623,443,8376,2231,6145,25,330,12,13
38721,443,64394,443,10216,3380,6836,26,120,12,14
56919,53,16423,53,193,102,91,2,29,1,1
50191,53,9113,53,734,94,640,2,30,1,1
39644,80,29707,80,2631,1207,1424,14,16,9,5
36661,443,26709,443,16244,2265,13979,35,262,19,16
49278,53,60636,53,200,94,106,2,30,1,1
49968,53,46436,53,285,94,191,2,30,1,1
49884,443,63837,443,5998,978,5020,19,50,10,9
52999,80,62826,80,1991,686,1305,10,335,6,4
55675,53,17939,53,190,97,93,2,0,1,1
64782,53,40065,53,758,93,665,2,31,1,1
47886,80,46758,80,1767,751,1016,10,15,6,4
49514,80,16033,80,1352,832,520,12,38,7,5
53191,443,21271,443,7694,3364,4330,21,123,11,10
53515,39608,40902,39608,70,70,0,1,4,1,0
49528,53,36226,53,177,94,83,2,29,1,1
54711,443,57738,443,7169,2405,4764,18,135,10,8
51697,60619,59919,60619,70,70,0,1,5,1,0
36542,443,35325,443,31814,26657,5157,52,212,32,20
49498,443,53084,443,4172,1018,3154,16,27,8,8
52015,443,52015,443,32358,7474,24884,49,49,23,26
50096,53,56974,53,733,94,639,2,30,1,1
49518,53,40851,53,167,86,81,2,30,1,1
65147,53,52735,53,323,102,221,2,30,1,1
57027,53,33808,53,177,94,83,2,30,1,1
30960,45762,15257,45762,330,330,0,6,3609,6,0
64401,53,5392,53,293,94,199,2,30,1,1
53004,80,58597,80,9956,2570,7386,21,335,10,11
64962,53,10417,53,196,94,102,2,30,1,1
47302,53,19968,53,168,78,90,2,30,1,1
6881,6881,10552,6881,238,118,120,2,1200,1,1
55637,53,58251,53,209,110,99,2,30,1,1
57377,443,4552,443,5553,927,4626,16,15,10,6
57382,443,54714,443,5619,927,4692,17,15,10,7
64413,443,46827,443,5660875,75934,5584941,4719,141,686,4033
59625,443,5961,443,6703,1307,5396,28,18,14,14
55957,53,38699,53,172,88,84,2,30,1,1
64678,53,21797,53,229,110,119,2,30,1,1
54449,443,54449,443,7974,2926,5048,25,17,15,10
57235,53,60743,53,757,102,655,2,29,1,1
65052,53,39393,53,200,94,106,2,30,1,1
5588,5588,0,0,3562,1936,1626,48,193,24,24
58987,443,9430,443,3730,2378,1352,23,28,12,11
44448,443,36659,443,5960,1651,4309,21,85,12,9
50466,53,18896,53,199,102,97,2,30,1,1
56633,53,42067,53,164,84,80,2,31,1,1
56521,443,40583,443,11375,1770,9605,27,55,15,12
55922,53,46699,53,423,102,321,2,30,1,1
65129,443,48258,443,1765,1126,639,17,125,10,7
56645,443,5860,443,32966,3481,29485,49,80,21,28
53251,443,53251,443,1404,697,707,17,121,8,9
50619,53,43137,53,815,95,720,2,30,1,1
50353,443,15424,443,1775,169,1606,7,121,3,4
64751,53,23466,53,458,188,270,6,31,3,3
54520,443,49982,443,8152,4874,3278,22,138,11,11
55498,53,29212,53,177,94,83,2,30,1,1
55955,53,59557,53,184,94,90,2,30,1,1
52632,443,52632,443,4351,1444,2907,19,28,11,8
46714,80,46714,80,83777,2610,81167,90,155,27,63
54502,443,10226,443,6750,1755,4995,16,103,9,7
38427,443,30130,443,12591,2902,9689,40,55,19,21
27005,27015,17359,27015,878,126,752,2,30,1,1
53297,443,55944,443,5600,1187,4413,24,80,13,11
27005,27015,45199,27015,892,126,766,2,30,1,1
27992,443,34351,443,7775,3104,4671,18,76,10,8
64547,53,28372,53,367,102,265,2,31,1,1
64974,53,51198,53,493,111,382,4,57,2,2
57074,53,56571,53,190,97,93,2,30,1,1
62034,53,62034,53,216,90,126,2,30,1,1
3304,80,1558,80,2340,1419,921,10,15,5,5
64079,20233,31225,20233,66,66,0,2,7,2,0
28013,443,29765,443,6130,1264,4866,18,75,9,9
51750,54567,18193,54567,70,70,0,2,7,2,0
49186,53,49186,53,257,101,156,2,32,1,1
64319,53,34050,53,193,102,91,2,31,1,1
37736,443,40675,443,498507,26210,472297,544,207,200,344
44169,443,53615,443,12098,5328,6770,25,121,12,13
37267,443,16640,443,3296,1636,1660,17,255,9,8
27005,27015,20017,27015,882,126,756,2,30,1,1
56924,53,61139,53,216,110,106,2,30,1,1
60410,443,3323,443,3683,1899,1784,20,20,10,10
49478,53,25544,53,172,94,78,2,30,1,1
53347,443,16972,443,21456,6153,15303,120,491,46,74
1100,27540,53473,27540,132,70,62,2,30,1,1
64020,53,53035,53,196,102,94,2,30,1,1
55644,53,20547,53,184,94,90,2,30,1,1
53789,47191,38332,47191,70,70,0,1,5,1,0
49597,53,63650,53,168,86,82,2,31,1,1
49429,53,2752,53,194,102,92,2,30,1,1
56543,53,18371,53,756,95,661,2,30,1,1
49408,443,42776,443,4189,2286,1903,35,256,17,18
55336,53,18020,53,308,94,214,2,30,1,1
50060,80,8335,80,2425,529,1896,11,75,6,5
50064,443,33198,443,6376,2499,3877,20,16,10,10
30960,45686,49488,45686,330,330,0,6,3609,6,0
37911,443,2261,443,466,392,74,4,0,3,1
50293,80,34278,80,134242,13446,120796,154,161,58,96
56942,443,61847,443,494,420,74,4,0,3,1
38805,443,57310,443,6686,1197,5489,23,16,12,11
61580,53,48820,53,275,94,181,2,29,1,1
61802,443,61802,443,4521,1614,2907,19,26,11,8
53230,443,3800,443,6177,1038,5139,22,58,11,11
55044,443,54771,443,5549,2777,2772,24,16,14,10
56964,53,11967,53,774,101,673,2,31,1,1
61343,443,57856,443,1784740,34746,1749994,1769,331,357,1412
50639,80,20616,80,318,192,126,6,25,4,2
55330,53,64550,53,194,102,92,2,31,1,1
42356,443,3759,443,276,70,206,5,26,2,3
63974,53,39548,53,212,102,110,2,29,1,1
44960,80,44960,80,4372,2093,2279,16,19,10,6
49854,443,54861,443,5089,1037,4052,20,61,11,9
58171,80,42934,80,1651,550,1101,13,15,7,6
63627,443,58785,443,17242,3015,14227,19,143,5,14
56526,53,17737,53,168,94,74,2,30,1,1
64963,53,58073,53,453,186,267,6,30,3,3
53185,443,52524,443,4442408,142153,4300255,4731,235,1574,3157
56928,53,57142,53,178,94,84,2,30,1,1
51499,443,1743,443,6848,769,6079,17,15,9,8
49556,443,19377,443,198375,6279,192096,205,153,69,136
63786,50091,41625,50091,70,70,0,1,5,1,0
65208,53,46888,53,637,178,459,6,70,3,3
49997,53,42386,53,264,102,162,2,30,1,1
49935,53,57757,53,775,102,673,2,30,1,1
60755,40010,18324,40010,316,136,180,6,7,3,3
49908,443,25535,443,4712,908,3804,18,75,9,9
58766,443,24380,443,6031,770,5261,18,15,8,10
49464,53,1533,53,213,102,111,2,30,1,1
49675,53,62598,53,199,102,97,2,29,1,1
49973,53,27114,53,261,94,167,2,30,1,1
57146,53,13566,53,199,102,97,2,29,1,1
54815,3389,54815,3389,3424,1710,1714,16,31,8,8
36502,53,33412,53,168,78,90,2,30,1,1
58770,443,24221,443,6033,770,5263,18,15,8,10
50385,443,20761,443,11098,2853,8245,25,33,12,13
55889,53,7976,53,168,86,82,2,30,1,1
49520,443,49520,443,88797,5446,83351,137,76,70,67
64410,53,61695,53,196,102,94,2,30,1,1
50972,3544,56182,3544,409,107,302,4,31,2,2
49946,443,3936,443,8725,3341,5384,25,136,12,13
49864,53,63965,53,193,102,91,2,30,1,1
65071,53,53845,53,411,99,312,4,52,2,2
49780,53,4418,53,183,94,89,2,29,1,1
55730,8060,61259,8060,70,70,0,1,4,1,0
55700,26957,33294,26957,70,70,0,2,8,2,0
56177,443,61837,443,6826,5299,1527,22,330,12,10
56346,53,56346,53,262,106,156,2,32,1,1
50263,443,33451,443,35817,18303,17514,160,138,85,75
48817,39388,48817,39388,1267,631,636,6,1199,3,3
58365,53,51432,53,260,86,174,2,30,1,1
50376,53,47622,53,167,78,89,2,30,1,1
50584,443,50316,443,36457,2308,34149,52,98,23,29
52932,443,34898,443,20789,4927,15862,35,31,20,15
49332,53,28193,53,281,98,183,4,56,2,2
55833,53,34904,53,177,94,83,2,30,1,1
55850,443,8932,443,2883,642,2241,13,135,6,7
57239,53,14403,53,193,102,91,2,31,1,1
65419,53,10153,53,198,101,97,2,31,1,1
58566,443,36573,443,34405,7602,26803,53,35,24,29
56818,53,44106,53,755,94,661,2,30,1,1
55000,53,30925,53,753,93,660,2,31,1,1
37133,80,37133,80,12799,979,11820,20,17,9,11
65180,53,35991,53,199,102,97,2,30,1,1
47504,53,47504,53,174,77,97,2,30,1,1
62759,443,5744,443,9928,5183,4745,34,134,17,17
50116,22,50116,22,184,120,64,4,4,3,1
60239,443,31265,443,3149,1969,1180,19,150,11,8
47657,443,24927,443,502,140,362,8,140,3,5
53123,59228,59037,59228,70,70,0,1,4,1,0
61816,80,7127,80,2058,589,1469,10,45,6,4
22278,53,34234,53,806,458,348,3,29,2,1
50657,80,54275,80,23292,2267,21025,28,21,10,18
65318,53,11252,53,184,94,90,2,30,1,1
36738,80,36738,80,416,198,218,7,121,4,3
60111,443,2026,443,11519,3163,8356,51,25,26,25
65179,53,63378,53,184,94,90,2,31,1,1
56167,53,17314,53,178,94,84,2,30,1,1
64742,53,25271,53,165,86,79,2,29,1,1
58507,80,58507,80,348,132,216,6,26,3,3
19520,7000,19520,7000,4579,2182,2397,16,17,9,7
38564,443,56432,443,1312,651,661,13,185,7,6
59847,443,63269,443,21180,2662,18518,34,17,14,20
45717,80,45717,80,2081,1632,449,10,19,6,4
55404,443,57333,443,2352,1394,958,17,275,9,8
65006,53,31072,53,793,101,692,2,30,1,1
47739,53,26929,53,168,78,90,2,29,1,1
56192,53,2949,53,170,87,83,2,30,1,1
49342,443,54046,443,10075,6346,3729,48,84,25,23
60415,443,32364,443,7727,2796,4931,36,104,18,18
55830,53,42279,53,170,87,83,2,30,1,1
56845,443,17798,443,16207,6355,9852,84,195,43,41
60871,443,24250,443,8338,3198,5140,28,46,16,12
56630,443,17918,443,6156,918,5238,18,26,10,8
37751,53,37751,53,194,87,107,2,30,1,1
57203,53,8040,53,199,102,97,2,29,1,1
60520,53,60520,53,248,106,142,2,29,1,1
58254,80,49705,80,1151,711,440,10,15,5,5
57083,53,55638,53,198,102,96,2,30,1,1
51721,35426,54780,35426,70,70,0,1,5,1,0
49627,443,59623,443,20583,3435,17148,54,95,27,27
55657,37273,52099,37273,70,70,0,1,5,1,0
53165,18504,45814,18504,70,70,0,2,8,2,0
55214,443,10396,443,10048,2128,7920,44,118,24,20
42298,40023,18406,40023,1487,743,744,10,30,5,5
8283,45858,63554,45858,130,70,60,2,30,1,1
50841,443,31504,443,10475,1518,8957,24,139,11,13
57790,443,8937,443,117653,21783,95870,251,556,93,158
65286,53,17051,53,756,94,662,2,30,1,1
53772,443,49684,443,499,425,74,4,0,3,1
62447,53,48844,53,296,94,202,2,30,1,1
50609,80,26280,80,4163,2891,1272,17,17,9,8
65469,53,49560,53,195,102,93,2,30,1,1
64959,53,12342,53,209,110,99,2,30,1,1
56677,53,7912,53,200,102,98,2,30,1,1
42298,58000,33594,58000,596,256,340,10,30,5,5
65024,53,19328,53,199,102,97,2,30,1,1
55155,53,23280,53,194,102,92,2,30,1,1
53753,443,5988,443,499,425,74,4,0,3,1
65136,53,56323,53,458,104,354,4,57,2,2
56625,53,10109,53,711,87,624,2,31,1,1
49686,80,54142,80,2611,1811,800,13,15,7,6
52126,56057,15046,56057,70,70,0,2,8,2,0
56986,53,7478,53,259,87,172,4,37,2,2
12776,53,12776,53,239,94,145,2,30,1,1
28608,80,28608,80,602483,18143,584340,627,27,219,408
55611,58049,54667,58049,504,318,186,8,15,5,3
64170,53,8544,53,355,118,237,2,30,1,1
54709,443,26640,443,5493,933,4560,18,41,9,9
56879,53,15909,53,780,93,687,2,31,1,1
46772,80,10171,80,2068,1371,697,13,83,7,6
64122,53,44861,53,212,108,104,2,31,1,1
64749,3389,64749,3389,3347,1458,1889,15,18,8,7
50749,443,31608,443,70,70,0,2,171,2,0
44543,443,30865,443,13478,2683,10795,36,104,19,17
56560,53,25642,53,900,110,790,2,31,1,1
49520,80,52279,80,2011,975,1036,13,70,7,6
46764,443,46764,443,4401,1494,2907,19,29,11,8
53918,24300,60964,24300,1735,975,760,11,16,7,4
56997,80,45711,80,214,140,74,4,35,3,1
33971,443,52032,443,244193,7090,237103,260,136,87,173
50495,80,9941,80,312,192,120,6,25,4,2
37148,53,21111,53,164,78,86,2,30,1,1
53525,34759,57554,34759,70,70,0,2,8,2,0
19840,7000,19840,7000,3610,2043,1567,16,17,9,7
56055,53,24959,53,168,86,82,2,30,1,1
51159,443,36632,443,6405463,157088,6248375,6383,90,2146,4237
63967,53,11149,53,195,102,93,2,30,1,1
60965,443,57735,443,1439,718,721,15,111,8,7
49879,443,31980,443,6121,1042,5079,21,53,11,10
19473,12345,64156,12345,478,149,329,2,1200,1,1
27005,33026,58261,33026,879,126,753,3,32,2,1
59899,53,59899,53,194,87,107,2,31,1,1
65152,53,30200,53,177,94,83,2,30,1,1
55913,53,60589,53,177,94,83,2,30,1,1
58563,53,4425,53,312,78,234,2,29,1,1
55543,3389,55543,3389,3488,1774,1714,17,32,9,8
51827,48432,37555,48432,164,70,94,2,4,1,1
65453,53,50552,53,242,94,148,2,30,1,1
53843,17556,3555,17556,320,140,180,6,7,3,3
65389,53,51653,53,94,94,0,1,30,1,0
56414,53,12496,53,178,94,84,2,29,1,1
49218,53,31585,53,179,86,93,2,30,1,1
49986,53,46060,53,779,110,669,2,30,1,1
60817,443,60817,443,1320,685,635,14,180,7,7
56805,443,33799,443,8022,2002,6020,20,15,11,9
35333,80,8364,80,1432,663,769,10,19,6,4
52407,443,29892,443,1043,556,487,10,16,6,4
27005,30000,59167,30000,913,126,787,2,30,1,1
57077,443,42602,443,7159,1851,5308,22,31,13,9
49962,53,32122,53,402,118,284,2,30,1,1
50100,53,23176,53,216,110,106,2,30,1,1
58957,80,23483,80,13330975,109486,13221489,10177,23,1394,8783
55190,53,7214,53,733,86,647,2,31,1,1
51660,80,21356,80,52002,2984,49018,77,35,35,42
50662,443,44987,443,3306,1714,1592,17,16,9,8
55160,443,10978,443,333522,14341,319181,347,129,109,238
55871,53,11606,53,711,87,624,2,30,1,1
53924,45212,48371,45212,70,70,0,2,8,2,0
55448,53,34800,53,184,94,90,2,29,1,1
27005,27017,28274,27017,880,126,754,2,31,1,1
57108,53,1595,53,193,102,91,2,30,1,1
52105,1024,64532,1024,70,70,0,1,4,1,0
40554,53,2086,53,223,78,145,2,30,1,1
35165,443,20390,443,7174,4658,2516,18,121,10,8
57631,443,64255,443,154,94,60,2,5,1,1
56033,443,58131,443,8396,1919,6477,27,116,12,15
55022,53,10600,53,190,97,93,2,31,1,1
9480,443,14084,443,6100,777,5323,17,25,9,8
51823,80,56758,80,4456,1889,2567,11,39,6,5
55679,1024,59914,1024,70,70,0,2,8,2,0
50210,53,56208,53,756,94,662,2,29,1,1
60771,80,37890,80,254,128,126,5,15,3,2
49304,443,13306,443,12436,7656,4780,41,17,23,18
25808,53,25808,53,218,99,119,2,31,1,1
49277,53,14856,53,230,102,128,2,30,1,1
50021,53,13540,53,821,102,719,2,30,1,1
51861,53,51861,53,305,160,145,3,33,2,1
54079,443,34399,443,6931,1974,4957,24,342,11,13
30188,41184,4045,41184,509,150,359,2,1200,1,1
57092,53,56689,53,445,86,359,2,30,1,1
10151,40231,24979,40231,481,150,331,2,1200,1,1
55902,53,58638,53,181,94,87,2,30,1,1
51853,30585,59624,30585,136,136,0,3,14,3,0
63084,53,39134,53,86,86,0,2,31,2,0
14431,443,44094,443,2601,1455,1146,18,16,8,10
64004,48339,7779,48339,66,66,0,2,7,2,0
51498,443,60787,443,7211,823,6388,16,15,10,6
64886,53,36555,53,199,102,97,2,30,1,1
56745,443,56745,443,101899,20048,81851,132,62,67,65
55147,53,22954,53,184,94,90,2,30,1,1
44516,443,18408,443,156324,6993,149331,192,108,81,111
64605,53,37496,53,183,94,89,2,30,1,1
57691,53,57691,53,247,98,149,2,32,1,1
59021,443,44226,443,4596,1442,3154,24,154,11,13
51997,443,19517,443,2648,1797,851,19,22,11,8
30960,45758,64660,45758,462,462,0,8,3632,8,0
49768,53,39040,53,459,103,356,4,43,2,2
52432,443,37828,443,330,190,140,6,15,4,2
39890,123,28941,123,184,94,90,2,30,1,1
60812,80,61213,80,1658,1344,314,10,14,5,5
52025,42442,23036,42442,70,70,0,2,7,2,0
64871,53,62774,53,263,94,169,2,31,1,1
41498,443,27057,443,2733,1555,1178,22,275,11,11
65315,53,22076,53,216,110,106,2,30,1,1
53930,19831,49369,19831,70,70,0,2,7,2,0
37066,443,21003,443,2386,1423,963,18,169,10,8
64290,53,18678,53,196,102,94,2,31,1,1
57139,53,30822,53,193,102,91,2,30,1,1
60192,53,4239,53,236,94,142,2,30,1,1
63750,63343,14942,63343,66,66,0,1,5,1,0
50265,6881,13047,6881,491,150,341,2,1200,1,1
55199,53,62103,53,196,94,102,2,30,1,1
60864,5223,21557,5223,6278,2408,3870,27,3600,15,12
56533,53,11547,53,498,204,294,6,30,3,3
49418,27015,14381,27015,248,71,177,2,31,1,1
54898,443,54771,443,78537,4022,74515,120,386,55,65
49730,53,40205,53,194,102,92,2,30,1,1
56226,53,58477,53,780,104,676,2,31,1,1
9123,80,23605,80,65336,2808,62528,73,37,28,45
57886,443,10717,443,33667,25477,8190,60,33,34,26
65528,53,47715,53,217,75,142,4,30,2,2
26900,27017,39625,27017,422,164,258,6,30,3,3
55049,443,34090,443,13661,4451,9210,32,46,18,14
50629,443,47938,443,6553,1034,5519,23,87,12,11
27005,30007,41112,30007,890,126,764,2,31,1,1
39098,443,35056,443,5519,1493,4026,20,121,9,11
51880,51881,42143,51881,86,86,0,1,30,1,0
53052,443,60187,443,8476,2030,6446,38,91,19,19
51892,80,28935,80,15867,8841,7026,29,26,16,13
57996,80,13904,80,5411,3618,1793,27,75,14,13
64016,53,48329,53,183,94,89,2,30,1,1
53656,58624,54901,58624,70,70,0,1,5,1,0
52050,31648,17402,31648,70,70,0,2,8,2,0
50594,443,48288,443,4337,3026,1311,21,141,12,9
57604,53,48752,53,290,86,204,2,29,1,1
51135,443,21022,443,640504,257235,383269,1476,797,643,833
54535,80,13360,80,4162,3455,707,14,15,8,6
60229,443,63895,443,19536,7593,11943,76,151,37,39
65176,53,13076,53,299,103,196,4,51,2,2
56258,3389,56258,3389,4768,1600,3168,19,17,10,9
61732,3389,61732,3389,3380,1730,1650,15,33,8,7
34308,3389,34308,3389,4930,2691,2239,24,19,14,10
56770,443,61506,443,5829,2962,2867,35,89,17,18
55646,53,12583,53,780,93,687,2,30,1,1
57021,443,9946,443,4697,1470,3227,20,131,9,11
64685,53,15480,53,199,102,97,2,30,1,1
53986,53,15974,53,102,102,0,1,30,1,0
64710,53,45310,53,195,102,93,2,31,1,1
65426,53,23528,53,706,195,511,6,52,3,3
55100,53,57209,53,711,87,624,2,30,1,1
64602,53,17194,53,751,94,657,2,29,1,1
50393,443,41486,443,7356,1014,6342,20,75,10,10
49506,53,23058,53,200,102,98,2,30,1,1
63924,26328,47247,26328,70,70,0,1,4,1,0
60884,443,1605,443,6505,2038,4467,26,46,15,11
60406,64337,21894,64337,70,70,0,1,5,1,0
55531,53,57594,53,370,126,244,2,30,1,1
64985,53,53017,53,196,102,94,2,30,1,1
58074,443,57514,443,2974,408,2566,13,135,6,7
4702,53,4702,53,220,90,130,2,29,1,1
54956,53,56541,53,194,102,92,2,30,1,1
64485,53,10635,53,183,94,89,2,30,1,1
50560,53,62139,53,755,94,661,2,30,1,1
53708,80,59470,80,2434,516,1918,12,76,6,6
55651,53,20940,53,199,102,97,2,30,1,1
39458,443,56911,443,1053,566,487,10,31,6,4
37641,443,55231,443,8423,2244,6179,32,15,17,15
56592,53,10104,53,200,102,98,2,31,1,1
65336,53,30958,53,771,101,670,2,31,1,1
56583,53,7154,53,177,94,83,2,30,1,1
60469,60092,64603,60092,70,70,0,2,8,2,0
56883,53,30894,53,184,94,90,2,29,1,1
53566,8999,11689,8999,3428,1820,1608,21,17,12,9
38639,443,56279,443,10556,3559,6997,38,82,21,17
53920,443,44819,443,499,425,74,4,0,3,1
56612,53,25509,53,274,87,187,4,31,2,2
64707,53,28396,53,757,98,659,2,31,1,1
64578,53,30124,53,193,102,91,2,30,1,1
50994,443,10248,443,3137,1855,1282,19,16,9,10
52010,80,42870,80,29838,2481,27357,56,31,24,32
60495,6882,21325,6882,70,70,0,1,5,1,0
65289,53,55084,53,174,89,85,2,31,1,1
56026,53,4908,53,183,94,89,2,31,1,1
6881,6881,56597,6881,231,111,120,2,1200,1,1
59766,443,36182,443,508206,39212,468994,748,192,296,452
45268,443,29338,443,7503,2345,5158,34,256,17,17
60004,443,3185,443,134,60,74,3,4,2,1
58638,5900,58638,5900,62,62,0,1,5,1,0
39446,443,32219,443,1647482,62713,1584769,1898,219,744,1154
64506,53,14791,53,230,94,136,2,30,1,1
55619,53,59792,53,241,78,163,2,30,1,1
59685,443,54976,443,7747,1533,6214,27,31,13,14
30296,53,30296,53,233,90,143,2,33,1,1
33898,80,33898,80,14448,2001,12447,26,16,14,12
49999,53,13553,53,181,94,87,2,29,1,1
53898,443,56204,443,499,425,74,4,0,3,1
46555,53,62486,53,168,78,90,2,30,1,1
51892,46647,6843,46647,70,70,0,1,5,1,0
54388,53,31456,53,168,78,90,2,30,1,1
55384,53,49003,53,194,102,92,2,31,1,1
34998,443,4497,443,9114,2208,6906,36,120,19,17
64475,443,53340,443,251092,8989,242103,282,123,98,184
50286,443,48730,443,6414386,102255,6312131,5812,182,1634,4178
0,0,0,0,480,244,236,4,0,2,2
8878,80,27996,80,1220,403,817,15,414,4,11
51966,443,48480,443,130,70,60,2,15,1,1
49665,53,6360,53,779,298,481,8,67,4,4
51896,43357,29923,43357,70,70,0,2,8,2,0
65516,53,41111,53,290,94,196,4,40,2,2
49301,443,34200,443,7616,3064,4552,14,120,6,8
53270,443,48173,443,21684,2143,19541,38,322,16,22
62464,443,10700,443,4595,3120,1475,18,33,10,8
57278,443,35481,443,8960,2949,6011,21,122,10,11
49354,53,30111,53,192,98,94,2,31,1,1
49918,53,24031,53,196,100,96,2,31,1,1
35747,443,32307,443,8676,3499,5177,31,373,17,14
51936,443,23888,443,4940,3363,1577,27,34,16,11
54028,443,7656,443,11123,4258,6865,48,197,27,21
65509,53,55791,53,321,102,219,2,30,1,1
55647,53,8145,53,168,86,82,2,30,1,1
53644,58085,53471,58085,70,70,0,1,4,1,0
57187,53,15982,53,782,105,677,2,30,1,1
49941,53,13341,53,193,102,91,2,30,1,1
53124,52917,46926,52917,70,70,0,2,8,2,0
37965,6881,15418,6881,1534,248,1286,4,1200,2,2
56875,53,55228,53,167,86,81,2,30,1,1
56356,53,26889,53,277,118,159,2,30,1,1
53240,443,24615,443,46348,20067,26281,75,60,37,38
64297,53,43105,53,364,94,270,4,49,2,2
7322,80,9945,80,950,485,465,9,16,5,4
55871,53,4127,53,177,94,83,2,30,1,1
57470,43611,57055,43611,3960,3960,0,61,3411,61,0
49186,443,54954,443,508520,13734,494786,527,18,192,335
6882,5406,43769,5406,654,150,504,3,1200,1,2
50265,45682,34420,45682,330,330,0,6,1200,6,0
51466,443,4846,443,1878,1050,828,9,16,5,4
56771,43648,21453,43648,70,70,0,1,5,1,0
55853,53,20879,53,197,102,95,2,29,1,1
37647,443,55661,443,697381,19797,677584,725,106,247,478
56357,53,34112,53,178,94,84,2,30,1,1
56782,53,44895,53,197,102,95,2,30,1,1
57308,443,38390,443,36373,15248,21125,172,123,69,103
55180,53,4513,53,209,110,99,2,30,1,1
61405,443,43963,443,4810,2361,2449,34,80,16,18
55528,443,24685,443,7845,1860,5985,24,81,14,10
53805,443,64828,443,499,425,74,4,0,3,1
16403,16384,41860,16384,122,62,60,2,30,1,1
64620,53,58577,53,166,86,80,2,30,1,1
51880,8000,29097,8000,270,270,0,4,33,4,0
45400,80,25751,80,574,500,74,6,15,5,1
59983,80,41468,80,1745,779,966,12,144,7,5
56113,443,21683,443,103486,7416,96070,161,42,82,79
50740,443,2714,443,3108,1730,1378,16,16,9,7
49708,53,2580,53,177,94,83,2,30,1,1
40340,53,40340,53,217,90,127,2,30,1,1
56756,443,23896,443,8007,1987,6020,20,15,11,9
61407,443,61407,443,4552,1645,2907,19,26,11,8
49743,53,12081,53,636,202,434,6,47,3,3
50523,443,44131,443,1389,868,521,12,25,6,6
55831,53,65358,53,183,94,89,2,30,1,1
56617,443,25954,443,7981,1961,6020,20,16,11,9
56225,53,16256,53,188,96,92,2,30,1,1
55705,54638,46726,54638,504,318,186,8,15,5,3
65249,53,5221,53,166,86,80,2,30,1,1
54069,443,6998,443,887350,41179,846171,1082,210,487,595
64981,53,62988,53,214,102,112,2,29,1,1
59419,80,51819,80,3442,1672,1770,19,22,10,9
37672,5223,15708,5223,110,110,0,1,5,1,0
37581,443,35670,443,499,425,74,4,0,3,1
53998,443,53998,443,4613,1706,2907,19,30,11,8
49856,443,13732,443,18685,4528,14157,31,151,13,18
47677,80,49789,80,1304,850,454,11,31,6,5
56973,53,45728,53,193,102,91,2,30,1,1
54743,443,47896,443,166136,7244,158892,202,149,76,126
49171,443,58850,443,13649,6228,7421,28,30,15,13
49663,443,36491,443,4271,1075,3196,16,25,8,8
59813,53,1465,53,355,118,237,2,30,1,1
63813,53455,10491,53455,70,70,0,1,5,1,0
56413,80,48301,80,31432,748,30684,32,104,8,24
56259,53,56259,53,244,98,146,2,32,1,1
53173,25067,13422,25067,70,70,0,2,8,2,0
55429,443,27216,443,343735,15691,328044,423,171,179,244
51916,24596,60319,24596,70,70,0,1,5,1,0
55790,53,27986,53,177,94,83,2,30,1,1
57855,443,34807,443,4370,3370,1000,19,187,10,9
52053,34411,20997,34411,70,70,0,2,7,2,0
46002,53,40286,53,168,78,90,2,30,1,1
38639,80,55224,80,1013,504,509,10,15,6,4
57108,53,35898,53,193,102,91,2,30,1,1
56031,53,4995,53,177,94,83,2,29,1,1
49826,443,3257,443,102548,19098,83450,140,35,60,80
26900,27017,33518,27017,422,164,258,6,30,3,3
36420,443,54908,443,7018,1381,5637,24,17,14,10
42164,80,6790,80,1658,1344,314,10,15,5,5
50730,443,12545,443,3514,1609,1905,30,51,16,14
50658,80,54358,80,5018,4314,704,11,30,6,5
56834,46513,28288,46513,70,70,0,1,5,1,0
65404,443,46166,443,63040,3063,59977,78,129,30,48
49203,53,20527,53,168,86,82,2,31,1,1
10053,443,28179,443,1832,1113,719,18,110,10,8
50895,443,43273,443,14584,6798,7786,37,181,18,19
58705,80,29021,80,2543,1880,663,12,14,6,6
43357,443,59688,443,1053,566,487,10,15,6,4
59068,443,48115,443,11182,6150,5032,65,1775,41,24
55126,53,61612,53,193,102,91,2,29,1,1
56654,53,7307,53,209,110,99,2,30,1,1
62947,53,18275,53,213,86,127,2,30,1,1
42298,40018,26921,40018,148,86,62,2,30,1,1
56899,53,4081,53,258,102,156,2,30,1,1
29245,80,29245,80,27233,4047,23186,44,27,20,24
53294,443,27871,443,7740,4267,3473,39,97,21,18
49736,443,37577,443,378,192,186,7,15,4,3
57396,53,65107,53,183,94,89,2,30,1,1
50717,80,38874,80,3317,2376,941,17,165,9,8
56226,53,44944,53,284,96,188,4,33,2,2
42956,53,20926,53,168,78,90,2,30,1,1
23228,443,23228,443,20540,5514,15026,52,76,29,23
57906,443,24320,443,2725,1564,1161,19,124,10,9
51905,65253,44295,65253,66,66,0,1,5,1,0
60911,53,23878,53,335,78,257,2,29,1,1
57340,53,2776,53,216,110,106,2,30,1,1
55526,53,26801,53,749,94,655,2,30,1,1
49342,53,37970,53,200,102,98,2,30,1,1
53972,59089,65256,59089,70,70,0,2,7,2,0
57121,53,54174,53,257,110,147,2,30,1,1
55726,27015,8012,27015,628,462,166,4,31,2,2
56617,53,38232,53,228,110,118,2,30,1,1
57306,443,21388,443,8699,3391,5308,40,15,24,16
64022,53,64185,53,197,102,95,2,30,1,1
40204,40021,21562,40021,148,86,62,2,31,1,1
9417,443,16764,443,324745,7830,316915,327,31,112,215
65025,443,1842,443,2227,1018,1209,17,16,8,9
47120,443,47120,443,4380,1473,2907,19,29,11,8
55179,53,18189,53,183,94,89,2,30,1,1
53449,443,9843,443,12474,4810,7664,39,66,19,20
49905,53,43598,53,176,90,86,2,31,1,1
60439,53,58321,53,70,70,0,1,30,1,0
56297,53,38652,53,228,75,153,4,31,2,2
56524,443,12291,443,5212,1037,4175,20,115,10,10
37110,53,37110,53,247,98,149,2,33,1,1
50305,53,38735,53,209,110,99,2,30,1,1
49479,80,63239,80,9192,4788,4404,30,126,17,13
64573,53,37433,53,757,102,655,2,30,1,1
64997,53,31899,53,166,86,80,2,30,1,1
49334,53,44213,53,194,102,92,2,31,1,1
54942,80,32519,80,5696,703,4993,14,75,8,6
60930,443,60930,443,16379,2214,14165,39,18,20,19
64898,53,53869,53,167,86,81,2,29,1,1
59267,53,59267,53,222,87,135,2,31,1,1
64997,53,9569,53,164,84,80,2,31,1,1
50067,53,31624,53,177,94,83,2,30,1,1
49367,53,52320,53,718,94,624,2,30,1,1
62479,443,46621,443,14673,3914,10759,31,27,14,17
54447,53,9967,53,199,94,105,2,29,1,1
56978,53,58165,53,774,101,673,2,30,1,1
56178,443,35008,443,12283477,390003,11893474,13073,164,4327,8746
54664,443,18558,443,8263,1279,6984,15,136,7,8
56770,443,17971,443,7889,1900,5989,20,15,11,9
55000,443,17337,443,134,60,74,3,10,2,1
56633,80,19210,80,234,234,0,4,12,4,0
57215,53,55858,53,810,108,702,2,30,1,1
43784,443,17789,443,10458,1688,8770,30,15,17,13
55221,443,37010,443,12954,2333,10621,20,120,9,11
58364,53,50367,53,167,78,89,2,30,1,1
57333,53,60768,53,167,86,81,2,30,1,1
60744,40010,53059,40010,316,136,180,6,5,3,3
51294,443,42258,443,162,102,60,2,5,1,1
56085,53,59161,53,166,85,81,2,31,1,1
26900,27017,33807,27017,422,164,258,6,30,3,3
9420,443,29951,443,9308,2125,7183,27,34,13,14
56406,443,10804,443,8328,1391,6937,18,123,10,8
35098,443,17186,443,7703,1606,6097,23,80,13,10
50654,123,28946,123,184,94,90,2,30,1,1
56303,53,55286,53,177,94,83,2,30,1,1
41476,53,41476,53,235,90,145,2,33,1,1
50320,53,20919,53,168,78,90,2,30,1,1
49901,53,32175,53,231,102,129,2,30,1,1
52326,443,52326,443,5433,2251,3182,23,86,12,11
49736,443,65019,443,52574,2783,49791,61,129,19,42
54402,53,53139,53,291,86,205,2,30,1,1
55101,53,27553,53,194,99,95,2,30,1,1
49998,53,44432,53,94,94,0,1,30,1,0
36448,53,11652,53,199,94,105,2,30,1,1
56320,53,14969,53,183,94,89,2,30,1,1
64200,53,25588,53,193,102,91,2,30,1,1
64117,80,61513,80,5827,773,5054,16,73,9,7
57993,443,27022,443,8647,1990,6657,23,26,14,9
49862,53,62626,53,744,89,655,2,31,1,1
45316,80,11125,80,3044854,64416,2980438,2968,19,997,1971
37912,443,31339,443,130,70,60,3,5,2,1
42718,443,45721,443,7341,2111,5230,18,135,8,10
55526,53,8264,53,250,86,164,2,30,1,1
65480,53,23239,53,211,102,109,2,30,1,1
9154,443,7257,443,6258,843,5415,19,29,10,9
55052,80,37545,80,11677266,314362,11362904,12711,129,5174,7537
39435,443,17310,443,2403265,93626,2309639,2795,243,1103,1692
50209,1688,16419,1688,70,70,0,1,4,1,0
9042,443,33866,443,15177,5713,9464,37,120,17,20
49432,53,34624,53,812,110,702,2,30,1,1
37752,53,54109,53,220,78,142,2,30,1,1
64582,53,17757,53,209,110,99,2,30,1,1
52431,443,19671,443,7396,3677,3719,16,120,8,8
48817,41768,48817,41768,511,152,359,2,1200,1,1
40182,443,51089,443,6865,1958,4907,21,16,13,8
58478,443,30017,443,19356,2148,17208,34,112,17,17
51538,443,28169,443,6384,1899,4485,16,75,9,7
65189,27015,42181,27015,262,78,184,2,29,1,1
64040,12226,39321,12226,66,66,0,2,7,2,0
50585,80,50585,80,9588,4478,5110,28,21,16,12
61053,443,61053,443,40415,2911,37504,57,18,27,30
50077,53,51701,53,261,97,164,4,44,2,2
51865,14732,14153,14732,70,70,0,1,5,1,0
35047,53,53594,53,70657,70002,655,845,88,839,6
50469,443,45578,443,19063941,342071,18721870,17124,384,4119,13005
55387,53,15050,53,195,94,101,2,29,1,1
57419,53,1217,53,819,102,717,2,30,1,1
50016,53,14072,53,766,103,663,4,41,2,2
64987,53,8755,53,357,107,250,4,36,2,2
55005,53,24549,53,183,94,89,2,30,1,1
56667,80,26674,80,234,234,0,4,12,4,0
37565,443,55641,443,4898,1119,3779,17,30,9,8
54125,443,54125,443,65572,14874,50698,92,84,48,44
58682,443,48693,443,5061,876,4185,16,70,8,8
55132,53,34901,53,889,404,485,10,30,5,5
56743,443,40694,443,7789,2275,5514,30,47,16,14
65238,53,61898,53,302,104,198,4,46,2,2
49602,53,63187,53,178,94,84,2,30,1,1
56365,80,15105,80,1636,699,937,10,15,5,5
55934,53,60885,53,196,102,94,2,30,1,1
50051,53,51528,53,766,102,664,2,30,1,1
56613,53,57106,53,307,134,173,2,30,1,1
9147,443,1443,443,6334,840,5494,19,29,10,9
12136,53,12136,53,198,90,108,2,30,1,1
65350,53,48602,53,168,86,82,2,31,1,1
63691,80,13237,80,314,192,122,6,15,4,2
50389,443,61820,443,306,180,126,6,26,4,2
57007,53,30076,53,182,93,89,2,31,1,1
49418,27017,9977,27017,260,78,182,2,31,1,1
62912,443,19185,443,10829,2227,8602,35,47,20,15
33071,443,36886,443,4234,2185,2049,36,1099,16,20
49550,443,28578,443,2338,1407,931,18,200,10,8
39101,443,49967,443,201217,15748,185469,327,207,163,164
49746,53,8872,53,290,102,188,2,30,1,1
57309,53,4070,53,197,102,95,2,30,1,1
60031,443,5116,443,350,210,140,6,15,4,2
27005,27015,24637,27015,1630,126,1504,4,31,2,2
54165,443,54165,443,147750,13521,134229,182,92,84,98
56589,53,29325,53,198,101,97,2,31,1,1
56497,80,9145,80,410119,16112,394007,424,63,155,269
37335,443,14228,443,130,70,60,3,5,2,1
52108,443,27930,443,18735,3452,15283,42,52,22,20
64312,53,39914,53,209,110,99,2,30,1,1
56835,27582,44303,27582,130,70,60,2,5,1,1
49604,53,12616,53,179,94,85,2,30,1,1
55003,53,61767,53,196,102,94,2,30,1,1
65327,53,49765,53,822,102,720,2,29,1,1
64271,53,22789,53,198,94,104,2,30,1,1
53777,62955,35330,62955,70,70,0,2,7,2,0
49574,53,41987,53,193,102,91,2,29,1,1
49382,53,23594,53,200,102,98,2,30,1,1
50151,53,17420,53,152,78,74,2,30,1,1
52401,443,47720,443,12402,3972,8430,46,138,26,20
33462,53,33462,53,256,114,142,2,30,1,1
40204,40014,35119,40014,141,79,62,2,31,1,1
56079,53,40631,53,199,102,97,2,29,1,1
36617,443,29137,443,16276,14463,1813,33,95,20,13
49637,53,40941,53,255,102,153,2,30,1,1
50580,443,63411,443,2604,1413,1191,15,98,9,6
50582,443,54824,443,7453,1467,5986,19,25,10,9
56838,53,49360,53,170,87,83,2,30,1,1
55039,443,11955,443,62,62,0,1,4,1,0
8986,443,12105,443,8062,2804,5258,43,161,20,23
49995,53,53855,53,303,98,205,4,40,2,2
41910,443,63630,443,9358,2304,7054,39,120,20,19
53268,443,58840,443,4241,706,3535,14,25,8,6
56532,53,25649,53,193,102,91,2,30,1,1
51573,53,28199,53,212,86,126,2,30,1,1
49191,53,32868,53,186,95,91,2,31,1,1
64431,53,52524,53,170,87,83,2,31,1,1
41050,443,28705,443,137809,4697,133112,153,170,55,98
49372,53,4796,53,527,208,319,6,64,3,3
60464,11385,6156,11385,1090,712,378,16,26,10,6
52775,80,57119,80,432,240,192,8,101,5,3
56860,53,58794,53,168,86,82,2,30,1,1
55230,53,36374,53,182,93,89,2,30,1,1
57470,39541,8082,39541,792,792,0,13,1200,13,0
53018,443,30354,443,48877,5205,43672,95,93,32,63
50426,53,48591,53,889,404,485,10,30,5,5
64586,53,9543,53,183,94,89,2,30,1,1
63590,443,25710,443,6187,933,5254,18,147,10,8
50573,443,27732,443,7282,953,6329,18,16,10,8
55269,53,18249,53,102,102,0,1,30,1,0
55097,53,54198,53,177,94,83,2,29,1,1
6881,6881,55325,6881,853,355,498,4,1200,2,2
51809,443,10522,443,82930,18836,64094,131,128,55,76
49406,80,24541,80,32206,1049,31157,37,89,11,26
49267,53,65415,53,184,94,90,2,30,1,1
62892,443,62892,443,4377,1470,2907,19,30,11,8
36838,443,43654,443,9381,1457,7924,21,31,11,10
51999,80,34655,80,20433,10970,9463,34,42,19,15
49418,27015,58093,27015,78,78,0,1,30,1,0
50571,80,64124,80,300,174,126,5,15,3,2
49767,53,37135,53,170,87,83,2,30,1,1
53238,80,59852,80,1726,940,786,8,55,5,3
56977,80,20065,80,214,140,74,4,35,3,1
56434,80,3931,80,17128,1499,15629,24,25,9,15
1380,53,1380,53,235,90,145,2,32,1,1
60580,53,24695,53,229,94,135,2,30,1,1
49942,53,42847,53,264,94,170,2,31,1,1
49226,443,24983,443,532687,14365,518322,560,20,211,349
50823,443,50823,443,1210,637,573,14,25,7,7
55467,53,65023,53,198,94,104,2,30,1,1
55071,53,30463,53,356,118,238,2,29,1,1
58045,443,63795,443,3296,1329,1967,14,135,7,7
54489,443,33538,443,4263,2019,2244,14,136,7,7
55626,63805,65310,63805,70,70,0,2,8,2,0
51610,443,19441,443,6952,3608,3344,27,21,14,13
39094,443,9909,443,350650,19028,331622,494,83,251,243
61501,443,38275,443,633920,7867,626053,505,41,81,424
55478,53,55747,53,177,94,83,2,30,1,1
49454,80,13717,80,3920,2138,1782,23,135,12,11
49828,443,20161,443,5927,1644,4283,18,16,10,8
56183,53,46991,53,174,89,85,2,31,1,1
65522,53,17756,53,1281,94,1187,2,30,1,1
27005,23010,48268,23010,881,126,755,2,30,1,1
64083,63666,39336,63666,70,70,0,1,4,1,0
54563,443,54563,443,109880,24958,84922,154,20,83,71
38114,443,10061,443,863998,37140,826858,1072,61,479,593
65445,53,54616,53,199,102,97,2,30,1,1
52049,80,61901,80,34695,17472,17223,55,33,28,27
65027,53,8113,53,758,96,662,2,30,1,1
57244,53,57244,53,240,98,142,2,30,1,1
55604,44235,60786,44235,504,318,186,8,15,5,3
56144,53,58343,53,176,90,86,2,31,1,1
57244,443,45761,443,230914,10401,220513,290,76,121,169
52124,80,5847,80,366,240,126,7,26,5,2
57150,53,63337,53,286,97,189,4,47,2,2
57336,443,14468,443,6956,2856,4100,28,16,16,12
56827,53,30639,53,195,102,93,2,29,1,1
39920,443,36288,443,4552,1255,3297,27,183,12,15
56639,53,13077,53,168,86,82,2,31,1,1
53260,443,37700,443,572,292,280,9,33,5,4
53077,443,54152,443,6173,924,5249,18,177,10,8
47892,443,19816,443,6454,1447,5007,22,17,11,11
56085,53,41627,53,167,86,81,2,30,1,1
55222,53,19882,53,178,91,87,2,30,1,1
55627,53,20054,53,174,89,85,2,31,1,1
64354,53,25529,53,240,78,162,2,30,1,1
64911,53,65363,53,232,86,146,2,30,1,1
49900,443,28761,443,1820,1101,719,18,73,10,8
54595,443,41142,443,5692,2502,3190,24,131,12,12
52993,443,38783,443,10754,4129,6625,42,112,20,22
58278,443,36015,443,3581,1045,2536,10,122,5,5
49228,443,26216,443,13758,6577,7181,66,918,34,32
51274,24399,41980,24399,70,70,0,1,5,1,0
41730,443,24945,443,760,422,338,12,28,7,5
47053,80,59078,80,1188,463,725,8,15,5,3
52272,80,52272,80,237488,7574,229914,231,27,71,160
62627,7000,62627,7000,2990,1599,1391,15,15,8,7
63962,53,53078,53,188,96,92,2,31,1,1
55897,53,23504,53,770,102,668,2,30,1,1
35608,443,36107,443,8530,2685,5845,25,100,15,10
48068,443,12098,443,10418,1427,8991,27,16,12,15
60776,4156,9252,4156,70,70,0,2,8,2,0
56128,53,30035,53,744,89,655,2,31,1,1
49842,443,41562,443,5309,1043,4266,22,72,11,11
65340,53,54833,53,313,110,203,4,33,2,2
9405,443,45039,443,5691,503,5188,14,15,7,7
55199,53,53506,53,214,110,104,2,31,1,1
59613,443,9064,443,10366,4530,5836,21,135,10,11
49855,53,48096,53,177,94,83,2,30,1,1
60572,80,35245,80,556,280,276,9,28,5,4
60450,56494,22389,56494,70,70,0,1,5,1,0
58721,443,55162,443,7973,4166,3807,28,141,14,14
32486,443,32486,443,5497,2520,2977,20,16,11,9
64000,53,61132,53,214,102,112,2,30,1,1
50634,53,32177,53,218,86,132,2,30,1,1
63905,19899,5860,19899,312,132,180,6,7,3,3
52226,48784,24421,48784,70,70,0,2,8,2,0
57315,443,45136,443,77504,4494,73010,112,200,54,58
60380,55125,31447,55125,70,70,0,1,5,1,0
50354,53,24829,53,209,110,99,2,30,1,1
57556,443,34647,443,7087,2587,4500,21,30,12,9
51939,80,10449,80,103732,4081,99651,128,61,55,73
56912,53,43272,53,216,94,122,2,30,1,1
58774,443,50443,443,7254,838,6416,27,290,9,18
49922,80,11141,80,1126,609,517,11,15,6,5
65282,53,16283,53,193,102,91,2,30,1,1
56977,53,42818,53,273,102,171,2,30,1,1
58725,443,21181,443,26960,13206,13754,53,17,28,25
49707,53,6726,53,733,85,648,2,31,1,1
64126,53,37940,53,216,102,114,2,30,1,1
37918,443,47034,443,6521,2079,4442,32,3827,19,13
64224,53,56405,53,280,94,186,2,30,1,1
51348,7000,51348,7000,2163,676,1487,14,15,7,7
54081,443,47129,443,444890,27602,417288,580,176,265,315
49364,53,40148,53,182,94,88,2,30,1,1
57304,443,45886,443,134,60,74,3,5,2,1
63672,443,63672,443,4398,1491,2907,19,27,11,8
49901,53,59612,53,193,102,91,2,31,1,1
57073,443,48824,443,7731,2016,5715,38,271,20,18
49312,443,38998,443,3171,2293,878,17,40,10,7
50371,443,40015,443,456,390,66,4,0,3,1
49849,53,11014,53,196,102,94,2,30,1,1
56981,80,19891,80,214,140,74,4,35,3,1
46719,443,39379,443,7261,3272,3989,22,45,13,9
57052,53,31599,53,711,87,624,2,31,1,1
62776,443,62776,443,4398,1491,2907,19,26,11,8
35311,80,30298,80,947,376,571,8,14,5,3
53108,80,57072,80,1797,1070,727,10,15,5,5
35085,443,56294,443,1617,1062,555,13,45,8,5
50182,443,50182,443,12509,1447,11062,28,122,16,12
10003,443,7102,443,7617,4161,3456,34,332,15,19
55027,443,27203,443,17167,5192,11975,32,121,17,15
61938,443,14944,443,7118,2462,4656,18,75,10,8
64614,53,55255,53,168,86,82,2,30,1,1
58140,53,58140,53,262,106,156,2,34,1,1
54233,443,10183,443,499,425,74,4,0,3,1
53126,47035,16520,47035,70,70,0,2,8,2,0
55857,53,19177,53,437,98,339,4,41,2,2
49815,443,13935,443,8614049,176366,8437683,7757,202,1608,6149
53614,443,48622,443,6352,1552,4800,23,17,12,11
55224,53,26209,53,711,87,624,2,31,1,1
43744,53,43744,53,235,90,145,2,32,1,1
50276,5223,4771,5223,552,280,272,9,16,5,4
42225,443,6040,443,8962,1601,7361,26,186,14,12
5394,23,5394,23,124,60,64,2,5,1,1
51964,80,61928,80,306,120,186,6,25,3,3
55470,53,12953,53,197,102,95,2,33,1,1
62460,443,33310,443,4608,3133,1475,18,35,10,8
51700,7000,51700,7000,2163,676,1487,14,15,7,7
56452,53,0,0,82,82,0,2,40,2,0
64815,53,51366,53,214,110,104,2,30,1,1
54224,443,19866,443,499,425,74,4,0,3,1
26900,27017,56455,27017,926,410,516,12,31,6,6
56710,443,25252,443,8057,2037,6020,20,15,11,9
52471,443,40608,443,41966,23593,18373,89,154,42,47
49272,53,25138,53,168,86,82,3,44,2,1
56004,53,27325,53,177,94,83,2,29,1,1
50631,443,5471,443,4158,1021,3137,15,26,8,7
65159,53,58481,53,500,204,296,6,75,3,3
8024,80,8024,80,572,240,332,10,83,5,5
51897,57057,43684,57057,70,70,0,1,5,1,0
49790,53,51287,53,195,102,93,2,30,1,1
37075,80,46978,80,1678,1364,314,10,15,5,5
45552,80,5282,80,890,420,470,14,27,7,7
44395,443,50721,443,18921,10848,8073,49,401,20,29
49718,53,42238,53,807,94,713,2,30,1,1
49410,53,35309,53,167,86,81,2,31,1,1
63229,443,6765,443,1373,734,639,17,134,10,7
60454,18359,20909,18359,1842,1017,825,19,16,9,10
55620,53,48166,53,177,94,83,2,30,1,1
49467,53,63815,53,811,94,717,2,30,1,1
56388,53,20771,53,816,102,714,2,30,1,1
65331,53,20706,53,767,102,665,2,29,1,1
54994,443,29516,443,13580,3864,9716,40,18,23,17
49277,53,20518,53,199,102,97,2,30,1,1
53664,13701,26986,13701,70,70,0,1,4,1,0
54291,443,41478,443,8056,3762,4294,55,517,28,27
53197,80,29002,80,748,459,289,8,254,5,3
49556,53,1572,53,300,100,200,4,43,2,2
53831,80,61237,80,5774,1483,4291,14,162,8,6
49297,53,48060,53,183,94,89,2,30,1,1
53861,443,51732,443,499,425,74,4,1,3,1
64051,19548,23106,19548,66,66,0,1,5,1,0
57910,443,61063,443,1853,1214,639,18,156,11,7
63047,443,26730,443,304,86,218,2,30,1,1
51931,19416,18686,19416,70,70,0,1,5,1,0
51994,80,37899,80,366,240,126,7,26,5,2
57132,53,28118,53,216,110,106,2,31,1,1
55866,443,45291,443,53845,7300,46545,80,31,38,42
56308,53,17371,53,814,110,704,2,30,1,1
64557,53,9245,53,766,102,664,2,30,1,1
54463,53,52007,53,164,78,86,2,30,1,1
49788,53,45773,53,198,102,96,2,33,1,1
57122,53,16456,53,199,102,97,2,29,1,1
51659,80,25484,80,318,192,126,6,37,4,2
50047,443,50047,443,4534,1627,2907,19,27,11,8
46056,443,52673,443,80200,69062,11138,193,89,100,93
56829,33418,63291,33418,316,136,180,6,5,3,3
56126,53,43934,53,183,94,89,2,30,1,1
52054,80,49202,80,1682,642,1040,13,54,4,9
56112,53,63692,53,199,102,97,2,29,1,1
34294,53,17102,53,168,78,90,2,30,1,1
42298,40014,14476,40014,148,86,62,2,31,1,1
56786,443,56786,443,4381,1474,2907,19,27,11,8
48817,8999,48817,8999,512,158,354,2,1200,1,1
48165,53,17622,53,199,94,105,2,30,1,1
48437,443,48848,443,934,420,514,15,30,7,8
49174,53,10014,53,323,107,216,4,47,2,2
54161,443,65319,443,3157,1827,1330,23,15,11,12
56806,443,47180,443,403093,31796,371297,497,151,185,312
55684,80,6722,80,70,70,0,2,8,2,0
56220,53,22417,53,772,103,669,2,31,1,1
38676,443,10906,443,5306,1619,3687,20,29,12,8
53757,1,5970,1,70,70,0,1,5,1,0
49696,53,15575,53,200,94,106,2,30,1,1
56185,53,24061,53,168,86,82,2,31,1,1
55232,53,34536,53,177,94,83,2,29,1,1
64991,53,47067,53,625,192,433,6,46,3,3
55050,80,49586,80,246,120,126,5,15,3,2
37427,443,48428,443,10281,4850,5431,23,400,13,10
55995,443,59419,443,7563,2253,5310,20,157,11,9
56308,53,53406,53,700,282,418,8,81,4,4
50378,443,15906,443,8663,1983,6680,21,33,10,11
49181,53,18919,53,184,102,82,2,30,1,1
51770,37237,29637,37237,316,136,180,6,6,3,3
64631,53,29007,53,193,102,91,2,29,1,1
55268,53,12955,53,193,102,91,2,29,1,1
26900,27017,34490,27017,422,164,258,6,30,3,3
27005,27018,42119,27018,881,126,755,2,30,1,1
49967,53,41633,53,186,95,91,2,31,1,1
64639,53,5053,53,198,101,97,2,31,1,1
55735,53,16181,53,199,102,97,2,30,1,1
64971,53,0,0,229,85,144,2,31,1,1
50906,443,11737,443,124,64,60,2,15,1,1
55668,80,57634,80,70,70,0,1,5,1,0
51576,443,48626,443,21523,4681,16842,37,149,18,19
63793,48970,37013,48970,70,70,0,1,4,1,0
59885,443,10109,443,1401,864,537,12,28,6,6
52261,53,8647,53,578,286,292,9,15,5,4
51745,2572,3211,2572,66,66,0,1,5,1,0
40183,443,34811,443,6065,2277,3788,17,135,8,9
51859,35365,59521,35365,70,70,0,1,5,1,0
57436,66,13833,66,70,70,0,2,7,2,0
49556,80,42311,80,7002,5717,1285,15,45,9,6
56612,53,28216,53,178,94,84,2,30,1,1
46415,443,41654,443,9307,2265,7042,31,325,13,18
60241,443,21837,443,4512,1810,2702,16,135,7,9
60193,53,20927,53,214,85,129,2,0,1,1
47650,443,28162,443,1056,569,487,10,24,6,4
65411,53,12985,53,194,94,100,2,30,1,1
50625,443,48490,443,3090,1707,1383,15,19,9,6
55177,80,55177,80,374,240,134,7,15,5,2
49744,53,14742,53,816,102,714,2,30,1,1
54427,53,16738,53,199,94,105,2,30,1,1
36951,443,31916,443,70,70,0,1,5,1,0
41085,443,36619,443,5553,1055,4498,19,121,9,10
34883,443,14501,443,51393,3538,47855,70,30,29,41
55645,443,7018,443,9213,3751,5462,17,121,8,9
51753,15038,3918,15038,70,70,0,2,7,2,0
63955,53,0,0,219,81,138,2,30,1,1
50202,53,17431,53,166,86,80,2,30,1,1
49708,53,19029,53,186,95,91,2,31,1,1
49962,53,28111,53,184,94,90,2,30,1,1
61413,80,4426,80,283970,23419,260551,574,158,255,319
52245,443,44464,443,7488,2474,5014,23,3600,12,11
58062,443,59135,443,2257,1225,1032,15,18,8,7
60511,443,60511,443,4658,1751,2907,19,30,11,8
55229,53,55587,53,199,94,105,2,30,1,1
38698,443,26967,443,628,250,378,11,39,5,6
46892,443,33257,443,12488,5447,7041,28,16,16,12
55109,53,12323,53,711,87,624,2,30,1,1
53757,1,21144,1,70,70,0,2,8,2,0
57288,53,46993,53,177,94,83,2,30,1,1
34600,80,41483,80,3089,775,2314,15,16,9,6
58368,53,61007,53,167,78,89,2,30,1,1
32299,40014,29367,40014,280,182,98,2,30,1,1
50337,80,47050,80,1083,653,430,8,16,5,3
0,0,0,0,480,244,236,4,0,2,2
58152,443,52749,443,5584,1168,4416,19,17,11,8
55211,53,19820,53,760,97,663,2,30,1,1
50578,80,50578,80,35580,13335,22245,69,23,38,31
37965,61085,23932,61085,132,132,0,3,1199,3,0
50722,80,21337,80,3235,555,2680,13,20,6,7
57470,44172,25895,44172,353,166,187,2,1199,1,1
59685,443,5373,443,2316,1353,963,17,276,9,8
39983,80,29072,80,1614,1300,314,10,16,5,5
56050,53,26569,53,178,94,84,2,30,1,1
51221,57522,58823,57522,481,150,331,2,1200,1,1
50265,59362,35253,59362,4228,2471,1757,55,2758,31,24
60286,80,21753,80,5836,2829,3007,19,164,14,5
58039,161,0,0,11672,5710,5962,60,29,30,30
53246,5222,38090,5222,10577,3496,7081,68,616,36,32
55365,53,10129,53,184,94,90,2,29,1,1
50622,53,42098,53,202,83,119,2,30,1,1
56542,53,32612,53,183,94,89,2,31,1,1
55225,53,24302,53,199,102,97,2,30,1,1
64649,53,33149,53,225,102,123,2,30,1,1
50630,53,64139,53,209,110,99,2,30,1,1
41284,443,45151,443,7252,2147,5105,18,136,8,10
56738,53,36120,53,264,87,177,4,37,2,2
57470,25089,59334,25089,132,132,0,3,1199,3,0
52159,80,40700,80,1278,731,547,10,15,6,4
57470,48096,60784,48096,132,132,0,3,1200,3,0
50403,53,23748,53,168,86,82,2,31,1,1
63934,55027,48051,55027,66,66,0,2,8,2,0
65477,53,61765,53,183,94,89,2,30,1,1
62333,443,30059,443,3170,1556,1614,7,121,3,4
42298,51408,45869,51408,725,325,400,12,31,6,6
49542,443,62121,443,40423,35897,4526,52,16,33,19
42971,3478,49754,3478,312,140,172,4,29,2,2
44889,443,7395,443,9982,2062,7920,37,120,19,18
39416,443,22181,443,621104,12188,608916,575,78,149,426
64493,53,24989,53,280,97,183,4,59,2,2
30960,45673,1133,45673,462,462,0,8,3633,8,0
53206,80,36804,80,2622,1074,1548,14,282,8,6
26177,53,26177,53,220,90,130,2,30,1,1
2844,3389,2844,3389,4635,2460,2175,21,18,12,9
60441,64337,24616,64337,70,70,0,1,5,1,0
54774,443,8128,443,9501,1502,7999,24,29,13,11
59271,443,60275,443,26414,4349,22065,41,149,17,24
65357,53,31464,53,256,93,163,2,30,1,1
55687,53,12551,53,193,102,91,2,29,1,1
53444,443,53444,443,960,539,421,9,30,5,4
64825,53,38972,53,184,94,90,2,30,1,1
43225,443,17321,443,3831584,85342,3746242,3246,110,597,2649
63906,36909,1381,36909,70,70,0,1,4,1,0
51977,80,44699,80,4305,699,3606,13,46,7,6
40877,443,50860,443,6451,1003,5448,21,360,11,10
2267,53,11454,53,204,118,86,2,31,1,1
49632,443,35637,443,5598,1185,4413,24,80,13,11
50584,1191,3170,1191,161,161,0,2,1200,2,0
53652,57503,44187,57503,492,306,186,8,15,5,3
45354,443,16907,443,81504,6111,75393,108,20,53,55
8886,80,28945,80,1748,716,1032,19,395,6,13
64560,53,40808,53,578,179,399,6,56,3,3
58867,443,37875,443,16230,11127,5103,69,330,34,35
49658,53,43401,53,211,102,109,2,30,1,1
54498,443,44231,443,8060,2001,6059,24,19,14,10
34767,443,6327,443,6313,1368,4945,21,846,11,10
49183,53,38350,53,177,94,83,2,30,1,1
7318,443,16542,443,6458,2658,3800,34,255,16,18
64473,53,45182,53,184,94,90,2,31,1,1
63734,28221,28610,28221,70,70,0,1,4,1,0
64143,53,3615,53,179,94,85,2,30,1,1
13375,53,13375,53,213,82,131,2,30,1,1
55773,53,61209,53,199,102,97,2,30,1,1
56717,53,51715,53,172,88,84,2,31,1,1
58638,5900,58638,5900,62,62,0,1,5,1,0
49744,53,4877,53,211,102,109,2,30,1,1
45768,80,41776,80,2784,1804,980,17,20,9,8
27005,27015,37450,27015,879,126,753,2,31,1,1
49235,53,22418,53,172,94,78,2,30,1,1
50110,53,63137,53,178,94,84,2,30,1,1
49764,53,54622,53,199,102,97,2,30,1,1
64676,53,19072,53,276,94,182,2,30,1,1
49347,443,51852,443,611644,29314,582330,793,132,333,460
63818,19291,56455,19291,66,66,0,2,7,2,0
27005,33059,58962,33059,900,126,774,3,30,2,1
56115,53,55783,53,278,96,182,4,54,2,2
49672,53,36267,53,761,100,661,2,30,1,1
61831,443,61831,443,530764,27638,503126,528,175,179,349
51509,443,60240,443,1307,688,619,14,37,8,6
64876,53,13922,53,718,94,624,2,31,1,1
56952,53,60759,53,193,102,91,2,30,1,1
51891,80,21420,80,7434,3830,3604,17,30,9,8
56661,53,3079,53,297,102,195,4,34,2,2
46295,443,39789,443,178,118,60,2,15,1,1
56759,53,10512,53,177,94,83,2,30,1,1
49234,53,38404,53,170,87,83,2,30,1,1
50707,53,59770,53,181,86,95,2,30,1,1
56907,53,52225,53,193,102,91,2,30,1,1
65510,443,47071,443,92101,4799,87302,107,16,43,64
65090,53,63161,53,230,102,128,2,31,1,1
29011,7000,29011,7000,3756,2125,1631,18,17,10,8
50698,5900,50698,5900,130,66,64,2,5,1,1
49718,53,39555,53,793,101,692,2,30,1,1
63318,443,32091,443,8451,2698,5753,21,129,9,12
37027,53,20580,53,168,78,90,2,30,1,1
53119,53,39459,53,326,102,224,2,29,1,1
49282,53,64879,53,178,94,84,2,30,1,1
8915,443,26790,443,7182,1016,6166,28,412,11,17
49935,53,10954,53,75,75,0,1,30,1,0
64125,53,22287,53,199,102,97,2,31,1,1
57226,53,25603,53,178,94,84,2,30,1,1
62937,80,62937,80,1918,1469,449,10,20,6,4
52025,42442,45647,42442,70,70,0,1,4,1,0
53000,80,5659,80,1991,686,1305,10,335,6,4
49342,53,56835,53,200,102,98,2,30,1,1
61478,443,38710,443,45313,3360,41953,61,47,26,35
56433,53,26629,53,177,94,83,2,30,1,1
56692,443,32743,443,3932,2581,1351,18,18,10,8
52244,58774,2211,58774,70,70,0,1,5,1,0
50488,80,56611,80,318,192,126,6,25,4,2
64414,53,6612,53,186,95,91,2,30,1,1
64127,53,29234,53,170,87,83,2,31,1,1
37469,53,51680,53,168,78,90,2,30,1,1
51985,38904,27850,38904,70,70,0,2,8,2,0
53024,123,1742,123,184,94,90,2,30,1,1
52784,443,47288,443,2802,1626,1176,18,72,9,9
65469,443,41637,443,92958,4869,88089,109,15,44,65
50576,443,29225,443,7282,953,6329,18,16,10,8
27005,32030,25176,32030,1796,252,1544,5,31,3,2
62049,443,56388,443,7856,2410,5446,30,17,16,14
50265,14107,11611,14107,132,132,0,3,1200,3,0
60813,443,34578,443,658,140,518,10,3632,3,7
123,123,15561,123,184,94,90,2,30,1,1
49418,27001,19678,27001,274,78,196,2,31,1,1
48817,6881,48817,6881,506,152,354,2,1200,1,1
38568,53,38568,53,247,98,149,2,33,1,1
49619,53,1376,53,184,86,98,2,30,1,1
38258,443,9287,443,5714,1536,4178,24,21,13,11
52071,443,56996,443,8232,3997,4235,21,16,11,10
55651,53,8251,53,199,102,97,2,29,1,1
40709,443,57804,443,256802,11839,244963,329,173,136,193
52085,29894,54507,29894,136,136,0,3,14,3,0
48347,443,29830,443,8415,883,7532,23,54,8,15
47042,443,19544,443,2809,1884,925,19,25,11,8
57115,53,57243,53,178,94,84,2,29,1,1
55563,53,57917,53,763,101,662,2,30,1,1
51656,80,3808,80,318,192,126,6,37,4,2
55830,53,49103,53,184,94,90,2,29,1,1
56755,53,8890,53,663,212,451,6,63,3,3
64306,53,29347,53,216,110,106,2,31,1,1
56724,53,41138,53,195,102,93,2,29,1,1
57189,53,57433,53,174,89,85,2,30,1,1
52125,80,43801,80,2178,1003,1175,10,15,6,4
62230,443,57839,443,3709,1176,2533,14,135,7,7
51167,80,51167,80,1502,817,685,10,20,6,4
54226,443,4295,443,499,425,74,4,0,3,1
56425,80,34044,80,17188,1559,15629,25,31,10,15
53696,50321,3484,50321,70,70,0,1,4,1,0
30960,45708,10232,45708,330,330,0,6,3609,6,0
61569,53,2254,53,211,78,133,2,30,1,1
53136,41442,55511,41442,70,70,0,1,5,1,0
56609,80,38761,80,234,234,0,4,12,4,0
48817,51634,48817,51634,480,149,331,2,1200,1,1
56739,443,41966,443,7914,1925,5989,20,15,11,9
56659,53,59706,53,711,87,624,2,30,1,1
55230,53,6138,53,183,94,89,2,30,1,1
63964,53,52901,53,196,94,102,2,30,1,1
42358,80,63133,80,1081,641,440,9,14,4,5
42089,53,62601,53,199,94,105,2,29,1,1
49526,53,12720,53,272,97,175,4,58,2,2
55836,443,59611,443,7519,2177,5342,16,136,8,8
49486,53,9984,53,177,94,83,2,30,1,1
53248,443,60652,443,532222,22112,510110,645,232,259,386
49385,443,34796,443,44437,2600,41837,62,16,28,34
47905,443,5382,443,172,172,0,2,5,2,0
50012,53,27557,53,212,110,102,2,30,1,1
64567,53,24261,53,199,102,97,2,30,1,1
55427,53,54288,53,200,102,98,2,30,1,1
52158,80,31502,80,502,310,192,9,31,6,3
51844,80,51844,80,72734,3432,69302,83,25,31,52
26900,27017,64029,27017,422,164,258,6,30,3,3
65317,80,47905,80,1014,507,507,8,133,5,3
55695,28182,59050,28182,504,318,186,8,16,5,3
56577,53,47746,53,198,110,88,2,30,1,1
52492,443,60482,443,33131,9092,24039,41,15,19,22
3424,53,3424,53,216,88,128,2,30,1,1
56810,53,54787,53,170,87,83,2,31,1,1
58914,443,39439,443,5168,700,4468,16,16,7,9
42749,443,12087,443,6172,1310,4862,28,468,10,18
50516,80,41134,80,502,256,246,9,25,5,4
51156,53,46247,53,168,78,90,2,29,1,1
46974,443,29237,443,5861,1151,4710,18,34,10,8
42485,443,17248,443,130,70,60,3,5,2,1
34366,443,52089,443,520306,17622,502684,582,210,210,372
56304,53,62384,53,443,182,261,6,31,3,3
55490,80,37170,80,186387,10616,175771,243,33,116,127
58819,1433,58819,1433,124,60,64,2,5,1,1
63898,13205,16525,13205,66,66,0,2,7,2,0
50267,80,27570,80,12364,548,11816,17,46,6,11
50198,3389,50198,3389,3343,1454,1889,15,16,8,7
49569,53,55862,53,181,94,87,2,31,1,1
56719,53,51859,53,185,102,83,2,30,1,1
60777,443,22998,443,10417,2617,7800,32,15,17,15
51957,56737,56106,56737,316,136,180,6,6,3,3
55155,53,52768,53,194,102,92,2,31,1,1
55308,443,11904,443,14364,4095,10269,33,404,13,20
51221,52423,24107,52423,322,149,173,2,1201,1,1
61879,53,34841,53,207,86,121,2,29,1,1
59779,443,2318,443,5834,1810,4024,24,17,13,11
56950,443,1900,443,4391,2171,2220,14,135,7,7
55004,443,35617,443,27629,9041,18588,88,271,46,42
56327,53,30596,53,199,102,97,2,30,1,1
57228,53,13792,53,199,102,97,2,30,1,1
55021,53,4080,53,174,89,85,2,31,1,1
65436,53,10665,53,102,102,0,1,30,1,0
51819,59208,18687,59208,66,66,0,2,8,2,0
50969,443,54163,443,469,403,66,4,0,3,1
59779,443,65358,443,18360,1734,16626,32,28,13,19
55553,53,10197,53,711,87,624,2,30,1,1
53162,443,22912,443,23929,10333,13596,51,43,25,26
36357,443,35351,443,14614,1935,12679,36,16,20,16
2267,53,1251,53,204,118,86,2,31,1,1
53608,1024,52758,1024,70,70,0,2,8,2,0
37385,443,16177,443,8824,2041,6783,34,255,17,17
64707,53,25293,53,216,102,114,2,30,1,1
55230,53,3013,53,183,94,89,2,30,1,1
65363,53,10206,53,181,94,87,2,30,1,1
61862,80,50297,80,9747,537,9210,14,16,6,8
51275,10924,61359,10924,70,70,0,2,8,2,0
63961,53,35480,53,184,86,98,2,30,1,1
31123,53,31123,53,231,88,143,2,34,1,1
54460,443,28221,443,7372,1764,5608,27,547,15,12
64132,53,11636,53,179,94,85,2,30,1,1
65376,53,45808,53,184,94,90,2,31,1,1
45551,443,60203,443,6964,2091,4873,20,15,10,10
53587,3389,53587,3389,3504,1790,1714,17,31,9,8
38671,443,56566,443,90139,3545,86594,96,15,32,64
49742,53,64876,53,223,102,121,2,30,1,1
49750,80,55648,80,1788,628,1160,11,15,6,5
65055,53,62687,53,225,86,139,2,30,1,1
65140,53,62512,53,199,102,97,2,31,1,1
52012,80,40658,80,366,240,126,7,25,5,2
49303,443,12405,443,10844,5117,5727,42,17,25,17
50629,80,39121,80,1658,1247,411,8,15,5,3
29606,53,29606,53,216,90,126,2,30,1,1
60453,24369,51749,24369,70,70,0,2,8,2,0
56415,53,9528,53,199,102,97,2,30,1,1
46985,993,3733,993,9725,3931,5794,46,48,25,21
39197,443,22296,443,65158,3519,61639,89,200,41,48
54692,443,45906,443,5907,2630,3277,21,147,10,11
57231,53,2071,53,168,86,82,2,31,1,1
64216,53,45002,53,295,93,202,4,30,2,2
65261,53,34538,53,168,86,82,2,30,1,1
49181,53,15171,53,491,98,393,4,40,2,2
27005,27015,5725,27015,876,126,750,2,30,1,1
53118,56839,2314,56839,70,70,0,1,4,1,0
7197,80,7197,80,450,246,204,8,31,5,3
50018,80,3941,80,825,685,140,6,33,4,2
65424,53,39053,53,210,110,100,2,31,1,1
27005,27017,13207,27017,890,126,764,2,30,1,1
63907,54218,37939,54218,696,452,244,11,21,7,4
27005,27015,23860,27015,871,126,745,2,31,1,1
56972,53,24503,53,177,94,83,2,30,1,1
53527,45626,48951,45626,70,70,0,2,7,2,0
27005,27016,17329,27016,883,126,757,2,30,1,1
49418,27015,42779,27015,227,71,156,2,30,1,1
9487,443,35248,443,5179,2934,2245,25,32,13,12
60849,443,12589,443,3364,1737,1627,15,360,8,7
55193,53,55120,53,200,102,98,2,33,1,1
37836,443,46026,443,4647,1536,3111,25,40,12,13
41923,53,17859,53,168,78,90,2,30,1,1
56263,53,57632,53,214,110,104,2,31,1,1
65133,53,34896,53,198,102,96,2,30,1,1
56120,53,62724,53,168,78,90,2,30,1,1
55018,443,29845,443,7232,2925,4307,27,16,16,11
60341,443,14614,443,54103,3190,50913,68,362,27,41
49331,443,35944,443,78663,4968,73695,85,47,24,61
51956,36995,25588,36995,70,70,0,2,8,2,0
56163,53,47516,53,265,85,180,4,41,2,2
56929,53,5055,53,170,87,83,2,30,1,1
57547,80,39933,80,32368,2187,30181,45,337,23,22
41410,80,40896,80,1484,877,607,11,34,6,5
64854,53,42024,53,172,88,84,2,30,1,1
49983,53,17295,53,211,110,101,2,31,1,1
49174,53,59747,53,199,102,97,2,33,1,1
64964,53,38711,53,197,102,95,2,30,1,1
27005,27018,61508,27018,252,252,0,3,2,3,0
57416,53,37012,53,771,101,670,2,31,1,1
57342,53,55197,53,167,86,81,2,31,1,1
50013,53,8122,53,662,195,467,6,39,3,3
54648,443,56134,443,9215,3253,5962,51,22,25,26
49929,443,35482,443,2484,330,2154,12,136,5,7
58872,443,51853,443,342665,10261,332404,369,90,117,252
37653,5223,53311,5223,70,70,0,1,5,1,0
50179,443,33699,443,5419,1080,4339,17,42,10,7
35516,80,25484,80,841,715,126,5,15,3,2
54121,443,19391,443,26357358,863775,25493583,27347,208,8650,18697
49782,53,28643,53,228,86,142,2,30,1,1
34529,443,32303,443,77395,64623,12772,206,188,116,90
50500,53,52272,53,164,84,80,2,30,1,1
50828,443,49506,443,6337,1378,4959,19,140,9,10
50068,53,50068,53,240,96,144,2,30,1,1
59402,443,55166,443,4821,1882,2939,19,15,9,10
52916,80,53748,80,4266,1776,2490,20,367,11,9
64235,53,40648,53,197,102,95,2,30,1,1
60900,443,23820,443,134,60,74,3,6,2,1
34114,443,15852,443,6206,1695,4511,25,16,13,12
30188,32873,43392,32873,502,150,352,2,1200,1,1
27988,40011,54890,40011,253,190,63,2,30,1,1
65071,53,37727,53,93,93,0,2,60,2,0
37845,443,37845,443,4441,1534,2907,19,25,11,8
27005,27016,8684,27016,898,126,772,2,31,1,1
50316,53,38175,53,753,94,659,2,29,1,1
44399,443,14238,443,11367,9355,2012,32,395,13,19
53723,51501,50854,51501,70,70,0,2,7,2,0
57371,53,32883,53,212,108,104,2,31,1,1
33150,53,63816,53,816,228,588,8,29,4,4
60011,443,31949,443,6053,2582,3471,30,80,15,15
50868,80,40174,80,12388,742,11646,18,130,7,11
64053,53,26364,53,193,102,91,2,30,1,1
52070,55946,25301,55946,316,136,180,6,7,3,3
49762,53,33292,53,184,94,90,2,30,1,1
55403,53,28747,53,211,102,109,2,30,1,1
57490,443,55071,443,1778,1219,559,13,26,8,5
62482,443,44604,443,4427,2362,2065,11,119,6,5
63092,53,40692,53,304,86,218,2,30,1,1
64899,53,12836,53,199,102,97,2,29,1,1
61435,443,45257,443,1401,940,461,11,29,7,4
49989,53,26196,53,346,111,235,2,30,1,1
53525,34759,11727,34759,70,70,0,1,5,1,0
50272,53,61330,53,210,110,100,2,30,1,1
56846,53,45229,53,196,102,94,2,30,1,1
55731,36432,38455,36432,70,70,0,2,8,2,0
50584,6882,59204,6882,371,311,60,4,1199,3,1
54356,443,29580,443,18744,10266,8478,44,35,21,23
55950,53,65022,53,752,93,659,2,31,1,1
54634,443,32455,443,225732,7330,218402,246,174,86,160
49849,53,48086,53,325,126,199,2,30,1,1
52049,52557,23041,52557,70,70,0,1,5,1,0
45257,443,55440,443,36062,4663,31399,87,33,41,46
57850,3389,57850,3389,3347,1458,1889,15,18,8,7
53539,6881,61115,6881,492,306,186,8,14,5,3
57010,80,42816,80,214,140,74,4,30,3,1
56200,53,31034,53,211,110,101,2,31,1,1
64205,53,12061,53,172,88,84,2,30,1,1
41485,443,16482,443,29513,23962,5551,40,121,24,16
51221,20864,10145,20864,7308,6812,496,71,3243,63,8
56800,1,6191,1,70,70,0,2,8,2,0
34001,53,36189,53,225,78,147,2,30,1,1
16689,53,15770,53,199,94,105,2,30,1,1
56335,53,48756,53,816,102,714,2,30,1,1
52065,80,44925,80,692,300,392,9,26,6,3
56843,53,57824,53,177,94,83,2,30,1,1
58638,5900,58638,5900,130,66,64,2,4,1,1
57574,443,28846,443,3595,1957,1638,17,361,9,8
56945,80,24790,80,214,140,74,4,30,3,1
60156,443,49389,443,178,118,60,2,15,1,1
40386,443,23622,443,600,156,444,8,25,2,6
45186,443,63714,443,5959,169,5790,10,121,3,7
19473,32332,63968,32332,481,150,331,2,1200,1,1
44714,443,14525,443,7389,2124,5265,26,316,12,14
57076,53,47154,53,184,94,90,2,30,1,1
34331,443,11872,443,120,60,60,3,4,2,1
63965,53,30693,53,192,90,102,2,31,1,1
50584,40420,46560,40420,868,150,718,4,1200,2,2
56380,53,36495,53,177,94,83,2,30,1,1
53932,27258,53010,27258,70,70,0,1,5,1,0
52156,18238,49104,18238,70,70,0,2,7,2,0
37965,44056,39211,44056,158,158,0,1,1199,1,0
65383,53,42198,53,267,94,173,2,30,1,1
2267,53,16452,53,204,118,86,2,30,1,1
49767,53,46615,53,200,102,98,2,31,1,1
49558,53,47394,53,184,94,90,2,30,1,1
57180,53,28550,53,305,86,219,2,31,1,1
59946,443,42319,443,11836,3531,8305,37,121,19,18
63226,443,50931,443,4462,2023,2439,33,125,17,16
53537,34901,47127,34901,672,426,246,11,21,7,4
63203,443,63203,443,9324,4240,5084,24,16,13,11
55899,443,47257,443,4819,2304,2515,16,135,8,8
52052,80,64577,80,2188,593,1595,11,16,5,6
56622,53,6660,53,340,107,233,4,30,2,2
55720,443,32771,443,2494,719,1775,9,120,5,4
49742,443,32248,443,4490,750,3740,16,128,8,8
50126,443,42712,443,8464,2699,5765,48,147,26,22
15930,53,15930,53,244,98,146,2,31,1,1
61466,443,43127,443,6205,1125,5080,23,89,13,10
46342,53,46342,53,220,90,130,2,30,1,1
51906,443,34093,443,5685,1179,4506,18,29,10,8
54590,443,20540,443,12094,4159,7935,21,135,10,11
37562,443,51859,443,13836,6371,7465,34,23,20,14
57382,53,15348,53,969,86,883,2,30,1,1
14914,443,14914,443,16960,1347,15613,28,17,10,18
21133,11342,54289,11342,478,149,329,2,1200,1,1
59823,443,61551,443,306,180,126,6,29,4,2
65403,53,51244,53,178,94,84,2,30,1,1
56968,80,44242,80,53181,50384,2797,75,20,39,36
58830,28678,13686,28678,1806,1806,0,22,224,22,0
64331,53,13624,53,226,110,116,2,30,1,1
35164,443,44026,443,5505,995,4510,20,255,11,9
63421,53,63421,53,223,86,137,2,30,1,1
55444,53,60851,53,193,102,91,2,30,1,1
53629,51413,13341,51413,70,70,0,2,7,2,0
49381,53,64109,53,230,102,128,2,29,1,1
55084,443,37269,443,5556,1438,4118,22,196,12,10
63785,55255,57684,55255,3706,2125,1581,18,33,10,8
56756,53,14084,53,167,86,81,2,30,1,1
60366,443,31619,443,14484,7411,7073,26,60,15,11
36754,443,36754,443,4699,1792,2907,19,30,11,8
65524,53,37598,53,183,94,89,2,30,1,1
49456,443,44613,443,939,547,392,11,27,5,6
49627,53,57352,53,288,110,178,2,31,1,1
34275,443,58408,443,4880,3216,1664,29,79,15,14
59319,53,47365,53,285,106,179,2,31,1,1
60427,61137,3652,61137,70,70,0,2,8,2,0
45364,443,12194,443,9276,2422,6854,25,186,14,11
55788,53,13740,53,755,93,662,2,31,1,1
64149,53,17311,53,301,108,193,4,49,2,2
50298,53,22376,53,172,94,78,2,30,1,1
20570,53,52597,53,428,78,350,2,31,1,1
55675,53,48589,53,198,102,96,2,30,1,1
52149,52188,10170,52188,70,70,0,1,5,1,0
56911,53,21649,53,170,87,83,2,30,1,1
55268,53,38039,53,318,91,227,4,33,2,2
64794,80,22092,80,22646,1660,20986,29,135,10,19
34154,443,26311,443,6107,2012,4095,18,25,10,8
60460,54233,40952,54233,70,70,0,2,8,2,0
65439,53,54009,53,168,86,82,2,30,1,1
60413,43555,44163,43555,70,70,0,2,8,2,0
43402,53,65461,53,241,78,163,2,30,1,1
49212,38306,22542,38306,70,70,0,1,5,1,0
47656,443,30620,443,684,140,544,11,165,3,8
27005,33070,6671,33070,883,126,757,2,31,1,1
59741,443,12538,443,384,166,218,2,30,1,1
49723,53,9926,53,209,110,99,2,30,1,1
53666,80,3658,80,3741,3008,733,16,15,10,6
17750,27517,53975,27517,491,150,341,2,1200,1,1
49894,443,1865,443,8633,2099,6534,29,35,15,14
57598,80,57598,80,1810,821,989,10,20,6,4
64322,53,46348,53,273,90,183,4,32,2,2
62749,53,25858,53,184,86,98,2,30,1,1
57470,35988,31535,35988,132,132,0,3,1199,3,0
60416,55998,61754,55998,70,70,0,2,8,2,0
35735,80,48997,80,1155,781,374,10,15,6,4
64245,53,26898,53,199,102,97,2,30,1,1
55662,53,45972,53,212,102,110,2,30,1,1
60864,443,60864,443,8578,2549,6029,22,16,13,9
50314,80,10727,80,1030,310,720,11,56,6,5
63938,3389,63938,3389,3364,1714,1650,15,32,8,7
49702,80,5138,80,71256,962,70294,63,52,11,52
53783,443,19626,443,499,425,74,4,0,3,1
50960,80,58959,80,5533225,44880,5488345,4345,78,654,3691
55691,16410,58376,16410,70,70,0,2,8,2,0
49980,53,26131,53,152,78,74,2,30,1,1
50584,8569,42866,8569,1356,300,1056,6,1200,3,3
52876,443,35265,443,501046,7967,493079,419,118,69,350
54971,443,20430,443,13124,8442,4682,40,43,24,16
65442,53,44743,53,262,102,160,2,29,1,1
64709,53,12288,53,229,110,119,2,30,1,1
50260,53,44495,53,168,86,82,2,30,1,1
38350,80,18584,80,1678,1364,314,10,16,5,5
64998,53,50318,53,214,94,120,2,30,1,1
60412,12965,23315,12965,70,70,0,2,8,2,0
46291,443,48252,443,70,70,0,1,5,1,0
57408,53,58963,53,195,102,93,2,33,1,1
56820,19562,44411,19562,316,136,180,6,6,3,3
55945,53,51093,53,733,86,647,2,30,1,1
49824,53,4911,53,392,88,304,4,53,2,2
64534,53,57803,53,214,110,104,2,30,1,1
57444,53,13400,53,198,94,104,2,29,1,1
53770,58120,33681,58120,684,432,252,10,19,6,4
37616,443,22145,443,6506,1356,5150,24,16,14,10
63976,53,50670,53,200,102,98,2,30,1,1
56860,49991,37577,49991,70,70,0,2,8,2,0
63998,11372,44405,11372,504,382,122,8,16,6,2
56387,53,9036,53,182,93,89,2,31,1,1
50632,443,61474,443,10084,2145,7939,36,120,18,18
56435,53,33982,53,193,102,91,2,30,1,1
2267,53,54928,53,204,118,86,2,31,1,1
55651,53,31474,53,198,101,97,2,30,1,1
65155,53,8256,53,295,103,192,4,48,2,2
49346,53,44128,53,164,78,86,2,31,1,1
49581,80,58944,80,2339,1107,1232,11,21,6,5
33444,53,33346,53,168,78,90,2,30,1,1
45401,443,44939,443,9535,3495,6040,18,121,10,8
45852,53,58364,53,164,78,86,2,30,1,1
49665,53,62694,53,289,99,190,4,35,2,2
58999,443,30350,443,2687,1593,1094,20,20,11,9
51833,47388,26582,47388,70,70,0,2,6,2,0
65221,53,13826,53,168,86,82,2,30,1,1
65241,53,13968,53,484,102,382,4,36,2,2
58210,443,60868,443,14898,12644,2254,32,316,18,14
50130,53,10528,53,183,94,89,2,30,1,1
44974,443,22658,443,17760,13913,3847,54,167,25,29
58870,443,45632,443,1411,921,490,12,15,7,5
57593,443,14217,443,7037,1786,5251,23,200,13,10
55828,53,14283,53,177,94,83,2,30,1,1
48737,53,48737,53,227,90,137,2,30,1,1
41153,53,8565,53,168,78,90,2,30,1,1
55192,53,5787,53,178,94,84,2,31,1,1
55840,53,25093,53,711,87,624,2,30,1,1
64621,53,52780,53,387,134,253,2,29,1,1
38125,443,63227,443,497663,22937,474726,585,38,245,340
57585,443,55906,443,9273,2712,6561,50,615,25,25
49163,53,27365,53,167,86,81,2,31,1,1
58836,443,51260,443,12230,8144,4086,33,17,18,15
56563,443,19548,443,4528,884,3644,15,26,9,6
49906,443,16050,443,6754,2219,4535,21,77,11,10
64647,3389,64647,3389,3327,1438,1889,15,17,8,7
50233,80,29881,80,2388,1066,1322,16,135,8,8
33045,443,23219,443,4446,1298,3148,15,34,8,7
55933,53,58575,53,177,94,83,2,30,1,1
56939,53,27310,53,216,110,106,2,30,1,1
55693,443,55693,443,23467,2707,20760,45,80,21,24
64236,53,6587,53,211,102,109,2,30,1,1
56601,443,9573,443,7889,1900,5989,20,15,11,9
54550,443,54550,443,13490,2525,10965,30,18,17,13
49708,80,56764,80,179277,5324,173953,171,108,49,122
54912,80,63649,80,1992,1350,642,10,15,5,5
64829,53,40836,53,213,102,111,2,30,1,1
49601,53,32118,53,178,94,84,2,30,1,1
52329,443,64562,443,294025,14919,279106,401,42,192,209
56067,53,5556,53,195,102,93,2,30,1,1
56633,53,60296,53,197,102,95,2,30,1,1
5588,5588,0,0,3562,1936,1626,48,194,24,24
64917,53,41071,53,194,94,100,2,30,1,1
41981,443,19357,443,5164,2984,2180,42,1285,26,16
49618,53,25113,53,774,101,673,2,30,1,1
64980,27047,61209,27047,735,462,273,2,30,1,1
60420,443,16410,443,7330,1565,5765,20,134,10,10
55450,53,40761,53,193,102,91,2,29,1,1
57470,6881,33137,6881,792,792,0,13,1200,13,0
30859,53,30859,53,213,79,134,2,32,1,1
51158,443,53566,443,3155111,84086,3071025,3163,75,1072,2091
55199,53,8107,53,214,110,104,2,30,1,1
53286,80,26328,80,3096,1001,2095,12,150,7,5
55404,53,35517,53,326,102,224,2,29,1,1
65507,53,62722,53,177,94,83,2,30,1,1
42298,40010,41895,40010,1082,86,996,2,31,1,1
50119,443,16718,443,15168,5689,9479,51,34,27,24
26900,27017,26279,27017,422,164,258,6,30,3,3
37850,443,54127,443,3595,1468,2127,13,135,6,7
64235,53,30515,53,321,99,222,4,52,2,2
64721,53,18309,53,214,110,104,2,30,1,1
35205,53,35205,53,240,98,142,2,30,1,1
65013,53,26292,53,473,105,368,4,30,2,2
50013,53,7317,53,199,102,97,2,30,1,1
49336,80,14005,80,3060,1219,1841,11,19,7,4
63068,443,30672,443,2928239,68426,2859813,2888,37,955,1933
38706,443,10577,443,90545,3481,87064,96,16,31,65
57352,53,29825,53,196,102,94,2,31,1,1
43676,80,43895,80,2132,997,1135,14,20,8,6
57098,80,38453,80,819,530,289,8,40,5,3
49218,5222,44351,5222,85080,31769,53311,661,1172,305,356
50584,54321,2526,54321,1275,300,975,6,1200,3,3
64631,53,53048,53,226,102,124,2,30,1,1
9145,80,20559,80,318,192,126,6,30,4,2
33255,443,24023,443,7579,3093,4486,25,21,14,11
27005,27015,25452,27015,887,126,761,2,30,1,1
55835,443,26347,443,10087,3968,6119,32,271,17,15
57363,53,22472,53,178,94,84,2,30,1,1
58583,443,61583,443,8605,3169,5436,19,17,12,7
33151,53,41502,53,168,78,90,2,30,1,1
57707,443,36174,443,3150,1709,1441,26,276,13,13
53894,2944,4121,2944,70,70,0,2,8,2,0
35672,443,33861,443,938,576,362,14,27,9,5
53711,80,6435,80,2391,532,1859,11,75,6,5
34484,53,27104,53,86,86,0,1,30,1,0
57452,443,52384,443,6990,2193,4797,15,120,7,8
55318,53,35151,53,166,85,81,2,30,1,1
55005,53,64520,53,183,94,89,2,30,1,1
56758,53,14411,53,165,86,79,2,30,1,1
55362,53,13886,53,190,97,93,2,31,1,1
51820,80,11900,80,366,240,126,7,25,5,2
54420,80,23681,80,1596,511,1085,10,15,5,5
49229,53,54866,53,178,94,84,2,29,1,1
50898,443,1887,443,6883,1378,5505,19,128,9,10
50100,53,17377,53,734,94,640,2,30,1,1
55666,53,48851,53,728,96,632,2,30,1,1
65353,53,55498,53,351,105,246,4,57,2,2
56500,53,60506,53,199,102,97,2,30,1,1
64238,53,7198,53,211,102,109,2,29,1,1
57131,53,26066,53,168,78,90,2,30,1,1
26900,27017,65080,27017,422,164,258,6,30,3,3
41689,443,36583,443,1307513,51701,1255812,1486,148,576,910
49369,443,63066,443,6277395,184853,6092542,6543,317,2262,4281
65406,53,1627,53,102,102,0,1,60,1,0
34787,80,1192,80,2989,813,2176,15,166,8,7
48817,49301,48817,49301,490,149,341,2,1200,1,1
49453,53,4294,53,763,101,662,2,31,1,1
59838,443,12869,443,5520,3416,2104,27,22,13,14
49729,53,55522,53,210,102,108,2,30,1,1
43095,443,34288,443,6513,2043,4470,20,17,12,8
64483,53,26683,53,168,86,82,2,31,1,1
50255,53,26984,53,199,102,97,2,30,1,1
56046,53,22169,53,289,160,129,3,29,2,1
44967,53,51774,53,198,93,105,2,31,1,1
60758,40010,38736,40010,316,136,180,6,5,3,3
63751,17102,12860,17102,312,132,180,6,6,3,3
65092,53,7341,53,197,102,95,2,30,1,1
60037,443,12655,443,6194,1289,4905,23,66,12,11
34756,443,27102,443,100090,8304,91786,135,127,50,85
38633,443,44108,443,3448,1619,1829,18,18,8,10
52044,5824,18446,5824,70,70,0,2,8,2,0
48521,53,27557,53,78,78,0,1,30,1,0
57173,53,30572,53,322,110,212,4,31,2,2
50618,443,39503,443,11054,1724,9330,28,91,15,13
44673,80,44673,80,1916,1467,449,10,20,6,4
53599,47783,42378,47783,618,432,186,9,17,6,3
55786,53,13962,53,193,102,91,2,30,1,1
59911,80,3482,80,2025658,45348,1980310,1992,44,640,1352
64980,53,39962,53,90,90,0,1,31,1,0
62311,443,64602,443,598,598,0,8,41,8,0
53227,53,29917,53,205,86,119,2,29,1,1
56774,443,5880,443,7889,1900,5989,20,15,11,9
50917,80,57551,80,11626518,135099,11491419,9627,134,1907,7720
50338,80,9655,80,2668,870,1798,13,47,7,6
49899,443,2357,443,26284,21857,4427,72,83,39,33
60805,20010,40863,20010,70,70,0,2,8,2,0
58949,443,63115,443,5166,700,4466,16,15,7,9
49432,80,52783,80,2231,899,1332,15,92,8,7
56864,15646,51512,15646,70,70,0,2,8,2,0
65201,53,7188,53,216,110,106,2,30,1,1
48372,8100,12918,8100,78,78,0,1,5,1,0
53947,867,53640,867,70,70,0,2,8,2,0
63854,16437,6082,16437,70,70,0,1,4,1,0
36972,443,35947,443,7557,3602,3955,20,150,12,8
51104,443,47911,443,5220,3063,2157,14,135,7,7
10008,40004,11500,40004,156,94,62,2,30,1,1
50137,53,53286,53,448,184,264,6,31,3,3
47918,443,24262,443,7936,2847,5089,15,120,7,8
61349,443,14011,443,1786,172,1614,7,120,3,4
39980,443,30240,443,2674,1386,1288,17,120,8,9
50893,443,25118,443,9452,1832,7620,20,130,10,10
64316,53,34882,53,184,94,90,2,31,1,1
49631,53,64330,53,198,102,96,2,33,1,1
64839,53,30697,53,443,182,261,6,30,3,3
56263,443,47325,443,101747,13436,88311,135,319,53,82
60462,80,40235,80,1588,553,1035,10,75,6,4
53967,54589,61471,54589,70,70,0,1,5,1,0
43175,53,11498,53,194,86,108,2,30,1,1
52544,19000,32388,19000,492,216,276,2,31,1,1
64956,53,28840,53,322,84,238,4,36,2,2
5588,5588,0,0,3498,1872,1626,48,199,24,24
56318,53,32737,53,183,94,89,2,30,1,1
46417,443,30278,443,359878,6703,353175,325,36,88,237
51166,443,54384,443,13072,4708,8364,47,130,24,23
49991,53,12205,53,198,102,96,2,30,1,1
55044,443,65434,443,14427,4574,9853,34,61,18,16
60707,80,12418,80,144,78,66,2,5,1,1
23270,443,23270,443,5802,2592,3210,24,76,14,10
49710,443,63933,443,7691,1797,5894,22,137,12,10
64791,53,7738,53,184,94,90,2,30,1,1
56623,443,24976,443,8963,2190,6773,18,138,8,10
51848,443,16596,443,5788,3446,2342,22,135,11,11
56117,53,31292,53,172,88,84,2,31,1,1
56738,53,58828,53,198,102,96,2,30,1,1
9320,443,10901,443,3599,566,3033,15,15,8,7
48817,13073,48817,13073,787,296,491,4,1200,2,2
50241,53,50241,53,260,106,154,2,32,1,1
57352,53,7772,53,196,102,94,2,29,1,1
65226,443,51904,443,35968,13816,22152,77,96,34,43
49544,53,31008,53,226,86,140,2,30,1,1
59405,443,60870,443,9052,2120,6932,28,23,14,14
55836,53,6468,53,177,94,83,2,30,1,1
55006,53,7313,53,711,87,624,2,30,1,1
49679,53,7089,53,166,86,80,2,31,1,1
60985,443,55270,443,11535,4866,6669,34,50,20,14
55024,443,7164,443,6986,1578,5408,26,25,15,11
57448,53,27842,53,177,94,83,2,29,1,1
56612,53,15256,53,274,87,187,4,30,2,2
58662,53,17171,53,167,78,89,2,31,1,1
51512,443,52808,443,626132,21332,604800,730,33,294,436
56676,53,39365,53,178,94,84,2,31,1,1
60463,6890,23297,6890,164,70,94,3,8,2,1
61675,80,46507,80,5108,676,4432,14,15,7,7
56077,80,50993,80,5302,704,4598,14,18,8,6
55052,53,1245,53,198,102,96,2,30,1,1
41790,443,32230,443,232,172,60,3,4,2,1
36351,80,36351,80,1920,1471,449,10,20,6,4
64816,123,36690,123,184,94,90,2,30,1,1
56169,53,42323,53,204,104,100,2,30,1,1
47388,443,27845,443,350,210,140,6,15,4,2
64421,53,64542,53,172,88,84,2,31,1,1
51780,21130,9712,21130,70,70,0,2,8,2,0
54994,53,46934,53,747,90,657,2,30,1,1
51834,30309,65352,30309,70,70,0,2,7,2,0
55663,19994,59885,19994,70,70,0,2,8,2,0
60061,443,58385,443,3195,1426,1769,15,141,8,7
60575,443,23365,443,5994,1594,4400,23,42,12,11
64249,53,23999,53,181,94,87,2,33,1,1
48266,80,46749,80,130,70,60,2,15,1,1
47828,443,4397,443,512466,48982,463484,912,124,446,466
37390,80,51104,80,234,234,0,4,12,4,0
42306,443,42899,443,449862,38989,410873,644,280,286,358
60450,56494,22867,56494,70,70,0,2,8,2,0
56355,443,33571,443,3734,1750,1984,24,203,12,12
57246,53,12592,53,183,94,89,2,30,1,1
55072,53,57853,53,701,88,613,2,30,1,1
49654,22,49654,22,7791,3373,4418,54,36,26,28
55194,53,43998,53,195,102,93,2,30,1,1
39496,80,39496,80,2898,1485,1413,10,15,6,4
59999,443,10266,443,1571,660,911,13,18,7,6
65447,53,50068,53,277,102,175,2,29,1,1
65038,53,49241,53,173,94,79,2,31,1,1
65304,53,61262,53,209,110,99,2,30,1,1
50584,53,43253,53,174,89,85,2,31,1,1
40355,443,8929,443,15367456,244322,15123134,12866,268,1819,11047
36430,443,61120,443,3777,1509,2268,18,120,9,9
50584,30773,22058,30773,1356,300,1056,6,1200,3,3
26503,80,26503,80,225609,13986,211623,285,31,134,151
50265,55243,25034,55243,481,150,331,2,1200,1,1
56161,80,10423,80,2670,799,1871,13,46,8,5
58889,15000,32384,15000,138,78,60,2,6,1,1
58061,80,39603,80,5571,2637,2934,23,75,12,11
36836,443,26019,443,9381,1457,7924,21,31,11,10
9471,443,58396,443,8533,1544,6989,22,30,11,11
42162,80,42162,80,2941,1499,1442,10,16,6,4
49225,53,59832,53,295,101,194,4,49,2,2
50034,53,21368,53,179,94,85,2,30,1,1
49779,443,29819,443,10057,1887,8170,23,126,12,11
46488,443,7780,443,87129,6924,80205,126,258,49,77
51035,443,33243,443,2227,1018,1209,17,16,8,9
56575,443,16584,443,14284,5729,8555,31,61,19,12
60369,443,30950,443,12859,2557,10302,25,80,10,15
43465,80,31398,80,1352,848,504,13,255,8,5
60121,161,0,0,8215,3237,4978,30,30,15,15
65325,53,57020,53,216,110,106,2,29,1,1
64888,53,19204,53,718,94,624,2,30,1,1
50105,53,29739,53,969,86,883,2,30,1,1
52088,80,52684,80,3442,1728,1714,15,21,9,6
57096,53,39504,53,198,102,96,2,30,1,1
34947,53,51809,53,168,78,90,2,30,1,1
50534,53,37578,53,168,86,82,2,31,1,1
65374,53,40635,53,376,102,274,4,47,2,2
33067,53,47200,53,168,78,90,2,30,1,1
41440,443,30380,443,4370,1148,3222,17,25,9,8
49761,53,36428,53,373,99,274,4,41,2,2
49484,53,47845,53,742,88,654,2,31,1,1
56985,53,26642,53,916,86,830,2,30,1,1
47038,443,65328,443,2809,1884,925,19,24,11,8
37965,50321,10306,50321,158,158,0,1,1199,1,0
49591,53,54188,53,408,86,322,4,31,2,2
64003,38926,55687,38926,66,66,0,1,5,1,0
64076,53,18119,53,353,118,235,2,30,1,1
57347,443,40026,443,3889,1296,2593,11,120,6,5
50519,443,63602,443,16215,1368,14847,36,77,12,24
55384,53,33566,53,212,102,110,2,30,1,1
55217,53,39301,53,210,102,108,2,30,1,1
56603,53,10898,53,174,89,85,2,31,1,1
38704,443,15370,443,90097,3289,86808,93,15,28,65
60036,161,64579,161,2800,2800,0,28,111,28,0
37611,443,45731,443,11038,3875,7163,33,16,18,15
52662,443,35849,443,5382,1353,4029,19,135,10,9
51940,26399,4423,26399,66,66,0,1,5,1,0
49825,53,31559,53,168,86,82,2,29,1,1
56082,53,50090,53,271,88,183,4,38,2,2
50152,53,50662,53,776,102,674,2,30,1,1
55577,80,44269,80,70,70,0,1,5,1,0
64579,443,6221,443,24686,1935,22751,36,20,17,19
64494,443,46008,443,2872,717,2155,14,135,6,8
1738,80,1738,80,87958,5378,82580,100,95,39,61
49290,53,50836,53,184,94,90,2,30,1,1
49293,53,34843,53,382,95,287,4,48,2,2
63834,27037,35809,27037,1130,924,206,5,30,3,2
64766,53,62502,53,214,110,104,2,31,1,1
56658,53,51855,53,177,94,83,2,30,1,1
55272,53,55902,53,198,110,88,2,30,1,1
50281,443,10698,443,25811,4278,21533,73,100,38,35
57591,80,57591,80,144228,2522,141706,135,144,36,99
42378,443,63662,443,1970,1231,739,14,30,8,6
34097,443,35195,443,5241,860,4381,17,15,9,8
45537,80,48297,80,1638,1324,314,10,15,5,5
50367,53,22257,53,578,286,292,9,15,5,4
49163,53,24237,53,166,85,81,2,30,1,1
59475,53,33895,53,179,86,93,2,30,1,1
64951,53,50176,53,402,118,284,2,30,1,1
64077,53,54964,53,199,94,105,2,30,1,1
43904,443,27046,443,7552,2611,4941,24,360,13,11
62112,443,29747,443,505589,13504,492085,462,345,91,371
53232,443,40771,443,69742,34581,35161,105,63,52,53
58816,443,57126,443,5168,700,4468,16,15,7,9
64569,53,45660,53,183,94,89,2,30,1,1
52221,443,62267,443,4567,717,3850,17,148,7,10
65287,3389,65287,3389,3409,1454,1955,16,16,8,8
55912,53,11122,53,199,102,97,2,30,1,1
64685,53,47486,53,785,110,675,2,30,1,1
36132,80,36132,80,514,246,268,9,76,5,4
49587,443,57871,443,5879,870,5009,18,53,9,9
49246,53,24337,53,779,86,693,2,30,1,1
49505,53,46670,53,232,110,122,2,30,1,1
58056,80,49652,80,3518,1780,1738,12,20,7,5
35570,443,64379,443,3221,705,2516,15,135,7,8
49477,53,4842,53,178,94,84,2,31,1,1
50439,443,55602,443,73712,18850,54862,135,717,61,74
56677,443,24316,443,7941,1952,5989,20,15,11,9
47894,443,64449,443,70,70,0,2,5,2,0
52385,53,0,0,138,69,69,2,30,1,1
26900,27017,12614,27017,422,164,258,6,29,3,3
65431,53,65431,53,262,106,156,2,31,1,1
34704,443,48562,443,10207,3126,7081,26,24,14,12
59627,53,32997,53,290,102,188,2,30,1,1
55598,41565,26251,41565,70,70,0,2,8,2,0
44503,1433,44503,1433,150,60,90,2,9,1,1
64096,443,64096,443,5661,2415,3246,26,160,14,12
52097,23279,1789,23279,70,70,0,1,5,1,0
60607,53,60607,53,832,106,726,2,30,1,1
49926,53,49666,53,176,90,86,2,31,1,1
65172,53,3984,53,211,102,109,2,30,1,1
8978,443,11135,443,49938,20855,29083,165,216,81,84
56773,443,51568,443,7941,1952,5989,20,15,11,9
65323,53,53376,53,247,118,129,2,30,1,1
48822,53,49162,53,168,78,90,2,30,1,1
65387,53,9016,53,221,94,127,2,30,1,1
12116,53,12116,53,214,82,132,2,33,1,1
56852,53,36624,53,762,101,661,2,31,1,1
49418,27015,15763,27015,248,78,170,2,30,1,1
19236,53,19236,53,235,90,145,2,33,1,1
56330,53,24669,53,711,87,624,2,30,1,1
0,0,0,0,320,320,0,5,0,5,0
56203,53,21719,53,751,95,656,2,30,1,1
65056,53,13429,53,168,94,74,2,30,1,1
56964,53,51072,53,174,89,85,2,31,1,1
60335,7010,60335,7010,6127,4018,2109,19,17,11,8
14697,8000,26641,8000,212,150,62,2,31,1,1
58172,443,58172,443,4526,1619,2907,19,26,11,8
38608,80,62728,80,1289,303,986,12,16,5,7
56917,53,47484,53,188,96,92,2,31,1,1
53257,443,51156,443,8715,1814,6901,26,29,15,11
65304,53,18529,53,209,110,99,2,30,1,1
65186,53,43195,53,733,85,648,2,31,1,1
56498,53,39557,53,199,102,97,2,30,1,1
35649,53,35649,53,220,90,130,2,29,1,1
56317,53,35779,53,183,94,89,2,31,1,1
51594,53,51594,53,219,92,127,2,30,1,1
52206,80,42642,80,372,246,126,6,27,4,2
63991,80,39490,80,314,192,122,6,15,4,2
9104,443,36522,443,6240,1399,4841,24,44,12,12
26900,27017,14698,27017,422,164,258,6,29,3,3
53806,443,13248,443,499,425,74,4,0,3,1
57012,53,13483,53,230,86,144,2,29,1,1
27005,1202,59034,1202,865,126,739,2,30,1,1
55301,443,54571,443,9881,1486,8395,22,200,12,10
49738,443,52506,443,3085,1404,1681,15,15,7,8
52278,443,55005,443,7196,1791,5405,18,31,11,7
53192,443,46060,443,35788,2073,33715,54,21,20,34
56603,53,25992,53,1400,97,1303,4,57,2,2
42595,443,30091,443,190565,9979,180586,272,244,140,132
57295,53,34997,53,448,184,264,6,30,3,3
50870,5228,4125,5228,7069,1804,5265,20,3602,11,9
49812,53,37839,53,195,86,109,2,30,1,1
60858,443,17492,443,64658,47775,16883,115,16,63,52
64715,53,13561,53,770,102,668,2,30,1,1
56693,443,47203,443,7862,1873,5989,20,16,11,9
53023,443,2353,443,9625,3512,6113,41,92,21,20
48408,443,3268,443,115036,11567,103469,189,103,92,97
57470,1337,11046,1337,132,132,0,3,1199,3,0
54194,443,38493,443,195229,13204,182025,270,124,102,168
58898,443,10940,443,5108,700,4408,15,15,7,8
59814,443,30492,443,1560,977,583,15,30,8,7
6881,34635,39166,34635,228,118,110,2,1200,1,1
55570,53,7060,53,889,404,485,10,30,5,5
65472,53,45041,53,209,110,99,2,30,1,1
35441,5222,17710,5222,10854,4776,6078,80,119,41,39
64985,53,7448,53,196,102,94,2,31,1,1
56134,53,19695,53,167,86,81,2,30,1,1
49224,53,31598,53,177,94,83,2,30,1,1
50307,80,42606,80,3179,863,2316,13,57,7,6
63108,443,56013,443,4609,2177,2432,11,120,6,5
37712,443,12957,443,7660,2239,5421,32,255,16,16
51812,443,55280,443,10741,7368,3373,32,135,16,16
50871,53,48869,53,86,86,0,1,30,1,0
55650,53,39411,53,179,94,85,2,29,1,1
59652,443,50919,443,562,562,0,4,175,4,0
60247,80,40412,80,21505,6581,14924,31,149,14,17
61887,443,28383,443,81136,7785,73351,109,131,40,69
51987,23136,59906,23136,70,70,0,2,8,2,0
38194,53,38194,53,210,98,112,2,29,1,1
41484,443,11902,443,10024,6237,3787,22,27,11,11
55505,53,61786,53,198,101,97,2,1,1,1
53743,23915,44968,23915,70,70,0,1,4,1,0
64493,53,45305,53,198,101,97,2,30,1,1
55770,53,9659,53,177,94,83,2,30,1,1
26900,27017,1315,27017,422,164,258,6,30,3,3
64811,53,5466,53,190,97,93,2,31,1,1
53508,80,33768,80,16965052,382638,16582414,16619,61,5458,11161
48617,443,54481,443,10802,2841,7961,29,21,14,15
40204,40018,64999,40018,150,88,62,2,30,1,1
56492,80,31421,80,74105,3416,70689,84,135,32,52
56849,23745,9953,23745,66,66,0,1,5,1,0
65008,53,8162,53,312,94,218,2,30,1,1
27005,27015,55058,27015,1666,126,1540,4,31,2,2
56141,53,2789,53,184,94,90,2,31,1,1
49342,53,2621,53,200,102,98,2,30,1,1
56773,53,6473,53,735,88,647,2,30,1,1
34896,53,34896,53,231,90,141,2,30,1,1
64719,53,44200,53,196,102,94,2,31,1,1
35981,53,35981,53,227,89,138,2,31,1,1
49482,53,59102,53,196,94,102,2,30,1,1
65239,53,46235,53,198,101,97,2,31,1,1
64815,53,31191,53,214,110,104,2,30,1,1
42574,53,42574,53,262,106,156,2,32,1,1
1926,53,62848,53,210,78,132,2,30,1,1
51650,80,16811,80,312,192,120,6,37,4,2
59398,443,65413,443,3730,1956,1774,16,15,8,8
49846,443,49846,443,4693,1786,2907,19,27,11,8
49128,443,6577,443,3062,1747,1315,17,16,9,8
56713,443,29098,443,373053,9725,363328,374,45,129,245
59860,443,59422,443,2165,987,1178,17,40,8,9
64897,53,12641,53,266,110,156,2,30,1,1
52709,443,18513,443,266282,13744,252538,313,374,128,185
51790,46839,56676,46839,70,70,0,1,5,1,0
49742,53,16673,53,216,110,106,2,30,1,1
51111,80,36793,80,1614,1300,314,10,15,5,5
64631,53,54731,53,351,93,258,4,50,2,2
49684,53,44986,53,265,110,155,2,30,1,1
65143,53,22648,53,822,102,720,2,29,1,1
56677,53,47518,53,200,102,98,2,30,1,1
58051,443,3762,443,8930,1529,7401,21,19,9,12
56344,53,6437,53,199,102,97,2,31,1,1
39023,443,14196,443,1017,705,312,9,20,4,5
55442,53,12898,53,177,94,83,2,30,1,1
60014,443,60627,443,4275,1488,2787,17,143,9,8
50522,443,12346,443,13347,4662,8685,40,202,24,16
65386,53,49656,53,197,102,95,2,33,1,1
44074,443,54425,443,5498,3406,2092,28,95,16,12
56524,53,60434,53,182,102,80,2,31,1,1
59851,80,45085,80,307815,6418,301397,285,63,84,201
49372,53,17589,53,216,110,106,2,31,1,1
59764,53,23530,53,304,86,218,2,30,1,1
27005,27015,26613,27015,1664,126,1538,4,30,2,2
57470,1337,44694,1337,594,594,0,10,1199,10,0
55060,53,22947,53,195,102,93,2,30,1,1
46684,443,11949,443,26724,2570,24154,52,42,26,26
63087,443,39607,443,448,166,282,2,31,1,1
57423,443,2574,443,10222,4415,5807,26,15,11,15
50700,80,4259,80,417,417,0,4,9,4,0
61044,53,61044,53,180,82,98,2,30,1,1
41587,5222,51042,5222,208,60,148,4,14,2,2
55519,53,8879,53,186,95,91,2,30,1,1
60489,53151,64380,53151,70,70,0,2,8,2,0
55582,53,45316,53,170,87,83,2,30,1,1
65348,53,17423,53,177,94,83,2,29,1,1
63582,443,11318,443,6178,1669,4509,19,15,11,8
56688,53,13604,53,196,102,94,2,29,1,1
33968,443,15691,443,10073,4379,5694,33,42,17,16
9129,53,56648,53,205,86,119,2,30,1,1
15503,8624,29745,8624,491,150,341,2,1200,1,1
50584,63591,44593,63591,161,161,0,2,1200,2,0
49570,443,47382,443,162268,121343,40925,316,6101,108,208
57262,53,33477,53,180,94,86,2,30,1,1
64796,53,48263,53,184,94,90,2,31,1,1
63826,80,41744,80,314,192,122,6,15,4,2
56099,53,33681,53,701,88,613,2,30,1,1
56486,80,1722,80,46682,3447,43235,61,135,27,34
58914,53,2441,53,244,86,158,2,30,1,1
64882,53,29551,53,230,102,128,2,29,1,1
47785,443,12110,443,9224,2055,7169,37,41,19,18
58094,53,1806,53,249,102,147,2,29,1,1
55218,80,61870,80,2568,1705,863,12,186,7,5
27005,27027,32399,27027,880,126,754,2,31,1,1
50542,443,16831,443,5347,2537,2810,17,120,8,9
56104,53,63968,53,197,102,95,2,30,1,1
27005,27017,4799,27017,883,126,757,2,30,1,1
50384,443,12155,443,6147,911,5236,18,16,10,8
61355,443,38386,443,17666,3045,14621,52,213,21,31
65331,53,50741,53,732,89,643,2,0,1,1
55934,53,51844,53,731,85,646,2,30,1,1
53936,5915,56119,5915,70,70,0,1,5,1,0
65482,53,46055,53,179,94,85,2,31,1,1
60424,6881,10732,6881,320,140,180,6,7,3,3
65529,53,12629,53,199,102,97,2,30,1,1
65505,53,12322,53,164,84,80,2,31,1,1
55555,53,26797,53,194,102,92,2,30,1,1
64652,443,64652,443,6792,1521,5271,18,26,11,7
57258,53,32914,53,198,102,96,2,30,1,1
60913,443,14058,443,18805,1162,17643,28,135,11,17
37314,80,28984,80,1348,844,504,13,255,8,5
51594,53,61639,53,172,80,92,2,31,1,1
64614,53,52648,53,168,86,82,2,31,1,1
55617,53,37518,53,194,102,92,2,31,1,1
64665,53,12742,53,181,94,87,2,32,1,1
50859,53,0,0,286,79,207,2,30,1,1
58638,5900,58638,5900,126,62,64,2,5,1,1
49378,53,42308,53,306,94,212,2,30,1,1
51938,11218,41228,11218,70,70,0,1,5,1,0
56906,53,50869,53,166,85,81,2,31,1,1
60751,20010,62533,20010,70,70,0,1,5,1,0
49256,53,12893,53,177,94,83,2,30,1,1
58533,443,53373,443,17356,5096,12260,46,26,24,22
56279,443,27594,443,15248,5524,9724,54,364,27,27
41876,443,3381,443,55975,2553,53422,72,105,29,43
60503,53425,43534,53425,504,318,186,8,16,5,3
49923,53,15331,53,199,94,105,2,30,1,1
53573,14856,10337,14856,320,140,180,6,5,3,3
26900,443,4352,443,24703,16382,8321,49,21,28,21
35526,443,57074,443,4566,3317,1249,21,23,12,9
64089,53,37654,53,194,102,92,2,30,1,1
40650,443,51106,443,7298,2661,4637,21,17,11,10
64706,27065,37449,27065,924,924,0,3,30,3,0
46167,80,23731,80,234,234,0,4,11,4,0
55770,443,27394,443,40169,4646,35523,61,122,24,37
37570,443,53443,443,986,499,487,9,17,5,4
60105,443,39991,443,4856,1587,3269,17,138,9,8
49558,53,29414,53,177,94,83,2,30,1,1
56783,21279,18481,21279,70,70,0,2,8,2,0
55171,53,40871,53,199,102,97,2,30,1,1
64645,53,50507,53,391,96,295,4,49,2,2
64976,53,29065,53,193,102,91,2,29,1,1
53133,443,4728,443,5610,1599,4011,24,17,14,10
55090,53,47013,53,192,98,94,2,30,1,1
64023,53,2522,53,179,94,85,2,29,1,1
42870,443,3034,443,20248,1033,19215,28,3620,9,19
27005,27015,48788,27015,913,126,787,2,30,1,1
20520,53,20520,53,215,80,135,2,32,1,1
35879,443,58250,443,6108,3916,2192,51,1143,31,20
55647,443,60557,443,90956,83597,7359,106,127,70,36
53930,19831,55247,19831,70,70,0,1,5,1,0
55022,80,15142,80,1080714,29230,1051484,1137,174,436,701
34107,443,34100,443,11976,5066,6910,83,2475,43,40
57431,53,35038,53,392,134,258,2,30,1,1
56414,80,4969,80,33712,928,32784,36,104,11,25
56207,53,30514,53,260,102,158,2,30,1,1
5588,5588,0,0,3562,1936,1626,48,195,24,24
56409,53,35272,53,199,102,97,2,30,1,1
41126,53,30186,53,199,94,105,2,30,1,1
64810,53,44808,53,272,93,179,4,33,2,2
8283,45858,25688,45858,130,70,60,2,30,1,1
53535,1393,14227,1393,70,70,0,1,5,1,0
62860,443,23047,443,4954,2554,2400,11,122,6,5
50000,53,16568,53,502,115,387,4,52,2,2
28014,443,49655,443,6435,1089,5346,18,75,9,9
56476,443,56476,443,4624,1717,2907,19,30,11,8
56532,53,51264,53,186,95,91,2,31,1,1
8416,8416,61571,8416,66,66,0,1,30,1,0
51733,30688,11073,30688,70,70,0,1,4,1,0
64006,53,16897,53,394,96,298,4,47,2,2
53951,8999,52530,8999,70,70,0,1,4,1,0
51853,443,32598,443,7415,1550,5865,28,37,15,13
52233,42673,65112,42673,136,136,0,3,14,3,0
61666,443,28189,443,1786,172,1614,7,120,3,4
48268,443,29893,443,18462,11672,6790,47,63,26,21
52015,80,59849,80,14830,11044,3786,27,37,15,12
56314,53,21778,53,211,102,109,2,29,1,1
59298,443,18109,443,20971,2840,18131,52,89,24,28
55762,53,54612,53,184,102,82,2,29,1,1
27005,1104,16545,1104,870,126,744,2,30,1,1
55981,80,6270,80,130,70,60,2,15,1,1
44011,443,64228,443,1056,569,487,10,78,6,4
53132,443,46008,443,6515,1516,4999,23,16,12,11
64463,53,5557,53,182,93,89,2,0,1,1
64089,53,3452,53,194,102,92,2,31,1,1
52205,5222,24221,5222,684,280,404,11,26,5,6
43884,80,63772,80,1774,1460,314,13,15,8,5
15503,56331,21797,56331,481,150,331,2,1200,1,1
56276,443,43498,443,71414,17145,54269,194,292,91,103
2079,7000,2079,7000,3102,1551,1551,16,16,8,8
64748,53,6781,53,183,94,89,2,30,1,1
57306,53,11858,53,170,87,83,2,31,1,1
51869,25355,56016,25355,70,70,0,1,5,1,0
51607,53,31322,53,296,94,202,2,30,1,1
60977,443,59690,443,275026,15030,259996,353,72,167,186
46505,443,30509,443,59700,5399,54301,109,32,57,52
49571,443,40326,443,12258,5621,6637,52,286,25,27
57103,53,61295,53,193,102,91,2,29,1,1
49430,443,47050,443,18859,5795,13064,62,3666,28,34
46746,443,17806,443,9506,4029,5477,30,330,17,13
64385,443,64385,443,18895,2061,16834,34,18,18,16
60684,80,43634,80,1737,796,941,12,16,7,5
64588,53,18701,53,211,102,109,2,30,1,1
52019,40689,48482,40689,70,70,0,2,8,2,0
50311,443,61436,443,466,392,74,4,0,3,1
65107,53,27622,53,193,102,91,2,30,1,1
44131,443,6596,443,6582,1943,4639,14,122,7,7
49961,53,12419,53,377,107,270,4,45,2,2
49418,27015,18735,27015,244,78,166,2,30,1,1
56736,80,11534,80,194,128,66,4,25,3,1
57202,53,28601,53,184,94,90,2,30,1,1
49166,53,8191,53,468,93,375,4,34,2,2
57395,53,28814,53,262,88,174,4,59,2,2
52072,443,62613,443,7737,6531,1206,21,16,12,9
56352,53,39464,53,177,94,83,2,30,1,1
63755,53,63755,53,223,92,131,2,31,1,1
55155,53,64785,53,183,94,89,2,29,1,1
2954,443,2954,443,6915,882,6033,16,149,9,7
49749,53,47748,53,200,102,98,2,30,1,1
49314,443,47530,443,3185,2263,922,18,25,9,9
49727,53,64244,53,280,110,170,2,31,1,1
55242,53,7339,53,373,126,247,2,30,1,1
54222,443,54407,443,499,425,74,4,0,3,1
50612,80,47441,80,1559,1107,452,9,24,5,4
26900,27017,15818,27017,422,164,258,6,30,3,3
41313,53,41313,53,404,259,145,3,32,2,1
58828,53,32002,53,215,102,113,2,30,1,1
38644,1723,38644,1723,146,60,86,2,9,1,1
5588,5588,0,0,3562,1936,1626,48,193,24,24
2434,443,2434,443,8209,1695,6514,21,23,13,8
65251,53,30637,53,196,102,94,2,30,1,1
51357,80,45603,80,124,64,60,2,16,1,1
57369,16881,7618,16881,564,318,246,9,15,5,4
50164,443,9375,443,3312,1098,2214,19,137,10,9
57007,53,38539,53,183,94,89,2,30,1,1
58153,443,33248,443,12215,7275,4940,26,26,16,10
59119,53,4964,53,168,78,90,2,30,1,1
62455,443,9859,443,8302,2895,5407,22,25,11,11
53780,47132,22525,47132,70,70,0,2,8,2,0
55192,53,45038,53,172,88,84,2,30,1,1
49760,1443,52471,1443,626,352,274,10,15,6,4
64116,443,49764,443,7439,1156,6283,19,75,11,8
61364,443,41959,443,8492,2950,5542,27,16,15,12
58873,443,27496,443,1855088,42017,1813071,1821,49,531,1290
49915,443,34488,443,7648,2967,4681,23,15,13,10
50559,53,61943,53,216,110,106,2,30,1,1
55896,53,64776,53,168,86,82,2,30,1,1
42121,53,52822,53,199,94,105,2,31,1,1
26900,27017,31467,27017,422,164,258,6,30,3,3
49182,53,41433,53,199,102,97,2,29,1,1
23157,53,23157,53,228,90,138,2,30,1,1
54372,443,7862,443,11828,2811,9017,31,76,16,15
50172,53,37056,53,211,78,133,2,30,1,1
6881,6881,14545,6881,492,150,342,2,1200,1,1
56468,53,1634,53,180,94,86,2,30,1,1
38274,443,9313,443,600,156,444,8,25,2,6
52201,44054,14407,44054,70,70,0,1,5,1,0
34038,5222,46652,5222,2853,1289,1564,30,1555,12,18
52513,80,64881,80,39793,2026,37767,55,16,27,28
52288,443,59643,443,38314,11683,26631,76,34,38,38
51719,13715,5835,13715,70,70,0,2,8,2,0
55763,8060,49115,8060,70,70,0,2,7,2,0
56186,53,3994,53,198,102,96,2,29,1,1
56928,80,39650,80,526,304,222,8,35,5,3
55107,53,52328,53,214,102,112,2,30,1,1
49111,443,50826,443,43887,3283,40604,60,398,21,39
64926,53,31198,53,309,118,191,2,30,1,1
37513,443,37513,443,4347,1440,2907,19,30,11,8
49940,53,16387,53,257,110,147,2,29,1,1
57321,53,34343,53,762,98,664,2,30,1,1
49859,80,22070,80,1644,1324,320,10,15,5,5
64684,53,23170,53,199,94,105,2,30,1,1
52221,33166,34754,33166,70,70,0,2,8,2,0
64355,53,49915,53,402,118,284,2,29,1,1
53240,443,16717,443,1296713,27754,1268959,1253,118,366,887
53664,13701,27246,13701,70,70,0,2,8,2,0
5588,5588,0,0,3354,1792,1562,46,195,23,23
51541,3389,51541,3389,3609,1654,1955,19,18,11,8
54220,443,37468,443,499,425,74,4,0,3,1
65309,53,47712,53,258,110,148,2,30,1,1
50967,443,62336,443,5841,1986,3855,19,17,11,8
58724,443,37298,443,21610,9250,12360,40,17,19,21
52177,443,57914,443,7659,3234,4425,35,288,17,18
55649,443,18027,443,7045,2145,4900,18,136,8,10
32843,443,63526,443,6444,2640,3804,18,122,9,9
64068,53,64068,53,1184,83,1101,4,59,2,2
56484,53,12661,53,214,110,104,2,30,1,1
49558,53,42255,53,350,93,257,4,42,2,2
49556,443,13898,443,6440,1844,4596,22,141,11,11
51647,80,60876,80,378,192,186,7,38,4,3
65282,53,39898,53,193,102,91,2,30,1,1
27005,1107,18135,1107,824,126,698,2,29,1,1
56704,53,8695,53,194,102,92,2,31,1,1
65381,53,27857,53,317,102,215,2,31,1,1
55591,443,37425,443,7902,1565,6337,20,150,9,11
59377,53,59377,53,216,98,118,2,30,1,1
65414,443,41456,443,2494,1643,851,17,25,9,8
42186,443,1253,443,3562,2096,1466,18,336,9,9
56793,53,24911,53,196,102,94,2,30,1,1
64530,53,49179,53,782,105,677,2,30,1,1
52094,443,12498,443,2960,1982,978,15,16,9,6
50244,80,52530,80,136475,59298,77177,166,53,78,88
64815,53,23371,53,755,94,661,2,30,1,1
57008,443,25539,443,10572,5109,5463,24,122,12,12
38633,443,38633,443,4378,1471,2907,19,29,11,8
50655,80,2422,80,2108,1167,941,10,20,6,4
64326,53,50909,53,196,102,94,2,31,1,1
65189,27241,23433,27241,235,71,164,2,31,1,1
57038,53,2434,53,186,102,84,2,30,1,1
64543,53,58923,53,761,100,661,2,31,1,1
50116,22,50116,22,60,60,0,1,5,1,0
55364,53,12032,53,168,86,82,2,30,1,1
61352,443,38180,443,14131,5620,8511,38,216,20,18
64332,53,46508,53,167,86,81,2,30,1,1
55821,443,39900,443,128791,11254,117537,141,132,48,93
60730,443,28797,443,14776,5238,9538,41,175,21,20
57602,443,23488,443,2614,1689,925,18,20,10,8
56769,53,31740,53,183,94,89,2,30,1,1
33588,443,49965,443,6382,2331,4051,24,109,13,11
37570,443,52731,443,130,64,66,3,6,2,1
56268,53,23212,53,210,102,108,2,30,1,1
6881,6881,5588,6881,324,150,174,2,1203,1,1
55799,53,31223,53,752,93,659,2,31,1,1
49855,53,11171,53,290,102,188,2,30,1,1
65328,53,16469,53,174,89,85,2,30,1,1
39850,53,3565,53,199,94,105,2,29,1,1
56445,53,26251,53,199,102,97,2,30,1,1
52089,443,10472,443,15525,1642,13883,32,16,16,16
57907,443,20224,443,1584,953,631,17,124,9,8
56489,53,16732,53,208,106,102,2,31,1,1
57906,80,15891,80,318,192,126,6,26,4,2
37558,16385,3655,16385,432,192,240,8,30,4,4
57258,53,4190,53,177,94,83,2,29,1,1
56252,443,19925,443,6728,1775,4953,25,275,13,12
47200,443,56772,443,11003,3821,7182,35,257,14,21
61493,443,44435,443,5325,1242,4083,23,27,13,10
56370,443,11997,443,26040,2148,23892,44,22,21,23
56622,80,24066,80,234,234,0,4,12,4,0
57429,80,55023,80,1056,682,374,10,15,6,4
27005,1101,40896,1101,902,126,776,2,30,1,1
57592,443,17732,443,2614,1689,925,18,19,10,8
52490,53,52490,53,240,98,142,2,30,1,1
43361,80,14228,80,630,630,0,10,217,10,0
50254,53,7590,53,749,94,655,2,30,1,1
56050,53,45376,53,178,94,84,2,30,1,1
56330,53,30393,53,198,101,97,2,31,1,1
61705,80,47319,80,134,60,74,3,11,2,1
57401,53,56934,53,179,94,85,2,31,1,1
57256,5228,53413,5228,7144,1872,5272,36,22,20,16
56737,80,46127,80,194,128,66,4,25,3,1
56672,443,28399,443,7888,1899,5989,20,15,11,9
6881,41872,4010,41872,509,150,359,2,1200,1,1
52178,30922,2429,30922,70,70,0,1,5,1,0
56214,53,17373,53,200,102,98,2,30,1,1
45151,53,40658,53,168,78,90,2,30,1,1
56690,443,32613,443,3936,2585,1351,18,18,10,8
64023,53,59287,53,174,89,85,2,30,1,1
58704,80,26628,80,4115,3452,663,13,15,7,6
57470,1500,26703,1500,528,528,0,9,1200,9,0
63823,51558,34606,51558,66,66,0,2,7,2,0
40806,8000,49174,8000,1259,639,620,20,300,10,10
27005,27015,24724,27015,878,126,752,2,30,1,1
52000,80,35679,80,3604,2064,1540,15,40,10,5
51453,80,39611,80,214,140,74,4,15,3,1
58867,443,59291,443,5167,700,4467,16,15,7,9
37999,49152,14143,49152,156,156,0,3,8,3,0
59680,80,46564,80,5762500,128192,5634308,5613,134,1854,3759
34960,443,6692,443,7029,2223,4806,23,361,12,11
27005,30010,6041,30010,887,126,761,2,31,1,1
50974,80,21113,80,1095989,7833,1088156,841,37,117,724
50596,80,46998,80,1598,937,661,13,78,7,6
64537,53,60663,53,168,86,82,2,29,1,1
64493,53,17644,53,280,97,183,4,60,2,2
5588,5588,0,0,3354,1792,1562,46,194,23,23
58230,443,58230,443,4465,1558,2907,19,27,11,8
50968,443,1299,443,10759,3158,7601,29,75,16,13
49928,80,49356,80,1270,679,591,13,15,7,6
50320,80,20341,80,50565,32661,17904,77,167,39,38
63763,17368,8449,17368,66,66,0,1,5,1,0
9413,443,2971,443,3510,430,3080,10,15,6,4
57880,443,33669,443,1868,1229,639,18,177,11,7
55771,53,58272,53,283,98,185,4,51,2,2
63999,10552,38263,10552,70,70,0,1,4,1,0
49518,53,16482,53,193,102,91,2,30,1,1
58802,443,8176,443,5167,700,4467,16,15,7,9
57195,53,19593,53,195,102,93,2,33,1,1
63811,80,47846,80,314,192,122,6,15,4,2
55597,7485,9099,7485,70,70,0,2,8,2,0
55804,80,55804,80,424,198,226,7,143,4,3
51933,80,40922,80,3676,2136,1540,15,40,10,5
41524,443,23023,443,3976,2652,1324,20,312,11,9
55937,53,44427,53,758,93,665,2,31,1,1
63885,6969,1755,6969,66,66,0,2,8,2,0
61191,443,24135,443,569471,20976,548495,666,333,273,393
49921,53,21465,53,214,110,104,2,31,1,1
54846,53,32938,53,168,78,90,2,30,1,1
54105,443,23340,443,2227,1018,1209,17,16,8,9
63798,16357,31313,16357,70,70,0,1,4,1,0
58499,123,31733,123,184,94,90,2,30,1,1
54269,443,49860,443,5768,3426,2342,22,135,11,11
9187,443,51654,443,158704,5074,153630,184,34,69,115
56676,53,4759,53,172,88,84,2,31,1,1
57470,867,17411,867,330,330,0,6,1200,6,0
56910,53,59135,53,211,78,133,2,30,1,1
58748,443,1980,443,522925,36953,485972,799,229,304,495
55163,53,20116,53,197,102,95,2,31,1,1
53174,41442,13286,41442,70,70,0,1,5,1,0
55056,53,24229,53,177,94,83,2,30,1,1
64602,53,4497,53,184,94,90,2,30,1,1
52064,43273,64418,43273,70,70,0,1,5,1,0
51853,80,50403,80,4903,4061,842,11,26,6,5
40626,443,40626,443,7772,2569,5203,23,148,13,10
26865,443,47610,443,20959,15902,5057,38,20,21,17
56857,53,15955,53,195,102,93,2,30,1,1
51683,5228,43500,5228,9476,2759,6717,27,3601,15,12
10151,22208,55626,22208,323,150,173,2,1203,1,1
50303,443,45984,443,3051,1801,1250,18,15,8,10
49418,27015,37886,27015,219,71,148,2,31,1,1
65403,53,49597,53,359,94,265,2,30,1,1
59842,443,63853,443,1307,666,641,15,46,7,8
33826,443,52979,443,416,210,206,7,57,4,3
37842,443,37842,443,109189,6692,102497,151,80,69,82
54730,443,29479,443,20465,3839,16626,43,229,22,21
57793,53,34542,53,168,78,90,2,31,1,1
9377,80,44297,80,1643,485,1158,10,15,5,5
56848,19556,15601,19556,66,66,0,1,5,1,0
53533,22642,24303,22642,612,306,306,10,16,5,5
53234,443,53234,443,1276,703,573,15,33,8,7
49559,443,14886,443,1332,876,456,11,56,6,5
55994,53,14095,53,183,94,89,2,30,1,1
56569,53,53689,53,183,94,89,2,30,1,1
56174,443,38355,443,18931,4924,14007,46,139,20,26
49177,443,40595,443,840,700,140,13,59,11,2
38677,443,24014,443,89883,3417,86466,94,15,30,64
58842,443,44558,443,16260,10863,5397,39,19,21,18
51603,443,62273,443,2927,2062,865,14,134,8,6
27005,27016,48371,27016,887,126,761,2,30,1,1
63853,10659,8048,10659,70,70,0,1,4,1,0
51244,443,19950,443,8024,2572,5452,39,15,23,16
53328,53,0,0,418,154,264,4,33,2,2
60487,1134,57270,1134,70,70,0,1,5,1,0
48285,80,8478,80,6713,1736,4977,24,1130,8,16
49418,27015,60296,27015,253,78,175,2,31,1,1
52751,443,8615,443,5378,984,4394,18,17,10,8
65031,53,50837,53,184,94,90,2,30,1,1
64244,53,29357,53,198,101,97,2,30,1,1
65189,27015,25924,27015,233,71,162,2,30,1,1
49622,53,58073,53,244,94,150,2,30,1,1
50820,80,16954,80,550,476,74,6,15,5,1
65049,53,38762,53,184,94,90,2,30,1,1
57051,443,6628,443,594793,518081,76712,1350,1004,781,569
65134,53,41256,53,273,102,171,2,30,1,1
64742,53,28467,53,173,94,79,2,29,1,1
53727,443,53687,443,499,425,74,4,0,3,1
55450,53,15433,53,186,95,91,2,30,1,1
59046,443,4447,443,8279,2876,5403,22,155,9,13
51977,80,40997,80,366,240,126,7,25,5,2
51269,36983,55294,36983,70,70,0,2,8,2,0
60851,443,17568,443,36974,3935,33039,56,61,27,29
56656,53,54597,53,255,88,167,4,53,2,2
59084,443,59084,443,4598,1691,2907,19,30,11,8
55705,53,6400,53,281,101,180,4,60,2,2
36828,80,12290,80,5189,2979,2210,19,136,12,7
51878,443,1905,443,7241,1972,5269,28,68,16,12
43309,80,55504,80,805,665,140,6,32,4,2
65520,56330,49409,56330,558,318,240,9,143,5,4
65200,53,35834,53,290,102,188,2,30,1,1
54105,80,38446,80,78,78,0,1,5,1,0
32161,53,32161,53,823,98,725,2,31,1,1
49353,53,30816,53,738,86,652,2,31,1,1
59605,443,24489,443,4507,1525,2982,24,148,13,11
50028,443,29629,443,15425,9901,5524,33,84,17,16
50584,9045,4330,9045,166,166,0,1,1200,1,0
63798,16357,18681,16357,66,66,0,2,8,2,0
31089,53,31089,53,197,90,107,2,30,1,1
47073,7275,39561,7275,416,210,206,7,15,4,3
62457,7000,62457,7000,3959,1738,2221,15,15,8,7
55272,53,54690,53,198,110,88,2,29,1,1
63046,53,33586,53,510,164,346,2,30,1,1
35991,443,1116,443,10857,4247,6610,27,121,13,14
65269,53,14472,53,237,94,143,2,30,1,1
39914,443,20492,443,26779179,169104,26610075,19911,91,1968,17943
64254,53,19864,53,197,94,103,2,30,1,1
40105,80,32685,80,9656,3195,6461,19,23,12,7
57343,443,46945,443,1607664,53945,1553719,1792,39,700,1092
35832,443,44222,443,17110,4513,12597,42,121,19,23
57470,20220,32069,20220,870,330,540,12,2308,6,6
49420,443,13090,443,5241,1194,4047,19,40,9,10
46081,443,10510,443,125213,5113,120100,153,96,58,95
56685,443,20018,443,7855,1866,5989,20,15,11,9
64947,53,18048,53,275,96,179,4,41,2,2
27005,27015,49738,27015,893,126,767,2,30,1,1
56730,53,51057,53,733,86,647,2,30,1,1
51921,443,16602,443,7970,4154,3816,39,102,23,16
57201,53,63092,53,195,102,93,2,30,1,1
50059,443,43913,443,8205,2989,5216,42,115,21,21
52495,443,36037,443,32875,8836,24039,37,16,15,22
57398,53,40796,53,196,94,102,2,31,1,1
60683,443,28178,443,17071,1532,15539,17,147,3,14
65386,53,35268,53,197,102,95,2,33,1,1
27005,27015,42167,27015,869,126,743,2,30,1,1
57470,10748,14210,10748,594,594,0,10,1200,10,0
56400,80,42500,80,1281,398,883,16,392,4,12
56688,53,20462,53,196,102,94,2,30,1,1
49341,80,65147,80,1969,463,1506,13,55,7,6
53773,15459,13024,15459,70,70,0,2,7,2,0
43735,53,43735,53,216,88,128,2,30,1,1
49639,53,29692,53,250,102,148,2,29,1,1
64762,53,37992,53,194,102,92,2,30,1,1
65228,53,28438,53,200,102,98,2,30,1,1
56511,53,32498,53,200,102,98,2,30,1,1
56780,443,59581,443,7922,1933,5989,20,16,11,9
56834,53,36228,53,172,88,84,2,30,1,1
36008,80,27818,80,1614,1300,314,10,15,5,5
0,0,0,0,320,320,0,5,0,5,0
7539,53,7539,53,194,87,107,2,30,1,1
49418,27016,26183,27016,262,78,184,2,30,1,1
50648,80,9788,80,1717,1247,470,9,15,5,4
55058,443,16741,443,12435,4022,8413,27,62,15,12
50334,53,13800,53,216,110,106,2,30,1,1
50641,53,60493,53,760,97,663,2,30,1,1
55552,53,60195,53,211,102,109,2,30,1,1
23769,53,45289,53,334,226,108,3,30,2,1
10090,443,45576,443,20612,7872,12740,57,643,21,36
53464,443,61601,443,6550,1555,4995,25,53,13,12
10903,53,10903,53,247,98,149,2,32,1,1
27005,27015,60094,27015,876,126,750,2,31,1,1
58040,80,24098,80,9984,5333,4651,21,25,10,11
61415,443,64279,443,6143,1796,4347,21,21,11,10
49476,443,31371,443,7254,1183,6071,19,152,9,10
56601,53,12996,53,170,87,83,2,30,1,1
49580,53,4352,53,196,102,94,2,30,1,1
55678,53,40642,53,270,88,182,4,54,2,2
33443,443,53620,443,14402,2801,11601,28,205,11,17
52094,55986,33027,55986,66,66,0,1,5,1,0
6881,6881,57384,6881,238,118,120,2,1200,1,1
42598,443,46015,443,3134,1983,1151,15,15,8,7
57575,443,57575,443,206737,25710,181027,212,180,75,137
56677,53,61027,53,200,102,98,2,30,1,1
60881,443,30566,443,8284,1577,6707,29,48,14,15
60342,7000,60342,7000,3114,1659,1455,17,15,9,8
59278,443,45402,443,10495,9044,1451,29,35,18,11
53079,80,59311,80,2424,1110,1314,11,78,7,4
49224,53,51489,53,199,102,97,2,34,1,1
51092,80,39250,80,3974,2713,1261,34,131,19,15
22078,53,22078,53,229,98,131,2,30,1,1
49734,443,18197,443,7548,1543,6005,22,18,12,10
56515,995,45992,995,2901,1472,1429,27,17,12,15
65266,53,57275,53,216,110,106,2,29,1,1
32299,40019,6627,40019,261,175,86,2,31,1,1
50704,80,8069,80,499,192,307,6,26,4,2
48817,1025,48817,1025,334,158,176,2,1199,1,1
38261,443,49964,443,134,60,74,3,4,2,1
51076,443,8592,443,19880,4739,15141,58,187,26,32
64519,53,39794,53,277,94,183,4,60,2,2
58828,443,9559,443,5166,700,4466,16,15,7,9
38085,443,1147,443,78,78,0,1,5,1,0
55617,53,20605,53,214,110,104,2,30,1,1
49203,53,1575,53,195,102,93,2,30,1,1
64218,53,41220,53,212,94,118,2,30,1,1
42380,443,32272,443,1622,1137,485,11,26,7,4
49407,80,43999,80,4878,1570,3308,19,165,10,9
56674,53,20676,53,183,94,89,2,30,1,1
35999,443,44617,443,670261,26523,643738,728,188,262,466
56934,80,1586,80,486,280,206,8,26,5,3
51152,443,11725,443,44048,4441,39607,97,317,43,54
45630,443,4110,443,2996,1629,1367,17,21,9,8
55641,443,52887,443,6133,1655,4478,12,119,5,7
56887,53,35999,53,177,94,83,2,30,1,1
57018,53,62434,53,209,110,99,2,29,1,1
57355,53,57355,53,242,98,144,2,30,1,1
56553,443,45538,443,116577,6817,109760,137,62,54,83
48344,443,10226,443,68467,4750,63717,100,276,48,52
49851,53,28608,53,164,84,80,2,30,1,1
41688,443,15969,443,626036,38764,587272,713,191,245,468
49855,53,19600,53,916,86,830,2,30,1,1
29677,53,29677,53,218,90,128,2,29,1,1
51077,443,6425,443,2997,1906,1091,29,186,17,12
34326,443,28311,443,5692,1597,4095,19,18,11,8
61387,80,56509,80,28791,2297,26494,41,255,20,21
65506,53,20953,53,197,102,95,2,30,1,1
49812,53,34841,53,193,102,91,2,30,1,1
49280,53,63122,53,167,86,81,2,30,1,1
60874,443,51364,443,1706,169,1537,6,121,3,3
55319,443,12527,443,6210,2720,3490,15,121,7,8
50070,443,16090,443,9148,1570,7578,31,257,13,18
63034,443,35751,443,304,86,218,2,30,1,1
45987,443,65054,443,3160640,65300,3095340,2786,144,547,2239
59403,443,14686,443,30995,9655,21340,65,121,27,38
56621,443,45506,443,7981,1961,6020,20,15,11,9
55727,53,33963,53,335,93,242,4,32,2,2
50594,80,17201,80,3116,452,2664,18,394,5,13
36926,53,54098,53,164,78,86,2,30,1,1
62889,993,15893,993,9608,4549,5059,88,199,45,43
54862,19000,22196,19000,476,216,260,2,30,1,1
55332,53,52188,53,211,110,101,2,30,1,1
5588,5588,0,0,3354,1792,1562,46,193,23,23
9755,53,9755,53,244,98,146,2,33,1,1
46983,443,17844,443,2809,1884,925,19,25,11,8
49341,53,47990,53,199,102,97,2,31,1,1
51780,21130,19007,21130,66,66,0,1,5,1,0
27005,32028,16656,32028,900,126,774,2,31,1,1
50608,443,53757,443,8058,2722,5336,17,31,10,7
37965,25180,40858,25180,858,858,0,14,1199,14,0
27005,37579,27251,37579,886,126,760,2,31,1,1
55690,443,55690,443,14768,2185,12583,32,80,13,19
55617,53,58686,53,196,94,102,2,30,1,1
56846,53,22209,53,196,102,94,2,31,1,1
63230,443,3094,443,1309,670,639,16,127,9,7
63865,48610,9039,48610,66,66,0,1,5,1,0
49499,443,13640,443,87970,5355,82615,141,483,55,86
64103,38976,24644,38976,66,66,0,2,8,2,0
38425,443,45581,443,103112,8212,94900,165,55,80,85
50265,38203,29229,38203,480,149,331,2,1200,1,1
39743,80,10677,80,1563,570,993,10,16,6,4
65036,53,38858,53,214,110,104,2,29,1,1
27005,27126,47087,27126,636020,187240,448780,2701,104,1538,1163
65236,53,36812,53,215,102,113,2,30,1,1
56815,50510,55664,50510,70,70,0,1,5,1,0
53517,48019,30847,48019,70,70,0,1,4,1,0
37132,443,37132,443,4381,1474,2907,19,27,11,8
28236,443,42527,443,9686,2335,7351,28,124,13,15
65491,53,39082,53,186,95,91,2,30,1,1
52134,18470,2197,18470,70,70,0,2,7,2,0
44925,443,50958,443,153,93,60,2,5,1,1
52275,80,52275,80,210890,8286,202604,208,28,64,144
56827,53,43714,53,190,97,93,2,31,1,1
51891,23238,29444,23238,70,70,0,1,5,1,0
14199,443,14199,443,416,198,218,7,27,4,3
50708,80,26997,80,1658,1247,411,8,15,5,3
64752,53,22741,53,178,94,84,2,29,1,1
37428,53,37182,53,168,78,90,2,30,1,1
55794,443,55794,443,4578,1671,2907,19,28,11,8
49597,53,40368,53,86,86,0,1,30,1,0
55450,53,2536,53,102,102,0,1,30,1,0
56308,53,13825,53,184,94,90,2,30,1,1
54968,53,59116,53,199,102,97,2,30,1,1
55484,53,28906,53,711,87,624,2,30,1,1
53566,80,56289,80,2270749,47314,2223435,2132,99,651,1481
62887,993,3389,993,8921,4675,4246,77,200,47,30
65364,53,50447,53,226,110,116,2,29,1,1
49509,443,49509,443,242669,43830,198839,310,67,159,151
49254,53,63665,53,173,94,79,2,29,1,1
57204,53,62842,53,195,102,93,2,29,1,1
43029,443,37384,443,6053,1321,4732,19,980,9,10
57746,15000,19364,15000,130,70,60,2,6,1,1
39057,443,14567,443,70,70,0,1,5,1,0
29025,53,29025,53,235,90,145,2,31,1,1
45872,53,25002,53,199,94,105,2,30,1,1
57019,53,50222,53,193,102,91,2,30,1,1
46857,443,55410,443,280,140,140,5,129,3,2
49567,53,30320,53,195,94,101,2,30,1,1
64766,53,32517,53,214,110,104,2,30,1,1
55689,37558,18058,37558,70,70,0,1,5,1,0
56219,53,21871,53,211,102,109,2,30,1,1
63729,80,63729,80,7324,1017,6307,16,20,8,8
51236,443,52300,443,7950,2502,5448,38,15,22,16
57040,443,58515,443,59451,47894,11557,177,91,99,78
57902,443,28629,443,20509,7660,12849,54,131,28,26
55556,53,62239,53,183,94,89,2,29,1,1
55820,53,49367,53,194,102,92,2,30,1,1
52090,443,53299,443,45583818,387905,45195913,35736,272,5246,30490
48817,49157,48817,49157,328,152,176,2,1200,1,1
55675,53,24009,53,195,102,93,2,30,1,1
44871,53,32671,53,168,78,90,2,30,1,1
65148,53,60062,53,498,204,294,6,29,3,3
54599,443,16547,443,6410,2001,4409,27,28,16,11
60113,443,5252,443,704,280,424,11,19,5,6
56588,443,17428,443,15450,6149,9301,106,177,47,59
49196,53,18490,53,230,91,139,3,47,2,1
49964,53,63838,53,380,110,270,2,31,1,1
41008,53,32302,53,168,78,90,2,29,1,1
49671,53,11585,53,183,94,89,2,29,1,1
28743,53,28743,53,197,76,121,2,30,1,1
54994,53,24459,53,202,103,99,2,31,1,1
49629,443,16590,443,5600,1187,4413,24,80,13,11
61423,443,8022,443,1113,589,524,12,28,6,6
55800,53,53999,53,711,87,624,2,30,1,1
65318,80,50736,80,2356,499,1857,10,134,6,4
50475,80,52145,80,2669,1434,1235,11,21,6,5
63972,53,46168,53,193,102,91,2,30,1,1
49960,80,58313,80,9718,819,8899,19,15,9,10
64426,53,20042,53,289,101,188,4,51,2,2
55526,80,37218,80,78,78,0,2,8,2,0
56636,53,8907,53,168,86,82,2,30,1,1
37617,443,6093,443,1654,931,723,20,16,11,9
51636,80,6805,80,318,192,126,6,39,4,2
60426,25988,19003,25988,70,70,0,2,8,2,0
49414,443,63863,443,43326,4905,38421,56,43,16,40
61423,80,2681,80,214,140,74,4,41,3,1
55664,53,60480,53,177,94,83,2,29,1,1
57237,53,56776,53,701,88,613,2,30,1,1
60717,443,21678,443,61464,11538,49926,87,32,41,46
57132,53,36267,53,177,94,83,2,30,1,1
56291,53,51569,53,260,102,158,2,30,1,1
56257,53,40161,53,177,94,83,2,30,1,1
38936,53,29060,53,215,86,129,2,30,1,1
51814,80,8693,80,11975,2907,9068,24,38,14,10
56274,443,23756,443,3093,868,2225,10,120,5,5
49710,53,2087,53,179,94,85,2,30,1,1
49418,27015,13881,27015,237,71,166,2,31,1,1
34737,443,45602,443,5586,1338,4248,17,109,9,8
56035,53,45102,53,173,94,79,2,30,1,1
63925,53,36572,53,682,199,483,6,46,3,3
38562,443,22999,443,1310,649,661,13,185,7,6
26504,443,26504,443,1251,722,529,11,147,6,5
57470,43323,55435,43323,2292,332,1960,11,1200,5,6
53168,23074,22420,23074,958,454,504,14,21,8,6
65276,53,33888,53,226,86,140,2,30,1,1
63978,53,60357,53,214,110,104,2,30,1,1
46904,443,22687,443,1314,653,661,13,184,7,6
43220,5222,35739,5222,5415,2041,3374,53,467,23,30
49515,443,49515,443,102168,31819,70349,140,62,75,65
64814,53,26949,53,165,86,79,2,31,1,1
56636,53,35098,53,372,86,286,4,54,2,2
52191,32843,25090,32843,70,70,0,2,8,2,0
20689,53,20689,53,237,91,146,2,33,1,1
63992,53,33581,53,198,101,97,2,31,1,1
50829,53,16960,53,168,78,90,2,30,1,1
53871,443,16922,443,499,425,74,4,1,3,1
36369,443,28864,443,4039,2616,1423,24,45,14,10
50569,443,18328,443,5941,1856,4085,22,81,13,9
56333,53,63639,53,202,103,99,2,31,1,1
5231,30114,20445,30114,832,832,0,14,96,14,0
27005,1306,39345,1306,858,126,732,2,30,1,1
56821,53,37054,53,199,102,97,2,29,1,1
45996,443,45996,443,1494,898,596,12,142,6,6
0,0,0,0,600,306,294,6,0,3,3
50584,61467,32483,61467,1377,300,1077,6,1200,3,3
52003,443,46194,443,18400,6207,12193,60,212,32,28
57470,13613,11885,13613,1577,594,983,20,1601,10,10
56282,53,56282,53,194,87,107,2,31,1,1
65485,53,26681,53,184,94,90,2,29,1,1
64628,53,58574,53,199,102,97,2,29,1,1
56255,53,37256,53,701,88,613,2,31,1,1
60864,5223,16379,5223,194,134,60,2,5,1,1
56240,53,50619,53,748,95,653,2,30,1,1
11296,443,11296,443,1311,782,529,12,23,7,5
49160,50321,21626,50321,150,150,0,2,1200,2,0
26867,443,1450,443,11115,3034,8081,35,19,18,17
57839,53,54040,53,78,78,0,1,30,1,0
6882,40796,60379,40796,228,118,110,2,1200,1,1
64790,443,36803,443,53280,3270,50010,78,142,31,47
35685,443,31847,443,2967,876,2091,11,120,5,6
37653,5223,9635,5223,417,417,0,4,13,4,0
53769,8999,35608,8999,70,70,0,2,8,2,0
55049,53,52659,53,733,86,647,2,31,1,1
55872,123,4281,123,184,94,90,2,30,1,1
49418,27015,25961,27015,234,78,156,2,30,1,1
51731,39392,6820,39392,70,70,0,2,8,2,0
64422,53,39408,53,180,94,86,2,31,1,1
55159,53,6565,53,200,102,98,2,30,1,1
36088,443,55123,443,7229,2357,4872,26,270,14,12
39145,443,40241,443,4602,1305,3297,27,183,12,15
57470,6881,39218,6881,517,163,354,2,1200,1,1
56729,443,23413,443,8652,2148,6504,20,15,11,9
52019,40689,33926,40689,70,70,0,1,5,1,0
33227,443,20860,443,8888,1757,7131,26,174,15,11
0,0,0,0,2000,1020,980,20,0,10,10
48978,443,3498,443,10163,3585,6578,47,26,24,23
37586,443,60521,443,499,425,74,4,0,3,1
34257,7275,41230,7275,2845,419,2426,12,15,7,5
49811,443,7864,443,7551,2453,5098,22,126,12,10
56285,53,40728,53,711,87,624,2,30,1,1
50377,80,8000,80,1451,796,655,11,31,6,5
56751,53,35800,53,177,94,83,2,30,1,1
49073,443,18222,443,8960,2497,6463,35,32,19,16
56324,53,56324,53,257,101,156,2,34,1,1
54469,80,59842,80,1466,831,635,10,255,6,4
57843,443,8894,443,130,70,60,2,15,1,1
39582,80,57536,80,1614,1300,314,10,15,5,5
64902,53,51695,53,414,106,308,2,30,1,1
57176,443,31036,443,12844,2619,10225,23,120,10,13
56958,80,27013,80,9535,3968,5567,21,30,12,9
63433,443,29608,443,1950,1231,719,20,15,12,8
6881,6881,43994,6881,502,150,352,2,1200,1,1
65024,53,40250,53,198,101,97,2,32,1,1
56638,443,63919,443,7855,1866,5989,20,15,11,9
56609,443,13546,443,11061,1566,9495,25,19,13,12
57204,53,58502,53,182,93,89,2,30,1,1
65468,53,8938,53,200,94,106,2,30,1,1
58304,443,13109,443,13442,1200,12242,26,29,11,15
49876,443,4745,443,5993,974,5019,19,54,10,9
48389,443,33224,443,6616,3644,2972,18,122,9,9
64835,53,1399,53,200,102,98,2,30,1,1
53158,17234,38811,17234,70,70,0,1,4,1,0
48344,443,40212,443,232,172,60,3,5,2,1
50341,5222,19733,5222,9254,3356,5898,74,444,30,44
58004,443,48941,443,13206,7781,5425,29,253,15,14
47600,53,23679,53,168,78,90,2,29,1,1
47130,80,63322,80,613,539,74,7,15,6,1
37263,53,37263,53,220,90,130,2,30,1,1
65446,53,45033,53,204,104,100,2,30,1,1
65275,53,52488,53,184,102,82,2,29,1,1
53687,51471,3936,51471,70,70,0,2,8,2,0
26900,27017,35355,27017,422,164,258,6,30,3,3
50311,80,32414,80,366,180,186,7,57,4,3
49841,53,53641,53,751,95,656,2,30,1,1
65192,53,33207,53,178,94,84,2,30,1,1
39607,443,22667,443,559339,545011,14328,595,316,388,207
23276,443,23276,443,4668,1745,2923,21,76,12,9
53159,443,33030,443,9711,3950,5761,38,28,22,16
53833,443,61114,443,499,425,74,4,0,3,1
33098,443,57667,443,6044,780,5264,16,66,8,8
55176,80,55176,80,374,240,134,7,15,5,2
51295,80,40456,80,6702,5879,823,19,135,10,9
55044,53,38715,53,196,102,94,2,30,1,1
55534,53,23781,53,168,86,82,2,30,1,1
49201,17852,10581,17852,66,66,0,1,5,1,0
62884,5223,41292,5223,11427,6608,4819,37,248,21,16
64810,53,33589,53,272,93,179,4,33,2,2
53563,17355,37621,17355,320,140,180,6,5,3,3
51229,443,49748,443,8590,1038,7552,16,120,7,9
49631,53,24676,53,184,102,82,2,30,1,1
64274,53,64916,53,110,110,0,1,30,1,0
50533,443,28213,443,3518,1654,1864,10,120,5,5
15503,42286,2173,42286,480,149,331,2,1200,1,1
15732,53,15732,53,414,268,146,3,32,2,1
49675,53,62009,53,78,78,0,1,30,1,0
63045,443,61231,443,510,164,346,2,30,1,1
52146,80,44068,80,366,240,126,7,33,5,2
65258,53,25267,53,193,102,91,2,30,1,1
56798,40759,43301,40759,70,70,0,1,5,1,0
55632,45682,33177,45682,70,70,0,1,5,1,0
57470,44046,49985,44046,166,166,0,1,1199,1,0
55332,53,34862,53,211,110,101,2,30,1,1
56940,80,57845,80,606,70,536,10,278,2,8
56373,53,1027,53,181,98,83,2,31,1,1
65307,53,2186,53,184,94,90,2,31,1,1
65161,53,65161,53,256,114,142,2,30,1,1
60075,443,54321,443,6300,1427,4873,20,141,9,11
65040,53,64566,53,180,94,86,2,29,1,1
53651,47758,11315,47758,70,70,0,1,5,1,0
56887,53,63111,53,177,94,83,2,30,1,1
60171,443,39238,443,1059,556,503,12,25,6,6
35218,53,23519,53,168,78,90,2,30,1,1
35128,443,23671,443,9120,5103,4017,38,587,22,16
52923,443,55900,443,5581,1388,4193,19,15,9,10
54329,443,7872,443,7827,2416,5411,18,136,8,10
50023,53,49657,53,166,86,80,2,29,1,1
2267,53,56692,53,204,118,86,2,30,1,1
34900,443,21666,443,70,70,0,1,5,1,0
53035,443,38723,443,20048,9134,10914,96,92,39,57
63869,34368,47992,34368,66,66,0,2,8,2,0
43563,53,1876,53,164,78,86,2,30,1,1
56712,53,4721,53,448,184,264,6,29,3,3
64874,53,59017,53,323,110,213,2,30,1,1
51658,80,29469,80,318,192,126,6,37,4,2
57162,443,26306,443,1798,1223,575,13,25,8,5
55284,53,61340,53,193,102,91,2,30,1,1
64048,53,43444,53,202,103,99,2,31,1,1
35190,80,55473,80,130,70,60,2,14,1,1
65227,53,53714,53,180,86,94,2,30,1,1
49500,80,17093,80,309313,41646,267667,433,486,113,320
56568,53,16992,53,211,110,101,2,30,1,1
36548,443,36548,443,4621,1714,2907,19,30,11,8
57470,13551,21268,13551,761,166,595,2,1200,1,1
49662,443,52708,443,4353,1145,3208,17,25,9,8
57890,443,58945,443,3588,1991,1597,27,176,14,13
57028,53,32039,53,776,102,674,2,31,1,1
49891,80,30734,80,1694,666,1028,10,75,6,4
55272,53,42714,53,285,103,182,4,50,2,2
50470,80,50470,80,2144,900,1244,11,26,7,4
33497,53,21271,53,168,78,90,2,30,1,1
60473,22170,57823,22170,1599,743,856,13,36,7,6
52063,7886,16483,7886,70,70,0,1,5,1,0
65184,27126,4649,27126,268,78,190,2,29,1,1
48908,53,48908,53,398,255,143,3,32,2,1
51942,22272,51406,22272,210,70,140,4,8,2,2
64789,53,27915,53,199,102,97,2,30,1,1
55000,5222,35744,5222,32608,22014,10594,225,215,124,101
51954,80,41489,80,18285,8756,9529,29,27,15,14
33649,123,62077,123,184,94,90,2,30,1,1
64857,53,57218,53,332,104,228,2,30,1,1
56770,53,31600,53,779,86,693,2,30,1,1
61426,443,49528,443,7348,1763,5585,23,77,12,11
60331,443,58220,443,1867,1228,639,18,87,11,7
49495,443,17412,443,12452,10841,1611,26,27,14,12
49176,443,57308,443,10225,3155,7070,28,57,19,9
65127,53,25987,53,780,104,676,2,31,1,1
40203,80,61605,80,28577,1878,26699,47,31,23,24
25608,53,25608,53,823,98,725,2,30,1,1
57150,53,24486,53,170,87,83,2,30,1,1
63945,53,38413,53,216,110,106,2,30,1,1
65350,53,48988,53,168,86,82,2,30,1,1
50178,443,40731,443,6353,1075,5278,18,26,10,8
36790,80,59682,80,191737,8302,183435,205,31,79,126
56683,443,10179,443,8735,1819,6916,23,23,14,9
43906,443,43906,443,4792,2767,2025,38,255,20,18
55871,443,13590,443,21179,8150,13029,46,153,25,21
49213,443,9169,443,157994,4952,153042,186,255,68,118
63118,7000,63118,7000,3310,1535,1775,15,15,8,7
56786,443,47874,443,36203,1763,34440,46,119,17,29
53370,443,49689,443,6877,1694,5183,24,306,13,11
55555,53,19089,53,778,103,675,2,30,1,1
56103,443,24314,443,22293,16437,5856,51,30,27,24
49249,80,49249,80,265842,14126,251716,311,22,136,175
39932,443,25651,443,8309,4385,3924,26,121,12,14
63768,55755,28718,55755,66,66,0,2,7,2,0
63466,443,61707,443,5828,1439,4389,16,75,9,7
37306,53,55019,53,168,78,90,2,30,1,1
55711,53,2553,53,728,96,632,2,30,1,1
59997,443,62198,443,3063,1395,1668,16,144,8,8
56601,53,1857,53,177,94,83,2,31,1,1
38436,5222,53562,5222,7338,3611,3727,74,616,37,37
55281,53,43570,53,210,102,108,2,30,1,1
50970,80,27517,80,1123476,15099,1108377,963,39,223,740
35051,80,55027,80,350,210,140,6,30,4,2
56439,80,9837,80,17128,1499,15629,24,25,9,15
56480,53,53765,53,755,94,661,2,31,1,1
64351,53,15747,53,228,102,126,2,30,1,1
40204,40002,65519,40002,148,86,62,2,30,1,1
64749,443,34361,443,10750,1814,8936,37,195,17,20
60412,443,58640,443,7353,1573,5780,21,78,11,10
57395,53,40276,53,262,88,174,4,58,2,2
58124,123,43315,123,184,94,90,2,30,1,1
64994,27032,29881,27032,737,462,275,2,29,1,1
9452,443,55218,443,5693,499,5194,14,15,7,7
49167,53,55909,53,193,102,91,2,30,1,1
63355,443,59950,443,2870,343,2527,11,120,5,6
49868,443,36753,443,6251,1706,4545,16,88,9,7
63021,443,34609,443,512,166,346,2,30,1,1
34910,443,46197,443,16227,7159,9068,40,524,21,19
42451,443,55087,443,4886,895,3991,16,31,9,7
65484,443,65484,443,4640,1733,2907,19,27,11,8
57388,53,36277,53,732,89,643,2,30,1,1
57218,53,55252,53,789,110,679,2,31,1,1
40217,443,1676,443,14944,7430,7514,32,25,19,13
52541,53,60922,53,242,78,164,2,29,1,1
55043,443,31088,443,11681,3607,8074,40,120,20,20
64569,53,10194,53,182,93,89,2,31,1,1
64576,53,5234,53,194,102,92,2,31,1,1
65107,53,44757,53,266,87,179,4,33,2,2
27005,30006,32139,30006,890,126,764,3,31,2,1
26661,53,26661,53,217,87,130,2,31,1,1
51622,53,52520,53,260,86,174,2,30,1,1
56651,443,36673,443,4628,1035,3593,19,25,11,8
27005,27058,35794,27058,908,126,782,2,30,1,1
37905,443,37905,443,4707,1800,2907,19,26,11,8
53699,36887,39756,36887,492,306,186,8,15,5,3
49418,27018,21489,27018,255,78,177,2,31,1,1
57470,1031,51778,1031,402,132,270,6,1209,3,3
64716,53,33097,53,385,134,251,2,30,1,1
50831,443,11343,443,721741,131746,589995,1518,322,787,731
49260,80,56058,80,2013987,64000,1949987,1818,160,504,1314
49191,80,25150,80,2807,587,2220,13,16,7,6
49218,443,54857,443,590577,16239,574338,610,23,222,388
56227,53,19451,53,194,102,92,2,30,1,1
51767,59158,21535,59158,70,70,0,2,8,2,0
49461,53,38932,53,198,102,96,2,29,1,1
56413,53,29873,53,233,94,139,2,30,1,1
51961,443,43999,443,6913,1658,5255,22,17,12,10
49831,53,63335,53,198,94,104,2,30,1,1
33725,53,33725,53,216,90,126,2,30,1,1
52202,64241,19062,64241,250,66,184,4,9,2,2
58718,443,59357,443,1129,599,530,12,25,6,6
46279,443,60019,443,172,172,0,2,5,2,0
35722,443,40129,443,13035,2590,10445,27,125,14,13
47244,443,21922,443,5953,1848,4105,18,17,10,8
63046,443,63046,443,4419,1512,2907,19,30,11,8
56483,443,20342,443,6463,3844,2619,39,135,21,18
23824,80,23824,80,24232,4550,19682,59,17,34,25
50045,53,44466,53,168,86,82,2,31,1,1
65365,53,13159,53,196,102,94,2,30,1,1
64937,53,29678,53,210,110,100,2,29,1,1
60432,443,46333,443,4355,2135,2220,15,136,7,8
56695,53,47655,53,183,94,89,2,30,1,1
64559,53,6054,53,196,100,96,2,31,1,1
55443,53,14959,53,194,102,92,2,30,1,1
51596,443,63040,443,4638384,61757,4576627,3641,280,309,3332
49914,443,10717,443,10915,2554,8361,33,270,17,16
65491,53,7417,53,193,102,91,2,30,1,1
56481,53,28182,53,816,102,714,2,30,1,1
55387,443,54944,443,3997,1374,2623,14,136,7,7
57456,443,62626,443,6350,1550,4800,23,41,12,11
64567,53,15933,53,198,101,97,2,30,1,1
38447,443,18020,443,9824,2902,6922,38,48,19,19
53552,53,3574,53,168,78,90,2,29,1,1
37234,53,61804,53,168,78,90,2,30,1,1
50584,8999,32902,8999,311,311,0,3,1199,3,0
56041,53,39211,53,185,102,83,2,31,1,1
55656,53,20503,53,760,96,664,2,30,1,1
49777,443,39129,443,8638,2215,6423,24,126,14,10
55859,53,29640,53,210,110,100,2,30,1,1
37603,443,12094,443,8493,2314,6179,33,15,18,15
56671,443,59090,443,7940,1951,5989,20,16,11,9
49947,80,44031,80,362232,10443,351789,387,15,147,240
53164,443,1379,443,7434,1695,5739,23,27,12,11
52005,33191,61687,33191,70,70,0,2,7,2,0
55452,53,7661,53,184,94,90,2,30,1,1
63014,53,26673,53,304,86,218,2,29,1,1
63233,443,64284,443,1373,734,639,17,125,10,7
56602,53,29182,53,197,102,95,2,30,1,1
63738,443,63738,443,4349,1442,2907,19,27,11,8
49607,80,52438,80,378,192,186,7,41,4,3
63957,53,57529,53,211,102,109,2,30,1,1
7331,53,7331,53,213,79,134,2,32,1,1
50982,443,1681,443,5552,1179,4373,24,80,13,11
55059,443,19056,443,32852,17447,15405,61,64,32,29
49418,27015,26023,27015,78,78,0,1,30,1,0
47325,443,49234,443,130,70,60,2,15,1,1
50547,53,5293,53,210,110,100,2,30,1,1
63939,3389,63939,3389,4134,2109,2025,18,17,9,9
34988,80,55946,80,416,210,206,7,28,4,3
56496,53,28777,53,193,102,91,2,30,1,1
34715,443,46649,443,584,370,214,9,26,6,3
49230,53,36534,53,351,94,257,2,30,1,1
64053,53,35360,53,193,102,91,2,29,1,1
58077,36653,14563,36653,204,64,140,4,10,2,2
57665,53,28556,53,168,78,90,2,30,1,1
60792,443,60792,443,16401,8712,7689,53,297,25,28
45538,5228,21561,5228,2372,1452,920,16,3600,8,8
49418,27018,61835,27018,248,71,177,2,30,1,1
55692,53,9187,53,198,102,96,2,31,1,1
39803,443,33160,443,1701571,69958,1631613,1930,170,782,1148
51136,443,51136,443,1210,637,573,14,25,7,7
26943,443,22865,443,21275,16156,5119,41,22,23,18
65168,53,46023,53,239,94,145,2,30,1,1
48739,443,34033,443,7107,1636,5471,24,38,11,13
54224,53,18536,53,199,94,105,2,30,1,1
63982,53,27288,53,244,94,150,2,30,1,1
49710,53,28433,53,480,93,387,4,50,2,2
53350,443,13931,443,5987,2780,3207,21,140,10,11
49420,53,61159,53,183,94,89,2,30,1,1
50749,443,38979,443,4749,1897,2852,16,124,8,8
65143,53,45277,53,184,94,90,2,30,1,1
64283,53,30888,53,193,102,91,2,31,1,1
50186,443,57350,443,6363,1073,5290,18,38,10,8
55269,53,20584,53,186,95,91,2,31,1,1
46103,80,5613,80,70,70,0,2,5,2,0
53860,443,53373,443,8712,2293,6419,26,315,13,13
53790,53,7041,53,167,78,89,2,29,1,1
56694,443,1542,443,8058,2038,6020,20,15,11,9
46848,80,53629,80,25162,23336,1826,34,19,21,13
49414,443,6061,443,3427,2159,1268,20,17,11,9
45637,443,46378,443,6701,3487,3214,35,196,19,16
49237,443,19934,443,8293,4179,4114,22,128,11,11
65286,53,2453,53,369,102,267,2,30,1,1
21082,53,21082,53,226,90,136,2,30,1,1
49317,53,28300,53,194,102,92,2,29,1,1
47008,443,47008,443,4373,1466,2907,19,27,11,8
49806,53,64642,53,331,102,229,2,30,1,1
53080,443,53725,443,108155,4527,103628,115,83,30,85
50476,80,50476,80,28872,5086,23786,50,24,24,26
57470,64430,53438,64430,1386,1386,0,22,1526,22,0
54136,80,25504,80,1585,863,722,12,15,6,6
64174,53,11186,53,180,94,86,2,31,1,1
49742,53,9539,53,213,102,111,2,29,1,1
52052,27427,24815,27427,316,136,180,6,6,3,3
57109,53,6255,53,168,86,82,2,30,1,1
49611,53,14294,53,184,94,90,2,30,1,1
51606,443,32165,443,9979,4380,5599,26,256,12,14
65021,53,29006,53,256,93,163,2,30,1,1
49996,80,14871,80,3007,604,2403,11,15,6,5
61009,27065,32929,27065,1582,1386,196,6,30,4,2
54807,443,9391,443,10078,2210,7868,36,120,19,17
64347,53,36083,53,186,95,91,2,30,1,1
56282,53,64449,53,751,95,656,2,31,1,1
65427,53,25865,53,677,188,489,6,57,3,3
57470,32251,57534,32251,132,132,0,3,1199,3,0
0,0,0,0,2000,1020,980,20,0,10,10
27005,50002,4449,50002,1642,126,1516,4,31,2,2
62306,443,62306,443,5442,2195,3247,22,39,13,9
21189,53,21189,53,374,240,134,3,32,2,1
56427,53,1277,53,178,94,84,2,30,1,1
37299,443,19605,443,10790,5444,5346,21,122,10,11
49479,7000,49479,7000,5200,3745,1455,18,15,10,8
54769,80,54769,80,23168,3380,19788,36,19,18,18
49931,53,22854,53,594,196,398,6,82,3,3
23023,80,23023,80,2270,1645,625,9,26,6,3
54956,53,34992,53,188,96,92,2,31,1,1
52358,443,40970,443,4145,2738,1407,29,27,16,13
37067,443,4326,443,21446,1599,19847,35,155,16,19
50584,49001,14591,49001,166,166,0,1,1199,1,0
50565,53,50708,53,707,94,613,2,30,1,1
57343,53,10133,53,214,86,128,2,29,1,1
64781,53,27529,53,209,102,107,2,30,1,1
55062,443,36502,443,14701,3640,11061,29,60,16,13
49683,80,8217,80,1548,847,701,10,15,5,5
59765,443,22401,443,571,166,405,2,30,1,1
49386,443,47173,443,6250,1765,4485,22,15,12,10
55495,53,27718,53,210,110,100,2,31,1,1
50409,53,47032,53,731,85,646,2,30,1,1
65448,53,13119,53,209,110,99,2,30,1,1
49928,443,22562,443,9330,2410,6920,25,81,13,12
46026,443,9317,443,8908,3897,5011,19,135,9,10
56142,53,56422,53,194,102,92,2,31,1,1
58728,443,26266,443,5167,700,4467,16,15,7,9
55200,53,50421,53,209,110,99,2,30,1,1
56556,53,18816,53,184,94,90,2,31,1,1
53984,57077,13402,57077,70,70,0,2,8,2,0
57493,443,46334,443,1778,1219,559,13,27,8,5
49663,53,18877,53,184,80,104,2,30,1,1
54712,8080,31768,8080,110,110,0,1,31,1,0
64756,53,52664,53,190,97,93,2,31,1,1
54268,443,64525,443,10173,1548,8625,25,41,14,11
49342,53,62127,53,200,102,98,2,30,1,1
57286,443,36985,443,134,60,74,3,10,2,1
56312,53,44683,53,756,95,661,2,31,1,1
6194,80,6194,80,3058,774,2284,11,16,6,5
49418,27015,63577,27015,71,71,0,1,30,1,0
57138,443,50278,443,498,210,288,8,26,4,4
52928,443,44110,443,5584,1390,4194,19,15,9,10
56987,53,30832,53,192,98,94,2,31,1,1
57396,53,39255,53,358,102,256,2,30,1,1
64525,53,5631,53,199,102,97,2,29,1,1
56332,53,16709,53,209,110,99,2,30,1,1
40648,443,10699,443,130,70,60,3,5,2,1
40791,443,54664,443,7236,2069,5167,25,25,12,13
59773,443,43322,443,165464,10322,155142,189,71,69,120
50127,443,64951,443,31982,9936,22046,61,16,33,28
50012,7000,50012,7000,3132,815,2317,14,16,7,7
63867,43618,49838,43618,70,70,0,1,4,1,0
58781,443,55654,443,6133,1655,4478,12,120,5,7
54439,443,63339,443,44294,9390,34904,167,319,83,84
64073,53,57961,53,304,101,203,4,38,2,2
49686,53,9507,53,343,94,249,2,30,1,1
55222,53,59150,53,1210,950,260,2,29,1,1
48189,443,41896,443,1343,616,727,14,82,7,7
64370,53,62116,53,399,102,297,4,54,2,2
64388,53,48927,53,248,102,146,2,30,1,1
49236,443,49236,443,554853,293345,261508,600,69,317,283
64587,443,60822,443,24686,1935,22751,36,18,17,19
55778,53,21245,53,189,102,87,2,29,1,1
49189,443,23027,443,9734,1613,8121,24,17,12,12
64146,53,63495,53,197,102,95,2,30,1,1
49766,53,54774,53,234,102,132,2,30,1,1
58638,5900,58638,5900,156,62,94,2,10,1,1
60081,443,25599,443,10893,4674,6219,43,121,19,24
26900,27017,25827,27017,172,86,86,2,29,1,1
58638,5900,58638,5900,156,62,94,2,10,1,1
55312,53,37351,53,195,102,93,2,29,1,1
37052,53,37052,53,178,82,96,2,30,1,1
40781,443,17024,443,14327,1918,12409,37,270,17,20
27005,33026,18106,33026,879,126,753,2,31,1,1
56775,53,45440,53,177,94,83,2,30,1,1
54688,443,54688,443,149676,25300,124376,220,110,122,98
54075,443,31475,443,76388,4341,72047,107,169,48,59
58415,443,33034,443,560,280,280,9,30,5,4
14667,443,14667,443,20280,2078,18202,35,17,19,16
55372,53,44494,53,199,102,97,2,30,1,1
56757,53,39521,53,167,86,81,2,30,1,1
6881,6881,34489,6881,253,118,135,2,1199,1,1
42618,443,18541,443,4694,2432,2262,34,81,16,18
49538,443,16302,443,2926,1825,1101,22,171,11,11
11073,3389,11073,3389,4085,1916,2169,21,18,12,9
52002,53,64717,53,289,86,203,2,30,1,1
50332,53,15195,53,193,102,91,2,29,1,1
55154,443,28417,443,1610,771,839,22,120,11,11
64940,53,23084,53,250,94,156,2,30,1,1
46902,123,43333,123,184,94,90,2,30,1,1
65430,53,43606,53,305,94,211,2,29,1,1
59646,5223,10066,5223,139,139,0,1,5,1,0
56697,443,20511,443,8007,1987,6020,20,15,11,9
40193,443,57432,443,1462,735,727,15,185,8,7
33912,443,41888,443,6288,3354,2934,9,122,5,4
53545,27700,24861,27700,320,140,180,6,7,3,3
44871,53,64533,53,164,78,86,2,31,1,1
55692,53,35310,53,196,100,96,2,30,1,1
42484,443,62904,443,79507,72433,7074,96,415,60,36
123,123,34455,123,184,94,90,2,30,1,1
60875,443,60875,443,1092,645,447,10,34,6,4
50360,80,38167,80,5307,2694,2613,17,25,9,8
56962,53,9303,53,177,94,83,2,30,1,1
49966,53,59809,53,166,86,80,2,30,1,1
59883,443,34270,443,8031,2957,5074,27,46,16,11
40878,443,41466,443,6517,1003,5514,22,360,11,11
41619,443,17467,443,188529,10173,178356,248,256,93,155
31593,53,31593,53,832,106,726,2,30,1,1
60338,7000,60338,7000,3486,1983,1503,15,16,8,7
55503,53,13265,53,200,102,98,2,30,1,1
65396,53,32966,53,178,94,84,2,30,1,1
50047,80,4097,80,1455,349,1106,10,15,5,5
50391,8080,50391,8080,1614,785,829,11,54,6,5
53685,38978,33015,38978,70,70,0,1,5,1,0
49782,443,2557,443,7757,1997,5760,23,126,13,10
61936,443,38328,443,4348,1643,2705,14,138,6,8
37444,53,37444,53,213,79,134,2,32,1,1
64048,53,15990,53,209,110,99,2,30,1,1
65184,53,30460,53,225,102,123,2,30,1,1
63679,443,51267,443,7987,2092,5895,18,119,8,10
57240,53,57857,53,215,94,121,2,30,1,1
57444,443,3253,443,9581,3281,6300,36,16,16,20
64058,53,58322,53,280,110,170,2,30,1,1
50415,443,63011,443,2542,1504,1038,16,20,9,7
33806,443,17179,443,37541,4945,32596,69,127,31,38
62122,53,41697,53,179,86,93,2,30,1,1
65528,53,21468,53,168,86,82,2,30,1,1
51847,80,28250,80,366,240,126,7,31,5,2
57161,53,42229,53,224,102,122,2,29,1,1
55624,53,59892,53,308,101,207,4,53,2,2
49660,53,23772,53,193,102,91,2,30,1,1
55771,53,21538,53,283,98,185,4,52,2,2
51836,53,49755,53,168,78,90,2,30,1,1
57351,53,50583,53,177,94,83,2,30,1,1
56006,53,30347,53,200,102,98,2,30,1,1
57314,53,31776,53,195,102,93,2,30,1,1
44847,18659,47289,18659,150,150,0,1,1200,1,0
64528,53,42814,53,353,118,235,2,30,1,1
44481,443,29524,443,6336,1633,4703,22,256,12,10
32888,80,22913,80,1542,831,711,7,16,5,2
56772,53,30219,53,185,102,83,2,29,1,1
65496,53,16227,53,194,102,92,2,29,1,1
49716,443,11903,443,9323,3144,6179,24,130,14,10
7198,53,7198,53,398,255,143,3,32,2,1
56524,53,26224,53,182,102,80,2,30,1,1
56431,80,21703,80,17248,1619,15629,26,25,11,15
64016,53,9177,53,93,93,0,1,31,1,0
58793,443,26304,443,5167,700,4467,16,15,7,9
57556,443,56704,443,162,102,60,2,5,1,1
50584,49001,36650,49001,1290,300,990,6,1200,3,3
35287,443,46797,443,47587,20536,27051,345,581,173,172
56638,443,50177,443,44984,28294,16690,77,40,40,37
64636,53,17069,53,166,86,80,2,31,1,1
37561,80,40884,80,1630,918,712,12,16,7,5
5480,53,5480,53,244,98,146,2,33,1,1
53874,43922,52145,43922,320,140,180,6,6,3,3
49740,443,61794,443,7554,2281,5273,22,129,13,9
45336,443,30419,443,2312,1382,930,19,28,11,8
51999,34619,15741,34619,70,70,0,1,5,1,0
57284,53,33476,53,173,94,79,2,29,1,1
51734,59825,48074,59825,70,70,0,1,5,1,0
43093,53,41079,53,242,78,164,2,30,1,1
58642,443,2998,443,7127,3015,4112,24,144,12,12
56538,53,20855,53,401,95,306,4,57,2,2
63879,80,50871,80,314,192,122,6,15,4,2
54136,80,22556,80,25148,5233,19915,39,71,21,18
49314,53,60410,53,214,94,120,2,30,1,1
38111,443,61640,443,566856,28278,538578,737,37,351,386
56432,80,52279,80,17128,1499,15629,24,25,9,15
53793,20468,19761,20468,70,70,0,1,5,1,0
42298,40020,48690,40020,148,86,62,2,30,1,1
26900,27017,64848,27017,422,164,258,6,30,3,3
51944,12470,26336,12470,316,136,180,6,6,3,3
65338,53,10255,53,314,88,226,4,44,2,2
50604,443,50604,443,4401,1494,2907,19,28,11,8
54134,443,5561,443,10425,1383,9042,23,75,13,10
50358,443,18545,443,5133,2154,2979,26,81,13,13
50550,443,42250,443,8123,1809,6314,22,71,12,10
64171,53,19883,53,174,89,85,2,30,1,1
53207,443,15704,443,3655,2344,1311,18,17,9,9
55533,53,2426,53,183,94,89,2,30,1,1
6882,6881,62031,6881,238,118,120,2,1200,1,1
65229,53,28081,53,195,102,93,2,30,1,1
63823,51558,31200,51558,1518,1396,122,12,45,10,2
54093,5228,31167,5228,7608,1824,5784,34,171,19,15
56167,53,49116,53,178,94,84,2,30,1,1
55405,53,55361,53,199,102,97,2,30,1,1
60420,80,1065,80,14498,6454,8044,24,120,12,12
6881,6881,22683,6881,502,150,352,2,1200,1,1
64820,53,13245,53,190,97,93,2,31,1,1
49932,53,48698,53,190,97,93,2,30,1,1
20826,53,20826,53,228,90,138,2,32,1,1
49776,53,42364,53,182,94,88,2,30,1,1
51765,443,19120,443,3026,965,2061,14,135,7,7
49487,53,10311,53,183,94,89,2,31,1,1
56246,53,65270,53,202,103,99,2,30,1,1
56872,53,25005,53,443,182,261,6,29,3,3
17824,53,17824,53,244,98,146,2,32,1,1
19876,53,19876,53,209,77,132,2,33,1,1
64107,53,23798,53,212,102,110,2,29,1,1
55098,53,14805,53,180,94,86,2,30,1,1
39611,443,31755,443,234,234,0,4,12,4,0
50939,443,38504,443,8058,1136,6922,19,126,9,10
62037,80,19447,80,1670,422,1248,13,17,5,8
61418,443,63876,443,7741,1614,6127,21,77,11,10
52157,23002,50044,23002,70,70,0,1,5,1,0
54618,53,15831,53,263,86,177,2,30,1,1
58801,443,36000,443,8937,5785,3152,26,16,14,12
44641,80,65447,80,1354,850,504,13,256,8,5
38621,443,27614,443,1593,946,647,15,64,8,7
55568,443,60113,443,8979,5057,3922,89,110,51,38
64874,53,28911,53,808,110,698,2,30,1,1
57386,53,13419,53,193,102,91,2,31,1,1
64908,53,50064,53,812,110,702,2,30,1,1
47091,443,62680,443,3543,1570,1973,18,120,9,9
52006,49849,11177,49849,70,70,0,2,7,2,0
44864,25,44864,25,130,66,64,2,5,1,1
64133,53,32044,53,216,102,114,2,30,1,1
64627,53,3343,53,199,102,97,2,31,1,1
53815,17290,63882,17290,70,70,0,2,7,2,0
56950,53,53864,53,183,94,89,2,30,1,1
57096,53,11827,53,198,102,96,2,30,1,1
65446,53,26325,53,210,110,100,2,30,1,1
59821,80,19887,80,1052,612,440,10,15,5,5
55756,53,41764,53,747,90,657,2,30,1,1
65014,53,29342,53,193,102,91,2,30,1,1
64217,53,58721,53,186,95,91,2,31,1,1
64869,443,59977,443,6454,1227,5227,18,122,9,9
54142,7000,54142,7000,4067,1750,2317,16,16,9,7
59898,443,21573,443,5429,2835,2594,19,140,9,10
51682,443,60633,443,5060,2867,2193,26,398,9,17
50253,53,9014,53,756,95,661,2,30,1,1
64850,53,13429,53,166,85,81,2,31,1,1
56784,23140,27615,23140,70,70,0,1,5,1,0
56862,53,7245,53,198,94,104,2,30,1,1
55022,53,7516,53,195,102,93,2,30,1,1
60386,9136,45378,9136,624,318,306,10,16,5,5
56177,53,33735,53,184,94,90,2,30,1,1
38654,443,36804,443,9144,1783,7361,19,16,10,9
36148,443,59223,443,2233,1237,996,18,75,9,9
58638,5900,58638,5900,126,62,64,2,5,1,1
56892,53,6597,53,199,102,97,2,30,1,1
21975,3389,21975,3389,3910,1805,2105,20,19,12,8
56223,53,58545,53,185,102,83,2,31,1,1
46746,443,33868,443,7002,4142,2860,46,1485,29,17
48817,60483,48817,60483,519,158,361,2,1199,1,1
51388,443,52372,443,20351,3359,16992,52,103,27,25
52083,26607,58147,26607,70,70,0,1,4,1,0
60903,443,60903,443,3672,2294,1378,23,17,13,10
53860,443,61776,443,499,425,74,4,1,3,1
65001,53,54840,53,224,78,146,2,30,1,1
53902,443,2298,443,499,425,74,4,0,3,1
50187,443,52959,443,6363,1073,5290,18,38,10,8
64608,53,19709,53,718,94,624,2,30,1,1
56997,53,59115,53,711,87,624,2,30,1,1
10166,80,10166,80,450,246,204,8,24,5,3
63808,53,2452,53,578,286,292,9,15,5,4
53216,443,34085,443,14933,1671,13262,31,66,15,16
55134,53,17370,53,214,110,104,2,30,1,1
35098,161,0,0,15190,7454,7736,78,30,39,39
54204,443,50779,443,18159,12786,5373,34,270,19,15
56440,53,14356,53,742,88,654,2,30,1,1
11139,443,11139,443,6981,948,6033,17,27,10,7
61482,443,17696,443,49181,3553,45628,65,46,29,36
33845,80,39303,80,424,210,214,7,27,4,3
56326,53,18129,53,177,94,83,2,29,1,1
51730,33399,62466,33399,70,70,0,2,8,2,0
49418,37569,43147,37569,237,71,166,2,30,1,1
49437,443,4843,443,9621,2347,7274,24,78,12,12
56700,80,19955,80,51889,4253,47636,68,64,31,37
49418,27016,31344,27016,250,78,172,2,31,1,1
6590,80,6590,80,326,186,140,6,29,4,2
51938,80,16530,80,4424,3281,1143,12,27,8,4
52936,5228,12223,5228,9201,2130,7071,41,5528,21,20
53654,53,13764,53,523,85,438,4,31,2,2
45932,53,57917,53,199,94,105,2,30,1,1
38262,80,2079,80,3843,1312,2531,19,227,6,13
58281,443,12495,443,4039,805,3234,17,120,8,9
26900,27017,41011,27017,422,164,258,6,30,3,3
56739,53,56739,53,825,99,726,2,30,1,1
64357,53,13293,53,183,94,89,2,30,1,1
55877,22374,2922,22374,150,150,0,1,1200,1,0
56962,53,33318,53,210,102,108,2,30,1,1
55921,53,30522,53,711,87,624,2,30,1,1
54992,53,3265,53,195,102,93,2,30,1,1
49317,53,48476,53,166,86,80,2,30,1,1
38444,443,18273,443,3547,955,2592,13,120,6,7
55955,53,35067,53,184,94,90,2,31,1,1
64900,53,46043,53,197,102,95,2,30,1,1
45057,443,53651,443,1394,733,661,14,80,8,6
55624,53,50480,53,199,102,97,2,30,1,1
60797,28080,55300,28080,70,70,0,1,5,1,0
55043,443,10001,443,36707,3750,32957,54,60,24,30
55714,18904,51148,18904,320,140,180,6,6,3,3
57505,443,24632,443,3640,606,3034,13,120,6,7
45510,443,22832,443,130,70,60,2,15,1,1
65304,53,2754,53,202,103,99,2,31,1,1
49900,443,9178,443,6300,2644,3656,16,121,8,8
51957,443,52201,443,3516,1732,1784,34,42,19,15
49160,61365,56372,61365,502,150,352,3,1200,2,1
63136,443,35141,443,6781,1289,5492,17,15,9,8
56668,53,43075,53,199,102,97,2,30,1,1
34951,443,13510,443,3308,2109,1199,30,751,16,14
56589,53,53742,53,711,87,624,2,30,1,1
56362,53,49796,53,190,97,93,2,31,1,1
55584,53,31260,53,184,80,104,2,30,1,1
49800,53,14799,53,183,94,89,2,30,1,1
50201,53,18513,53,751,95,656,2,31,1,1
57986,443,51773,443,124014,6270,117744,175,27,69,106
49849,53,37502,53,196,102,94,2,31,1,1
42298,40013,31078,40013,140,78,62,2,30,1,1
56109,53,59181,53,323,102,221,2,29,1,1
56456,53,39368,53,199,102,97,2,30,1,1
56624,53,40354,53,199,102,97,2,29,1,1
35449,443,35449,443,157435,9243,148192,220,97,101,119
65028,53,41163,53,265,94,171,2,30,1,1
48337,443,44874,443,227876,8050,219826,236,36,83,153
36823,80,35585,80,3335,2735,600,12,30,7,5
55223,443,2473,443,1118883,33814,1085069,1206,48,451,755
38653,443,63492,443,6969,2162,4807,20,15,11,9
51613,7000,51613,7000,2163,676,1487,14,15,7,7
64970,27055,4626,27055,735,462,273,2,31,1,1
44661,443,11205,443,9468,2242,7226,23,15,12,11
49990,53,60528,53,198,102,96,2,30,1,1
56988,53,43201,53,216,110,106,2,30,1,1
50774,443,17270,443,4521,2256,2265,15,135,7,8
58767,53,1096,53,168,78,90,2,29,1,1
49359,80,26843,80,60,60,0,2,154,2,0
52028,53,52028,53,194,87,107,2,31,1,1
53490,80,9100,80,2577,1278,1299,14,267,8,6
58020,80,26488,80,2312,1094,1218,25,89,13,12
51769,19165,52583,19165,70,70,0,1,5,1,0
17750,6881,35389,6881,150,150,0,1,1200,1,0
55249,53,63785,53,711,87,624,2,30,1,1
52163,14181,24095,14181,70,70,0,2,8,2,0
64406,53,3194,53,102,102,0,1,30,1,0
50713,80,55082,80,708,384,324,12,195,7,5
49666,53,7037,53,325,126,199,2,30,1,1
63866,17623,35380,17623,66,66,0,2,8,2,0
35340,443,44611,443,7470,1088,6382,21,27,12,9
49512,443,62361,443,12472,1628,10844,35,195,16,19
10151,6881,7271,6881,490,150,340,2,1200,1,1
53263,443,23949,443,11175,1078,10097,25,41,11,14
9698,53,9698,53,197,90,107,2,30,1,1
65378,53,28736,53,770,102,668,2,30,1,1
63139,53,41966,53,78,78,0,1,30,1,0
52030,43068,39879,43068,70,70,0,2,8,2,0
50827,443,28235,443,166814,93487,73327,620,4017,312,308
27005,27015,27369,27015,889,126,763,2,30,1,1
64482,53,47729,53,196,102,94,2,30,1,1
65342,53,53223,53,760,97,663,2,30,1,1
64950,53,37238,53,725,277,448,8,61,4,4
45993,443,45993,443,1494,898,596,12,142,6,6
19473,51413,49212,51413,459,149,310,2,1200,1,1
49767,80,33888,80,70,70,0,2,8,2,0
54996,53,2476,53,168,86,82,2,31,1,1
52132,55014,27986,55014,70,70,0,1,4,1,0
49224,53,25602,53,199,102,97,2,30,1,1
56941,53,42543,53,196,102,94,2,30,1,1
59727,443,28777,443,304,86,218,2,31,1,1
58809,443,38293,443,4055,1295,2760,11,121,6,5
50483,443,29109,443,10050,1192,8858,28,81,14,14
52904,443,65264,443,17521,6560,10961,55,117,28,27
39416,443,62311,443,11188,5277,5911,95,587,44,51
65376,53,8405,53,184,94,90,2,30,1,1
55648,80,35736,80,70,70,0,1,5,1,0
60720,443,36383,443,41921,15385,26536,69,34,37,32
49724,53,34584,53,210,102,108,2,30,1,1
50727,27029,42555,27029,269,78,191,2,30,1,1
51603,443,54804,443,19849,6817,13032,45,37,23,22
55382,53,35558,53,199,102,97,2,30,1,1
33967,80,35208,80,1836,662,1174,15,3826,6,9
53903,443,40208,443,499,425,74,4,0,3,1
33415,53,42301,53,164,78,86,2,29,1,1
54135,443,36564,443,11065,1394,9671,23,75,13,10
64684,53,7467,53,757,102,655,2,30,1,1
55624,53,2352,53,199,102,97,2,30,1,1
55897,53,59750,53,733,85,648,2,30,1,1
59703,443,2631,443,8867,2701,6166,21,105,9,12
49157,443,32525,443,5115,977,4138,18,18,10,8
58149,443,24568,443,153,93,60,2,5,1,1
58309,53,16090,53,255,86,169,2,30,1,1
53792,1,64543,1,70,70,0,1,4,1,0
64968,53,21697,53,250,102,148,2,31,1,1
46262,123,34977,123,184,94,90,2,30,1,1
36037,53,7009,53,198,93,105,2,30,1,1
49731,80,40624,80,318,192,126,6,130,4,2
56536,443,5996,443,6044,3444,2600,49,501,25,24
49765,53,11309,53,194,102,92,2,30,1,1
27005,27016,9591,27016,884,126,758,2,30,1,1
57470,13613,53702,13613,1577,594,983,20,1638,10,10
56805,53,39519,53,178,94,84,2,30,1,1
53589,53,45469,53,578,286,292,9,15,5,4
50208,80,63761,80,1277,460,817,16,77,5,11
56341,3389,56341,3389,3424,1710,1714,16,33,8,8
56257,53,60774,53,170,87,83,2,31,1,1
42440,443,11681,443,9412,2994,6418,27,48,16,11
9512,443,14359,443,3614,434,3180,11,1,6,5
49777,53,52771,53,216,110,106,2,30,1,1
47971,443,27561,443,11482,2506,8976,48,1329,24,24
59738,443,4655,443,510,164,346,2,31,1,1
43310,443,13938,443,60,60,0,1,5,1,0
41232,443,32307,443,1807,1048,759,16,25,8,8
36453,443,24873,443,7298,2661,4637,21,18,11,10
51988,32239,13198,32239,66,66,0,1,5,1,0
50518,443,27027,443,1352,691,661,14,47,8,6
43549,443,50179,443,10316,2303,8013,39,120,20,19
40364,443,43021,443,20594,14251,6343,40,361,22,18
56670,80,44971,80,234,234,0,4,12,4,0
49690,53,14782,53,790,110,680,2,29,1,1
49721,443,34964,443,65732,3951,61781,102,65,40,62
64593,53,5715,53,602,93,509,4,42,2,2
56930,53,53703,53,774,101,673,2,31,1,1
60990,443,42071,443,212824,12881,199943,244,49,101,143
49172,53,32719,53,227,102,125,2,29,1,1
50271,443,3937,443,10103,2342,7761,39,121,22,17
56324,53,13523,53,177,94,83,2,30,1,1
14032,53,14032,53,235,90,145,2,32,1,1
37617,443,47875,443,499,425,74,4,0,3,1
55024,443,1691,443,552073,14113,537960,536,31,176,360
55123,53,62052,53,762,97,665,2,31,1,1
59115,443,45739,443,30048,2775,27273,41,137,16,25
56125,53,3352,53,168,86,82,2,30,1,1
51876,443,3089,443,1852,1103,749,16,32,9,7
64564,53,49143,53,273,94,179,2,30,1,1
55440,53,50711,53,711,87,624,2,30,1,1
55638,53,11091,53,168,86,82,2,30,1,1
55821,53,65311,53,196,102,94,2,31,1,1
50877,80,27709,80,186520,11545,174975,222,141,96,126
50681,80,59849,80,318,192,126,6,26,4,2
53679,24300,62271,24300,1656,914,742,13,21,9,4
50265,42698,16471,42698,726,726,0,12,1200,12,0
52866,80,44619,80,6022,2590,3432,37,131,20,17
49852,53,14933,53,230,102,128,2,31,1,1
53811,443,28685,443,499,425,74,4,0,3,1
53506,50144,41476,50144,492,306,186,8,15,5,3
53872,443,24185,443,499,425,74,4,1,3,1
51732,54299,27558,54299,70,70,0,2,8,2,0
39890,443,4730,443,21106,2445,18661,45,20,24,21
61712,443,30612,443,7443,2692,4751,19,76,11,8
49900,7000,49900,7000,2958,1567,1391,15,15,8,7
64428,53,56066,53,195,102,93,2,30,1,1
65449,53,26123,53,315,87,228,4,40,2,2
55937,53,36384,53,177,94,83,2,30,1,1
50049,443,7528,443,27889,1445,26444,37,121,14,23
52194,22674,61715,22674,66,66,0,1,5,1,0
49816,80,56471,80,130,70,60,2,15,1,1
55277,53,53790,53,701,88,613,2,30,1,1
10125,443,63386,443,6151,2939,3212,28,332,13,15
49564,53,61434,53,193,102,91,2,30,1,1
57832,443,1165,443,91134,7506,83628,132,130,52,80
49418,27015,19557,27015,255,78,177,2,30,1,1
32962,443,9560,443,3935,1010,2925,20,165,9,11
59769,443,37962,443,8432,1967,6465,35,68,17,18
25251,53,25251,53,231,90,141,2,30,1,1
64613,53,26326,53,89,89,0,1,30,1,0
52523,80,47280,80,4302,3722,580,14,15,8,6
52006,49849,60139,49849,70,70,0,1,5,1,0
55090,53,59676,53,196,102,94,2,29,1,1
65235,53,42179,53,209,110,99,2,30,1,1
53041,443,62358,443,2881,346,2535,12,120,5,7
26900,27017,9336,27017,422,164,258,6,30,3,3
64608,53,13914,53,208,106,102,2,31,1,1
44265,80,44265,80,22407,7251,15156,35,23,16,19
35047,80,8306,80,7891,2035,5856,17,32,10,7
64036,53,37626,53,692,224,468,6,49,3,3
64088,39650,57206,39650,66,66,0,2,7,2,0
51992,22670,60663,22670,70,70,0,2,7,2,0
60369,80,60369,80,266818,12375,254443,285,34,107,178
51606,443,52418,443,3013,1661,1352,14,20,8,6
54320,27016,15570,27016,924,924,0,3,30,3,0
56472,53,12167,53,711,87,624,2,30,1,1
5588,5588,0,0,3354,1792,1562,46,192,23,23
56406,53,15140,53,213,102,111,2,30,1,1
52101,443,43263,443,22696,18094,4602,41,315,25,16
58362,53,30634,53,167,78,89,2,30,1,1
57452,53,64588,53,774,101,673,2,30,1,1
65446,53,24128,53,210,110,100,2,30,1,1
56873,53,29966,53,184,94,90,2,30,1,1
40006,80,2393,80,7086,1841,5245,15,92,8,7
52931,443,65247,443,8519,1687,6832,29,17,16,13
49684,443,64157,443,9083,2300,6783,19,56,10,9
49347,443,42711,443,8309,949,7360,19,75,9,10
49160,9703,22798,9703,842,150,692,4,1200,2,2
51964,443,11131,443,5363,2713,2650,26,53,14,12
57027,53,52973,53,170,87,83,2,30,1,1
59218,53,41217,53,511,126,385,2,31,1,1
47661,443,40195,443,3718,420,3298,13,120,6,7
56724,53,33113,53,182,94,88,2,29,1,1
33949,80,17456,80,1360,540,820,20,191,10,10
52148,80,52148,80,62796,1961,60835,72,141,26,46
56610,443,4585,443,8035,2015,6020,20,16,11,9
56534,443,31456,443,3055,993,2062,10,120,5,5
65465,443,59471,443,92040,4799,87241,107,16,43,64
36417,443,45000,443,3579,1914,1665,23,291,8,15
57316,53,57316,53,216,82,134,2,32,1,1
53909,20545,63910,20545,612,366,246,10,19,6,4
44498,53,11053,53,168,78,90,2,30,1,1
57903,443,52416,443,5465,2653,2812,28,169,14,14
58981,443,5501,443,3155,836,2319,13,135,6,7
51205,443,62572,443,8857,2827,6030,52,17,29,23
55975,53,27530,53,939,678,261,2,30,1,1
65439,53,55852,53,751,95,656,2,31,1,1
55014,80,6896,80,1573,1145,428,13,32,8,5
57333,443,55597,443,12837,1681,11156,30,62,16,14
50278,53,13442,53,196,102,94,2,31,1,1
54138,443,3905,443,5702,1212,4490,19,139,10,9
56708,443,38081,443,9634,3110,6524,26,138,11,15
9456,443,36831,443,6096,777,5319,17,25,9,8
49882,80,49056,80,2560,599,1961,13,75,7,6
50098,53,37375,53,199,102,97,2,30,1,1
55244,53,26585,53,184,102,82,2,30,1,1
50289,53,8502,53,189,102,87,2,30,1,1
55223,53,62144,53,168,86,82,2,30,1,1
49410,53,7557,53,178,94,84,2,30,1,1
2321,53,2321,53,216,98,118,2,30,1,1
64020,53,31935,53,196,102,94,2,29,1,1
64773,53,48477,53,328,150,178,2,30,1,1
63999,53,37511,53,193,102,91,2,29,1,1
63385,443,63385,443,4659,1752,2907,19,30,11,8
65396,53,55502,53,186,102,84,2,29,1,1
56929,53,59011,53,177,94,83,2,30,1,1
49942,443,49942,443,29781,5947,23834,63,47,32,31
65366,53,60695,53,198,101,97,2,31,1,1
49932,53,2052,53,289,94,195,2,30,1,1
50272,443,15445,443,8456,2502,5954,32,120,19,13
56493,80,12499,80,65864,3286,62578,76,135,30,46
46716,443,30978,443,7298,2661,4637,21,17,11,10
55267,53,21533,53,168,86,82,2,30,1,1
55060,123,26864,123,184,94,90,2,30,1,1
58843,80,20341,80,1439485,27511,1411974,1308,108,369,939
56724,53,34585,53,308,97,211,4,45,2,2
59175,53,63239,53,168,78,90,2,30,1,1
26900,27017,23576,27017,340,82,258,5,29,2,3
61433,443,18649,443,7796,766,7030,16,27,8,8
56728,443,11785,443,8652,2148,6504,20,15,11,9
37109,80,41807,80,763,434,329,8,14,5,3
47211,80,37416,80,1638,1324,314,10,16,5,5
49879,53,57267,53,517,95,422,4,44,2,2
36336,443,11755,443,8111,5060,3051,31,396,11,20
56704,53,49275,53,177,94,83,2,31,1,1
64722,53,7575,53,184,94,90,2,30,1,1
64025,26826,22306,26826,66,66,0,2,7,2,0
46838,80,4801,80,70,70,0,1,120,1,0
64460,53,42311,53,196,102,94,2,31,1,1
56380,53,35466,53,177,94,83,2,30,1,1
48839,443,60350,443,111590,17663,93927,212,115,93,119
62422,443,30175,443,16258,11067,5191,37,45,21,16
53631,443,46993,443,31965,26754,5211,63,22,34,29
64066,80,28023,80,314,192,122,6,15,4,2
55042,53,54765,53,782,105,677,2,30,1,1
55892,53,8349,53,182,93,89,2,30,1,1
59237,53,43242,53,164,78,86,2,30,1,1
36413,443,33262,443,2064683,47545,2017138,1994,33,657,1337
46408,443,13228,443,15452,3787,11665,36,62,19,17
49225,443,49225,443,854266,56622,797644,969,98,420,549
57015,80,50968,80,1348,844,504,13,255,8,5
52466,443,10561,443,5082,896,4186,16,70,8,8
6881,6881,48403,6881,502,150,352,2,1200,1,1
54990,53,13608,53,168,86,82,2,31,1,1
54511,53,42780,53,304,86,218,2,30,1,1
54322,27015,10656,27015,924,924,0,3,30,3,0
49374,53,45816,53,193,102,91,2,30,1,1
56694,53,29552,53,192,98,94,2,30,1,1
50309,80,22924,80,2481,723,1758,12,57,6,6
51798,80,50477,80,1825,824,1001,21,134,11,10
58830,443,23946,443,5168,700,4468,16,15,7,9
57396,443,55887,443,1054,567,487,10,24,6,4
27005,28002,21197,28002,918,126,792,2,30,1,1
56581,80,13177,80,1630,918,712,12,17,7,5
10038,443,58313,443,7481,2070,5411,25,315,12,13
57240,53,54621,53,180,94,86,2,30,1,1
38641,443,31615,443,318,192,126,6,14,4,2
51887,16514,28256,16514,70,70,0,1,5,1,0
51594,443,50600,443,5854,1148,4706,18,23,10,8
56395,53,54170,53,199,102,97,2,29,1,1
5588,5588,0,0,3354,1792,1562,46,193,23,23
64130,53,8273,53,215,94,121,2,31,1,1
52787,443,46630,443,352,218,134,6,28,4,2
49848,53,25784,53,167,86,81,2,30,1,1
56783,53,3501,53,186,95,91,2,30,1,1
44277,443,64665,443,36026,28458,7568,70,407,30,40
60378,443,48147,443,22073,10774,11299,48,107,26,22
2267,53,35940,53,204,118,86,2,30,1,1
56456,53,17169,53,195,102,93,2,30,1,1
53938,15926,50841,15926,492,306,186,8,15,5,3
57450,53,43406,53,916,86,830,2,31,1,1
55439,53,52898,53,209,110,99,2,30,1,1
56828,53156,57681,53156,70,70,0,2,8,2,0
53660,18599,61340,18599,492,306,186,8,16,5,3
49552,53,39720,53,102,102,0,1,30,1,0
52694,80,51604,80,1960,1366,594,12,34,7,5
34079,443,61674,443,14068,7909,6159,37,82,23,14
60463,6890,27604,6890,70,70,0,1,5,1,0
55243,443,31338,443,36501,26194,10307,76,71,47,29
50277,443,65171,443,268,120,148,5,11,3,2
40766,443,50985,443,1093,662,431,10,41,6,4
52017,26175,30441,26175,66,66,0,1,5,1,0
56754,443,40687,443,9868,2027,7841,24,20,12,12
6666,2222,6666,2222,130,66,64,2,5,1,1
49418,26259,63056,26259,254,78,176,2,30,1,1
52080,9554,43185,9554,70,70,0,1,5,1,0
55018,53,31411,53,174,89,85,2,30,1,1
32846,80,52606,80,1644,1324,320,10,15,5,5
51715,80,53478,80,3309,2152,1157,18,150,10,8
56374,53,54087,53,711,87,624,2,30,1,1
56722,443,4374,443,7941,1952,5989,20,15,11,9
55634,58846,20945,58846,70,70,0,1,5,1,0
53130,80,42031,80,3683,606,3077,12,15,6,6
52103,7172,64684,7172,70,70,0,2,7,2,0
44363,443,4525,443,10667,2992,7675,32,560,17,15
51764,80,40729,80,5605,3306,2299,21,74,13,8
55182,443,46108,443,2970,1689,1281,24,18,13,11
65107,53,53716,53,193,102,91,2,30,1,1
54819,443,51134,443,8093,1263,6830,25,39,13,12
60016,443,40510,443,134,60,74,3,6,2,1
49210,80,26357,80,2965,715,2250,9,75,5,4
50549,80,64687,80,378,192,186,7,21,4,3
48817,6889,48817,6889,1283,666,617,6,1200,3,3
56694,443,2147,443,3723,2372,1351,18,18,10,8
49436,53,61599,53,718,94,624,2,30,1,1
57422,53,50721,53,747,90,657,2,30,1,1
41906,80,41906,80,127215,3221,123994,137,3685,42,95
56271,53,27532,53,195,102,93,2,29,1,1
27005,27015,19164,27015,871,126,745,2,31,1,1
56681,53,9758,53,195,102,93,2,30,1,1
52997,443,41046,443,10754,4129,6625,42,112,20,22
60439,47783,16622,47783,70,70,0,2,8,2,0
49182,53,44371,53,211,102,109,2,30,1,1
57504,443,39017,443,5238,695,4543,14,25,8,6
53027,443,45299,443,26309,3035,23274,69,92,27,42
56767,53,44423,53,177,94,83,2,30,1,1
50374,53,63648,53,755,102,653,2,29,1,1
49528,53,46480,53,170,87,83,2,30,1,1
64710,53,46845,53,393,110,283,2,30,1,1
63963,53,7667,53,262,86,176,4,46,2,2
50584,55624,58737,55624,1326,300,1026,6,1200,3,3
32899,443,18208,443,47948,40338,7610,82,17,43,39
49576,80,3769,80,318,192,126,6,43,4,2
48726,80,33900,80,1794,1480,314,13,15,8,5
40510,1488,40510,1488,156,156,0,3,7,3,0
55588,53,33228,53,168,86,82,2,30,1,1
46384,443,46384,443,4594,1687,2907,19,30,11,8
52126,56057,8315,56057,70,70,0,1,5,1,0
35201,53,32554,53,308,118,190,2,30,1,1
64995,27023,24538,27023,1773,924,849,6,30,3,3
65466,53,31281,53,200,102,98,2,33,1,1
57149,443,55393,443,1647,1375,272,9,37,5,4
40633,53,51896,53,168,78,90,2,30,1,1
50443,80,16210,80,378,192,186,7,19,4,3
56704,53,19637,53,188,96,92,2,31,1,1
49830,443,7649,443,6131,1960,4171,18,15,10,8
65513,53,29862,53,195,102,93,2,31,1,1
49826,53,26730,53,650,286,364,8,84,4,4
55800,53,5218,53,177,94,83,2,30,1,1
50361,80,40866,80,318,192,126,6,28,4,2
53870,24535,51626,24535,70,70,0,1,5,1,0
60620,80,60620,80,1916,1467,449,10,19,6,4
55372,53,13857,53,271,93,178,4,42,2,2
50413,123,48114,123,184,94,90,2,31,1,1
49693,53,65326,53,209,110,99,2,30,1,1
56081,53,45307,53,237,94,143,2,29,1,1
35041,80,18613,80,3515,1137,2378,12,30,7,5
60777,40010,8810,40010,316,136,180,6,6,3,3
53187,443,36781,443,5244,1925,3319,33,21,17,16
49418,37579,44074,37579,239,71,168,2,30,1,1
49835,53,19938,53,194,102,92,2,30,1,1
49696,53,9591,53,178,94,84,2,30,1,1
49209,53,10202,53,198,101,97,2,31,1,1
30188,33285,47903,33285,502,150,352,2,1200,1,1
65142,53,52457,53,167,86,81,2,30,1,1
57235,53,31902,53,210,102,108,2,30,1,1
58865,443,1630,443,505070,16437,488633,543,45,187,356
37510,443,18789,443,8619,2288,6331,41,361,16,25
49558,53,10290,53,193,102,91,2,30,1,1
43415,443,53448,443,130,70,60,2,15,1,1
38728,53,38728,53,414,268,146,3,33,2,1
63875,43485,59709,43485,312,132,180,6,6,3,3
60308,443,63284,443,2622412,144918,2477494,3052,316,1078,1974
56397,53,56445,53,179,94,85,2,31,1,1
40102,443,45271,443,29714,2090,27624,43,97,17,26
49653,443,56043,443,8915,2193,6722,22,46,13,9
38102,5228,57941,5228,4235,1797,2438,38,4443,13,25
64631,53,8154,53,193,102,91,2,30,1,1
58178,53,58178,53,237,93,144,2,31,1,1
42601,443,30864,443,10845900,123386,10722514,8862,139,1081,7781
34062,443,2265,443,3208,2015,1193,19,34,11,8
15503,52798,43633,52798,28448,16525,11923,253,3696,148,105
60226,443,32684,443,1907736,31488,1876248,1747,21,470,1277
64753,443,41377,443,145226,5591,139635,164,120,58,106
56720,443,60130,443,4989,1014,3975,16,53,9,7
55917,53,22277,53,177,94,83,2,30,1,1
55498,53,58802,53,170,87,83,2,30,1,1
49353,443,32645,443,7030,1195,5835,20,76,10,10
56745,80,35194,80,214,140,74,4,25,3,1
57083,53,19689,53,198,102,96,2,30,1,1
49852,53,8412,53,94,94,0,1,29,1,0
64711,53,30437,53,179,86,93,2,30,1,1
57169,53,55485,53,177,94,83,2,30,1,1
50501,443,19632,443,1499,930,569,16,78,9,7
57163,443,13914,443,1779,1375,404,11,40,5,6
64139,53,9779,53,498,93,405,4,47,2,2
49165,5938,24586,5938,143727,72050,71677,1106,10824,655,451
53605,13468,23024,13468,70,70,0,2,7,2,0
65140,53,14372,53,199,102,97,2,30,1,1
51000,443,65422,443,6544,939,5605,17,17,10,7
56772,53,27354,53,168,86,82,2,30,1,1
54137,443,48423,443,2573,330,2243,12,136,5,7
64828,53,62244,53,260,102,158,2,30,1,1
51894,26116,38290,26116,70,70,0,2,8,2,0
50497,443,60901,443,1322,725,597,14,78,7,7
64985,53,37843,53,194,102,92,2,30,1,1
44636,443,35730,443,6297,1831,4466,20,16,9,11
53682,20884,39828,20884,70,70,0,2,7,2,0
51087,80,58473,80,6363,3093,3270,36,130,19,17
59778,443,59778,443,4580,1673,2907,19,28,11,8
50038,443,53552,443,2652,1566,1086,15,86,9,6
49903,443,42458,443,8078,1511,6567,30,54,14,16
41700,443,15367,443,167721,6935,160786,185,77,68,117
59122,80,13058,80,2865,2000,865,12,16,7,5
57051,53,27315,53,170,87,83,2,31,1,1
64964,53,28757,53,197,102,95,2,31,1,1
58673,443,29883,443,11116,2910,8206,30,20,16,14
51487,443,12254,443,828,390,438,11,60,4,7
51602,443,19598,443,2013,1363,650,12,134,7,5
34758,5228,2453,5228,10206,2218,7988,36,4265,18,18
56788,443,35911,443,22508,1965,20543,32,17,13,19
56909,53,4449,53,260,86,174,2,30,1,1
51083,5223,18916,5223,4070,1456,2614,26,2889,15,11
49522,443,58242,443,2731084,2639957,91127,2979,151,1945,1034
46596,443,51995,443,4146,2690,1456,31,37,16,15
44846,53,44846,53,86,86,0,1,30,1,0
50368,53,59190,53,70,70,0,1,30,1,0
38413,53,37201,53,199,94,105,2,29,1,1
53677,10657,26875,10657,70,70,0,2,8,2,0
49348,53,24608,53,194,102,92,2,31,1,1
51500,443,60787,443,451,259,192,5,23,2,3
64850,53,49939,53,196,102,94,2,30,1,1
56673,53,10759,53,193,102,91,2,30,1,1
37625,443,14545,443,7766,1810,5956,24,46,14,10
55712,53,52427,53,164,86,78,2,29,1,1
51953,443,64481,443,8900,2020,6880,28,25,15,13
49759,53,28731,53,216,110,106,2,30,1,1
45540,8100,31556,8100,78,78,0,1,4,1,0
65108,53,46911,53,195,94,101,2,29,1,1
37585,443,50718,443,499,425,74,4,2,3,1
50649,80,63151,80,1366,865,501,8,15,5,3
54955,53,54702,53,177,94,83,2,29,1,1
64789,53,62569,53,816,102,714,2,30,1,1
50265,44843,10747,44843,70,70,0,1,1200,1,0
21276,53,21276,53,244,98,146,2,33,1,1
55067,443,38448,443,3136,2025,1111,19,26,10,9
27176,53,64798,53,396,257,139,3,30,2,1
64769,53,55242,53,418,150,268,2,30,1,1
55337,443,21717,443,24341,15170,9171,78,461,39,39
35459,443,23832,443,119911,5690,114221,153,173,63,90
57470,22838,37190,22838,481,150,331,2,1199,1,1
64021,53,18880,53,195,102,93,2,29,1,1
57354,53,26026,53,177,94,83,2,29,1,1
55725,14704,64431,14704,70,70,0,1,5,1,0
41632,443,12669,443,7670,2131,5539,30,27,15,15
58772,443,9884,443,5106,700,4406,15,15,7,8
60059,53,45306,53,168,78,90,2,30,1,1
55318,53,12855,53,167,86,81,2,30,1,1
36433,80,4245,80,1585,863,722,12,15,6,6
53605,443,11722,443,8738,2628,6110,23,154,11,12
49146,443,34396,443,3655,1807,1848,17,15,9,8
49379,80,26229,80,6307,2851,3456,18,150,9,9
50011,53,7545,53,766,102,664,2,30,1,1
28235,443,3343,443,8830,2388,6442,29,124,14,15
49558,53,18984,53,177,94,83,2,30,1,1
55611,53,41439,53,768,200,568,6,53,3,3
46189,443,46189,443,4398,1491,2907,19,30,11,8
34671,53,40615,53,168,78,90,2,30,1,1
35814,443,26348,443,5205,1251,3954,18,15,10,8
56025,53,63426,53,761,100,661,2,30,1,1
64962,53,48454,53,226,94,132,2,30,1,1
49741,443,56871,443,6060,1553,4507,18,129,10,8
6881,48947,47849,48947,228,118,110,2,1199,1,1
46898,53,46898,53,194,87,107,2,30,1,1
64530,53,39688,53,261,87,174,4,46,2,2
6973,80,6973,80,132958,3923,129035,143,38,53,90
53713,26085,40044,26085,70,70,0,1,5,1,0
14205,53,14205,53,233,91,142,2,31,1,1
50625,80,24486,80,8688,4248,4440,56,131,34,22
52113,19619,19801,19619,70,70,0,1,4,1,0
53759,80,20494,80,997,582,415,11,315,6,5
51847,32112,38487,32112,70,70,0,2,9,2,0
56254,80,61838,80,1196,682,514,12,15,6,6
33228,443,46001,443,2567,1173,1394,19,179,8,11
53802,59932,27956,59932,320,140,180,6,6,3,3
56655,80,36577,80,234,234,0,4,12,4,0
49206,443,56721,443,7875,1817,6058,41,255,19,22
65257,443,11599,443,4019,708,3311,16,137,7,9
55022,53,15240,53,195,102,93,2,30,1,1
64070,53,27144,53,258,110,148,2,30,1,1
55745,53,56029,53,199,102,97,2,30,1,1
49480,53,4215,53,168,78,90,2,29,1,1
54124,443,47726,443,13210,3034,10176,47,153,19,28
55312,443,20877,443,7952,3638,4314,36,149,17,19
63902,22928,21119,22928,504,382,122,8,15,6,2
55003,443,26179,443,7925,2114,5811,27,37,16,11
38970,443,29135,443,4144,2479,1665,19,361,10,9
50292,80,5743,80,442,250,192,8,44,5,3
59089,443,40663,443,77560,5020,72540,93,121,34,59
64554,53,13352,53,199,102,97,2,29,1,1
53782,443,62733,443,499,425,74,4,0,3,1
56104,53,14895,53,204,104,100,2,30,1,1
56426,53,19941,53,184,94,90,2,31,1,1
64791,443,34950,443,4725,1727,2998,11,121,6,5
64561,53,25485,53,270,94,176,2,30,1,1
53755,45416,43327,45416,320,140,180,6,6,3,3
26499,80,26499,80,168957,11365,157592,202,31,90,112
55236,53,27697,53,196,102,94,2,29,1,1
63937,53,33435,53,183,94,89,2,30,1,1
41166,443,62560,443,8933,1938,6995,21,16,12,9
53830,443,40467,443,499,425,74,4,0,3,1
57353,443,50919,443,70,70,0,1,5,1,0
64912,53,63953,53,356,118,238,2,30,1,1
50072,443,58353,443,827,484,343,8,15,5,3
60944,443,4014,443,5081,896,4185,16,70,8,8
64715,53,61600,53,209,110,99,2,30,1,1
56409,53,61903,53,199,102,97,2,31,1,1
65514,53,32610,53,214,110,104,2,31,1,1
59000,443,41990,443,9876,5325,4551,25,131,14,11
54957,53,32234,53,102,102,0,1,30,1,0
50466,53,34951,53,199,102,97,2,30,1,1
60385,59696,28455,59696,70,70,0,2,8,2,0
50395,443,41606,443,6205,2761,3444,25,28,14,11
49246,53,51289,53,164,86,78,2,31,1,1
64540,53,45439,53,179,94,85,2,30,1,1
55677,53,14201,53,177,94,83,2,29,1,1
54259,443,22869,443,7508,2864,4644,18,75,11,7
65466,53,26406,53,248,94,154,2,30,1,1
52221,53,60196,53,164,78,86,2,29,1,1
55646,53,39790,53,760,97,663,2,31,1,1
52621,443,59205,443,190,70,120,4,15,2,2
52912,53,52912,53,237,91,146,2,32,1,1
47092,15000,12405,15000,138,78,60,2,5,1,1
50443,53,37606,53,788,108,680,2,31,1,1
56374,53,12810,53,177,94,83,2,29,1,1
2980,53,2980,53,216,90,126,2,30,1,1
55067,53,2725,53,164,84,80,2,31,1,1
49620,53,9957,53,211,110,101,2,29,1,1
48754,80,48754,80,560,264,296,9,44,5,4
27563,443,27563,443,1181,722,459,10,147,6,4
52729,443,62575,443,9026,3447,5579,50,45,26,24
49372,53,57735,53,210,110,100,2,30,1,1
56804,53,22833,53,760,96,664,2,31,1,1
38329,80,52994,80,350,210,140,6,16,4,2
39345,80,26537,80,918,461,457,9,16,6,3
55147,53,9806,53,184,94,90,2,30,1,1
56608,443,21691,443,10062,1631,8431,25,19,14,11
50324,443,9934,443,8725,2284,6441,17,120,8,9
49844,80,65486,80,18950,788,18162,23,89,8,15
50944,443,50944,443,1210,637,573,14,25,7,7
65528,53,22092,53,199,86,113,2,29,1,1
43686,443,17205,443,6804,914,5890,22,257,10,12
55064,443,12029,443,12611,3681,8930,26,61,15,11
56117,53,32150,53,178,94,84,2,31,1,1
49949,53,60223,53,186,95,91,2,31,1,1
59861,443,36199,443,2128,828,1300,19,40,8,11
51819,80,5456,80,5368,946,4422,16,77,9,7
6527,53,6527,53,235,90,145,2,32,1,1
30960,45737,31575,45737,330,330,0,6,3609,6,0
52045,443,60420,443,51604,4684,46920,70,133,28,42
46554,5228,16651,5228,4520,2520,2000,40,3961,20,20
65138,53,38637,53,765,102,663,2,30,1,1
56948,53,35699,53,93,93,0,1,30,1,0
55649,53,24364,53,216,110,106,2,30,1,1
53482,53,51944,53,168,78,90,2,30,1,1
64897,53,54215,53,312,94,218,2,30,1,1
46014,53,46014,53,414,268,146,3,33,2,1
55702,53,21809,53,761,100,661,2,31,1,1
49205,443,49232,443,512444,20822,491622,555,159,191,364
65504,53,23026,53,193,102,91,2,30,1,1
65090,53,43740,53,209,102,107,2,30,1,1
53671,80,50539,80,956,502,454,12,15,7,5
45440,25,45440,25,7679,1922,5757,34,17,15,19
55415,53,7035,53,183,94,89,2,30,1,1
56579,53,36844,53,288,94,194,2,30,1,1
58985,443,13213,443,9218,1776,7442,28,23,13,15
51976,11816,28383,11816,70,70,0,1,5,1,0
57106,443,27171,443,38893,31305,7588,107,101,55,52
50899,80,62536,80,13974043,173337,13800706,11715,134,2429,9286
40749,5222,28403,5222,3474,915,2559,34,685,10,24
65241,53,1849,53,198,102,96,2,30,1,1
44847,51365,14892,51365,509,150,359,2,1200,1,1
63819,18445,34551,18445,70,70,0,1,4,1,0
64992,53,21333,53,177,94,83,2,29,1,1
42166,443,27279,443,4057,966,3091,14,31,8,6
57043,53,58233,53,166,86,80,2,30,1,1
55889,53,49760,53,198,101,97,2,31,1,1
27005,1402,23160,1402,870,126,744,2,29,1,1
52205,24416,50314,24416,136,136,0,3,13,3,0
65342,53,59254,53,183,94,89,2,30,1,1
54159,443,24398,443,4723,2593,2130,16,137,8,8
62066,443,9765,443,3150,831,2319,13,135,6,7
49932,53,14546,53,195,102,93,2,30,1,1
54993,53,49299,53,410,109,301,4,32,2,2
55437,443,56917,443,24415,1491,22924,34,131,14,20
55040,443,2837,443,8558,1869,6689,31,236,14,17
49783,53,20382,53,174,89,85,2,31,1,1
11319,443,11319,443,179461,16904,162557,220,36,105,115
64569,53,17459,53,183,94,89,2,30,1,1
51893,63924,1367,63924,70,70,0,1,5,1,0
48673,443,24154,443,18147,9173,8974,42,175,24,18
60855,443,10736,443,598135,40549,557586,873,251,326,547
50310,80,45251,80,2958,1116,1842,15,83,8,7
44320,443,45352,443,1657,1128,529,15,35,9,6
65078,53,50659,53,177,94,83,2,30,1,1
37066,443,58040,443,9705,4332,5373,32,321,17,15
59629,80,40534,80,1652,1264,388,10,17,4,6
41128,443,53510,443,3474,2349,1125,29,3438,17,12
46486,53,46486,53,414,268,146,3,34,2,1
56005,53,10080,53,199,102,97,2,30,1,1
49524,80,21220,80,1401,828,573,11,38,6,5
55384,53,51117,53,194,102,92,2,30,1,1
64422,53,42337,53,176,90,86,2,30,1,1
63981,53,39748,53,329,86,243,4,42,2,2
27005,27016,63808,27016,879,126,753,2,30,1,1
49165,53,17672,53,212,102,110,2,29,1,1
55329,443,60850,443,18284,2468,15816,42,26,22,20
40923,53,40923,53,200,90,110,2,29,1,1
59938,443,27868,443,1820,1303,517,13,26,7,6
57321,443,61348,443,5613,733,4880,16,14,9,7
64739,53,1998,53,816,102,714,2,30,1,1
55818,443,58281,443,5100,2001,3099,15,119,7,8
57346,53,23622,53,210,110,100,2,29,1,1
48590,443,14073,443,3538,2083,1455,17,256,9,8
56477,443,27592,443,5638,2934,2704,15,120,7,8
50654,80,39837,80,3728,1504,2224,13,21,7,6
65524,443,51488,443,282968,9210,273758,296,15,106,190
64755,443,45264,443,23561,3667,19894,40,121,19,21
50005,53,14000,53,199,102,97,2,30,1,1
42665,80,22230,80,7651,2046,5605,16,91,10,6
51909,80,5336,80,6057,4543,1514,16,15,9,7
38445,443,60732,443,23571,4700,18871,60,48,30,30
45563,443,24709,443,1022491,42917,979574,1099,36,416,683
47879,443,13971,443,37598,2397,35201,53,239,22,31
0,0,0,0,244,244,0,2,0,2,0
55130,53,9076,53,216,110,106,2,31,1,1
65471,53,5865,53,441,90,351,4,48,2,2
65515,53,18245,53,195,102,93,2,31,1,1
58956,80,51257,80,2493,1830,663,12,15,6,6
53583,15354,6378,15354,70,70,0,2,7,2,0
56775,20617,28248,20617,70,70,0,2,8,2,0
65353,53,60832,53,170,87,83,2,30,1,1
65155,53,63407,53,295,103,192,4,49,2,2
57359,53,20340,53,458,188,270,6,31,3,3
49752,53,64105,53,193,102,91,2,30,1,1
56318,53,8880,53,182,93,89,2,31,1,1
56748,53,43623,53,184,94,90,2,31,1,1
59405,443,1405,443,276,70,206,5,26,2,3
64958,53,26216,53,194,99,95,2,31,1,1
43892,443,53731,443,9754,4277,5477,27,330,14,13
56464,443,4268,443,5058,913,4145,17,25,10,7
61119,53,61119,53,217,90,127,2,29,1,1
57266,53,22077,53,209,102,107,2,30,1,1
15503,27645,52952,27645,480,149,331,2,1200,1,1
59787,443,23637,443,276238,23971,252267,482,138,188,294
56832,23900,53161,23900,130,70,60,2,5,1,1
11295,40040,53425,40040,213,89,124,4,54,2,2
58924,443,40571,443,5168,700,4468,16,15,7,9
65025,53,23591,53,347,94,253,2,30,1,1
5588,5588,0,0,3354,1792,1562,46,194,23,23
62293,53,18482,53,232,88,144,2,31,1,1
29413,53,29413,53,217,82,135,2,32,1,1
52036,52608,31210,52608,70,70,0,1,4,1,0
53155,28206,42266,28206,70,70,0,2,8,2,0
49963,53,58470,53,564,191,373,6,62,3,3
60440,53830,1700,53830,320,140,180,6,6,3,3
56156,53,34308,53,711,87,624,2,31,1,1
40254,443,35283,443,7646,1024,6622,19,15,11,8
58088,8765,45865,8765,336,150,186,6,89,3,3
50883,80,64742,80,204646,11741,192905,240,141,104,136
64036,53,28611,53,360,93,267,4,57,2,2
50325,80,35970,80,2535,783,1752,13,48,7,6
53763,50144,49298,50144,492,306,186,8,16,5,3
5588,5588,0,0,3354,1792,1562,46,195,23,23
49042,443,19321,443,5792,1764,4028,24,31,14,10
55816,53,3790,53,214,110,104,2,31,1,1
55760,53,12734,53,182,94,88,2,30,1,1
56024,53,53250,53,711,87,624,2,30,1,1
56101,53,1484,53,188,96,92,2,40,1,1
49418,27018,39372,27018,259,71,188,2,31,1,1
49771,53,64611,53,272,110,162,2,30,1,1
5233,22683,23073,22683,832,832,0,14,95,14,0
65499,53,27912,53,182,102,80,2,30,1,1
53609,38060,12354,38060,70,70,0,2,8,2,0
56561,53,4757,53,166,85,81,2,31,1,1
51990,42127,13506,42127,70,70,0,2,8,2,0
36699,443,33647,443,11086707,166045,10920662,9176,172,1285,7891
38300,443,24962,443,200383,4673,195710,196,30,58,138
65278,53,33473,53,403,91,312,4,34,2,2
53256,443,33815,443,6185,1994,4191,27,16,16,11
49364,80,23008,80,1614,1300,314,10,15,5,5
53647,16194,65302,16194,70,70,0,2,8,2,0
53093,443,27460,443,6774,3651,3123,35,80,18,17
56710,53,43417,53,190,97,93,2,31,1,1
36368,80,60128,80,78,78,0,1,5,1,0
5588,5588,0,0,3354,1792,1562,46,194,23,23
40893,443,32829,443,10450,3898,6552,20,135,11,9
64639,53,21872,53,199,102,97,2,30,1,1
64803,53,39873,53,102,102,0,1,30,1,0
50676,80,23134,80,13054,6885,6169,27,26,13,14
27005,27057,3516,27057,917,126,791,2,31,1,1
36079,53,36079,53,235,90,145,2,32,1,1
21133,41620,37961,41620,150,150,0,1,1199,1,0
52025,80,59666,80,87927,9680,78247,101,37,40,61
47612,5228,36863,5228,2880,1648,1232,22,3602,10,12
64102,53,25876,53,274,94,180,2,29,1,1
57174,53,49887,53,293,86,207,2,29,1,1
49505,53,42199,53,225,110,115,2,30,1,1
49472,53,22827,53,751,95,656,2,31,1,1
51831,26270,17546,26270,70,70,0,1,5,1,0
55665,443,34619,443,6291,1499,4792,22,17,11,11
65070,53,12563,53,198,102,96,2,30,1,1
49728,443,15564,443,7626,1676,5950,29,63,10,19
49934,53,41301,53,752,93,659,2,30,1,1
47438,80,47438,80,2886,1481,1405,10,15,6,4
43412,443,47585,443,2423,1465,958,18,171,10,8
53041,443,37580,443,7263,1834,5429,27,16,15,12
27008,443,27008,443,1251,722,529,11,147,6,5
51968,443,63060,443,5315,3154,2161,56,47,32,24
52150,80,40663,80,546,300,246,10,32,6,4
63952,50734,27783,50734,70,70,0,1,5,1,0
60241,80,52293,80,29924,6743,23181,37,150,16,21
50345,80,27840,80,736,670,66,6,15,5,1
59397,443,43163,443,3218,1700,1518,16,15,8,8
27005,30008,37635,30008,881,126,755,2,30,1,1
60363,443,28558,443,5214,1101,4113,22,123,12,10
63923,59177,22656,59177,70,70,0,1,4,1,0
63586,443,51785,443,12760,2205,10555,39,122,21,18
41842,443,41842,443,4707,1800,2907,19,28,11,8
38678,443,31559,443,484,210,274,8,26,4,4
49692,53,30173,53,212,110,102,2,30,1,1
57294,443,32624,443,122959,4611,118348,142,150,51,91
57344,53,44764,53,228,110,118,2,30,1,1
51403,443,50805,443,190,70,120,4,8,2,2
52111,53162,33838,53162,1330,706,624,10,33,6,4
63464,443,46979,443,24271,2640,21631,38,123,16,22
56778,35292,48198,35292,70,70,0,1,5,1,0
57894,443,52904,443,4544,1112,3432,21,176,12,9
48458,53,30263,53,168,78,90,2,31,1,1
56627,443,11832,443,7889,1900,5989,20,15,11,9
38672,443,23620,443,4478,1133,3345,13,35,8,5
65236,53,60243,53,247,118,129,2,30,1,1
56263,53,42126,53,214,110,104,2,30,1,1
60976,443,6084,443,5027222,114898,4912324,4763,109,1375,3388
65498,53,22566,53,752,93,659,2,31,1,1
63964,53,34726,53,195,102,93,2,30,1,1
38280,443,38280,443,3333,2072,1261,21,148,12,9
53150,43918,23563,43918,320,140,180,6,6,3,3
56292,53,5398,53,197,102,95,2,29,1,1
51717,63436,12791,63436,70,70,0,2,8,2,0
49442,53,12597,53,326,110,216,2,30,1,1
64370,443,23826,443,2783,692,2091,10,120,5,5
52652,443,14258,443,14511,4628,9883,29,559,15,14
37790,443,42788,443,448,78,370,6,25,1,5
59937,443,15432,443,7701,3981,3720,27,70,12,15
61500,443,52553,443,14738,2175,12563,24,16,10,14
37321,443,3162,443,70,70,0,1,5,1,0
35178,8635,35178,8635,138,78,60,2,5,1,1
55052,443,42502,443,4425,876,3549,15,29,8,7
20957,53,20957,53,216,90,126,2,30,1,1
44710,443,12033,443,13320,3575,9745,38,26,19,19
53437,6057,54615,6057,245,245,0,2,30,2,0
60973,443,19022,443,398300,18473,379827,492,72,222,270
59898,443,27640,443,1265,684,581,13,30,6,7
51377,443,25439,443,2838,944,1894,12,135,7,5
49482,53,61985,53,460,84,376,4,46,2,2
60522,443,60522,443,1088,641,447,10,25,6,4
56738,53,53123,53,242,110,132,2,29,1,1
46308,123,1425,123,184,94,90,2,30,1,1
55692,53,51127,53,198,102,96,2,30,1,1
17282,7000,17282,7000,2163,676,1487,14,15,7,7
57253,53,25140,53,199,102,97,2,29,1,1
0,0,0,0,244,244,0,2,0,2,0
52939,443,34090,443,16053,6801,9252,51,115,26,25
56611,53,54736,53,181,94,87,2,32,1,1
50642,80,53491,80,27013,3578,23435,36,21,15,21
65075,53,1890,53,278,100,178,4,31,2,2
49406,53,22949,53,215,102,113,2,30,1,1
49700,443,48800,443,64,64,0,2,5,2,0
65496,443,16540,443,92799,4939,87860,111,16,45,66
56733,53,13870,53,170,87,83,2,30,1,1
49718,443,50184,443,7644833,215496,7429337,8664,135,2509,6155
3669,53,3669,53,825,99,726,2,30,1,1
53136,5228,42128,5228,26821,4295,22526,95,5045,40,55
2267,53,42129,53,204,118,86,2,31,1,1
51666,443,15224,443,3256,2213,1043,16,15,8,8
49207,58751,38431,58751,70,70,0,1,5,1,0
65304,53,24960,53,195,102,93,2,31,1,1
35833,443,20943,443,5524,1857,3667,27,3652,9,18
25871,53,25871,53,266,72,194,2,30,1,1
55944,53,13576,53,194,94,100,2,30,1,1
55828,53,17599,53,181,94,87,2,30,1,1
55065,53,9474,53,168,78,90,2,30,1,1
48817,51234,48817,51234,158,158,0,1,1200,1,0
49487,443,25025,443,72073,12550,59523,78,45,25,53
49601,53,44219,53,178,94,84,2,30,1,1
58856,443,60071,443,2694,1614,1080,14,386,8,6
63850,6881,54520,6881,66,66,0,2,7,2,0
55230,443,41463,443,39555,12054,27501,78,66,41,37
56750,53,56750,53,217,87,130,2,30,1,1
57432,66,52808,66,70,70,0,1,5,1,0
53248,443,8243,443,5995,974,5021,19,66,10,9
49843,80,51294,80,2901,1805,1096,17,108,13,4
49156,53,27997,53,304,118,186,2,30,1,1
65381,53,45140,53,241,110,131,2,30,1,1
56733,53,47115,53,187,98,89,3,52,2,1
64281,53,41166,53,492,90,402,4,45,2,2
59808,443,49702,443,147637,6160,141477,164,121,56,108
65212,53,30386,53,196,102,94,2,30,1,1
55006,53,44866,53,789,110,679,2,30,1,1
51077,80,9544,80,9133,1055,8078,17,151,8,9
64586,53,21236,53,173,94,79,2,30,1,1
37996,49152,50684,49152,156,156,0,3,8,3,0
55377,3389,55377,3389,3343,1454,1889,15,16,8,7
55354,53,24160,53,168,94,74,2,30,1,1
43298,53,31678,53,199,94,105,2,30,1,1
34630,443,65434,443,12120,5747,6373,22,120,10,12
56343,53,58460,53,194,102,92,2,31,1,1
25150,53,25150,53,217,87,130,2,30,1,1
26467,6969,47386,6969,192,192,0,4,1200,4,0
54617,443,54617,443,3186,1836,1350,16,17,10,6
39287,53,1937,53,198,93,105,2,30,1,1
64675,53,55719,53,749,94,655,2,31,1,1
56772,443,38284,443,7889,1900,5989,20,15,11,9
50408,53,52200,53,182,93,89,2,30,1,1
64321,53,31319,53,190,97,93,2,31,1,1
58183,443,49158,443,841459,41656,799803,1083,141,389,694
65220,53,55029,53,178,94,84,2,30,1,1
51956,36995,10789,36995,66,66,0,1,5,1,0
56312,53,57178,53,214,102,112,2,29,1,1
51900,80,40398,80,366,240,126,7,29,5,2
55718,16805,50581,16805,70,70,0,1,5,1,0
56114,53,59313,53,216,110,106,2,30,1,1
56830,53,55667,53,195,102,93,2,30,1,1
54951,443,21945,443,69882,3520,66362,96,320,38,58
54967,53,27983,53,178,94,84,2,30,1,1
65083,53,18755,53,198,94,104,2,30,1,1
49383,53,39251,53,758,102,656,2,30,1,1
56855,64607,58491,64607,316,136,180,6,6,3,3
65444,53,15259,53,86,86,0,1,30,1,0
53722,6881,24173,6881,552,306,246,9,15,5,4
65136,53,56790,53,335,84,251,4,32,2,2
64804,53,12585,53,383,97,286,4,58,2,2
59748,53,55446,53,230,110,120,2,29,1,1
55647,53,53361,53,250,86,164,4,31,2,2
37965,1052,51562,1052,132,132,0,3,1199,3,0
34340,443,16904,443,3497,1845,1652,18,16,9,9
37665,443,54006,443,8134,2717,5417,24,16,15,9
55773,53,49268,53,97,97,0,1,60,1,0
59799,443,7688,443,10642,1102,9540,25,27,11,14
35292,443,36726,443,4866,3323,1543,25,94,14,11
33641,443,2360,443,15017,6951,8066,49,20,25,24
49236,53,51973,53,377,94,283,2,30,1,1
61304,443,62811,443,8594,1042,7552,16,120,7,9
49279,53,50429,53,199,102,97,2,29,1,1
51945,443,60723,443,8830,1950,6880,27,25,14,13
49418,27018,36116,27018,256,78,178,2,30,1,1
14430,443,35759,443,2629,1470,1159,18,15,8,10
41850,443,17792,443,6714,1515,5199,23,196,13,10
55763,53,36537,53,197,94,103,2,31,1,1
59396,443,16679,443,5801,1995,3806,19,16,10,9
34429,443,39079,443,1701,1048,653,15,38,8,7
50582,80,50582,80,6647,4891,1756,23,21,13,10
57629,443,51109,443,14555,5048,9507,82,134,33,49
52573,80,52573,80,3487,696,2791,13,142,6,7
61637,53,32273,53,82,82,0,2,31,2,0
42298,40032,22903,40032,720,549,171,4,30,2,2
62820,53,62820,53,237,91,146,2,33,1,1
54926,6789,33904,6789,124239,48650,75589,1342,84,628,714
49685,443,41646,443,8435,1687,6748,30,76,14,16
63938,26204,5698,26204,66,66,0,2,7,2,0
51824,80,16784,80,15487,8701,6786,29,44,17,12
49355,53,6777,53,168,86,82,2,29,1,1
60270,80,22290,80,1528,946,582,11,149,6,5
57211,443,58131,443,25881,12394,13487,221,579,105,116
49881,53,28896,53,213,102,111,2,30,1,1
64929,53,59059,53,168,86,82,2,30,1,1
26900,27017,57216,27017,422,164,258,6,30,3,3
64561,53,17308,53,461,91,370,4,60,2,2
50040,53,5250,53,193,102,91,2,30,1,1
26900,27017,3690,27017,422,164,258,6,30,3,3
55548,53,39542,53,197,102,95,2,35,1,1
44211,443,12188,443,6263,1804,4459,21,361,11,10
61680,443,50542,443,12015,3771,8244,41,18,23,18
65400,53,61482,53,211,102,109,2,30,1,1
62486,53,59489,53,102,102,0,1,30,1,0
51591,80,40282,80,12683,8567,4116,53,271,33,20
59739,443,20531,443,304,86,218,2,30,1,1
48627,443,55025,443,638,70,568,10,207,2,8
10007,40005,19403,40005,148,86,62,2,31,1,1
55722,53,10365,53,229,110,119,2,30,1,1
57152,53,2032,53,183,94,89,2,30,1,1
49418,32036,34122,32036,243,78,165,2,30,1,1
55722,26192,12187,26192,70,70,0,2,8,2,0
8432,23,8432,23,130,66,64,2,5,1,1
64126,53,25754,53,255,102,153,2,30,1,1
65118,53,14399,53,539,91,448,4,43,2,2
49962,53,58375,53,184,94,90,2,31,1,1
56878,53,41614,53,168,86,82,2,30,1,1
34170,80,4419,80,2865,2000,865,12,16,7,5
49431,53,23067,53,353,94,259,2,30,1,1
51272,12210,15332,12210,70,70,0,1,5,1,0
56382,53,19333,53,190,97,93,2,31,1,1
57366,53,60542,53,458,188,270,6,31,3,3
60875,443,9147,443,45373,35377,9996,88,72,48,40
49926,53,63439,53,180,94,86,2,30,1,1
60502,443,31971,443,416,210,206,7,28,4,3
56689,443,17106,443,4857,3938,919,18,81,11,7
39422,80,48610,80,1057,683,374,10,15,6,4
49823,53,45548,53,202,103,99,2,31,1,1
55004,443,44724,443,7960,2219,5741,27,35,16,11
49456,53,27659,53,360,110,250,2,29,1,1
51926,58664,64074,58664,70,70,0,1,5,1,0
56625,443,54912,443,6734,2065,4669,21,16,11,10
55933,53,17036,53,212,102,110,2,30,1,1
49332,53,40502,53,281,98,183,4,57,2,2
49286,53,14433,53,184,94,90,2,30,1,1
56216,53,5035,53,170,87,83,2,31,1,1
48229,53,48229,53,213,87,126,2,31,1,1
18333,53,18333,53,215,98,117,2,30,1,1
57891,80,37829,80,6518,1210,5308,15,24,8,7
50382,443,9728,443,10423,2542,7881,48,20,24,24
64780,53,37698,53,627,224,403,6,56,3,3
49907,53,52196,53,199,102,97,2,30,1,1
53256,443,33969,443,6181,1040,5141,22,65,11,11
64456,53,28818,53,341,110,231,2,29,1,1
62049,443,63135,443,9526,1375,8151,24,125,12,12
49218,443,48762,443,8929,3316,5613,38,255,18,20
65499,53,27799,53,167,86,81,2,30,1,1
65050,53,2914,53,264,102,162,2,30,1,1
58805,53,42120,53,237,86,151,2,30,1,1
64037,18592,23660,18592,66,66,0,2,7,2,0
64144,53,48969,53,186,95,91,2,30,1,1
45743,8765,60687,8765,336,150,186,6,89,3,3
27005,27016,11664,27016,902,126,776,2,30,1,1
43108,443,38121,443,7578,2358,5220,18,121,8,10
58762,443,39294,443,318,192,126,6,25,4,2
51613,443,47721,443,5052,2873,2179,26,15,14,12
38365,15000,43140,15000,130,70,60,2,6,1,1
56663,53,55920,53,181,94,87,2,30,1,1
55761,53,38695,53,168,78,90,2,30,1,1
64074,53,54669,53,209,110,99,2,30,1,1
52184,443,13267,443,13902,3253,10649,26,135,14,12
58481,53,42506,53,290,110,180,2,30,1,1
5588,5588,0,0,3562,1936,1626,48,193,24,24
63987,58476,60558,58476,504,382,122,8,16,6,2
49459,53,24594,53,198,101,97,2,30,1,1
64004,53,17770,53,247,94,153,2,30,1,1
46492,443,13641,443,11163,3642,7521,25,30,14,11
53835,7000,53835,7000,2099,676,1423,13,15,7,6
65117,53,17216,53,198,102,96,2,30,1,1
41295,443,9928,443,1482,988,494,12,26,7,5
64885,53,64870,53,753,93,660,2,31,1,1
49534,53,40703,53,193,102,91,2,29,1,1
51841,21960,6708,21960,136,136,0,3,14,3,0
55026,53,50435,53,177,94,83,2,30,1,1
64249,53,29634,53,178,91,87,2,30,1,1
64580,53,13673,53,199,102,97,2,30,1,1
26081,53,34120,53,75510,75228,282,904,90,902,2
56657,443,53403,443,8059,2039,6020,20,15,11,9
56658,53,42222,53,177,94,83,2,29,1,1
9202,80,37636,80,2949,546,2403,11,25,6,5
50265,54145,30228,54145,858,858,0,14,1200,14,0
52839,443,27104,443,11808,5409,6399,73,123,33,40
60955,443,4042,443,40105,2847,37258,61,17,28,33
49851,53,9637,53,166,86,80,2,29,1,1
44256,3389,44256,3389,4145,1976,2169,22,18,13,9
50930,443,54294,443,134,60,74,3,10,2,1
62353,80,60521,80,2895,771,2124,12,24,6,6
64679,53,32723,53,328,88,240,4,32,2,2
64448,53,46885,53,353,92,261,4,38,2,2
37097,80,49884,80,1114,534,580,12,15,7,5
55492,80,58922,80,164902,9835,155067,227,32,114,113
56273,53,48350,53,197,102,95,2,33,1,1
56086,53,3627,53,172,94,78,2,30,1,1
57409,443,54706,443,1054,567,487,10,15,6,4
55207,443,50638,443,1803,1029,774,16,185,9,7
57150,53,55226,53,164,84,80,2,30,1,1
61503,443,25661,443,182448,3931,178517,161,26,36,125
56620,53,63507,53,216,110,106,2,30,1,1
55227,53,7352,53,183,102,81,2,30,1,1
51817,54601,57265,54601,316,136,180,6,7,3,3
49418,27017,11133,27017,247,78,169,2,30,1,1
56542,53,15813,53,183,94,89,2,30,1,1
63963,53,20929,53,262,86,176,4,46,2,2
52866,443,59183,443,3101,801,2300,13,136,6,7
64432,53,45233,53,482,188,294,6,44,3,3
27005,28315,51531,28315,875,126,749,2,30,1,1
41339,443,20728,443,7450,1203,6247,22,16,12,10
34873,443,26122,443,236097,12185,223912,307,32,125,182
55533,53,30263,53,816,97,719,2,31,1,1
51282,443,3652,443,4933,2248,2685,14,135,7,7
56992,53,30426,53,355,102,253,2,30,1,1
49885,443,30250,443,4626083,113708,4512375,4382,213,1198,3184
55013,53,27966,53,198,102,96,2,30,1,1
45122,15000,56634,15000,130,70,60,2,5,1,1
52014,443,52014,443,16507,6060,10447,32,49,16,16
51950,17499,15514,17499,70,70,0,2,8,2,0
40326,443,22959,443,7937,3883,4054,65,4602,25,40
27005,33111,34326,33111,895,126,769,2,30,1,1
50182,443,53780,443,6349,1071,5278,18,42,10,8
49948,53,46968,53,177,94,83,2,30,1,1
65485,53,34553,53,184,94,90,2,31,1,1
49635,53,17449,53,210,110,100,2,30,1,1
49921,53,27368,53,214,110,104,2,30,1,1
64739,53,44159,53,172,88,84,2,30,1,1
56760,443,12477,443,8006,1986,6020,20,15,11,9
65261,53,13380,53,168,86,82,2,30,1,1
49474,7000,49474,7000,3100,783,2317,14,15,7,7
65240,53,35636,53,755,102,653,2,30,1,1
56986,53,34763,53,259,87,172,4,36,2,2
27988,40034,46189,40034,141,79,62,2,31,1,1
56808,54393,51587,54393,70,70,0,2,8,2,0
53921,443,59413,443,499,425,74,4,0,3,1
59844,80,25773,80,397391,8624,388767,380,49,118,262
65061,53,34099,53,297,101,196,4,31,2,2
54085,443,49010,443,4128,1929,2199,38,48,21,17
50446,443,25780,443,5471,2089,3382,17,121,8,9
37632,443,56701,443,11338,2980,8358,31,46,18,13
49420,53,47944,53,183,94,89,2,30,1,1
56433,53,33860,53,210,110,100,2,29,1,1
53718,443,3459,443,499,425,74,4,0,3,1
49486,443,60567,443,4160,1015,3145,16,28,8,8
49266,53,16843,53,199,102,97,2,30,1,1
52160,443,34670,443,6679,3424,3255,19,138,10,9
51946,443,39002,443,8670,1805,6865,28,26,15,13
38872,443,38872,443,4480,1573,2907,19,29,11,8
53055,443,19489,443,17225,7769,9456,71,91,34,37
50282,443,7706,443,24856,2858,21998,57,100,30,27
58311,443,32362,443,6128,1394,4734,24,146,10,14
49215,52611,46200,52611,70,70,0,2,8,2,0
39537,80,22901,80,903,482,421,10,360,5,5
64181,53,17159,53,194,102,92,2,31,1,1
49368,443,7264,443,9482,4710,4772,19,17,11,8
49359,443,29384,443,6261,1362,4899,22,15,12,10
50987,80,34293,80,8047,2291,5756,22,19,13,9
57470,32177,25835,32177,480,149,331,2,1200,1,1
56758,53,35324,53,173,94,79,2,31,1,1
1931,53,26121,53,210,78,132,2,30,1,1
65515,53,35838,53,718,94,624,2,30,1,1
55579,53,14828,53,172,88,84,2,30,1,1
52712,443,61572,443,348281,20002,328279,401,350,153,248
64355,53,3739,53,213,102,111,2,30,1,1
64811,53,57822,53,314,97,217,4,47,2,2
56990,80,57120,80,214,140,74,4,35,3,1
63848,443,19599,443,3182,1568,1614,8,120,4,4
56266,53,40991,53,166,86,80,2,31,1,1
49290,53,29478,53,184,94,90,2,30,1,1
56879,53,15562,53,744,95,649,2,30,1,1
65529,53,50654,53,821,102,719,2,30,1,1
54835,443,32514,443,15578,7071,8507,69,140,33,36
56986,53,24262,53,170,87,83,2,30,1,1
22592,443,22592,443,29021,6752,22269,48,30,29,19
38710,443,50238,443,89931,3417,86514,94,15,30,64
56343,53,26546,53,170,87,83,2,30,1,1
34413,443,27966,443,8107,2200,5907,34,255,16,18
54998,53,11974,53,179,94,85,2,30,1,1
27005,27207,59346,27207,875,126,749,2,29,1,1
51523,443,27460,443,4045,765,3280,11,45,5,6
51266,16103,3760,16103,70,70,0,2,8,2,0
10079,443,27678,443,7122,1766,5356,27,331,14,13
51106,80,9259,80,9767,6194,3573,40,47,21,19
55642,53,4187,53,711,87,624,2,30,1,1
53434,53,34860,53,87,87,0,2,31,2,0
49459,53,33594,53,199,102,97,2,30,1,1
57067,53,11101,53,252,102,150,2,30,1,1
38174,443,51209,443,7034,1885,5149,28,95,15,13
60406,64337,47861,64337,70,70,0,2,8,2,0
65218,53,47163,53,276,126,150,2,30,1,1
63962,53,22978,53,274,93,181,4,64,2,2
64789,53,3910,53,198,101,97,2,30,1,1
56605,53,38242,53,341,110,231,2,30,1,1
51091,80,22433,80,4033,2712,1321,35,130,19,16
59899,3389,59899,3389,3624,1910,1714,19,32,11,8
57430,53,16018,53,200,102,98,2,29,1,1
50073,443,27421,443,22729,6539,16190,54,93,27,27
58966,443,39805,443,8209,2174,6035,25,210,12,13
48817,23456,48817,23456,485,158,327,2,1200,1,1
49275,53,55214,53,283,97,186,4,30,2,2
51576,443,34580,443,3323,2023,1300,17,255,9,8
1932,53,37462,53,210,78,132,2,30,1,1
9167,443,11467,443,4072,434,3638,12,15,6,6
50584,8622,56694,8622,166,166,0,1,1200,1,0
10963,53,53121,53,177,86,91,2,30,1,1
56620,53,33976,53,216,110,106,2,31,1,1
51879,38564,56529,38564,70,70,0,1,5,1,0
57618,80,57618,80,265909,7294,258615,235,25,55,180
56893,53,50861,53,177,94,83,2,30,1,1
56732,53,32710,53,701,88,613,2,30,1,1
60442,53,50367,53,184,78,106,2,30,1,1
33383,443,13969,443,24440,2215,22225,46,316,20,26
65289,53,55210,53,179,94,85,2,30,1,1
49603,53,34411,53,326,126,200,2,30,1,1
55917,53,56529,53,170,87,83,2,31,1,1
49569,53,65331,53,181,94,87,2,32,1,1
57319,53,9103,53,189,102,87,2,30,1,1
49890,443,45754,443,6068,1047,5021,20,50,11,9
43096,443,6075,443,3063,1813,1250,18,16,8,10
52233,443,57646,443,5479,929,4550,20,360,10,10
56523,443,56096,443,28479,3138,25341,42,42,17,25
65382,53,20411,53,274,94,180,2,30,1,1
50584,28387,54140,28387,161,161,0,2,1200,2,0
50576,80,50576,80,24419,8463,15956,49,19,25,24
55305,53,27046,53,176,176,0,3,46,3,0
59766,53,33803,53,512,166,346,2,30,1,1
50840,443,34565,443,8057,1135,6922,19,139,9,10
65016,443,10524,443,5957,2481,3476,14,120,8,6
60373,443,19425,443,3875761,85491,3790270,3838,89,1315,2523
59747,443,7939,443,304,86,218,2,29,1,1
57030,53,10715,53,749,94,655,2,30,1,1
50063,53,17752,53,173,94,79,2,29,1,1
54828,443,16065,443,572,572,0,5,11,5,0
53180,443,55711,443,7876,3195,4681,22,20,11,11
56145,3389,56145,3389,4286,2261,2025,20,17,11,9
55325,53,64305,53,711,87,624,2,31,1,1
53575,1025,61617,1025,70,70,0,1,4,1,0
49846,443,59260,443,278883,9002,269881,313,72,115,198
50098,443,16798,443,12942,3659,9283,66,217,36,30
57144,53,45834,53,178,94,84,2,30,1,1
57137,53,46999,53,279,96,183,4,32,2,2
60256,80,21007,80,3401,2157,1244,12,149,7,5
49518,443,29100,443,6602,1573,5029,25,271,11,14
65484,53,31170,53,195,102,93,2,30,1,1
65453,53,27266,53,251,94,157,2,31,1,1
50145,53,3618,53,807,94,713,2,30,1,1
49272,53,44204,53,198,102,96,2,30,1,1
52143,33283,63927,33283,70,70,0,2,8,2,0
51216,443,25956,443,4540,1056,3484,19,17,11,8
48551,443,15020,443,7433,2086,5347,26,316,12,14
49260,53,30297,53,791,85,706,4,57,2,2
39538,80,23642,80,2191,1142,1049,21,370,9,12
49289,443,60908,443,3890599,46254,3844345,3173,116,609,2564
59258,80,59258,80,107904,4143,103761,179,15,59,120
52116,64692,45907,64692,70,70,0,2,8,2,0
57918,443,47624,443,38204,3737,34467,77,95,40,37
32939,443,44702,443,3312,1936,1376,19,29,10,9
63107,443,39326,443,3272,800,2472,10,120,5,5
57470,6881,1701,6881,453,251,202,4,1199,2,2
58759,443,21160,443,6012,873,5139,18,25,9,9
63081,53,24594,53,304,86,218,2,30,1,1
55771,53,22517,53,819,102,717,2,30,1,1
50354,53,23392,53,209,110,99,2,30,1,1
64334,53,44519,53,200,94,106,2,31,1,1
59875,443,3172,443,12357,5182,7175,30,108,13,17
63718,80,18056,80,314,192,122,6,15,4,2
59381,53,57847,53,189,78,111,2,30,1,1
50096,53,50096,53,197,90,107,2,30,1,1
59779,443,64471,443,70,70,0,1,5,1,0
49156,53,43723,53,195,102,93,2,32,1,1
60320,443,1355,443,4679,2232,2447,15,136,7,8
52710,443,22445,443,203346,21619,181727,301,376,140,161
56320,53,27969,53,761,100,661,2,30,1,1
61673,443,54566,443,9218,3728,5490,30,50,16,14
57470,24260,9692,24260,806,163,643,2,1201,1,1
49991,53,8139,53,198,102,96,2,30,1,1
36821,443,62805,443,6164,3172,2992,28,141,12,16
27005,1308,10914,1308,855,126,729,2,29,1,1
55076,80,31296,80,1129,580,549,11,74,6,5
53260,443,22555,443,23664,2213,21451,41,323,17,24
55427,53,22421,53,200,102,98,2,33,1,1
58813,443,14180,443,6475,4197,2278,22,16,12,10
50574,443,59952,443,5870,1785,4085,21,80,12,9
58832,443,5090,443,3862,2458,1404,16,15,8,8
64711,53,46738,53,211,110,101,2,30,1,1
41640,8080,50397,8080,78,78,0,2,8,2,0
56998,53,58740,53,177,94,83,2,29,1,1
8358,80,8358,80,1875,567,1308,11,31,6,5
33087,443,44739,443,13265,1924,11341,33,201,17,16
52188,13182,17024,13182,70,70,0,1,4,1,0
9516,443,9863,443,3909,369,3540,16,35,5,11
44086,443,28968,443,8542,4191,4351,84,616,46,38
62235,443,62235,443,16675,2296,14379,37,78,17,20
59950,53,51206,53,395,115,280,2,30,1,1
53793,20468,60935,20468,70,70,0,2,8,2,0
58773,443,53074,443,3854,2390,1464,17,15,8,9
53765,16178,2985,16178,70,70,0,1,5,1,0
55589,53,33223,53,177,94,83,2,29,1,1
55593,53,53460,53,102,102,0,1,30,1,0
55199,53,63151,53,214,110,104,2,30,1,1
41614,5222,29157,5222,768,510,258,9,21,5,4
50818,80,50818,80,514,246,268,9,42,5,4
54269,53,35881,53,86,86,0,1,30,1,0
53803,17637,1467,17637,70,70,0,2,8,2,0
56118,443,45922,443,187927,12115,175812,276,42,137,139
27005,31000,15120,31000,898,126,772,2,30,1,1
64403,53,2532,53,199,102,97,2,31,1,1
49365,80,10585,80,2361,1586,775,11,166,7,4
56622,443,13170,443,8034,2014,6020,20,15,11,9
52481,443,2836,443,70,70,0,1,5,1,0
56504,53,4684,53,196,100,96,2,30,1,1
55735,53,52965,53,184,94,90,2,30,1,1
57406,53,10288,53,194,102,92,2,30,1,1
35699,443,53038,443,2060,1106,954,17,150,10,7
55823,53,52028,53,210,102,108,2,30,1,1
35187,443,44307,443,27553,21226,6327,57,216,31,26
59180,53,28928,53,260,86,174,2,30,1,1
57422,53,31757,53,821,102,719,2,30,1,1
49418,53,11471,53,776,102,674,2,30,1,1
56734,53,17479,53,751,95,656,2,30,1,1
49912,80,32939,80,1590,858,732,10,110,6,4
50746,443,34629,443,8422,1676,6746,25,16,13,12
51971,20347,9073,20347,66,66,0,1,5,1,0
64361,53,32766,53,228,110,118,2,30,1,1
9381,53,9381,53,200,90,110,2,30,1,1
42115,53,42115,53,262,106,156,2,32,1,1
49687,53,40743,53,184,102,82,2,30,1,1
49967,53,25418,53,193,102,91,2,31,1,1
64431,53,6973,53,177,94,83,2,30,1,1
53272,80,30742,80,11060,3925,7135,24,108,13,11
64627,53,39841,53,199,102,97,2,31,1,1
35642,80,28559,80,1849,1015,834,11,150,6,5
50128,53,3916,53,757,98,659,2,30,1,1
49166,53,17612,53,322,102,220,2,30,1,1
55742,53,18944,53,193,102,91,2,30,1,1
49828,53,30864,53,340,110,230,2,31,1,1
57397,53,42252,53,735,88,647,2,31,1,1
58786,443,62467,443,13240,8717,4523,33,16,17,16
35810,443,44672,443,13706,3115,10591,40,201,22,18
65201,53,42204,53,216,110,106,2,30,1,1
65024,53,8030,53,295,101,194,4,33,2,2
54924,443,20791,443,53816,22991,30825,139,306,71,68
65164,53,35312,53,262,94,168,2,30,1,1
47508,443,1346,443,5778,1095,4683,17,26,10,7
56210,5228,6603,5228,7061,1730,5331,21,3600,11,10
51718,55003,59957,55003,66,66,0,1,5,1,0
57835,443,21443,443,9125,3736,5389,19,120,10,9
49954,80,59970,80,10841,821,10020,19,15,9,10
18238,53,18238,53,240,96,144,2,30,1,1
49869,53,17507,53,414,103,311,4,31,2,2
64374,53,64374,53,240,98,142,2,30,1,1
45979,80,24142,80,1638,1324,314,10,15,5,5
50135,53,57045,53,774,101,673,2,30,1,1
60479,53928,50197,53928,70,70,0,2,8,2,0
50336,53,8935,53,102,102,0,1,30,1,0
64882,53,2357,53,176,90,86,2,30,1,1
51790,46839,55080,46839,70,70,0,2,8,2,0
51769,19165,28138,19165,70,70,0,2,8,2,0
53691,11528,36171,11528,492,306,186,8,16,5,3
50584,50545,46451,50545,166,166,0,1,1199,1,0
65266,53,28016,53,536,113,423,4,56,2,2
56937,8200,16885,8200,78,78,0,1,30,1,0
57470,1337,52453,1337,594,594,0,10,1199,10,0
43591,443,60892,443,1848,1141,707,14,566,8,6
55784,53,32669,53,184,94,90,2,30,1,1
56240,80,56240,80,101524,1673,99851,94,15,24,70
41624,15000,41127,15000,130,70,60,2,5,1,1
24985,443,23171,443,2227,1018,1209,17,15,8,9
64722,53,36705,53,214,110,104,2,30,1,1
49319,53,45899,53,166,86,80,2,30,1,1
57436,53,48007,53,183,94,89,2,30,1,1
53541,59939,24806,59939,70,70,0,2,7,2,0
53849,17580,55160,17580,492,306,186,8,15,5,3
45860,443,61779,443,12852,3554,9298,35,24,19,16
52042,443,63896,443,8740,1799,6941,25,25,13,12
56038,53,40412,53,170,87,83,2,30,1,1
60778,40010,59381,40010,316,136,180,6,6,3,3
52004,443,64314,443,4804,866,3938,19,26,10,9
50469,80,50469,80,350722,14506,336216,459,26,231,228
37185,443,49991,443,14035,8420,5615,31,256,18,13
49509,53,2190,53,339,110,229,2,30,1,1
55646,443,13625,443,11771,2624,9147,50,19,25,25
60427,61137,28150,61137,70,70,0,1,5,1,0
50116,443,45796,443,48255,4798,43457,100,149,47,53
53164,48198,7411,48198,320,140,180,6,7,3,3
56336,53,53884,53,196,102,94,2,35,1,1
34330,443,44282,443,1717,1153,564,13,26,7,6
50584,44816,28229,44816,161,161,0,1,1201,1,0
65026,53,20362,53,188,96,92,2,30,1,1
40763,443,27693,443,15679,4305,11374,32,43,17,15
55664,53,32292,53,195,102,93,2,30,1,1
55713,53,11593,53,308,94,214,2,30,1,1
56689,443,16946,443,7890,1901,5989,20,15,11,9
49531,443,49531,443,95223,30803,64420,107,23,50,57
49624,53,59918,53,293,126,167,2,30,1,1
51088,443,60075,443,14025,7301,6724,38,171,22,16
26941,443,39877,443,8466,3146,5320,30,20,15,15
64748,53,7421,53,152,78,74,2,30,1,1
55713,47783,7321,47783,70,70,0,2,8,2,0
62738,443,30177,443,126,60,66,3,10,2,1
55808,53,36895,53,183,94,89,2,30,1,1
65098,53,11310,53,260,94,166,2,30,1,1
56730,53,39267,53,177,94,83,2,29,1,1
56363,53,52930,53,212,102,110,2,30,1,1
55614,29731,26252,29731,70,70,0,1,5,1,0
62783,443,22003,443,28847,16957,11890,144,293,60,84
55956,53,7528,53,200,94,106,2,30,1,1
53971,18810,62225,18810,70,70,0,2,8,2,0
51142,80,61764,80,1114,534,580,12,16,7,5
64472,53,7630,53,182,93,89,2,30,1,1
55639,53,27613,53,244,94,150,2,30,1,1
65140,53,14760,53,752,110,642,2,30,1,1
51698,80,35267,80,15609,1298,14311,26,75,14,12
58166,53,23423,53,224,94,130,2,30,1,1
56523,53,49008,53,184,102,82,2,30,1,1
59874,443,18993,443,1066,545,521,11,28,5,6
50679,80,31176,80,2139,1167,972,10,20,6,4
49410,53,12703,53,178,94,84,2,30,1,1
51517,443,51517,443,153968,7663,146305,170,173,43,127
64099,55470,50878,55470,66,66,0,1,5,1,0
36934,443,62872,443,490,210,280,8,131,4,4
60947,443,46012,443,1373,712,661,14,18,8,6
56100,53,41303,53,177,94,83,2,30,1,1
61411,443,46300,443,4775,894,3881,18,28,10,8
47355,161,0,0,7809,3013,4796,28,31,14,14
48906,80,50980,80,2544,1681,863,12,185,7,5
57038,53,5859,53,186,102,84,2,31,1,1
55746,53,40664,53,216,110,106,2,30,1,1
56142,53,42662,53,194,102,92,2,31,1,1
45019,53,52189,53,168,78,90,2,30,1,1
50914,443,57800,443,22211,8661,13550,173,854,77,96
57685,53,47518,53,275,86,189,2,30,1,1
55045,443,7851,443,4660,3048,1612,31,81,15,16
41891,443,2286,443,235626,4546,231080,232,339,53,179
60381,26312,40513,26312,70,70,0,1,5,1,0
49899,53,23402,53,718,94,624,2,30,1,1
40403,53,40667,53,199,94,105,2,30,1,1
49912,53,25675,53,246,102,144,2,30,1,1
50040,443,40234,443,1097,654,443,12,86,7,5
38038,443,62435,443,6180,3550,2630,27,272,13,14
55228,443,61820,443,12645,4916,7729,39,94,22,17
55504,53,5700,53,711,87,624,2,30,1,1
50106,53,26028,53,209,110,99,2,30,1,1
63847,443,57992,443,8012,4410,3602,20,135,10,10
51969,80,21230,80,622,70,552,10,1117,2,8
49582,80,30882,80,454222,9730,444492,425,155,119,306
50898,80,8835,80,21445,1605,19840,36,255,19,17
27322,443,7841,443,5235,1839,3396,22,48,10,12
64477,53,1968,53,272,94,178,2,30,1,1
55542,53,62446,53,177,94,83,2,30,1,1
39358,443,53461,443,9115,6806,2309,37,80,20,17
50303,443,16402,443,13459,1604,11855,27,187,14,13
53857,443,11803,443,499,425,74,4,1,3,1
56752,53,3213,53,183,94,89,2,29,1,1
63464,443,19526,443,8543,1114,7429,26,93,11,15
56438,53,21882,53,312,94,218,2,30,1,1
53527,5228,55667,5228,9674,1776,7898,29,3764,11,18
64973,53,36407,53,257,102,155,2,30,1,1
49663,80,43225,80,8935,3175,5760,17,41,8,9
51619,443,27223,443,13526,2192,11334,32,141,16,16
6881,35766,64668,35766,221,111,110,2,1200,1,1
59473,80,31869,80,1052,612,440,10,15,5,5
44513,443,46778,443,3698,1302,2396,13,136,6,7
65502,443,12498,443,92573,4519,88054,105,16,39,66
55907,53,13623,53,711,87,624,2,30,1,1
55634,53,8065,53,210,110,100,2,30,1,1
56055,53,2822,53,168,86,82,2,31,1,1
59363,443,28293,443,15860,1930,13930,37,195,14,23
65080,53,49569,53,193,102,91,2,29,1,1
47758,443,3505,443,299614,32024,267590,587,115,304,283
49434,443,8627,443,197635,12994,184641,287,183,143,144
52107,11191,13712,11191,70,70,0,2,7,2,0
57134,53,42837,53,195,102,93,2,30,1,1
55752,53,32253,53,177,94,83,2,30,1,1
50577,80,50577,80,18679,9115,9564,45,18,24,21
13171,53,13171,53,404,259,145,3,32,2,1
60939,53,60939,53,237,91,146,2,32,1,1
59636,80,29464,80,1352,848,504,13,169,8,5
2874,53,2874,53,216,82,134,2,31,1,1
62592,443,27957,443,11741,7040,4701,40,172,22,18
41027,80,63019,80,540,540,0,10,186,10,0
49676,53,36174,53,733,86,647,2,30,1,1
55786,53,63117,53,177,94,83,2,29,1,1
49661,443,46909,443,10553,2117,8436,24,46,12,12
49473,443,31044,443,3990,1296,2694,17,158,9,8
52348,80,52348,80,2910,1489,1421,10,16,6,4
56706,80,18045,80,214,140,74,4,25,3,1
60393,443,31011,443,8049,1805,6244,23,81,12,11
53596,56732,3415,56732,70,70,0,1,4,1,0
32782,80,6482,80,1495,779,716,10,30,6,4
34346,443,57407,443,3497,1845,1652,18,15,9,9
64980,53,10354,53,200,102,98,2,29,1,1
35372,443,41929,443,269750,10062,259688,285,152,92,193
49636,443,48846,443,6158,1149,5009,17,52,9,8
57440,53,5992,53,199,102,97,2,30,1,1
65508,443,2648,443,92884,4939,87945,111,16,45,66
50901,80,6668,80,14661588,141996,14519592,11768,134,2012,9756
64913,53,34114,53,211,102,109,2,30,1,1
57700,53,0,0,300,90,210,2,30,1,1
49863,53,59500,53,200,86,114,2,30,1,1
53841,443,33528,443,499,425,74,4,0,3,1
49709,80,35500,80,128214,4961,123253,134,108,43,91
37953,1935,23472,1935,3623810,67493,3556317,3486,35,943,2543
49445,53,33858,53,770,101,669,2,30,1,1
49797,53,5232,53,787,110,677,2,30,1,1
51052,80,32804,80,5678,1692,3986,13,17,8,5
56078,53,11255,53,168,86,82,2,30,1,1
50188,80,44459,80,1746,780,966,19,56,7,12
35556,53,63282,53,168,78,90,2,30,1,1
38671,443,7350,443,7897,3562,4335,19,16,10,9
31653,53,31653,53,235,90,145,2,34,1,1
57194,53,31354,53,2198,193,2005,6,90,3,3
50972,3544,45034,3544,258,107,151,2,31,1,1
42117,443,44867,443,9999,4008,5991,33,345,18,15
17532,53,17532,53,233,90,143,2,31,1,1
51930,443,10848,443,9114,2713,6401,33,82,15,18
56650,443,36450,443,4628,1035,3593,19,25,11,8
33809,80,12746,80,1052,612,440,10,15,5,5
37657,443,62208,443,8926,2746,6180,27,46,16,11
49346,443,21624,443,4312,2524,1788,34,132,19,15
49167,53,55211,53,258,94,164,2,30,1,1
50914,443,19872,443,8058,1136,6922,19,129,9,10
43033,443,43033,443,10239,2017,8222,23,18,14,9
43086,443,19069,443,6496,2026,4470,20,16,12,8
56496,53,36684,53,164,86,78,2,29,1,1
49678,80,44529,80,1977,921,1056,9,15,5,4
49965,53,5956,53,257,110,147,2,30,1,1
59582,443,37348,443,22106,5214,16892,23,127,9,14
63954,60430,18529,60430,66,66,0,2,8,2,0
58209,53,48023,53,259,86,173,2,30,1,1
42385,443,55838,443,321621,14025,307596,408,41,185,223
19629,53,19629,53,244,98,146,2,33,1,1
56445,53,52720,53,198,101,97,2,30,1,1
60989,443,62484,443,3182,1568,1614,8,120,4,4
55010,443,19028,443,7651,2261,5390,41,255,21,20
26352,53,26352,53,231,90,141,2,31,1,1
53807,443,5620,443,4622,860,3762,16,17,9,7
49767,53,4502,53,177,94,83,2,30,1,1
63949,53,18113,53,195,102,93,2,31,1,1
64079,20233,52835,20233,70,70,0,1,4,1,0
53851,443,36931,443,11779,3603,8176,42,142,21,21
49453,53,64414,53,227,110,117,2,31,1,1
64692,53,27620,53,760,97,663,2,31,1,1
9156,443,14551,443,5734,498,5236,14,15,7,7
50433,53,61618,53,770,102,668,2,30,1,1
41674,443,45032,443,14424911,433341,13991570,15454,320,5482,9972
52138,25621,30366,25621,70,70,0,2,8,2,0
65198,53,6063,53,448,94,354,4,49,2,2
9443,443,55182,443,7398,1480,5918,24,39,12,12
60191,53,31189,53,196,94,102,2,31,1,1
40471,53,40471,53,194,87,107,2,31,1,1
56642,443,26637,443,27108,2396,24712,40,80,18,22
57307,53,14179,53,177,94,83,2,30,1,1
57115,53,15026,53,756,95,661,2,30,1,1
65499,53,26043,53,167,86,81,2,29,1,1
49823,53,39665,53,209,110,99,2,31,1,1
26690,53,55791,53,197,94,103,2,29,1,1
57883,443,47068,443,1786,1147,639,17,177,10,7
37508,443,44640,443,8586,1714,6872,25,43,14,11
45564,443,62998,443,4851,848,4003,16,16,9,7
60999,53,14276,53,578,286,292,9,16,5,4
1431,53,1431,53,215,80,135,2,32,1,1
50865,443,45042,443,6883,1378,5505,19,131,9,10
51550,443,50088,443,13331,2421,10910,38,209,20,18
54969,53,12796,53,199,102,97,2,29,1,1
50120,443,33702,443,23870,3485,20385,55,143,29,26
53797,14550,19741,14550,320,140,180,6,5,3,3
52452,80,35444,80,5582,591,4991,14,75,7,7
59189,53,53487,53,222,94,128,2,30,1,1
49400,80,44770,80,3651,2020,1631,16,65,9,7
65378,53,49018,53,212,102,110,2,30,1,1
49503,443,6313,443,20565,2848,17717,31,27,10,21
41199,443,15931,443,30604,3050,27554,45,122,18,27
56656,53,41327,53,255,88,167,4,52,2,2
49300,53,25911,53,232,86,146,2,30,1,1
41269,443,34077,443,234,234,0,4,12,4,0
63943,53,31455,53,254,110,144,2,30,1,1
56495,53,8652,53,199,102,97,2,30,1,1
55711,53,33941,53,733,93,640,2,31,1,1
53578,34129,19410,34129,70,70,0,1,5,1,0
51628,443,50977,443,5678,3121,2557,39,256,18,21
49528,53,13440,53,177,94,83,2,30,1,1
54074,443,19199,443,72465,3991,68474,98,169,43,55
40215,443,50672,443,5656,1009,4647,24,87,10,14
50604,443,64927,443,1385,783,602,14,23,8,6
39820,443,46872,443,2190,1249,941,23,26,12,11
65455,3389,65455,3389,4350,2261,2089,21,17,11,10
60299,80,6795,80,1557,778,779,11,144,6,5
55285,53,16025,53,268,95,173,4,47,2,2
50666,80,35544,80,2937,1241,1696,12,22,7,5
63863,34678,27822,34678,504,382,122,8,15,6,2
65104,53,20417,53,198,94,104,2,30,1,1
52265,53,0,0,233,89,144,2,30,1,1
55850,53,22849,53,711,87,624,2,31,1,1
33825,443,41237,443,9407,2233,7174,38,96,16,22
55625,80,27507,80,389326,9849,379477,391,21,138,253
53883,443,37691,443,495,421,74,4,0,3,1
52040,80,54028,80,366,240,126,7,24,5,2
55545,53,34965,53,196,100,96,3,33,2,1
49872,443,65245,443,3120,1862,1258,18,15,11,7
49761,443,53360,443,36615,5107,31508,108,125,49,59
56603,53,32862,53,168,86,82,2,30,1,1
50584,28020,62483,28020,1302,300,1002,6,1200,3,3
55127,80,31027,80,4239,2334,1905,17,187,10,7
56251,80,56251,80,101529,1646,99883,94,15,24,70
35965,443,31855,443,3821,2814,1007,22,17,12,10
57232,53,10597,53,821,102,719,2,30,1,1
49893,443,25504,443,617481,41514,575967,856,221,381,475
50015,53,0,0,234,86,148,2,30,1,1
51766,80,8995,80,2190,1284,906,13,74,8,5
65531,53,44923,53,193,102,91,2,30,1,1
19366,53,39850,53,300,209,91,3,30,2,1
51404,443,29692,443,9076,2650,6426,35,247,15,20
64489,53,3033,53,320,97,223,4,50,2,2
49498,53,63118,53,734,94,640,2,29,1,1
49785,53,38466,53,206,105,101,2,31,1,1
56308,53,54603,53,184,94,90,2,31,1,1
49603,53,17814,53,766,102,664,2,30,1,1
55465,443,38707,443,12399,3942,8457,83,615,42,41
39119,53,39119,53,221,89,132,2,30,1,1
64244,53,64721,53,199,102,97,2,29,1,1
36499,53,58408,53,302,208,94,3,30,2,1
49511,443,56126,443,1200,623,577,13,27,6,7
64573,53,58393,53,558,104,454,4,49,2,2
55013,53,63318,53,728,102,626,2,29,1,1
58589,80,4699,80,1360,900,460,10,515,6,4
63964,53,22176,53,323,85,238,4,34,2,2
37987,49152,22842,49152,156,156,0,3,7,3,0
52245,53652,1791,53652,70,70,0,2,7,2,0
49891,53,42483,53,164,84,80,2,31,1,1
55179,53,17808,53,183,94,89,2,30,1,1
55079,443,57713,443,7156,1187,5969,20,16,10,10
57017,53,22107,53,177,94,83,2,30,1,1
50584,10312,63675,10312,161,161,0,2,1200,2,0
65212,53,14498,53,273,118,155,2,30,1,1
57456,443,23040,443,1857,1218,639,18,119,11,7
63968,53,61368,53,310,142,168,2,30,1,1
56951,53,51481,53,250,86,164,4,31,2,2
27005,27015,53679,27015,894,126,768,2,30,1,1
55635,38649,44116,38649,70,70,0,1,5,1,0
58789,443,17140,443,14261,9361,4900,35,16,19,16
49806,53,49806,53,229,89,140,2,31,1,1
49245,53,24840,53,195,102,93,2,30,1,1
64586,53,31352,53,257,102,155,2,30,1,1
49965,53,10762,53,226,110,116,2,30,1,1
35197,443,30510,443,12481,2743,9738,53,20,26,27
49701,53,45217,53,523,92,431,4,48,2,2
55726,27015,16348,27015,1173,924,249,6,30,3,3
36942,53,36942,53,197,90,107,2,30,1,1
49374,53,54400,53,186,95,91,2,31,1,1
52105,80,43976,80,422,240,182,8,26,5,3
56365,53,1142,53,198,101,97,2,30,1,1
26900,27017,38585,27017,6466,3520,2946,38,46,21,17
56472,53,9100,53,166,85,81,2,31,1,1
65189,27016,20619,27016,249,78,171,2,29,1,1
56660,53,3127,53,338,110,228,2,30,1,1
12064,53,12064,53,244,98,146,2,33,1,1
58511,53,45280,53,302,86,216,2,30,1,1
64112,443,40510,443,4116645,96572,4020073,4029,58,1356,2673
50730,443,7850,443,1323,738,585,10,16,6,4
56986,53,21320,53,177,94,83,2,31,1,1
49255,80,49255,80,8453,961,7492,18,20,9,9
41254,443,60907,443,12757,4053,8704,39,522,14,25
63759,443,31179,443,7995,2096,5899,18,120,8,10
56244,80,56244,80,101473,1494,99979,91,15,21,70
59773,53,31376,53,193,94,99,2,30,1,1
64697,53,40381,53,199,102,97,2,30,1,1
55018,53,37429,53,179,94,85,2,30,1,1
49227,2710,36226,2710,70,70,0,2,8,2,0
48275,15000,58699,15000,130,70,60,2,5,1,1
64104,53,19823,53,288,101,187,4,57,2,2
64481,53,22915,53,386,106,280,4,51,2,2
56337,53,25650,53,268,89,179,4,45,2,2
56056,53,12861,53,172,94,78,2,29,1,1
65356,443,39597,443,3122508,193850,2928658,4050,681,1740,2310
53709,15000,7812,15000,320,140,180,6,7,3,3
49452,443,8798,443,16012,6573,9439,43,175,20,23
40472,443,17256,443,317215,285998,31217,436,982,244,192
55582,26957,64555,26957,70,70,0,1,5,1,0
55053,80,18063,80,162010,4343,157667,170,98,61,109
58027,80,53632,80,1225,711,514,11,15,5,6
57406,53,49515,53,194,102,92,2,30,1,1
49665,53,35069,53,168,86,82,2,32,1,1
49532,53,18389,53,443,182,261,6,31,3,3
54948,443,58033,443,493685,14728,478957,612,316,213,399
48086,443,38296,443,3138,2011,1127,16,255,9,7
55670,53,52397,53,774,101,673,2,30,1,1
55477,53,61973,53,183,94,89,2,31,1,1
62345,443,13195,443,6343025,74037,6268988,5018,58,765,4253
53557,39731,45884,39731,70,70,0,1,5,1,0
50130,53,57806,53,174,89,85,2,30,1,1
55994,53,14780,53,182,93,89,2,30,1,1
55261,53,19627,53,173,94,79,2,30,1,1
57396,53,6439,53,183,94,89,2,30,1,1
37851,443,26132,443,14283,12630,1653,29,126,17,12
57363,53,20262,53,178,94,84,2,29,1,1
49198,53,16713,53,261,94,167,2,29,1,1
56929,53,55156,53,784,94,690,2,30,1,1
52195,50930,43224,50930,70,70,0,2,8,2,0
53520,37553,50212,37553,70,70,0,2,7,2,0
50988,80,43692,80,5956,1595,4361,17,19,10,7
54987,53,61181,53,215,102,113,2,30,1,1
65528,53,30567,53,168,86,82,2,31,1,1
64201,53,27931,53,200,94,106,2,29,1,1
64048,53,38443,53,209,110,99,2,30,1,1
50001,53,34185,53,239,94,145,2,29,1,1
57253,443,15843,443,8613,2377,6236,41,17,23,18
49393,443,42342,443,62,62,0,1,5,1,0
50154,53,53091,53,756,95,661,2,30,1,1
123,123,12424,123,184,94,90,2,30,1,1
56526,443,53927,443,1560,988,572,13,25,7,6
52218,80,52218,80,1921,1472,449,10,20,6,4
38700,443,57335,443,90113,3417,86696,95,16,30,65
9421,443,1496,443,5699,505,5194,14,15,7,7
55213,53,60229,53,238,94,144,2,30,1,1
64959,53,12491,53,209,110,99,2,30,1,1
56905,443,19184,443,7537,2310,5227,19,142,8,11
62074,443,62074,443,151233,12592,138641,190,19,88,102
51602,443,19989,443,19664,8943,10721,42,37,22,20
52385,53,0,0,138,69,69,2,30,1,1
59324,53,10357,53,211,78,133,2,30,1,1
65290,3389,65290,3389,3327,1438,1889,15,16,8,7
54816,3389,54816,3389,3413,1458,1955,16,17,8,8
44847,51413,1303,51413,475,150,325,2,1200,1,1
43601,80,43601,80,1252,539,713,10,20,5,5
34166,443,10129,443,1984,1233,751,16,20,8,8
63070,53,63583,53,446,164,282,2,30,1,1
55830,53,60660,53,182,93,89,2,31,1,1
48861,53,40652,53,164,78,86,2,30,1,1
56759,53,36247,53,733,94,639,2,31,1,1
44519,443,58426,443,716,428,288,11,26,7,4
58959,53,45652,53,307,86,221,2,30,1,1
65529,53,2543,53,199,102,97,2,30,1,1
55382,53,39381,53,226,110,116,2,30,1,1
53800,59950,39242,59950,1973,1021,952,10,15,6,4
49531,80,27250,80,78,78,0,2,8,2,0
49418,27200,10128,27200,78,78,0,1,30,1,0
56939,53,50675,53,216,110,106,2,31,1,1
55305,53,15624,53,88,88,0,2,31,2,0
56645,80,11255,80,234,234,0,4,12,4,0
51920,80,17031,80,5069,4443,626,11,30,6,5
50864,443,25636,443,6391,1285,5106,19,15,10,9
49274,53,14620,53,197,102,95,2,30,1,1
55057,443,7517,443,1364,940,424,12,16,7,5
49671,53,47128,53,183,94,89,2,30,1,1
32971,443,57614,443,300,180,120,4,15,2,2
36717,443,50144,443,232,172,60,3,5,2,1
65008,53,11411,53,276,118,158,2,29,1,1
53987,16571,20059,16571,70,70,0,1,5,1,0
53145,44634,36222,44634,70,70,0,1,5,1,0
55481,53,35011,53,758,96,662,2,30,1,1
49418,27017,6721,27017,300,78,222,2,30,1,1
49197,2710,30685,2710,70,70,0,1,4,1,0
60037,443,65363,443,4722,2945,1777,18,142,10,8
53753,46790,44362,46790,492,306,186,8,15,5,3
60773,20010,46646,20010,70,70,0,1,5,1,0
56950,53,15623,53,363,109,254,4,46,2,2
52408,443,37575,443,1043,556,487,10,16,6,4
63994,47013,54250,47013,66,66,0,2,8,2,0
34531,80,18192,80,467664,17895,449769,610,355,265,345
13749,53,13749,53,237,91,146,2,32,1,1
61700,53,61700,53,221,90,131,2,30,1,1
65439,53,2036,53,168,86,82,2,29,1,1
57069,53,52685,53,177,94,83,2,31,1,1
59735,443,59735,443,4730,1823,2907,19,28,11,8
42654,443,18143,443,3650,2162,1488,25,80,13,12
56410,53,65347,53,757,98,659,2,30,1,1
50355,443,1395,443,1786,172,1614,7,120,3,4
63464,443,53137,443,5614,2964,2650,19,120,9,10
55123,53,29393,53,198,102,96,2,29,1,1
56072,53,60907,53,198,101,97,2,31,1,1
48467,80,55817,80,1113,534,579,12,15,7,5
54114,443,54114,443,171467,27550,143917,220,85,108,112
51177,443,18641,443,154,94,60,2,4,1,1
27005,32078,22538,32078,871,126,745,2,30,1,1
56568,443,49242,443,1277,705,572,13,25,7,6
64958,53,27605,53,216,94,122,2,30,1,1
55371,53,15832,53,184,102,82,2,29,1,1
51559,443,32426,443,254,70,184,5,21,2,3
35201,443,64123,443,291,171,120,4,15,2,2
56604,443,22617,443,2904,662,2242,13,135,6,7
33834,443,55526,443,1178,820,358,9,15,6,3
49189,443,36551,443,15611,1501,14110,32,361,14,18
58087,123,31892,123,184,94,90,2,30,1,1
49654,53,5508,53,184,94,90,2,30,1,1
56637,80,52477,80,234,234,0,4,12,4,0
55600,53,57524,53,184,94,90,2,30,1,1
10436,53,10436,53,237,91,146,2,32,1,1
55088,53,3753,53,193,102,91,2,29,1,1
50558,80,10581,80,318,192,126,6,26,4,2
57139,53,1323,53,164,84,80,2,31,1,1
56724,53,16788,53,190,97,93,2,31,1,1
46550,443,33261,443,7330,4420,2910,31,316,16,15
39799,443,18557,443,5597,3595,2002,42,68,23,19
6881,6889,64062,6889,228,118,110,2,1199,1,1
38635,443,21019,443,4089,1965,2124,25,83,13,12
64689,53,18910,53,182,93,89,2,31,1,1
9189,80,9189,80,13456,880,12576,21,16,9,12
57470,1024,34451,1024,132,132,0,3,1200,3,0
50356,443,55689,443,505625,19174,486451,584,143,204,380
57978,5228,59102,5228,2725,1610,1115,20,3600,10,10
33410,80,44582,80,1570,754,816,10,15,6,4
50534,53,50534,53,216,88,128,2,30,1,1
65460,53,21678,53,387,102,285,2,29,1,1
43154,53,41451,53,168,78,90,2,30,1,1
64335,53,25261,53,193,102,91,2,30,1,1
49433,53,51324,53,278,94,184,2,30,1,1
49573,80,24541,80,180917,5183,175734,175,65,49,126
55752,53,39716,53,177,94,83,2,30,1,1
49848,443,21903,443,5997,976,5021,19,72,10,9
52519,80,46745,80,3771,3257,514,12,14,7,5
57270,53,53677,53,200,102,98,2,31,1,1
64968,53,11604,53,448,98,350,4,41,2,2
60143,443,49806,443,16448,5420,11028,47,319,23,24
55183,53,35427,53,177,94,83,2,29,1,1
56661,53,16607,53,288,93,195,4,32,2,2
64711,53,26786,53,211,110,101,2,30,1,1
49629,53,2341,53,198,102,96,2,29,1,1
34937,443,49817,443,10059,2039,8020,23,186,12,11
53826,10168,29575,10168,70,70,0,2,7,2,0
39537,8245,49028,8245,280,214,66,2,30,1,1
51169,443,30146,443,975832,29038,946794,991,51,341,650
57095,53,10011,53,177,94,83,2,30,1,1
65189,27015,18038,27015,257,78,179,2,30,1,1
49359,443,64650,443,63494,7222,56272,107,81,49,58
50520,53,46734,53,732,86,646,2,30,1,1
61797,23,61797,23,60,60,0,1,5,1,0
51686,80,25444,80,45058,2444,42614,90,52,33,57
55721,53,12194,53,177,94,83,2,29,1,1
53137,443,3588,443,7648,3641,4007,29,42,13,16
41833,443,22584,443,50425,3972,46453,63,122,25,38
27005,1305,58083,1305,855,126,729,2,29,1,1
52063,80,12503,80,366,240,126,7,26,5,2
63847,45598,22596,45598,376,254,122,6,15,4,2
57427,443,63478,443,5337,1085,4252,14,76,8,6
59645,53,23128,53,263,94,169,2,30,1,1
54813,443,48795,443,1633,819,814,16,40,8,8
52154,80,54882,80,366,240,126,7,32,5,2
37716,443,28375,443,14009,10561,3448,30,135,16,14
45000,443,43427,443,2227,1018,1209,17,16,8,9
9401,443,34975,443,7135,1346,5789,21,32,10,11
46186,443,59452,443,10103,3482,6621,59,16,29,30
65506,53,39413,53,194,99,95,2,30,1,1
54656,443,58488,443,6509,1635,4874,21,186,11,10
51828,11916,54336,11916,316,136,180,6,6,3,3
51327,443,49417,443,8433,3066,5367,21,17,10,11
30023,3389,30023,3389,4145,1976,2169,22,19,13,9
52731,443,19807,443,10819,5326,5493,45,16,27,18
65314,53,39947,53,195,102,93,2,30,1,1
65437,53,48894,53,1386,85,1301,4,53,2,2
56063,53,52462,53,196,102,94,2,30,1,1
49397,53,53029,53,373,98,275,4,43,2,2
60098,443,41490,443,1011,568,443,11,139,6,5
51957,80,56020,80,486,300,186,9,27,6,3
65313,53,62981,53,166,86,80,2,30,1,1
42903,53,55150,53,168,78,90,2,30,1,1
60186,53,47856,53,199,94,105,2,30,1,1
59580,443,31817,443,10200,2180,8020,26,19,15,11
49418,27118,47467,27118,78,78,0,1,30,1,0
48817,8677,48817,8677,490,149,341,2,1200,1,1
50456,53,42563,53,754,94,660,2,30,1,1
51547,443,55970,443,642,582,60,2,5,1,1
26900,27017,15895,27017,254,82,172,4,30,2,2
65181,53,41975,53,421,96,325,4,42,2,2
46216,443,9972,443,161,101,60,2,5,1,1
46834,53,46834,53,235,90,145,2,32,1,1
51500,993,4543,993,14747,5073,9674,109,45,51,58
56528,443,54144,443,8313,3597,4716,16,119,8,8
63728,11785,51708,11785,66,66,0,1,5,1,0
65056,53,56800,53,270,94,176,2,30,1,1
64520,53,16253,53,198,102,96,2,29,1,1
64530,53,20478,53,261,87,174,4,44,2,2
49168,53,14343,53,196,102,94,2,30,1,1
65048,53,26939,53,188,96,92,2,31,1,1
55983,53,48141,53,255,102,153,2,30,1,1
26865,443,22998,443,21239,16302,4937,35,20,20,15
49712,443,1489,443,11365,1278,10087,23,131,10,13
56788,443,39724,443,7929,1940,5989,20,15,11,9
57499,80,58855,80,30979,1798,29181,46,14,23,23
50057,53,42578,53,177,94,83,2,29,1,1
65431,53,63045,53,210,102,108,2,30,1,1
59859,443,59054,443,27510,4470,23040,67,122,34,33
55613,53,25861,53,177,94,83,2,30,1,1
49749,443,40981,443,7398,1597,5801,20,128,10,10
56668,53,61814,53,177,94,83,2,29,1,1
33877,53,33877,53,643,88,555,2,31,1,1
63992,53,19496,53,199,102,97,2,30,1,1
48817,33028,48817,33028,152,152,0,1,1200,1,0
55859,53,59697,53,210,110,100,2,30,1,1
56783,21279,24337,21279,70,70,0,1,5,1,0
57061,53,39332,53,1780,674,1106,18,68,9,9
50968,80,19228,80,109660,1992,107668,99,35,20,79
64041,53,17809,53,200,102,98,2,30,1,1
50697,80,44763,80,54775,28230,26545,230,175,115,115
54197,443,61116,443,190,70,120,4,15,2,2
65014,53,11511,53,718,94,624,2,29,1,1
49534,53,49440,53,168,86,82,2,30,1,1
55005,53,54882,53,182,93,89,2,31,1,1
38646,443,44799,443,2335,1247,1088,15,28,8,7
64618,53,41913,53,305,100,205,4,54,2,2
53224,443,28053,443,6001,982,5019,19,65,10,9
65286,3389,65286,3389,3424,1710,1714,16,31,8,8
53126,443,58223,443,11811,4242,7569,27,46,15,12
49632,53,3027,53,199,102,97,2,31,1,1
50425,443,34304,443,5653,1079,4574,14,26,8,6
61362,443,23026,443,7653,1226,6427,24,18,14,10
58081,3389,58081,3389,3549,1594,1955,18,16,10,8
27005,27017,47675,27017,878,126,752,2,31,1,1
58369,443,14100,443,155345,11568,143777,195,195,73,122
51698,63846,26436,63846,66,66,0,1,5,1,0
46215,443,1828,443,161,101,60,2,5,1,1
57072,53,14779,53,195,102,93,2,30,1,1
56415,53,6950,53,179,94,85,2,30,1,1
51959,42269,61621,42269,70,70,0,1,4,1,0
65449,53,25371,53,170,87,83,2,31,1,1
51982,80,16574,80,2776,2091,685,9,47,5,4
55679,1024,62004,1024,70,70,0,1,5,1,0
9341,443,61165,443,3835,501,3334,14,15,7,7
47722,80,12273,80,1720,1406,314,10,15,5,5
49752,53,44269,53,182,94,88,2,29,1,1
57424,2258,57424,2258,156,156,0,3,8,3,0
35991,443,8225,443,2509208,64544,2444664,2429,304,700,1729
54620,80,5302,80,14855,1611,13244,26,77,14,12
53824,443,33513,443,499,425,74,4,0,3,1
49996,53,3392,53,182,93,89,2,31,1,1
46112,53,33823,53,168,78,90,2,30,1,1
50652,80,2519,80,97934,5018,92916,124,20,55,69
27005,27014,60898,27014,879,126,753,2,30,1,1
40980,443,52078,443,567854,22650,545204,713,158,311,402
37525,443,14541,443,9082,3492,5590,26,61,15,11
56678,53,49059,53,240,110,130,2,30,1,1
53241,443,7784,443,24835,2671,22164,42,323,17,25
44455,443,5697,443,6972,1375,5597,20,31,10,10
64068,53,31141,53,168,86,82,2,30,1,1
49286,53,40508,53,184,94,90,2,29,1,1
10151,6881,1638,6881,460,150,310,2,1200,1,1
56994,53,65507,53,170,87,83,2,30,1,1
49317,53,41699,53,168,78,90,2,30,1,1
36411,443,59094,443,10691,3704,6987,25,181,13,12
64359,53,39260,53,192,98,94,2,31,1,1
61143,443,58972,443,6391,3788,2603,14,121,7,7
64818,53,61380,53,260,102,158,2,30,1,1
63970,53,14367,53,200,94,106,2,30,1,1
41028,80,41028,80,100182,8294,91888,137,127,69,68
56725,53,46910,53,262,90,172,4,59,2,2
49225,443,22877,443,11707,2326,9381,28,19,14,14
56882,53,4292,53,87,87,0,2,61,2,0
40465,443,49132,443,1053,566,487,10,47,6,4
57015,53,23440,53,363,102,261,2,30,1,1
57417,53,14881,53,295,101,194,4,31,2,2
35196,8635,35196,8635,138,78,60,2,5,1,1
51053,80,62409,80,1638,1324,314,10,14,5,5
123,123,8340,123,184,94,90,2,29,1,1
63816,2073,29145,2073,66,66,0,2,7,2,0
49809,443,59332,443,83683,2747,80936,92,125,32,60
50010,53,39739,53,756,95,661,2,31,1,1
57183,53,32090,53,178,94,84,2,30,1,1
123,123,26744,123,184,94,90,2,30,1,1
65465,53,62433,53,372,126,246,2,30,1,1
40880,443,42551,443,8142,2090,6052,22,360,10,12
58664,53,10827,53,167,78,89,2,29,1,1
62232,80,62232,80,2158,1419,739,11,150,6,5
49734,53,51597,53,259,110,149,2,30,1,1
55812,53,26314,53,215,94,121,2,30,1,1
55123,53,24178,53,295,86,209,2,30,1,1
2298,53,2298,53,221,83,138,2,32,1,1
40404,80,22213,80,1502,467,1035,9,180,5,4
10047,443,65295,443,25316,10344,14972,84,170,48,36
6881,12999,32088,12999,622,356,266,4,1201,2,2
59321,53,33396,53,209,70,139,2,30,1,1
64255,53,2166,53,332,102,230,2,30,1,1
64995,53,32873,53,210,110,100,2,31,1,1
57315,443,25232,443,134,60,74,3,5,2,1
56828,53156,12395,53156,66,66,0,1,5,1,0
64316,53,59418,53,184,94,90,2,31,1,1
49867,53,44107,53,170,87,83,2,30,1,1
50265,26650,50101,26650,480,149,331,2,1201,1,1
49884,53,8513,53,252,102,150,2,30,1,1
53111,50809,36816,50809,70,70,0,2,8,2,0
25434,53,25434,53,231,90,141,2,31,1,1
55757,53,24073,53,177,94,83,2,30,1,1
55972,53,18787,53,193,102,91,2,31,1,1
55220,53,22108,53,193,102,91,2,30,1,1
43675,80,34710,80,1676620,41953,1634667,1725,25,636,1089
24692,53,24692,53,235,90,145,2,32,1,1
49476,7010,49476,7010,4215,2090,2125,15,16,8,7
58795,443,24808,443,10273,2573,7700,24,305,8,16
51996,41888,46821,41888,70,70,0,1,4,1,0
40561,443,22594,443,3167,2456,711,15,16,10,5
44894,443,39327,443,1849,1130,719,17,36,9,8
26742,53,26742,53,237,91,146,2,33,1,1
50660,80,51110,80,1658,1247,411,8,15,5,3
65045,53,16728,53,197,102,95,2,29,1,1
58877,53,28014,53,426,118,308,2,31,1,1
36352,443,46352,443,3256,1753,1503,17,315,10,7
55325,53,53505,53,199,102,97,2,30,1,1
45885,80,47215,80,23259,2769,20490,36,143,19,17
64974,53,44237,53,212,108,104,2,31,1,1
49774,53,40062,53,234,102,132,2,30,1,1
46288,443,54873,443,28173,21385,6788,100,41,51,49
53319,443,19200,443,2246,1396,850,15,117,9,6
56320,53,53146,53,183,94,89,2,30,1,1
51600,443,3011,443,12552,2564,9988,29,16,17,12
46713,53,46713,53,217,87,130,2,31,1,1
58933,80,48784,80,2055,1651,404,8,76,5,3
64331,53,12876,53,174,89,85,2,31,1,1
57152,53,56256,53,720,94,626,2,30,1,1
57001,53,25113,53,177,94,83,2,30,1,1
55867,53,58666,53,172,88,84,2,30,1,1
56385,53,3618,53,249,85,164,4,55,2,2
56677,443,37200,443,6313,2068,4245,21,20,12,9
50576,80,30685,80,4189,1691,2498,16,24,9,7
57195,53,29138,53,190,97,93,2,31,1,1
65511,53,1627,53,212,102,110,2,30,1,1
36435,443,62505,443,7046,3518,3528,66,612,35,31
55851,53,26107,53,167,86,81,2,31,1,1
25,55987,25,55987,118,118,0,1,120,1,0
49418,53,51153,53,379,93,286,4,37,2,2
65049,443,55584,443,12674,1396,11278,12,139,2,10
57831,443,53060,443,1320606,47731,1272875,1454,294,552,902
55913,53,58939,53,170,87,83,2,31,1,1
53208,443,19606,443,11664,7921,3743,23,16,14,9
50555,80,24136,80,318,192,126,6,26,4,2
54775,443,48406,443,9501,1502,7999,24,29,13,11
56680,8100,25887,8100,234,234,0,4,11,4,0
49331,53,35223,53,182,94,88,2,30,1,1
50999,53,58447,53,214,78,136,2,30,1,1
38914,443,38914,443,4644,1737,2907,19,28,11,8
49587,53,25936,53,229,102,127,2,30,1,1
49963,53,54838,53,279,96,183,4,59,2,2
57022,53,55045,53,369,150,219,2,30,1,1
51266,16103,36869,16103,70,70,0,1,5,1,0
49216,53,14364,53,181,94,87,2,30,1,1
49629,53,65217,53,198,102,96,2,31,1,1
57074,53,64644,53,195,102,93,2,30,1,1
34310,80,6005,80,1614,1300,314,10,15,5,5
51855,7700,11959,7700,12087,9521,2566,76,32,38,38
33062,53,30187,53,86,86,0,1,30,1,0
51911,14543,20500,14543,70,70,0,1,5,1,0
9430,443,49322,443,6094,771,5323,17,26,9,8
55542,53,5269,53,711,87,624,2,31,1,1
59090,443,47184,443,1469,702,767,20,120,10,10
47423,80,58553,80,1056,682,374,10,15,6,4
50644,80,26132,80,314,192,122,6,25,4,2
49763,443,64834,443,8439,1840,6599,21,127,11,10
49556,443,16559,443,8602,2308,6294,23,82,13,10
42478,80,42478,80,1913,1464,449,10,19,6,4
44097,80,3259,80,36152,2792,33360,55,19,29,26
51240,443,5101,443,9668,4688,4980,42,16,25,17
56381,53,44431,53,192,98,94,2,31,1,1
56976,80,37703,80,214,140,74,4,35,3,1
65463,53,27388,53,210,102,108,2,30,1,1
64935,53,65195,53,193,102,91,2,30,1,1
53767,10004,34912,10004,70,70,0,2,7,2,0
54518,7000,54518,7000,3518,1951,1567,15,15,8,7
49418,4444,6124,4444,238,78,160,2,31,1,1
33229,443,52661,443,2161,1231,930,17,180,9,8
49930,443,7030,443,7934,1836,6098,23,15,13,10
49507,443,28948,443,9536,2399,7137,32,270,17,15
49268,443,60948,443,77368,9874,67494,139,100,65,74
60205,53,4372,53,491,115,376,2,31,1,1
49418,27020,23482,27020,248,78,170,2,30,1,1
51641,443,16546,443,7419,2682,4737,26,66,13,13
64945,53,35387,53,240,86,154,2,30,1,1
52163,14181,27565,14181,70,70,0,1,5,1,0
65300,53,37068,53,190,97,93,2,31,1,1
58297,443,46075,443,7338,2419,4919,19,17,12,7
9084,53,9084,53,224,88,136,2,30,1,1
53137,35111,32550,35111,70,70,0,1,5,1,0
49841,53,34208,53,264,110,154,2,31,1,1
64022,53,20960,53,194,99,95,2,1,1,1
55002,80,41422,80,10872190,337459,10534731,12500,208,5532,6968
56972,53,60729,53,301,126,175,2,30,1,1
59983,443,57676,443,158230,9208,149022,214,21,105,109
56688,443,60189,443,7942,1953,5989,20,15,11,9
49683,53,44598,53,262,94,168,2,29,1,1
49461,53,21062,53,821,102,719,2,29,1,1
51120,80,28128,80,366,240,126,7,21,5,2
52125,49224,18364,49224,70,70,0,2,8,2,0
63294,443,54054,443,9929,4574,5355,29,134,14,15
50861,443,62102,443,1501,590,911,12,26,6,6
49372,443,30393,443,6158,3587,2571,37,104,19,18
65009,53,56985,53,737,94,643,2,30,1,1
48817,6881,48817,6881,479,277,202,4,1200,2,2
65348,53,40565,53,177,94,83,2,30,1,1
65077,443,2224,443,6118,5698,420,12,123,6,6
65280,53,19530,53,166,86,80,2,31,1,1
49514,443,49514,443,234110,36300,197810,309,66,160,149
58432,443,22620,443,26845,11746,15099,187,161,104,83
37655,443,41125,443,9811,3415,6396,29,46,17,12
64017,53,51575,53,202,103,99,2,30,1,1
45345,443,9986,443,2438,1442,996,21,27,12,9
46984,443,45323,443,416,210,206,7,35,4,3
49693,53,17140,53,196,94,102,2,30,1,1
64893,53,6270,53,326,134,192,2,30,1,1
56192,53,30886,53,177,94,83,2,30,1,1
53583,15354,45877,15354,70,70,0,1,4,1,0
51174,443,5740,443,12037,3531,8506,35,271,18,17
62890,993,29471,993,9624,4559,5065,88,196,45,43
56626,443,26601,443,7941,1952,5989,20,15,11,9
47010,53,59094,53,294,94,200,2,30,1,1
41156,443,9223,443,59486,3261,56225,74,360,29,45
53686,19010,53686,19010,70,70,0,1,30,1,0
50386,53,42277,53,782,110,672,2,30,1,1
64028,53,50736,53,263,134,129,2,30,1,1
44956,443,44956,443,5220,1973,3247,22,38,13,9
57043,53,11137,53,164,84,80,2,31,1,1
55772,53,55772,53,194,87,107,2,30,1,1
42569,443,10285,443,7284,1456,5828,21,360,10,11
65211,53,54701,53,183,94,89,2,30,1,1
12364,80,12364,80,7282,653,6629,16,16,8,8
49952,53,43225,53,196,94,102,2,30,1,1
64949,53,48447,53,212,110,102,2,31,1,1
51420,443,42852,443,7653,1188,6465,21,16,12,9
37628,443,18772,443,70,70,0,2,5,2,0
5240,36828,56682,36828,166456,128,166328,270,35,3,267
65507,53,3795,53,166,85,81,2,31,1,1
43460,80,58949,80,23394,1667,21727,38,18,20,18
8108,80,8108,80,7972,840,7132,16,50,6,10
50935,80,12497,80,40645,6133,34512,66,274,33,33
60536,80,60536,80,318,120,198,6,25,3,3
56601,53,17234,53,177,94,83,2,30,1,1
37097,443,17597,443,1835,1190,645,17,26,10,7
50584,49376,27285,49376,1320,300,1020,6,1200,3,3
57002,53,39237,53,211,94,117,2,30,1,1
55881,443,18861,443,25586,4360,21226,57,81,29,28
60896,443,6271,443,14819,8197,6622,47,45,26,21
56738,443,13897,443,7863,1874,5989,20,15,11,9
65491,443,49902,443,452013,13200,438813,465,16,163,302
56524,443,60258,443,759397,22470,736927,766,108,270,496
50481,80,4638,80,318,192,126,6,25,4,2
56857,53,28297,53,195,102,93,2,30,1,1
41776,443,58103,443,3196404,47816,3148588,2668,147,469,2199
54503,443,54503,443,157452,26878,130574,213,214,111,102
56945,53,12864,53,180,94,86,2,30,1,1
57295,443,4265,443,5614,733,4881,16,15,9,7
39456,443,56286,443,6944,1650,5294,24,40,14,10
50564,443,57456,443,1313,876,437,11,26,6,5
35991,443,26374,443,190,70,120,4,14,2,2
51944,53,51944,53,832,106,726,2,30,1,1
53976,52534,48449,52534,70,70,0,2,7,2,0
50265,28520,23958,28520,132,132,0,3,1200,3,0
55651,53,6764,53,760,97,663,2,30,1,1
38732,443,56897,443,9217,1548,7669,25,50,13,12
64912,53,22829,53,258,102,156,2,30,1,1
64029,53,31401,53,176,90,86,2,30,1,1
56047,443,45831,443,126,60,66,3,4,2,1
56765,53,1940,53,188,96,92,2,31,1,1
60523,443,60523,443,1088,641,447,10,25,6,4
55072,53,59629,53,177,94,83,2,30,1,1
64308,53,11059,53,258,102,156,2,29,1,1
59182,53,59092,53,168,78,90,2,30,1,1
56550,53,48765,53,183,94,89,2,29,1,1
50265,57121,42011,57121,132,132,0,3,1200,3,0
58356,443,14561,443,10817,2611,8206,44,135,21,23
60743,40010,9730,40010,316,136,180,6,6,3,3
49229,53,47924,53,183,94,89,2,30,1,1
15503,63684,7728,63684,481,150,331,2,1200,1,1
44037,443,25209,443,5839,3664,2175,13,120,8,5
55088,53,52692,53,170,87,83,2,31,1,1
57373,443,61209,443,5620,927,4693,17,15,10,7
56281,443,8565,443,22352,9825,12527,111,370,55,56
55072,53,55776,53,177,94,83,2,30,1,1
64311,53,19538,53,199,102,97,2,30,1,1
53724,443,35083,443,7759,1476,6283,24,19,14,10
64168,53,53054,53,306,94,212,2,30,1,1
64726,53,62108,53,172,88,84,2,31,1,1
33084,443,45325,443,15474,4188,11286,14,139,4,10
55399,53,43504,53,180,94,86,2,30,1,1
63013,443,17200,443,304,86,218,2,30,1,1
52520,80,54295,80,3224,2776,448,11,15,7,4
49837,53,39920,53,212,108,104,2,30,1,1
60426,25988,33152,25988,70,70,0,1,5,1,0
56819,53,1488,53,209,110,99,2,30,1,1
49730,53,46996,53,211,110,101,2,30,1,1
39343,443,19498,443,8562,1634,6928,27,26,13,14
64711,53,44473,53,206,105,101,2,31,1,1
42783,53,31772,53,199,94,105,2,30,1,1
49945,53,62137,53,198,102,96,2,30,1,1
61476,443,42404,443,230640,12863,217777,253,62,98,155
49566,80,12827,80,1268,703,565,11,23,6,5
49567,53,35834,53,168,86,82,2,30,1,1
55732,53,29178,53,177,94,83,2,30,1,1
56476,53,12813,53,94,94,0,1,30,1,0
27005,27015,35469,27015,886,126,760,2,30,1,1
56020,53,56318,53,168,86,82,2,29,1,1
49824,53,46232,53,178,94,84,2,30,1,1
56987,443,32142,443,3800,1324,2476,14,136,7,7
64726,53,25224,53,178,94,84,2,30,1,1
58807,443,28426,443,6033,770,5263,18,15,8,10
65263,80,27562,80,7440,4032,3408,48,629,25,23
59117,443,59117,443,4659,1752,2907,19,30,11,8
49402,53,62978,53,214,110,104,2,30,1,1
57772,443,4338,443,6783,3270,3513,22,120,11,11
56987,80,45961,80,214,140,74,4,35,3,1
49269,53,11598,53,254,102,152,2,30,1,1
55842,443,52718,443,8661,2036,6625,40,256,19,21
55808,53,62686,53,174,89,85,2,30,1,1
53672,20380,35772,20380,70,70,0,2,7,2,0
50156,443,23478,443,6666,1682,4984,28,1157,15,13
56884,53,20649,53,199,102,97,2,29,1,1
48817,6881,48817,6881,773,279,494,4,1200,2,2
50498,80,12035,80,312,192,120,6,25,4,2
56389,53,5155,53,279,93,186,4,32,2,2
57300,443,65390,443,8979,3093,5886,43,15,24,19
55220,80,9309,80,1146,606,540,8,45,5,3
55804,53,9951,53,816,102,714,2,30,1,1
36668,443,55888,443,142299,120615,21684,348,336,180,168
49900,4500,1746,4500,78,78,0,1,5,1,0
49424,53,11040,53,198,102,96,2,33,1,1
64414,53,2206,53,183,94,89,2,30,1,1
60477,30889,23604,30889,70,70,0,1,5,1,0
60967,443,57765,443,11529,8753,2776,41,120,22,19
55555,53,4576,53,194,102,92,2,31,1,1
28742,53,28742,53,365,233,132,3,32,2,1
60953,443,32015,443,103580,4856,98724,133,17,56,77
49886,53,51424,53,311,102,209,2,30,1,1
55106,53,58487,53,177,94,83,2,30,1,1
27005,32025,48806,32025,887,126,761,2,31,1,1
52857,443,23236,443,10234,2550,7684,47,139,23,24
55955,53,39332,53,164,86,78,2,30,1,1
60768,40010,23273,40010,316,136,180,6,7,3,3
51844,12471,17127,12471,70,70,0,2,8,2,0
52054,50513,53866,50513,66,66,0,1,5,1,0
5588,5588,0,0,3498,1872,1626,48,201,24,24
51079,80,14506,80,19699,2094,17605,32,229,14,18
63930,53,2970,53,377,94,283,2,29,1,1
64882,53,62094,53,343,134,209,2,30,1,1
50207,53,4187,53,195,102,93,2,29,1,1
52313,443,33219,443,52235,4973,47262,81,179,39,42
43693,53,25103,53,164,78,86,2,30,1,1
56639,53,16587,53,168,86,82,2,36,1,1
61829,443,61829,443,280243,73972,206271,309,206,142,167
56977,53,6420,53,322,102,220,2,30,1,1
58754,53,0,0,258,80,178,2,30,1,1
50554,80,7103,80,378,192,186,7,26,4,3
26253,53,26253,53,414,268,146,3,33,2,1
30960,45751,20805,45751,66,66,0,1,3600,1,0
56389,53,30370,53,279,93,186,4,31,2,2
64806,53,37126,53,211,102,109,2,29,1,1
54319,53,54319,53,253,99,154,2,32,1,1
51999,34619,53326,34619,70,70,0,1,5,1,0
49319,443,42333,443,3191,2313,878,17,44,10,7
50701,443,1473,443,45394,5743,39651,133,233,49,84
55688,53,51379,53,184,94,90,2,30,1,1
57273,53,15438,53,177,94,83,2,30,1,1
49613,80,63557,80,374,192,182,7,41,4,3
65228,53,34659,53,267,93,174,4,46,2,2
51849,80,48623,80,366,240,126,7,31,5,2
43391,80,44561,80,1560,684,876,10,15,5,5
55123,53,56989,53,198,102,96,2,30,1,1
60017,443,62960,443,5291,2624,2667,28,145,15,13
47245,443,62935,443,1989,1183,806,16,94,9,7
39545,443,12909,443,5596,3797,1799,27,96,14,13
65165,53,58294,53,200,102,98,2,31,1,1
42338,443,46950,443,4181,998,3183,14,26,7,7
60882,443,27723,443,4485,794,3691,17,25,9,8
55966,53,61391,53,86,86,0,1,29,1,0
49222,53,61468,53,418,150,268,2,30,1,1
52686,53,56390,53,199,94,105,2,30,1,1
43875,443,31372,443,18367,3429,14938,41,500,23,18
55004,80,20099,80,2394,630,1764,9,16,6,3
50285,443,58128,443,7210,2382,4828,33,100,19,14
62908,993,3979,993,8772,3614,5158,77,54,35,42
56676,80,29076,80,78,78,0,2,6,2,0
58666,53,58666,53,235,90,145,2,32,1,1
51724,25807,42911,25807,66,66,0,1,5,1,0
55833,53,54382,53,170,87,83,2,31,1,1
36126,53,44357,53,326,78,248,2,31,1,1
34628,443,42980,443,6392,1025,5367,18,27,9,9
55941,53,27410,53,184,94,90,2,30,1,1
39834,53,46672,53,199,94,105,2,30,1,1
30960,45722,27416,45722,396,396,0,7,3616,7,0
59875,443,49654,443,6922,2214,4708,32,136,20,12
64322,53,37052,53,273,90,183,4,32,2,2
60591,80,30981,80,1364,860,504,13,17,8,5
58881,443,10013,443,1413,876,537,12,26,6,6
53915,1026,61852,1026,70,70,0,1,5,1,0
57304,53,49312,53,228,110,118,2,31,1,1
55575,31948,50458,31948,70,70,0,1,5,1,0
47773,53,42715,53,236,86,150,2,30,1,1
50986,80,14169,80,8074,2261,5813,22,19,13,9
57007,53,36349,53,183,94,89,2,31,1,1
53124,443,13902,443,7459,2962,4497,24,47,14,10
15503,63425,41497,63425,481,150,331,2,1200,1,1
49588,443,55419,443,5879,870,5009,18,53,9,9
55505,53,30588,53,199,102,97,2,31,1,1
56620,443,7502,443,8033,2013,6020,20,16,11,9
54118,443,28446,443,115373,6904,108469,171,117,87,84
65318,53,18281,53,184,94,90,2,30,1,1
56464,53,12940,53,170,87,83,2,31,1,1
55107,53,13262,53,184,94,90,2,30,1,1
52160,80,10438,80,502,310,192,9,31,6,3
55791,53,4698,53,811,94,717,2,30,1,1
54708,443,18474,443,5702,1143,4559,21,41,12,9
61735,443,32889,443,57467,4506,52961,86,30,42,44
31574,53,31574,53,213,90,123,2,29,1,1
49943,80,26149,80,10767,783,9984,19,15,9,10
38684,443,33741,443,90449,3289,87160,93,16,28,65
62620,3389,62620,3389,4410,2321,2089,22,18,12,10
54316,53,0,0,325,77,248,2,31,1,1
64276,53,2055,53,436,89,347,4,42,2,2
50347,53,2188,53,756,94,662,2,29,1,1
54287,443,5975,443,250,190,60,2,5,1,1
41000,443,31779,443,10675,5079,5596,88,588,47,41
2267,53,31811,53,204,118,86,2,31,1,1
57902,443,7313,443,1912,1213,699,19,169,11,8
42996,53,58544,53,168,78,90,2,30,1,1
43106,443,35974,443,3259,1913,1346,18,16,8,10
58029,80,1723,80,374,192,182,7,21,4,3
56312,53,62526,53,195,102,93,2,30,1,1
49513,53,63183,53,200,102,98,2,29,1,1
62058,443,34202,443,8666,2933,5733,46,15,27,19
56884,53,31028,53,177,94,83,2,30,1,1
61838,443,61838,443,36811,5190,31621,60,150,24,36
49649,443,20901,443,10099,1721,8378,27,46,14,13
50326,53,27014,53,720,94,626,2,31,1,1
51513,443,63128,443,10839,705,10134,14,46,4,10
27005,1202,29779,1202,865,126,739,2,29,1,1
64321,53,56788,53,195,102,93,2,31,1,1
49513,53,13327,53,200,102,98,2,31,1,1
62439,443,26291,443,16246,11056,5190,37,45,21,16
64574,443,40988,443,9151,2109,7042,27,30,15,12
49402,53,34826,53,214,110,104,2,30,1,1
33313,443,29395,443,9675,2389,7286,43,143,21,22
51949,5484,1068,5484,70,70,0,2,8,2,0
55332,53,45716,53,211,110,101,2,30,1,1
55081,53,2837,53,711,87,624,2,31,1,1
51936,17650,3656,17650,70,70,0,1,5,1,0
49752,53,10768,53,193,102,91,2,29,1,1
22939,443,22939,443,6993,960,6033,17,31,10,7
55803,53,18638,53,261,89,172,4,32,2,2
64471,53,53728,53,264,110,154,2,30,1,1
53458,443,20818,443,7584,7094,490,14,123,7,7
49488,53,29306,53,194,102,92,2,30,1,1
60240,443,63324,443,4310,2523,1787,42,120,24,18
47595,33436,0,0,106,106,0,1,60,1,0
51747,7000,51747,7000,3132,815,2317,14,15,7,7
9334,443,58101,443,674,128,546,12,46,3,9
56273,53,59580,53,182,93,89,2,30,1,1
56673,443,49966,443,5726,1474,4252,22,81,13,9
49174,53,1263,53,166,86,80,2,31,1,1
48786,443,62894,443,7130,1890,5240,25,33,12,13
55935,53,36129,53,819,102,717,2,30,1,1
50481,443,48883,443,7653,1188,6465,21,15,12,9
53576,23505,43782,23505,70,70,0,2,7,2,0
60296,80,32377,80,1463,865,598,11,144,6,5
51682,80,11682,80,59786,3488,56298,119,55,45,74
49432,53,5253,53,177,94,83,2,31,1,1
64188,53,45023,53,194,94,100,2,30,1,1
56767,443,38617,443,7941,1952,5989,20,15,11,9
65391,53,47962,53,720,94,626,2,30,1,1
64642,53,25504,53,718,94,624,2,30,1,1
52139,38259,57318,38259,70,70,0,2,7,2,0
55179,53,36377,53,188,96,92,2,31,1,1
57325,443,9317,443,5613,733,4880,16,14,9,7
65196,53,56319,53,172,94,78,2,29,1,1
56901,53,16725,53,264,94,170,2,31,1,1
37042,53,37042,53,237,98,139,2,30,1,1
36928,53,43446,53,241,78,163,2,30,1,1
39118,443,29645,443,5229,2388,2841,23,367,12,11
61408,443,17703,443,9492,3543,5949,49,117,25,24
49826,443,4711,443,1738,1159,579,16,74,10,6
57282,53,4028,53,199,102,97,2,29,1,1
50258,5228,5532,5228,6764,1575,5189,25,157,14,11
55939,53,41055,53,177,94,83,2,30,1,1
57004,53,12740,53,195,78,117,2,30,1,1
51947,80,31823,80,1582,866,716,11,27,7,4
53681,31466,20007,31466,70,70,0,1,5,1,0
50261,443,64119,443,10320,3495,6825,45,136,25,20
55630,53,58025,53,194,99,95,2,31,1,1
9238,80,17779,80,378,192,186,7,26,4,3
55487,53,20467,53,198,101,97,2,31,1,1
39872,53,48299,53,78,78,0,1,30,1,0
50908,443,7886,443,124,64,60,2,15,1,1
50362,53,31941,53,181,98,83,2,31,1,1
57238,53,29243,53,165,86,79,2,30,1,1
59926,80,37542,80,2615,830,1785,10,32,6,4
60249,80,1265,80,31138,6772,24366,40,149,17,23
52501,53,50653,53,201,80,121,2,30,1,1
61443,443,44561,443,7832,1143,6689,19,26,9,10
49935,53,2977,53,370,94,276,2,30,1,1
38642,443,33643,443,1468,893,575,15,62,8,7
51120,443,19662,443,2940,787,2153,11,119,5,6
44847,9912,37796,9912,502,150,352,2,1200,1,1
49951,80,47463,80,38898,1623,37275,49,15,21,28
39931,443,19532,443,4464,2847,1617,29,80,15,14
49327,443,33965,443,54335,2550,51785,74,42,29,45
63626,443,34704,443,15769,1619,14150,17,138,4,13
65201,53,38349,53,216,110,106,2,30,1,1
44514,443,59227,443,448741,15805,432936,491,109,181,310
60289,80,35170,80,1928,906,1022,11,145,6,5
51979,443,5164,443,11555,2620,8935,45,822,18,27
65045,53,56055,53,197,102,95,2,32,1,1
49157,53,58041,53,184,94,90,2,31,1,1
55538,53,48787,53,195,102,93,2,30,1,1
40764,443,58656,443,3321,1297,2024,13,28,7,6
49512,53,53127,53,190,97,93,2,31,1,1
49224,80,15279,80,2999,2271,728,11,15,6,5
53063,443,53063,443,6793,3206,3587,25,52,15,10
33893,443,60654,443,8623,1758,6865,36,28,17,19
56756,13973,64423,13973,70,70,0,1,5,1,0
57228,53,50397,53,344,94,250,2,30,1,1
56985,53,40638,53,165,86,79,2,29,1,1
43851,53,43851,53,227,90,137,2,30,1,1
64555,53,10175,53,469,97,372,4,49,2,2
64904,53,57832,53,199,102,97,2,29,1,1
63949,53,2589,53,338,97,241,4,43,2,2
49864,53,57559,53,193,102,91,2,30,1,1
36405,443,39201,443,1149,709,440,13,38,8,5
64847,53,37930,53,211,102,109,2,30,1,1
41664,53,40771,53,376,78,298,2,30,1,1
51221,3054,33559,3054,870,330,540,12,1320,6,6
64885,53,51711,53,212,102,110,2,31,1,1
58767,443,20066,443,5167,700,4467,16,15,7,9
52154,4635,63801,4635,70,70,0,2,8,2,0
48734,443,7322,443,256887,11565,245322,293,56,112,181
64144,53,4671,53,193,102,91,2,29,1,1
35423,443,35423,443,4555,1648,2907,20,29,12,8
57424,53,65254,53,177,94,83,2,30,1,1
50237,443,44543,443,2994,1521,1473,15,83,9,6
52071,57491,41650,57491,70,70,0,2,8,2,0
64907,53,16767,53,211,102,109,2,30,1,1
56171,53,61869,53,756,95,661,2,30,1,1
9047,443,22557,443,3645,609,3036,13,120,6,7
18743,53,18743,53,235,90,145,2,31,1,1
56592,53,12698,53,200,102,98,2,29,1,1
50211,1688,29763,1688,70,70,0,2,7,2,0
51958,51322,52514,51322,70,70,0,2,7,2,0
55391,53,33139,53,210,110,100,2,30,1,1
55786,53,44397,53,177,94,83,2,30,1,1
64751,53,58884,53,178,94,84,2,31,1,1
60480,60519,7495,60519,320,140,180,6,8,3,3
51816,27721,15774,27721,70,70,0,1,5,1,0
57340,53,50973,53,258,110,148,2,30,1,1
49840,443,58601,443,6998,1906,5092,22,24,12,10
50528,80,29237,80,66430,7013,59417,93,156,40,53
27005,29999,60743,29999,887,126,761,2,31,1,1
64017,53,3169,53,209,110,99,2,30,1,1
15503,61284,64885,61284,16553,6930,9623,212,6269,106,106
56522,53,65076,53,177,94,83,2,31,1,1
33576,443,52498,443,170319,23354,146965,283,34,121,162
49418,37569,8517,37569,246,78,168,2,30,1,1
64281,53,18314,53,212,108,104,2,30,1,1
63972,53,23173,53,186,95,91,2,30,1,1
41508,53,41508,53,244,98,146,2,32,1,1
56138,53,22955,53,177,94,83,2,30,1,1
64719,53,55102,53,263,118,145,2,30,1,1
44805,443,37165,443,6975,2168,4807,20,15,11,9
50265,51413,14137,51413,460,150,310,2,1200,1,1
64914,443,15488,443,6120028,157580,5962448,6108,75,2083,4025
57240,53,0,0,230,87,143,2,30,1,1
65418,53,5528,53,197,94,103,2,30,1,1
10151,6881,61137,6881,469,150,319,2,1200,1,1
56649,53,35726,53,152,78,74,2,30,1,1
64279,53,42792,53,177,94,83,2,30,1,1
49737,443,51096,443,334252,14917,319335,405,73,179,226
58905,443,41213,443,13055,5677,7378,29,122,15,14
56455,53,48314,53,182,93,89,2,31,1,1
49663,53,58279,53,195,102,93,2,30,1,1
53677,10657,55902,10657,70,70,0,1,4,1,0
6881,7005,9518,7005,118,118,0,1,1200,1,0
55019,53,16040,53,299,110,189,4,32,2,2
49641,443,54383,443,5776,1079,4697,15,53,8,7
64766,53,54775,53,195,102,93,2,30,1,1
48983,15000,51295,15000,130,70,60,2,6,1,1
57904,443,64826,443,7912,3215,4697,23,20,12,11
39571,443,44587,443,580560,15724,564836,583,30,187,396
55830,53,59149,53,164,84,80,2,31,1,1
53159,58710,30090,58710,698,320,378,10,18,6,4
56982,53,27888,53,177,94,83,2,31,1,1
57140,53,16030,53,170,87,83,2,30,1,1
64347,53,32269,53,193,102,91,2,30,1,1
63967,53,22995,53,195,102,93,2,33,1,1
53037,80,8932,80,2906,1233,1673,24,92,13,11
56637,53,42734,53,711,87,624,2,30,1,1
51691,993,8747,993,17462,4583,12879,93,19,47,46
55392,53,27900,53,195,102,93,2,31,1,1
51808,443,64378,443,3871,1166,2705,13,136,6,7
53912,3478,54737,3478,3532,1792,1740,58,88,29,29
49795,53,15978,53,209,110,99,2,30,1,1
63978,53,35845,53,214,110,104,2,30,1,1
46773,80,41646,80,2075,1376,699,13,83,7,6
38160,443,38160,443,11290,5394,5896,37,80,21,16
53690,42301,12821,42301,1821,1088,733,17,15,9,8
56103,53,56052,53,279,94,185,2,30,1,1
56963,53,63248,53,210,110,100,2,30,1,1
63951,443,17963,443,6718,3582,3136,18,126,10,8
35377,443,51737,443,15771,2037,13734,39,187,20,19
56416,53,40943,53,969,86,883,2,29,1,1
59636,443,44710,443,3197,1047,2150,15,120,8,7
51899,80,55362,80,1758,989,769,13,76,8,5
34750,80,47643,80,111678,5254,106424,150,240,71,79
33654,443,14790,443,8628,2898,5730,20,144,9,11
63597,443,64564,443,19821,11622,8199,77,135,39,38
56923,53,49262,53,711,87,624,2,30,1,1
49502,443,43578,443,31780,3232,28548,44,29,16,28
64368,443,54903,443,4741,1306,3435,26,300,14,12
53822,18716,3913,18716,70,70,0,2,8,2,0
36567,443,58934,443,2341,1054,1287,20,299,7,13
52162,15104,24399,15104,70,70,0,1,5,1,0
54956,53,35292,53,711,87,624,2,31,1,1
57120,443,27868,443,23906,9380,14526,40,16,24,16
64804,53,26105,53,182,102,80,2,30,1,1
9291,80,9291,80,208056,7568,200488,227,39,88,139
48265,443,35728,443,7379,2268,5111,18,134,8,10
57416,53,2716,53,193,102,91,2,30,1,1
49545,53,14108,53,195,102,93,2,30,1,1
62854,443,62854,443,4579,1672,2907,19,29,11,8
26833,443,13799,443,21487,16430,5057,39,21,22,17
36225,443,18751,443,638,350,288,10,26,6,4
55375,53,46240,53,711,87,624,2,31,1,1
49513,80,22592,80,476333,9582,466751,453,225,135,318
44065,443,13980,443,6114,862,5252,17,71,9,8
64770,53,5158,53,360,93,267,3,37,2,1
27005,33055,54134,33055,888,126,762,2,31,1,1
60514,80,54084,80,1641,944,697,9,15,5,4
40122,443,13389,443,8235,2076,6159,24,330,11,13
49656,443,39036,443,6006,763,5243,17,52,8,9
51830,32787,57258,32787,70,70,0,1,5,1,0
51809,52528,58895,52528,70,70,0,1,4,1,0
55889,53,65516,53,168,86,82,2,30,1,1
49936,53,50715,53,152,78,74,2,31,1,1
55919,53,57611,53,754,94,660,2,31,1,1
56948,53,22387,53,183,94,89,2,30,1,1
63960,53,46740,53,228,110,118,2,29,1,1
51811,443,43399,443,4007,2063,1944,12,122,6,6
49418,27017,44700,27017,78,78,0,1,30,1,0
0,0,0,0,480,244,236,4,0,2,2
58866,443,52755,443,2353,1453,900,16,15,8,8
52776,80,21861,80,432,240,192,8,101,5,3
56803,443,62661,443,8020,2000,6020,20,15,11,9
26900,27017,59495,27017,422,164,258,6,30,3,3
49818,53,22415,53,211,102,109,2,29,1,1
60213,80,45825,80,70,70,0,1,4,1,0
27005,27015,64723,27015,901,126,775,2,30,1,1
56748,53,15879,53,184,94,90,2,30,1,1
60782,3389,60782,3389,3504,1790,1714,17,33,9,8
51515,443,8850,443,16287,13303,2984,49,38,26,23
56106,53,61650,53,816,102,714,2,30,1,1
47747,443,43132,443,4187,1350,2837,18,321,8,10
27005,27016,2493,27016,895,126,769,2,30,1,1
50069,53,27415,53,179,94,85,2,30,1,1
49246,53,41120,53,172,94,78,2,30,1,1
51656,53,51656,53,198,89,109,2,30,1,1
53601,30160,44927,30160,70,70,0,2,8,2,0
54369,53,50744,53,168,78,90,2,31,1,1
60340,443,5002,443,6844,2441,4403,19,181,9,10
61717,80,65373,80,6160,2912,3248,17,18,9,8
64965,27049,54387,27049,747,462,285,2,31,1,1
51947,16935,29468,16935,70,70,0,2,8,2,0
51503,443,40605,443,4801,702,4099,13,16,8,5
52054,50513,38403,50513,70,70,0,2,9,2,0
49418,16666,10447,16666,71,71,0,1,30,1,0
56577,53,39696,53,182,94,88,2,30,1,1
40039,80,57862,80,1155,781,374,10,15,6,4
61015,443,14729,443,7863,1962,5901,29,270,16,13
45189,443,22726,443,10789,5723,5066,36,136,17,19
55687,53,17643,53,731,85,646,2,31,1,1
55677,16588,6838,16588,70,70,0,1,5,1,0
49574,53,2504,53,496,92,404,4,58,2,2
58640,443,44043,443,4440,114,4326,7,122,2,5
50680,80,61821,80,23386,2375,21011,30,21,12,18
60769,443,3938,443,7639,2051,5588,33,120,17,16
54957,53,30594,53,197,102,95,2,33,1,1
49738,53,39292,53,228,86,142,2,29,1,1
55421,53,56436,53,200,102,98,2,30,1,1
56932,53,30512,53,172,94,78,2,30,1,1
55769,53,28226,53,373,103,270,4,43,2,2
56835,53,56114,53,177,94,83,2,29,1,1
50059,53,45752,53,718,94,624,2,30,1,1
57470,6969,61511,6969,37677,7875,29802,115,3342,58,57
50944,443,36385,443,9517,1898,7619,21,85,11,10
64430,53,25685,53,245,118,127,2,30,1,1
56414,53,17231,53,88,88,0,1,30,1,0
55251,53,30492,53,212,110,102,2,30,1,1
60796,80,60796,80,13869,3749,10120,28,26,15,13
51834,80,36073,80,366,240,126,7,32,5,2
55520,53,61502,53,194,102,92,2,30,1,1
57033,53,53118,53,216,110,106,2,30,1,1
55259,443,24007,443,4523,3044,1479,17,64,10,7
63123,443,2036,443,5530,2343,3187,22,128,10,12
56258,53,14638,53,167,86,81,2,29,1,1
49501,443,27772,443,1882,1108,774,17,135,10,7
53883,24830,47697,24830,258,70,188,4,7,2,2
48817,1722,48817,1722,158,158,0,1,1200,1,0
56800,443,33972,443,7518,2862,4656,18,75,10,8
54673,443,44962,443,10244,2295,7949,38,121,20,18
53836,443,61812,443,499,425,74,4,0,3,1
27005,27015,32807,27015,1622,126,1496,4,30,2,2
51689,993,61833,993,11580,4032,7548,79,19,40,39
51957,53,51957,53,825,99,726,2,31,1,1
65231,53,2677,53,200,102,98,2,30,1,1
33262,443,40811,443,4067,2672,1395,23,23,14,9
49914,53,9646,53,718,94,624,2,30,1,1
55266,53,20409,53,365,102,263,2,30,1,1
49561,53,14887,53,211,94,117,2,30,1,1
57470,31114,57905,31114,528,528,0,9,1199,9,0
51393,443,1567,443,4721,2724,1997,35,130,19,16
53707,53,63109,53,86,86,0,1,30,1,0
54207,443,5893,443,4788,785,4003,15,70,8,7
53140,80,7687,80,2560,2083,477,13,15,7,6
52145,443,2383,443,190,70,120,4,15,2,2
65501,53,61730,53,774,102,672,2,30,1,1
64947,53,11296,53,275,96,179,4,41,2,2
35776,443,4893,443,7500,2339,5161,18,136,8,10
55970,53,39090,53,810,108,702,2,31,1,1
63870,6881,25073,6881,70,70,0,1,5,1,0
37591,443,50251,443,499,425,74,4,0,3,1
53445,443,53445,443,960,539,421,9,30,5,4
60911,443,41186,443,3862,2679,1183,28,46,15,13
55464,53,8236,53,214,110,104,2,30,1,1
56470,53,27427,53,168,78,90,2,30,1,1
52143,443,25458,443,712,452,260,8,25,4,4
49777,53,2324,53,485,79,406,4,31,2,2
57385,53,16664,53,177,94,83,2,30,1,1
1462,41599,5098,41599,70,70,0,1,5,1,0
27005,32028,64745,32028,900,126,774,2,31,1,1
53096,443,46942,443,13599,5335,8264,35,171,18,17
34419,443,53851,443,2713,1386,1327,18,316,10,8
53502,443,33693,443,10893,6516,4377,36,131,16,20
49487,53,55528,53,183,94,89,2,30,1,1
56672,53,60163,53,199,102,97,2,30,1,1
50020,443,25948,443,9175,2213,6962,37,121,19,18
60163,443,11476,443,3041,1745,1296,28,3600,15,13
52263,16350,50284,16350,70,70,0,2,8,2,0
50091,53,60727,53,183,94,89,2,30,1,1
55423,53,31871,53,177,94,83,2,31,1,1
44984,80,44984,80,7061,2943,4118,16,23,9,7
36839,80,35799,80,10345,6823,3522,25,25,14,11
57411,53,22912,53,192,98,94,2,31,1,1
65501,443,33887,443,416348,12360,403988,429,16,151,278
57001,53,34470,53,210,110,100,2,30,1,1
55487,53,11679,53,195,102,93,2,30,1,1
59873,443,3851,443,1066,545,521,11,28,5,6
43016,53,43016,53,235,90,145,2,32,1,1
53073,80,1603,80,2594,1200,1394,16,17,10,6
26831,443,14363,443,7283,2586,4697,22,19,11,11
64245,53,47905,53,199,102,97,2,30,1,1
60985,443,15568,443,30399,22692,7707,57,144,31,26
49162,53,33354,53,183,94,89,2,30,1,1
56792,42155,2470,42155,70,70,0,2,8,2,0
56952,53,7156,53,186,95,91,2,30,1,1
56651,443,21328,443,8058,2038,6020,20,15,11,9
64859,53,38916,53,385,134,251,2,30,1,1
51388,443,13575,443,6703,3312,3391,31,145,14,17
49800,53,35452,53,485,93,392,4,48,2,2
57014,80,25497,80,214,140,74,4,30,3,1
49370,443,17640,443,350,210,140,6,16,4,2
65518,53,57051,53,198,94,104,2,30,1,1
49227,53,39429,53,174,89,85,2,30,1,1
51952,80,54561,80,1263,640,623,12,45,7,5
37965,47686,60898,47686,480,149,331,2,1200,1,1
51514,443,43958,443,2188,1329,859,23,19,13,10
55605,53,47383,53,772,103,669,2,31,1,1
57173,53,39121,53,168,78,90,2,30,1,1
60770,443,16135,443,4239,2026,2213,15,120,7,8
52084,30863,5581,30863,70,70,0,1,5,1,0
55776,53,14354,53,271,93,178,4,31,2,2
49679,443,62696,443,7938,1721,6217,25,172,12,13
52171,63033,49679,63033,70,70,0,2,8,2,0
56837,53,1718,53,227,110,117,2,30,1,1
55582,53,48223,53,344,107,237,4,54,2,2
53958,80,11138,80,130,70,60,2,15,1,1
50912,443,13273,443,5159,1080,4079,20,255,10,10
49762,53,65280,53,184,94,90,2,30,1,1
55076,53,44619,53,760,97,663,2,30,1,1
51868,30305,49639,30305,70,70,0,2,8,2,0
64128,53,32109,53,186,95,91,2,30,1,1
59859,53,1491,53,218,86,132,2,30,1,1
50658,443,64697,443,4876,2522,2354,22,83,13,9
56539,443,36962,443,8335,2802,5533,26,567,14,12
14417,443,14417,443,15556,2973,12583,41,80,22,19
42060,53,44916,53,164,78,86,2,30,1,1
58438,53,46803,53,246,102,144,2,29,1,1
65037,53,16035,53,210,110,100,2,29,1,1
55697,53,14156,53,193,102,91,2,31,1,1
49798,53,59765,53,365,97,268,4,40,2,2
53964,24389,41775,24389,1473,842,631,12,15,7,5
51674,80,17494,80,533166,22786,510380,905,50,321,584
35644,53,9492,53,198,93,105,2,30,1,1
38630,443,20829,443,9277,3025,6252,32,109,17,15
57319,53,57319,53,198,90,108,2,29,1,1
9129,80,33910,80,318,192,126,6,30,4,2
63966,42532,21022,42532,66,66,0,2,7,2,0
56724,53,27864,53,182,94,88,2,30,1,1
50005,53,1672,53,199,102,97,2,30,1,1
49930,53,6830,53,361,94,267,2,30,1,1
55068,53,59463,53,196,102,94,2,29,1,1
42999,3389,42999,3389,3910,1805,2105,20,19,12,8
20253,53,20253,53,404,259,145,3,33,2,1
65248,53,32569,53,779,86,693,2,30,1,1
36674,443,40100,443,11882,3450,8432,39,120,19,20
59807,53,15491,53,263,94,169,2,30,1,1
64539,53,5433,53,170,87,83,2,31,1,1
50901,80,56736,80,11091,2772,8319,22,154,12,10
52280,443,52280,443,1615,941,674,15,20,7,8
65331,53,63156,53,816,102,714,2,30,1,1
50038,53,65055,53,286,87,199,4,59,2,2
65343,53,41692,53,184,94,90,2,29,1,1
48817,51413,48817,51413,479,152,327,2,1200,1,1
65238,53,22542,53,168,86,82,2,29,1,1
51954,12380,62025,12380,70,70,0,2,7,2,0
34155,443,22614,443,11294,2234,9060,23,139,12,11
55693,53,60577,53,748,95,653,2,31,1,1
53249,443,53249,443,1404,697,707,17,121,8,9
58638,5900,58638,5900,62,62,0,1,5,1,0
50826,443,11870,443,6601,1120,5481,17,115,9,8
49385,53,59773,53,241,102,139,2,29,1,1
64306,53,23219,53,216,110,106,2,30,1,1
54053,443,54053,443,1468,763,705,16,181,8,8
49175,53,45258,53,193,102,91,2,31,1,1
53753,443,14141,443,6973,2166,4807,20,15,11,9
16776,53,16776,53,197,90,107,2,30,1,1
59644,443,54066,443,8362065,55143,8306922,6375,152,332,6043
43494,443,46566,443,670,382,288,10,133,6,4
40888,8434,40888,8434,156,156,0,3,8,3,0
57129,53,40985,53,793,101,692,2,31,1,1
34726,53,62948,53,168,78,90,2,30,1,1
55026,53,14938,53,177,94,83,2,30,1,1
42298,40012,32444,40012,148,86,62,2,29,1,1
50477,443,35054,443,2604,1413,1191,15,83,9,6
60027,443,20291,443,8216,2269,5947,42,106,25,17
50983,80,17764,80,7765,2215,5550,20,20,12,8
50837,443,12077,443,3292,2022,1270,16,16,9,7
34989,80,37174,80,350,210,140,6,28,4,2
64995,53,14595,53,210,110,100,2,30,1,1
51104,13011,33495,13011,948,473,475,13,15,7,6
51221,32329,23850,32329,870,330,540,12,1316,6,6
36010,443,44715,443,5689,1505,4184,24,19,13,11
51924,80,58410,80,32222,3146,29076,43,31,18,25
44252,443,6888,443,14455,6007,8448,45,120,26,19
64723,443,61032,443,7978900,79979,7898921,6464,210,644,5820
58681,123,50487,123,184,94,90,2,30,1,1
49567,80,10114,80,2855,1388,1467,12,44,7,5
65419,443,11559,443,2494,1643,851,17,24,9,8
5588,5588,0,0,3354,1792,1562,46,194,23,23
55406,53,15179,53,768,99,669,2,30,1,1
53609,53,21780,53,385,94,291,2,30,1,1
53259,443,54002,443,6250,1774,4476,27,17,14,13
53811,8999,57709,8999,1322,799,523,13,16,8,5
56987,53,59227,53,196,102,94,2,30,1,1
37142,443,20503,443,17201,10578,6623,57,145,27,30
55639,53,59060,53,196,102,94,2,30,1,1
53119,58118,15448,58118,70,70,0,2,8,2,0
54678,443,37690,443,84066,79714,4352,98,125,66,32
52494,443,23008,443,5782,1008,4774,17,15,8,9
64080,11801,22050,11801,66,66,0,2,8,2,0
57266,443,13002,443,16452,7129,9323,44,47,25,19
5588,5588,0,0,3354,1792,1562,46,192,23,23
58999,53,58999,53,825,99,726,2,30,1,1
49920,443,27141,443,9759,1989,7770,25,16,13,12
65011,53,42934,53,168,86,82,2,30,1,1
57899,443,40248,443,6115,1035,5080,21,170,11,10
37336,443,19104,443,995086,50081,945005,1281,216,515,766
53674,31724,4834,31724,70,70,0,2,7,2,0
55903,53,64113,53,177,94,83,2,29,1,1
57069,443,33403,443,15125,2482,12643,53,38,27,26
40998,80,36819,80,103213,8726,94487,178,38,109,69
51761,19136,54705,19136,70,70,0,2,8,2,0
60085,443,22950,443,1000,557,443,11,141,6,5
65239,53,58774,53,199,102,97,2,29,1,1
55176,53,23799,53,181,94,87,2,30,1,1
49756,53,22675,53,243,118,125,2,30,1,1
55752,53,35033,53,170,87,83,2,31,1,1
40204,40001,61401,40001,244,181,63,2,31,1,1
54124,443,54124,443,105609,16179,89430,150,84,79,71
27005,27016,25142,27016,883,126,757,2,30,1,1
60343,80,4297,80,2005,1094,911,11,87,6,5
64431,53,36891,53,177,94,83,2,30,1,1
54982,53,26204,53,282,96,186,4,48,2,2
64748,53,54501,53,183,94,89,2,30,1,1
58638,5900,58638,5900,130,66,64,2,4,1,1
64484,53,32900,53,732,239,493,6,51,3,3
53261,443,44593,443,5025,973,4052,19,53,10,9
55678,53,55305,53,270,88,182,4,54,2,2
51221,51413,63036,51413,459,149,310,2,1200,1,1
55677,16588,61905,16588,70,70,0,2,8,2,0
57350,53,53074,53,257,94,163,2,30,1,1
54123,443,54123,443,79652,20710,58942,112,84,58,54
59284,443,33120,443,10243,3289,6954,41,26,21,20
42980,80,62897,80,944,529,415,11,315,6,5
50285,53,26837,53,760,97,663,2,31,1,1
57308,443,32709,443,8837,3033,5804,44,16,24,20
65522,443,46739,443,399281,11940,387341,412,16,145,267
50411,53,28874,53,86,86,0,1,30,1,0
50486,443,7512,443,1043,556,487,10,16,6,4
55617,53,59978,53,194,102,92,2,30,1,1
52245,443,52245,443,1615,941,674,15,21,7,8
55207,80,45213,80,1979,1326,653,16,500,10,6
26081,53,4535,53,243667,236247,7420,2897,90,2851,46
56478,80,51578,80,73400,4542,68858,87,136,37,50
123,123,4169,123,184,94,90,2,31,1,1
36834,443,42042,443,8975,1129,7846,19,31,10,9
56621,53,42291,53,170,87,83,2,30,1,1
52070,80,56531,80,3572,2746,826,14,15,8,6
55867,53,45353,53,178,94,84,2,30,1,1
52736,443,12534,443,1217451,39642,1177809,1359,39,539,820
53678,31592,21651,31592,70,70,0,1,5,1,0
50615,443,36645,443,1577,949,628,16,71,9,7
53543,51819,47777,51819,70,70,0,1,4,1,0
59179,53,29104,53,260,86,174,2,30,1,1
57492,53,57492,53,218,90,128,2,30,1,1
17750,18866,37630,18866,150,150,0,1,1200,1,0
60875,443,41853,443,7251,2098,5153,27,25,15,12
40831,80,63406,80,1614,1300,314,10,15,5,5
6881,25649,11591,25649,509,150,359,2,1200,1,1
52932,443,50755,443,3032,1082,1950,9,120,5,4
49732,80,36115,80,5236,1070,4166,13,145,6,7
49532,53,40570,53,195,102,93,2,30,1,1
50918,80,48461,80,9643,812,8831,18,128,8,10
49896,443,39739,443,151170,17408,133762,256,130,118,138
56941,53,4680,53,192,98,94,2,31,1,1
50265,45589,64355,45589,132,132,0,3,1200,3,0
53718,1053,4101,1053,320,140,180,6,8,3,3
49201,53,24647,53,243,86,157,2,30,1,1
55890,53,44710,53,193,102,91,2,31,1,1
56468,53,56108,53,209,110,99,2,30,1,1
47376,443,12829,443,2944,778,2166,10,120,5,5
33505,80,10878,80,130,70,60,2,15,1,1
37611,443,44824,443,499,425,74,4,0,3,1
57377,443,22825,443,11247,3991,7256,30,149,14,16
51704,9266,12391,9266,66,66,0,1,5,1,0
55605,53,24748,53,195,102,93,2,29,1,1
55234,443,6100,443,9176,2226,6950,28,31,16,12
43109,80,31634,80,7607,3563,4044,18,20,9,9
56659,53,34690,53,199,94,105,2,30,1,1
3440,7000,3440,7000,3127,676,2451,15,19,7,8
64049,53,41804,53,209,102,107,2,30,1,1
49349,53,37003,53,183,94,89,2,31,1,1
57702,53,57702,53,398,255,143,3,32,2,1
56111,53,27769,53,227,110,117,2,30,1,1
60087,443,43883,443,5470,3223,2247,43,172,22,21
57905,443,45669,443,1851,1152,699,18,169,10,8
54992,53,62120,53,195,102,93,2,30,1,1
4025,53,4025,53,230,90,140,2,30,1,1
51417,443,60924,443,25865,7151,18714,36,15,19,17
56620,53,8741,53,214,102,112,2,30,1,1
64327,53,51961,53,210,110,100,2,30,1,1
49703,53,48424,53,198,86,112,2,30,1,1
64684,53,19854,53,184,94,90,2,31,1,1
34837,80,34635,80,7794,1470,6324,18,151,9,9
57586,443,57586,443,13517,1521,11996,32,87,11,21
57343,53,25885,53,181,94,87,2,30,1,1
57340,53,7589,53,216,110,106,2,30,1,1
59882,53,29947,53,244,86,158,2,29,1,1
49296,443,49940,443,20862040,250452,20611588,16880,170,1832,15048
49610,53,51833,53,212,102,110,2,30,1,1
52126,80,5898,80,3592,2098,1494,26,417,14,12
53524,45395,6631,45395,70,70,0,2,8,2,0
41484,443,26840,443,433834,12764,421070,452,32,156,296
42716,443,52714,443,12561,2901,9660,29,17,15,14
49454,443,27908,443,7212,1757,5455,20,17,10,10
27005,27020,19187,27020,890,126,764,2,30,1,1
51233,443,5696,443,9925,2939,6986,30,46,17,13
50635,53,9293,53,199,94,105,2,30,1,1
49767,53,45579,53,341,102,239,4,37,2,2
49423,443,63927,443,4287346,130607,4156739,4409,282,1473,2936
54757,443,1080,443,6954,1758,5196,29,361,15,14
49418,27015,33694,27015,246,78,168,2,31,1,1
55991,53,9133,53,199,102,97,2,30,1,1
51880,18468,1087,18468,70,70,0,2,8,2,0
64140,53,22655,53,306,94,212,4,33,2,2
53817,59216,40309,59216,164,70,94,2,5,1,1
50170,53,38281,53,260,86,174,2,29,1,1
64403,53,33316,53,193,102,91,2,30,1,1
39462,80,39462,80,1058,497,561,10,16,6,4
49316,53,52712,53,338,102,236,2,30,1,1
50542,80,60343,80,1607,970,637,8,16,5,3
56749,80,24129,80,194,128,66,4,25,3,1
55417,53,4838,53,199,102,97,2,30,1,1
51081,53,49643,53,168,78,90,2,30,1,1
36366,443,13851,443,6147,910,5237,18,16,10,8
51653,443,13431,443,6660,1542,5118,21,305,11,10
35497,443,49704,443,162,102,60,2,4,1,1
63141,55860,18547,55860,316,190,126,5,15,3,2
55254,53,52828,53,287,102,185,2,30,1,1
27005,27015,8670,27015,877,126,751,2,30,1,1
47039,443,29901,443,2809,1884,925,19,25,11,8
50617,80,45162,80,1658,1247,411,8,14,5,3
60428,55172,58181,55172,320,140,180,6,7,3,3
55015,443,30029,443,8133,2402,5731,35,255,17,18
49418,27025,65106,27025,240,78,162,2,30,1,1
50056,27018,46603,27018,468,390,78,5,30,4,1
58890,15000,13228,15000,138,78,60,2,5,1,1
56363,443,4827,443,4864,3011,1853,20,234,12,8
56666,443,25263,443,8006,1986,6020,20,15,11,9
47058,443,44896,443,328838,76878,251960,449,243,185,264
57614,80,57614,80,470276,8994,461282,388,25,75,313
49901,53,43057,53,752,93,659,2,31,1,1
55443,53,31894,53,751,95,656,2,31,1,1
51539,443,52838,443,94949,5974,88975,118,148,45,73
30188,55886,45541,55886,502,150,352,2,1200,1,1
63154,443,63154,443,4642,1735,2907,19,30,11,8
42184,53,42184,53,334,226,108,3,30,2,1
57001,80,47227,80,214,140,74,4,35,3,1
58057,80,12753,80,254,128,126,5,15,3,2
57381,443,25601,443,4645,700,3945,12,15,8,4
65473,53,40939,53,309,94,215,2,30,1,1
62067,80,14393,80,1862,616,1246,11,15,6,5
53521,8999,10502,8999,312,186,126,5,15,3,2
49796,53,34008,53,238,102,136,2,30,1,1
11295,40040,23656,40040,213,89,124,4,31,2,2
49925,53,18861,53,953,215,738,6,46,3,3
56085,53,34233,53,167,86,81,2,30,1,1
17734,53,17734,53,217,90,127,2,30,1,1
49774,80,42910,80,254,128,126,5,15,3,2
50512,80,4579,80,318,192,126,6,25,4,2
55165,53,30043,53,199,102,97,2,30,1,1
56333,53,59595,53,209,110,99,2,31,1,1
57709,53,57709,53,265,111,154,2,30,1,1
15420,53,15420,53,237,91,146,2,32,1,1
64443,53,23166,53,878,184,694,6,71,3,3
55495,53,17025,53,210,110,100,2,30,1,1
65312,53,55577,53,182,94,88,2,30,1,1
37000,443,57961,443,280,140,140,5,130,3,2
61746,443,1496,443,251,69,182,3,120,1,2
37965,21859,39298,21859,481,150,331,2,1199,1,1
38368,15000,38283,15000,130,70,60,2,5,1,1
49622,53,6128,53,209,102,107,2,30,1,1
37307,443,33957,443,9563,2336,7227,25,15,14,11
55907,53,18173,53,184,94,90,2,30,1,1
51772,59814,9968,59814,66,66,0,1,5,1,0
50659,53,45075,53,168,78,90,2,30,1,1
49757,53,9163,53,177,94,83,2,30,1,1
56349,53,42172,53,216,110,106,2,29,1,1
64768,53,30558,53,394,102,292,2,29,1,1
46542,443,1363,443,5916,1144,4772,20,17,11,9
64077,20208,51700,20208,70,70,0,1,4,1,0
44157,53,44157,53,216,90,126,2,29,1,1
57979,443,3610,443,7970957,82522,7888435,6370,179,1027,5343
49608,53,63046,53,198,110,88,2,31,1,1
50045,53,13478,53,168,86,82,2,30,1,1
60065,443,12163,443,6395,2524,3871,18,141,10,8
50050,53,12626,53,253,87,166,4,51,2,2
56267,53,59732,53,453,186,267,6,30,3,3
53668,50678,24375,50678,70,70,0,2,7,2,0
37628,443,37628,443,1452,817,635,16,20,9,7
55387,53,44046,53,172,94,78,2,29,1,1
44009,443,15754,443,1392,731,661,14,80,8,6
51637,443,21678,443,3110,1049,2061,14,136,7,7
53101,443,12106,443,1287,800,487,13,16,9,4
64618,53,46697,53,196,100,96,2,31,1,1
54974,443,56766,443,8670,2248,6422,36,90,21,15
63166,443,63166,443,5407,2160,3247,22,38,13,9
52184,57262,18616,57262,70,70,0,2,8,2,0
56731,443,8891,443,7828,2313,5515,31,64,17,14
53596,56732,58606,56732,70,70,0,2,7,2,0
42140,443,52282,443,12322,3893,8429,28,139,13,15
49945,53,48312,53,281,97,184,4,58,2,2
40576,443,40576,443,4433,1526,2907,19,27,11,8
60228,80,30633,80,6854,6211,643,16,151,9,7
51872,48108,27950,48108,70,70,0,1,5,1,0
49251,53,13051,53,94,94,0,1,30,1,0
49196,53,19330,53,91,91,0,1,30,1,0
62640,443,62640,443,27723,5572,22151,59,47,31,28
58735,443,63211,443,1413,876,537,12,26,6,6
26900,27017,27524,27017,422,164,258,6,30,3,3
50478,443,59774,443,25979,7217,18762,36,15,19,17
60190,443,8550,443,10178,1101,9077,22,125,10,12
55549,53,20623,53,209,110,99,2,30,1,1
49073,443,9351,443,7032,2643,4389,23,16,12,11
52067,80,33886,80,362,240,122,7,25,5,2
50072,53,26115,53,164,86,78,2,30,1,1
65323,53,33275,53,356,118,238,2,30,1,1
49397,80,15765,80,4382,2084,2298,18,66,10,8
49603,53,2204,53,238,110,128,2,30,1,1
55126,53,10895,53,193,102,91,2,31,1,1
55934,53,23725,53,182,102,80,2,30,1,1
60481,40075,20355,40075,70,70,0,1,5,1,0
53202,443,56977,443,23323,1589,21734,27,85,10,17
49308,53,5550,53,195,94,101,2,29,1,1
57203,443,49091,443,1798,1223,575,13,28,8,5
50042,80,50042,80,2986,1514,1472,10,15,6,4
64560,53,23612,53,802,104,698,2,30,1,1
27471,53,27471,53,237,91,146,2,32,1,1
49113,443,18821,443,6318,877,5441,23,396,8,15
61704,80,4261,80,1555,954,601,14,47,8,6
65176,53,39241,53,193,102,91,2,30,1,1
56795,35465,29402,35465,70,70,0,1,5,1,0
65211,53,44478,53,183,94,89,2,30,1,1
51974,54759,44353,54759,70,70,0,1,4,1,0
55528,80,12209,80,3868,2218,1650,19,39,11,8
51744,1678,56992,1678,66,66,0,1,5,1,0
49943,80,49943,80,254742,14106,240636,305,22,131,174
64539,53,23141,53,712,214,498,6,44,3,3
55728,53,24572,53,195,102,93,2,31,1,1
49742,53,44369,53,199,94,105,2,30,1,1
56720,53,57762,53,916,86,830,2,31,1,1
47595,33437,0,0,106,106,0,1,61,1,0
42090,443,42090,443,3509,1693,1816,21,96,10,11
50264,443,29730,443,430,60,370,7,24,2,5
56344,443,64957,443,8111,1413,6698,21,28,12,9
63028,53,16966,53,384,166,218,2,30,1,1
49297,53,2852,53,183,94,89,2,30,1,1
27005,27015,57619,27015,902,126,776,2,30,1,1
53841,8999,39565,8999,70,70,0,1,4,1,0
50973,80,49428,80,1095221,7065,1088156,829,36,105,724
50978,80,49892,80,81390,4223,77167,103,21,49,54
60716,443,33650,443,6898,2843,4055,21,17,11,10
56568,53,15733,53,711,87,624,2,30,1,1
49418,29999,25371,29999,244,78,166,2,31,1,1
49333,53,61415,53,392,102,290,2,30,1,1
60786,40010,58556,40010,316,136,180,6,7,3,3
56145,53,42798,53,458,188,270,6,31,3,3
64763,53,53321,53,214,110,104,2,30,1,1
38551,53,14191,53,168,78,90,2,30,1,1
51081,443,34616,443,8192,2781,5411,22,374,12,10
55039,443,45987,443,7993,677,7316,16,16,8,8
50537,443,21381,443,6250,1595,4655,23,150,12,11
51196,443,64591,443,346,140,206,6,130,3,3
44155,443,5461,443,5157,917,4240,20,360,10,10
63917,443,22910,443,9043,5948,3095,31,121,15,16
60166,80,1732,80,186,64,122,4,28,2,2
50159,53,16650,53,94,94,0,1,29,1,0
6881,6881,44146,6881,502,150,352,2,1199,1,1
60520,53,60520,53,198,90,108,2,30,1,1
64632,443,35078,443,8391,5178,3213,41,256,20,21
47819,443,19809,443,6258,956,5302,20,16,11,9
50400,53,28411,53,177,94,83,2,30,1,1
54354,443,10906,443,18848,10436,8412,42,33,20,22
51539,443,4046,443,6359,1559,4800,24,19,13,11
51970,443,63530,443,17072,6138,10934,33,85,18,15
39513,443,6930,443,16012,10450,5562,33,80,18,15
53115,443,63976,443,9616,6956,2660,39,47,21,18
54448,443,65424,443,1786,172,1614,7,120,3,4
49995,53,57379,53,197,102,95,2,30,1,1
47471,80,60446,80,1114,534,580,12,16,7,5
26536,53,62994,53,306,99,207,2,0,1,1
6881,6881,2586,6881,237,118,119,2,1200,1,1
63846,443,9201,443,3811,1538,2273,20,135,10,10
51726,3389,51726,3389,3444,1730,1714,16,33,8,8
64941,53,51178,53,216,94,122,2,30,1,1
50022,53,5739,53,179,94,85,2,31,1,1
43725,443,24670,443,82838,3838,79000,104,31,42,62
50886,80,22505,80,312952,13869,299083,347,141,138,209
49750,5223,50752,5223,46785,27735,19050,232,5491,123,109
43516,53,56876,53,168,78,90,2,30,1,1
49936,80,9467,80,1130,613,517,11,15,6,5
64765,53,64580,53,177,94,83,2,30,1,1
64188,53,49847,53,216,94,122,2,29,1,1
56695,443,49657,443,3874,2523,1351,18,17,10,8
60244,80,21449,80,1114,534,580,12,16,7,5
56415,53,18388,53,179,94,85,2,29,1,1
53952,26973,7961,26973,70,70,0,1,4,1,0
52080,443,29531,443,3052,2014,1038,16,15,9,7
48742,443,3234,443,4801,2138,2663,23,15,12,11
60472,443,5896,443,3779,2809,970,23,47,12,11
56601,80,22349,80,234,234,0,4,12,4,0
52135,46475,11599,46475,70,70,0,1,5,1,0
58654,53,55637,53,168,78,90,2,30,1,1
55064,53,40731,53,774,101,673,2,31,1,1
49877,80,36716,80,28450,4547,23903,34,88,13,21
53796,53,64571,53,213,78,135,2,30,1,1
64338,53,55215,53,292,102,190,2,29,1,1
37272,443,58616,443,10809,2465,8344,45,121,21,24
56810,53,11762,53,177,94,83,2,30,1,1
64321,53,62198,53,195,102,93,2,30,1,1
39423,443,60458,443,121145,3578,117567,128,77,39,89
62336,443,4923,443,8217,2075,6142,31,76,15,16
38679,443,29452,443,484912,17317,467595,550,16,229,321
49229,53,40938,53,183,94,89,2,29,1,1
57341,443,25399,443,7551,2807,4744,42,26,22,20
64047,53,55544,53,604,89,515,4,45,2,2
63914,32805,62469,32805,66,66,0,2,8,2,0
49177,53,33754,53,184,94,90,2,31,1,1
51992,443,50696,443,1083,596,487,11,16,7,4
64198,53,39637,53,321,102,219,2,30,1,1
37605,443,2336,443,573,425,148,5,0,3,2
61404,443,64202,443,4526,2655,1871,24,98,14,10
65169,80,56657,80,1516,481,1035,11,15,6,5
57282,53,23204,53,199,102,97,2,29,1,1
44516,443,57254,443,4709,2451,2258,18,304,8,10
57051,53,56096,53,185,102,83,2,30,1,1
57149,53,45353,53,222,86,136,2,30,1,1
56229,53,1556,53,173,94,79,2,30,1,1
56557,53,47692,53,214,110,104,2,30,1,1
51619,15000,21734,15000,130,70,60,2,6,1,1
10006,40025,40345,40025,284,190,94,2,29,1,1
65099,53,58455,53,199,102,97,2,30,1,1
63214,53,63214,53,261,103,158,2,30,1,1
59962,53,13839,53,316,94,222,2,30,1,1
63995,15396,40455,15396,70,70,0,1,4,1,0
56143,3389,56143,3389,4365,2581,1784,20,32,11,9
21544,41599,59404,41599,70,70,0,2,8,2,0
27005,27016,41130,27016,1622,126,1496,4,31,2,2
55760,53,9967,53,182,94,88,2,30,1,1
48206,53,48206,53,253,99,154,2,30,1,1
60421,6882,64164,6882,70,70,0,2,8,2,0
56035,443,61035,443,10622,4094,6528,29,514,16,13
59771,443,63690,443,7672,1164,6508,24,30,12,12
57078,443,63821,443,4730,2569,2161,16,135,8,8
56814,53,9627,53,193,102,91,2,30,1,1
57223,443,27688,443,24283,14945,9338,46,318,26,20
26900,27017,12054,27017,422,164,258,6,30,3,3
50438,53,42985,53,199,102,97,2,29,1,1
55639,53,11030,53,819,102,717,2,30,1,1
50100,53,44319,53,216,110,106,2,30,1,1
49418,27016,47902,27016,245,78,167,2,30,1,1
55817,53,30944,53,392,102,290,2,30,1,1
56568,53,34489,53,102,102,0,1,30,1,0
57188,8525,57188,8525,138,78,60,2,6,1,1
50095,53,59595,53,250,86,164,4,30,2,2
56707,53,58987,53,199,94,105,2,30,1,1
50497,53,25431,53,747,93,654,2,30,1,1
65238,53,13271,53,86,86,0,1,30,1,0
43531,53,58732,53,199,94,105,2,30,1,1
52425,443,14303,443,64135,3588,60547,88,40,38,50
56697,53,7977,53,711,87,624,2,31,1,1
51889,44348,63585,44348,70,70,0,2,8,2,0
49623,443,17482,443,3972,2532,1440,18,80,10,8
55344,53,42459,53,212,110,102,2,29,1,1
57913,443,41913,443,1853,1214,639,18,142,11,7
42298,40007,31436,40007,148,86,62,2,30,1,1
53455,443,54035,443,240325,8131,232194,262,31,100,162
53835,443,32854,443,499,425,74,4,0,3,1
36158,443,62102,443,7848,2137,5711,23,25,13,10
56411,53,39978,53,184,94,90,2,30,1,1
55060,80,45377,80,1289,724,565,11,26,6,5
55877,14966,41407,14966,480,149,331,2,1200,1,1
50366,80,53987,80,318,192,126,6,28,4,2
48817,18529,48817,18529,152,152,0,1,1200,1,0
58638,5900,58638,5900,62,62,0,1,5,1,0
43288,443,20649,443,11123,2634,8489,22,121,10,12
56744,53,53021,53,274,110,164,2,30,1,1
55896,53,50702,53,184,94,90,2,31,1,1
59930,80,22245,80,1638,1324,314,10,15,5,5
49737,53,3736,53,338,110,228,2,30,1,1
34111,53,34111,53,213,87,126,2,30,1,1
60337,443,11026,443,1862,1223,639,18,89,11,7
56759,53,4446,53,177,94,83,2,30,1,1
49573,443,42644,443,111881,6152,105729,137,139,51,86
58752,443,52846,443,5167,700,4467,16,15,7,9
57424,53,34088,53,177,94,83,2,30,1,1
64872,53,64528,53,166,86,80,2,31,1,1
60675,443,27643,443,1871,1235,636,13,31,8,5
60370,443,62763,443,6045,1834,4211,21,82,10,11
58776,443,47713,443,3991,2587,1404,17,16,9,8
51812,15279,41054,15279,70,70,0,1,4,1,0
49376,53,19245,53,209,110,99,2,30,1,1
53136,80,42745,80,23974,12718,11256,37,36,19,18
58904,443,20613,443,4732,3142,1590,20,18,9,11
2073,7000,2073,7000,3566,1999,1567,16,15,8,8
48931,53,2346,53,168,78,90,2,30,1,1
15503,19168,41378,19168,481,150,331,2,1200,1,1
54203,443,21798,443,499,425,74,4,0,3,1
50366,443,19959,443,1755,986,769,13,25,8,5
65239,53,28035,53,757,102,655,2,29,1,1
49430,53,18362,53,279,94,185,2,30,1,1
35073,443,44227,443,6201,1790,4411,24,330,13,11
49488,53,49488,53,823,98,725,2,30,1,1
52450,443,52450,443,4750,1843,2907,19,26,11,8
56773,28093,5962,28093,70,70,0,2,8,2,0
51720,51388,49576,51388,70,70,0,2,8,2,0
57327,443,38850,443,5613,733,4880,16,15,9,7
63770,24466,46194,24466,312,132,180,6,6,3,3
64274,53,57250,53,104,104,0,2,35,2,0
52000,80,36562,80,416,210,206,7,26,4,3
62704,443,4818,443,6805,3445,3360,31,121,15,16
49986,443,64470,443,11626,1206,10420,31,74,13,18
55849,443,27388,443,5944,1501,4443,27,163,13,14
56476,53,63647,53,239,94,145,2,30,1,1
56420,443,51933,443,5220,922,4298,17,135,10,7
49914,443,44270,443,5895,728,5167,16,27,8,8
55691,16410,1413,16410,70,70,0,1,5,1,0
42298,40001,24361,40001,140,78,62,2,31,1,1
36628,80,34664,80,78,78,0,1,4,1,0
37322,53,64245,53,168,78,90,2,31,1,1
53864,443,51683,443,232,172,60,3,5,2,1
49418,27019,38743,27019,251,71,180,2,30,1,1
57426,66,63838,66,70,70,0,1,5,1,0
64814,53,35715,53,173,94,79,2,30,1,1
64723,53,29424,53,165,86,79,2,31,1,1
33042,443,44384,443,10328,5341,4987,26,35,13,13
62052,443,44827,443,11674,2699,8975,27,48,14,13
51221,41939,7547,41939,3917,1584,2333,50,3325,25,25
49764,53,36622,53,199,102,97,2,31,1,1
56906,53,55216,53,167,86,81,2,31,1,1
57003,443,38569,443,8592,3700,4892,39,108,21,18
36953,443,22801,443,70,70,0,1,5,1,0
51496,443,43516,443,416,210,206,7,15,4,3
61429,80,5078,80,214,140,74,4,41,3,1
64095,53,56290,53,177,94,83,2,30,1,1
55187,53,20282,53,256,93,163,2,30,1,1
53126,47035,20200,47035,70,70,0,1,5,1,0
123,123,44322,123,184,94,90,2,29,1,1
17750,30022,45838,30022,481,150,331,2,1200,1,1
55337,53,17571,53,294,106,188,4,56,2,2
49384,53,28867,53,305,93,212,4,48,2,2
58859,443,48012,443,39518,2389,37129,54,179,21,33
57470,43259,40741,43259,517,163,354,2,1200,1,1
49713,53,20450,53,821,102,719,2,30,1,1
51953,443,6688,443,7571,3372,4199,33,88,17,16
64530,53,55254,53,261,87,174,4,45,2,2
52054,80,38291,80,41406,4176,37230,57,32,25,32
50711,443,57174,443,7240,2265,4975,24,351,13,11
57994,80,57049,80,2494,1540,954,21,75,11,10
53237,443,24814,443,33472,16066,17406,57,48,29,28
53870,443,3316,443,499,425,74,4,1,3,1
55975,53,65159,53,190,97,93,2,30,1,1
46013,80,29418,80,134,60,74,3,6,2,1
55616,42929,18894,42929,70,70,0,2,8,2,0
41776,443,6550,443,32434,15588,16846,164,1128,83,81
50077,53,35101,53,787,110,677,2,30,1,1
37597,443,2780,443,10497,3476,7021,34,17,18,16
53762,443,60750,443,499,425,74,4,0,3,1
58058,443,59293,443,560,280,280,9,28,5,4
52193,443,50924,443,13948,1150,12798,29,15,14,15
49676,53,40519,53,197,102,95,2,30,1,1
41626,15000,7526,15000,130,70,60,2,5,1,1
64912,53,24794,53,183,94,89,2,30,1,1
51693,56308,27101,56308,70,70,0,1,5,1,0
57398,53,44535,53,202,86,116,2,30,1,1
49512,53,64595,53,210,102,108,2,30,1,1
63888,6881,1639,6881,66,66,0,2,7,2,0
57470,51413,17602,51413,330,330,0,6,1199,6,0
63965,53,50907,53,306,94,212,2,30,1,1
34183,443,44472,443,10459,2529,7930,31,375,13,18
56675,53,13397,53,254,94,160,2,30,1,1
49904,53,31561,53,217,94,123,2,29,1,1
64575,53,7510,53,182,102,80,2,30,1,1
51480,3027,51480,3027,156,156,0,3,8,3,0
64985,53,34087,53,194,102,92,2,30,1,1
57226,53,37479,53,178,94,84,2,30,1,1
50584,80,50584,80,6706,4950,1756,23,20,13,10
49639,443,37506,443,7521,2117,5404,22,89,12,10
53954,57868,45044,57868,70,70,0,2,8,2,0
37233,53,50033,53,198,93,105,2,30,1,1
38807,443,45968,443,99092,3694,95398,115,170,43,72
56375,53,4140,53,322,110,212,4,30,2,2
56386,53,3694,53,177,94,83,2,30,1,1
9337,443,53921,443,428,128,300,8,47,3,5
55705,53,27815,53,281,101,180,4,59,2,2
51547,443,7780,443,202,70,132,3,11,1,2
53859,443,52772,443,499,425,74,4,1,3,1
47733,443,46776,443,556154,55291,500863,1146,559,440,706
60979,443,13590,443,49981,8331,41650,75,48,36,39
51979,443,24826,443,10613,3156,7457,42,15,24,18
65498,443,58734,443,3874,1587,2287,17,143,9,8
64637,53,52362,53,194,102,92,2,30,1,1
62546,443,43210,443,7740,2603,5137,13,120,7,6
56950,53,38998,53,183,86,97,2,29,1,1
60581,53,60581,53,197,76,121,2,30,1,1
52708,443,22649,443,10748,1634,9114,22,316,10,12
57436,66,1487,66,70,70,0,1,4,1,0
36622,443,36622,443,16116,3253,12863,52,97,29,23
55784,53,34530,53,199,94,105,2,29,1,1
37031,443,21372,443,43818,31519,12299,85,259,49,36
56712,53,17239,53,177,94,83,2,30,1,1
50306,80,39882,80,182517,10761,171756,265,352,130,135
52000,80,35865,80,3495,1150,2345,17,18,8,9
50364,443,37739,443,1727,926,801,15,30,7,8
51860,53854,59221,53854,70,70,0,1,5,1,0
46287,443,19273,443,7071,2628,4443,32,23,16,16
57209,53,54053,53,764,99,665,2,30,1,1
56800,443,17462,443,8074,2054,6020,20,16,11,9
49269,53,8382,53,198,110,88,2,30,1,1
64121,53,21027,53,365,102,263,2,31,1,1
55315,53,41500,53,192,98,94,2,31,1,1
41034,443,11072,443,6055,2800,3255,38,279,19,19
35913,443,5129,443,14329,8250,6079,26,22,16,10
57007,53,62995,53,183,94,89,2,31,1,1
48979,15000,58069,15000,130,70,60,2,5,1,1
27005,27016,28994,27016,880,126,754,2,30,1,1
54944,443,7511,443,4891,2237,2654,12,121,6,6
49677,80,37951,80,1977,921,1056,9,16,5,4
47642,443,46910,443,12735,10573,2162,33,316,16,17
56495,53,46439,53,199,102,97,2,30,1,1
56937,53,52000,53,181,94,87,2,33,1,1
61732,443,11286,443,8655,2300,6355,24,21,12,12
52077,443,25258,443,6317,2196,4121,19,15,10,9
57150,53,36180,53,177,94,83,2,30,1,1
64365,53,27467,53,341,110,231,2,29,1,1
56889,53,49457,53,211,110,101,2,30,1,1
27005,27237,36473,27237,876,126,750,2,30,1,1
50420,443,27192,443,648,210,438,10,27,4,6
56809,53,9821,53,167,86,81,2,30,1,1
43308,443,4843,443,120,120,0,2,5,2,0
5588,5588,0,0,3354,1792,1562,46,192,23,23
56070,53,12726,53,193,102,91,2,30,1,1
55556,53,41769,53,224,94,130,2,30,1,1
35061,80,46318,80,15651782,355118,15296664,15172,45,5065,10107
63997,59512,17767,59512,312,132,180,6,5,3,3
49250,80,27382,80,1623,629,994,8,75,5,3
49629,53,32885,53,742,88,654,2,30,1,1
64766,53,47744,53,214,110,104,2,29,1,1
55174,80,55174,80,374,240,134,7,15,5,2
49913,53,47185,53,216,110,106,2,30,1,1
27005,27016,56293,27016,1640,126,1514,4,31,2,2
6881,6881,40398,6881,238,118,120,2,1199,1,1
60234,80,15861,80,1131,772,359,10,151,6,4
56812,443,34534,443,8073,2053,6020,20,15,11,9
57814,443,32836,443,6162,925,5237,18,108,10,8
50408,53,10616,53,183,94,89,2,30,1,1
55531,53,64298,53,216,110,106,2,30,1,1
55469,53,16063,53,817,98,719,2,31,1,1
55128,53,34503,53,711,87,624,2,31,1,1
57201,53,54960,53,173,94,79,2,30,1,1
43893,443,47910,443,1440,719,721,15,198,8,7
64730,53,52714,53,1152,86,1066,2,29,1,1
39540,80,37629,80,130,70,60,2,15,1,1
41850,53,41850,53,257,101,156,2,33,1,1
49219,53,24039,53,264,102,162,2,30,1,1
57375,53,58111,53,247,102,145,2,30,1,1
49837,53,3661,53,183,102,81,2,30,1,1
53195,443,44058,443,2016,1160,856,17,46,9,8
56443,53,48417,53,250,86,164,4,29,2,2
56450,443,16622,443,1786,172,1614,7,120,3,4
56288,53,49732,53,183,94,89,2,31,1,1
32100,53,32100,53,200,90,110,2,29,1,1
50609,80,7480,80,12986,6816,6170,26,26,12,14
57394,53,63615,53,193,102,91,2,30,1,1
49451,53,46529,53,757,98,659,2,31,1,1
64519,53,20237,53,277,94,183,4,60,2,2
64933,53,1484,53,738,86,652,2,31,1,1
51424,80,51424,80,4995,3443,1552,23,26,13,10
49539,53,64502,53,340,87,253,4,50,2,2
56563,53,31162,53,751,95,656,2,30,1,1
38715,443,52129,443,403299,12717,390582,439,16,171,268
14432,443,31078,443,7420,1078,6342,21,75,11,10
55477,80,28863,80,498,280,218,8,26,5,3
58259,53,21594,53,578,286,292,9,15,5,4
49741,53,35577,53,766,102,664,2,30,1,1
45363,443,50809,443,2396,1144,1252,14,982,7,7
43314,443,11137,443,27958,21973,5985,77,403,43,34
56365,53,8027,53,199,102,97,2,30,1,1
56455,53,12391,53,183,94,89,2,30,1,1
49661,443,16392,443,9021,2548,6473,38,80,19,19
57047,53,47290,53,1426,98,1328,4,53,2,2
58784,443,58898,443,41305,2456,38849,63,30,29,34
57382,53,16095,53,184,94,90,2,31,1,1
56114,53,2423,53,216,110,106,2,30,1,1
58473,443,15678,443,3120,1862,1258,18,15,11,7
8888,53,8888,53,214,97,117,2,30,1,1
58440,53,26101,53,305,102,203,2,30,1,1
55580,53,22194,53,788,108,680,2,30,1,1
50730,27029,7986,27029,269,78,191,2,30,1,1
4544,41599,1547,41599,710,710,0,6,302,6,0
53917,80,62681,80,1829,755,1074,10,15,6,4
54977,53,39208,53,275,93,182,4,31,2,2
65109,53,18311,53,753,94,659,2,30,1,1
34535,443,2952,443,74325,3719,70606,98,200,44,54
49217,53,50933,53,282,93,189,4,45,2,2
35055,80,30586,80,3650999,83941,3567058,3541,21,1184,2357
60417,55100,30057,55100,258,70,188,4,8,2,2
64615,53,57777,53,195,102,93,2,31,1,1
53766,443,46858,443,499,425,74,4,0,3,1
52256,41337,31273,41337,316,136,180,6,8,3,3
56469,53,24320,53,177,94,83,2,30,1,1
5588,5588,0,0,3562,1936,1626,48,192,24,24
54184,443,12378,443,2786,1537,1249,17,16,8,9
55107,53,40259,53,184,94,90,2,30,1,1
57340,2258,57340,2258,156,156,0,3,8,3,0
56613,443,29986,443,7981,1961,6020,20,16,11,9
57003,80,40780,80,526,304,222,8,35,5,3
37009,53,17382,53,78,78,0,1,30,1,0
54197,443,1352,443,499,425,74,4,0,3,1
52027,80,10157,80,9732,8170,1562,18,38,10,8
49828,53,40540,53,578,286,292,9,15,5,4
49720,443,54089,443,4936,855,4081,17,52,7,10
58893,443,9531,443,5107,700,4407,15,15,7,8
56497,53,2084,53,170,87,83,2,31,1,1
53151,29500,62396,29500,514,274,240,8,143,4,4
60893,443,56200,443,4252,1594,2658,13,135,6,7
65530,53,53494,53,194,102,92,2,30,1,1
60593,80,31498,80,123436,6053,117383,165,241,83,82
53827,443,32061,443,499,425,74,4,0,3,1
50466,80,60136,80,1718,1247,471,9,15,5,4
50693,443,1637,443,306,120,186,6,23,3,3
57425,53,32563,53,168,86,82,2,30,1,1
48551,443,38107,443,7104,888,6216,19,27,9,10
54966,53,44405,53,171,88,83,3,33,2,1
49207,443,63518,443,19566,12185,7381,89,176,42,47
50181,443,22681,443,6350,1071,5279,18,42,10,8
56313,53,7170,53,198,102,96,2,29,1,1
64885,53,54457,53,182,102,80,2,31,1,1
43853,443,27275,443,6156,4764,1392,17,231,11,6
56080,443,20631,443,3970,1726,2244,13,135,6,7
65071,53,49896,53,93,93,0,2,60,2,0
58056,443,24409,443,6821,1076,5745,21,38,12,9
53464,3389,53464,3389,4245,2461,1784,18,31,9,9
56721,443,14378,443,7889,1900,5989,20,15,11,9
50330,80,61342,80,736,670,66,6,15,5,1
54819,3389,54819,3389,3327,1438,1889,15,17,8,7
36881,443,36881,443,4652,1745,2907,19,28,11,8
56456,53,45669,53,199,102,97,2,30,1,1
27005,27015,45197,27015,881,126,755,2,30,1,1
53172,56013,19244,56013,70,70,0,2,8,2,0
51001,443,45191,443,5841,1986,3855,19,18,11,8
53987,16571,41017,16571,70,70,0,2,7,2,0
9122,80,61976,80,98161,5033,93128,125,37,45,80
32879,443,46058,443,8137,2110,6027,29,394,10,19
56848,53,54786,53,764,99,665,2,31,1,1
60093,443,46965,443,2090,1218,872,15,140,8,7
61189,443,61189,443,1092,645,447,10,34,6,4
64077,20208,16294,20208,66,66,0,2,8,2,0
61462,443,27750,443,6271,1191,5080,24,94,14,10
50661,80,9944,80,2693,461,2232,14,17,6,8
48690,443,27547,443,19402,10414,8988,35,22,21,14
37965,31483,54456,31483,4530,2856,1674,62,2421,35,27
55610,23383,13424,23383,70,70,0,1,5,1,0
51784,34568,52434,34568,66,66,0,1,5,1,0
56343,53,52506,53,177,94,83,2,29,1,1
50584,51413,31560,51413,800,150,650,4,1200,2,2
49612,80,44677,80,378,192,186,7,41,4,3
55777,53,11730,53,200,94,106,2,30,1,1
52251,443,26101,443,23328780,730794,22597986,24754,320,8113,16641
57093,80,11310,80,130,70,60,2,15,1,1
49466,53,47860,53,209,110,99,2,30,1,1
49188,53,21489,53,777,87,690,2,31,1,1
64538,53,8098,53,194,102,92,2,29,1,1
27005,27057,9296,27057,917,126,791,2,31,1,1
64890,53,13860,53,210,110,100,2,30,1,1
33237,443,28944,443,31065,6730,24335,68,18,37,31
49937,443,1883,443,240,240,0,5,338,5,0
64174,53,49823,53,176,90,86,2,31,1,1
59761,53,13611,53,569,164,405,2,31,1,1
50455,443,11561,443,107749,6262,101487,142,138,58,84
49354,53,25819,53,196,102,94,2,30,1,1
50880,80,36202,80,395978,13168,382810,411,143,151,260
60126,443,24609,443,3015,2086,929,16,15,9,7
53735,58869,2598,58869,70,70,0,2,7,2,0
49284,53,41000,53,195,86,109,2,30,1,1
50384,80,18722,80,2537,783,1754,13,20,7,6
39336,443,55309,443,7759,4000,3759,23,96,11,12
57603,443,1218,443,2614,1689,925,18,23,10,8
44384,80,20153,80,51651,48866,2785,74,19,38,36
61546,443,4493,443,208,60,148,4,13,2,2
48343,443,59139,443,1985333,91427,1893906,2159,190,721,1438
39303,80,19010,80,3198,1493,1705,18,80,11,7
56845,27201,52716,27201,316,136,180,6,7,3,3
54470,80,58006,80,16896,1514,15382,30,255,16,14
56703,53,38555,53,183,94,89,2,30,1,1
50387,443,3636,443,2227,1018,1209,17,16,8,9
56416,80,36682,80,33755,928,32827,36,104,11,25
38000,443,20816,443,13123,6654,6469,29,135,15,14
34113,443,8238,443,70,70,0,1,5,1,0
55075,443,61643,443,2459,1608,851,17,25,9,8
49994,80,9515,80,2618,591,2027,11,16,6,5
53111,50809,43690,50809,70,70,0,1,4,1,0
51401,443,22599,443,202,70,132,3,11,1,2
55869,53,8327,53,196,102,94,2,31,1,1
52394,53,35816,53,168,78,90,2,30,1,1
64153,53,64829,53,340,134,206,2,30,1,1
56774,39553,10646,39553,70,70,0,2,8,2,0
50590,80,16341,80,1507,951,556,13,78,7,6
49935,53,45170,53,168,86,82,2,30,1,1
61791,80,61791,80,16848,822,16026,23,16,9,14
27005,27017,53801,27017,1634,126,1508,4,31,2,2
49705,443,51038,443,156357,6403,149954,155,81,44,111
50005,80,43332,80,2088,1160,928,10,86,6,4
55238,443,7974,443,6186,1650,4536,20,16,11,9
52001,80,20376,80,8117874,148550,7969324,7318,25,2033,5285
55951,53,4112,53,197,102,95,2,30,1,1
60269,443,14941,443,499,425,74,4,0,3,1
50095,53,20934,53,168,86,82,2,30,1,1
56263,53,57350,53,385,134,251,2,31,1,1
55664,53,1350,53,195,102,93,2,30,1,1
35481,443,52517,443,6804,1473,5331,33,258,15,18
64971,53,64971,53,218,85,133,2,30,1,1
43129,443,48108,443,4579,580,3999,13,22,5,8
49174,443,55183,443,524887,14310,510577,546,18,201,345
50990,53,51984,53,232,94,138,2,29,1,1
55467,53,34377,53,193,102,91,2,30,1,1
64654,53,63011,53,240,110,130,2,30,1,1
62453,53,64784,53,441,162,279,6,32,3,3
39569,443,64666,443,125906,21096,104810,172,130,68,104
59772,80,1176,80,5558,3386,2172,29,36,15,14
37484,443,55128,443,59233,7514,51719,70,122,27,43
53922,443,26654,443,499,425,74,4,0,3,1
64979,53,4667,53,194,102,92,2,31,1,1
57555,443,43596,443,25519,7061,18458,37,16,20,17
34692,443,49759,443,3386,1833,1553,17,255,9,8
55703,13836,63794,13836,70,70,0,1,5,1,0
54361,443,48340,443,12268,2979,9289,35,81,18,17
56822,53,60516,53,184,94,90,2,30,1,1
53671,60416,30870,60416,70,70,0,1,4,1,0
5588,5588,0,0,3498,1872,1626,48,193,24,24
50139,5228,61271,5228,7727,2172,5555,44,104,23,21
63138,51452,48571,51452,70,70,0,2,8,2,0
9239,80,63339,80,318,192,126,6,26,4,2
42307,443,58231,443,101673,5966,95707,121,178,47,74
51879,38564,27585,38564,70,70,0,2,8,2,0
46773,443,61841,443,10812,3429,7383,39,315,20,19
57948,443,51203,443,6885,3239,3646,53,190,24,29
55419,53,50922,53,760,97,663,2,31,1,1
55630,53,39473,53,197,102,95,2,30,1,1
36548,80,36548,80,514,246,268,9,76,5,4
47834,443,47834,443,4716,1809,2907,19,26,11,8
52152,58114,56068,58114,70,70,0,1,5,1,0
35570,443,53736,443,3297,2327,970,22,37,11,11
52110,35411,42303,35411,70,70,0,2,8,2,0
49998,443,24613,443,24410,6698,17712,32,16,13,19
55961,53,7584,53,214,102,112,2,30,1,1
49824,53,9699,53,172,88,84,2,31,1,1
6881,19215,41309,19215,509,150,359,2,1199,1,1
42298,40040,5414,40040,140,78,62,2,30,1,1
55256,443,41393,443,3524,2973,551,15,16,9,6
52038,14487,18653,14487,70,70,0,2,7,2,0
37546,80,60597,80,10438,979,9459,21,38,11,10
36017,443,12463,443,4883,3524,1359,20,200,11,9
43120,80,4226,80,1151,711,440,10,15,5,5
37965,40840,26004,40840,150,150,0,1,1199,1,0
42792,443,30288,443,7102,1857,5245,28,95,15,13
55133,53,13417,53,168,86,82,2,30,1,1
19473,20467,44164,20467,480,149,331,2,1200,1,1
51605,443,15283,443,4343,2350,1993,17,36,9,8
9317,443,63611,443,5687,499,5188,14,16,7,7
56596,53,10703,53,194,102,92,2,31,1,1
56563,53,53188,53,292,126,166,2,30,1,1
40458,53,17783,53,168,78,90,2,31,1,1
27005,27017,53303,27017,1634,126,1508,4,30,2,2
49566,443,56246,443,2888,1389,1499,18,15,9,9
47651,443,48756,443,1053,566,487,10,43,6,4
61827,5223,22031,5223,10784,5831,4953,33,521,15,18
60187,53,13355,53,168,78,90,2,30,1,1
56481,443,31113,443,1853,1214,639,18,134,11,7
37434,443,37114,443,11113,2993,8120,26,143,14,12
53798,53,26638,53,224,86,138,2,30,1,1
55078,53,15054,53,246,94,152,2,30,1,1
50684,80,50889,80,1658,1247,411,8,15,5,3
37576,443,42873,443,499,425,74,4,0,3,1
35242,8635,35242,8635,138,78,60,2,6,1,1
53707,443,35739,443,7272,930,6342,19,75,9,10
56004,53,16480,53,177,94,83,2,30,1,1
51689,53,28477,53,198,86,112,2,29,1,1
55786,53,33325,53,177,94,83,2,30,1,1
57411,53,38630,53,711,87,624,2,31,1,1
64961,53,7551,53,243,110,133,2,30,1,1
52765,443,7289,443,10359,1566,8793,27,150,13,14
28004,443,21121,443,5517,1390,4127,18,15,9,9
60265,53,3375,53,215,86,129,2,30,1,1
64253,53,64253,53,288,83,205,2,30,1,1
57073,53,22592,53,197,102,95,2,33,1,1
53125,443,2099,443,7738,2230,5508,24,45,14,10
52128,21294,45027,21294,70,70,0,1,4,1,0
9192,443,26579,443,318,192,126,6,22,4,2
49324,443,63452,443,6586,3686,2900,35,75,17,18
62490,443,60258,443,7206,4320,2886,16,120,8,8
60873,443,46332,443,4265,1678,2587,21,142,10,11
50480,443,25461,443,57535,3735,53800,70,122,26,44
49876,53,42623,53,211,102,109,2,30,1,1
5588,5588,0,0,3562,1936,1626,48,195,24,24
47445,443,40456,443,8710,2009,6701,30,395,10,20
64335,53,51507,53,293,95,198,4,46,2,2
49656,53,55066,53,193,102,91,2,30,1,1
39775,443,49168,443,6883,1887,4996,23,361,12,11
50968,443,1243,443,469,403,66,4,0,3,1
56523,443,42102,443,5212,1037,4175,20,115,10,10
50450,80,49757,80,26924,4418,22506,34,25,13,21
53552,8999,58202,8999,70,70,0,2,7,2,0
8941,443,25184,443,541643,15245,526398,507,416,103,404
45152,80,61047,80,2865,2000,865,12,18,7,5
56771,53,12754,53,261,94,167,2,30,1,1
50459,80,33223,80,1328,917,411,10,28,6,4
56756,53,38135,53,167,86,81,2,30,1,1
51837,37610,19513,37610,316,136,180,6,5,3,3
50692,80,35406,80,57678,29714,27964,241,175,120,121
55076,53,24944,53,183,94,89,2,30,1,1
50542,443,10876,443,86426,3497,82929,102,170,38,64
64249,53,32881,53,181,94,87,2,30,1,1
49559,53,6355,53,164,84,80,2,31,1,1
51726,18475,34444,18475,316,136,180,6,7,3,3
58858,443,56785,443,7413235,214811,7198424,7869,344,2785,5084
55415,53,9661,53,183,94,89,2,30,1,1
53588,8999,41805,8999,1268,960,308,9,32,5,4
52482,443,8869,443,26154,6874,19280,35,17,16,19
10013,40024,56811,40024,156,94,62,2,30,1,1
42705,80,6053,80,1222,782,440,11,15,6,5
53127,443,41153,443,13914,7812,6102,52,69,28,24
56672,53,24787,53,199,102,97,2,29,1,1
45396,53,7036,53,168,78,90,2,30,1,1
33823,443,20715,443,8237,1724,6513,31,270,16,15
49456,53,42586,53,199,102,97,2,31,1,1
65328,53,23014,53,179,94,85,2,30,1,1
47817,443,11040,443,18158,2080,16078,34,122,19,15
50482,80,36252,80,314,192,122,6,25,4,2
57588,443,14769,443,7629,3270,4359,34,337,17,17
49611,19000,49520,19000,594,174,420,2,31,1,1
51221,51413,53021,51413,460,150,310,2,1200,1,1
56696,443,57667,443,8059,2039,6020,20,15,11,9
49211,15576,30482,15576,70,70,0,1,5,1,0
34105,443,37693,443,43883,3446,40437,57,122,22,35
53548,443,18610,443,6812,1127,5685,24,255,11,13
61838,53,61838,53,216,90,126,2,30,1,1
58809,443,34899,443,4054,2590,1464,18,16,9,9
49707,80,15833,80,196092,6387,189705,189,108,57,132
48000,443,53560,443,7193,1890,5303,22,37,15,7
60883,443,43627,443,5710,1228,4482,21,16,12,9
49893,80,42792,80,1376,946,430,8,86,5,3
56396,53,44233,53,182,93,89,2,31,1,1
27005,27015,1608,27015,888,126,762,2,30,1,1
52188,13182,48724,13182,70,70,0,2,9,2,0
44943,443,56912,443,16225,2078,14147,38,42,19,19
49338,53,20545,53,368,94,274,2,30,1,1
56357,53,43441,53,819,102,717,2,30,1,1
50265,65535,43978,65535,222,132,90,4,1210,3,1
55443,53,18885,53,194,102,92,2,30,1,1
49935,53,46528,53,177,94,83,2,30,1,1
60783,40010,46411,40010,316,136,180,6,6,3,3
57679,443,27474,443,6568,2770,3798,20,121,10,10
50546,80,2878,80,1990,812,1178,9,15,5,4
55146,53,34694,53,181,94,87,2,30,1,1
54959,53,54959,53,230,90,140,2,29,1,1
64517,53,41007,53,188,96,92,2,31,1,1
52327,443,52327,443,5444,2263,3181,23,86,12,11
64913,53,26175,53,555,195,360,6,62,3,3
29599,443,15239,443,2227,1018,1209,17,16,8,9
64917,53,19019,53,718,94,624,2,30,1,1
55467,53,6293,53,320,95,225,4,41,2,2
57470,49001,13810,49001,166,166,0,1,1200,1,0
64055,53,63061,53,178,91,87,2,31,1,1
64578,53,11531,53,193,102,91,2,30,1,1
49535,80,31379,80,1548,847,701,10,16,5,5
63975,53,64486,53,316,94,222,2,30,1,1
56487,80,45530,80,42070,2703,39367,53,135,22,31
49327,53,15373,53,396,102,294,2,30,1,1
50750,443,64318,443,70,70,0,2,171,2,0
56281,53,4042,53,177,94,83,2,30,1,1
55239,443,1727,443,9352,2524,6828,27,46,14,13
60429,46854,52028,46854,70,70,0,2,8,2,0
53223,443,54102,443,7457,1726,5731,25,65,13,12
23022,443,23022,443,10943,5186,5757,32,25,18,14
56185,53,13789,53,167,86,81,2,30,1,1
57670,80,41385,80,2274,1660,614,21,15,11,10
65160,443,49536,443,1786,172,1614,7,120,3,4
50375,80,22563,80,350,210,140,6,15,4,2
53736,37168,47120,37168,70,70,0,2,7,2,0
43310,80,46970,80,811,671,140,6,32,4,2
64837,53,36950,53,195,102,93,2,30,1,1
64779,53,1103,53,810,108,702,2,30,1,1
50558,53,44600,53,733,94,639,2,30,1,1
55254,443,18308,443,8431,2584,5847,25,46,14,11
55632,45682,28003,45682,70,70,0,2,8,2,0
65406,53,43109,53,273,102,171,2,30,1,1
64680,53,61021,53,808,272,536,8,78,4,4
56934,53,48178,53,216,110,106,2,31,1,1
65417,443,43584,443,2494,1643,851,17,25,9,8
49410,53,54828,53,178,94,84,2,30,1,1
55037,443,53217,443,13372,3722,9650,37,47,21,16
58472,53,5380,53,86,86,0,1,30,1,0
57342,53,16666,53,167,86,81,2,31,1,1
60270,443,24845,443,6155,1709,4446,29,1710,15,14
51993,443,1370,443,1209,656,553,13,16,8,5
38591,53,55685,53,391,102,289,2,30,1,1
56772,61424,18304,61424,70,70,0,2,8,2,0
6881,6881,52538,6881,118,118,0,1,1200,1,0
43088,5228,50878,5228,4708,1753,2955,27,4133,12,15
49228,53,52033,53,209,110,99,2,30,1,1
58799,443,29874,443,7899,5184,2715,24,16,13,11
10151,34592,23117,34592,480,149,331,2,1200,1,1
51166,53,27662,53,168,78,90,2,30,1,1
35824,443,2741,443,7237,2204,5033,15,120,7,8
56141,53,19077,53,184,94,90,2,30,1,1
55807,53,4924,53,257,102,155,2,29,1,1
65287,53,49493,53,180,94,86,2,30,1,1
54939,443,24418,443,13018,3066,9952,65,361,33,32
65489,53,57940,53,531,97,434,4,35,2,2
56349,53,14775,53,184,102,82,2,29,1,1
64966,53,61255,53,347,100,247,4,49,2,2
55249,443,62038,443,3056958,73055,2983903,3016,43,1023,1993
33857,123,20930,123,184,94,90,2,30,1,1
59722,443,18746,443,70,70,0,2,5,2,0
26900,27017,26989,27017,422,164,258,6,30,3,3
55337,53,58173,53,198,102,96,2,30,1,1
137,137,20437,137,384,384,0,5,51,5,0
49713,53,3397,53,198,102,96,2,30,1,1
64854,53,27051,53,178,94,84,2,30,1,1
64201,53,54602,53,434,96,338,4,30,2,2
50252,53,7370,53,165,86,79,2,30,1,1
64169,53,57112,53,212,102,110,2,30,1,1
59808,443,39380,443,23950,2135,21815,43,35,16,27
54350,443,6406,443,2402,1444,958,18,167,10,8
65209,53,17107,53,212,102,110,2,30,1,1
37555,16384,64075,16384,432,192,240,8,30,4,4
59859,443,33487,443,10266,7336,2930,49,222,24,25
51221,62348,26234,62348,132,132,0,3,1200,3,0
27327,53,27327,53,823,98,725,2,30,1,1
38169,443,2048,443,7841,2301,5540,18,135,8,10
50911,80,6093,80,13780884,170419,13610465,11542,134,2387,9155
60049,443,36353,443,23967,5983,17984,40,142,17,23
49761,80,49761,80,2937,703,2234,13,142,6,7
64091,53,16270,53,178,94,84,2,30,1,1
31019,53,31019,53,194,87,107,2,30,1,1
55535,53,31917,53,198,101,97,2,30,1,1
58813,80,56191,80,2393,551,1842,10,21,6,4
50265,18183,50480,18183,966,464,502,14,1200,7,7
63948,80,9193,80,314,192,122,6,15,4,2
46785,53,46785,53,230,91,139,2,30,1,1
55348,53,24176,53,498,204,294,6,30,3,3
35060,80,35060,80,1918,1469,449,10,20,6,4
8883,443,24361,443,9742,2044,7698,30,391,12,18
58856,80,5930,80,1614,1300,314,10,15,5,5
54070,443,51450,443,828875,45659,783216,1020,210,456,564
56663,53,28501,53,215,102,113,2,30,1,1
58638,5900,58638,5900,160,66,94,2,9,1,1
64664,53,51475,53,168,86,82,2,34,1,1
33525,443,32155,443,8088,2191,5897,28,508,13,15
55542,53,10496,53,177,94,83,2,29,1,1
50852,80,1179,80,1118864,18787,1100077,1036,132,280,756
49482,7000,49482,7000,3098,1611,1487,16,15,9,7
30960,45682,63379,45682,330,330,0,6,3609,6,0
53892,443,6388,443,499,425,74,4,0,3,1
51510,7000,51510,7000,3490,1923,1567,14,16,7,7
27005,27018,51393,27018,881,126,755,2,30,1,1
50683,443,25335,443,6414,1372,5042,19,171,9,10
50227,80,3538,80,1935,895,1040,15,75,8,7
27005,27011,25017,27011,1622,126,1496,4,31,2,2
50692,80,30484,80,5727,3584,2143,15,31,8,7
55122,443,57128,443,17936,14273,3663,59,122,33,26
27005,50003,10902,50003,1636,126,1510,4,31,2,2
56497,53,16693,53,177,94,83,2,30,1,1
48817,50321,48817,50321,334,158,176,2,1203,1,1
33583,443,54351,443,479444,14906,464538,489,62,173,316
53575,1025,56604,1025,70,70,0,2,8,2,0
52091,4789,61902,4789,70,70,0,1,5,1,0
64724,53,43750,53,195,102,93,2,30,1,1
55999,443,22014,443,3640,606,3034,13,120,6,7
21544,41599,31043,41599,70,70,0,1,5,1,0
49187,80,38831,80,1213,471,742,10,111,6,4
49477,443,54783,443,1332,876,456,11,27,6,5
53232,80,53232,80,6385,778,5607,17,16,9,8
56998,53,2449,53,199,94,105,2,30,1,1
56403,443,35663,443,24745,1926,22819,39,170,18,21
64716,53,18562,53,195,102,93,2,31,1,1
50152,80,46738,80,731402,17622,713780,600,97,116,484
47756,443,23688,443,8504,4770,3734,46,196,25,21
64566,53,1628,53,188,96,92,2,30,1,1
56624,53,50985,53,196,102,94,2,30,1,1
64038,28187,42501,28187,70,70,0,1,4,1,0
49493,53,48045,53,241,118,123,2,30,1,1
50240,53,16161,53,733,93,640,2,30,1,1
50591,80,63944,80,318,192,126,6,25,4,2
56039,53,8952,53,762,98,664,2,30,1,1
42298,40031,50162,40031,1341,657,684,8,30,4,4
9437,443,16715,443,6285,839,5446,19,25,10,9
55745,443,5170,443,11503,3691,7812,30,240,14,16
48837,53,7815,53,198,93,105,2,30,1,1
54717,443,54717,443,4608,1701,2907,19,27,11,8
53185,443,12844,443,8020,1134,6886,23,15,11,12
57249,443,12847,443,7965,2643,5322,42,15,24,18
45157,7,33504,7,138,78,60,2,5,1,1
55181,53,13217,53,711,87,624,2,30,1,1
61826,443,61826,443,95212,17857,77355,119,175,53,66
39054,443,15031,443,7772,4119,3653,31,17,16,15
56937,53,51825,53,178,91,87,2,30,1,1
55012,443,43376,443,7249,1797,5452,29,32,17,12
44922,443,33552,443,5578,764,4814,14,15,8,6
58638,5900,58638,5900,126,62,64,2,5,1,1
38658,443,22719,443,1294,864,430,12,81,7,5
56830,53,35063,53,752,93,659,2,30,1,1
50367,80,15574,80,318,192,126,6,28,4,2
10001,40041,23223,40041,151,89,62,2,30,1,1
49437,443,14429,443,586175,29694,556481,753,182,349,404
50487,80,64502,80,13796,627,13169,20,30,8,12
54998,80,32299,80,2814,2440,374,13,16,7,6
38028,443,50090,443,8805,1300,7505,23,30,12,11
55038,443,26774,443,4424,876,3548,15,35,8,7
65313,53,33070,53,193,102,91,2,30,1,1
56594,53,50396,53,165,86,79,2,29,1,1
9314,443,56500,443,3792,488,3304,14,16,7,7
55986,53,53201,53,744,89,655,2,30,1,1
59787,443,50421,443,173218,14836,158382,227,48,114,113
13553,53,13553,53,235,90,145,2,32,1,1
12656,53,33403,53,211,86,125,2,30,1,1
49978,53,17082,53,195,102,93,2,31,1,1
56641,80,60111,80,234,234,0,4,12,4,0
55167,443,39745,443,12946,5235,7711,38,185,21,17
56695,443,5124,443,8006,1986,6020,20,15,11,9
52159,80,23650,80,502,310,192,9,31,6,3
55367,443,46972,443,101466,17775,83691,225,74,112,113
59878,53,26296,53,391,102,289,2,29,1,1
64516,53,8350,53,216,110,106,2,30,1,1
50265,31101,44674,31101,150,150,0,1,1200,1,0
30960,45760,12069,45760,462,462,0,8,3632,8,0
50008,53,47667,53,193,102,91,2,31,1,1
49717,443,12194,443,20576,8959,11617,42,130,24,18
54830,443,23517,443,4478,1133,3345,13,26,8,5
49698,53,53512,53,184,102,82,2,30,1,1
57340,53,41414,53,711,87,624,2,30,1,1
49297,53,13905,53,182,93,89,2,31,1,1
50571,80,62731,80,318,192,126,6,26,4,2
58744,443,58147,443,14878,4225,10653,83,330,41,42
64270,443,64270,443,4747,1840,2907,19,27,11,8
55164,53,9551,53,170,87,83,2,31,1,1
55867,53,6696,53,184,94,90,2,30,1,1
55848,53,34320,53,168,86,82,2,30,1,1
52772,80,28043,80,2501,1085,1416,15,108,8,7
37316,443,11978,443,19840,6479,13361,57,127,32,25
55352,53,35227,53,216,110,106,2,30,1,1
38922,443,18971,443,346170,16091,330079,454,16,225,229
64227,53,32450,53,245,94,151,2,30,1,1
44883,53,44883,53,216,90,126,2,29,1,1
27005,27019,53599,27019,881,126,755,2,30,1,1
59936,443,17847,443,34167,3638,30529,50,200,23,27
59993,80,25071,80,1883,1263,620,11,83,6,5
60590,443,17721,443,41114,1554,39560,49,120,18,31
60039,80,53912,80,3431,2292,1139,17,142,10,7
63976,25725,20832,25725,66,66,0,1,5,1,0
64835,53,44115,53,371,126,245,2,30,1,1
49437,53,10171,53,199,102,97,2,30,1,1
123,123,56817,123,184,94,90,2,30,1,1
60887,443,40935,443,3795,2679,1116,27,45,15,12
55813,443,20333,443,15097,2888,12209,40,28,20,20
49215,53,25508,53,214,102,112,2,30,1,1
57470,18634,6347,18634,594,594,0,10,1199,10,0
61908,7000,61908,7000,4131,1750,2381,17,15,9,8
49537,53,46669,53,269,96,173,4,59,2,2
39615,443,10074,443,6133,1343,4790,22,275,12,10
56367,443,5869,443,4863,3011,1852,20,234,12,8
49160,28890,3522,28890,830,150,680,4,1200,2,2
42819,443,36580,443,10837,3411,7426,34,272,17,17
32777,443,20717,443,8080,2049,6031,23,255,12,11
53828,443,58283,443,499,425,74,4,0,3,1
38832,443,4622,443,23292,17154,6138,141,522,79,62
58854,443,18047,443,5202,3361,1841,19,16,10,9
5588,5588,0,0,3498,1872,1626,48,195,24,24
56622,443,37505,443,3575,1079,2496,15,155,7,8
27005,27015,2437,27015,878,126,752,2,30,1,1
43412,80,13841,80,78,78,0,1,4,1,0
56727,53,51350,53,250,86,164,4,54,2,2
36682,80,24588,80,130,70,60,2,15,1,1
56552,53,11395,53,190,97,93,2,31,1,1
55223,53,34886,53,168,86,82,2,31,1,1
50880,80,50880,80,163985,6578,157407,188,26,72,116
60429,46854,20959,46854,70,70,0,1,5,1,0
51946,9407,10036,9407,70,70,0,2,7,2,0
57827,443,29156,443,912754,34972,877782,1035,294,410,625
55620,53,23313,53,177,94,83,2,30,1,1
58872,443,3820,443,1178,820,358,9,15,6,3
53889,443,11378,443,499,425,74,4,0,3,1
56721,53,12920,53,711,87,624,2,30,1,1
65350,53,14923,53,212,102,110,2,31,1,1
44455,53,21066,53,221,75,146,2,30,1,1
64323,53,64062,53,195,102,93,2,30,1,1
47257,443,58413,443,64727,10981,53746,91,141,36,55
48163,53,27599,53,199,94,105,2,30,1,1
64987,53,19027,53,196,100,96,2,30,1,1
65133,53,55111,53,198,102,96,2,30,1,1
50691,80,17442,80,55050,28089,26961,228,175,112,116
56122,53,50294,53,731,91,640,2,30,1,1
49418,27015,37811,27015,236,78,158,2,30,1,1
57035,53,29329,53,199,102,97,2,30,1,1
48865,443,7956,443,12824,2604,10220,46,255,20,26
53623,50093,42211,50093,552,306,246,9,38,5,4
49699,53,7442,53,266,89,177,4,58,2,2
50613,443,53382,443,1512,850,662,16,93,9,7
49815,443,20999,443,3964,780,3184,14,125,8,6
59979,443,21635,443,30171,25514,4657,77,37,42,35
38795,40042,2140,40042,142,80,62,2,31,1,1
15503,23852,58898,23852,10840,6789,4051,143,4379,82,61
57709,443,55185,443,10392,2789,7603,25,16,13,12
50594,80,50594,80,9937,4191,5746,27,17,13,14
36793,80,35918,80,156726,8626,148100,206,32,104,102
56782,443,26053,443,7956,1967,5989,20,15,11,9
61469,443,16667,443,6204,1125,5079,23,89,13,10
60945,443,30602,443,7771,2691,5080,34,28,19,15
58638,5900,58638,5900,126,62,64,2,5,1,1
54115,443,7544,443,6840,1394,5446,29,270,14,15
43435,5228,26335,5228,6668,1369,5299,20,3600,10,10
56600,443,42581,443,13773,6668,7105,31,105,19,12
51025,443,40011,443,6999,2523,4476,22,80,13,9
56615,53,33953,53,177,94,83,2,30,1,1
54322,27015,26816,27015,924,924,0,3,29,3,0
51876,35624,49210,35624,70,70,0,1,5,1,0
55025,53,8549,53,93,93,0,1,31,1,0
50140,53,26490,53,209,110,99,2,30,1,1
34680,9595,34680,9595,152,66,86,2,10,1,1
40701,5223,47765,5223,5723,1105,4618,27,473,10,17
57470,9273,56118,9273,491,150,341,2,1199,1,1
49631,53,0,0,82,82,0,1,30,1,0
52776,443,19615,443,10091,2314,7777,33,17,18,15
53771,443,40823,443,499,425,74,4,0,3,1
50621,443,42155,443,3171,1473,1698,15,93,9,6
65186,27126,54671,27126,268,78,190,2,30,1,1
44125,53,44125,53,209,79,130,2,30,1,1
49549,443,52947,443,7896,1770,6126,26,171,13,13
50870,80,58385,80,7313,1684,5629,15,148,8,7
54953,53,51225,53,289,134,155,2,30,1,1
56979,53,46725,53,209,110,99,2,29,1,1
55855,443,32782,443,11485,3525,7960,32,33,18,14
61716,80,3411,80,9323,5142,4181,23,20,12,11
55918,53,15262,53,184,94,90,2,31,1,1
49722,443,18328,443,9698,3026,6672,54,618,27,27
57470,21178,29997,21178,166,166,0,1,1200,1,0
61286,443,11751,443,8970,5359,3611,22,121,11,11
56192,53,47862,53,177,94,83,2,30,1,1
46072,443,46479,443,16656,3094,13562,29,271,14,15
49210,53,44765,53,183,94,89,2,30,1,1
37965,16153,40075,16153,1320,1320,0,21,1682,21,0
42891,53,42891,53,224,88,136,2,30,1,1
52120,443,51831,443,305183,9715,295468,312,44,107,205
56107,53,50537,53,817,102,715,2,30,1,1
49623,80,12161,80,454,262,192,8,42,5,3
49166,53,45421,53,770,101,669,2,31,1,1
56419,80,4193,80,34098,808,33290,34,104,9,25
64013,48970,1892,48970,66,66,0,2,8,2,0
64283,53,44589,53,193,102,91,2,29,1,1
9290,443,4925,443,8041,2882,5159,29,23,16,13
37965,54371,6962,54371,132,132,0,3,1199,3,0
65347,53,20093,53,352,94,258,2,30,1,1
52728,443,50981,443,186399,56439,129960,335,45,170,165
55719,8060,46962,8060,70,70,0,1,4,1,0
52929,443,26411,443,8623,4829,3794,44,195,22,22
55541,53,64093,53,177,94,83,2,30,1,1
56369,443,26395,443,3674,1750,1924,23,203,12,11
0,0,0,0,244,244,0,2,0,2,0
49976,53,5693,53,393,110,283,2,30,1,1
59044,53,47816,53,78,78,0,1,30,1,0
48728,443,2946,443,2437,1321,1116,15,83,9,6
50458,53,29574,53,177,94,83,2,31,1,1
45308,443,7277,443,3657,1867,1790,22,391,7,15
44915,443,17055,443,23886,6994,16892,26,129,12,14
42226,53,42226,53,259,114,145,2,29,1,1
51920,443,50819,443,98155,20830,77325,151,103,70,81
49167,53,5532,53,816,102,714,2,30,1,1
49310,53,37425,53,239,102,137,2,30,1,1
27005,27027,61298,27027,880,126,754,2,31,1,1
58278,443,51446,443,7349712,213635,7136077,7600,192,2303,5297
50873,443,21465,443,6889,1381,5508,19,129,9,10
38495,443,26566,443,7778,1724,6054,29,17,16,13
49658,443,50327,443,14121,2299,11822,37,19,19,18
55634,58846,18331,58846,70,70,0,2,8,2,0
59638,53,40619,53,714,454,260,2,30,1,1
44757,53,59516,53,179,86,93,2,30,1,1
52022,80,47623,80,422,240,182,8,24,5,3
55017,53,20456,53,288,110,178,2,29,1,1
49969,53,27742,53,199,102,97,2,30,1,1
55926,53,56818,53,184,94,90,2,29,1,1
57409,53,7230,53,168,86,82,2,30,1,1
59297,80,59297,80,107500,4003,103497,173,16,57,116
42663,80,49274,80,5562,1204,4358,11,91,7,4
39310,53,33057,53,199,94,105,2,30,1,1
50509,80,1536,80,49872,11098,38774,65,24,27,38
56119,53,4548,53,199,102,97,2,30,1,1
49554,53,13063,53,204,104,100,2,30,1,1
52126,443,21159,443,1672,1149,523,13,37,8,5
62593,7010,62593,7010,4231,2106,2125,15,15,8,7
49717,443,52321,443,4876,855,4021,16,52,7,9
27005,27015,45042,27015,878,126,752,2,30,1,1
50230,80,65071,80,12572,8562,4010,48,442,26,22
58021,80,10301,80,318,192,126,6,20,4,2
9302,443,20327,443,4216,771,3445,16,26,9,7
50041,443,6754,443,17237,1717,15520,36,152,16,20
60500,443,54155,443,103479,7755,95724,165,19,70,95
56945,53,11659,53,180,94,86,2,30,1,1
49166,443,10443,443,70,70,0,1,5,1,0
53917,35885,37941,35885,70,70,0,1,4,1,0
48785,443,37520,443,6464,1223,5241,25,33,12,13
64813,53,49645,53,177,94,83,2,30,1,1
34219,53,25349,53,199,94,105,2,30,1,1
64298,443,45877,443,115035,5282,109753,128,120,44,84
56757,53,3651,53,783,96,687,2,31,1,1
57306,53,20608,53,573,186,387,6,71,3,3
47054,443,53511,443,6803,2164,4639,14,121,7,7
58878,443,22672,443,25575,16682,8893,57,21,31,26
51221,40624,20030,40624,594,594,0,10,1200,10,0
64403,53,53109,53,387,134,253,2,30,1,1
55043,53,37629,53,167,86,81,2,30,1,1
63830,15847,65256,15847,1592,1044,548,15,15,9,6
60398,80,57820,80,378,192,186,7,122,4,3
9278,23,9278,23,146,60,86,2,10,1,1
52026,80,21940,80,422,240,182,8,25,5,3
65265,53,48964,53,207,86,121,2,30,1,1
49530,53,54763,53,265,102,163,2,30,1,1
37390,443,2795,443,4859,964,3895,17,26,10,7
52082,14804,9932,14804,70,70,0,2,8,2,0
56734,45086,42195,45086,1640,460,1180,8,30,4,4
55492,53,34032,53,216,110,106,2,29,1,1
29746,53,29746,53,235,90,145,2,32,1,1
53741,43800,53441,43800,70,70,0,2,7,2,0
54828,443,7869,443,150,150,0,1,5,1,0
29047,80,29047,80,10148,1458,8690,23,25,11,12
45550,80,42274,80,890,420,470,14,27,7,7
55830,53,50350,53,166,86,80,2,30,1,1
55797,53,14709,53,735,88,647,2,30,1,1
58101,53,12737,53,83,83,0,2,31,2,0
51728,55504,11641,55504,316,136,180,6,6,3,3
63779,12226,30689,12226,70,70,0,1,4,1,0
50307,53,50594,53,1370,89,1281,4,33,2,2
50746,443,7838,443,6354,1372,4982,18,161,9,9
56755,443,63082,443,1327,918,409,10,26,6,4
49493,443,39689,443,9692,6055,3637,21,30,11,10
55754,53,32469,53,170,87,83,2,31,1,1
34424,443,13536,443,8277,2394,5883,31,316,16,15
58805,443,25945,443,32148,21507,10641,72,21,42,30
5588,5588,0,0,3562,1936,1626,48,196,24,24
33842,53,33842,53,1415,689,726,3,31,2,1
49615,53,30558,53,413,170,243,6,31,3,3
40161,443,23210,443,13459,1604,11855,27,66,14,13
56710,80,31559,80,30614,1926,28688,44,45,23,21
49160,38552,12049,38552,868,150,718,4,1200,2,2
50334,53,27323,53,216,110,106,2,29,1,1
56658,53,56658,53,257,114,143,2,30,1,1
50418,53,58072,53,185,102,83,2,30,1,1
64729,53,36616,53,262,94,168,2,30,1,1
58638,5900,58638,5900,66,66,0,1,4,1,0
6712,80,6712,80,514,246,268,9,82,5,4
38640,80,6468,80,1013,504,509,10,15,6,4
55045,443,26442,443,5541,2778,2763,24,15,14,10
50038,53,4648,53,281,78,203,2,31,1,1
55967,53,41577,53,209,110,99,2,30,1,1
27999,443,45047,443,5577,1390,4187,19,15,9,10
36843,443,62939,443,1988,1348,640,16,30,9,7
57335,443,6083,443,4048,3089,959,24,15,13,11
50284,53,6888,53,168,78,90,2,30,1,1
50553,3389,50553,3389,3327,1438,1889,15,17,8,7
57878,80,49228,80,5518,527,4991,13,75,6,7
56375,53,25593,53,216,110,106,2,30,1,1
49622,80,33304,80,454,262,192,8,42,5,3
49171,443,51614,443,7966,2735,5231,22,120,10,12
55730,53,1752,53,819,102,717,2,29,1,1
39322,443,56925,443,7450,2503,4947,21,977,11,10
49348,53,25745,53,188,96,92,2,31,1,1
36245,53,44289,53,168,78,90,2,30,1,1
38659,443,10582,443,11202,2200,9002,39,131,20,19
43576,80,43576,80,44566,6675,37891,58,23,27,31
54314,53,25378,53,284,79,205,2,30,1,1
60142,443,18976,443,2998,1997,1001,16,16,8,8
61472,443,58092,443,6211,1132,5079,23,88,13,10
50230,80,20217,80,2384,952,1432,15,75,8,7
34344,443,5583,443,9167,2205,6962,37,120,19,18
58771,443,59212,443,5750,1163,4587,25,258,13,12
57326,53,28871,53,90,90,0,1,30,1,0
59182,53,44334,53,260,86,174,2,30,1,1
49164,53,54796,53,226,102,124,2,30,1,1
39980,443,41321,443,130,70,60,2,15,1,1
58131,53,58131,53,194,87,107,2,30,1,1
57134,53,48452,53,178,94,84,2,30,1,1
53604,1046,44060,1046,320,140,180,6,5,3,3
58424,443,8670,443,81295,4140,77155,114,117,42,72
56344,53,47952,53,199,102,97,2,30,1,1
61956,80,61956,80,2102,1583,519,11,23,6,5
55669,53,15952,53,177,94,83,2,30,1,1
27005,27257,60876,27257,883,126,757,2,30,1,1
37917,443,55165,443,6124,860,5264,18,361,9,9
40848,8434,40848,8434,156,156,0,3,8,3,0
58991,443,64156,443,972647,20727,951920,916,263,245,671
49768,80,40790,80,254,128,126,5,15,3,2
52930,80,36918,80,76193,2105,74088,75,359,23,52
49415,443,37841,443,9623,3235,6388,33,118,18,15
53223,53,33950,53,165,78,87,2,30,1,1
64957,53,58925,53,196,102,94,2,30,1,1
44191,443,19988,443,7151,1943,5208,30,25,17,13
65304,53,46271,53,209,110,99,2,30,1,1
55502,53,12440,53,817,102,715,2,30,1,1
50589,53,50328,53,733,85,648,2,30,1,1
55036,53,3360,53,177,94,83,2,30,1,1
52022,53657,53149,53657,66,66,0,1,5,1,0
51667,25826,43364,25826,9372,9372,0,11,30,11,0
57321,53,18718,53,199,102,97,2,30,1,1
50283,443,36964,443,290,142,148,5,11,3,2
46658,53,46658,53,216,98,118,2,30,1,1
56439,53,22467,53,751,95,656,2,30,1,1
47510,443,50202,443,5149,852,4297,16,15,9,7
60436,56687,61011,56687,564,318,246,9,16,5,4
53831,443,42938,443,190,70,120,4,15,2,2
45051,53,45051,53,404,259,145,3,32,2,1
58950,443,1545,443,5108,700,4408,15,15,7,8
62050,443,9772,443,2139,1140,999,15,124,9,6
51946,9407,60623,9407,70,70,0,1,4,1,0
43770,53,60550,53,199,94,105,2,30,1,1
52757,80,11666,80,2426,1594,832,17,151,9,8
34990,80,31222,80,350,210,140,6,28,4,2
59985,443,16838,443,25649,1485,24164,36,144,14,22
52921,443,44773,443,36892,20283,16609,191,116,77,114
65180,53,7905,53,199,102,97,2,30,1,1
64146,53,33411,53,273,94,179,2,30,1,1
64180,53,29611,53,180,94,86,2,31,1,1
63015,53,58315,53,303,85,218,2,31,1,1
42597,443,16661,443,8533,2023,6510,23,15,12,11
57470,53756,4202,53756,132,132,0,3,1199,3,0
35452,443,39555,443,5120,3761,1359,21,49,12,9
49321,53,65339,53,225,102,123,2,30,1,1
49418,32058,6170,32058,78,78,0,1,30,1,0
49724,53,13142,53,183,94,89,2,30,1,1
55650,53,47564,53,174,89,85,2,30,1,1
51145,80,27456,80,78198970,2041652,76157318,79332,368,28698,50634
57130,443,40605,443,6489,1065,5424,22,255,12,10
60875,443,10095,443,1786,172,1614,7,120,3,4
56620,80,60684,80,234,234,0,4,12,4,0
56625,443,59240,443,7888,1899,5989,20,15,11,9
65325,53,48288,53,216,110,106,2,30,1,1
50807,443,17833,443,9328,1709,7619,18,139,8,10
52075,37919,16771,37919,70,70,0,1,4,1,0
61681,443,50543,443,10714,3531,7183,26,120,12,14
65251,53,42946,53,199,102,97,2,30,1,1
64461,53,32838,53,350,89,261,4,53,2,2
48371,443,24225,443,3908,630,3278,12,17,7,5
49429,53,47373,53,194,102,92,2,30,1,1
49611,53,47629,53,184,94,90,2,29,1,1
64798,53,7114,53,178,94,84,2,30,1,1
49492,53,34957,53,199,102,97,2,31,1,1
61678,80,36347,80,79505,3799,75706,105,53,43,62
56823,50291,65479,50291,316,136,180,6,6,3,3
63934,53,32673,53,209,110,99,2,29,1,1
58194,443,27436,443,3108,1047,2061,14,136,7,7
41639,8080,18114,8080,78,78,0,2,8,2,0
12567,53,12567,53,231,90,141,2,30,1,1
50193,443,31534,443,2404,1121,1283,14,115,7,7
52016,80,9292,80,124703,6134,118569,147,125,64,83
60321,443,49674,443,1743,1164,579,16,25,10,6
40956,443,7227,443,10836,1733,9103,34,180,15,19
49687,53,63012,53,241,94,147,2,29,1,1
36927,80,32507,80,130,70,60,2,14,1,1
58068,443,17873,443,543,303,240,8,5,4,4
21944,53,21944,53,217,82,135,2,32,1,1
51969,80,41756,80,7304882,206543,7098339,7398,37,2677,4721
60982,443,39893,443,18274,7660,10614,46,48,26,20
56907,53,55203,53,193,102,91,2,30,1,1
53130,443,27794,443,7169,1715,5454,18,325,9,9
49364,443,4324,443,5141,896,4245,17,69,8,9
52194,80,42397,80,1151,711,440,10,15,5,5
1939,53,33288,53,210,78,132,2,30,1,1
64711,53,17611,53,211,110,101,2,30,1,1
53908,443,36300,443,499,425,74,4,0,3,1
51844,12471,8982,12471,70,70,0,1,5,1,0
6881,45711,37473,45711,228,118,110,2,1199,1,1
64359,53,44275,53,196,102,94,2,30,1,1
33555,443,31836,443,10856,3151,7705,34,361,16,18
51535,443,45578,443,202,70,132,3,11,1,2
55164,53,26323,53,177,94,83,2,30,1,1
55967,53,30635,53,209,110,99,2,30,1,1
55200,53,19754,53,209,110,99,2,30,1,1
52171,63033,25728,63033,70,70,0,1,5,1,0
55918,53,38281,53,184,94,90,2,31,1,1
54461,80,46042,80,2544,900,1644,12,255,7,5
53548,443,53548,443,1386,751,635,15,181,8,7
57428,53,16884,53,198,94,104,2,30,1,1
62618,443,27342,443,6939,2970,3969,19,144,9,10
56382,53,27838,53,195,102,93,2,30,1,1
49275,53,59894,53,190,97,93,2,31,1,1
60319,53,31437,53,316,80,236,2,31,1,1
57035,80,15633,80,953,524,429,11,256,6,5
34320,443,18156,443,5823,1597,4226,21,19,11,10
55383,443,17690,443,40612,4090,36522,71,150,31,40
49686,53,47017,53,183,94,89,2,30,1,1
60278,80,27803,80,1422,734,688,7,99,4,3
58638,5900,58638,5900,160,66,94,2,9,1,1
10151,6889,16341,6889,481,150,331,2,1200,1,1
56337,53,29643,53,268,89,179,4,45,2,2
41543,443,50786,443,78,78,0,1,5,1,0
34960,443,12324,443,190,70,120,4,15,2,2
6881,6881,26370,6881,502,150,352,2,1200,1,1
65115,53,52563,53,193,102,91,2,30,1,1
42308,443,54120,443,433261,34730,398531,604,279,258,346
53823,443,24155,443,499,425,74,4,0,3,1
64281,53,42063,53,214,110,104,2,30,1,1
50823,443,51509,443,6601,1120,5481,17,115,9,8
0,0,0,0,244,244,0,2,0,2,0
55244,53,11760,53,168,78,90,2,30,1,1
49513,53,36009,53,200,102,98,2,30,1,1
64957,53,56586,53,196,102,94,2,31,1,1
55288,53,34566,53,196,102,94,2,30,1,1
27005,27015,54928,27015,882,126,756,2,30,1,1
49418,27015,42227,27015,251,78,173,2,30,1,1
49905,53,31462,53,180,94,86,2,29,1,1
37594,443,15585,443,60339,4689,55650,79,47,35,44
38460,443,14446,443,272822,10124,262698,330,81,126,204
33060,443,63569,443,25617,6531,19086,87,220,46,41
0,0,0,0,320,320,0,5,0,5,0
55889,53,44791,53,199,102,97,2,30,1,1
60821,443,28093,443,16554,7445,9109,49,255,24,25
9463,443,40374,443,8952,5576,3376,35,38,21,14
36404,443,36404,443,4651,1744,2907,19,28,11,8
47665,443,4370,443,214,140,74,4,15,3,1
49478,53,58294,53,164,86,78,2,31,1,1
57447,443,54490,443,12192,3788,8404,36,18,18,18
65254,53,46437,53,459,94,365,4,45,2,2
50509,53,14571,53,789,110,679,2,31,1,1
51632,80,60453,80,502,256,246,9,39,5,4
35105,443,59131,443,639937,14873,625064,627,230,188,439
49853,53,48467,53,811,94,717,2,30,1,1
39572,443,3299,443,2396,1144,1252,14,982,7,7
64725,53,58713,53,757,102,655,2,30,1,1
29964,53,52267,53,200,86,114,2,30,1,1
53252,443,50911,443,6899,2368,4531,27,27,14,13
57791,443,18201,443,30057,13955,16102,146,556,65,81
64356,53,40978,53,243,94,149,2,30,1,1
31126,53,31126,53,240,98,142,2,30,1,1
56335,53,52497,53,193,102,91,2,30,1,1
53067,4040,59736,4040,115,115,0,1,31,1,0
57397,53,56026,53,177,94,83,2,31,1,1
56416,53,30154,53,816,102,714,2,30,1,1
5588,5588,0,0,3354,1792,1562,46,193,23,23
49761,80,17829,80,2113,1181,932,10,127,6,4
36858,443,39662,443,3789,2373,1416,24,26,14,10
56991,443,28802,443,20986,10828,10158,35,95,20,15
52641,6881,46429,6881,1162,856,306,10,14,5,5
64156,53,39777,53,409,92,317,4,30,2,2
61421,80,3203,80,214,140,74,4,41,3,1
46102,80,6915,80,70,70,0,2,5,2,0
52006,443,14012,443,2898,2047,851,19,22,11,8
49459,443,10186,443,10166,3392,6774,35,133,18,17
53710,27935,34512,27935,70,70,0,1,4,1,0
64637,53,26983,53,194,102,92,2,31,1,1
62068,80,36797,80,2806,626,2180,12,15,6,6
49650,443,26849,443,92597,47158,45439,747,1187,422,325
65354,53,12903,53,168,86,82,2,30,1,1
56204,53,35086,53,195,102,93,2,30,1,1
38947,443,49748,443,16499,9522,6977,44,364,22,22
56536,53,3128,53,209,110,99,2,31,1,1
56567,53,28811,53,194,102,92,2,31,1,1
54961,443,45503,443,25572,2605,22967,56,133,29,27
64856,53,25050,53,451,124,327,4,45,2,2
51916,80,61338,80,182,60,122,4,26,2,2
65339,53,50441,53,186,95,91,2,31,1,1
36754,7,13340,7,138,78,60,2,5,1,1
51243,80,3228,80,1451,949,502,12,46,7,5
27005,1105,65392,1105,855,126,729,2,29,1,1
49938,80,5232,80,1130,613,517,11,15,6,5
65331,53,14108,53,308,102,206,2,30,1,1
64125,53,55658,53,370,94,276,2,30,1,1
64135,53,37160,53,196,102,94,2,30,1,1
56838,53,31421,53,327,87,240,4,50,2,2
56456,53,58146,53,199,102,97,2,30,1,1
49767,53,59870,53,200,102,98,2,30,1,1
21447,53,55331,53,245648,213726,31922,2763,89,2579,184
60043,443,26610,443,1015,572,443,11,142,6,5
56844,44445,50438,44445,70,70,0,1,5,1,0
53072,443,53072,443,49826,37097,12729,66,163,40,26
55531,53,31789,53,216,110,106,2,30,1,1
54537,80,39580,80,4096,3455,641,13,15,8,5
64751,53,57978,53,178,94,84,2,30,1,1
65507,53,3700,53,167,86,81,2,30,1,1
55708,22094,3066,22094,564,318,246,9,15,5,4
52897,80,31689,80,4292,1932,2360,32,118,17,15
27005,27015,35363,27015,884,126,758,2,31,1,1
56772,53,9066,53,168,86,82,2,30,1,1
51497,443,32306,443,4710,699,4011,12,15,8,4
49686,53,35211,53,182,93,89,2,30,1,1
52167,61948,3341,61948,70,70,0,1,5,1,0
64756,53,60471,53,195,102,93,2,30,1,1
56380,53,55619,53,170,87,83,2,31,1,1
58986,443,33028,443,2894,1653,1241,24,26,12,12
57023,53,64217,53,174,89,85,2,31,1,1
60382,62582,16978,62582,70,70,0,1,5,1,0
48066,443,56844,443,62,62,0,1,4,1,0
33829,443,29338,443,568,222,346,9,26,4,5
64199,53,4669,53,215,102,113,2,30,1,1
49884,443,34007,443,5265,1647,3618,16,88,9,7
49163,53,13314,53,167,86,81,2,29,1,1
49771,53,11315,53,728,96,632,2,31,1,1
49640,443,44264,443,12619,3258,9361,33,47,19,14
63725,80,55530,80,374,192,182,7,15,4,3
50620,80,32710,80,16709,10372,6337,31,52,16,15
58043,80,57225,80,378,192,186,7,20,4,3
65477,53,48091,53,183,94,89,2,30,1,1
50156,53,2104,53,777,87,690,2,0,1,1
43972,80,64832,80,1894,1520,374,15,15,9,6
58673,443,8091,443,3330,737,2593,10,121,5,5
52380,443,20377,443,8659,3601,5058,34,80,18,16
39054,53,31083,53,168,78,90,2,30,1,1
52117,20600,30733,20600,70,70,0,2,8,2,0
42862,443,59113,443,10233,2198,8035,25,81,14,11
41924,53,41924,53,237,91,146,2,33,1,1
49205,53,61916,53,194,102,92,2,30,1,1
55631,443,58192,443,6897,2509,4388,16,121,8,8
49432,53,51069,53,177,94,83,2,30,1,1
57118,443,64702,443,5133,631,4502,14,15,8,6
57747,80,27520,80,2754,1602,1152,17,22,9,8
55968,53,21608,53,243,94,149,2,30,1,1
55750,53,45785,53,211,110,101,2,29,1,1
54309,80,4585,80,552,280,272,9,30,5,4
53234,443,53501,443,6059,1040,5019,20,58,11,9
49715,53,16817,53,184,94,90,2,30,1,1
33099,443,5841,443,11110,1700,9410,33,750,11,22
60022,80,60022,80,2959,1505,1454,10,15,6,4
51884,22828,1526,22828,70,70,0,1,5,1,0
64034,53,27312,53,194,102,92,2,30,1,1
53729,443,15910,443,499,425,74,4,0,3,1
46532,3389,46532,3389,4145,1976,2169,22,20,13,9
56140,53,23511,53,195,86,109,2,30,1,1
52498,80,52498,80,15453,911,14542,25,16,11,14
55044,80,26880,80,306,180,126,6,34,4,2
41487,443,27679,443,7112,5916,1196,20,30,10,10
11028,443,11028,443,6671,3244,3427,26,30,16,10
9315,443,40509,443,3649,424,3225,12,15,6,6
37048,53,15129,53,168,78,90,2,29,1,1
52057,80,6987,80,422,240,182,8,25,5,3
53899,45682,27773,45682,70,70,0,2,7,2,0
64703,53,13570,53,214,102,112,2,30,1,1
51960,58601,34616,58601,70,70,0,1,5,1,0
56787,443,11653,443,5639,846,4793,18,27,10,8
36513,443,42006,443,4216,2615,1601,26,80,13,13
56650,443,37147,443,8008,1988,6020,20,15,11,9
58831,443,26619,443,5167,700,4467,16,15,7,9
45077,443,30343,443,9599,1234,8365,27,29,15,12
55027,443,20215,443,19367,11346,8021,47,19,26,21
49168,53,56952,53,196,102,94,2,30,1,1
56980,80,6065,80,214,140,74,4,35,3,1
53791,53,53567,53,260,86,174,2,30,1,1
53012,80,53012,80,278027,5087,272940,288,22,76,212
27005,32073,48886,32073,884,126,758,2,31,1,1
34687,443,63653,443,3120,1862,1258,18,15,11,7
52078,15518,47758,15518,70,70,0,2,7,2,0
55945,53,26703,53,170,87,83,2,30,1,1
51825,25501,11280,25501,70,70,0,2,9,2,0
44959,443,64557,443,373033,19903,353130,469,143,180,289
27005,27015,41826,27015,868,126,742,2,30,1,1
49337,443,20876,443,3185,2263,922,18,26,9,9
27005,27015,36150,27015,889,126,763,2,30,1,1
26900,27017,31665,27017,254,82,172,4,30,2,2
64657,53,12172,53,312,94,218,2,30,1,1
65513,53,57723,53,195,102,93,2,29,1,1
52280,5228,18366,5228,2147,1315,832,14,3601,7,7
63981,34250,53768,34250,66,66,0,2,8,2,0
53853,443,38658,443,499,425,74,4,0,3,1
8282,39458,7982,39458,78,78,0,1,30,1,0
64978,53,20864,53,198,102,96,2,30,1,1
54977,53,63603,53,275,93,182,4,32,2,2
56919,53,56265,53,177,94,83,2,30,1,1
46641,8100,62793,8100,234,234,0,4,11,4,0
49224,53,60967,53,177,94,83,2,30,1,1
56838,35124,44520,35124,70,70,0,1,5,1,0
32967,80,37431,80,21387,1482,19905,38,18,19,19
8415,8415,47085,8415,66,66,0,1,30,1,0
64811,53,25235,53,193,102,91,2,29,1,1
50653,80,52730,80,1658,1247,411,8,15,5,3
50266,443,13343,443,6344,2063,4281,26,21,12,14
61448,443,1765,443,6109,1902,4207,33,141,19,14
57130,443,51431,443,10724,3758,6966,38,403,13,25
49418,27015,23061,27015,256,78,178,2,30,1,1
53565,443,13839,443,12007,942,11065,19,120,8,11
58282,53,59362,53,215,102,113,2,30,1,1
57309,53,41723,53,316,110,206,2,30,1,1
56067,53,40948,53,195,102,93,2,30,1,1
50390,53,29650,53,772,103,669,2,30,1,1
61424,80,26157,80,214,140,74,4,41,3,1
55475,53,3330,53,381,102,279,4,44,2,2
53049,443,20030,443,7393,2050,5343,34,92,16,18
49238,53,49238,53,235,90,145,2,32,1,1
16012,53,16012,53,235,90,145,2,32,1,1
53767,10004,19496,10004,70,70,0,1,4,1,0
55831,53,9463,53,183,94,89,2,30,1,1
52065,52021,23578,52021,70,70,0,1,4,1,0
33571,443,51011,443,4281,1160,3121,12,122,6,6
42420,443,29433,443,8616,2683,5933,30,459,15,15
41793,53,3227,53,168,78,90,2,30,1,1
55600,53,4581,53,209,110,99,2,30,1,1
49803,443,21959,443,9506,1461,8045,20,158,9,11
51260,80,52216,80,23175,13071,10104,134,1929,67,67
54199,443,3753,443,26903,3579,23324,72,278,33,39
65306,53,12072,53,244,94,150,2,30,1,1
50437,80,64833,80,314,192,122,6,26,4,2
55647,53,13562,53,168,86,82,2,31,1,1
53912,3478,60537,3478,3532,1792,1740,58,88,29,29
56340,53,40288,53,198,102,96,2,30,1,1
56658,53,32323,53,193,102,91,2,30,1,1
55098,53,8835,53,176,90,86,2,30,1,1
58605,443,40025,443,3301,1240,2061,14,135,7,7
49849,53,61078,53,196,102,94,2,31,1,1
64672,53,41499,53,576,195,381,6,51,3,3
51171,443,60392,443,1532,965,567,14,20,7,7
53917,443,58017,443,499,425,74,4,0,3,1
56620,53,31427,53,216,110,106,2,30,1,1
53714,443,10907,443,4933,957,3976,17,15,10,7
49482,80,62281,80,378,192,186,7,39,4,3
57283,53,15261,53,185,102,83,2,30,1,1
9117,80,20757,80,318,192,126,6,29,4,2
56427,53,59591,53,166,86,80,2,30,1,1
56415,53,6839,53,198,101,97,2,30,1,1
51943,55464,31100,55464,70,70,0,2,8,2,0
52172,80,27126,80,362,240,122,7,17,5,2
17119,53,17119,53,217,87,130,2,30,1,1
51948,34853,60337,34853,316,136,180,6,6,3,3
59752,443,12592,443,304,86,218,2,30,1,1
57000,53,32346,53,194,102,92,2,30,1,1
53133,34853,20354,34853,758,320,438,11,16,6,5
50260,53,50381,53,196,86,110,2,30,1,1
54327,7000,54327,7000,3310,1535,1775,15,15,8,7
52998,443,2559,443,190,70,120,4,15,2,2
57071,53,20542,53,166,86,80,2,29,1,1
50267,53,48112,53,734,94,640,2,31,1,1
51811,20740,61529,20740,70,70,0,2,8,2,0
50126,443,34426,443,15032,5689,9343,51,35,27,24
52933,443,60920,443,5582,1388,4194,19,15,9,10
56631,443,17729,443,7889,1900,5989,20,16,11,9
56747,53,24796,53,172,94,78,2,30,1,1
52160,49212,45447,49212,316,136,180,6,6,3,3
56684,443,25036,443,8737,1821,6916,23,23,14,9
56481,80,14814,80,71347,4788,66559,83,136,34,49
56317,53,15827,53,183,94,89,2,30,1,1
27005,27058,26884,27058,908,126,782,2,31,1,1
33564,443,54838,443,314376,14130,300246,399,246,169,230
57136,53,60175,53,209,110,99,2,29,1,1
64687,53,10483,53,183,94,89,2,29,1,1
49834,443,28335,443,9890,4516,5374,26,124,14,12
64036,53,20328,53,183,94,89,2,30,1,1
27005,27023,4968,27023,1640,126,1514,4,30,2,2
64631,53,41468,53,186,95,91,2,31,1,1
57312,53,16678,53,1385,85,1300,4,42,2,2
50257,443,7570,443,249660,21361,228299,416,141,191,225
18686,53,18686,53,235,90,145,2,32,1,1
55867,53,63583,53,184,94,90,2,31,1,1
56018,443,53493,443,162,102,60,2,5,1,1
51846,41510,42814,41510,70,70,0,1,5,1,0
9330,443,63077,443,3255,430,2825,11,15,6,5
45859,443,65407,443,5508,999,4509,20,255,11,9
53842,443,26608,443,499,425,74,4,0,3,1
55415,53,31153,53,183,94,89,2,31,1,1
57470,29500,37295,29500,2772,2772,0,43,2311,43,0
49414,443,32360,443,11485,3381,8104,39,124,23,16
53793,443,25367,443,499,425,74,4,0,3,1
65100,53,16934,53,199,102,97,2,30,1,1
50337,443,21907,443,9653,1740,7913,23,81,12,11
58826,443,32981,443,5168,700,4468,16,15,7,9
55727,53,61818,53,177,94,83,2,30,1,1
53787,53,59844,53,224,86,138,2,30,1,1
51103,443,36898,443,20280,13177,7103,82,1176,46,36
64698,53,59784,53,430,106,324,4,58,2,2
56995,53,4474,53,167,86,81,2,30,1,1
61231,443,59948,443,1864,250,1614,8,121,4,4
56361,53,48019,53,816,102,714,2,30,1,1
56583,443,5338,443,9416,2366,7050,25,19,14,11
53955,3290,40369,3290,70,70,0,2,7,2,0
8180,53,8180,53,220,90,130,2,30,1,1
42820,443,41684,443,8155,1999,6156,22,81,13,9
51231,443,1331,443,1396,735,661,14,80,8,6
49749,443,51214,443,54416,3219,51197,76,240,30,46
43094,443,34606,443,6443,1973,4470,19,16,11,8
65330,53,59699,53,766,102,664,2,29,1,1
61637,53,21621,53,86,86,0,1,30,1,0
51870,443,29475,443,4375,1230,3145,16,26,8,8
49128,53,21318,53,199,94,105,2,30,1,1
58940,443,24448,443,5108,700,4408,15,15,7,8
50349,80,24554,80,3909,888,3021,12,15,6,6
44945,80,24197,80,1729,1287,442,7,15,5,2
65524,53,51364,53,182,93,89,2,31,1,1
37965,58909,50714,58909,1577,594,983,20,1724,10,10
64935,53,3553,53,198,102,96,2,30,1,1
37004,80,37004,80,13825,1203,12622,22,29,9,13
54991,53,33819,53,177,94,83,2,30,1,1
64555,53,55605,53,167,86,81,2,30,1,1
60759,40010,60253,40010,316,136,180,6,7,3,3
43830,443,46012,443,2257,461,1796,9,39,4,5
47080,80,47080,80,276453,7832,268621,287,165,92,195
45732,443,54582,443,6558,2131,4427,26,262,10,16
49384,53,31275,53,178,91,87,2,31,1,1
50981,443,28253,443,8407,3736,4671,19,101,11,8
61480,443,37591,443,5716,1341,4375,29,80,16,13
55152,53,21399,53,180,94,86,2,29,1,1
38160,443,10215,443,8185,2274,5911,18,135,8,10
55377,53,41334,53,195,102,93,2,30,1,1
55595,33677,1152,33677,210,140,70,4,14,3,1
56376,53,35947,53,198,102,96,2,30,1,1
53875,43611,37582,43611,70,70,0,1,5,1,0
41170,443,30807,443,8837,1938,6899,21,17,12,9
65160,53,39178,53,198,94,104,2,30,1,1
40599,443,4488,443,7338,2419,4919,19,23,12,7
55932,53,22197,53,209,110,99,2,30,1,1
56142,53,12873,53,188,96,92,2,30,1,1
38774,80,38774,80,369073,4523,364550,316,142,59,257
49304,443,52179,443,932965,16289,916676,768,65,148,620
49650,53,24810,53,216,110,106,2,29,1,1
57470,8999,31471,8999,1577,594,983,20,1614,10,10
60878,443,38028,443,764899,31427,733472,883,60,368,515
52568,80,52568,80,16474,1881,14593,28,143,12,16
45852,53,16051,53,774,76,698,4,29,2,2
47957,443,9309,443,7658,4247,3411,29,31,15,14
56841,29753,27881,29753,70,70,0,2,8,2,0
39333,443,52867,443,7832,1895,5937,24,83,14,10
53550,1,56985,1,70,70,0,2,8,2,0
39317,443,31071,443,2045,1025,1020,17,80,9,8
50979,80,12190,80,576971,8128,568843,497,38,114,383
49782,80,13908,80,1661,1147,514,9,210,5,4
47551,443,47551,443,4743,1836,2907,19,29,11,8
50238,53,16273,53,164,78,86,2,29,1,1
56717,53,2347,53,178,94,84,2,30,1,1
49948,80,2205,80,19740,993,18747,28,15,12,16
46744,53,46744,53,404,259,145,3,32,2,1
37672,5223,8222,5223,110,110,0,1,5,1,0
44858,5228,3088,5228,6819,1586,5233,18,3603,9,9
65424,53,57166,53,210,110,100,2,29,1,1
49698,443,62719,443,14762,1871,12891,30,34,16,14
56770,52920,10024,52920,70,70,0,1,5,1,0
49548,53,2066,53,263,102,161,2,29,1,1
35106,443,63708,443,309321,13076,296245,368,189,150,218
55684,53,19288,53,193,102,91,2,29,1,1
49531,53,3594,53,182,93,89,2,31,1,1
35568,443,33534,443,5383,3710,1673,27,309,14,13
27005,27027,58259,27027,1654,126,1528,4,31,2,2
65505,53,13490,53,166,86,80,2,30,1,1
49418,27015,31380,27015,239,78,161,2,30,1,1
55828,53,56117,53,177,94,83,2,30,1,1
64122,53,40984,53,214,110,104,2,30,1,1
59244,53,54257,53,168,78,90,2,30,1,1
50584,12948,3713,12948,346,161,185,2,1200,1,1
27005,27015,5411,27015,887,126,761,2,30,1,1
60715,443,1663,443,1716,1136,580,15,30,9,6
50302,80,5947,80,5100,1620,3480,17,114,10,7
65488,53,3940,53,266,110,156,2,30,1,1
54712,443,60548,443,5158,2609,2549,11,121,6,5
49706,443,36455,443,32941,1850,31091,46,131,19,27
56991,443,56991,443,6305,1352,4953,19,16,10,9
49434,53,30404,53,326,134,192,2,30,1,1
37579,443,40926,443,7982,2392,5590,25,26,14,11
52254,443,36907,443,13640,2316,11324,24,136,10,14
8662,80,8662,80,194259,7011,187248,211,39,80,131
55979,53,21397,53,193,102,91,2,31,1,1
54667,443,17668,443,3989,1104,2885,12,122,5,7
14605,53,14605,53,209,77,132,2,32,1,1
62061,53,49325,53,181,78,103,2,30,1,1
64906,53,18657,53,209,110,99,2,30,1,1
27393,53,7301,53,168,78,90,2,30,1,1
55735,53,9793,53,199,102,97,2,30,1,1
56176,53,13645,53,177,94,83,2,30,1,1
37277,80,37277,80,52625,3140,49485,55,52,14,41
53358,443,35239,443,8626,2839,5787,47,27,24,23
55346,443,44978,443,13181,6041,7140,60,410,27,33
50074,443,37111,443,1625,838,787,18,92,10,8
49931,443,45441,443,3278,1835,1443,22,16,13,9
50699,80,28391,80,54318,27824,26494,227,174,113,114
5588,5588,0,0,3562,1936,1626,48,194,24,24
60088,443,5059,443,1000,557,443,11,141,6,5
51776,14645,41362,14645,70,70,0,2,8,2,0
36505,443,41059,443,6293,1501,4792,22,16,11,11
64404,53,48455,53,224,94,130,2,30,1,1
9247,80,43064,80,860,794,66,6,17,5,1
57382,2258,57382,2258,156,156,0,3,8,3,0
53915,1026,52746,1026,70,70,0,2,8,2,0
56803,53,20372,53,195,102,93,2,31,1,1
37356,443,58036,443,1842,1134,708,14,315,8,6
52424,443,16403,443,10070,5084,4986,41,16,24,17
51966,443,55026,443,35199,15909,19290,70,152,34,36
51632,443,13714,443,5021,2884,2137,14,135,7,7
54998,53,21655,53,198,102,96,2,31,1,1
51951,65387,56923,65387,70,70,0,2,8,2,0
5284,53,5284,53,178,82,96,2,30,1,1
49319,53,1935,53,166,86,80,2,29,1,1
55008,53,19602,53,215,102,113,2,30,1,1
57912,443,23938,443,7953,5153,2800,33,142,19,14
64986,53,36194,53,182,93,89,2,31,1,1
50596,443,51132,443,9573,1963,7610,25,72,12,13
60786,3389,60786,3389,4226,2201,2025,19,18,10,9
34922,443,21368,443,8093,2068,6025,23,360,11,12
64329,53,19539,53,281,110,171,2,30,1,1
63993,53,47498,53,338,110,228,2,31,1,1
43347,7275,22003,7275,3299,665,2634,18,16,10,8
55030,443,37524,443,5372,1221,4151,23,18,14,9
45325,53,64530,53,168,78,90,2,30,1,1
64259,53,65307,53,211,78,133,2,31,1,1
52143,33283,33804,33283,70,70,0,1,5,1,0
37542,443,40273,443,13299,2872,10427,34,41,19,15
65290,53,22798,53,181,94,87,2,29,1,1
46899,80,46899,80,82739,3221,79518,91,156,28,63
64567,53,19362,53,199,102,97,2,30,1,1
19473,53813,59984,53813,481,150,331,2,1200,1,1
53772,14132,42222,14132,70,70,0,1,5,1,0
64331,53,26878,53,324,89,235,4,31,2,2
38791,53,38791,53,229,89,140,2,30,1,1
51408,443,60315,443,8774,3355,5419,19,36,11,8
59744,80,14710,80,699554,16426,683128,701,95,244,457
6881,50321,40130,50321,238,118,120,2,1199,1,1
64985,53,36411,53,192,98,94,2,30,1,1
64376,53,21911,53,210,94,116,2,30,1,1
50265,26512,31440,26512,480,149,331,2,1200,1,1
60480,80,35551,80,7406,1038,6368,18,16,10,8
55932,53,3397,53,186,95,91,2,30,1,1
56954,80,1117,80,1469,970,499,9,65,6,3
64986,53,8227,53,180,94,86,2,30,1,1
52096,55854,2133,55854,70,70,0,2,7,2,0
52074,53,21333,53,199,94,105,2,30,1,1
54323,27016,29153,27016,924,924,0,3,30,3,0
55624,80,8124,80,70,70,0,2,8,2,0
46209,443,22477,443,4900,2781,2119,25,95,13,12
65342,53,40557,53,183,94,89,2,30,1,1
52003,18150,63580,18150,70,70,0,1,5,1,0
27005,27091,18957,27091,883,126,757,2,31,1,1
56172,53,35826,53,253,87,166,4,30,2,2
59928,53,64195,53,168,78,90,2,30,1,1
123,123,4741,123,184,94,90,2,30,1,1
49857,80,39166,80,7800,1743,6057,20,89,11,9
56258,443,7050,443,3325,1067,2258,13,135,6,7
56765,53,27082,53,194,102,92,2,31,1,1
45896,443,44655,443,211720,46699,165021,332,109,152,180
50662,443,10724,443,6518,1200,5318,17,16,8,9
64054,53,34990,53,183,94,89,2,30,1,1
60907,443,25513,443,7477,3022,4455,27,45,15,12
53872,24710,60030,24710,70,70,0,2,7,2,0
49660,53,59057,53,193,102,91,2,29,1,1
53899,45682,35205,45682,70,70,0,1,4,1,0
64001,53,5288,53,182,93,89,2,30,1,1
37175,53,14480,53,231,86,145,2,29,1,1
54951,443,4064,443,30123,21849,8274,65,77,38,27
62439,443,62439,443,4507,1600,2907,19,26,11,8
56655,53,1875,53,210,110,100,2,30,1,1
57807,443,2939,443,9783,5855,3928,22,122,11,11
64870,53,47029,53,200,102,98,2,31,1,1
49762,53,16917,53,184,94,90,2,30,1,1
52346,5222,7493,5222,3983,1663,2320,40,151,19,21
55577,53,47306,53,199,102,97,2,30,1,1
49735,443,35310,443,6292,1682,4610,21,15,9,12
48643,80,57942,80,1912,1464,448,14,16,7,7
49695,53,13184,53,772,103,669,2,31,1,1
56405,443,6737,443,12470,1570,10900,21,125,10,11
57066,53,30352,53,197,94,103,2,30,1,1
58926,80,29286,80,1291,887,404,8,89,5,3
55869,53,64090,53,196,102,94,2,30,1,1
56913,53,62016,53,247,94,153,2,30,1,1
50477,80,59736,80,648,256,392,8,25,5,3
64801,53,57986,53,211,102,109,2,29,1,1
56653,53,34935,53,78,78,0,1,30,1,0
52018,2425,15478,2425,70,70,0,2,9,2,0
53928,443,61918,443,499,425,74,4,0,3,1
37912,443,38909,443,2738,1475,1263,19,275,10,9
55158,53,38311,53,212,102,110,2,30,1,1
39796,443,39796,443,4744,1837,2907,19,27,11,8
54870,443,54870,443,313399,38167,275232,411,23,205,206
52133,15015,56839,15015,70,70,0,2,8,2,0
49910,53,38613,53,218,94,124,2,30,1,1
51499,443,64851,443,43980,3500,40480,65,16,31,34
64813,53,46374,53,177,94,83,2,30,1,1
56237,80,56237,80,44949,1017,43932,48,15,15,33
49941,53,58431,53,193,102,91,2,30,1,1
49437,53,23949,53,199,102,97,2,30,1,1
51845,11201,33761,11201,316,136,180,6,6,3,3
51900,15755,25086,15755,316,136,180,6,6,3,3
65300,53,36602,53,758,102,656,2,30,1,1
44971,443,53632,443,6861,2809,4052,33,407,11,22
55021,443,3999,443,5987,1556,4431,19,47,12,7
26900,27017,2558,27017,422,164,258,6,30,3,3
49615,53,9854,53,276,94,182,2,30,1,1
46746,443,46746,443,4427,1520,2907,19,30,11,8
49971,443,5852,443,62,62,0,1,120,1,0
56109,53,22951,53,177,94,83,2,30,1,1
49392,53,35647,53,398,93,305,4,45,2,2
55675,53,52778,53,764,99,665,2,31,1,1
56297,53,44253,53,168,86,82,2,30,1,1
50601,53,58017,53,760,97,663,2,30,1,1
64072,80,14418,80,314,192,122,6,15,4,2
55826,53,27290,53,86,86,0,2,34,2,0
64862,53,23535,53,223,94,129,2,29,1,1
64967,53,44002,53,751,102,649,2,30,1,1
55676,28694,59367,28694,316,190,126,5,15,3,2
37965,30982,7359,30982,528,528,0,9,1199,9,0
58615,443,30095,443,6796,1541,5255,23,121,11,12
65206,53,46359,53,167,86,81,2,30,1,1
56125,53,44434,53,168,86,82,2,29,1,1
49218,53,22762,53,195,102,93,2,31,1,1
64321,53,14158,53,296,97,199,4,53,2,2
49259,53,28989,53,168,86,82,2,30,1,1
64894,53,8238,53,195,102,93,2,30,1,1
27988,40002,6353,40002,140,78,62,2,30,1,1
56925,53,7944,53,192,98,94,2,30,1,1
50840,80,15901,80,268155,6485,261670,281,25,97,184
6881,1564,62594,1564,324,150,174,2,1200,1,1
60611,443,2263,443,478331,21023,457308,573,211,201,372
60334,7080,60334,7080,2960,432,2528,11,15,6,5
26923,443,40541,443,7362,1770,5592,31,87,16,15
51824,443,65512,443,10841,6594,4247,75,585,37,38
49572,443,38388,443,11583,4967,6616,31,47,17,14
49897,80,15304,80,188,128,60,3,15,2,1
60596,53,45720,53,300,86,214,2,31,1,1
38405,80,54534,80,1114,534,580,12,16,7,5
19651,53,19651,53,216,90,126,2,30,1,1
52241,51717,19106,51717,70,70,0,1,4,1,0
50874,80,33456,80,331828,15003,316825,363,141,140,223
56163,53,47774,53,194,102,92,2,30,1,1
38330,123,58815,123,184,94,90,2,30,1,1
49845,53,59006,53,168,86,82,2,30,1,1
58366,53,25101,53,167,78,89,2,30,1,1
36405,53,36515,53,199,94,105,2,30,1,1
42263,443,45775,443,224,164,60,3,5,2,1
55792,53,55035,53,199,102,97,2,30,1,1
47087,15000,40073,15000,138,78,60,2,5,1,1
55147,53,48564,53,184,94,90,2,30,1,1
57443,443,31881,443,8287,2469,5818,31,18,14,17
65218,53,51807,53,186,95,91,2,30,1,1
47147,443,41911,443,5789,952,4837,19,150,10,9
49466,53,24088,53,209,110,99,2,30,1,1
58771,80,64938,80,2062,904,1158,10,258,6,4
40865,8100,38607,8100,234,234,0,4,11,4,0
64814,53,31747,53,565,215,350,6,37,3,3
56910,53,3209,53,199,102,97,2,30,1,1
55910,53,5285,53,182,93,89,2,30,1,1
56561,53,4933,53,167,86,81,2,30,1,1
56667,443,7226,443,8057,2037,6020,20,16,11,9
48470,80,20195,80,959,544,415,11,315,6,5
46859,15000,30674,15000,130,70,60,2,6,1,1
56541,443,9751,443,130,70,60,2,15,1,1
23984,53,23984,53,216,98,118,2,30,1,1
49247,53,6509,53,478,196,282,6,64,3,3
56126,53,21706,53,177,94,83,2,30,1,1
56361,53,14867,53,193,102,91,2,30,1,1
63733,47013,45780,47013,66,66,0,2,8,2,0
49861,443,11860,443,5995,974,5021,19,56,10,9
49104,80,61237,80,1638,1324,314,10,15,5,5
56221,53,42617,53,177,94,83,2,29,1,1
50524,53,52843,53,816,102,714,2,29,1,1
53424,443,24039,443,9953,1605,8348,35,18,19,16
54735,443,61550,443,12507,6114,6393,30,90,18,12
50722,80,43079,80,7550,5292,2258,13,29,7,6
64588,53,41773,53,173,94,79,2,31,1,1
65200,53,41473,53,214,110,104,2,29,1,1
49791,53,37520,53,412,90,322,4,34,2,2
52038,80,51825,80,70,70,0,1,5,1,0
42780,53,61676,53,198,93,105,2,30,1,1
64683,53,49305,53,821,102,719,2,29,1,1
50067,53,8496,53,177,94,83,2,30,1,1
56345,53,18764,53,199,94,105,2,30,1,1
55636,25569,50876,25569,320,140,180,6,6,3,3
53152,27367,49089,27367,758,320,438,11,20,6,5
64642,53,54204,53,751,94,657,2,30,1,1
58420,53,57046,53,351,78,273,2,29,1,1
55434,53,55434,53,198,90,108,2,30,1,1
55692,18319,26451,18319,320,140,180,6,7,3,3
57813,443,65376,443,6163,925,5238,18,109,10,8
60852,443,55582,443,7471,2914,4557,26,47,15,11
44847,22467,39791,22467,150,150,0,1,1200,1,0
37087,443,26551,443,9710,2136,7574,26,363,11,15
50584,16453,1503,16453,161,161,0,2,1200,2,0
55840,53,55617,53,177,94,83,2,30,1,1
50091,53,50600,53,164,86,78,2,30,1,1
55732,53,1656,53,194,102,92,2,30,1,1
49918,443,49171,443,10385,3107,7278,28,16,16,12
56697,443,50660,443,3593,2749,844,18,22,11,7
55480,53,36431,53,378,97,281,4,33,2,2
60894,443,14726,443,3507,900,2607,13,135,6,7
47400,80,1203,80,1052,612,440,10,15,5,5
56767,34578,60694,34578,564,318,246,9,16,5,4
64534,53,37006,53,214,110,104,2,30,1,1
49323,443,62942,443,9802,2846,6956,33,79,15,18
55729,53,3835,53,256,96,160,4,42,2,2
54385,53,14777,53,168,78,90,2,30,1,1
64380,53,9655,53,196,102,94,2,33,1,1
18796,443,17365,443,2227,1018,1209,17,15,8,9
64419,53,6330,53,210,102,108,2,30,1,1
53282,443,30859,443,1786,172,1614,7,119,3,4
37586,443,60764,443,19675,10416,9259,53,81,30,23
21447,53,34557,53,80280,68084,12196,889,90,816,73
50017,53,58091,53,195,102,93,2,31,1,1
48191,5223,34035,5223,4164,1264,2900,23,1140,13,10
64708,53,37304,53,437,89,348,4,48,2,2
64937,53,43310,53,183,94,89,2,29,1,1
34465,443,9083,443,1402,910,492,11,360,6,5
59829,443,18743,443,182,60,122,4,26,2,2
55577,53,20988,53,199,102,97,2,30,1,1
57807,443,57807,443,4434,1527,2907,19,29,11,8
15503,37512,24044,37512,528,528,0,9,1199,9,0
55484,443,11193,443,5039,2002,3037,14,120,7,7
61856,443,61856,443,4918,1626,3292,17,17,10,7
41781,443,5729,443,1820,1101,719,18,82,10,8
49418,27016,33402,27016,259,78,181,2,29,1,1
65477,53,57278,53,183,94,89,2,30,1,1
38649,443,32676,443,13463,5427,8036,24,121,11,13
65521,53,38042,53,167,86,81,2,29,1,1
52994,443,57845,443,10694,4129,6565,41,111,20,21
49752,53,1168,53,182,94,88,2,30,1,1
60369,443,26606,443,6052,1841,4211,21,82,10,11
52523,443,12913,443,4307,2005,2302,37,18,20,17
58701,27030,51697,27030,70,70,0,2,9,2,0
64462,53,6951,53,174,89,85,2,30,1,1
10151,53,10151,53,220,90,130,2,30,1,1
56892,53,32986,53,199,102,97,2,31,1,1
49644,80,17566,80,2950,601,2349,12,15,6,6
49369,53,17790,53,246,94,152,2,30,1,1
56631,80,27363,80,61771,2713,59058,80,45,35,45
64124,53,32205,53,236,86,150,2,30,1,1
49756,53,16127,53,396,94,302,4,41,2,2
55193,53,3630,53,533,102,431,4,42,2,2
50040,53,62872,53,322,102,220,2,30,1,1
65487,443,56960,443,413465,12290,401175,427,16,150,277
45439,443,28530,443,24785,17234,7551,68,421,36,32
55875,53,25979,53,296,110,186,2,30,1,1
55443,53,49327,53,188,96,92,2,30,1,1
55326,53,7571,53,177,94,83,2,30,1,1
27005,26259,57804,26259,889,126,763,2,31,1,1
53615,867,16773,867,70,70,0,2,7,2,0
49216,53,46478,53,316,91,225,4,32,2,2
49789,53,40494,53,177,94,83,2,30,1,1
51106,80,64772,80,14616,6227,8389,32,31,16,16
64097,443,12441,443,6372,1893,4479,15,120,8,7
50149,80,19755,80,78701,4331,74370,77,75,21,56
51418,443,34735,443,7653,1188,6465,21,17,12,9
43514,5223,35160,5223,3651,1103,2548,17,1802,10,7
64125,53,8672,53,198,101,97,2,31,1,1
49812,443,57189,443,6503,2037,4466,24,125,13,11
56673,53,13282,53,183,94,89,2,30,1,1
53217,443,21683,443,6058,1038,5020,20,66,11,9
53448,5223,10796,5223,134,60,74,3,4,2,1
56037,53,29985,53,168,94,74,2,31,1,1
58852,443,26155,443,3723,1793,1930,21,69,10,11
56824,443,13725,443,18356,13354,5002,47,34,29,18
40128,80,6000,80,2437,1277,1160,12,16,7,5
55159,53,29350,53,200,102,98,2,30,1,1
65047,53,39231,53,645,185,460,6,40,3,3
65128,443,26680,443,3055,1759,1296,22,126,12,10
49595,53,17154,53,176,90,86,2,30,1,1
56730,53,45534,53,210,110,100,2,30,1,1
64986,27049,14066,27049,1764,924,840,6,31,3,3
56802,53,9464,53,753,93,660,2,31,1,1
50500,80,1291,80,318,192,126,6,25,4,2
51081,443,32211,443,6653,3225,3428,18,135,9,9
52148,443,33858,443,375357,11451,363906,356,61,100,256
64959,53,63198,53,245,102,143,2,31,1,1
61158,443,55712,443,12854,2237,10617,47,638,19,28
51687,80,38806,80,1517,481,1036,11,15,6,5
42615,443,10393,443,117381,60398,56983,518,4126,256,262
50265,34311,31562,34311,480,149,331,2,1200,1,1
64266,53,43619,53,168,86,82,2,30,1,1
49676,53,26255,53,216,110,106,2,30,1,1
60597,53,0,0,344,94,250,2,30,1,1
34787,443,34308,443,13074,2439,10635,46,279,22,24
55962,53,37019,53,193,102,91,2,30,1,1
51711,1027,5156,1027,70,70,0,1,5,1,0
40662,443,40662,443,4624,1717,2907,19,28,11,8
65057,53,5504,53,199,102,97,2,30,1,1
46525,5228,57899,5228,1410,933,477,11,3601,6,5
49160,51413,36529,51413,800,150,650,4,1200,2,2
60944,443,6650,443,59999,8737,51262,95,18,43,52
49499,443,1804,443,5541,2623,2918,28,144,15,13
56889,53,27625,53,206,105,101,2,31,1,1
50392,8080,50392,8080,8962,4731,4231,26,75,14,12
52206,59077,23195,59077,316,136,180,6,9,3,3
65212,53,45804,53,196,102,94,2,30,1,1
55655,53,43785,53,754,94,660,2,31,1,1
39796,443,27327,443,7425,2276,5149,24,16,12,12
37090,443,37090,443,4637,1730,2907,19,30,11,8
49418,27019,50504,27019,71,71,0,1,30,1,0
42408,443,51647,443,13108,2630,10478,26,120,12,14
56067,53,59693,53,294,102,192,2,30,1,1
43222,443,24936,443,2088188,38201,2049987,1829,84,404,1425
56522,53,55041,53,177,94,83,2,30,1,1
56644,443,53305,443,3079,1895,1184,18,16,10,8
56356,53,61835,53,184,102,82,2,30,1,1
58418,443,64364,443,15305,3334,11971,45,198,21,24
57309,443,42080,443,134,60,74,3,6,2,1
55275,53,25486,53,213,94,119,2,30,1,1
55454,53,25468,53,209,110,99,2,30,1,1
57352,53,35059,53,816,102,714,2,30,1,1
64098,10096,39565,10096,66,66,0,2,8,2,0
56802,443,7219,443,8072,2052,6020,20,15,11,9
49162,53,61794,53,371,94,277,2,29,1,1
57331,53,27996,53,164,86,78,2,30,1,1
10151,1042,12380,1042,490,149,341,2,1200,1,1
49836,53,59050,53,327,102,225,2,30,1,1
26900,27017,35787,27017,422,164,258,6,29,3,3
51173,443,28678,443,13341,4805,8536,88,378,42,46
52146,80,22638,80,1868,1374,494,12,16,7,5
64614,443,5122,443,5505,3166,2339,22,136,11,11
64048,44918,64560,44918,66,66,0,2,8,2,0
49656,443,50043,443,11810,2769,9041,29,47,15,14
48204,443,48204,443,4743,1836,2907,19,26,11,8
52247,443,52247,443,948720,23674,925046,988,26,349,639
52093,80,7625,80,3019,716,2303,12,23,7,5
33569,443,7892,443,7418,1880,5538,28,396,9,19
28885,53,28885,53,404,259,145,3,32,2,1
57125,53,40271,53,745,93,652,2,30,1,1
65168,53,7392,53,185,102,83,2,31,1,1
52179,14354,22942,14354,70,70,0,1,5,1,0
27005,30008,41191,30008,881,126,755,2,31,1,1
60517,53,31898,53,198,86,112,2,30,1,1
27450,443,32260,443,10099,1635,8464,31,83,14,17
43108,443,11094,443,3117,1867,1250,19,16,9,10
59955,80,59955,80,16324,808,15516,25,59,11,14
54340,443,13340,443,3176,752,2424,10,121,5,5
52210,15604,53868,15604,70,70,0,2,8,2,0
34741,53,34741,53,414,268,146,3,33,2,1
16224,443,3120,443,7525,1098,6427,22,16,12,10
10077,443,21308,443,10940,4625,6315,36,347,19,17
7447,53,7447,53,244,98,146,2,32,1,1
51804,53,51804,53,247,98,149,2,33,1,1
56379,53,59317,53,166,86,80,2,30,1,1
50996,443,60752,443,12654,1719,10935,28,21,15,13
65390,53,64921,53,387,134,253,2,30,1,1
58879,443,43164,443,10439,1785,8654,25,85,10,15
64837,53,35241,53,195,102,93,2,31,1,1
59517,443,5605,443,6285,1545,4740,22,17,12,10
56628,80,40916,80,1359,435,924,13,30,7,6
64538,53,57273,53,194,102,92,2,30,1,1
37335,443,52361,443,4734755,152171,4582584,5334,405,2083,3251
50584,63015,51175,63015,166,166,0,1,1200,1,0
49495,443,44088,443,9037,3596,5441,36,321,19,17
51555,443,44960,443,876,390,486,12,39,4,8
50744,443,51827,443,6811,1923,4888,21,15,11,10
33818,53,62977,53,168,78,90,2,30,1,1
54525,443,38089,443,3766,1654,2112,10,120,5,5
36767,53,36767,53,237,93,144,2,31,1,1
33967,5222,10318,5222,74654,9673,64981,221,616,106,115
23317,443,22656,443,2227,1018,1209,17,15,8,9
35671,443,43722,443,6824,1142,5682,24,134,13,11
56226,53,12248,53,284,96,188,4,33,2,2
65316,53,39745,53,225,110,115,2,30,1,1
55633,53,26791,53,793,101,692,2,31,1,1
65514,53,17473,53,177,94,83,2,29,1,1
46211,443,37976,443,190,70,120,4,16,2,2
6580,443,39397,443,2227,1018,1209,17,16,8,9
33242,443,38172,443,14244,2907,11337,33,17,17,16
41432,53,63040,53,202,83,119,2,30,1,1
27005,1308,46544,1308,855,126,729,2,30,1,1
49372,53,58789,53,216,110,106,2,30,1,1
64021,53,21293,53,190,97,93,2,30,1,1
27005,30005,45159,30005,890,126,764,2,31,1,1
52046,59791,37077,59791,70,70,0,2,7,2,0
65094,53,59382,53,630,204,426,6,64,3,3
54286,123,33034,123,184,94,90,2,30,1,1
64287,53,20763,53,178,91,87,2,31,1,1
56000,53,49191,53,177,94,83,2,30,1,1
53350,443,63189,443,2950,679,2271,13,120,6,7
59016,443,23931,443,12676,4222,8454,36,87,20,16
60886,443,34294,443,3855,2679,1176,28,45,15,13
64842,443,46917,443,5467,2738,2729,23,137,11,12
64618,53,21647,53,198,102,96,2,30,1,1
56275,53,54180,53,177,94,83,2,30,1,1
55533,53,54545,53,183,94,89,2,29,1,1
63971,42759,55186,42759,504,382,122,8,15,6,2
64454,53,61289,53,293,110,183,2,29,1,1
54372,80,17871,80,3517,1612,1905,17,186,10,7
54346,443,30268,443,12594,5098,7496,32,36,17,15
55727,53,47747,53,701,88,613,2,31,1,1
1039,53,1039,53,644,90,554,2,30,1,1
49657,80,55424,80,1278,774,504,12,361,7,5
49835,53,6905,53,817,102,715,2,30,1,1
49764,53,50844,53,199,102,97,2,30,1,1
46728,443,17105,443,7087,746,6341,16,15,9,7
51740,35988,5363,35988,136,136,0,3,14,3,0
56326,53,62646,53,177,94,83,2,30,1,1
36788,80,9413,80,235873,12126,223747,306,31,154,152
54664,443,62017,443,175780,7700,168080,196,36,78,118
61363,80,43167,80,1931,752,1179,15,16,8,7
50709,80,20258,80,708,384,324,12,195,7,5
48757,80,48757,80,560,264,296,9,44,5,4
65206,53,9006,53,762,98,664,2,30,1,1
65155,53,21805,53,295,103,192,4,48,2,2
64224,443,1301,443,24320,6711,17609,45,122,20,25
55340,53,32896,53,184,94,90,2,31,1,1
51412,443,35247,443,200230,8733,191497,250,122,106,144
56414,53,33736,53,178,94,84,2,31,1,1
56515,443,56741,443,5083,969,4114,18,32,10,8
48443,53,3585,53,168,78,90,2,30,1,1
36403,443,54491,443,1149,709,440,13,39,8,5
50584,6889,59579,6889,161,161,0,2,1200,2,0
57211,53,8547,53,258,110,148,2,30,1,1
26900,27017,50644,27017,422,164,258,6,30,3,3
55796,53,36094,53,196,102,94,2,30,1,1
56336,53,15481,53,489,88,401,4,46,2,2
64884,53,3518,53,195,102,93,2,30,1,1
56773,80,16432,80,1462,703,759,8,16,5,3
49650,80,5839,80,318,192,126,6,41,4,2
55317,53,59583,53,244,94,150,2,31,1,1
49362,443,33824,443,9551,6129,3422,35,47,19,16
62915,993,36226,993,8257,4187,4070,70,43,42,28
55332,53,16316,53,206,105,101,2,31,1,1
49994,53,33575,53,86,86,0,1,29,1,0
49501,53,63385,53,193,102,91,2,31,1,1
65481,53,28484,53,168,86,82,2,31,1,1
65291,53,60855,53,335,97,238,4,31,2,2
47694,443,24366,443,23751,3197,20554,42,170,19,23
51620,443,24957,443,3330,2281,1049,17,16,9,8
51820,53738,52497,53738,70,70,0,1,5,1,0
49502,80,22198,80,2300864,53111,2247753,2242,18,755,1487
33107,443,39338,443,35031,3490,31541,60,363,28,32
64541,53,6698,53,363,94,269,2,30,1,1
61289,53,61289,53,197,76,121,2,30,1,1
49351,443,50580,443,11389,1184,10205,22,76,9,13
49763,443,47715,443,12767,8343,4424,31,122,17,14
61046,443,61046,443,5830,2583,3247,22,40,13,9
39228,53,7632,53,199,94,105,2,30,1,1
65067,53,22984,53,327,102,225,2,30,1,1
44095,443,27127,443,6109,3363,2746,60,615,33,27
43701,3389,43701,3389,3910,1805,2105,20,19,12,8
13257,53,13257,53,227,88,139,2,31,1,1
49210,33757,53103,33757,70,70,0,2,8,2,0
56893,53,21610,53,177,94,83,2,30,1,1
64732,53,52596,53,189,102,87,2,30,1,1
51762,12747,44025,12747,70,70,0,2,8,2,0
6881,6882,46322,6882,324,150,174,2,1200,1,1
65043,53,7870,53,213,94,119,2,29,1,1
19473,6889,17971,6889,481,150,331,2,1200,1,1
64712,53,32713,53,210,102,108,2,30,1,1
64567,443,24686,443,24984,2042,22942,41,32,19,22
33197,443,9055,443,1067,650,417,10,27,6,4
58058,80,25761,80,318,192,126,6,21,4,2
56603,443,20013,443,7890,1901,5989,20,16,11,9
56519,53,63557,53,166,85,81,2,31,1,1
50982,443,30343,443,8227,3496,4731,20,82,11,9
57385,80,37415,80,2546,1294,1252,17,138,9,8
55930,443,56260,443,6271,1354,4917,25,113,14,11
58610,443,32629,443,6345,1545,4800,23,18,12,11
50584,48493,7175,48493,161,161,0,1,1200,1,0
41741,443,53387,443,5379,1424,3955,19,507,11,8
55620,53,36114,53,178,94,84,2,31,1,1
56817,48650,23825,48650,130,70,60,2,5,1,1
59714,3389,59714,3389,4134,2109,2025,18,17,9,9
11295,40032,25935,40032,148,86,62,2,30,1,1
53918,443,16862,443,499,425,74,4,0,3,1
52599,53,38138,53,338,94,244,2,29,1,1
50608,443,5976,443,5039,2265,2774,21,30,11,10
45334,443,8591,443,8798,1667,7131,25,22,14,11
44182,443,55726,443,8241,1810,6431,25,20,14,11
49418,27015,12957,27015,271,78,193,2,31,1,1
49665,53,12263,53,194,99,95,2,30,1,1
50588,443,8589,443,2460,1267,1193,16,98,9,7
54054,443,10549,443,34629391,1109219,33520172,36863,278,12240,24623
56576,443,12093,443,6971,1510,5461,21,80,11,10
60318,123,6592,123,184,94,90,2,30,1,1
6881,51413,35496,51413,475,150,325,2,1200,1,1
40216,443,24772,443,10196,2175,8021,25,186,14,11
53781,36366,2063,36366,70,70,0,1,5,1,0
57470,26247,60262,26247,1320,1320,0,21,1624,21,0
49392,80,13895,80,156587,46628,109959,307,314,203,104
34657,443,31367,443,448,78,370,6,25,1,5
52478,443,31557,443,7985,2085,5900,18,121,8,10
52220,65128,43562,65128,70,70,0,2,8,2,0
53818,15337,26034,15337,164,70,94,2,4,1,1
50641,443,27533,443,1473,890,583,13,140,7,6
51443,443,10966,443,1048,1048,0,9,16,9,0
55564,53,50276,53,775,103,672,2,30,1,1
5530,80,5530,80,514,246,268,9,91,5,4
57298,53,55060,53,323,110,213,2,30,1,1
55699,53,21219,53,211,102,109,2,29,1,1
9439,443,40829,443,6092,775,5317,17,25,9,8
56396,53,37010,53,183,94,89,2,30,1,1
58478,53,13215,53,332,102,230,2,29,1,1
55071,53,28115,53,711,87,624,2,30,1,1
37234,443,63563,443,1622,1137,485,11,26,7,4
35078,443,8054,443,234,234,0,4,12,4,0
49791,443,8451,443,6057,767,5290,16,126,8,8
50584,26301,47178,26301,161,161,0,2,1199,2,0
54677,5228,25400,5228,6679,2730,3949,43,4309,23,20
37035,443,37035,443,4510,1603,2907,19,28,11,8
56816,443,16188,443,7956,1967,5989,20,15,11,9
56322,53,21211,53,166,86,80,2,29,1,1
62711,443,43946,443,266781,12334,254447,323,161,119,204
54271,80,5783,80,6006,861,5145,18,19,10,8
60412,12965,9031,12965,70,70,0,1,5,1,0
50601,80,50601,80,4206,3273,933,17,19,9,8
63963,53,46328,53,262,86,176,4,46,2,2
55957,53,34097,53,178,94,84,2,30,1,1
62952,443,20995,443,1304,612,692,18,120,9,9
54989,80,38298,80,8159037,271621,7887416,9644,214,4424,5220
51150,53,51368,53,167,78,89,2,30,1,1
50241,53,25762,53,728,102,626,2,30,1,1
33245,443,3684,443,7279,2884,4395,28,16,16,12
20953,53,20953,53,295,90,205,2,30,1,1
63059,53,39205,53,304,86,218,2,30,1,1
54842,443,49660,443,5860,1151,4709,18,283,10,8
43920,443,54926,443,12666,4180,8486,37,504,20,17
64344,53,46040,53,286,102,184,4,45,2,2
54710,443,54710,443,32709,8467,24242,54,20,29,25
60305,80,11406,80,4419,3852,567,15,144,8,7
55707,53,54526,53,811,94,717,2,30,1,1
1485,53,1485,53,194,87,107,2,30,1,1
65404,53,13922,53,256,94,162,2,30,1,1
34746,443,4348,443,284320,14149,270171,398,244,203,195
56520,53,9113,53,177,94,83,2,29,1,1
59014,443,31435,443,27298,11122,16176,59,31,30,29
42611,443,22505,443,5559,1639,3920,21,186,12,9
53618,1025,19237,1025,320,140,180,6,7,3,3
44695,443,65027,443,4419,3179,1240,17,17,10,7
49747,443,22101,443,7087,1705,5382,19,128,10,9
58322,53,41674,53,352,78,274,2,30,1,1
55305,53,52264,53,1448,103,1345,4,54,2,2
48817,6884,48817,6884,328,152,176,2,1200,1,1
50022,80,11593,80,10023148,180272,9842876,9438,193,2907,6531
52210,80,30096,80,372,246,126,6,30,4,2
50263,53,23939,53,172,94,78,2,30,1,1
64976,53,35202,53,229,102,127,2,30,1,1
54966,53,23127,53,170,87,83,3,32,2,1
39068,443,31079,443,10831,1381,9450,22,20,12,10
43206,443,34471,443,4550611,95139,4455472,4046,217,935,3111
58822,443,40826,443,3594,1787,1807,31,163,17,14
49253,53,44015,53,199,102,97,2,30,1,1
49850,53,46784,53,166,86,80,2,30,1,1
51173,443,13645,443,13772,1738,12034,26,31,12,14
53733,40599,48603,40599,70,70,0,1,4,1,0
64768,80,26612,80,18045,3544,14501,28,156,12,16
55992,53,33542,53,194,94,100,2,30,1,1
64223,53,57211,53,199,94,105,2,30,1,1
50574,80,15293,80,61763,2941,58822,75,135,33,42
51500,443,12798,443,49843,3506,46337,77,16,39,38
52087,52766,15525,52766,136,136,0,3,14,3,0
37382,80,11429,80,1221,781,440,11,16,6,5
49475,53,30283,53,819,102,717,2,30,1,1
65356,53,60802,53,197,94,103,2,31,1,1
64904,53,43718,53,199,102,97,2,30,1,1
62624,443,17860,443,6990,2057,4933,19,121,9,10
53719,443,54352,443,3225,1939,1286,26,139,14,12
56932,53,43209,53,172,94,78,2,29,1,1
51800,443,3294,443,36048,2364,33684,54,28,23,31
65294,53,7465,53,184,102,82,2,30,1,1
39268,443,60773,443,7691,1999,5692,35,256,18,17
52769,443,2032,443,8083,1790,6293,27,150,14,13
48203,80,21963,80,946,531,415,11,315,6,5
49600,53,23356,53,243,94,149,2,30,1,1
56626,80,44276,80,234,234,0,4,12,4,0
60060,22,60060,22,7974,3469,4505,57,40,28,29
56553,53,14002,53,198,101,97,2,30,1,1
26900,27017,6136,27017,422,164,258,6,30,3,3
56751,80,54705,80,1462,703,759,8,16,5,3
59609,443,2759,443,7762,1777,5985,22,80,13,9
46734,53,46734,53,314,98,216,2,29,1,1
49931,53,2557,53,195,102,93,2,30,1,1
64458,53,4904,53,292,102,190,2,30,1,1
52998,443,34422,443,57778,2562,55216,73,200,29,44
43513,443,9885,443,224,164,60,3,5,2,1
55752,53,44697,53,200,102,98,2,30,1,1
56769,53,26341,53,195,102,93,2,30,1,1
49668,80,43673,80,318,192,126,6,41,4,2
56553,53,46585,53,199,102,97,2,30,1,1
63749,13219,47890,13219,504,382,122,8,15,6,2
49672,443,34216,443,10080,2728,7352,28,188,14,14
53270,443,54512,443,12757,4360,8397,41,17,23,18
49545,443,43829,443,6606,936,5670,17,23,9,8
49321,53,46028,53,184,94,90,2,30,1,1
55748,443,39721,443,21446,1599,19847,35,154,16,19
51654,80,46130,80,318,192,126,6,37,4,2
50237,53,53638,53,183,94,89,2,31,1,1
34901,443,15952,443,70,70,0,1,5,1,0
65462,53,18628,53,98,98,0,1,30,1,0
37965,33738,46824,33738,1548,265,1283,4,1200,2,2
34285,53,45642,53,168,78,90,2,30,1,1
44521,443,14957,443,6502,1347,5155,31,1195,10,21
56107,53,24230,53,194,102,92,2,30,1,1
57619,443,40662,443,9315,2153,7162,23,127,6,17
22345,80,22345,80,490,264,226,8,30,5,3
49492,53,44432,53,199,102,97,2,30,1,1
58871,443,24562,443,405189,13572,391617,446,89,155,291
50365,443,19679,443,712,374,338,11,28,6,5
49486,53,40876,53,177,94,83,2,31,1,1
26900,27017,55723,27017,20322,11404,8918,118,133,67,51
56111,53,45505,53,179,94,85,2,30,1,1
55774,8060,21425,8060,70,70,0,1,5,1,0
60824,53,60824,53,220,90,130,2,30,1,1
55989,53,34510,53,301,80,221,2,31,1,1
27005,27015,32114,27015,1634,126,1508,4,31,2,2
50288,53,30921,53,764,102,662,2,30,1,1
49568,53,17593,53,214,102,112,2,30,1,1
14434,443,32675,443,2556,1470,1086,17,16,8,9
34147,53,34147,53,227,106,121,2,30,1,1
8430,53,21349,53,80361,77433,2928,946,89,930,16
54352,53,16730,53,578,286,292,9,16,5,4
51779,49525,24742,49525,70,70,0,2,8,2,0
52225,31985,22878,31985,70,70,0,2,8,2,0
56652,80,44398,80,9012,4718,4294,43,81,21,22
55232,53,8300,53,177,94,83,2,30,1,1
56134,53,62024,53,183,94,89,2,31,1,1
55326,53,39375,53,177,94,83,2,29,1,1
56615,443,6112,443,22938,14436,8502,43,41,23,20
50857,3389,50857,3389,3613,1594,2019,19,18,10,9
49418,27017,43664,27017,259,71,188,2,31,1,1
49534,53,33345,53,186,95,91,2,31,1,1
64426,53,6048,53,289,101,188,4,50,2,2
51763,34121,10888,34121,70,70,0,2,8,2,0
33876,53,33876,53,404,259,145,3,32,2,1
51046,443,28730,443,17469,2444,15025,39,207,17,22
51733,30688,48958,30688,70,70,0,2,8,2,0
64810,53,23866,53,199,102,97,2,29,1,1
56333,53,40833,53,209,110,99,2,30,1,1
55371,53,41494,53,168,86,82,2,30,1,1
49217,53,45409,53,282,93,189,4,45,2,2
57629,80,39284,80,1115,534,581,12,16,7,5
64067,53,26067,53,331,102,229,2,30,1,1
62929,443,8515,443,46033,7524,38509,103,141,49,54
35405,53,35405,53,217,87,130,2,30,1,1
59607,443,14075,443,2150,1280,870,18,832,10,8
56727,53,4531,53,250,86,164,4,46,2,2
47643,80,39174,80,3524,2698,826,14,16,8,6
53813,39832,19071,39832,320,140,180,6,5,3,3
52169,59681,50827,59681,70,70,0,2,8,2,0
54126,443,11328,443,147104,9481,137623,217,115,111,106
51964,1103,26830,1103,70,70,0,1,4,1,0
51097,80,51452,80,3374,1914,1460,33,131,18,15
64614,53,55438,53,168,86,82,2,30,1,1
27005,27015,19502,27015,880,126,754,2,30,1,1
49418,27056,31810,27056,269,78,191,2,30,1,1
56574,53,9941,53,275,94,181,2,30,1,1
56120,53,36940,53,212,102,110,2,30,1,1
26900,27017,32451,27017,422,164,258,6,30,3,3
51829,46209,24768,46209,66,66,0,1,5,1,0
54995,443,42324,443,13281,4753,8528,32,17,18,14
51832,443,21428,443,2831,740,2091,11,120,5,6
59343,80,59343,80,32527,13068,19459,56,15,21,35
51729,63553,13105,63553,70,70,0,2,8,2,0
51961,40373,19759,40373,70,70,0,2,8,2,0
51451,443,12053,443,6957,1775,5182,22,17,12,10
50309,53,29176,53,193,102,91,2,29,1,1
50564,443,64623,443,1894028,31411,1862617,1579,122,209,1370
59836,443,35828,443,1394,733,661,14,80,8,6
56704,53,43778,53,194,102,92,2,29,1,1
64075,1026,24378,1026,70,70,0,1,4,1,0
38211,443,38211,443,4653,1746,2907,19,26,11,8
49860,53,63227,53,184,102,82,2,30,1,1
64051,53,30405,53,1114,468,646,12,67,6,6
36575,443,29496,443,412,140,272,7,25,3,4
51576,443,13071,443,9753,2821,6932,39,201,22,17
38474,443,30004,443,53562,2314,51248,64,31,24,40
40656,443,51290,443,10293,1331,8962,22,255,12,10
58727,443,14813,443,26922,13251,13671,50,18,26,24
50655,80,4984,80,91198,3990,87208,113,19,49,64
52092,443,18467,443,13078,7055,6023,114,162,59,55
26900,27017,46103,27017,422,164,258,6,30,3,3
51295,443,51295,443,4334,1427,2907,19,27,11,8
50535,80,27169,80,36985,3992,32993,56,151,25,31
63056,443,24879,443,304,86,218,2,30,1,1
46478,443,23649,443,493,280,213,8,97,5,3
56364,443,28728,443,10427,6311,4116,33,234,20,13
43654,443,39718,443,8761,2571,6190,24,17,14,10
56615,53,58132,53,170,87,83,2,30,1,1
27005,27019,23362,27019,873,126,747,2,31,1,1
56775,53,62594,53,200,94,106,2,29,1,1
56622,53,54285,53,214,110,104,2,30,1,1
36445,443,44215,443,234,234,0,4,12,4,0
36067,443,36067,443,228681,29484,199197,303,110,149,154
65428,443,7165,443,14203,1525,12678,13,143,2,11
55520,53,58665,53,194,102,92,2,29,1,1
14641,443,14641,443,254281,66535,187746,336,317,183,153
37757,53,12221,53,86,86,0,1,30,1,0
45939,5228,13443,5228,7528,1416,6112,29,811,11,18
50864,80,3838,80,1888,1814,74,10,15,9,1
36368,80,58408,80,78,78,0,1,5,1,0
60893,443,5461,443,46690,9390,37300,77,54,36,41
27005,27016,9043,27016,881,126,755,2,30,1,1
50265,45682,46008,45682,402,132,270,6,1209,3,3
50239,53,31652,53,183,94,89,2,31,1,1
65114,53,27541,53,196,102,94,2,31,1,1
33200,443,11701,443,67123,10708,56415,100,124,41,59
52872,443,5601,443,110507,3940,106567,129,118,37,92
2359,443,2359,443,8209,1695,6514,21,23,13,8
49870,443,21099,443,6062,1042,5020,20,55,11,9
49230,53,1845,53,168,86,82,2,31,1,1
56849,23745,4233,23745,70,70,0,2,8,2,0
36276,7000,36276,7000,3638,2027,1611,17,15,9,8
50375,443,20024,443,4707,865,3842,17,30,9,8
45067,443,54041,443,7794,2844,4950,26,29,16,10
53584,62974,57251,62974,70,70,0,1,5,1,0
52035,36498,46508,36498,70,70,0,2,9,2,0
49291,53,21649,53,771,102,669,2,30,1,1
42384,443,16298,443,8561,2300,6261,37,316,18,19
56498,443,11650,443,1343,763,580,14,26,8,6
38602,443,28302,443,130,70,60,3,5,2,1
9823,53,9823,53,244,98,146,2,32,1,1
49263,53,43703,53,178,94,84,2,30,1,1
27005,27017,40940,27017,600,126,474,2,31,1,1
45184,5228,38008,5228,9107,2358,6749,24,3600,13,11
55629,53,44695,53,168,86,82,2,31,1,1
50928,80,36754,80,875,518,357,10,75,6,4
55635,53,13643,53,177,94,83,2,30,1,1
33043,443,21466,443,11414,6355,5059,30,40,15,15
53761,123,54980,123,184,94,90,2,30,1,1
49332,53,35822,53,276,118,158,2,30,1,1
49378,53,33691,53,179,86,93,2,30,1,1
49973,53,28904,53,747,93,654,2,30,1,1
55605,53,8091,53,190,97,93,2,31,1,1
53013,80,53013,80,258732,4788,253944,268,25,71,197
56665,80,42041,80,234,234,0,4,12,4,0
56388,443,34459,443,70,70,0,1,5,1,0
53470,53,29709,53,168,78,90,2,30,1,1
55176,53,57165,53,195,102,93,2,30,1,1
49472,53,37751,53,210,110,100,2,30,1,1
50378,53,11083,53,199,102,97,2,29,1,1
56779,53,5601,53,173,94,79,2,30,1,1
55818,53,21143,53,775,103,672,2,31,1,1
52572,80,52572,80,1899,1310,589,12,48,6,6
57470,27232,13855,27232,4212,2724,1488,57,2411,33,24
9189,443,50417,443,4941,429,4512,12,15,6,6
49609,53,20657,53,177,94,83,2,29,1,1
49786,443,10389,443,8941,1816,7125,27,15,15,12
64123,53,16597,53,325,102,223,2,30,1,1
55633,54638,31495,54638,504,318,186,8,15,5,3
52951,443,13326,443,628801,19603,609198,708,114,227,481
64277,53,1694,53,337,110,227,2,30,1,1
55262,53,22053,53,193,102,91,2,30,1,1
56723,443,2144,443,7889,1900,5989,20,15,11,9
56717,53,57782,53,183,94,89,2,29,1,1
60701,443,27691,443,5166,1989,3177,15,122,7,8
64018,53,10598,53,229,94,135,2,30,1,1
50103,53,21620,53,168,86,82,2,30,1,1
27005,27015,12555,27015,887,126,761,2,30,1,1
55866,53,45530,53,732,89,643,2,30,1,1
35459,443,42175,443,2350,1392,958,17,275,9,8
52076,28895,42169,28895,70,70,0,2,8,2,0
64964,53,20852,53,194,99,95,2,31,1,1
33845,443,64577,443,6495,1547,4948,19,318,10,9
64638,53,33072,53,215,102,113,2,29,1,1
53925,61701,1063,61701,70,70,0,1,4,1,0
7595,80,7595,80,34707,1796,32911,45,45,20,25
56091,53,32743,53,738,86,652,2,31,1,1
49331,53,37708,53,182,94,88,2,30,1,1
56927,53,19352,53,182,93,89,2,31,1,1
52930,443,20378,443,5584,1390,4194,19,15,9,10
49712,53,3465,53,178,94,84,2,30,1,1
52182,53,34693,53,199,94,105,2,30,1,1
65482,443,27020,443,6762,3351,3411,31,160,14,17
60661,53,54714,53,278,102,176,2,31,1,1
58800,443,5645,443,3874,2470,1404,17,15,9,8
49168,443,13690,443,519325,13798,505527,535,18,193,342
58924,443,13598,443,7783,2690,5093,24,255,13,11
30188,14432,60719,14432,868,150,718,4,1200,2,2
63631,443,40886,443,8640,5157,3483,17,120,10,7
56888,443,32016,443,15807,12220,3587,44,242,18,26
49320,53,42245,53,331,90,241,4,38,2,2
52189,443,26207,443,4688,3009,1679,33,80,17,16
53982,24226,55007,24226,70,70,0,1,4,1,0
32787,80,54491,80,1412,848,564,14,316,8,6
49502,53,5291,53,193,102,91,2,30,1,1
65532,53,33764,53,196,102,94,2,30,1,1
56362,53,49455,53,195,102,93,2,30,1,1
47594,443,65055,443,5447,1074,4373,21,17,10,11
55662,53,51499,53,753,93,660,2,31,1,1
50021,80,33696,80,10026538,185017,9841521,9515,195,2989,6526
42805,443,52110,443,130,70,60,2,15,1,1
53524,45395,27489,45395,70,70,0,1,5,1,0
65066,80,65066,80,874843,22526,852317,878,44,304,574
52803,443,59403,443,4913,751,4162,18,28,8,10
49455,53,42395,53,1750,184,1566,6,85,3,3
63092,443,8576,443,4771341,155341,4616000,5024,147,1667,3357
46640,9002,46640,9002,124,60,64,2,5,1,1
64171,53,17588,53,179,94,85,2,30,1,1
57052,53,26525,53,177,94,83,2,30,1,1
58070,443,16488,443,5041,2002,3039,14,120,7,7
54458,443,1235,443,3885,2355,1530,26,270,13,13
52110,35411,30183,35411,66,66,0,1,5,1,0
56873,53,11452,53,184,94,90,2,29,1,1
55609,39869,60499,39869,70,70,0,1,5,1,0
59832,443,5609,443,302,120,182,6,28,3,3
54160,443,65221,443,9464,1751,7713,29,48,13,16
50528,80,29242,80,1658,1247,411,8,16,5,3
60499,51413,63354,51413,70,70,0,1,5,1,0
49348,53,21322,53,749,94,655,2,30,1,1
64755,53,11546,53,339,134,205,2,30,1,1
57310,443,42139,443,134,60,74,3,6,2,1
55585,48063,18600,48063,70,70,0,1,5,1,0
50605,443,19181,443,13409,3033,10376,29,124,15,14
35292,8100,45355,8100,78,78,0,1,4,1,0
53795,443,29582,443,499,425,74,4,0,3,1
49913,53,50642,53,216,110,106,2,31,1,1
42298,40015,12335,40015,140,78,62,2,31,1,1
64819,53,53319,53,198,94,104,2,30,1,1
64770,53,63194,53,93,93,0,1,31,1,0
33812,443,2950,443,16120,8754,7366,36,327,21,15
52329,53,12571,53,294,86,208,2,30,1,1
55857,53,49437,53,196,102,94,2,30,1,1
55206,53,49621,53,196,94,102,2,30,1,1
59994,53,59994,53,86,86,0,1,29,1,0
56606,53,17065,53,762,97,665,2,31,1,1
58831,443,5275,443,8004,2236,5768,41,18,23,18
41472,53,41472,53,218,90,128,2,30,1,1
65114,53,15041,53,196,102,94,2,29,1,1
49676,53,19443,53,216,110,106,2,30,1,1
49537,53,41171,53,686,276,410,8,74,4,4
49558,53,30601,53,184,94,90,2,30,1,1
56548,53,6954,53,198,101,97,2,31,1,1
56174,443,33268,443,1310,649,661,13,185,7,6
63952,53,42119,53,358,105,253,4,44,2,2
53714,6882,37422,6882,70,70,0,2,7,2,0
57300,53,58923,53,184,94,90,2,31,1,1
55354,53,28658,53,168,94,74,2,30,1,1
55776,53,26753,53,271,93,178,4,30,2,2
49194,443,5495,443,605037,246018,359019,1735,1300,846,889
50973,80,57219,80,314164,13077,301087,356,25,144,212
64385,443,4632,443,3677,1168,2509,17,120,8,9
47674,53,47674,53,200,90,110,2,30,1,1
57202,443,8164,443,1728,1153,575,12,28,7,5
53232,443,53232,443,1270,697,573,15,33,8,7
65319,53,47160,53,285,103,182,4,44,2,2
36939,80,43312,80,5733,3036,2697,25,235,9,16
28036,443,58065,443,5780,4574,1206,20,16,11,9
55958,53,40832,53,177,94,83,2,30,1,1
27988,40005,9616,40005,148,86,62,2,30,1,1
56695,53,57441,53,776,102,674,2,30,1,1
55000,53,31472,53,193,102,91,2,29,1,1
51414,443,57873,443,8292,2164,6128,31,120,17,14
56997,53,62280,53,86,86,0,1,30,1,0
60948,53,22265,53,168,78,90,2,30,1,1
52335,443,49316,443,5670,2739,2931,18,129,9,9
58846,443,58496,443,7680,4905,2775,24,17,12,12
59533,443,28553,443,448,78,370,6,24,1,5
51648,80,37574,80,974005,25912,948093,1003,32,361,642
59801,443,35070,443,5678,2820,2858,25,141,11,14
53706,443,53579,443,499,425,74,4,0,3,1
49903,443,11070,443,355761,14847,340914,423,33,183,240
40804,8434,40804,8434,156,156,0,3,8,3,0
43732,443,8555,443,19123,2319,16804,39,28,21,18
55234,53,5157,53,177,94,83,2,29,1,1
55660,53,37547,53,757,98,659,2,30,1,1
50204,80,48586,80,1221,781,440,11,14,6,5
49469,443,43348,443,8779,3672,5107,17,119,8,9
57270,443,35956,443,9415,3482,5933,57,16,29,28
55643,53,52326,53,183,94,89,2,29,1,1
60900,53,31593,53,181,86,95,2,30,1,1
56500,53,34519,53,198,101,97,2,31,1,1
42642,443,22756,443,10548,2689,7859,38,24,19,19
56592,53,24895,53,200,102,98,2,30,1,1
56700,443,13069,443,8059,2039,6020,20,16,11,9
57372,443,37935,443,4612,700,3912,12,15,8,4
36277,443,45497,443,14212,8194,6018,38,104,21,17
52178,30922,40190,30922,70,70,0,2,7,2,0
49935,443,48016,443,366,180,186,7,28,4,3
32299,40019,4671,40019,148,86,62,2,30,1,1
63763,17368,13988,17368,66,66,0,2,8,2,0
56889,53,34055,53,170,87,83,2,31,1,1
56935,53,51699,53,821,102,719,2,30,1,1
49621,53,22875,53,182,93,89,2,31,1,1
52246,443,52246,443,1615,941,674,15,21,7,8
51961,443,54912,443,2600,1396,1204,18,48,10,8
43326,443,43455,443,8065,2689,5376,27,315,14,13
56353,53,32385,53,216,102,114,2,29,1,1
63991,53,25716,53,193,102,91,2,31,1,1
65379,53,2143,53,126,126,0,1,29,1,0
65304,53,22589,53,308,97,211,4,33,2,2
63854,16437,39591,16437,66,66,0,2,7,2,0
37683,53,37683,53,240,98,142,2,30,1,1
55447,53,15473,53,1449,108,1341,4,33,2,2
49794,53,1835,53,197,102,95,2,30,1,1
50066,443,28197,443,7144,2505,4639,14,120,7,7
65491,53,6276,53,889,404,485,10,30,5,5
50031,53,15521,53,181,94,87,2,30,1,1
34495,80,62171,80,1026,417,609,7,19,5,2
49185,53,26156,53,307,94,213,2,29,1,1
59402,53,5852,53,203,86,117,2,30,1,1
55199,53,62068,53,152,78,74,2,30,1,1
31214,53,31214,53,216,90,126,2,30,1,1
64925,53,10435,53,338,110,228,2,30,1,1
54886,443,54886,443,136775,6729,130046,181,18,82,99
55545,53,31002,53,177,94,83,2,30,1,1
63952,53,14655,53,211,110,101,2,30,1,1
36191,443,31290,443,9386,1934,7452,32,135,17,15
39472,443,61496,443,9767,2138,7629,22,16,12,10
56772,61424,62775,61424,66,66,0,1,5,1,0
49654,53,26382,53,184,94,90,2,30,1,1
49224,53,4375,53,199,102,97,2,32,1,1
57486,80,57486,80,1248,535,713,10,20,5,5
55963,443,55963,443,8882,1866,7016,24,148,13,11
39108,443,16198,443,330651,13398,317253,404,115,179,225
49475,7000,49475,7000,3546,2043,1503,16,15,9,7
49762,443,52270,443,7479,2226,5253,29,151,15,14
55628,53,53766,53,199,94,105,2,30,1,1
64693,53,28781,53,248,102,146,2,30,1,1
49421,53,15245,53,744,89,655,2,31,1,1
27260,443,46156,443,4329,2374,1955,23,520,8,15
63076,443,41788,443,7975,423,7552,15,119,6,9
60470,443,16410,443,7289,1899,5390,29,317,16,13
63994,47013,15711,47013,70,70,0,1,4,1,0
43604,53,41746,53,168,78,90,2,30,1,1
56846,26665,43590,26665,70,70,0,1,5,1,0
50228,53,44907,53,173,94,79,2,30,1,1
51518,443,15866,443,38155,33545,4610,79,26,42,37
49438,443,63285,443,18773,1492,17281,38,94,11,27
57643,80,14145,80,172,172,0,2,5,2,0
42190,53,42190,53,639,86,553,2,31,1,1
55156,53,44381,53,194,102,92,2,30,1,1
65187,53,40747,53,345,101,244,4,53,2,2
59944,80,51806,80,1186,390,796,9,16,5,4
57204,53,25182,53,190,97,93,2,30,1,1
52474,123,6683,123,184,94,90,2,30,1,1
54017,443,16478,443,33220,3819,29401,77,255,39,38
52200,42430,15926,42430,66,66,0,2,10,2,0
41335,53,41335,53,825,99,726,2,30,1,1
65024,53,6765,53,199,102,97,2,30,1,1
50727,443,38985,443,26161,3618,22543,80,119,31,49
53820,7488,54828,7488,70,70,0,1,4,1,0
50672,80,6037,80,1718,1247,471,9,14,5,4
11835,53,11835,53,216,88,128,2,31,1,1
3470,53,3470,53,217,82,135,2,32,1,1
65469,53,60792,53,327,110,217,2,30,1,1
60814,443,60814,443,1386,751,635,15,181,8,7
51835,443,19929,443,48635,5346,43289,83,151,38,45
60402,47094,53695,47094,320,140,180,6,7,3,3
55688,53,48185,53,183,94,89,2,31,1,1
36287,443,35494,443,6419,2962,3457,25,148,12,13
51776,8000,6250,8000,328,142,186,6,90,3,3
64516,443,9177,443,2649258,1156086,1493172,7283,5215,3384,3899
42354,443,60503,443,4181,998,3183,14,27,7,7
58077,36653,2343,36653,204,64,140,4,10,2,2
56770,53,41386,53,212,110,102,2,30,1,1
55356,53,43051,53,756,95,661,2,31,1,1
53892,443,40316,443,9312,4088,5224,23,76,13,10
56262,53,24636,53,177,94,83,2,30,1,1
56629,53,37533,53,177,94,83,2,30,1,1
61566,53,28325,53,86,86,0,1,30,1,0
56704,443,41939,443,8125,2039,6086,21,15,11,10
59276,443,40586,443,16232,3319,12913,23,125,9,14
50584,56209,14402,56209,166,166,0,1,1200,1,0
45937,53,13210,53,241,78,163,2,30,1,1
51467,443,7148,443,20313,6637,13676,45,24,23,22
49950,80,54747,80,3991,620,3371,14,15,7,7
49368,443,28033,443,5224,1560,3664,15,165,9,6
51667,25826,12114,25826,9434,9434,0,11,30,11,0
51412,53,4036,53,252,78,174,2,30,1,1
55265,53,65356,53,199,102,97,2,30,1,1
56550,123,27975,123,184,94,90,2,30,1,1
50229,80,35977,80,1743,979,764,13,81,7,6
54367,443,60704,443,5892088,193411,5698677,6287,213,2098,4189
54957,80,50979,80,416,210,206,7,15,4,3
55969,53,43128,53,731,91,640,2,31,1,1
56835,53,60962,53,177,94,83,2,29,1,1
65277,53,17756,53,819,102,717,2,31,1,1
64992,53,64992,53,180,82,98,2,30,1,1
64399,53,50659,53,230,110,120,2,29,1,1
60074,443,12733,443,3465,818,2647,11,122,5,6
48556,80,48556,80,19225,817,18408,29,15,13,16
41233,443,15671,443,1807,1048,759,16,26,8,8
45402,80,27119,80,573,499,74,6,15,5,1
54553,53,43102,53,101,101,0,2,31,2,0
56249,443,29498,443,80340,72269,8071,106,122,65,41
53705,443,25596,443,1579,988,591,13,44,7,6
56349,53,17487,53,216,110,106,2,31,1,1
50584,19051,19819,19051,300,300,0,3,1200,3,0
53304,80,56632,80,130,64,66,3,4,2,1
50686,443,65474,443,6586,1807,4779,23,360,12,11
55858,53,14376,53,214,102,112,2,30,1,1
51551,53,57627,53,304,86,218,2,30,1,1
58720,443,50201,443,32598,22046,10552,83,60,49,34
56631,53,31631,53,199,94,105,2,30,1,1
16225,443,41335,443,13126,5105,8021,37,31,21,16
64793,80,12166,80,508,256,252,9,77,5,4
63951,53,30484,53,193,102,91,2,30,1,1
59181,53,28620,53,260,86,174,2,29,1,1
56332,53,17265,53,193,102,91,2,30,1,1
52093,40828,32567,40828,258,70,188,4,8,2,2
51988,32239,6773,32239,70,70,0,2,8,2,0
65504,443,39358,443,92275,4799,87476,107,16,43,64
55312,53,35283,53,438,180,258,6,30,3,3
53019,443,6559,443,30012,3461,26551,72,93,28,44
56912,53,8353,53,199,102,97,2,30,1,1
57435,53,43686,53,184,102,82,2,30,1,1
46908,80,46908,80,5464,713,4751,15,16,8,7
31630,53,31630,53,220,90,130,2,30,1,1
33028,80,50046,80,130,70,60,2,15,1,1
55142,443,55142,443,4480,555,3925,11,20,6,5
33042,443,32323,443,130,70,60,2,14,1,1
53591,443,53591,443,1468,763,705,16,181,8,8
56536,443,5996,443,210110,14803,195307,246,105,103,143
64208,53,37921,53,194,94,100,2,29,1,1
50403,53,9932,53,749,94,655,2,30,1,1
56115,53,38646,53,278,96,182,4,54,2,2
51976,80,64058,80,366,240,126,7,25,5,2
9916,53,9916,53,235,90,145,2,33,1,1
64926,53,0,0,371,77,294,2,30,1,1
55288,53,4599,53,196,102,94,2,30,1,1
59399,443,48462,443,66108,6145,59963,93,16,41,52
52361,443,27364,443,7488,2474,5014,23,3600,12,11
50079,443,34341,443,7274,2208,5066,26,255,14,12
50716,80,11421,80,1106,326,780,12,140,6,6
56241,80,56241,80,101607,1692,99915,94,15,24,70
42947,53,42947,53,260,106,154,2,33,1,1
44466,443,54385,443,466,392,74,4,0,3,1
49732,443,33979,443,4414,993,3421,14,25,6,8
49737,53,34228,53,184,86,98,2,31,1,1
47495,443,53611,443,490,210,280,8,28,4,4
56288,53,56709,53,182,93,89,2,31,1,1
55286,53,58993,53,194,102,92,2,29,1,1
32971,443,64078,443,12597,6029,6568,36,267,15,21
57332,53,48938,53,168,86,82,2,30,1,1
49217,52769,38751,52769,2189,1143,1046,10,16,6,4
48817,29614,48817,29614,506,152,354,2,1201,1,1
50007,53,39028,53,216,110,106,2,30,1,1
53810,443,43179,443,499,425,74,4,0,3,1
55268,53,37193,53,186,95,91,2,31,1,1
45342,443,2921,443,2378,1382,996,20,21,11,9
54148,443,30287,443,272587,11910,260677,336,76,140,196
56495,80,7502,80,32396,2695,29701,46,135,22,24
56525,443,51595,443,14108,2487,11621,32,81,18,14
49418,27053,45679,27053,78,78,0,1,30,1,0
49690,53,35001,53,216,110,106,2,30,1,1
59980,443,52666,443,345468,18536,326932,432,22,200,232
50216,443,60442,443,6320,1382,4938,24,167,13,11
64690,53,18350,53,338,110,228,2,30,1,1
49893,443,34865,443,7115,1670,5445,24,35,13,11
60378,11385,17333,11385,1218,774,444,17,26,10,7
39611,443,2531,443,78,78,0,1,5,1,0
65229,53,24708,53,195,102,93,2,30,1,1
60394,80,52231,80,2047,701,1346,16,26,5,11
55498,53,3379,53,340,134,206,2,30,1,1
46567,443,52746,443,6407,984,5423,21,360,11,10
51890,80,53517,80,7097,3553,3544,15,31,8,7
57417,443,11340,443,43052,2466,40586,64,18,21,43
58173,993,62958,993,430,60,370,7,24,2,5
26961,443,26961,443,1251,722,529,11,147,6,5
50382,80,4705,80,1369,799,570,13,77,7,6
49384,53,28172,53,181,94,87,2,29,1,1
45499,443,58024,443,17031,8260,8771,39,128,19,20
42298,40022,65114,40022,148,86,62,2,30,1,1
60245,80,28831,80,14705,6415,8290,26,149,12,14
50116,22,50116,22,152,66,86,2,10,1,1
52002,34348,46608,34348,66,66,0,1,5,1,0
53772,53,7783,53,70,70,0,1,30,1,0
35666,443,50206,443,3389452,85022,3304430,3290,159,997,2293
56376,53,49970,53,198,102,96,2,31,1,1
62110,443,43597,443,10390,3051,7339,16,121,6,10
42151,53,3505,53,168,78,90,2,30,1,1
49428,53,34747,53,267,94,173,2,31,1,1
65480,443,49360,443,310863,9840,301023,323,16,115,208
64658,53,30936,53,785,110,675,2,30,1,1
57172,53,27478,53,196,102,94,2,31,1,1
55629,36190,12886,36190,504,318,186,8,16,5,3
56857,53,39377,53,195,102,93,2,30,1,1
63526,3389,63526,3389,4365,2581,1784,20,33,11,9
55060,53,16844,53,195,102,93,2,30,1,1
10151,55149,20876,55149,481,150,331,2,1200,1,1
56561,53,2642,53,216,110,106,2,31,1,1
57837,443,41125,443,17236,1691,15545,19,146,5,14
52128,443,43146,443,16113,2152,13961,35,20,18,17
57054,80,1820,80,25138,16043,9095,79,2410,53,26
52739,443,43890,443,25048,2850,22198,45,26,23,22
57422,53,42352,53,198,102,96,2,30,1,1
57083,53,25967,53,196,100,96,2,31,1,1
49383,53,44225,53,94,94,0,1,30,1,0
43024,53,45972,53,198,93,105,2,30,1,1
56009,53,38515,53,178,94,84,2,30,1,1
56272,53,7235,53,193,102,91,2,30,1,1
55245,53,15511,53,193,102,91,2,30,1,1
63743,46081,6085,46081,70,70,0,1,4,1,0
60217,443,8028,443,6075,3806,2269,18,120,10,8
63786,50091,30767,50091,66,66,0,2,7,2,0
53626,443,63196,443,10520,3200,7320,29,38,16,13
51497,443,14907,443,8939,3462,5477,25,263,12,13
21018,53,21018,53,235,90,145,2,31,1,1
49849,53,33985,53,173,94,79,2,31,1,1
53248,443,27776,443,41125,3625,37500,62,323,25,37
63957,53,44993,53,214,94,120,2,29,1,1
64756,53,21500,53,195,102,93,2,30,1,1
63853,443,40585,443,3182,1568,1614,8,120,4,4
56273,53,37875,53,330,126,204,2,30,1,1
63031,443,4313,443,304,86,218,2,29,1,1
26791,443,23053,443,21391,16334,5057,38,20,21,17
53829,53,12567,53,258,86,172,2,31,1,1
56982,80,63526,80,214,140,74,4,35,3,1
39932,80,45032,80,3472,2124,1348,14,21,8,6
27005,27015,27978,27015,888,126,762,2,31,1,1
45657,443,4313,443,2553,1355,1198,22,77,13,9
45775,443,19122,443,8706,1430,7276,23,316,9,14
65096,443,53521,443,2414,639,1775,9,121,5,4
54020,53,54020,53,233,90,143,2,32,1,1
58851,443,62485,443,15848,13507,2341,37,32,19,18
65472,443,58915,443,460338,13340,446998,472,16,165,307
55560,53,43077,53,166,86,80,2,30,1,1
61151,443,65420,443,121129,5559,115570,157,640,51,106
48238,443,41856,443,2227,1018,1209,17,15,8,9
42298,40018,41162,40018,629,83,546,4,31,2,2
43546,443,49269,443,5948,1664,4284,21,247,12,9
52824,443,27899,443,4114,2920,1194,19,80,11,8
64489,53,32733,53,215,102,113,2,30,1,1
28064,53,28064,53,233,90,143,2,32,1,1
63708,29685,60492,29685,66,66,0,1,5,1,0
49809,53,6008,53,386,134,252,2,30,1,1
65526,53,37729,53,199,102,97,2,30,1,1
52101,64162,42746,64162,1200,576,624,8,31,4,4
59717,443,16330,443,303966,26201,277765,521,167,208,313
55021,53,50748,53,179,94,85,2,30,1,1
53141,8595,63363,8595,70,70,0,2,8,2,0
56455,53,58599,53,183,94,89,2,30,1,1
57281,443,25432,443,212477,8324,204153,232,122,79,153
45001,443,55898,443,570,318,252,10,20,6,4
60247,443,21929,443,12256,5443,6813,33,437,18,15
53236,443,53236,443,1210,637,573,14,34,7,7
60749,40010,57224,40010,316,136,180,6,5,3,3
59755,53,7532,53,211,78,133,2,30,1,1
51372,80,40252,80,882,527,355,10,255,6,4
54999,443,63007,443,6430,1513,4917,26,40,14,12
52134,443,44449,443,473832,22822,451010,464,109,139,325
59627,443,59627,443,4401,1494,2907,19,29,11,8
49534,53,11716,53,193,102,91,2,31,1,1
10570,53,10570,53,215,80,135,2,32,1,1
56506,53,39583,53,807,94,713,2,30,1,1
44228,443,22389,443,2754856,125760,2629096,3115,32,1340,1775
51579,443,8189,443,1522,1210,312,9,28,4,5
56431,53,59476,53,177,94,83,2,30,1,1
27005,27016,12661,27016,879,126,753,2,30,1,1
48305,443,59833,443,572565,17274,555291,546,147,124,422
2547,53,2547,53,194,87,107,2,30,1,1
49662,53,17327,53,268,93,175,4,57,2,2
50550,443,16736,443,4551,2140,2411,14,135,6,8
65377,53,44573,53,193,102,91,2,31,1,1
60384,53,44713,53,234,96,138,2,31,1,1
56518,53,9053,53,170,87,83,2,30,1,1
56659,443,54837,443,8058,2038,6020,20,15,11,9
49342,53,10156,53,443,182,261,6,30,3,3
55936,53,60791,53,177,94,83,2,30,1,1
57912,53,13801,53,295,77,218,2,30,1,1
49224,443,16302,443,93540,22718,70822,155,918,65,90
55033,443,57495,443,19846,10062,9784,42,47,22,20
56020,53,55046,53,168,86,82,2,30,1,1
52131,443,17836,443,6565,1251,5314,27,31,14,13
53766,3596,6099,3596,70,70,0,1,4,1,0
41314,80,2894,80,1723,438,1285,10,136,6,4
49624,443,56067,443,6440,1965,4475,22,36,12,10
52148,29104,12286,29104,70,70,0,2,8,2,0
48625,443,33941,443,29988,20891,9097,170,598,95,75
64816,53,1997,53,164,84,80,2,31,1,1
51406,443,38367,443,8186,2146,6040,29,33,16,13
51821,443,38521,443,3002,258,2744,9,119,4,5
49657,443,29231,443,9039,2175,6864,32,20,17,15
27005,49000,39068,49000,887,126,761,2,30,1,1
54056,443,63986,443,8340,3417,4923,20,75,11,9
65497,53,19517,53,490,111,379,4,54,2,2
36765,443,20693,443,27557,20627,6930,89,5581,44,45
58273,53,40385,53,202,86,116,2,30,1,1
51311,22,51311,22,5624,2099,3525,30,23,17,13
65104,53,46686,53,311,94,217,2,30,1,1
60449,28260,32141,28260,70,70,0,1,5,1,0
55695,53,64745,53,177,94,83,2,29,1,1
55551,53,54639,53,788,108,680,2,30,1,1
59486,80,62432,80,2633,1151,1482,10,32,6,4
65001,53,27011,53,200,78,122,2,30,1,1
55706,53,42379,53,209,110,99,2,30,1,1
27114,53,27114,53,414,268,146,3,33,2,1
52782,443,35099,443,1581,924,657,15,125,7,8
53668,80,20063,80,1173,665,508,13,16,7,6
57342,443,57537,443,10761,5724,5037,43,15,25,18
50089,443,20398,443,292,172,120,4,15,2,2
53888,39204,51033,39204,70,70,0,1,5,1,0
49285,53,46992,53,94,94,0,1,30,1,0
65352,443,3902,443,12690,1918,10772,39,195,19,20
63941,53,9002,53,228,94,134,2,30,1,1
56518,53,42205,53,177,94,83,2,29,1,1
41868,443,44888,443,6204,1328,4876,21,139,12,9
64723,53,23544,53,677,198,479,6,68,3,3
40306,443,40306,443,4520,1613,2907,19,26,11,8
55152,53,31927,53,177,94,83,2,30,1,1
57157,53,8214,53,165,86,79,2,30,1,1
64552,53,41507,53,754,94,660,2,30,1,1
65256,53,29045,53,357,105,252,4,57,2,2
42522,80,42522,80,29727,1571,28156,44,16,21,23
49862,53,25145,53,176,90,86,2,30,1,1
50471,53,24459,53,168,78,90,2,30,1,1
49680,80,4197,80,1548,847,701,10,16,5,5
49280,80,50074,80,200808,6612,194196,217,3669,83,134
57289,443,13366,443,2693,1361,1332,17,19,10,7
51157,443,53397,443,2791,1800,991,26,186,15,11
17129,53,49932,53,225,78,147,2,31,1,1
60174,80,16526,80,1564,990,574,15,24,8,7
64071,53,30972,53,188,96,92,2,31,1,1
55023,53,43972,53,216,102,114,2,30,1,1
57470,6881,22501,6881,353,166,187,2,1199,1,1
57536,53,46039,53,199,94,105,2,30,1,1
34788,443,32056,443,8230,2275,5955,18,135,8,10
54084,443,63980,443,37440,7952,29488,67,128,28,39
50595,80,62524,80,2049,1065,984,15,78,8,7
57396,443,25332,443,9318,3350,5968,31,140,14,17
39748,80,44062,80,1638,1324,314,10,15,5,5
56935,80,54520,80,1482,878,604,10,75,6,4
52249,443,52249,443,152755,7304,145451,171,21,65,106
60822,443,31127,443,4435,2482,1953,10,121,6,4
49318,53,58973,53,718,94,624,2,30,1,1
42657,443,20758,443,10204,2106,8098,37,255,19,18
53183,443,26366,443,6094,1073,5021,19,15,10,9
65373,53,10645,53,197,102,95,2,29,1,1
51729,63553,6792,63553,70,70,0,1,5,1,0
65530,53,42402,53,194,102,92,2,30,1,1
49734,80,8310,80,88983,2379,86604,92,129,30,62
64934,53,46124,53,194,99,95,2,31,1,1
56183,53,22164,53,179,94,85,2,30,1,1
56071,53,13568,53,193,102,91,2,30,1,1
57317,443,9547,443,5614,733,4881,16,15,9,7
49537,53,25046,53,269,96,173,4,59,2,2
38681,443,38681,443,3028,1828,1200,19,21,11,8
37999,443,54290,443,1650,815,835,17,186,9,8
40814,53,40814,53,213,87,126,2,31,1,1
64959,53,35711,53,173,94,79,2,30,1,1
56809,53,64424,53,172,88,84,2,31,1,1
44675,53,44675,53,197,76,121,2,30,1,1
56492,53,6474,53,184,94,90,2,30,1,1
63799,13835,56478,13835,66,66,0,1,5,1,0
56341,53,11727,53,243,94,149,2,30,1,1
65018,53,21026,53,168,94,74,2,31,1,1
49258,80,49258,80,17197,1551,15646,29,27,13,16
41630,15000,14960,15000,130,70,60,2,5,1,1
65085,53,47896,53,196,94,102,2,30,1,1
51387,443,34318,443,5795,3322,2473,22,93,13,9
65381,80,14160,80,1630,982,648,13,78,7,6
49830,443,24513,443,8471,2343,6128,30,240,15,15
48906,53,48906,53,217,87,130,2,30,1,1
49526,443,23120,443,6032,1049,4983,18,26,9,9
38910,53,21140,53,198,93,105,2,31,1,1
53178,42671,48767,42671,70,70,0,2,8,2,0
57067,53,26997,53,178,94,84,2,30,1,1
63080,443,52084,443,304,86,218,2,30,1,1
49778,53,5798,53,319,98,221,4,53,2,2
60816,443,60816,443,1320,685,635,14,182,7,7
52183,13503,58173,13503,70,70,0,1,5,1,0
53264,443,22628,443,7424,1825,5599,25,18,13,12
50318,80,21534,80,3855,828,3027,11,15,5,6
50428,80,50756,80,312,192,120,6,27,4,2
27005,27017,61483,27017,878,126,752,2,30,1,1
65261,53,11148,53,313,97,216,4,56,2,2
45886,80,22615,80,6959,2024,4935,14,148,8,6
59045,53,10960,53,231,110,121,2,30,1,1
60802,40010,3447,40010,316,136,180,6,6,3,3
53899,443,57181,443,499,425,74,4,0,3,1
27005,27016,26608,27016,880,126,754,2,30,1,1
34312,80,11906,80,874,500,374,10,14,6,4
51791,56116,24331,56116,70,70,0,1,5,1,0
53757,443,15611,443,499,425,74,4,0,3,1
0,0,0,0,244,244,0,2,0,2,0
37544,443,15194,443,23647,9422,14225,52,40,28,24
65045,53,47072,53,755,94,661,2,30,1,1
64055,53,52345,53,181,94,87,2,29,1,1
7686,80,7686,80,176670,11287,165383,216,46,96,120
64371,53,21841,53,181,86,95,2,30,1,1
6881,6883,20913,6883,259,150,109,2,1200,1,1
56617,80,63909,80,234,234,0,4,12,4,0
54672,443,56107,443,2285,1130,1155,25,120,12,13
58885,15000,9072,15000,138,78,60,2,5,1,1
55735,53,59032,53,256,93,163,2,30,1,1
65328,53,29572,53,182,102,80,2,31,1,1
56149,53,56149,53,832,106,726,2,30,1,1
50675,80,44462,80,1658,1247,411,8,15,5,3
56639,53,41760,53,168,86,82,2,30,1,1
56985,53,45052,53,711,87,624,2,31,1,1
57312,53,43620,53,208,106,102,2,30,1,1
64814,16386,26637,16386,432,192,240,8,30,4,4
49646,443,41538,443,5647,1832,3815,16,36,9,7
50388,443,13080,443,6734,4301,2433,21,29,12,9
49407,53,49407,53,247,98,149,2,32,1,1
57333,53,36710,53,167,86,81,2,31,1,1
56226,53,33247,53,200,102,98,2,30,1,1
37093,53,37093,53,645,90,555,2,29,1,1
52910,53,52910,53,414,268,146,3,32,2,1
56970,443,7987,443,6815,3817,2998,23,143,11,12
54969,53,41747,53,199,102,97,2,29,1,1
49706,53,42213,53,296,102,194,4,41,2,2
63137,47117,19060,47117,574,448,126,10,25,8,2
53727,8999,52156,8999,320,140,180,6,5,3,3
56332,53,33283,53,199,102,97,2,29,1,1
51503,443,56151,443,887,635,252,7,23,3,4
53004,443,34423,443,18064,5135,12929,108,95,44,64
51115,80,32483,80,1426,930,496,10,22,7,3
54329,443,26217,443,5850,1617,4233,28,127,13,15
51939,53,4042,53,222,94,128,2,30,1,1
53789,443,10563,443,499,425,74,4,0,3,1
56847,53,25632,53,225,86,139,2,30,1,1
51650,80,36691,80,141348,4210,137138,161,17,58,103
56543,443,22323,443,1323,616,707,18,120,9,9
57331,53,57928,53,178,94,84,2,29,1,1
57996,53,57996,53,265,114,151,2,30,1,1
53704,443,40944,443,5743,1339,4404,18,180,8,10
59630,443,48650,443,3304,1468,1836,18,139,10,8
56326,80,40390,80,2541,689,1852,13,60,8,5
49157,443,64620,443,2529,1230,1299,17,16,9,8
65487,53,62444,53,184,94,90,2,30,1,1
51692,25565,11654,25565,66,66,0,1,5,1,0
53715,443,45128,443,70,70,0,2,8,2,0
49418,27035,7817,27035,250,78,172,2,31,1,1
49160,13917,61966,13917,150,150,0,1,1201,1,0
65506,53,16583,53,197,102,95,2,30,1,1
39342,80,30469,80,1638,1324,314,10,16,5,5
49838,53,8093,53,182,93,89,2,31,1,1
53728,19442,57763,19442,320,140,180,6,7,3,3
42155,443,26461,443,70,70,0,1,5,1,0
51749,1408,51950,1408,70,70,0,1,5,1,0
64802,80,15134,80,2424,529,1895,11,75,6,5
63916,56318,63492,56318,70,70,0,1,4,1,0
57142,53,15103,53,165,86,79,2,30,1,1
28509,80,28509,80,10145,1446,8699,23,29,11,12
58045,80,55044,80,62067,24127,37940,79,34,33,46
37965,33149,27231,33149,3957,2324,1633,51,1732,29,22
63960,53,45995,53,178,94,84,2,30,1,1
56674,53,8365,53,183,94,89,2,30,1,1
56998,53,31320,53,177,94,83,2,30,1,1
9166,53,9166,53,244,98,146,2,32,1,1
49563,80,12092,80,318,192,126,6,45,4,2
65362,80,32536,80,1347,771,576,11,86,7,4
53704,15000,2505,15000,70,70,0,2,7,2,0
61340,443,7462,443,31549,6352,25197,64,206,26,38
56243,80,56243,80,101477,1626,99851,93,15,23,70
57075,53,9642,53,199,94,105,2,30,1,1
61406,443,11878,443,12588,4915,7673,28,94,15,13
49760,80,49760,80,613303,16858,596445,666,143,251,415
123,123,44210,123,184,94,90,2,30,1,1
62894,993,44411,993,8840,4151,4689,80,190,41,39
57347,443,57555,443,1081375,19607,1061768,921,122,142,779
49939,53,35576,53,229,102,127,2,30,1,1
41876,80,9169,80,1740,708,1032,19,396,6,13
60230,443,4763,443,1868,1229,639,18,151,11,7
52426,443,20298,443,8760,1218,7542,25,15,14,11
55122,53,24716,53,173,94,79,2,30,1,1
64988,27052,9710,27052,735,462,273,2,31,1,1
56184,53,63317,53,215,94,121,2,30,1,1
51651,80,41220,80,8100,4781,3319,23,166,12,11
64573,53,34650,53,184,94,90,2,30,1,1
64495,443,32988,443,1786,172,1614,7,120,3,4
57155,53,11661,53,396,102,294,2,30,1,1
52783,443,32956,443,1581,924,657,15,125,7,8
64655,53,25772,53,225,102,123,2,30,1,1
51098,80,4123,80,3378,1918,1460,33,131,18,15
56934,53,21277,53,216,110,106,2,31,1,1
54054,5228,24551,5228,8767,2486,6281,45,6062,24,21
58771,443,23708,443,5167,700,4467,16,15,7,9
49283,6881,34041,6881,803,617,186,6,16,3,3
57287,53,47799,53,305,102,203,2,29,1,1
57028,8080,10225,8080,78,78,0,2,8,2,0
50012,53,43824,53,94,94,0,1,30,1,0
52024,47600,3124,47600,70,70,0,1,4,1,0
38848,80,21726,80,288702,9850,278852,312,105,123,189
48817,6881,48817,6881,490,149,341,2,1200,1,1
49418,27015,41865,27015,242,71,171,2,31,1,1
58113,3389,58113,3389,4245,2461,1784,18,33,9,9
56765,53,52447,53,194,102,92,2,30,1,1
56914,53,24598,53,821,102,719,2,30,1,1
49320,443,28886,443,2371,1839,532,14,45,8,6
52763,53,0,0,296,87,209,2,30,1,1
60782,20010,25511,20010,70,70,0,1,5,1,0
50321,443,43498,443,8156,1586,6570,24,82,11,13
50542,53,19780,53,762,98,664,2,30,1,1
44313,53,51644,53,199,94,105,2,30,1,1
45755,443,42960,443,1625,1038,587,14,26,8,6
64169,53,31527,53,209,110,99,2,30,1,1
57936,443,57936,443,18738,1904,16834,33,17,17,16
51797,80,9284,80,1929,796,1133,21,135,11,10
34357,443,9724,443,33131,26333,6798,49,121,28,21
52931,443,64191,443,416,210,206,7,26,4,3
42289,443,63031,443,6827,1776,5051,26,121,13,13
56324,53,52043,53,177,94,83,2,30,1,1
37616,443,4256,443,18611,3046,15565,41,362,20,21
55938,53,31705,53,209,110,99,2,30,1,1
64865,53,49871,53,305,97,208,4,53,2,2
49418,27016,1873,27016,281,78,203,2,31,1,1
63313,443,9713,443,1786,172,1614,7,120,3,4
52837,443,26069,443,843201,50940,792261,1191,159,451,740
59032,53,50252,53,295,86,209,2,30,1,1
57265,53,26246,53,762,98,664,2,30,1,1
52286,995,52286,995,146,82,64,2,5,1,1
9230,443,20303,443,6020,792,5228,18,25,9,9
55407,53,58404,53,195,94,101,2,30,1,1
42298,40017,13967,40017,148,86,62,2,30,1,1
54772,443,51519,443,3388,894,2494,19,154,8,11
50034,53,15680,53,179,94,85,2,30,1,1
38802,53,38802,53,216,90,126,2,30,1,1
49924,80,4925,80,1126,609,517,11,15,6,5
64999,53,5804,53,178,94,84,2,29,1,1
56281,53,56281,53,851,114,737,2,30,1,1
50584,25935,2865,25935,1377,300,1077,6,1200,3,3
56433,80,35239,80,17188,1559,15629,25,25,10,15
60408,55557,44331,55557,70,70,0,2,8,2,0
56312,53,62143,53,711,87,624,2,30,1,1
55134,53,55976,53,214,110,104,2,31,1,1
65520,443,22541,443,438102,12780,425322,449,15,157,292
56765,53,52854,53,711,87,624,2,30,1,1
38599,443,40890,443,3605,1648,1957,20,255,10,10
55411,53,25352,53,183,94,89,2,30,1,1
36983,80,52569,80,130,70,60,2,15,1,1
37621,80,10654,80,350,210,140,6,15,4,2
56738,443,56738,443,48740,2961,45779,73,46,33,40
54994,53,3788,53,209,110,99,2,30,1,1
64472,53,45709,53,183,94,89,2,30,1,1
0,0,0,0,480,244,236,4,0,2,2
53977,22266,9645,22266,492,306,186,8,17,5,3
5588,5588,0,0,3354,1792,1562,46,192,23,23
51221,51413,15223,51413,460,150,310,2,1200,1,1
49552,53,34956,53,194,102,92,2,30,1,1
51822,80,12401,80,3709,1390,2319,17,19,10,7
63887,80,15748,80,314,192,122,6,15,4,2
45545,53,45545,53,178,82,96,2,30,1,1
45339,443,35795,443,2312,1382,930,19,34,11,8
60293,53,33499,53,312,78,234,2,30,1,1
49888,443,29885,443,117085,3435,113650,123,87,43,80
52151,80,38473,80,546,300,246,10,32,6,4
45493,5223,26430,5223,4196,1378,2818,21,3002,12,9
60241,443,3002,443,92975,3289,89686,107,316,40,67
59204,443,10417,443,9335,3052,6283,25,125,11,14
65040,53,62726,53,176,90,86,2,31,1,1
53884,48754,22273,48754,70,70,0,1,4,1,0
42298,40013,38063,40013,209,87,122,4,29,2,2
56137,53,37448,53,199,102,97,2,30,1,1
60488,27615,36232,27615,70,70,0,2,8,2,0
60992,443,15020,443,3465,2532,933,20,47,12,8
40909,443,25631,443,1062,724,338,16,41,11,5
23997,53,23997,53,230,90,140,2,30,1,1
55605,53,12415,53,300,88,212,4,51,2,2
52217,80,27362,80,1074,565,509,11,16,6,5
52122,443,45457,443,5841,1986,3855,19,15,11,8
34995,443,34995,443,1542,489,1053,8,20,5,3
54124,80,4965,80,1594,1280,314,10,15,5,5
56744,443,27482,443,8008,1988,6020,20,15,11,9
49480,53,38554,53,428,96,332,4,52,2,2
59776,443,24367,443,966,480,486,17,29,9,8
57126,53,6801,53,183,94,89,2,31,1,1
48308,443,61860,443,4654,2499,2155,17,31,9,8
55373,53,29623,53,164,86,78,2,30,1,1
32805,80,38439,80,7450,2372,5078,26,24,15,11
56213,53,25430,53,168,78,90,2,30,1,1
52325,443,52325,443,17806,3169,14637,41,86,18,23
65219,443,28202,443,4748,2193,2555,14,135,7,7
57729,443,45932,443,12689,5742,6947,26,43,14,12
9151,443,63028,443,6128,763,5365,17,29,9,8
56415,443,20835,443,6032,1722,4310,22,117,13,9
64517,53,18639,53,194,102,92,2,31,1,1
5232,46495,40739,46495,832,832,0,14,96,14,0
28021,443,4074,443,5578,1390,4188,19,16,9,10
48542,80,42394,80,811,671,140,6,32,4,2
49162,53,39735,53,183,94,89,2,29,1,1
56307,53,55446,53,185,102,83,2,31,1,1
49619,80,12609,80,318,192,126,6,42,4,2
53717,443,51020,443,499,425,74,4,0,3,1
53531,48908,42269,48908,70,70,0,1,4,1,0
53437,443,53437,443,4198,2498,1700,25,102,12,13
57354,53,64428,53,198,94,104,2,29,1,1
54898,443,38797,443,4559,2054,2505,11,120,6,5
51155,443,7506,443,8351,2366,5985,41,185,20,21
56911,53,36658,53,177,94,83,2,31,1,1
49892,443,11967,443,5930,910,5020,18,36,9,9
65418,443,32664,443,2494,1643,851,17,26,9,8
42599,443,19054,443,215284,28807,186477,346,129,151,195
39338,443,58557,443,4362,1145,3217,17,26,9,8
65234,53,64779,53,186,95,91,2,31,1,1
50642,53,41798,53,165,86,79,2,30,1,1
53697,6224,22057,6224,70,70,0,1,4,1,0
49222,443,64126,443,476852,12774,464078,491,17,177,314
53797,53,41009,53,260,86,174,2,30,1,1
49536,80,12566,80,4544,3602,942,15,15,8,7
65159,53,20643,53,286,103,183,4,51,2,2
49815,53,18819,53,212,102,110,2,29,1,1
47728,443,8590,443,8404,3653,4751,25,256,14,11
55659,37787,37419,37787,70,70,0,1,5,1,0
57445,53,50878,53,342,142,200,2,30,1,1
52069,53446,32796,53446,70,70,0,1,5,1,0
60884,443,11637,443,7411,3022,4389,26,46,15,11
37923,443,39242,443,2593394,70243,2523151,2678,303,908,1770
58554,80,58554,80,348,132,216,6,26,3,3
52339,443,45302,443,4362,1266,3096,26,129,11,15
51978,57496,57419,57496,70,70,0,1,5,1,0
57416,53,62592,53,186,95,91,2,31,1,1
9106,53,9106,53,227,89,138,2,30,1,1
64790,53,64538,53,779,86,693,2,30,1,1
61041,443,15332,443,77650,64697,12953,148,902,81,67
54631,443,52521,443,2352,1394,958,17,275,9,8
35292,8100,23509,8100,78,78,0,1,5,1,0
56912,53,37939,53,753,96,657,2,31,1,1
53711,30355,27778,30355,320,140,180,6,5,3,3
55059,53,53925,53,711,87,624,2,30,1,1
57896,7635,57896,7635,138,78,60,2,5,1,1
51970,80,32175,80,366,240,126,7,25,5,2
52016,443,52016,443,219803,9390,210413,222,49,72,150
51973,12321,46700,12321,1260,636,624,9,30,5,4
64724,443,50877,443,8602,1050,7552,16,121,7,9
64973,53,14211,53,210,102,108,2,30,1,1
53128,443,36411,443,72734,14614,58120,112,44,39,73
62185,53,27701,53,578,286,292,9,15,5,4
56297,53,12569,53,168,86,82,2,30,1,1
56857,43237,16433,43237,70,70,0,2,8,2,0
56265,53,18284,53,733,85,648,2,30,1,1
49592,53,47137,53,177,94,83,2,30,1,1
55530,53,3862,53,758,93,665,2,31,1,1
53516,443,26441,443,560,280,280,9,34,5,4
55451,53,24181,53,193,102,91,2,29,1,1
50156,53,6756,53,186,102,84,2,30,1,1
51769,80,52683,80,74039,4367,69672,91,19,40,51
46845,443,36578,443,5506,878,4628,16,26,9,7
56334,53,55727,53,170,87,83,2,30,1,1
35628,443,46062,443,8414,4131,4283,36,64,16,20
56231,53,34438,53,757,98,659,2,30,1,1
38380,80,38380,80,5397,713,4684,14,16,8,6
49943,53,18559,53,718,94,624,2,30,1,1
57188,443,9507,443,20317684,620294,19697390,20965,186,6716,14249
51215,443,16837,443,11490,3671,7819,33,93,18,15
56938,80,50995,80,1403,841,562,10,75,6,4
40200,5222,30344,5222,8250,3928,4322,80,296,44,36
54981,53,59429,53,757,102,655,2,29,1,1
49380,53,10250,53,198,101,97,2,31,1,1
55087,53,44618,53,344,110,234,2,30,1,1
49420,53,64966,53,183,94,89,2,31,1,1
56737,443,49751,443,7915,1926,5989,20,16,11,9
57052,53,21671,53,177,94,83,2,30,1,1
43762,443,5128,443,7775,1963,5812,22,77,13,9
33048,443,57285,443,90054,6681,83373,104,133,33,71
35156,8635,35156,8635,138,78,60,2,5,1,1
50054,443,33481,443,7630,839,6791,20,79,9,11
56758,40000,5881,40000,70,70,0,1,5,1,0
5588,5588,0,0,3354,1792,1562,46,195,23,23
49851,443,11118,443,6058,1038,5020,20,71,11,9
50550,80,15717,80,374,192,182,7,26,4,3
59759,53,55695,53,384,166,218,2,29,1,1
9436,443,44079,443,5693,499,5194,14,15,7,7
54497,443,36894,443,10017,2436,7581,22,138,10,12
40517,53,18726,53,284,79,205,2,30,1,1
42298,40029,57945,40029,652,83,569,4,31,2,2
33539,53,23280,53,336,231,105,3,30,2,1
44839,443,23952,443,3188,2056,1132,23,121,13,10
60641,443,61674,443,34758,2573,32185,50,320,21,29
64357,53,4119,53,182,93,89,2,31,1,1
49201,53,3474,53,200,102,98,2,30,1,1
27005,27016,2145,27016,883,126,757,2,30,1,1
50584,53,20103,53,179,94,85,2,30,1,1
55596,14795,19064,14795,630,444,186,9,16,6,3
56840,53,4523,53,242,110,132,2,30,1,1
59437,53,35841,53,215,86,129,2,29,1,1
65176,53,2902,53,186,95,91,2,30,1,1
51821,28306,23516,28306,316,136,180,6,6,3,3
34173,53,34173,53,240,98,142,2,29,1,1
36138,443,58693,443,50384,5218,45166,76,99,26,50
49472,443,5541,443,3897,1306,2591,17,158,9,8
64205,53,1901,53,178,94,84,2,30,1,1
34297,443,14287,443,65853,31390,34463,203,694,105,98
60505,53,0,0,340,90,250,2,31,1,1
48817,51413,48817,51413,485,158,327,2,1199,1,1
49418,27018,46953,27018,249,71,178,2,31,1,1
47552,443,59060,443,6268,1904,4364,30,119,16,14
59399,53,32458,53,232,94,138,2,30,1,1
63042,443,30142,443,512,166,346,2,30,1,1
54325,7000,54325,7000,755529,16895,738634,785,16,264,521
55113,53,41095,53,198,102,96,2,29,1,1
65204,53,50425,53,183,94,89,2,29,1,1
64051,53,51013,53,430,172,258,6,61,3,3
56830,53,56847,53,195,102,93,2,30,1,1
49402,80,31803,80,405,285,120,5,15,3,2
57470,24276,41676,24276,132,132,0,3,1200,3,0
55327,443,55327,443,16304,2069,14235,39,17,19,20
58888,443,13119,443,274616,12640,261976,352,28,167,185
45227,80,43141,80,1114,534,580,12,16,7,5
59923,53,29358,53,197,78,119,2,30,1,1
52109,60841,37568,60841,258,70,188,4,8,2,2
50313,80,63654,80,736,670,66,6,15,5,1
65442,80,64392,80,366,180,186,7,28,4,3
49800,53,33373,53,183,94,89,2,29,1,1
36902,443,18209,443,10252,2152,8100,38,126,18,20
39297,443,49533,443,9320,3888,5432,21,119,10,11
27005,1104,28939,1104,870,126,744,2,29,1,1
52632,443,1395,443,4399,1857,2542,28,136,14,14
48817,6886,48817,6886,491,150,341,2,1200,1,1
57301,53,28379,53,177,94,83,2,30,1,1
53942,28921,35066,28921,320,140,180,6,6,3,3
55865,53,56298,53,168,86,82,2,30,1,1
55024,53,31814,53,179,94,85,2,30,1,1
56785,53,13080,53,213,102,111,2,30,1,1
57947,443,51760,443,3282,781,2501,17,136,8,9
53572,22754,17581,22754,70,70,0,1,5,1,0
56944,80,48541,80,214,140,74,4,30,3,1
52147,80,1117,80,366,240,126,7,32,5,2
54996,53,39612,53,168,86,82,2,35,1,1
63204,443,63204,443,9340,4256,5084,24,16,13,11
38123,443,24032,443,15449,1976,13473,32,16,16,16
64907,53,25739,53,168,86,82,2,30,1,1
49604,53,14213,53,86,86,0,1,29,1,0
64950,53,8334,53,186,95,91,2,31,1,1
56570,443,57405,443,4722,1330,3392,18,80,9,9
57584,443,57584,443,8019,4063,3956,33,92,16,17
64872,53,21895,53,166,86,80,2,31,1,1
61030,53,15331,53,167,78,89,2,30,1,1
51767,59158,56330,59158,70,70,0,1,5,1,0
42281,443,42281,443,1530,817,713,17,68,9,8
5237,30128,2836,30128,621281,256,621025,881,49,5,876
55697,53,64657,53,193,102,91,2,31,1,1
53559,58968,6999,58968,70,70,0,1,4,1,0
63850,6881,4556,6881,70,70,0,1,4,1,0
64605,53,39152,53,182,93,89,2,30,1,1
63931,53,21564,53,380,105,275,4,35,2,2
55357,53,12869,53,754,94,660,2,31,1,1
49733,80,1914,80,4198,2450,1748,20,148,15,5
49924,443,9177,443,13502,2331,11171,42,194,19,23
34244,443,6672,443,3528,1045,2483,13,120,6,7
63654,443,35757,443,9152483,314975,8837508,9599,206,3195,6404
64665,53,19631,53,181,94,87,2,31,1,1
52797,443,22094,443,8355,1923,6432,32,16,18,14
52849,443,32844,443,7735,1260,6475,16,133,7,9
55265,53,44071,53,199,102,97,2,30,1,1
64924,53,58224,53,747,93,654,2,31,1,1
50305,80,32825,80,5500,2829,2671,19,34,10,9
49491,53,15104,53,492,94,398,4,45,2,2
56673,443,15225,443,7941,1952,5989,20,15,11,9
53171,11820,1212,11820,698,320,378,10,16,6,4
27005,27016,48849,27016,1688,126,1562,4,31,2,2
55047,443,3031,443,7069,2512,4557,25,46,14,11
51835,29778,40587,29778,70,70,0,1,5,1,0
56082,53,31858,53,271,88,183,4,37,2,2
63899,62015,51023,62015,70,70,0,1,4,1,0
49795,53,1877,53,211,102,109,2,30,1,1
38759,443,24886,443,7878,1531,6347,36,257,16,20
50605,80,49790,80,1657,1247,410,8,15,5,3
50609,53,13488,53,766,102,664,2,30,1,1
53433,443,53433,443,15095,2556,12539,37,102,15,22
53971,80,16324,80,662,448,214,10,15,7,3
49845,53,0,0,206,83,123,2,30,1,1
27005,27016,53095,27016,889,126,763,3,31,2,1
56385,53,50438,53,249,85,164,4,56,2,2
57593,80,6872,80,486,280,206,8,26,5,3
51976,443,42576,443,2466,1497,969,21,46,12,9
50328,80,59408,80,55878,5841,50037,70,94,29,41
49418,27016,50703,27016,258,78,180,2,31,1,1
6881,48533,62658,48533,502,150,352,2,1199,1,1
64683,53,62247,53,198,102,96,2,29,1,1
51752,7000,51752,7000,3638,2087,1551,17,16,10,7
49467,443,18409,443,4564,2466,2098,20,119,11,9
27005,27018,60808,27018,881,126,755,2,31,1,1
58824,443,46343,443,11863,7694,4169,33,17,17,16
64884,53,48287,53,239,110,129,2,30,1,1
50116,22,50116,22,152,66,86,2,9,1,1
57587,443,4519,443,15613,1408,14205,32,125,15,17
56946,53,14578,53,732,89,643,2,31,1,1
65340,53,24167,53,313,110,203,4,34,2,2
53891,443,8709,443,499,425,74,4,0,3,1
61828,443,31671,443,7490,2688,4802,23,383,10,13
53694,8999,50905,8999,1179,606,573,12,17,7,5
57385,53,34809,53,197,102,95,2,30,1,1
44511,53,15897,53,199,94,105,2,30,1,1
55865,53,56628,53,196,102,94,2,30,1,1
50933,443,10395,443,10546,2453,8093,28,15,16,12
58942,443,33385,443,5168,700,4468,16,15,7,9
49217,53,20500,53,209,110,99,2,29,1,1
50868,443,26459,443,7646,1697,5949,31,271,15,16
56446,443,1598,443,16401,10833,5568,32,362,18,14
56567,53,56060,53,188,96,92,2,31,1,1
40547,443,6575,443,4916,2083,2833,24,43,13,11
50376,53,23494,53,166,86,80,2,31,1,1
55678,52879,10322,52879,70,70,0,2,8,2,0
49234,53,44202,53,167,86,81,2,30,1,1
58883,443,51515,443,1115,591,524,12,25,6,6
55644,53,33807,53,184,94,90,2,31,1,1
42385,443,44650,443,26481,1832,24649,40,330,18,22
49425,53,61081,53,772,102,670,2,30,1,1
49950,80,40840,80,51651,48866,2785,74,20,38,36
28025,443,15107,443,5578,1390,4188,19,15,9,10
54052,443,54052,443,1386,751,635,15,181,8,7
57375,443,64184,443,130,70,60,2,15,1,1
53246,443,25270,443,6574,1935,4639,14,121,7,7
54950,443,18760,443,5281,1393,3888,22,16,13,9
65220,53,21177,53,184,94,90,2,30,1,1
37222,443,57670,443,4713,895,3818,18,16,10,8
49655,443,28580,443,50533,7291,43242,74,61,34,40
57944,80,62722,80,1718,1404,314,11,15,6,5
49543,53,11834,53,779,110,669,2,30,1,1
55539,53,7321,53,814,110,704,2,30,1,1
50072,53,48106,53,172,94,78,2,30,1,1
60962,443,57911,443,50093,8331,41762,75,48,36,39
60540,443,60540,443,4455,1548,2907,19,27,11,8
52425,443,26865,443,6527,1142,5385,23,32,13,10
42025,443,40368,443,2394,1365,1029,18,275,9,9
27005,27015,4886,27015,876,126,750,2,30,1,1
1923,53,53314,53,260,86,174,2,30,1,1
48735,443,54377,443,77050,5353,71697,113,95,46,67
64926,53,45252,53,257,102,155,2,30,1,1
56626,443,37778,443,45304,28614,16690,82,41,45,37
55056,80,26189,80,306,180,126,6,26,4,2
56720,443,57174,443,7941,1952,5989,20,15,11,9
49633,443,1902,443,60196,10141,50055,122,33,62,60
51803,33973,32167,33973,66,66,0,1,5,1,0
55828,443,52104,443,5278,1026,4252,20,15,11,9
33795,80,33795,80,490,264,226,8,142,5,3
36301,443,2134,443,7316,1933,5383,27,15,15,12
46590,443,20776,443,6665,1130,5535,24,287,13,11
49610,53,48262,53,241,94,147,2,30,1,1
65073,53,50486,53,195,102,93,2,29,1,1
55684,53,46714,53,214,110,104,2,30,1,1
52179,14354,64270,14354,70,70,0,2,8,2,0
49465,443,57765,443,11184,6821,4363,27,53,14,13
48006,443,61488,443,1429,1295,134,10,30,8,2
49919,53,2531,53,225,102,123,2,30,1,1
50097,53,57646,53,199,94,105,2,30,1,1
52036,80,8626,80,366,240,126,7,24,5,2
55867,53,51725,53,184,94,90,2,29,1,1
55782,53,15555,53,245,94,151,2,29,1,1
55325,53,47399,53,199,102,97,2,29,1,1
53087,443,59846,443,408922,10621,398301,421,121,145,276
60910,443,19521,443,3862,2679,1183,28,46,15,13
43215,443,60115,443,9781,3108,6673,28,15,15,13
55650,18073,23998,18073,504,318,186,8,15,5,3
55072,53,45639,53,170,87,83,2,31,1,1
38733,443,28389,443,9058,1542,7516,25,50,13,12
61718,443,31970,443,21125,2413,18712,42,49,20,22
50602,80,50602,80,7596,5063,2533,28,27,16,12
49773,53,59337,53,225,110,115,2,30,1,1
58036,443,28433,443,10454,1724,8730,28,525,12,16
64270,53,47275,53,455,102,353,4,33,2,2
57932,443,47126,443,29612,2205,27407,53,186,21,32
55683,53,63904,53,391,134,257,2,30,1,1
65236,53,21854,53,177,94,83,2,30,1,1
55865,53,64490,53,168,86,82,2,30,1,1
65492,443,42698,443,92573,4519,88054,105,16,39,66
58839,443,29041,443,6270,4231,2039,22,16,11,11
50473,80,6625,80,1658,1247,411,8,15,5,3
57470,51413,34007,51413,460,150,310,2,1199,1,1
50506,80,64243,80,318,192,126,6,25,4,2
65153,53,29688,53,168,86,82,2,30,1,1
39858,443,36124,443,167,107,60,2,5,1,1
39915,443,9924,443,15058,8409,6649,40,271,21,19
43585,443,18767,443,6636,3565,3071,22,187,13,9
65437,53,61379,53,195,102,93,2,31,1,1
55857,53,40207,53,199,102,97,2,29,1,1
54966,443,5878,443,4645,2498,2147,14,135,7,7
55729,53,33239,53,199,102,97,2,30,1,1
64732,53,44138,53,189,102,87,2,29,1,1
57470,6346,6625,6346,330,330,0,6,1200,6,0
9308,443,57827,443,3837,488,3349,15,15,7,8
49410,53,59985,53,324,87,237,4,55,2,2
56110,53,15545,53,508,102,406,2,30,1,1
49449,80,49449,80,416,198,218,7,29,4,3
49757,53,31813,53,177,94,83,2,31,1,1
56797,443,58873,443,8022,2002,6020,20,16,11,9
38936,443,16870,443,3217,2090,1127,16,255,9,7
44910,443,16825,443,2841,1916,925,18,26,10,8
55900,53,53468,53,194,102,92,2,30,1,1
55547,53,9428,53,774,101,673,2,31,1,1
51877,443,15246,443,1852,1103,749,16,31,9,7
49257,53,6745,53,199,102,97,2,30,1,1
50249,443,46250,443,6125,1674,4451,22,81,11,11
49232,53,52451,53,242,78,164,2,29,1,1
54496,53,1798,53,164,86,78,2,29,1,1
60912,443,25198,443,9959,2430,7529,27,46,16,11
56803,53,43368,53,182,93,89,2,30,1,1
52913,443,33752,443,50739,5508,45231,100,116,36,64
49304,53,30791,53,214,102,112,2,30,1,1
37466,443,58228,443,13829,1724,12105,28,516,13,15
58306,443,59387,443,864,436,428,13,29,7,6
56757,53,22580,53,322,118,204,2,30,1,1
51963,80,35774,80,422,240,182,8,25,5,3
61509,443,47638,443,1506,984,522,14,27,8,6
56785,53,64900,53,186,95,91,2,31,1,1
49488,53,14006,53,188,96,92,2,30,1,1
26795,443,14434,443,21804,16558,5246,43,21,24,19
57227,443,51779,443,9322,2994,6328,26,22,16,10
37531,443,49565,443,17284,5197,12087,46,48,25,21
49231,443,44532,443,474745,13542,461203,502,17,189,313
56995,80,29664,80,214,140,74,4,35,3,1
55215,53,18031,53,315,126,189,2,29,1,1
51690,80,20015,80,1273,471,802,11,290,6,5
50754,443,43460,443,10133,2663,7470,35,255,18,17
64114,64126,30827,64126,66,66,0,2,8,2,0
49207,443,35081,443,2643240,203689,2439551,3285,576,1237,2048
51870,53,51870,53,825,99,726,2,30,1,1
56182,80,62619,80,2085,797,1288,10,15,6,4
19473,6881,30849,6881,491,150,341,2,1200,1,1
59103,443,44683,443,2192,1049,1143,24,119,11,13
27153,80,27153,80,6397,947,5450,15,18,8,7
55665,44235,23820,44235,504,318,186,8,15,5,3
49418,27015,37107,27015,223,71,152,2,31,1,1
56439,53,49648,53,198,102,96,2,29,1,1
52079,1024,39803,1024,66,66,0,1,5,1,0
50128,443,52903,443,15069,5689,9380,51,35,27,24
46265,7700,48956,7700,1440,956,484,15,35,8,7
33498,443,13950,443,3672,1802,1870,25,129,10,15
50334,443,29587,443,3193,346,2847,12,121,5,7
49945,53,50921,53,281,97,184,4,58,2,2
46618,443,48794,443,9505,3214,6291,33,19,19,14
46404,53,18296,53,240,86,154,2,30,1,1
65377,53,42499,53,186,95,91,2,31,1,1
56358,80,8330,80,1569,1077,492,11,30,6,5
55972,53,10428,53,186,95,91,2,30,1,1
55436,53,43899,53,774,101,673,2,30,1,1
64591,53,55985,53,179,86,93,2,30,1,1
56781,443,59501,443,7870,1881,5989,20,15,11,9
56375,53,41703,53,177,94,83,2,30,1,1
41538,443,31150,443,8090,2462,5628,22,21,12,10
55778,53,54108,53,181,94,87,2,30,1,1
53075,53,27228,53,168,78,90,2,30,1,1
64276,53,55136,53,197,102,95,2,31,1,1
60750,40010,25363,40010,316,136,180,6,6,3,3
62464,41090,36975,41090,454923,271912,183011,516,549,295,221
64341,53,61484,53,355,118,237,2,30,1,1
37577,443,55436,443,499,425,74,4,0,3,1
53182,443,14179,443,16255,8279,7976,42,422,21,21
55715,53,19164,53,168,86,82,2,29,1,1
50688,53,22980,53,78,78,0,1,30,1,0
54270,443,24840,443,6620,672,5948,17,128,8,9
56125,80,28714,80,891,536,355,10,255,6,4
49621,80,15641,80,318,192,126,6,42,4,2
27988,40006,7041,40006,148,86,62,2,30,1,1
50656,443,61533,443,3815,1772,2043,18,16,10,8
48755,443,25931,443,6423,1145,5278,19,33,11,8
123,123,7719,123,184,94,90,2,31,1,1
39442,123,6602,123,184,94,90,2,30,1,1
60949,443,41744,443,1598,794,804,16,18,9,7
55637,53,5558,53,209,110,99,2,29,1,1
64991,53,31407,53,196,94,102,2,29,1,1
64961,27025,27939,27025,1334,462,872,4,30,2,2
56921,443,49898,443,8416,2142,6274,25,330,12,13
64461,53,47213,53,177,94,83,2,31,1,1
56925,53,20388,53,196,102,94,2,30,1,1
65320,53,12285,53,227,110,117,2,30,1,1
56319,53,40959,53,455,94,361,2,30,1,1
56780,48298,2043,48298,264,70,194,4,19,1,3
36125,443,36185,443,6620,1197,5423,22,129,12,10
64663,53,18610,53,578,286,292,9,15,5,4
33992,53,33992,53,79,79,0,1,30,1,0
63885,443,2549,443,254829,10396,244433,255,194,64,191
65373,53,60314,53,194,99,95,2,31,1,1
38941,443,53715,443,4613,2811,1802,27,95,14,13
64645,443,28393,443,7752,4399,3353,34,159,17,17
50038,53,0,0,275,85,190,2,31,1,1
56070,53,35943,53,770,101,669,2,30,1,1
58052,80,61267,80,1550,853,697,9,15,5,4
38554,443,64744,443,5021,1030,3991,16,30,9,7
49935,53,55130,53,458,111,347,4,59,2,2
57166,53,13391,53,177,94,83,2,30,1,1
58301,53,36478,53,233,102,131,2,30,1,1
55989,53,49458,53,205,86,119,2,30,1,1
33804,443,22331,443,5815,1128,4687,19,0,9,10
36710,443,45580,443,6786,1795,4991,18,16,11,7
65189,53,27284,53,180,94,86,2,30,1,1
37694,443,63637,443,234688,15158,219530,324,173,157,167
56750,80,10595,80,194,128,66,4,25,3,1
65188,53,51573,53,731,91,640,2,31,1,1
56292,53,4815,53,197,102,95,2,30,1,1
53842,57861,18155,57861,492,306,186,8,14,5,3
64127,53,10956,53,471,182,289,6,57,3,3
50669,443,15933,443,8464,2256,6208,25,255,13,12
53792,53,47522,53,224,86,138,2,30,1,1
45294,443,12924,443,6290,4832,1458,18,120,11,7
43782,7275,17092,7275,4955,1749,3206,24,16,15,9
27005,27111,65327,27111,913,126,787,2,30,1,1
38450,443,8906,443,593,473,120,4,15,2,2
55067,443,5248,443,17968,12031,5937,38,63,21,17
49442,53,40025,53,198,94,104,2,31,1,1
55146,53,42848,53,181,94,87,2,30,1,1
50421,80,60680,80,7162,3201,3961,19,27,11,8
53536,34200,55165,34200,70,70,0,1,4,1,0
8411,8411,36899,8411,66,66,0,1,30,1,0
40204,40035,37692,40035,156,94,62,2,30,1,1
55212,443,36417,443,10500,5056,5444,23,143,11,12
49411,53,20667,53,195,102,93,2,30,1,1
57346,53,18432,53,210,110,100,2,29,1,1
63027,443,10834,443,384,166,218,2,30,1,1
64580,53,18330,53,180,94,86,2,30,1,1
65100,53,65386,53,720,94,626,2,30,1,1
43788,80,23555,80,2597,699,1898,11,181,6,5
39570,443,58125,443,127970,4968,123002,144,30,53,91
57470,1,27948,1,132,132,0,3,1199,3,0
65461,53,1880,53,268,110,158,2,30,1,1
60115,443,39754,443,268,120,148,5,10,3,2
50584,53,13408,53,793,101,692,2,30,1,1
56965,53,44831,53,183,94,89,2,30,1,1
54902,80,36045,80,1107,630,477,10,16,6,4
49585,53,39603,53,732,86,646,2,30,1,1
50377,53,60945,53,214,110,104,2,30,1,1
50017,53,24863,53,300,97,203,4,36,2,2
56962,53,9664,53,177,94,83,2,30,1,1
61719,80,27024,80,32457,1499,30958,42,50,16,26
65489,53,22228,53,242,102,140,2,30,1,1
56020,53,48606,53,168,86,82,2,31,1,1
52147,30265,24438,30265,70,70,0,2,8,2,0
52948,48482,33406,48482,5180,2470,2710,49,339,25,24
41471,443,22977,443,1973617,48070,1925547,1945,84,606,1339
49651,80,24642,80,318,192,126,6,41,4,2
49356,443,28911,443,5946,1254,4692,20,33,10,10
52071,80,35794,80,362,240,122,7,25,5,2
49334,53,54606,53,184,94,90,2,31,1,1
60287,80,62692,80,1052,612,440,10,15,5,5
50082,53,51299,53,199,94,105,2,30,1,1
50015,53,57649,53,287,94,193,2,29,1,1
56327,53,13541,53,178,94,84,2,30,1,1
44235,443,40190,443,2863,1501,1362,20,317,10,10
49262,443,12479,443,4353,1227,3126,12,135,6,6
56129,53,60836,53,94,94,0,1,30,1,0
34408,443,19414,443,9649,3714,5935,47,340,24,23
49518,53,62825,53,266,110,156,2,30,1,1
42298,4126,11425,4126,132,64,68,2,30,1,1
64287,53,27313,53,497,90,407,4,33,2,2
8243,443,8243,443,1024,539,485,10,58,5,5
61167,443,24525,443,27000,11646,15354,176,640,82,94
56646,443,10246,443,1327,918,409,10,26,6,4
56597,443,58985,443,8700,2196,6504,21,16,12,9
65073,53,7816,53,195,102,93,2,30,1,1
65007,53,25899,53,165,86,79,2,30,1,1
49855,53,34570,53,177,94,83,2,30,1,1
49772,53,54364,53,181,94,87,2,31,1,1
53932,80,32355,80,1134,465,669,9,18,6,3
49957,80,62910,80,6389,690,5699,16,15,8,8
49862,443,63314,443,819841,23462,796379,897,56,298,599
56378,53,11573,53,214,102,112,2,30,1,1
50151,53,44129,53,168,94,74,2,30,1,1
65384,443,21164,443,8613,1465,7148,22,15,13,9
56641,443,17125,443,7942,1953,5989,20,15,11,9
48817,36292,48817,36292,519,158,361,2,1200,1,1
48817,1049,48817,1049,334,158,176,2,1199,1,1
48620,53,31132,53,199,94,105,2,29,1,1
55579,53,12007,53,178,94,84,2,30,1,1
58288,443,25819,443,6438,2646,3792,18,37,11,7
53722,443,10654,443,70,70,0,2,7,2,0
43483,443,14734,443,144138,17538,126600,275,300,115,160
63757,51413,7176,51413,66,66,0,2,7,2,0
57075,53,34299,53,212,102,110,2,30,1,1
61388,80,19899,80,14158,1392,12766,26,255,14,12
21087,80,21087,80,159790,4676,155114,177,128,67,110
55312,53,24613,53,195,102,93,2,30,1,1
57228,53,47856,53,199,102,97,2,31,1,1
51072,80,39928,80,1299,793,506,12,16,6,6
27005,27015,49083,27015,872,126,746,2,30,1,1
27005,28018,47944,28018,1640,126,1514,4,30,2,2
64715,53,35107,53,209,110,99,2,30,1,1
57388,53,31918,53,266,86,180,2,30,1,1
37965,51413,23143,51413,2020,1090,930,18,1200,15,3
27721,53,27721,53,404,259,145,3,32,2,1
56317,53,55686,53,182,93,89,2,31,1,1
56263,53,62395,53,214,110,104,2,29,1,1
50339,80,14820,80,306,180,126,6,41,4,2
55877,62071,53667,62071,481,150,331,2,1200,1,1
49349,443,17096,443,5282,1090,4192,17,25,10,7
49636,443,28958,443,50297,4871,45426,86,31,40,46
56794,1,30345,1,70,70,0,1,5,1,0
57037,443,39402,443,6847,1658,5189,21,25,12,9
53864,443,39351,443,499,425,74,4,1,3,1
49786,53,64235,53,209,110,99,2,30,1,1
55098,53,15101,53,474,200,274,6,43,3,3
64877,53,24917,53,182,93,89,2,31,1,1
40587,53,36507,53,271,102,169,2,30,1,1
50437,3389,50437,3389,3444,1730,1714,16,31,8,8
57269,53,63044,53,183,94,89,2,30,1,1
48817,11373,48817,11373,481,150,331,2,1200,1,1
52072,25595,16816,25595,66,66,0,1,5,1,0
55662,36445,15210,36445,504,318,186,8,17,5,3
55556,53,8408,53,183,94,89,2,30,1,1
62481,80,55007,80,890,440,450,10,33,6,4
57470,13244,33439,13244,166,166,0,1,1199,1,0
51283,443,17367,443,638,292,346,10,28,5,5
57748,15000,46693,15000,130,70,60,2,5,1,1
57308,53,39831,53,302,110,192,2,30,1,1
60083,443,30237,443,490571,27526,463045,511,141,170,341
40362,443,26484,443,8229,2091,6138,24,361,12,12
64444,53,10743,53,183,94,89,2,30,1,1
45386,5222,47309,5222,4579,2357,2222,46,114,26,20
27005,27015,13591,27015,880,126,754,2,30,1,1
51855,23268,16577,23268,70,70,0,1,5,1,0
50584,2775,5247,2775,150,150,0,1,1200,1,0
64669,53,24998,53,198,94,104,2,30,1,1
55511,443,12800,443,10499,2421,8078,28,15,14,14
53739,27290,11218,27290,70,70,0,2,7,2,0
54410,443,16745,443,7256,1669,5587,27,318,15,12
55654,18251,36307,18251,70,70,0,1,5,1,0
50496,80,19242,80,318,192,126,6,25,4,2
37663,80,36231,80,974,481,493,8,15,5,3
39038,443,14810,443,3970,2230,1740,17,114,10,7
50584,6881,16713,6881,166,166,0,1,1200,1,0
49835,53,23738,53,168,86,82,2,30,1,1
42566,53,42566,53,216,98,118,2,30,1,1
57314,53,53459,53,195,102,93,2,30,1,1
53625,39198,33493,39198,552,306,246,9,16,5,4
65114,53,14258,53,177,94,83,2,29,1,1
56434,53,28860,53,316,94,222,2,30,1,1
58638,5900,58638,5900,156,62,94,2,10,1,1
49905,53,29720,53,180,94,86,2,30,1,1
44654,80,35775,80,2121,1558,563,13,16,7,6
56493,443,6298,443,10532,6786,3746,55,81,28,27
52701,443,13239,443,130,70,60,3,5,2,1
51947,16935,4514,16935,70,70,0,1,5,1,0
35501,53,35501,53,213,79,134,2,33,1,1
50284,443,28484,443,208,60,148,4,12,2,2
52068,39864,30686,39864,70,70,0,1,5,1,0
49477,443,62857,443,8416,1247,7169,21,152,10,11
49954,53,53212,53,216,110,106,2,29,1,1
48694,123,37842,123,184,94,90,2,30,1,1
49667,53,30486,53,759,102,657,2,31,1,1
56569,53,23106,53,182,93,89,2,31,1,1
55130,53,20364,53,216,110,106,2,30,1,1
58796,443,14867,443,7402,2429,4973,40,139,22,18
34912,443,42889,443,36366,2297,34069,51,139,21,30
51137,80,51137,80,66992,5462,61530,79,26,30,49
44885,443,54078,443,1849,1130,719,17,38,9,8
49300,443,11326,443,10704,4094,6610,52,47,29,23
49772,53,62355,53,181,94,87,2,29,1,1
49418,27015,35116,27015,78,78,0,1,30,1,0
37152,443,20347,443,7794,2670,5124,27,316,14,13
49653,80,62428,80,372,192,180,7,42,4,3
65372,53,1041,53,196,100,96,2,31,1,1
1876,53,51383,53,404,261,143,3,30,2,1
58930,443,60456,443,10413,7123,3290,30,18,17,13
57470,6881,14174,6881,490,163,327,2,1200,1,1
51548,80,13460,80,1861,1219,642,10,15,5,5
57411,443,31872,443,214,140,74,4,15,3,1
50366,80,48017,80,23852,1662,22190,36,15,19,17
50592,443,1677,443,9646,3396,6250,23,79,12,11
46053,443,15914,443,6999,1563,5436,18,186,3,15
56485,80,20851,80,569,365,204,6,16,3,3
54962,53,25167,53,194,102,92,2,30,1,1
56430,53,26813,53,199,102,97,2,30,1,1
55813,443,55813,443,4543,1636,2907,19,29,11,8
65028,53,37363,53,79,79,0,2,33,2,0
50516,443,49495,443,12855,2077,10778,30,78,15,15
58302,443,57426,443,4568,2059,2509,17,33,9,8
51880,8001,53470,8001,86,86,0,1,29,1,0
64784,53,44632,53,195,102,93,2,30,1,1
55696,64301,60133,64301,316,190,126,5,15,3,2
49629,53,19594,53,916,86,830,2,30,1,1
36601,443,32906,443,16455,11185,5270,37,271,22,15
50584,60395,46252,60395,166,166,0,1,1200,1,0
65339,53,13346,53,949,285,664,8,39,4,4
65196,53,58386,53,177,94,83,2,30,1,1
49323,53,61963,53,196,102,94,2,30,1,1
55655,63670,50631,63670,70,70,0,1,5,1,0
54054,443,22271,443,12268,7082,5186,26,85,15,11
2084,7000,2084,7000,3566,1999,1567,16,15,8,8
49126,443,33194,443,3800867,77753,3723114,3263,625,478,2785
56951,443,11252,443,5601,1203,4398,14,60,9,5
55565,443,12183,443,21087,4784,16303,25,146,7,18
45844,80,40841,80,152,78,74,2,5,1,1
46442,80,6730,80,1373,669,704,10,16,5,5
50976,80,46012,80,1094127,5977,1088150,812,35,88,724
53739,27290,28914,27290,70,70,0,1,4,1,0
56887,53,15975,53,170,87,83,3,56,2,1
38911,443,33015,443,13187,2075,11112,35,420,11,24
49942,53,37670,53,196,94,102,2,31,1,1
38809,443,49064,443,79659,3269,76390,96,170,37,59
46505,443,50685,443,7072,1541,5531,27,271,12,15
9474,443,14729,443,6100,777,5323,17,26,9,8
49937,80,61073,80,1130,613,517,11,15,6,5
50577,53,42323,53,819,102,717,2,30,1,1
46099,80,56104,80,70,70,0,2,5,2,0
42846,443,19024,443,162,102,60,2,5,1,1
50010,53,37943,53,205,86,119,2,30,1,1
45523,443,20387,443,8636,1914,6722,31,95,16,15
53863,8999,63067,8999,70,70,0,1,5,1,0
47050,53,14793,53,199,94,105,2,30,1,1
65353,53,4050,53,177,94,83,2,29,1,1
65313,53,6135,53,193,102,91,2,30,1,1
56181,53,54189,53,764,99,665,2,31,1,1
57183,53,27398,53,172,88,84,2,30,1,1
37203,443,4528,443,466,392,74,4,0,3,1
61428,80,48945,80,214,140,74,4,41,3,1
65253,53,8346,53,766,102,664,2,30,1,1
54978,80,11814,80,1448,539,909,17,32,9,8
57188,53,20332,53,193,102,91,2,30,1,1
50678,80,52506,80,1549,1097,452,9,21,5,4
38713,443,14389,443,90241,3033,87208,89,16,24,65
64510,53,63517,53,280,118,162,2,29,1,1
45648,80,30446,80,130,70,60,2,15,1,1
53903,51339,10537,51339,70,70,0,1,4,1,0
57236,443,34862,443,2294,1126,1168,25,120,12,13
50984,80,27335,80,8706,2289,6417,22,19,13,9
50214,53,34671,53,789,110,679,2,31,1,1
56658,443,35998,443,18959,1799,17160,35,110,15,20
51839,27256,49193,27256,70,70,0,1,5,1,0
56360,53,60818,53,184,102,82,2,30,1,1
53791,53,58724,53,204,204,0,3,46,3,0
50407,8080,50407,8080,378,180,198,7,33,4,3
53685,38978,44279,38978,70,70,0,2,8,2,0
54078,443,47563,443,1060654,45683,1014971,1265,176,560,705
50951,80,50951,80,514,246,268,9,42,5,4
65081,443,33904,443,5291,339,4952,11,120,5,6
64024,57825,29804,57825,312,132,180,6,6,3,3
55469,53,3156,53,193,102,91,2,30,1,1
27005,27016,5470,27016,879,126,753,2,30,1,1
58552,443,44204,443,28468,2316,26152,43,42,15,28
49255,53,62654,53,212,102,110,2,30,1,1
55062,80,41792,80,486,240,246,9,28,5,4
36486,80,36486,80,15249,1015,14234,24,29,9,15
57258,53,16585,53,177,94,83,2,30,1,1
18125,53,18125,53,235,90,145,2,33,1,1
55802,443,44281,443,30007,2755,27252,41,136,16,25
52485,443,22795,443,22817,7615,15202,30,16,16,14
55942,53,19231,53,197,102,95,2,31,1,1
46310,443,45813,443,10106,2096,8010,24,186,13,11
37965,32405,17637,32405,766,248,518,4,1200,2,2
51441,443,56551,443,642,582,60,2,15,1,1
53742,63344,47218,63344,1294,797,497,13,15,7,6
65314,53,31001,53,195,102,93,2,30,1,1
56393,443,8306,443,25779,3436,22343,42,109,19,23
14237,53,14237,53,245,98,147,2,29,1,1
55644,45579,20057,45579,70,70,0,1,5,1,0
52281,161,0,0,550,550,0,6,35,6,0
49473,53,57880,53,290,118,172,2,30,1,1
58785,443,24870,443,11873,7787,4086,32,16,17,15
57010,53,20752,53,198,101,97,2,30,1,1
9234,80,38036,80,318,192,126,6,26,4,2
49156,53,9695,53,190,97,93,2,30,1,1
60356,443,15398,443,8079,2282,5797,26,17,15,11
53812,45694,7999,45694,3156,1011,2145,16,16,8,8
56820,53,32969,53,186,95,91,2,31,1,1
52413,53,24477,53,168,78,90,2,30,1,1
47102,123,23383,123,184,94,90,2,30,1,1
49418,50019,9812,50019,268,78,190,2,30,1,1
55836,443,16714,443,3538,2015,1523,28,323,14,14
9325,443,25037,443,3616,429,3187,11,15,6,5
52182,443,53611,443,10422,1313,9109,23,75,12,11
55399,53,4452,53,405,99,306,4,41,2,2
36065,443,10379,443,3171,1490,1681,22,21,12,10
55031,443,21855,443,134,60,74,3,5,2,1
60870,53,30144,53,220,94,126,2,30,1,1
56637,443,26633,443,7907,1918,5989,20,15,11,9
35608,443,62915,443,5776,1880,3896,19,272,11,8
56914,53,41623,53,731,85,646,2,30,1,1
50065,80,29478,80,4709,4006,703,11,25,6,5
26900,27017,32007,27017,422,164,258,6,30,3,3
38305,443,38305,443,5510,2263,3247,22,40,13,9
52894,443,46843,443,5424,1445,3979,29,117,14,15
50902,80,25107,80,5166,1278,3888,14,144,8,6
56984,53,53152,53,199,102,97,2,29,1,1
55816,53,28988,53,212,108,104,2,30,1,1
65245,53,50630,53,193,102,91,2,30,1,1
64037,18592,48496,18592,70,70,0,1,5,1,0
55820,53,49464,53,184,94,90,2,30,1,1
64335,53,30399,53,193,102,91,2,29,1,1
12266,443,12266,443,18634,3895,14739,48,29,27,21
59976,80,48173,80,890,469,421,10,360,5,5
56680,53,8517,53,211,102,109,2,30,1,1
58808,80,14493,80,2295,1574,721,10,375,6,4
49670,443,5760,443,886,541,345,11,15,6,5
50438,53,48155,53,295,101,194,4,31,2,2
57237,443,44952,443,3283,1030,2253,16,136,8,8
53125,443,24442,443,3358,1952,1406,16,360,8,8
60424,443,16988,443,1477,940,537,13,26,7,6
56261,53,22541,53,184,94,90,2,31,1,1
49405,53,14474,53,94,94,0,1,30,1,0
50188,443,57063,443,6357,1079,5278,18,32,10,8
64363,53,54171,53,212,102,110,2,30,1,1
50583,53,37919,53,819,102,717,2,30,1,1
56596,53,55954,53,199,102,97,2,29,1,1
59381,53,5162,53,189,78,111,2,30,1,1
55806,80,22467,80,1248,755,493,7,81,5,2
50950,80,33535,80,942,527,415,11,342,6,5
56939,53,59190,53,216,110,106,2,31,1,1
52328,443,52328,443,5438,2255,3183,23,86,12,11
49526,53,6376,53,272,97,175,4,58,2,2
53134,443,53110,443,8361,2182,6179,26,40,15,11
58970,443,57205,443,3715,1958,1757,23,21,12,11
56160,53,61640,53,195,102,93,2,30,1,1
55991,53,22499,53,199,102,97,2,30,1,1
64052,53,43180,53,211,102,109,2,30,1,1
55046,53,5301,53,300,102,198,4,40,2,2
58904,123,61821,123,184,94,90,2,30,1,1
57904,80,60274,80,6453,1210,5243,14,23,8,6
60003,443,18889,443,32538,7037,25501,49,143,20,29
60957,443,56619,443,68539,4175,64364,98,32,46,52
56991,53,36997,53,748,106,642,2,30,1,1
58396,443,53120,443,138065,109491,28574,429,186,230,199
55046,80,55074,80,1056,682,374,10,16,6,4
65049,53,4020,53,210,110,100,2,31,1,1
59958,443,39480,443,2303,1334,969,18,16,10,8
57169,53,44732,53,170,87,83,2,30,1,1
65130,53,25428,53,646,200,446,6,62,3,3
51857,40561,47310,40561,70,70,0,1,5,1,0
51062,80,29351,80,36568,23029,13539,94,194,47,47
55641,53,24406,53,184,94,90,2,31,1,1
41311,443,64855,443,70,70,0,1,5,1,0
55084,443,30495,443,6936,819,6117,20,85,11,9
57371,53,5536,53,214,110,104,2,30,1,1
54952,443,11665,443,61842,4466,57376,109,293,46,63
33534,443,30363,443,4640,1416,3224,18,121,9,9
41243,443,21826,443,3697,2379,1318,26,16,14,12
51985,38904,1159,38904,70,70,0,1,5,1,0
49379,53,24029,53,199,102,97,2,30,1,1
52089,443,15915,443,6032,3616,2416,39,187,20,19
51918,443,34743,443,28031,11553,16478,122,108,61,61
53689,42719,61267,42719,70,70,0,2,7,2,0
56195,53,54925,53,811,94,717,2,30,1,1
57448,53,10658,53,177,94,83,2,29,1,1
45837,443,61728,443,39986,3118,36868,72,82,30,42
46619,123,26763,123,184,94,90,2,30,1,1
57305,53,63466,53,177,94,83,2,30,1,1
56604,443,32761,443,7314,2061,5253,29,92,15,14
56186,53,13478,53,198,102,96,2,31,1,1
51810,33776,47745,33776,66,66,0,1,5,1,0
63560,53,63560,53,209,79,130,2,30,1,1
50595,443,49114,443,2862,1587,1275,15,95,9,6
52190,29765,3143,29765,70,70,0,2,8,2,0
47873,443,44942,443,12813,5036,7777,40,383,20,20
40839,53,42784,53,78,78,0,1,29,1,0
51927,63309,60569,63309,70,70,0,1,5,1,0
52094,443,44037,443,2983,1667,1316,25,153,12,13
64393,53,36156,53,183,94,89,2,30,1,1
50503,443,63118,443,5987,1085,4902,15,25,8,7
59199,53,18550,53,228,94,134,2,30,1,1
64596,53,7572,53,237,110,127,2,30,1,1
56234,443,33837,443,8971,2446,6525,50,347,23,27
55467,53,15072,53,186,95,91,2,30,1,1
57188,443,33520,443,7162,1731,5431,29,32,14,15
49845,443,54304,443,8518,2260,6258,32,806,12,20
64520,53,44752,53,184,86,98,2,29,1,1
61417,443,31390,443,4890,1219,3671,17,28,10,7
55628,53,3702,53,198,102,96,2,30,1,1
63745,39800,55951,39800,504,382,122,8,16,6,2
49676,53,60800,53,322,110,212,4,31,2,2
60863,443,14093,443,134,60,74,3,5,2,1
64232,53,50382,53,258,110,148,2,30,1,1
65494,443,61063,443,92044,4379,87665,102,16,37,65
64788,53,47380,53,168,86,82,2,30,1,1
57192,53,38984,53,177,94,83,2,30,1,1
49718,80,57630,80,11291,1348,9943,17,131,6,11
52474,443,15526,443,14908,4027,10881,28,136,11,17
55295,3389,55295,3389,4365,2581,1784,20,33,11,9
51713,33724,27696,33724,70,70,0,1,5,1,0
9824,53,59579,53,179,86,93,2,29,1,1
52333,443,52333,443,960,539,421,9,52,5,4
57163,53,34170,53,209,110,99,2,30,1,1
38692,443,23262,443,10335,2523,7812,42,32,20,22
57338,443,27463,443,8126,1887,6239,32,732,17,15
65159,53,15273,53,286,103,183,4,52,2,2
57431,80,59179,80,11357,5000,6357,22,30,11,11
52943,443,54392,443,14640,5951,8689,52,115,26,26
60393,46347,14352,46347,320,140,180,6,7,3,3
64765,53,50725,53,177,94,83,2,30,1,1
49209,53,27106,53,199,102,97,2,31,1,1
49591,53,7578,53,168,86,82,2,32,1,1
56744,443,47935,443,6205,986,5219,16,32,10,6
9473,443,29099,443,6100,777,5323,17,26,9,8
57186,53,41154,53,177,94,83,2,30,1,1
58413,443,5177,443,9371,1936,7435,26,29,14,12
56458,53,9119,53,196,102,94,2,31,1,1
64475,53,56794,53,184,94,90,2,31,1,1
137,137,55406,137,114,114,0,2,32,2,0
56168,53,62337,53,745,93,652,2,30,1,1
56437,80,52294,80,17128,1499,15629,24,21,9,15
58316,443,4061,443,7493,1658,5835,22,255,12,10
65026,53,30024,53,193,102,91,2,30,1,1
57470,1337,56441,1337,792,792,0,13,1199,13,0
37651,443,37651,443,4659,1752,2907,19,30,11,8
59669,80,64457,80,2026957,42480,1984477,1975,80,655,1320
65258,53,62928,53,178,94,84,2,30,1,1
51486,4545,51486,4545,156,156,0,3,8,3,0
49666,443,64744,443,14531,7971,6560,36,190,20,16
58968,443,55462,443,4934,1351,3583,21,21,11,10
61712,80,5502,80,1864,1024,840,10,16,6,4
9262,80,26310,80,378,192,186,7,26,4,3
56521,443,48766,443,8760,3693,5067,20,90,12,8
55617,53,46139,53,214,110,104,2,30,1,1
54349,443,33751,443,14063,6328,7735,33,37,16,17
50622,80,45334,80,11907,10409,1498,28,52,16,12
64051,19548,46632,19548,66,66,0,2,8,2,0
64746,53,11815,53,186,95,91,2,31,1,1
55685,48407,34505,48407,320,140,180,6,6,3,3
57470,51413,20990,51413,132,132,0,3,1199,3,0
57065,53,13982,53,182,102,80,2,29,1,1
37574,123,51434,123,184,94,90,2,30,1,1
49827,443,4607,443,21625,7638,13987,45,48,24,21
42298,40031,17629,40031,148,86,62,2,30,1,1
56372,53,63368,53,172,94,78,2,29,1,1
58934,53,32905,53,205,86,119,2,30,1,1
57470,37395,27238,37395,1566,332,1234,11,1199,5,6
55732,53,62249,53,188,96,92,2,31,1,1
55563,53,47396,53,177,94,83,2,29,1,1
55134,53,55134,53,825,99,726,2,31,1,1
56198,53,28713,53,184,102,82,2,30,1,1
21133,54508,26359,54508,323,150,173,2,1199,1,1
60060,443,7904,443,4648,1505,3143,17,141,9,8
26900,27017,5951,27017,422,164,258,6,30,3,3
55706,33677,37931,33677,210,140,70,4,14,3,1
60368,443,34243,443,6041,1830,4211,21,82,10,11
49562,53,28687,53,198,94,104,2,30,1,1
55516,123,34894,123,184,94,90,2,30,1,1
50330,53,50330,53,237,93,144,2,0,1,1
60139,53,31222,53,218,78,140,2,30,1,1
50885,80,41376,80,291594,13131,278463,312,159,116,196
37598,443,64510,443,8102,2685,5417,24,17,15,9
23338,53,23338,53,242,98,144,2,30,1,1
50579,80,50579,80,32612,18106,14506,83,24,47,36
53786,53,10105,53,260,86,174,2,30,1,1
55015,443,24425,443,22687,6933,15754,50,50,26,24
58087,53,39920,53,168,78,90,2,30,1,1
55828,443,33777,443,8420,4472,3948,63,450,32,31
50002,53,41135,53,196,102,94,2,30,1,1
33027,443,54809,443,3723,2408,1315,28,376,15,13
55392,443,3923,443,7347,2127,5220,18,135,8,10
58908,443,56510,443,6278402,111931,6166471,5306,1119,732,4574
65485,53,26521,53,184,94,90,2,31,1,1
41501,80,33952,80,306627,58973,247654,556,297,246,310
64075,53,49394,53,352,86,266,4,36,2,2
52807,443,39495,443,67984,17257,50727,121,148,50,71
50408,53,64657,53,755,94,661,2,31,1,1
55040,443,30969,443,15722,5108,10614,39,16,22,17
49542,443,22517,443,9824,1839,7985,27,172,13,14
49273,7000,49273,7000,2163,676,1487,14,15,7,7
64327,53,59589,53,214,102,112,2,29,1,1
64967,53,42572,53,184,94,90,2,29,1,1
56924,53,38205,53,177,94,83,2,31,1,1
62505,443,46992,443,14891,3970,10921,32,33,15,17
50362,53,58174,53,214,110,104,2,29,1,1
65236,53,5620,53,758,102,656,2,30,1,1
56427,53,19551,53,166,86,80,2,30,1,1
49597,53,33201,53,168,86,82,2,31,1,1
52932,80,19505,80,4214,1921,2293,18,383,10,8
62896,993,54480,993,178,118,60,2,15,1,1
34746,80,56625,80,1299,793,506,12,15,6,6
27490,53,27490,53,214,82,132,2,33,1,1
3691,80,6351,80,6826,1214,5612,20,105,12,8
56805,53,61616,53,178,94,84,2,31,1,1
10151,31964,38746,31964,481,150,331,2,1200,1,1
37581,443,19620,443,13435,2441,10994,30,26,16,14
63741,36776,34457,36776,66,66,0,2,8,2,0
9305,443,52742,443,3616,429,3187,11,16,6,5
50061,443,9312,443,7199,2528,4671,18,76,10,8
55745,53,2082,53,198,101,97,2,30,1,1
15503,6881,37170,6881,490,149,341,2,1200,1,1
49764,443,53395,443,7128,865,6263,19,127,9,10
56440,53,9792,53,711,87,624,2,31,1,1
55810,80,19012,80,11093,1415,9678,18,18,8,10
50525,80,36119,80,152171,9332,142839,189,156,78,111
53888,443,42576,443,8935,4627,4308,22,121,12,10
64029,38651,25596,38651,70,70,0,1,4,1,0
57007,53,22368,53,183,94,89,2,30,1,1
64813,53,11826,53,335,90,245,4,35,2,2
55478,53,12055,53,170,87,83,2,31,1,1
59684,443,44849,443,5173,860,4313,16,15,9,7
43829,443,59022,443,368,160,208,6,33,3,3
55503,53,12220,53,200,102,98,2,30,1,1
55417,53,13088,53,174,89,85,2,30,1,1
55656,53,44214,53,214,110,104,2,30,1,1
49216,53,26832,53,401,142,259,2,30,1,1
63068,443,50738,443,571,166,405,2,30,1,1
56490,443,62341,443,11756,4004,7752,26,121,12,14
49905,80,54689,80,1173,672,501,8,31,5,3
49300,443,26110,443,8282,3240,5042,40,255,20,20
56273,53,26440,53,182,93,89,2,31,1,1
56966,53,53823,53,177,94,83,2,30,1,1
57993,80,1572,80,3822,2132,1690,19,32,11,8
56373,53,9374,53,177,94,83,2,30,1,1
55446,443,18400,443,165191,6141,159050,184,30,67,117
64837,53,39780,53,195,102,93,2,30,1,1
58988,443,31183,443,4330,1777,2553,18,122,9,9
65168,53,15649,53,230,110,120,2,30,1,1
37182,80,39276,80,1638,1324,314,10,16,5,5
54828,443,63990,443,70,70,0,1,5,1,0
49418,27444,10177,27444,258,78,180,2,30,1,1
49651,53,30768,53,312,94,218,2,29,1,1
51574,443,25990,443,3021,960,2061,14,135,7,7
35338,443,31577,443,571121,38361,532760,718,69,342,376
54990,53,17689,53,168,86,82,2,29,1,1
55372,53,64639,53,271,93,178,4,43,2,2
51443,53,51443,53,217,87,130,2,31,1,1
46475,80,46475,80,8300,966,7334,14,20,6,8
49182,53,13161,53,199,102,97,2,30,1,1
49954,53,49870,53,216,110,106,2,30,1,1
56756,53,42523,53,760,97,663,2,30,1,1
55106,53,55106,53,200,90,110,2,30,1,1
42298,40033,43978,40033,245,182,63,2,30,1,1
35104,53,13881,53,168,78,90,2,29,1,1
53735,58869,24687,58869,70,70,0,1,4,1,0
50327,80,7970,80,366,180,186,7,47,4,3
26900,27017,25587,27017,422,164,258,6,30,3,3
38364,15000,10224,15000,130,70,60,2,5,1,1
54988,443,63071,443,69664,6958,62706,98,23,46,52
65194,53,61837,53,402,142,260,2,31,1,1
63803,41439,2152,41439,66,66,0,2,8,2,0
42349,443,27589,443,90562,4227,86335,118,200,49,69
55030,53,46316,53,177,94,83,2,30,1,1
57341,53,32411,53,184,94,90,2,31,1,1
56906,53,34993,53,167,86,81,2,31,1,1
64559,53,60231,53,258,110,148,2,29,1,1
53272,443,47485,443,20745,2083,18662,36,322,15,21
65182,53,61284,53,634,199,435,6,79,3,3
64780,53,50803,53,193,102,91,2,29,1,1
51210,443,30801,443,8248,2460,5788,45,17,26,19
57090,53,28237,53,198,102,96,2,30,1,1
49411,443,49244,443,17524,2569,14955,38,124,17,21
49856,53,57011,53,168,78,90,2,30,1,1
51818,43942,37942,43942,258,70,188,4,8,2,2
65091,53,53299,53,212,102,110,2,29,1,1
54118,443,16400,443,3182,1568,1614,8,120,4,4
55254,443,12972,443,3257,782,2475,17,140,8,9
59162,80,16258,80,1031,314,717,13,175,3,10
58870,443,14754,443,7415,2363,5052,17,120,9,8
56239,53,24103,53,176,90,86,2,31,1,1
51234,80,58624,80,6798,4486,2312,42,107,22,20
64026,53,1792,53,211,102,109,2,30,1,1
37961,443,21395,443,153,93,60,2,5,1,1
51928,52520,11257,52520,70,70,0,1,5,1,0
63788,80,49704,80,314,192,122,6,15,4,2
54342,80,39601,80,1515,481,1034,11,16,6,5
55912,53,45004,53,199,102,97,2,29,1,1
51102,80,48661,80,254,128,126,5,16,3,2
55107,443,57254,443,12000,3846,8154,29,28,17,12
27005,27015,1344,27015,880,126,754,3,31,2,1
57241,53,11880,53,760,97,663,2,31,1,1
35338,443,9775,443,7504,2762,4742,35,61,17,18
50116,22,50116,22,184,120,64,4,11,3,1
52320,443,52845,443,65770,4466,61304,94,46,44,50
55849,53,18869,53,195,102,93,2,31,1,1
54962,53,47568,53,241,102,139,2,31,1,1
50932,443,17054,443,167483,7402,160081,221,23,93,128
64825,53,5593,53,728,96,632,2,31,1,1
55002,53,42728,53,196,102,94,2,31,1,1
56037,53,56792,53,168,94,74,2,29,1,1
56625,53,48390,53,193,102,91,2,29,1,1
50577,53,36248,53,196,102,94,2,30,1,1
49699,443,3417,443,9968,2106,7862,27,128,14,13
56837,53,12687,53,180,94,86,2,30,1,1
27005,32063,39805,32063,889,126,763,2,30,1,1
64914,53,55728,53,168,86,82,2,30,1,1
49889,53,36232,53,197,102,95,2,29,1,1
28000,443,52315,443,5746,1271,4475,25,105,12,13
64149,53,19971,53,301,108,193,4,49,2,2
55601,44049,44869,44049,504,318,186,8,15,5,3
57061,53,24920,53,197,94,103,2,29,1,1
65514,53,43311,53,214,110,104,2,30,1,1
51704,443,61850,443,7117,619,6498,19,34,6,13
27005,27016,61455,27016,881,126,755,2,31,1,1
64610,53,2406,53,292,102,190,2,30,1,1
53522,24116,32649,24116,70,70,0,2,8,2,0
60428,80,55142,80,20301,1264,19037,28,26,11,17
60271,443,5474,443,10324,8406,1918,44,87,26,18
64047,16221,14226,16221,70,70,0,1,4,1,0
55834,53,8445,53,429,94,335,4,52,2,2
56667,53,18172,53,199,102,97,2,30,1,1
33399,443,27816,443,3603,2013,1590,21,42,12,9
57470,38871,35688,38871,545,166,379,2,1199,1,1
36026,443,14720,443,7050,984,6066,18,39,12,6
42341,443,25797,443,276,70,206,5,26,2,3
57176,53,54360,53,178,94,84,2,29,1,1
49320,53,59903,53,177,94,83,2,30,1,1
60314,80,12778,80,1498,539,959,10,77,6,4
55055,80,30882,80,306,180,126,6,26,4,2
38059,443,31779,443,25214,14000,11214,66,99,34,32
64825,53,28794,53,184,94,90,2,31,1,1
47152,443,10144,443,11278,2044,9234,32,178,17,15
42298,40009,62202,40009,148,86,62,2,30,1,1
51848,443,58021,443,68198,5503,62695,102,40,43,59
36729,443,18622,443,7480,1122,6358,27,257,13,14
59735,443,11468,443,7310,967,6343,18,25,10,8
57027,123,48138,123,184,94,90,2,30,1,1
55378,53,28719,53,277,102,175,2,30,1,1
51518,443,51518,443,15967,3046,12921,39,173,15,24
57169,53,45860,53,177,94,83,2,31,1,1
59608,443,1997,443,2149,1277,872,18,829,10,8
41901,443,21025,443,5586,1404,4182,17,212,10,7
64967,53,21374,53,389,134,255,2,30,1,1
49156,443,29780,443,8569,2165,6404,23,34,12,11
55633,53,54670,53,816,97,719,2,30,1,1
39852,53,51714,53,223,78,145,2,30,1,1
54516,53,54516,53,235,90,145,2,33,1,1
56792,53,2003,53,782,105,677,2,31,1,1
51771,19103,1964,19103,70,70,0,1,5,1,0
63932,53,16188,53,179,94,85,2,31,1,1
38690,443,27226,443,8871,3470,5401,24,123,13,11
65343,53,10337,53,184,94,90,2,30,1,1
50634,443,27378,443,8220,1670,6550,26,71,13,13
64697,53,13382,53,199,102,97,2,30,1,1
55085,53,9873,53,301,94,207,2,30,1,1
57386,443,57835,443,1056,569,487,10,38,6,4
45394,53,64814,53,199,94,105,2,30,1,1
57152,53,41610,53,733,94,639,2,30,1,1
52967,443,11017,443,9893,2231,7662,42,113,21,21
51204,123,19622,123,184,94,90,2,30,1,1
64983,53,5979,53,181,94,87,2,30,1,1
49623,443,29272,443,36302,2869,33433,67,180,32,35
54631,443,58856,443,8367,3945,4422,81,616,42,39
62880,53,59831,53,248,78,170,2,30,1,1
56007,53,24693,53,197,102,95,2,35,1,1
51968,43622,9817,43622,70,70,0,2,8,2,0
65111,53,60409,53,198,94,104,2,29,1,1
60402,80,24295,80,1135,736,399,7,95,4,3
43596,80,25616,80,1947,1182,765,10,515,6,4
57273,53,29269,53,177,94,83,2,30,1,1
58638,5900,58638,5900,156,62,94,2,10,1,1
32299,40021,3069,40021,148,86,62,2,31,1,1
58847,443,11614,443,7014,1630,5384,20,120,10,10
5588,5588,0,0,3354,1792,1562,46,194,23,23
53567,43167,28309,43167,492,306,186,8,16,5,3
56191,53,1757,53,177,94,83,2,30,1,1
52121,58933,11142,58933,66,66,0,1,5,1,0
56227,53,18236,53,174,89,85,2,31,1,1
64828,53,47016,53,881,243,638,6,39,3,3
41322,443,6156,443,994089,30018,964071,1058,350,373,685
54218,443,2874,443,499,425,74,4,0,3,1
64502,53,56214,53,199,102,97,2,30,1,1
49712,53,29972,53,172,88,84,2,30,1,1
55367,53,25329,53,215,102,113,2,30,1,1
53729,40721,47011,40721,70,70,0,1,4,1,0
21478,53,21478,53,625,79,546,2,30,1,1
36563,6851,45259,6851,7584,4075,3509,51,169,27,24
37628,443,37587,443,5783,1761,4022,24,46,14,10
49532,53,59388,53,331,92,239,4,40,2,2
2088,7010,2088,7010,10300,8829,1471,24,15,13,11
56720,53,21366,53,170,87,83,2,31,1,1
60430,51413,49908,51413,70,70,0,1,5,1,0
49929,53,53934,53,214,110,104,2,30,1,1
49780,53,9183,53,183,94,89,2,31,1,1
54891,443,48520,443,10035,2160,7875,35,120,18,17
56837,46790,59586,46790,70,70,0,1,5,1,0
56918,53,41255,53,778,103,675,2,30,1,1
14597,53,14597,53,404,259,145,3,32,2,1
52129,55550,12680,55550,70,70,0,2,8,2,0
53425,51689,2819,51689,546,306,240,9,142,5,4
56536,53,64182,53,209,110,99,2,30,1,1
63931,443,46072,443,103248,6121,97127,124,144,47,77
44924,53,44924,53,235,90,145,2,32,1,1
53052,443,55345,443,214,140,74,4,15,3,1
59835,53,53528,53,168,78,90,2,30,1,1
60397,443,49717,443,7643,1678,5965,21,80,11,10
59779,443,18781,443,6055,3602,2453,16,136,8,8
56970,53,57331,53,428,103,325,4,34,2,2
63810,443,22948,443,8243,4867,3376,33,137,16,17
45540,443,45540,443,4702,1795,2907,19,28,11,8
52141,1033,19443,1033,316,136,180,6,7,3,3
49984,53,41486,53,172,88,84,2,30,1,1
65515,53,15950,53,652,209,443,6,50,3,3
64618,53,55916,53,198,102,96,2,31,1,1
39039,443,46475,443,3159,1237,1922,14,19,8,6
47548,53,51360,53,168,78,90,2,30,1,1
34662,443,60147,443,50100,46087,4013,73,121,43,30
64995,53,33043,53,199,102,97,2,30,1,1
55771,80,55771,80,3538,701,2837,11,20,6,5
64711,53,23065,53,760,97,663,2,30,1,1
52132,55014,54625,55014,70,70,0,2,7,2,0
38112,443,61056,443,1053962,45604,1008358,1190,69,456,734
63796,60557,39305,60557,66,66,0,2,8,2,0
27005,1307,27385,1307,857,126,731,2,30,1,1
55652,443,55652,443,141647,19296,122351,203,55,102,101
58831,443,40650,443,9378,2858,6520,48,196,21,27
56847,36370,51543,36370,624,318,306,10,15,5,5
55245,443,9754,443,6799,1581,5218,27,25,14,13
49936,53,6002,53,216,110,106,2,31,1,1
48015,443,45822,443,19394,2961,16433,51,196,24,27
63815,11372,42999,11372,504,382,122,8,16,6,2
51269,36983,59727,36983,70,70,0,1,5,1,0
48982,53,28037,53,306,212,94,3,29,2,1
56945,53,29864,53,711,87,624,2,30,1,1
49243,53,19778,53,212,102,110,2,30,1,1
5588,5588,0,0,3498,1872,1626,48,195,24,24
40071,443,38223,443,7855,1850,6005,24,187,14,10
52572,80,52572,80,1680,696,984,11,142,6,5
52070,80,7371,80,362,240,122,7,25,5,2
56586,53,33852,53,177,94,83,2,31,1,1
51107,80,41417,80,8827,4961,3866,34,47,18,16
54660,443,15942,443,7077,3245,3832,24,173,12,12
49418,27015,20814,27015,249,78,171,2,30,1,1
42574,443,64198,443,130,70,60,3,5,2,1
49588,53,53938,53,733,94,639,2,29,1,1
47969,443,44705,443,10825,4667,6158,25,159,15,10
58020,80,7358,80,2482,516,1966,11,75,6,5
49850,53,15104,53,166,86,80,2,30,1,1
55934,53,0,0,86,86,0,1,30,1,0
53131,443,52675,443,33229,7810,25419,63,44,24,39
36533,443,27150,443,10488,4495,5993,38,32,20,18
42022,80,12678,80,31196,607,30589,29,500,5,24
56204,53,35079,53,190,97,93,2,31,1,1
49418,27015,44388,27015,71,71,0,1,30,1,0
53201,443,8091,443,3907,2251,1656,16,321,8,8
57082,80,34844,80,2944,1074,1870,12,75,7,5
60448,8106,52879,8106,3105,1298,1807,20,16,10,10
55061,443,38247,443,18682,8068,10614,42,62,22,20
50149,80,2917,80,11574,901,10673,20,46,11,9
49519,80,21026,80,2981,1514,1467,12,38,7,5
52106,41632,7529,41632,70,70,0,2,9,2,0
34353,53,34353,53,213,79,134,2,33,1,1
56887,53,53946,53,250,87,163,4,60,2,2
55962,53,28186,53,193,102,91,2,30,1,1
51102,443,49198,443,3402,1258,2144,13,135,6,7
38337,443,4269,443,499,425,74,4,1,3,1
64381,53,35709,53,168,86,82,2,32,1,1
53883,24830,60159,24830,164,70,94,2,5,1,1
45742,443,8175,443,8471,3275,5196,21,120,11,10
38534,443,44926,443,8918,730,8188,20,72,7,13
64793,53,25945,53,168,86,82,2,29,1,1
49532,53,13697,53,195,102,93,2,30,1,1
5571,80,5571,80,326,186,140,6,29,4,2
62184,443,42085,443,4283,2038,2245,14,135,7,7
57119,53,0,0,318,95,223,2,31,1,1
56421,53,23965,53,170,87,83,2,30,1,1
50522,443,53720,443,460,394,66,4,0,3,1
64582,53,64118,53,209,110,99,2,30,1,1
56622,53,51149,53,757,98,659,2,31,1,1
57275,53,65357,53,170,87,83,2,31,1,1
43464,443,26785,443,8198,656,7542,19,327,5,14
53663,17904,16406,17904,320,140,180,6,7,3,3
64979,53,23009,53,188,96,92,2,31,1,1
43405,443,52895,443,5977,1326,4651,18,30,11,7
59970,443,20638,443,7448,1347,6101,24,16,13,11
28557,53,28557,53,213,79,134,2,32,1,1
56863,53,37391,53,177,94,83,2,30,1,1
38118,443,46227,443,70,70,0,1,5,1,0
59291,53,59291,53,197,90,107,2,30,1,1
27005,52013,29857,52013,252,252,0,3,32,3,0
41925,443,48625,443,8333,2153,6180,31,100,18,13
49365,53,34232,53,199,94,105,2,31,1,1
65139,53,15314,53,216,110,106,2,30,1,1
56500,53,18802,53,775,103,672,2,31,1,1
49883,443,6647,443,17238,4435,12803,32,103,15,17
35710,443,47207,443,1053,566,487,10,31,6,4
57365,53,10039,53,780,104,676,2,31,1,1
53112,29258,11040,29258,70,70,0,2,8,2,0
65074,53,7213,53,227,94,133,2,29,1,1
56790,443,12015,443,8073,2053,6020,20,16,11,9
55582,53,34252,53,168,86,82,2,30,1,1
56979,53,50155,53,180,94,86,2,29,1,1
63071,443,65203,443,569,164,405,2,30,1,1
59560,443,54712,443,4038,1219,2819,22,135,9,13
80,34539,80,34539,1468,1468,0,1,5,1,0
63965,11785,30846,11785,66,66,0,1,5,1,0
56940,443,15296,443,4184,2787,1397,19,345,10,9
49480,53,59035,53,184,94,90,2,31,1,1
56242,53,30808,53,231,86,145,2,30,1,1
58907,443,50091,443,2976,1572,1404,17,17,9,8
49251,443,56131,443,15567,1944,13623,40,81,17,23
56573,443,64654,443,16205,6113,10092,36,110,20,16
55514,53,44502,53,783,96,687,2,30,1,1
60250,443,56947,443,12389,5180,7209,31,149,17,14
49310,53,61139,53,186,95,91,3,33,2,1
43600,443,57317,443,172272,14401,157871,254,418,100,154
52715,443,11256,443,26901,2286,24615,46,319,18,28
57326,443,3757,443,64382,9305,55077,101,123,41,60
42744,443,24894,443,224178,118713,105465,333,140,162,171
53768,19067,20998,19067,70,70,0,1,5,1,0
65496,53,6299,53,210,86,124,2,30,1,1
64017,53,52336,53,209,110,99,2,30,1,1
64877,53,41929,53,209,110,99,2,30,1,1
57221,443,19947,443,7306,2784,4522,22,202,12,10
9245,80,28513,80,378,192,186,7,26,4,3
44323,5228,8392,5228,7292,4509,2783,50,6392,25,25
57913,80,64220,80,6515,1210,5305,15,23,8,7
51954,443,51642,443,2995,1894,1101,20,46,11,9
123,123,23599,123,184,94,90,2,30,1,1
50287,80,60290,80,3325,607,2718,11,45,6,5
33418,443,42698,443,4764,1876,2888,22,81,10,12
56712,53,4358,53,177,94,83,2,30,1,1
64052,443,61598,443,4395,1673,2722,14,119,7,7
52968,80,9235,80,4004,1347,2657,29,114,15,14
37566,443,56010,443,214,140,74,4,15,3,1
56817,53,9899,53,772,103,669,2,30,1,1
49507,53,33142,53,177,94,83,2,30,1,1
58663,53,40233,53,167,78,89,2,30,1,1
54912,443,54912,443,4401,1494,2907,19,27,11,8
11901,443,11901,443,5599,2459,3140,23,29,14,9
53252,443,20191,443,6053,974,5079,20,66,10,10
56459,53,55165,53,392,86,306,2,30,1,1
56418,80,22380,80,39249,938,38311,40,104,11,29
22321,80,22321,80,490,264,226,8,26,5,3
56318,53,21992,53,183,94,89,2,29,1,1
55070,80,64489,80,246,120,126,5,16,3,2
49911,53,26669,53,258,110,148,2,30,1,1
57892,80,46739,80,6519,1210,5309,15,17,8,7
55669,53,38123,53,177,94,83,2,30,1,1
49527,53,19400,53,200,94,106,2,30,1,1
49333,443,11751,443,30571,1990,28581,53,80,21,32
52244,58774,22208,58774,70,70,0,2,6,2,0
53543,51819,43192,51819,70,70,0,2,7,2,0
56665,443,40335,443,8058,2038,6020,20,15,11,9
60644,5222,7350,5222,9852,2665,7187,60,360,25,35
50212,1688,56560,1688,70,70,0,2,8,2,0
52116,80,18216,80,422,240,182,8,26,5,3
54748,53,4076,53,245,110,135,2,30,1,1
64858,53,43430,53,211,102,109,2,30,1,1
44847,23628,55980,23628,509,150,359,2,1200,1,1
56344,53,27123,53,198,101,97,2,31,1,1
60494,33709,52651,33709,504,318,186,8,16,5,3
54196,80,31560,80,2640,540,2100,12,45,6,6
56260,53,30984,53,177,94,83,2,31,1,1
59556,443,25166,443,3888,1169,2719,13,136,6,7
49969,53,49918,53,198,101,97,2,31,1,1
57595,443,62180,443,291,171,120,4,16,2,2
43439,443,4737,443,13482,3731,9751,40,500,17,23
50938,80,32549,80,10272889,104948,10167941,8416,121,1525,6891
64417,53,47310,53,369,94,275,4,49,2,2
27005,27015,14590,27015,901,126,775,2,30,1,1
38676,443,23921,443,101056,3737,97319,107,15,35,72
57356,53,26396,53,199,102,97,2,30,1,1
49208,6881,5366,6881,66,66,0,1,5,1,0
56144,53,26768,53,180,94,86,2,30,1,1
56708,443,4344,443,8059,2039,6020,20,15,11,9
26940,53,26940,53,197,90,107,2,30,1,1
64789,443,4787,443,1786,172,1614,7,121,3,4
53452,443,10617,443,15368,8643,6725,36,49,19,17
56819,53,44720,53,209,110,99,2,29,1,1
42298,40007,6536,40007,148,86,62,2,30,1,1
46295,443,56188,443,7493,3793,3700,40,109,26,14
60188,443,15594,443,9811,1112,8699,21,125,10,11
55514,53,45295,53,779,86,693,2,29,1,1
56046,53,6511,53,193,102,91,2,31,1,1
64332,53,40499,53,167,86,81,2,30,1,1
51148,443,4211,443,4942,2409,2533,11,120,6,5
56472,53,13780,53,167,86,81,2,31,1,1
64797,53,6795,53,183,94,89,2,30,1,1
63964,53,35341,53,195,102,93,2,30,1,1
51274,24399,41569,24399,70,70,0,2,8,2,0
64332,53,56454,53,195,102,93,2,31,1,1
53751,443,64587,443,61501,14276,47225,91,35,39,52
49343,53,20254,53,478,106,372,4,48,2,2
58506,443,5356,443,2408,1399,1009,18,274,9,9
52002,34348,16658,34348,70,70,0,2,7,2,0
65441,80,26203,80,366,180,186,7,28,4,3
53835,15000,42611,15000,130,70,60,2,5,1,1
51943,53,57117,53,200,86,114,2,30,1,1
41325,443,52651,443,9669,2488,7181,26,149,11,15
49490,443,14327,443,9109,1943,7166,32,270,16,16
37567,443,51638,443,13774,4989,8785,35,51,20,15
42298,40031,8368,40031,157,94,63,2,30,1,1
59893,53,45221,53,198,93,105,2,30,1,1
42298,40007,25770,40007,206,84,122,4,29,2,2
45337,443,2595,443,2312,1382,930,19,24,11,8
65171,53,52756,53,194,94,100,2,29,1,1
30188,49786,29335,49786,502,150,352,2,1200,1,1
56163,53,9366,53,194,102,92,2,30,1,1
59131,53,59747,53,70,70,0,1,30,1,0
22013,53,22013,53,198,90,108,2,30,1,1
64739,53,35789,53,164,86,78,2,31,1,1
53245,443,58724,443,4595,1038,3557,19,69,11,8
52142,80,50942,80,246,120,126,5,32,3,2
50122,443,3201,443,15217,5689,9528,52,35,27,25
65279,53,56734,53,182,93,89,2,31,1,1
55984,53,2333,53,216,102,114,2,30,1,1
40050,53,42804,53,168,78,90,2,30,1,1
57043,53,5828,53,735,88,647,2,31,1,1
50630,53,37346,53,754,94,660,2,30,1,1
54350,443,24025,443,10318,2117,8201,38,371,19,19
56835,53,48670,53,177,94,83,2,30,1,1
56985,80,59526,80,214,140,74,4,35,3,1
37247,443,37247,443,4401,1494,2907,19,25,11,8
58931,443,42670,443,1413,876,537,12,28,6,6
55610,53,5256,53,822,102,720,2,29,1,1
56594,53,5143,53,173,94,79,2,30,1,1
51880,8001,9632,8001,86,86,0,1,30,1,0
64128,53,37051,53,193,102,91,2,30,1,1
37179,443,24898,443,7440,3165,4275,31,358,17,14
49395,53,40831,53,390,111,279,4,53,2,2
51966,18716,12930,18716,70,70,0,2,8,2,0
30960,45724,8617,45724,330,330,0,6,3609,6,0
50438,53,15254,53,296,101,195,4,31,2,2
52010,443,6265,443,7722,2568,5154,26,63,15,11
26900,27017,23136,27017,422,164,258,6,29,3,3
27005,27016,25389,27016,1006,252,754,4,32,3,1
54279,443,54279,443,4699,1792,2907,19,28,11,8
50265,31240,10906,31240,726,726,0,12,1200,12,0
65251,53,39893,53,179,94,85,2,31,1,1
55759,53,35937,53,177,94,83,2,30,1,1
34053,443,6934,443,5987,1678,4309,21,199,12,9
50904,80,18118,80,12289218,202774,12086444,11470,149,2789,8681
50464,80,5838,80,26020,2247,23773,47,18,23,24
52965,443,12004,443,8602,1050,7552,16,120,7,9
50130,53,12691,53,183,94,89,2,29,1,1
65451,53,3084,53,728,234,494,6,67,3,3
28040,443,50475,443,5578,1390,4188,19,15,9,10
49496,53,24067,53,194,102,92,2,30,1,1
57342,53,19842,53,167,86,81,2,30,1,1
37965,6881,46281,6881,479,150,329,2,1199,1,1
53654,8100,50250,8100,70,70,0,1,5,1,0
63712,21917,18745,21917,504,382,122,8,15,6,2
41657,443,13161,443,122547,6414,116133,160,81,61,99
64902,53,48255,53,762,98,664,2,30,1,1
64915,53,11027,53,177,94,83,2,30,1,1
26900,27017,1081,27017,422,164,258,6,29,3,3
49256,53,15315,53,212,102,110,2,30,1,1
53862,36120,51667,36120,2254,1281,973,17,17,10,7
60807,443,39155,443,9127,2506,6621,38,146,20,18
62461,443,18805,443,14832,3978,10854,32,34,15,17
59534,53,0,0,216,72,144,2,30,1,1
45540,8100,25472,8100,234,234,0,4,12,4,0
64771,53,10938,53,228,110,118,2,30,1,1
56260,53,6502,53,177,94,83,2,30,1,1
55678,53,49821,53,270,88,182,4,54,2,2
60287,53,28366,53,168,78,90,2,29,1,1
61669,443,27122,443,12453,3460,8993,43,18,24,19
54836,443,5754,443,119863,100823,19040,322,229,183,139
57301,53,42748,53,177,94,83,2,29,1,1
33871,443,48273,443,11277,2233,9044,43,215,20,23
52514,80,52514,80,1916,1467,449,10,19,6,4
64200,53,60467,53,186,95,91,2,30,1,1
64611,53,9832,53,181,94,87,2,29,1,1
65372,53,40284,53,198,102,96,2,30,1,1
59964,443,8853,443,166170,5611,160559,189,16,78,111
49693,443,16419,443,12060,4857,7203,25,71,14,11
56005,53,33914,53,199,102,97,2,29,1,1
43895,443,52101,443,1442,721,721,15,199,8,7
58983,53,44611,53,168,78,90,2,29,1,1
45141,443,63115,443,4497,2208,2289,15,137,7,8
60498,55100,54000,55100,164,70,94,2,5,1,1
49838,53,33413,53,183,94,89,2,30,1,1
54553,443,44028,443,68345,58488,9857,122,329,62,60
53700,45682,9190,45682,492,306,186,8,15,5,3
40781,443,52827,443,448,78,370,7,20,2,5
50450,53,51972,53,209,110,99,2,30,1,1
55902,53,57612,53,181,94,87,2,30,1,1
56272,53,49117,53,235,86,149,2,30,1,1
56313,443,7717,443,37465,18615,18850,299,588,135,164
9099,443,46908,443,6677,1097,5580,21,25,11,10
49882,443,5946,443,5019,1424,3595,15,87,9,6
52758,80,33293,80,1746,980,766,15,151,8,7
25,63566,25,63566,102,102,0,1,5,1,0
58990,53,6423,53,168,78,90,2,30,1,1
44061,443,59659,443,8551,1685,6866,24,170,12,12
56414,53,14395,53,178,94,84,2,30,1,1
38691,443,60473,443,90369,3417,86952,95,15,30,65
57220,53,51033,53,701,88,613,2,30,1,1
49906,53,24653,53,200,94,106,2,29,1,1
9163,443,23024,443,5658,501,5157,14,15,7,7
49684,53,21165,53,305,94,211,2,29,1,1
51163,443,48007,443,9466,2602,6864,41,185,20,21
55321,53,21988,53,193,102,91,2,31,1,1
65440,53,49659,53,181,94,87,2,30,1,1
57364,53,64164,53,177,94,83,2,30,1,1
49900,4500,63369,4500,78,78,0,1,5,1,0
37608,443,50721,443,7866,2680,5186,26,16,14,12
60026,443,38651,443,3643,607,3036,13,120,6,7
0,0,0,0,320,320,0,5,0,5,0
38280,80,34023,80,748,459,289,8,254,5,3
59654,53,16319,53,199,94,105,2,30,1,1
56115,53,18486,53,167,86,81,2,30,1,1
57038,53,18909,53,194,102,92,2,33,1,1
27005,27016,54195,27016,876,126,750,2,30,1,1
9373,80,65080,80,1643,485,1158,10,15,5,5
55828,53,29834,53,181,94,87,2,31,1,1
52241,51717,30281,51717,70,70,0,2,5,2,0
54823,53,13813,53,198,93,105,2,30,1,1
53734,22051,14778,22051,70,70,0,1,5,1,0
57057,53,25166,53,194,102,92,2,30,1,1
5786,53,5786,53,213,87,126,2,31,1,1
37350,53,37350,53,213,87,126,2,30,1,1
55596,53,2008,53,177,94,83,2,29,1,1
52194,443,33437,443,9075,3727,5348,38,50,18,20
49723,53,39151,53,427,90,337,4,41,2,2
65446,53,21925,53,210,110,100,2,30,1,1
49247,53,56867,53,478,196,282,6,63,3,3
57470,62348,3608,62348,149,149,0,1,1200,1,0
45549,443,52830,443,7951,1449,6502,22,125,12,10
49620,443,22598,443,4565,3479,1086,13,138,8,5
1831,53,1831,53,194,87,107,2,30,1,1
56940,443,47279,443,5147,2613,2534,19,137,10,9
49241,443,49241,443,31778,6075,25703,54,49,28,26
47668,443,3195,443,69732,65832,3900,104,316,55,49
123,123,52430,123,184,94,90,2,30,1,1
55179,53,7582,53,194,102,92,2,33,1,1
26900,27017,37776,27017,422,164,258,6,30,3,3
55786,53,43858,53,177,94,83,2,31,1,1
53687,19010,53687,19010,64,64,0,1,30,1,0
65341,53,36456,53,200,102,98,2,31,1,1
55415,53,34000,53,182,93,89,2,31,1,1
64312,53,19518,53,209,110,99,2,30,1,1
56200,53,10019,53,211,110,101,2,30,1,1
64670,53,24174,53,193,102,91,2,30,1,1
57470,64108,16646,64108,330,330,0,6,1199,6,0
64487,53,6176,53,225,110,115,2,30,1,1
65492,53,51377,53,707,94,613,2,29,1,1
46863,15000,49470,15000,130,70,60,2,5,1,1
55236,443,64536,443,10293,2881,7412,25,45,14,11
56169,53,53942,53,210,110,100,2,30,1,1
60472,20273,4062,20273,70,70,0,1,5,1,0
56757,53,30520,53,167,86,81,2,31,1,1
34355,80,5779,80,416,210,206,7,15,4,3
50332,80,8939,80,5517,2843,2674,19,47,10,9
8998,53,50504,53,225,78,147,2,29,1,1
61836,443,61836,443,132180,4407,127773,146,75,51,95
56215,53,9049,53,165,86,79,2,30,1,1
49012,443,59626,443,44584,2838,41746,66,31,31,35
54321,27015,6955,27015,924,924,0,3,30,3,0
46155,443,27543,443,206090,6478,199612,211,170,69,142
64444,53,57791,53,183,94,89,2,29,1,1
65287,53,32403,53,222,86,136,2,30,1,1
64294,53,36421,53,329,118,211,2,30,1,1
49667,443,39894,443,8329,2188,6141,29,100,16,13
55469,53,31769,53,193,102,91,2,30,1,1
50265,43974,25412,43974,132,132,0,3,1200,3,0
35905,443,10061,443,8272,2091,6181,25,331,12,13
18331,53,15455,53,376,94,282,2,30,1,1
60904,443,17681,443,2356,1309,1047,16,31,9,7
64982,53,19403,53,190,97,93,2,31,1,1
47196,443,63403,443,2701330,44089,2657241,2230,134,296,1934
56279,443,57070,443,97608,4852,92756,108,121,37,71
49328,443,21805,443,74569,3173,71396,97,80,36,61
43864,443,38853,443,4922,2860,2062,25,39,14,11
56592,53,8567,53,262,94,168,2,30,1,1
52026,12523,4758,12523,70,70,0,1,4,1,0
55226,443,25011,443,711879,19394,692485,724,98,238,486
55125,53,57865,53,177,94,83,2,29,1,1
57046,53,24095,53,234,94,140,2,29,1,1
34416,443,60300,443,10255,2803,7452,35,26,18,17
56661,443,57675,443,334,70,264,5,17,1,4
61665,443,16320,443,6279,1859,4420,25,16,14,11
64681,443,43290,443,2924,653,2271,13,135,6,7
48768,443,48768,443,4398,1491,2907,19,27,11,8
58890,80,3070,80,1883,1448,435,11,16,6,5
0,0,0,0,480,244,236,4,0,2,2
56322,53,7412,53,202,103,99,2,31,1,1
53227,443,7377,443,16336,3219,13117,46,59,21,25
57867,27019,34880,27019,468,390,78,5,30,4,1
49418,27015,48509,27015,266,71,195,2,31,1,1
49825,53,46479,53,793,101,692,2,30,1,1
41790,443,64093,443,2350,1392,958,17,275,9,8
39572,443,50194,443,64247,3857,60390,94,30,43,51
52607,80,12616,80,2543,691,1852,13,30,8,5
65417,53,31307,53,183,94,89,2,30,1,1
65003,53,32396,53,94,94,0,1,30,1,0
49418,27016,45260,27016,255,78,177,2,30,1,1
9074,443,22062,443,318,192,126,6,29,4,2
62188,443,50318,443,6973,2413,4560,22,148,11,11
49195,53,13959,53,239,110,129,2,30,1,1
56948,443,19472,443,5601,1203,4398,14,59,9,5
64941,53,17276,53,199,102,97,2,30,1,1
50411,8080,50411,8080,1626,798,828,11,61,6,5
49918,443,5366,443,3291,1714,1577,18,16,11,7
62962,443,7055,443,5036,2564,2472,15,125,8,7
56571,53,30480,53,749,94,655,2,31,1,1
50800,443,31236,443,7067,1129,5938,19,141,9,10
65129,53,16453,53,324,110,214,2,30,1,1
60870,443,18926,443,8219,2676,5543,40,15,24,16
48020,443,61756,443,33481,5635,27846,73,287,32,41
27005,31000,35910,31000,898,126,772,2,31,1,1
56636,53,34067,53,168,86,82,2,30,1,1
53460,443,49234,443,6118,5698,420,12,124,6,6
14694,53,14694,53,230,90,140,2,30,1,1
50475,443,44824,443,3893,1910,1983,36,255,17,19
46872,80,56165,80,29218,27458,1760,36,22,24,12
48608,443,46175,443,6371,848,5523,20,16,11,9
50803,443,40558,443,1590,1038,552,12,48,6,6
59360,53,6794,53,429,116,313,2,31,1,1
64162,53,51950,53,255,118,137,2,29,1,1
57886,80,60119,80,6526,1210,5316,15,17,8,7
51884,22828,5463,22828,70,70,0,2,8,2,0
5380,53,15988,53,377,94,283,2,30,1,1
59012,443,51105,443,6278,3531,2747,23,122,12,11
27005,30009,16373,30009,889,126,763,2,31,1,1
57300,53,43157,53,184,94,90,2,30,1,1
35796,443,15213,443,664348,23858,640490,757,119,292,465
43495,5223,36493,5223,142,142,0,1,4,1,0
56556,53,58365,53,184,94,90,2,31,1,1
37557,443,30973,443,9824,2477,7347,27,37,16,11
44847,58839,4824,58839,501,150,351,2,1200,1,1
55034,443,55034,443,154907,10748,144159,217,20,101,116
49464,443,43565,443,4555,2472,2083,20,119,11,9
55159,53,29512,53,200,102,98,2,30,1,1
65321,53,29738,53,166,85,81,2,30,1,1
46123,443,37747,443,5161,3826,1335,16,137,9,7
55123,53,57840,53,198,102,96,2,31,1,1
40603,80,57176,80,1104,475,629,10,15,6,4
52102,80,29370,80,22495,1895,20600,33,27,15,18
46989,80,46989,80,82082,3212,78870,90,155,27,63
52013,443,52013,443,43964,6675,37289,60,49,25,35
49293,53,58522,53,172,88,84,2,31,1,1
51605,443,22416,443,2013,1363,650,12,134,7,5
49859,443,46970,443,18811,1868,16943,22,142,7,15
53121,443,47087,443,36181,3264,32917,51,62,24,27
27005,1201,20493,1201,867,126,741,2,30,1,1
45601,443,27195,443,5378,984,4394,18,17,10,8
63383,53,63383,53,235,90,145,2,33,1,1
49708,53,50223,53,193,102,91,2,30,1,1
58743,443,4487,443,5167,700,4467,16,15,7,9
65251,53,45927,53,183,98,85,3,31,2,1
49811,53,52504,53,300,118,182,2,29,1,1
56766,53,19363,53,210,110,100,2,30,1,1
53047,443,44730,443,13229,3527,9702,56,91,28,28
50674,443,55479,443,8709,1708,7001,22,19,11,11
64117,53,35902,53,350,94,256,2,29,1,1
55690,53,56846,53,182,93,89,2,30,1,1
64774,53,37147,53,214,102,112,2,29,1,1
30960,45656,54549,45656,66,66,0,1,3600,1,0
65229,53,46914,53,193,102,91,2,30,1,1
56487,53,29660,53,778,103,675,2,31,1,1
64718,53,52565,53,781,94,687,2,30,1,1
37536,80,9440,80,3565,1020,2545,16,15,9,7
56544,53,54094,53,224,102,122,2,30,1,1
15503,21394,46725,21394,479,150,329,2,1200,1,1
64065,53,56733,53,264,94,170,2,29,1,1
36109,443,56907,443,26538,7971,18567,70,128,38,32
57917,6789,34924,6789,8164,1336,6828,34,18,18,16
50829,443,2487,443,1445207,43930,1401277,1562,219,556,1006
60380,443,29465,443,70,70,0,1,5,1,0
56022,53,29566,53,728,102,626,2,30,1,1
50317,443,44223,443,13565,6019,7546,35,112,19,16
56115,53,48441,53,278,96,182,4,54,2,2
64041,53,11407,53,200,102,98,2,31,1,1
60414,52559,6876,52559,70,70,0,1,5,1,0
51739,62163,31026,62163,70,70,0,2,8,2,0
64706,53,11232,53,179,94,85,2,29,1,1
9186,80,65016,80,17643,1063,16580,26,35,11,15
61860,10443,7961,10443,10811,2571,8240,27,48,15,12
58738,443,24230,443,12382,9652,2730,43,58,26,17
50212,1688,47539,1688,70,70,0,1,5,1,0
46318,443,20839,443,6373,1744,4629,22,15,13,9
43162,443,31273,443,10096,3002,7094,25,16,13,12
44361,443,44674,443,424,210,214,7,132,4,3
55763,8060,47887,8060,70,70,0,1,5,1,0
52469,443,22069,443,29896,14149,15747,61,209,35,26
56567,53,47104,53,701,88,613,2,30,1,1
51485,443,20455,443,828,390,438,11,40,4,7
60466,64337,26945,64337,70,70,0,1,5,1,0
63617,53,24659,53,299,102,197,2,30,1,1
64787,53,29856,53,728,102,626,2,30,1,1
56764,45797,41990,45797,164,70,94,2,5,1,1
65028,53,59262,53,183,94,89,2,31,1,1
55321,443,9589,443,9462,2297,7165,23,15,13,10
41577,53,41577,53,265,111,154,2,0,1,1
49620,80,21542,80,318,192,126,6,42,4,2
49985,53,61904,53,312,90,222,2,31,1,1
51651,53,58120,53,237,86,151,2,29,1,1
55126,53,57162,53,177,94,83,2,30,1,1
15792,3478,30536,3478,428935914,213443641,215492273,635946,2242,308738,327208
49352,53,48466,53,214,94,120,2,30,1,1
51582,5223,65291,5223,4183,1283,2900,23,163,13,10
50899,80,61517,80,130,70,60,2,15,1,1
51407,443,40522,443,25490,8419,17071,54,48,30,24
56932,80,33047,80,8325,5642,2683,16,28,9,7
35804,443,35654,443,232,172,60,3,5,2,1
59819,443,17243,443,1401,864,537,12,29,6,6
55085,443,57915,443,5803,4960,843,19,124,11,8
63882,49163,63411,49163,66,66,0,2,8,2,0
50428,443,6305,443,4356,806,3550,14,15,7,7
57098,53,51101,53,229,94,135,2,30,1,1
50667,80,50667,80,15686,1227,14459,24,20,11,13
58039,80,32642,80,318,192,126,6,21,4,2
35628,443,42437,443,7840,1829,6011,24,85,14,10
50850,443,34368,443,6341,1382,4959,19,132,9,10
49621,53,6731,53,501,188,313,6,33,3,3
49793,53,43171,53,718,94,624,2,30,1,1
56420,80,57757,80,34636,928,33708,37,104,11,26
50717,80,28545,80,1649,963,686,7,15,5,2
59000,443,15029,443,6362,1745,4617,25,18,13,12
49504,7275,25597,7275,8962,1625,7337,28,16,15,13
32804,80,61447,80,7454,2436,5018,26,23,16,10
53896,48027,7654,48027,70,70,0,2,8,2,0
27005,27015,56758,27015,869,126,743,2,30,1,1
42298,40014,10112,40014,140,78,62,2,31,1,1
42158,443,61169,443,6865,3366,3499,39,206,15,24
55155,53,1843,53,183,94,89,2,30,1,1
52944,443,11890,443,58499,47163,11336,106,115,59,47
28391,80,28391,80,12237,2818,9419,27,26,14,13
55275,53,41187,53,770,101,669,2,30,1,1
52207,4637,29875,4637,136,136,0,3,14,3,0
26900,27017,50857,27017,254,82,172,4,30,2,2
50426,53,23864,53,760,97,663,2,30,1,1
49418,27015,35776,27015,78,78,0,1,29,1,0
41156,53,41156,53,216,82,134,2,31,1,1
56622,53,24570,53,179,94,85,2,30,1,1
52624,443,65468,443,5837,1982,3855,19,19,11,8
36008,443,16915,443,5378,1423,3955,19,56,11,8
45032,53,45032,53,216,82,134,2,33,1,1
55026,443,39326,443,3591,1906,1685,22,80,11,11
55826,53,22161,53,168,86,82,2,30,1,1
56572,53,50763,53,438,180,258,6,30,3,3
53219,443,33001,443,6058,1038,5020,20,66,11,9
49400,80,14888,80,40119,2475,37644,49,84,16,33
0,0,0,0,320,320,0,5,0,5,0
50312,80,15679,80,17102,1099,16003,19,16,5,14
56289,53,51620,53,749,89,660,2,30,1,1
56052,53,19569,53,177,94,83,2,30,1,1
57371,53,64674,53,214,110,104,2,30,1,1
48834,443,52235,443,655052,13866,641186,599,31,150,449
50031,53,6210,53,181,94,87,2,30,1,1
64820,53,31810,53,195,102,93,2,30,1,1
49638,53,20349,53,210,110,100,2,30,1,1
49317,53,61249,53,164,84,80,2,31,1,1
53737,443,33568,443,12192,3674,8518,53,454,26,27
42881,443,61289,443,28707,2793,25914,58,115,29,29
59214,443,59214,443,27659,5508,22151,59,47,31,28
56645,443,24912,443,37030,24937,12093,83,1286,30,53
49643,443,30041,443,1640,1089,551,14,15,8,6
33359,443,23934,443,9818,2036,7782,28,31,12,16
51112,80,46143,80,2433,1280,1153,11,20,7,4
38370,443,49097,443,9194,5026,4168,24,32,11,13
49780,53,34638,53,183,94,89,2,29,1,1
65142,53,52775,53,167,86,81,2,29,1,1
55925,80,55925,80,450,246,204,8,28,5,3
51846,41510,18249,41510,70,70,0,2,8,2,0
35752,80,35752,80,871846,24071,847775,900,30,326,574
49209,53,48140,53,199,102,97,2,31,1,1
49890,53,63142,53,767,102,665,2,30,1,1
42298,40008,65439,40008,140,78,62,2,30,1,1
55154,53,33060,53,184,94,90,2,30,1,1
55441,53,33231,53,216,110,106,2,30,1,1
51826,443,55412,443,682,370,312,12,32,7,5
2267,53,19148,53,826,826,0,8,44,8,0
53905,50130,9021,50130,552,306,246,9,16,5,4
52007,37732,20807,37732,70,70,0,1,4,1,0
41459,80,32156,80,1866,1032,834,11,150,6,5
57578,80,57578,80,55886,2728,53158,68,148,25,43
32877,443,56293,443,5701,1585,4116,23,1102,13,10
49858,53,34344,53,177,94,83,2,30,1,1
56582,53,23626,53,711,87,624,2,31,1,1
53375,53,19528,53,298,86,212,2,30,1,1
49773,53,20298,53,994,86,908,2,30,1,1
65075,53,30736,53,278,100,178,4,30,2,2
56019,53,28168,53,194,102,92,2,31,1,1
55559,53,59475,53,182,94,88,2,30,1,1
12299,53,12299,53,229,89,140,2,30,1,1
55958,53,32998,53,177,94,83,2,30,1,1
56045,53,44616,53,754,94,660,2,31,1,1
56041,53,26244,53,179,94,85,2,30,1,1
65143,53,4098,53,184,94,90,2,31,1,1
56160,53,39836,53,195,102,93,2,30,1,1
60498,55100,34970,55100,258,70,188,4,8,2,2
59841,80,53537,80,711697,18422,693275,716,50,253,463
55836,53,17348,53,177,94,83,2,30,1,1
27005,27017,41161,27017,883,126,757,2,30,1,1
58922,443,2924,443,14553,9653,4900,38,19,22,16
50584,6889,8974,6889,166,166,0,1,1200,1,0
51875,25072,3449,25072,70,70,0,1,5,1,0
51466,443,58507,443,7638,1758,5880,24,17,13,11
57368,443,57368,443,4401,1494,2907,19,28,11,8
43677,443,54935,443,30090,19982,10108,77,543,41,36
50607,80,15942,80,1657,1247,410,8,14,5,3
48098,80,19717,80,1638,1324,314,10,15,5,5
15503,63093,6070,63093,481,150,331,2,1200,1,1
34428,443,49184,443,21512,4620,16892,22,127,8,14
63965,11785,23827,11785,66,66,0,2,8,2,0
56439,53,35642,53,198,102,96,2,31,1,1
55290,53,19726,53,198,94,104,2,30,1,1
64181,53,43777,53,194,102,92,2,30,1,1
50977,80,13754,80,45483,4137,41346,68,21,36,32
58936,443,47053,443,9081,3368,5713,42,76,24,18
47091,443,36299,443,6326,4367,1959,31,144,17,14
49290,53,14935,53,184,94,90,2,31,1,1
56330,53,48273,53,199,102,97,2,30,1,1
51843,80,51843,80,35384,3225,32159,49,26,20,29
46569,443,56973,443,6409,984,5425,21,360,11,10
53955,3290,25446,3290,70,70,0,1,5,1,0
57470,24874,7043,24874,132,132,0,3,1199,3,0
41593,53,64892,53,243,86,157,2,29,1,1
49769,443,60646,443,14166,2015,12151,27,127,11,16
60333,443,9820,443,8945,5766,3179,30,130,18,12
51398,53,51398,53,197,90,107,2,30,1,1
60751,20010,54269,20010,70,70,0,2,8,2,0
61416,80,26249,80,2366,764,1602,10,137,5,5
49460,53,64925,53,458,188,270,6,30,3,3
55711,53,17367,53,177,94,83,2,30,1,1
56853,53,24934,53,167,86,81,2,29,1,1
51986,80,3605,80,1274,694,580,13,16,6,7
53848,443,21534,443,7015200,135026,6880174,6063,438,1252,4811
49237,80,10310,80,1934086,60476,1873610,1754,162,493,1261
57367,443,57367,443,4381,1474,2907,19,29,11,8
49569,53,19473,53,198,102,96,2,30,1,1
27005,30007,42736,30007,890,126,764,2,31,1,1
49242,53,38872,53,167,86,81,2,29,1,1
64602,53,26542,53,185,102,83,2,30,1,1
34994,443,34994,443,5046,2069,2977,20,15,11,9
57089,53,62761,53,226,110,116,2,30,1,1
56644,80,27121,80,234,234,0,4,12,4,0
60432,80,60432,80,19915,764,19151,23,16,7,16
49214,58485,53751,58485,70,70,0,2,8,2,0
50655,80,3910,80,1507,682,825,13,20,8,5
49202,53,57613,53,226,86,140,2,30,1,1
48381,53,16694,53,221,75,146,2,30,1,1
53831,54676,36346,54676,492,306,186,8,16,5,3
50561,80,19741,80,318,192,126,6,26,4,2
64587,53,28928,53,166,85,81,2,30,1,1
49178,53,17300,53,348,105,243,4,45,2,2
57880,53,57880,53,231,97,134,2,30,1,1
60872,443,25312,443,27204,15677,11527,59,62,30,29
8978,53,8978,53,1415,689,726,3,30,2,1
51861,80,40570,80,366,240,126,7,31,5,2
38891,80,9037,80,5491,2690,2801,13,15,7,6
53232,443,62934,443,102629,3555,99074,114,58,40,74
64559,53,29849,53,198,110,88,2,30,1,1
52146,18174,42084,18174,70,70,0,2,7,2,0
37711,443,32947,443,8060,2166,5894,23,255,12,11
44901,443,19443,443,11891,6219,5672,35,174,16,19
61674,443,44305,443,6117,1224,4893,21,50,12,9
53662,55043,16806,55043,320,140,180,6,6,3,3
36851,53,52640,53,404,261,143,3,30,2,1
56561,53,63189,53,167,86,81,2,30,1,1
50406,8080,50406,8080,47078,2874,44204,66,51,32,34
55178,80,55178,80,374,240,134,7,15,5,2
34768,443,18480,443,11605,6867,4738,29,256,17,12
50086,80,23658,80,3148,687,2461,12,15,7,5
51947,443,7702,443,3893,2046,1847,29,56,16,13
27005,27015,32214,27015,878,126,752,2,30,1,1
59715,443,21725,443,3420,983,2437,15,121,7,8
48892,443,58975,443,740,210,530,12,110,4,8
57986,80,48652,80,1056,682,374,10,15,6,4
65315,53,30606,53,216,110,106,2,30,1,1
51991,80,57002,80,482,300,182,9,25,6,3
50223,53,39269,53,165,86,79,2,30,1,1
50462,53,31547,53,299,94,205,2,30,1,1
58056,443,35080,443,10493,2658,7835,50,1469,26,24
60766,28080,32813,28080,70,70,0,1,5,1,0
57335,8631,57083,8631,742,298,444,11,16,5,6
55414,443,59075,443,6053,4104,1949,31,84,17,14
47357,443,6177,443,153,93,60,2,5,1,1
27005,27016,13972,27016,1656,126,1530,4,30,2,2
51949,80,39415,80,5106,766,4340,16,45,9,7
55066,53,23255,53,180,94,86,2,31,1,1
52138,25621,21857,25621,70,70,0,1,5,1,0
60546,443,51628,443,52666,33941,18725,95,139,49,46
56007,53,3946,53,99,99,0,1,30,1,0
64020,53,44407,53,192,98,94,2,31,1,1
51263,443,3091,443,8247,2116,6131,23,360,11,12
19473,35726,44271,35726,481,150,331,2,1200,1,1
57136,53,36933,53,209,110,99,2,31,1,1
57013,53,17393,53,178,94,84,2,30,1,1
58888,15000,44683,15000,138,78,60,2,5,1,1
64092,14447,3904,14447,66,66,0,2,8,2,0
50210,80,7597,80,1277,460,817,16,71,5,11
56322,53,19434,53,166,86,80,2,30,1,1
54221,443,30528,443,499,425,74,4,0,3,1
52092,48658,51084,48658,316,136,180,6,7,3,3
39583,53,11422,53,86,86,0,1,30,1,0
55429,53,31053,53,182,102,80,2,30,1,1
55907,53,18391,53,184,94,90,2,31,1,1
50523,53,46429,53,376,78,298,2,31,1,1
57436,53,31842,53,182,93,89,2,30,1,1
63998,53,51868,53,263,126,137,2,30,1,1
60346,80,8391,80,2124,1158,966,13,87,7,6
52003,18150,42315,18150,70,70,0,2,7,2,0
58638,5900,58638,5900,62,62,0,1,5,1,0
65274,53,10401,53,295,101,194,4,32,2,2
49986,443,61933,443,25918,2247,23671,53,124,26,27
54215,443,45620,443,499,425,74,4,0,3,1
35702,443,5840,443,6751,1889,4862,24,316,13,11
23397,53,23397,53,234,93,141,2,30,1,1
55071,53,33464,53,177,94,83,2,31,1,1
55293,53,52510,53,230,110,120,2,30,1,1
40159,53,40159,53,229,89,140,2,31,1,1
59157,443,21885,443,7139,3570,3569,22,166,11,11
49276,53,23238,53,199,102,97,2,29,1,1
58575,443,10441,443,6453,1742,4711,20,17,10,10
58638,5900,58638,5900,130,66,64,2,4,1,1
64937,53,47101,53,210,110,100,2,30,1,1
58034,443,53963,443,10192,3621,6571,24,36,12,12
57109,443,58630,443,7170,1436,5734,35,261,19,16
60874,443,2065,443,777438,37182,740256,940,64,407,533
49792,443,3776,443,6089,799,5290,16,126,8,8
34396,443,45872,443,6214,1750,4464,24,316,12,12
60209,443,58823,443,26423,2338,24085,50,152,24,26
63729,6969,55353,6969,66,66,0,2,8,2,0
50584,38496,45984,38496,166,166,0,1,1200,1,0
43477,443,38784,443,20739,7254,13485,97,734,44,53
59830,443,56581,443,82533,15815,66718,124,131,50,74
57334,443,4953,443,11347,2434,8913,28,62,15,13
6881,50321,43265,50321,238,118,120,2,1199,1,1
37965,46994,50866,46994,4089,2456,1633,53,1773,31,22
50089,53,38993,53,752,93,659,2,31,1,1
64072,53,31241,53,292,110,182,2,30,1,1
52035,80,21577,80,426,240,186,8,24,5,3
56656,53,40908,53,255,88,167,4,53,2,2
45426,80,3986,80,416,210,206,7,28,4,3
54986,53,42487,53,214,110,104,2,30,1,1
53795,22719,37217,22719,258,70,188,4,8,2,2
41173,443,28924,443,11771,2624,9147,50,19,25,25
60952,443,35261,443,391561,17125,374436,478,17,213,265
26459,80,26459,80,490,264,226,8,32,5,3
65126,53,19594,53,216,94,122,2,30,1,1
56792,443,43093,443,8074,2054,6020,20,15,11,9
57071,443,54499,443,20873,8800,12073,68,19,37,31
56402,53,29838,53,322,134,188,2,30,1,1
49263,53,22784,53,172,88,84,2,31,1,1
65264,53,54273,53,88,88,0,1,30,1,0
50092,80,20230,80,11297,8141,3156,52,508,34,18
57470,1930,53151,1930,858,858,0,14,1199,14,0
53138,15048,61968,15048,70,70,0,2,7,2,0
56353,443,16805,443,3775,1791,1984,24,203,12,12
38785,443,33251,443,5206,3832,1374,23,25,13,10
49988,443,8213,443,642,582,60,2,5,1,1
57048,53,62627,53,512,95,417,4,34,2,2
49175,53,59846,53,186,95,91,2,30,1,1
64357,53,31050,53,183,94,89,2,29,1,1
27988,40001,35761,40001,148,86,62,2,30,1,1
53521,443,20457,443,280,140,140,5,129,3,2
49396,53,21722,53,177,94,83,2,30,1,1
33965,443,58848,443,31008,10449,20559,69,130,31,38
50621,443,42624,443,10905,4352,6553,30,18,18,12
56998,53,8754,53,170,87,83,2,31,1,1
51829,80,1041,80,1484,928,556,13,76,8,5
56738,53,8511,53,264,87,177,4,37,2,2
34331,443,8773,443,1717,1153,564,13,26,7,6
50680,443,16561,443,7066,1129,5937,19,172,9,10
39350,3389,39350,3389,3910,1805,2105,20,18,12,8
4683,53,49166,53,207,86,121,2,30,1,1
53932,27258,15001,27258,70,70,0,2,7,2,0
65082,53,42896,53,305,94,211,4,35,2,2
50465,80,50465,80,202622,12371,190251,264,22,132,132
49981,53,37329,53,438,180,258,6,30,3,3
46673,80,11851,80,1151,711,440,10,15,5,5
51842,80,51842,80,407760,15074,392686,424,25,154,270
38504,443,56099,443,2227,1018,1209,17,15,8,9
41024,443,41024,443,4639,1732,2907,19,30,11,8
65075,53,49710,53,278,100,178,4,30,2,2
53880,61393,8542,61393,320,140,180,6,6,3,3
64215,53,28280,53,196,94,102,2,30,1,1
40784,443,40784,443,4378,1471,2907,19,25,11,8
49972,53,6023,53,314,94,220,4,31,2,2
53760,443,58528,443,13059,3730,9329,73,3729,32,41
56180,53,56180,53,229,98,131,2,30,1,1
62825,443,8189,443,17772,2595,15177,25,122,12,13
56678,443,37527,443,4099,2450,1649,36,2615,19,17
50584,6881,41717,6881,1357,369,988,6,1200,3,3
49458,53,15275,53,280,94,186,2,30,1,1
51090,53,42988,53,164,78,86,2,30,1,1
45602,443,17240,443,4417,3084,1333,17,361,9,8
56375,80,51111,80,1609,919,690,15,72,8,7
57006,53,15142,53,819,102,717,2,30,1,1
44546,53,44546,53,204,92,112,2,30,1,1
56967,443,1130,443,9222,3148,6074,26,91,14,12
65395,53,34335,53,754,94,660,2,30,1,1
58267,443,58267,443,4674,1767,2907,19,26,11,8
58018,443,65091,443,8828,2193,6635,38,99,17,21
40682,443,13381,443,10010,4051,5959,32,346,17,15
57470,6881,12266,6881,453,251,202,4,1199,2,2
27005,27016,44876,27016,887,126,761,2,30,1,1
51911,80,54033,80,5474,1920,3554,20,65,12,8
64251,53,6102,53,177,94,83,2,30,1,1
55204,53,55204,53,239,98,141,2,30,1,1
0,0,0,0,600,306,294,6,0,3,3
64703,53,15968,53,314,92,222,4,31,2,2
58900,443,22833,443,8547,5209,3338,30,19,15,15
27005,27214,50051,27214,876,126,750,2,29,1,1
60281,443,39585,443,63696,4774,58922,83,125,32,51
57311,53,52829,53,768,99,669,2,31,1,1
44836,443,51394,443,34881,6721,28160,62,46,30,32
49547,443,35951,443,1346,918,428,10,23,6,4
56110,80,5106,80,31087,1654,29433,42,16,18,24
65330,53,32414,53,733,94,639,2,30,1,1
6881,43642,35387,43642,150,150,0,1,1201,1,0
53870,24535,42849,24535,70,70,0,2,8,2,0
50681,443,36673,443,6888,1380,5508,19,171,9,10
49162,53,41472,53,183,94,89,2,30,1,1
55070,53,2161,53,190,97,93,2,31,1,1
49908,53,39258,53,789,110,679,2,30,1,1
63952,53,32922,53,211,110,101,2,29,1,1
54167,53,54167,53,242,98,144,2,30,1,1
52385,53,0,0,139,70,69,2,30,1,1
49885,53,17170,53,760,97,663,2,31,1,1
31976,53,31976,53,241,95,146,2,30,1,1
52454,80,19961,80,2425,529,1896,11,75,6,5
65112,53,1739,53,209,110,99,2,31,1,1
59787,443,40007,443,1457,816,641,15,28,7,8
36754,443,35340,443,1320,822,498,16,41,9,7
59486,443,24695,443,9161,2202,6959,28,374,14,14
57201,53,46716,53,214,110,104,2,30,1,1
57470,34590,16143,34590,527,166,361,2,1200,1,1
56038,53,40238,53,177,94,83,2,29,1,1
53985,26515,42482,26515,70,70,0,1,4,1,0
64171,53,42919,53,211,102,109,2,29,1,1
65180,53,28162,53,199,102,97,2,30,1,1
32228,53,32228,53,228,90,138,2,33,1,1
55106,53,22662,53,184,94,90,2,30,1,1
55256,53,58019,53,79,79,0,2,35,2,0
56857,53,30246,53,711,87,624,2,30,1,1
49360,53,51221,53,321,102,219,2,30,1,1
64580,53,58707,53,425,90,335,4,43,2,2
63861,37832,6242,37832,66,66,0,2,7,2,0
56676,443,53618,443,7889,1900,5989,20,15,11,9
52150,37603,63249,37603,70,70,0,1,5,1,0
47293,443,64269,443,6318,1025,5293,17,31,9,8
54063,80,60737,80,2545,515,2030,12,17,6,6
49851,53,3240,53,166,86,80,2,30,1,1
37644,443,35046,443,3886,2516,1370,22,95,12,10
50288,443,59061,443,8207,2558,5649,41,80,23,18
51008,80,51008,80,114613,6365,108248,134,26,51,83
49843,53,13877,53,193,102,91,2,30,1,1
52124,11296,17277,11296,70,70,0,2,8,2,0
56191,53,27279,53,177,94,83,2,30,1,1
55127,53,55127,53,220,100,120,2,31,1,1
52901,443,37617,443,87558,4155,83403,115,117,41,74
50473,123,38470,123,184,94,90,2,30,1,1
52069,53446,38596,53446,70,70,0,2,7,2,0
57193,80,36563,80,2235,1055,1180,12,16,7,5
64825,53,52627,53,184,94,90,2,30,1,1
55778,53,1773,53,94,94,0,1,30,1,0
49635,443,49110,443,54634,6944,47690,99,47,47,52
27988,40027,35628,40027,140,78,62,2,30,1,1
43674,80,1697,80,13872,1244,12628,29,19,14,15
56928,53,48986,53,172,88,84,2,31,1,1
21133,26760,14164,26760,480,149,331,2,1200,1,1
53799,80,41607,80,1056,682,374,10,15,6,4
49632,53,26153,53,199,102,97,2,30,1,1
64225,53,35755,53,322,118,204,2,30,1,1
56422,53,25062,53,195,102,93,2,31,1,1
8893,123,39834,123,94,94,0,1,30,1,0
50914,443,65485,443,6813,1729,5084,18,16,10,8
56536,53,49265,53,209,110,99,2,30,1,1
49839,53,59644,53,258,110,148,2,29,1,1
51997,53,57972,53,164,78,86,2,30,1,1
49707,53,0,0,82,82,0,1,31,1,0
50172,443,57262,443,130,70,60,2,14,1,1
58665,53,16877,53,260,86,174,2,30,1,1
37587,443,50576,443,499,425,74,4,0,3,1
27005,37569,24512,37569,880,126,754,2,30,1,1
60787,40010,15005,40010,316,136,180,6,6,3,3
52087,443,46518,443,5780,1646,4134,22,15,11,11
56633,53,58541,53,166,86,80,2,30,1,1
58793,443,33855,443,40456,12307,28149,114,140,58,56
57000,53,25419,53,188,96,92,2,31,1,1
63968,37264,37420,37264,504,382,122,8,15,6,2
48625,443,29976,443,7605,2028,5577,23,159,11,12
48854,443,38265,443,2497156,63601,2433555,2465,17,852,1613
64379,53,64379,53,235,90,145,2,33,1,1
57986,80,14489,80,1898,1524,374,14,15,8,6
57843,443,8573,443,25053,19627,5426,38,76,23,15
62964,53,62964,53,404,259,145,3,33,2,1
65317,53,60723,53,195,102,93,2,29,1,1
64614,53,61495,53,538,179,359,6,63,3,3
52068,39864,59001,39864,70,70,0,2,8,2,0
50597,80,50597,80,16296,9143,7153,48,27,26,22
50338,80,24125,80,2475,723,1752,12,41,6,6
49182,53,44027,53,198,101,97,2,30,1,1
49503,80,52162,80,121857,7431,114426,166,486,38,128
49774,443,43328,443,8130,2220,5910,23,16,13,10
52744,443,47091,443,14838,2048,12790,32,25,18,14
52158,3841,65016,3841,70,70,0,2,7,2,0
50403,53,33399,53,168,86,82,2,30,1,1
55613,53,34338,53,170,87,83,2,30,1,1
49503,53,43089,53,167,86,81,2,29,1,1
62158,443,35160,443,4975,2828,2147,14,135,7,7
27005,27015,4147,27015,869,126,743,2,30,1,1
53903,51339,21513,51339,70,70,0,2,7,2,0
61391,443,41670,443,11151,3001,8150,51,365,25,26
54199,443,31908,443,499,425,74,4,0,3,1
27005,27015,3616,27015,887,126,761,2,30,1,1
49923,443,51816,443,466,392,74,4,1,3,1
45862,443,6882,443,234,234,0,4,11,4,0
56358,443,57449,443,3734,1750,1984,24,203,12,12
53131,80,64503,80,2957,619,2338,12,15,6,6
53688,17106,21939,17106,70,70,0,2,8,2,0
49501,53,7726,53,734,94,640,2,29,1,1
27005,32056,3703,32056,886,126,760,2,30,1,1
65397,443,12248,443,2494,1643,851,17,25,9,8
49429,53,17254,53,210,110,100,2,29,1,1
60434,11339,17493,11339,70,70,0,1,5,1,0
0,0,0,0,124,64,60,2,0,1,1
64041,53,28808,53,380,92,288,4,37,2,2
64711,53,31035,53,273,118,155,2,30,1,1
43196,80,6981,80,3494,1589,1905,16,186,9,7
49929,53,44359,53,214,110,104,2,29,1,1
52221,53,10859,53,177,86,91,2,30,1,1
36841,443,46092,443,7293,1544,5749,22,256,11,11
55963,53,27489,53,755,93,662,2,30,1,1
61396,443,45721,443,550484,8433,542051,541,246,99,442
3819,80,3819,80,9399,632,8767,15,15,7,8
30960,45759,38428,45759,330,330,0,6,3609,6,0
50559,53,33553,53,178,94,84,2,29,1,1
64868,53,56069,53,216,102,114,2,30,1,1
52116,64692,3805,64692,70,70,0,1,5,1,0
64962,27048,15901,27048,747,462,285,2,30,1,1
65363,53,10698,53,181,94,87,2,30,1,1
53587,32029,40143,32029,70,70,0,1,5,1,0
51744,1678,51884,1678,70,70,0,2,8,2,0
56215,53,45300,53,168,78,90,2,29,1,1
52272,37105,49502,37105,316,136,180,6,6,3,3
64554,53,57103,53,498,204,294,6,30,3,3
53483,443,14059,443,8333,2292,6041,27,360,15,12
57545,443,29665,443,25540,8247,17293,187,574,79,108
43683,443,23640,443,6941,1551,5390,25,200,12,13
63976,25725,46114,25725,66,66,0,2,8,2,0
10283,53,10283,53,370,238,132,3,31,2,1
50580,443,17458,443,2723,1383,1340,29,37,16,13
36532,6555,55068,6555,922,428,494,10,14,5,5
64867,53,27823,53,765,102,663,2,30,1,1
60862,443,5299,443,12604,6376,6228,27,133,16,11
65075,53,5602,53,164,86,78,2,31,1,1
49379,53,35998,53,199,102,97,2,31,1,1
32927,443,11670,443,5746,1079,4667,17,27,10,7
63945,53,51432,53,216,110,106,2,29,1,1
53106,59478,22060,59478,70,70,0,1,5,1,0
50443,80,50443,80,73400,3702,69698,77,19,26,51
53925,61701,5754,61701,70,70,0,2,8,2,0
43568,443,63608,443,9445,6593,2852,43,96,25,18
57604,80,57604,80,16101,4026,12075,35,38,16,19
55172,80,55172,80,268230,8528,259702,292,231,106,186
56796,41431,54757,41431,70,70,0,1,5,1,0
65348,53,57406,53,214,102,112,2,31,1,1
55524,53,55524,53,197,90,107,2,29,1,1
62909,993,50101,993,8033,4241,3792,67,54,42,25
52157,23002,39596,23002,70,70,0,2,7,2,0
49418,27018,39364,27018,247,78,169,2,30,1,1
28858,80,28858,80,83253,4938,78315,99,26,39,60
6882,50239,19851,50239,296,150,146,2,1200,1,1
63884,53,63884,53,400,257,143,3,33,2,1
51880,4000,30933,4000,270,270,0,4,32,4,0
27005,33060,25157,33060,928,126,802,2,31,1,1
63205,443,63205,443,9324,4240,5084,24,16,13,11
49637,53,0,0,86,86,0,1,30,1,0
65219,53,39844,53,410,99,311,4,56,2,2
64985,27037,29129,27037,734,462,272,2,30,1,1
56548,53,54465,53,199,102,97,2,31,1,1
50286,443,30253,443,10203,2365,7838,40,86,22,18
64500,53,31734,53,212,102,110,2,30,1,1
26900,27017,11839,27017,422,164,258,6,30,3,3
55040,80,41951,80,486,240,246,9,34,5,4
55782,53,22320,53,245,94,151,2,29,1,1
35961,80,62048,80,11575,902,10673,20,46,11,9
39195,443,6951,443,8991,2438,6553,18,120,8,10
50263,53,61533,53,753,96,657,2,30,1,1
56560,53,15895,53,164,86,78,2,29,1,1
55354,53,62421,53,214,110,104,2,30,1,1
41597,53,41597,53,213,79,134,2,32,1,1
52092,443,50536,443,4642,3496,1146,18,16,10,8
9140,80,58869,80,49165,1785,47380,56,36,21,35
40430,80,30893,80,1566,754,812,10,15,6,4
56955,53,20294,53,184,86,98,2,29,1,1
59336,80,59336,80,24437,12718,11719,41,15,16,25
51752,31677,2687,31677,70,70,0,2,8,2,0
58638,5900,58638,5900,66,66,0,1,4,1,0
49880,53,16831,53,817,102,715,2,30,1,1
49349,53,29426,53,182,93,89,2,31,1,1
49708,53,19621,53,212,94,118,2,29,1,1
55444,443,64554,443,13284,3562,9722,38,26,21,17
49382,53,52583,53,200,102,98,2,31,1,1
42298,40038,63975,40038,148,86,62,2,30,1,1
49416,53,16616,53,185,102,83,2,30,1,1
49262,53,27998,53,168,86,82,2,31,1,1
51766,48169,62941,48169,70,70,0,2,7,2,0
44314,443,36123,443,1268867,60489,1208378,1558,141,557,1001
50441,80,60802,80,318,192,126,6,26,4,2
35915,443,57098,443,1786,172,1614,7,120,3,4
57437,443,10192,443,9539,3344,6195,36,17,17,19
56819,53,17305,53,209,110,99,2,31,1,1
60806,40010,25471,40010,316,136,180,6,6,3,3
64762,53,50554,53,194,102,92,2,30,1,1
60318,80,34962,80,2714,2154,560,12,26,7,5
42019,443,22698,443,21620,7973,13647,112,488,57,55
51913,52188,11778,52188,70,70,0,2,8,2,0
38624,443,30332,443,6385,1090,5295,18,33,10,8
64914,53,63909,53,86,86,0,1,29,1,0
54106,53,53865,53,164,78,86,2,30,1,1
58395,53,61283,53,307,86,221,2,30,1,1
47127,443,18899,443,7166,2377,4789,16,122,7,9
52121,443,41012,443,199757,7497,192260,216,45,80,136
57894,443,47420,443,85263,3763,81500,115,216,46,69
27005,27052,57707,27052,1948,378,1570,6,33,4,2
57434,443,22130,443,9237,2447,6790,30,16,14,16
53184,443,16399,443,13515,3057,10458,40,21,20,20
58638,5900,58638,5900,62,62,0,1,5,1,0
65082,53,15912,53,182,93,89,2,31,1,1
30960,45746,57659,45746,330,330,0,6,3609,6,0
33733,443,7805,443,6998,2361,4637,20,17,10,10
65126,443,41319,443,958,384,574,14,34,7,7
55130,53,39778,53,216,110,106,2,29,1,1
56117,53,20260,53,178,94,84,2,30,1,1
49361,53,45475,53,184,94,90,2,31,1,1
56231,80,56231,80,44747,815,43932,45,15,12,33
56172,53,12622,53,253,87,166,4,29,2,2
10004,40014,64871,40014,156,94,62,2,30,1,1
44740,443,62303,443,5954,1454,4500,22,142,13,9
53913,28402,8057,28402,70,70,0,1,4,1,0
55560,53,1916,53,164,84,80,2,31,1,1
57127,53,17390,53,193,102,91,2,31,1,1
50317,80,56458,80,3800,2776,1024,16,83,9,7
51267,38070,5566,38070,210,140,70,4,14,3,1
49971,53,55758,53,198,102,96,2,30,1,1
56925,53,48692,53,196,102,94,2,30,1,1
51848,80,47789,80,12009,5364,6645,23,31,12,11
21870,53,21870,53,209,77,132,2,32,1,1
63809,45193,55784,45193,66,66,0,2,8,2,0
50416,80,7917,80,11343,3864,7479,22,21,11,11
65115,53,30107,53,253,87,166,4,31,2,2
55365,53,26447,53,184,94,90,2,30,1,1
60044,443,17036,443,15769,1619,14150,17,141,4,13
53780,47132,52557,47132,70,70,0,1,5,1,0
57440,53,58703,53,199,102,97,2,30,1,1
55502,53,25311,53,193,102,91,2,30,1,1
56258,53,24780,53,167,86,81,2,30,1,1
27005,27018,36101,27018,1634,126,1508,4,31,2,2
65191,53,55910,53,294,102,192,2,30,1,1
55859,53,35635,53,778,103,675,2,31,1,1
55891,443,55891,443,4581,1674,2907,19,30,11,8
55387,53,41194,53,164,86,78,2,30,1,1
59105,443,52375,443,8742,3785,4957,21,16,12,9
48758,443,1312,443,6353,1075,5278,18,33,10,8
58104,443,9408,443,2396,1144,1252,14,979,7,7
49560,443,58104,443,13516,6981,6535,61,2149,34,27
34522,80,31284,80,1420,715,705,12,16,7,5
27005,27017,10381,27017,600,126,474,2,30,1,1
63992,53,39861,53,199,102,97,2,30,1,1
30188,12494,61043,12494,502,150,352,2,1200,1,1
54996,80,15340,80,1979,826,1153,13,17,9,4
57023,53,56230,53,179,94,85,2,30,1,1
56588,53,8372,53,197,102,95,2,30,1,1
50380,443,13367,443,306,180,126,6,25,4,2
47971,443,21107,443,9021,1511,7510,21,121,11,10
51656,80,50242,80,152651,4700,147951,174,17,65,109
55879,53,11765,53,184,94,90,2,30,1,1
53929,60741,10876,60741,320,140,180,6,6,3,3
57171,443,13487,443,13932,3673,10259,26,121,11,15
51990,443,58670,443,2094,1402,692,14,15,8,6
52258,443,2636,443,3757,356,3401,12,120,5,7
50878,80,60118,80,325925,18062,307863,377,146,161,216
49895,443,39538,443,6060,1040,5020,20,34,11,9
63868,60392,13062,60392,70,70,0,1,4,1,0
64743,443,34069,443,31480,1953,29527,54,196,20,34
64091,53,52948,53,172,88,84,2,30,1,1
42889,443,3091,443,3961,1595,2366,21,15,12,9
49726,443,2292,443,3941,902,3039,13,50,7,6
51203,443,62126,443,5737,1829,3908,22,18,13,9
55705,53,9254,53,281,101,180,4,58,2,2
65410,53,23769,53,216,94,122,2,30,1,1
49665,80,35482,80,8457,3062,5395,16,41,7,9
35814,443,57995,443,9126,3975,5151,21,15,11,10
49415,53,62672,53,194,102,92,2,30,1,1
65363,53,16393,53,747,93,654,2,30,1,1
51844,443,37014,443,6752,1387,5365,21,115,10,11
35145,443,40787,443,3542,1045,2497,13,120,6,7
60811,40010,33835,40010,316,136,180,6,5,3,3
41343,443,31271,443,7601,1595,6006,25,35,12,13
47969,53,59484,53,199,94,105,2,30,1,1
53243,443,50839,443,242426,7999,234427,277,70,100,177
65344,53,52002,53,190,90,100,3,60,2,1
58370,443,50234,443,6277528,124223,6153305,5970,160,1890,4080
27296,443,26053,443,10243,1659,8584,29,83,13,16
65481,53,17512,53,168,86,82,2,30,1,1
49618,80,5688,80,314,192,122,6,42,4,2
56381,53,46735,53,196,102,94,2,31,1,1
52237,53,52237,53,220,90,130,2,30,1,1
63762,41373,50271,41373,66,66,0,2,8,2,0
65379,53,64746,53,376,126,250,2,30,1,1
2371,53,52292,53,164,86,78,2,31,1,1
7536,53,7536,53,198,90,108,2,30,1,1
52182,53,52182,53,832,106,726,2,30,1,1
35122,80,19351,80,130,70,60,2,15,1,1
64803,80,9867,80,5518,527,4991,13,75,6,7
60812,443,60812,443,2871,1671,1200,17,179,9,8
53751,22266,31272,22266,754,502,252,11,20,7,4
64022,60918,60664,60918,70,70,0,1,4,1,0
55236,53,57748,53,216,102,114,2,30,1,1
55653,53,53327,53,199,102,97,2,30,1,1
38118,443,33958,443,574857,27894,546963,745,57,346,399
42379,443,23086,443,6598,1506,5092,22,305,12,10
49925,80,18933,80,12290,10150,2140,37,256,19,18
55142,53,21559,53,770,101,669,2,31,1,1
44299,80,44299,80,1915,1466,449,10,20,6,4
63584,443,2301,443,7146,2010,5136,34,167,18,16
50828,443,8189,443,178483,7778,170705,219,218,90,129
45475,161,0,0,41552,20621,20931,212,31,106,106
5115,53,5115,53,216,90,126,2,30,1,1
56973,53,50381,53,193,102,91,2,30,1,1
51540,3389,51540,3389,4425,2641,1784,21,33,12,9
37805,443,7210,443,9481,3482,5999,58,16,29,29
55463,53,9844,53,216,110,106,2,31,1,1
57415,443,15579,443,28216,10325,17891,93,23,42,51
60415,53,60415,53,257,101,156,2,33,1,1
55122,53,17738,53,173,94,79,2,30,1,1
49160,6886,47580,6886,854,150,704,4,1200,2,2
58888,443,9606,443,5166,700,4466,16,14,7,9
64414,53,58315,53,406,142,264,2,30,1,1
51938,80,6039,80,82321,4061,78260,109,61,50,59
62232,80,47630,80,1511,517,994,8,15,5,3
55559,53,14649,53,1026,292,734,8,50,4,4
53113,443,2940,443,11030,4292,6738,32,61,17,15
49217,53,30696,53,282,93,189,4,45,2,2
49725,443,10242,443,311104,8270,302834,336,18,99,237
54204,443,58891,443,499,425,74,4,0,3,1
56975,80,23804,80,214,140,74,4,35,3,1
50481,443,21430,443,1258,716,542,13,83,7,6
33919,53,58115,53,168,78,90,2,30,1,1
14247,53,14247,53,197,90,107,2,30,1,1
61436,443,20457,443,1401,940,461,11,29,7,4
51915,5222,45227,5222,11827,5467,6360,100,144,54,46
59477,443,16193,443,7825,4076,3749,19,121,10,9
29616,53,29616,53,241,98,143,2,30,1,1
64936,53,55896,53,816,102,714,2,30,1,1
56395,53,56804,53,199,102,97,2,29,1,1
55722,26192,51333,26192,70,70,0,1,5,1,0
58367,53,2848,53,167,78,89,2,30,1,1
64908,53,55022,53,232,94,138,2,30,1,1
55576,443,55576,443,4665,1758,2907,19,28,11,8
59240,53,59240,53,194,87,107,2,30,1,1
64175,53,22231,53,453,100,353,4,57,2,2
49649,443,64805,443,5964,674,5290,16,60,7,9
56120,53,38603,53,177,94,83,2,30,1,1
56788,53,1582,53,199,102,97,2,30,1,1
49356,53,31993,53,763,102,661,2,31,1,1
26460,80,26460,80,490,264,226,8,32,5,3
42278,443,42278,443,1916,1121,795,19,69,10,9
56307,53,24670,53,185,102,83,2,29,1,1
56984,53,20901,53,199,102,97,2,29,1,1
51140,443,48264,443,5759,1904,3855,19,15,11,8
49650,443,63033,443,93063,2948,90115,107,80,30,77
56349,53,33887,53,168,86,82,2,29,1,1
50418,53,2799,53,760,96,664,2,31,1,1
49404,53,23314,53,200,94,106,2,30,1,1
57167,53,41895,53,195,102,93,2,30,1,1
55429,53,62139,53,182,102,80,2,30,1,1
50669,443,61553,443,2985,1505,1480,16,20,9,7
49909,53,17902,53,1410,95,1315,4,57,2,2
41580,443,42075,443,4354,2166,2188,14,136,7,7
27005,27015,44800,27015,858,126,732,2,30,1,1
49654,53,49736,53,184,94,90,2,30,1,1
56665,53,16180,53,216,102,114,2,30,1,1
5588,5588,0,0,3562,1936,1626,48,193,24,24
52845,443,44053,443,2082,1322,760,14,41,8,6
54035,443,43754,443,7724,2555,5169,26,47,15,11
49606,53,55555,53,328,94,234,4,43,2,2
65165,53,53498,53,200,102,98,2,30,1,1
53936,443,5510,443,886,70,816,14,166,2,12
57470,61768,42520,61768,330,330,0,6,1199,6,0
39945,443,42447,443,5446,805,4641,17,26,9,8
52071,57491,38679,57491,70,70,0,1,5,1,0
65498,53,49564,53,749,94,655,2,30,1,1
56045,53,39272,53,731,91,640,2,30,1,1
53644,58085,31937,58085,70,70,0,2,7,2,0
40662,53,39686,53,223,78,145,2,30,1,1
4781,443,51838,443,1191,692,499,12,40,7,5
50319,53,7471,53,194,102,92,2,30,1,1
41252,53,41252,53,398,255,143,3,32,2,1
49181,53,64897,53,168,86,82,2,30,1,1
37264,443,41734,443,130,70,60,3,5,2,1
49240,8080,49240,8080,22799,6835,15964,35,56,20,15
65357,53,38110,53,194,102,92,2,29,1,1
2037,23,2037,23,152,66,86,2,10,1,1
49583,443,53752,443,10877,2925,7952,56,285,23,33
9332,443,23835,443,3616,429,3187,11,15,6,5
49828,443,7626,443,1737,1158,579,16,74,10,6
51410,443,38178,443,13187,6736,6451,22,55,12,10
64793,53,53457,53,184,94,90,2,30,1,1
60407,8106,10620,8106,2541,1158,1383,19,16,9,10
55616,53,41127,53,776,102,674,2,30,1,1
55219,443,55870,443,6528,1918,4610,23,45,13,10
57206,123,21797,123,184,94,90,2,30,1,1
62921,993,3682,993,8856,4253,4603,79,27,42,37
58442,123,61048,123,184,94,90,2,30,1,1
6881,56867,6114,56867,150,150,0,1,1199,1,0
54963,53,23635,53,210,110,100,2,30,1,1
19473,61397,60276,61397,323,150,173,2,1200,1,1
43749,443,15009,443,8900,2090,6810,26,80,14,12
49944,53,37550,53,196,102,94,2,30,1,1
65258,53,18646,53,763,102,661,2,30,1,1
43603,443,42478,443,8420,2986,5434,23,138,13,10
45473,53,13745,53,168,78,90,2,31,1,1
57372,53,54871,53,177,94,83,2,30,1,1
63768,53,12206,53,298,102,196,2,30,1,1
1955,53,1955,53,216,89,127,2,30,1,1
47493,53,47493,53,227,92,135,2,31,1,1
51090,80,51090,80,19837,2061,17776,30,21,14,16
27005,27014,39253,27014,882,126,756,2,30,1,1
56663,443,26392,443,9691,2221,7470,16,120,8,8
53598,40326,41639,40326,70,70,0,2,7,2,0
56594,53,29488,53,167,86,81,2,30,1,1
52218,62004,11964,62004,136,136,0,3,12,3,0
58439,443,54279,443,2659,1417,1242,19,276,9,10
65189,30015,16566,30015,276,78,198,2,30,1,1
49359,53,18321,53,216,110,106,2,30,1,1
36098,443,41283,443,5901,1324,4577,25,50,14,11
51802,443,43953,443,4976,1826,3150,19,151,9,10
50103,53,41648,53,168,86,82,2,31,1,1
65530,53,20818,53,166,85,81,2,30,1,1
49228,53,49228,53,825,99,726,2,30,1,1
49190,443,44351,443,568536,16389,552147,598,19,224,374
64996,53,37849,53,547,91,456,4,35,2,2
53746,7546,3408,7546,70,70,0,2,7,2,0
49892,443,4679,443,6966,1436,5530,32,600,13,19
57506,443,36392,443,2696,1695,1001,24,105,13,11
49929,53,13431,53,260,124,136,2,31,1,1
52027,49743,54736,49743,70,70,0,2,7,2,0
65466,53,3496,53,733,86,647,2,31,1,1
50508,443,58389,443,7588,1850,5738,19,25,10,9
49418,27025,19302,27025,71,71,0,1,30,1,0
56861,53,42758,53,756,95,661,2,31,1,1
53819,443,53819,443,1386,751,635,15,180,8,7
65384,53,58692,53,194,99,95,2,30,1,1
49086,443,34505,443,8535,2139,6396,25,394,9,16
65487,53,58054,53,184,94,90,2,29,1,1
60019,443,11836,443,76774,9184,67590,104,143,41,63
64624,53,46919,53,228,94,134,2,30,1,1
55627,53,18188,53,240,110,130,2,30,1,1
53154,44645,45393,44645,320,140,180,6,5,3,3
55786,53,23026,53,177,94,83,2,30,1,1
50964,80,13485,80,4680740,67312,4613428,4675,77,985,3690
39118,443,64547,443,206769,6309,200460,215,27,77,138
49267,53,44367,53,184,94,90,2,31,1,1
65189,27015,61124,27015,250,78,172,2,30,1,1
5588,5588,0,0,3354,1792,1562,46,194,23,23
60252,443,61357,443,5169,790,4379,16,72,8,8
39043,443,33177,443,4832,3054,1778,27,16,14,13
64697,53,51206,53,199,102,97,2,30,1,1
44187,53,44187,53,233,90,143,2,32,1,1
65236,53,45022,53,177,94,83,2,30,1,1
42298,40036,28327,40036,205,83,122,4,29,2,2
56942,53,38411,53,177,94,83,2,30,1,1
9518,443,46388,443,3613,433,3180,11,16,6,5
40994,443,58076,443,1396,735,661,14,80,8,6
26900,27017,46394,27017,422,164,258,6,30,3,3
63234,443,45160,443,5846,3321,2525,34,96,19,15
65239,53,27517,53,199,102,97,2,30,1,1
64181,53,25731,53,188,96,92,2,31,1,1
43560,443,3098,443,8964,2125,6839,34,120,18,16
57419,53,24851,53,326,110,216,2,29,1,1
57100,53,13292,53,402,118,284,2,30,1,1
9458,443,4963,443,5695,505,5190,14,15,7,7
42644,443,8391,443,8384,2161,6223,24,255,12,12
61666,80,7138,80,16580,1400,15180,33,48,15,18
55849,53,49045,53,195,102,93,2,30,1,1
37609,443,19871,443,499,425,74,4,0,3,1
47193,443,47193,443,4555,1648,2907,19,30,11,8
27005,27001,35440,27001,887,126,761,2,31,1,1
56663,443,26937,443,1299,730,569,13,25,7,6
61356,53,61356,53,235,90,145,2,32,1,1
36337,443,41043,443,3781,1917,1864,23,396,7,16
52099,443,31661,443,39798,12257,27541,68,97,27,41
56550,53,60039,53,182,93,89,2,31,1,1
49256,53,62875,53,179,94,85,2,30,1,1
51958,443,6859,443,9994,8270,1724,34,68,19,15
51946,80,42668,80,1716,952,764,13,69,8,5
53954,57868,29520,57868,70,70,0,1,5,1,0
53006,443,46019,443,17711,5894,11817,47,96,24,23
49197,2710,8644,2710,70,70,0,2,7,2,0
50280,53,20623,53,916,86,830,2,31,1,1
56791,443,55063,443,8021,2001,6020,20,15,11,9
33156,3478,41500,3478,338,110,228,2,300,1,1
9146,443,17435,443,10056,2310,7746,27,36,14,13
32806,53,32806,53,194,87,107,2,31,1,1
41325,443,55609,443,6015,4418,1597,38,246,22,16
35357,53,47462,53,291,86,205,2,29,1,1
44228,443,32223,443,7352,1790,5562,24,263,12,12
50161,53,40110,53,173,94,79,2,30,1,1
50116,22,50116,22,60,60,0,1,5,1,0
56167,53,4828,53,178,94,84,2,30,1,1
56304,53,20690,53,184,94,90,2,30,1,1
50425,53,24348,53,199,102,97,2,30,1,1
64172,53,0,0,174,79,95,2,30,1,1
32871,53,29403,53,199,94,105,2,30,1,1
42298,40020,47579,40020,148,86,62,2,31,1,1
50458,443,25872,443,523577,34256,489321,1025,208,473,552
60413,80,20847,80,958,543,415,11,315,6,5
55010,53,38368,53,190,97,93,2,31,1,1
50279,443,26201,443,1128,654,474,17,18,10,7
50584,64368,19845,64368,161,161,0,2,1200,2,0
27005,27016,51582,27016,1626,126,1500,4,30,2,2
60290,443,20487,443,6753,2052,4701,25,15,13,12
63910,53,63969,53,178,75,103,2,30,1,1
64776,53,62229,53,198,94,104,2,30,1,1
64742,53,25545,53,761,102,659,2,29,1,1
57705,443,65472,443,7915,1994,5921,31,270,15,16
49263,53,10892,53,731,85,646,2,31,1,1
65073,53,40365,53,293,102,191,2,30,1,1
55770,53,17489,53,167,86,81,2,30,1,1
64905,53,62456,53,283,102,181,2,30,1,1
56723,53,2628,53,733,85,648,2,31,1,1
51689,80,35961,80,16205,2525,13680,31,139,15,16
64251,53,65162,53,177,94,83,2,30,1,1
56020,53,51205,53,199,102,97,2,32,1,1
47473,443,41796,443,11072,3983,7089,27,186,15,12
30960,45739,64773,45739,330,330,0,6,3609,6,0
56485,443,48158,443,5711,1208,4503,21,121,11,10
49615,80,42615,80,374,192,182,7,41,4,3
57835,53,49650,53,308,118,190,2,29,1,1
62120,443,62120,443,4378,1471,2907,19,27,11,8
57307,443,21158,443,8407,3013,5394,43,15,24,19
40836,443,10613,443,9524,3934,5590,20,135,10,10
49902,443,13295,443,7456,1591,5865,32,54,15,17
57510,443,62415,443,16532,2229,14303,26,133,11,15
14374,443,14374,443,1582,883,699,18,32,10,8
55224,53,59301,53,180,92,88,2,31,1,1
50140,53,14261,53,177,94,83,2,30,1,1
55019,443,55019,443,3773,2325,1448,24,18,13,11
64519,53,52190,53,184,94,90,2,30,1,1
49637,443,18252,443,50296,4666,45630,90,31,43,47
38948,53,19233,53,242,78,164,2,29,1,1
26900,27017,30170,27017,422,164,258,6,30,3,3
49164,53,4974,53,212,94,118,2,30,1,1
51643,80,38570,80,499,192,307,6,38,4,2
49239,8080,49239,8080,378,180,198,7,53,4,3
41328,53,51462,53,198,93,105,2,30,1,1
64599,53,10160,53,250,94,156,2,29,1,1
40103,443,24820,443,161,101,60,2,5,1,1
53853,39723,8770,39723,1890,1010,880,13,16,8,5
55517,53,14797,53,179,94,85,2,31,1,1
55375,53,8307,53,214,110,104,2,30,1,1
65474,53,12902,53,198,94,104,2,30,1,1
50369,80,41191,80,318,192,126,6,28,4,2
50623,443,54546,443,13392,11220,2172,31,53,19,12
44847,12269,58091,12269,502,150,352,2,1200,1,1
38523,53,38523,53,214,82,132,2,32,1,1
51606,443,25122,443,5188,1096,4092,21,95,12,9
57334,53,60234,53,184,94,90,2,31,1,1
52704,53,49844,53,168,78,90,2,30,1,1
49226,53,7327,53,194,102,92,2,29,1,1
49797,53,57522,53,306,94,212,2,30,1,1
55966,443,29704,443,214312,69934,144378,612,671,303,309
56753,80,58241,80,1462,703,759,8,16,5,3
40042,80,40042,80,1919,1470,449,10,20,6,4
52193,443,39804,443,8868,4111,4757,24,16,12,12
51877,13472,10032,13472,70,70,0,2,8,2,0
54677,443,22432,443,10029,4115,5914,31,61,17,14
55022,53,45433,53,195,102,93,2,30,1,1
54604,80,54604,80,2244,1549,695,11,18,7,4
56550,53,58694,53,84,84,0,1,31,1,0
64162,53,14611,53,225,110,115,2,30,1,1
65248,53,49147,53,212,110,102,2,30,1,1
53124,80,20707,80,4198,3534,664,13,19,8,5
50505,80,62173,80,318,192,126,6,25,4,2
50576,53,22318,53,765,102,663,2,29,1,1
53701,8999,10439,8999,1328,960,368,10,32,5,5
55669,53,15322,53,94,94,0,1,29,1,0
38460,443,18587,443,14768,3347,11421,69,1902,32,37
64257,53,2954,53,168,86,82,2,30,1,1
39926,443,4012,443,40820,4400,36420,81,81,42,39
52640,443,13563,443,70,70,0,1,5,1,0
40367,80,26121,80,2119,808,1311,12,16,7,5
60475,443,52273,443,585392,18731,566661,623,119,209,414
65036,53,40667,53,214,110,104,2,30,1,1
53806,443,60221,443,12788,2594,10194,40,17,20,20
17750,1024,34469,1024,323,150,173,2,1200,1,1
56984,80,27269,80,214,140,74,4,35,3,1
64873,53,31946,53,195,94,101,2,31,1,1
64496,53,57419,53,196,94,102,2,30,1,1
55067,53,26485,53,178,94,84,2,31,1,1
50997,443,46270,443,3772,2099,1673,22,18,11,11
50209,53,45881,53,780,104,676,2,31,1,1
44731,443,63210,443,4920,2738,2182,33,259,16,17
57256,443,52300,443,47762,39522,8240,77,332,43,34
64584,80,64584,80,142674,8057,134617,192,27,94,98
49256,53,36401,53,179,94,85,2,29,1,1
22983,443,22983,443,205941,20753,185188,264,30,129,135
53591,35889,63951,35889,320,140,180,6,6,3,3
43195,80,21562,80,3477,1572,1905,16,186,9,7
57072,53,9949,53,195,102,93,2,30,1,1
55488,53,31385,53,210,94,116,2,29,1,1
55286,53,22881,53,268,87,181,4,35,2,2
39483,443,14932,443,3884,1859,2025,20,255,10,10
63957,80,57502,80,314,192,122,6,15,4,2
56411,80,44029,80,35574,868,34706,36,104,10,26
45218,443,18311,443,16297,12965,3332,54,193,30,24
51135,443,24290,443,6678,1212,5466,22,256,12,10
57470,13613,29471,13613,1577,594,983,20,1600,10,10
53807,28630,23692,28630,70,70,0,1,4,1,0
36452,53,36452,53,226,106,120,2,29,1,1
9172,443,4913,443,89362,3092,86270,100,21,37,63
55025,443,34661,443,7654,2110,5544,21,46,13,8
55742,53,3708,53,780,93,687,2,30,1,1
56544,443,50945,443,3413,1537,1876,19,7,10,9
65346,53,42988,53,183,94,89,2,29,1,1
57343,53,33500,53,181,94,87,2,30,1,1
49591,53,51142,53,168,86,82,2,30,1,1
41350,80,41350,80,1914,1465,449,10,19,6,4
53103,443,15301,443,130,70,60,2,15,1,1
57205,53,27220,53,711,87,624,2,30,1,1
37368,80,60512,80,554,258,296,9,13,5,4
51852,443,17719,443,1382291,55962,1326329,1491,24,582,909
57071,53,61611,53,164,84,80,2,31,1,1
49323,53,32529,53,204,104,100,2,31,1,1
60303,443,45517,443,7914400,166459,7747941,6839,775,1138,5701
49281,53,63913,53,251,102,149,2,30,1,1
51091,80,6090,80,3324,663,2661,12,15,7,5
51967,443,38807,443,10684,3167,7517,43,34,24,19
65298,53,31126,53,277,110,167,2,30,1,1
60374,17432,21315,17432,564,318,246,9,18,5,4
39474,443,60202,443,9766,2050,7716,23,15,12,11
61140,443,36707,443,10803,2906,7897,20,135,10,10
49961,53,46234,53,216,110,106,2,31,1,1
53994,16605,15809,16605,70,70,0,2,8,2,0
50575,80,50575,80,44569,12221,32348,81,19,42,39
0,0,0,0,124,64,60,2,0,1,1
55797,53,36305,53,177,94,83,2,31,1,1
54877,53,59244,53,199,94,105,2,30,1,1
27005,27015,50781,27015,881,126,755,2,30,1,1
52013,35185,29346,35185,66,66,0,1,5,1,0
61937,443,25012,443,24420,19966,4454,64,136,35,29
59798,443,49371,443,1887,1152,735,18,28,9,9
53730,37096,47492,37096,70,70,0,2,7,2,0
38891,443,20514,443,3489,636,2853,16,143,7,9
64311,53,1855,53,198,101,97,2,31,1,1
56802,80,23332,80,1559,762,797,14,30,7,7
56970,53,18773,53,230,110,120,2,30,1,1
21133,39263,6580,39263,323,150,173,2,1200,1,1
50404,8080,50404,8080,11938,4533,7405,33,98,20,13
62311,443,60007,443,4778,1121,3657,15,280,8,7
65484,443,29745,443,148284,6200,142084,165,16,63,102
53759,443,57982,443,499,425,74,4,0,3,1
64935,53,54508,53,193,102,91,2,29,1,1
53980,36153,43274,36153,164,70,94,2,5,1,1
57872,443,43316,443,183325,10358,172967,289,227,95,194
56769,11155,9985,11155,70,70,0,2,8,2,0
43112,443,57880,443,7192,1772,5420,25,305,13,12
53247,443,53247,443,1528,757,771,19,121,9,10
62337,443,30628,443,3908576,93181,3815395,3743,56,1160,2583
20388,53,20388,53,217,90,127,2,30,1,1
62705,443,21442,443,357841,77119,280722,646,142,316,330
50278,443,27147,443,259911,11421,248490,336,92,144,192
38598,80,50146,80,1114,534,580,12,16,7,5
38544,161,0,0,8977,3570,5407,30,31,15,15
56791,11500,23499,11500,70,70,0,1,5,1,0
34924,443,1749,443,2401,1149,1252,14,982,7,7
63962,53,52393,53,483,189,294,6,85,3,3
6881,51413,17965,51413,150,150,0,1,1200,1,0
52601,443,40695,443,2046,1026,1020,17,80,9,8
58903,80,49363,80,22851,3171,19680,39,147,20,19
52096,443,12292,443,86745,6260,80485,121,32,58,63
27005,27019,21783,27019,1648,126,1522,4,31,2,2
18485,81,18485,81,146,60,86,2,10,1,1
53986,53,63410,53,306,306,0,4,47,4,0
57183,53,22943,53,178,94,84,2,29,1,1
49701,443,31912,443,13022,1500,11522,30,23,15,15
49781,53,35337,53,254,102,152,2,29,1,1
64414,53,13029,53,183,94,89,2,29,1,1
58001,80,18559,80,20532,14664,5868,47,75,24,23
56192,53,15421,53,170,87,83,2,30,1,1
58885,443,6031,443,152,86,66,2,5,1,1
40217,443,61607,443,5377,857,4520,21,88,8,13
49563,53,27885,53,200,102,98,2,30,1,1
54476,443,29193,443,48303,3997,44306,69,271,30,39
50272,53,50516,53,168,78,90,2,30,1,1
49515,53,21422,53,226,110,116,2,29,1,1
57911,443,43789,443,10141,5997,4144,56,156,28,28
65289,53,50124,53,564,193,371,6,51,3,3
53650,37096,27046,37096,70,70,0,1,5,1,0
57470,15870,28583,15870,149,149,0,2,1199,2,0
49418,27013,52000,27013,241,78,163,2,30,1,1
56388,53,23027,53,186,95,91,3,34,2,1
56582,53,17999,53,196,102,94,2,32,1,1
60727,443,60727,443,2169,1158,1011,20,15,11,9
50124,443,10944,443,48860,5749,43111,91,147,47,44
64798,53,32594,53,303,88,215,4,40,2,2
38661,15000,5688,15000,138,78,60,2,5,1,1
57195,53,47926,53,195,102,93,2,33,1,1
64592,53,20935,53,177,94,83,2,30,1,1
27005,27016,11653,27016,876,126,750,3,31,2,1
55786,53,7570,53,193,102,91,2,30,1,1
56648,80,59981,80,234,234,0,4,12,4,0
61714,443,30943,443,134,60,74,3,10,2,1
51145,80,51145,80,33072,3959,29113,40,46,14,26
49924,53,63883,53,353,94,259,2,31,1,1
49449,53,11737,53,216,110,106,2,30,1,1
55708,8060,17338,8060,70,70,0,1,5,1,0
44983,443,63267,443,4991,3096,1895,22,220,13,9
55386,53,14835,53,199,102,97,2,30,1,1
58756,443,10542,443,5168,700,4468,16,15,7,9
63062,443,18661,443,26697,7168,19529,74,213,39,35
55496,80,55496,80,124,60,64,2,5,1,1
57002,80,6505,80,214,140,74,4,35,3,1
49319,53,9038,53,199,102,97,2,30,1,1
57371,53,14687,53,321,108,213,4,33,2,2
37590,443,37590,443,4572,1665,2907,19,27,11,8
62449,443,11939,443,9977,4364,5613,19,121,9,10
35052,443,8505,443,4652,3109,1543,25,95,14,11
58179,443,33593,443,7883,1768,6115,30,36,14,16
55182,53,36739,53,293,94,199,2,30,1,1
7003,53,7003,53,229,90,139,2,30,1,1
33694,443,52274,443,18876,16514,2362,43,95,24,19
64439,53,21739,53,198,101,97,2,30,1,1
55176,53,63516,53,190,97,93,2,31,1,1
49633,53,37557,53,210,102,108,2,30,1,1
55669,53,24694,53,195,94,101,2,30,1,1
50176,443,54312,443,6081,844,5237,17,15,9,8
53630,64745,36069,64745,70,70,0,1,4,1,0
59952,80,58096,80,440081,8465,431616,424,24,137,287
55237,53,6417,53,259,87,172,4,56,2,2
21585,443,21585,443,14344,1146,13198,25,19,11,14
63457,443,6711,443,606,300,306,11,60,6,5
64914,53,14005,53,224,94,130,2,30,1,1
49812,443,22276,443,6128,1356,4772,20,978,10,10
50913,80,46319,80,12767608,157856,12609752,11936,135,2227,9709
56104,53,24374,53,197,102,95,2,30,1,1
55680,53,53324,53,198,94,104,2,30,1,1
51906,17491,7245,17491,70,70,0,1,5,1,0
56834,53,25406,53,178,94,84,2,30,1,1
55035,443,8425,443,5653,2347,3306,33,361,18,15
27005,27020,51720,27020,1626,126,1500,4,30,2,2
49651,443,6996,443,920003,731041,188962,2024,929,1212,812
56303,53,31666,53,177,94,83,2,30,1,1
64767,80,54344,80,3199,988,2211,14,99,7,7
64615,53,56632,53,395,89,306,4,32,2,2
37552,443,42195,443,9959,2495,7464,27,37,15,12
57260,53,31217,53,211,102,109,2,30,1,1
65219,53,31087,53,197,102,95,2,29,1,1
27005,30003,56044,30003,1640,126,1514,4,30,2,2
64615,53,39093,53,190,97,93,2,31,1,1
53500,443,64344,443,558,210,348,9,29,4,5
40651,443,45721,443,41517,28432,13085,89,601,47,42
0,0,0,0,320,320,0,5,0,5,0
52434,53,49925,53,183,86,97,2,30,1,1
65116,53,7436,53,220,94,126,2,29,1,1
55295,53,52273,53,779,86,693,2,30,1,1
56360,443,55866,443,188316,24744,163572,302,172,119,183
59254,443,5881,443,8332,1024,7308,21,25,11,10
64340,53,7157,53,266,110,156,2,30,1,1
40826,443,36041,443,4125,2847,1278,18,255,10,8
50697,80,65344,80,318,192,126,6,27,4,2
52076,443,51633,443,24299,8382,15917,69,93,35,34
27005,27016,52333,27016,892,126,766,2,30,1,1
52865,443,19165,443,13139,6481,6658,36,262,16,20
43224,443,58496,443,2027060,31188,1995872,1708,77,321,1387
64689,53,48296,53,183,94,89,2,30,1,1
49595,53,9542,53,180,94,86,2,30,1,1
55804,53,21847,53,193,102,91,2,30,1,1
49882,53,52287,53,441,104,337,4,48,2,2
57053,53,53183,53,173,94,79,2,31,1,1
56937,7150,12270,7150,126,126,0,1,30,1,0
60388,80,7152,80,2424,529,1895,11,125,6,5
37997,80,37997,80,3581,2902,679,13,23,8,5
56559,53,63676,53,177,94,83,2,30,1,1
57139,53,57139,53,235,90,145,2,32,1,1
50176,53,47477,53,768,99,669,2,31,1,1
49538,80,51947,80,2050,1691,359,9,75,6,3
64664,53,45386,53,250,86,164,4,33,2,2
56761,34725,47498,34725,70,70,0,1,5,1,0
56684,53,21413,53,301,94,207,2,31,1,1
61858,10443,43005,10443,10747,2507,8240,26,48,14,12
64779,53,46294,53,497,102,395,4,40,2,2
32012,500,63361,500,879,462,417,2,600,1,1
49940,443,15585,443,4363,1298,3065,17,127,8,9
38269,443,44100,443,130,70,60,2,15,1,1
57035,53,19895,53,198,101,97,2,31,1,1
41036,443,13628,443,153,93,60,2,5,1,1
64945,53,32076,53,733,94,639,2,30,1,1
54219,443,4628,443,499,425,74,4,0,3,1
57778,443,43252,443,6182,3879,2303,53,3828,31,22
49926,53,15614,53,180,94,86,2,30,1,1
50966,443,50616,443,17161,1619,15542,18,143,4,14
49568,53,53479,53,184,102,82,2,29,1,1
55019,443,34089,443,12411,7888,4523,33,17,19,14
53980,36153,5182,36153,258,70,188,4,7,2,2
27005,33038,17485,33038,892,126,766,2,30,1,1
64684,53,15819,53,184,94,90,2,31,1,1
55376,53,17927,53,711,87,624,2,30,1,1
2946,53,2946,53,240,96,144,2,30,1,1
54967,53,43919,53,178,94,84,2,31,1,1
37991,443,14336,443,8365,3018,5347,31,271,15,16
64679,53,17226,53,211,102,109,2,31,1,1
52043,80,36469,80,4185,3462,723,14,15,7,7
65188,27126,32293,27126,268,78,190,2,29,1,1
65209,53,36498,53,166,86,80,2,30,1,1
47809,53,47809,53,260,106,154,2,32,1,1
49393,53,14583,53,183,86,97,2,30,1,1
33149,5228,22043,5228,15651,3559,12092,63,6557,28,35
56808,53,18042,53,180,94,86,2,35,1,1
52167,80,36480,80,1734,800,934,10,16,6,4
52247,53,24197,53,216,86,130,2,30,1,1
64894,53,19330,53,195,102,93,2,30,1,1
51455,443,21298,443,8618,3110,5508,34,1695,18,16
56880,53,13587,53,209,110,99,2,30,1,1
38968,80,48567,80,1280,586,694,10,15,5,5
53981,53,31166,53,199,94,105,2,31,1,1
41098,443,2984,443,3384,762,2622,15,135,7,8
64297,443,21726,443,56432,4371,52061,72,135,29,43
55336,53,26759,53,199,102,97,2,31,1,1
42298,40002,11642,40002,724,550,174,4,30,2,2
9500,443,23639,443,3614,434,3180,11,15,6,5
60796,40010,42755,40010,316,136,180,6,7,3,3
63743,46081,59158,46081,66,66,0,2,7,2,0
37604,443,27839,443,573,425,148,5,0,3,2
61697,443,10867,443,9963,2631,7332,37,48,20,17
47450,443,63060,443,9950,4684,5266,26,306,12,14
51811,443,57601,443,18108,1782,16326,31,215,15,16
52434,80,48898,80,1647,481,1166,13,15,6,7
57067,53,64624,53,172,88,84,2,30,1,1
53973,50546,28275,50546,2069,1081,988,12,16,7,5
60903,443,60903,443,13557,3307,10250,43,47,25,18
52308,53,36287,53,70,70,0,1,29,1,0
56504,53,45710,53,102,102,0,1,30,1,0
56579,443,24024,443,23150,13858,9292,52,49,32,20
53710,27935,28057,27935,70,70,0,2,7,2,0
50635,443,12337,443,8252,1702,6550,26,72,13,13
64311,53,4229,53,199,102,97,2,29,1,1
56935,53,62999,53,198,102,96,2,30,1,1
49656,53,53745,53,309,118,191,2,30,1,1
49732,443,11249,443,592433,191668,400765,1555,1157,608,947
55542,53,50778,53,177,94,83,2,30,1,1
55797,53,21762,53,177,94,83,2,30,1,1
9259,80,48036,80,318,192,126,6,26,4,2
46881,53,46881,53,197,90,107,2,30,1,1
42286,443,57060,443,6021,1249,4772,20,23,11,9
55089,53,42866,53,198,101,97,2,30,1,1
18837,53,18837,53,233,90,143,2,32,1,1
37058,80,51116,80,1056,682,374,10,15,6,4
26900,27017,43419,27017,422,164,258,6,30,3,3
14438,443,5069,443,2556,1470,1086,17,15,8,9
56445,53,29245,53,199,102,97,2,30,1,1
55897,53,62688,53,711,87,624,2,31,1,1
65219,53,20854,53,197,102,95,2,31,1,1
42277,443,42277,443,2200,1253,947,23,76,12,11
55570,53,44028,53,168,86,82,2,31,1,1
54625,53,52244,53,168,78,90,2,30,1,1
56375,53,53548,53,184,102,82,2,30,1,1
53798,443,32162,443,499,425,74,4,0,3,1
6881,6881,38378,6881,231,111,120,2,1200,1,1
26900,27017,57594,27017,172,86,86,2,30,1,1
27005,27024,9068,27024,1760,252,1508,5,31,3,2
58744,443,37896,443,42954,12409,30545,154,319,67,87
50023,53,60476,53,166,86,80,2,31,1,1
47795,443,48531,443,8708,3949,4759,22,21,11,11
56782,53,51814,53,197,102,95,2,33,1,1
49828,53,44800,53,733,86,647,2,29,1,1
49744,80,34902,80,1111,749,362,9,15,5,4
10164,80,10164,80,7351,803,6548,16,24,7,9
65295,53,10641,53,212,102,110,2,29,1,1
65080,53,25627,53,209,110,99,2,30,1,1
58850,443,9120,443,18715,10778,7937,39,96,16,23
56908,443,5972,443,187104,26358,160746,205,190,58,147
49291,53,30701,53,759,102,657,2,30,1,1
54782,443,13415,443,9487,2103,7384,32,24,16,16
9326,443,61009,443,3616,429,3187,11,15,6,5
57384,53,57923,53,228,110,118,2,30,1,1
59932,443,3310,443,6065,1772,4293,27,1587,15,12
60425,443,26007,443,1541,1004,537,14,26,8,6
55491,443,47772,443,5123,2651,2472,15,123,8,7
42867,443,28433,443,15769,1619,14150,17,137,4,13
55958,53,62913,53,177,94,83,2,29,1,1
64548,53,58347,53,209,110,99,2,30,1,1
57351,53,48992,53,177,94,83,2,30,1,1
40408,443,59569,443,6058,1749,4309,22,201,13,9
53298,443,53298,443,4348,1441,2907,19,29,11,8
55784,53,41751,53,184,94,90,2,30,1,1
59970,443,18481,443,6720,1166,5554,22,360,11,11
64661,53,48759,53,216,102,114,2,30,1,1
48412,443,30459,443,47703,2616,45087,62,120,24,38
48817,10528,48817,10528,2736,1992,744,37,1580,25,12
35041,443,38147,443,16010,4754,11256,47,130,20,27
50239,443,44236,443,9418,2681,6737,39,256,18,21
42917,53,23421,53,168,78,90,2,30,1,1
50943,443,64250,443,29452,1988,27464,37,3619,10,27
33768,53,59037,53,168,78,90,2,29,1,1
43107,443,43113,443,3051,1801,1250,18,16,8,10
63035,443,45890,443,304,86,218,2,29,1,1
63548,443,63548,443,4742,1835,2907,19,29,11,8
65444,80,16519,80,486,240,246,9,28,5,4
43177,443,43177,443,4493,1586,2907,19,26,11,8
44220,443,37375,443,2709,1698,1011,20,1143,11,9
53951,80,8930,80,78,78,0,2,7,2,0
64789,53,49397,53,199,102,97,2,30,1,1
55877,51413,55340,51413,460,150,310,2,1200,1,1
45225,443,59513,443,11233,3101,8132,37,150,18,19
35517,443,27389,443,130,70,60,3,5,2,1
49484,7000,49484,7000,2958,1567,1391,15,15,8,7
26461,80,26461,80,490,264,226,8,32,5,3
50116,22,50116,22,66,66,0,1,5,1,0
27005,1302,11338,1302,862,126,736,2,30,1,1
59723,443,54726,443,8380,1882,6498,29,396,9,20
50573,80,11289,80,318,192,126,6,26,4,2
37248,80,37248,80,7850,1208,6642,16,20,8,8
64772,53,16557,53,416,107,309,4,29,2,2
52155,63867,51864,63867,70,70,0,2,7,2,0
54986,53,26600,53,214,110,104,2,30,1,1
57176,53,30899,53,172,88,84,2,30,1,1
50804,443,11310,443,6337,1378,4959,19,140,9,10
42096,80,4456,80,1711,698,1013,14,17,6,8
43047,80,45126,80,2088,472,1616,15,155,3,12
64674,53,62663,53,183,94,89,2,29,1,1
56327,53,49632,53,172,88,84,2,31,1,1
53876,443,64698,443,499,425,74,4,1,3,1
55022,60100,63915,60100,1550,1130,420,15,25,9,6
49193,443,41261,443,11773,2390,9383,29,19,15,14
49612,53,33123,53,234,94,140,2,31,1,1
59133,443,44471,443,2863,1501,1362,20,315,10,10
56587,53,5530,53,184,94,90,2,31,1,1
49767,53,2563,53,177,94,83,2,30,1,1
56226,53,55576,53,512,187,325,6,58,3,3
47159,443,53350,443,777,432,345,10,15,5,5
65065,53,49362,53,754,94,660,2,31,1,1
53818,15337,22779,15337,258,70,188,4,8,2,2
44404,443,27524,443,9060,3523,5537,27,319,15,12
56499,80,63072,80,277848,13775,264073,301,63,118,183
57284,443,12442,443,1402,917,485,12,27,7,5
52213,80,42925,80,5022,1422,3600,16,135,8,8
55665,53,45679,53,229,94,135,2,30,1,1
53684,25933,35129,25933,552,306,246,9,15,5,4
60404,37869,1264,37869,164,70,94,2,5,1,1
34360,80,12302,80,494,280,214,8,14,5,3
50575,80,13060,80,318,192,126,6,25,4,2
57263,53,19540,53,167,86,81,2,30,1,1
15986,8000,55850,8000,212,150,62,2,30,1,1
60914,53,60914,53,220,100,120,2,31,1,1
29226,80,29226,80,490,264,226,8,35,5,3
64227,53,63621,53,302,92,210,4,30,2,2
60270,443,42458,443,9551,2173,7378,33,26,17,16
56422,53,30231,53,195,102,93,2,30,1,1
56712,443,43897,443,1540037,36876,1503161,1511,62,511,1000
49540,53,39432,53,198,110,88,2,31,1,1
34709,443,21963,443,2119,1310,809,21,27,12,9
55312,53,28336,53,195,102,93,2,31,1,1
64872,53,23783,53,323,94,229,2,30,1,1
34230,53,34230,53,823,98,725,2,31,1,1
56904,80,52022,80,25125,2681,22444,36,318,19,17
50562,443,53886,443,103466,11111,92355,258,140,119,139
64783,53,10599,53,214,94,120,2,30,1,1
39095,443,56882,443,310402,12194,298208,374,82,157,217
52050,80,59091,80,20868,10484,10384,34,32,17,17
45052,443,37093,443,131573,4926,126647,152,152,55,97
60447,36396,16095,36396,70,70,0,2,8,2,0
40671,443,5840,443,190,70,120,4,15,2,2
57157,53,17035,53,755,94,661,2,31,1,1
64913,53,45899,53,183,94,89,2,30,1,1
51907,47518,40645,47518,316,136,180,6,5,3,3
45658,443,10440,443,5359,3152,2207,51,2901,28,23
57881,443,48213,443,3486,2064,1422,26,177,14,12
55037,443,6546,443,130,70,60,3,5,2,1
49257,80,49257,80,19393,1504,17889,30,32,12,18
34670,53,34670,53,257,106,151,2,30,1,1
54996,53,30248,53,252,102,150,2,29,1,1
34240,53,34240,53,229,89,140,2,31,1,1
54986,53,61995,53,214,110,104,2,30,1,1
56519,53,14326,53,167,86,81,2,29,1,1
40845,53,40845,53,210,98,112,2,31,1,1
49020,80,13819,80,3422,2088,1334,18,152,9,9
55189,53,54191,53,211,102,109,2,30,1,1
57030,53,58226,53,283,101,182,4,38,2,2
49930,53,51940,53,258,110,148,2,30,1,1
53798,62166,25360,62166,164,70,94,2,4,1,1
61808,443,61318,443,8189,3146,5043,26,30,14,12
65437,53,59504,53,488,111,377,4,53,2,2
52422,443,1583,443,1043,556,487,10,15,6,4
49330,443,4383,443,7913,2091,5822,23,42,11,12
50536,80,24703,80,24166,3105,21061,31,24,12,19
44036,443,28418,443,6599,3950,2649,36,186,20,16
51910,443,32865,443,308,188,120,4,15,2,2
36834,80,37812,80,12993,6920,6073,22,20,13,9
21772,443,21772,443,17221,1314,15907,31,44,16,15
51221,51413,6783,51413,459,149,310,2,1201,1,1
19473,44929,9531,44929,481,150,331,2,1200,1,1
58638,5900,58638,5900,130,66,64,2,4,1,1
57470,46772,63151,46772,528,528,0,9,1201,9,0
55380,53,27233,53,289,97,192,4,45,2,2
52048,443,14008,443,3182,1568,1614,8,120,4,4
53651,443,17075,443,9485,2173,7312,32,27,17,15
40709,53,32661,53,221,75,146,2,30,1,1
48105,53,48105,53,262,106,156,2,33,1,1
56245,53,35606,53,200,102,98,2,30,1,1
59863,443,54710,443,12809,7765,5044,95,84,55,40
38384,443,38384,443,4609,1702,2907,19,29,11,8
64483,53,53474,53,168,86,82,2,29,1,1
57281,53,42469,53,172,88,84,2,30,1,1
26900,27017,55012,27017,422,164,258,6,30,3,3
65514,53,14703,53,214,110,104,2,29,1,1
35354,443,9498,443,2392,917,1475,16,224,8,8
55042,443,48187,443,5409,1471,3938,21,17,12,9
54955,53,60657,53,177,94,83,2,31,1,1
51868,30305,17475,30305,70,70,0,1,5,1,0
64169,53,50395,53,209,102,107,2,30,1,1
56424,80,11869,80,17135,1507,15628,24,22,9,15
55712,27816,8971,27816,316,190,126,5,16,3,2
44047,443,38951,443,6750,4410,2340,19,120,9,10
38784,443,14395,443,9185,3854,5331,23,16,13,10
56131,53,31536,53,245,94,151,2,30,1,1
50958,80,62860,80,5730351,74236,5656115,4865,78,1088,3777
52010,23685,49442,23685,316,136,180,6,5,3,3
65186,53,5333,53,285,94,191,2,30,1,1
50265,12348,24050,12348,858,858,0,14,1200,14,0
49575,53,59647,53,244,102,142,2,29,1,1
49205,29020,24277,29020,316,136,180,6,7,3,3
56970,80,14502,80,1783,841,942,10,20,6,4
64357,53,57507,53,271,85,186,4,30,2,2
51212,443,57861,443,18745,11713,7032,67,77,37,30
55294,53,35326,53,199,102,97,2,30,1,1
46341,443,54451,443,9172,3518,5654,39,103,21,18
59732,27036,24754,27036,1218,924,294,6,30,3,3
49229,53,8820,53,88,88,0,1,31,1,0
53826,10168,43672,10168,70,70,0,1,5,1,0
33994,443,56656,443,19547,2951,16596,42,82,21,21
49475,53,49996,53,243,110,133,2,30,1,1
55161,53,9497,53,732,89,643,2,30,1,1
34392,443,49266,443,1820,1101,719,18,76,10,8
39804,443,42042,443,56980,4095,52885,90,256,37,53
9451,443,45125,443,5699,505,5194,14,15,7,7
55439,53,44673,53,177,94,83,2,30,1,1
51037,443,13769,443,7298,2661,4637,21,17,11,10
52231,1026,54310,1026,136,136,0,3,14,3,0
49302,443,38802,443,9232,3149,6083,55,40,31,24
50011,53,47474,53,1398,98,1300,4,31,2,2
55586,17332,63048,17332,70,70,0,2,8,2,0
55184,53,63377,53,183,94,89,2,30,1,1
50378,53,9266,53,199,102,97,2,29,1,1
31090,53,31090,53,365,233,132,3,34,2,1
55272,53,11966,53,285,103,182,4,51,2,2
36791,80,9992,80,196328,10952,185376,244,31,117,127
53007,443,38198,443,25010,3519,21491,42,135,17,25
17750,8953,36082,8953,491,150,341,2,1200,1,1
56357,53,35688,53,270,110,160,2,30,1,1
56427,53,59297,53,164,84,80,2,31,1,1
60942,443,40230,443,5081,896,4185,16,70,8,8
49585,53,59933,53,718,94,624,2,30,1,1
56893,53,20902,53,177,94,83,2,31,1,1
47994,443,47994,443,4485,1578,2907,19,28,11,8
40967,443,61086,443,1786,172,1614,7,121,3,4
60796,53,60796,53,248,106,142,2,30,1,1
59762,80,15903,80,1278,774,504,12,361,7,5
10168,80,10168,80,450,246,204,8,24,5,3
56677,53,32244,53,286,103,183,4,48,2,2
51963,443,38927,443,14602,6734,7868,46,56,26,20
59788,443,42215,443,162,102,60,2,5,1,1
51987,80,37675,80,2175,1532,643,10,22,7,3
56773,53,31138,53,183,94,89,2,30,1,1
36058,443,41067,443,11769,1894,9875,27,99,13,14
55313,443,62411,443,4005,1162,2843,17,142,8,9
42286,5228,46877,5228,3489,1598,1891,25,631,7,18
64694,53,57973,53,209,102,107,2,30,1,1
56637,53,51918,53,214,110,104,2,30,1,1
34100,443,31456,443,2044,1024,1020,17,80,9,8
57470,17690,10017,17690,1818,1188,630,26,2804,19,7
64352,53,14227,53,213,102,111,2,29,1,1
58994,443,55812,443,3284,1878,1406,20,27,11,9
48018,443,52238,443,1429,1295,134,10,29,8,2
55165,53,23562,53,193,102,91,2,29,1,1
49871,443,47130,443,615040,25597,589443,704,54,245,459
57987,443,16754,443,3264,1175,2089,14,120,7,7
52937,443,42865,443,22218,12408,9810,66,115,33,33
9148,443,13581,443,6334,840,5494,19,29,10,9
47729,443,6419,443,15600,2166,13434,32,205,16,16
55217,443,55217,443,3239,740,2499,15,40,8,7
51418,53,32808,53,168,78,90,2,30,1,1
49278,80,32439,80,991,525,466,10,136,6,4
49225,80,23885,80,15343,3240,12103,23,81,9,14
53250,443,53250,443,1464,757,707,18,121,9,9
53858,53,53858,53,832,106,726,2,30,1,1
55893,53,24260,53,267,94,173,4,55,2,2
53222,53,43522,53,165,78,87,2,30,1,1
64089,53,20449,53,197,94,103,2,30,1,1
64171,53,47261,53,179,94,85,2,30,1,1
50969,443,44036,443,7221,2265,4956,16,127,7,9
64220,53,21263,53,265,110,155,2,30,1,1
54550,443,8260,443,3296,1329,1967,14,135,7,7
41267,443,45130,443,8248,876,7372,25,186,9,16
65359,53,4725,53,443,182,261,6,30,3,3
56386,53,9835,53,177,94,83,2,31,1,1
55707,53,37897,53,170,87,83,2,31,1,1
64854,53,19682,53,178,94,84,2,31,1,1
6977,53,6977,53,235,90,145,2,32,1,1
9166,443,13455,443,5242,902,4340,16,29,8,8
32729,3389,32729,3389,4021,1916,2105,20,18,12,8
53221,443,43184,443,57706,2486,55220,67,65,23,44
64457,53,27221,53,261,102,159,2,30,1,1
38612,443,17131,443,20651533,655694,19995839,24885,362,8746,16139
56974,53,21612,53,814,110,704,2,30,1,1
64835,53,38888,53,179,94,85,2,30,1,1
49916,53,52400,53,395,111,284,2,31,1,1
49326,443,59214,443,5514,3341,2173,31,75,15,16
52105,1024,36023,1024,70,70,0,2,7,2,0
56326,53,47935,53,177,94,83,2,31,1,1
49798,53,43543,53,196,102,94,2,30,1,1
52041,48103,36252,48103,70,70,0,2,8,2,0
37573,443,7707,443,13637,6347,7290,34,46,20,14
49710,53,26259,53,89,89,0,1,30,1,0
53654,8100,3351,8100,70,70,0,2,8,2,0
58512,5222,4015,5222,2834,1238,1596,26,34,13,13
50567,443,13850,443,1202,720,482,12,139,7,5
42046,443,15950,443,10195,2175,8020,25,187,14,11
56629,443,11922,443,23887293,546911,23340382,23137,108,7700,15437
55656,53,7470,53,214,110,104,2,30,1,1
64611,53,46299,53,189,102,87,2,30,1,1
53957,29970,1762,29970,552,366,186,9,17,6,3
51000,443,31109,443,41713,34380,7333,67,333,38,29
50504,443,47105,443,5476,1073,4403,22,78,12,10
40604,443,31639,443,130,70,60,3,5,2,1
52100,443,58970,443,190,70,120,4,15,2,2
65444,3389,65444,3389,4305,2521,1784,19,34,10,9
55054,443,7526,443,6903,1481,5422,33,612,12,21
37098,443,22843,443,1835,1190,645,17,26,10,7
56459,53,20811,53,209,110,99,2,30,1,1
56396,443,27935,443,4239,1850,2389,25,179,12,13
60869,443,60836,443,10630,3315,7315,27,46,15,12
50568,80,17182,80,318,192,126,6,26,4,2
55687,53,45230,53,193,102,91,2,29,1,1
37576,53,58836,53,168,78,90,2,30,1,1
65344,53,21017,53,90,90,0,1,30,1,0
55200,53,14143,53,209,110,99,2,30,1,1
55719,13302,11300,13302,70,70,0,2,8,2,0
45756,80,2776,80,41602,9508,32094,72,476,36,36
56443,53,2207,53,168,86,82,2,30,1,1
49160,52011,11430,52011,800,150,650,4,1200,2,2
52191,32843,31336,32843,70,70,0,1,4,1,0
57102,443,24363,443,17207,7111,10096,44,51,23,21
64021,53,54662,53,195,102,93,2,30,1,1
26940,443,35054,443,7599,2842,4757,27,22,15,12
56163,53,14069,53,265,85,180,4,42,2,2
64765,53,34365,53,195,94,101,2,30,1,1
56857,53,63903,53,190,97,93,2,31,1,1
56291,53,26927,53,177,94,83,2,31,1,1
52585,53,6341,53,265,91,174,4,40,2,2
57385,53,40272,53,194,99,95,2,31,1,1
41741,443,63716,443,20594,4629,15965,46,317,29,17
53974,53,45539,53,578,286,292,9,15,5,4
37582,443,52781,443,499,425,74,4,0,3,1
50735,443,6692,443,22676,8150,14526,33,16,17,16
51950,80,41291,80,1268,645,623,12,45,7,5
44409,53,42084,53,199,94,105,2,30,1,1
49222,53,15691,53,199,94,105,2,30,1,1
51409,443,64493,443,36713,3193,33520,57,623,23,34
56636,53,49408,53,168,86,82,2,30,1,1
19253,53,19253,53,414,268,146,3,32,2,1
56041,53,23370,53,183,94,89,2,30,1,1
65260,53,3983,53,199,102,97,2,30,1,1
53819,9472,27834,9472,70,70,0,2,7,2,0
37612,443,3287,443,2141,1270,871,18,130,10,8
45551,443,26442,443,7764,1734,6030,23,20,13,10
55513,53,5223,53,184,94,90,2,30,1,1
53123,443,38611,443,1630,1089,541,14,15,8,6
49212,80,1671,80,1013,566,447,8,134,5,3
64344,53,48570,53,286,102,184,4,46,2,2
41474,443,57047,443,2767442,82304,2685138,2961,85,1088,1873
60873,443,47153,443,60954,33730,27224,101,63,50,51
0,0,0,0,244,244,0,2,0,2,0
52791,80,25328,80,82430,3774,78656,108,67,49,59
49422,53,52820,53,719,208,511,6,32,3,3
36327,80,6199,80,1348,844,504,13,255,8,5
34085,80,34085,80,490,264,226,8,140,5,3
51997,14398,23393,14398,130,70,60,2,4,1,1
50690,443,43818,443,354,294,60,2,5,1,1
56587,53,64159,53,184,94,90,2,31,1,1
56612,53,30112,53,274,87,187,4,31,2,2
49385,443,8821,443,16316,7445,8871,49,237,23,26
44164,443,64667,443,280,140,140,5,130,3,2
64408,53,9592,53,257,126,131,2,31,1,1
55965,53,22177,53,184,94,90,2,30,1,1
40192,443,40192,443,11928,3226,8702,23,160,11,12
54819,443,51937,443,9035,1873,7162,28,124,14,14
53622,61393,55834,61393,320,140,180,6,7,3,3
64155,53,47794,53,182,93,89,2,31,1,1
52120,80,3357,80,366,240,126,7,26,5,2
47650,443,47650,443,4585,1678,2907,19,28,11,8
57387,53,49331,53,178,94,84,2,30,1,1
53286,443,1896,443,123194,68738,54456,402,287,167,235
64071,53,28084,53,424,104,320,4,31,2,2
64922,53,2264,53,209,102,107,2,30,1,1
52570,80,52570,80,3886,696,3190,13,142,6,7
60262,443,35496,443,6627,1780,4847,23,149,13,10
49688,53,10693,53,782,110,672,2,30,1,1
54828,53,54828,53,404,259,145,3,33,2,1
57640,80,57640,80,64437,2630,61807,64,31,18,46
49418,27017,12250,27017,239,78,161,2,30,1,1
55159,53,49513,53,199,102,97,2,29,1,1
49199,8106,41963,8106,370,190,180,6,15,3,3
1100,27540,45452,27540,132,70,62,2,31,1,1
61687,80,48451,80,11437,2775,8662,32,53,15,17
32390,53,32390,53,229,89,140,2,30,1,1
40296,80,40296,80,1032410,43358,989052,1356,72,591,765
26900,27017,63917,27017,422,164,258,6,30,3,3
55666,36653,34073,36653,70,70,0,1,5,1,0
58753,443,28125,443,70,70,0,1,5,1,0
53427,443,4839,443,9896,2040,7856,34,120,17,17
60756,40010,4489,40010,316,136,180,6,6,3,3
49415,53,12077,53,313,83,230,4,54,2,2
52022,53657,34064,53657,70,70,0,2,8,2,0
59177,53,0,0,619,76,543,2,30,1,1
40806,443,37490,443,3287,2049,1238,12,31,7,5
55894,53,40691,53,216,102,114,2,30,1,1
63994,53,4398,53,225,110,115,2,30,1,1
64043,53,22374,53,320,94,226,2,29,1,1
27005,27015,60571,27015,902,126,776,2,30,1,1
61438,443,9604,443,4933,771,4162,18,28,8,10
53789,53,10128,53,167,78,89,2,30,1,1
56894,53,27064,53,178,94,84,2,30,1,1
56733,53,5625,53,183,94,89,2,30,1,1
49349,80,49349,80,450,246,204,8,141,5,3
57243,53,20159,53,173,94,79,2,30,1,1
49418,27015,52121,27015,232,71,161,2,31,1,1
52190,80,11921,80,3223,843,2380,12,30,7,5
60277,443,60277,443,7428,729,6699,19,80,7,12
64580,53,16498,53,176,90,86,2,31,1,1
65341,53,7483,53,200,102,98,2,30,1,1
51986,41982,47346,41982,70,70,0,2,8,2,0
56336,53,52213,53,196,102,94,2,35,1,1
5235,34592,6891,34592,247495,256,247239,361,49,5,356
53196,443,1285,443,4371,1115,3256,19,19,9,10
60891,443,53303,443,204,70,134,4,25,2,2
49662,53,29879,53,211,102,109,2,29,1,1
55780,53,61304,53,322,134,188,2,29,1,1
49552,80,31507,80,1963,1067,896,11,15,6,5
56955,53,34703,53,183,94,89,2,30,1,1
49769,53,30329,53,785,110,675,2,30,1,1
56661,443,32722,443,8059,2039,6020,20,15,11,9
56509,80,38678,80,3697,832,2865,12,15,7,5
33063,443,10345,443,6411,1611,4800,24,17,13,11
59829,443,54560,443,948180,35714,912466,1121,119,378,743
56596,53,38999,53,188,96,92,2,31,1,1
49484,443,58905,443,407843,11895,395948,436,271,157,279
51796,48779,55326,48779,70,70,0,2,8,2,0
56709,443,60934,443,1239919,29325,1210594,1214,46,409,805
49900,443,21992,443,6896,2139,4757,31,33,15,16
34600,443,63857,443,7950,1925,6025,26,66,14,12
64017,53,10978,53,461,94,367,2,29,1,1
64012,40642,36772,40642,66,66,0,2,8,2,0
65152,53,32824,53,167,86,81,2,31,1,1
56653,443,22218,443,1272,876,396,10,25,6,4
56643,443,54840,443,7914,1925,5989,20,15,11,9
40040,5223,48273,5223,5386,1100,4286,27,686,10,17
53588,3389,53588,3389,3489,1534,1955,17,16,9,8
34165,443,5648,443,8208,2080,6128,24,81,14,10
53434,443,53434,443,2511,1464,1047,21,102,10,11
46327,25903,25335,25903,332,192,140,6,25,4,2
65366,53,44706,53,458,188,270,6,31,3,3
64782,53,60235,53,212,102,110,2,29,1,1
42298,40016,11792,40016,148,86,62,2,30,1,1
5588,5588,0,0,3354,1792,1562,46,192,23,23
63878,50829,45177,50829,66,66,0,2,8,2,0
58429,443,42456,443,10588,1664,8924,29,631,11,18
56624,53,34436,53,177,94,83,2,30,1,1
49444,53,42796,53,401,88,313,4,38,2,2
56703,80,22325,80,41915,4128,37787,59,64,29,30
51860,53854,28127,53854,70,70,0,2,7,2,0
64729,53,52284,53,770,102,668,2,30,1,1
58755,443,8030,443,11839,7753,4086,30,17,15,15
41444,80,42580,80,1000,577,423,10,200,6,4
56924,53,48740,53,216,110,106,2,30,1,1
57095,53,7010,53,177,94,83,2,30,1,1
65134,53,31124,53,229,110,119,2,30,1,1
46193,53,56530,53,311,86,225,2,30,1,1
5588,5588,0,0,3498,1872,1626,48,195,24,24
56362,53,52775,53,453,186,267,6,30,3,3
57344,443,31123,443,30232,22633,7599,77,23,46,31
56212,53,11758,53,168,86,82,2,31,1,1
46985,53,9920,53,199,94,105,2,30,1,1
65187,53,4197,53,198,101,97,2,30,1,1
49465,443,48053,443,2894,725,2169,10,121,5,5
53754,443,24588,443,499,425,74,4,0,3,1
43861,123,6210,123,184,94,90,2,29,1,1
50532,80,48066,80,4561,2110,2451,15,26,9,6
43472,5228,13384,5228,2531,1416,1115,17,3600,8,9
61923,80,14146,80,4295,719,3576,16,125,8,8
27005,27020,2257,27020,1622,126,1496,4,31,2,2
56035,53,24305,53,173,94,79,2,30,1,1
52243,35643,17676,35643,70,70,0,2,6,2,0
56367,53,30541,53,194,102,92,2,30,1,1
46392,443,48556,443,232,172,60,3,5,2,1
65414,53,10727,53,197,102,95,2,31,1,1
50121,443,24047,443,307104860,2750998,304353862,234597,6122,15017,219580
55226,443,46963,443,8025,3048,4977,23,45,13,10
57221,53,46489,53,184,102,82,2,29,1,1
45077,443,32205,443,6533,1777,4756,24,271,13,11
58780,443,38511,443,5971,706,5265,17,15,7,10
49188,53,58733,53,621,111,510,4,35,2,2
44223,443,7488,443,63895,4604,59291,80,276,34,46
63747,80,64940,80,314,192,122,6,15,4,2
53605,13468,43310,13468,70,70,0,1,4,1,0
57238,53,58179,53,165,86,79,2,30,1,1
45913,443,64072,443,4046,967,3079,13,27,7,6
35048,80,62136,80,15867,2466,13401,29,33,16,13
64810,53,57933,53,199,102,97,2,30,1,1
60500,44739,7471,44739,70,70,0,1,5,1,0
59420,443,36806,443,7913,5787,2126,28,316,14,14
64283,53,28343,53,186,95,91,2,31,1,1
64420,53,3288,53,194,102,92,2,31,1,1
53208,80,52746,80,2953,785,2168,12,116,8,4
10371,53,10371,53,404,259,145,3,33,2,1
57470,6881,10120,6881,163,163,0,1,1200,1,0
49475,443,44120,443,10402,1945,8457,24,158,11,13
41164,443,62496,443,8582,4759,3823,29,135,14,15
55005,443,32809,443,134,60,74,3,11,2,1
58994,443,24369,443,204,70,134,4,25,2,2
50210,1688,19159,1688,70,70,0,2,8,2,0
37965,18122,9264,18122,3957,2324,1633,51,1794,29,22
49719,443,28042,443,4717,849,3868,15,52,7,8
63989,53,19416,53,259,110,149,2,30,1,1
57323,53,24768,53,194,102,92,2,31,1,1
49321,443,15064,443,3005,2082,923,18,28,9,9
50534,80,11143,80,318,192,126,6,25,4,2
50823,80,36399,80,35970,11674,24296,108,265,55,53
53832,443,1159,443,499,425,74,4,0,3,1
50074,53,31884,53,168,86,82,2,30,1,1
56390,53,2004,53,701,88,613,2,30,1,1
54139,53,64934,53,168,78,90,2,31,1,1
61465,443,63826,443,9619,879,8740,19,135,8,11
56588,443,28580,443,10615,5909,4706,28,42,14,14
56596,53,31650,53,194,102,92,2,30,1,1
49296,53,29013,53,186,95,91,2,31,1,1
49590,80,22848,80,314,128,186,6,26,3,3
64853,53,39005,53,199,102,97,2,30,1,1
51919,443,36228,443,17595,8241,9354,80,106,43,37
39774,443,8618,443,69542,11991,57551,139,157,60,79
49634,53,43147,53,344,126,218,2,30,1,1
58843,443,44716,443,6033,770,5263,18,16,8,10
65343,53,45711,53,197,102,95,2,30,1,1
55471,53,40426,53,760,97,663,2,31,1,1
56728,53,11841,53,166,86,80,2,30,1,1
60971,443,28807,443,396507,14667,381840,458,21,171,287
57268,53,42841,53,205,94,111,2,30,1,1
38714,443,54689,443,90043,3609,86434,97,15,33,64
64790,53,14045,53,178,94,84,2,29,1,1
57122,53,32018,53,216,110,106,2,30,1,1
57470,6889,39885,6889,507,163,344,2,1200,1,1
64338,53,41701,53,200,102,98,2,30,1,1
50290,443,49413,443,26064,2233,23831,44,97,23,21
55039,53,9278,53,177,94,83,2,30,1,1
55841,53,55031,53,265,86,179,4,59,2,2
49722,443,17749,443,5943,850,5093,16,50,7,9
51790,80,59266,80,1936,1085,851,9,15,5,4
56994,53,19050,53,177,94,83,2,30,1,1
63814,12906,14738,12906,70,70,0,1,5,1,0
57470,41071,64833,41071,1716,1716,0,27,1598,27,0
55975,53,39571,53,195,102,93,2,30,1,1
49169,53,65143,53,184,94,90,2,30,1,1
64040,12226,50739,12226,70,70,0,1,4,1,0
62237,443,62237,443,169315,5255,164060,190,77,66,124
33827,443,18177,443,696,152,544,11,48,3,8
30728,53,30728,53,196,88,108,2,30,1,1
55387,53,17527,53,761,100,661,2,31,1,1
51951,443,56049,443,6633,3485,3148,34,197,19,15
27005,27014,42282,27014,882,126,756,2,30,1,1
64238,53,60413,53,213,102,111,2,30,1,1
64586,443,13912,443,8573,2039,6534,25,32,14,11
56500,53,54568,53,164,86,78,2,30,1,1
57470,34617,39417,34617,481,150,331,2,1199,1,1
9137,80,35596,80,908,842,66,7,18,6,1
65176,53,60246,53,299,103,196,4,53,2,2
35353,443,65162,443,1833,991,842,14,224,7,7
50689,80,10754,80,54757,28216,26541,229,175,114,115
27005,1305,52487,1305,855,126,729,2,30,1,1
55261,53,52324,53,183,94,89,2,29,1,1
55517,53,21431,53,174,89,85,2,31,1,1
42207,443,33313,443,7870,2945,4925,19,136,9,10
55840,443,56226,443,9374,2150,7224,42,255,19,23
51260,80,28140,80,2339,1680,659,11,17,6,5
13980,53,13980,53,213,87,126,2,31,1,1
53121,8986,30082,8986,70,70,0,1,5,1,0
50568,443,35404,443,5877,1792,4085,21,81,12,9
42298,40031,52392,40031,156,94,62,2,30,1,1
58860,443,58775,443,5594,3484,2110,16,15,8,8
64823,53,49719,53,754,94,660,2,30,1,1
49307,53,61453,53,210,102,108,2,29,1,1
41294,443,46411,443,7595,1115,6480,18,35,10,8
36061,53,36061,53,220,100,120,2,30,1,1
64835,53,41380,53,179,94,85,2,30,1,1
56800,443,21923,443,79399,4048,75351,90,120,32,58
49532,53,28306,53,730,102,628,2,31,1,1
51989,80,41304,80,4166,1708,2458,14,16,7,7
55926,53,47769,53,184,94,90,2,29,1,1
50958,53,61318,53,94,94,0,1,30,1,0
56799,1,48991,1,316,136,180,6,6,3,3
56724,443,8554,443,14956,2081,12875,30,20,16,14
64756,53,24462,53,757,98,659,2,30,1,1
27005,27016,31550,27016,884,126,758,2,30,1,1
65359,53,28420,53,193,102,91,2,30,1,1
55106,53,36714,53,314,94,220,4,33,2,2
55442,53,42681,53,177,94,83,2,30,1,1
53779,24874,26263,24874,70,70,0,2,8,2,0
53744,443,46972,443,499,425,74,4,0,3,1
50981,443,20620,443,5553,1179,4374,24,80,13,11
57582,443,57582,443,2506,1461,1045,21,88,10,11
64023,12954,37073,12954,504,382,122,8,15,6,2
27005,27016,17178,27016,914,126,788,2,31,1,1
64389,53,21920,53,244,94,150,2,30,1,1
49242,443,26105,443,4528,803,3725,14,15,8,6
50178,53,23159,53,758,96,662,2,31,1,1
2939,53,2939,53,200,90,110,2,30,1,1
38772,443,61255,443,410,210,200,7,86,4,3
49718,53,50641,53,184,94,90,2,30,1,1
53479,80,7819,80,3307,937,2370,17,16,10,7
58739,443,43331,443,22751,17995,4756,67,73,42,25
65176,53,65083,53,183,94,89,2,30,1,1
65044,443,31714,443,4446,2496,1950,9,120,5,4
56945,53,27105,53,176,90,86,2,31,1,1
56411,53,33416,53,184,94,90,2,31,1,1
52925,53,48232,53,168,78,90,2,29,1,1
39995,443,64142,443,6812,2910,3902,31,282,8,23
60469,60092,63327,60092,70,70,0,1,5,1,0
50877,443,13364,443,7984,2447,5537,41,2904,24,17
57057,53,64992,53,194,102,92,2,31,1,1
53716,443,15837,443,70,70,0,1,5,1,0
53726,26083,31165,26083,70,70,0,1,5,1,0
56634,80,24022,80,234,234,0,4,12,4,0
27005,27015,58465,27015,881,126,755,2,30,1,1
34417,443,59906,443,6378,1571,4807,23,315,12,11
34158,443,8410,443,130,70,60,2,15,1,1
52327,443,53473,443,134,60,74,3,6,2,1
51836,37753,57785,37753,70,70,0,1,4,1,0
39682,443,54017,443,4439,862,3577,16,160,9,7
50645,53,27805,53,177,94,83,2,30,1,1
53721,443,6188,443,70,70,0,1,4,1,0
54324,7000,54324,7000,4007,1690,2317,15,0,8,7
55535,53,2360,53,199,102,97,2,31,1,1
34331,443,59493,443,9415,3998,5417,23,301,11,12
64633,53,4250,53,762,98,664,2,30,1,1
58888,443,23971,443,7329,949,6380,17,35,7,10
53626,33194,41822,33194,70,70,0,2,7,2,0
56712,53,57306,53,170,87,83,2,31,1,1
60786,443,40740,443,12106,2192,9914,38,38,19,19
55980,123,7764,123,184,94,90,2,30,1,1
0,0,0,0,320,320,0,5,0,5,0
49414,53,44484,53,561,112,449,4,53,2,2
56235,53,15523,53,199,94,105,2,30,1,1
56639,80,24086,80,234,234,0,4,12,4,0
65495,53,62386,53,209,110,99,2,31,1,1
49603,53,29581,53,199,102,97,2,30,1,1
53760,45682,34507,45682,70,70,0,2,7,2,0
64551,53,55757,53,755,94,661,2,31,1,1
51566,53,46943,53,239,102,137,2,30,1,1
41575,443,49577,443,24256,1841,22415,41,131,18,23
49284,6881,63605,6881,411,225,186,6,16,3,3
65176,53,48862,53,193,102,91,2,31,1,1
56783,53,31906,53,751,95,656,2,31,1,1
50438,53,8831,53,199,102,97,2,29,1,1
50454,80,50454,80,450,246,204,8,33,5,3
64340,53,64340,53,237,91,146,2,33,1,1
62023,53,10426,53,301,102,199,2,30,1,1
56513,53,54850,53,215,102,113,2,30,1,1
55630,43736,23766,43736,70,70,0,2,8,2,0
50351,80,28696,80,1083,653,430,8,15,5,3
37907,443,63465,443,9227,2999,6228,64,616,35,29
64778,53,20977,53,269,110,159,2,30,1,1
53530,8999,1234,8999,70,70,0,1,5,1,0
49914,53,31140,53,215,86,129,2,30,1,1
49536,53,5228,53,239,94,145,2,30,1,1
55431,53,28791,53,192,98,94,2,30,1,1
56611,53,45220,53,177,94,83,2,30,1,1
49633,53,1926,53,245,94,151,2,29,1,1
54086,443,46250,443,4982,2205,2777,46,61,24,22
64332,53,28123,53,166,85,81,2,31,1,1
49840,53,48921,53,277,102,175,2,30,1,1
55444,443,59927,443,1455177,56285,1398892,1600,31,632,968
64762,53,23924,53,200,94,106,2,30,1,1
57196,53,22247,53,754,94,660,2,31,1,1
50310,80,55858,80,7979,802,7177,17,57,8,9
52732,443,31396,443,27467,22472,4995,85,42,45,40
52605,443,40382,443,3523,518,3005,12,15,6,6
11919,53,11919,53,213,79,134,2,32,1,1
37624,443,54201,443,471102,14016,457086,503,25,191,312
49989,53,42243,53,677,217,460,6,74,3,3
42273,443,42273,443,4398,1491,2907,19,26,11,8
55991,53,7983,53,183,94,89,2,30,1,1
46492,80,56877,80,1967,1133,834,12,45,7,5
50064,80,16215,80,186,64,122,4,25,2,2
56769,443,25443,443,7941,1952,5989,20,15,11,9
26900,27017,21436,27017,422,164,258,6,30,3,3
50283,443,2548,443,49752,4187,45565,87,100,45,42
33624,443,6639,443,247438,52606,194832,305,237,124,181
55837,53,36982,53,195,102,93,2,29,1,1
49351,53,12256,53,164,84,80,2,30,1,1
65256,53,14067,53,213,102,111,2,30,1,1
55688,53,32958,53,182,93,89,2,30,1,1
56260,80,50522,80,72600,58760,13840,186,1232,107,79
37571,443,14290,443,499,425,74,4,0,3,1
60795,443,29587,443,3282,1018,2264,10,121,5,5
63809,45193,55077,45193,66,66,0,1,5,1,0
60750,53,24428,53,198,93,105,2,30,1,1
49316,53,61603,53,184,94,90,2,30,1,1
50398,80,47950,80,318,192,126,6,26,4,2
60863,53,60863,53,298,114,184,2,30,1,1
44158,443,51060,443,232,172,60,3,5,2,1
58986,443,40709,443,10624,6845,3779,50,123,25,25
46640,443,38435,443,10768,1726,9042,35,199,17,18
49432,53,56971,53,170,87,83,2,31,1,1
32928,443,19319,443,1527,940,587,14,90,8,6
50079,443,3173,443,32829,8718,24111,41,17,18,23
50511,80,14463,80,318,192,126,6,25,4,2
50600,53,50600,53,257,101,156,2,34,1,1
51648,443,53191,443,30116,4336,25780,44,123,18,26
50326,443,38402,443,552885,34781,518104,733,245,314,419
53283,443,23870,443,9121,2486,6635,22,45,13,9
49429,53,19279,53,210,110,100,2,30,1,1
57127,53,59492,53,186,95,91,2,31,1,1
56618,443,31063,443,3096,1882,1214,19,16,10,9
55462,53,6708,53,194,102,92,2,30,1,1
64102,53,54377,53,619,102,517,4,43,2,2
45452,443,54388,443,16362,3716,12646,79,601,38,41
57316,443,30855,443,5613,733,4880,16,15,9,7
56561,53,36683,53,167,86,81,2,30,1,1
53131,44021,31517,44021,698,320,378,10,16,6,4
9322,443,10424,443,4106,703,3403,15,26,8,7
27005,1303,22373,1303,868,126,742,2,30,1,1
56705,443,63668,443,8007,1987,6020,20,15,11,9
55887,53,33560,53,166,86,80,2,31,1,1
38387,80,17970,80,2008,810,1198,20,394,7,13
48606,443,28779,443,4160,2675,1485,25,95,14,11
41336,443,51571,443,350,210,140,6,30,4,2
58875,443,10382,443,5168,700,4468,16,15,7,9
43837,443,18055,443,5733,1543,4190,24,28,13,11
60137,443,42633,443,10407,3966,6441,30,149,18,12
65422,443,52517,443,2494,1643,851,17,23,9,8
51815,80,14356,80,3910,2158,1752,15,32,10,5
53863,443,64176,443,13492,3615,9877,42,120,20,22
37965,63666,47723,63666,10717,6715,4002,121,4588,71,50
49207,443,35553,443,9852,2190,7662,49,257,22,27
53719,443,48486,443,70,70,0,2,8,2,0
58771,443,41397,443,4726,2487,2239,19,305,9,10
50089,53,56216,53,718,94,624,2,30,1,1
52238,48996,6858,48996,70,70,0,2,4,2,0
55812,53,55812,53,235,90,145,2,32,1,1
55829,53,51099,53,177,94,83,2,30,1,1
42873,443,33511,443,3379,2111,1268,19,15,10,9
65246,53,33087,53,174,89,85,2,31,1,1
55032,443,43927,443,12704,3182,9522,35,49,16,19
60972,443,43346,443,10208,5093,5115,46,15,27,19
23283,53,47679,53,344,78,266,2,30,1,1
50265,37711,22022,37711,132,132,0,3,1200,3,0
49435,53,64990,53,608,199,409,6,69,3,3
48245,443,12754,443,7417,1760,5657,21,256,12,9
63978,53,35344,53,214,110,104,2,30,1,1
65184,53,13116,53,166,86,80,2,30,1,1
55563,53,56094,53,188,96,92,2,31,1,1
49958,80,11985,80,11173,821,10352,19,15,9,10
60794,20010,30261,20010,70,70,0,2,8,2,0
65405,53,50341,53,560,104,456,4,43,2,2
49369,53,54778,53,183,94,89,2,30,1,1
55088,53,34841,53,177,94,83,2,30,1,1
65384,53,45912,53,735,88,647,2,31,1,1
49326,53,31358,53,193,102,91,2,31,1,1
54022,443,20800,443,121935,7839,114096,175,255,82,93
64510,443,61997,443,18370,2434,15936,26,120,11,15
56004,443,20130,443,53826,3670,50156,85,275,41,44
64538,53,28152,53,188,96,92,2,31,1,1
64299,53,64359,53,166,86,80,2,30,1,1
64639,53,46471,53,199,102,97,2,30,1,1
37939,80,33562,80,1616,1302,314,10,15,5,5
6881,48608,12608,48608,228,118,110,2,1199,1,1
46822,3389,46822,3389,3457,1568,1889,17,21,10,7
45205,443,55089,443,7221,3151,4070,20,162,9,11
55752,53,6985,53,200,102,98,2,30,1,1
56254,53,3663,53,498,204,294,6,30,3,3
53173,25067,40514,25067,70,70,0,1,5,1,0
64128,53,26433,53,193,102,91,2,30,1,1
55195,443,24998,443,3543,1855,1688,20,122,10,10
56326,53,1837,53,177,94,83,2,29,1,1
35047,53,40543,53,214830,214584,246,2594,88,2591,3
55538,53,2707,53,168,86,82,2,30,1,1
45944,443,12806,443,4715,1935,2780,24,183,11,13
36256,443,43168,443,3871,2466,1405,22,95,12,10
56599,80,32983,80,234,234,0,4,12,4,0
52232,35126,13178,35126,70,70,0,1,5,1,0
60883,443,40215,443,11586,5435,6151,46,46,25,21
64614,53,45879,53,616,188,428,6,35,3,3
43311,80,24777,80,811,671,140,6,31,4,2
55683,19215,63970,19215,320,140,180,6,7,3,3
49782,443,53470,443,70,70,0,2,7,2,0
56070,53,23575,53,193,102,91,2,30,1,1
65000,53,35253,53,184,102,82,2,30,1,1
56763,443,10844,443,8058,2038,6020,20,15,11,9
59983,443,26904,443,296863,14073,282790,351,127,130,221
28003,443,64020,443,5515,1388,4127,18,15,9,9
49690,53,24171,53,216,110,106,2,30,1,1
57099,53,12968,53,278,102,176,2,31,1,1
50486,80,43523,80,378,192,186,7,21,4,3
50252,53,45062,53,173,94,79,2,30,1,1
56661,53,9185,53,297,102,195,4,34,2,2
48756,80,48756,80,560,264,296,9,44,5,4
64559,53,63710,53,198,102,96,2,30,1,1
51987,443,55315,443,134,60,74,3,5,2,1
56654,53,54903,53,102,102,0,2,31,2,0
45427,80,37690,80,350,210,140,6,28,4,2
49650,53,49396,53,776,102,674,2,31,1,1
32618,53,32618,53,231,90,141,2,31,1,1
6881,25243,30519,25243,498,150,348,4,1273,2,2
50890,80,12548,80,290951,15209,275742,327,141,132,195
37759,53,3026,53,199,94,105,2,30,1,1
64816,53,25047,53,166,86,80,2,30,1,1
56238,80,56238,80,44951,1019,43932,48,15,15,33
65451,53,7550,53,178,94,84,2,31,1,1
57319,53,22543,53,176,90,86,2,30,1,1
57177,443,54507,443,1610,771,839,22,120,11,11
55352,53,46162,53,216,110,106,2,30,1,1
56699,443,19537,443,8006,1986,6020,20,15,11,9
49418,27058,37318,27058,263,78,185,2,30,1,1
58379,443,57467,443,24040,4851,19189,86,160,41,45
62478,443,29633,443,10391,7059,3332,27,27,15,12
42971,3478,56626,3478,452,280,172,5,30,3,2
50207,53,41164,53,189,102,87,2,30,1,1
50426,443,9963,443,5713,1079,4634,15,26,8,7
64209,53,25156,53,277,94,183,2,30,1,1
38536,443,1919,443,33980,7386,26594,51,121,22,29
56421,53,5669,53,350,94,256,2,30,1,1
51667,443,62904,443,1203,703,500,14,42,8,6
57139,53,51563,53,166,86,80,2,30,1,1
56940,53,20579,53,316,97,219,4,33,2,2
60945,443,60945,443,4680,1773,2907,19,29,11,8
55848,53,3289,53,387,134,253,2,30,1,1
55583,14822,28217,14822,70,70,0,1,5,1,0
45315,443,19700,443,56118,3429,52689,77,26,35,42
55497,53,23337,53,184,102,82,2,29,1,1
51753,7000,51753,7000,3638,2087,1551,17,15,10,7
57061,53,28599,53,1780,674,1106,18,68,9,9
49216,53,25748,53,178,91,87,2,31,1,1
49274,53,51381,53,197,102,95,2,29,1,1
57312,53,57312,53,208,94,114,2,30,1,1
39612,443,50624,443,482030,16677,465353,539,28,207,332
23613,53,55694,53,177,94,83,2,29,1,1
52930,443,25439,443,4596,1029,3567,15,26,9,6
54990,443,49240,443,20961,10306,10655,49,48,25,24
49813,53,53266,53,775,102,673,2,30,1,1
51620,443,44132,443,4320,932,3388,16,15,10,6
55887,443,44668,443,3954,778,3176,17,121,8,9
54446,443,54881,443,2782,1778,1004,20,33,10,10
49504,443,22336,443,62,62,0,1,5,1,0
55076,53,45529,53,182,93,89,2,31,1,1
65075,53,31161,53,293,94,199,2,29,1,1
64749,53,28339,53,199,94,105,2,33,1,1
60121,443,30083,443,6351,1857,4494,20,16,11,9
64795,53,2622,53,338,110,228,2,30,1,1
52015,25487,39642,25487,70,70,0,1,5,1,0
44783,443,27769,443,4173582,66515,4107067,3494,129,510,2984
64958,53,42023,53,197,102,95,2,31,1,1
51073,80,13586,80,525373,237667,287706,1387,390,693,694
42222,53,45931,53,209,86,123,2,30,1,1
55997,53,30863,53,716,95,621,2,30,1,1
55187,53,45900,53,172,94,78,2,29,1,1
56658,443,12805,443,1560,988,572,13,23,7,6
56822,53,28434,53,184,94,90,2,30,1,1
65131,53,39663,53,168,86,82,2,31,1,1
53727,53,60009,53,172,72,100,2,30,1,1
59191,443,56618,443,4489,2046,2443,23,121,11,12
45459,53,25942,53,198,93,105,2,31,1,1
56357,53,47293,53,196,102,94,2,30,1,1
53432,53,53432,53,197,76,121,2,31,1,1
49648,80,25450,80,318,192,126,6,41,4,2
51952,50967,36786,50967,70,70,0,2,7,2,0
49367,53,7025,53,548,112,436,4,36,2,2
3155,23,3155,23,66,66,0,1,5,1,0
36215,443,40898,443,3554,2208,1346,18,256,10,8
49711,443,12474,443,18088,1844,16244,34,130,14,20
49711,80,42345,80,2269,821,1448,15,51,8,7
55070,53,21493,53,195,102,93,2,30,1,1
64967,53,8909,53,184,94,90,2,29,1,1
57470,50321,35732,50321,490,149,341,2,1201,1,1
56182,53,55538,53,762,98,664,2,0,1,1
55284,443,12539,443,2895,726,2169,10,121,5,5
60513,443,43919,443,9047,2015,7032,25,39,13,12
54666,123,26890,123,184,94,90,2,31,1,1
64824,443,53612,443,2442,356,2086,12,120,5,7
50865,53,50865,53,242,98,144,2,30,1,1
37253,443,5340,443,6840,1556,5284,32,26,17,15
41405,443,41405,443,4565,1658,2907,19,29,11,8
57130,53,10466,53,778,103,675,2,31,1,1
58046,53,58046,53,231,88,143,2,32,1,1
42820,443,40301,443,20255,5440,14815,32,122,16,16
60150,443,32146,443,7741,2692,5049,24,16,13,11
56326,53,34552,53,177,94,83,2,30,1,1
48817,49490,48817,49490,513,152,361,2,1200,1,1
65059,53,35510,53,168,86,82,2,30,1,1
58443,443,26143,443,12060,3749,8311,42,17,23,19
51275,10924,1826,10924,70,70,0,1,5,1,0
43197,80,55210,80,3605,1700,1905,16,186,9,7
50510,80,5594,80,378,192,186,7,25,4,3
50022,53,60834,53,174,89,85,2,31,1,1
48111,443,2939,443,214,140,74,4,15,3,1
65140,53,64543,53,198,101,97,2,30,1,1
58459,53,37044,53,307,86,221,2,29,1,1
56170,53,52947,53,198,102,96,2,31,1,1
27005,37569,6063,37569,880,126,754,2,31,1,1
17750,50321,45531,50321,491,150,341,2,1200,1,1
50584,6881,29773,6881,502,150,352,2,1200,1,1
64894,53,1246,53,550,113,437,4,46,2,2
50875,443,41381,443,1786,172,1614,7,121,3,4
55620,53,62411,53,178,94,84,2,30,1,1
65365,53,42836,53,196,102,94,2,31,1,1
50584,61867,27152,61867,166,166,0,1,1200,1,0
65277,53,40732,53,199,102,97,2,30,1,1
55577,53,3000,53,699,204,495,6,57,3,3
56199,53,11587,53,79,79,0,2,33,2,0
5578,53,5578,53,288,83,205,2,31,1,1
11992,443,11992,443,12020,5977,6043,38,30,23,15
53796,443,58960,443,499,425,74,4,0,3,1
49738,53,2728,53,215,102,113,2,30,1,1
53238,443,61389,443,13597,1371,12226,26,323,11,15
60045,443,3000,443,1573,769,804,16,47,9,7
55042,443,45406,443,126,60,66,3,5,2,1
57470,56098,25356,56098,1359,726,633,6,1199,3,3
51501,443,62787,443,10861,5281,5580,65,49,33,32
18166,53,18166,53,825,99,726,2,30,1,1
64065,53,29677,53,270,94,176,2,30,1,1
19116,53,19116,53,398,255,143,3,33,2,1
63972,53,28656,53,325,94,231,2,30,1,1
64883,53,48996,53,184,94,90,2,30,1,1
60376,443,21896,443,9379,2092,7287,21,126,9,12
50579,80,47300,80,1827,989,838,13,78,7,6
57276,443,44097,443,14236,2699,11537,51,31,27,24
53766,3596,64680,3596,70,70,0,2,8,2,0
55580,45817,63033,45817,70,70,0,1,5,1,0
57343,53,26142,53,178,91,87,2,31,1,1
65048,53,32798,53,194,102,92,2,30,1,1
48067,443,48553,443,12648,5285,7363,58,32,27,31
57351,53,48672,53,184,94,90,2,29,1,1
33938,443,14561,443,6919,2112,4807,19,15,10,9
65377,53,29691,53,193,102,91,2,30,1,1
65189,28515,39536,28515,266,78,188,2,30,1,1
56616,53,31793,53,183,94,89,2,30,1,1
55049,443,4491,443,1600,1089,511,13,151,7,6
65019,53,29209,53,195,102,93,2,31,1,1
45533,80,45533,80,52365,3013,49352,53,51,13,40
64974,27054,45428,27054,3142,1386,1756,8,31,4,4
60796,443,14652,443,69973,4662,65311,108,135,43,65
62109,443,64847,443,21219,1329,19890,32,122,13,19
57296,53,45722,53,200,102,98,2,30,1,1
49952,53,65134,53,195,102,93,2,31,1,1
60207,80,10851,80,3596,2562,1034,14,151,8,6
53398,443,48527,443,5196,2308,2888,34,137,16,18
51941,19333,59185,19333,70,70,0,1,5,1,0
50523,53,31491,53,199,102,97,2,30,1,1
56349,53,21926,53,216,110,106,2,30,1,1
65498,53,39980,53,209,110,99,2,30,1,1
47500,443,47942,443,7464,2375,5089,15,120,7,8
49429,53,29436,53,188,96,92,2,31,1,1
55655,63670,23563,63670,70,70,0,2,8,2,0
44040,443,39447,443,11774,5465,6309,75,585,38,37
35610,80,8611,80,1970,977,993,12,61,7,5
64588,443,57526,443,9156,2109,7047,27,32,15,12
65188,53,34848,53,213,102,111,2,30,1,1
37584,80,39013,80,3587,2484,1103,19,135,10,9
50430,80,29932,80,318,192,126,6,26,4,2
51497,443,10165,443,350,210,140,6,14,4,2
56227,53,39156,53,194,102,92,2,30,1,1
57332,53,59062,53,184,102,82,2,30,1,1
51974,443,46910,443,17456,7877,9579,47,49,24,23
55774,53,26343,53,701,88,613,2,30,1,1
44099,443,23895,443,8049289,98432,7950857,6501,125,717,5784
34043,443,15753,443,7280,4154,3126,30,735,16,14
38501,53,38501,53,233,91,142,2,31,1,1
9133,80,26542,80,318,192,126,6,30,4,2
52985,80,52009,80,3111,1364,1747,28,112,15,13
62905,443,5789,443,8426,2893,5533,27,16,15,12
53956,41578,43631,41578,492,306,186,8,17,5,3
53848,43725,33158,43725,552,306,246,9,15,5,4
55702,80,29070,80,70,70,0,1,5,1,0
55670,31056,27603,31056,70,70,0,1,5,1,0
50354,443,37764,443,71226,18632,52594,137,318,63,74
57886,53,57886,53,216,90,126,2,29,1,1
65482,53,50244,53,179,94,85,2,30,1,1
54492,80,36549,80,1384,937,447,9,360,5,4
59802,53,61597,53,168,78,90,2,30,1,1
51898,50677,11184,50677,70,70,0,2,8,2,0
53118,443,63279,443,21933,11660,10273,206,188,114,92
52925,443,2164,443,114867,4243,110624,128,120,44,84
60362,443,18140,443,130,70,60,2,15,1,1
39717,443,63809,443,10921,3102,7819,25,217,13,12
64122,53,29748,53,214,110,104,2,30,1,1
62229,443,62229,443,211574,21152,190422,236,96,92,144
26462,80,26462,80,490,264,226,8,32,5,3
53805,34155,31252,34155,70,70,0,2,7,2,0
64140,53,48538,53,184,94,90,2,30,1,1
60496,56871,22838,56871,504,318,186,8,15,5,3
52150,37603,39264,37603,70,70,0,2,7,2,0
57419,443,3080,443,9224,2381,6843,29,19,14,15
65442,443,8292,443,3783,1087,2696,11,120,5,6
65260,53,12231,53,184,94,90,2,30,1,1
50447,53,27142,53,765,102,663,2,30,1,1
52903,443,59181,443,3478,1580,1898,21,31,12,9
53318,56648,63034,56648,672,432,240,10,142,6,4
49741,80,28243,80,1149,412,737,8,17,5,3
64000,14441,35024,14441,66,66,0,2,7,2,0
27005,29999,13147,29999,876,126,750,2,31,1,1
64968,53,11084,53,87,87,0,1,31,1,0
51774,16930,45672,16930,70,70,0,2,8,2,0
12532,80,12532,80,6215,769,5446,14,16,7,7
50427,80,43709,80,312,192,120,6,27,4,2
51913,52188,58050,52188,66,66,0,1,5,1,0
33133,443,21005,443,8138,2101,6037,17,121,9,8
50158,53,45524,53,758,96,662,2,30,1,1
6881,16869,32052,16869,509,150,359,2,1200,1,1
53237,443,53237,443,1210,637,573,14,34,7,7
64585,53,55669,53,210,110,100,2,30,1,1
59862,443,40236,443,5301,953,4348,17,28,9,8
48360,443,45618,443,8400,2088,6312,33,20,18,15
55607,17820,29778,17820,504,318,186,8,16,5,3
37663,443,39550,443,8493,2314,6179,33,15,18,15
55743,53,47802,53,165,86,79,2,30,1,1
33856,443,15413,443,8171028,105740,8065288,6637,149,745,5892
54977,80,22361,80,4259,1114,3145,12,18,8,4
38334,22,38334,22,9022,3349,5673,57,43,26,31
53181,443,19571,443,2309,1443,866,16,17,8,8
49175,2710,30746,2710,70,70,0,2,8,2,0
58856,443,36240,443,6350667,198580,6152087,6885,451,2497,4388
37965,27261,16872,27261,150,150,0,1,1199,1,0
64051,53,27383,53,430,172,258,6,59,3,3
48817,47719,48817,47719,1837,852,985,8,1200,4,4
64946,53,5511,53,452,118,334,2,30,1,1
51976,11816,61215,11816,70,70,0,2,8,2,0
56382,53,5952,53,195,102,93,2,31,1,1
65370,53,21172,53,193,102,91,2,30,1,1
49223,80,54325,80,1793,1030,763,11,15,6,5
40242,443,42973,443,7407,2516,4891,37,32,19,18
60287,80,59923,80,10135,7433,2702,28,164,19,9
11582,41599,40027,41599,70,70,0,1,5,1,0
49418,27018,26196,27018,71,71,0,1,31,1,0
27005,30010,26771,30010,887,126,761,2,31,1,1
54807,53,14408,53,206,86,120,2,30,1,1
55674,53,14625,53,744,89,655,2,31,1,1
57470,14435,56762,14435,1035,253,782,4,1200,2,2
34306,53,34306,53,241,98,143,2,30,1,1
55476,80,7666,80,498,280,218,8,26,5,3
65139,53,58108,53,754,94,660,2,31,1,1
49689,53,60193,53,812,110,702,2,30,1,1
50802,80,54812,80,3874,684,3190,11,141,6,5
43027,80,42429,80,1506,1446,60,2,5,1,1
52003,80,9765,80,88807,5957,82850,113,15,54,59
37568,443,2020,443,499,425,74,4,0,3,1
52208,47300,63479,47300,70,70,0,1,5,1,0
65180,53,3585,53,165,86,79,2,29,1,1
39724,443,26600,443,6128,1344,4784,19,87,12,7
49572,443,43054,443,1820,1101,719,18,18,10,8
55555,53,39560,53,188,96,92,2,31,1,1
41282,53,19391,53,168,78,90,2,30,1,1
40204,40005,24841,40005,148,86,62,2,30,1,1
65018,53,37688,53,152,78,74,2,30,1,1
42922,80,60551,80,78,78,0,1,4,1,0
56579,53,34186,53,711,87,624,2,30,1,1
65526,53,17627,53,199,102,97,2,29,1,1
13859,53,13859,53,215,98,117,2,30,1,1
57166,53,41004,53,170,87,83,2,30,1,1
50054,53,65410,53,775,103,672,2,31,1,1
65049,53,16377,53,210,110,100,2,30,1,1
55451,53,40344,53,816,102,714,2,29,1,1
58969,80,39801,80,1431,783,648,10,75,6,4
51942,22272,28402,22272,140,70,70,2,5,1,1
54251,443,43085,443,499,425,74,4,0,3,1
38603,5228,52662,5228,3534,1679,1855,30,3640,11,19
43032,443,31725,443,6792,3009,3783,20,46,12,8
60770,40010,17084,40010,316,136,180,6,6,3,3
39272,443,24238,443,7134,1963,5171,22,284,11,11
54992,53,53080,53,195,102,93,2,29,1,1
51230,80,14122,80,579418,15579,563839,599,76,219,380
56230,80,56230,80,44881,949,43932,47,15,14,33
55958,53,17152,53,177,94,83,2,30,1,1
51921,37744,59756,37744,70,70,0,2,8,2,0
57416,53,53787,53,193,102,91,2,30,1,1
55639,53,39796,53,292,102,190,2,29,1,1
55426,53,8033,53,181,98,83,2,30,1,1
50305,443,11776,443,3325,1851,1474,19,16,9,10
33143,80,14116,80,7406,1038,6368,18,15,10,8
27005,27015,55780,27015,873,126,747,3,31,2,1
64284,53,55514,53,229,110,119,2,30,1,1
50684,443,36548,443,6909,2495,4414,20,15,11,9
40597,443,45954,443,11101,4498,6603,35,430,20,15
50375,53,64896,53,211,110,101,2,30,1,1
27005,27015,38522,27015,878,126,752,2,30,1,1
55066,443,16494,443,39091,9981,29110,93,208,42,51
56625,53,59531,53,186,95,91,2,31,1,1
49807,443,23954,443,2796,1730,1066,15,126,9,6
55995,53,56863,53,182,94,88,2,30,1,1
56355,53,43280,53,184,94,90,2,31,1,1
9464,443,61543,443,9340,5582,3758,36,38,21,15
64879,53,23535,53,173,94,79,2,30,1,1
38323,443,27893,443,130,70,60,2,15,1,1
56404,80,13755,80,17376,1687,15689,28,40,12,16
64677,53,12416,53,172,88,84,2,31,1,1
61716,443,60379,443,3168,1038,2130,16,136,8,8
35708,443,18676,443,8264,1910,6354,21,361,10,11
55237,53,14253,53,193,102,91,2,30,1,1
56172,53,39320,53,216,102,114,2,30,1,1
37653,5223,43344,5223,142,142,0,1,5,1,0
49417,53,14090,53,211,110,101,2,30,1,1
35212,443,35212,443,4700,1793,2907,19,27,11,8
49395,53,16625,53,315,90,225,4,32,2,2
49468,443,51693,443,6940,1302,5638,20,119,10,10
55273,53,51928,53,166,85,81,2,31,1,1
46167,80,10521,80,78,78,0,1,5,1,0
37638,443,24895,443,8134,2717,5417,24,16,15,9
64643,53,40117,53,177,94,83,2,30,1,1
21133,51413,31456,51413,459,149,310,2,1200,1,1
55534,80,1439,80,3335,2314,1021,19,38,11,8
56789,443,21644,443,257154,11550,245604,303,54,121,182
49454,53,56383,53,762,97,665,2,31,1,1
48151,123,24928,123,184,94,90,2,30,1,1
59805,443,46522,443,2334,1113,1221,19,27,9,10
25629,28678,25311,28678,1806,1806,0,22,225,22,0
41803,443,1948,443,11804,4009,7795,41,150,21,20
50385,80,53379,80,28942,2526,26416,39,25,16,23
60900,443,51308,443,7426,1877,5549,22,81,13,9
50453,80,50453,80,450,246,204,8,30,5,3
56083,53,60591,53,711,87,624,2,30,1,1
49563,53,27987,53,200,102,98,2,31,1,1
60483,443,59259,443,3089,866,2223,11,121,6,5
49522,443,12494,443,3090,1796,1294,19,26,10,9
6881,8999,10252,8999,502,150,352,2,1199,1,1
64780,53,40708,53,193,102,91,2,31,1,1
55127,53,49558,53,253,87,166,4,44,2,2
56784,443,32848,443,7957,1968,5989,20,15,11,9
64135,53,23762,53,196,102,94,2,30,1,1
53832,56005,15467,56005,70,70,0,2,8,2,0
49907,443,59724,443,5895,728,5167,16,47,8,8
57585,443,57585,443,2504,1458,1046,21,87,10,11
1933,53,18812,53,210,78,132,2,29,1,1
51928,80,8868,80,1357,963,394,10,26,7,3
49889,53,4477,53,338,110,228,2,30,1,1
56522,53,28369,53,170,87,83,2,30,1,1
32910,443,36297,443,2299332,50663,2248669,2117,141,553,1564
56000,53,18353,53,177,94,83,2,29,1,1
55735,53,17069,53,772,100,672,2,30,1,1
50200,53,14002,53,758,102,656,2,30,1,1
49337,443,47623,443,5483,2770,2713,30,361,15,15
59683,443,7689,443,16524,4274,12250,35,133,15,20
49546,53,30362,53,193,102,91,2,30,1,1
55755,53,57482,53,779,86,693,2,30,1,1
47161,443,37026,443,11342,3715,7627,28,92,17,11
50568,443,63503,443,15702,3473,12229,50,70,23,27
49369,53,34405,53,324,86,238,4,47,2,2
64932,53,8604,53,230,102,128,2,30,1,1
49210,33757,6282,33757,70,70,0,1,5,1,0
44776,443,54500,443,10087,4073,6014,33,88,18,15
56752,80,35742,80,1462,703,759,8,16,5,3
53716,6881,32283,6881,70,70,0,1,4,1,0
58736,53,58736,53,235,90,145,2,32,1,1
64385,53,43683,53,179,94,85,2,30,1,1
57414,53,33094,53,214,102,112,2,29,1,1
60108,443,32347,443,9091,2988,6103,47,19,22,25
56740,80,35362,80,1462,703,759,8,17,5,3
2267,53,42274,53,204,118,86,2,31,1,1
56442,53,53594,53,167,86,81,2,30,1,1
58902,443,55109,443,8119,5152,2967,29,18,14,15
43886,5223,33165,5223,3721,1173,2548,18,257,11,7
55972,53,35969,53,193,102,91,2,29,1,1
54299,443,30059,443,9986,2440,7546,17,120,8,9
47732,80,47732,80,9621,1618,8003,19,20,10,9
33784,443,3722,443,2378,1126,1252,14,979,7,7
50148,53,50148,53,198,90,108,2,29,1,1
53675,29970,54968,29970,612,426,186,10,22,7,3
50299,53,31351,53,770,102,668,2,30,1,1
55011,443,43208,443,134,60,74,3,10,2,1
51452,443,6945,443,7674,2829,4845,23,31,14,9
50433,53,29987,53,193,102,91,2,30,1,1
10051,443,38650,443,11412,1763,9649,27,110,13,14
49503,53,8833,53,167,86,81,2,30,1,1
46409,80,63158,80,1053,613,440,10,15,5,5
63953,53,20506,53,426,89,337,4,49,2,2
50864,53,14255,53,199,94,105,2,30,1,1
49674,53,9150,53,211,102,109,2,29,1,1
50052,53,19645,53,738,86,652,2,30,1,1
64132,53,9025,53,174,89,85,2,30,1,1
6354,53,6354,53,217,87,130,2,30,1,1
57892,443,5458,443,6845,1743,5102,22,81,13,9
56917,53,28057,53,194,102,92,2,31,1,1
56143,53,31546,53,748,106,642,2,31,1,1
65237,53,3519,53,225,94,131,2,30,1,1
65354,53,6099,53,168,86,82,2,31,1,1
56352,80,27612,80,1258,752,506,13,16,7,6
52472,443,52472,443,4400,1493,2907,19,31,11,8
55024,53,28341,53,168,86,82,2,30,1,1
55151,53,16947,53,285,102,183,2,30,1,1
42317,443,11761,443,416,210,206,7,27,4,3
53245,443,1855,443,28206,2737,25469,45,323,18,27
57302,53,18711,53,770,102,668,2,31,1,1
56082,53,4620,53,182,94,88,2,30,1,1
30188,39920,5702,39920,501,150,351,2,1200,1,1
37936,443,26226,443,5463,1378,4085,16,145,10,6
56916,443,36796,443,13829,2472,11357,30,243,13,17
57374,53,45450,53,733,86,647,2,31,1,1
56585,443,49312,443,7157,2183,4974,22,16,12,10
55209,53,9446,53,98,98,0,1,30,1,0
51856,62841,45068,62841,136,136,0,3,13,3,0
55979,53,36976,53,186,95,91,2,31,1,1
49418,27015,50232,27015,286,78,208,2,31,1,1
57355,443,46923,443,36265,3519,32746,55,46,27,28
49206,53,3418,53,448,184,264,6,30,3,3
56841,53,62125,53,177,94,83,2,30,1,1
49633,443,51430,443,4348,911,3437,14,135,8,6
49885,443,59973,443,37539,4310,33229,63,51,27,36
60248,80,33298,80,22768,6548,16220,31,149,14,17
63996,45759,55251,45759,66,66,0,2,8,2,0
52898,80,57619,80,3020,1414,1606,30,118,16,14
20378,53,20378,53,235,90,145,2,32,1,1
39910,80,12870,80,1658,1344,314,10,15,5,5
49903,53,65277,53,231,110,121,2,30,1,1
62059,443,14919,443,11903,6327,5576,48,15,27,21
64575,53,36717,53,268,110,158,2,31,1,1
37833,80,26930,80,2087,729,1358,10,15,5,5
48754,443,18594,443,6490,1145,5345,20,33,11,9
55230,53,65301,53,467,96,371,4,44,2,2
49213,53,21489,53,272,94,178,2,30,1,1
59347,80,59347,80,108790,4633,104157,192,15,66,126
55601,53,41824,53,815,95,720,2,30,1,1
59424,443,18512,443,252,70,182,3,120,1,2
53568,443,10135,443,12646,7169,5477,53,198,25,28
56875,53,47885,53,166,85,81,2,31,1,1
60627,443,41376,443,5663,1711,3952,22,17,13,9
57968,443,57498,443,6254,1581,4673,21,190,12,9
53430,443,50940,443,4383,2064,2319,11,120,6,5
2267,53,21811,53,204,118,86,2,30,1,1
49682,443,37715,443,9766,1633,8133,27,172,13,14
49651,80,48758,80,1854,945,909,13,106,7,6
51387,443,47138,443,9584,1871,7713,28,106,14,14
48440,443,28168,443,6945,1551,5394,25,200,12,13
62766,443,26712,443,4911,3442,1469,29,322,16,13
65367,443,29972,443,5666,4417,1249,23,86,12,11
51283,80,60981,80,1114,534,580,12,16,7,5
53565,58695,57027,58695,70,70,0,2,8,2,0
65067,53,28760,53,86,86,0,1,30,1,0
64323,53,33071,53,376,126,250,2,30,1,1
60561,53,50880,53,343,86,257,2,30,1,1
56327,53,4067,53,178,94,84,2,30,1,1
55025,80,12764,80,1142,626,516,8,180,5,3
52657,80,31996,80,26073,2868,23205,41,110,17,24
48326,53,48326,53,398,255,143,3,33,2,1
55824,53,60939,53,819,102,717,2,30,1,1
46326,443,42575,443,430,152,278,7,32,3,4
49441,443,28685,443,2921276,89544,2831732,3090,63,1086,2004
38567,80,39974,80,1571,877,694,11,181,6,5
37965,6881,34922,6881,448,246,202,4,1199,2,2
50041,443,48278,443,7924,1798,6126,26,15,14,12
58541,28678,6280,28678,1806,1806,0,22,224,22,0
56807,18177,32535,18177,70,70,0,1,5,1,0
55195,53,34217,53,969,86,883,2,29,1,1
51459,443,30706,443,6779,2365,4414,19,15,10,9
65359,53,29324,53,186,95,91,2,30,1,1
55028,443,57444,443,7196,2834,4362,28,17,16,12
35745,443,18614,443,7634,4417,3217,35,197,19,16
35311,443,37900,443,6584,1945,4639,14,120,7,7
52000,10491,1794,10491,70,70,0,1,5,1,0
49210,53,10205,53,183,94,89,2,30,1,1
56204,53,48985,53,168,86,82,2,30,1,1
45701,80,26870,80,1579,1217,362,8,15,5,3
63960,53,27823,53,178,94,84,2,30,1,1
54202,443,43752,443,499,425,74,4,0,3,1
50495,53,24606,53,182,102,80,2,30,1,1
63705,19652,30539,19652,70,70,0,1,5,1,0
55668,80,2182,80,70,70,0,2,8,2,0
42263,443,55947,443,6431,1665,4766,22,275,12,10
52057,34664,13510,34664,70,70,0,2,8,2,0
38432,53,33848,53,336,231,105,3,30,2,1
59731,443,62257,443,7236,827,6409,17,25,8,9
49757,80,22692,80,1396,864,532,9,15,5,4
45123,15000,48758,15000,130,70,60,2,6,1,1
54636,443,3394,443,311000,8576,302424,319,175,103,216
57084,443,60490,443,9905,4321,5584,27,315,13,14
50419,80,4719,80,350,350,0,1,120,1,0
42853,443,44169,443,130,70,60,3,5,2,1
57169,53,0,0,208,86,122,2,30,1,1
56997,53,32024,53,273,102,171,2,30,1,1
38659,15000,47156,15000,138,78,60,2,5,1,1
51893,80,59031,80,14289,7263,7026,27,27,14,13
49456,443,8615,443,10956,1757,9199,21,37,10,11
9119,80,62063,80,8732,2438,6294,23,36,11,12
65031,53,9401,53,184,94,90,2,30,1,1
63759,64509,61744,64509,70,70,0,1,4,1,0
50262,443,49732,443,7608,2413,5195,19,120,9,10
65394,53,54686,53,230,94,136,2,30,1,1
43154,80,38984,80,139303,9065,130238,210,20,120,90
57268,443,5467,443,1617,1073,544,16,15,9,7
49343,53,1518,53,209,110,99,2,30,1,1
43212,443,25002,443,7476,2192,5284,27,316,13,14
58790,443,27687,443,3558,2453,1105,17,15,9,8
46750,443,52499,443,350,210,140,6,25,4,2
53191,80,63359,80,1871,712,1159,10,15,5,5
33148,443,29475,443,7639,948,6691,25,395,9,16
64074,53,19017,53,209,110,99,2,30,1,1
56935,53,37247,53,174,89,85,2,31,1,1
63929,48477,10688,48477,66,66,0,2,7,2,0
51969,37558,21407,37558,70,70,0,2,8,2,0
57149,53,29225,53,612,114,498,4,52,2,2
60886,443,45692,443,12652,6172,6480,44,16,26,18
43411,443,13391,443,2895,726,2169,10,121,5,5
50287,53,28262,53,781,94,687,2,30,1,1
49506,443,26865,443,18260,2912,15348,30,28,11,19
49418,27016,26293,27016,257,71,186,2,30,1,1
55083,53,56476,53,216,110,106,2,30,1,1
55182,53,55293,53,199,102,97,2,30,1,1
49609,80,24955,80,11534,719,10815,18,61,7,11
57208,53,19470,53,183,94,89,2,30,1,1
65517,443,57866,443,92117,4799,87318,107,15,43,64
48894,53,34771,53,164,78,86,2,31,1,1
57385,443,20044,443,8747,3323,5424,45,110,25,20
65196,53,54719,53,392,90,302,4,55,2,2
54136,443,41489,443,10109,1394,8715,22,75,13,9
49878,80,42487,80,2086,1214,872,8,88,5,3
42202,443,2028,443,6610,1106,5504,23,361,12,11
47766,53,58844,53,164,78,86,2,29,1,1
52194,22674,46846,22674,70,70,0,2,8,2,0
64915,53,33891,53,170,87,83,2,31,1,1
55911,53,54432,53,211,110,101,2,30,1,1
53258,53,63456,53,277,78,199,2,30,1,1
63950,443,48115,443,5844,2360,3484,25,127,12,13
36688,443,58971,443,178,118,60,2,15,1,1
55975,53,49618,53,711,87,624,2,30,1,1
40368,123,25473,123,184,94,90,2,30,1,1
65349,53,10010,53,275,110,165,2,30,1,1
52109,60841,45067,60841,156,66,90,2,5,1,1
56956,53,49926,53,183,94,89,2,30,1,1
56604,443,5643,443,7915,1926,5989,20,15,11,9
63768,55755,10523,55755,70,70,0,1,4,1,0
57346,443,34868,443,1547,960,587,14,22,8,6
64764,53,35102,53,211,102,109,2,30,1,1
56068,53,60568,53,168,94,74,2,30,1,1
41882,443,10450,443,7218,4166,3052,38,133,19,19
52211,56648,57880,56648,70,70,0,2,8,2,0
45816,443,45816,443,4430,1523,2907,19,27,11,8
55947,53,4712,53,94,94,0,1,30,1,0
36877,443,64698,443,9787,2382,7405,17,120,7,10
58013,80,34784,80,3877,2069,1808,15,26,9,6
57895,443,60971,443,10639,4680,5959,53,176,24,29
50353,80,65364,80,8007,830,7177,17,30,8,9
49229,53,37715,53,243,110,133,2,29,1,1
50166,80,59884,80,2181,849,1332,14,97,7,7
56233,80,56233,80,44955,1023,43932,48,15,15,33
37854,443,37854,443,1452,817,635,16,20,9,7
50468,80,50468,80,90393,7684,82709,132,22,69,63
64726,53,39418,53,178,94,84,2,30,1,1
49659,443,27992,443,11455,2804,8651,59,121,28,31
26502,80,26502,80,184480,11115,173365,239,30,116,123
46669,80,58799,80,1802,1488,314,11,16,6,5
57470,6881,1895,6881,528,528,0,9,1200,9,0
53719,49306,59032,49306,70,70,0,2,8,2,0
56557,53,31623,53,212,108,104,2,31,1,1
52026,12523,2339,12523,70,70,0,2,7,2,0
49520,53,55540,53,229,102,127,2,30,1,1
65452,53,31972,53,365,102,263,2,30,1,1
55519,53,47075,53,193,102,91,2,30,1,1
56399,53,36148,53,498,204,294,6,29,3,3
56724,53,52473,53,195,102,93,2,30,1,1
2081,7000,2081,7000,5914,4395,1519,19,15,10,9
56710,53,63295,53,193,94,99,2,29,1,1
49533,80,42327,80,8220,849,7371,13,28,5,8
9299,443,15796,443,4216,771,3445,16,26,9,7
55094,53,35029,53,244,94,150,2,30,1,1
50553,80,13843,80,378,192,186,7,26,4,3
50438,80,13874,80,314,192,122,6,26,4,2
41418,443,15753,443,6670,1576,5094,23,200,13,10
27005,27016,21347,27016,902,126,776,2,30,1,1
49220,53,32308,53,755,94,661,2,30,1,1
55797,53,58246,53,817,102,715,2,30,1,1
63976,53,34685,53,200,102,98,2,30,1,1
60152,80,38610,80,1056,682,374,10,15,6,4
53531,48908,54109,48908,70,70,0,2,7,2,0
51964,443,28760,443,54794,16744,38050,82,71,42,40
61734,443,59784,443,231110,14545,216565,307,18,154,153
49418,27015,52335,27015,295,78,217,2,30,1,1
63937,43443,65141,43443,160,70,90,2,5,1,1
37658,16384,24782,16384,130,70,60,2,30,1,1
47661,80,24519,80,2865,2000,865,12,15,7,5
56624,53,53106,53,259,118,141,2,29,1,1
61833,443,61833,443,80743,4724,76019,101,89,37,64
30478,53,30478,53,229,89,140,2,30,1,1
49290,443,20906,443,1629306,22920,1606386,1339,116,262,1077
52113,19619,23788,19619,70,70,0,2,8,2,0
64992,53,56297,53,177,94,83,2,30,1,1
40464,80,50769,80,15535,2173,13362,30,21,17,13
50345,443,44342,443,1385,868,517,12,30,6,6
55517,53,26427,53,179,94,85,2,29,1,1
47825,443,54151,443,932130,36511,895619,1142,167,465,677
53158,443,6890,443,7427,1517,5910,22,323,11,11
54033,443,51149,443,43491,8521,34970,69,50,34,35
64726,53,22205,53,231,94,137,2,30,1,1
49237,443,49237,443,33985,8645,25340,53,35,28,25
56739,443,56739,443,94524,4465,90059,126,45,56,70
5588,5588,0,0,3562,1936,1626,48,194,24,24
55444,53,54146,53,193,102,91,2,30,1,1
57157,443,64238,443,1647,1375,272,9,48,5,4
64987,53,14036,53,192,98,94,2,30,1,1
44320,443,32394,443,154,94,60,2,4,1,1
57030,53,7649,53,283,101,182,4,39,2,2
49160,1025,14161,1025,868,150,718,4,1200,2,2
64744,53,33076,53,376,118,258,2,30,1,1
38115,80,9146,80,6442,1404,5038,23,30,12,11
55031,443,25745,443,3625,1378,2247,14,135,7,7
60093,443,38976,443,292,172,120,4,15,2,2
50544,53,48893,53,816,102,714,2,30,1,1
54586,161,0,0,14172,5597,8575,50,31,25,25
55748,53,60711,53,194,102,92,2,30,1,1
50771,80,8237,80,6420,677,5743,13,151,6,7
55271,53,11910,53,754,94,660,2,30,1,1
49293,53,22414,53,811,94,717,2,30,1,1
63019,53,40745,53,512,166,346,2,29,1,1
49254,53,47857,53,173,94,79,2,30,1,1
39213,443,39213,443,4378,1471,2907,19,29,11,8
47282,443,1990,443,130,70,60,2,15,1,1
64452,53,37833,53,322,102,220,2,29,1,1
59919,53,59919,53,231,90,141,2,31,1,1
55747,53,57229,53,215,102,113,2,29,1,1
33238,443,21628,443,21538,3952,17586,48,17,27,21
64730,53,5756,53,261,94,167,2,30,1,1
56906,443,9378,443,1712418,88847,1623571,2014,149,715,1299
49603,443,57719,443,11841,1700,10141,37,195,16,21
59189,443,26773,443,9050,4611,4439,37,222,20,17
65107,53,22367,53,266,87,179,4,35,2,2
50462,80,37104,80,113965,10014,103951,154,204,65,89
56668,53,7163,53,199,102,97,2,30,1,1
64558,53,57812,53,321,102,219,2,31,1,1
37896,443,37896,443,4704,1797,2907,19,30,11,8
57246,8525,57246,8525,138,78,60,2,5,1,1
49952,53,50731,53,190,97,93,2,30,1,1
53796,48019,63153,48019,70,70,0,1,5,1,0
53719,49306,15851,49306,70,70,0,1,5,1,0
18749,53,18749,53,370,238,132,3,32,2,1
51265,63960,62847,63960,70,70,0,1,5,1,0
49192,8106,32598,8106,2050,1277,773,15,15,8,7
56924,53,7241,53,216,110,106,2,30,1,1
43827,443,38851,443,677212,30094,647118,785,136,282,503
51179,443,22561,443,13708,1734,11974,25,31,12,13
61398,80,45091,80,2425,529,1896,11,75,6,5
50194,443,13497,443,50338,5239,45099,54,165,19,35
53167,22083,32129,22083,70,70,0,1,4,1,0
60027,443,59128,443,25215,5119,20096,55,144,26,29
57867,27019,40046,27019,2338,634,1704,10,30,6,4
65485,443,65115,443,92447,4519,87928,105,16,39,66
65067,53,58003,53,214,110,104,2,30,1,1
55417,53,60973,53,198,102,96,2,30,1,1
51553,443,28429,443,6662,522,6140,15,16,5,10
56125,80,62901,80,2091,799,1292,10,15,6,4
60396,443,5888,443,5964,1586,4378,19,80,10,9
56832,80,37022,80,54049,2036,52013,69,18,31,38
27005,27111,57650,27111,893,126,767,2,30,1,1
55596,53,25789,53,194,102,92,2,31,1,1
50168,53,56159,53,211,78,133,2,30,1,1
38085,443,38085,443,1452,817,635,16,20,9,7
58791,443,11218,443,5167,700,4467,16,15,7,9
53261,443,39643,443,96485,4565,91920,119,150,45,74
65444,53,41449,53,227,110,117,2,29,1,1
60307,443,42783,443,5574,1200,4374,26,80,13,13
51830,80,53910,80,486,300,186,9,31,6,3
54670,443,29364,443,18487,3434,15053,37,80,20,17
51809,52528,62433,52528,70,70,0,2,8,2,0
56694,53,2840,53,427,88,339,4,55,2,2
40358,443,63081,443,626,352,274,10,16,6,4
65344,53,6284,53,211,102,109,2,30,1,1
56757,443,9849,443,8057,2037,6020,20,15,11,9
40511,80,1880,80,1680,950,730,12,15,6,6
2267,53,13716,53,204,118,86,2,30,1,1
64113,22211,60375,22211,312,132,180,6,7,3,3
55855,53,25503,53,182,102,80,2,30,1,1
2072,7000,2072,7000,3164,783,2381,15,16,7,8
52450,443,7964,443,9648,3653,5995,37,155,19,18
43151,443,30299,443,9462,4488,4974,28,96,13,15
64643,53,62127,53,177,94,83,2,30,1,1
38696,443,18796,443,1069542,21337,1048205,1028,16,310,718
59112,443,3834,443,7174,1831,5343,31,110,17,14
49163,53,4379,53,167,86,81,2,30,1,1
38515,443,54100,443,12624,5203,7421,48,274,24,24
49100,80,49100,80,3568,2889,679,13,23,8,5
49253,53,32297,53,593,188,405,6,59,3,3
55323,53,14352,53,172,88,84,2,31,1,1
49380,53,47715,53,199,102,97,2,30,1,1
55797,53,20315,53,177,94,83,2,29,1,1
57000,53,37935,53,193,94,99,2,30,1,1
48844,443,50866,443,36383,29447,6936,103,163,51,52
6881,6881,2620,6881,150,150,0,1,1200,1,0
27005,27017,1737,27017,891,126,765,2,30,1,1
64987,53,36862,53,410,100,310,4,55,2,2
57987,80,45212,80,2803,1625,1178,16,21,9,7
50540,443,25941,443,134507,6585,127922,148,121,51,97
57092,53,43166,53,270,102,168,2,30,1,1
39186,443,31509,443,8126,2183,5943,29,270,14,15
22680,443,22680,443,18490,7811,10679,47,81,27,20
49233,8080,49233,8080,2602,846,1756,13,136,7,6
52042,80,17014,80,70,70,0,2,8,2,0
35117,443,10765,443,8866,4928,3938,26,121,13,13
28007,443,65025,443,10168,968,9200,19,15,9,10
57867,27019,27516,27019,468,390,78,5,30,4,1
41581,443,9229,443,6816,1197,5619,24,269,12,12
58829,443,11100,443,2576,1549,1027,15,15,7,8
49418,27015,32548,27015,255,78,177,2,29,1,1
44588,443,64745,443,8850,2551,6299,32,369,16,16
40204,40018,24038,40018,566,86,480,2,30,1,1
55829,53,23534,53,168,78,90,2,30,1,1
49548,53,36556,53,198,94,104,2,29,1,1
43346,443,33396,443,3691281,56325,3634956,3201,138,570,2631
50986,443,39025,443,18156,12850,5306,32,76,19,13
63965,53,11899,53,180,94,86,2,30,1,1
52940,443,39271,443,14640,5951,8689,52,115,26,26
40342,53,32234,53,168,78,90,2,29,1,1
55896,53,44537,53,184,94,90,2,30,1,1
50435,80,28947,80,318,192,126,6,27,4,2
53152,443,33270,443,116790,7062,109728,166,144,85,81
38402,443,45229,443,3830718,112946,3717772,4353,224,1395,2958
52413,443,50762,443,2114,1152,962,14,15,8,6
52220,65128,1362,65128,70,70,0,1,5,1,0
57470,1136,15403,1136,402,132,270,6,1209,3,3
38049,53,38049,53,213,87,126,2,31,1,1
50368,443,46131,443,8048,1189,6859,19,25,10,9
62241,443,33164,443,7205,2250,4955,16,120,7,9
52094,55986,52536,55986,70,70,0,2,8,2,0
27005,28002,27297,28002,918,126,792,2,31,1,1
49982,53,16411,53,211,110,101,2,30,1,1
60206,443,52179,443,4706,2475,2231,13,120,7,6
58921,443,47044,443,10782,7193,3589,30,16,17,13
51465,443,39975,443,3961,1595,2366,21,16,12,9
65530,53,21720,53,167,86,81,2,30,1,1
56734,80,64954,80,194,128,66,4,25,3,1
55216,53,63091,53,174,89,85,2,30,1,1
61822,53,61822,53,237,91,146,2,33,1,1
58638,5900,58638,5900,66,66,0,1,4,1,0
40842,80,63836,80,1712,786,926,12,17,7,5
49808,53,25125,53,268,102,166,2,29,1,1
39387,443,57166,443,204,70,134,4,26,2,2
52152,443,39969,443,433460,26631,406829,595,147,224,371
44505,53,44505,53,216,90,126,2,30,1,1
59618,443,47989,443,5682,1562,4120,23,61,13,10
49952,53,64431,53,195,102,93,2,29,1,1
63050,53,33894,53,384,166,218,2,30,1,1
51757,54657,24157,54657,66,66,0,1,5,1,0
57146,53,33353,53,199,102,97,2,31,1,1
26900,27017,44088,27017,250,164,86,4,30,3,1
49734,53,34033,53,216,110,106,2,30,1,1
52237,16801,36529,16801,70,70,0,2,4,2,0
55600,53,36294,53,184,94,90,2,30,1,1
62021,443,62021,443,4625,1718,2907,19,27,11,8
41298,443,14805,443,2974,1378,1596,28,34,15,13
64540,53,24153,53,179,94,85,2,30,1,1
33793,80,7506,80,1286,782,504,12,361,7,5
65238,53,15919,53,168,86,82,2,31,1,1
64761,53,64761,53,220,100,120,2,31,1,1
52102,19604,10302,19604,70,70,0,2,8,2,0
50122,443,55695,443,6407,1101,5306,18,26,10,8
49725,53,18742,53,211,102,109,2,29,1,1
56609,53,56720,53,198,101,97,2,30,1,1
55934,53,17194,53,182,102,80,2,30,1,1
49741,53,44929,53,177,94,83,2,30,1,1
56808,53,42088,53,180,94,86,2,35,1,1
52074,80,8248,80,422,240,182,8,26,5,3
56101,53,11714,53,194,102,92,2,30,1,1
52020,80,52020,80,6764,5555,1209,20,28,12,8
60276,80,60276,80,671,313,358,7,75,4,3
63977,54486,31444,54486,66,66,0,2,8,2,0
57648,443,58910,443,35696,3196,32500,48,121,19,29
52060,29868,16909,29868,70,70,0,2,8,2,0
30960,45755,44633,45755,462,462,0,8,3631,8,0
51221,6881,38542,6881,469,150,319,2,1200,1,1
49201,53,5443,53,200,102,98,2,31,1,1
58463,53,64645,53,380,88,292,2,30,1,1
56687,53,1087,53,225,110,115,2,30,1,1
64555,53,55433,53,166,85,81,2,31,1,1
37578,443,36969,443,7534,2392,5142,25,25,14,11
49418,27019,20347,27019,71,71,0,1,30,1,0
48171,443,3704,443,10420,3506,6914,33,274,18,15
56939,80,26245,80,194,128,66,4,31,3,1
49418,27015,36683,27015,251,71,180,2,31,1,1
51863,22038,12301,22038,70,70,0,1,5,1,0
54653,53,54653,53,231,90,141,2,30,1,1
53668,50678,10621,50678,70,70,0,1,5,1,0
55089,53,6638,53,199,102,97,2,30,1,1
53781,36366,44419,36366,70,70,0,2,8,2,0
65241,53,22089,53,200,102,98,2,31,1,1
36230,443,36230,443,4681,1774,2907,19,30,11,8
56594,80,5980,80,234,234,0,4,11,4,0
56667,53,36173,53,232,94,138,2,30,1,1
52153,80,26645,80,366,240,126,7,32,5,2
50265,80,26557,80,2100,1146,954,13,46,6,7
51872,443,26165,443,442,250,192,8,30,5,3
9513,443,25594,443,3615,435,3180,11,16,6,5
40309,443,48693,443,51588,40242,11346,107,418,53,54
51505,443,46771,443,645662,22326,623336,743,41,299,444
49631,53,32416,53,323,102,221,2,30,1,1
53560,42459,25720,42459,552,306,246,9,17,5,4
49873,80,19431,80,9540,2954,6586,18,88,8,10
65378,53,29573,53,476,121,355,4,40,2,2
62325,443,62325,443,1210,637,573,14,51,7,7
65147,53,28135,53,763,101,662,2,30,1,1
27005,27015,5485,27015,889,126,763,2,30,1,1
48933,443,5665,443,4372,2402,1970,27,53,14,13
56984,53,44033,53,209,102,107,2,30,1,1
64155,53,12235,53,183,94,89,2,30,1,1
64907,53,3413,53,168,86,82,2,30,1,1
50690,80,44292,80,56951,28706,28245,236,174,116,120
59991,443,45209,443,5108,2834,2274,21,143,10,11
57424,53,34696,53,177,94,83,2,30,1,1
57134,53,29907,53,178,94,84,2,30,1,1
54326,27054,42842,27054,924,924,0,3,30,3,0
39566,443,50145,443,9748,5209,4539,22,121,11,11
52030,443,52030,443,4400,1493,2907,19,30,11,8
55227,53,15557,53,183,102,81,2,31,1,1
64575,53,5183,53,182,102,80,2,31,1,1
50562,80,50562,80,1696,996,700,11,22,6,5
50373,443,36496,443,4695,859,3836,17,30,9,8
51221,6889,53258,6889,481,150,331,2,1200,1,1
51408,443,61197,443,1576,789,787,17,122,9,8
49972,53,10685,53,216,110,106,2,31,1,1
34373,28678,41304,28678,1806,1806,0,22,224,22,0
2074,7010,2074,7010,4279,2090,2189,16,15,8,8
25436,53,25436,53,220,90,130,2,30,1,1
50948,80,50948,80,520,246,274,9,25,5,4
43702,443,33020,443,1201,707,494,12,26,7,5
60403,443,22407,443,3802,1769,2033,15,135,7,8
65371,53,17018,53,199,102,97,2,30,1,1
37965,10909,61398,10909,844,152,692,4,1199,2,2
50613,80,39114,80,85306,4735,80571,120,22,55,65
51925,29587,19217,29587,70,70,0,1,5,1,0
64105,53,18897,53,182,86,96,2,30,1,1
9068,443,2083,443,5045,2005,3040,14,119,7,7
27005,27056,45270,27056,908,126,782,2,31,1,1
64968,27030,53742,27030,735,462,273,2,30,1,1
53840,443,34687,443,499,425,74,4,0,3,1
65216,53,28628,53,218,94,124,2,30,1,1
64094,1024,62040,1024,70,70,0,1,5,1,0
53501,443,53501,443,960,539,421,9,36,5,4
53227,53,11040,53,78,78,0,1,29,1,0
50222,443,25494,443,178347,31093,147254,290,446,140,150
61507,443,11095,443,443128,10267,432861,362,45,60,302
55159,53,17196,53,168,86,82,2,30,1,1
47045,53,20106,53,225,78,147,2,30,1,1
50363,53,62670,53,214,110,104,2,30,1,1
49919,443,28097,443,4534,909,3625,16,32,8,8
58472,53,35113,53,246,246,0,4,47,4,0
55238,53,10880,53,168,86,82,2,30,1,1
34625,443,10799,443,6393,1025,5368,18,27,9,9
55007,53,10621,53,164,84,80,2,31,1,1
58959,80,58892,80,5481,4758,723,15,15,8,7
38136,443,41208,443,3919,1099,2820,35,627,9,26
65507,53,17701,53,211,102,109,2,30,1,1
55531,53,35408,53,772,100,672,2,31,1,1
56004,53,52519,53,178,94,84,2,31,1,1
55134,53,14594,53,212,108,104,2,30,1,1
34083,443,2580,443,7510,2040,5470,24,210,13,11
6882,42505,24055,42505,207,118,89,2,1200,1,1
55370,53,18357,53,747,93,654,2,31,1,1
44839,443,42515,443,308,84,224,4,120,2,2
53713,26085,43109,26085,70,70,0,2,7,2,0
64697,53,42927,53,198,101,97,2,31,1,1
50584,45270,4666,45270,1377,300,1077,6,1200,3,3
10075,53,26138,53,229,86,143,2,30,1,1
57350,53,14841,53,177,94,83,2,30,1,1
50272,53,52496,53,210,110,100,2,29,1,1
60711,53,53816,53,211,78,133,2,30,1,1
48817,46429,48817,46429,763,296,467,4,1200,2,2
64055,45105,11907,45105,66,66,0,2,7,2,0
17840,53,17840,53,414,268,146,3,32,2,1
55020,443,57548,443,3533,1045,2488,17,147,8,9
55820,53,24388,53,188,96,92,2,31,1,1
28316,3389,28316,3389,4695,2520,2175,22,19,13,9
41247,80,40368,80,78,78,0,1,5,1,0
53496,3389,53496,3389,3624,1910,1714,19,33,11,8
49857,53,15096,53,173,94,79,2,30,1,1
60339,80,1887,80,35136,7862,27274,53,124,26,27
65365,53,10909,53,196,102,94,2,29,1,1
55617,53,30754,53,212,108,104,2,31,1,1
38867,53,38867,53,213,79,134,2,32,1,1
60375,53,25105,53,226,94,132,2,31,1,1
48488,443,26104,443,12993,3240,9753,36,24,18,18
56337,53,46173,53,268,89,179,4,45,2,2
52926,443,36627,443,5458,1390,4068,17,15,9,8
50037,53,57358,53,190,97,93,2,30,1,1
9742,80,9742,80,1384,648,736,9,15,5,4
49448,53,48392,53,210,102,108,2,30,1,1
63310,443,15095,443,1481,701,780,20,120,10,10
55972,53,37415,53,699,438,261,2,30,1,1
44884,443,19838,443,36435,28844,7591,65,396,35,30
51880,8000,24485,8000,582,270,312,8,32,4,4
57773,443,16393,443,11544,6888,4656,32,125,17,15
50991,443,38073,443,6448,2376,4072,22,2,10,12
37155,443,46832,443,7303,2206,5097,23,255,12,11
49727,443,58320,443,4116,972,3144,15,50,8,7
50281,53,33175,53,195,102,93,2,30,1,1
45412,53,45412,53,220,90,130,2,30,1,1
52150,443,44913,443,5481,3086,2395,26,49,13,13
57052,53,52166,53,170,87,83,2,31,1,1
49104,443,34299,443,7424,2381,5043,24,18,13,11
64366,53,57312,53,234,94,140,2,30,1,1
11324,443,11324,443,6981,948,6033,17,28,10,7
56951,53,23495,53,199,102,97,2,30,1,1
65144,53,52237,53,204,104,100,2,31,1,1
65057,53,20625,53,397,102,295,2,30,1,1
60136,443,22877,443,3647,1221,2426,13,135,6,7
51763,80,41535,80,3830,2255,1575,16,74,10,6
55201,53,9810,53,168,78,90,2,30,1,1
49761,53,37619,53,382,94,288,2,30,1,1
49609,53,44498,53,177,94,83,2,30,1,1
2890,53,28510,53,78,78,0,1,30,1,0
60376,80,60376,80,180425,10839,169586,213,33,93,120
34358,80,63755,80,350,210,140,6,16,4,2
56637,53,47556,53,214,110,104,2,31,1,1
45926,443,11767,443,9153,4216,4937,29,331,16,13
55323,53,29422,53,279,94,185,2,30,1,1
49635,53,55370,53,204,104,100,2,30,1,1
63769,47661,30265,47661,66,66,0,2,7,2,0
53624,7370,12914,7370,70,70,0,2,8,2,0
52099,28401,35047,28401,70,70,0,1,5,1,0
50387,443,41513,443,8507,1945,6562,21,33,10,11
55770,53,54138,53,167,86,81,2,30,1,1
42379,443,23985,443,499,425,74,4,0,3,1
28539,53,28539,53,231,88,143,2,32,1,1
54672,443,53803,443,7210,2267,4943,22,15,12,10
55642,26872,27323,26872,70,70,0,1,5,1,0
64112,24707,56635,24707,66,66,0,2,8,2,0
46265,443,19534,443,173828,9311,164517,245,448,118,127
58638,5900,58638,5900,156,62,94,2,10,1,1
53653,17436,61017,17436,70,70,0,1,5,1,0
49629,53,5781,53,198,102,96,2,30,1,1
49655,80,40166,80,499,192,307,6,42,4,2
56989,53,15263,53,152,78,74,2,30,1,1
64947,53,12228,53,402,118,284,2,29,1,1
23725,80,23725,80,1100980,31101,1069879,1210,19,462,748
55654,53,20360,53,726,85,641,2,31,1,1
50689,443,64099,443,180,60,120,4,15,2,2
58993,443,16211,443,1437,736,701,15,28,7,8
52011,443,52011,443,110812,7779,103033,122,49,44,78
56388,53,34689,53,275,95,180,4,49,2,2
53713,443,37609,443,4931,957,3974,17,15,10,7
63737,80,37849,80,314,192,122,6,15,4,2
50321,53,23352,53,438,180,258,6,30,3,3
49718,443,25229,443,4524,779,3745,13,52,6,7
64634,53,16629,53,786,110,676,2,30,1,1
56793,443,4192,443,8022,2002,6020,20,16,11,9
49234,53,17547,53,166,85,81,2,31,1,1
56857,43237,51679,43237,66,66,0,1,5,1,0
56126,53,59441,53,336,110,226,2,29,1,1
6882,6999,21724,6999,228,118,110,2,1200,1,1
55735,53,20718,53,184,94,90,2,30,1,1
46683,443,6885,443,234,234,0,4,12,4,0
64319,53,16100,53,186,95,91,2,30,1,1
56006,53,47168,53,210,102,108,2,30,1,1
26227,23,26227,23,146,60,86,2,10,1,1
55871,53,54584,53,177,94,83,2,29,1,1
37965,46405,21208,46405,1217,594,623,16,1764,10,6
27269,53,56522,53,199,94,105,2,31,1,1
49366,443,23124,443,14668,3601,11067,34,19,19,15
50233,53,55519,53,756,95,661,2,31,1,1
50356,80,58294,80,1578,756,822,13,34,7,6
58463,443,33811,443,19057,9308,9749,111,307,53,58
49418,33098,30068,33098,78,78,0,1,30,1,0
49197,53,3341,53,249,94,155,2,30,1,1
64583,53,3855,53,179,94,85,2,29,1,1
65370,53,23524,53,193,102,91,2,30,1,1
64636,53,4639,53,325,102,223,2,30,1,1
59920,443,3699,443,7359,2050,5309,18,16,10,8
43440,80,5073,80,2093,825,1268,12,45,7,5
52043,443,36100,443,7847,1904,5943,21,361,10,11
49601,80,15488,80,378,192,186,7,41,4,3
60410,18359,27575,18359,1759,820,939,18,16,8,10
50022,443,50896,443,70,70,0,2,5,2,0
52091,80,64640,80,2825,716,2109,12,22,7,5
9179,443,30869,443,5731,495,5236,14,15,7,7
26467,6969,46826,6969,192,192,0,4,1200,4,0
54815,3389,54815,3389,3428,1714,1714,16,32,8,8
56668,53,30534,53,199,102,97,2,30,1,1
51751,55855,62891,55855,66,66,0,1,5,1,0
52011,10722,14551,10722,70,70,0,1,4,1,0
41779,443,29003,443,618072,8505,609567,523,87,90,433
49611,53,44019,53,177,94,83,2,30,1,1
50994,443,11381,443,6349,1072,5277,18,21,10,8
64700,53,35656,53,239,86,153,2,29,1,1
60129,80,34372,80,2910,1439,1471,12,31,7,5
55273,53,3281,53,764,99,665,2,31,1,1
50437,53,50192,53,413,170,243,6,30,3,3
50011,53,8163,53,272,110,162,2,30,1,1
2437,53,2437,53,229,90,139,2,30,1,1
49228,443,55799,443,842887,22143,820744,866,19,314,552
65463,443,25060,443,92752,4519,88233,105,15,39,66
59277,53,14948,53,164,78,86,2,29,1,1
55141,53,13525,53,184,94,90,2,31,1,1
65482,53,17558,53,278,126,152,2,30,1,1
26900,27017,2675,27017,422,164,258,6,30,3,3
60408,443,33443,443,7282,1596,5686,21,79,11,10
56214,53,46867,53,200,102,98,2,33,1,1
46297,80,56497,80,1155,781,374,10,15,6,4
60871,443,15673,443,95311,21869,73442,140,62,61,79
55869,53,59798,53,192,98,94,2,30,1,1
55538,53,33092,53,250,86,164,4,30,2,2
40182,443,24953,443,1312,651,661,13,184,7,6
64900,53,45787,53,197,102,95,2,30,1,1
49640,443,18216,443,8607,3608,4999,25,256,14,11
28280,53,52004,53,168,78,90,2,30,1,1
56489,53,43327,53,212,110,102,2,30,1,1
56386,53,21142,53,177,94,83,2,30,1,1
51598,443,10892,443,14194,4643,9551,34,30,19,15
37898,53,37898,53,244,98,146,2,33,1,1
55457,443,46084,443,8447,2129,6318,26,250,15,11
63807,38976,18542,38976,66,66,0,2,8,2,0
57596,80,43063,80,1231,726,505,10,18,6,4
49192,80,39568,80,2807,587,2220,13,16,7,6
63842,45682,31353,45682,4687209,3850148,837061,4974,107,3004,1970
65105,80,65105,80,23382,3770,19612,48,45,24,24
24988,53,24988,53,214,82,132,2,33,1,1
52073,16316,19866,16316,70,70,0,2,8,2,0
49648,7275,24792,7275,8962,1625,7337,28,16,15,13
56697,53,1249,53,198,102,96,2,30,1,1
50476,80,25570,80,5049,4344,705,11,30,6,5
56292,53,23956,53,197,102,95,2,30,1,1
65049,53,22516,53,210,110,100,2,30,1,1
49547,53,1649,53,186,95,91,2,31,1,1
49574,53,25202,53,816,102,714,2,30,1,1
61581,443,25669,443,5103,2363,2740,11,120,6,5
57914,443,43452,443,4322,2383,1939,29,124,17,12
43361,443,8514,443,13275,10536,2739,50,101,27,23
52021,443,14701,443,7508,2350,5158,37,1323,21,16
58833,443,6455,443,5167,700,4467,16,14,7,9
63847,443,1340,443,1786,172,1614,7,120,3,4
57072,53,31261,53,816,102,714,2,29,1,1
2001,80,2001,80,1535,652,883,9,16,5,4
52088,35605,28933,35605,70,70,0,2,8,2,0
57331,443,8045,443,7468,2225,5243,27,16,15,12
51866,23431,38401,23431,70,70,0,2,8,2,0
52038,14487,65073,14487,66,66,0,1,5,1,0
59788,443,27023,443,248845,14935,233910,308,49,148,160
53946,27426,37838,27426,612,306,306,10,14,5,5
55796,53,53720,53,196,102,94,2,30,1,1
27005,28115,50771,28115,910,126,784,2,30,1,1
60354,80,7611,80,644,256,388,8,124,5,3
63594,443,17345,443,7673,2645,5028,31,137,17,14
56733,80,32206,80,214,140,74,4,25,3,1
49611,53,5356,53,177,94,83,2,30,1,1
44354,80,44354,80,250076,10158,239918,315,24,146,169
65132,53,11821,53,166,85,81,2,31,1,1
49991,80,28668,80,2095,1010,1085,11,87,6,5
56681,53,26694,53,195,102,93,2,30,1,1
40180,443,53378,443,1310,649,661,13,184,7,6
53193,443,17954,443,1462,965,497,13,18,7,6
53035,80,53035,80,373926,8227,365699,379,143,130,249
30960,45690,12118,45690,330,330,0,6,3609,6,0
50265,44822,26867,44822,149,149,0,1,1200,1,0
56185,53,59066,53,216,94,122,2,30,1,1
14102,80,14102,80,722,300,422,11,158,5,6
49743,443,50508,443,2372,1143,1229,21,82,10,11
55704,53,10411,53,177,94,83,2,31,1,1
10097,53,3471,53,259,86,173,2,30,1,1
51918,41488,58958,41488,70,70,0,1,5,1,0
53462,443,47212,443,6384,1091,5293,18,30,10,8
49777,53,14014,53,166,86,80,2,30,1,1
49836,53,62893,53,168,78,90,2,30,1,1
65384,53,46519,53,197,102,95,2,33,1,1
65492,53,43623,53,199,102,97,2,30,1,1
64792,53,34890,53,338,110,228,2,30,1,1
65045,53,53307,53,194,99,95,2,30,1,1
65218,53,49451,53,193,102,91,2,30,1,1
53544,22051,5386,22051,70,70,0,1,5,1,0
49326,443,20775,443,9303,2551,6752,33,16,18,15
50603,443,37566,443,2928,1448,1480,17,20,10,7
63742,443,58789,443,7444,1915,5529,28,16,16,12
60187,443,37474,443,5656,1936,3720,23,57,11,12
43480,443,57887,443,58423,25600,32823,86,138,40,46
50045,443,55393,443,5661,1526,4135,22,85,12,10
56468,53,3693,53,180,94,86,2,30,1,1
49696,53,30519,53,178,94,84,2,30,1,1
6881,50239,58874,50239,3514,1874,1640,15,1200,8,7
64516,53,41634,53,216,110,106,2,30,1,1
56489,80,59923,80,118508,4979,113529,128,135,48,80
57470,59208,35897,59208,1367,664,703,16,1199,9,7
42090,443,46273,443,5041,817,4224,20,373,8,12
56740,443,16895,443,7862,1873,5989,20,15,11,9
56412,80,47207,80,34476,818,33658,35,104,9,26
65350,53,8382,53,390,105,285,4,42,2,2
14421,443,39143,443,15204,8747,6457,83,167,44,39
56845,53,65473,53,233,102,131,2,30,1,1
55420,53,38783,53,177,94,83,2,30,1,1
55601,53,28384,53,177,94,83,2,30,1,1
64911,53,46196,53,209,110,99,2,31,1,1
9073,443,37513,443,4187235,99258,4087977,4375,28,1464,2911
50693,443,50693,443,19125,2345,16780,37,128,15,22
47388,443,44848,443,2897,728,2169,10,121,5,5
53967,54589,5598,54589,70,70,0,2,8,2,0
64380,53,47265,53,193,102,91,2,30,1,1
45387,443,38103,443,3999,2255,1744,37,1122,19,18
58705,5228,47511,5228,4706,2850,1856,44,6872,25,19
53321,443,65410,443,416,210,206,7,28,4,3
45619,80,13038,80,1052,612,440,10,15,5,5
39009,443,34628,443,12197,2338,9859,34,122,14,20
52737,443,14623,443,32774,3629,29145,52,26,27,25
41919,53,41919,53,223,86,137,2,30,1,1
49308,53,4514,53,195,102,93,2,30,1,1
53767,443,6984,443,499,425,74,4,0,3,1
57095,53,1337,53,211,110,101,2,29,1,1
56738,53,54145,53,264,87,177,4,36,2,2
50502,123,48233,123,184,94,90,2,30,1,1
64870,53,1765,53,200,102,98,2,33,1,1
62984,8920,64791,8920,829,583,246,9,15,5,4
47110,80,30489,80,436,222,214,7,19,4,3
57254,443,6263,443,3948,1290,2658,13,120,6,7
49290,443,44950,443,4783,2366,2417,16,203,8,8
51857,40561,9754,40561,70,70,0,2,8,2,0
46159,443,16876,443,4168,1128,3040,14,121,7,7
45414,443,2299,443,2215,1412,803,19,38,10,9
52080,80,40918,80,27100,21684,5416,39,38,25,14
49484,80,60761,80,318,192,126,6,39,4,2
27005,28215,29356,28215,879,126,753,2,30,1,1
49984,53,22558,53,178,94,84,2,30,1,1
18381,53,18381,53,237,91,146,2,32,1,1
55638,53,1033,53,78,78,0,1,30,1,0
55846,53,44796,53,821,102,719,2,29,1,1
55024,53,61199,53,174,89,85,2,30,1,1
49450,443,1753,443,2319947,69322,2250625,2464,70,870,1594
64609,53,7201,53,168,86,82,2,30,1,1
6159,53,6159,53,404,259,145,3,32,2,1
63976,53,54161,53,200,102,98,2,33,1,1
41980,443,47669,443,11377,7703,3674,26,162,19,7
63939,53,40762,53,226,110,116,2,30,1,1
52149,52188,59594,52188,70,70,0,2,8,2,0
38283,443,38283,443,6981,948,6033,17,54,10,7
60409,44739,34320,44739,70,70,0,2,8,2,0
55028,443,3475,443,1403116,30089,1373027,1321,32,404,917
64052,53,55826,53,232,102,130,2,30,1,1
56664,443,64784,443,9160636,285656,8874980,9685,189,3160,6525
53963,6882,44227,6882,70,70,0,2,8,2,0
64587,53,63035,53,167,86,81,2,30,1,1
52100,443,47301,443,298527,11814,286713,310,37,107,203
54351,443,26403,443,7900,2042,5858,27,36,15,12
57744,53,14767,53,198,93,105,2,31,1,1
41764,53,7946,53,168,78,90,2,29,1,1
9159,443,37775,443,5727,491,5236,14,15,7,7
56668,53,61467,53,701,88,613,2,30,1,1
64204,53,27061,53,264,102,162,2,31,1,1
56913,53,26881,53,193,102,91,2,30,1,1
64348,53,23011,53,321,102,219,2,30,1,1
55340,53,63068,53,184,94,90,2,31,1,1
63403,443,54530,443,4470,1597,2873,16,138,8,8
55421,53,44471,53,200,102,98,2,30,1,1
52062,443,35040,443,466,392,74,4,0,3,1
49597,80,58897,80,372,192,180,7,41,4,3
64053,53,10506,53,193,102,91,2,30,1,1
41163,443,48910,443,9045,1938,7107,21,16,12,9
56612,443,41735,443,8033,2013,6020,20,15,11,9
64940,53,17775,53,758,102,656,2,30,1,1
53964,443,36020,443,374,254,120,4,5,2,2
65505,53,17210,53,166,86,80,2,29,1,1
54571,443,54134,443,10546,2453,8093,28,15,16,12
57069,53,40804,53,1335,87,1248,4,32,2,2
27005,27025,22813,27025,887,126,761,2,31,1,1
51804,31012,28842,31012,70,70,0,1,5,1,0
33244,443,30372,443,4239,2487,1752,19,16,11,8
35868,123,20404,123,184,94,90,2,30,1,1
53672,20380,47465,20380,70,70,0,1,4,1,0
64420,53,14172,53,188,96,92,2,30,1,1
49954,53,59869,53,753,94,659,2,30,1,1
49874,443,3516,443,6058,1037,5021,20,54,11,9
57990,80,35454,80,42086,9535,32551,48,21,19,29
49762,53,56822,53,184,94,90,2,31,1,1
56820,53,40391,53,193,102,91,2,30,1,1
34217,443,35043,443,6650,1556,5094,23,18,13,10
54654,6881,17557,6881,470,348,122,6,26,4,2
65023,53,44980,53,761,102,659,2,30,1,1
49510,53,7986,53,754,94,660,2,30,1,1
54996,53,14810,53,168,86,82,2,31,1,1
27005,27016,54268,27016,1642,126,1516,4,31,2,2
49246,80,49246,80,133699,9415,124284,169,23,77,92
50265,41071,33048,41071,1716,1716,0,27,2188,27,0
46741,53,52840,53,221,75,146,2,30,1,1
52403,443,54910,443,8811,3668,5143,26,126,13,13
59840,80,40850,80,469946,11862,458084,482,68,173,309
56595,80,43530,80,234,234,0,4,12,4,0
49160,12176,2844,12176,852,150,702,4,1200,2,2
65472,53,63288,53,202,103,99,2,31,1,1
53160,39001,22070,39001,70,70,0,2,8,2,0
47258,443,16882,443,50898,2733,48165,73,218,33,40
38568,443,10055,443,11418,1999,9419,28,22,13,15
49759,53,39321,53,201,86,115,2,30,1,1
47598,443,10751,443,22048,16451,5597,47,18,21,26
6881,37321,46991,37321,502,150,352,2,1199,1,1
55345,53,38199,53,255,102,153,2,30,1,1
46216,443,47226,443,13769,11153,2616,30,361,16,14
53801,53,14956,53,167,78,89,2,30,1,1
56553,53,56242,53,199,102,97,2,30,1,1
57281,53,58597,53,711,87,624,2,31,1,1
50461,443,58774,443,5440,4368,1072,19,34,11,8
60208,80,42230,80,1313,738,575,10,152,6,4
36402,80,36402,80,1917,1468,449,10,20,6,4
57271,443,34428,443,7155,2151,5004,34,33,20,14
56680,443,28221,443,8942,1817,7125,23,77,13,10
30188,36914,20864,36914,2668,1950,718,16,7827,14,2
64983,53,38581,53,777,87,690,2,31,1,1
49212,38306,32120,38306,70,70,0,2,8,2,0
50362,53,19652,53,177,94,83,2,30,1,1
65421,443,16177,443,2494,1643,851,17,25,9,8
48817,6881,48817,6881,506,152,354,2,1200,1,1
52501,80,52501,80,79714,5592,74122,102,23,45,57
45679,53,45679,53,262,106,156,2,33,1,1
60452,62582,62916,62582,70,70,0,1,5,1,0
40549,443,33434,443,5591,3194,2397,16,122,8,8
56735,80,56735,80,2243,1548,695,11,46,7,4
63964,60705,4477,60705,312,132,180,6,7,3,3
56692,443,45896,443,7914,1925,5989,20,15,11,9
56783,53,24430,53,199,102,97,2,31,1,1
6882,16276,42707,16276,150,150,0,1,1200,1,0
57568,53,57568,53,235,98,137,2,30,1,1
44933,443,37036,443,8958,1683,7275,24,23,10,14
51641,443,64110,443,4692,2882,1810,32,80,14,18
65469,53,59478,53,190,97,93,2,30,1,1
59082,443,59082,443,6264,1435,4829,21,15,11,10
56423,53,27855,53,184,102,82,2,30,1,1
53154,443,28335,443,3947,2796,1151,22,28,12,10
56494,80,51723,80,44136,2908,41228,56,135,25,31
64854,53,12372,53,1431,101,1330,4,50,2,2
47831,443,18559,443,180582,6020,174562,196,200,70,126
64926,53,24382,53,166,86,80,2,30,1,1
50729,27029,59296,27029,269,78,191,2,30,1,1
64534,53,43156,53,212,108,104,2,31,1,1
64988,53,16723,53,196,94,102,2,30,1,1
22602,53,22602,53,217,87,130,2,30,1,1
57190,53,17320,53,757,102,655,2,30,1,1
52359,443,35892,443,13972,2550,11422,29,954,11,18
56725,53,45081,53,262,90,172,4,53,2,2
52795,443,15981,443,1444,723,721,15,198,8,7
27988,40022,50196,40022,146,84,62,2,30,1,1
56862,80,27370,80,2058,589,1469,10,45,6,4
65158,53,9153,53,728,102,626,2,30,1,1
64172,53,18592,53,194,99,95,2,30,1,1
54031,53,23447,53,168,78,90,2,30,1,1
54448,53,29193,53,70,70,0,1,30,1,0
64580,443,64391,443,24686,1935,22751,36,20,17,19
49165,53,64334,53,780,104,676,2,30,1,1
58857,443,13362,443,3439647,103607,3336040,3670,452,1291,2379
65165,53,5142,53,177,94,83,2,30,1,1
51268,47662,19145,47662,70,70,0,1,5,1,0
65411,53,35148,53,771,101,670,2,30,1,1
49332,53,38516,53,281,98,183,4,57,2,2
50265,37449,54760,37449,925,594,331,11,2335,10,1
45074,443,48285,443,4493,2566,1927,40,130,21,19
39597,443,19827,443,1350,689,661,14,18,8,6
50803,443,27237,443,25297,10467,14830,51,362,27,24
49390,53,36883,53,210,110,100,2,30,1,1
52417,443,14213,443,8376,6877,1499,27,31,15,12
62284,443,22217,443,3419,1275,2144,13,135,6,7
56646,53,16936,53,177,94,83,2,29,1,1
50638,80,16658,80,21873,2252,19621,27,21,10,17
57417,53,46711,53,199,102,97,2,30,1,1
52028,35097,53575,35097,206,136,70,4,13,3,1
49742,443,14299,443,16041,1805,14236,30,20,14,16
11601,53,11601,53,233,91,142,2,31,1,1
40204,40025,3762,40025,148,86,62,2,30,1,1
51466,4545,51466,4545,156,156,0,3,8,3,0
63237,443,45268,443,1369,670,699,17,141,9,8
55770,53,28096,53,167,86,81,2,29,1,1
55007,443,50452,443,9726,4743,4983,41,15,24,17
50607,443,33073,443,3947,2271,1676,22,140,13,9
50882,80,51896,80,207895,10483,197412,229,141,90,139
52018,53,53682,53,164,78,86,2,30,1,1
46034,53,59880,53,168,78,90,2,30,1,1
53650,53,49968,53,199,94,105,2,29,1,1
56691,443,48234,443,3986,2645,1341,18,18,10,8
56925,53,23020,53,196,102,94,2,30,1,1
49919,80,50897,80,2821387,64706,2756681,2277,183,418,1859
49631,443,24213,443,6304,1793,4511,29,255,15,14
34957,80,4367,80,7136,3526,3610,42,1239,21,21
55732,53,61011,53,194,102,92,2,30,1,1
60719,443,32077,443,71523,19991,51532,112,41,59,53
50255,53,55681,53,199,102,97,2,29,1,1
56566,443,19189,443,343737,9198,334539,348,80,121,227
53751,443,44095,443,499,425,74,4,0,3,1
52134,18470,56970,18470,70,70,0,1,4,1,0
49704,443,41533,443,513839,16341,497498,453,210,104,349
33098,443,16704,443,466,392,74,4,0,3,1
57425,443,11895,443,16413,6367,10046,60,17,28,32
38077,80,35599,80,1484,601,883,9,44,6,3
49604,53,29103,53,89,89,0,1,30,1,0
65336,53,64946,53,275,94,181,2,30,1,1
56006,53,33224,53,183,102,81,2,30,1,1
27988,40021,42591,40021,245,182,63,2,30,1,1
57879,80,31290,80,318,192,126,6,27,4,2
60306,443,28741,443,9188,3421,5767,43,83,19,24
53160,39001,43902,39001,70,70,0,1,5,1,0
52880,443,45002,443,1695880,25777,1670103,1423,118,264,1159
64570,443,7059,443,24984,2042,22942,41,32,19,22
64935,53,16580,53,765,102,663,2,30,1,1
61420,443,13668,443,6327,1143,5184,18,28,9,9
57476,443,16400,443,10068,3304,6764,28,36,17,11
6881,51413,48817,51413,200,111,89,2,1200,1,1
35112,8635,35112,8635,138,78,60,2,5,1,1
65370,53,4186,53,778,103,675,2,31,1,1
53550,1,57289,1,70,70,0,1,5,1,0
32742,53,46400,53,207,86,121,2,30,1,1
55106,53,60018,53,184,94,90,2,29,1,1
51221,55497,56542,55497,528,528,0,9,1200,9,0
48962,161,0,0,8507,3320,5187,28,30,14,14
56625,80,20338,80,234,234,0,4,11,4,0
55042,80,32886,80,306,180,126,6,34,4,2
58837,443,12859,443,13120,8597,4523,34,17,18,16
37965,29299,52257,29299,858,858,0,14,1199,14,0
55933,53,32005,53,177,94,83,2,30,1,1
59486,80,17490,80,882,527,355,10,255,6,4
51760,443,1508,443,1569,1044,525,14,94,9,5
63607,53,63607,53,643,88,555,2,30,1,1
27005,30005,39246,30005,890,126,764,2,31,1,1
55699,21063,32423,21063,70,70,0,2,8,2,0
11761,443,11761,443,5626,2487,3139,23,29,14,9
65221,53,38871,53,258,102,156,2,29,1,1
55007,443,13149,443,14030,7043,6987,32,123,18,14
56406,53,47759,53,749,89,660,2,30,1,1
64152,53,18184,53,232,110,122,2,30,1,1
42804,443,52813,443,8113,1626,6487,24,21,14,10
54998,443,38889,443,10151,2256,7895,32,39,17,15
56484,443,2923,443,1857,1218,639,18,135,11,7
54182,443,54182,443,4581,1674,2907,19,29,11,8
53750,27352,21637,27352,70,70,0,2,8,2,0
64739,53,37126,53,193,102,91,2,30,1,1
39821,443,37984,443,11179,7205,3974,47,136,26,21
60227,443,25151,443,6553,871,5682,19,45,9,10
43539,53,26606,53,168,78,90,2,30,1,1
61113,443,60052,443,23915,14776,9139,66,136,35,31
46424,443,29456,443,1340,760,580,14,39,8,6
46570,443,45902,443,8897,2184,6713,24,516,13,11
57893,443,16617,443,1867,1228,639,18,176,11,7
55058,53,41146,53,216,110,106,2,31,1,1
49673,80,41313,80,318,192,126,6,41,4,2
56853,13203,65279,13203,316,136,180,6,6,3,3
56217,53,61344,53,183,94,89,2,31,1,1
49788,443,22621,443,74171,1888,72283,72,126,18,54
64468,53,38719,53,259,118,141,2,30,1,1
55440,53,55440,53,220,90,130,2,30,1,1
65357,53,23805,53,180,94,86,2,30,1,1
50584,6889,64241,6889,1326,300,1026,6,1200,3,3
37555,16386,35583,16386,432,192,240,8,30,4,4
52173,80,40738,80,362,240,122,7,17,5,2
50510,443,23339,443,2259313,91208,2168105,2847,1409,1118,1729
41267,8245,14045,8245,280,214,66,2,30,1,1
56869,53,8171,53,198,94,104,2,31,1,1
53962,16251,40390,16251,70,70,0,2,7,2,0
55933,53,60713,53,182,94,88,2,30,1,1
51114,443,50404,443,10301,4593,5708,21,121,10,11
56313,53,15835,53,196,100,96,2,30,1,1
34367,443,31324,443,25205,2243,22962,41,149,17,24
36256,443,38729,443,3936219,107920,3828299,3880,132,1208,2672
55889,53,7647,53,199,102,97,2,30,1,1
63931,16528,26745,16528,376,254,122,6,17,4,2
65503,53,13139,53,177,94,83,2,30,1,1
41462,443,21403,443,10331,2157,8174,37,137,18,19
49546,443,3244,443,5519,945,4574,15,23,8,7
41210,443,59857,443,78,78,0,1,5,1,0
50972,3544,40157,3544,409,107,302,4,30,2,2
61397,80,22347,80,2500,531,1969,11,75,6,5
49418,27014,18652,27014,249,78,171,2,31,1,1
56642,443,62625,443,7890,1901,5989,20,15,11,9
39869,53,19258,53,394,80,314,4,29,2,2
65487,53,62751,53,204,104,100,2,31,1,1
64797,53,56821,53,183,94,89,2,30,1,1
49225,53,55909,53,295,101,194,4,49,2,2
36166,80,26343,80,1614,1300,314,10,15,5,5
51251,443,24124,443,7950,2502,5448,38,16,22,16
57169,53,49234,53,177,94,83,2,30,1,1
53899,443,60991,443,21288,10113,11175,107,31,51,56
55559,53,26431,53,180,92,88,2,30,1,1
35584,80,52820,80,1507,454,1053,10,15,5,5
64842,53,15693,53,340,95,245,4,47,2,2
50684,80,15318,80,62,62,0,1,5,1,0
55208,80,41287,80,1638,1324,314,10,15,5,5
49988,443,12921,443,214,82,132,4,5,2,2
56926,53,27418,53,711,87,624,2,30,1,1
42298,40037,29650,40037,208,86,122,4,30,2,2
51771,19103,40132,19103,70,70,0,2,8,2,0
52081,51835,33500,51835,316,136,180,6,6,3,3
39615,443,17497,443,130,70,60,3,5,2,1
56612,53,50823,53,184,94,90,2,30,1,1
49604,53,53151,53,179,94,85,2,30,1,1
64554,53,30164,53,94,94,0,1,29,1,0
53528,20485,28809,20485,70,70,0,1,5,1,0
52179,443,33825,443,7439,1156,6283,19,75,11,8
14697,8000,41154,8000,274,150,124,4,60,2,2
52140,53155,1111,53155,70,70,0,2,8,2,0
50288,80,24804,80,2032,600,1432,10,45,6,4
54619,80,53235,80,2269,1579,690,10,77,6,4
48668,7275,13487,7275,276,70,206,5,32,2,3
34920,53,40562,53,168,78,90,2,31,1,1
56062,53,55161,53,537,98,439,4,40,2,2
47337,443,13338,443,14281,2906,11375,15,122,4,11
10059,443,58839,443,70553,6471,64082,141,182,69,72
51468,80,31366,80,3389,2054,1335,19,25,11,8
52060,80,41226,80,366,240,126,7,25,5,2
48495,443,14805,443,3108,1711,1397,24,813,11,13
56850,53,62960,53,763,101,662,2,31,1,1
64396,53,52154,53,349,91,258,2,30,1,1
56079,53,63600,53,198,101,97,2,31,1,1
56028,53,49252,53,770,102,668,2,31,1,1
42298,40005,19733,40005,148,86,62,2,30,1,1
55834,443,1790,443,190,70,120,4,15,2,2
57901,443,18752,443,3924,1906,2018,26,170,14,12
57031,53,13224,53,711,87,624,2,30,1,1
55026,53,55024,53,196,94,102,2,30,1,1
56769,53,50586,53,195,102,93,2,30,1,1
50883,80,50883,80,514,246,268,9,42,5,4
56616,53,21461,53,183,94,89,2,30,1,1
55329,443,18522,443,9458,2227,7231,23,15,12,11
35191,53,35191,53,825,99,726,2,31,1,1
48743,443,24308,443,26609,2444,24165,45,21,21,24
55056,53,51122,53,209,110,99,2,30,1,1
49424,53,45939,53,198,102,96,2,32,1,1
52023,41791,57379,41791,70,70,0,1,5,1,0
38368,443,41740,443,4392,1164,3228,17,34,9,8
37561,443,20164,443,9766,3093,6673,37,270,21,16
46633,53,46633,53,237,91,146,2,32,1,1
64595,53,13089,53,299,93,206,4,35,2,2
55706,22,55706,22,252,60,192,5,14,2,3
49236,80,22987,80,1904818,59945,1844873,1747,162,498,1249
52235,48910,47820,48910,136,136,0,3,14,3,0
49702,443,53414,443,42430,4111,38319,79,130,42,37
33041,443,60563,443,12375,6777,5598,28,49,13,15
56062,53,34305,53,196,102,94,2,30,1,1
53453,443,33620,443,17494,6818,10676,46,46,25,21
50203,443,50531,443,3792,871,2921,16,121,7,9
52034,80,60212,80,366,240,126,7,25,5,2
56478,53,6625,53,177,94,83,2,29,1,1
62597,53,49610,53,306,306,0,4,47,4,0
65246,53,26370,53,179,94,85,2,30,1,1
56489,53,51415,53,178,94,84,2,30,1,1
59868,443,9732,443,6869,3351,3518,22,135,11,11
62155,53,41278,53,263,86,177,2,29,1,1
64073,53,53984,53,304,101,203,4,37,2,2
62888,53,62888,53,240,98,142,2,29,1,1
55966,443,15279,443,9006,2048,6958,36,121,18,18
27005,33051,48719,33051,887,126,761,2,31,1,1
64602,80,64602,80,18594,5204,13390,42,26,25,17
53758,443,30147,443,499,425,74,4,0,3,1
53715,53,53715,53,216,98,118,2,29,1,1
49203,53,4131,53,403,99,304,4,32,2,2
49722,53,29083,53,215,94,121,2,30,1,1
37965,58043,10741,58043,6029,3652,2377,79,3221,45,34
64581,443,64560,443,9221,2109,7112,28,32,15,13
61740,443,6060,443,92202,65396,26806,193,3454,68,125
60246,80,10832,80,17231,6415,10816,26,149,12,14
52158,443,56576,443,2149,1549,600,14,45,8,6
39326,53,39326,53,233,90,143,2,32,1,1
57242,443,22643,443,291104,18601,272503,413,77,186,227
56422,53,35743,53,190,97,93,2,31,1,1
48496,443,6861,443,2661,1558,1103,18,807,7,11
63106,443,7897,443,8712,3748,4964,51,255,23,28
49912,443,43170,443,2048821,56490,1992331,2082,44,522,1560
54522,443,63026,443,4728282,133897,4594385,4756,80,1650,3106
58055,80,48571,80,3791,2804,987,14,31,8,6
39995,443,36730,443,4160,2228,1932,25,159,13,12
65058,53,6038,53,249,94,155,2,30,1,1
14341,80,14341,80,3360,2260,1100,19,61,11,8
50584,56221,62822,56221,166,166,0,1,1199,1,0
28011,443,11393,443,5577,1390,4187,19,15,9,10
49272,7000,49272,7000,3132,815,2317,14,15,7,7
60078,80,2527,80,1114,534,580,12,15,7,5
51806,443,31513,443,19093,3390,15703,26,126,10,16
47836,443,38604,443,36324,2308,34016,55,81,22,33
34739,5222,35050,5222,26914,4119,22795,85,539,41,44
50394,80,50061,80,306,180,126,6,26,4,2
56374,53,20604,53,177,94,83,2,29,1,1
58643,443,8549,443,4801,2506,2295,12,121,6,6
38604,53,38604,53,203,82,121,2,30,1,1
62886,993,19324,993,9557,4773,4784,84,199,48,36
10808,443,10808,443,4902,861,4041,15,16,7,8
53752,35446,60472,35446,492,306,186,8,15,5,3
56715,53,19827,53,184,94,90,2,30,1,1
54267,53,33061,53,86,86,0,1,30,1,0
55024,53,59987,53,179,94,85,2,30,1,1
39814,443,9384,443,5761,3561,2200,45,51,23,22
65207,53,42618,53,277,110,167,2,30,1,1
55776,53,40395,53,216,110,106,2,29,1,1
48082,443,55722,443,5619,885,4734,17,26,9,8
64477,53,60345,53,211,102,109,2,29,1,1
40175,53,40175,53,235,90,145,2,32,1,1
59751,53,11335,53,304,86,218,2,30,1,1
10092,443,29539,443,130,70,60,3,5,2,1
40583,80,60376,80,898,543,355,10,255,6,4
60065,80,60065,80,246733,5745,240988,246,144,80,166
50011,53,36525,53,94,94,0,1,30,1,0
61018,443,61018,443,4400,1493,2907,19,29,11,8
39340,443,15093,443,334,140,194,6,25,3,3
49418,27015,47175,27015,234,78,156,2,30,1,1
56839,49949,49715,49949,70,70,0,1,5,1,0
19473,58093,47634,58093,460,150,310,2,1200,1,1
65382,53,20387,53,301,108,193,4,54,2,2
55320,53,54468,53,304,94,210,2,30,1,1
65319,53,38266,53,285,103,182,4,43,2,2
17861,443,17861,443,1155,728,427,11,26,7,4
57600,443,30518,443,2614,1689,925,18,21,10,8
49408,53,3483,53,252,102,150,2,30,1,1
52515,80,55752,80,4183,3603,580,14,15,8,6
49640,53,5967,53,402,118,284,2,30,1,1
56658,53,1646,53,170,87,83,2,30,1,1
49742,53,64012,53,731,91,640,2,30,1,1
39488,53,45099,53,199,94,105,2,29,1,1
55921,443,55921,443,4510,1603,2907,19,27,11,8
49847,80,28928,80,4135,2587,1548,10,89,7,3
49233,443,34014,443,9622,3524,6098,59,916,29,30
9100,443,50468,443,4945,431,4514,12,15,6,6
55545,3389,55545,3389,3527,1638,1889,18,18,11,7
62415,53,36183,53,86,86,0,1,30,1,0
6881,30096,6963,30096,509,150,359,2,1199,1,1
12157,80,12157,80,2144,1519,625,9,29,6,3
4651,443,4651,443,14579,1280,13299,25,16,9,16
65486,53,53853,53,193,102,91,2,30,1,1
5431,53,64205,53,220,78,142,2,30,1,1
55609,53,21760,53,178,94,84,2,30,1,1
63943,53,51755,53,274,90,184,4,56,2,2
65110,53,31746,53,406,142,264,2,30,1,1
45458,443,14560,443,7144,4917,2227,36,561,18,18
49358,443,12762,443,137147,82203,54944,174,105,103,71
56298,53,17699,53,173,94,79,2,30,1,1
56085,53,39673,53,167,86,81,2,31,1,1
48164,53,51985,53,199,94,105,2,30,1,1
52168,62118,28732,62118,70,70,0,1,5,1,0
55661,443,55661,443,24362,8850,15512,52,47,32,20
50348,80,25254,80,4929,2773,2156,17,42,9,8
58848,443,16146,443,2109,420,1689,11,121,6,5
54139,80,14592,80,1515,481,1034,11,15,6,5
59403,443,58702,443,5853,2409,3444,35,80,16,19
54992,443,45267,443,31183,3879,27304,52,19,26,26
39042,443,60755,443,3589,1251,2338,15,20,9,6
58600,443,58600,443,4396,1489,2907,19,26,11,8
49529,443,17894,443,9047,1436,7611,22,27,10,12
52327,53,21249,53,224,94,130,2,29,1,1
52089,16543,15795,16543,70,70,0,1,5,1,0
65073,53,55415,53,325,102,223,2,29,1,1
64950,53,51754,53,728,102,626,2,30,1,1
55526,80,64372,80,6138,1242,4896,15,40,7,8
49998,53,11230,53,467,90,377,4,39,2,2
60981,443,40562,443,22449,19500,2949,53,21,31,22
49803,80,1813,80,2553,1621,932,13,126,8,5
45418,443,36338,443,137754,15176,122578,229,99,106,123
52237,443,52237,443,7718,2030,5688,23,20,11,12
56603,53,39210,53,168,86,82,2,30,1,1
54711,443,40588,443,3663,1136,2527,13,136,6,7
51923,11542,51093,11542,70,70,0,1,5,1,0
50045,443,64654,443,4551,2388,2163,16,120,8,8
64915,53,19337,53,177,94,83,2,29,1,1
49561,80,28691,80,57215,680,56535,47,135,7,40
27005,29999,22693,29999,876,126,750,2,31,1,1
57270,53,35020,53,211,102,109,2,30,1,1
64787,53,33533,53,179,94,85,2,30,1,1
60066,80,60066,80,355862,9048,346814,358,163,116,242
58363,53,45299,53,167,78,89,2,30,1,1
60485,13314,64825,13314,70,70,0,2,8,2,0
47163,53,47163,53,825,99,726,2,31,1,1
60225,443,43705,443,8989,3335,5654,65,152,31,34
27005,27269,13554,27269,886,126,760,2,30,1,1
50593,443,18063,443,1745,1068,677,18,95,10,8
5588,5588,0,0,3354,1792,1562,46,195,23,23
56822,53,60070,53,184,94,90,2,30,1,1
55971,53,55971,53,233,90,143,2,33,1,1
56662,80,65360,80,234,234,0,4,12,4,0
56135,53,22804,53,542,112,430,4,34,2,2
56955,53,64522,53,183,94,89,2,30,1,1
52780,443,29664,443,122,62,60,2,15,1,1
53937,28506,44986,28506,492,306,186,8,15,5,3
64987,53,57288,53,196,102,94,2,31,1,1
50000,53,33265,53,216,110,106,2,30,1,1
58776,443,11042,443,7259,842,6417,27,290,9,18
6649,80,6649,80,103631,2766,100865,110,39,38,72
47643,443,8942,443,11108,3774,7334,28,230,13,15
50455,80,38947,80,4395,3599,796,15,34,8,7
54979,53,64417,53,183,94,89,2,30,1,1
37534,443,60202,443,6927,1883,5044,25,46,14,11
50598,80,63854,80,17837,3830,14007,27,24,12,15
50430,53,3410,53,789,102,687,2,30,1,1
35797,53,35797,53,217,90,127,2,30,1,1
49787,443,47487,443,34175,1680,32495,42,126,15,27
2226,443,2226,443,46743,4890,41853,69,23,35,34
51263,443,47905,443,143597,6963,136634,206,439,103,103
49555,53,29992,53,193,102,91,2,30,1,1
51973,80,59636,80,21570,1613,19957,33,54,16,17
51952,443,19528,443,11367,3820,7547,28,28,16,12
52107,80,35011,80,9902,8772,1130,18,35,10,8
53261,12348,58794,12348,552,306,246,9,142,5,4
27005,27268,57130,27268,884,126,758,2,30,1,1
63965,53,54423,53,180,94,86,2,31,1,1
53450,443,34036,443,10139,3656,6483,29,128,14,15
57445,66,37294,66,70,70,0,2,8,2,0
51304,443,39350,443,5839,3609,2230,25,361,13,12
52170,45144,16828,45144,70,70,0,2,8,2,0
46056,80,34041,80,5066,4404,662,11,30,6,5
63837,14023,10553,14023,66,66,0,2,8,2,0
56832,53,34537,53,214,102,112,2,29,1,1
57406,53,28886,53,761,100,661,2,30,1,1
64592,53,18733,53,177,94,83,2,30,1,1
38149,53,54452,53,199,94,105,2,31,1,1
49983,53,19113,53,267,110,157,2,30,1,1
57186,53,42967,53,177,94,83,2,30,1,1
64790,53,41901,53,178,94,84,2,29,1,1
56621,80,4891,80,234,234,0,4,12,4,0
38769,443,3016,443,7352,3452,3900,18,15,10,8
39154,80,25294,80,1504,926,578,15,36,9,6
42298,40039,50865,40039,602,86,516,2,30,1,1
65220,53,17734,53,303,94,209,4,32,2,2
64143,53,3333,53,179,94,85,2,30,1,1
53676,80,62250,80,154478,6934,147544,194,24,86,108
49335,80,26214,80,1193,703,490,8,18,5,3
49997,53,1711,53,209,110,99,2,30,1,1
53764,443,39809,443,8115,1962,6153,24,18,14,10
65143,53,7897,53,184,94,90,2,30,1,1
50875,53,15135,53,234,234,0,4,47,4,0
54991,53,13574,53,177,94,83,2,29,1,1
54461,443,55522,443,7548,2583,4965,26,362,12,14
51960,443,7003,443,8830,1950,6880,27,25,14,13
53723,51501,24523,51501,70,70,0,1,5,1,0
63895,43729,42252,43729,66,66,0,2,7,2,0
64110,443,18222,443,5060,3367,1693,21,102,12,9
65460,53,40464,53,197,102,95,2,30,1,1
43309,443,32781,443,60,60,0,1,5,1,0
55342,53,57972,53,994,86,908,2,30,1,1
55339,53,49453,53,194,94,100,2,30,1,1
53648,31637,17348,31637,70,70,0,2,7,2,0
56330,53,38670,53,760,97,663,2,30,1,1
58744,80,31824,80,4635,1572,3063,12,15,7,5
50346,53,1416,53,168,78,90,2,30,1,1
51874,43161,58126,43161,70,70,0,2,8,2,0
57372,53,34702,53,756,95,661,2,31,1,1
45706,443,50703,443,512213,34626,477587,741,147,283,458
64026,53,2303,53,244,94,150,2,31,1,1
49420,53,37701,53,185,102,83,2,30,1,1
9176,443,40179,443,6331,837,5494,19,28,10,9
49732,53,17684,53,178,94,84,2,30,1,1
53486,443,39031,443,8879,2420,6459,32,255,17,15
49276,53,39804,53,199,102,97,2,29,1,1
51923,80,55461,80,60441,6260,54181,79,29,35,44
51505,443,22811,443,7211,823,6388,16,15,10,6
38606,53,21514,53,168,78,90,2,30,1,1
18194,53,18194,53,225,87,138,2,31,1,1
53447,80,56181,80,1517,481,1036,11,15,6,5
55695,53,3075,53,177,94,83,2,29,1,1
57323,53,57323,53,216,98,118,2,30,1,1
39194,53,39194,53,414,268,146,3,32,2,1
43071,80,63845,80,808,480,328,13,158,9,4
6881,51719,22526,51719,324,150,174,2,1199,1,1
56939,53,33751,53,351,94,257,2,30,1,1
64099,55470,5838,55470,66,66,0,2,8,2,0
50584,6881,19659,6881,161,161,0,2,1200,2,0
43089,443,26098,443,9737,6695,3042,45,81,24,21
56395,443,25199,443,7018,2751,4267,24,39,11,13
43518,443,23490,443,10265,2118,8147,23,81,13,10
42443,443,56747,443,5378,1512,3866,20,16,11,9
52928,80,52040,80,1996,691,1305,10,359,6,4
52953,80,11532,80,3247,1730,1517,12,36,7,5
52267,443,8782,443,24712,9272,15440,65,136,34,31
55958,53,30538,53,275,86,189,2,29,1,1
53022,443,29069,443,15099,7828,7271,45,92,24,21
48817,1024,48817,1024,152,152,0,1,1200,1,0
58907,80,55384,80,694,350,344,11,28,6,5
64367,53,24939,53,257,110,147,2,30,1,1
49345,443,4175,443,61954,10029,51925,114,82,50,64
56807,443,49269,443,8020,2000,6020,20,16,11,9
65523,53,26977,53,228,94,134,2,30,1,1
49875,443,6451,443,31715,20427,11288,103,54,54,49
57470,51413,59920,51413,528,528,0,9,1199,9,0
52277,80,52277,80,259496,6676,252820,249,28,74,175
34298,53,58428,53,199,94,105,2,30,1,1
22659,53,22659,53,247,98,149,2,32,1,1
65273,53,14991,53,338,110,228,2,29,1,1
55396,443,55396,443,63319,6716,56603,91,19,45,46
64608,53,12446,53,212,110,102,2,30,1,1
55645,18904,52547,18904,320,140,180,6,6,3,3
57442,2258,57442,2258,156,156,0,3,8,3,0
56769,53,53195,53,183,94,89,2,30,1,1
38675,443,48538,443,5236,1549,3687,19,29,11,8
6882,59689,61028,59689,221,111,110,2,1200,1,1
56648,53,16460,53,199,102,97,2,31,1,1
56314,53,10977,53,183,94,89,2,30,1,1
39267,123,6756,123,184,94,90,2,30,1,1
39704,53,39704,53,398,255,143,3,33,2,1
53114,32975,31768,32975,70,70,0,2,8,2,0
50560,443,29461,443,408090,25873,382217,748,137,354,394
49723,80,53474,80,2367,557,1810,10,82,6,4
55095,53,24827,53,188,96,92,2,30,1,1
56375,53,7933,53,170,87,83,2,30,1,1
63952,53,34336,53,206,105,101,2,31,1,1
51975,443,30656,443,4692,2376,2316,30,47,16,14
21456,53,21456,53,240,98,142,2,30,1,1
59183,53,39038,53,260,86,174,2,30,1,1
52046,59791,21148,59791,70,70,0,1,4,1,0
65179,53,9786,53,289,102,187,2,30,1,1
57348,443,25316,443,13048,4976,8072,40,140,18,22
13871,53,13871,53,240,98,142,2,30,1,1
50475,53,26369,53,772,100,672,2,31,1,1
50566,443,50394,443,11116,4583,6533,39,256,19,20
52777,80,21198,80,432,240,192,8,100,5,3
51513,443,33339,443,75323,6054,69269,110,38,52,58
59830,443,59830,443,21205,1711,19494,32,1806,11,21
55514,53,31515,53,747,93,654,2,30,1,1
55276,53,33496,53,170,87,83,2,31,1,1
55671,53,40091,53,196,102,94,2,33,1,1
55939,53,47586,53,177,94,83,2,29,1,1
53934,443,47963,443,360,360,0,7,4,7,0
56648,443,37098,443,1327,918,409,10,26,6,4
64985,53,10267,53,86,86,0,1,60,1,0
64788,53,8538,53,749,94,655,2,31,1,1
60391,47212,53433,47212,258,70,188,4,8,2,2
48726,443,17212,443,6644134,184008,6460126,6659,204,2197,4462
65115,53,25677,53,368,95,273,4,61,2,2
55941,53,18127,53,184,94,90,2,30,1,1
48817,7131,48817,7131,158,158,0,1,1200,1,0
55566,443,9542,443,8426,4752,3674,37,122,18,19
123,123,44084,123,184,94,90,2,30,1,1
55002,53,6216,53,196,102,94,2,30,1,1
55487,53,48616,53,199,102,97,2,29,1,1
56902,53,41488,53,768,99,669,2,30,1,1
49440,443,48823,443,3721809,103604,3618205,3808,156,1281,2527
56661,443,39690,443,7900,3324,4576,28,139,13,15
64790,53,41786,53,183,94,89,2,30,1,1
40360,443,31288,443,3146,766,2380,10,120,5,5
51832,40607,46819,40607,70,70,0,2,7,2,0
55836,53,27528,53,181,94,87,2,30,1,1
56470,53,63709,53,198,102,96,2,30,1,1
51773,23728,42323,23728,70,70,0,2,8,2,0
50390,8080,50390,8080,378,180,198,7,54,4,3
27998,443,50249,443,5515,1388,4127,18,15,9,9
49595,53,24473,53,180,94,86,2,30,1,1
49810,80,21965,80,1469,979,490,10,125,6,4
50293,443,30749,443,6697,1606,5091,23,36,13,10
49864,80,42240,80,5205,1474,3731,9,88,5,4
64034,53,39969,53,194,102,92,2,31,1,1
39948,5223,55367,5223,5551,1338,4213,28,1323,11,17
49925,443,37960,443,19134,7361,11773,40,148,19,21
48297,443,9986,443,7320,1817,5503,41,106,16,25
64098,10096,50669,10096,70,70,0,1,4,1,0
57408,53,58813,53,190,97,93,2,30,1,1
51500,443,57250,443,7211,823,6388,16,15,10,6
64772,53,64772,53,241,98,143,2,30,1,1
64982,53,7068,53,321,97,224,4,57,2,2
65130,80,61798,80,2500,531,1969,11,76,6,5
58887,15000,7750,15000,138,78,60,2,6,1,1
50922,80,57250,80,9219616,105865,9113751,7687,120,1487,6200
49540,53,53210,53,198,110,88,2,30,1,1
53882,13613,12263,13613,320,140,180,6,5,3,3
55932,53,12204,53,193,102,91,2,29,1,1
63951,53,13752,53,186,95,91,2,31,1,1
52046,80,15183,80,27904,14100,13804,46,34,24,22
55681,31948,14765,31948,70,70,0,1,5,1,0
49473,80,51676,80,388,262,126,7,29,5,2
49880,443,51797,443,1087632,32231,1055401,1112,53,334,778
48817,6881,48817,6881,863,363,500,4,1200,2,2
39353,9339,55496,9339,170706,9877,160829,260,46,110,150
57103,53,56809,53,193,102,91,2,30,1,1
51924,28016,24796,28016,70,70,0,2,8,2,0
64495,53,28201,53,243,94,149,2,30,1,1
9260,80,58390,80,318,192,126,6,26,4,2
64846,53,55957,53,785,110,675,2,30,1,1
48886,443,65287,443,8468,2867,5601,23,144,10,13
50013,53,8187,53,199,102,97,2,30,1,1
51974,54759,44030,54759,70,70,0,2,7,2,0
50265,24387,12796,24387,132,132,0,3,1200,3,0
49692,53,19952,53,208,106,102,2,30,1,1
35012,443,7162,443,1461,980,481,11,25,7,4
50209,53,30899,53,749,94,655,2,30,1,1
64706,27065,4529,27065,924,924,0,3,30,3,0
65021,53,29449,53,589,91,498,4,54,2,2
64614,53,5990,53,517,179,338,6,62,3,3
55657,53,56154,53,101,101,0,2,34,2,0
49886,443,23328,443,7488,1598,5890,25,50,13,12
49483,53,49626,53,172,88,84,2,30,1,1
60411,58131,51349,58131,70,70,0,2,8,2,0
62230,443,62230,443,119850,11021,108829,134,95,50,84
56550,53,19597,53,166,86,80,2,29,1,1
47929,80,47929,80,11976,6928,5048,25,24,14,11
43563,443,50861,443,466,392,74,4,0,3,1
56335,53,31703,53,260,102,158,2,30,1,1
48092,443,48092,443,4398,1491,2907,19,27,11,8
55027,53,18379,53,168,86,82,2,31,1,1
64891,53,17816,53,211,102,109,2,30,1,1
53083,80,12541,80,5259,1904,3355,30,15,23,7
50195,53,23918,53,199,102,97,2,30,1,1
49518,443,49518,443,103941,6635,97306,158,76,81,77
49846,80,38683,80,3215,2272,943,15,38,9,6
59988,443,59988,443,8589,2809,5780,30,16,15,15
50051,443,1683,443,7912,3269,4643,23,96,12,11
44911,80,13176,80,1052,612,440,10,15,5,5
54136,443,48147,443,18716,8002,10714,100,945,51,49
65246,53,1802,53,209,102,107,2,30,1,1
50474,80,50474,80,4994,855,4139,14,21,7,7
39915,443,23556,443,27886,17603,10283,138,462,76,62
65133,53,56873,53,196,100,96,2,31,1,1
62072,443,3018,443,6095,1965,4130,26,46,15,11
64609,53,7620,53,250,86,164,4,30,2,2
6881,61404,13734,61404,228,118,110,2,1200,1,1
63904,18268,47003,18268,66,66,0,2,7,2,0
36535,443,10367,443,416,210,206,7,27,4,3
57303,443,1835,443,5612,733,4879,16,15,9,7
56308,53,37236,53,184,94,90,2,31,1,1
51653,80,24193,80,454,262,192,8,37,5,3
56766,53,59139,53,210,110,100,2,30,1,1
39115,443,62542,443,335190,17497,317693,449,42,211,238
36676,443,44727,443,7636,3367,4269,24,319,13,11
64116,53,45149,53,267,94,173,4,59,2,2
50255,53,25168,53,199,102,97,2,29,1,1
35140,123,7443,123,184,94,90,2,30,1,1
33008,53,33008,53,263,104,159,2,30,1,1
49227,53,61588,53,179,94,85,2,30,1,1
49208,53,8830,53,216,94,122,2,29,1,1
64242,53,44715,53,176,90,86,2,31,1,1
49980,443,59748,443,7227,4437,2790,29,271,16,13
54833,443,46650,443,3894,969,2925,20,153,9,11
60216,80,20321,80,3606,2572,1034,14,151,8,6
57470,22646,6893,22646,353,166,187,2,1200,1,1
51757,54657,4096,54657,70,70,0,2,8,2,0
51437,443,45199,443,6286,1494,4792,22,16,11,11
47238,443,16760,443,16131,4542,11589,45,139,21,24
63992,443,1306,443,4360,2142,2218,15,120,7,8
45624,443,55280,443,6697,1606,5091,23,17,13,10
57470,56432,6012,56432,132,132,0,3,1199,3,0
55021,53,44725,53,179,94,85,2,30,1,1
55199,53,24591,53,152,78,74,2,29,1,1
49418,27015,42209,27015,234,71,163,2,31,1,1
43659,443,24456,443,17592,11518,6074,51,248,26,25
50572,80,21152,80,132,132,0,2,8,2,0
51953,62964,9503,62964,316,136,180,6,5,3,3
59780,443,27949,443,19224,2358,16866,38,28,15,23
47091,5228,39353,5228,3113,1395,1718,20,3608,8,12
45195,80,65375,80,1115,534,581,12,15,7,5
53372,443,36591,443,214,140,74,4,20,3,1
39918,443,58004,443,7542,1235,6307,23,15,12,11
41231,443,41940,443,65667,5371,60296,89,85,36,53
64840,53,24107,53,356,118,238,2,30,1,1
59899,3389,59899,3389,3504,1790,1714,17,32,9,8
44319,443,43736,443,13919,3349,10570,46,120,25,21
53541,443,39871,443,10583,1889,8694,28,251,10,18
49594,80,30490,80,25430,15577,9853,37,41,19,18
56357,53,8894,53,168,86,82,2,30,1,1
50122,53,55627,53,811,94,717,2,31,1,1
65213,53,57292,53,198,94,104,2,30,1,1
64406,53,46788,53,204,204,0,3,46,3,0
50520,53,8153,53,183,94,89,2,30,1,1
55701,31543,58312,31543,320,140,180,6,5,3,3
49313,443,5265,443,3185,2263,922,18,25,9,9
50543,443,30180,443,38667,3344,35323,56,210,24,32
51789,443,60352,443,6218,4326,1892,31,124,17,14
55310,53,30986,53,176,90,86,2,31,1,1
50423,80,33009,80,23470,2457,21013,31,22,13,18
56474,53,9698,53,209,110,99,2,29,1,1
55945,53,7616,53,177,94,83,2,29,1,1
35484,443,11377,443,1633,1038,595,14,34,8,6
49179,53,18943,53,309,118,191,2,30,1,1
57030,53,12910,53,283,101,182,4,38,2,2
57339,53,52334,53,196,94,102,2,30,1,1
50401,53,50401,53,200,90,110,2,30,1,1
56809,40641,18349,40641,70,70,0,1,5,1,0
10060,443,49510,443,293424,16379,277045,410,93,193,217
55068,53,54785,53,196,102,94,2,30,1,1
60803,80,16464,80,254,128,126,5,15,3,2
64532,53,56480,53,258,110,148,2,30,1,1
33609,443,62063,443,9348,1018,8330,22,256,11,11
64636,53,38894,53,182,102,80,2,30,1,1
56531,443,49300,443,215863,14423,201440,245,105,95,150
39817,443,13115,443,516080,28328,487752,660,95,305,355
45079,80,36951,80,233914,10359,223555,294,442,136,158
56509,53,37473,53,1165,94,1071,2,30,1,1
64276,53,40042,53,194,99,95,2,31,1,1
57222,53,54587,53,177,94,83,2,30,1,1
49617,80,31416,80,314,192,122,6,42,4,2
45214,443,34615,443,6641,4617,2024,34,80,18,16
64989,53,60666,53,214,102,112,2,30,1,1
55708,443,3177,443,10710,4573,6137,53,3376,31,22
39107,443,62182,443,692830,23263,669567,784,114,306,478
47647,443,47647,443,4565,1658,2907,19,28,11,8
60329,80,45049,80,374,192,182,7,61,4,3
50448,443,40818,443,1119,595,524,12,26,6,6
55383,53,13927,53,177,94,83,2,30,1,1
54352,443,22800,443,6854,2318,4536,20,16,11,9
64952,53,2309,53,232,94,138,2,30,1,1
53614,8999,9856,8999,928,541,387,8,17,5,3
49874,80,9513,80,9921,2945,6976,19,88,8,11
56141,53,30553,53,184,94,90,2,30,1,1
42665,443,42665,443,4620,1713,2907,19,26,11,8
40507,53,2072,53,86,86,0,1,30,1,0
41694,443,48276,443,16107,3200,12907,35,362,17,18
55155,53,55155,53,240,98,142,2,30,1,1
55747,53,60258,53,186,95,91,2,30,1,1
49186,53,38504,53,198,102,96,2,30,1,1
56849,443,44408,443,7374,2085,5289,33,270,18,15
63846,80,10554,80,314,192,122,6,15,4,2
56441,80,22718,80,1272,389,883,16,394,4,12
57470,39113,45501,39113,14689,8867,5822,93,3051,67,26
56522,53,51170,53,177,94,83,2,30,1,1
56489,53,32825,53,178,94,84,2,30,1,1
60410,80,39027,80,186,64,122,4,27,2,2
61886,443,1075,443,8829,3335,5494,16,126,9,7
51467,443,43898,443,186117,12962,173155,249,143,83,166
52045,16853,65490,16853,70,70,0,2,8,2,0
36628,80,36628,80,5529,713,4816,15,15,8,7
53002,80,19802,80,1601,761,840,10,334,6,4
26854,53,44108,53,222,86,136,2,30,1,1
49605,53,30084,53,756,95,661,2,30,1,1
9440,443,42891,443,7573,1528,6045,22,33,11,11
50341,80,19405,80,306,180,126,6,41,4,2
50584,49533,38774,49533,161,161,0,1,1200,1,0
50319,53,28862,53,756,95,661,2,30,1,1
27005,27015,45770,27015,874,126,748,2,30,1,1
56305,53,56939,53,242,118,124,2,30,1,1
49870,53,17515,53,194,102,92,2,30,1,1
52491,443,12140,443,22753,7559,15194,31,16,16,15
49681,53,1706,53,170,87,83,2,30,1,1
49859,443,23944,443,6065,1045,5020,20,60,11,9
58053,25,49850,25,1316,442,874,15,16,7,8
63977,54486,15705,54486,66,66,0,1,5,1,0
48817,57451,48817,57451,152,152,0,1,1200,1,0
37769,80,60461,80,1213,471,742,10,255,6,4
49849,443,49569,443,6117,976,5141,21,72,10,11
39348,443,17067,443,28301,21778,6523,88,125,49,39
46529,80,23858,80,1119,388,731,9,223,5,4
51899,47537,11729,47537,66,66,0,1,5,1,0
34432,80,52921,80,6260,696,5564,17,16,9,8
61273,443,61273,443,8480,2451,6029,21,17,12,9
49262,53,13310,53,168,86,82,2,29,1,1
62050,443,56297,443,7955,2503,5452,33,16,19,14
52735,443,43904,443,41870,3567,38303,68,15,34,34
55893,53,56779,53,711,87,624,2,30,1,1
44796,443,34897,443,8158,2927,5231,25,85,15,10
24208,53,24208,53,231,88,143,2,32,1,1
59124,443,60758,443,27431,19413,8018,71,175,36,35
65251,53,12989,53,199,102,97,2,29,1,1
50010,53,28513,53,330,126,204,2,31,1,1
42298,40003,32102,40003,206,84,122,4,30,2,2
49972,53,40776,53,184,94,90,2,30,1,1
54341,443,8795,443,10046,3300,6746,23,61,14,9
53976,443,65435,443,9921,2236,7685,35,32,17,18
8984,443,5920,443,13750,4934,8816,64,167,31,33
55216,53,32573,53,179,94,85,2,30,1,1
51960,58601,12629,58601,70,70,0,2,8,2,0
64707,53,47683,53,258,102,156,2,30,1,1
5688,44847,0,0,62,62,0,1,0,1,0
51745,30188,0,0,66,66,0,1,0,1,0
2932,44847,0,0,62,62,0,1,0,1,0
53841,37965,0,0,66,66,0,1,0,1,0
52827,25174,0,0,146,146,0,1,0,1,0
54779,50584,0,0,66,66,0,1,0,1,0
59915,42707,0,0,145,145,0,1,0,1,0
57131,35776,0,0,145,145,0,1,0,1,0
32051,37965,0,0,62,62,0,1,0,1,0
22922,35440,0,0,66,66,0,1,0,1,0
47913,25174,0,0,62,62,0,1,0,1,0
27110,22114,0,0,62,62,0,1,0,1,0
36011,25174,0,0,66,66,0,1,0,1,0
1067,51221,0,0,145,145,0,1,0,1,0
40845,64147,0,0,62,62,0,1,0,1,0
58371,23,0,0,60,60,0,1,0,1,0
58638,5900,0,0,62,62,0,1,0,1,0
60438,17372,0,0,66,66,0,1,0,1,0
52459,33890,0,0,60,60,0,1,0,1,0
55459,50584,0,0,66,66,0,1,0,1,0
443,24425,0,0,151,151,0,1,0,1,0
5914,10214,0,0,100,100,0,1,0,1,0
57761,15503,0,0,66,66,0,1,0,1,0
9231,3389,0,0,66,66,0,1,0,1,0
49036,44847,0,0,62,62,0,1,0,1,0
26762,22114,0,0,62,62,0,1,0,1,0
58463,11392,0,0,66,66,0,1,0,1,0
62071,22114,0,0,62,62,0,1,0,1,0
45941,23388,0,0,60,60,0,1,0,1,0
64772,64147,0,0,66,66,0,1,0,1,0
50328,22114,0,0,66,66,0,1,0,1,0
62872,50584,0,0,62,62,0,1,0,1,0
443,10010,0,0,60,60,0,1,0,1,0
14036,48817,0,0,66,66,0,1,0,1,0
59587,25174,0,0,62,62,0,1,0,1,0
31619,51221,0,0,62,62,0,1,0,1,0
49286,23,0,0,60,60,0,1,0,1,0
37008,42707,0,0,62,62,0,1,0,1,0
58849,64147,0,0,66,66,0,1,0,1,0
8560,50584,0,0,62,62,0,1,0,1,0
61523,37807,0,0,66,66,0,1,0,1,0
3830,26467,0,0,66,66,0,1,0,1,0
55994,22114,0,0,66,66,0,1,0,1,0
58638,5900,0,0,62,62,0,1,0,1,0
1036,64147,0,0,145,145,0,1,0,1,0
8889,33698,0,0,60,60,0,1,0,1,0
55082,25174,0,0,62,62,0,1,0,1,0
10262,11392,0,0,62,62,0,1,0,1,0
1888,51505,0,0,62,62,0,1,0,1,0
47910,7461,0,0,60,60,0,1,0,1,0
0,0,0,0,98,98,0,1,0,1,0
1024,26296,0,0,159,159,0,1,0,1,0
26881,25174,0,0,66,66,0,1,0,1,0
10467,25174,0,0,62,62,0,1,0,1,0
61838,37965,0,0,66,66,0,1,0,1,0
43260,41615,0,0,145,145,0,1,0,1,0
59845,44847,0,0,66,66,0,1,0,1,0
52838,37965,0,0,66,66,0,1,0,1,0
4935,3389,0,0,66,66,0,1,0,1,0
60184,37965,0,0,66,66,0,1,0,1,0
51582,48817,0,0,66,66,0,1,0,1,0
50820,57470,0,0,62,62,0,1,0,1,0
46829,64147,0,0,146,146,0,1,0,1,0
11030,17372,0,0,62,62,0,1,0,1,0
16387,35583,0,0,60,60,0,1,0,1,0
52837,35440,0,0,66,66,0,1,0,1,0
9102,29635,0,0,148,148,0,1,0,1,0
55027,37965,0,0,145,145,0,1,0,1,0
45944,44847,0,0,146,146,0,1,0,1,0
10088,37807,0,0,66,66,0,1,0,1,0
443,14315,0,0,158,158,0,1,0,1,0
56098,55442,0,0,66,66,0,1,0,1,0
443,9863,0,0,60,60,0,1,0,1,0
22916,25174,0,0,62,62,0,1,0,1,0
57034,44847,0,0,62,62,0,1,0,1,0
62709,57470,0,0,62,62,0,1,0,1,0
53906,37965,0,0,62,62,0,1,0,1,0
58638,5900,0,0,62,62,0,1,0,1,0
43815,50584,0,0,146,146,0,1,0,1,0
1070,26467,0,0,62,62,0,1,0,1,0
40078,44847,0,0,146,146,0,1,0,1,0
48840,50584,0,0,62,62,0,1,0,1,0
22547,48817,0,0,72,72,0,1,0,1,0
58638,5900,0,0,62,62,0,1,0,1,0
14489,25174,0,0,146,146,0,1,0,1,0
52740,51505,0,0,66,66,0,1,0,1,0
40254,25174,0,0,146,146,0,1,0,1,0
39086,53733,0,0,146,146,0,1,0,1,0
80,9918,0,0,60,60,0,1,0,1,0
52492,37965,0,0,66,66,0,1,0,1,0
37011,25174,0,0,62,62,0,1,0,1,0
7889,48817,0,0,146,146,0,1,0,1,0
60192,35440,0,0,66,66,0,1,0,1,0
63321,37807,0,0,66,66,0,1,0,1,0
58638,5900,0,0,62,62,0,1,0,1,0
10547,57470,0,0,62,62,0,1,0,1,0
57073,57470,0,0,62,62,0,1,0,1,0
5462,21247,0,0,62,62,0,1,0,1,0
33193,50584,0,0,62,62,0,1,0,1,0
55618,56205,0,0,62,62,0,1,0,1,0
43584,24748,0,0,156,156,0,1,0,1,0
14578,50584,0,0,66,66,0,1,0,1,0
46275,64147,0,0,62,62,0,1,0,1,0
16387,35308,0,0,60,60,0,1,0,1,0
45964,5333,0,0,60,60,0,1,0,1,0
56092,56205,0,0,146,146,0,1,0,1,0
34936,30188,0,0,62,62,0,1,0,1,0
36548,25174,0,0,62,62,0,1,0,1,0
15345,36829,0,0,66,66,0,1,0,1,0
58638,5900,0,0,62,62,0,1,0,1,0
26053,33720,0,0,160,160,0,1,0,1,0
51910,37965,0,0,62,62,0,1,0,1,0
59988,64147,0,0,66,66,0,1,0,1,0
52596,17372,0,0,66,66,0,1,0,1,0
50086,57470,0,0,66,66,0,1,0,1,0
24260,50584,0,0,62,62,0,1,0,1,0
52430,35440,0,0,146,146,0,1,0,1,0
46495,4607,0,0,60,60,0,1,0,1,0
55161,37807,0,0,66,66,0,1,0,1,0
443,62514,0,0,66,66,0,1,0,1,0
41734,57470,0,0,62,62,0,1,0,1,0
52112,22114,0,0,66,66,0,1,0,1,0
52640,64147,0,0,62,62,0,1,0,1,0
59430,50584,0,0,66,66,0,1,0,1,0
3478,61463,0,0,164,164,0,1,0,1,0
9381,35440,0,0,62,62,0,1,0,1,0
59509,64147,0,0,62,62,0,1,0,1,0
10166,44847,0,0,62,62,0,1,0,1,0
49417,38558,0,0,66,66,0,1,0,1,0
46901,26672,0,0,60,60,0,1,0,1,0
44258,25,0,0,74,74,0,1,0,1,0
49197,30188,0,0,62,62,0,1,0,1,0
56396,5900,0,0,60,60,0,1,0,1,0
51414,22,0,0,60,60,0,1,0,1,0
50422,50584,0,0,62,62,0,1,0,1,0
65250,22114,0,0,66,66,0,1,0,1,0
63334,37807,0,0,66,66,0,1,0,1,0
37988,64147,0,0,66,66,0,1,0,1,0
31845,55777,0,0,62,62,0,1,0,1,0
44388,63874,0,0,66,66,0,1,0,1,0
63385,25174,0,0,66,66,0,1,0,1,0
20112,64147,0,0,62,62,0,1,0,1,0
1821,64147,0,0,66,66,0,1,0,1,0
45964,3111,0,0,60,60,0,1,0,1,0
64155,60043,0,0,66,66,0,1,0,1,0
65060,35440,0,0,66,66,0,1,0,1,0
52462,25174,0,0,62,62,0,1,0,1,0
62079,30188,0,0,66,66,0,1,0,1,0
18246,64097,0,0,66,66,0,1,0,1,0
17262,25174,0,0,146,146,0,1,0,1,0
29263,50939,0,0,148,148,0,1,0,1,0
443,38956,0,0,82,82,0,1,0,1,0
14255,2767,0,0,62,62,0,1,0,1,0
48706,23393,0,0,60,60,0,1,0,1,0
19963,2767,0,0,66,66,0,1,0,1,0
62043,25174,0,0,62,62,0,1,0,1,0
58038,51505,0,0,146,146,0,1,0,1,0
443,7387,0,0,60,60,0,1,0,1,0
8536,37965,0,0,62,62,0,1,0,1,0
64957,5555,0,0,60,60,0,1,0,1,0
43578,15503,0,0,74,74,0,1,0,1,0
51903,26467,0,0,62,62,0,1,0,1,0
1043,30170,0,0,159,159,0,1,0,1,0
7842,23,0,0,60,60,0,1,0,1,0
61736,50584,0,0,66,66,0,1,0,1,0
45079,31573,0,0,66,66,0,1,0,1,0
1024,35894,0,0,62,62,0,1,0,1,0
25565,18855,0,0,60,60,0,1,0,1,0
31172,22114,0,0,62,62,0,1,0,1,0
51999,37965,0,0,62,62,0,1,0,1,0
3478,61463,0,0,441,441,0,1,0,1,0
54189,64147,0,0,66,66,0,1,0,1,0
58582,50584,0,0,66,66,0,1,0,1,0
13062,52274,0,0,66,66,0,1,0,1,0
43747,22114,0,0,62,62,0,1,0,1,0
58627,25174,0,0,62,62,0,1,0,1,0
60246,44612,0,0,66,66,0,1,0,1,0
27824,51505,0,0,146,146,0,1,0,1,0
64681,35993,0,0,62,62,0,1,0,1,0
58811,53976,0,0,62,62,0,1,0,1,0
26531,37965,0,0,62,62,0,1,0,1,0
46701,1433,0,0,60,60,0,1,0,1,0
50593,64147,0,0,62,62,0,1,0,1,0
8486,56205,0,0,66,66,0,1,0,1,0
53071,25174,0,0,66,66,0,1,0,1,0
59435,37807,0,0,66,66,0,1,0,1,0
4110,35440,0,0,66,66,0,1,0,1,0
57468,57470,0,0,66,66,0,1,0,1,0
52451,56205,0,0,66,66,0,1,0,1,0
49255,44847,0,0,66,66,0,1,0,1,0
443,11817,0,0,74,74,0,1,0,1,0
52232,53,0,0,71,71,0,1,0,1,0
58638,5900,0,0,62,62,0,1,0,1,0
23001,64147,0,0,62,62,0,1,0,1,0
7744,32480,0,0,62,62,0,1,0,1,0
57325,37965,0,0,62,62,0,1,0,1,0
48706,23393,0,0,60,60,0,1,0,1,0
51558,37965,0,0,72,72,0,1,0,1,0
26053,33720,0,0,160,160,0,1,0,1,0
14148,1,0,0,62,62,0,1,0,1,0
47913,25174,0,0,62,62,0,1,0,1,0
11754,25174,0,0,62,62,0,1,0,1,0
31330,15503,0,0,145,145,0,1,0,1,0
54790,1433,0,0,60,60,0,1,0,1,0
49191,35440,0,0,62,62,0,1,0,1,0
58638,5900,0,0,62,62,0,1,0,1,0
31727,57470,0,0,62,62,0,1,0,1,0
23776,57354,0,0,145,145,0,1,0,1,0
26211,1433,0,0,60,60,0,1,0,1,0
58638,5900,0,0,62,62,0,1,0,1,0
26330,26348,0,0,62,62,0,1,0,1,0
56711,25174,0,0,62,62,0,1,0,1,0
49276,51505,0,0,66,66,0,1,0,1,0
62080,54532,0,0,60,60,0,1,0,1,0
29195,51505,0,0,146,146,0,1,0,1,0
55201,22114,0,0,66,66,0,1,0,1,0
12527,50584,0,0,62,62,0,1,0,1,0
58251,36237,0,0,62,62,0,1,0,1,0
51271,37965,0,0,66,66,0,1,0,1,0
50990,23884,0,0,62,62,0,1,0,1,0
59549,50584,0,0,66,66,0,1,0,1,0
58638,5900,0,0,62,62,0,1,0,1,0
56218,43890,0,0,62,62,0,1,0,1,0
63545,25174,0,0,62,62,0,1,0,1,0
59584,36237,0,0,66,66,0,1,0,1,0
55678,32468,0,0,66,66,0,1,0,1,0
56494,30228,0,0,146,146,0,1,0,1,0
43129,15503,0,0,62,62,0,1,0,1,0
25207,48817,0,0,62,62,0,1,0,1,0
50637,36237,0,0,66,66,0,1,0,1,0
59505,53733,0,0,62,62,0,1,0,1,0
53781,37965,0,0,66,66,0,1,0,1,0
1912,48817,0,0,62,62,0,1,0,1,0
2572,35440,0,0,66,66,0,1,0,1,0
44849,46478,0,0,74,74,0,1,0,1,0
63852,35440,0,0,62,62,0,1,0,1,0
13159,37965,0,0,66,66,0,1,0,1,0
34808,22114,0,0,62,62,0,1,0,1,0
33726,44847,0,0,62,62,0,1,0,1,0
12709,51505,0,0,62,62,0,1,0,1,0
25523,35974,0,0,62,62,0,1,0,1,0
13285,29892,0,0,145,145,0,1,0,1,0
60772,36829,0,0,62,62,0,1,0,1,0
19882,22114,0,0,146,146,0,1,0,1,0
50360,37965,0,0,66,66,0,1,0,1,0
52144,49344,0,0,62,62,0,1,0,1,0
58638,5900,0,0,62,62,0,1,0,1,0
9227,9000,0,0,60,60,0,1,0,1,0
13581,51505,0,0,66,66,0,1,0,1,0
52925,3389,0,0,60,60,0,1,0,1,0
48857,50584,0,0,66,66,0,1,0,1,0
1873,37965,0,0,62,62,0,1,0,1,0
1749,64147,0,0,66,66,0,1,0,1,0
19662,22114,0,0,62,62,0,1,0,1,0
61761,44847,0,0,66,66,0,1,0,1,0
443,44683,0,0,83,83,0,1,0,1,0
34809,57470,0,0,66,66,0,1,0,1,0
29178,35440,0,0,66,66,0,1,0,1,0
60557,23117,0,0,66,66,0,1,0,1,0
49893,25174,0,0,66,66,0,1,0,1,0
37875,55108,0,0,148,148,0,1,0,1,0
50,64147,0,0,62,62,0,1,0,1,0
1356,57470,0,0,72,72,0,1,0,1,0
60761,51221,0,0,66,66,0,1,0,1,0
52714,64147,0,0,62,62,0,1,0,1,0
56456,1433,0,0,60,60,0,1,0,1,0
14185,48637,0,0,60,60,0,1,0,1,0
443,61686,0,0,1484,1484,0,1,0,1,0
65006,26467,0,0,62,62,0,1,0,1,0
63469,64147,0,0,62,62,0,1,0,1,0
58118,22114,0,0,66,66,0,1,0,1,0
54418,22114,0,0,66,66,0,1,0,1,0
6666,2222,0,0,60,60,0,1,0,1,0
36034,35440,0,0,62,62,0,1,0,1,0
44207,44847,0,0,66,66,0,1,0,1,0
443,45788,0,0,332,332,0,1,0,1,0
41674,5900,0,0,60,60,0,1,0,1,0
60772,36829,0,0,66,66,0,1,0,1,0
27147,22114,0,0,62,62,0,1,0,1,0
37034,25174,0,0,62,62,0,1,0,1,0
6824,26467,0,0,66,66,0,1,0,1,0
22683,39210,0,0,60,60,0,1,0,1,0
6247,51221,0,0,78,78,0,1,0,1,0
63030,25174,0,0,146,146,0,1,0,1,0
55421,57470,0,0,74,74,0,1,0,1,0
13413,44847,0,0,66,66,0,1,0,1,0
6931,55108,0,0,139,139,0,1,0,1,0
54048,25174,0,0,66,66,0,1,0,1,0
9588,37965,0,0,62,62,0,1,0,1,0
47561,26467,0,0,62,62,0,1,0,1,0
50535,51505,0,0,66,66,0,1,0,1,0
49664,37965,0,0,66,66,0,1,0,1,0
11458,2767,0,0,66,66,0,1,0,1,0
51635,50265,0,0,66,66,0,1,0,1,0
2062,35440,0,0,66,66,0,1,0,1,0
59876,44847,0,0,62,62,0,1,0,1,0
58638,5900,0,0,62,62,0,1,0,1,0
58022,5601,0,0,60,60,0,1,0,1,0
50573,22114,0,0,62,62,0,1,0,1,0
3585,64147,0,0,62,62,0,1,0,1,0
8976,44847,0,0,66,66,0,1,0,1,0
18652,64147,0,0,62,62,0,1,0,1,0
65006,26467,0,0,66,66,0,1,0,1,0
46116,51505,0,0,62,62,0,1,0,1,0
56127,37965,0,0,66,66,0,1,0,1,0
40100,17,0,0,60,60,0,1,0,1,0
20939,60461,0,0,60,60,0,1,0,1,0
45941,23386,0,0,60,60,0,1,0,1,0
32722,25174,0,0,62,62,0,1,0,1,0
41447,64147,0,0,62,62,0,1,0,1,0
6247,51221,0,0,78,78,0,1,0,1,0
64219,51050,0,0,66,66,0,1,0,1,0
63245,26296,0,0,159,159,0,1,0,1,0
60162,53436,0,0,66,66,0,1,0,1,0
8103,65473,0,0,157,157,0,1,0,1,0
33582,44847,0,0,62,62,0,1,0,1,0
0,0,0,0,60,60,0,1,0,1,0
27995,22114,0,0,62,62,0,1,0,1,0
58486,57470,0,0,66,66,0,1,0,1,0
57431,15503,0,0,62,62,0,1,0,1,0
53871,37965,0,0,66,66,0,1,0,1,0
38330,44847,0,0,66,66,0,1,0,1,0
59618,46824,0,0,66,66,0,1,0,1,0
63221,53436,0,0,62,62,0,1,0,1,0
23031,22114,0,0,146,146,0,1,0,1,0
55111,39004,0,0,66,66,0,1,0,1,0
31609,25174,0,0,146,146,0,1,0,1,0
36566,37965,0,0,62,62,0,1,0,1,0
2904,44847,0,0,78,78,0,1,0,1,0
40489,1433,0,0,60,60,0,1,0,1,0
30923,12883,0,0,157,157,0,1,0,1,0
24534,50584,0,0,146,146,0,1,0,1,0
3117,37965,0,0,62,62,0,1,0,1,0
3585,64147,0,0,62,62,0,1,0,1,0
50090,50265,0,0,66,66,0,1,0,1,0
56428,30317,0,0,66,66,0,1,0,1,0
58836,51505,0,0,66,66,0,1,0,1,0
60126,35440,0,0,66,66,0,1,0,1,0
50562,37965,0,0,62,62,0,1,0,1,0
42951,22114,0,0,62,62,0,1,0,1,0
34811,56205,0,0,66,66,0,1,0,1,0
12107,22114,0,0,66,66,0,1,0,1,0
59563,30188,0,0,66,66,0,1,0,1,0
49590,57470,0,0,78,78,0,1,0,1,0
1057,57470,0,0,62,62,0,1,0,1,0
18091,32480,0,0,62,62,0,1,0,1,0
1880,57470,0,0,146,146,0,1,0,1,0
45981,51505,0,0,62,62,0,1,0,1,0
36586,5900,0,0,60,60,0,1,0,1,0
56703,50584,0,0,66,66,0,1,0,1,0
57546,25174,0,0,66,66,0,1,0,1,0
47132,1433,0,0,60,60,0,1,0,1,0
45941,23386,0,0,60,60,0,1,0,1,0
58638,5900,0,0,62,62,0,1,0,1,0
63213,57866,0,0,62,62,0,1,0,1,0
49977,57470,0,0,62,62,0,1,0,1,0
3410,17372,0,0,145,145,0,1,0,1,0
47396,23,0,0,60,60,0,1,0,1,0
50713,57470,0,0,66,66,0,1,0,1,0
52018,57866,0,0,66,66,0,1,0,1,0
23353,25174,0,0,146,146,0,1,0,1,0
59097,2767,0,0,66,66,0,1,0,1,0
53260,36237,0,0,62,62,0,1,0,1,0
34772,15503,0,0,146,146,0,1,0,1,0
65249,25864,0,0,72,72,0,1,0,1,0
5223,44091,0,0,66,66,0,1,0,1,0
21482,22114,0,0,62,62,0,1,0,1,0
56173,37807,0,0,66,66,0,1,0,1,0
1663,30188,0,0,62,62,0,1,0,1,0
17957,64097,0,0,66,66,0,1,0,1,0
56127,35440,0,0,62,62,0,1,0,1,0
49616,30188,0,0,62,62,0,1,0,1,0
5060,37965,0,0,66,66,0,1,0,1,0
3117,37965,0,0,62,62,0,1,0,1,0
10949,22114,0,0,62,62,0,1,0,1,0
1511,3389,0,0,60,60,0,1,0,1,0
47910,7454,0,0,60,60,0,1,0,1,0
65209,57866,0,0,66,66,0,1,0,1,0
1128,44847,0,0,146,146,0,1,0,1,0
40821,41615,0,0,157,157,0,1,0,1,0
53774,51505,0,0,66,66,0,1,0,1,0
3980,63710,0,0,62,62,0,1,0,1,0
63465,56205,0,0,66,66,0,1,0,1,0
54854,19847,0,0,66,66,0,1,0,1,0
10319,42707,0,0,62,62,0,1,0,1,0
59043,35440,0,0,66,66,0,1,0,1,0
62575,12207,0,0,66,66,0,1,0,1,0
52788,64147,0,0,62,62,0,1,0,1,0
58638,5900,0,0,62,62,0,1,0,1,0
42044,60043,0,0,66,66,0,1,0,1,0
12737,35440,0,0,62,62,0,1,0,1,0
59786,25174,0,0,62,62,0,1,0,1,0
52724,64147,0,0,62,62,0,1,0,1,0
50419,26467,0,0,66,66,0,1,0,1,0
58598,50584,0,0,66,66,0,1,0,1,0
58463,11392,0,0,66,66,0,1,0,1,0
11677,56205,0,0,62,62,0,1,0,1,0
53189,62413,0,0,62,62,0,1,0,1,0
52410,8604,0,0,66,66,0,1,0,1,0
58638,5900,0,0,62,62,0,1,0,1,0
60485,22114,0,0,66,66,0,1,0,1,0
28584,37965,0,0,62,62,0,1,0,1,0
443,64347,0,0,60,60,0,1,0,1,0
65012,2767,0,0,66,66,0,1,0,1,0
10701,11392,0,0,62,62,0,1,0,1,0
53756,50584,0,0,62,62,0,1,0,1,0
50052,65010,0,0,60,60,0,1,0,1,0
63724,23,0,0,60,60,0,1,0,1,0
2531,30188,0,0,66,66,0,1,0,1,0
62348,48817,0,0,145,145,0,1,0,1,0
50716,50584,0,0,70,70,0,1,0,1,0
25510,48817,0,0,140,140,0,1,0,1,0
6881,21162,0,0,146,146,0,1,0,1,0
60579,25174,0,0,66,66,0,1,0,1,0
51032,30188,0,0,62,62,0,1,0,1,0
42951,44847,0,0,66,66,0,1,0,1,0
65529,35440,0,0,62,62,0,1,0,1,0
42075,36237,0,0,146,146,0,1,0,1,0
64077,25174,0,0,62,62,0,1,0,1,0
61013,41705,0,0,66,66,0,1,0,1,0
26601,22114,0,0,66,66,0,1,0,1,0
58638,5900,0,0,62,62,0,1,0,1,0
52064,22114,0,0,62,62,0,1,0,1,0
20939,60461,0,0,60,60,0,1,0,1,0
60799,25174,0,0,66,66,0,1,0,1,0
42332,22114,0,0,66,66,0,1,0,1,0
61925,51505,0,0,62,62,0,1,0,1,0
55056,44512,0,0,62,62,0,1,0,1,0
48605,50584,0,0,146,146,0,1,0,1,0
6889,41864,0,0,143,143,0,1,0,1,0
44889,23,0,0,60,60,0,1,0,1,0
7905,22114,0,0,66,66,0,1,0,1,0
61451,17500,0,0,62,62,0,1,0,1,0
46662,36237,0,0,62,62,0,1,0,1,0
32520,47993,0,0,66,66,0,1,0,1,0
27947,26467,0,0,66,66,0,1,0,1,0
52988,53567,0,0,66,66,0,1,0,1,0
57500,37965,0,0,62,62,0,1,0,1,0
49514,52255,0,0,162,162,0,1,0,1,0
65003,57470,0,0,78,78,0,1,0,1,0
65012,2767,0,0,66,66,0,1,0,1,0
44546,32468,0,0,62,62,0,1,0,1,0
51910,37965,0,0,62,62,0,1,0,1,0
55587,43890,0,0,66,66,0,1,0,1,0
49577,57470,0,0,66,66,0,1,0,1,0
42981,44847,0,0,62,62,0,1,0,1,0
26527,25174,0,0,62,62,0,1,0,1,0
17786,44847,0,0,62,62,0,1,0,1,0
58318,15503,0,0,66,66,0,1,0,1,0
60818,37965,0,0,62,62,0,1,0,1,0
12709,51505,0,0,62,62,0,1,0,1,0
37075,48817,0,0,62,62,0,1,0,1,0
17010,57470,0,0,62,62,0,1,0,1,0
9017,6881,0,0,66,66,0,1,0,1,0
45269,50584,0,0,62,62,0,1,0,1,0
27300,6881,0,0,62,62,0,1,0,1,0
59347,57470,0,0,62,62,0,1,0,1,0
16387,56995,0,0,60,60,0,1,0,1,0
35957,51185,0,0,60,60,0,1,0,1,0
21833,22114,0,0,62,62,0,1,0,1,0
10028,25604,0,0,62,62,0,1,0,1,0
24910,64147,0,0,66,66,0,1,0,1,0
31410,25174,0,0,62,62,0,1,0,1,0
60312,57470,0,0,74,74,0,1,0,1,0
56005,64147,0,0,62,62,0,1,0,1,0
12060,37965,0,0,66,66,0,1,0,1,0
45964,55559,0,0,60,60,0,1,0,1,0
23843,26467,0,0,62,62,0,1,0,1,0
17004,64147,0,0,66,66,0,1,0,1,0
57987,56125,0,0,90,90,0,1,0,1,0
61230,22114,0,0,62,62,0,1,0,1,0
1030,64147,0,0,62,62,0,1,0,1,0
45964,5333,0,0,60,60,0,1,0,1,0
6666,138,0,0,60,60,0,1,0,1,0
3478,61463,0,0,451,451,0,1,0,1,0
62339,25174,0,0,66,66,0,1,0,1,0
60923,49903,0,0,66,66,0,1,0,1,0
59147,25174,0,0,146,146,0,1,0,1,0
21419,23,0,0,60,60,0,1,0,1,0
54555,25174,0,0,66,66,0,1,0,1,0
64880,9694,0,0,66,66,0,1,0,1,0
1888,51505,0,0,62,62,0,1,0,1,0
57297,51221,0,0,66,66,0,1,0,1,0
51313,25174,0,0,62,62,0,1,0,1,0
58021,17,0,0,60,60,0,1,0,1,0
65016,37965,0,0,66,66,0,1,0,1,0
45964,55559,0,0,60,60,0,1,0,1,0
50946,44847,0,0,66,66,0,1,0,1,0
49786,25174,0,0,66,66,0,1,0,1,0
17097,62413,0,0,62,62,0,1,0,1,0
62080,54532,0,0,60,60,0,1,0,1,0
59943,37807,0,0,62,62,0,1,0,1,0
30920,64147,0,0,62,62,0,1,0,1,0
45118,39004,0,0,74,74,0,1,0,1,0
26085,10387,0,0,148,148,0,1,0,1,0
28830,37965,0,0,62,62,0,1,0,1,0
55232,25174,0,0,146,146,0,1,0,1,0
10348,25604,0,0,62,62,0,1,0,1,0
59833,48817,0,0,107,107,0,1,0,1,0
36456,25174,0,0,62,62,0,1,0,1,0
44059,23,0,0,60,60,0,1,0,1,0
51922,44847,0,0,62,62,0,1,0,1,0
50135,50584,0,0,62,62,0,1,0,1,0
60000,1879,0,0,145,145,0,1,0,1,0
27401,37965,0,0,66,66,0,1,0,1,0
10586,37965,0,0,62,62,0,1,0,1,0
59225,57587,0,0,66,66,0,1,0,1,0
17027,1,0,0,62,62,0,1,0,1,0
48301,25174,0,0,66,66,0,1,0,1,0
1024,57470,0,0,62,62,0,1,0,1,0
63183,64147,0,0,66,66,0,1,0,1,0
57782,57470,0,0,66,66,0,1,0,1,0
9067,44847,0,0,62,62,0,1,0,1,0
443,23133,0,0,97,97,0,1,0,1,0
6666,990,0,0,60,60,0,1,0,1,0
61762,44847,0,0,62,62,0,1,0,1,0
61314,23,0,0,60,60,0,1,0,1,0
3478,61463,0,0,1290,1290,0,1,0,1,0
13911,57470,0,0,60,60,0,1,0,1,0
28875,51505,0,0,62,62,0,1,0,1,0
59096,57866,0,0,66,66,0,1,0,1,0
32395,30188,0,0,62,62,0,1,0,1,0
56826,22114,0,0,66,66,0,1,0,1,0
55008,21247,0,0,66,66,0,1,0,1,0
58638,5900,0,0,62,62,0,1,0,1,0
1027,25174,0,0,146,146,0,1,0,1,0
1027,25174,0,0,62,62,0,1,0,1,0
50834,64147,0,0,62,62,0,1,0,1,0
59937,37965,0,0,66,66,0,1,0,1,0
15499,22114,0,0,62,62,0,1,0,1,0
65231,50584,0,0,66,66,0,1,0,1,0
32974,37965,0,0,66,66,0,1,0,1,0
443,21745,0,0,66,66,0,1,0,1,0
43260,41615,0,0,145,145,0,1,0,1,0
34247,48817,0,0,145,145,0,1,0,1,0
56026,51505,0,0,146,146,0,1,0,1,0
2075,19473,0,0,62,62,0,1,0,1,0
7749,36237,0,0,62,62,0,1,0,1,0
42128,54532,0,0,60,60,0,1,0,1,0
45964,2225,0,0,60,60,0,1,0,1,0
6666,8888,0,0,60,60,0,1,0,1,0
8239,37965,0,0,146,146,0,1,0,1,0
5223,1210,0,0,66,66,0,1,0,1,0
5228,3434,0,0,345,345,0,1,0,1,0
49501,11392,0,0,66,66,0,1,0,1,0
27677,22114,0,0,146,146,0,1,0,1,0
6121,51505,0,0,66,66,0,1,0,1,0
45169,14037,0,0,74,74,0,1,0,1,0
56400,35440,0,0,66,66,0,1,0,1,0
65203,30188,0,0,66,66,0,1,0,1,0
53640,25174,0,0,66,66,0,1,0,1,0
58638,5900,0,0,62,62,0,1,0,1,0
16387,7205,0,0,60,60,0,1,0,1,0
443,50238,0,0,331,331,0,1,0,1,0
14903,10387,0,0,159,159,0,1,0,1,0
54526,44847,0,0,66,66,0,1,0,1,0
55459,50584,0,0,62,62,0,1,0,1,0
56328,36237,0,0,62,62,0,1,0,1,0
34811,56205,0,0,62,62,0,1,0,1,0
18683,26467,0,0,62,62,0,1,0,1,0
58435,64631,0,0,74,74,0,1,0,1,0
2383,37965,0,0,66,66,0,1,0,1,0
53567,64147,0,0,66,66,0,1,0,1,0
54109,36829,0,0,66,66,0,1,0,1,0
42722,56448,0,0,74,74,0,1,0,1,0
58381,57470,0,0,66,66,0,1,0,1,0
57837,64147,0,0,66,66,0,1,0,1,0
1025,35447,0,0,62,62,0,1,0,1,0
56676,37965,0,0,66,66,0,1,0,1,0
45941,23388,0,0,60,60,0,1,0,1,0
31539,37965,0,0,62,62,0,1,0,1,0
15793,64147,0,0,66,66,0,1,0,1,0
4427,50584,0,0,62,62,0,1,0,1,0
53227,64097,0,0,62,62,0,1,0,1,0
20005,37965,0,0,62,62,0,1,0,1,0
58638,5900,0,0,62,62,0,1,0,1,0
58638,5900,0,0,62,62,0,1,0,1,0
62064,22114,0,0,66,66,0,1,0,1,0
63263,57470,0,0,66,66,0,1,0,1,0
51093,57470,0,0,66,66,0,1,0,1,0
39742,62413,0,0,66,66,0,1,0,1,0
4366,51505,0,0,62,62,0,1,0,1,0
10480,26467,0,0,62,62,0,1,0,1,0
63925,37965,0,0,66,66,0,1,0,1,0
54206,25174,0,0,62,62,0,1,0,1,0
15513,25174,0,0,62,62,0,1,0,1,0
40481,22114,0,0,66,66,0,1,0,1,0
21179,44847,0,0,146,146,0,1,0,1,0
37647,36237,0,0,62,62,0,1,0,1,0
41381,23,0,0,60,60,0,1,0,1,0
52143,37807,0,0,66,66,0,1,0,1,0
58638,5900,0,0,62,62,0,1,0,1,0
48350,57470,0,0,74,74,0,1,0,1,0
26799,50584,0,0,62,62,0,1,0,1,0
59037,28370,0,0,62,62,0,1,0,1,0
59451,50584,0,0,62,62,0,1,0,1,0
63344,53,0,0,73,73,0,1,0,1,0
62014,35440,0,0,66,66,0,1,0,1,0
31978,57470,0,0,60,60,0,1,0,1,0
56131,37807,0,0,62,62,0,1,0,1,0
39681,37965,0,0,62,62,0,1,0,1,0
42030,25,0,0,74,74,0,1,0,1,0
58638,5900,0,0,62,62,0,1,0,1,0
6666,50070,0,0,60,60,0,1,0,1,0
64756,11392,0,0,62,62,0,1,0,1,0
52188,1433,0,0,60,60,0,1,0,1,0
58562,57587,0,0,66,66,0,1,0,1,0
443,38956,0,0,82,82,0,1,0,1,0
58638,5900,0,0,62,62,0,1,0,1,0
56869,17637,0,0,66,66,0,1,0,1,0
11030,37965,0,0,62,62,0,1,0,1,0
29988,44847,0,0,66,66,0,1,0,1,0
15530,49718,0,0,146,146,0,1,0,1,0
36538,64147,0,0,62,62,0,1,0,1,0
15701,37965,0,0,146,146,0,1,0,1,0
21496,50265,0,0,62,62,0,1,0,1,0
63765,51221,0,0,62,62,0,1,0,1,0
12074,10197,0,0,72,72,0,1,0,1,0
15113,25174,0,0,62,62,0,1,0,1,0
61457,21247,0,0,66,66,0,1,0,1,0
63677,15503,0,0,66,66,0,1,0,1,0
48186,51050,0,0,62,62,0,1,0,1,0
52280,44847,0,0,66,66,0,1,0,1,0
12965,37965,0,0,66,66,0,1,0,1,0
10669,49756,0,0,60,60,0,1,0,1,0
58638,5900,0,0,62,62,0,1,0,1,0
19361,37965,0,0,66,66,0,1,0,1,0
3541,22114,0,0,62,62,0,1,0,1,0
35111,22114,0,0,66,66,0,1,0,1,0
1027,23684,0,0,159,159,0,1,0,1,0
52091,11392,0,0,66,66,0,1,0,1,0
63287,44847,0,0,62,62,0,1,0,1,0
55199,21247,0,0,66,66,0,1,0,1,0
58091,51505,0,0,66,66,0,1,0,1,0
59068,49813,0,0,74,74,0,1,0,1,0
4232,50584,0,0,62,62,0,1,0,1,0
34348,22114,0,0,62,62,0,1,0,1,0
63379,36237,0,0,66,66,0,1,0,1,0
63461,51505,0,0,66,66,0,1,0,1,0
27528,35440,0,0,66,66,0,1,0,1,0
5222,27389,0,0,66,66,0,1,0,1,0
51575,9694,0,0,66,66,0,1,0,1,0
58638,5900,0,0,62,62,0,1,0,1,0
49805,64147,0,0,62,62,0,1,0,1,0
53532,22114,0,0,62,62,0,1,0,1,0
26287,56205,0,0,66,66,0,1,0,1,0
6882,55839,0,0,146,146,0,1,0,1,0
60311,56205,0,0,66,66,0,1,0,1,0
64824,37965,0,0,62,62,0,1,0,1,0
48676,53395,0,0,60,60,0,1,0,1,0
1866,51505,0,0,62,62,0,1,0,1,0
63595,51050,0,0,66,66,0,1,0,1,0
58687,11392,0,0,62,62,0,1,0,1,0
5637,37965,0,0,62,62,0,1,0,1,0
53120,25174,0,0,62,62,0,1,0,1,0
63347,25174,0,0,66,66,0,1,0,1,0
58286,37965,0,0,66,66,0,1,0,1,0
17760,50584,0,0,62,62,0,1,0,1,0
53469,36237,0,0,66,66,0,1,0,1,0
28221,37965,0,0,62,62,0,1,0,1,0
56679,51505,0,0,62,62,0,1,0,1,0
48978,25174,0,0,66,66,0,1,0,1,0
6224,37965,0,0,62,62,0,1,0,1,0
20487,50584,0,0,66,66,0,1,0,1,0
48258,37965,0,0,62,62,0,1,0,1,0
6889,34962,0,0,143,143,0,1,0,1,0
43840,50265,0,0,72,72,0,1,0,1,0
57987,56125,0,0,90,90,0,1,0,1,0
63213,57866,0,0,66,66,0,1,0,1,0
56098,55442,0,0,66,66,0,1,0,1,0
54365,64147,0,0,62,62,0,1,0,1,0
29512,30188,0,0,66,66,0,1,0,1,0
8999,1,0,0,62,62,0,1,0,1,0
993,33264,0,0,66,66,0,1,0,1,0
58638,5900,0,0,62,62,0,1,0,1,0
10273,21247,0,0,66,66,0,1,0,1,0
52526,30188,0,0,66,66,0,1,0,1,0
53656,31573,0,0,66,66,0,1,0,1,0
58638,5900,0,0,62,62,0,1,0,1,0
46945,64147,0,0,62,62,0,1,0,1,0
14260,36829,0,0,62,62,0,1,0,1,0
14872,23,0,0,60,60,0,1,0,1,0
51581,17546,0,0,62,62,0,1,0,1,0
3964,51505,0,0,62,62,0,1,0,1,0
14438,51505,0,0,62,62,0,1,0,1,0
23528,44847,0,0,62,62,0,1,0,1,0
43584,24748,0,0,156,156,0,1,0,1,0
55012,25174,0,0,66,66,0,1,0,1,0
31500,1,0,0,146,146,0,1,0,1,0
4269,26672,0,0,60,60,0,1,0,1,0
11136,15503,0,0,62,62,0,1,0,1,0
10006,64147,0,0,62,62,0,1,0,1,0
0,0,0,0,98,98,0,1,0,1,0
53495,37807,0,0,66,66,0,1,0,1,0
58638,5900,0,0,62,62,0,1,0,1,0
53314,64097,0,0,66,66,0,1,0,1,0
53750,25174,0,0,66,66,0,1,0,1,0
52640,64147,0,0,62,62,0,1,0,1,0
15180,26467,0,0,62,62,0,1,0,1,0
65494,53,0,0,88,88,0,1,0,1,0
6712,44818,0,0,66,66,0,1,0,1,0
59213,25174,0,0,66,66,0,1,0,1,0
13663,23,0,0,60,60,0,1,0,1,0
26494,26467,0,0,62,62,0,1,0,1,0
80,9918,0,0,60,60,0,1,0,1,0
54062,31573,0,0,66,66,0,1,0,1,0
20619,25174,0,0,62,62,0,1,0,1,0
61785,64147,0,0,66,66,0,1,0,1,0
6889,8497,0,0,143,143,0,1,0,1,0
1431,30041,0,0,62,62,0,1,0,1,0
11585,56205,0,0,66,66,0,1,0,1,0
59668,50584,0,0,66,66,0,1,0,1,0
4257,35440,0,0,62,62,0,1,0,1,0
62115,57470,0,0,66,66,0,1,0,1,0
54600,6881,0,0,62,62,0,1,0,1,0
8191,51221,0,0,62,62,0,1,0,1,0
62189,64147,0,0,62,62,0,1,0,1,0
59413,51505,0,0,66,66,0,1,0,1,0
27321,25174,0,0,62,62,0,1,0,1,0
47682,20541,0,0,62,62,0,1,0,1,0
34360,25174,0,0,66,66,0,1,0,1,0
45941,23386,0,0,60,60,0,1,0,1,0
3375,35253,0,0,66,66,0,1,0,1,0
18423,51505,0,0,62,62,0,1,0,1,0
60337,30188,0,0,66,66,0,1,0,1,0
42034,28189,0,0,145,145,0,1,0,1,0
45941,23388,0,0,60,60,0,1,0,1,0
38852,37965,0,0,62,62,0,1,0,1,0
61522,64147,0,0,66,66,0,1,0,1,0
51042,22114,0,0,66,66,0,1,0,1,0
443,4205,0,0,320,320,0,1,0,1,0
1024,64147,0,0,62,62,0,1,0,1,0
49694,5900,0,0,60,60,0,1,0,1,0
26921,37965,0,0,62,62,0,1,0,1,0
443,23133,0,0,97,97,0,1,0,1,0
10390,26467,0,0,66,66,0,1,0,1,0
13020,26467,0,0,62,62,0,1,0,1,0
33556,25174,0,0,62,62,0,1,0,1,0
11133,51505,0,0,66,66,0,1,0,1,0
25973,26467,0,0,66,66,0,1,0,1,0
58638,5900,0,0,62,62,0,1,0,1,0
20939,60461,0,0,60,60,0,1,0,1,0
7151,37965,0,0,66,66,0,1,0,1,0
22733,26467,0,0,62,62,0,1,0,1,0
39617,50584,0,0,62,62,0,1,0,1,0
4019,50584,0,0,66,66,0,1,0,1,0
38959,25174,0,0,62,62,0,1,0,1,0
60204,2767,0,0,66,66,0,1,0,1,0
45941,23386,0,0,60,60,0,1,0,1,0
48841,51221,0,0,62,62,0,1,0,1,0
58758,22114,0,0,66,66,0,1,0,1,0
17244,22114,0,0,62,62,0,1,0,1,0
61332,23,0,0,60,60,0,1,0,1,0
61961,11392,0,0,66,66,0,1,0,1,0
51525,35440,0,0,66,66,0,1,0,1,0
35494,22114,0,0,62,62,0,1,0,1,0
1330,53567,0,0,146,146,0,1,0,1,0
61925,51505,0,0,62,62,0,1,0,1,0
59668,51505,0,0,62,62,0,1,0,1,0
28839,30188,0,0,62,62,0,1,0,1,0
6881,6881,0,0,146,146,0,1,0,1,0
6014,37965,0,0,66,66,0,1,0,1,0
1663,30188,0,0,66,66,0,1,0,1,0
57723,45129,0,0,148,148,0,1,0,1,0
58724,43890,0,0,66,66,0,1,0,1,0
42366,57470,0,0,66,66,0,1,0,1,0
54377,56205,0,0,66,66,0,1,0,1,0
51655,26467,0,0,62,62,0,1,0,1,0
49628,35440,0,0,66,66,0,1,0,1,0
46516,57470,0,0,62,62,0,1,0,1,0
56403,51505,0,0,62,62,0,1,0,1,0
56679,51505,0,0,146,146,0,1,0,1,0
3410,17372,0,0,62,62,0,1,0,1,0
59679,37807,0,0,66,66,0,1,0,1,0
60104,30188,0,0,62,62,0,1,0,1,0
443,61686,0,0,1484,1484,0,1,0,1,0
27537,25198,0,0,148,148,0,1,0,1,0
55678,32468,0,0,66,66,0,1,0,1,0
3478,61463,0,0,214,214,0,1,0,1,0
57237,21247,0,0,62,62,0,1,0,1,0
42252,33303,0,0,60,60,0,1,0,1,0
7977,25174,0,0,146,146,0,1,0,1,0
8760,22114,0,0,66,66,0,1,0,1,0
52503,50584,0,0,62,62,0,1,0,1,0
23331,25174,0,0,62,62,0,1,0,1,0
58638,5900,0,0,62,62,0,1,0,1,0
64106,64147,0,0,66,66,0,1,0,1,0
43260,41615,0,0,145,145,0,1,0,1,0
61148,37965,0,0,66,66,0,1,0,1,0
6889,45129,0,0,159,159,0,1,0,1,0
50949,45960,0,0,62,62,0,1,0,1,0
1030,35776,0,0,139,139,0,1,0,1,0
9104,26296,0,0,157,157,0,1,0,1,0
63305,62413,0,0,66,66,0,1,0,1,0
27038,51505,0,0,62,62,0,1,0,1,0
24145,35440,0,0,62,62,0,1,0,1,0
30135,37965,0,0,62,62,0,1,0,1,0
63495,50584,0,0,66,66,0,1,0,1,0
59088,57470,0,0,62,62,0,1,0,1,0
6666,8888,0,0,60,60,0,1,0,1,0
1026,8305,0,0,148,148,0,1,0,1,0
3976,25174,0,0,62,62,0,1,0,1,0
43260,41615,0,0,145,145,0,1,0,1,0
24227,48817,0,0,160,160,0,1,0,1,0
34212,11392,0,0,66,66,0,1,0,1,0
25880,44847,0,0,146,146,0,1,0,1,0
59459,37807,0,0,66,66,0,1,0,1,0
59136,50584,0,0,66,66,0,1,0,1,0
15018,37965,0,0,62,62,0,1,0,1,0
45833,13494,0,0,60,60,0,1,0,1,0
58148,43890,0,0,66,66,0,1,0,1,0
443,63113,0,0,100,100,0,1,0,1,0
8999,57470,0,0,146,146,0,1,0,1,0
57360,18375,0,0,66,66,0,1,0,1,0
53358,23,0,0,60,60,0,1,0,1,0
48706,23393,0,0,60,60,0,1,0,1,0
60485,22114,0,0,62,62,0,1,0,1,0
50765,22114,0,0,62,62,0,1,0,1,0
32520,47993,0,0,66,66,0,1,0,1,0
65270,3855,0,0,78,78,0,1,0,1,0
64535,37965,0,0,62,62,0,1,0,1,0
8486,56205,0,0,66,66,0,1,0,1,0
62189,64147,0,0,62,62,0,1,0,1,0
57987,56125,0,0,90,90,0,1,0,1,0
56247,23,0,0,60,60,0,1,0,1,0
51533,44847,0,0,62,62,0,1,0,1,0
41210,23,0,0,60,60,0,1,0,1,0
58638,5900,0,0,62,62,0,1,0,1,0
40254,25174,0,0,62,62,0,1,0,1,0
60869,48817,0,0,62,62,0,1,0,1,0
50637,36237,0,0,66,66,0,1,0,1,0
55043,57470,0,0,78,78,0,1,0,1,0
63065,54369,0,0,66,66,0,1,0,1,0
48980,11119,0,0,146,146,0,1,0,1,0
48335,25174,0,0,62,62,0,1,0,1,0
54043,36237,0,0,66,66,0,1,0,1,0
62580,23,0,0,60,60,0,1,0,1,0
27110,22114,0,0,60,60,0,1,0,1,0
16693,36237,0,0,66,66,0,1,0,1,0
52802,56205,0,0,66,66,0,1,0,1,0
54530,35440,0,0,66,66,0,1,0,1,0
27010,64147,0,0,62,62,0,1,0,1,0
18655,44847,0,0,66,66,0,1,0,1,0
49417,38558,0,0,66,66,0,1,0,1,0
58638,5900,0,0,62,62,0,1,0,1,0
62580,25174,0,0,62,62,0,1,0,1,0
443,61686,0,0,642,642,0,1,0,1,0
45964,2228,0,0,60,60,0,1,0,1,0
54305,39004,0,0,145,145,0,1,0,1,0
54914,51505,0,0,62,62,0,1,0,1,0
49540,50584,0,0,66,66,0,1,0,1,0
50095,30188,0,0,62,62,0,1,0,1,0
34775,5900,0,0,60,60,0,1,0,1,0
58638,5900,0,0,62,62,0,1,0,1,0
50081,57470,0,0,66,66,0,1,0,1,0
6980,48543,0,0,139,139,0,1,0,1,0
30707,30317,0,0,62,62,0,1,0,1,0
57302,62413,0,0,66,66,0,1,0,1,0
38852,37965,0,0,62,62,0,1,0,1,0
26658,25174,0,0,62,62,0,1,0,1,0
60899,25174,0,0,66,66,0,1,0,1,0
1227,56205,0,0,66,66,0,1,0,1,0
62143,23,0,0,60,60,0,1,0,1,0
65064,30188,0,0,66,66,0,1,0,1,0
16948,990,0,0,60,60,0,1,0,1,0
58341,10197,0,0,78,78,0,1,0,1,0
23795,44847,0,0,146,146,0,1,0,1,0
13917,18033,0,0,62,62,0,1,0,1,0
60196,53,0,0,88,88,0,1,0,1,0
11716,37965,0,0,62,62,0,1,0,1,0
62512,25174,0,0,62,62,0,1,0,1,0
56876,30188,0,0,62,62,0,1,0,1,0
57173,44847,0,0,62,62,0,1,0,1,0
62217,37807,0,0,62,62,0,1,0,1,0
13287,16933,0,0,62,62,0,1,0,1,0
51490,57587,0,0,100,100,0,1,0,1,0
58638,5900,0,0,62,62,0,1,0,1,0
80,9918,0,0,60,60,0,1,0,1,0
2572,17546,0,0,66,66,0,1,0,1,0
56582,23718,0,0,66,66,0,1,0,1,0
57351,62413,0,0,66,66,0,1,0,1,0
25523,35974,0,0,62,62,0,1,0,1,0
28579,64147,0,0,62,62,0,1,0,1,0
13062,52274,0,0,66,66,0,1,0,1,0
58638,5900,0,0,62,62,0,1,0,1,0
59772,62413,0,0,66,66,0,1,0,1,0
54876,25174,0,0,62,62,0,1,0,1,0
62217,37807,0,0,66,66,0,1,0,1,0
51455,53733,0,0,62,62,0,1,0,1,0
37902,23718,0,0,62,62,0,1,0,1,0
9246,35440,0,0,66,66,0,1,0,1,0
12530,35440,0,0,66,66,0,1,0,1,0
18029,50584,0,0,66,66,0,1,0,1,0
23218,62413,0,0,62,62,0,1,0,1,0
58829,64147,0,0,62,62,0,1,0,1,0
57538,30188,0,0,66,66,0,1,0,1,0
51346,51221,0,0,74,74,0,1,0,1,0
65285,50584,0,0,66,66,0,1,0,1,0
2704,37,0,0,60,60,0,1,0,1,0
60610,58414,0,0,62,62,0,1,0,1,0
59476,23,0,0,60,60,0,1,0,1,0
34993,15503,0,0,62,62,0,1,0,1,0
50936,22114,0,0,62,62,0,1,0,1,0
9544,7302,0,0,62,62,0,1,0,1,0
43679,44847,0,0,62,62,0,1,0,1,0
60875,50584,0,0,66,66,0,1,0,1,0
23079,9694,0,0,62,62,0,1,0,1,0
58638,5900,0,0,62,62,0,1,0,1,0
3580,25174,0,0,62,62,0,1,0,1,0
28832,36237,0,0,66,66,0,1,0,1,0
61185,54532,0,0,62,62,0,1,0,1,0
25570,35440,0,0,62,62,0,1,0,1,0
58638,5900,0,0,62,62,0,1,0,1,0
42231,57470,0,0,78,78,0,1,0,1,0
45964,2225,0,0,60,60,0,1,0,1,0
60342,36237,0,0,66,66,0,1,0,1,0
60018,64147,0,0,62,62,0,1,0,1,0
25497,44847,0,0,146,146,0,1,0,1,0
55012,25174,0,0,66,66,0,1,0,1,0
47910,7454,0,0,60,60,0,1,0,1,0
55616,56205,0,0,66,66,0,1,0,1,0
26239,25174,0,0,62,62,0,1,0,1,0
13223,1310,0,0,62,62,0,1,0,1,0
35657,48637,0,0,62,62,0,1,0,1,0
62908,21,0,0,60,60,0,1,0,1,0
20894,51505,0,0,62,62,0,1,0,1,0
50535,51505,0,0,62,62,0,1,0,1,0
45941,23384,0,0,60,60,0,1,0,1,0
26921,37965,0,0,62,62,0,1,0,1,0
65512,44847,0,0,66,66,0,1,0,1,0
63314,57470,0,0,66,66,0,1,0,1,0
51346,51221,0,0,74,74,0,1,0,1,0
64824,36829,0,0,66,66,0,1,0,1,0
58326,50584,0,0,62,62,0,1,0,1,0
58745,30188,0,0,66,66,0,1,0,1,0
27811,57866,0,0,146,146,0,1,0,1,0
52938,64097,0,0,66,66,0,1,0,1,0
52989,51505,0,0,66,66,0,1,0,1,0
60830,50584,0,0,62,62,0,1,0,1,0
52340,22114,0,0,66,66,0,1,0,1,0
29203,26467,0,0,62,62,0,1,0,1,0
16760,10214,0,0,62,62,0,1,0,1,0
65285,44847,0,0,62,62,0,1,0,1,0
33595,23,0,0,60,60,0,1,0,1,0
48676,53395,0,0,60,60,0,1,0,1,0
51324,11392,0,0,66,66,0,1,0,1,0
58638,5900,0,0,62,62,0,1,0,1,0
443,49988,0,0,82,82,0,1,0,1,0
44459,37807,0,0,62,62,0,1,0,1,0
43724,35440,0,0,62,62,0,1,0,1,0
34228,45129,0,0,148,148,0,1,0,1,0
52238,26467,0,0,62,62,0,1,0,1,0
16620,25174,0,0,62,62,0,1,0,1,0
46090,50584,0,0,66,66,0,1,0,1,0
56035,1310,0,0,66,66,0,1,0,1,0
29787,37965,0,0,62,62,0,1,0,1,0
43657,50011,0,0,62,62,0,1,0,1,0
51900,48817,0,0,146,146,0,1,0,1,0
58638,5900,0,0,62,62,0,1,0,1,0
1038,37965,0,0,62,62,0,1,0,1,0
12878,25174,0,0,146,146,0,1,0,1,0
38681,15503,0,0,74,74,0,1,0,1,0
33543,44847,0,0,66,66,0,1,0,1,0
14175,10387,0,0,159,159,0,1,0,1,0
10003,64147,0,0,62,62,0,1,0,1,0
6889,55108,0,0,143,143,0,1,0,1,0
26265,37965,0,0,66,66,0,1,0,1,0
54758,35993,0,0,62,62,0,1,0,1,0
63346,37965,0,0,66,66,0,1,0,1,0
45941,23386,0,0,60,60,0,1,0,1,0
57431,15503,0,0,66,66,0,1,0,1,0
58638,5900,0,0,62,62,0,1,0,1,0
24662,26467,0,0,66,66,0,1,0,1,0
6247,51221,0,0,78,78,0,1,0,1,0
51356,22114,0,0,66,66,0,1,0,1,0
62149,22114,0,0,66,66,0,1,0,1,0
64115,2767,0,0,66,66,0,1,0,1,0
56237,26467,0,0,66,66,0,1,0,1,0
42968,56205,0,0,146,146,0,1,0,1,0
58861,26467,0,0,66,66,0,1,0,1,0
58638,5900,0,0,62,62,0,1,0,1,0
14023,37965,0,0,62,62,0,1,0,1,0
45682,37965,0,0,62,62,0,1,0,1,0
57239,161,0,0,82,82,0,1,0,1,0
63547,37965,0,0,66,66,0,1,0,1,0
56386,50584,0,0,66,66,0,1,0,1,0
34382,26314,0,0,143,143,0,1,0,1,0
56039,50584,0,0,66,66,0,1,0,1,0
53495,37807,0,0,66,66,0,1,0,1,0
6404,64147,0,0,145,145,0,1,0,1,0
48706,23393,0,0,60,60,0,1,0,1,0
15319,51505,0,0,62,62,0,1,0,1,0
19455,25174,0,0,62,62,0,1,0,1,0
59842,62413,0,0,66,66,0,1,0,1,0
54991,36829,0,0,62,62,0,1,0,1,0
1114,37965,0,0,62,62,0,1,0,1,0
56967,35440,0,0,66,66,0,1,0,1,0
56521,32480,0,0,62,62,0,1,0,1,0
0,0,0,0,82,82,0,1,0,1,0
55701,55777,0,0,62,62,0,1,0,1,0
54016,42707,0,0,66,66,0,1,0,1,0
22679,2323,0,0,60,60,0,1,0,1,0
45013,50584,0,0,62,62,0,1,0,1,0
18577,25174,0,0,62,62,0,1,0,1,0
58338,3369,0,0,60,60,0,1,0,1,0
53355,23117,0,0,66,66,0,1,0,1,0
53166,61600,0,0,66,66,0,1,0,1,0
48706,23394,0,0,60,60,0,1,0,1,0
1943,48817,0,0,66,66,0,1,0,1,0
57994,30188,0,0,62,62,0,1,0,1,0
58468,57587,0,0,66,66,0,1,0,1,0
11136,15503,0,0,62,62,0,1,0,1,0
59694,50584,0,0,66,66,0,1,0,1,0
57937,22114,0,0,146,146,0,1,0,1,0
57093,26467,0,0,62,62,0,1,0,1,0
26527,25174,0,0,66,66,0,1,0,1,0
38383,51221,0,0,62,62,0,1,0,1,0
5223,44091,0,0,220,220,0,1,0,1,0
4323,64147,0,0,62,62,0,1,0,1,0
59214,57866,0,0,66,66,0,1,0,1,0
50529,44847,0,0,66,66,0,1,0,1,0
29576,37807,0,0,66,66,0,1,0,1,0
58638,5900,0,0,62,62,0,1,0,1,0
38723,15503,0,0,146,146,0,1,0,1,0
12616,23,0,0,60,60,0,1,0,1,0
32770,51505,0,0,62,62,0,1,0,1,0
32796,37965,0,0,62,62,0,1,0,1,0
59303,21247,0,0,66,66,0,1,0,1,0
57165,34101,0,0,66,66,0,1,0,1,0
26884,37965,0,0,66,66,0,1,0,1,0
14023,37965,0,0,62,62,0,1,0,1,0
26379,23,0,0,60,60,0,1,0,1,0
2323,23117,0,0,146,146,0,1,0,1,0
10688,25174,0,0,146,146,0,1,0,1,0
1081,14984,0,0,146,146,0,1,0,1,0
38664,37965,0,0,62,62,0,1,0,1,0
56255,44847,0,0,66,66,0,1,0,1,0
62338,50011,0,0,62,62,0,1,0,1,0
7048,25174,0,0,62,62,0,1,0,1,0
48513,44847,0,0,62,62,0,1,0,1,0
58638,5900,0,0,62,62,0,1,0,1,0
50251,35440,0,0,66,66,0,1,0,1,0
52238,26467,0,0,62,62,0,1,0,1,0
63621,30188,0,0,62,62,0,1,0,1,0
443,2629,0,0,135,135,0,1,0,1,0
26435,39004,0,0,62,62,0,1,0,1,0
50222,42873,0,0,66,66,0,1,0,1,0
31609,25174,0,0,62,62,0,1,0,1,0
49824,25174,0,0,62,62,0,1,0,1,0
29623,37807,0,0,62,62,0,1,0,1,0
32185,47807,0,0,159,159,0,1,0,1,0
58638,5900,0,0,62,62,0,1,0,1,0
50200,44847,0,0,74,74,0,1,0,1,0
35319,51505,0,0,62,62,0,1,0,1,0
15585,64147,0,0,66,66,0,1,0,1,0
49964,64147,0,0,66,66,0,1,0,1,0
58900,37807,0,0,66,66,0,1,0,1,0
6666,6379,0,0,60,60,0,1,0,1,0
27038,51505,0,0,62,62,0,1,0,1,0
58638,5900,0,0,62,62,0,1,0,1,0
54693,30188,0,0,62,62,0,1,0,1,0
65016,37965,0,0,66,66,0,1,0,1,0
58638,5900,0,0,62,62,0,1,0,1,0
8080,37965,0,0,62,62,0,1,0,1,0
32983,51221,0,0,66,66,0,1,0,1,0
9219,32480,0,0,72,72,0,1,0,1,0
42465,57470,0,0,60,60,0,1,0,1,0
43725,54532,0,0,109,109,0,1,0,1,0
48258,37965,0,0,62,62,0,1,0,1,0
51401,6881,0,0,66,66,0,1,0,1,0
45964,3111,0,0,60,60,0,1,0,1,0
48388,44847,0,0,62,62,0,1,0,1,0
63421,44847,0,0,66,66,0,1,0,1,0
443,14591,0,0,131,131,0,1,0,1,0
55056,56205,0,0,66,66,0,1,0,1,0
48692,57470,0,0,62,62,0,1,0,1,0
23940,41615,0,0,146,146,0,1,0,1,0
56688,25174,0,0,66,66,0,1,0,1,0
5228,3434,0,0,601,601,0,1,0,1,0
59201,51221,0,0,66,66,0,1,0,1,0
1480,12447,0,0,66,66,0,1,0,1,0
58305,51180,0,0,66,66,0,1,0,1,0
58638,5900,0,0,62,62,0,1,0,1,0
38629,25174,0,0,66,66,0,1,0,1,0
19698,502,0,0,60,60,0,1,0,1,0
50562,37965,0,0,66,66,0,1,0,1,0
58638,5900,0,0,62,62,0,1,0,1,0
58638,5900,0,0,62,62,0,1,0,1,0
56793,56205,0,0,62,62,0,1,0,1,0
51413,48637,0,0,72,72,0,1,0,1,0
0,0,0,0,98,98,0,1,0,1,0
58638,5900,0,0,62,62,0,1,0,1,0
56403,51505,0,0,66,66,0,1,0,1,0
54600,6881,0,0,66,66,0,1,0,1,0
64824,37965,0,0,62,62,0,1,0,1,0
54146,5900,0,0,60,60,0,1,0,1,0
38363,5900,0,0,60,60,0,1,0,1,0
11056,6881,0,0,62,62,0,1,0,1,0
6037,43890,0,0,74,74,0,1,0,1,0
34822,31573,0,0,62,62,0,1,0,1,0
54473,37807,0,0,66,66,0,1,0,1,0
45941,23388,0,0,60,60,0,1,0,1,0
57782,57470,0,0,66,66,0,1,0,1,0
41840,50584,0,0,66,66,0,1,0,1,0
30135,37965,0,0,66,66,0,1,0,1,0
56428,30317,0,0,66,66,0,1,0,1,0
443,44683,0,0,83,83,0,1,0,1,0
50675,56205,0,0,66,66,0,1,0,1,0
50063,35776,0,0,148,148,0,1,0,1,0
38592,57209,0,0,62,62,0,1,0,1,0
57131,31061,0,0,145,145,0,1,0,1,0
22300,51505,0,0,66,66,0,1,0,1,0
43584,24748,0,0,156,156,0,1,0,1,0
39583,37965,0,0,66,66,0,1,0,1,0
59210,50584,0,0,62,62,0,1,0,1,0
49607,25174,0,0,66,66,0,1,0,1,0
49805,64147,0,0,66,66,0,1,0,1,0
31727,57470,0,0,62,62,0,1,0,1,0
57302,62413,0,0,66,66,0,1,0,1,0
2394,43890,0,0,62,62,0,1,0,1,0
50920,60182,0,0,66,66,0,1,0,1,0
63027,35440,0,0,66,66,0,1,0,1,0
39324,64147,0,0,62,62,0,1,0,1,0
63398,25174,0,0,66,66,0,1,0,1,0
58509,21247,0,0,66,66,0,1,0,1,0
5223,14446,0,0,220,220,0,1,0,1,0
58638,5900,0,0,62,62,0,1,0,1,0
49501,11392,0,0,62,62,0,1,0,1,0
55155,2767,0,0,66,66,0,1,0,1,0
32124,30188,0,0,62,62,0,1,0,1,0
54280,3385,0,0,60,60,0,1,0,1,0
65212,22114,0,0,146,146,0,1,0,1,0
52828,51221,0,0,66,66,0,1,0,1,0
6416,22114,0,0,62,62,0,1,0,1,0
62257,2767,0,0,66,66,0,1,0,1,0
42957,64147,0,0,145,145,0,1,0,1,0
44334,26467,0,0,62,62,0,1,0,1,0
51052,50584,0,0,66,66,0,1,0,1,0
54518,25174,0,0,146,146,0,1,0,1,0
19136,64147,0,0,62,62,0,1,0,1,0
61185,54532,0,0,62,62,0,1,0,1,0
6057,51221,0,0,78,78,0,1,0,1,0
30149,23,0,0,60,60,0,1,0,1,0
57761,15503,0,0,62,62,0,1,0,1,0
63963,50584,0,0,66,66,0,1,0,1,0
55008,21247,0,0,66,66,0,1,0,1,0
10273,21247,0,0,66,66,0,1,0,1,0
55212,53733,0,0,66,66,0,1,0,1,0
46275,64147,0,0,62,62,0,1,0,1,0
55464,22114,0,0,62,62,0,1,0,1,0
443,29326,0,0,82,82,0,1,0,1,0
39313,37965,0,0,62,62,0,1,0,1,0
54305,39004,0,0,62,62,0,1,0,1,0
3578,51505,0,0,66,66,0,1,0,1,0
58638,5900,0,0,62,62,0,1,0,1,0
55966,57866,0,0,66,66,0,1,0,1,0
50298,37965,0,0,62,62,0,1,0,1,0
5223,32965,0,0,66,66,0,1,0,1,0
55439,37965,0,0,66,66,0,1,0,1,0
37008,42707,0,0,62,62,0,1,0,1,0
62941,57470,0,0,74,74,0,1,0,1,0
58638,5900,0,0,62,62,0,1,0,1,0
58148,43890,0,0,66,66,0,1,0,1,0
64482,64147,0,0,66,66,0,1,0,1,0
6881,57470,0,0,100,100,0,1,0,1,0
1446,35440,0,0,66,66,0,1,0,1,0
19204,57866,0,0,66,66,0,1,0,1,0
32282,8604,0,0,66,66,0,1,0,1,0
60480,57470,0,0,62,62,0,1,0,1,0
57612,28793,0,0,66,66,0,1,0,1,0
59430,50584,0,0,66,66,0,1,0,1,0
13120,25174,0,0,62,62,0,1,0,1,0
53097,25174,0,0,66,66,0,1,0,1,0
5926,25174,0,0,62,62,0,1,0,1,0
53305,50584,0,0,66,66,0,1,0,1,0
59668,51505,0,0,66,66,0,1,0,1,0
54976,15503,0,0,66,66,0,1,0,1,0
53960,30041,0,0,66,66,0,1,0,1,0
1030,64147,0,0,62,62,0,1,0,1,0
54638,36829,0,0,146,146,0,1,0,1,0
8191,51221,0,0,62,62,0,1,0,1,0
19875,30170,0,0,145,145,0,1,0,1,0
62859,35440,0,0,66,66,0,1,0,1,0
58251,36237,0,0,66,66,0,1,0,1,0
57471,62413,0,0,66,66,0,1,0,1,0
26872,44847,0,0,62,62,0,1,0,1,0
17315,11392,0,0,66,66,0,1,0,1,0
18246,64097,0,0,62,62,0,1,0,1,0
6892,36949,0,0,159,159,0,1,0,1,0
39587,22114,0,0,62,62,0,1,0,1,0
50727,57470,0,0,78,78,0,1,0,1,0
50197,64147,0,0,66,66,0,1,0,1,0
58250,35440,0,0,66,66,0,1,0,1,0
17786,44847,0,0,62,62,0,1,0,1,0
61053,44847,0,0,66,66,0,1,0,1,0
58638,5900,0,0,62,62,0,1,0,1,0
45941,23386,0,0,60,60,0,1,0,1,0
1024,50265,0,0,62,62,0,1,0,1,0
48676,53399,0,0,60,60,0,1,0,1,0
11816,50584,0,0,66,66,0,1,0,1,0
45304,64147,0,0,72,72,0,1,0,1,0
42429,22114,0,0,62,62,0,1,0,1,0
30129,37965,0,0,72,72,0,1,0,1,0
58638,5900,0,0,62,62,0,1,0,1,0
64880,9694,0,0,66,66,0,1,0,1,0
21534,42246,0,0,66,66,0,1,0,1,0
49514,52255,0,0,162,162,0,1,0,1,0
23331,25174,0,0,66,66,0,1,0,1,0
48706,23393,0,0,60,60,0,1,0,1,0
58638,5900,0,0,62,62,0,1,0,1,0
14484,39004,0,0,145,145,0,1,0,1,0
58247,57866,0,0,66,66,0,1,0,1,0
51455,53733,0,0,66,66,0,1,0,1,0
44235,50265,0,0,145,145,0,1,0,1,0
3478,61463,0,0,967,967,0,1,0,1,0
10144,62609,0,0,148,148,0,1,0,1,0
52356,55442,0,0,66,66,0,1,0,1,0
31136,50584,0,0,62,62,0,1,0,1,0
3928,64147,0,0,62,62,0,1,0,1,0
16027,22,0,0,60,60,0,1,0,1,0
0,0,0,0,98,98,0,1,0,1,0
65344,46824,0,0,62,62,0,1,0,1,0
56161,62413,0,0,66,66,0,1,0,1,0
50977,56205,0,0,66,66,0,1,0,1,0
51093,57470,0,0,66,66,0,1,0,1,0
52837,35440,0,0,66,66,0,1,0,1,0
52860,9694,0,0,62,62,0,1,0,1,0
49797,25174,0,0,66,66,0,1,0,1,0
24144,57470,0,0,62,62,0,1,0,1,0
30765,56205,0,0,66,66,0,1,0,1,0
60351,50584,0,0,66,66,0,1,0,1,0
16387,63752,0,0,60,60,0,1,0,1,0
56883,22114,0,0,62,62,0,1,0,1,0
55144,30188,0,0,66,66,0,1,0,1,0
45673,30188,0,0,62,62,0,1,0,1,0
15635,41182,0,0,66,66,0,1,0,1,0
50316,37965,0,0,66,66,0,1,0,1,0
15442,22114,0,0,62,62,0,1,0,1,0
3381,44847,0,0,78,78,0,1,0,1,0
1190,25174,0,0,146,146,0,1,0,1,0
8889,30434,0,0,60,60,0,1,0,1,0
63323,54369,0,0,78,78,0,1,0,1,0
42209,36237,0,0,146,146,0,1,0,1,0
35494,22114,0,0,66,66,0,1,0,1,0
30332,48817,0,0,145,145,0,1,0,1,0
17702,6881,0,0,66,66,0,1,0,1,0
60960,49049,0,0,66,66,0,1,0,1,0
58829,64147,0,0,66,66,0,1,0,1,0
3524,25174,0,0,62,62,0,1,0,1,0
53147,37965,0,0,62,62,0,1,0,1,0
54684,37965,0,0,62,62,0,1,0,1,0
54868,1433,0,0,60,60,0,1,0,1,0
4594,35993,0,0,66,66,0,1,0,1,0
11821,64147,0,0,62,62,0,1,0,1,0
54365,64147,0,0,62,62,0,1,0,1,0
51999,37965,0,0,62,62,0,1,0,1,0
61420,64097,0,0,66,66,0,1,0,1,0
18415,37965,0,0,62,62,0,1,0,1,0
58638,5900,0,0,62,62,0,1,0,1,0
13559,57866,0,0,62,62,0,1,0,1,0
59210,8168,0,0,66,66,0,1,0,1,0
63323,54369,0,0,78,78,0,1,0,1,0
64756,11392,0,0,62,62,0,1,0,1,0
52860,9694,0,0,62,62,0,1,0,1,0
27055,25174,0,0,62,62,0,1,0,1,0
52431,64147,0,0,62,62,0,1,0,1,0
63136,25174,0,0,66,66,0,1,0,1,0
16387,26193,0,0,60,60,0,1,0,1,0
6712,123,0,0,90,90,0,1,0,1,0
30456,36237,0,0,62,62,0,1,0,1,0
51745,57470,0,0,62,62,0,1,0,1,0
59451,50584,0,0,66,66,0,1,0,1,0
64295,26467,0,0,62,62,0,1,0,1,0
58638,5900,0,0,62,62,0,1,0,1,0
59126,57470,0,0,66,66,0,1,0,1,0
22300,51505,0,0,62,62,0,1,0,1,0
28221,37965,0,0,62,62,0,1,0,1,0
17146,57470,0,0,62,62,0,1,0,1,0
57260,51221,0,0,66,66,0,1,0,1,0
1025,35447,0,0,62,62,0,1,0,1,0
13027,64147,0,0,62,62,0,1,0,1,0
50292,22114,0,0,62,62,0,1,0,1,0
11023,51505,0,0,66,66,0,1,0,1,0
26198,64147,0,0,62,62,0,1,0,1,0
39895,26467,0,0,62,62,0,1,0,1,0
57173,44847,0,0,62,62,0,1,0,1,0
11136,17500,0,0,145,145,0,1,0,1,0
65518,5710,0,0,62,62,0,1,0,1,0
35718,20238,0,0,62,62,0,1,0,1,0
64989,50265,0,0,66,66,0,1,0,1,0
58638,5900,0,0,62,62,0,1,0,1,0
27348,22114,0,0,62,62,0,1,0,1,0
6416,22114,0,0,66,66,0,1,0,1,0
12465,11392,0,0,62,62,0,1,0,1,0
0,0,0,0,98,98,0,1,0,1,0
11842,35440,0,0,66,66,0,1,0,1,0
46275,64147,0,0,62,62,0,1,0,1,0
27144,25174,0,0,66,66,0,1,0,1,0
63288,52848,0,0,66,66,0,1,0,1,0
62341,26467,0,0,62,62,0,1,0,1,0
58638,5900,0,0,62,62,0,1,0,1,0
60772,36829,0,0,66,66,0,1,0,1,0
18655,44847,0,0,66,66,0,1,0,1,0
60132,50584,0,0,66,66,0,1,0,1,0
22683,39210,0,0,60,60,0,1,0,1,0
12651,62413,0,0,62,62,0,1,0,1,0
54305,35440,0,0,62,62,0,1,0,1,0
63565,22114,0,0,146,146,0,1,0,1,0
18655,50584,0,0,146,146,0,1,0,1,0
65233,23117,0,0,66,66,0,1,0,1,0
50624,50584,0,0,66,66,0,1,0,1,0
52451,56205,0,0,66,66,0,1,0,1,0
542,46783,0,0,62,62,0,1,0,1,0
443,44683,0,0,83,83,0,1,0,1,0
11136,57587,0,0,62,62,0,1,0,1,0
52348,62413,0,0,66,66,0,1,0,1,0
37487,25174,0,0,66,66,0,1,0,1,0
57793,37807,0,0,66,66,0,1,0,1,0
49203,51050,0,0,62,62,0,1,0,1,0
7892,50584,0,0,62,62,0,1,0,1,0
49485,11392,0,0,66,66,0,1,0,1,0
1024,64147,0,0,62,62,0,1,0,1,0
5664,36237,0,0,66,66,0,1,0,1,0
57452,57470,0,0,62,62,0,1,0,1,0
61135,50265,0,0,62,62,0,1,0,1,0
48388,44847,0,0,62,62,0,1,0,1,0
17101,25174,0,0,66,66,0,1,0,1,0
30580,50265,0,0,66,66,0,1,0,1,0
19330,25174,0,0,146,146,0,1,0,1,0
34713,22114,0,0,146,146,0,1,0,1,0
20012,8443,0,0,60,60,0,1,0,1,0
50620,50584,0,0,66,66,0,1,0,1,0
62392,15503,0,0,62,62,0,1,0,1,0
443,62732,0,0,332,332,0,1,0,1,0
27081,10197,0,0,62,62,0,1,0,1,0
58703,50584,0,0,66,66,0,1,0,1,0
33589,23,0,0,60,60,0,1,0,1,0
50470,61463,0,0,86,86,0,1,0,1,0
1638,22114,0,0,62,62,0,1,0,1,0
58638,5900,0,0,62,62,0,1,0,1,0
64051,36829,0,0,62,62,0,1,0,1,0
50095,30188,0,0,66,66,0,1,0,1,0
3730,37965,0,0,62,62,0,1,0,1,0
61451,17500,0,0,66,66,0,1,0,1,0
37429,25174,0,0,62,62,0,1,0,1,0
52231,50934,0,0,62,62,0,1,0,1,0
3667,56205,0,0,146,146,0,1,0,1,0
61426,64910,0,0,66,66,0,1,0,1,0
49196,25174,0,0,66,66,0,1,0,1,0
47727,25174,0,0,62,62,0,1,0,1,0
58638,5900,0,0,62,62,0,1,0,1,0
45908,33330,0,0,60,60,0,1,0,1,0
14447,25174,0,0,62,62,0,1,0,1,0
33432,5900,0,0,60,60,0,1,0,1,0
62678,57470,0,0,62,62,0,1,0,1,0
58091,51505,0,0,62,62,0,1,0,1,0
52472,7302,0,0,62,62,0,1,0,1,0
59618,46824,0,0,66,66,0,1,0,1,0
38549,22114,0,0,146,146,0,1,0,1,0
19004,51505,0,0,66,66,0,1,0,1,0
42572,995,0,0,60,60,0,1,0,1,0
49531,26467,0,0,62,62,0,1,0,1,0
1968,23,0,0,60,60,0,1,0,1,0
50636,23117,0,0,62,62,0,1,0,1,0
63527,50584,0,0,62,62,0,1,0,1,0
48676,53395,0,0,60,60,0,1,0,1,0
45908,3383,0,0,60,60,0,1,0,1,0
49818,37965,0,0,62,62,0,1,0,1,0
17581,23,0,0,60,60,0,1,0,1,0
51948,17372,0,0,62,62,0,1,0,1,0
55749,37965,0,0,66,66,0,1,0,1,0
58338,3353,0,0,60,60,0,1,0,1,0
23475,25174,0,0,146,146,0,1,0,1,0
61911,15503,0,0,146,146,0,1,0,1,0
63743,25174,0,0,62,62,0,1,0,1,0
33822,57470,0,0,66,66,0,1,0,1,0
65265,55067,0,0,66,66,0,1,0,1,0
50066,30188,0,0,62,62,0,1,0,1,0
37597,50584,0,0,66,66,0,1,0,1,0
54633,36237,0,0,66,66,0,1,0,1,0
61400,64147,0,0,66,66,0,1,0,1,0
48706,23393,0,0,60,60,0,1,0,1,0
51094,35440,0,0,66,66,0,1,0,1,0
56327,44512,0,0,66,66,0,1,0,1,0
12632,25174,0,0,62,62,0,1,0,1,0
58638,5900,0,0,62,62,0,1,0,1,0
43584,24748,0,0,156,156,0,1,0,1,0
56456,1433,0,0,60,60,0,1,0,1,0
3478,61463,0,0,1273,1273,0,1,0,1,0
51706,25174,0,0,66,66,0,1,0,1,0
62731,21247,0,0,66,66,0,1,0,1,0
62824,37807,0,0,66,66,0,1,0,1,0
443,38956,0,0,82,82,0,1,0,1,0
62642,25174,0,0,66,66,0,1,0,1,0
64949,44847,0,0,66,66,0,1,0,1,0
1024,45129,0,0,145,145,0,1,0,1,0
10216,11392,0,0,66,66,0,1,0,1,0
59949,44847,0,0,66,66,0,1,0,1,0
56307,52700,0,0,66,66,0,1,0,1,0
22528,48817,0,0,148,148,0,1,0,1,0
58638,5900,0,0,62,62,0,1,0,1,0
61000,15503,0,0,146,146,0,1,0,1,0
56127,37965,0,0,62,62,0,1,0,1,0
37633,44847,0,0,62,62,0,1,0,1,0
7099,51505,0,0,62,62,0,1,0,1,0
62043,25174,0,0,62,62,0,1,0,1,0
54816,35440,0,0,146,146,0,1,0,1,0
39063,44847,0,0,66,66,0,1,0,1,0
3717,25174,0,0,62,62,0,1,0,1,0
52611,9571,0,0,62,62,0,1,0,1,0
58715,64097,0,0,62,62,0,1,0,1,0
49893,25174,0,0,66,66,0,1,0,1,0
23553,37965,0,0,62,62,0,1,0,1,0
58638,5900,0,0,62,62,0,1,0,1,0
29697,51221,0,0,62,62,0,1,0,1,0
64727,25174,0,0,66,66,0,1,0,1,0
15466,41864,0,0,148,148,0,1,0,1,0
55893,45711,0,0,78,78,0,1,0,1,0
59424,50265,0,0,74,74,0,1,0,1,0
23126,35440,0,0,66,66,0,1,0,1,0
45941,23388,0,0,60,60,0,1,0,1,0
36881,56205,0,0,146,146,0,1,0,1,0
12895,37965,0,0,62,62,0,1,0,1,0
60960,49049,0,0,66,66,0,1,0,1,0
31660,35440,0,0,62,62,0,1,0,1,0
13285,29892,0,0,145,145,0,1,0,1,0
56388,22114,0,0,66,66,0,1,0,1,0
51602,22114,0,0,66,66,0,1,0,1,0
49587,35776,0,0,157,157,0,1,0,1,0
27621,50584,0,0,146,146,0,1,0,1,0
47201,44847,0,0,66,66,0,1,0,1,0
59781,56205,0,0,66,66,0,1,0,1,0
65179,44847,0,0,62,62,0,1,0,1,0
49182,21247,0,0,62,62,0,1,0,1,0
22390,19473,0,0,62,62,0,1,0,1,0
3803,51505,0,0,66,66,0,1,0,1,0
15806,11392,0,0,66,66,0,1,0,1,0
443,4205,0,0,187,187,0,1,0,1,0
50046,22114,0,0,66,66,0,1,0,1,0
58716,9694,0,0,62,62,0,1,0,1,0
45410,1,0,0,62,62,0,1,0,1,0
58463,11392,0,0,66,66,0,1,0,1,0
51973,44847,0,0,66,66,0,1,0,1,0
59365,42873,0,0,74,74,0,1,0,1,0
58638,5900,0,0,62,62,0,1,0,1,0
64673,6881,0,0,66,66,0,1,0,1,0
42753,56205,0,0,62,62,0,1,0,1,0
58638,5900,0,0,62,62,0,1,0,1,0
61738,2767,0,0,66,66,0,1,0,1,0
18653,42707,0,0,66,66,0,1,0,1,0
4772,37965,0,0,66,66,0,1,0,1,0
58238,23,0,0,60,60,0,1,0,1,0
49325,41615,0,0,157,157,0,1,0,1,0
61190,21247,0,0,66,66,0,1,0,1,0
68,67,0,0,346,346,0,1,0,1,0
53750,25174,0,0,62,62,0,1,0,1,0
65332,56205,0,0,62,62,0,1,0,1,0
60830,50584,0,0,62,62,0,1,0,1,0
3478,61463,0,0,1103,1103,0,1,0,1,0
56309,22114,0,0,62,62,0,1,0,1,0
35507,15503,0,0,62,62,0,1,0,1,0
3077,50584,0,0,146,146,0,1,0,1,0
26480,64147,0,0,62,62,0,1,0,1,0
26872,44847,0,0,62,62,0,1,0,1,0
59879,55783,0,0,66,66,0,1,0,1,0
58925,25174,0,0,66,66,0,1,0,1,0
443,50238,0,0,331,331,0,1,0,1,0
6356,26467,0,0,62,62,0,1,0,1,0
51732,50934,0,0,146,146,0,1,0,1,0
43584,24748,0,0,156,156,0,1,0,1,0
56268,44847,0,0,66,66,0,1,0,1,0
52238,26467,0,0,62,62,0,1,0,1,0
41744,37965,0,0,62,62,0,1,0,1,0
58638,5900,0,0,62,62,0,1,0,1,0
53376,22114,0,0,146,146,0,1,0,1,0
24882,50647,0,0,60,60,0,1,0,1,0
57348,25174,0,0,62,62,0,1,0,1,0
37455,50584,0,0,66,66,0,1,0,1,0
58638,5900,0,0,62,62,0,1,0,1,0
29509,25174,0,0,62,62,0,1,0,1,0
43207,26467,0,0,62,62,0,1,0,1,0
32381,50584,0,0,66,66,0,1,0,1,0
443,54507,0,0,82,82,0,1,0,1,0
11585,56205,0,0,62,62,0,1,0,1,0
11967,57470,0,0,62,62,0,1,0,1,0
443,49988,0,0,82,82,0,1,0,1,0
17982,11392,0,0,62,62,0,1,0,1,0
51615,25174,0,0,66,66,0,1,0,1,0
26884,37965,0,0,66,66,0,1,0,1,0
25565,42779,0,0,60,60,0,1,0,1,0
55933,64097,0,0,62,62,0,1,0,1,0
22029,50584,0,0,66,66,0,1,0,1,0
13484,37965,0,0,62,62,0,1,0,1,0
16059,22114,0,0,62,62,0,1,0,1,0
39873,23,0,0,60,60,0,1,0,1,0
43350,58414,0,0,66,66,0,1,0,1,0
53140,51221,0,0,74,74,0,1,0,1,0
22263,30188,0,0,66,66,0,1,0,1,0
62625,37965,0,0,66,66,0,1,0,1,0
64997,51221,0,0,66,66,0,1,0,1,0
58638,5900,0,0,62,62,0,1,0,1,0
60721,22114,0,0,66,66,0,1,0,1,0
16948,990,0,0,60,60,0,1,0,1,0
57899,34317,0,0,145,145,0,1,0,1,0
63586,46824,0,0,62,62,0,1,0,1,0
45908,3383,0,0,60,60,0,1,0,1,0
3986,17372,0,0,66,66,0,1,0,1,0
63587,22114,0,0,62,62,0,1,0,1,0
37431,25174,0,0,146,146,0,1,0,1,0
53766,51505,0,0,66,66,0,1,0,1,0
41840,50584,0,0,66,66,0,1,0,1,0
26802,50584,0,0,62,62,0,1,0,1,0
51109,11392,0,0,62,62,0,1,0,1,0
26053,33720,0,0,160,160,0,1,0,1,0
58638,5900,0,0,62,62,0,1,0,1,0
58638,5900,0,0,62,62,0,1,0,1,0
57994,30188,0,0,62,62,0,1,0,1,0
51300,64147,0,0,66,66,0,1,0,1,0
8760,22114,0,0,66,66,0,1,0,1,0
50799,37807,0,0,66,66,0,1,0,1,0
58638,5900,0,0,62,62,0,1,0,1,0
53652,1900,0,0,139,139,0,1,0,1,0
45941,23386,0,0,60,60,0,1,0,1,0
65115,50584,0,0,66,66,0,1,0,1,0
35261,15503,0,0,74,74,0,1,0,1,0
80,18811,0,0,60,60,0,1,0,1,0
2707,37,0,0,60,60,0,1,0,1,0
36339,50584,0,0,146,146,0,1,0,1,0
58638,5900,0,0,62,62,0,1,0,1,0
63242,50584,0,0,62,62,0,1,0,1,0
58638,5900,0,0,62,62,0,1,0,1,0
35154,42707,0,0,62,62,0,1,0,1,0
56067,25174,0,0,146,146,0,1,0,1,0
59241,62413,0,0,66,66,0,1,0,1,0
28345,11392,0,0,66,66,0,1,0,1,0
28824,44847,0,0,66,66,0,1,0,1,0
56127,37965,0,0,66,66,0,1,0,1,0
45964,3111,0,0,60,60,0,1,0,1,0
54796,22114,0,0,62,62,0,1,0,1,0
62911,36237,0,0,66,66,0,1,0,1,0
64841,6881,0,0,62,62,0,1,0,1,0
1384,44847,0,0,66,66,0,1,0,1,0
1024,44847,0,0,146,146,0,1,0,1,0
43323,1,0,0,62,62,0,1,0,1,0
17548,36829,0,0,62,62,0,1,0,1,0
51731,57470,0,0,78,78,0,1,0,1,0
3169,22114,0,0,66,66,0,1,0,1,0
12694,12446,0,0,62,62,0,1,0,1,0
60602,15503,0,0,66,66,0,1,0,1,0
65379,22114,0,0,66,66,0,1,0,1,0
51191,26467,0,0,66,66,0,1,0,1,0
58638,5900,0,0,62,62,0,1,0,1,0
52830,22114,0,0,146,146,0,1,0,1,0
42389,42873,0,0,74,74,0,1,0,1,0
51429,22114,0,0,62,62,0,1,0,1,0
6057,51221,0,0,62,62,0,1,0,1,0
1182,23,0,0,60,60,0,1,0,1,0
54737,50584,0,0,66,66,0,1,0,1,0
62068,64147,0,0,66,66,0,1,0,1,0
17643,50584,0,0,146,146,0,1,0,1,0
64898,35993,0,0,74,74,0,1,0,1,0
15176,62413,0,0,66,66,0,1,0,1,0
7444,57470,0,0,66,66,0,1,0,1,0
58486,57470,0,0,66,66,0,1,0,1,0
3478,61463,0,0,1306,1306,0,1,0,1,0
49248,35993,0,0,66,66,0,1,0,1,0
13285,29892,0,0,145,145,0,1,0,1,0
52348,62413,0,0,66,66,0,1,0,1,0
1865,25174,0,0,62,62,0,1,0,1,0
54062,31573,0,0,66,66,0,1,0,1,0
56712,46824,0,0,66,66,0,1,0,1,0
57236,53733,0,0,66,66,0,1,0,1,0
45783,22114,0,0,62,62,0,1,0,1,0
33706,23,0,0,60,60,0,1,0,1,0
36357,25174,0,0,66,66,0,1,0,1,0
15922,44847,0,0,66,66,0,1,0,1,0
58638,5900,0,0,62,62,0,1,0,1,0
54502,34729,0,0,66,66,0,1,0,1,0
5223,21557,0,0,60,60,0,1,0,1,0
18091,23,0,0,60,60,0,1,0,1,0
17177,64147,0,0,62,62,0,1,0,1,0
64880,9694,0,0,66,66,0,1,0,1,0
28378,56205,0,0,62,62,0,1,0,1,0
30583,25174,0,0,66,66,0,1,0,1,0
64214,25174,0,0,62,62,0,1,0,1,0
64000,44847,0,0,62,62,0,1,0,1,0
63364,57470,0,0,62,62,0,1,0,1,0
34086,25174,0,0,66,66,0,1,0,1,0
1035,57470,0,0,72,72,0,1,0,1,0
59773,5900,0,0,60,60,0,1,0,1,0
64294,64147,0,0,62,62,0,1,0,1,0
54858,51505,0,0,66,66,0,1,0,1,0
24236,26296,0,0,148,148,0,1,0,1,0
54389,28543,0,0,62,62,0,1,0,1,0
58638,5900,0,0,62,62,0,1,0,1,0
58638,5900,0,0,62,62,0,1,0,1,0
13970,42873,0,0,66,66,0,1,0,1,0
24145,35440,0,0,62,62,0,1,0,1,0
42490,1433,0,0,60,60,0,1,0,1,0
3375,35253,0,0,62,62,0,1,0,1,0
49805,6881,0,0,66,66,0,1,0,1,0
58638,5900,0,0,62,62,0,1,0,1,0
56816,11392,0,0,66,66,0,1,0,1,0
45912,44847,0,0,62,62,0,1,0,1,0
15701,37965,0,0,146,146,0,1,0,1,0
16387,35583,0,0,60,60,0,1,0,1,0
9067,44847,0,0,62,62,0,1,0,1,0
22547,48817,0,0,72,72,0,1,0,1,0
10797,50584,0,0,62,62,0,1,0,1,0
0,0,0,0,70,70,0,1,0,1,0
54418,22114,0,0,62,62,0,1,0,1,0
64035,25174,0,0,146,146,0,1,0,1,0
58638,5900,0,0,62,62,0,1,0,1,0
14997,57470,0,0,72,72,0,1,0,1,0
51414,22,0,0,60,60,0,1,0,1,0
57789,30188,0,0,62,62,0,1,0,1,0
49616,30188,0,0,66,66,0,1,0,1,0
40571,26467,0,0,62,62,0,1,0,1,0
11136,17500,0,0,62,62,0,1,0,1,0
30181,61689,0,0,62,62,0,1,0,1,0
56202,15503,0,0,146,146,0,1,0,1,0
59234,21247,0,0,62,62,0,1,0,1,0
6832,51505,0,0,66,66,0,1,0,1,0
60192,35440,0,0,62,62,0,1,0,1,0
63221,53436,0,0,62,62,0,1,0,1,0
45908,3383,0,0,60,60,0,1,0,1,0
49220,22,0,0,60,60,0,1,0,1,0
57676,64147,0,0,70,70,0,1,0,1,0
30598,37965,0,0,62,62,0,1,0,1,0
52962,35440,0,0,66,66,0,1,0,1,0
9756,26467,0,0,66,66,0,1,0,1,0
59097,2767,0,0,66,66,0,1,0,1,0
7686,25174,0,0,146,146,0,1,0,1,0
63213,15503,0,0,62,62,0,1,0,1,0
18608,11392,0,0,62,62,0,1,0,1,0
55854,54369,0,0,74,74,0,1,0,1,0
48020,7484,0,0,60,60,0,1,0,1,0
64878,26467,0,0,62,62,0,1,0,1,0
39110,50584,0,0,62,62,0,1,0,1,0
34212,11392,0,0,66,66,0,1,0,1,0
50486,56205,0,0,62,62,0,1,0,1,0
54552,64147,0,0,62,62,0,1,0,1,0
62152,56205,0,0,66,66,0,1,0,1,0
23537,35253,0,0,66,66,0,1,0,1,0
24271,52700,0,0,66,66,0,1,0,1,0
8999,57470,0,0,146,146,0,1,0,1,0
2919,37965,0,0,62,62,0,1,0,1,0
53995,25174,0,0,66,66,0,1,0,1,0
53676,35974,0,0,60,60,0,1,0,1,0
42615,25174,0,0,146,146,0,1,0,1,0
58638,5900,0,0,62,62,0,1,0,1,0
55201,26467,0,0,66,66,0,1,0,1,0
23763,23,0,0,60,60,0,1,0,1,0
3478,61463,0,0,893,893,0,1,0,1,0
22683,39210,0,0,60,60,0,1,0,1,0
59523,37965,0,0,62,62,0,1,0,1,0
48144,21247,0,0,66,66,0,1,0,1,0
1025,46776,0,0,62,62,0,1,0,1,0
61635,37965,0,0,66,66,0,1,0,1,0
16057,56205,0,0,66,66,0,1,0,1,0
56920,23117,0,0,146,146,0,1,0,1,0
51655,26467,0,0,62,62,0,1,0,1,0
51922,44847,0,0,66,66,0,1,0,1,0
51920,30188,0,0,62,62,0,1,0,1,0
58638,5900,0,0,62,62,0,1,0,1,0
33973,50265,0,0,62,62,0,1,0,1,0
443,2629,0,0,135,135,0,1,0,1,0
27084,50584,0,0,66,66,0,1,0,1,0
53667,22114,0,0,66,66,0,1,0,1,0
51979,25174,0,0,66,66,0,1,0,1,0
22835,51221,0,0,62,62,0,1,0,1,0
22408,22114,0,0,66,66,0,1,0,1,0
443,39999,0,0,74,74,0,1,0,1,0
53314,64097,0,0,62,62,0,1,0,1,0
48706,23393,0,0,60,60,0,1,0,1,0
52741,24211,0,0,66,66,0,1,0,1,0
3478,61463,0,0,156,156,0,1,0,1,0
11136,15503,0,0,62,62,0,1,0,1,0
35163,30188,0,0,62,62,0,1,0,1,0
17760,50584,0,0,146,146,0,1,0,1,0
56327,44512,0,0,66,66,0,1,0,1,0
18415,37965,0,0,62,62,0,1,0,1,0
35460,35440,0,0,146,146,0,1,0,1,0
57410,37965,0,0,66,66,0,1,0,1,0
58627,25174,0,0,62,62,0,1,0,1,0
36227,23,0,0,60,60,0,1,0,1,0
1025,50584,0,0,62,62,0,1,0,1,0
38320,51505,0,0,66,66,0,1,0,1,0
14255,2767,0,0,146,146,0,1,0,1,0
55130,25174,0,0,62,62,0,1,0,1,0
50328,22114,0,0,62,62,0,1,0,1,0
11030,17372,0,0,62,62,0,1,0,1,0
46670,51505,0,0,146,146,0,1,0,1,0
64104,22114,0,0,66,66,0,1,0,1,0
48706,23393,0,0,60,60,0,1,0,1,0
60245,25174,0,0,62,62,0,1,0,1,0
22367,50584,0,0,146,146,0,1,0,1,0
59810,6004,0,0,66,66,0,1,0,1,0
61017,64147,0,0,66,66,0,1,0,1,0
63208,30975,0,0,148,148,0,1,0,1,0
50878,53733,0,0,66,66,0,1,0,1,0
58638,5900,0,0,62,62,0,1,0,1,0
20576,37965,0,0,62,62,0,1,0,1,0
49711,14984,0,0,66,66,0,1,0,1,0
15641,26467,0,0,62,62,0,1,0,1,0
6057,51221,0,0,78,78,0,1,0,1,0
51155,56205,0,0,66,66,0,1,0,1,0
3478,61463,0,0,217,217,0,1,0,1,0
12031,36237,0,0,66,66,0,1,0,1,0
34993,15503,0,0,62,62,0,1,0,1,0
33886,65504,0,0,162,162,0,1,0,1,0
23218,62413,0,0,66,66,0,1,0,1,0
45941,23386,0,0,60,60,0,1,0,1,0
63023,51505,0,0,62,62,0,1,0,1,0
56494,15503,0,0,146,146,0,1,0,1,0
15403,51505,0,0,66,66,0,1,0,1,0
53120,25174,0,0,146,146,0,1,0,1,0
50052,65008,0,0,60,60,0,1,0,1,0
50,38211,0,0,66,66,0,1,0,1,0
49929,26467,0,0,66,66,0,1,0,1,0
7105,25174,0,0,66,66,0,1,0,1,0
27617,51505,0,0,146,146,0,1,0,1,0
443,48346,0,0,81,81,0,1,0,1,0
59879,55783,0,0,66,66,0,1,0,1,0
25756,22114,0,0,146,146,0,1,0,1,0
1030,35776,0,0,139,139,0,1,0,1,0
16387,56995,0,0,60,60,0,1,0,1,0
49786,25174,0,0,66,66,0,1,0,1,0
31066,57470,0,0,74,74,0,1,0,1,0
45941,23386,0,0,60,60,0,1,0,1,0
34932,38608,0,0,62,62,0,1,0,1,0
57131,26296,0,0,145,145,0,1,0,1,0
56367,44847,0,0,66,66,0,1,0,1,0
45682,1,0,0,62,62,0,1,0,1,0
58638,5900,0,0,62,62,0,1,0,1,0
27947,26467,0,0,62,62,0,1,0,1,0
58638,5900,0,0,62,62,0,1,0,1,0
28306,25604,0,0,62,62,0,1,0,1,0
52472,51221,0,0,74,74,0,1,0,1,0
14208,51221,0,0,66,66,0,1,0,1,0
58638,5900,0,0,62,62,0,1,0,1,0
50,38211,0,0,66,66,0,1,0,1,0
52644,57209,0,0,66,66,0,1,0,1,0
5179,50265,0,0,62,62,0,1,0,1,0
54600,6881,0,0,66,66,0,1,0,1,0
65068,23,0,0,60,60,0,1,0,1,0
26698,25174,0,0,66,66,0,1,0,1,0
34489,35440,0,0,66,66,0,1,0,1,0
23770,50584,0,0,62,62,0,1,0,1,0
50052,65008,0,0,60,60,0,1,0,1,0
51706,25174,0,0,66,66,0,1,0,1,0
49651,37965,0,0,74,74,0,1,0,1,0
62637,42873,0,0,66,66,0,1,0,1,0
1972,57470,0,0,78,78,0,1,0,1,0
63984,25174,0,0,62,62,0,1,0,1,0
6943,57099,0,0,100,100,0,1,0,1,0
52696,21247,0,0,66,66,0,1,0,1,0
27153,50584,0,0,146,146,0,1,0,1,0
54883,60043,0,0,62,62,0,1,0,1,0
58638,5900,0,0,62,62,0,1,0,1,0
42674,22114,0,0,62,62,0,1,0,1,0
28378,56205,0,0,62,62,0,1,0,1,0
58226,52848,0,0,62,62,0,1,0,1,0
40082,22,0,0,60,60,0,1,0,1,0
51560,46783,0,0,62,62,0,1,0,1,0
56413,51221,0,0,66,66,0,1,0,1,0
55136,11392,0,0,66,66,0,1,0,1,0
52410,8604,0,0,66,66,0,1,0,1,0
45082,17,0,0,60,60,0,1,0,1,0
10669,49756,0,0,60,60,0,1,0,1,0
36663,22114,0,0,62,62,0,1,0,1,0
2704,37,0,0,60,60,0,1,0,1,0
38909,57470,0,0,62,62,0,1,0,1,0
50065,44847,0,0,62,62,0,1,0,1,0
61902,22114,0,0,66,66,0,1,0,1,0
56405,62413,0,0,66,66,0,1,0,1,0
56711,25174,0,0,146,146,0,1,0,1,0
1024,44847,0,0,62,62,0,1,0,1,0
46537,25174,0,0,62,62,0,1,0,1,0
35011,37965,0,0,62,62,0,1,0,1,0
9377,56205,0,0,66,66,0,1,0,1,0
50566,22114,0,0,62,62,0,1,0,1,0
36096,51505,0,0,146,146,0,1,0,1,0
32520,47993,0,0,62,62,0,1,0,1,0
3580,25174,0,0,62,62,0,1,0,1,0
33405,37965,0,0,62,62,0,1,0,1,0
443,22323,0,0,83,83,0,1,0,1,0
49255,44847,0,0,66,66,0,1,0,1,0
1190,25174,0,0,62,62,0,1,0,1,0
62792,53,0,0,88,88,0,1,0,1,0
1280,25174,0,0,66,66,0,1,0,1,0
0,0,0,0,60,60,0,1,0,1,0
56578,64147,0,0,62,62,0,1,0,1,0
15465,64147,0,0,62,62,0,1,0,1,0
25679,27189,0,0,62,62,0,1,0,1,0
58638,5900,0,0,62,62,0,1,0,1,0
58638,5900,0,0,62,62,0,1,0,1,0
59535,25174,0,0,146,146,0,1,0,1,0
1114,37965,0,0,62,62,0,1,0,1,0
63400,57470,0,0,66,66,0,1,0,1,0
8999,50432,0,0,62,62,0,1,0,1,0
58597,35440,0,0,66,66,0,1,0,1,0
63242,50584,0,0,66,66,0,1,0,1,0
50767,57470,0,0,62,62,0,1,0,1,0
12471,48817,0,0,62,62,0,1,0,1,0
52699,26467,0,0,62,62,0,1,0,1,0
8889,2117,0,0,60,60,0,1,0,1,0
58638,5900,0,0,62,62,0,1,0,1,0
14263,22114,0,0,66,66,0,1,0,1,0
57987,56125,0,0,90,90,0,1,0,1,0
63765,51221,0,0,62,62,0,1,0,1,0
60527,35440,0,0,66,66,0,1,0,1,0
29021,23,0,0,60,60,0,1,0,1,0
28824,44847,0,0,66,66,0,1,0,1,0
49479,56205,0,0,66,66,0,1,0,1,0
27841,35894,0,0,62,62,0,1,0,1,0
54280,3385,0,0,60,60,0,1,0,1,0
59043,35440,0,0,62,62,0,1,0,1,0
515,10214,0,0,62,62,0,1,0,1,0
36484,67,0,0,60,60,0,1,0,1,0
27197,22114,0,0,146,146,0,1,0,1,0
7664,2149,0,0,62,62,0,1,0,1,0
61550,5529,0,0,145,145,0,1,0,1,0
54095,26467,0,0,62,62,0,1,0,1,0
52432,50265,0,0,66,66,0,1,0,1,0
58638,5900,0,0,62,62,0,1,0,1,0
38971,25174,0,0,146,146,0,1,0,1,0
6890,34729,0,0,146,146,0,1,0,1,0
55629,42873,0,0,74,74,0,1,0,1,0
57538,23,0,0,60,60,0,1,0,1,0
56015,56205,0,0,66,66,0,1,0,1,0
443,64347,0,0,131,131,0,1,0,1,0
1190,25174,0,0,62,62,0,1,0,1,0
62400,35993,0,0,66,66,0,1,0,1,0
57849,50584,0,0,66,66,0,1,0,1,0
50566,22114,0,0,62,62,0,1,0,1,0
65024,51505,0,0,62,62,0,1,0,1,0
59985,57470,0,0,66,66,0,1,0,1,0
64449,30188,0,0,66,66,0,1,0,1,0
9687,57470,0,0,78,78,0,1,0,1,0
5859,11392,0,0,66,66,0,1,0,1,0
58916,21247,0,0,146,146,0,1,0,1,0
52563,17235,0,0,70,70,0,1,0,1,0
58638,5900,0,0,62,62,0,1,0,1,0
55508,64147,0,0,62,62,0,1,0,1,0
34993,15503,0,0,62,62,0,1,0,1,0
55012,25174,0,0,66,66,0,1,0,1,0
63670,64097,0,0,66,66,0,1,0,1,0
16275,23117,0,0,146,146,0,1,0,1,0
13518,25174,0,0,62,62,0,1,0,1,0
13285,29892,0,0,145,145,0,1,0,1,0
63379,36237,0,0,66,66,0,1,0,1,0
62217,37807,0,0,66,66,0,1,0,1,0
63988,50584,0,0,66,66,0,1,0,1,0
48301,25174,0,0,62,62,0,1,0,1,0
10586,37965,0,0,62,62,0,1,0,1,0
61798,35440,0,0,66,66,0,1,0,1,0
58343,23718,0,0,66,66,0,1,0,1,0
26642,57470,0,0,62,62,0,1,0,1,0
16387,35244,0,0,60,60,0,1,0,1,0
58769,22114,0,0,146,146,0,1,0,1,0
63772,35440,0,0,66,66,0,1,0,1,0
26287,56205,0,0,62,62,0,1,0,1,0
5661,37965,0,0,62,62,0,1,0,1,0
53871,37965,0,0,66,66,0,1,0,1,0
16387,56995,0,0,60,60,0,1,0,1,0
58638,5900,0,0,62,62,0,1,0,1,0
6909,57470,0,0,62,62,0,1,0,1,0
14059,21247,0,0,62,62,0,1,0,1,0
46573,50584,0,0,66,66,0,1,0,1,0
62219,25174,0,0,146,146,0,1,0,1,0
1033,35440,0,0,146,146,0,1,0,1,0
58638,5900,0,0,62,62,0,1,0,1,0
57414,57470,0,0,146,146,0,1,0,1,0
44147,64147,0,0,62,62,0,1,0,1,0
55985,44847,0,0,146,146,0,1,0,1,0
64572,37965,0,0,66,66,0,1,0,1,0
58481,15503,0,0,146,146,0,1,0,1,0
16001,48817,0,0,143,143,0,1,0,1,0
10688,25174,0,0,62,62,0,1,0,1,0
57233,50934,0,0,66,66,0,1,0,1,0
50920,60182,0,0,62,62,0,1,0,1,0
44822,40108,0,0,145,145,0,1,0,1,0
58638,5900,0,0,62,62,0,1,0,1,0
58338,3375,0,0,60,60,0,1,0,1,0
60155,23718,0,0,66,66,0,1,0,1,0
42939,48817,0,0,156,156,0,1,0,1,0
58638,5900,0,0,62,62,0,1,0,1,0
23483,57470,0,0,109,109,0,1,0,1,0
11574,51505,0,0,66,66,0,1,0,1,0
1138,57470,0,0,146,146,0,1,0,1,0
58638,5900,0,0,62,62,0,1,0,1,0
58207,51505,0,0,62,62,0,1,0,1,0
11066,50584,0,0,66,66,0,1,0,1,0
59435,37807,0,0,62,62,0,1,0,1,0
17489,50584,0,0,146,146,0,1,0,1,0
22547,23,0,0,60,60,0,1,0,1,0
51837,37965,0,0,66,66,0,1,0,1,0
19933,35440,0,0,62,62,0,1,0,1,0
57174,57470,0,0,66,66,0,1,0,1,0
4545,1900,0,0,136,136,0,1,0,1,0
58638,5900,0,0,62,62,0,1,0,1,0
59585,36237,0,0,62,62,0,1,0,1,0
52791,25174,0,0,66,66,0,1,0,1,0
62514,37807,0,0,66,66,0,1,0,1,0
52537,57866,0,0,66,66,0,1,0,1,0
27064,51221,0,0,72,72,0,1,0,1,0
11988,48817,0,0,66,66,0,1,0,1,0
41852,35440,0,0,62,62,0,1,0,1,0
443,14591,0,0,60,60,0,1,0,1,0
58638,5900,0,0,62,62,0,1,0,1,0
52724,64147,0,0,62,62,0,1,0,1,0
50283,49169,0,0,66,66,0,1,0,1,0
34811,56205,0,0,66,66,0,1,0,1,0
13179,57866,0,0,62,62,0,1,0,1,0
59376,5900,0,0,60,60,0,1,0,1,0
54236,36829,0,0,62,62,0,1,0,1,0
48676,53392,0,0,60,60,0,1,0,1,0
10028,25604,0,0,62,62,0,1,0,1,0
62043,25174,0,0,146,146,0,1,0,1,0
44922,57470,0,0,74,74,0,1,0,1,0
50459,62413,0,0,62,62,0,1,0,1,0
8040,44847,0,0,66,66,0,1,0,1,0
57015,25174,0,0,66,66,0,1,0,1,0
57578,51221,0,0,66,66,0,1,0,1,0
58399,56205,0,0,66,66,0,1,0,1,0
62696,50584,0,0,62,62,0,1,0,1,0
54917,60043,0,0,66,66,0,1,0,1,0
14255,2767,0,0,62,62,0,1,0,1,0
54373,26467,0,0,62,62,0,1,0,1,0
59018,22114,0,0,146,146,0,1,0,1,0
55842,64147,0,0,66,66,0,1,0,1,0
27898,52700,0,0,62,62,0,1,0,1,0
59377,9319,0,0,62,62,0,1,0,1,0
20864,51221,0,0,62,62,0,1,0,1,0
3478,61463,0,0,503,503,0,1,0,1,0
31978,57470,0,0,60,60,0,1,0,1,0
42685,51180,0,0,62,62,0,1,0,1,0
58638,5900,0,0,62,62,0,1,0,1,0
7968,2767,0,0,62,62,0,1,0,1,0
45837,25174,0,0,62,62,0,1,0,1,0
17344,62413,0,0,66,66,0,1,0,1,0
16620,25174,0,0,62,62,0,1,0,1,0
45908,3383,0,0,60,60,0,1,0,1,0
52743,15503,0,0,66,66,0,1,0,1,0
44207,44847,0,0,66,66,0,1,0,1,0
18608,11392,0,0,66,66,0,1,0,1,0
51474,14914,0,0,139,139,0,1,0,1,0
16377,21247,0,0,62,62,0,1,0,1,0
7286,51221,0,0,62,62,0,1,0,1,0
35843,51505,0,0,146,146,0,1,0,1,0
51954,57470,0,0,66,66,0,1,0,1,0
6843,42873,0,0,62,62,0,1,0,1,0
65389,26467,0,0,62,62,0,1,0,1,0
64363,22114,0,0,66,66,0,1,0,1,0
12338,64147,0,0,66,66,0,1,0,1,0
27272,64147,0,0,66,66,0,1,0,1,0
60771,58414,0,0,66,66,0,1,0,1,0
58686,18375,0,0,66,66,0,1,0,1,0
58091,51505,0,0,66,66,0,1,0,1,0
58488,37965,0,0,62,62,0,1,0,1,0
44710,25174,0,0,62,62,0,1,0,1,0
33822,57470,0,0,66,66,0,1,0,1,0
25207,48817,0,0,62,62,0,1,0,1,0
35864,44847,0,0,78,78,0,1,0,1,0
40840,21247,0,0,62,62,0,1,0,1,0
59096,57866,0,0,66,66,0,1,0,1,0
51164,64147,0,0,66,66,0,1,0,1,0
56256,62413,0,0,62,62,0,1,0,1,0
6247,51221,0,0,62,62,0,1,0,1,0
53030,56205,0,0,66,66,0,1,0,1,0
51339,50584,0,0,66,66,0,1,0,1,0
51560,46783,0,0,66,66,0,1,0,1,0
38959,25174,0,0,62,62,0,1,0,1,0
57564,56205,0,0,66,66,0,1,0,1,0
57251,37965,0,0,62,62,0,1,0,1,0
40260,44610,0,0,145,145,0,1,0,1,0
61600,56205,0,0,62,62,0,1,0,1,0
27442,44847,0,0,62,62,0,1,0,1,0
443,32698,0,0,89,89,0,1,0,1,0
43398,25604,0,0,146,146,0,1,0,1,0
13525,51505,0,0,62,62,0,1,0,1,0
41734,57470,0,0,62,62,0,1,0,1,0
3802,55777,0,0,66,66,0,1,0,1,0
53053,64147,0,0,66,66,0,1,0,1,0
63080,37965,0,0,66,66,0,1,0,1,0
58638,5900,0,0,62,62,0,1,0,1,0
58638,5900,0,0,62,62,0,1,0,1,0
37998,26467,0,0,66,66,0,1,0,1,0
64237,51505,0,0,66,66,0,1,0,1,0
25565,27960,0,0,60,60,0,1,0,1,0
53257,37450,0,0,66,66,0,1,0,1,0
21759,51505,0,0,66,66,0,1,0,1,0
62150,23718,0,0,66,66,0,1,0,1,0
443,14591,0,0,131,131,0,1,0,1,0
65501,57470,0,0,72,72,0,1,0,1,0
57479,56205,0,0,66,66,0,1,0,1,0
63998,21247,0,0,66,66,0,1,0,1,0
1280,25174,0,0,66,66,0,1,0,1,0
62197,22114,0,0,66,66,0,1,0,1,0
64333,57470,0,0,78,78,0,1,0,1,0
63495,50584,0,0,66,66,0,1,0,1,0
64808,62413,0,0,66,66,0,1,0,1,0
50535,51505,0,0,66,66,0,1,0,1,0
56127,35440,0,0,62,62,0,1,0,1,0
29706,50584,0,0,66,66,0,1,0,1,0
7561,43890,0,0,66,66,0,1,0,1,0
58962,23,0,0,60,60,0,1,0,1,0
27144,25174,0,0,66,66,0,1,0,1,0
26722,11446,0,0,62,62,0,1,0,1,0
1972,57470,0,0,78,78,0,1,0,1,0
50470,61463,0,0,86,86,0,1,0,1,0
61550,5529,0,0,145,145,0,1,0,1,0
22971,50584,0,0,62,62,0,1,0,1,0
1847,64147,0,0,62,62,0,1,0,1,0
56604,17372,0,0,66,66,0,1,0,1,0
21588,52700,0,0,145,145,0,1,0,1,0
35421,30188,0,0,146,146,0,1,0,1,0
57860,23,0,0,60,60,0,1,0,1,0
51490,1,0,0,100,100,0,1,0,1,0
52459,5555,0,0,60,60,0,1,0,1,0
43657,50011,0,0,62,62,0,1,0,1,0
34400,39004,0,0,74,74,0,1,0,1,0
63852,35440,0,0,66,66,0,1,0,1,0
52410,8604,0,0,66,66,0,1,0,1,0
20012,8443,0,0,60,60,0,1,0,1,0
54997,26467,0,0,66,66,0,1,0,1,0
49711,14984,0,0,66,66,0,1,0,1,0
18750,57866,0,0,62,62,0,1,0,1,0
53143,50584,0,0,66,66,0,1,0,1,0
53089,24211,0,0,66,66,0,1,0,1,0
63855,25174,0,0,62,62,0,1,0,1,0
51401,6881,0,0,62,62,0,1,0,1,0
62673,34159,0,0,66,66,0,1,0,1,0
1040,37965,0,0,62,62,0,1,0,1,0
53957,35440,0,0,62,62,0,1,0,1,0
45169,14037,0,0,74,74,0,1,0,1,0
63920,64147,0,0,66,66,0,1,0,1,0
58638,5900,0,0,62,62,0,1,0,1,0
7048,25174,0,0,66,66,0,1,0,1,0
58638,5900,0,0,62,62,0,1,0,1,0
5223,59023,0,0,66,66,0,1,0,1,0
28498,36237,0,0,146,146,0,1,0,1,0
58664,64147,0,0,66,66,0,1,0,1,0
58638,5900,0,0,62,62,0,1,0,1,0
16387,7205,0,0,60,60,0,1,0,1,0
1027,65473,0,0,159,159,0,1,0,1,0
51096,63710,0,0,66,66,0,1,0,1,0
31845,55777,0,0,62,62,0,1,0,1,0
53257,37450,0,0,62,62,0,1,0,1,0
62415,57470,0,0,66,66,0,1,0,1,0
30179,57470,0,0,60,60,0,1,0,1,0
28649,43890,0,0,66,66,0,1,0,1,0
57131,8055,0,0,145,145,0,1,0,1,0
52812,25174,0,0,66,66,0,1,0,1,0
1873,37965,0,0,62,62,0,1,0,1,0
27828,56205,0,0,146,146,0,1,0,1,0
13970,42873,0,0,62,62,0,1,0,1,0
56582,23718,0,0,66,66,0,1,0,1,0
41885,25174,0,0,66,66,0,1,0,1,0
16387,22272,0,0,60,60,0,1,0,1,0
31021,35440,0,0,62,62,0,1,0,1,0
12986,64147,0,0,62,62,0,1,0,1,0
2923,57470,0,0,66,66,0,1,0,1,0
55386,32480,0,0,66,66,0,1,0,1,0
48676,53395,0,0,60,60,0,1,0,1,0
26560,26467,0,0,66,66,0,1,0,1,0
31691,50584,0,0,62,62,0,1,0,1,0
31995,61689,0,0,146,146,0,1,0,1,0
58638,5900,0,0,62,62,0,1,0,1,0
53097,25174,0,0,66,66,0,1,0,1,0
38852,37965,0,0,62,62,0,1,0,1,0
7222,57470,0,0,62,62,0,1,0,1,0
53156,35993,0,0,66,66,0,1,0,1,0
26651,25174,0,0,62,62,0,1,0,1,0
16693,36237,0,0,66,66,0,1,0,1,0
54071,50265,0,0,66,66,0,1,0,1,0
52988,53567,0,0,66,66,0,1,0,1,0
58638,5900,0,0,62,62,0,1,0,1,0
30303,56301,0,0,169,169,0,1,0,1,0
65494,53,0,0,88,88,0,1,0,1,0
52038,50584,0,0,62,62,0,1,0,1,0
40185,64147,0,0,66,66,0,1,0,1,0
53554,1433,0,0,60,60,0,1,0,1,0
39715,35440,0,0,146,146,0,1,0,1,0
736,23,0,0,60,60,0,1,0,1,0
61250,42873,0,0,66,66,0,1,0,1,0
41908,1433,0,0,60,60,0,1,0,1,0
32710,22114,0,0,62,62,0,1,0,1,0
64990,55442,0,0,66,66,0,1,0,1,0
8889,9794,0,0,60,60,0,1,0,1,0
59371,22114,0,0,62,62,0,1,0,1,0
62341,26467,0,0,66,66,0,1,0,1,0
59051,27520,0,0,62,62,0,1,0,1,0
64379,37965,0,0,66,66,0,1,0,1,0
58638,5900,0,0,62,62,0,1,0,1,0
54236,36829,0,0,66,66,0,1,0,1,0
25179,62609,0,0,148,148,0,1,0,1,0
12107,22114,0,0,62,62,0,1,0,1,0
64808,62413,0,0,62,62,0,1,0,1,0
51754,18375,0,0,66,66,0,1,0,1,0
48676,53395,0,0,60,60,0,1,0,1,0
32342,62413,0,0,66,66,0,1,0,1,0
54989,50265,0,0,66,66,0,1,0,1,0
55435,25174,0,0,62,62,0,1,0,1,0
44453,1433,0,0,60,60,0,1,0,1,0
993,11946,0,0,66,66,0,1,0,1,0
39646,44847,0,0,146,146,0,1,0,1,0
50439,64147,0,0,66,66,0,1,0,1,0
55144,30188,0,0,66,66,0,1,0,1,0
32736,22114,0,0,66,66,0,1,0,1,0
57131,7774,0,0,145,145,0,1,0,1,0
43129,20220,0,0,62,62,0,1,0,1,0
42231,57470,0,0,78,78,0,1,0,1,0
0,0,0,0,98,98,0,1,0,1,0
52975,23718,0,0,62,62,0,1,0,1,0
57131,35776,0,0,145,145,0,1,0,1,0
55386,32480,0,0,62,62,0,1,0,1,0
57325,37965,0,0,62,62,0,1,0,1,0
55248,67,0,0,60,60,0,1,0,1,0
26531,25174,0,0,146,146,0,1,0,1,0
63092,46776,0,0,78,78,0,1,0,1,0
64847,22114,0,0,66,66,0,1,0,1,0
59918,44847,0,0,66,66,0,1,0,1,0
16387,8455,0,0,60,60,0,1,0,1,0
54339,23117,0,0,66,66,0,1,0,1,0
51674,51505,0,0,66,66,0,1,0,1,0
60558,51221,0,0,62,62,0,1,0,1,0
63621,30188,0,0,62,62,0,1,0,1,0
59128,44847,0,0,66,66,0,1,0,1,0
29177,44847,0,0,62,62,0,1,0,1,0
1373,22114,0,0,66,66,0,1,0,1,0
61150,11392,0,0,66,66,0,1,0,1,0
443,35385,0,0,161,161,0,1,0,1,0
6881,6881,0,0,146,146,0,1,0,1,0
2332,35440,0,0,62,62,0,1,0,1,0
63194,50265,0,0,66,66,0,1,0,1,0
2440,37807,0,0,66,66,0,1,0,1,0
20400,64147,0,0,62,62,0,1,0,1,0
52526,30188,0,0,62,62,0,1,0,1,0
58638,5900,0,0,62,62,0,1,0,1,0
24592,50584,0,0,62,62,0,1,0,1,0
3117,37965,0,0,62,62,0,1,0,1,0
65515,22114,0,0,66,66,0,1,0,1,0
57943,1433,0,0,60,60,0,1,0,1,0
5228,3434,0,0,1093,1093,0,1,0,1,0
10003,64147,0,0,62,62,0,1,0,1,0
42453,17,0,0,60,60,0,1,0,1,0
41677,57470,0,0,66,66,0,1,0,1,0
56334,1433,0,0,60,60,0,1,0,1,0
33627,36237,0,0,62,62,0,1,0,1,0
56309,22114,0,0,62,62,0,1,0,1,0
39098,51505,0,0,62,62,0,1,0,1,0
62776,62413,0,0,62,62,0,1,0,1,0
45964,7776,0,0,60,60,0,1,0,1,0
58638,5900,0,0,62,62,0,1,0,1,0
60117,50934,0,0,62,62,0,1,0,1,0
50419,26467,0,0,66,66,0,1,0,1,0
45964,2225,0,0,60,60,0,1,0,1,0
46573,50584,0,0,62,62,0,1,0,1,0
62949,37965,0,0,62,62,0,1,0,1,0
26528,51221,0,0,78,78,0,1,0,1,0
58638,5900,0,0,62,62,0,1,0,1,0
40772,15503,0,0,74,74,0,1,0,1,0
51320,44847,0,0,66,66,0,1,0,1,0
64177,44847,0,0,62,62,0,1,0,1,0
1280,25174,0,0,62,62,0,1,0,1,0
51953,37965,0,0,66,66,0,1,0,1,0
63469,64147,0,0,62,62,0,1,0,1,0
25565,52284,0,0,60,60,0,1,0,1,0
1057,57470,0,0,62,62,0,1,0,1,0
17573,44847,0,0,146,146,0,1,0,1,0
9775,30188,0,0,62,62,0,1,0,1,0
40322,23,0,0,60,60,0,1,0,1,0
47413,23,0,0,60,60,0,1,0,1,0
8868,50584,0,0,146,146,0,1,0,1,0
58638,5900,0,0,62,62,0,1,0,1,0
47561,26467,0,0,62,62,0,1,0,1,0
11256,47967,0,0,143,143,0,1,0,1,0
7347,56205,0,0,66,66,0,1,0,1,0
53120,25174,0,0,62,62,0,1,0,1,0
35657,48637,0,0,62,62,0,1,0,1,0
30274,23,0,0,60,60,0,1,0,1,0
45535,25174,0,0,66,66,0,1,0,1,0
57131,31061,0,0,145,145,0,1,0,1,0
24271,52700,0,0,66,66,0,1,0,1,0
55766,36237,0,0,146,146,0,1,0,1,0
34360,25174,0,0,66,66,0,1,0,1,0
5223,5025,0,0,220,220,0,1,0,1,0
57131,31061,0,0,145,145,0,1,0,1,0
47771,25174,0,0,62,62,0,1,0,1,0
21750,39004,0,0,66,66,0,1,0,1,0
51963,22114,0,0,66,66,0,1,0,1,0
60823,25174,0,0,66,66,0,1,0,1,0
1865,25174,0,0,146,146,0,1,0,1,0
52838,37965,0,0,66,66,0,1,0,1,0
64808,27098,0,0,66,66,0,1,0,1,0
54043,36237,0,0,62,62,0,1,0,1,0
443,20087,0,0,83,83,0,1,0,1,0
47910,7454,0,0,60,60,0,1,0,1,0
53300,37807,0,0,66,66,0,1,0,1,0
19610,9571,0,0,62,62,0,1,0,1,0
59668,51505,0,0,66,66,0,1,0,1,0
56679,51505,0,0,62,62,0,1,0,1,0
63079,64147,0,0,62,62,0,1,0,1,0
1028,62609,0,0,148,148,0,1,0,1,0
50529,44847,0,0,66,66,0,1,0,1,0
36120,57470,0,0,145,145,0,1,0,1,0
57585,51221,0,0,62,62,0,1,0,1,0
12545,25174,0,0,62,62,0,1,0,1,0
60425,15503,0,0,145,145,0,1,0,1,0
16327,55442,0,0,66,66,0,1,0,1,0
26391,44847,0,0,146,146,0,1,0,1,0
50326,46824,0,0,66,66,0,1,0,1,0
63221,53436,0,0,62,62,0,1,0,1,0
42228,51050,0,0,66,66,0,1,0,1,0
51313,25174,0,0,66,66,0,1,0,1,0
64279,23718,0,0,62,62,0,1,0,1,0
11967,57470,0,0,62,62,0,1,0,1,0
61898,50584,0,0,66,66,0,1,0,1,0
58638,5900,0,0,62,62,0,1,0,1,0
64150,22114,0,0,66,66,0,1,0,1,0
28064,36237,0,0,62,62,0,1,0,1,0
51164,64147,0,0,62,62,0,1,0,1,0
54593,51505,0,0,66,66,0,1,0,1,0
21817,22114,0,0,62,62,0,1,0,1,0
59400,22114,0,0,66,66,0,1,0,1,0
13588,15503,0,0,62,62,0,1,0,1,0
59755,44512,0,0,66,66,0,1,0,1,0
6141,23,0,0,60,60,0,1,0,1,0
58007,62413,0,0,66,66,0,1,0,1,0
30304,64147,0,0,62,62,0,1,0,1,0
45908,33330,0,0,60,60,0,1,0,1,0
51172,44847,0,0,62,62,0,1,0,1,0
64051,36829,0,0,66,66,0,1,0,1,0
443,45788,0,0,332,332,0,1,0,1,0
59937,37965,0,0,66,66,0,1,0,1,0
53957,35440,0,0,62,62,0,1,0,1,0
26229,21247,0,0,66,66,0,1,0,1,0
58638,5900,0,0,62,62,0,1,0,1,0
7160,34317,0,0,146,146,0,1,0,1,0
35261,15503,0,0,74,74,0,1,0,1,0
28973,30188,0,0,66,66,0,1,0,1,0
11876,22,0,0,60,60,0,1,0,1,0
57233,50934,0,0,66,66,0,1,0,1,0
17097,62413,0,0,62,62,0,1,0,1,0
54742,37965,0,0,66,66,0,1,0,1,0
64283,37965,0,0,74,74,0,1,0,1,0
60771,58414,0,0,62,62,0,1,0,1,0
58007,62413,0,0,62,62,0,1,0,1,0
53459,37807,0,0,146,146,0,1,0,1,0
57797,64147,0,0,66,66,0,1,0,1,0
53771,57470,0,0,66,66,0,1,0,1,0
56100,57470,0,0,62,62,0,1,0,1,0
46093,32661,0,0,74,74,0,1,0,1,0
7356,25174,0,0,66,66,0,1,0,1,0
48706,23393,0,0,60,60,0,1,0,1,0
3584,25174,0,0,62,62,0,1,0,1,0
1040,6004,0,0,72,72,0,1,0,1,0
64392,25174,0,0,66,66,0,1,0,1,0
40512,57470,0,0,74,74,0,1,0,1,0
45981,51505,0,0,62,62,0,1,0,1,0
37075,48817,0,0,62,62,0,1,0,1,0
13559,57866,0,0,66,66,0,1,0,1,0
46557,57866,0,0,66,66,0,1,0,1,0
12348,50265,0,0,62,62,0,1,0,1,0
9246,35440,0,0,62,62,0,1,0,1,0
53579,42707,0,0,66,66,0,1,0,1,0
3478,61463,0,0,918,918,0,1,0,1,0
50716,50584,0,0,74,74,0,1,0,1,0
8080,37965,0,0,62,62,0,1,0,1,0
58724,43890,0,0,66,66,0,1,0,1,0
63852,25174,0,0,62,62,0,1,0,1,0
5228,3434,0,0,345,345,0,1,0,1,0
58131,3855,0,0,146,146,0,1,0,1,0
48706,23393,0,0,60,60,0,1,0,1,0
58638,5900,0,0,62,62,0,1,0,1,0
57545,35440,0,0,66,66,0,1,0,1,0
50235,5900,0,0,60,60,0,1,0,1,0
54142,20541,0,0,66,66,0,1,0,1,0
26879,37965,0,0,62,62,0,1,0,1,0
25015,64147,0,0,66,66,0,1,0,1,0
59037,51505,0,0,66,66,0,1,0,1,0
46837,57470,0,0,62,62,0,1,0,1,0
63527,50584,0,0,66,66,0,1,0,1,0
58023,47808,0,0,60,60,0,1,0,1,0
11983,57470,0,0,62,62,0,1,0,1,0
51740,37965,0,0,66,66,0,1,0,1,0
62388,39004,0,0,145,145,0,1,0,1,0
52166,26467,0,0,66,66,0,1,0,1,0
2740,22,0,0,60,60,0,1,0,1,0
57698,64147,0,0,66,66,0,1,0,1,0
45941,23386,0,0,60,60,0,1,0,1,0
58922,57470,0,0,66,66,0,1,0,1,0
51085,56205,0,0,66,66,0,1,0,1,0
10669,49756,0,0,60,60,0,1,0,1,0
50570,57470,0,0,66,66,0,1,0,1,0
24910,64147,0,0,66,66,0,1,0,1,0
48996,22114,0,0,146,146,0,1,0,1,0
19416,23,0,0,60,60,0,1,0,1,0
50292,62413,0,0,146,146,0,1,0,1,0
52439,35894,0,0,70,70,0,1,0,1,0
7364,50584,0,0,66,66,0,1,0,1,0
63988,50584,0,0,62,62,0,1,0,1,0
63467,37807,0,0,62,62,0,1,0,1,0
27844,52700,0,0,74,74,0,1,0,1,0
30782,36237,0,0,62,62,0,1,0,1,0
25101,50584,0,0,62,62,0,1,0,1,0
13062,52752,0,0,66,66,0,1,0,1,0
11023,51505,0,0,66,66,0,1,0,1,0
46491,50584,0,0,66,66,0,1,0,1,0
2278,25174,0,0,146,146,0,1,0,1,0
56152,56205,0,0,66,66,0,1,0,1,0
57633,50584,0,0,146,146,0,1,0,1,0
26263,8168,0,0,66,66,0,1,0,1,0
7285,51221,0,0,66,66,0,1,0,1,0
52128,37807,0,0,66,66,0,1,0,1,0
60806,51050,0,0,66,66,0,1,0,1,0
62257,2767,0,0,66,66,0,1,0,1,0
58638,5900,0,0,62,62,0,1,0,1,0
9522,51505,0,0,66,66,0,1,0,1,0
4545,1900,0,0,136,136,0,1,0,1,0
60438,17372,0,0,66,66,0,1,0,1,0
31691,50584,0,0,146,146,0,1,0,1,0
5912,22114,0,0,62,62,0,1,0,1,0
443,20995,0,0,83,83,0,1,0,1,0
2828,35253,0,0,66,66,0,1,0,1,0
47040,25174,0,0,62,62,0,1,0,1,0
50367,37965,0,0,66,66,0,1,0,1,0
14263,22114,0,0,62,62,0,1,0,1,0
28221,37965,0,0,62,62,0,1,0,1,0
13285,29892,0,0,145,145,0,1,0,1,0
61981,9000,0,0,60,60,0,1,0,1,0
17008,35440,0,0,62,62,0,1,0,1,0
48706,23393,0,0,60,60,0,1,0,1,0
63213,35440,0,0,146,146,0,1,0,1,0
60223,67,0,0,60,60,0,1,0,1,0
19885,64147,0,0,62,62,0,1,0,1,0
31130,30188,0,0,66,66,0,1,0,1,0
58564,50432,0,0,66,66,0,1,0,1,0
52064,22114,0,0,66,66,0,1,0,1,0
33502,5529,0,0,143,143,0,1,0,1,0
48676,53398,0,0,60,60,0,1,0,1,0
13528,51221,0,0,62,62,0,1,0,1,0
15249,22114,0,0,62,62,0,1,0,1,0
64387,37965,0,0,66,66,0,1,0,1,0
22971,50584,0,0,62,62,0,1,0,1,0
31404,46232,0,0,100,100,0,1,0,1,0
2422,50584,0,0,66,66,0,1,0,1,0
60297,25604,0,0,62,62,0,1,0,1,0
57015,42707,0,0,62,62,0,1,0,1,0
40254,25174,0,0,62,62,0,1,0,1,0
35163,30188,0,0,66,66,0,1,0,1,0
25565,50263,0,0,60,60,0,1,0,1,0
19875,30170,0,0,145,145,0,1,0,1,0
59949,44847,0,0,62,62,0,1,0,1,0
27679,37965,0,0,62,62,0,1,0,1,0
58888,23718,0,0,62,62,0,1,0,1,0
60311,30627,0,0,66,66,0,1,0,1,0
43076,23,0,0,60,60,0,1,0,1,0
49277,51505,0,0,66,66,0,1,0,1,0
58638,5900,0,0,62,62,0,1,0,1,0
33292,50584,0,0,62,62,0,1,0,1,0
39195,25174,0,0,146,146,0,1,0,1,0
58213,37807,0,0,66,66,0,1,0,1,0
51233,43890,0,0,66,66,0,1,0,1,0
30129,37965,0,0,72,72,0,1,0,1,0
28668,8696,0,0,60,60,0,1,0,1,0
53408,50243,0,0,145,145,0,1,0,1,0
68,67,0,0,346,346,0,1,0,1,0
11136,15503,0,0,145,145,0,1,0,1,0
59592,37965,0,0,62,62,0,1,0,1,0
26480,64147,0,0,62,62,0,1,0,1,0
35570,22114,0,0,62,62,0,1,0,1,0
62973,51505,0,0,62,62,0,1,0,1,0
60646,11392,0,0,66,66,0,1,0,1,0
63041,50584,0,0,62,62,0,1,0,1,0
58195,38303,0,0,66,66,0,1,0,1,0
49812,26467,0,0,62,62,0,1,0,1,0
16086,6881,0,0,146,146,0,1,0,1,0
51453,64147,0,0,66,66,0,1,0,1,0
60361,57470,0,0,62,62,0,1,0,1,0
3478,61463,0,0,1345,1345,0,1,0,1,0
10145,21247,0,0,62,62,0,1,0,1,0
6881,10104,0,0,107,107,0,1,0,1,0
64755,31573,0,0,66,66,0,1,0,1,0
31978,57470,0,0,60,60,0,1,0,1,0
1024,64147,0,0,109,109,0,1,0,1,0
31410,25174,0,0,146,146,0,1,0,1,0
54094,5900,0,0,60,60,0,1,0,1,0
1266,57470,0,0,146,146,0,1,0,1,0
3478,61463,0,0,1118,1118,0,1,0,1,0
62632,35440,0,0,66,66,0,1,0,1,0
58635,51505,0,0,62,62,0,1,0,1,0
42722,56448,0,0,74,74,0,1,0,1,0
53207,50584,0,0,66,66,0,1,0,1,0
50210,26467,0,0,62,62,0,1,0,1,0
51429,22114,0,0,66,66,0,1,0,1,0
7877,22114,0,0,66,66,0,1,0,1,0
63690,64147,0,0,62,62,0,1,0,1,0
11842,35440,0,0,66,66,0,1,0,1,0
55161,37807,0,0,62,62,0,1,0,1,0
993,4543,0,0,66,66,0,1,0,1,0
60128,22114,0,0,62,62,0,1,0,1,0
61192,35440,0,0,146,146,0,1,0,1,0
44933,26467,0,0,62,62,0,1,0,1,0
443,18368,0,0,60,60,0,1,0,1,0
53227,64097,0,0,66,66,0,1,0,1,0
31654,65473,0,0,148,148,0,1,0,1,0
23383,64147,0,0,62,62,0,1,0,1,0
59772,62413,0,0,62,62,0,1,0,1,0
45941,23386,0,0,60,60,0,1,0,1,0
1029,44847,0,0,62,62,0,1,0,1,0
20650,26467,0,0,66,66,0,1,0,1,0
16221,50584,0,0,62,62,0,1,0,1,0
443,62451,0,0,199,199,0,1,0,1,0
50052,65010,0,0,60,60,0,1,0,1,0
58638,5900,0,0,62,62,0,1,0,1,0
16387,64075,0,0,60,60,0,1,0,1,0
58638,5900,0,0,62,62,0,1,0,1,0
1054,15503,0,0,62,62,0,1,0,1,0
41490,25174,0,0,62,62,0,1,0,1,0
23650,37807,0,0,62,62,0,1,0,1,0
57607,21247,0,0,66,66,0,1,0,1,0
63589,44847,0,0,66,66,0,1,0,1,0
10050,31573,0,0,146,146,0,1,0,1,0
56386,50584,0,0,62,62,0,1,0,1,0
62907,21,0,0,60,60,0,1,0,1,0
50394,25174,0,0,62,62,0,1,0,1,0
55421,57470,0,0,74,74,0,1,0,1,0
7000,23117,0,0,62,62,0,1,0,1,0
57550,50584,0,0,66,66,0,1,0,1,0
51999,37965,0,0,62,62,0,1,0,1,0
58681,36829,0,0,70,70,0,1,0,1,0
35589,25174,0,0,66,66,0,1,0,1,0
47173,35440,0,0,62,62,0,1,0,1,0
16387,44427,0,0,60,60,0,1,0,1,0
443,43990,0,0,74,74,0,1,0,1,0
14309,56205,0,0,62,62,0,1,0,1,0
443,5920,0,0,66,66,0,1,0,1,0
51414,22,0,0,60,60,0,1,0,1,0
63583,37965,0,0,66,66,0,1,0,1,0
44127,30188,0,0,146,146,0,1,0,1,0
57131,7774,0,0,145,145,0,1,0,1,0
34677,51185,0,0,60,60,0,1,0,1,0
16387,35244,0,0,60,60,0,1,0,1,0
58638,5900,0,0,62,62,0,1,0,1,0
50772,35440,0,0,66,66,0,1,0,1,0
58638,5900,0,0,62,62,0,1,0,1,0
32704,46824,0,0,66,66,0,1,0,1,0
21604,50201,0,0,66,66,0,1,0,1,0
45908,33330,0,0,60,60,0,1,0,1,0
52340,22114,0,0,66,66,0,1,0,1,0
52494,36237,0,0,62,62,0,1,0,1,0
19632,37965,0,0,62,62,0,1,0,1,0
53437,44847,0,0,62,62,0,1,0,1,0
58638,5900,0,0,62,62,0,1,0,1,0
51674,51505,0,0,66,66,0,1,0,1,0
1092,57470,0,0,145,145,0,1,0,1,0
53178,26467,0,0,62,62,0,1,0,1,0
27160,64147,0,0,62,62,0,1,0,1,0
43271,50584,0,0,62,62,0,1,0,1,0
8239,37965,0,0,146,146,0,1,0,1,0
7166,64147,0,0,66,66,0,1,0,1,0
58638,5900,0,0,62,62,0,1,0,1,0
61766,44847,0,0,62,62,0,1,0,1,0
11066,50584,0,0,66,66,0,1,0,1,0
52690,7302,0,0,66,66,0,1,0,1,0
58638,5900,0,0,62,62,0,1,0,1,0
16687,10214,0,0,66,66,0,1,0,1,0
45964,2666,0,0,60,60,0,1,0,1,0
26092,23,0,0,60,60,0,1,0,1,0
43584,24748,0,0,156,156,0,1,0,1,0
29989,26467,0,0,66,66,0,1,0,1,0
49752,50584,0,0,62,62,0,1,0,1,0
57793,37807,0,0,66,66,0,1,0,1,0
40099,23,0,0,60,60,0,1,0,1,0
61730,25320,0,0,62,62,0,1,0,1,0
51183,56205,0,0,66,66,0,1,0,1,0
22583,9822,0,0,62,62,0,1,0,1,0
55539,57470,0,0,66,66,0,1,0,1,0
56952,22114,0,0,146,146,0,1,0,1,0
47727,25174,0,0,146,146,0,1,0,1,0
65422,26467,0,0,62,62,0,1,0,1,0
55968,56205,0,0,66,66,0,1,0,1,0
54737,50584,0,0,66,66,0,1,0,1,0
33359,30188,0,0,66,66,0,1,0,1,0
35232,36602,0,0,74,74,0,1,0,1,0
42285,57470,0,0,62,62,0,1,0,1,0
6666,62078,0,0,60,60,0,1,0,1,0
9219,32480,0,0,72,72,0,1,0,1,0
45964,3111,0,0,60,60,0,1,0,1,0
24589,10197,0,0,145,145,0,1,0,1,0
1114,46824,0,0,62,62,0,1,0,1,0
16387,3655,0,0,60,60,0,1,0,1,0
46640,8880,0,0,60,60,0,1,0,1,0
1431,30041,0,0,62,62,0,1,0,1,0
57523,25174,0,0,146,146,0,1,0,1,0
1446,35440,0,0,62,62,0,1,0,1,0
44411,37965,0,0,62,62,0,1,0,1,0
10547,57470,0,0,62,62,0,1,0,1,0
45941,23386,0,0,60,60,0,1,0,1,0
49356,50584,0,0,62,62,0,1,0,1,0
45941,23388,0,0,60,60,0,1,0,1,0
52836,36829,0,0,62,62,0,1,0,1,0
44821,64147,0,0,62,62,0,1,0,1,0
58638,5900,0,0,62,62,0,1,0,1,0
17781,50265,0,0,62,62,0,1,0,1,0
3478,61463,0,0,982,982,0,1,0,1,0
7977,25174,0,0,62,62,0,1,0,1,0
62819,56205,0,0,62,62,0,1,0,1,0
53577,35894,0,0,62,62,0,1,0,1,0
35812,1,0,0,146,146,0,1,0,1,0
10115,52700,0,0,62,62,0,1,0,1,0
57020,36237,0,0,66,66,0,1,0,1,0
443,61686,0,0,1484,1484,0,1,0,1,0
50470,61463,0,0,86,86,0,1,0,1,0
44378,995,0,0,60,60,0,1,0,1,0
51564,50584,0,0,66,66,0,1,0,1,0
51148,9571,0,0,66,66,0,1,0,1,0
1027,9822,0,0,146,146,0,1,0,1,0
56564,9571,0,0,78,78,0,1,0,1,0
3875,25174,0,0,146,146,0,1,0,1,0
52781,57470,0,0,66,66,0,1,0,1,0
49805,64147,0,0,66,66,0,1,0,1,0
23900,64147,0,0,62,62,0,1,0,1,0
50360,35440,0,0,62,62,0,1,0,1,0
58638,5900,0,0,62,62,0,1,0,1,0
33328,25174,0,0,62,62,0,1,0,1,0
6712,123,0,0,90,90,0,1,0,1,0
63577,30188,0,0,66,66,0,1,0,1,0
59147,51505,0,0,66,66,0,1,0,1,0
49915,35440,0,0,146,146,0,1,0,1,0
5223,21557,0,0,60,60,0,1,0,1,0
65495,11392,0,0,66,66,0,1,0,1,0
58876,57470,0,0,66,66,0,1,0,1,0
21674,28189,0,0,60,60,0,1,0,1,0
57090,51505,0,0,62,62,0,1,0,1,0
44922,57470,0,0,74,74,0,1,0,1,0
25363,22114,0,0,66,66,0,1,0,1,0
35558,15503,0,0,66,66,0,1,0,1,0
58638,5900,0,0,62,62,0,1,0,1,0
443,60496,0,0,320,320,0,1,0,1,0
52699,25174,0,0,66,66,0,1,0,1,0
45726,64147,0,0,62,62,0,1,0,1,0
16490,25174,0,0,62,62,0,1,0,1,0
39824,51505,0,0,62,62,0,1,0,1,0
34301,21247,0,0,62,62,0,1,0,1,0
64546,57470,0,0,66,66,0,1,0,1,0
61369,64147,0,0,62,62,0,1,0,1,0
44147,64147,0,0,62,62,0,1,0,1,0
52430,22114,0,0,62,62,0,1,0,1,0
58638,5900,0,0,62,62,0,1,0,1,0
42417,22114,0,0,62,62,0,1,0,1,0
61218,22114,0,0,66,66,0,1,0,1,0
64036,23718,0,0,62,62,0,1,0,1,0
26084,36237,0,0,62,62,0,1,0,1,0
40967,1433,0,0,60,60,0,1,0,1,0
14208,51221,0,0,66,66,0,1,0,1,0
39100,2767,0,0,62,62,0,1,0,1,0
45855,25174,0,0,146,146,0,1,0,1,0
51271,37965,0,0,66,66,0,1,0,1,0
28899,37965,0,0,62,62,0,1,0,1,0
23632,64147,0,0,66,66,0,1,0,1,0
49386,64147,0,0,62,62,0,1,0,1,0
53160,25174,0,0,62,62,0,1,0,1,0
7720,44847,0,0,66,66,0,1,0,1,0
35570,22114,0,0,62,62,0,1,0,1,0
43840,50265,0,0,72,72,0,1,0,1,0
5222,7493,0,0,66,66,0,1,0,1,0
14567,37965,0,0,62,62,0,1,0,1,0
65216,35440,0,0,66,66,0,1,0,1,0
4961,62741,0,0,66,66,0,1,0,1,0
57698,64147,0,0,66,66,0,1,0,1,0
65398,7129,0,0,62,62,0,1,0,1,0
11133,51505,0,0,66,66,0,1,0,1,0
60861,25174,0,0,66,66,0,1,0,1,0
14656,36237,0,0,62,62,0,1,0,1,0
61911,1,0,0,146,146,0,1,0,1,0
57896,1,0,0,100,100,0,1,0,1,0
16376,35440,0,0,62,62,0,1,0,1,0
3964,51505,0,0,62,62,0,1,0,1,0
52459,33890,0,0,60,60,0,1,0,1,0
12530,35440,0,0,62,62,0,1,0,1,0
7210,22114,0,0,62,62,0,1,0,1,0
13021,25174,0,0,62,62,0,1,0,1,0
20706,37965,0,0,62,62,0,1,0,1,0
18652,64147,0,0,62,62,0,1,0,1,0
6889,47807,0,0,143,143,0,1,0,1,0
30039,7363,0,0,145,145,0,1,0,1,0
54858,51505,0,0,62,62,0,1,0,1,0
50920,60182,0,0,66,66,0,1,0,1,0
32282,8604,0,0,66,66,0,1,0,1,0
6975,26543,0,0,139,139,0,1,0,1,0
63080,37965,0,0,66,66,0,1,0,1,0
12471,31573,0,0,62,62,0,1,0,1,0
7435,62609,0,0,148,148,0,1,0,1,0
40239,22114,0,0,146,146,0,1,0,1,0
49182,21247,0,0,66,66,0,1,0,1,0
58638,5900,0,0,62,62,0,1,0,1,0
3478,61463,0,0,1262,1262,0,1,0,1,0
54280,3385,0,0,60,60,0,1,0,1,0
54976,15503,0,0,66,66,0,1,0,1,0
3074,64147,0,0,62,62,0,1,0,1,0
1027,64147,0,0,62,62,0,1,0,1,0
29989,26467,0,0,66,66,0,1,0,1,0
45472,8168,0,0,62,62,0,1,0,1,0
58638,5900,0,0,62,62,0,1,0,1,0
50084,26672,0,0,62,62,0,1,0,1,0
63321,37807,0,0,66,66,0,1,0,1,0
54530,35440,0,0,66,66,0,1,0,1,0
57846,57866,0,0,66,66,0,1,0,1,0
443,49313,0,0,97,97,0,1,0,1,0
58398,44847,0,0,62,62,0,1,0,1,0
29989,26467,0,0,62,62,0,1,0,1,0
2849,30188,0,0,62,62,0,1,0,1,0
17781,50265,0,0,145,145,0,1,0,1,0
60435,35440,0,0,62,62,0,1,0,1,0
58638,5900,0,0,62,62,0,1,0,1,0
49248,35993,0,0,66,66,0,1,0,1,0
15249,22114,0,0,62,62,0,1,0,1,0
18950,50584,0,0,146,146,0,1,0,1,0
45964,2225,0,0,60,60,0,1,0,1,0
2062,35440,0,0,66,66,0,1,0,1,0
46516,57470,0,0,62,62,0,1,0,1,0
64036,23718,0,0,66,66,0,1,0,1,0
2598,23718,0,0,62,62,0,1,0,1,0
34553,48637,0,0,60,60,0,1,0,1,0
37927,50265,0,0,66,66,0,1,0,1,0
26448,9192,0,0,145,145,0,1,0,1,0
59696,57470,0,0,62,62,0,1,0,1,0
53712,25174,0,0,66,66,0,1,0,1,0
10333,22114,0,0,62,62,0,1,0,1,0
23306,25174,0,0,146,146,0,1,0,1,0
7222,57470,0,0,62,62,0,1,0,1,0
18357,51180,0,0,62,62,0,1,0,1,0
37887,22114,0,0,66,66,0,1,0,1,0
9605,57470,0,0,62,62,0,1,0,1,0
53539,44847,0,0,66,66,0,1,0,1,0
53318,22114,0,0,66,66,0,1,0,1,0
1284,50584,0,0,62,62,0,1,0,1,0
61522,64147,0,0,62,62,0,1,0,1,0
21733,56205,0,0,66,66,0,1,0,1,0
16361,60888,0,0,146,146,0,1,0,1,0
50734,37965,0,0,62,62,0,1,0,1,0
58791,25174,0,0,62,62,0,1,0,1,0
30879,35440,0,0,146,146,0,1,0,1,0
57459,51505,0,0,66,66,0,1,0,1,0
65270,3855,0,0,78,78,0,1,0,1,0
58638,5900,0,0,62,62,0,1,0,1,0
45837,25174,0,0,146,146,0,1,0,1,0
2531,30188,0,0,62,62,0,1,0,1,0
58638,5900,0,0,62,62,0,1,0,1,0
58638,5900,0,0,62,62,0,1,0,1,0
44529,6881,0,0,146,146,0,1,0,1,0
63786,25174,0,0,62,62,0,1,0,1,0
58638,5900,0,0,62,62,0,1,0,1,0
63447,44847,0,0,62,62,0,1,0,1,0
33193,50584,0,0,62,62,0,1,0,1,0
3478,61463,0,0,1262,1262,0,1,0,1,0
58638,5900,0,0,62,62,0,1,0,1,0
58118,22114,0,0,62,62,0,1,0,1,0
63708,25174,0,0,66,66,0,1,0,1,0
64824,37965,0,0,62,62,0,1,0,1,0
8999,57470,0,0,146,146,0,1,0,1,0
62088,56205,0,0,62,62,0,1,0,1,0
45941,23386,0,0,60,60,0,1,0,1,0
58638,5900,0,0,62,62,0,1,0,1,0
11252,23,0,0,60,60,0,1,0,1,0
61477,57470,0,0,66,66,0,1,0,1,0
61185,54532,0,0,62,62,0,1,0,1,0
3377,50584,0,0,66,66,0,1,0,1,0
53189,62413,0,0,62,62,0,1,0,1,0
56688,25174,0,0,66,66,0,1,0,1,0
62408,50584,0,0,66,66,0,1,0,1,0
55968,56205,0,0,66,66,0,1,0,1,0
39810,48817,0,0,148,148,0,1,0,1,0
24073,22114,0,0,62,62,0,1,0,1,0
1821,64147,0,0,66,66,0,1,0,1,0
64013,57470,0,0,74,74,0,1,0,1,0
50470,61463,0,0,86,86,0,1,0,1,0
48258,37965,0,0,62,62,0,1,0,1,0
65259,37965,0,0,66,66,0,1,0,1,0
62424,37965,0,0,66,66,0,1,0,1,0
2062,35440,0,0,66,66,0,1,0,1,0
59679,37807,0,0,66,66,0,1,0,1,0
36419,50584,0,0,62,62,0,1,0,1,0
39996,23,0,0,60,60,0,1,0,1,0
33193,50584,0,0,146,146,0,1,0,1,0
55043,57470,0,0,78,78,0,1,0,1,0
7286,44847,0,0,66,66,0,1,0,1,0
50798,36237,0,0,62,62,0,1,0,1,0
58638,5900,0,0,62,62,0,1,0,1,0
16387,8455,0,0,60,60,0,1,0,1,0
49036,44847,0,0,62,62,0,1,0,1,0
54769,50584,0,0,62,62,0,1,0,1,0
58638,5900,0,0,62,62,0,1,0,1,0
58129,26467,0,0,62,62,0,1,0,1,0
17947,36237,0,0,62,62,0,1,0,1,0
62765,16933,0,0,66,66,0,1,0,1,0
56966,35440,0,0,62,62,0,1,0,1,0
443,10010,0,0,60,60,0,1,0,1,0
33896,57470,0,0,74,74,0,1,0,1,0
64346,51505,0,0,66,66,0,1,0,1,0
11344,42873,0,0,62,62,0,1,0,1,0
63467,37807,0,0,62,62,0,1,0,1,0
51745,57470,0,0,145,145,0,1,0,1,0
45908,33330,0,0,60,60,0,1,0,1,0
58338,3362,0,0,60,60,0,1,0,1,0
62654,35440,0,0,62,62,0,1,0,1,0
62194,50584,0,0,66,66,0,1,0,1,0
17315,11392,0,0,66,66,0,1,0,1,0
23379,57866,0,0,146,146,0,1,0,1,0
30114,65151,0,0,60,60,0,1,0,1,0
15180,26467,0,0,62,62,0,1,0,1,0
2622,25174,0,0,146,146,0,1,0,1,0
60260,22114,0,0,66,66,0,1,0,1,0
1143,25174,0,0,62,62,0,1,0,1,0
59739,35253,0,0,62,62,0,1,0,1,0
62148,37965,0,0,62,62,0,1,0,1,0
57860,51505,0,0,66,66,0,1,0,1,0
57441,57470,0,0,66,66,0,1,0,1,0
443,20995,0,0,83,83,0,1,0,1,0
49629,26467,0,0,66,66,0,1,0,1,0
58638,5900,0,0,62,62,0,1,0,1,0
5223,21557,0,0,91,91,0,1,0,1,0
37633,44847,0,0,62,62,0,1,0,1,0
64878,26467,0,0,62,62,0,1,0,1,0
14615,57866,0,0,66,66,0,1,0,1,0
58638,5900,0,0,62,62,0,1,0,1,0
22714,30188,0,0,62,62,0,1,0,1,0
51769,51505,0,0,66,66,0,1,0,1,0
19634,64147,0,0,62,62,0,1,0,1,0
29706,50584,0,0,62,62,0,1,0,1,0
27995,22114,0,0,62,62,0,1,0,1,0
48692,57470,0,0,62,62,0,1,0,1,0
3564,57470,0,0,62,62,0,1,0,1,0
39119,44847,0,0,62,62,0,1,0,1,0
58638,5900,0,0,62,62,0,1,0,1,0
57478,7302,0,0,66,66,0,1,0,1,0
10381,22114,0,0,62,62,0,1,0,1,0
61840,25174,0,0,62,62,0,1,0,1,0
3117,37965,0,0,62,62,0,1,0,1,0
52321,26467,0,0,62,62,0,1,0,1,0
50334,64147,0,0,66,66,0,1,0,1,0
50113,51505,0,0,62,62,0,1,0,1,0
65085,22114,0,0,66,66,0,1,0,1,0
26528,51221,0,0,78,78,0,1,0,1,0
50609,2323,0,0,60,60,0,1,0,1,0
51262,35440,0,0,66,66,0,1,0,1,0
27063,25174,0,0,62,62,0,1,0,1,0
51413,54351,0,0,136,136,0,1,0,1,0
58638,5900,0,0,62,62,0,1,0,1,0
63098,35440,0,0,62,62,0,1,0,1,0
13285,29892,0,0,145,145,0,1,0,1,0
27841,35894,0,0,62,62,0,1,0,1,0
35319,51505,0,0,146,146,0,1,0,1,0
28139,22114,0,0,62,62,0,1,0,1,0
50974,11392,0,0,66,66,0,1,0,1,0
60018,64147,0,0,62,62,0,1,0,1,0
24731,51505,0,0,62,62,0,1,0,1,0
61382,25174,0,0,66,66,0,1,0,1,0
61838,37965,0,0,66,66,0,1,0,1,0
10416,64147,0,0,62,62,0,1,0,1,0
55735,50584,0,0,62,62,0,1,0,1,0
64767,51221,0,0,62,62,0,1,0,1,0
25063,64147,0,0,62,62,0,1,0,1,0
56216,50584,0,0,62,62,0,1,0,1,0
65179,44847,0,0,66,66,0,1,0,1,0
58103,10197,0,0,66,66,0,1,0,1,0
50644,35440,0,0,66,66,0,1,0,1,0
25150,25174,0,0,62,62,0,1,0,1,0
16387,20045,0,0,60,60,0,1,0,1,0
25091,64147,0,0,66,66,0,1,0,1,0
45964,55559,0,0,60,60,0,1,0,1,0
58638,5900,0,0,62,62,0,1,0,1,0
45964,3111,0,0,60,60,0,1,0,1,0
14924,44847,0,0,62,62,0,1,0,1,0
53650,64147,0,0,66,66,0,1,0,1,0
61600,56205,0,0,66,66,0,1,0,1,0
0,0,0,0,98,98,0,1,0,1,0
21998,51221,0,0,62,62,0,1,0,1,0
19747,37965,0,0,62,62,0,1,0,1,0
58638,5900,0,0,62,62,0,1,0,1,0
58638,5900,0,0,62,62,0,1,0,1,0
8999,64910,0,0,146,146,0,1,0,1,0
57073,57470,0,0,62,62,0,1,0,1,0
46576,23718,0,0,62,62,0,1,0,1,0
6882,64147,0,0,146,146,0,1,0,1,0
57729,19750,0,0,66,66,0,1,0,1,0
38253,23117,0,0,146,146,0,1,0,1,0
48513,44847,0,0,146,146,0,1,0,1,0
64697,37965,0,0,66,66,0,1,0,1,0
64382,44847,0,0,62,62,0,1,0,1,0
16319,44847,0,0,62,62,0,1,0,1,0
0,0,0,0,70,70,0,1,0,1,0
9529,26467,0,0,62,62,0,1,0,1,0
32342,62413,0,0,62,62,0,1,0,1,0
42285,57470,0,0,62,62,0,1,0,1,0
50765,22114,0,0,66,66,0,1,0,1,0
58638,5900,0,0,62,62,0,1,0,1,0
443,52365,0,0,97,97,0,1,0,1,0
58884,23,0,0,60,60,0,1,0,1,0
53608,39004,0,0,66,66,0,1,0,1,0
44044,23,0,0,60,60,0,1,0,1,0
41165,23,0,0,60,60,0,1,0,1,0
11907,57470,0,0,66,66,0,1,0,1,0
25772,7302,0,0,66,66,0,1,0,1,0
62792,53,0,0,88,88,0,1,0,1,0
54365,64147,0,0,62,62,0,1,0,1,0
62242,44512,0,0,66,66,0,1,0,1,0
43350,58414,0,0,66,66,0,1,0,1,0
44919,26467,0,0,62,62,0,1,0,1,0
54539,26467,0,0,62,62,0,1,0,1,0
49629,26467,0,0,62,62,0,1,0,1,0
62400,35993,0,0,66,66,0,1,0,1,0
57479,56205,0,0,66,66,0,1,0,1,0
56494,15503,0,0,146,146,0,1,0,1,0
11136,19910,0,0,62,62,0,1,0,1,0
15899,37807,0,0,146,146,0,1,0,1,0
54796,22114,0,0,66,66,0,1,0,1,0
8239,37965,0,0,146,146,0,1,0,1,0
58638,5900,0,0,62,62,0,1,0,1,0
25207,48817,0,0,62,62,0,1,0,1,0
6461,25174,0,0,66,66,0,1,0,1,0
39098,51505,0,0,62,62,0,1,0,1,0
19623,25174,0,0,62,62,0,1,0,1,0
10072,25174,0,0,62,62,0,1,0,1,0
53928,15503,0,0,62,62,0,1,0,1,0
46936,35440,0,0,62,62,0,1,0,1,0
50949,45960,0,0,62,62,0,1,0,1,0
49717,57470,0,0,62,62,0,1,0,1,0
37420,44847,0,0,62,62,0,1,0,1,0
1794,22114,0,0,146,146,0,1,0,1,0
62649,48817,0,0,148,148,0,1,0,1,0
62682,23,0,0,60,60,0,1,0,1,0
51313,25174,0,0,66,66,0,1,0,1,0
23383,64147,0,0,62,62,0,1,0,1,0
58638,5900,0,0,62,62,0,1,0,1,0
45682,1,0,0,62,62,0,1,0,1,0
2707,37,0,0,60,60,0,1,0,1,0
56646,48817,0,0,62,62,0,1,0,1,0
33453,64147,0,0,62,62,0,1,0,1,0
23969,57470,0,0,62,62,0,1,0,1,0
10736,35440,0,0,62,62,0,1,0,1,0
58638,5900,0,0,62,62,0,1,0,1,0
26921,57470,0,0,62,62,0,1,0,1,0
23274,50584,0,0,62,62,0,1,0,1,0
44594,64147,0,0,66,66,0,1,0,1,0
19394,44847,0,0,66,66,0,1,0,1,0
52676,53733,0,0,66,66,0,1,0,1,0
63878,22114,0,0,146,146,0,1,0,1,0
29080,50265,0,0,62,62,0,1,0,1,0
57894,44847,0,0,62,62,0,1,0,1,0
2731,25174,0,0,146,146,0,1,0,1,0
47357,50584,0,0,66,66,0,1,0,1,0
12348,50265,0,0,62,62,0,1,0,1,0
58638,5900,0,0,62,62,0,1,0,1,0
6881,6881,0,0,146,146,0,1,0,1,0
62109,44847,0,0,66,66,0,1,0,1,0
19747,37965,0,0,62,62,0,1,0,1,0
58638,5900,0,0,62,62,0,1,0,1,0
3052,7302,0,0,66,66,0,1,0,1,0
58638,5900,0,0,62,62,0,1,0,1,0
51533,44847,0,0,66,66,0,1,0,1,0
51413,57470,0,0,72,72,0,1,0,1,0
443,56117,0,0,97,97,0,1,0,1,0
36963,23,0,0,60,60,0,1,0,1,0
58238,23,0,0,60,60,0,1,0,1,0
59563,56205,0,0,66,66,0,1,0,1,0
5087,22114,0,0,62,62,0,1,0,1,0
45908,33330,0,0,60,60,0,1,0,1,0
55310,50584,0,0,66,66,0,1,0,1,0
45099,57470,0,0,62,62,0,1,0,1,0
58638,5900,0,0,62,62,0,1,0,1,0
47357,50584,0,0,62,62,0,1,0,1,0
59966,37965,0,0,66,66,0,1,0,1,0
52282,37965,0,0,66,66,0,1,0,1,0
27010,64147,0,0,62,62,0,1,0,1,0
30304,64147,0,0,66,66,0,1,0,1,0
57772,50584,0,0,66,66,0,1,0,1,0
54912,64147,0,0,66,66,0,1,0,1,0
36579,30188,0,0,66,66,0,1,0,1,0
64543,50265,0,0,66,66,0,1,0,1,0
59210,50584,0,0,66,66,0,1,0,1,0
6881,46776,0,0,146,146,0,1,0,1,0
346,23,0,0,60,60,0,1,0,1,0
15333,44847,0,0,62,62,0,1,0,1,0
3399,25174,0,0,66,66,0,1,0,1,0
61527,51050,0,0,66,66,0,1,0,1,0
19875,30170,0,0,145,145,0,1,0,1,0
443,20087,0,0,83,83,0,1,0,1,0
7810,25174,0,0,66,66,0,1,0,1,0
2021,44847,0,0,66,66,0,1,0,1,0
48706,23393,0,0,60,60,0,1,0,1,0
58638,5900,0,0,62,62,0,1,0,1,0
3478,61463,0,0,364,364,0,1,0,1,0
11136,17500,0,0,62,62,0,1,0,1,0
34281,52862,0,0,145,145,0,1,0,1,0
51015,64147,0,0,145,145,0,1,0,1,0
53406,50584,0,0,62,62,0,1,0,1,0
49336,25174,0,0,62,62,0,1,0,1,0
37034,25174,0,0,146,146,0,1,0,1,0
52812,25174,0,0,66,66,0,1,0,1,0
60923,49903,0,0,66,66,0,1,0,1,0
60720,23718,0,0,66,66,0,1,0,1,0
7166,64147,0,0,66,66,0,1,0,1,0
50549,43890,0,0,62,62,0,1,0,1,0
51244,59353,0,0,100,100,0,1,0,1,0
46116,57470,0,0,74,74,0,1,0,1,0
9504,25174,0,0,62,62,0,1,0,1,0
56119,37965,0,0,62,62,0,1,0,1,0
56219,22114,0,0,66,66,0,1,0,1,0
7482,57470,0,0,66,66,0,1,0,1,0
4257,35440,0,0,62,62,0,1,0,1,0
58638,5900,0,0,62,62,0,1,0,1,0
59563,56205,0,0,66,66,0,1,0,1,0
2935,64147,0,0,62,62,0,1,0,1,0
14615,57866,0,0,66,66,0,1,0,1,0
44147,64147,0,0,62,62,0,1,0,1,0
64923,25174,0,0,66,66,0,1,0,1,0
57471,62413,0,0,66,66,0,1,0,1,0
37213,36237,0,0,66,66,0,1,0,1,0
56794,46824,0,0,66,66,0,1,0,1,0
58638,5900,0,0,62,62,0,1,0,1,0
3478,61463,0,0,1188,1188,0,1,0,1,0
51558,37965,0,0,72,72,0,1,0,1,0
5223,32965,0,0,119,119,0,1,0,1,0
55985,44847,0,0,62,62,0,1,0,1,0
19875,30170,0,0,145,145,0,1,0,1,0
58248,50584,0,0,66,66,0,1,0,1,0
59592,37965,0,0,62,62,0,1,0,1,0
13285,29892,0,0,145,145,0,1,0,1,0
58638,5900,0,0,62,62,0,1,0,1,0
8229,22114,0,0,66,66,0,1,0,1,0
1049,54369,0,0,62,62,0,1,0,1,0
41025,38191,0,0,157,157,0,1,0,1,0
80,53945,0,0,60,60,0,1,0,1,0
20371,35440,0,0,62,62,0,1,0,1,0
63433,57866,0,0,66,66,0,1,0,1,0
61185,54532,0,0,62,62,0,1,0,1,0
51151,64147,0,0,66,66,0,1,0,1,0
22275,51505,0,0,62,62,0,1,0,1,0
15319,51505,0,0,66,66,0,1,0,1,0
50901,26467,0,0,66,66,0,1,0,1,0
64294,64147,0,0,146,146,0,1,0,1,0
26566,44847,0,0,66,66,0,1,0,1,0
59008,51221,0,0,66,66,0,1,0,1,0
65289,46776,0,0,66,66,0,1,0,1,0
50798,36237,0,0,62,62,0,1,0,1,0
51396,56205,0,0,66,66,0,1,0,1,0
65494,53,0,0,88,88,0,1,0,1,0
6655,2323,0,0,60,60,0,1,0,1,0
62331,61689,0,0,66,66,0,1,0,1,0
58638,5900,0,0,62,62,0,1,0,1,0
40216,50265,0,0,62,62,0,1,0,1,0
33351,43890,0,0,146,146,0,1,0,1,0
54742,50584,0,0,66,66,0,1,0,1,0
42094,35440,0,0,62,62,0,1,0,1,0
59994,11446,0,0,66,66,0,1,0,1,0
33786,23,0,0,60,60,0,1,0,1,0
43584,24748,0,0,156,156,0,1,0,1,0
3478,61463,0,0,64,64,0,1,0,1,0
30114,65151,0,0,60,60,0,1,0,1,0
18116,37807,0,0,66,66,0,1,0,1,0
8194,21247,0,0,62,62,0,1,0,1,0
60423,35440,0,0,62,62,0,1,0,1,0
50084,26672,0,0,62,62,0,1,0,1,0
46901,26672,0,0,60,60,0,1,0,1,0
18423,51505,0,0,66,66,0,1,0,1,0
50321,48817,0,0,143,143,0,1,0,1,0
55508,64147,0,0,62,62,0,1,0,1,0
50734,37965,0,0,62,62,0,1,0,1,0
25536,50584,0,0,62,62,0,1,0,1,0
3478,45401,0,0,109,109,0,1,0,1,0
10775,35440,0,0,66,66,0,1,0,1,0
53168,44847,0,0,146,146,0,1,0,1,0
10494,23,0,0,60,60,0,1,0,1,0
18011,44847,0,0,62,62,0,1,0,1,0
33886,39127,0,0,162,162,0,1,0,1,0
32520,50265,0,0,145,145,0,1,0,1,0
60132,50584,0,0,62,62,0,1,0,1,0
49931,25174,0,0,66,66,0,1,0,1,0
57768,37965,0,0,66,66,0,1,0,1,0
12951,50584,0,0,66,66,0,1,0,1,0
23900,64147,0,0,62,62,0,1,0,1,0
35524,34962,0,0,159,159,0,1,0,1,0
45908,33330,0,0,60,60,0,1,0,1,0
58638,5900,0,0,62,62,0,1,0,1,0
56219,22114,0,0,66,66,0,1,0,1,0
30797,23,0,0,60,60,0,1,0,1,0
80,37649,0,0,60,60,0,1,0,1,0
14331,23,0,0,60,60,0,1,0,1,0
65025,57866,0,0,66,66,0,1,0,1,0
59345,25174,0,0,62,62,0,1,0,1,0
45060,37965,0,0,62,62,0,1,0,1,0
47944,50584,0,0,62,62,0,1,0,1,0
57874,26467,0,0,62,62,0,1,0,1,0
63779,26467,0,0,62,62,0,1,0,1,0
43571,26467,0,0,62,62,0,1,0,1,0
1024,5529,0,0,146,146,0,1,0,1,0
35626,22114,0,0,62,62,0,1,0,1,0
53971,55442,0,0,62,62,0,1,0,1,0
43129,20220,0,0,62,62,0,1,0,1,0
57677,57470,0,0,62,62,0,1,0,1,0
10532,26672,0,0,60,60,0,1,0,1,0
39540,37965,0,0,66,66,0,1,0,1,0
59497,64097,0,0,66,66,0,1,0,1,0
53419,28189,0,0,60,60,0,1,0,1,0
53490,62413,0,0,66,66,0,1,0,1,0
54778,22114,0,0,62,62,0,1,0,1,0
8903,23,0,0,60,60,0,1,0,1,0
60645,35440,0,0,62,62,0,1,0,1,0
50804,1,0,0,62,62,0,1,0,1,0
58338,3353,0,0,60,60,0,1,0,1,0
54773,50584,0,0,66,66,0,1,0,1,0
56067,25174,0,0,62,62,0,1,0,1,0
45304,64147,0,0,72,72,0,1,0,1,0
44569,3389,0,0,60,60,0,1,0,1,0
61278,56205,0,0,66,66,0,1,0,1,0
61017,64147,0,0,62,62,0,1,0,1,0
9017,6881,0,0,62,62,0,1,0,1,0
6881,6881,0,0,62,62,0,1,0,1,0
14694,443,0,0,60,60,0,1,0,1,0
50470,61463,0,0,86,86,0,1,0,1,0
56949,22,0,0,60,60,0,1,0,1,0
44411,37965,0,0,62,62,0,1,0,1,0
59225,57587,0,0,66,66,0,1,0,1,0
58638,5900,0,0,62,62,0,1,0,1,0
57613,42707,0,0,66,66,0,1,0,1,0
62064,22114,0,0,66,66,0,1,0,1,0
5357,32468,0,0,66,66,0,1,0,1,0
29009,25174,0,0,146,146,0,1,0,1,0
60136,56205,0,0,66,66,0,1,0,1,0
22636,30188,0,0,66,66,0,1,0,1,0
14148,1,0,0,66,66,0,1,0,1,0
16824,11119,0,0,148,148,0,1,0,1,0
3800,5223,0,0,146,146,0,1,0,1,0
60970,20541,0,0,66,66,0,1,0,1,0
443,45788,0,0,332,332,0,1,0,1,0
7307,23,0,0,60,60,0,1,0,1,0
13985,34159,0,0,62,62,0,1,0,1,0
53044,36237,0,0,66,66,0,1,0,1,0
20487,50584,0,0,66,66,0,1,0,1,0
56306,17500,0,0,146,146,0,1,0,1,0
38755,22114,0,0,66,66,0,1,0,1,0
6666,16010,0,0,60,60,0,1,0,1,0
39661,53733,0,0,146,146,0,1,0,1,0
26658,25174,0,0,62,62,0,1,0,1,0
34146,1433,0,0,60,60,0,1,0,1,0
60976,22114,0,0,66,66,0,1,0,1,0
52726,56205,0,0,62,62,0,1,0,1,0
58835,17372,0,0,66,66,0,1,0,1,0
48219,55442,0,0,62,62,0,1,0,1,0
26717,25174,0,0,62,62,0,1,0,1,0
43323,1,0,0,62,62,0,1,0,1,0
3764,9694,0,0,66,66,0,1,0,1,0
53194,35440,0,0,66,66,0,1,0,1,0
32551,51221,0,0,66,66,0,1,0,1,0
43828,44847,0,0,66,66,0,1,0,1,0
12694,12446,0,0,145,145,0,1,0,1,0
3117,37965,0,0,62,62,0,1,0,1,0
58638,5900,0,0,62,62,0,1,0,1,0
53015,64147,0,0,62,62,0,1,0,1,0
26921,57470,0,0,62,62,0,1,0,1,0
61523,37807,0,0,66,66,0,1,0,1,0
60188,15503,0,0,62,62,0,1,0,1,0
5685,35440,0,0,62,62,0,1,0,1,0
443,10010,0,0,60,60,0,1,0,1,0
58638,5900,0,0,62,62,0,1,0,1,0
58638,5900,0,0,62,62,0,1,0,1,0
54346,44847,0,0,66,66,0,1,0,1,0
27368,22114,0,0,62,62,0,1,0,1,0
3399,25174,0,0,66,66,0,1,0,1,0
14023,37965,0,0,62,62,0,1,0,1,0
58950,5900,0,0,60,60,0,1,0,1,0
56638,64147,0,0,62,62,0,1,0,1,0
53469,44847,0,0,62,62,0,1,0,1,0
64298,50584,0,0,66,66,0,1,0,1,0
24480,35440,0,0,66,66,0,1,0,1,0
14923,51505,0,0,66,66,0,1,0,1,0
3093,62413,0,0,62,62,0,1,0,1,0
53927,64147,0,0,66,66,0,1,0,1,0
57410,25174,0,0,62,62,0,1,0,1,0
443,60496,0,0,320,320,0,1,0,1,0
46460,36237,0,0,146,146,0,1,0,1,0
1111,25174,0,0,62,62,0,1,0,1,0
54189,64147,0,0,66,66,0,1,0,1,0
515,10214,0,0,66,66,0,1,0,1,0
63023,51505,0,0,66,66,0,1,0,1,0
58912,11392,0,0,66,66,0,1,0,1,0
443,45940,0,0,85,85,0,1,0,1,0
60261,25174,0,0,66,66,0,1,0,1,0
64214,25174,0,0,66,66,0,1,0,1,0
14023,37965,0,0,62,62,0,1,0,1,0
19298,30188,0,0,62,62,0,1,0,1,0
12531,22114,0,0,62,62,0,1,0,1,0
61345,21247,0,0,66,66,0,1,0,1,0
58638,5900,0,0,62,62,0,1,0,1,0
64240,50584,0,0,66,66,0,1,0,1,0
58007,62413,0,0,66,66,0,1,0,1,0
26722,11446,0,0,66,66,0,1,0,1,0
55600,22,0,0,60,60,0,1,0,1,0
59736,51505,0,0,62,62,0,1,0,1,0
40687,64147,0,0,62,62,0,1,0,1,0
54758,35993,0,0,66,66,0,1,0,1,0
6121,51505,0,0,62,62,0,1,0,1,0
10003,64147,0,0,62,62,0,1,0,1,0
53406,50584,0,0,66,66,0,1,0,1,0
50227,57470,0,0,66,66,0,1,0,1,0
11337,15503,0,0,62,62,0,1,0,1,0
54021,25174,0,0,62,62,0,1,0,1,0
62678,57470,0,0,62,62,0,1,0,1,0
48180,143,0,0,60,60,0,1,0,1,0
3777,64097,0,0,146,146,0,1,0,1,0
51042,22114,0,0,66,66,0,1,0,1,0
4323,64147,0,0,66,66,0,1,0,1,0
56376,44847,0,0,62,62,0,1,0,1,0
41220,59356,0,0,62,62,0,1,0,1,0
38477,5900,0,0,60,60,0,1,0,1,0
64811,51221,0,0,66,66,0,1,0,1,0
12060,37965,0,0,66,66,0,1,0,1,0
58638,5900,0,0,62,62,0,1,0,1,0
62183,57470,0,0,74,74,0,1,0,1,0
15585,64147,0,0,66,66,0,1,0,1,0
6778,50584,0,0,66,66,0,1,0,1,0
34932,38608,0,0,62,62,0,1,0,1,0
12531,22114,0,0,62,62,0,1,0,1,0
34301,21247,0,0,62,62,0,1,0,1,0
64697,37965,0,0,66,66,0,1,0,1,0
54614,37807,0,0,66,66,0,1,0,1,0
16377,21247,0,0,62,62,0,1,0,1,0
51934,36180,0,0,66,66,0,1,0,1,0
50767,57470,0,0,66,66,0,1,0,1,0
45144,25174,0,0,62,62,0,1,0,1,0
8999,8055,0,0,146,146,0,1,0,1,0
46093,32661,0,0,74,74,0,1,0,1,0
50439,64147,0,0,66,66,0,1,0,1,0
54277,22114,0,0,146,146,0,1,0,1,0
45654,67,0,0,60,60,0,1,0,1,0
63183,64147,0,0,66,66,0,1,0,1,0
55565,64147,0,0,66,66,0,1,0,1,0
64341,57470,0,0,62,62,0,1,0,1,0
64368,22114,0,0,66,66,0,1,0,1,0
64066,23718,0,0,66,66,0,1,0,1,0
20576,37965,0,0,62,62,0,1,0,1,0
58751,9571,0,0,62,62,0,1,0,1,0
2064,22114,0,0,62,62,0,1,0,1,0
55933,64097,0,0,62,62,0,1,0,1,0
43063,57470,0,0,62,62,0,1,0,1,0
2404,35440,0,0,146,146,0,1,0,1,0
56639,48817,0,0,62,62,0,1,0,1,0
43269,50584,0,0,66,66,0,1,0,1,0
64368,22114,0,0,62,62,0,1,0,1,0
54424,50584,0,0,146,146,0,1,0,1,0
7181,64147,0,0,66,66,0,1,0,1,0
1035,26467,0,0,62,62,0,1,0,1,0
65422,26467,0,0,62,62,0,1,0,1,0
41677,57470,0,0,66,66,0,1,0,1,0
63488,22114,0,0,62,62,0,1,0,1,0
58638,5900,0,0,62,62,0,1,0,1,0
16285,23,0,0,60,60,0,1,0,1,0
54991,36829,0,0,66,66,0,1,0,1,0
62991,51221,0,0,66,66,0,1,0,1,0
10914,35974,0,0,60,60,0,1,0,1,0
18650,23718,0,0,62,62,0,1,0,1,0
53105,42707,0,0,66,66,0,1,0,1,0
10547,57470,0,0,62,62,0,1,0,1,0
52026,26467,0,0,60,60,0,1,0,1,0
55854,54369,0,0,74,74,0,1,0,1,0
46286,21247,0,0,146,146,0,1,0,1,0
4594,35993,0,0,66,66,0,1,0,1,0
443,1340,0,0,85,85,0,1,0,1,0
57387,70,0,0,60,60,0,1,0,1,0
58638,5900,0,0,62,62,0,1,0,1,0
62970,44847,0,0,62,62,0,1,0,1,0
59937,18375,0,0,66,66,0,1,0,1,0
63778,50584,0,0,146,146,0,1,0,1,0
33453,64147,0,0,62,62,0,1,0,1,0
56946,1,0,0,66,66,0,1,0,1,0
443,62451,0,0,60,60,0,1,0,1,0
54389,28543,0,0,66,66,0,1,0,1,0
61013,41705,0,0,66,66,0,1,0,1,0
50857,26467,0,0,66,66,0,1,0,1,0
59008,51221,0,0,62,62,0,1,0,1,0
54206,25174,0,0,62,62,0,1,0,1,0
58638,5900,0,0,62,62,0,1,0,1,0
443,63113,0,0,100,100,0,1,0,1,0
58497,39004,0,0,66,66,0,1,0,1,0
52720,35894,0,0,62,62,0,1,0,1,0
3478,61463,0,0,252,252,0,1,0,1,0
58869,57470,0,0,145,145,0,1,0,1,0
14260,36829,0,0,62,62,0,1,0,1,0
51726,64147,0,0,66,66,0,1,0,1,0
63927,50265,0,0,62,62,0,1,0,1,0
39839,22114,0,0,146,146,0,1,0,1,0
53051,44847,0,0,62,62,0,1,0,1,0
62549,53733,0,0,66,66,0,1,0,1,0
52200,23,0,0,60,60,0,1,0,1,0
30574,64147,0,0,62,62,0,1,0,1,0
56564,9571,0,0,78,78,0,1,0,1,0
52280,44847,0,0,62,62,0,1,0,1,0
63098,35440,0,0,66,66,0,1,0,1,0
33941,37807,0,0,62,62,0,1,0,1,0
62331,61689,0,0,62,62,0,1,0,1,0
43639,26467,0,0,66,66,0,1,0,1,0
52252,46314,0,0,62,62,0,1,0,1,0
64115,2767,0,0,62,62,0,1,0,1,0
9394,51505,0,0,62,62,0,1,0,1,0
6546,37965,0,0,62,62,0,1,0,1,0
25276,50584,0,0,146,146,0,1,0,1,0
37633,44847,0,0,62,62,0,1,0,1,0
29291,62609,0,0,150,150,0,1,0,1,0
63677,15503,0,0,66,66,0,1,0,1,0
46901,26672,0,0,60,60,0,1,0,1,0
51726,64147,0,0,62,62,0,1,0,1,0
26448,9192,0,0,145,145,0,1,0,1,0
2815,62413,0,0,66,66,0,1,0,1,0
59214,57866,0,0,66,66,0,1,0,1,0
37597,50584,0,0,66,66,0,1,0,1,0
52827,25174,0,0,62,62,0,1,0,1,0
35207,22114,0,0,146,146,0,1,0,1,0
49386,64147,0,0,62,62,0,1,0,1,0
51743,64147,0,0,62,62,0,1,0,1,0
46679,64147,0,0,62,62,0,1,0,1,0
26448,9192,0,0,145,145,0,1,0,1,0
39868,55839,0,0,137,137,0,1,0,1,0
55142,26467,0,0,66,66,0,1,0,1,0
48019,22114,0,0,66,66,0,1,0,1,0
3521,6881,0,0,66,66,0,1,0,1,0
50784,52952,0,0,62,62,0,1,0,1,0
51010,22114,0,0,146,146,0,1,0,1,0
8889,9806,0,0,60,60,0,1,0,1,0
2938,64147,0,0,62,62,0,1,0,1,0
3181,53567,0,0,66,66,0,1,0,1,0
58638,5900,0,0,62,62,0,1,0,1,0
58715,57470,0,0,62,62,0,1,0,1,0
51105,50584,0,0,66,66,0,1,0,1,0
45941,23386,0,0,60,60,0,1,0,1,0
58844,51505,0,0,66,66,0,1,0,1,0
54914,51505,0,0,66,66,0,1,0,1,0
11754,25174,0,0,62,62,0,1,0,1,0
3478,61463,0,0,164,164,0,1,0,1,0
58638,5900,0,0,62,62,0,1,0,1,0
56035,1310,0,0,62,62,0,1,0,1,0
49689,22114,0,0,62,62,0,1,0,1,0
5223,13602,0,0,66,66,0,1,0,1,0
58638,5900,0,0,62,62,0,1,0,1,0
45941,23386,0,0,60,60,0,1,0,1,0
443,49988,0,0,82,82,0,1,0,1,0
53305,50584,0,0,62,62,0,1,0,1,0
65518,5710,0,0,62,62,0,1,0,1,0
38664,37965,0,0,62,62,0,1,0,1,0
2440,37807,0,0,66,66,0,1,0,1,0
2425,23117,0,0,66,66,0,1,0,1,0
52699,26467,0,0,62,62,0,1,0,1,0
63998,21247,0,0,66,66,0,1,0,1,0
34932,38608,0,0,62,62,0,1,0,1,0
2791,7302,0,0,62,62,0,1,0,1,0
25878,25174,0,0,66,66,0,1,0,1,0
1025,64147,0,0,62,62,0,1,0,1,0
31738,51505,0,0,62,62,0,1,0,1,0
54346,44847,0,0,62,62,0,1,0,1,0
49938,57470,0,0,62,62,0,1,0,1,0
40301,8696,0,0,60,60,0,1,0,1,0
19096,64147,0,0,62,62,0,1,0,1,0
58638,5900,0,0,62,62,0,1,0,1,0
26658,25174,0,0,146,146,0,1,0,1,0
50459,62413,0,0,66,66,0,1,0,1,0
63867,64147,0,0,62,62,0,1,0,1,0
61537,57866,0,0,66,66,0,1,0,1,0
12785,2323,0,0,60,60,0,1,0,1,0
50419,26467,0,0,62,62,0,1,0,1,0
22541,64147,0,0,66,66,0,1,0,1,0
61315,48817,0,0,62,62,0,1,0,1,0
58638,5900,0,0,62,62,0,1,0,1,0
44147,64147,0,0,62,62,0,1,0,1,0
42389,42873,0,0,74,74,0,1,0,1,0
8080,37965,0,0,62,62,0,1,0,1,0
50106,30317,0,0,66,66,0,1,0,1,0
7342,22114,0,0,66,66,0,1,0,1,0
53419,28189,0,0,60,60,0,1,0,1,0
58638,5900,0,0,62,62,0,1,0,1,0
58638,5900,0,0,62,62,0,1,0,1,0
54236,36829,0,0,66,66,0,1,0,1,0
57034,44847,0,0,66,66,0,1,0,1,0
45832,51050,0,0,66,66,0,1,0,1,0
18950,50584,0,0,62,62,0,1,0,1,0
1882,43890,0,0,62,62,0,1,0,1,0
60374,57470,0,0,145,145,0,1,0,1,0
45964,2666,0,0,60,60,0,1,0,1,0
63465,56205,0,0,66,66,0,1,0,1,0
58638,5900,0,0,62,62,0,1,0,1,0
60133,1,0,0,62,62,0,1,0,1,0
3290,57470,0,0,145,145,0,1,0,1,0
57538,30188,0,0,66,66,0,1,0,1,0
3456,11392,0,0,66,66,0,1,0,1,0
58638,5900,0,0,62,62,0,1,0,1,0
1041,25174,0,0,146,146,0,1,0,1,0
2422,50584,0,0,66,66,0,1,0,1,0
11235,30188,0,0,66,66,0,1,0,1,0
24411,12809,0,0,60,60,0,1,0,1,0
25267,2323,0,0,60,60,0,1,0,1,0
60126,35440,0,0,62,62,0,1,0,1,0
57928,30188,0,0,62,62,0,1,0,1,0
3478,61463,0,0,1292,1292,0,1,0,1,0
62673,34159,0,0,66,66,0,1,0,1,0
17453,35440,0,0,66,66,0,1,0,1,0
53779,51505,0,0,66,66,0,1,0,1,0
39941,995,0,0,60,60,0,1,0,1,0
50470,61463,0,0,86,86,0,1,0,1,0
37308,43890,0,0,62,62,0,1,0,1,0
36258,23,0,0,60,60,0,1,0,1,0
22571,51505,0,0,62,62,0,1,0,1,0
34932,38608,0,0,62,62,0,1,0,1,0
55893,45711,0,0,78,78,0,1,0,1,0
60720,23718,0,0,62,62,0,1,0,1,0
60428,25174,0,0,66,66,0,1,0,1,0
51550,11392,0,0,66,66,0,1,0,1,0
58638,5900,0,0,62,62,0,1,0,1,0
53746,36237,0,0,66,66,0,1,0,1,0
58638,5900,0,0,62,62,0,1,0,1,0
41249,50584,0,0,66,66,0,1,0,1,0
26084,36237,0,0,66,66,0,1,0,1,0
25739,64147,0,0,62,62,0,1,0,1,0
40742,2967,0,0,62,62,0,1,0,1,0
54280,3398,0,0,60,60,0,1,0,1,0
61013,41705,0,0,66,66,0,1,0,1,0
37034,25174,0,0,62,62,0,1,0,1,0
14844,37965,0,0,62,62,0,1,0,1,0
45051,23,0,0,60,60,0,1,0,1,0
12545,43890,0,0,146,146,0,1,0,1,0
21674,28189,0,0,60,60,0,1,0,1,0
1054,57470,0,0,62,62,0,1,0,1,0
50734,37965,0,0,62,62,0,1,0,1,0
31991,23,0,0,60,60,0,1,0,1,0
16985,57866,0,0,66,66,0,1,0,1,0
44208,26467,0,0,62,62,0,1,0,1,0
49664,37965,0,0,66,66,0,1,0,1,0
51413,1,0,0,72,72,0,1,0,1,0
15281,25174,0,0,146,146,0,1,0,1,0
26254,56205,0,0,66,66,0,1,0,1,0
60112,23,0,0,60,60,0,1,0,1,0
34086,25174,0,0,62,62,0,1,0,1,0
45837,25174,0,0,62,62,0,1,0,1,0
58638,5900,0,0,62,62,0,1,0,1,0
48071,25174,0,0,62,62,0,1,0,1,0
52462,25174,0,0,66,66,0,1,0,1,0
65015,22114,0,0,62,62,0,1,0,1,0
61008,5555,0,0,60,60,0,1,0,1,0
6881,55108,0,0,148,148,0,1,0,1,0
9522,51505,0,0,66,66,0,1,0,1,0
2876,35440,0,0,62,62,0,1,0,1,0
10704,25174,0,0,62,62,0,1,0,1,0
59037,51505,0,0,62,62,0,1,0,1,0
10430,22114,0,0,146,146,0,1,0,1,0
46108,48817,0,0,145,145,0,1,0,1,0
55587,43890,0,0,66,66,0,1,0,1,0
6014,37965,0,0,62,62,0,1,0,1,0
51999,37965,0,0,62,62,0,1,0,1,0
52323,44847,0,0,146,146,0,1,0,1,0
57797,64147,0,0,66,66,0,1,0,1,0
57987,56125,0,0,90,90,0,1,0,1,0
48327,57470,0,0,145,145,0,1,0,1,0
36933,23117,0,0,66,66,0,1,0,1,0
64922,26296,0,0,148,148,0,1,0,1,0
61085,37965,0,0,62,62,0,1,0,1,0
58638,5900,0,0,62,62,0,1,0,1,0
36357,25174,0,0,62,62,0,1,0,1,0
56367,44847,0,0,66,66,0,1,0,1,0
16387,61049,0,0,60,60,0,1,0,1,0
54703,23,0,0,60,60,0,1,0,1,0
59223,17500,0,0,66,66,0,1,0,1,0
11133,51505,0,0,66,66,0,1,0,1,0
58638,5900,0,0,62,62,0,1,0,1,0
443,49689,0,0,60,60,0,1,0,1,0
443,48346,0,0,81,81,0,1,0,1,0
49805,6881,0,0,66,66,0,1,0,1,0
59663,37965,0,0,62,62,0,1,0,1,0
59048,57470,0,0,66,66,0,1,0,1,0
14614,25174,0,0,66,66,0,1,0,1,0
5617,64147,0,0,62,62,0,1,0,1,0
26330,26348,0,0,62,62,0,1,0,1,0
51446,3855,0,0,100,100,0,1,0,1,0
22408,22114,0,0,62,62,0,1,0,1,0
64691,25320,0,0,62,62,0,1,0,1,0
53838,36829,0,0,66,66,0,1,0,1,0
48706,23393,0,0,60,60,0,1,0,1,0
30181,61689,0,0,62,62,0,1,0,1,0
1187,64147,0,0,66,66,0,1,0,1,0
55386,37965,0,0,66,66,0,1,0,1,0
63084,64147,0,0,62,62,0,1,0,1,0
54786,30188,0,0,66,66,0,1,0,1,0
9687,57470,0,0,78,78,0,1,0,1,0
51979,25174,0,0,66,66,0,1,0,1,0
50086,57470,0,0,66,66,0,1,0,1,0
49993,37965,0,0,66,66,0,1,0,1,0
41220,59356,0,0,62,62,0,1,0,1,0
58638,5900,0,0,62,62,0,1,0,1,0
64891,22,0,0,60,60,0,1,0,1,0
59790,44847,0,0,66,66,0,1,0,1,0
22542,30188,0,0,62,62,0,1,0,1,0
51413,1,0,0,72,72,0,1,0,1,0
45535,25174,0,0,62,62,0,1,0,1,0
48230,57866,0,0,62,62,0,1,0,1,0
19999,30170,0,0,145,145,0,1,0,1,0
1536,50584,0,0,146,146,0,1,0,1,0
51685,57470,0,0,66,66,0,1,0,1,0
58638,5900,0,0,62,62,0,1,0,1,0
65200,51050,0,0,66,66,0,1,0,1,0
51812,1433,0,0,60,60,0,1,0,1,0
26528,51221,0,0,78,78,0,1,0,1,0
28624,23,0,0,60,60,0,1,0,1,0
14350,56205,0,0,62,62,0,1,0,1,0
27064,51221,0,0,72,72,0,1,0,1,0
65317,51221,0,0,78,78,0,1,0,1,0
45964,7778,0,0,60,60,0,1,0,1,0
59966,37965,0,0,66,66,0,1,0,1,0
6666,6379,0,0,60,60,0,1,0,1,0
17171,22114,0,0,66,66,0,1,0,1,0
11880,36829,0,0,146,146,0,1,0,1,0
60184,37965,0,0,66,66,0,1,0,1,0
15701,37965,0,0,146,146,0,1,0,1,0
45941,23386,0,0,60,60,0,1,0,1,0
46495,4607,0,0,60,60,0,1,0,1,0
64346,51505,0,0,66,66,0,1,0,1,0
57472,44847,0,0,62,62,0,1,0,1,0
49894,1433,0,0,60,60,0,1,0,1,0
22350,25174,0,0,66,66,0,1,0,1,0
51426,12447,0,0,100,100,0,1,0,1,0
63786,35440,0,0,62,62,0,1,0,1,0
52144,49344,0,0,62,62,0,1,0,1,0
6666,16010,0,0,60,60,0,1,0,1,0
58343,23718,0,0,66,66,0,1,0,1,0
51930,57470,0,0,66,66,0,1,0,1,0
48125,7548,0,0,60,60,0,1,0,1,0
54633,36237,0,0,66,66,0,1,0,1,0
2850,64147,0,0,62,62,0,1,0,1,0
3352,50584,0,0,66,66,0,1,0,1,0
64333,57470,0,0,78,78,0,1,0,1,0
64406,25174,0,0,66,66,0,1,0,1,0
51533,44847,0,0,66,66,0,1,0,1,0
80,37649,0,0,60,60,0,1,0,1,0
59411,37965,0,0,66,66,0,1,0,1,0
48087,16069,0,0,66,66,0,1,0,1,0
58638,5900,0,0,62,62,0,1,0,1,0
56719,37807,0,0,66,66,0,1,0,1,0
53305,50584,0,0,66,66,0,1,0,1,0
7249,30349,0,0,143,143,0,1,0,1,0
25222,37965,0,0,62,62,0,1,0,1,0
34306,37965,0,0,62,62,0,1,0,1,0
62804,37965,0,0,66,66,0,1,0,1,0
58966,30188,0,0,66,66,0,1,0,1,0
50422,50584,0,0,66,66,0,1,0,1,0
49336,25174,0,0,66,66,0,1,0,1,0
33908,48983,0,0,145,145,0,1,0,1,0
65285,44847,0,0,146,146,0,1,0,1,0
22547,48817,0,0,72,72,0,1,0,1,0
9087,37965,0,0,62,62,0,1,0,1,0
50594,25174,0,0,66,66,0,1,0,1,0
12128,37965,0,0,62,62,0,1,0,1,0
34073,37965,0,0,62,62,0,1,0,1,0
42044,60043,0,0,62,62,0,1,0,1,0
5690,23,0,0,60,60,0,1,0,1,0
52802,56205,0,0,66,66,0,1,0,1,0
47943,50584,0,0,74,74,0,1,0,1,0
53218,56205,0,0,62,62,0,1,0,1,0
7210,22114,0,0,66,66,0,1,0,1,0
37647,36237,0,0,66,66,0,1,0,1,0
60976,22114,0,0,62,62,0,1,0,1,0
1660,8696,0,0,62,62,0,1,0,1,0
37837,37965,0,0,62,62,0,1,0,1,0
31469,23,0,0,60,60,0,1,0,1,0
443,35385,0,0,161,161,0,1,0,1,0
29734,23,0,0,60,60,0,1,0,1,0
14740,26467,0,0,62,62,0,1,0,1,0
48488,50584,0,0,146,146,0,1,0,1,0
65332,56205,0,0,66,66,0,1,0,1,0
27869,51221,0,0,66,66,0,1,0,1,0
10427,50584,0,0,146,146,0,1,0,1,0
39959,23117,0,0,146,146,0,1,0,1,0
30782,36237,0,0,62,62,0,1,0,1,0
49754,35440,0,0,62,62,0,1,0,1,0
59701,44847,0,0,66,66,0,1,0,1,0
5462,21247,0,0,66,66,0,1,0,1,0
58638,5900,0,0,62,62,0,1,0,1,0
12663,62413,0,0,66,66,0,1,0,1,0
58638,5900,0,0,62,62,0,1,0,1,0
60823,25174,0,0,62,62,0,1,0,1,0
49664,37965,0,0,66,66,0,1,0,1,0
38549,22114,0,0,62,62,0,1,0,1,0
59934,35440,0,0,66,66,0,1,0,1,0
3478,61463,0,0,164,164,0,1,0,1,0
55529,44847,0,0,66,66,0,1,0,1,0
52683,22114,0,0,62,62,0,1,0,1,0
10319,42707,0,0,62,62,0,1,0,1,0
60962,64147,0,0,66,66,0,1,0,1,0
55826,42771,0,0,62,62,0,1,0,1,0
56590,25174,0,0,66,66,0,1,0,1,0
53437,44847,0,0,66,66,0,1,0,1,0
33292,50584,0,0,66,66,0,1,0,1,0
51705,22114,0,0,62,62,0,1,0,1,0
30280,37965,0,0,66,66,0,1,0,1,0
11859,64147,0,0,62,62,0,1,0,1,0
52150,39109,0,0,66,66,0,1,0,1,0
8560,50584,0,0,66,66,0,1,0,1,0
50927,44847,0,0,62,62,0,1,0,1,0
30129,37965,0,0,72,72,0,1,0,1,0
0,0,0,0,98,98,0,1,0,1,0
36538,64147,0,0,62,62,0,1,0,1,0
58638,5900,0,0,62,62,0,1,0,1,0
45682,47993,0,0,62,62,0,1,0,1,0
63569,62413,0,0,66,66,0,1,0,1,0
16370,56205,0,0,62,62,0,1,0,1,0
40547,24051,0,0,74,74,0,1,0,1,0
9522,51505,0,0,66,66,0,1,0,1,0
46362,35440,0,0,66,66,0,1,0,1,0
32496,48817,0,0,148,148,0,1,0,1,0
64013,57470,0,0,74,74,0,1,0,1,0
50137,1433,0,0,60,60,0,1,0,1,0
6666,3389,0,0,60,60,0,1,0,1,0
58638,5900,0,0,62,62,0,1,0,1,0
59481,41182,0,0,66,66,0,1,0,1,0
27679,37965,0,0,62,62,0,1,0,1,0
16013,35253,0,0,66,66,0,1,0,1,0
5661,37965,0,0,66,66,0,1,0,1,0
35065,23,0,0,60,60,0,1,0,1,0
64166,35440,0,0,62,62,0,1,0,1,0
30046,15503,0,0,62,62,0,1,0,1,0
59610,51505,0,0,66,66,0,1,0,1,0
1081,59353,0,0,146,146,0,1,0,1,0
50063,35776,0,0,148,148,0,1,0,1,0
63002,22114,0,0,66,66,0,1,0,1,0
14183,26467,0,0,62,62,0,1,0,1,0
49485,56972,0,0,66,66,0,1,0,1,0
58213,37807,0,0,66,66,0,1,0,1,0
20619,25174,0,0,66,66,0,1,0,1,0
9092,26672,0,0,60,60,0,1,0,1,0
64535,37965,0,0,66,66,0,1,0,1,0
1903,43890,0,0,66,66,0,1,0,1,0
61537,57866,0,0,66,66,0,1,0,1,0
12537,28816,0,0,145,145,0,1,0,1,0
45964,55559,0,0,60,60,0,1,0,1,0
60557,23117,0,0,66,66,0,1,0,1,0
30783,51505,0,0,62,62,0,1,0,1,0
62014,35440,0,0,66,66,0,1,0,1,0
1646,23,0,0,60,60,0,1,0,1,0
58638,5900,0,0,62,62,0,1,0,1,0
23770,50584,0,0,66,66,0,1,0,1,0
58751,9571,0,0,62,62,0,1,0,1,0
54051,28793,0,0,66,66,0,1,0,1,0
57131,35776,0,0,145,145,0,1,0,1,0
47266,25174,0,0,146,146,0,1,0,1,0
61195,56205,0,0,62,62,0,1,0,1,0
58966,30188,0,0,62,62,0,1,0,1,0
9329,2323,0,0,60,60,0,1,0,1,0
56186,57470,0,0,62,62,0,1,0,1,0
30015,36237,0,0,66,66,0,1,0,1,0
52975,23718,0,0,66,66,0,1,0,1,0
34932,38608,0,0,62,62,0,1,0,1,0
45941,23386,0,0,60,60,0,1,0,1,0
30654,51221,0,0,72,72,0,1,0,1,0
63508,62413,0,0,66,66,0,1,0,1,0
56186,57470,0,0,62,62,0,1,0,1,0
19875,30170,0,0,145,145,0,1,0,1,0
56693,1900,0,0,139,139,0,1,0,1,0
5450,23,0,0,60,60,0,1,0,1,0
61738,2767,0,0,66,66,0,1,0,1,0
4862,37965,0,0,66,66,0,1,0,1,0
6881,8305,0,0,143,143,0,1,0,1,0
18091,32480,0,0,66,66,0,1,0,1,0
45941,23388,0,0,60,60,0,1,0,1,0
14740,26467,0,0,62,62,0,1,0,1,0
5121,35440,0,0,62,62,0,1,0,1,0
56946,1,0,0,66,66,0,1,0,1,0
8999,57470,0,0,146,146,0,1,0,1,0
11716,37965,0,0,62,62,0,1,0,1,0
443,20087,0,0,83,83,0,1,0,1,0
37538,37965,0,0,66,66,0,1,0,1,0
60923,49903,0,0,66,66,0,1,0,1,0
6057,51221,0,0,78,78,0,1,0,1,0
14148,1,0,0,66,66,0,1,0,1,0
65085,22114,0,0,62,62,0,1,0,1,0
63569,62413,0,0,62,62,0,1,0,1,0
53833,26467,0,0,66,66,0,1,0,1,0
58480,57470,0,0,66,66,0,1,0,1,0
64776,25174,0,0,66,66,0,1,0,1,0
36456,25174,0,0,146,146,0,1,0,1,0
16454,25174,0,0,62,62,0,1,0,1,0
10216,11392,0,0,66,66,0,1,0,1,0
61635,37965,0,0,66,66,0,1,0,1,0
58638,5900,0,0,62,62,0,1,0,1,0
30280,37965,0,0,66,66,0,1,0,1,0
27300,6881,0,0,66,66,0,1,0,1,0
27443,23,0,0,60,60,0,1,0,1,0
58638,5900,0,0,62,62,0,1,0,1,0
50442,25174,0,0,66,66,0,1,0,1,0
63460,55160,0,0,62,62,0,1,0,1,0
5379,37965,0,0,62,62,0,1,0,1,0
49150,51505,0,0,146,146,0,1,0,1,0
5227,50584,0,0,62,62,0,1,0,1,0
60159,22114,0,0,62,62,0,1,0,1,0
50280,57470,0,0,78,78,0,1,0,1,0
22240,22114,0,0,146,146,0,1,0,1,0
45682,25604,0,0,62,62,0,1,0,1,0
58638,5900,0,0,62,62,0,1,0,1,0
55893,45711,0,0,78,78,0,1,0,1,0
59597,37965,0,0,66,66,0,1,0,1,0
26131,56205,0,0,62,62,0,1,0,1,0
59584,36237,0,0,66,66,0,1,0,1,0
42632,44847,0,0,146,146,0,1,0,1,0
23353,25174,0,0,62,62,0,1,0,1,0
10248,21247,0,0,62,62,0,1,0,1,0
64295,26467,0,0,66,66,0,1,0,1,0
58638,5900,0,0,62,62,0,1,0,1,0
8999,57470,0,0,146,146,0,1,0,1,0
4111,25174,0,0,62,62,0,1,0,1,0
11005,30188,0,0,146,146,0,1,0,1,0
1081,43109,0,0,146,146,0,1,0,1,0
13525,51505,0,0,62,62,0,1,0,1,0
42542,25174,0,0,62,62,0,1,0,1,0
51865,61689,0,0,62,62,0,1,0,1,0
50446,26467,0,0,66,66,0,1,0,1,0
2938,64147,0,0,62,62,0,1,0,1,0
58638,5900,0,0,62,62,0,1,0,1,0
46280,5900,0,0,60,60,0,1,0,1,0
13168,35440,0,0,62,62,0,1,0,1,0
14208,51221,0,0,66,66,0,1,0,1,0
54636,26467,0,0,66,66,0,1,0,1,0
57539,44847,0,0,62,62,0,1,0,1,0
52217,22114,0,0,62,62,0,1,0,1,0
29145,8168,0,0,62,62,0,1,0,1,0
58638,5900,0,0,62,62,0,1,0,1,0
13911,57470,0,0,60,60,0,1,0,1,0
42796,22114,0,0,62,62,0,1,0,1,0
48420,54532,0,0,146,146,0,1,0,1,0
62911,36237,0,0,62,62,0,1,0,1,0
45941,23386,0,0,60,60,0,1,0,1,0
60168,35440,0,0,66,66,0,1,0,1,0
19944,22114,0,0,66,66,0,1,0,1,0
22856,22114,0,0,66,66,0,1,0,1,0
58460,36237,0,0,66,66,0,1,0,1,0
43704,37965,0,0,66,66,0,1,0,1,0
6881,64910,0,0,146,146,0,1,0,1,0
55749,37965,0,0,66,66,0,1,0,1,0
64605,35993,0,0,66,66,0,1,0,1,0
10586,37965,0,0,62,62,0,1,0,1,0
51514,50584,0,0,62,62,0,1,0,1,0
1024,64147,0,0,62,62,0,1,0,1,0
49644,30188,0,0,62,62,0,1,0,1,0
443,14591,0,0,60,60,0,1,0,1,0
52655,15503,0,0,146,146,0,1,0,1,0
6881,6881,0,0,146,146,0,1,0,1,0
57239,161,0,0,85,85,0,1,0,1,0
16059,22114,0,0,146,146,0,1,0,1,0
32976,37965,0,0,66,66,0,1,0,1,0
22240,22114,0,0,62,62,0,1,0,1,0
39920,22114,0,0,62,62,0,1,0,1,0
7664,2149,0,0,66,66,0,1,0,1,0
64382,44847,0,0,66,66,0,1,0,1,0
57853,64147,0,0,66,66,0,1,0,1,0
1866,51505,0,0,66,66,0,1,0,1,0
52003,44512,0,0,66,66,0,1,0,1,0
4607,6004,0,0,70,70,0,1,0,1,0
62566,35993,0,0,62,62,0,1,0,1,0
42798,26467,0,0,62,62,0,1,0,1,0
65250,22114,0,0,62,62,0,1,0,1,0
12290,22114,0,0,66,66,0,1,0,1,0
49367,51505,0,0,66,66,0,1,0,1,0
63822,14037,0,0,145,145,0,1,0,1,0
63097,44847,0,0,62,62,0,1,0,1,0
1038,37965,0,0,62,62,0,1,0,1,0
26651,25174,0,0,146,146,0,1,0,1,0
26351,22114,0,0,62,62,0,1,0,1,0
58305,18375,0,0,66,66,0,1,0,1,0
57297,51221,0,0,66,66,0,1,0,1,0
38565,51505,0,0,62,62,0,1,0,1,0
443,49031,0,0,74,74,0,1,0,1,0
25342,8168,0,0,62,62,0,1,0,1,0
48271,25174,0,0,146,146,0,1,0,1,0
54917,60043,0,0,66,66,0,1,0,1,0
14252,35993,0,0,66,66,0,1,0,1,0
45673,30188,0,0,62,62,0,1,0,1,0
59400,22114,0,0,66,66,0,1,0,1,0
10082,64147,0,0,62,62,0,1,0,1,0
24292,48817,0,0,148,148,0,1,0,1,0
42798,26467,0,0,62,62,0,1,0,1,0
33761,25174,0,0,62,62,0,1,0,1,0
4752,30188,0,0,62,62,0,1,0,1,0
42632,44847,0,0,62,62,0,1,0,1,0
59096,8604,0,0,66,66,0,1,0,1,0
57665,52700,0,0,66,66,0,1,0,1,0
53199,30188,0,0,66,66,0,1,0,1,0
4862,37965,0,0,66,66,0,1,0,1,0
49831,30188,0,0,66,66,0,1,0,1,0
39617,50584,0,0,146,146,0,1,0,1,0
5476,23,0,0,60,60,0,1,0,1,0
15499,22114,0,0,146,146,0,1,0,1,0
43611,50939,0,0,145,145,0,1,0,1,0
33814,22114,0,0,146,146,0,1,0,1,0
58638,5900,0,0,62,62,0,1,0,1,0
3478,61463,0,0,1063,1063,0,1,0,1,0
58638,5900,0,0,62,62,0,1,0,1,0
49824,25174,0,0,62,62,0,1,0,1,0
32976,37965,0,0,66,66,0,1,0,1,0
47700,51505,0,0,66,66,0,1,0,1,0
49855,36180,0,0,62,62,0,1,0,1,0
443,36576,0,0,60,60,0,1,0,1,0
58638,5900,0,0,62,62,0,1,0,1,0
26301,22114,0,0,146,146,0,1,0,1,0
59822,56205,0,0,66,66,0,1,0,1,0
3478,61463,0,0,342,342,0,1,0,1,0
13285,29892,0,0,145,145,0,1,0,1,0
63895,44847,0,0,62,62,0,1,0,1,0
61000,50432,0,0,146,146,0,1,0,1,0
53051,44847,0,0,66,66,0,1,0,1,0
22399,22,0,0,60,60,0,1,0,1,0
1695,30349,0,0,148,148,0,1,0,1,0
60141,30188,0,0,66,66,0,1,0,1,0
12608,21247,0,0,66,66,0,1,0,1,0
54917,60043,0,0,66,66,0,1,0,1,0
2780,23117,0,0,62,62,0,1,0,1,0
18577,25174,0,0,62,62,0,1,0,1,0
55155,2767,0,0,66,66,0,1,0,1,0
58638,5900,0,0,62,62,0,1,0,1,0
2636,11392,0,0,66,66,0,1,0,1,0
3730,17372,0,0,62,62,0,1,0,1,0
62493,50584,0,0,146,146,0,1,0,1,0
26921,26467,0,0,62,62,0,1,0,1,0
58638,5900,0,0,62,62,0,1,0,1,0
46734,50265,0,0,74,74,0,1,0,1,0
11967,57470,0,0,62,62,0,1,0,1,0
33401,51505,0,0,66,66,0,1,0,1,0
58638,5900,0,0,62,62,0,1,0,1,0
38681,15503,0,0,74,74,0,1,0,1,0
12737,35440,0,0,62,62,0,1,0,1,0
57339,57470,0,0,66,66,0,1,0,1,0
1080,8391,0,0,66,66,0,1,0,1,0
45908,33330,0,0,60,60,0,1,0,1,0
723,3389,0,0,74,74,0,1,0,1,0
9353,32761,0,0,110,110,0,1,0,1,0
20167,1550,0,0,104,104,0,1,0,1,0
58681,36829,0,0,74,74,0,1,0,1,0
9687,35440,0,0,66,66,0,1,0,1,0
60351,50584,0,0,66,66,0,1,0,1,0
63717,37965,0,0,66,66,0,1,0,1,0
63445,64631,0,0,66,66,0,1,0,1,0
58638,5900,0,0,62,62,0,1,0,1,0
26084,36237,0,0,66,66,0,1,0,1,0
58638,5900,0,0,62,62,0,1,0,1,0
443,5705,0,0,60,60,0,1,0,1,0
24301,6881,0,0,62,62,0,1,0,1,0
63690,64147,0,0,66,66,0,1,0,1,0
443,61686,0,0,90,90,0,1,0,1,0
53779,51505,0,0,66,66,0,1,0,1,0
41197,30188,0,0,62,62,0,1,0,1,0
21064,25174,0,0,62,62,0,1,0,1,0
56191,22114,0,0,62,62,0,1,0,1,0
51909,6881,0,0,66,66,0,1,0,1,0
59411,37965,0,0,66,66,0,1,0,1,0
24062,51505,0,0,146,146,0,1,0,1,0
46292,42873,0,0,72,72,0,1,0,1,0
52913,2767,0,0,66,66,0,1,0,1,0
56798,9571,0,0,62,62,0,1,0,1,0
50828,23,0,0,60,60,0,1,0,1,0
1025,35447,0,0,62,62,0,1,0,1,0
64509,9571,0,0,62,62,0,1,0,1,0
33352,50584,0,0,146,146,0,1,0,1,0
52459,5555,0,0,60,60,0,1,0,1,0
42745,50011,0,0,62,62,0,1,0,1,0
61963,6881,0,0,146,146,0,1,0,1,0
56703,50584,0,0,62,62,0,1,0,1,0
19245,64147,0,0,66,66,0,1,0,1,0
59842,62413,0,0,62,62,0,1,0,1,0
7342,22114,0,0,66,66,0,1,0,1,0
20726,2767,0,0,62,62,0,1,0,1,0
26048,21,0,0,60,60,0,1,0,1,0
1024,25174,0,0,62,62,0,1,0,1,0
16387,16862,0,0,60,60,0,1,0,1,0
37011,25174,0,0,62,62,0,1,0,1,0
49594,22114,0,0,66,66,0,1,0,1,0
54991,36829,0,0,66,66,0,1,0,1,0
443,21255,0,0,66,66,0,1,0,1,0
58638,5900,0,0,62,62,0,1,0,1,0
54684,37965,0,0,62,62,0,1,0,1,0
59324,17,0,0,60,60,0,1,0,1,0
34166,22114,0,0,62,62,0,1,0,1,0
33822,57470,0,0,66,66,0,1,0,1,0
54277,22114,0,0,62,62,0,1,0,1,0
52988,53567,0,0,62,62,0,1,0,1,0
515,10214,0,0,66,66,0,1,0,1,0
64343,6004,0,0,66,66,0,1,0,1,0
56278,52752,0,0,62,62,0,1,0,1,0
48706,23393,0,0,60,60,0,1,0,1,0
42898,25174,0,0,62,62,0,1,0,1,0
11136,15503,0,0,145,145,0,1,0,1,0
1538,50584,0,0,146,146,0,1,0,1,0
45908,33330,0,0,60,60,0,1,0,1,0
45964,2228,0,0,60,60,0,1,0,1,0
59701,44847,0,0,66,66,0,1,0,1,0
58638,5900,0,0,62,62,0,1,0,1,0
13441,57470,0,0,62,62,0,1,0,1,0
58638,5900,0,0,62,62,0,1,0,1,0
61002,26314,0,0,143,143,0,1,0,1,0
47256,37807,0,0,146,146,0,1,0,1,0
38723,15503,0,0,146,146,0,1,0,1,0
46448,30170,0,0,159,159,0,1,0,1,0
55735,50584,0,0,62,62,0,1,0,1,0
42344,48637,0,0,60,60,0,1,0,1,0
18415,37965,0,0,62,62,0,1,0,1,0
29139,64147,0,0,62,62,0,1,0,1,0
50211,51050,0,0,66,66,0,1,0,1,0
10532,26672,0,0,60,60,0,1,0,1,0
61223,37965,0,0,66,66,0,1,0,1,0
18771,35440,0,0,66,66,0,1,0,1,0
0,0,0,0,98,98,0,1,0,1,0
65015,22114,0,0,66,66,0,1,0,1,0
40312,55442,0,0,62,62,0,1,0,1,0
61845,11392,0,0,66,66,0,1,0,1,0
59739,35253,0,0,62,62,0,1,0,1,0
16826,22,0,0,60,60,0,1,0,1,0
65388,55783,0,0,66,66,0,1,0,1,0
41954,2323,0,0,60,60,0,1,0,1,0
54796,22114,0,0,66,66,0,1,0,1,0
46849,36237,0,0,62,62,0,1,0,1,0
14693,64147,0,0,66,66,0,1,0,1,0
21674,28189,0,0,60,60,0,1,0,1,0
64362,35253,0,0,146,146,0,1,0,1,0
1024,44847,0,0,62,62,0,1,0,1,0
54483,25174,0,0,66,66,0,1,0,1,0
6666,16010,0,0,60,60,0,1,0,1,0
54754,50432,0,0,66,66,0,1,0,1,0
61057,25174,0,0,62,62,0,1,0,1,0
20682,57470,0,0,62,62,0,1,0,1,0
35833,23,0,0,60,60,0,1,0,1,0
1046,48817,0,0,62,62,0,1,0,1,0
26425,22114,0,0,62,62,0,1,0,1,0
64115,2767,0,0,66,66,0,1,0,1,0
6057,51221,0,0,78,78,0,1,0,1,0
64923,25174,0,0,66,66,0,1,0,1,0
39132,44847,0,0,62,62,0,1,0,1,0
22677,25174,0,0,66,66,0,1,0,1,0
33003,28543,0,0,62,62,0,1,0,1,0
55839,56535,0,0,62,62,0,1,0,1,0
28878,51505,0,0,146,146,0,1,0,1,0
30306,23,0,0,60,60,0,1,0,1,0
25679,27189,0,0,62,62,0,1,0,1,0
14350,56205,0,0,146,146,0,1,0,1,0
55296,23718,0,0,66,66,0,1,0,1,0
27419,23,0,0,60,60,0,1,0,1,0
49196,25174,0,0,66,66,0,1,0,1,0
64877,37450,0,0,66,66,0,1,0,1,0
58638,5900,0,0,62,62,0,1,0,1,0
54167,50584,0,0,66,66,0,1,0,1,0
62153,35440,0,0,66,66,0,1,0,1,0
45908,33330,0,0,60,60,0,1,0,1,0
50090,50265,0,0,66,66,0,1,0,1,0
443,28215,0,0,60,60,0,1,0,1,0
65494,53,0,0,88,88,0,1,0,1,0
63334,37807,0,0,66,66,0,1,0,1,0
443,34599,0,0,60,60,0,1,0,1,0
55429,25174,0,0,66,66,0,1,0,1,0
55373,1,0,0,66,66,0,1,0,1,0
54471,36237,0,0,66,66,0,1,0,1,0
53161,51221,0,0,66,66,0,1,0,1,0
26606,40108,0,0,145,145,0,1,0,1,0
58900,37807,0,0,62,62,0,1,0,1,0
52745,57866,0,0,62,62,0,1,0,1,0
60049,25174,0,0,66,66,0,1,0,1,0
43888,64147,0,0,62,62,0,1,0,1,0
50655,26467,0,0,66,66,0,1,0,1,0
12318,36866,0,0,139,139,0,1,0,1,0
25797,30188,0,0,146,146,0,1,0,1,0
35229,32468,0,0,62,62,0,1,0,1,0
60550,50584,0,0,146,146,0,1,0,1,0
34932,38608,0,0,62,62,0,1,0,1,0
53071,25174,0,0,66,66,0,1,0,1,0
60479,25174,0,0,66,66,0,1,0,1,0
59694,50584,0,0,62,62,0,1,0,1,0
59400,22114,0,0,62,62,0,1,0,1,0
58638,5900,0,0,62,62,0,1,0,1,0
21322,25174,0,0,62,62,0,1,0,1,0
53207,50584,0,0,66,66,0,1,0,1,0
443,60496,0,0,187,187,0,1,0,1,0
50341,37965,0,0,66,66,0,1,0,1,0
56306,15503,0,0,146,146,0,1,0,1,0
9687,57470,0,0,78,78,0,1,0,1,0
37429,25174,0,0,62,62,0,1,0,1,0
56453,37965,0,0,66,66,0,1,0,1,0
48706,23393,0,0,60,60,0,1,0,1,0
43584,24748,0,0,156,156,0,1,0,1,0
52336,64097,0,0,66,66,0,1,0,1,0
62725,51221,0,0,66,66,0,1,0,1,0
58638,5900,0,0,62,62,0,1,0,1,0
59201,51221,0,0,66,66,0,1,0,1,0
27621,50584,0,0,62,62,0,1,0,1,0
61419,57470,0,0,66,66,0,1,0,1,0
50086,57470,0,0,66,66,0,1,0,1,0
63213,57866,0,0,66,66,0,1,0,1,0
13963,50584,0,0,66,66,0,1,0,1,0
1128,44847,0,0,62,62,0,1,0,1,0
50337,37965,0,0,66,66,0,1,0,1,0
19885,64147,0,0,62,62,0,1,0,1,0
58638,5900,0,0,62,62,0,1,0,1,0
55994,22114,0,0,66,66,0,1,0,1,0
12311,6881,0,0,62,62,0,1,0,1,0
1024,44847,0,0,62,62,0,1,0,1,0
41734,57470,0,0,62,62,0,1,0,1,0
56785,39004,0,0,145,145,0,1,0,1,0
27745,50584,0,0,62,62,0,1,0,1,0
64940,26467,0,0,62,62,0,1,0,1,0
50708,22114,0,0,62,62,0,1,0,1,0
34166,22114,0,0,146,146,0,1,0,1,0
60141,30188,0,0,66,66,0,1,0,1,0
58638,5900,0,0,62,62,0,1,0,1,0
16862,21247,0,0,62,62,0,1,0,1,0
10088,37807,0,0,66,66,0,1,0,1,0
443,28417,0,0,82,82,0,1,0,1,0
27010,64147,0,0,62,62,0,1,0,1,0
29577,64147,0,0,62,62,0,1,0,1,0
58836,44847,0,0,70,70,0,1,0,1,0
9212,51505,0,0,62,62,0,1,0,1,0
6881,6881,0,0,146,146,0,1,0,1,0
4269,26672,0,0,60,60,0,1,0,1,0
51725,56205,0,0,62,62,0,1,0,1,0
32071,51221,0,0,62,62,0,1,0,1,0
58973,57470,0,0,62,62,0,1,0,1,0
51197,30188,0,0,66,66,0,1,0,1,0
54418,22114,0,0,66,66,0,1,0,1,0
58638,5900,0,0,62,62,0,1,0,1,0
53960,30041,0,0,66,66,0,1,0,1,0
50067,64147,0,0,62,62,0,1,0,1,0
58638,5900,0,0,62,62,0,1,0,1,0
26311,23,0,0,60,60,0,1,0,1,0
63331,51221,0,0,62,62,0,1,0,1,0
21294,57470,0,0,62,62,0,1,0,1,0
54343,50584,0,0,66,66,0,1,0,1,0
23934,41615,0,0,145,145,0,1,0,1,0
35494,22114,0,0,66,66,0,1,0,1,0
47040,25174,0,0,146,146,0,1,0,1,0
32156,51505,0,0,146,146,0,1,0,1,0
56307,52700,0,0,66,66,0,1,0,1,0
20894,51505,0,0,62,62,0,1,0,1,0
62919,9694,0,0,146,146,0,1,0,1,0
35347,20238,0,0,62,62,0,1,0,1,0
6881,21416,0,0,146,146,0,1,0,1,0
61329,51505,0,0,66,66,0,1,0,1,0
1882,43890,0,0,62,62,0,1,0,1,0
64051,36829,0,0,66,66,0,1,0,1,0
60155,23718,0,0,66,66,0,1,0,1,0
39244,36829,0,0,146,146,0,1,0,1,0
19678,36237,0,0,146,146,0,1,0,1,0
6666,8443,0,0,60,60,0,1,0,1,0
61550,5529,0,0,145,145,0,1,0,1,0
39171,22114,0,0,146,146,0,1,0,1,0
53073,32468,0,0,66,66,0,1,0,1,0
58638,5900,0,0,62,62,0,1,0,1,0
10627,36829,0,0,146,146,0,1,0,1,0
59755,44512,0,0,66,66,0,1,0,1,0
50355,43890,0,0,66,66,0,1,0,1,0
56521,32480,0,0,62,62,0,1,0,1,0
59845,15503,0,0,66,66,0,1,0,1,0
10445,46824,0,0,62,62,0,1,0,1,0
16387,41860,0,0,60,60,0,1,0,1,0
443,45788,0,0,332,332,0,1,0,1,0
58638,5900,0,0,62,62,0,1,0,1,0
64387,37965,0,0,62,62,0,1,0,1,0
7482,57470,0,0,66,66,0,1,0,1,0
60786,25174,0,0,66,66,0,1,0,1,0
33003,28543,0,0,62,62,0,1,0,1,0
15933,64147,0,0,62,62,0,1,0,1,0
11716,37965,0,0,62,62,0,1,0,1,0
50637,44847,0,0,66,66,0,1,0,1,0
65398,7129,0,0,66,66,0,1,0,1,0
58638,5900,0,0,62,62,0,1,0,1,0
1811,35440,0,0,62,62,0,1,0,1,0
3766,25174,0,0,62,62,0,1,0,1,0
54189,64147,0,0,66,66,0,1,0,1,0
443,62451,0,0,199,199,0,1,0,1,0
2598,23718,0,0,66,66,0,1,0,1,0
53043,51050,0,0,66,66,0,1,0,1,0
44612,25174,0,0,66,66,0,1,0,1,0
1024,25174,0,0,62,62,0,1,0,1,0
49501,11392,0,0,66,66,0,1,0,1,0
54526,44847,0,0,62,62,0,1,0,1,0
42465,57470,0,0,60,60,0,1,0,1,0
58638,5900,0,0,62,62,0,1,0,1,0
58424,52700,0,0,66,66,0,1,0,1,0
43350,58414,0,0,62,62,0,1,0,1,0
28579,64147,0,0,62,62,0,1,0,1,0
49918,26296,0,0,146,146,0,1,0,1,0
16944,50584,0,0,146,146,0,1,0,1,0
39230,23,0,0,60,60,0,1,0,1,0
11136,15503,0,0,62,62,0,1,0,1,0
4110,35440,0,0,62,62,0,1,0,1,0
61563,37807,0,0,66,66,0,1,0,1,0
55825,52700,0,0,66,66,0,1,0,1,0
47812,30627,0,0,62,62,0,1,0,1,0
26881,25174,0,0,66,66,0,1,0,1,0
21064,25174,0,0,146,146,0,1,0,1,0
52184,22114,0,0,66,66,0,1,0,1,0
51479,25174,0,0,62,62,0,1,0,1,0
443,10010,0,0,60,60,0,1,0,1,0
52018,57866,0,0,66,66,0,1,0,1,0
1025,57470,0,0,62,62,0,1,0,1,0
50562,37965,0,0,66,66,0,1,0,1,0
11136,15503,0,0,62,62,0,1,0,1,0
16654,50265,0,0,62,62,0,1,0,1,0
62824,37807,0,0,62,62,0,1,0,1,0
58638,5900,0,0,62,62,0,1,0,1,0
43129,15503,0,0,62,62,0,1,0,1,0
51244,52290,0,0,100,100,0,1,0,1,0
57799,10387,0,0,145,145,0,1,0,1,0
6721,37965,0,0,66,66,0,1,0,1,0
34112,44847,0,0,66,66,0,1,0,1,0
58543,6881,0,0,146,146,0,1,0,1,0
20619,25174,0,0,66,66,0,1,0,1,0
31404,12082,0,0,100,100,0,1,0,1,0
53024,57866,0,0,146,146,0,1,0,1,0
13985,34159,0,0,66,66,0,1,0,1,0
58638,5900,0,0,62,62,0,1,0,1,0
5617,64147,0,0,62,62,0,1,0,1,0
10965,22114,0,0,62,62,0,1,0,1,0
59563,30188,0,0,66,66,0,1,0,1,0
25151,58833,0,0,146,146,0,1,0,1,0
65384,57470,0,0,66,66,0,1,0,1,0
30580,50265,0,0,66,66,0,1,0,1,0
14993,50584,0,0,62,62,0,1,0,1,0
3352,50584,0,0,66,66,0,1,0,1,0
53376,22114,0,0,62,62,0,1,0,1,0
53233,51221,0,0,66,66,0,1,0,1,0
58638,5900,0,0,62,62,0,1,0,1,0
38763,30188,0,0,146,146,0,1,0,1,0
58638,5900,0,0,62,62,0,1,0,1,0
49992,5900,0,0,60,60,0,1,0,1,0
29363,36237,0,0,146,146,0,1,0,1,0
44919,26467,0,0,62,62,0,1,0,1,0
59068,49813,0,0,74,74,0,1,0,1,0
55893,45711,0,0,78,78,0,1,0,1,0
53097,25174,0,0,62,62,0,1,0,1,0
443,10010,0,0,60,60,0,1,0,1,0
2990,64147,0,0,66,66,0,1,0,1,0
49834,23,0,0,60,60,0,1,0,1,0
60714,50584,0,0,66,66,0,1,0,1,0
1024,57470,0,0,62,62,0,1,0,1,0
57015,42707,0,0,62,62,0,1,0,1,0
8239,37965,0,0,146,146,0,1,0,1,0
45313,64147,0,0,62,62,0,1,0,1,0
3478,61463,0,0,233,233,0,1,0,1,0
63096,44847,0,0,66,66,0,1,0,1,0
57431,15503,0,0,66,66,0,1,0,1,0
43540,1433,0,0,60,60,0,1,0,1,0
58638,5900,0,0,62,62,0,1,0,1,0
27502,50584,0,0,66,66,0,1,0,1,0
65270,3855,0,0,78,78,0,1,0,1,0
58638,5900,0,0,62,62,0,1,0,1,0
58638,5900,0,0,62,62,0,1,0,1,0
58638,5900,0,0,62,62,0,1,0,1,0
47105,64147,0,0,62,62,0,1,0,1,0
59785,14914,0,0,143,143,0,1,0,1,0
10436,37965,0,0,62,62,0,1,0,1,0
39742,62413,0,0,66,66,0,1,0,1,0
55514,1604,0,0,84,84,0,1,0,1,0
59032,25174,0,0,66,66,0,1,0,1,0
58049,50265,0,0,145,145,0,1,0,1,0
59937,18375,0,0,66,66,0,1,0,1,0
59886,64147,0,0,72,72,0,1,0,1,0
2206,25174,0,0,62,62,0,1,0,1,0
19610,9571,0,0,62,62,0,1,0,1,0
44388,63874,0,0,66,66,0,1,0,1,0
63586,46824,0,0,62,62,0,1,0,1,0
61945,48817,0,0,66,66,0,1,0,1,0
56403,51505,0,0,66,66,0,1,0,1,0
59524,25174,0,0,66,66,0,1,0,1,0
13484,37965,0,0,66,66,0,1,0,1,0
3169,22114,0,0,66,66,0,1,0,1,0
52318,22114,0,0,146,146,0,1,0,1,0
16387,3655,0,0,60,60,0,1,0,1,0
11136,15503,0,0,62,62,0,1,0,1,0
58745,30188,0,0,66,66,0,1,0,1,0
54189,22114,0,0,66,66,0,1,0,1,0
58638,5900,0,0,62,62,0,1,0,1,0
55508,64147,0,0,62,62,0,1,0,1,0
62902,32468,0,0,66,66,0,1,0,1,0
0,0,0,0,98,98,0,1,0,1,0
6881,35894,0,0,62,62,0,1,0,1,0
1026,30188,0,0,146,146,0,1,0,1,0
2476,6881,0,0,62,62,0,1,0,1,0
54142,20541,0,0,62,62,0,1,0,1,0
10262,11392,0,0,62,62,0,1,0,1,0
54542,25604,0,0,66,66,0,1,0,1,0
22636,30188,0,0,66,66,0,1,0,1,0
5060,37965,0,0,66,66,0,1,0,1,0
55250,25174,0,0,146,146,0,1,0,1,0
49113,50584,0,0,66,66,0,1,0,1,0
15345,36829,0,0,62,62,0,1,0,1,0
10000,10214,0,0,62,62,0,1,0,1,0
64294,64147,0,0,62,62,0,1,0,1,0
55043,57470,0,0,78,78,0,1,0,1,0
64677,57470,0,0,66,66,0,1,0,1,0
27922,25174,0,0,62,62,0,1,0,1,0
16387,63752,0,0,60,60,0,1,0,1,0
56279,23,0,0,60,60,0,1,0,1,0
61242,35253,0,0,66,66,0,1,0,1,0
31675,23,0,0,60,60,0,1,0,1,0
45941,23386,0,0,60,60,0,1,0,1,0
51490,17500,0,0,100,100,0,1,0,1,0
56148,37965,0,0,66,66,0,1,0,1,0
37014,25174,0,0,66,66,0,1,0,1,0
50799,37807,0,0,62,62,0,1,0,1,0
53771,37965,0,0,66,66,0,1,0,1,0
62150,23718,0,0,66,66,0,1,0,1,0
55396,26467,0,0,62,62,0,1,0,1,0
53995,25174,0,0,66,66,0,1,0,1,0
5132,23,0,0,60,60,0,1,0,1,0
1030,35776,0,0,139,139,0,1,0,1,0
41719,50584,0,0,146,146,0,1,0,1,0
58638,5900,0,0,62,62,0,1,0,1,0
2238,22114,0,0,62,62,0,1,0,1,0
13188,35440,0,0,62,62,0,1,0,1,0
61520,23718,0,0,66,66,0,1,0,1,0
52177,25320,0,0,66,66,0,1,0,1,0
54520,1433,0,0,60,60,0,1,0,1,0
443,11135,0,0,66,66,0,1,0,1,0
28156,50584,0,0,146,146,0,1,0,1,0
57585,51221,0,0,62,62,0,1,0,1,0
58638,5900,0,0,62,62,0,1,0,1,0
23331,25174,0,0,66,66,0,1,0,1,0
38852,37965,0,0,62,62,0,1,0,1,0
3818,37965,0,0,66,66,0,1,0,1,0
64878,26467,0,0,62,62,0,1,0,1,0
56015,56205,0,0,66,66,0,1,0,1,0
55012,64147,0,0,66,66,0,1,0,1,0
41677,57470,0,0,62,62,0,1,0,1,0
43584,24748,0,0,156,156,0,1,0,1,0
33405,37965,0,0,62,62,0,1,0,1,0
58638,5900,0,0,62,62,0,1,0,1,0
18246,64097,0,0,66,66,0,1,0,1,0
62386,37965,0,0,66,66,0,1,0,1,0
64535,37965,0,0,66,66,0,1,0,1,0
64626,50584,0,0,66,66,0,1,0,1,0
11382,43890,0,0,66,66,0,1,0,1,0
58638,5900,0,0,62,62,0,1,0,1,0
54298,48983,0,0,159,159,0,1,0,1,0
58638,5900,0,0,62,62,0,1,0,1,0
64024,22114,0,0,62,62,0,1,0,1,0
22587,30188,0,0,66,66,0,1,0,1,0
57765,2767,0,0,146,146,0,1,0,1,0
17289,25174,0,0,146,146,0,1,0,1,0
19875,30170,0,0,145,145,0,1,0,1,0
25237,57470,0,0,62,62,0,1,0,1,0
58638,5900,0,0,62,62,0,1,0,1,0
57557,64147,0,0,66,66,0,1,0,1,0
38093,11392,0,0,146,146,0,1,0,1,0
56638,64147,0,0,62,62,0,1,0,1,0
39824,51505,0,0,62,62,0,1,0,1,0
35722,30188,0,0,146,146,0,1,0,1,0
60416,37965,0,0,66,66,0,1,0,1,0
61808,18375,0,0,66,66,0,1,0,1,0
26239,25174,0,0,66,66,0,1,0,1,0
65003,57470,0,0,78,78,0,1,0,1,0
59988,64147,0,0,66,66,0,1,0,1,0
1162,57470,0,0,62,62,0,1,0,1,0
26752,64147,0,0,62,62,0,1,0,1,0
43578,15503,0,0,74,74,0,1,0,1,0
12164,22114,0,0,62,62,0,1,0,1,0
53353,26467,0,0,62,62,0,1,0,1,0
57837,64147,0,0,66,66,0,1,0,1,0
51042,22114,0,0,66,66,0,1,0,1,0
61150,11392,0,0,62,62,0,1,0,1,0
1262,23,0,0,60,60,0,1,0,1,0
17811,23,0,0,60,60,0,1,0,1,0
43725,57470,0,0,109,109,0,1,0,1,0
443,44683,0,0,83,83,0,1,0,1,0
7686,25174,0,0,62,62,0,1,0,1,0
60646,11392,0,0,66,66,0,1,0,1,0
63469,64147,0,0,62,62,0,1,0,1,0
16376,35440,0,0,146,146,0,1,0,1,0
58638,5900,0,0,62,62,0,1,0,1,0
57459,51505,0,0,62,62,0,1,0,1,0
52519,44847,0,0,62,62,0,1,0,1,0
47771,25174,0,0,146,146,0,1,0,1,0
56564,9571,0,0,78,78,0,1,0,1,0
28124,37965,0,0,62,62,0,1,0,1,0
62838,44847,0,0,66,66,0,1,0,1,0
55817,36829,0,0,66,66,0,1,0,1,0
0,0,0,0,60,60,0,1,0,1,0
56098,64147,0,0,66,66,0,1,0,1,0
57283,64147,0,0,66,66,0,1,0,1,0
22036,44847,0,0,62,62,0,1,0,1,0
2791,7302,0,0,62,62,0,1,0,1,0
2543,25174,0,0,66,66,0,1,0,1,0
443,22323,0,0,61,61,0,1,0,1,0
61408,30188,0,0,66,66,0,1,0,1,0
27824,51505,0,0,62,62,0,1,0,1,0
58638,5900,0,0,62,62,0,1,0,1,0
37014,23,0,0,60,60,0,1,0,1,0
26884,57866,0,0,74,74,0,1,0,1,0
53260,36237,0,0,146,146,0,1,0,1,0
19858,38211,0,0,145,145,0,1,0,1,0
63488,22114,0,0,62,62,0,1,0,1,0
58638,5900,0,0,62,62,0,1,0,1,0
56442,11392,0,0,66,66,0,1,0,1,0
40977,21247,0,0,66,66,0,1,0,1,0
45941,23386,0,0,60,60,0,1,0,1,0
60761,51221,0,0,66,66,0,1,0,1,0
30114,65151,0,0,60,60,0,1,0,1,0
58638,5900,0,0,62,62,0,1,0,1,0
52929,1433,0,0,60,60,0,1,0,1,0
61583,64147,0,0,66,66,0,1,0,1,0
28914,26296,0,0,159,159,0,1,0,1,0
23089,48817,0,0,62,62,0,1,0,1,0
18655,44847,0,0,66,66,0,1,0,1,0
1972,57470,0,0,78,78,0,1,0,1,0
39920,22114,0,0,62,62,0,1,0,1,0
21322,25174,0,0,62,62,0,1,0,1,0
4041,50584,0,0,62,62,0,1,0,1,0
26906,22114,0,0,66,66,0,1,0,1,0
62912,26467,0,0,62,62,0,1,0,1,0
59696,57470,0,0,62,62,0,1,0,1,0
25901,50265,0,0,62,62,0,1,0,1,0
44746,37965,0,0,62,62,0,1,0,1,0
64324,37807,0,0,62,62,0,1,0,1,0
1955,35974,0,0,60,60,0,1,0,1,0
57496,25174,0,0,62,62,0,1,0,1,0
26332,57470,0,0,62,62,0,1,0,1,0
24174,57470,0,0,62,62,0,1,0,1,0
55375,44847,0,0,66,66,0,1,0,1,0
58687,11392,0,0,66,66,0,1,0,1,0
4545,1900,0,0,136,136,0,1,0,1,0
1024,64147,0,0,62,62,0,1,0,1,0
12143,56205,0,0,66,66,0,1,0,1,0
20939,60461,0,0,60,60,0,1,0,1,0
4752,30188,0,0,62,62,0,1,0,1,0
45944,44847,0,0,62,62,0,1,0,1,0
58638,5900,0,0,62,62,0,1,0,1,0
24021,6881,0,0,146,146,0,1,0,1,0
45908,33330,0,0,60,60,0,1,0,1,0
57585,51221,0,0,62,62,0,1,0,1,0
0,0,0,0,70,70,0,1,0,1,0
45941,23386,0,0,60,60,0,1,0,1,0
18876,44847,0,0,66,66,0,1,0,1,0
36080,26467,0,0,62,62,0,1,0,1,0
9836,22114,0,0,66,66,0,1,0,1,0
52914,37965,0,0,66,66,0,1,0,1,0
3478,61463,0,0,814,814,0,1,0,1,0
22439,25174,0,0,66,66,0,1,0,1,0
7810,25174,0,0,66,66,0,1,0,1,0
7087,23,0,0,60,60,0,1,0,1,0
58230,64147,0,0,66,66,0,1,0,1,0
63364,57470,0,0,66,66,0,1,0,1,0
443,20995,0,0,83,83,0,1,0,1,0
48706,23393,0,0,60,60,0,1,0,1,0
56906,50584,0,0,62,62,0,1,0,1,0
51197,57470,0,0,66,66,0,1,0,1,0
16293,57470,0,0,62,62,0,1,0,1,0
59948,22114,0,0,146,146,0,1,0,1,0
43671,37965,0,0,62,62,0,1,0,1,0
12616,23,0,0,60,60,0,1,0,1,0
51094,35440,0,0,62,62,0,1,0,1,0
58638,5900,0,0,62,62,0,1,0,1,0
58638,5900,0,0,62,62,0,1,0,1,0
59413,51505,0,0,66,66,0,1,0,1,0
63786,25174,0,0,66,66,0,1,0,1,0
26758,50584,0,0,66,66,0,1,0,1,0
6881,57470,0,0,146,146,0,1,0,1,0
59377,9319,0,0,62,62,0,1,0,1,0
7041,37965,0,0,62,62,0,1,0,1,0
54552,64147,0,0,62,62,0,1,0,1,0
50052,65008,0,0,60,60,0,1,0,1,0
58638,5900,0,0,62,62,0,1,0,1,0
6881,6881,0,0,62,62,0,1,0,1,0
26502,64147,0,0,62,62,0,1,0,1,0
53985,30188,0,0,66,66,0,1,0,1,0
53073,32468,0,0,66,66,0,1,0,1,0
55468,23,0,0,60,60,0,1,0,1,0
61730,25320,0,0,66,66,0,1,0,1,0
28825,23,0,0,60,60,0,1,0,1,0
45944,44847,0,0,62,62,0,1,0,1,0
48478,49903,0,0,62,62,0,1,0,1,0
27081,10197,0,0,62,62,0,1,0,1,0
31136,50584,0,0,62,62,0,1,0,1,0
15296,37965,0,0,62,62,0,1,0,1,0
54277,22114,0,0,62,62,0,1,0,1,0
1663,30188,0,0,66,66,0,1,0,1,0
45941,23386,0,0,60,60,0,1,0,1,0
2598,23718,0,0,66,66,0,1,0,1,0
52808,57470,0,0,146,146,0,1,0,1,0
37121,21247,0,0,66,66,0,1,0,1,0
11404,64147,0,0,62,62,0,1,0,1,0
52863,50584,0,0,66,66,0,1,0,1,0
3730,37965,0,0,62,62,0,1,0,1,0
34470,57470,0,0,66,66,0,1,0,1,0
36566,37965,0,0,62,62,0,1,0,1,0
25150,25174,0,0,62,62,0,1,0,1,0
5223,59023,0,0,66,66,0,1,0,1,0
58955,57470,0,0,74,74,0,1,0,1,0
54666,36237,0,0,66,66,0,1,0,1,0
51966,25174,0,0,62,62,0,1,0,1,0
40005,36237,0,0,62,62,0,1,0,1,0
58638,5900,0,0,62,62,0,1,0,1,0
21777,50584,0,0,62,62,0,1,0,1,0
46864,25174,0,0,146,146,0,1,0,1,0
55435,25174,0,0,62,62,0,1,0,1,0
59192,25174,0,0,66,66,0,1,0,1,0
56494,57587,0,0,146,146,0,1,0,1,0
52471,22114,0,0,62,62,0,1,0,1,0
54118,6004,0,0,66,66,0,1,0,1,0
16979,56205,0,0,66,66,0,1,0,1,0
58638,5900,0,0,62,62,0,1,0,1,0
56250,36237,0,0,66,66,0,1,0,1,0
62787,51221,0,0,66,66,0,1,0,1,0
62438,37807,0,0,66,66,0,1,0,1,0
46389,27098,0,0,66,66,0,1,0,1,0
21733,56205,0,0,66,66,0,1,0,1,0
52569,30188,0,0,66,66,0,1,0,1,0
52910,51221,0,0,78,78,0,1,0,1,0
53650,64147,0,0,66,66,0,1,0,1,0
11030,17372,0,0,62,62,0,1,0,1,0
58791,25174,0,0,146,146,0,1,0,1,0
16687,10214,0,0,66,66,0,1,0,1,0
19175,50584,0,0,146,146,0,1,0,1,0
45908,33330,0,0,60,60,0,1,0,1,0
61609,25174,0,0,146,146,0,1,0,1,0
23936,41615,0,0,146,146,0,1,0,1,0
41499,23,0,0,60,60,0,1,0,1,0
45941,23386,0,0,60,60,0,1,0,1,0
45964,3111,0,0,60,60,0,1,0,1,0
59051,27520,0,0,62,62,0,1,0,1,0
34176,51505,0,0,146,146,0,1,0,1,0
26333,23,0,0,60,60,0,1,0,1,0
46945,64147,0,0,62,62,0,1,0,1,0
26301,22114,0,0,62,62,0,1,0,1,0
9445,56205,0,0,62,62,0,1,0,1,0
61315,48817,0,0,62,62,0,1,0,1,0
58488,37965,0,0,62,62,0,1,0,1,0
51382,56205,0,0,66,66,0,1,0,1,0
22856,22114,0,0,62,62,0,1,0,1,0
62549,53733,0,0,66,66,0,1,0,1,0
52726,56205,0,0,66,66,0,1,0,1,0
30373,23,0,0,60,60,0,1,0,1,0
56326,56205,0,0,66,66,0,1,0,1,0
10916,44847,0,0,66,66,0,1,0,1,0
25296,51505,0,0,66,66,0,1,0,1,0
25360,51505,0,0,66,66,0,1,0,1,0
4127,26467,0,0,62,62,0,1,0,1,0
49001,40108,0,0,161,161,0,1,0,1,0
52625,25174,0,0,66,66,0,1,0,1,0
31061,23,0,0,60,60,0,1,0,1,0
56462,37965,0,0,66,66,0,1,0,1,0
6356,26467,0,0,62,62,0,1,0,1,0
52390,2323,0,0,60,60,0,1,0,1,0
443,46569,0,0,66,66,0,1,0,1,0
48660,21622,0,0,143,143,0,1,0,1,0
3047,50584,0,0,146,146,0,1,0,1,0
50853,50584,0,0,66,66,0,1,0,1,0
38475,11392,0,0,66,66,0,1,0,1,0
6828,64322,0,0,60,60,0,1,0,1,0
59481,41182,0,0,62,62,0,1,0,1,0
55689,37965,0,0,66,66,0,1,0,1,0
0,0,0,0,98,98,0,1,0,1,0
53771,57470,0,0,66,66,0,1,0,1,0
55874,64147,0,0,66,66,0,1,0,1,0
43688,22114,0,0,66,66,0,1,0,1,0
25254,5555,0,0,60,60,0,1,0,1,0
32983,51221,0,0,66,66,0,1,0,1,0
62796,37807,0,0,62,62,0,1,0,1,0
62709,57470,0,0,62,62,0,1,0,1,0
65115,50584,0,0,66,66,0,1,0,1,0
3478,61463,0,0,933,933,0,1,0,1,0
20400,64147,0,0,62,62,0,1,0,1,0
8976,44847,0,0,62,62,0,1,0,1,0
58638,5900,0,0,62,62,0,1,0,1,0
46149,23,0,0,60,60,0,1,0,1,0
55565,64147,0,0,62,62,0,1,0,1,0
29682,44847,0,0,62,62,0,1,0,1,0
64339,18375,0,0,66,66,0,1,0,1,0
58638,5900,0,0,62,62,0,1,0,1,0
59055,11392,0,0,66,66,0,1,0,1,0
38358,22300,0,0,60,60,0,1,0,1,0
17177,64147,0,0,62,62,0,1,0,1,0
1733,65448,0,0,66,66,0,1,0,1,0
56173,37807,0,0,62,62,0,1,0,1,0
27841,35894,0,0,62,62,0,1,0,1,0
48258,37965,0,0,62,62,0,1,0,1,0
57987,56125,0,0,90,90,0,1,0,1,0
58638,5900,0,0,62,62,0,1,0,1,0
58357,62413,0,0,62,62,0,1,0,1,0
8191,51221,0,0,62,62,0,1,0,1,0
52741,24211,0,0,66,66,0,1,0,1,0
58638,5900,0,0,62,62,0,1,0,1,0
23274,50584,0,0,62,62,0,1,0,1,0
18398,21247,0,0,66,66,0,1,0,1,0
11136,15503,0,0,62,62,0,1,0,1,0
58638,5900,0,0,62,62,0,1,0,1,0
36419,50584,0,0,62,62,0,1,0,1,0
54883,51505,0,0,62,62,0,1,0,1,0
56753,44847,0,0,62,62,0,1,0,1,0
28306,25604,0,0,62,62,0,1,0,1,0
39359,15503,0,0,74,74,0,1,0,1,0
49976,22114,0,0,66,66,0,1,0,1,0
2691,64147,0,0,62,62,0,1,0,1,0
53459,37807,0,0,62,62,0,1,0,1,0
58638,5900,0,0,62,62,0,1,0,1,0
58638,5900,0,0,62,62,0,1,0,1,0
58638,5900,0,0,62,62,0,1,0,1,0
16387,35583,0,0,60,60,0,1,0,1,0
14844,37965,0,0,62,62,0,1,0,1,0
43671,17372,0,0,62,62,0,1,0,1,0
64772,64147,0,0,66,66,0,1,0,1,0
12841,37965,0,0,62,62,0,1,0,1,0
16057,56205,0,0,66,66,0,1,0,1,0
43269,50584,0,0,66,66,0,1,0,1,0
57131,26296,0,0,145,145,0,1,0,1,0
60899,25174,0,0,66,66,0,1,0,1,0
10797,50584,0,0,62,62,0,1,0,1,0
62838,44847,0,0,66,66,0,1,0,1,0
64024,57470,0,0,66,66,0,1,0,1,0
59459,37807,0,0,66,66,0,1,0,1,0
55429,25174,0,0,66,66,0,1,0,1,0
52328,44847,0,0,62,62,0,1,0,1,0
58638,5900,0,0,62,62,0,1,0,1,0
10775,35440,0,0,62,62,0,1,0,1,0
58638,5900,0,0,62,62,0,1,0,1,0
55666,35440,0,0,60,60,0,1,0,1,0
59611,56205,0,0,66,66,0,1,0,1,0
62799,25174,0,0,62,62,0,1,0,1,0
52432,50265,0,0,66,66,0,1,0,1,0
56703,50584,0,0,66,66,0,1,0,1,0
50127,64147,0,0,62,62,0,1,0,1,0
55839,56535,0,0,62,62,0,1,0,1,0
1818,22114,0,0,62,62,0,1,0,1,0
58638,5900,0,0,62,62,0,1,0,1,0
59592,37965,0,0,62,62,0,1,0,1,0
42223,67,0,0,60,60,0,1,0,1,0
62549,64147,0,0,62,62,0,1,0,1,0
48125,7548,0,0,60,60,0,1,0,1,0
32701,23,0,0,60,60,0,1,0,1,0
16221,50584,0,0,62,62,0,1,0,1,0
50116,22,0,0,60,60,0,1,0,1,0
48706,23393,0,0,60,60,0,1,0,1,0
25901,50265,0,0,62,62,0,1,0,1,0
41648,56205,0,0,66,66,0,1,0,1,0
8999,57470,0,0,146,146,0,1,0,1,0
56582,23718,0,0,62,62,0,1,0,1,0
65153,38303,0,0,62,62,0,1,0,1,0
62148,37965,0,0,62,62,0,1,0,1,0
52650,44847,0,0,66,66,0,1,0,1,0
443,43775,0,0,97,97,0,1,0,1,0
24910,64147,0,0,66,66,0,1,0,1,0
23528,44847,0,0,146,146,0,1,0,1,0
46679,64147,0,0,62,62,0,1,0,1,0
65249,25864,0,0,72,72,0,1,0,1,0
9494,23,0,0,60,60,0,1,0,1,0
60398,46776,0,0,74,74,0,1,0,1,0
22856,22114,0,0,66,66,0,1,0,1,0
1025,35447,0,0,62,62,0,1,0,1,0
1441,51221,0,0,62,62,0,1,0,1,0
1054,57470,0,0,62,62,0,1,0,1,0
18683,26467,0,0,62,62,0,1,0,1,0
58638,5900,0,0,62,62,0,1,0,1,0
45908,33330,0,0,60,60,0,1,0,1,0
63855,25174,0,0,146,146,0,1,0,1,0
53822,25174,0,0,66,66,0,1,0,1,0
27908,23,0,0,60,60,0,1,0,1,0
57987,56125,0,0,90,90,0,1,0,1,0
50547,22197,0,0,66,66,0,1,0,1,0
53355,23117,0,0,66,66,0,1,0,1,0
64324,37807,0,0,146,146,0,1,0,1,0
13911,57470,0,0,60,60,0,1,0,1,0
12226,37965,0,0,62,62,0,1,0,1,0
50283,49169,0,0,62,62,0,1,0,1,0
52696,21247,0,0,62,62,0,1,0,1,0
28124,37965,0,0,145,145,0,1,0,1,0
59345,25174,0,0,62,62,0,1,0,1,0
52022,52752,0,0,74,74,0,1,0,1,0
51298,57470,0,0,66,66,0,1,0,1,0
63840,36829,0,0,66,66,0,1,0,1,0
19068,37965,0,0,62,62,0,1,0,1,0
1024,25174,0,0,146,146,0,1,0,1,0
27328,21247,0,0,66,66,0,1,0,1,0
1038,37965,0,0,62,62,0,1,0,1,0
22036,44847,0,0,62,62,0,1,0,1,0
2422,50584,0,0,62,62,0,1,0,1,0
59524,25174,0,0,66,66,0,1,0,1,0
10381,22114,0,0,62,62,0,1,0,1,0
21213,23,0,0,60,60,0,1,0,1,0
16387,16862,0,0,60,60,0,1,0,1,0
1860,25174,0,0,66,66,0,1,0,1,0
60883,64147,0,0,70,70,0,1,0,1,0
58486,57470,0,0,66,66,0,1,0,1,0
47173,35440,0,0,146,146,0,1,0,1,0
43584,24748,0,0,156,156,0,1,0,1,0
0,0,0,0,70,70,0,1,0,1,0
51045,25174,0,0,66,66,0,1,0,1,0
51339,50584,0,0,62,62,0,1,0,1,0
23519,25174,0,0,62,62,0,1,0,1,0
16037,25174,0,0,62,62,0,1,0,1,0
62804,37965,0,0,66,66,0,1,0,1,0
54051,28793,0,0,66,66,0,1,0,1,0
45682,37965,0,0,62,62,0,1,0,1,0
4162,21532,0,0,146,146,0,1,0,1,0
62885,62413,0,0,66,66,0,1,0,1,0
64586,50584,0,0,62,62,0,1,0,1,0
16387,64075,0,0,60,60,0,1,0,1,0
50088,1604,0,0,84,84,0,1,0,1,0
4019,50584,0,0,66,66,0,1,0,1,0
30650,25174,0,0,62,62,0,1,0,1,0
61280,26467,0,0,66,66,0,1,0,1,0
63840,36829,0,0,62,62,0,1,0,1,0
58550,21247,0,0,62,62,0,1,0,1,0
63398,25174,0,0,66,66,0,1,0,1,0
64962,64147,0,0,66,66,0,1,0,1,0
65270,3855,0,0,78,78,0,1,0,1,0
60389,16933,0,0,66,66,0,1,0,1,0
43104,26467,0,0,62,62,0,1,0,1,0
62408,50584,0,0,66,66,0,1,0,1,0
28286,22114,0,0,62,62,0,1,0,1,0
63343,53,0,0,74,74,0,1,0,1,0
49191,35440,0,0,66,66,0,1,0,1,0
64283,37965,0,0,74,74,0,1,0,1,0
1441,51221,0,0,62,62,0,1,0,1,0
58977,37965,0,0,66,66,0,1,0,1,0
443,9986,0,0,297,297,0,1,0,1,0
36881,56205,0,0,62,62,0,1,0,1,0
49516,35894,0,0,62,62,0,1,0,1,0
8239,37965,0,0,146,146,0,1,0,1,0
51430,25174,0,0,62,62,0,1,0,1,0
35154,42707,0,0,62,62,0,1,0,1,0
51505,17372,0,0,66,66,0,1,0,1,0
52754,26467,0,0,66,66,0,1,0,1,0
1040,6004,0,0,72,72,0,1,0,1,0
51414,22,0,0,60,60,0,1,0,1,0
50407,62413,0,0,62,62,0,1,0,1,0
57164,50584,0,0,62,62,0,1,0,1,0
443,45788,0,0,199,199,0,1,0,1,0
55620,30188,0,0,66,66,0,1,0,1,0
59736,51505,0,0,62,62,0,1,0,1,0
59128,44847,0,0,66,66,0,1,0,1,0
13554,44847,0,0,62,62,0,1,0,1,0
28385,50584,0,0,146,146,0,1,0,1,0
3521,6881,0,0,62,62,0,1,0,1,0
17453,35440,0,0,62,62,0,1,0,1,0
43611,32480,0,0,109,109,0,1,0,1,0
10669,49756,0,0,60,60,0,1,0,1,0
17004,64147,0,0,66,66,0,1,0,1,0
25523,35974,0,0,145,145,0,1,0,1,0
11716,37965,0,0,62,62,0,1,0,1,0
10949,22114,0,0,62,62,0,1,0,1,0
39583,37965,0,0,66,66,0,1,0,1,0
55973,25174,0,0,62,62,0,1,0,1,0
29291,40108,0,0,150,150,0,1,0,1,0
27348,22114,0,0,66,66,0,1,0,1,0
64755,31573,0,0,66,66,0,1,0,1,0
58638,5900,0,0,62,62,0,1,0,1,0
51155,56205,0,0,62,62,0,1,0,1,0
19361,23117,0,0,66,66,0,1,0,1,0
16013,61903,0,0,145,145,0,1,0,1,0
63701,46824,0,0,66,66,0,1,0,1,0
45941,23388,0,0,60,60,0,1,0,1,0
35261,15503,0,0,74,74,0,1,0,1,0
40512,57470,0,0,74,74,0,1,0,1,0
1256,50584,0,0,146,146,0,1,0,1,0
10669,49756,0,0,60,60,0,1,0,1,0
23512,57354,0,0,145,145,0,1,0,1,0
24376,50584,0,0,66,66,0,1,0,1,0
5227,50584,0,0,62,62,0,1,0,1,0
19245,64147,0,0,66,66,0,1,0,1,0
50710,50584,0,0,146,146,0,1,0,1,0
7905,22114,0,0,66,66,0,1,0,1,0
49982,37965,0,0,66,66,0,1,0,1,0
58638,5900,0,0,62,62,0,1,0,1,0
1972,57470,0,0,78,78,0,1,0,1,0
51592,51505,0,0,66,66,0,1,0,1,0
58247,57866,0,0,66,66,0,1,0,1,0
47561,26467,0,0,62,62,0,1,0,1,0
25536,50584,0,0,62,62,0,1,0,1,0
24285,26467,0,0,62,62,0,1,0,1,0
5228,3434,0,0,345,345,0,1,0,1,0
46367,36237,0,0,66,66,0,1,0,1,0
53871,37965,0,0,66,66,0,1,0,1,0
25237,25174,0,0,146,146,0,1,0,1,0
47403,57470,0,0,109,109,0,1,0,1,0
18623,1,0,0,66,66,0,1,0,1,0
26263,8168,0,0,62,62,0,1,0,1,0
20168,81,0,0,60,60,0,1,0,1,0
10462,25174,0,0,62,62,0,1,0,1,0
54423,21247,0,0,66,66,0,1,0,1,0
57987,56125,0,0,90,90,0,1,0,1,0
49308,22114,0,0,66,66,0,1,0,1,0
52361,23718,0,0,66,66,0,1,0,1,0
16327,55442,0,0,66,66,0,1,0,1,0
58486,57470,0,0,66,66,0,1,0,1,0
54518,25174,0,0,62,62,0,1,0,1,0
57368,7302,0,0,66,66,0,1,0,1,0
1138,42873,0,0,62,62,0,1,0,1,0
51827,56205,0,0,66,66,0,1,0,1,0
58638,5900,0,0,62,62,0,1,0,1,0
41541,25174,0,0,66,66,0,1,0,1,0
59842,62413,0,0,66,66,0,1,0,1,0
65492,2323,0,0,60,60,0,1,0,1,0
23021,25174,0,0,66,66,0,1,0,1,0
7105,25174,0,0,66,66,0,1,0,1,0
57564,56205,0,0,62,62,0,1,0,1,0
62696,50584,0,0,66,66,0,1,0,1,0
48857,50584,0,0,66,66,0,1,0,1,0
443,4205,0,0,320,320,0,1,0,1,0
53300,37807,0,0,62,62,0,1,0,1,0
7166,64147,0,0,62,62,0,1,0,1,0
5223,61002,0,0,161,161,0,1,0,1,0
58638,5900,0,0,62,62,0,1,0,1,0
7444,57470,0,0,66,66,0,1,0,1,0
5926,25174,0,0,146,146,0,1,0,1,0
11816,50584,0,0,66,66,0,1,0,1,0
22263,30188,0,0,66,66,0,1,0,1,0
50251,35440,0,0,66,66,0,1,0,1,0
56127,37965,0,0,66,66,0,1,0,1,0
51592,51505,0,0,66,66,0,1,0,1,0
6881,6881,0,0,146,146,0,1,0,1,0
29177,44847,0,0,66,66,0,1,0,1,0
62804,37965,0,0,62,62,0,1,0,1,0
52557,44847,0,0,62,62,0,1,0,1,0
31062,50584,0,0,62,62,0,1,0,1,0
34422,64147,0,0,145,145,0,1,0,1,0
61670,57470,0,0,74,74,0,1,0,1,0
443,48120,0,0,97,97,0,1,0,1,0
5222,7493,0,0,66,66,0,1,0,1,0
53966,57470,0,0,62,62,0,1,0,1,0
59965,36237,0,0,62,62,0,1,0,1,0
57015,25174,0,0,66,66,0,1,0,1,0
48706,23393,0,0,60,60,0,1,0,1,0
50200,44847,0,0,70,70,0,1,0,1,0
10477,44847,0,0,66,66,0,1,0,1,0
58638,5900,0,0,62,62,0,1,0,1,0
50804,1,0,0,62,62,0,1,0,1,0
58345,24748,0,0,148,148,0,1,0,1,0
993,4281,0,0,66,66,0,1,0,1,0
6121,51505,0,0,66,66,0,1,0,1,0
64379,37965,0,0,66,66,0,1,0,1,0
58021,22114,0,0,62,62,0,1,0,1,0
44491,50584,0,0,62,62,0,1,0,1,0
64334,25174,0,0,66,66,0,1,0,1,0
35722,30188,0,0,62,62,0,1,0,1,0
58638,5900,0,0,62,62,0,1,0,1,0
9471,23,0,0,60,60,0,1,0,1,0
1024,48817,0,0,145,145,0,1,0,1,0
15333,44847,0,0,62,62,0,1,0,1,0
56711,25174,0,0,62,62,0,1,0,1,0
8486,56205,0,0,62,62,0,1,0,1,0
56388,22114,0,0,66,66,0,1,0,1,0
11382,43890,0,0,66,66,0,1,0,1,0
17640,55442,0,0,62,62,0,1,0,1,0
61591,22114,0,0,62,62,0,1,0,1,0
53656,31573,0,0,66,66,0,1,0,1,0
51564,50584,0,0,66,66,0,1,0,1,0
58638,5900,0,0,62,62,0,1,0,1,0
56872,21247,0,0,70,70,0,1,0,1,0
2370,23,0,0,60,60,0,1,0,1,0
58638,5900,0,0,62,62,0,1,0,1,0
27679,37965,0,0,62,62,0,1,0,1,0
48706,23393,0,0,60,60,0,1,0,1,0
55570,44847,0,0,66,66,0,1,0,1,0
61392,50584,0,0,146,146,0,1,0,1,0
17038,36829,0,0,146,146,0,1,0,1,0
54007,50265,0,0,66,66,0,1,0,1,0
14360,64147,0,0,62,62,0,1,0,1,0
58638,5900,0,0,62,62,0,1,0,1,0
6881,6881,0,0,146,146,0,1,0,1,0
6881,6881,0,0,62,62,0,1,0,1,0
40500,48009,0,0,146,146,0,1,0,1,0
65494,53,0,0,88,88,0,1,0,1,0
51948,37965,0,0,62,62,0,1,0,1,0
61701,15503,0,0,66,66,0,1,0,1,0
16477,37807,0,0,66,66,0,1,0,1,0
58638,5900,0,0,62,62,0,1,0,1,0
32424,25174,0,0,146,146,0,1,0,1,0
7905,48817,0,0,146,146,0,1,0,1,0
19642,23,0,0,60,60,0,1,0,1,0
62588,57470,0,0,146,146,0,1,0,1,0
58638,5900,0,0,62,62,0,1,0,1,0
2541,51505,0,0,66,66,0,1,0,1,0
1026,64147,0,0,62,62,0,1,0,1,0
1024,25174,0,0,62,62,0,1,0,1,0
36696,25174,0,0,62,62,0,1,0,1,0
8889,42210,0,0,60,60,0,1,0,1,0
55477,22114,0,0,146,146,0,1,0,1,0
50563,37965,0,0,66,66,0,1,0,1,0
32395,30188,0,0,146,146,0,1,0,1,0
49540,50584,0,0,66,66,0,1,0,1,0
13394,23,0,0,60,60,0,1,0,1,0
59168,39004,0,0,62,62,0,1,0,1,0
60246,44612,0,0,66,66,0,1,0,1,0
443,60496,0,0,187,187,0,1,0,1,0
63569,62413,0,0,66,66,0,1,0,1,0
50561,55777,0,0,62,62,0,1,0,1,0
2323,23117,0,0,62,62,0,1,0,1,0
27321,25174,0,0,62,62,0,1,0,1,0
59282,51050,0,0,62,62,0,1,0,1,0
49842,7302,0,0,66,66,0,1,0,1,0
14042,22114,0,0,146,146,0,1,0,1,0
2432,11392,0,0,62,62,0,1,0,1,0
57825,13014,0,0,74,74,0,1,0,1,0
57896,46783,0,0,100,100,0,1,0,1,0
1035,64147,0,0,145,145,0,1,0,1,0
11112,43890,0,0,66,66,0,1,0,1,0
53233,51221,0,0,66,66,0,1,0,1,0
61392,50584,0,0,62,62,0,1,0,1,0
55225,11392,0,0,66,66,0,1,0,1,0
42285,57470,0,0,62,62,0,1,0,1,0
46349,51505,0,0,74,74,0,1,0,1,0
65265,55067,0,0,66,66,0,1,0,1,0
57649,6881,0,0,62,62,0,1,0,1,0
54866,37965,0,0,62,62,0,1,0,1,0
52356,55442,0,0,62,62,0,1,0,1,0
58582,50584,0,0,66,66,0,1,0,1,0
38681,15503,0,0,74,74,0,1,0,1,0
993,34205,0,0,66,66,0,1,0,1,0
51046,25174,0,0,66,66,0,1,0,1,0
51815,51221,0,0,74,74,0,1,0,1,0
443,61686,0,0,1484,1484,0,1,0,1,0
52625,25174,0,0,66,66,0,1,0,1,0
52744,25174,0,0,62,62,0,1,0,1,0
39730,17372,0,0,66,66,0,1,0,1,0
3541,22114,0,0,62,62,0,1,0,1,0
7686,25174,0,0,62,62,0,1,0,1,0
61053,44847,0,0,66,66,0,1,0,1,0
23807,44847,0,0,62,62,0,1,0,1,0
443,60040,0,0,60,60,0,1,0,1,0
63487,129,0,0,60,60,0,1,0,1,0
61845,11392,0,0,62,62,0,1,0,1,0
55973,25174,0,0,62,62,0,1,0,1,0
23753,25174,0,0,62,62,0,1,0,1,0
38633,51221,0,0,62,62,0,1,0,1,0
2705,37,0,0,60,60,0,1,0,1,0
58638,5900,0,0,62,62,0,1,0,1,0
23969,57470,0,0,62,62,0,1,0,1,0
37647,29892,0,0,145,145,0,1,0,1,0
58022,8112,0,0,60,60,0,1,0,1,0
58638,5900,0,0,62,62,0,1,0,1,0
58811,53976,0,0,66,66,0,1,0,1,0
57015,42707,0,0,62,62,0,1,0,1,0
59724,64147,0,0,66,66,0,1,0,1,0
15677,64147,0,0,145,145,0,1,0,1,0
7067,22114,0,0,62,62,0,1,0,1,0
44147,64147,0,0,62,62,0,1,0,1,0
24174,57470,0,0,62,62,0,1,0,1,0
63956,38211,0,0,62,62,0,1,0,1,0
36579,30188,0,0,66,66,0,1,0,1,0
62392,15503,0,0,146,146,0,1,0,1,0
57762,25174,0,0,62,62,0,1,0,1,0
58703,50584,0,0,66,66,0,1,0,1,0
14693,64147,0,0,66,66,0,1,0,1,0
54071,50265,0,0,62,62,0,1,0,1,0
38755,22114,0,0,66,66,0,1,0,1,0
58638,5900,0,0,62,62,0,1,0,1,0
64622,36829,0,0,66,66,0,1,0,1,0
5151,50584,0,0,62,62,0,1,0,1,0
42459,22114,0,0,62,62,0,1,0,1,0
39217,31573,0,0,146,146,0,1,0,1,0
61898,50584,0,0,66,66,0,1,0,1,0
57131,8055,0,0,145,145,0,1,0,1,0
50488,22114,0,0,62,62,0,1,0,1,0
56397,26467,0,0,66,66,0,1,0,1,0
51746,25174,0,0,66,66,0,1,0,1,0
61426,64910,0,0,66,66,0,1,0,1,0
62709,57470,0,0,62,62,0,1,0,1,0
60426,57470,0,0,62,62,0,1,0,1,0
17781,50265,0,0,62,62,0,1,0,1,0
55225,11392,0,0,66,66,0,1,0,1,0
38383,51221,0,0,66,66,0,1,0,1,0
60617,64147,0,0,62,62,0,1,0,1,0
58638,5900,0,0,62,62,0,1,0,1,0
50877,30041,0,0,62,62,0,1,0,1,0
60722,37965,0,0,62,62,0,1,0,1,0
50236,25174,0,0,66,66,0,1,0,1,0
25565,58771,0,0,60,60,0,1,0,1,0
55839,56535,0,0,62,62,0,1,0,1,0
53022,25174,0,0,62,62,0,1,0,1,0
50106,31573,0,0,66,66,0,1,0,1,0
49370,11392,0,0,66,66,0,1,0,1,0
50563,37965,0,0,66,66,0,1,0,1,0
28795,37965,0,0,62,62,0,1,0,1,0
58638,5900,0,0,62,62,0,1,0,1,0
37316,22114,0,0,62,62,0,1,0,1,0
58638,5900,0,0,62,62,0,1,0,1,0
58743,35894,0,0,66,66,0,1,0,1,0
53353,26467,0,0,62,62,0,1,0,1,0
48629,63131,0,0,74,74,0,1,0,1,0
15605,50265,0,0,62,62,0,1,0,1,0
6889,48817,0,0,143,143,0,1,0,1,0
45205,25174,0,0,146,146,0,1,0,1,0
50052,65008,0,0,60,60,0,1,0,1,0
64016,25174,0,0,62,62,0,1,0,1,0
46774,51050,0,0,146,146,0,1,0,1,0
52472,7302,0,0,66,66,0,1,0,1,0
54188,6004,0,0,78,78,0,1,0,1,0
13020,26467,0,0,66,66,0,1,0,1,0
15635,41182,0,0,66,66,0,1,0,1,0
57360,18375,0,0,66,66,0,1,0,1,0
44285,25174,0,0,62,62,0,1,0,1,0
53966,57470,0,0,62,62,0,1,0,1,0
57339,50584,0,0,66,66,0,1,0,1,0
17561,52700,0,0,62,62,0,1,0,1,0
52135,2790,0,0,66,66,0,1,0,1,0
40054,62413,0,0,62,62,0,1,0,1,0
64776,50584,0,0,66,66,0,1,0,1,0
52518,35440,0,0,62,62,0,1,0,1,0
1024,64147,0,0,62,62,0,1,0,1,0
64482,64147,0,0,66,66,0,1,0,1,0
48815,22114,0,0,146,146,0,1,0,1,0
64677,57470,0,0,66,66,0,1,0,1,0
56582,37965,0,0,66,66,0,1,0,1,0
54786,30188,0,0,66,66,0,1,0,1,0
50853,50584,0,0,62,62,0,1,0,1,0
41429,50584,0,0,66,66,0,1,0,1,0
11410,36237,0,0,146,146,0,1,0,1,0
0,0,0,0,98,98,0,1,0,1,0
56381,51505,0,0,62,62,0,1,0,1,0
22568,37965,0,0,66,66,0,1,0,1,0
64005,26467,0,0,66,66,0,1,0,1,0
58421,30188,0,0,66,66,0,1,0,1,0
16387,26193,0,0,60,60,0,1,0,1,0
23758,44847,0,0,62,62,0,1,0,1,0
58638,5900,0,0,62,62,0,1,0,1,0
48857,50584,0,0,66,66,0,1,0,1,0
23091,11119,0,0,148,148,0,1,0,1,0
2305,35440,0,0,62,62,0,1,0,1,0
55985,44847,0,0,62,62,0,1,0,1,0
24351,57470,0,0,62,62,0,1,0,1,0
3937,36829,0,0,62,62,0,1,0,1,0
54601,26467,0,0,66,66,0,1,0,1,0
50280,57470,0,0,78,78,0,1,0,1,0
59845,44847,0,0,66,66,0,1,0,1,0
52348,62413,0,0,66,66,0,1,0,1,0
56718,50584,0,0,62,62,0,1,0,1,0
46090,50584,0,0,62,62,0,1,0,1,0
59511,21247,0,0,66,66,0,1,0,1,0
28378,56205,0,0,146,146,0,1,0,1,0
62721,56205,0,0,66,66,0,1,0,1,0
7992,64147,0,0,62,62,0,1,0,1,0
55451,56205,0,0,66,66,0,1,0,1,0
57131,7774,0,0,145,145,0,1,0,1,0
12242,51221,0,0,62,62,0,1,0,1,0
53625,64147,0,0,66,66,0,1,0,1,0
48016,57470,0,0,62,62,0,1,0,1,0
18029,50584,0,0,66,66,0,1,0,1,0
17760,50584,0,0,62,62,0,1,0,1,0
43063,57470,0,0,62,62,0,1,0,1,0
2572,17546,0,0,66,66,0,1,0,1,0
53971,50265,0,0,66,66,0,1,0,1,0
5774,37965,0,0,66,66,0,1,0,1,0
48335,25174,0,0,62,62,0,1,0,1,0
55341,39004,0,0,74,74,0,1,0,1,0
55766,36237,0,0,62,62,0,1,0,1,0
49629,26467,0,0,66,66,0,1,0,1,0
60141,62413,0,0,66,66,0,1,0,1,0
22220,25174,0,0,146,146,0,1,0,1,0
53667,22114,0,0,66,66,0,1,0,1,0
48706,23393,0,0,60,60,0,1,0,1,0
4961,62741,0,0,66,66,0,1,0,1,0
45308,22114,0,0,146,146,0,1,0,1,0
61639,37965,0,0,66,66,0,1,0,1,0
43155,35440,0,0,66,66,0,1,0,1,0
6881,55839,0,0,139,139,0,1,0,1,0
37343,21247,0,0,146,146,0,1,0,1,0
47342,20541,0,0,66,66,0,1,0,1,0
6666,3389,0,0,60,60,0,1,0,1,0
57633,50584,0,0,62,62,0,1,0,1,0
50990,23884,0,0,66,66,0,1,0,1,0
45941,23386,0,0,60,60,0,1,0,1,0
51742,30317,0,0,66,66,0,1,0,1,0
26553,57470,0,0,62,62,0,1,0,1,0
62532,57354,0,0,159,159,0,1,0,1,0
4257,35440,0,0,62,62,0,1,0,1,0
50031,44847,0,0,74,74,0,1,0,1,0
43815,50584,0,0,62,62,0,1,0,1,0
43828,44847,0,0,66,66,0,1,0,1,0
1827,64147,0,0,66,66,0,1,0,1,0
25091,64147,0,0,66,66,0,1,0,1,0
63670,64097,0,0,66,66,0,1,0,1,0
3584,25174,0,0,146,146,0,1,0,1,0
2837,25174,0,0,66,66,0,1,0,1,0
5223,44091,0,0,119,119,0,1,0,1,0
59994,11446,0,0,66,66,0,1,0,1,0
25363,22114,0,0,66,66,0,1,0,1,0
16387,45121,0,0,60,60,0,1,0,1,0
5223,32965,0,0,220,220,0,1,0,1,0
26502,64147,0,0,62,62,0,1,0,1,0
7561,43890,0,0,66,66,0,1,0,1,0
993,54748,0,0,66,66,0,1,0,1,0
47910,7454,0,0,60,60,0,1,0,1,0
8889,3808,0,0,60,60,0,1,0,1,0
6247,51221,0,0,78,78,0,1,0,1,0
53906,44512,0,0,62,62,0,1,0,1,0
58638,5900,0,0,62,62,0,1,0,1,0
50052,65008,0,0,60,60,0,1,0,1,0
40086,22114,0,0,62,62,0,1,0,1,0
50326,46824,0,0,66,66,0,1,0,1,0
58715,57470,0,0,66,66,0,1,0,1,0
51769,51505,0,0,66,66,0,1,0,1,0
443,10010,0,0,60,60,0,1,0,1,0
53260,36237,0,0,62,62,0,1,0,1,0
44674,25174,0,0,146,146,0,1,0,1,0
44398,50584,0,0,146,146,0,1,0,1,0
55386,37965,0,0,66,66,0,1,0,1,0
41207,5900,0,0,60,60,0,1,0,1,0
63032,22114,0,0,66,66,0,1,0,1,0
22619,10214,0,0,66,66,0,1,0,1,0
3478,61463,0,0,1053,1053,0,1,0,1,0
10834,50584,0,0,66,66,0,1,0,1,0
43645,39004,0,0,145,145,0,1,0,1,0
45013,50584,0,0,62,62,0,1,0,1,0
58511,50584,0,0,62,62,0,1,0,1,0
5223,7851,0,0,66,66,0,1,0,1,0
5179,50265,0,0,62,62,0,1,0,1,0
12107,22114,0,0,66,66,0,1,0,1,0
58638,5900,0,0,62,62,0,1,0,1,0
55320,22114,0,0,146,146,0,1,0,1,0
6927,4660,0,0,100,100,0,1,0,1,0
58074,11392,0,0,66,66,0,1,0,1,0
20576,37965,0,0,62,62,0,1,0,1,0
28839,30188,0,0,146,146,0,1,0,1,0
13418,22,0,0,60,60,0,1,0,1,0
33801,62413,0,0,62,62,0,1,0,1,0
7423,22114,0,0,62,62,0,1,0,1,0
61430,37965,0,0,66,66,0,1,0,1,0
6881,9074,0,0,143,143,0,1,0,1,0
56816,11392,0,0,62,62,0,1,0,1,0
42463,56205,0,0,62,62,0,1,0,1,0
26762,22114,0,0,62,62,0,1,0,1,0
40971,1433,0,0,60,60,0,1,0,1,0
443,37338,0,0,118,118,0,1,0,1,0
61002,37965,0,0,145,145,0,1,0,1,0
23844,26467,0,0,62,62,0,1,0,1,0
11136,15503,0,0,62,62,0,1,0,1,0
53161,51221,0,0,66,66,0,1,0,1,0
58445,17500,0,0,66,66,0,1,0,1,0
46090,50584,0,0,66,66,0,1,0,1,0
50708,22114,0,0,146,146,0,1,0,1,0
11859,64147,0,0,62,62,0,1,0,1,0
56249,55442,0,0,66,66,0,1,0,1,0
53437,44847,0,0,66,66,0,1,0,1,0
53324,44847,0,0,66,66,0,1,0,1,0
60806,51050,0,0,66,66,0,1,0,1,0
53928,15503,0,0,62,62,0,1,0,1,0
6943,1970,0,0,100,100,0,1,0,1,0
42231,57470,0,0,78,78,0,1,0,1,0
61550,5529,0,0,145,145,0,1,0,1,0
64546,57470,0,0,66,66,0,1,0,1,0
53323,35253,0,0,66,66,0,1,0,1,0
45941,23388,0,0,60,60,0,1,0,1,0
50084,26672,0,0,62,62,0,1,0,1,0
14696,42707,0,0,62,62,0,1,0,1,0
58638,5900,0,0,62,62,0,1,0,1,0
10329,7774,0,0,143,143,0,1,0,1,0
55413,37965,0,0,66,66,0,1,0,1,0
49514,39127,0,0,162,162,0,1,0,1,0
58638,5900,0,0,62,62,0,1,0,1,0
65231,50584,0,0,62,62,0,1,0,1,0
26494,26467,0,0,62,62,0,1,0,1,0
64035,25174,0,0,62,62,0,1,0,1,0
17004,64147,0,0,66,66,0,1,0,1,0
30951,50584,0,0,62,62,0,1,0,1,0
50063,35776,0,0,148,148,0,1,0,1,0
12290,22114,0,0,66,66,0,1,0,1,0
24160,37807,0,0,62,62,0,1,0,1,0
49177,54532,0,0,60,60,0,1,0,1,0
65288,44847,0,0,66,66,0,1,0,1,0
61744,11392,0,0,66,66,0,1,0,1,0
57655,56205,0,0,66,66,0,1,0,1,0
51026,37450,0,0,66,66,0,1,0,1,0
42564,50584,0,0,62,62,0,1,0,1,0
58638,5900,0,0,62,62,0,1,0,1,0
58488,37965,0,0,62,62,0,1,0,1,0
55711,26467,0,0,66,66,0,1,0,1,0
58608,62413,0,0,66,66,0,1,0,1,0
58638,5900,0,0,62,62,0,1,0,1,0
31845,55777,0,0,62,62,0,1,0,1,0
3996,57470,0,0,62,62,0,1,0,1,0
57853,64147,0,0,66,66,0,1,0,1,0
28194,32468,0,0,62,62,0,1,0,1,0
35229,32468,0,0,62,62,0,1,0,1,0
39393,22114,0,0,62,62,0,1,0,1,0
19882,22114,0,0,62,62,0,1,0,1,0
50254,44847,0,0,62,62,0,1,0,1,0
45964,55559,0,0,60,60,0,1,0,1,0
56387,25174,0,0,62,62,0,1,0,1,0
58638,5900,0,0,62,62,0,1,0,1,0
7109,64147,0,0,62,62,0,1,0,1,0
43723,5900,0,0,60,60,0,1,0,1,0
65496,57470,0,0,146,146,0,1,0,1,0
16654,50265,0,0,62,62,0,1,0,1,0
10091,22114,0,0,62,62,0,1,0,1,0
40120,23,0,0,60,60,0,1,0,1,0
11136,19910,0,0,62,62,0,1,0,1,0
42969,8146,0,0,62,62,0,1,0,1,0
53090,59356,0,0,66,66,0,1,0,1,0
24616,48983,0,0,146,146,0,1,0,1,0
2432,11392,0,0,146,146,0,1,0,1,0
26458,44847,0,0,146,146,0,1,0,1,0
443,46382,0,0,66,66,0,1,0,1,0
80,56289,0,0,1090,1090,0,1,0,1,0
51413,57470,0,0,72,72,0,1,0,1,0
19885,64147,0,0,145,145,0,1,0,1,0
42796,22114,0,0,62,62,0,1,0,1,0
1918,25174,0,0,66,66,0,1,0,1,0
29742,50584,0,0,146,146,0,1,0,1,0
34932,38608,0,0,62,62,0,1,0,1,0
47132,1433,0,0,60,60,0,1,0,1,0
55286,37965,0,0,66,66,0,1,0,1,0
59736,51505,0,0,146,146,0,1,0,1,0
63447,44847,0,0,66,66,0,1,0,1,0
23415,11392,0,0,66,66,0,1,0,1,0
58638,5900,0,0,62,62,0,1,0,1,0
443,48346,0,0,81,81,0,1,0,1,0
30794,37965,0,0,62,62,0,1,0,1,0
17378,44847,0,0,62,62,0,1,0,1,0
34808,22114,0,0,66,66,0,1,0,1,0
57987,56125,0,0,90,90,0,1,0,1,0
48488,50584,0,0,62,62,0,1,0,1,0
52809,56205,0,0,146,146,0,1,0,1,0
58511,50584,0,0,146,146,0,1,0,1,0
52439,35894,0,0,74,74,0,1,0,1,0
11136,15503,0,0,62,62,0,1,0,1,0
52973,57470,0,0,74,74,0,1,0,1,0
48087,16069,0,0,66,66,0,1,0,1,0
7524,23,0,0,60,60,0,1,0,1,0
28413,64147,0,0,62,62,0,1,0,1,0
57283,64147,0,0,66,66,0,1,0,1,0
56793,56205,0,0,66,66,0,1,0,1,0
20743,23,0,0,60,60,0,1,0,1,0
63545,25174,0,0,66,66,0,1,0,1,0
28754,50584,0,0,62,62,0,1,0,1,0
59156,50584,0,0,66,66,0,1,0,1,0
65203,30188,0,0,66,66,0,1,0,1,0
3103,50584,0,0,62,62,0,1,0,1,0
45079,31573,0,0,66,66,0,1,0,1,0
61589,21247,0,0,66,66,0,1,0,1,0
23119,41615,0,0,148,148,0,1,0,1,0
58638,5900,0,0,62,62,0,1,0,1,0
61643,22114,0,0,62,62,0,1,0,1,0
59048,57470,0,0,66,66,0,1,0,1,0
58638,5900,0,0,62,62,0,1,0,1,0
58638,5900,0,0,62,62,0,1,0,1,0
52973,57470,0,0,74,74,0,1,0,1,0
45682,25604,0,0,62,62,0,1,0,1,0
59393,25174,0,0,66,66,0,1,0,1,0
3765,64147,0,0,62,62,0,1,0,1,0
48478,49903,0,0,62,62,0,1,0,1,0
23537,35253,0,0,66,66,0,1,0,1,0
44491,50584,0,0,62,62,0,1,0,1,0
32997,50584,0,0,62,62,0,1,0,1,0
58638,5900,0,0,62,62,0,1,0,1,0
14844,37965,0,0,62,62,0,1,0,1,0
51535,44847,0,0,62,62,0,1,0,1,0
58638,5900,0,0,62,62,0,1,0,1,0
51973,44847,0,0,66,66,0,1,0,1,0
53985,30188,0,0,66,66,0,1,0,1,0
49607,25174,0,0,62,62,0,1,0,1,0
57348,25174,0,0,146,146,0,1,0,1,0
38976,46824,0,0,62,62,0,1,0,1,0
51148,9571,0,0,66,66,0,1,0,1,0
25151,58833,0,0,62,62,0,1,0,1,0
6881,6881,0,0,146,146,0,1,0,1,0
59378,50584,0,0,66,66,0,1,0,1,0
443,29326,0,0,82,82,0,1,0,1,0
57173,44847,0,0,62,62,0,1,0,1,0
63690,64147,0,0,66,66,0,1,0,1,0
3585,64147,0,0,62,62,0,1,0,1,0
55450,64147,0,0,66,66,0,1,0,1,0
12969,55777,0,0,66,66,0,1,0,1,0
27446,30188,0,0,66,66,0,1,0,1,0
53140,51221,0,0,74,74,0,1,0,1,0
23936,35440,0,0,62,62,0,1,0,1,0
61457,21247,0,0,66,66,0,1,0,1,0
61023,26467,0,0,62,62,0,1,0,1,0
61744,11392,0,0,66,66,0,1,0,1,0
7308,50584,0,0,66,66,0,1,0,1,0
56604,17372,0,0,66,66,0,1,0,1,0
47962,16069,0,0,62,62,0,1,0,1,0
31112,50584,0,0,62,62,0,1,0,1,0
57339,57470,0,0,66,66,0,1,0,1,0
22981,15503,0,0,62,62,0,1,0,1,0
1024,25174,0,0,62,62,0,1,0,1,0
61902,22114,0,0,66,66,0,1,0,1,0
64449,30188,0,0,66,66,0,1,0,1,0
49159,23,0,0,60,60,0,1,0,1,0
16660,55783,0,0,62,62,0,1,0,1,0
51413,57470,0,0,72,72,0,1,0,1,0
34822,31573,0,0,62,62,0,1,0,1,0
56381,51505,0,0,62,62,0,1,0,1,0
58638,5900,0,0,62,62,0,1,0,1,0
56827,63710,0,0,62,62,0,1,0,1,0
54016,42707,0,0,62,62,0,1,0,1,0
50857,26467,0,0,66,66,0,1,0,1,0
24271,52700,0,0,66,66,0,1,0,1,0
51052,50584,0,0,66,66,0,1,0,1,0
8229,22114,0,0,66,66,0,1,0,1,0
49516,35894,0,0,145,145,0,1,0,1,0
36456,25174,0,0,62,62,0,1,0,1,0
6929,35440,0,0,66,66,0,1,0,1,0
28009,36237,0,0,146,146,0,1,0,1,0
58638,5900,0,0,62,62,0,1,0,1,0
52177,25320,0,0,66,66,0,1,0,1,0
43688,22114,0,0,62,62,0,1,0,1,0
38653,21247,0,0,62,62,0,1,0,1,0
58338,3369,0,0,60,60,0,1,0,1,0
51412,51505,0,0,62,62,0,1,0,1,0
53971,55442,0,0,66,66,0,1,0,1,0
58914,37965,0,0,66,66,0,1,0,1,0
63346,37965,0,0,66,66,0,1,0,1,0
35194,57470,0,0,74,74,0,1,0,1,0
3212,22114,0,0,62,62,0,1,0,1,0
56676,37965,0,0,62,62,0,1,0,1,0
40005,36237,0,0,62,62,0,1,0,1,0
57170,38303,0,0,66,66,0,1,0,1,0
7310,44847,0,0,62,62,0,1,0,1,0
51414,22,0,0,60,60,0,1,0,1,0
64191,44847,0,0,62,62,0,1,0,1,0
61185,54532,0,0,62,62,0,1,0,1,0
64551,2310,0,0,143,143,0,1,0,1,0
58638,5900,0,0,62,62,0,1,0,1,0
0,0,0,0,98,98,0,1,0,1,0
56213,26467,0,0,62,62,0,1,0,1,0
51426,59737,0,0,100,100,0,1,0,1,0
48676,53392,0,0,60,60,0,1,0,1,0
28370,35440,0,0,66,66,0,1,0,1,0
51560,46783,0,0,66,66,0,1,0,1,0
50637,36237,0,0,62,62,0,1,0,1,0
30365,45991,0,0,60,60,0,1,0,1,0
47682,64147,0,0,66,66,0,1,0,1,0
52026,26467,0,0,60,60,0,1,0,1,0
1284,50584,0,0,66,66,0,1,0,1,0
40903,5900,0,0,60,60,0,1,0,1,0
62337,44847,0,0,66,66,0,1,0,1,0
59209,25174,0,0,62,62,0,1,0,1,0
65384,57470,0,0,66,66,0,1,0,1,0
54575,11392,0,0,66,66,0,1,0,1,0
443,64347,0,0,85,85,0,1,0,1,0
48016,57470,0,0,62,62,0,1,0,1,0
58836,51505,0,0,66,66,0,1,0,1,0
50280,57470,0,0,78,78,0,1,0,1,0
13188,35440,0,0,66,66,0,1,0,1,0
50280,57470,0,0,78,78,0,1,0,1,0
28424,35440,0,0,66,66,0,1,0,1,0
57170,38303,0,0,66,66,0,1,0,1,0
40369,57470,0,0,62,62,0,1,0,1,0
56564,9571,0,0,78,78,0,1,0,1,0
38664,37965,0,0,62,62,0,1,0,1,0
62725,51221,0,0,62,62,0,1,0,1,0
19570,50584,0,0,66,66,0,1,0,1,0
41429,50584,0,0,66,66,0,1,0,1,0
54109,36829,0,0,62,62,0,1,0,1,0
21502,44847,0,0,66,66,0,1,0,1,0
33289,50584,0,0,62,62,0,1,0,1,0
49415,22114,0,0,66,66,0,1,0,1,0
54140,17372,0,0,66,66,0,1,0,1,0
38633,51221,0,0,66,66,0,1,0,1,0
24110,23,0,0,60,60,0,1,0,1,0
52112,22114,0,0,66,66,0,1,0,1,0
22835,51221,0,0,62,62,0,1,0,1,0
2850,64147,0,0,66,66,0,1,0,1,0
59942,22114,0,0,62,62,0,1,0,1,0
22784,9571,0,0,62,62,0,1,0,1,0
61005,50584,0,0,146,146,0,1,0,1,0
16477,37807,0,0,66,66,0,1,0,1,0
24311,22617,0,0,60,60,0,1,0,1,0
64387,37965,0,0,66,66,0,1,0,1,0
56576,9000,0,0,60,60,0,1,0,1,0
50717,9571,0,0,62,62,0,1,0,1,0
59626,22114,0,0,66,66,0,1,0,1,0
64175,56502,0,0,66,66,0,1,0,1,0
44568,3389,0,0,60,60,0,1,0,1,0
62331,61689,0,0,66,66,0,1,0,1,0
39063,44847,0,0,66,66,0,1,0,1,0
49255,44847,0,0,62,62,0,1,0,1,0
61461,50584,0,0,62,62,0,1,0,1,0
58207,51505,0,0,66,66,0,1,0,1,0
30315,57470,0,0,145,145,0,1,0,1,0
54189,22114,0,0,66,66,0,1,0,1,0
6899,48817,0,0,139,139,0,1,0,1,0
5688,44847,0,0,66,66,0,1,0,1,0
53053,64147,0,0,62,62,0,1,0,1,0
2932,44847,0,0,66,66,0,1,0,1,0
11066,50584,0,0,62,62,0,1,0,1,0
54305,26467,0,0,66,66,0,1,0,1,0
57632,7302,0,0,146,146,0,1,0,1,0
56152,56205,0,0,66,66,0,1,0,1,0
52745,57866,0,0,62,62,0,1,0,1,0
49485,11392,0,0,62,62,0,1,0,1,0
55451,56205,0,0,66,66,0,1,0,1,0
13938,64147,0,0,145,145,0,1,0,1,0
6889,55108,0,0,143,143,0,1,0,1,0
36641,25174,0,0,66,66,0,1,0,1,0
1404,51180,0,0,145,145,0,1,0,1,0
7222,57470,0,0,62,62,0,1,0,1,0
35589,25174,0,0,66,66,0,1,0,1,0
27869,51221,0,0,66,66,0,1,0,1,0
39195,25174,0,0,62,62,0,1,0,1,0
10910,57866,0,0,62,62,0,1,0,1,0
45682,37965,0,0,62,62,0,1,0,1,0
24311,22617,0,0,60,60,0,1,0,1,0
2238,22114,0,0,62,62,0,1,0,1,0
54976,2273,0,0,60,60,0,1,0,1,0
52447,43890,0,0,62,62,0,1,0,1,0
58638,5900,0,0,62,62,0,1,0,1,0
6881,35894,0,0,62,62,0,1,0,1,0
443,56513,0,0,78,78,0,1,0,1,0
52934,26467,0,0,66,66,0,1,0,1,0
52749,64147,0,0,66,66,0,1,0,1,0
54721,22114,0,0,66,66,0,1,0,1,0
31691,50584,0,0,62,62,0,1,0,1,0
56205,51505,0,0,66,66,0,1,0,1,0
26351,22114,0,0,62,62,0,1,0,1,0
54140,43890,0,0,66,66,0,1,0,1,0
45964,3111,0,0,60,60,0,1,0,1,0
17306,25174,0,0,66,66,0,1,0,1,0
57478,7302,0,0,62,62,0,1,0,1,0
5222,1504,0,0,66,66,0,1,0,1,0
52024,25174,0,0,66,66,0,1,0,1,0
32554,34729,0,0,62,62,0,1,0,1,0
9448,57866,0,0,62,62,0,1,0,1,0
49747,37965,0,0,62,62,0,1,0,1,0
49367,51505,0,0,66,66,0,1,0,1,0
5830,22114,0,0,66,66,0,1,0,1,0
45682,8055,0,0,159,159,0,1,0,1,0
49594,22114,0,0,66,66,0,1,0,1,0
57233,50934,0,0,66,66,0,1,0,1,0
5894,44847,0,0,66,66,0,1,0,1,0
61912,17546,0,0,62,62,0,1,0,1,0
26058,1433,0,0,60,60,0,1,0,1,0
61761,44847,0,0,66,66,0,1,0,1,0
22409,55442,0,0,74,74,0,1,0,1,0
35957,51185,0,0,60,60,0,1,0,1,0
9327,57470,0,0,62,62,0,1,0,1,0
3212,22114,0,0,62,62,0,1,0,1,0
57896,49903,0,0,100,100,0,1,0,1,0
40845,64147,0,0,62,62,0,1,0,1,0
60855,35440,0,0,66,66,0,1,0,1,0
50052,65010,0,0,60,60,0,1,0,1,0
11983,57470,0,0,62,62,0,1,0,1,0
56752,44847,0,0,62,62,0,1,0,1,0
26448,41864,0,0,145,145,0,1,0,1,0
65015,22114,0,0,66,66,0,1,0,1,0
14343,6881,0,0,146,146,0,1,0,1,0
13285,29892,0,0,145,145,0,1,0,1,0
58638,5900,0,0,62,62,0,1,0,1,0
1025,50584,0,0,62,62,0,1,0,1,0
38538,22,0,0,60,60,0,1,0,1,0
24160,37807,0,0,62,62,0,1,0,1,0
62937,30975,0,0,185,185,0,1,0,1,0
54305,39004,0,0,62,62,0,1,0,1,0
57452,57470,0,0,62,62,0,1,0,1,0
5223,14446,0,0,220,220,0,1,0,1,0
63998,21247,0,0,62,62,0,1,0,1,0
58485,40740,0,0,145,145,0,1,0,1,0
3478,61463,0,0,431,431,0,1,0,1,0
57302,62413,0,0,66,66,0,1,0,1,0
5926,25174,0,0,62,62,0,1,0,1,0
57471,62413,0,0,62,62,0,1,0,1,0
19875,30170,0,0,145,145,0,1,0,1,0
42238,25174,0,0,66,66,0,1,0,1,0
3478,61463,0,0,491,491,0,1,0,1,0
6843,42873,0,0,62,62,0,1,0,1,0
3406,17372,0,0,62,62,0,1,0,1,0
10036,44847,0,0,66,66,0,1,0,1,0
36933,23117,0,0,62,62,0,1,0,1,0
15235,36237,0,0,62,62,0,1,0,1,0
56494,15503,0,0,146,146,0,1,0,1,0
4876,42920,0,0,146,146,0,1,0,1,0
62914,11392,0,0,62,62,0,1,0,1,0
53470,22114,0,0,66,66,0,1,0,1,0
58195,38303,0,0,66,66,0,1,0,1,0
443,61686,0,0,1484,1484,0,1,0,1,0
50321,23684,0,0,143,143,0,1,0,1,0
5774,37965,0,0,66,66,0,1,0,1,0
49842,7302,0,0,62,62,0,1,0,1,0
6881,33454,0,0,100,100,0,1,0,1,0
10910,57866,0,0,146,146,0,1,0,1,0
62189,64147,0,0,145,145,0,1,0,1,0
51996,57470,0,0,66,66,0,1,0,1,0
1027,25174,0,0,62,62,0,1,0,1,0
64605,35993,0,0,66,66,0,1,0,1,0
17982,11392,0,0,62,62,0,1,0,1,0
60248,30188,0,0,66,66,0,1,0,1,0
7377,57470,0,0,62,62,0,1,0,1,0
29203,26467,0,0,62,62,0,1,0,1,0
10736,6112,0,0,60,60,0,1,0,1,0
51105,50584,0,0,62,62,0,1,0,1,0
29064,23,0,0,60,60,0,1,0,1,0
50282,37965,0,0,66,66,0,1,0,1,0
1024,57470,0,0,62,62,0,1,0,1,0
2383,37965,0,0,62,62,0,1,0,1,0
48071,25174,0,0,62,62,0,1,0,1,0
58638,5900,0,0,62,62,0,1,0,1,0
50788,48817,0,0,66,66,0,1,0,1,0
18653,42707,0,0,66,66,0,1,0,1,0
56906,50584,0,0,62,62,0,1,0,1,0
24504,37965,0,0,62,62,0,1,0,1,0
63242,50584,0,0,66,66,0,1,0,1,0
54826,56205,0,0,66,66,0,1,0,1,0
63855,25174,0,0,62,62,0,1,0,1,0
36374,30228,0,0,145,145,0,1,0,1,0
10834,50584,0,0,66,66,0,1,0,1,0
25031,25174,0,0,146,146,0,1,0,1,0
57284,22114,0,0,62,62,0,1,0,1,0
45238,44847,0,0,66,66,0,1,0,1,0
53012,51050,0,0,62,62,0,1,0,1,0
52026,26467,0,0,60,60,0,1,0,1,0
42986,25174,0,0,66,66,0,1,0,1,0
13020,26467,0,0,66,66,0,1,0,1,0
61221,35440,0,0,66,66,0,1,0,1,0
57472,44847,0,0,66,66,0,1,0,1,0
54280,3398,0,0,60,60,0,1,0,1,0
56381,25174,0,0,62,62,0,1,0,1,0
58638,5900,0,0,62,62,0,1,0,1,0
35347,20238,0,0,66,66,0,1,0,1,0
7273,64147,0,0,66,66,0,1,0,1,0
58012,5555,0,0,60,60,0,1,0,1,0
37959,3855,0,0,72,72,0,1,0,1,0
4447,35440,0,0,66,66,0,1,0,1,0
15319,51505,0,0,66,66,0,1,0,1,0
60793,53733,0,0,66,66,0,1,0,1,0
58977,37965,0,0,66,66,0,1,0,1,0
50292,22114,0,0,66,66,0,1,0,1,0
6666,50070,0,0,60,60,0,1,0,1,0
37075,48817,0,0,62,62,0,1,0,1,0
58638,5900,0,0,62,62,0,1,0,1,0
56205,51505,0,0,66,66,0,1,0,1,0
58638,5900,0,0,62,62,0,1,0,1,0
6666,2222,0,0,60,60,0,1,0,1,0
1814,62413,0,0,66,66,0,1,0,1,0
51015,64147,0,0,62,62,0,1,0,1,0
52788,64147,0,0,66,66,0,1,0,1,0
48978,25174,0,0,66,66,0,1,0,1,0
40731,2323,0,0,60,60,0,1,0,1,0
60147,25198,0,0,148,148,0,1,0,1,0
3456,11392,0,0,66,66,0,1,0,1,0
7977,25174,0,0,62,62,0,1,0,1,0
25570,35440,0,0,62,62,0,1,0,1,0
12986,64147,0,0,145,145,0,1,0,1,0
50341,37965,0,0,62,62,0,1,0,1,0
54100,37965,0,0,62,62,0,1,0,1,0
993,4264,0,0,66,66,0,1,0,1,0
47201,44847,0,0,66,66,0,1,0,1,0
18986,44847,0,0,66,66,0,1,0,1,0
43129,15503,0,0,62,62,0,1,0,1,0
21833,22114,0,0,62,62,0,1,0,1,0
17534,50584,0,0,146,146,0,1,0,1,0
443,20982,0,0,97,97,0,1,0,1,0
20563,21247,0,0,66,66,0,1,0,1,0
42532,22114,0,0,146,146,0,1,0,1,0
45964,3111,0,0,60,60,0,1,0,1,0
11235,30188,0,0,66,66,0,1,0,1,0
62540,29892,0,0,145,145,0,1,0,1,0
1058,36866,0,0,136,136,0,1,0,1,0
59694,50584,0,0,66,66,0,1,0,1,0
39583,37965,0,0,66,66,0,1,0,1,0
37927,50265,0,0,66,66,0,1,0,1,0
62776,62413,0,0,62,62,0,1,0,1,0
36258,23,0,0,60,60,0,1,0,1,0
46478,64147,0,0,62,62,0,1,0,1,0
36548,25174,0,0,146,146,0,1,0,1,0
58638,5900,0,0,62,62,0,1,0,1,0
41648,56205,0,0,66,66,0,1,0,1,0
64815,37965,0,0,66,66,0,1,0,1,0
58638,5900,0,0,62,62,0,1,0,1,0
58638,5900,0,0,62,62,0,1,0,1,0
64693,26467,0,0,62,62,0,1,0,1,0
18088,23,0,0,60,60,0,1,0,1,0
11136,17500,0,0,62,62,0,1,0,1,0
1025,35447,0,0,62,62,0,1,0,1,0
34146,51221,0,0,62,62,0,1,0,1,0
54196,11392,0,0,66,66,0,1,0,1,0
58022,8800,0,0,60,60,0,1,0,1,0
62549,64147,0,0,62,62,0,1,0,1,0
63205,9571,0,0,66,66,0,1,0,1,0
57987,56125,0,0,90,90,0,1,0,1,0
11136,15503,0,0,62,62,0,1,0,1,0
54210,64097,0,0,66,66,0,1,0,1,0
11101,22114,0,0,146,146,0,1,0,1,0
48025,44847,0,0,146,146,0,1,0,1,0
58888,23718,0,0,66,66,0,1,0,1,0
52076,44847,0,0,66,66,0,1,0,1,0
6247,51221,0,0,78,78,0,1,0,1,0
54883,60043,0,0,62,62,0,1,0,1,0
27368,22114,0,0,62,62,0,1,0,1,0
49786,25174,0,0,66,66,0,1,0,1,0
36538,64147,0,0,62,62,0,1,0,1,0
58638,5900,0,0,62,62,0,1,0,1,0
5685,35440,0,0,66,66,0,1,0,1,0
51414,22,0,0,60,60,0,1,0,1,0
56377,51505,0,0,66,66,0,1,0,1,0
61140,27520,0,0,66,66,0,1,0,1,0
59364,44847,0,0,66,66,0,1,0,1,0
10006,64147,0,0,62,62,0,1,0,1,0
52091,11392,0,0,66,66,0,1,0,1,0
5087,22114,0,0,66,66,0,1,0,1,0
53987,57470,0,0,66,66,0,1,0,1,0
61838,37965,0,0,62,62,0,1,0,1,0
51426,47563,0,0,100,100,0,1,0,1,0
49938,57470,0,0,66,66,0,1,0,1,0
1694,30188,0,0,62,62,0,1,0,1,0
38859,22114,0,0,62,62,0,1,0,1,0
62737,64147,0,0,66,66,0,1,0,1,0
50280,57470,0,0,78,78,0,1,0,1,0
60480,57470,0,0,62,62,0,1,0,1,0
27160,64147,0,0,66,66,0,1,0,1,0
28413,64147,0,0,66,66,0,1,0,1,0
64811,51221,0,0,66,66,0,1,0,1,0
58421,30188,0,0,66,66,0,1,0,1,0
22530,23718,0,0,66,66,0,1,0,1,0
6828,64322,0,0,60,60,0,1,0,1,0
33314,44847,0,0,62,62,0,1,0,1,0
58638,5900,0,0,62,62,0,1,0,1,0
14042,22114,0,0,62,62,0,1,0,1,0
26872,44847,0,0,62,62,0,1,0,1,0
54742,50584,0,0,66,66,0,1,0,1,0
45964,3111,0,0,60,60,0,1,0,1,0
50341,37965,0,0,66,66,0,1,0,1,0
62089,8604,0,0,66,66,0,1,0,1,0
51093,57470,0,0,66,66,0,1,0,1,0
58638,5900,0,0,62,62,0,1,0,1,0
53373,64147,0,0,62,62,0,1,0,1,0
3524,25174,0,0,66,66,0,1,0,1,0
34716,23,0,0,60,60,0,1,0,1,0
1027,64147,0,0,62,62,0,1,0,1,0
28156,50584,0,0,62,62,0,1,0,1,0
59018,22114,0,0,62,62,0,1,0,1,0
58835,17372,0,0,66,66,0,1,0,1,0
35232,36602,0,0,74,74,0,1,0,1,0
16319,44847,0,0,146,146,0,1,0,1,0
37927,50265,0,0,66,66,0,1,0,1,0
55766,36237,0,0,62,62,0,1,0,1,0
62115,57470,0,0,66,66,0,1,0,1,0
33886,65504,0,0,162,162,0,1,0,1,0
52695,26467,0,0,66,66,0,1,0,1,0
9246,35440,0,0,66,66,0,1,0,1,0
9092,26672,0,0,60,60,0,1,0,1,0
2949,57470,0,0,66,66,0,1,0,1,0
19875,30170,0,0,145,145,0,1,0,1,0
52459,5555,0,0,60,60,0,1,0,1,0
33453,64147,0,0,62,62,0,1,0,1,0
61030,21247,0,0,66,66,0,1,0,1,0
43129,15503,0,0,62,62,0,1,0,1,0
58638,5900,0,0,62,62,0,1,0,1,0
38330,44847,0,0,66,66,0,1,0,1,0
51094,35440,0,0,66,66,0,1,0,1,0
22542,30188,0,0,62,62,0,1,0,1,0
63554,44847,0,0,66,66,0,1,0,1,0
51413,25864,0,0,72,72,0,1,0,1,0
50438,50584,0,0,146,146,0,1,0,1,0
55079,25174,0,0,62,62,0,1,0,1,0
29178,35440,0,0,66,66,0,1,0,1,0
7619,50584,0,0,146,146,0,1,0,1,0
16387,20045,0,0,60,60,0,1,0,1,0
39287,57470,0,0,62,62,0,1,0,1,0
10003,64147,0,0,62,62,0,1,0,1,0
50624,50584,0,0,66,66,0,1,0,1,0
64190,2767,0,0,66,66,0,1,0,1,0
48841,51221,0,0,62,62,0,1,0,1,0
64306,64147,0,0,62,62,0,1,0,1,0
57484,30317,0,0,66,66,0,1,0,1,0
13559,57866,0,0,66,66,0,1,0,1,0
18650,23718,0,0,62,62,0,1,0,1,0
62386,37965,0,0,66,66,0,1,0,1,0
16327,55442,0,0,66,66,0,1,0,1,0
32704,46824,0,0,66,66,0,1,0,1,0
41346,30188,0,0,62,62,0,1,0,1,0
43584,24748,0,0,156,156,0,1,0,1,0
55225,11392,0,0,62,62,0,1,0,1,0
15530,49718,0,0,146,146,0,1,0,1,0
49929,26467,0,0,66,66,0,1,0,1,0
2394,55108,0,0,159,159,0,1,0,1,0
9957,32480,0,0,62,62,0,1,0,1,0
38755,22114,0,0,66,66,0,1,0,1,0
52431,50265,0,0,62,62,0,1,0,1,0
64691,25320,0,0,66,66,0,1,0,1,0
30654,51221,0,0,72,72,0,1,0,1,0
63385,25174,0,0,66,66,0,1,0,1,0
16001,48817,0,0,143,143,0,1,0,1,0
1117,37965,0,0,62,62,0,1,0,1,0
6666,138,0,0,60,60,0,1,0,1,0
50084,26672,0,0,145,145,0,1,0,1,0
2543,25174,0,0,66,66,0,1,0,1,0
58638,5900,0,0,62,62,0,1,0,1,0
61288,23,0,0,60,60,0,1,0,1,0
63786,25174,0,0,66,66,0,1,0,1,0
61420,64097,0,0,66,66,0,1,0,1,0
35011,37965,0,0,62,62,0,1,0,1,0
63583,37965,0,0,62,62,0,1,0,1,0
51996,57470,0,0,66,66,0,1,0,1,0
57677,23,0,0,60,60,0,1,0,1,0
46839,51050,0,0,62,62,0,1,0,1,0
35940,47808,0,0,60,60,0,1,0,1,0
39244,36829,0,0,62,62,0,1,0,1,0
16330,50584,0,0,62,62,0,1,0,1,0
1943,48817,0,0,62,62,0,1,0,1,0
59977,30188,0,0,66,66,0,1,0,1,0
58743,35894,0,0,66,66,0,1,0,1,0
15899,37807,0,0,62,62,0,1,0,1,0
12164,22114,0,0,62,62,0,1,0,1,0
59107,25174,0,0,66,66,0,1,0,1,0
12226,37965,0,0,62,62,0,1,0,1,0
62337,44847,0,0,66,66,0,1,0,1,0
60857,61689,0,0,146,146,0,1,0,1,0
50052,65008,0,0,60,60,0,1,0,1,0
19875,30170,0,0,145,145,0,1,0,1,0
61242,35253,0,0,62,62,0,1,0,1,0
64363,22114,0,0,62,62,0,1,0,1,0
24281,23,0,0,60,60,0,1,0,1,0
58638,5900,0,0,62,62,0,1,0,1,0
52690,7302,0,0,66,66,0,1,0,1,0
60357,5900,0,0,60,60,0,1,0,1,0
43461,35440,0,0,146,146,0,1,0,1,0
27402,37965,0,0,66,66,0,1,0,1,0
52596,17372,0,0,62,62,0,1,0,1,0
30598,37965,0,0,62,62,0,1,0,1,0
12242,51221,0,0,62,62,0,1,0,1,0
49529,21247,0,0,62,62,0,1,0,1,0
46859,50584,0,0,62,62,0,1,0,1,0
46734,50265,0,0,74,74,0,1,0,1,0
52781,57470,0,0,62,62,0,1,0,1,0
39959,23117,0,0,62,62,0,1,0,1,0
55825,52700,0,0,66,66,0,1,0,1,0
16393,22114,0,0,62,62,0,1,0,1,0
59051,27520,0,0,62,62,0,1,0,1,0
37609,15503,0,0,146,146,0,1,0,1,0
57452,57470,0,0,62,62,0,1,0,1,0
58638,5900,0,0,62,62,0,1,0,1,0
443,39947,0,0,74,74,0,1,0,1,0
47943,50584,0,0,74,74,0,1,0,1,0
52811,44847,0,0,66,66,0,1,0,1,0
50757,64147,0,0,66,66,0,1,0,1,0
21108,25174,0,0,62,62,0,1,0,1,0
2918,37965,0,0,62,62,0,1,0,1,0
53022,25174,0,0,66,66,0,1,0,1,0
52714,64147,0,0,66,66,0,1,0,1,0
60899,25174,0,0,62,62,0,1,0,1,0
16293,57470,0,0,62,62,0,1,0,1,0
1067,51221,0,0,62,62,0,1,0,1,0
26698,25174,0,0,62,62,0,1,0,1,0
56883,22114,0,0,62,62,0,1,0,1,0
54778,22114,0,0,66,66,0,1,0,1,0
54062,49813,0,0,62,62,0,1,0,1,0
2427,25174,0,0,146,146,0,1,0,1,0
45964,2228,0,0,60,60,0,1,0,1,0
63779,26467,0,0,66,66,0,1,0,1,0
58638,5900,0,0,62,62,0,1,0,1,0
56719,37807,0,0,62,62,0,1,0,1,0
54786,30188,0,0,66,66,0,1,0,1,0
49113,50584,0,0,62,62,0,1,0,1,0
443,62732,0,0,332,332,0,1,0,1,0
59511,21247,0,0,62,62,0,1,0,1,0
61241,22114,0,0,66,66,0,1,0,1,0
58914,37965,0,0,66,66,0,1,0,1,0
25565,41288,0,0,60,60,0,1,0,1,0
58195,38303,0,0,66,66,0,1,0,1,0
26469,26348,0,0,66,66,0,1,0,1,0
5087,22114,0,0,66,66,0,1,0,1,0
9957,32480,0,0,66,66,0,1,0,1,0
32215,22114,0,0,66,66,0,1,0,1,0
47910,7461,0,0,60,60,0,1,0,1,0
52336,64097,0,0,66,66,0,1,0,1,0
46346,35440,0,0,66,66,0,1,0,1,0
61190,21247,0,0,66,66,0,1,0,1,0
54530,35440,0,0,66,66,0,1,0,1,0
7891,25174,0,0,66,66,0,1,0,1,0
55968,56205,0,0,66,66,0,1,0,1,0
58638,5900,0,0,62,62,0,1,0,1,0
50066,30188,0,0,66,66,0,1,0,1,0
14715,56205,0,0,62,62,0,1,0,1,0
53543,44847,0,0,62,62,0,1,0,1,0
2425,23117,0,0,66,66,0,1,0,1,0
19875,30170,0,0,145,145,0,1,0,1,0
38629,25174,0,0,62,62,0,1,0,1,0
8102,57470,0,0,62,62,0,1,0,1,0
54140,43890,0,0,62,62,0,1,0,1,0
54299,28081,0,0,143,143,0,1,0,1,0
25961,55783,0,0,60,60,0,1,0,1,0
58638,5900,0,0,62,62,0,1,0,1,0
20409,23,0,0,60,60,0,1,0,1,0
61527,51050,0,0,66,66,0,1,0,1,0
0,0,0,0,98,98,0,1,0,1,0
61881,48817,0,0,148,148,0,1,0,1,0
56213,26467,0,0,66,66,0,1,0,1,0
46808,25174,0,0,62,62,0,1,0,1,0
12290,22114,0,0,62,62,0,1,0,1,0
52050,11392,0,0,62,62,0,1,0,1,0
21482,22114,0,0,62,62,0,1,0,1,0
443,48346,0,0,81,81,0,1,0,1,0
58638,5900,0,0,62,62,0,1,0,1,0
13907,57470,0,0,62,62,0,1,0,1,0
2437,23117,0,0,62,62,0,1,0,1,0
33215,37965,0,0,62,62,0,1,0,1,0
42030,25,0,0,74,74,0,1,0,1,0
62792,53,0,0,88,88,0,1,0,1,0
56308,22114,0,0,146,146,0,1,0,1,0
53470,22114,0,0,66,66,0,1,0,1,0
33305,54532,0,0,60,60,0,1,0,1,0
37959,3855,0,0,72,72,0,1,0,1,0
25067,22114,0,0,146,146,0,1,0,1,0
57420,22114,0,0,62,62,0,1,0,1,0
36738,123,0,0,234,234,0,1,0,1,0
21998,51221,0,0,62,62,0,1,0,1,0
62148,37965,0,0,62,62,0,1,0,1,0
17173,23,0,0,60,60,0,1,0,1,0
16387,8455,0,0,60,60,0,1,0,1,0
4041,23,0,0,60,60,0,1,0,1,0
57706,64147,0,0,66,66,0,1,0,1,0
30697,57866,0,0,62,62,0,1,0,1,0
53199,30188,0,0,66,66,0,1,0,1,0
26494,26467,0,0,62,62,0,1,0,1,0
64727,25174,0,0,66,66,0,1,0,1,0
43584,24748,0,0,156,156,0,1,0,1,0
3584,25174,0,0,62,62,0,1,0,1,0
61085,37965,0,0,62,62,0,1,0,1,0
60793,53733,0,0,66,66,0,1,0,1,0
2075,19473,0,0,66,66,0,1,0,1,0
49164,25174,0,0,62,62,0,1,0,1,0
39981,57470,0,0,62,62,0,1,0,1,0
31017,50584,0,0,62,62,0,1,0,1,0
26085,8305,0,0,148,148,0,1,0,1,0
68,67,0,0,346,346,0,1,0,1,0
48676,53393,0,0,60,60,0,1,0,1,0
52483,1433,0,0,60,60,0,1,0,1,0
52811,44847,0,0,66,66,0,1,0,1,0
56778,35440,0,0,62,62,0,1,0,1,0
45964,2225,0,0,60,60,0,1,0,1,0
64190,2767,0,0,66,66,0,1,0,1,0
53841,37965,0,0,66,66,0,1,0,1,0
46901,26672,0,0,60,60,0,1,0,1,0
54300,22114,0,0,62,62,0,1,0,1,0
63433,57866,0,0,66,66,0,1,0,1,0
63486,51505,0,0,66,66,0,1,0,1,0
60645,35440,0,0,66,66,0,1,0,1,0
29576,37807,0,0,66,66,0,1,0,1,0
17640,55442,0,0,66,66,0,1,0,1,0
46495,4607,0,0,60,60,0,1,0,1,0
58638,5900,0,0,62,62,0,1,0,1,0
3478,61463,0,0,1163,1163,0,1,0,1,0
22924,25174,0,0,146,146,0,1,0,1,0
62051,11392,0,0,66,66,0,1,0,1,0
21833,22114,0,0,62,62,0,1,0,1,0
31130,30188,0,0,62,62,0,1,0,1,0
47910,7454,0,0,60,60,0,1,0,1,0
63832,25174,0,0,66,66,0,1,0,1,0
45855,25174,0,0,62,62,0,1,0,1,0
64691,25320,0,0,66,66,0,1,0,1,0
58022,7474,0,0,60,60,0,1,0,1,0
52973,57470,0,0,74,74,0,1,0,1,0
53389,23,0,0,60,60,0,1,0,1,0
18091,32480,0,0,66,66,0,1,0,1,0
3597,11392,0,0,66,66,0,1,0,1,0
39531,19473,0,0,62,62,0,1,0,1,0
54542,25604,0,0,62,62,0,1,0,1,0
12644,11392,0,0,62,62,0,1,0,1,0
54758,35993,0,0,66,66,0,1,0,1,0
14333,51050,0,0,62,62,0,1,0,1,0
14614,25174,0,0,62,62,0,1,0,1,0
39742,62413,0,0,62,62,0,1,0,1,0
64776,50584,0,0,66,66,0,1,0,1,0
53147,37965,0,0,62,62,0,1,0,1,0
26420,25174,0,0,66,66,0,1,0,1,0
443,4205,0,0,320,320,0,1,0,1,0
39959,23117,0,0,62,62,0,1,0,1,0
51414,50584,0,0,66,66,0,1,0,1,0
62194,50584,0,0,66,66,0,1,0,1,0
23379,57866,0,0,62,62,0,1,0,1,0
64723,56205,0,0,62,62,0,1,0,1,0
57874,26467,0,0,62,62,0,1,0,1,0
58638,5900,0,0,62,62,0,1,0,1,0
46587,57470,0,0,66,66,0,1,0,1,0
54773,50584,0,0,66,66,0,1,0,1,0
32215,22114,0,0,62,62,0,1,0,1,0
13973,50584,0,0,146,146,0,1,0,1,0
58638,5900,0,0,62,62,0,1,0,1,0
1114,46824,0,0,62,62,0,1,0,1,0
59424,50265,0,0,70,70,0,1,0,1,0
18876,44847,0,0,66,66,0,1,0,1,0
58638,5900,0,0,62,62,0,1,0,1,0
60052,37965,0,0,66,66,0,1,0,1,0
14615,57866,0,0,62,62,0,1,0,1,0
47063,15503,0,0,146,146,0,1,0,1,0
59509,64147,0,0,62,62,0,1,0,1,0
21365,23718,0,0,62,62,0,1,0,1,0
52626,44847,0,0,66,66,0,1,0,1,0
0,0,0,0,102,102,0,1,0,1,0
52076,44847,0,0,62,62,0,1,0,1,0
59988,64147,0,0,66,66,0,1,0,1,0
23021,25174,0,0,66,66,0,1,0,1,0
39823,36237,0,0,66,66,0,1,0,1,0
35657,48637,0,0,62,62,0,1,0,1,0
56460,22114,0,0,146,146,0,1,0,1,0
57131,31061,0,0,145,145,0,1,0,1,0
57837,64147,0,0,62,62,0,1,0,1,0
29988,44847,0,0,66,66,0,1,0,1,0
58638,5900,0,0,62,62,0,1,0,1,0
34217,23,0,0,60,60,0,1,0,1,0
52177,25320,0,0,66,66,0,1,0,1,0
64903,51050,0,0,66,66,0,1,0,1,0
64882,43890,0,0,66,66,0,1,0,1,0
24504,37965,0,0,62,62,0,1,0,1,0
13528,51221,0,0,62,62,0,1,0,1,0
8889,16520,0,0,60,60,0,1,0,1,0
45941,23386,0,0,60,60,0,1,0,1,0
63271,52752,0,0,78,78,0,1,0,1,0
58468,37965,0,0,66,66,0,1,0,1,0
56639,48817,0,0,66,66,0,1,0,1,0
26053,33720,0,0,160,160,0,1,0,1,0
52537,37965,0,0,62,62,0,1,0,1,0
34129,19410,0,0,60,60,0,1,0,1,0
58638,5900,0,0,62,62,0,1,0,1,0
46478,64147,0,0,62,62,0,1,0,1,0
59227,11392,0,0,62,62,0,1,0,1,0
13188,35440,0,0,66,66,0,1,0,1,0
12550,37807,0,0,62,62,0,1,0,1,0
55069,44847,0,0,66,66,0,1,0,1,0
52328,44847,0,0,66,66,0,1,0,1,0
80,54605,0,0,66,66,0,1,0,1,0
64191,44847,0,0,66,66,0,1,0,1,0
24874,55108,0,0,145,145,0,1,0,1,0
26792,37965,0,0,62,62,0,1,0,1,0
57789,30188,0,0,62,62,0,1,0,1,0
60168,35440,0,0,66,66,0,1,0,1,0
63098,35440,0,0,66,66,0,1,0,1,0
58638,5900,0,0,62,62,0,1,0,1,0
36858,50265,0,0,146,146,0,1,0,1,0
50488,22114,0,0,66,66,0,1,0,1,0
26531,37965,0,0,62,62,0,1,0,1,0
56268,44847,0,0,66,66,0,1,0,1,0
64543,50265,0,0,66,66,0,1,0,1,0
58131,15503,0,0,146,146,0,1,0,1,0
42632,44847,0,0,62,62,0,1,0,1,0
61970,57866,0,0,62,62,0,1,0,1,0
53298,26467,0,0,66,66,0,1,0,1,0
61639,37965,0,0,66,66,0,1,0,1,0
52114,64147,0,0,62,62,0,1,0,1,0
1108,47807,0,0,159,159,0,1,0,1,0
52018,57866,0,0,62,62,0,1,0,1,0
45941,23386,0,0,60,60,0,1,0,1,0
60159,22114,0,0,66,66,0,1,0,1,0
7286,44847,0,0,66,66,0,1,0,1,0
80,57411,0,0,1514,1514,0,1,0,1,0
37308,43890,0,0,62,62,0,1,0,1,0
51401,6881,0,0,66,66,0,1,0,1,0
27038,63836,0,0,145,145,0,1,0,1,0
3478,61463,0,0,1275,1275,0,1,0,1,0
47013,37965,0,0,62,62,0,1,0,1,0
49308,22114,0,0,66,66,0,1,0,1,0
28839,30188,0,0,62,62,0,1,0,1,0
21145,11392,0,0,146,146,0,1,0,1,0
33896,57470,0,0,74,74,0,1,0,1,0
56103,21247,0,0,66,66,0,1,0,1,0
57504,44847,0,0,66,66,0,1,0,1,0
1238,51505,0,0,62,62,0,1,0,1,0
3478,61463,0,0,901,901,0,1,0,1,0
2828,35253,0,0,66,66,0,1,0,1,0
5223,44091,0,0,220,220,0,1,0,1,0
58638,5900,0,0,62,62,0,1,0,1,0
62080,54532,0,0,60,60,0,1,0,1,0
25772,7302,0,0,66,66,0,1,0,1,0
46116,57470,0,0,74,74,0,1,0,1,0
49160,63766,0,0,146,146,0,1,0,1,0
48676,53398,0,0,60,60,0,1,0,1,0
50254,2323,0,0,60,60,0,1,0,1,0
60571,26467,0,0,62,62,0,1,0,1,0
46275,23,0,0,60,60,0,1,0,1,0
57131,8055,0,0,145,145,0,1,0,1,0
47303,31170,0,0,145,145,0,1,0,1,0
51320,37965,0,0,62,62,0,1,0,1,0
24285,26467,0,0,62,62,0,1,0,1,0
19204,48817,0,0,148,148,0,1,0,1,0
63062,11392,0,0,62,62,0,1,0,1,0
62079,30188,0,0,62,62,0,1,0,1,0
44117,6881,0,0,62,62,0,1,0,1,0
53770,64147,0,0,66,66,0,1,0,1,0
58638,5900,0,0,62,62,0,1,0,1,0
62109,44847,0,0,62,62,0,1,0,1,0
55199,21247,0,0,62,62,0,1,0,1,0
48706,23393,0,0,60,60,0,1,0,1,0
58638,5900,0,0,62,62,0,1,0,1,0
27055,25174,0,0,62,62,0,1,0,1,0
50106,31573,0,0,62,62,0,1,0,1,0
3478,61463,0,0,902,902,0,1,0,1,0
17378,44847,0,0,66,66,0,1,0,1,0
2864,25174,0,0,66,66,0,1,0,1,0
8999,57470,0,0,146,146,0,1,0,1,0
41004,5000,0,0,60,60,0,1,0,1,0
31035,23,0,0,60,60,0,1,0,1,0
50674,35440,0,0,62,62,0,1,0,1,0
63041,50584,0,0,62,62,0,1,0,1,0
59965,36237,0,0,62,62,0,1,0,1,0
59210,8168,0,0,66,66,0,1,0,1,0
57782,57470,0,0,66,66,0,1,0,1,0
27448,22114,0,0,62,62,0,1,0,1,0
20400,64147,0,0,62,62,0,1,0,1,0
28124,37965,0,0,62,62,0,1,0,1,0
50052,65008,0,0,60,60,0,1,0,1,0
80,53945,0,0,60,60,0,1,0,1,0
56897,11446,0,0,62,62,0,1,0,1,0
58022,5555,0,0,60,60,0,1,0,1,0
17010,57470,0,0,62,62,0,1,0,1,0
61455,64147,0,0,66,66,0,1,0,1,0
80,37649,0,0,60,60,0,1,0,1,0
45981,51505,0,0,146,146,0,1,0,1,0
18085,26467,0,0,66,66,0,1,0,1,0
25595,2323,0,0,60,60,0,1,0,1,0
11030,37965,0,0,62,62,0,1,0,1,0
27323,23117,0,0,146,146,0,1,0,1,0
61961,11392,0,0,66,66,0,1,0,1,0
18767,35440,0,0,146,146,0,1,0,1,0
53704,23,0,0,60,60,0,1,0,1,0
61345,21247,0,0,62,62,0,1,0,1,0
55464,22114,0,0,62,62,0,1,0,1,0
65389,26467,0,0,62,62,0,1,0,1,0
63848,64147,0,0,66,66,0,1,0,1,0
5223,44091,0,0,220,220,0,1,0,1,0
53746,36237,0,0,66,66,0,1,0,1,0
51760,50584,0,0,62,62,0,1,0,1,0
49001,48983,0,0,161,161,0,1,0,1,0
52740,51505,0,0,66,66,0,1,0,1,0
61430,37965,0,0,66,66,0,1,0,1,0
12821,37965,0,0,66,66,0,1,0,1,0
2180,63710,0,0,62,62,0,1,0,1,0
62438,37807,0,0,62,62,0,1,0,1,0
6881,6881,0,0,62,62,0,1,0,1,0
43260,41615,0,0,145,145,0,1,0,1,0
51032,30188,0,0,66,66,0,1,0,1,0
52492,37965,0,0,66,66,0,1,0,1,0
3090,1,0,0,62,62,0,1,0,1,0
1036,64147,0,0,62,62,0,1,0,1,0
16215,6881,0,0,146,146,0,1,0,1,0
1660,8696,0,0,62,62,0,1,0,1,0
50222,42873,0,0,66,66,0,1,0,1,0
42285,57470,0,0,62,62,0,1,0,1,0
58638,5900,0,0,62,62,0,1,0,1,0
49990,62413,0,0,66,66,0,1,0,1,0
30800,25174,0,0,62,62,0,1,0,1,0
62550,51505,0,0,62,62,0,1,0,1,0
62338,50011,0,0,66,66,0,1,0,1,0
11878,37807,0,0,146,146,0,1,0,1,0
53362,23,0,0,60,60,0,1,0,1,0
7701,23,0,0,60,60,0,1,0,1,0
63027,35440,0,0,66,66,0,1,0,1,0
19099,56205,0,0,62,62,0,1,0,1,0
9687,35440,0,0,66,66,0,1,0,1,0
63323,54369,0,0,78,78,0,1,0,1,0
27038,51505,0,0,146,146,0,1,0,1,0
25015,64147,0,0,66,66,0,1,0,1,0
1024,64147,0,0,62,62,0,1,0,1,0
26424,27189,0,0,66,66,0,1,0,1,0
60058,25174,0,0,66,66,0,1,0,1,0
17097,62413,0,0,62,62,0,1,0,1,0
54575,11392,0,0,66,66,0,1,0,1,0
53848,36237,0,0,62,62,0,1,0,1,0
58638,5900,0,0,62,62,0,1,0,1,0
41486,1433,0,0,60,60,0,1,0,1,0
24288,23,0,0,60,60,0,1,0,1,0
35291,44847,0,0,62,62,0,1,0,1,0
58398,44847,0,0,66,66,0,1,0,1,0
19136,64147,0,0,62,62,0,1,0,1,0
50245,44847,0,0,66,66,0,1,0,1,0
15442,22114,0,0,66,66,0,1,0,1,0
62549,64147,0,0,62,62,0,1,0,1,0
35291,44847,0,0,66,66,0,1,0,1,0
52472,51221,0,0,74,74,0,1,0,1,0
43129,15503,0,0,62,62,0,1,0,1,0
27089,30627,0,0,146,146,0,1,0,1,0
10390,26467,0,0,62,62,0,1,0,1,0
58638,5900,0,0,62,62,0,1,0,1,0
16522,26467,0,0,66,66,0,1,0,1,0
58343,23718,0,0,66,66,0,1,0,1,0
41756,56205,0,0,62,62,0,1,0,1,0
55711,26467,0,0,62,62,0,1,0,1,0
26531,37965,0,0,62,62,0,1,0,1,0
1024,64147,0,0,62,62,0,1,0,1,0
18683,26467,0,0,62,62,0,1,0,1,0
25889,11446,0,0,66,66,0,1,0,1,0
64757,52700,0,0,62,62,0,1,0,1,0
47256,37807,0,0,62,62,0,1,0,1,0
52720,35894,0,0,62,62,0,1,0,1,0
31017,50584,0,0,62,62,0,1,0,1,0
52819,15503,0,0,66,66,0,1,0,1,0
6486,64147,0,0,66,66,0,1,0,1,0
58836,44847,0,0,74,74,0,1,0,1,0
54305,35440,0,0,62,62,0,1,0,1,0
42898,43890,0,0,62,62,0,1,0,1,0
22904,56205,0,0,62,62,0,1,0,1,0
58226,52848,0,0,145,145,0,1,0,1,0
50734,37965,0,0,62,62,0,1,0,1,0
63503,42707,0,0,66,66,0,1,0,1,0
12709,51505,0,0,62,62,0,1,0,1,0
5223,21557,0,0,91,91,0,1,0,1,0
58638,5900,0,0,62,62,0,1,0,1,0
64693,26467,0,0,62,62,0,1,0,1,0
4111,25174,0,0,146,146,0,1,0,1,0
57982,64147,0,0,66,66,0,1,0,1,0
47832,50584,0,0,62,62,0,1,0,1,0
10909,30975,0,0,148,148,0,1,0,1,0
21108,25174,0,0,62,62,0,1,0,1,0
52459,33890,0,0,60,60,0,1,0,1,0
50620,50584,0,0,66,66,0,1,0,1,0
51172,44847,0,0,66,66,0,1,0,1,0
53906,44512,0,0,62,62,0,1,0,1,0
45410,1,0,0,62,62,0,1,0,1,0
23061,23,0,0,60,60,0,1,0,1,0
11235,30188,0,0,62,62,0,1,0,1,0
3478,61463,0,0,944,944,0,1,0,1,0
61400,64147,0,0,62,62,0,1,0,1,0
1620,53567,0,0,62,62,0,1,0,1,0
50316,25604,0,0,62,62,0,1,0,1,0
49160,44512,0,0,146,146,0,1,0,1,0
45941,23386,0,0,60,60,0,1,0,1,0
13279,10387,0,0,159,159,0,1,0,1,0
8622,64147,0,0,66,66,0,1,0,1,0
60246,44612,0,0,62,62,0,1,0,1,0
61660,64097,0,0,62,62,0,1,0,1,0
56872,21247,0,0,74,74,0,1,0,1,0
62089,8604,0,0,66,66,0,1,0,1,0
53105,42707,0,0,66,66,0,1,0,1,0
21492,51505,0,0,62,62,0,1,0,1,0
22927,48817,0,0,143,143,0,1,0,1,0
80,36466,0,0,1514,1514,0,1,0,1,0
54438,62413,0,0,66,66,0,1,0,1,0
31748,56205,0,0,62,62,0,1,0,1,0
36770,56205,0,0,62,62,0,1,0,1,0
50102,17546,0,0,66,66,0,1,0,1,0
58638,5900,0,0,62,62,0,1,0,1,0
62765,16933,0,0,66,66,0,1,0,1,0
23089,48817,0,0,62,62,0,1,0,1,0
57070,30170,0,0,146,146,0,1,0,1,0
58562,57587,0,0,66,66,0,1,0,1,0
62131,50584,0,0,66,66,0,1,0,1,0
50127,64147,0,0,66,66,0,1,0,1,0
80,53945,0,0,60,60,0,1,0,1,0
55079,25174,0,0,66,66,0,1,0,1,0
22733,26467,0,0,62,62,0,1,0,1,0
58638,5900,0,0,62,62,0,1,0,1,0
46808,25174,0,0,146,146,0,1,0,1,0
50651,25174,0,0,62,62,0,1,0,1,0
49418,22114,0,0,66,66,0,1,0,1,0
50360,35440,0,0,66,66,0,1,0,1,0
49616,30188,0,0,66,66,0,1,0,1,0
1024,57470,0,0,62,62,0,1,0,1,0
61916,64097,0,0,66,66,0,1,0,1,0
47910,7454,0,0,60,60,0,1,0,1,0
53465,57470,0,0,62,62,0,1,0,1,0
54973,1433,0,0,60,60,0,1,0,1,0
41213,25174,0,0,62,62,0,1,0,1,0
17777,30188,0,0,62,62,0,1,0,1,0
80,8562,0,0,74,74,0,1,0,1,0
1025,46776,0,0,62,62,0,1,0,1,0
57585,19750,0,0,66,66,0,1,0,1,0
7539,30317,0,0,62,62,0,1,0,1,0
42030,25,0,0,74,74,0,1,0,1,0
5223,44091,0,0,66,66,0,1,0,1,0
20217,8333,0,0,60,60,0,1,0,1,0
64155,60043,0,0,62,62,0,1,0,1,0
60617,64147,0,0,62,62,0,1,0,1,0
443,20087,0,0,83,83,0,1,0,1,0
62489,23117,0,0,66,66,0,1,0,1,0
16883,22,0,0,60,60,0,1,0,1,0
55145,11392,0,0,66,66,0,1,0,1,0
58638,5900,0,0,62,62,0,1,0,1,0
32997,50584,0,0,62,62,0,1,0,1,0
13484,37965,0,0,66,66,0,1,0,1,0
52870,22197,0,0,66,66,0,1,0,1,0
39056,22114,0,0,62,62,0,1,0,1,0
63672,22114,0,0,66,66,0,1,0,1,0
59745,25174,0,0,62,62,0,1,0,1,0
47141,50584,0,0,62,62,0,1,0,1,0
34677,51185,0,0,60,60,0,1,0,1,0
58627,64097,0,0,62,62,0,1,0,1,0
53756,50584,0,0,66,66,0,1,0,1,0
18398,21247,0,0,66,66,0,1,0,1,0
29109,11392,0,0,146,146,0,1,0,1,0
8820,41864,0,0,143,143,0,1,0,1,0
2681,48817,0,0,146,146,0,1,0,1,0
64890,51180,0,0,62,62,0,1,0,1,0
993,51747,0,0,66,66,0,1,0,1,0
6666,138,0,0,60,60,0,1,0,1,0
42144,30170,0,0,146,146,0,1,0,1,0
57991,22114,0,0,66,66,0,1,0,1,0
26566,44847,0,0,66,66,0,1,0,1,0
443,20995,0,0,83,83,0,1,0,1,0
6729,51505,0,0,62,62,0,1,0,1,0
61148,37965,0,0,66,66,0,1,0,1,0
48478,49903,0,0,62,62,0,1,0,1,0
49677,25174,0,0,66,66,0,1,0,1,0
5379,37965,0,0,66,66,0,1,0,1,0
58638,5900,0,0,62,62,0,1,0,1,0
19610,55839,0,0,137,137,0,1,0,1,0
3802,55777,0,0,66,66,0,1,0,1,0
55512,23718,0,0,66,66,0,1,0,1,0
40977,21247,0,0,62,62,0,1,0,1,0
62569,44847,0,0,66,66,0,1,0,1,0
49160,57470,0,0,146,146,0,1,0,1,0
24236,8055,0,0,148,148,0,1,0,1,0
10704,25174,0,0,62,62,0,1,0,1,0
53725,64147,0,0,66,66,0,1,0,1,0
443,28417,0,0,82,82,0,1,0,1,0
58638,5900,0,0,62,62,0,1,0,1,0
58638,5900,0,0,62,62,0,1,0,1,0
45941,23387,0,0,60,60,0,1,0,1,0
56440,56205,0,0,62,62,0,1,0,1,0
443,48346,0,0,81,81,0,1,0,1,0
58022,3000,0,0,60,60,0,1,0,1,0
64392,25174,0,0,62,62,0,1,0,1,0
46180,1433,0,0,60,60,0,1,0,1,0
35377,43890,0,0,62,62,0,1,0,1,0
51783,50584,0,0,66,66,0,1,0,1,0
50822,50584,0,0,66,66,0,1,0,1,0
28156,50584,0,0,62,62,0,1,0,1,0
31748,56205,0,0,62,62,0,1,0,1,0
14397,37965,0,0,62,62,0,1,0,1,0
58638,5900,0,0,62,62,0,1,0,1,0
58497,39004,0,0,66,66,0,1,0,1,0
64379,37965,0,0,66,66,0,1,0,1,0
55986,26467,0,0,62,62,0,1,0,1,0
59378,50584,0,0,62,62,0,1,0,1,0
43323,1,0,0,62,62,0,1,0,1,0
9212,51505,0,0,62,62,0,1,0,1,0
58751,51221,0,0,62,62,0,1,0,1,0
6546,37965,0,0,62,62,0,1,0,1,0
50470,61463,0,0,86,86,0,1,0,1,0
43129,20220,0,0,62,62,0,1,0,1,0
15403,51505,0,0,66,66,0,1,0,1,0
59523,37965,0,0,62,62,0,1,0,1,0
62859,35440,0,0,66,66,0,1,0,1,0
32554,34729,0,0,62,62,0,1,0,1,0
7482,57470,0,0,66,66,0,1,0,1,0
60374,57470,0,0,62,62,0,1,0,1,0
59326,57470,0,0,74,74,0,1,0,1,0
41756,56205,0,0,62,62,0,1,0,1,0
41447,64147,0,0,62,62,0,1,0,1,0
26324,30188,0,0,62,62,0,1,0,1,0
62914,11392,0,0,146,146,0,1,0,1,0
58912,11392,0,0,62,62,0,1,0,1,0
58338,3362,0,0,60,60,0,1,0,1,0
30783,51505,0,0,62,62,0,1,0,1,0
56255,44847,0,0,62,62,0,1,0,1,0
51705,22114,0,0,66,66,0,1,0,1,0
27947,26467,0,0,66,66,0,1,0,1,0
2636,11392,0,0,62,62,0,1,0,1,0
50327,1433,0,0,60,60,0,1,0,1,0
22574,44847,0,0,62,62,0,1,0,1,0
7000,23117,0,0,66,66,0,1,0,1,0
15854,50584,0,0,62,62,0,1,0,1,0
13840,37965,0,0,146,146,0,1,0,1,0
0,0,0,0,98,98,0,1,0,1,0
56621,50584,0,0,62,62,0,1,0,1,0
61589,21247,0,0,62,62,0,1,0,1,0
59477,36829,0,0,66,66,0,1,0,1,0
60248,46776,0,0,66,66,0,1,0,1,0
42898,43890,0,0,62,62,0,1,0,1,0
31021,35440,0,0,146,146,0,1,0,1,0
64586,50584,0,0,146,146,0,1,0,1,0
15341,23,0,0,60,60,0,1,0,1,0
15403,51505,0,0,66,66,0,1,0,1,0
46093,32661,0,0,74,74,0,1,0,1,0
7619,50584,0,0,62,62,0,1,0,1,0
58638,5900,0,0,62,62,0,1,0,1,0
13963,50584,0,0,62,62,0,1,0,1,0
60771,58414,0,0,66,66,0,1,0,1,0
55893,45711,0,0,78,78,0,1,0,1,0
49380,21247,0,0,66,66,0,1,0,1,0
13985,34159,0,0,66,66,0,1,0,1,0
32974,37965,0,0,66,66,0,1,0,1,0
1373,22114,0,0,66,66,0,1,0,1,0
53971,50265,0,0,62,62,0,1,0,1,0
36663,22114,0,0,62,62,0,1,0,1,0
53089,24211,0,0,66,66,0,1,0,1,0
6881,45711,0,0,100,100,0,1,0,1,0
64024,57470,0,0,62,62,0,1,0,1,0
56999,25174,0,0,62,62,0,1,0,1,0
3381,44847,0,0,78,78,0,1,0,1,0
58638,5900,0,0,62,62,0,1,0,1,0
25031,25174,0,0,62,62,0,1,0,1,0
58318,15503,0,0,66,66,0,1,0,1,0
55865,64147,0,0,66,66,0,1,0,1,0
58972,57866,0,0,66,66,0,1,0,1,0
50713,57470,0,0,66,66,0,1,0,1,0
63547,37965,0,0,66,66,0,1,0,1,0
28878,51505,0,0,62,62,0,1,0,1,0
59430,50584,0,0,66,66,0,1,0,1,0
31683,35440,0,0,62,62,0,1,0,1,0
51096,63710,0,0,66,66,0,1,0,1,0
39540,37965,0,0,66,66,0,1,0,1,0
51197,57470,0,0,66,66,0,1,0,1,0
56442,11392,0,0,66,66,0,1,0,1,0
9659,81,0,0,60,60,0,1,0,1,0
62569,44847,0,0,66,66,0,1,0,1,0
1044,23,0,0,60,60,0,1,0,1,0
23936,35440,0,0,62,62,0,1,0,1,0
63342,53,0,0,72,72,0,1,0,1,0
1024,25174,0,0,146,146,0,1,0,1,0
58715,57470,0,0,66,66,0,1,0,1,0
65379,22114,0,0,66,66,0,1,0,1,0
52969,44847,0,0,66,66,0,1,0,1,0
20133,2767,0,0,62,62,0,1,0,1,0
26821,57866,0,0,62,62,0,1,0,1,0
56653,22114,0,0,66,66,0,1,0,1,0
49824,25174,0,0,146,146,0,1,0,1,0
5664,36237,0,0,62,62,0,1,0,1,0
3169,22114,0,0,62,62,0,1,0,1,0
32007,26543,0,0,145,145,0,1,0,1,0
22924,25174,0,0,62,62,0,1,0,1,0
15701,37965,0,0,146,146,0,1,0,1,0
58638,5900,0,0,62,62,0,1,0,1,0
50877,30041,0,0,66,66,0,1,0,1,0
14183,26467,0,0,62,62,0,1,0,1,0
22683,39210,0,0,60,60,0,1,0,1,0
58564,50432,0,0,66,66,0,1,0,1,0
25360,51505,0,0,62,62,0,1,0,1,0
60141,62413,0,0,66,66,0,1,0,1,0
23089,48817,0,0,62,62,0,1,0,1,0
54438,62413,0,0,66,66,0,1,0,1,0
60969,48637,0,0,78,78,0,1,0,1,0
39570,62413,0,0,146,146,0,1,0,1,0
52358,30188,0,0,66,66,0,1,0,1,0
49479,56205,0,0,66,66,0,1,0,1,0
18750,57866,0,0,146,146,0,1,0,1,0
43916,21,0,0,60,60,0,1,0,1,0
60196,53,0,0,88,88,0,1,0,1,0
40571,26467,0,0,62,62,0,1,0,1,0
59303,21247,0,0,62,62,0,1,0,1,0
56327,44512,0,0,66,66,0,1,0,1,0
54276,37628,0,0,66,66,0,1,0,1,0
12074,10197,0,0,72,72,0,1,0,1,0
41213,25174,0,0,62,62,0,1,0,1,0
49976,22114,0,0,66,66,0,1,0,1,0
58638,5900,0,0,62,62,0,1,0,1,0
30304,26467,0,0,62,62,0,1,0,1,0
50052,65008,0,0,60,60,0,1,0,1,0
28764,2323,0,0,60,60,0,1,0,1,0
62767,57470,0,0,74,74,0,1,0,1,0
45682,37965,0,0,62,62,0,1,0,1,0
1620,53567,0,0,66,66,0,1,0,1,0
41653,21247,0,0,62,62,0,1,0,1,0
993,38356,0,0,66,66,0,1,0,1,0
54578,26467,0,0,66,66,0,1,0,1,0
58638,5900,0,0,62,62,0,1,0,1,0
61329,51505,0,0,62,62,0,1,0,1,0
5222,21212,0,0,66,66,0,1,0,1,0
55951,30188,0,0,66,66,0,1,0,1,0
55255,37965,0,0,146,146,0,1,0,1,0
30800,25174,0,0,62,62,0,1,0,1,0
56494,15503,0,0,146,146,0,1,0,1,0
26323,50584,0,0,146,146,0,1,0,1,0
53447,44847,0,0,66,66,0,1,0,1,0
6666,401,0,0,60,60,0,1,0,1,0
7226,50584,0,0,62,62,0,1,0,1,0
62799,25174,0,0,62,62,0,1,0,1,0
54013,37965,0,0,66,66,0,1,0,1,0
27507,25174,0,0,62,62,0,1,0,1,0
37959,3855,0,0,72,72,0,1,0,1,0
26502,64147,0,0,62,62,0,1,0,1,0
13090,36237,0,0,62,62,0,1,0,1,0
53539,44847,0,0,62,62,0,1,0,1,0
13408,44847,0,0,62,62,0,1,0,1,0
45941,23386,0,0,60,60,0,1,0,1,0
51413,57470,0,0,72,72,0,1,0,1,0
23753,25174,0,0,62,62,0,1,0,1,0
58638,5900,0,0,62,62,0,1,0,1,0
46859,50584,0,0,62,62,0,1,0,1,0
22948,26467,0,0,62,62,0,1,0,1,0
50644,35440,0,0,66,66,0,1,0,1,0
65344,46824,0,0,66,66,0,1,0,1,0
19617,39004,0,0,62,62,0,1,0,1,0
62088,56205,0,0,66,66,0,1,0,1,0
23900,64147,0,0,62,62,0,1,0,1,0
41003,5000,0,0,60,60,0,1,0,1,0
62930,21247,0,0,66,66,0,1,0,1,0
65259,37965,0,0,62,62,0,1,0,1,0
11541,40108,0,0,148,148,0,1,0,1,0
60875,50584,0,0,66,66,0,1,0,1,0
3272,1433,0,0,60,60,0,1,0,1,0
43363,26467,0,0,66,66,0,1,0,1,0
13518,25174,0,0,146,146,0,1,0,1,0
57496,25174,0,0,66,66,0,1,0,1,0
43724,35440,0,0,62,62,0,1,0,1,0
62337,44847,0,0,62,62,0,1,0,1,0
10916,44847,0,0,66,66,0,1,0,1,0
56528,64147,0,0,62,62,0,1,0,1,0
56015,56205,0,0,62,62,0,1,0,1,0
30179,57470,0,0,60,60,0,1,0,1,0
58638,5900,0,0,62,62,0,1,0,1,0
26180,35440,0,0,66,66,0,1,0,1,0
64605,35993,0,0,62,62,0,1,0,1,0
58791,25174,0,0,62,62,0,1,0,1,0
57289,31573,0,0,62,62,0,1,0,1,0
63341,53,0,0,77,77,0,1,0,1,0
45682,37965,0,0,145,145,0,1,0,1,0
62912,26467,0,0,62,62,0,1,0,1,0
45908,3383,0,0,60,60,0,1,0,1,0
55451,56205,0,0,66,66,0,1,0,1,0
34489,35440,0,0,62,62,0,1,0,1,0
58638,5900,0,0,62,62,0,1,0,1,0
58912,11392,0,0,66,66,0,1,0,1,0
42238,25174,0,0,62,62,0,1,0,1,0
8508,23,0,0,60,60,0,1,0,1,0
17916,23,0,0,60,60,0,1,0,1,0
41586,1900,0,0,139,139,0,1,0,1,0
58638,5900,0,0,62,62,0,1,0,1,0
64219,51050,0,0,66,66,0,1,0,1,0
6126,25174,0,0,66,66,0,1,0,1,0
45144,25174,0,0,146,146,0,1,0,1,0
18745,64147,0,0,66,66,0,1,0,1,0
443,64347,0,0,60,60,0,1,0,1,0
1024,44847,0,0,146,146,0,1,0,1,0
3911,37965,0,0,66,66,0,1,0,1,0
58876,57470,0,0,66,66,0,1,0,1,0
65025,57866,0,0,66,66,0,1,0,1,0
6842,42873,0,0,66,66,0,1,0,1,0
15854,50584,0,0,62,62,0,1,0,1,0
3225,64147,0,0,66,66,0,1,0,1,0
43747,22114,0,0,62,62,0,1,0,1,0
15131,50584,0,0,62,62,0,1,0,1,0
52430,35440,0,0,62,62,0,1,0,1,0
49788,1433,0,0,60,60,0,1,0,1,0
49699,64147,0,0,62,62,0,1,0,1,0
40787,57470,0,0,62,62,0,1,0,1,0
57750,37965,0,0,146,146,0,1,0,1,0
63305,62413,0,0,66,66,0,1,0,1,0
6943,1,0,0,100,100,0,1,0,1,0
52929,43890,0,0,66,66,0,1,0,1,0
49752,50584,0,0,62,62,0,1,0,1,0
50222,42873,0,0,66,66,0,1,0,1,0
52111,44847,0,0,66,66,0,1,0,1,0
55600,22,0,0,60,60,0,1,0,1,0
58103,10197,0,0,66,66,0,1,0,1,0
42344,48637,0,0,60,60,0,1,0,1,0
19858,64147,0,0,62,62,0,1,0,1,0
58250,35440,0,0,62,62,0,1,0,1,0
41271,50584,0,0,146,146,0,1,0,1,0
59784,42246,0,0,62,62,0,1,0,1,0
10669,49756,0,0,60,60,0,1,0,1,0
33793,23,0,0,60,60,0,1,0,1,0
12164,22114,0,0,146,146,0,1,0,1,0
50197,64147,0,0,66,66,0,1,0,1,0
51320,37965,0,0,62,62,0,1,0,1,0
38637,22,0,0,60,60,0,1,0,1,0
62088,56205,0,0,66,66,0,1,0,1,0
25237,25174,0,0,62,62,0,1,0,1,0
10914,35974,0,0,60,60,0,1,0,1,0
9957,32480,0,0,66,66,0,1,0,1,0
11136,15503,0,0,62,62,0,1,0,1,0
58598,50584,0,0,66,66,0,1,0,1,0
26400,44847,0,0,146,146,0,1,0,1,0
13285,29892,0,0,145,145,0,1,0,1,0
22619,10214,0,0,66,66,0,1,0,1,0
32796,37965,0,0,66,66,0,1,0,1,0
21064,25174,0,0,62,62,0,1,0,1,0
54866,37965,0,0,62,62,0,1,0,1,0
58638,5900,0,0,62,62,0,1,0,1,0
59191,35440,0,0,66,66,0,1,0,1,0
58458,17,0,0,60,60,0,1,0,1,0
80,53945,0,0,60,60,0,1,0,1,0
17230,25174,0,0,146,146,0,1,0,1,0
46808,25174,0,0,62,62,0,1,0,1,0
3478,61463,0,0,927,927,0,1,0,1,0
51903,26467,0,0,62,62,0,1,0,1,0
45964,7776,0,0,60,60,0,1,0,1,0
56098,55442,0,0,66,66,0,1,0,1,0
24731,51505,0,0,62,62,0,1,0,1,0
10072,25174,0,0,62,62,0,1,0,1,0
19747,37965,0,0,62,62,0,1,0,1,0
19875,30170,0,0,145,145,0,1,0,1,0
39981,57470,0,0,62,62,0,1,0,1,0
55874,64147,0,0,66,66,0,1,0,1,0
26889,50265,0,0,66,66,0,1,0,1,0
53089,24211,0,0,62,62,0,1,0,1,0
58638,5900,0,0,62,62,0,1,0,1,0
29742,50584,0,0,62,62,0,1,0,1,0
47910,7464,0,0,60,60,0,1,0,1,0
62339,25174,0,0,62,62,0,1,0,1,0
38891,64147,0,0,145,145,0,1,0,1,0
1873,37965,0,0,62,62,0,1,0,1,0
9265,37965,0,0,66,66,0,1,0,1,0
45941,23388,0,0,60,60,0,1,0,1,0
60052,37965,0,0,66,66,0,1,0,1,0
3410,17372,0,0,62,62,0,1,0,1,0
39823,36237,0,0,62,62,0,1,0,1,0
46600,443,0,0,1097,1097,0,1,0,1,0
53577,35894,0,0,66,66,0,1,0,1,0
58638,5900,0,0,62,62,0,1,0,1,0
18357,51180,0,0,62,62,0,1,0,1,0
55056,44512,0,0,62,62,0,1,0,1,0
28385,50584,0,0,62,62,0,1,0,1,0
38484,48637,0,0,60,60,0,1,0,1,0
14438,51505,0,0,146,146,0,1,0,1,0
443,60496,0,0,320,320,0,1,0,1,0
2923,57470,0,0,66,66,0,1,0,1,0
19634,64147,0,0,62,62,0,1,0,1,0
11344,42873,0,0,62,62,0,1,0,1,0
80,53945,0,0,60,60,0,1,0,1,0
55835,62413,0,0,66,66,0,1,0,1,0
58638,5900,0,0,62,62,0,1,0,1,0
35744,64147,0,0,66,66,0,1,0,1,0
27046,51505,0,0,66,66,0,1,0,1,0
52518,35440,0,0,66,66,0,1,0,1,0
22981,15503,0,0,62,62,0,1,0,1,0
46362,35440,0,0,66,66,0,1,0,1,0
12668,42707,0,0,62,62,0,1,0,1,0
10248,21247,0,0,146,146,0,1,0,1,0
57239,123,0,0,90,90,0,1,0,1,0
8889,47679,0,0,60,60,0,1,0,1,0
58638,5900,0,0,62,62,0,1,0,1,0
33886,65504,0,0,162,162,0,1,0,1,0
10126,57470,0,0,62,62,0,1,0,1,0
65081,26467,0,0,66,66,0,1,0,1,0
61961,11392,0,0,66,66,0,1,0,1,0
6943,52290,0,0,100,100,0,1,0,1,0
60883,64147,0,0,74,74,0,1,0,1,0
55069,44847,0,0,66,66,0,1,0,1,0
54636,26467,0,0,66,66,0,1,0,1,0
52471,22114,0,0,66,66,0,1,0,1,0
36369,51505,0,0,66,66,0,1,0,1,0
57468,57470,0,0,66,66,0,1,0,1,0
59483,23,0,0,60,60,0,1,0,1,0
53053,64147,0,0,66,66,0,1,0,1,0
7222,57470,0,0,62,62,0,1,0,1,0
6889,5529,0,0,143,143,0,1,0,1,0
52910,51221,0,0,78,78,0,1,0,1,0
58638,5900,0,0,62,62,0,1,0,1,0
41022,30975,0,0,157,157,0,1,0,1,0
13588,15503,0,0,62,62,0,1,0,1,0
45964,2777,0,0,60,60,0,1,0,1,0
55201,26467,0,0,66,66,0,1,0,1,0
53051,44847,0,0,66,66,0,1,0,1,0
54989,50265,0,0,66,66,0,1,0,1,0
2083,25174,0,0,62,62,0,1,0,1,0
54210,64097,0,0,66,66,0,1,0,1,0
60075,41705,0,0,66,66,0,1,0,1,0
54876,25174,0,0,146,146,0,1,0,1,0
65305,51221,0,0,66,66,0,1,0,1,0
21759,51505,0,0,66,66,0,1,0,1,0
9283,57470,0,0,66,66,0,1,0,1,0
2946,25174,0,0,62,62,0,1,0,1,0
30046,15503,0,0,62,62,0,1,0,1,0
10126,57470,0,0,62,62,0,1,0,1,0
65317,51221,0,0,78,78,0,1,0,1,0
23274,50584,0,0,146,146,0,1,0,1,0
0,0,0,0,60,60,0,1,0,1,0
59096,8604,0,0,66,66,0,1,0,1,0
50486,56205,0,0,66,66,0,1,0,1,0
29424,37807,0,0,66,66,0,1,0,1,0
58638,5900,0,0,62,62,0,1,0,1,0
46495,4607,0,0,60,60,0,1,0,1,0
26906,22114,0,0,66,66,0,1,0,1,0
52144,49344,0,0,62,62,0,1,0,1,0
38565,51505,0,0,66,66,0,1,0,1,0
64767,51221,0,0,62,62,0,1,0,1,0
57131,26296,0,0,145,145,0,1,0,1,0
1114,37965,0,0,62,62,0,1,0,1,0
43584,24748,0,0,156,156,0,1,0,1,0
1045,36237,0,0,66,66,0,1,0,1,0
22490,25174,0,0,62,62,0,1,0,1,0
57131,35776,0,0,145,145,0,1,0,1,0
65096,37807,0,0,66,66,0,1,0,1,0
43584,24748,0,0,156,156,0,1,0,1,0
62197,22114,0,0,66,66,0,1,0,1,0
59563,56205,0,0,66,66,0,1,0,1,0
1028,64147,0,0,62,62,0,1,0,1,0
9095,22114,0,0,146,146,0,1,0,1,0
55600,22,0,0,60,60,0,1,0,1,0
65454,61600,0,0,66,66,0,1,0,1,0
47762,36180,0,0,146,146,0,1,0,1,0
8194,21247,0,0,62,62,0,1,0,1,0
54221,57470,0,0,66,66,0,1,0,1,0
14693,64147,0,0,62,62,0,1,0,1,0
51963,22114,0,0,66,66,0,1,0,1,0
28435,23,0,0,60,60,0,1,0,1,0
57289,31573,0,0,66,66,0,1,0,1,0
1035,26467,0,0,62,62,0,1,0,1,0
443,62732,0,0,60,60,0,1,0,1,0
62780,35440,0,0,66,66,0,1,0,1,0
58638,5900,0,0,62,62,0,1,0,1,0
60714,50584,0,0,66,66,0,1,0,1,0
1187,64147,0,0,66,66,0,1,0,1,0
3478,61463,0,0,164,164,0,1,0,1,0
1024,64147,0,0,62,62,0,1,0,1,0
51160,8090,0,0,60,60,0,1,0,1,0
51298,57470,0,0,66,66,0,1,0,1,0
44854,26467,0,0,62,62,0,1,0,1,0
51559,26467,0,0,66,66,0,1,0,1,0
35058,23,0,0,60,60,0,1,0,1,0
25304,64147,0,0,146,146,0,1,0,1,0
56629,25174,0,0,66,66,0,1,0,1,0
56397,26467,0,0,66,66,0,1,0,1,0
443,50238,0,0,60,60,0,1,0,1,0
52714,64147,0,0,66,66,0,1,0,1,0
61461,50584,0,0,66,66,0,1,0,1,0
58829,64147,0,0,66,66,0,1,0,1,0
62152,56205,0,0,66,66,0,1,0,1,0
18754,30188,0,0,62,62,0,1,0,1,0
13441,57470,0,0,62,62,0,1,0,1,0
25090,9192,0,0,145,145,0,1,0,1,0
8313,51505,0,0,66,66,0,1,0,1,0
53044,36237,0,0,66,66,0,1,0,1,0
57500,37965,0,0,62,62,0,1,0,1,0
0,0,0,0,98,98,0,1,0,1,0
38484,48637,0,0,60,60,0,1,0,1,0
22528,25174,0,0,62,62,0,1,0,1,0
34914,26467,0,0,62,62,0,1,0,1,0
42252,33303,0,0,60,60,0,1,0,1,0
30015,36237,0,0,66,66,0,1,0,1,0
56376,44847,0,0,66,66,0,1,0,1,0
58638,5900,0,0,62,62,0,1,0,1,0
4041,50584,0,0,62,62,0,1,0,1,0
13285,29892,0,0,145,145,0,1,0,1,0
63083,25174,0,0,66,66,0,1,0,1,0
46509,36237,0,0,66,66,0,1,0,1,0
22409,55442,0,0,74,74,0,1,0,1,0
6881,6881,0,0,146,146,0,1,0,1,0
19455,25174,0,0,146,146,0,1,0,1,0
22408,22114,0,0,66,66,0,1,0,1,0
43584,24748,0,0,156,156,0,1,0,1,0
1377,44847,0,0,62,62,0,1,0,1,0
53669,23,0,0,60,60,0,1,0,1,0
14740,26467,0,0,62,62,0,1,0,1,0
59153,35440,0,0,66,66,0,1,0,1,0
58638,5900,0,0,62,62,0,1,0,1,0
60960,49049,0,0,62,62,0,1,0,1,0
61520,23718,0,0,62,62,0,1,0,1,0
65512,44847,0,0,62,62,0,1,0,1,0
47063,15503,0,0,146,146,0,1,0,1,0
56582,37965,0,0,62,62,0,1,0,1,0
58305,18375,0,0,62,62,0,1,0,1,0
56474,18375,0,0,62,62,0,1,0,1,0
33651,36237,0,0,62,62,0,1,0,1,0
51146,23117,0,0,66,66,0,1,0,1,0
51756,64147,0,0,66,66,0,1,0,1,0
52836,36829,0,0,66,66,0,1,0,1,0
59097,2767,0,0,66,66,0,1,0,1,0
36237,23,0,0,60,60,0,1,0,1,0
51310,64147,0,0,66,66,0,1,0,1,0
57772,50584,0,0,66,66,0,1,0,1,0
16570,25174,0,0,62,62,0,1,0,1,0
4752,30188,0,0,62,62,0,1,0,1,0
27368,22114,0,0,146,146,0,1,0,1,0
57669,64147,0,0,66,66,0,1,0,1,0
5774,37965,0,0,66,66,0,1,0,1,0
13021,25174,0,0,62,62,0,1,0,1,0
58638,5900,0,0,62,62,0,1,0,1,0
54471,36237,0,0,66,66,0,1,0,1,0
55666,35440,0,0,66,66,0,1,0,1,0
58638,5900,0,0,62,62,0,1,0,1,0
49485,56972,0,0,62,62,0,1,0,1,0
1024,25174,0,0,62,62,0,1,0,1,0
58638,5900,0,0,62,62,0,1,0,1,0
52231,50934,0,0,62,62,0,1,0,1,0
26048,21,0,0,60,60,0,1,0,1,0
10669,49756,0,0,60,60,0,1,0,1,0
45964,2666,0,0,60,60,0,1,0,1,0
37834,30349,0,0,145,145,0,1,0,1,0
1334,8497,0,0,148,148,0,1,0,1,0
47803,64147,0,0,145,145,0,1,0,1,0
3478,61463,0,0,1012,1012,0,1,0,1,0
58799,30188,0,0,66,66,0,1,0,1,0
0,0,0,0,98,98,0,1,0,1,0
58638,5900,0,0,62,62,0,1,0,1,0
61336,61689,0,0,62,62,0,1,0,1,0
39313,37965,0,0,62,62,0,1,0,1,0
36034,35440,0,0,146,146,0,1,0,1,0
58638,5900,0,0,62,62,0,1,0,1,0
1024,44847,0,0,146,146,0,1,0,1,0
8108,47807,0,0,157,157,0,1,0,1,0
50506,10214,0,0,66,66,0,1,0,1,0
1030,44847,0,0,62,62,0,1,0,1,0
6666,5000,0,0,60,60,0,1,0,1,0
47788,12250,0,0,146,146,0,1,0,1,0
59031,25174,0,0,62,62,0,1,0,1,0
42951,22114,0,0,66,66,0,1,0,1,0
42252,33303,0,0,60,60,0,1,0,1,0
8080,37965,0,0,62,62,0,1,0,1,0
43260,41615,0,0,145,145,0,1,0,1,0
33324,42873,0,0,62,62,0,1,0,1,0
59523,37965,0,0,62,62,0,1,0,1,0
20108,64147,0,0,66,66,0,1,0,1,0
56289,25174,0,0,66,66,0,1,0,1,0
51756,64147,0,0,62,62,0,1,0,1,0
12694,22114,0,0,66,66,0,1,0,1,0
61583,64147,0,0,66,66,0,1,0,1,0
27677,22114,0,0,62,62,0,1,0,1,0
27402,37628,0,0,62,62,0,1,0,1,0
16387,3655,0,0,60,60,0,1,0,1,0
18950,50584,0,0,62,62,0,1,0,1,0
9743,23,0,0,60,60,0,1,0,1,0
22924,25174,0,0,62,62,0,1,0,1,0
6703,21247,0,0,62,62,0,1,0,1,0
10669,49756,0,0,60,60,0,1,0,1,0
29016,25174,0,0,62,62,0,1,0,1,0
3478,61463,0,0,164,164,0,1,0,1,0
38653,21247,0,0,62,62,0,1,0,1,0
1045,36237,0,0,62,62,0,1,0,1,0
3478,61463,0,0,68,68,0,1,0,1,0
53469,44847,0,0,66,66,0,1,0,1,0
45908,3383,0,0,60,60,0,1,0,1,0
48301,25174,0,0,66,66,0,1,0,1,0
58638,5900,0,0,62,62,0,1,0,1,0
3375,35253,0,0,66,66,0,1,0,1,0
17579,57470,0,0,62,62,0,1,0,1,0
58638,5900,0,0,62,62,0,1,0,1,0
64808,62413,0,0,66,66,0,1,0,1,0
9544,11392,0,0,62,62,0,1,0,1,0
37234,44847,0,0,62,62,0,1,0,1,0
54167,50584,0,0,66,66,0,1,0,1,0
63050,57470,0,0,74,74,0,1,0,1,0
7968,2767,0,0,66,66,0,1,0,1,0
19570,50584,0,0,66,66,0,1,0,1,0
45908,3383,0,0,60,60,0,1,0,1,0
10639,11392,0,0,62,62,0,1,0,1,0
2919,37965,0,0,62,62,0,1,0,1,0
49001,22114,0,0,62,62,0,1,0,1,0
56432,35253,0,0,66,66,0,1,0,1,0
35666,22114,0,0,62,62,0,1,0,1,0
14717,64147,0,0,66,66,0,1,0,1,0
30246,51050,0,0,146,146,0,1,0,1,0
13285,29892,0,0,145,145,0,1,0,1,0
55012,64147,0,0,66,66,0,1,0,1,0
20057,44847,0,0,62,62,0,1,0,1,0
50624,26467,0,0,66,66,0,1,0,1,0
11574,51505,0,0,66,66,0,1,0,1,0
59497,64097,0,0,66,66,0,1,0,1,0
38281,37807,0,0,62,62,0,1,0,1,0
22530,23718,0,0,62,62,0,1,0,1,0
52227,64147,0,0,62,62,0,1,0,1,0
60196,53,0,0,88,88,0,1,0,1,0
59147,25174,0,0,62,62,0,1,0,1,0
6832,51505,0,0,66,66,0,1,0,1,0
55893,45711,0,0,78,78,0,1,0,1,0
54021,25174,0,0,62,62,0,1,0,1,0
3478,61463,0,0,1097,1097,0,1,0,1,0
443,45788,0,0,199,199,0,1,0,1,0
34311,5900,0,0,60,60,0,1,0,1,0
30598,46824,0,0,62,62,0,1,0,1,0
55711,26467,0,0,66,66,0,1,0,1,0
58638,5900,0,0,62,62,0,1,0,1,0
27055,25174,0,0,146,146,0,1,0,1,0
56621,50584,0,0,62,62,0,1,0,1,0
23218,62413,0,0,66,66,0,1,0,1,0
4529,56205,0,0,62,62,0,1,0,1,0
13408,44847,0,0,66,66,0,1,0,1,0
443,39878,0,0,74,74,0,1,0,1,0
58627,25174,0,0,62,62,0,1,0,1,0
55206,22114,0,0,66,66,0,1,0,1,0
53406,44847,0,0,66,66,0,1,0,1,0
3911,50584,0,0,62,62,0,1,0,1,0
443,14315,0,0,158,158,0,1,0,1,0
32424,50584,0,0,146,146,0,1,0,1,0
2083,25174,0,0,62,62,0,1,0,1,0
49168,57470,0,0,66,66,0,1,0,1,0
9588,37965,0,0,66,66,0,1,0,1,0
59668,50584,0,0,62,62,0,1,0,1,0
58598,50584,0,0,62,62,0,1,0,1,0
54876,25174,0,0,62,62,0,1,0,1,0
44079,10387,0,0,145,145,0,1,0,1,0
41037,55839,0,0,157,157,0,1,0,1,0
1865,25174,0,0,62,62,0,1,0,1,0
5222,32859,0,0,66,66,0,1,0,1,0
443,21717,0,0,97,97,0,1,0,1,0
53314,64097,0,0,66,66,0,1,0,1,0
64155,60043,0,0,66,66,0,1,0,1,0
47888,2310,0,0,145,145,0,1,0,1,0
1818,22114,0,0,62,62,0,1,0,1,0
19747,37965,0,0,62,62,0,1,0,1,0
60403,22114,0,0,66,66,0,1,0,1,0
57441,57470,0,0,66,66,0,1,0,1,0
6853,48543,0,0,148,148,0,1,0,1,0
65515,22114,0,0,66,66,0,1,0,1,0
63010,57470,0,0,145,145,0,1,0,1,0
50106,30317,0,0,62,62,0,1,0,1,0
10447,30317,0,0,146,146,0,1,0,1,0
52050,11392,0,0,62,62,0,1,0,1,0
62189,64147,0,0,62,62,0,1,0,1,0
19004,51505,0,0,62,62,0,1,0,1,0
62813,25174,0,0,62,62,0,1,0,1,0
54047,50011,0,0,66,66,0,1,0,1,0
12184,56205,0,0,146,146,0,1,0,1,0
49754,35440,0,0,62,62,0,1,0,1,0
24041,55783,0,0,62,62,0,1,0,1,0
50280,38558,0,0,62,62,0,1,0,1,0
30307,51505,0,0,62,62,0,1,0,1,0
50806,51505,0,0,66,66,0,1,0,1,0
45964,3111,0,0,60,60,0,1,0,1,0
44459,37807,0,0,62,62,0,1,0,1,0
58638,5900,0,0,62,62,0,1,0,1,0
56578,25174,0,0,66,66,0,1,0,1,0
32511,23,0,0,60,60,0,1,0,1,0
42044,60043,0,0,66,66,0,1,0,1,0
45908,33330,0,0,60,60,0,1,0,1,0
59060,50584,0,0,66,66,0,1,0,1,0
61278,56205,0,0,66,66,0,1,0,1,0
25543,22114,0,0,62,62,0,1,0,1,0
49994,26467,0,0,66,66,0,1,0,1,0
52018,22114,0,0,146,146,0,1,0,1,0
6712,123,0,0,90,90,0,1,0,1,0
63741,50584,0,0,66,66,0,1,0,1,0
27401,37965,0,0,66,66,0,1,0,1,0
47013,44512,0,0,62,62,0,1,0,1,0
49699,64147,0,0,66,66,0,1,0,1,0
53490,62413,0,0,62,62,0,1,0,1,0
51742,30317,0,0,66,66,0,1,0,1,0
63988,22114,0,0,66,66,0,1,0,1,0
27677,22114,0,0,62,62,0,1,0,1,0
12632,25174,0,0,62,62,0,1,0,1,0
53844,22114,0,0,62,62,0,1,0,1,0
52887,37807,0,0,66,66,0,1,0,1,0
64106,64147,0,0,66,66,0,1,0,1,0
58681,36829,0,0,74,74,0,1,0,1,0
26729,57470,0,0,66,66,0,1,0,1,0
33651,36237,0,0,62,62,0,1,0,1,0
61566,44847,0,0,66,66,0,1,0,1,0
61382,25174,0,0,62,62,0,1,0,1,0
32746,50584,0,0,146,146,0,1,0,1,0
443,35385,0,0,130,130,0,1,0,1,0
40216,50265,0,0,62,62,0,1,0,1,0
51414,22,0,0,60,60,0,1,0,1,0
21674,28189,0,0,60,60,0,1,0,1,0
8211,28793,0,0,62,62,0,1,0,1,0
45964,3111,0,0,60,60,0,1,0,1,0
3478,61463,0,0,68,68,0,1,0,1,0
31066,57470,0,0,74,74,0,1,0,1,0
58638,5900,0,0,62,62,0,1,0,1,0
59724,64147,0,0,66,66,0,1,0,1,0
28754,50584,0,0,66,66,0,1,0,1,0
3478,61463,0,0,1292,1292,0,1,0,1,0
44208,26467,0,0,62,62,0,1,0,1,0
22220,25174,0,0,62,62,0,1,0,1,0
65515,22114,0,0,62,62,0,1,0,1,0
5213,44847,0,0,66,66,0,1,0,1,0
36906,50584,0,0,146,146,0,1,0,1,0
51996,35440,0,0,66,66,0,1,0,1,0
33287,57354,0,0,145,145,0,1,0,1,0
13917,18033,0,0,62,62,0,1,0,1,0
60861,25174,0,0,66,66,0,1,0,1,0
56397,26467,0,0,62,62,0,1,0,1,0
25101,50584,0,0,146,146,0,1,0,1,0
45964,5333,0,0,60,60,0,1,0,1,0
43345,51505,0,0,146,146,0,1,0,1,0
16376,35440,0,0,62,62,0,1,0,1,0
29972,50584,0,0,62,62,0,1,0,1,0
19394,44847,0,0,62,62,0,1,0,1,0
53960,30041,0,0,62,62,0,1,0,1,0
80,57411,0,0,1514,1514,0,1,0,1,0
51746,25174,0,0,62,62,0,1,0,1,0
59845,15503,0,0,66,66,0,1,0,1,0
65115,50584,0,0,62,62,0,1,0,1,0
60793,53733,0,0,66,66,0,1,0,1,0
56753,44847,0,0,62,62,0,1,0,1,0
55616,56205,0,0,62,62,0,1,0,1,0
59889,30188,0,0,66,66,0,1,0,1,0
54028,37965,0,0,62,62,0,1,0,1,0
60941,25174,0,0,62,62,0,1,0,1,0
58076,21247,0,0,66,66,0,1,0,1,0
41298,51050,0,0,62,62,0,1,0,1,0
1128,44847,0,0,62,62,0,1,0,1,0
58638,5900,0,0,62,62,0,1,0,1,0
5223,14446,0,0,220,220,0,1,0,1,0
16387,16862,0,0,60,60,0,1,0,1,0
14059,21247,0,0,146,146,0,1,0,1,0
51146,23117,0,0,66,66,0,1,0,1,0
11450,57470,0,0,62,62,0,1,0,1,0
51479,25174,0,0,66,66,0,1,0,1,0
54343,50584,0,0,62,62,0,1,0,1,0
46856,25174,0,0,62,62,0,1,0,1,0
52711,37965,0,0,62,62,0,1,0,1,0
55966,35440,0,0,66,66,0,1,0,1,0
49203,51050,0,0,62,62,0,1,0,1,0
50439,64147,0,0,62,62,0,1,0,1,0
12608,21247,0,0,66,66,0,1,0,1,0
18061,25174,0,0,62,62,0,1,0,1,0
4772,37965,0,0,66,66,0,1,0,1,0
56101,57470,0,0,66,66,0,1,0,1,0
54280,3398,0,0,60,60,0,1,0,1,0
64723,56205,0,0,62,62,0,1,0,1,0
59966,37965,0,0,66,66,0,1,0,1,0
50644,35440,0,0,66,66,0,1,0,1,0
57557,64147,0,0,66,66,0,1,0,1,0
2464,50584,0,0,62,62,0,1,0,1,0
51148,9571,0,0,66,66,0,1,0,1,0
38980,17,0,0,60,60,0,1,0,1,0
50624,26467,0,0,66,66,0,1,0,1,0
64406,25174,0,0,66,66,0,1,0,1,0
63944,30188,0,0,62,62,0,1,0,1,0
10348,25604,0,0,66,66,0,1,0,1,0
54210,36237,0,0,62,62,0,1,0,1,0
39681,37965,0,0,66,66,0,1,0,1,0
38320,51505,0,0,66,66,0,1,0,1,0
45099,57470,0,0,62,62,0,1,0,1,0
47020,2323,0,0,60,60,0,1,0,1,0
48840,50584,0,0,146,146,0,1,0,1,0
16387,26193,0,0,60,60,0,1,0,1,0
59008,51221,0,0,66,66,0,1,0,1,0
58638,5900,0,0,62,62,0,1,0,1,0
51244,3855,0,0,100,100,0,1,0,1,0
44411,37965,0,0,62,62,0,1,0,1,0
64595,64147,0,0,66,66,0,1,0,1,0
1790,48817,0,0,66,66,0,1,0,1,0
45218,25174,0,0,146,146,0,1,0,1,0
28580,64147,0,0,62,62,0,1,0,1,0
12969,55777,0,0,66,66,0,1,0,1,0
22583,9822,0,0,62,62,0,1,0,1,0
3406,17372,0,0,66,66,0,1,0,1,0
54854,19847,0,0,62,62,0,1,0,1,0
45472,8168,0,0,62,62,0,1,0,1,0
42075,36237,0,0,62,62,0,1,0,1,0
14924,44847,0,0,66,66,0,1,0,1,0
34211,23,0,0,60,60,0,1,0,1,0
57441,57470,0,0,66,66,0,1,0,1,0
43704,465,0,0,60,60,0,1,0,1,0
26752,64147,0,0,62,62,0,1,0,1,0
47727,25174,0,0,62,62,0,1,0,1,0
50113,51505,0,0,66,66,0,1,0,1,0
39730,17372,0,0,66,66,0,1,0,1,0
60350,51505,0,0,66,66,0,1,0,1,0
56783,43890,0,0,66,66,0,1,0,1,0
27348,22114,0,0,66,66,0,1,0,1,0
52711,37965,0,0,62,62,0,1,0,1,0
10306,44847,0,0,66,66,0,1,0,1,0
63765,51221,0,0,62,62,0,1,0,1,0
41346,30188,0,0,62,62,0,1,0,1,0
53721,62413,0,0,62,62,0,1,0,1,0
18889,50584,0,0,146,146,0,1,0,1,0
44383,30188,0,0,66,66,0,1,0,1,0
17481,64097,0,0,146,146,0,1,0,1,0
23353,25174,0,0,62,62,0,1,0,1,0
51109,11392,0,0,66,66,0,1,0,1,0
30270,37965,0,0,62,62,0,1,0,1,0
24606,55783,0,0,72,72,0,1,0,1,0
46491,50584,0,0,66,66,0,1,0,1,0
38781,51505,0,0,62,62,0,1,0,1,0
80,53945,0,0,60,60,0,1,0,1,0
31021,35440,0,0,62,62,0,1,0,1,0
19634,64147,0,0,62,62,0,1,0,1,0
50675,56205,0,0,66,66,0,1,0,1,0
63460,55160,0,0,66,66,0,1,0,1,0
13462,35440,0,0,66,66,0,1,0,1,0
58638,5900,0,0,62,62,0,1,0,1,0
57114,35440,0,0,62,62,0,1,0,1,0
58638,5900,0,0,62,62,0,1,0,1,0
60312,57470,0,0,74,74,0,1,0,1,0
28345,11392,0,0,62,62,0,1,0,1,0
2310,8305,0,0,145,145,0,1,0,1,0
61916,64097,0,0,66,66,0,1,0,1,0
50470,61463,0,0,86,86,0,1,0,1,0
54666,36237,0,0,62,62,0,1,0,1,0
58686,18375,0,0,66,66,0,1,0,1,0
443,49988,0,0,82,82,0,1,0,1,0
23126,35440,0,0,62,62,0,1,0,1,0
50298,37965,0,0,66,66,0,1,0,1,0
5787,44847,0,0,66,66,0,1,0,1,0
26802,50584,0,0,62,62,0,1,0,1,0
22125,23,0,0,60,60,0,1,0,1,0
443,9986,0,0,669,669,0,1,0,1,0
58255,50584,0,0,62,62,0,1,0,1,0
56381,25174,0,0,62,62,0,1,0,1,0
57131,35776,0,0,145,145,0,1,0,1,0
1054,15503,0,0,62,62,0,1,0,1,0
53020,61903,0,0,159,159,0,1,0,1,0
29177,44847,0,0,66,66,0,1,0,1,0
14036,48817,0,0,66,66,0,1,0,1,0
52321,26467,0,0,62,62,0,1,0,1,0
1035,57470,0,0,72,72,0,1,0,1,0
11878,37807,0,0,62,62,0,1,0,1,0
62068,64147,0,0,66,66,0,1,0,1,0
38664,37965,0,0,145,145,0,1,0,1,0
30456,36237,0,0,146,146,0,1,0,1,0
64066,23718,0,0,62,62,0,1,0,1,0
61002,37965,0,0,145,145,0,1,0,1,0
1487,35440,0,0,146,146,0,1,0,1,0
12604,80,0,0,60,60,0,1,0,1,0
20576,37965,0,0,62,62,0,1,0,1,0
45013,50584,0,0,146,146,0,1,0,1,0
33912,25174,0,0,62,62,0,1,0,1,0
3478,61463,0,0,1302,1302,0,1,0,1,0
52887,37807,0,0,62,62,0,1,0,1,0
58399,56205,0,0,62,62,0,1,0,1,0
52596,17372,0,0,66,66,0,1,0,1,0
13413,44847,0,0,66,66,0,1,0,1,0
59493,44847,0,0,66,66,0,1,0,1,0
52633,30188,0,0,62,62,0,1,0,1,0
50396,62413,0,0,66,66,0,1,0,1,0
56103,21247,0,0,66,66,0,1,0,1,0
64595,64147,0,0,66,66,0,1,0,1,0
55921,43890,0,0,66,66,0,1,0,1,0
32679,37965,0,0,62,62,0,1,0,1,0
53721,62413,0,0,62,62,0,1,0,1,0
16697,64147,0,0,145,145,0,1,0,1,0
25523,35974,0,0,62,62,0,1,0,1,0
47913,25174,0,0,146,146,0,1,0,1,0
49160,57470,0,0,146,146,0,1,0,1,0
46557,57866,0,0,66,66,0,1,0,1,0
29742,50584,0,0,62,62,0,1,0,1,0
4427,50584,0,0,62,62,0,1,0,1,0
52975,23718,0,0,66,66,0,1,0,1,0
46774,51050,0,0,62,62,0,1,0,1,0
63461,51505,0,0,66,66,0,1,0,1,0
8592,35993,0,0,66,66,0,1,0,1,0
4772,37965,0,0,66,66,0,1,0,1,0
16387,23177,0,0,60,60,0,1,0,1,0
43104,26467,0,0,62,62,0,1,0,1,0
19068,37965,0,0,62,62,0,1,0,1,0
56967,35440,0,0,66,66,0,1,0,1,0
3068,36237,0,0,62,62,0,1,0,1,0
58638,5900,0,0,62,62,0,1,0,1,0
60674,8055,0,0,145,145,0,1,0,1,0
65231,50584,0,0,66,66,0,1,0,1,0
80,56289,0,0,578,578,0,1,0,1,0
1733,65448,0,0,62,62,0,1,0,1,0
12694,12446,0,0,62,62,0,1,0,1,0
12545,25174,0,0,62,62,0,1,0,1,0
60384,64147,0,0,62,62,0,1,0,1,0
52280,44847,0,0,66,66,0,1,0,1,0
64214,25174,0,0,66,66,0,1,0,1,0
54539,26467,0,0,62,62,0,1,0,1,0
58638,5900,0,0,62,62,0,1,0,1,0
53469,44847,0,0,66,66,0,1,0,1,0
61670,57470,0,0,74,74,0,1,0,1,0
10480,26467,0,0,62,62,0,1,0,1,0
58550,21247,0,0,66,66,0,1,0,1,0
63988,22114,0,0,66,66,0,1,0,1,0
64882,43890,0,0,66,66,0,1,0,1,0
61242,35253,0,0,66,66,0,1,0,1,0
6929,35440,0,0,62,62,0,1,0,1,0
60117,50934,0,0,66,66,0,1,0,1,0
6036,51505,0,0,66,66,0,1,0,1,0
51320,44847,0,0,66,66,0,1,0,1,0
51151,64147,0,0,66,66,0,1,0,1,0
49426,57470,0,0,66,66,0,1,0,1,0
58475,11392,0,0,66,66,0,1,0,1,0
1024,41055,0,0,157,157,0,1,0,1,0
50052,65008,0,0,60,60,0,1,0,1,0
60557,23117,0,0,62,62,0,1,0,1,0
37420,44847,0,0,66,66,0,1,0,1,0
45912,44847,0,0,146,146,0,1,0,1,0
18116,37807,0,0,62,62,0,1,0,1,0
65270,3855,0,0,78,78,0,1,0,1,0
50788,48817,0,0,66,66,0,1,0,1,0
14692,25174,0,0,62,62,0,1,0,1,0
14923,51505,0,0,62,62,0,1,0,1,0
16387,22272,0,0,60,60,0,1,0,1,0
32704,25174,0,0,62,62,0,1,0,1,0
60192,35440,0,0,66,66,0,1,0,1,0
26085,51221,0,0,72,72,0,1,0,1,0
3597,11392,0,0,66,66,0,1,0,1,0
54280,3398,0,0,60,60,0,1,0,1,0
15875,50584,0,0,62,62,0,1,0,1,0
58638,5900,0,0,62,62,0,1,0,1,0
47910,7461,0,0,60,60,0,1,0,1,0
46537,25174,0,0,62,62,0,1,0,1,0
14656,36237,0,0,66,66,0,1,0,1,0
58638,5900,0,0,62,62,0,1,0,1,0
46679,64147,0,0,62,62,0,1,0,1,0
3549,64147,0,0,62,62,0,1,0,1,0
36369,51505,0,0,66,66,0,1,0,1,0
35657,48637,0,0,62,62,0,1,0,1,0
44856,51505,0,0,62,62,0,1,0,1,0
53156,35993,0,0,66,66,0,1,0,1,0
50375,50584,0,0,62,62,0,1,0,1,0
58825,44847,0,0,146,146,0,1,0,1,0
50283,49169,0,0,66,66,0,1,0,1,0
43828,44847,0,0,62,62,0,1,0,1,0
56713,25174,0,0,62,62,0,1,0,1,0
50095,30188,0,0,66,66,0,1,0,1,0
22835,51221,0,0,62,62,0,1,0,1,0
58638,5900,0,0,62,62,0,1,0,1,0
18574,56205,0,0,66,66,0,1,0,1,0
51944,56205,0,0,62,62,0,1,0,1,0
2990,64147,0,0,62,62,0,1,0,1,0
51414,22,0,0,60,60,0,1,0,1,0
57034,44847,0,0,66,66,0,1,0,1,0
57578,51221,0,0,66,66,0,1,0,1,0
443,38956,0,0,82,82,0,1,0,1,0
60351,50584,0,0,62,62,0,1,0,1,0
57131,31061,0,0,145,145,0,1,0,1,0
43815,50584,0,0,62,62,0,1,0,1,0
51130,61689,0,0,66,66,0,1,0,1,0
42973,57470,0,0,62,62,0,1,0,1,0
51320,37965,0,0,62,62,0,1,0,1,0
21179,44847,0,0,62,62,0,1,0,1,0
54280,3359,0,0,60,60,0,1,0,1,0
11574,51505,0,0,62,62,0,1,0,1,0
22784,9571,0,0,62,62,0,1,0,1,0
62654,35440,0,0,62,62,0,1,0,1,0
58638,5900,0,0,62,62,0,1,0,1,0
49485,56972,0,0,66,66,0,1,0,1,0
58638,5900,0,0,62,62,0,1,0,1,0
6881,6881,0,0,62,62,0,1,0,1,0
443,62451,0,0,199,199,0,1,0,1,0
64824,36829,0,0,66,66,0,1,0,1,0
27844,52700,0,0,74,74,0,1,0,1,0
61078,57470,0,0,62,62,0,1,0,1,0
62796,37807,0,0,66,66,0,1,0,1,0
57669,64147,0,0,62,62,0,1,0,1,0
26180,35440,0,0,62,62,0,1,0,1,0
21759,51505,0,0,62,62,0,1,0,1,0
1594,44847,0,0,62,62,0,1,0,1,0
42463,56205,0,0,146,146,0,1,0,1,0
58751,51221,0,0,62,62,0,1,0,1,0
62386,37965,0,0,62,62,0,1,0,1,0
26408,64147,0,0,66,66,0,1,0,1,0
443,50238,0,0,331,331,0,1,0,1,0
1480,12447,0,0,66,66,0,1,0,1,0
26953,30317,0,0,62,62,0,1,0,1,0
58638,5900,0,0,62,62,0,1,0,1,0
63786,35440,0,0,66,66,0,1,0,1,0
5790,43890,0,0,62,62,0,1,0,1,0
21420,44847,0,0,66,66,0,1,0,1,0
43580,57470,0,0,145,145,0,1,0,1,0
22240,22114,0,0,62,62,0,1,0,1,0
12226,37965,0,0,62,62,0,1,0,1,0
50079,23,0,0,60,60,0,1,0,1,0
20389,64147,0,0,66,66,0,1,0,1,0
4910,2149,0,0,66,66,0,1,0,1,0
42995,26467,0,0,62,62,0,1,0,1,0
36229,62413,0,0,146,146,0,1,0,1,0
51300,64147,0,0,66,66,0,1,0,1,0
3803,51505,0,0,66,66,0,1,0,1,0
63593,22114,0,0,66,66,0,1,0,1,0
28345,11392,0,0,66,66,0,1,0,1,0
30765,56205,0,0,66,66,0,1,0,1,0
26287,56205,0,0,66,66,0,1,0,1,0
56218,43890,0,0,66,66,0,1,0,1,0
64989,50265,0,0,66,66,0,1,0,1,0
60129,55442,0,0,62,62,0,1,0,1,0
49514,52255,0,0,162,162,0,1,0,1,0
51993,25174,0,0,62,62,0,1,0,1,0
41249,50584,0,0,62,62,0,1,0,1,0
30496,57470,0,0,62,62,0,1,0,1,0
24260,50584,0,0,62,62,0,1,0,1,0
50806,51505,0,0,66,66,0,1,0,1,0
58638,5900,0,0,62,62,0,1,0,1,0
25010,30188,0,0,62,62,0,1,0,1,0
1025,50584,0,0,62,62,0,1,0,1,0
23379,57866,0,0,62,62,0,1,0,1,0
25469,57470,0,0,62,62,0,1,0,1,0
80,37649,0,0,60,60,0,1,0,1,0
30280,37965,0,0,66,66,0,1,0,1,0
30583,25174,0,0,66,66,0,1,0,1,0
34262,23,0,0,60,60,0,1,0,1,0
0,0,0,0,185,185,0,1,0,1,0
30574,64147,0,0,62,62,0,1,0,1,0
15605,50265,0,0,62,62,0,1,0,1,0
50651,25174,0,0,146,146,0,1,0,1,0
58638,5900,0,0,62,62,0,1,0,1,0
9518,30228,0,0,100,100,0,1,0,1,0
58396,22114,0,0,66,66,0,1,0,1,0
44855,58414,0,0,62,62,0,1,0,1,0
30559,64147,0,0,62,62,0,1,0,1,0
53022,25174,0,0,66,66,0,1,0,1,0
12226,37965,0,0,62,62,0,1,0,1,0
45941,23386,0,0,60,60,0,1,0,1,0
63456,37965,0,0,62,62,0,1,0,1,0
58382,50584,0,0,62,62,0,1,0,1,0
53211,22114,0,0,66,66,0,1,0,1,0
10380,5223,0,0,148,148,0,1,0,1,0
44538,50584,0,0,146,146,0,1,0,1,0
62744,62413,0,0,66,66,0,1,0,1,0
64077,25174,0,0,66,66,0,1,0,1,0
52726,56205,0,0,66,66,0,1,0,1,0
11648,37965,0,0,145,145,0,1,0,1,0
42463,56205,0,0,62,62,0,1,0,1,0
63136,25174,0,0,62,62,0,1,0,1,0
58424,52700,0,0,66,66,0,1,0,1,0
55920,25174,0,0,62,62,0,1,0,1,0
25961,55783,0,0,62,62,0,1,0,1,0
10192,25174,0,0,66,66,0,1,0,1,0
60786,51505,0,0,62,62,0,1,0,1,0
57131,31061,0,0,145,145,0,1,0,1,0
56826,22114,0,0,66,66,0,1,0,1,0
5610,37965,0,0,66,66,0,1,0,1,0
6712,5632,0,0,60,60,0,1,0,1,0
63385,25174,0,0,66,66,0,1,0,1,0
3580,25174,0,0,62,62,0,1,0,1,0
1880,57470,0,0,146,146,0,1,0,1,0
58638,5900,0,0,62,62,0,1,0,1,0
57991,22114,0,0,66,66,0,1,0,1,0
3976,25174,0,0,62,62,0,1,0,1,0
55704,64097,0,0,66,66,0,1,0,1,0
30948,50584,0,0,146,146,0,1,0,1,0
22783,64147,0,0,66,66,0,1,0,1,0
67,68,0,0,346,346,0,1,0,1,0
10688,25174,0,0,62,62,0,1,0,1,0
14997,57470,0,0,72,72,0,1,0,1,0
55488,57470,0,0,145,145,0,1,0,1,0
8536,37965,0,0,62,62,0,1,0,1,0
3074,64147,0,0,62,62,0,1,0,1,0
46837,57470,0,0,62,62,0,1,0,1,0
16387,64075,0,0,60,60,0,1,0,1,0
51996,57470,0,0,66,66,0,1,0,1,0
12969,55777,0,0,66,66,0,1,0,1,0
18725,35440,0,0,62,62,0,1,0,1,0
51829,36134,0,0,66,66,0,1,0,1,0
51993,25174,0,0,66,66,0,1,0,1,0
2464,50584,0,0,66,66,0,1,0,1,0
8313,51505,0,0,62,62,0,1,0,1,0
24311,22617,0,0,60,60,0,1,0,1,0
37042,48983,0,0,159,159,0,1,0,1,0
14023,37965,0,0,62,62,0,1,0,1,0
443,48056,0,0,135,135,0,1,0,1,0
15933,64147,0,0,62,62,0,1,0,1,0
57612,28793,0,0,66,66,0,1,0,1,0
49651,37965,0,0,74,74,0,1,0,1,0
1101,11119,0,0,146,146,0,1,0,1,0
3937,36829,0,0,62,62,0,1,0,1,0
63173,36237,0,0,66,66,0,1,0,1,0
49305,57470,0,0,66,66,0,1,0,1,0
10333,22114,0,0,62,62,0,1,0,1,0
12260,51505,0,0,62,62,0,1,0,1,0
46619,57470,0,0,62,62,0,1,0,1,0
54440,26467,0,0,62,62,0,1,0,1,0
15235,36237,0,0,62,62,0,1,0,1,0
58638,5900,0,0,62,62,0,1,0,1,0
57174,57470,0,0,66,66,0,1,0,1,0
63331,51221,0,0,62,62,0,1,0,1,0
52668,51221,0,0,66,66,0,1,0,1,0
1972,57470,0,0,78,78,0,1,0,1,0
3064,44847,0,0,62,62,0,1,0,1,0
63772,35440,0,0,66,66,0,1,0,1,0
58638,5900,0,0,62,62,0,1,0,1,0
20005,37965,0,0,62,62,0,1,0,1,0
57894,44847,0,0,66,66,0,1,0,1,0
61323,23117,0,0,146,146,0,1,0,1,0
42981,44847,0,0,62,62,0,1,0,1,0
63092,46776,0,0,78,78,0,1,0,1,0
36804,25174,0,0,66,66,0,1,0,1,0
25523,35974,0,0,62,62,0,1,0,1,0
1111,25174,0,0,62,62,0,1,0,1,0
51999,37965,0,0,62,62,0,1,0,1,0
15345,36829,0,0,66,66,0,1,0,1,0
9377,56205,0,0,66,66,0,1,0,1,0
54305,35440,0,0,62,62,0,1,0,1,0
59745,53635,0,0,66,66,0,1,0,1,0
61143,8080,0,0,60,60,0,1,0,1,0
18725,35440,0,0,146,146,0,1,0,1,0
58382,50584,0,0,62,62,0,1,0,1,0
27160,64147,0,0,66,66,0,1,0,1,0
56289,25174,0,0,66,66,0,1,0,1,0
54473,37807,0,0,66,66,0,1,0,1,0
2346,25174,0,0,66,66,0,1,0,1,0
42252,33303,0,0,60,60,0,1,0,1,0
52724,64147,0,0,62,62,0,1,0,1,0
28364,23,0,0,60,60,0,1,0,1,0
51244,30228,0,0,100,100,0,1,0,1,0
51096,63710,0,0,62,62,0,1,0,1,0
31066,57470,0,0,74,74,0,1,0,1,0
26439,37965,0,0,66,66,0,1,0,1,0
52537,37965,0,0,66,66,0,1,0,1,0
55620,30188,0,0,66,66,0,1,0,1,0
59424,50265,0,0,74,74,0,1,0,1,0
54423,21247,0,0,62,62,0,1,0,1,0
48706,23393,0,0,60,60,0,1,0,1,0
55459,50584,0,0,66,66,0,1,0,1,0
14692,25174,0,0,146,146,0,1,0,1,0
51544,34476,0,0,137,137,0,1,0,1,0
42252,33303,0,0,60,60,0,1,0,1,0
54742,37965,0,0,66,66,0,1,0,1,0
56386,50584,0,0,66,66,0,1,0,1,0
45952,22114,0,0,62,62,0,1,0,1,0
9756,26467,0,0,62,62,0,1,0,1,0
58264,44847,0,0,66,66,0,1,0,1,0
26921,57470,0,0,62,62,0,1,0,1,0
50563,37965,0,0,66,66,0,1,0,1,0
63832,25174,0,0,66,66,0,1,0,1,0
53466,25174,0,0,146,146,0,1,0,1,0
14165,51050,0,0,146,146,0,1,0,1,0
53465,57470,0,0,62,62,0,1,0,1,0
10192,25174,0,0,66,66,0,1,0,1,0
15955,48817,0,0,140,140,0,1,0,1,0
29045,41864,0,0,159,159,0,1,0,1,0
63765,51221,0,0,62,62,0,1,0,1,0
62396,51050,0,0,146,146,0,1,0,1,0
16454,25174,0,0,66,66,0,1,0,1,0
57538,30188,0,0,66,66,0,1,0,1,0
19698,502,0,0,60,60,0,1,0,1,0
6881,6881,0,0,62,62,0,1,0,1,0
25297,11530,0,0,145,145,0,1,0,1,0
3090,1,0,0,66,66,0,1,0,1,0
58638,5900,0,0,62,62,0,1,0,1,0
64877,37450,0,0,62,62,0,1,0,1,0
22530,23718,0,0,66,66,0,1,0,1,0
80,5101,0,0,78,78,0,1,0,1,0
57131,8055,0,0,145,145,0,1,0,1,0
46495,4607,0,0,60,60,0,1,0,1,0
5955,55160,0,0,74,74,0,1,0,1,0
51062,1433,0,0,60,60,0,1,0,1,0
56653,22114,0,0,66,66,0,1,0,1,0
21420,44847,0,0,66,66,0,1,0,1,0
51414,22,0,0,60,60,0,1,0,1,0
59048,57470,0,0,66,66,0,1,0,1,0
26425,22114,0,0,146,146,0,1,0,1,0
5841,22114,0,0,62,62,0,1,0,1,0
51353,46314,0,0,145,145,0,1,0,1,0
40116,23,0,0,60,60,0,1,0,1,0
58535,30317,0,0,62,62,0,1,0,1,0
26229,21247,0,0,66,66,0,1,0,1,0
443,9986,0,0,152,152,0,1,0,1,0
55674,5900,0,0,60,60,0,1,0,1,0
56127,37965,0,0,66,66,0,1,0,1,0
26699,35253,0,0,62,62,0,1,0,1,0
37749,15503,0,0,62,62,0,1,0,1,0
31785,25174,0,0,146,146,0,1,0,1,0
55111,39004,0,0,66,66,0,1,0,1,0
56413,51221,0,0,66,66,0,1,0,1,0
24351,57470,0,0,62,62,0,1,0,1,0
24144,57470,0,0,62,62,0,1,0,1,0
11136,19910,0,0,145,145,0,1,0,1,0
44710,25174,0,0,62,62,0,1,0,1,0
59037,51505,0,0,66,66,0,1,0,1,0
56494,50432,0,0,146,146,0,1,0,1,0
48676,53389,0,0,60,60,0,1,0,1,0
42252,33303,0,0,60,60,0,1,0,1,0
3047,50584,0,0,62,62,0,1,0,1,0
56562,44847,0,0,66,66,0,1,0,1,0
443,9313,0,0,74,74,0,1,0,1,0
57761,15503,0,0,66,66,0,1,0,1,0
45941,23386,0,0,60,60,0,1,0,1,0
35111,22114,0,0,66,66,0,1,0,1,0
22574,44847,0,0,62,62,0,1,0,1,0
58638,5900,0,0,62,62,0,1,0,1,0
8734,56205,0,0,66,66,0,1,0,1,0
57337,64147,0,0,66,66,0,1,0,1,0
39895,26467,0,0,62,62,0,1,0,1,0
47652,51505,0,0,62,62,0,1,0,1,0
3478,61463,0,0,315,315,0,1,0,1,0
12471,48817,0,0,62,62,0,1,0,1,0
25222,37965,0,0,62,62,0,1,0,1,0
54440,26467,0,0,66,66,0,1,0,1,0
20844,64147,0,0,66,66,0,1,0,1,0
58638,5900,0,0,62,62,0,1,0,1,0
57420,22114,0,0,62,62,0,1,0,1,0
49479,56205,0,0,62,62,0,1,0,1,0
58638,5900,0,0,62,62,0,1,0,1,0
4138,55777,0,0,66,66,0,1,0,1,0
30784,30975,0,0,159,159,0,1,0,1,0
48219,55442,0,0,66,66,0,1,0,1,0
57726,37965,0,0,62,62,0,1,0,1,0
18029,50584,0,0,66,66,0,1,0,1,0
31619,51221,0,0,62,62,0,1,0,1,0
60818,37965,0,0,66,66,0,1,0,1,0
64279,23718,0,0,62,62,0,1,0,1,0
63741,50584,0,0,62,62,0,1,0,1,0
28085,36237,0,0,66,66,0,1,0,1,0
56250,36237,0,0,66,66,0,1,0,1,0
16387,20045,0,0,60,60,0,1,0,1,0
48826,25174,0,0,66,66,0,1,0,1,0
57987,56125,0,0,90,90,0,1,0,1,0
36151,22,0,0,60,60,0,1,0,1,0
5228,3434,0,0,1093,1093,0,1,0,1,0
59505,53733,0,0,66,66,0,1,0,1,0
3212,22114,0,0,146,146,0,1,0,1,0
44674,25174,0,0,62,62,0,1,0,1,0
58638,5900,0,0,62,62,0,1,0,1,0
54542,25604,0,0,66,66,0,1,0,1,0
62780,35440,0,0,66,66,0,1,0,1,0
13643,22114,0,0,146,146,0,1,0,1,0
58638,5900,0,0,62,62,0,1,0,1,0
45941,23384,0,0,60,60,0,1,0,1,0
63910,44847,0,0,62,62,0,1,0,1,0
26835,47993,0,0,62,62,0,1,0,1,0
10390,26467,0,0,66,66,0,1,0,1,0
14082,50584,0,0,62,62,0,1,0,1,0
35011,37965,0,0,62,62,0,1,0,1,0
55862,62413,0,0,62,62,0,1,0,1,0
60272,26467,0,0,66,66,0,1,0,1,0
58638,5900,0,0,62,62,0,1,0,1,0
58638,5900,0,0,62,62,0,1,0,1,0
17579,57470,0,0,62,62,0,1,0,1,0
35111,22114,0,0,66,66,0,1,0,1,0
33822,57470,0,0,66,66,0,1,0,1,0
53759,42873,0,0,74,74,0,1,0,1,0
21145,11392,0,0,62,62,0,1,0,1,0
54373,26467,0,0,62,62,0,1,0,1,0
58638,5900,0,0,62,62,0,1,0,1,0
51413,25864,0,0,72,72,0,1,0,1,0
62792,53,0,0,88,88,0,1,0,1,0
51505,17372,0,0,66,66,0,1,0,1,0
50386,22114,0,0,62,62,0,1,0,1,0
52036,5900,0,0,60,60,0,1,0,1,0
5213,44847,0,0,62,62,0,1,0,1,0
1373,22114,0,0,62,62,0,1,0,1,0
60311,30627,0,0,66,66,0,1,0,1,0
64237,51505,0,0,62,62,0,1,0,1,0
28668,8696,0,0,60,60,0,1,0,1,0
24351,57470,0,0,62,62,0,1,0,1,0
59481,41182,0,0,66,66,0,1,0,1,0
40797,25174,0,0,62,62,0,1,0,1,0
27505,25174,0,0,62,62,0,1,0,1,0
52150,39109,0,0,66,66,0,1,0,1,0
55618,56205,0,0,66,66,0,1,0,1,0
51045,25174,0,0,66,66,0,1,0,1,0
50211,51050,0,0,66,66,0,1,0,1,0
37121,21247,0,0,66,66,0,1,0,1,0
4323,64147,0,0,66,66,0,1,0,1,0
19427,23,0,0,60,60,0,1,0,1,0
33416,23,0,0,60,60,0,1,0,1,0
1130,37965,0,0,145,145,0,1,0,1,0
39313,37965,0,0,62,62,0,1,0,1,0
60312,57470,0,0,74,74,0,1,0,1,0
31660,35440,0,0,66,66,0,1,0,1,0
1143,25174,0,0,62,62,0,1,0,1,0
13970,42873,0,0,66,66,0,1,0,1,0
49305,57470,0,0,66,66,0,1,0,1,0
10669,49756,0,0,60,60,0,1,0,1,0
49540,50584,0,0,66,66,0,1,0,1,0
11676,25174,0,0,146,146,0,1,0,1,0
40301,8696,0,0,60,60,0,1,0,1,0
61147,22114,0,0,66,66,0,1,0,1,0
10438,23,0,0,60,60,0,1,0,1,0
443,54507,0,0,82,82,0,1,0,1,0
54210,36237,0,0,62,62,0,1,0,1,0
63963,50584,0,0,66,66,0,1,0,1,0
53774,51505,0,0,66,66,0,1,0,1,0
35261,15503,0,0,74,74,0,1,0,1,0
60097,22114,0,0,62,62,0,1,0,1,0
52863,50584,0,0,66,66,0,1,0,1,0
26048,21,0,0,60,60,0,1,0,1,0
10552,25174,0,0,62,62,0,1,0,1,0
49415,22114,0,0,62,62,0,1,0,1,0
8313,51505,0,0,66,66,0,1,0,1,0
3478,61463,0,0,585,585,0,1,0,1,0
58638,5900,0,0,62,62,0,1,0,1,0
25010,30188,0,0,62,62,0,1,0,1,0
50878,53733,0,0,66,66,0,1,0,1,0
58638,5900,0,0,62,62,0,1,0,1,0
54471,36237,0,0,66,66,0,1,0,1,0
42231,57470,0,0,78,78,0,1,0,1,0
52741,24211,0,0,66,66,0,1,0,1,0
20198,17372,0,0,62,62,0,1,0,1,0
25054,36827,0,0,66,66,0,1,0,1,0
57484,30317,0,0,62,62,0,1,0,1,0
2346,25174,0,0,62,62,0,1,0,1,0
58638,5900,0,0,62,62,0,1,0,1,0
50493,15503,0,0,146,146,0,1,0,1,0
9494,23,0,0,60,60,0,1,0,1,0
46286,21247,0,0,62,62,0,1,0,1,0
23934,41615,0,0,145,145,0,1,0,1,0
64649,81,0,0,60,60,0,1,0,1,0
50994,35974,0,0,60,60,0,1,0,1,0
39324,64147,0,0,62,62,0,1,0,1,0
56826,22114,0,0,62,62,0,1,0,1,0
61916,64097,0,0,62,62,0,1,0,1,0
2572,35440,0,0,62,62,0,1,0,1,0
54769,50584,0,0,146,146,0,1,0,1,0
13164,39033,0,0,145,145,0,1,0,1,0
58638,5900,0,0,62,62,0,1,0,1,0
19068,37965,0,0,62,62,0,1,0,1,0
57020,36237,0,0,66,66,0,1,0,1,0
57613,42707,0,0,62,62,0,1,0,1,0
39380,49903,0,0,146,146,0,1,0,1,0
58638,5900,0,0,62,62,0,1,0,1,0
60627,51050,0,0,66,66,0,1,0,1,0
58114,11119,0,0,148,148,0,1,0,1,0
40772,15503,0,0,74,74,0,1,0,1,0
1024,64147,0,0,62,62,0,1,0,1,0
40500,48817,0,0,143,143,0,1,0,1,0
52247,51505,0,0,146,146,0,1,0,1,0
59147,51505,0,0,66,66,0,1,0,1,0
45941,23388,0,0,60,60,0,1,0,1,0
53475,3389,0,0,66,66,0,1,0,1,0
36906,50584,0,0,62,62,0,1,0,1,0
36011,25174,0,0,66,66,0,1,0,1,0
41755,48817,0,0,145,145,0,1,0,1,0
17378,44847,0,0,66,66,0,1,0,1,0
51581,17546,0,0,66,66,0,1,0,1,0
27446,30188,0,0,66,66,0,1,0,1,0
65159,37965,0,0,74,74,0,1,0,1,0
46346,35440,0,0,66,66,0,1,0,1,0
54631,44847,0,0,70,70,0,1,0,1,0
45682,1,0,0,62,62,0,1,0,1,0
8889,10794,0,0,60,60,0,1,0,1,0
59055,11392,0,0,62,62,0,1,0,1,0
60294,30188,0,0,66,66,0,1,0,1,0
52973,57470,0,0,74,74,0,1,0,1,0
20508,57470,0,0,62,62,0,1,0,1,0
50927,44847,0,0,146,146,0,1,0,1,0
2475,6881,0,0,66,66,0,1,0,1,0
47125,8055,0,0,159,159,0,1,0,1,0
60097,22114,0,0,66,66,0,1,0,1,0
37234,44847,0,0,66,66,0,1,0,1,0
1036,64147,0,0,62,62,0,1,0,1,0
34306,37965,0,0,62,62,0,1,0,1,0
30583,25174,0,0,62,62,0,1,0,1,0
49001,48983,0,0,161,161,0,1,0,1,0
49976,22114,0,0,62,62,0,1,0,1,0
56161,62413,0,0,62,62,0,1,0,1,0
38400,51505,0,0,146,146,0,1,0,1,0
61706,64147,0,0,62,62,0,1,0,1,0
5208,63836,0,0,145,145,0,1,0,1,0
58638,5900,0,0,62,62,0,1,0,1,0
1026,30188,0,0,62,62,0,1,0,1,0
11775,25174,0,0,62,62,0,1,0,1,0
50806,51505,0,0,66,66,0,1,0,1,0
45652,10214,0,0,62,62,0,1,0,1,0
53257,37450,0,0,66,66,0,1,0,1,0
55375,44847,0,0,66,66,0,1,0,1,0
58638,5900,0,0,62,62,0,1,0,1,0
3478,61463,0,0,437,437,0,1,0,1,0
58276,43890,0,0,62,62,0,1,0,1,0
54140,43890,0,0,66,66,0,1,0,1,0
57090,51505,0,0,66,66,0,1,0,1,0
14084,43890,0,0,62,62,0,1,0,1,0
53459,37807,0,0,62,62,0,1,0,1,0
58638,5900,0,0,62,62,0,1,0,1,0
58638,5900,0,0,62,62,0,1,0,1,0
27144,25174,0,0,66,66,0,1,0,1,0
17027,1,0,0,62,62,0,1,0,1,0
20830,1433,0,0,60,60,0,1,0,1,0
53043,51050,0,0,66,66,0,1,0,1,0
63864,23,0,0,60,60,0,1,0,1,0
56876,30188,0,0,66,66,0,1,0,1,0
49993,37965,0,0,66,66,0,1,0,1,0
64339,18375,0,0,66,66,0,1,0,1,0
16037,25174,0,0,62,62,0,1,0,1,0
7356,25174,0,0,62,62,0,1,0,1,0
54221,57470,0,0,66,66,0,1,0,1,0
32215,22114,0,0,66,66,0,1,0,1,0
6126,25174,0,0,66,66,0,1,0,1,0
31521,57470,0,0,145,145,0,1,0,1,0
56309,22114,0,0,146,146,0,1,0,1,0
26301,22114,0,0,62,62,0,1,0,1,0
50878,53733,0,0,62,62,0,1,0,1,0
45964,2666,0,0,60,60,0,1,0,1,0
16387,63752,0,0,60,60,0,1,0,1,0
19455,25174,0,0,62,62,0,1,0,1,0
56578,25174,0,0,62,62,0,1,0,1,0
55616,56205,0,0,66,66,0,1,0,1,0
57793,37807,0,0,66,66,0,1,0,1,0
44546,32468,0,0,62,62,0,1,0,1,0
18904,57470,0,0,62,62,0,1,0,1,0
39941,2767,0,0,62,62,0,1,0,1,0
59168,39004,0,0,62,62,0,1,0,1,0
57797,64147,0,0,62,62,0,1,0,1,0
443,29326,0,0,82,82,0,1,0,1,0
18398,21247,0,0,66,66,0,1,0,1,0
443,25740,0,0,131,131,0,1,0,1,0
54280,3385,0,0,60,60,0,1,0,1,0
26924,37965,0,0,66,66,0,1,0,1,0
443,54507,0,0,82,82,0,1,0,1,0
52676,53733,0,0,62,62,0,1,0,1,0
63080,37965,0,0,66,66,0,1,0,1,0
38926,37965,0,0,62,62,0,1,0,1,0
13285,29892,0,0,145,145,0,1,0,1,0
63888,25174,0,0,66,66,0,1,0,1,0
3730,17372,0,0,62,62,0,1,0,1,0
60750,42707,0,0,62,62,0,1,0,1,0
60308,37965,0,0,66,66,0,1,0,1,0
50316,37965,0,0,66,66,0,1,0,1,0
1025,64147,0,0,62,62,0,1,0,1,0
19875,30170,0,0,145,145,0,1,0,1,0
60058,25174,0,0,66,66,0,1,0,1,0
61785,64147,0,0,66,66,0,1,0,1,0
44856,51505,0,0,62,62,0,1,0,1,0
17579,57470,0,0,62,62,0,1,0,1,0
6666,80,0,0,60,60,0,1,0,1,0
17561,52700,0,0,62,62,0,1,0,1,0
2522,64147,0,0,62,62,0,1,0,1,0
60136,56205,0,0,62,62,0,1,0,1,0
23807,44847,0,0,66,66,0,1,0,1,0
63409,50265,0,0,66,66,0,1,0,1,0
6889,65473,0,0,143,143,0,1,0,1,0
59914,65473,0,0,145,145,0,1,0,1,0
41490,25174,0,0,62,62,0,1,0,1,0
42119,36237,0,0,66,66,0,1,0,1,0
22357,6004,0,0,62,62,0,1,0,1,0
5060,37965,0,0,66,66,0,1,0,1,0
2182,57354,0,0,145,145,0,1,0,1,0
0,0,0,0,98,98,0,1,0,1,0
59564,57470,0,0,66,66,0,1,0,1,0
34731,22114,0,0,62,62,0,1,0,1,0
59918,44847,0,0,66,66,0,1,0,1,0
60192,35440,0,0,146,146,0,1,0,1,0
54912,64147,0,0,66,66,0,1,0,1,0
44496,57470,0,0,66,66,0,1,0,1,0
57894,44847,0,0,66,66,0,1,0,1,0
60854,42873,0,0,66,66,0,1,0,1,0
11136,19910,0,0,62,62,0,1,0,1,0
11458,2767,0,0,62,62,0,1,0,1,0
53012,51050,0,0,66,66,0,1,0,1,0
58334,5223,0,0,148,148,0,1,0,1,0
65344,46824,0,0,66,66,0,1,0,1,0
55145,11392,0,0,66,66,0,1,0,1,0
52564,15503,0,0,74,74,0,1,0,1,0
21145,11392,0,0,62,62,0,1,0,1,0
64392,25174,0,0,66,66,0,1,0,1,0
33370,22,0,0,60,60,0,1,0,1,0
21332,23,0,0,60,60,0,1,0,1,0
22677,25174,0,0,66,66,0,1,0,1,0
58638,5900,0,0,62,62,0,1,0,1,0
38581,22114,0,0,62,62,0,1,0,1,0
5285,64147,0,0,145,145,0,1,0,1,0
26435,39004,0,0,62,62,0,1,0,1,0
61948,48817,0,0,145,145,0,1,0,1,0
58703,50584,0,0,66,66,0,1,0,1,0
58791,15503,0,0,66,66,0,1,0,1,0
62080,54532,0,0,60,60,0,1,0,1,0
5357,32468,0,0,66,66,0,1,0,1,0
56679,5900,0,0,60,60,0,1,0,1,0
60970,20541,0,0,66,66,0,1,0,1,0
61524,23,0,0,60,60,0,1,0,1,0
45964,3111,0,0,60,60,0,1,0,1,0
443,62732,0,0,199,199,0,1,0,1,0
27448,22114,0,0,62,62,0,1,0,1,0
45766,35440,0,0,62,62,0,1,0,1,0
80,9918,0,0,60,60,0,1,0,1,0
29017,2222,0,0,60,60,0,1,0,1,0
50514,52752,0,0,146,146,0,1,0,1,0
52569,30188,0,0,66,66,0,1,0,1,0
50031,44847,0,0,70,70,0,1,0,1,0
62902,32468,0,0,66,66,0,1,0,1,0
1024,57470,0,0,62,62,0,1,0,1,0
62183,57470,0,0,74,74,0,1,0,1,0
13281,51050,0,0,66,66,0,1,0,1,0
52503,50584,0,0,66,66,0,1,0,1,0
42030,25,0,0,74,74,0,1,0,1,0
16979,56205,0,0,66,66,0,1,0,1,0
58638,5900,0,0,62,62,0,1,0,1,0
62912,26467,0,0,62,62,0,1,0,1,0
21492,51505,0,0,62,62,0,1,0,1,0
58638,5900,0,0,62,62,0,1,0,1,0
40500,25356,0,0,146,146,0,1,0,1,0
54313,64147,0,0,66,66,0,1,0,1,0
54166,25174,0,0,62,62,0,1,0,1,0
56924,26467,0,0,62,62,0,1,0,1,0
1025,25174,0,0,62,62,0,1,0,1,0
1114,46824,0,0,62,62,0,1,0,1,0
49993,37965,0,0,66,66,0,1,0,1,0
63852,25174,0,0,62,62,0,1,0,1,0
25533,22114,0,0,62,62,0,1,0,1,0
49174,50584,0,0,146,146,0,1,0,1,0
42465,57470,0,0,60,60,0,1,0,1,0
26053,33720,0,0,160,160,0,1,0,1,0
56946,1,0,0,66,66,0,1,0,1,0
51396,56205,0,0,66,66,0,1,0,1,0
10072,25174,0,0,146,146,0,1,0,1,0
5611,25174,0,0,146,146,0,1,0,1,0
63314,57470,0,0,66,66,0,1,0,1,0
42469,30188,0,0,62,62,0,1,0,1,0
60855,35440,0,0,66,66,0,1,0,1,0
24606,55783,0,0,72,72,0,1,0,1,0
58638,5900,0,0,62,62,0,1,0,1,0
59223,17500,0,0,66,66,0,1,0,1,0
18642,42707,0,0,62,62,0,1,0,1,0
53371,26467,0,0,66,66,0,1,0,1,0
993,49276,0,0,129,129,0,1,0,1,0
35201,25174,0,0,62,62,0,1,0,1,0
27783,57470,0,0,62,62,0,1,0,1,0
42417,22114,0,0,62,62,0,1,0,1,0
43584,24748,0,0,156,156,0,1,0,1,0
49163,22114,0,0,62,62,0,1,0,1,0
60646,11392,0,0,66,66,0,1,0,1,0
51973,44847,0,0,62,62,0,1,0,1,0
43129,20220,0,0,62,62,0,1,0,1,0
51430,25174,0,0,146,146,0,1,0,1,0
50280,57470,0,0,78,78,0,1,0,1,0
443,62732,0,0,332,332,0,1,0,1,0
22346,51505,0,0,62,62,0,1,0,1,0
40687,64147,0,0,62,62,0,1,0,1,0
3407,57866,0,0,66,66,0,1,0,1,0
443,64347,0,0,131,131,0,1,0,1,0
51185,37965,0,0,66,66,0,1,0,1,0
58638,5900,0,0,62,62,0,1,0,1,0
5223,14446,0,0,220,220,0,1,0,1,0
3478,61463,0,0,1162,1162,0,1,0,1,0
49929,26467,0,0,62,62,0,1,0,1,0
50116,22,0,0,60,60,0,1,0,1,0
50470,61463,0,0,86,86,0,1,0,1,0
39351,23,0,0,60,60,0,1,0,1,0
18652,64147,0,0,62,62,0,1,0,1,0
56005,64147,0,0,62,62,0,1,0,1,0
39195,25174,0,0,62,62,0,1,0,1,0
38848,11119,0,0,146,146,0,1,0,1,0
28875,51505,0,0,62,62,0,1,0,1,0
2394,43890,0,0,62,62,0,1,0,1,0
59790,44847,0,0,62,62,0,1,0,1,0
14397,37965,0,0,62,62,0,1,0,1,0
20004,48817,0,0,146,146,0,1,0,1,0
61550,5529,0,0,145,145,0,1,0,1,0
50881,50584,0,0,66,66,0,1,0,1,0
64626,50584,0,0,66,66,0,1,0,1,0
46162,25174,0,0,146,146,0,1,0,1,0
52575,22114,0,0,66,66,0,1,0,1,0
56521,32480,0,0,62,62,0,1,0,1,0
35718,20238,0,0,62,62,0,1,0,1,0
53143,50584,0,0,66,66,0,1,0,1,0
25565,62144,0,0,60,60,0,1,0,1,0
63331,51221,0,0,62,62,0,1,0,1,0
23936,41615,0,0,146,146,0,1,0,1,0
443,56513,0,0,78,78,0,1,0,1,0
46774,51050,0,0,62,62,0,1,0,1,0
15341,23,0,0,60,60,0,1,0,1,0
60204,2767,0,0,66,66,0,1,0,1,0
57987,56125,0,0,90,90,0,1,0,1,0
39895,26467,0,0,62,62,0,1,0,1,0
61173,2323,0,0,60,60,0,1,0,1,0
46292,42873,0,0,72,72,0,1,0,1,0
51396,56205,0,0,62,62,0,1,0,1,0
15922,44847,0,0,66,66,0,1,0,1,0
1024,63737,0,0,518,518,0,1,0,1,0
26722,11446,0,0,66,66,0,1,0,1,0
39460,23117,0,0,66,66,0,1,0,1,0
52969,44847,0,0,62,62,0,1,0,1,0
60337,30188,0,0,66,66,0,1,0,1,0
58076,21247,0,0,62,62,0,1,0,1,0
26235,37965,0,0,66,66,0,1,0,1,0
65016,37965,0,0,66,66,0,1,0,1,0
38859,22114,0,0,66,66,0,1,0,1,0
44922,57470,0,0,74,74,0,1,0,1,0
54578,64147,0,0,66,66,0,1,0,1,0
56306,57587,0,0,146,146,0,1,0,1,0
58672,43890,0,0,62,62,0,1,0,1,0
54593,51505,0,0,66,66,0,1,0,1,0
63743,25174,0,0,62,62,0,1,0,1,0
61336,61689,0,0,66,66,0,1,0,1,0
14082,50584,0,0,66,66,0,1,0,1,0
16387,16862,0,0,60,60,0,1,0,1,0
53108,22114,0,0,146,146,0,1,0,1,0
16387,34137,0,0,60,60,0,1,0,1,0
65419,26467,0,0,62,62,0,1,0,1,0
65259,37965,0,0,66,66,0,1,0,1,0
6666,5000,0,0,60,60,0,1,0,1,0
1176,64147,0,0,62,62,0,1,0,1,0
29884,25174,0,0,62,62,0,1,0,1,0
32051,37965,0,0,62,62,0,1,0,1,0
42030,25,0,0,74,74,0,1,0,1,0
57107,64147,0,0,62,62,0,1,0,1,0
44129,64147,0,0,145,145,0,1,0,1,0
53676,35974,0,0,60,60,0,1,0,1,0
58638,5900,0,0,62,62,0,1,0,1,0
53300,37807,0,0,66,66,0,1,0,1,0
54140,17372,0,0,66,66,0,1,0,1,0
58638,5900,0,0,62,62,0,1,0,1,0
63030,25174,0,0,62,62,0,1,0,1,0
12655,30627,0,0,62,62,0,1,0,1,0
65006,26467,0,0,66,66,0,1,0,1,0
16387,44427,0,0,60,60,0,1,0,1,0
6881,33720,0,0,157,157,0,1,0,1,0
64733,35440,0,0,66,66,0,1,0,1,0
58638,5900,0,0,62,62,0,1,0,1,0
58638,5900,0,0,62,62,0,1,0,1,0
11464,37965,0,0,62,62,0,1,0,1,0
2691,64147,0,0,62,62,0,1,0,1,0
46734,50265,0,0,74,74,0,1,0,1,0
443,62451,0,0,199,199,0,1,0,1,0
32395,30188,0,0,62,62,0,1,0,1,0
57325,60043,0,0,62,62,0,1,0,1,0
14185,48637,0,0,60,60,0,1,0,1,0
3478,61463,0,0,1004,1004,0,1,0,1,0
10427,32480,0,0,62,62,0,1,0,1,0
9445,56205,0,0,66,66,0,1,0,1,0
58799,30188,0,0,66,66,0,1,0,1,0
52743,15503,0,0,66,66,0,1,0,1,0
52252,46314,0,0,62,62,0,1,0,1,0
47910,7464,0,0,60,60,0,1,0,1,0
63740,64147,0,0,66,66,0,1,0,1,0
58305,18375,0,0,66,66,0,1,0,1,0
45766,2323,0,0,60,60,0,1,0,1,0
62208,37965,0,0,66,66,0,1,0,1,0
53156,35993,0,0,66,66,0,1,0,1,0
58646,44847,0,0,62,62,0,1,0,1,0
52210,51505,0,0,66,66,0,1,0,1,0
49982,37965,0,0,66,66,0,1,0,1,0
59155,39004,0,0,74,74,0,1,0,1,0
35937,25174,0,0,66,66,0,1,0,1,0
63397,26467,0,0,66,66,0,1,0,1,0
33401,51505,0,0,66,66,0,1,0,1,0
58250,35440,0,0,66,66,0,1,0,1,0
22714,30188,0,0,62,62,0,1,0,1,0
65012,2767,0,0,62,62,0,1,0,1,0
58099,44847,0,0,62,62,0,1,0,1,0
61550,5529,0,0,145,145,0,1,0,1,0
43235,23,0,0,60,60,0,1,0,1,0
58421,30188,0,0,66,66,0,1,0,1,0
53419,28189,0,0,60,60,0,1,0,1,0
27272,64147,0,0,66,66,0,1,0,1,0
1042,33175,0,0,145,145,0,1,0,1,0
54196,11392,0,0,66,66,0,1,0,1,0
45060,37965,0,0,62,62,0,1,0,1,0
58638,5900,0,0,62,62,0,1,0,1,0
58638,5900,0,0,62,62,0,1,0,1,0
24972,27262,0,0,60,60,0,1,0,1,0
38629,25174,0,0,66,66,0,1,0,1,0
58638,5900,0,0,62,62,0,1,0,1,0
60312,57470,0,0,74,74,0,1,0,1,0
60222,22114,0,0,66,66,0,1,0,1,0
13110,52126,0,0,145,145,0,1,0,1,0
19394,44847,0,0,66,66,0,1,0,1,0
64815,37965,0,0,62,62,0,1,0,1,0
53197,25174,0,0,62,62,0,1,0,1,0
60805,5900,0,0,60,60,0,1,0,1,0
58638,5900,0,0,62,62,0,1,0,1,0
59937,18375,0,0,62,62,0,1,0,1,0
59696,57470,0,0,62,62,0,1,0,1,0
17453,35440,0,0,66,66,0,1,0,1,0
27402,37628,0,0,62,62,0,1,0,1,0
55862,62413,0,0,66,66,0,1,0,1,0
35460,35440,0,0,62,62,0,1,0,1,0
1865,25174,0,0,62,62,0,1,0,1,0
52838,37965,0,0,66,66,0,1,0,1,0
443,32698,0,0,89,89,0,1,0,1,0
13159,37965,0,0,66,66,0,1,0,1,0
10028,25604,0,0,62,62,0,1,0,1,0
12644,11392,0,0,66,66,0,1,0,1,0
50675,56205,0,0,66,66,0,1,0,1,0
42414,50939,0,0,148,148,0,1,0,1,0
43688,22114,0,0,66,66,0,1,0,1,0
50095,50584,0,0,66,66,0,1,0,1,0
44849,46478,0,0,74,74,0,1,0,1,0
1024,44847,0,0,62,62,0,1,0,1,0
13285,29892,0,0,145,145,0,1,0,1,0
58638,5900,0,0,62,62,0,1,0,1,0
9327,57470,0,0,62,62,0,1,0,1,0
3478,61463,0,0,159,159,0,1,0,1,0
62849,62413,0,0,62,62,0,1,0,1,0
51930,57470,0,0,66,66,0,1,0,1,0
50549,43890,0,0,66,66,0,1,0,1,0
28370,23,0,0,60,60,0,1,0,1,0
33973,50265,0,0,62,62,0,1,0,1,0
57539,44847,0,0,62,62,0,1,0,1,0
0,0,0,0,98,98,0,1,0,1,0
443,28417,0,0,82,82,0,1,0,1,0
28124,37965,0,0,62,62,0,1,0,1,0
54976,15503,0,0,62,62,0,1,0,1,0
63092,46776,0,0,78,78,0,1,0,1,0
1187,64147,0,0,66,66,0,1,0,1,0
56278,52752,0,0,62,62,0,1,0,1,0
3478,61463,0,0,877,877,0,1,0,1,0
34348,22114,0,0,62,62,0,1,0,1,0
10477,44847,0,0,62,62,0,1,0,1,0
50066,30188,0,0,66,66,0,1,0,1,0
80,53945,0,0,60,60,0,1,0,1,0
53197,25174,0,0,66,66,0,1,0,1,0
1026,64147,0,0,62,62,0,1,0,1,0
56614,25174,0,0,66,66,0,1,0,1,0
60129,55442,0,0,66,66,0,1,0,1,0
28899,37965,0,0,62,62,0,1,0,1,0
53090,59356,0,0,66,66,0,1,0,1,0
56035,1310,0,0,66,66,0,1,0,1,0
62799,25174,0,0,146,146,0,1,0,1,0
37662,2323,0,0,60,60,0,1,0,1,0
59023,64097,0,0,66,66,0,1,0,1,0
11983,57470,0,0,62,62,0,1,0,1,0
63213,35440,0,0,62,62,0,1,0,1,0
33215,37965,0,0,62,62,0,1,0,1,0
2467,2767,0,0,66,66,0,1,0,1,0
56067,25174,0,0,62,62,0,1,0,1,0
63136,42873,0,0,66,66,0,1,0,1,0
50620,50584,0,0,62,62,0,1,0,1,0
59107,25174,0,0,66,66,0,1,0,1,0
60894,50584,0,0,66,66,0,1,0,1,0
6843,42873,0,0,62,62,0,1,0,1,0
36641,25174,0,0,66,66,0,1,0,1,0
52340,64147,0,0,66,66,0,1,0,1,0
55539,57470,0,0,66,66,0,1,0,1,0
3352,50584,0,0,62,62,0,1,0,1,0
62740,44847,0,0,146,146,0,1,0,1,0
27869,51221,0,0,66,66,0,1,0,1,0
58638,5900,0,0,62,62,0,1,0,1,0
52575,22114,0,0,66,66,0,1,0,1,0
1038,37965,0,0,62,62,0,1,0,1,0
10026,50584,0,0,146,146,0,1,0,1,0
58638,5900,0,0,62,62,0,1,0,1,0
58721,51505,0,0,66,66,0,1,0,1,0
25342,8168,0,0,66,66,0,1,0,1,0
51829,36134,0,0,66,66,0,1,0,1,0
60550,50584,0,0,62,62,0,1,0,1,0
0,0,0,0,98,98,0,1,0,1,0
60342,36237,0,0,62,62,0,1,0,1,0
59943,37807,0,0,62,62,0,1,0,1,0
58638,5900,0,0,62,62,0,1,0,1,0
13285,29892,0,0,145,145,0,1,0,1,0
55079,25174,0,0,66,66,0,1,0,1,0
59493,44847,0,0,66,66,0,1,0,1,0
19875,30170,0,0,145,145,0,1,0,1,0
45964,55559,0,0,60,60,0,1,0,1,0
58509,21247,0,0,66,66,0,1,0,1,0
61137,40740,0,0,145,145,0,1,0,1,0
32796,37965,0,0,66,66,0,1,0,1,0
10445,46824,0,0,62,62,0,1,0,1,0
21213,23,0,0,60,60,0,1,0,1,0
58638,5900,0,0,62,62,0,1,0,1,0
1162,57470,0,0,62,62,0,1,0,1,0
65025,57866,0,0,62,62,0,1,0,1,0
443,64347,0,0,100,100,0,1,0,1,0
50095,50584,0,0,62,62,0,1,0,1,0
57846,57866,0,0,66,66,0,1,0,1,0
6666,5000,0,0,60,60,0,1,0,1,0
49982,37965,0,0,66,66,0,1,0,1,0
48020,7484,0,0,60,60,0,1,0,1,0
0,0,0,0,164,164,0,2,0,2,0
40742,2967,0,0,62,62,0,1,0,1,0
33528,23,0,0,60,60,0,1,0,1,0
6881,37965,0,0,146,146,0,1,0,1,0
58638,5900,0,0,62,62,0,1,0,1,0
48478,49903,0,0,62,62,0,1,0,1,0
19286,25174,0,0,146,146,0,1,0,1,0
993,58185,0,0,129,129,0,1,0,1,0
18086,25174,0,0,62,62,0,1,0,1,0
60485,22114,0,0,66,66,0,1,0,1,0
7720,44847,0,0,66,66,0,1,0,1,0
63263,57470,0,0,66,66,0,1,0,1,0
63888,57470,0,0,62,62,0,1,0,1,0
6666,138,0,0,60,60,0,1,0,1,0
38581,22114,0,0,146,146,0,1,0,1,0
12221,81,0,0,60,60,0,1,0,1,0
26527,25174,0,0,66,66,0,1,0,1,0
15998,36829,0,0,62,62,0,1,0,1,0
11677,56205,0,0,66,66,0,1,0,1,0
11023,51505,0,0,62,62,0,1,0,1,0
11112,43890,0,0,66,66,0,1,0,1,0
63984,25174,0,0,62,62,0,1,0,1,0
59366,35440,0,0,62,62,0,1,0,1,0
14036,48817,0,0,62,62,0,1,0,1,0
49001,40108,0,0,161,161,0,1,0,1,0
65270,3855,0,0,78,78,0,1,0,1,0
54693,30188,0,0,66,66,0,1,0,1,0
51062,1433,0,0,60,60,0,1,0,1,0
38859,22114,0,0,66,66,0,1,0,1,0
60818,37965,0,0,66,66,0,1,0,1,0
56078,22,0,0,60,60,0,1,0,1,0
37906,37965,0,0,62,62,0,1,0,1,0
7110,25174,0,0,66,66,0,1,0,1,0
58638,5900,0,0,62,62,0,1,0,1,0
80,37649,0,0,60,60,0,1,0,1,0
30794,37965,0,0,62,62,0,1,0,1,0
58758,22114,0,0,66,66,0,1,0,1,0
55262,44847,0,0,62,62,0,1,0,1,0
45767,50584,0,0,146,146,0,1,0,1,0
443,44683,0,0,83,83,0,1,0,1,0
41648,56205,0,0,66,66,0,1,0,1,0
38776,25174,0,0,146,146,0,1,0,1,0
35207,22114,0,0,62,62,0,1,0,1,0
51233,43890,0,0,66,66,0,1,0,1,0
58638,5900,0,0,62,62,0,1,0,1,0
53194,26467,0,0,66,66,0,1,0,1,0
0,0,0,0,74,74,0,1,0,1,0
25579,23,0,0,60,60,0,1,0,1,0
58638,5900,0,0,62,62,0,1,0,1,0
56578,64147,0,0,66,66,0,1,0,1,0
26906,22114,0,0,62,62,0,1,0,1,0
55254,50584,0,0,66,66,0,1,0,1,0
443,52504,0,0,97,97,0,1,0,1,0
52938,64097,0,0,66,66,0,1,0,1,0
443,12105,0,0,66,66,0,1,0,1,0
443,43775,0,0,97,97,0,1,0,1,0
3478,61463,0,0,935,935,0,1,0,1,0
43584,24748,0,0,156,156,0,1,0,1,0
39460,23117,0,0,62,62,0,1,0,1,0
11494,51505,0,0,146,146,0,1,0,1,0
29159,39004,0,0,62,62,0,1,0,1,0
44538,50584,0,0,62,62,0,1,0,1,0
58021,22114,0,0,66,66,0,1,0,1,0
52744,25174,0,0,66,66,0,1,0,1,0
13445,44847,0,0,66,66,0,1,0,1,0
62991,51221,0,0,66,66,0,1,0,1,0
14618,6881,0,0,66,66,0,1,0,1,0
60750,42707,0,0,66,66,0,1,0,1,0
59355,51505,0,0,66,66,0,1,0,1,0
68,67,0,0,594,594,0,1,0,1,0
3765,64147,0,0,66,66,0,1,0,1,0
3478,61463,0,0,240,240,0,1,0,1,0
22724,9822,0,0,66,66,0,1,0,1,0
59786,25174,0,0,66,66,0,1,0,1,0
5688,44847,0,0,66,66,0,1,0,1,0
37647,36237,0,0,66,66,0,1,0,1,0
51310,64147,0,0,66,66,0,1,0,1,0
50160,57470,0,0,146,146,0,1,0,1,0
38723,37838,0,0,146,146,0,1,0,1,0
58638,5900,0,0,62,62,0,1,0,1,0
10004,57470,0,0,145,145,0,1,0,1,0
33886,39127,0,0,162,162,0,1,0,1,0
39313,37965,0,0,62,62,0,1,0,1,0
62414,50584,0,0,62,62,0,1,0,1,0
55629,42873,0,0,74,74,0,1,0,1,0
58858,15503,0,0,66,66,0,1,0,1,0
55254,50584,0,0,66,66,0,1,0,1,0
57969,42873,0,0,66,66,0,1,0,1,0
3410,17372,0,0,62,62,0,1,0,1,0
15465,64147,0,0,66,66,0,1,0,1,0
9745,26467,0,0,62,62,0,1,0,1,0
1025,35447,0,0,62,62,0,1,0,1,0
49690,50265,0,0,66,66,0,1,0,1,0
32845,9797,0,0,60,60,0,1,0,1,0
48706,23393,0,0,60,60,0,1,0,1,0
56863,5900,0,0,60,60,0,1,0,1,0
58638,5900,0,0,62,62,0,1,0,1,0
45941,23388,0,0,60,60,0,1,0,1,0
27969,25174,0,0,66,66,0,1,0,1,0
51346,51221,0,0,70,70,0,1,0,1,0
63956,38211,0,0,62,62,0,1,0,1,0
4500,4500,0,0,862,862,0,1,0,1,0
41447,26467,0,0,62,62,0,1,0,1,0
48125,7548,0,0,60,60,0,1,0,1,0
58638,5900,0,0,62,62,0,1,0,1,0
57090,51505,0,0,66,66,0,1,0,1,0
45941,23388,0,0,60,60,0,1,0,1,0
7286,44847,0,0,66,66,0,1,0,1,0
1027,44847,0,0,62,62,0,1,0,1,0
6889,8055,0,0,143,143,0,1,0,1,0
61250,42873,0,0,66,66,0,1,0,1,0
25961,55783,0,0,60,60,0,1,0,1,0
24949,47224,0,0,145,145,0,1,0,1,0
56770,26467,0,0,66,66,0,1,0,1,0
18608,11392,0,0,66,66,0,1,0,1,0
4366,51505,0,0,62,62,0,1,0,1,0
51413,1,0,0,72,72,0,1,0,1,0
63670,64097,0,0,66,66,0,1,0,1,0
443,46223,0,0,66,66,0,1,0,1,0
11692,25174,0,0,62,62,0,1,0,1,0
6486,64147,0,0,66,66,0,1,0,1,0
55653,23,0,0,60,60,0,1,0,1,0
58475,11392,0,0,66,66,0,1,0,1,0
20706,37965,0,0,62,62,0,1,0,1,0
57643,28189,0,0,60,60,0,1,0,1,0
50067,64147,0,0,66,66,0,1,0,1,0
443,22238,0,0,112,112,0,1,0,1,0
59378,50584,0,0,66,66,0,1,0,1,0
57174,57470,0,0,66,66,0,1,0,1,0
7104,23,0,0,60,60,0,1,0,1,0
3225,64147,0,0,66,66,0,1,0,1,0
443,54507,0,0,82,82,0,1,0,1,0
63334,37807,0,0,66,66,0,1,0,1,0
58468,57587,0,0,66,66,0,1,0,1,0
55524,46232,0,0,66,66,0,1,0,1,0
19617,39004,0,0,62,62,0,1,0,1,0
50116,22,0,0,60,60,0,1,0,1,0
63474,48817,0,0,66,66,0,1,0,1,0
60558,51221,0,0,62,62,0,1,0,1,0
10000,10214,0,0,62,62,0,1,0,1,0
58638,5900,0,0,62,62,0,1,0,1,0
51830,42707,0,0,66,66,0,1,0,1,0
19875,30170,0,0,145,145,0,1,0,1,0
4447,35440,0,0,66,66,0,1,0,1,0
25570,35440,0,0,146,146,0,1,0,1,0
36579,30188,0,0,66,66,0,1,0,1,0
27442,44847,0,0,62,62,0,1,0,1,0
18642,42707,0,0,62,62,0,1,0,1,0
57768,37965,0,0,62,62,0,1,0,1,0
21179,44847,0,0,62,62,0,1,0,1,0
59586,57470,0,0,66,66,0,1,0,1,0
59889,30188,0,0,62,62,0,1,0,1,0
51728,44847,0,0,62,62,0,1,0,1,0
52318,22114,0,0,62,62,0,1,0,1,0
57131,31061,0,0,145,145,0,1,0,1,0
29016,25174,0,0,62,62,0,1,0,1,0
4793,50584,0,0,66,66,0,1,0,1,0
61085,37965,0,0,62,62,0,1,0,1,0
65012,32468,0,0,62,62,0,1,0,1,0
63347,25174,0,0,62,62,0,1,0,1,0
43155,35440,0,0,62,62,0,1,0,1,0
3068,36237,0,0,62,62,0,1,0,1,0
50236,25174,0,0,62,62,0,1,0,1,0
36453,23,0,0,60,60,0,1,0,1,0
41885,25174,0,0,62,62,0,1,0,1,0
58638,5900,0,0,62,62,0,1,0,1,0
55439,37965,0,0,66,66,0,1,0,1,0
52699,25174,0,0,66,66,0,1,0,1,0
9745,26467,0,0,62,62,0,1,0,1,0
50881,50584,0,0,66,66,0,1,0,1,0
27063,25174,0,0,62,62,0,1,0,1,0
54779,50584,0,0,62,62,0,1,0,1,0
11478,51221,0,0,66,66,0,1,0,1,0
48016,57470,0,0,62,62,0,1,0,1,0
61357,64147,0,0,62,62,0,1,0,1,0
12567,23,0,0,60,60,0,1,0,1,0
58638,5900,0,0,62,62,0,1,0,1,0
58638,5900,0,0,62,62,0,1,0,1,0
64880,64147,0,0,62,62,0,1,0,1,0
13166,57470,0,0,62,62,0,1,0,1,0
58638,5900,0,0,62,62,0,1,0,1,0
12694,22114,0,0,66,66,0,1,0,1,0
50798,36237,0,0,146,146,0,1,0,1,0
15131,50584,0,0,62,62,0,1,0,1,0
63397,26467,0,0,66,66,0,1,0,1,0
52569,30188,0,0,66,66,0,1,0,1,0
2705,37,0,0,60,60,0,1,0,1,0
30654,51221,0,0,72,72,0,1,0,1,0
51414,22,0,0,60,60,0,1,0,1,0
9092,26672,0,0,60,60,0,1,0,1,0
2525,23,0,0,60,60,0,1,0,1,0
43700,30188,0,0,62,62,0,1,0,1,0
51313,64147,0,0,66,66,0,1,0,1,0
26435,39004,0,0,62,62,0,1,0,1,0
8760,22114,0,0,62,62,0,1,0,1,0
80,53945,0,0,60,60,0,1,0,1,0
35194,57470,0,0,74,74,0,1,0,1,0
6712,123,0,0,90,90,0,1,0,1,0
60571,26467,0,0,62,62,0,1,0,1,0
50570,57470,0,0,66,66,0,1,0,1,0
16387,35244,0,0,60,60,0,1,0,1,0
26651,25174,0,0,62,62,0,1,0,1,0
35722,30188,0,0,62,62,0,1,0,1,0
59023,64097,0,0,66,66,0,1,0,1,0
13035,25174,0,0,146,146,0,1,0,1,0
39056,22114,0,0,62,62,0,1,0,1,0
54047,50011,0,0,66,66,0,1,0,1,0
37308,43890,0,0,62,62,0,1,0,1,0
55262,44847,0,0,62,62,0,1,0,1,0
51446,17500,0,0,100,100,0,1,0,1,0
30169,35776,0,0,159,159,0,1,0,1,0
59663,37965,0,0,66,66,0,1,0,1,0
443,48120,0,0,97,97,0,1,0,1,0
54276,37628,0,0,66,66,0,1,0,1,0
43584,26543,0,0,156,156,0,1,0,1,0
52459,3399,0,0,60,60,0,1,0,1,0
61241,22114,0,0,66,66,0,1,0,1,0
58207,51505,0,0,66,66,0,1,0,1,0
52497,47967,0,0,143,143,0,1,0,1,0
35626,22114,0,0,66,66,0,1,0,1,0
62414,50584,0,0,66,66,0,1,0,1,0
61369,64147,0,0,66,66,0,1,0,1,0
38330,44847,0,0,66,66,0,1,0,1,0
58638,5900,0,0,62,62,0,1,0,1,0
13285,29892,0,0,145,145,0,1,0,1,0
25878,25174,0,0,66,66,0,1,0,1,0
53015,64147,0,0,62,62,0,1,0,1,0
1530,62413,0,0,62,62,0,1,0,1,0
11983,57470,0,0,62,62,0,1,0,1,0
32970,64147,0,0,145,145,0,1,0,1,0
57762,25174,0,0,146,146,0,1,0,1,0
56256,62413,0,0,66,66,0,1,0,1,0
27328,21247,0,0,62,62,0,1,0,1,0
15793,64147,0,0,66,66,0,1,0,1,0
57484,30317,0,0,66,66,0,1,0,1,0
38053,50584,0,0,146,146,0,1,0,1,0
51244,50432,0,0,100,100,0,1,0,1,0
24853,39828,0,0,60,60,0,1,0,1,0
62849,62413,0,0,66,66,0,1,0,1,0
61566,44847,0,0,62,62,0,1,0,1,0
64997,51221,0,0,66,66,0,1,0,1,0
11821,64147,0,0,146,146,0,1,0,1,0
16387,35308,0,0,60,60,0,1,0,1,0
58085,57470,0,0,66,66,0,1,0,1,0
48488,50584,0,0,62,62,0,1,0,1,0
33912,25174,0,0,146,146,0,1,0,1,0
13090,36237,0,0,66,66,0,1,0,1,0
55600,22,0,0,60,60,0,1,0,1,0
11136,19910,0,0,62,62,0,1,0,1,0
65388,55783,0,0,66,66,0,1,0,1,0
33289,50584,0,0,146,146,0,1,0,1,0
64755,31573,0,0,62,62,0,1,0,1,0
0,0,0,0,102,102,0,1,0,1,0
28064,36237,0,0,62,62,0,1,0,1,0
6652,25174,0,0,62,62,0,1,0,1,0
443,7387,0,0,60,60,0,1,0,1,0
9518,57587,0,0,100,100,0,1,0,1,0
12471,48817,0,0,62,62,0,1,0,1,0
58972,57866,0,0,66,66,0,1,0,1,0
1038,37965,0,0,62,62,0,1,0,1,0
58638,5900,0,0,62,62,0,1,0,1,0
28878,51505,0,0,62,62,0,1,0,1,0
51414,50584,0,0,62,62,0,1,0,1,0
55562,50584,0,0,66,66,0,1,0,1,0
21604,50201,0,0,66,66,0,1,0,1,0
50052,65008,0,0,60,60,0,1,0,1,0
29895,23,0,0,60,60,0,1,0,1,0
8297,37965,0,0,62,62,0,1,0,1,0
20576,37965,0,0,62,62,0,1,0,1,0
3478,61463,0,0,164,164,0,1,0,1,0
62757,44847,0,0,146,146,0,1,0,1,0
54062,49813,0,0,62,62,0,1,0,1,0
443,46223,0,0,66,66,0,1,0,1,0
13285,29892,0,0,145,145,0,1,0,1,0
58638,5900,0,0,62,62,0,1,0,1,0
10243,36237,0,0,62,62,0,1,0,1,0
54121,25174,0,0,66,66,0,1,0,1,0
30303,30303,0,0,181,181,0,1,0,1,0
34146,51221,0,0,62,62,0,1,0,1,0
46774,64147,0,0,145,145,0,1,0,1,0
35957,51185,0,0,60,60,0,1,0,1,0
15296,37965,0,0,66,66,0,1,0,1,0
18904,57470,0,0,62,62,0,1,0,1,0
45964,3111,0,0,60,60,0,1,0,1,0
58638,5900,0,0,62,62,0,1,0,1,0
65060,35440,0,0,62,62,0,1,0,1,0
27125,51221,0,0,62,62,0,1,0,1,0
65012,32468,0,0,66,66,0,1,0,1,0
31172,22114,0,0,62,62,0,1,0,1,0
55032,62413,0,0,66,66,0,1,0,1,0
61230,22114,0,0,66,66,0,1,0,1,0
58305,51180,0,0,66,66,0,1,0,1,0
59781,56205,0,0,66,66,0,1,0,1,0
47814,51505,0,0,62,62,0,1,0,1,0
65064,30188,0,0,66,66,0,1,0,1,0
44258,25,0,0,74,74,0,1,0,1,0
26758,50584,0,0,66,66,0,1,0,1,0
3541,22114,0,0,62,62,0,1,0,1,0
51298,57470,0,0,66,66,0,1,0,1,0
16387,64075,0,0,60,60,0,1,0,1,0
58638,5900,0,0,62,62,0,1,0,1,0
58468,37965,0,0,66,66,0,1,0,1,0
51948,17372,0,0,62,62,0,1,0,1,0
64346,51505,0,0,66,66,0,1,0,1,0
42995,26467,0,0,62,62,0,1,0,1,0
54062,49813,0,0,62,62,0,1,0,1,0
9327,57470,0,0,62,62,0,1,0,1,0
29424,37807,0,0,66,66,0,1,0,1,0
23594,48983,0,0,159,159,0,1,0,1,0
44981,57470,0,0,66,66,0,1,0,1,0
58446,56205,0,0,62,62,0,1,0,1,0
61660,64097,0,0,62,62,0,1,0,1,0
34930,20005,0,0,60,60,0,1,0,1,0
59365,42873,0,0,74,74,0,1,0,1,0
6886,45378,0,0,139,139,0,1,0,1,0
4366,51505,0,0,62,62,0,1,0,1,0
7947,50584,0,0,62,62,0,1,0,1,0
12668,42707,0,0,62,62,0,1,0,1,0
58638,5900,0,0,62,62,0,1,0,1,0
5200,6643,0,0,145,145,0,1,0,1,0
443,38956,0,0,82,82,0,1,0,1,0
18085,26467,0,0,62,62,0,1,0,1,0
49001,40108,0,0,161,161,0,1,0,1,0
46576,23718,0,0,66,66,0,1,0,1,0
43207,26467,0,0,62,62,0,1,0,1,0
25739,64147,0,0,62,62,0,1,0,1,0
47134,37965,0,0,62,62,0,1,0,1,0
56629,25174,0,0,66,66,0,1,0,1,0
35120,26467,0,0,62,62,0,1,0,1,0
58264,44847,0,0,66,66,0,1,0,1,0
57545,35440,0,0,66,66,0,1,0,1,0
42973,57470,0,0,62,62,0,1,0,1,0
1027,44847,0,0,62,62,0,1,0,1,0
58638,5900,0,0,62,62,0,1,0,1,0
57020,36237,0,0,62,62,0,1,0,1,0
40474,23117,0,0,62,62,0,1,0,1,0
58638,5900,0,0,62,62,0,1,0,1,0
45941,23386,0,0,60,60,0,1,0,1,0
48706,23393,0,0,60,60,0,1,0,1,0
1117,37965,0,0,62,62,0,1,0,1,0
25565,38308,0,0,60,60,0,1,0,1,0
30270,37965,0,0,66,66,0,1,0,1,0
41744,37965,0,0,62,62,0,1,0,1,0
1227,56205,0,0,66,66,0,1,0,1,0
2705,37,0,0,60,60,0,1,0,1,0
65153,38303,0,0,66,66,0,1,0,1,0
30697,57866,0,0,62,62,0,1,0,1,0
59315,35440,0,0,66,66,0,1,0,1,0
52819,15503,0,0,66,66,0,1,0,1,0
58574,21247,0,0,66,66,0,1,0,1,0
53971,55442,0,0,66,66,0,1,0,1,0
12608,21247,0,0,66,66,0,1,0,1,0
32736,22114,0,0,66,66,0,1,0,1,0
33012,50265,0,0,145,145,0,1,0,1,0
53928,15503,0,0,62,62,0,1,0,1,0
58638,5900,0,0,62,62,0,1,0,1,0
22724,9822,0,0,66,66,0,1,0,1,0
63030,2222,0,0,66,66,0,1,0,1,0
39588,25174,0,0,66,66,0,1,0,1,0
6881,26296,0,0,146,146,0,1,0,1,0
51834,35440,0,0,66,66,0,1,0,1,0
63271,52752,0,0,78,78,0,1,0,1,0
30610,41615,0,0,145,145,0,1,0,1,0
58638,5900,0,0,62,62,0,1,0,1,0
3270,35440,0,0,66,66,0,1,0,1,0
50369,50584,0,0,66,66,0,1,0,1,0
6289,44847,0,0,66,66,0,1,0,1,0
10306,44847,0,0,66,66,0,1,0,1,0
3478,61463,0,0,627,627,0,1,0,1,0
23969,57470,0,0,62,62,0,1,0,1,0
58638,5900,0,0,62,62,0,1,0,1,0
50360,37965,0,0,66,66,0,1,0,1,0
64000,44847,0,0,66,66,0,1,0,1,0
26642,57470,0,0,62,62,0,1,0,1,0
50668,58833,0,0,66,66,0,1,0,1,0
58638,5900,0,0,62,62,0,1,0,1,0
54458,64147,0,0,62,62,0,1,0,1,0
63586,46824,0,0,62,62,0,1,0,1,0
49577,57470,0,0,66,66,0,1,0,1,0
6713,2222,0,0,60,60,0,1,0,1,0
30304,26467,0,0,62,62,0,1,0,1,0
37343,21247,0,0,62,62,0,1,0,1,0
2180,63710,0,0,66,66,0,1,0,1,0
62970,44847,0,0,62,62,0,1,0,1,0
22677,25174,0,0,66,66,0,1,0,1,0
62973,51505,0,0,62,62,0,1,0,1,0
9504,25174,0,0,146,146,0,1,0,1,0
22583,9822,0,0,62,62,0,1,0,1,0
4041,50584,0,0,62,62,0,1,0,1,0
45603,35894,0,0,145,145,0,1,0,1,0
60070,44847,0,0,66,66,0,1,0,1,0
53779,37965,0,0,66,66,0,1,0,1,0
2704,37,0,0,60,60,0,1,0,1,0
39681,37965,0,0,66,66,0,1,0,1,0
30920,64147,0,0,62,62,0,1,0,1,0
1027,11392,0,0,62,62,0,1,0,1,0
443,43775,0,0,97,97,0,1,0,1,0
56712,46824,0,0,66,66,0,1,0,1,0
32609,64097,0,0,66,66,0,1,0,1,0
64124,25174,0,0,62,62,0,1,0,1,0
25063,64147,0,0,62,62,0,1,0,1,0
58357,62413,0,0,146,146,0,1,0,1,0
2475,6881,0,0,66,66,0,1,0,1,0
55396,26467,0,0,62,62,0,1,0,1,0
58638,5900,0,0,62,62,0,1,0,1,0
58638,5900,0,0,62,62,0,1,0,1,0
46518,44847,0,0,62,62,0,1,0,1,0
49418,22114,0,0,62,62,0,1,0,1,0
35507,15503,0,0,62,62,0,1,0,1,0
50877,30041,0,0,66,66,0,1,0,1,0
60855,35440,0,0,66,66,0,1,0,1,0
62716,2323,0,0,60,60,0,1,0,1,0
26698,57470,0,0,62,62,0,1,0,1,0
17008,35440,0,0,146,146,0,1,0,1,0
52650,36237,0,0,62,62,0,1,0,1,0
51582,48817,0,0,66,66,0,1,0,1,0
52690,7302,0,0,66,66,0,1,0,1,0
58014,39004,0,0,62,62,0,1,0,1,0
56249,55442,0,0,66,66,0,1,0,1,0
44258,25,0,0,74,74,0,1,0,1,0
28824,44847,0,0,62,62,0,1,0,1,0
14869,44847,0,0,62,62,0,1,0,1,0
65200,51050,0,0,62,62,0,1,0,1,0
60558,51221,0,0,62,62,0,1,0,1,0
6015,23,0,0,60,60,0,1,0,1,0
33948,50432,0,0,146,146,0,1,0,1,0
51615,25174,0,0,66,66,0,1,0,1,0
50757,64147,0,0,66,66,0,1,0,1,0
49502,44847,0,0,66,66,0,1,0,1,0
16660,55783,0,0,62,62,0,1,0,1,0
28009,36237,0,0,62,62,0,1,0,1,0
22150,6881,0,0,146,146,0,1,0,1,0
24351,57470,0,0,62,62,0,1,0,1,0
6666,16010,0,0,60,60,0,1,0,1,0
22683,39210,0,0,60,60,0,1,0,1,0
54011,44847,0,0,66,66,0,1,0,1,0
26889,50265,0,0,62,62,0,1,0,1,0
53838,36829,0,0,66,66,0,1,0,1,0
443,4205,0,0,320,320,0,1,0,1,0
24592,50584,0,0,62,62,0,1,0,1,0
7105,25174,0,0,66,66,0,1,0,1,0
64949,44847,0,0,66,66,0,1,0,1,0
51732,50584,0,0,146,146,0,1,0,1,0
61660,64097,0,0,62,62,0,1,0,1,0
26408,64147,0,0,66,66,0,1,0,1,0
80,36466,0,0,1514,1514,0,1,0,1,0
50102,17546,0,0,66,66,0,1,0,1,0
38926,37965,0,0,62,62,0,1,0,1,0
55966,57866,0,0,66,66,0,1,0,1,0
64077,25174,0,0,66,66,0,1,0,1,0
32520,50265,0,0,145,145,0,1,0,1,0
23798,23,0,0,60,60,0,1,0,1,0
49001,48817,0,0,160,160,0,1,0,1,0
48544,44847,0,0,146,146,0,1,0,1,0
15998,36829,0,0,62,62,0,1,0,1,0
34553,48637,0,0,60,60,0,1,0,1,0
24560,25174,0,0,62,62,0,1,0,1,0
49680,26467,0,0,146,146,0,1,0,1,0
8889,19777,0,0,60,60,0,1,0,1,0
26573,44847,0,0,62,62,0,1,0,1,0
56816,11392,0,0,66,66,0,1,0,1,0
56581,25174,0,0,146,146,0,1,0,1,0
17415,25174,0,0,62,62,0,1,0,1,0
9504,25174,0,0,62,62,0,1,0,1,0
0,0,0,0,98,98,0,1,0,1,0
13581,51505,0,0,62,62,0,1,0,1,0
29313,48817,0,0,145,145,0,1,0,1,0
63398,25174,0,0,66,66,0,1,0,1,0
48681,11392,0,0,146,146,0,1,0,1,0
57131,7774,0,0,145,145,0,1,0,1,0
59647,47993,0,0,62,62,0,1,0,1,0
19617,39004,0,0,145,145,0,1,0,1,0
62153,35440,0,0,62,62,0,1,0,1,0
55201,22114,0,0,66,66,0,1,0,1,0
62131,50584,0,0,62,62,0,1,0,1,0
443,47582,0,0,85,85,0,1,0,1,0
51414,50584,0,0,66,66,0,1,0,1,0
53841,37965,0,0,66,66,0,1,0,1,0
24560,51050,0,0,146,146,0,1,0,1,0
55111,39004,0,0,66,66,0,1,0,1,0
9528,44847,0,0,146,146,0,1,0,1,0
25565,47158,0,0,60,60,0,1,0,1,0
64923,25174,0,0,66,66,0,1,0,1,0
59647,47993,0,0,66,66,0,1,0,1,0
44821,64147,0,0,62,62,0,1,0,1,0
26531,25174,0,0,62,62,0,1,0,1,0
0,0,0,0,70,70,0,1,0,1,0
45908,3383,0,0,60,60,0,1,0,1,0
7222,57470,0,0,62,62,0,1,0,1,0
26713,64147,0,0,62,62,0,1,0,1,0
2305,35440,0,0,62,62,0,1,0,1,0
50143,35253,0,0,66,66,0,1,0,1,0
52819,15503,0,0,66,66,0,1,0,1,0
17280,22114,0,0,62,62,0,1,0,1,0
36419,50584,0,0,146,146,0,1,0,1,0
30496,57470,0,0,62,62,0,1,0,1,0
58247,57866,0,0,66,66,0,1,0,1,0
58638,5900,0,0,62,62,0,1,0,1,0
3986,17372,0,0,66,66,0,1,0,1,0
55450,64147,0,0,66,66,0,1,0,1,0
51745,30188,0,0,62,62,0,1,0,1,0
56328,36237,0,0,66,66,0,1,0,1,0
7744,32480,0,0,62,62,0,1,0,1,0
10273,21247,0,0,62,62,0,1,0,1,0
11344,42873,0,0,62,62,0,1,0,1,0
43578,15503,0,0,74,74,0,1,0,1,0
36477,40740,0,0,145,145,0,1,0,1,0
61223,37965,0,0,62,62,0,1,0,1,0
42732,57470,0,0,62,62,0,1,0,1,0
55539,57470,0,0,66,66,0,1,0,1,0
0,0,0,0,82,82,0,1,0,1,0
46604,57866,0,0,66,66,0,1,0,1,0
3407,57866,0,0,66,66,0,1,0,1,0
58638,5900,0,0,62,62,0,1,0,1,0
61140,27520,0,0,66,66,0,1,0,1,0
17781,50265,0,0,62,62,0,1,0,1,0
27337,51505,0,0,62,62,0,1,0,1,0
50442,25174,0,0,62,62,0,1,0,1,0
443,60496,0,0,320,320,0,1,0,1,0
50668,58833,0,0,66,66,0,1,0,1,0
54047,50011,0,0,62,62,0,1,0,1,0
16158,50584,0,0,66,66,0,1,0,1,0
54464,56205,0,0,62,62,0,1,0,1,0
7521,20234,0,0,157,157,0,1,0,1,0
3875,25174,0,0,62,62,0,1,0,1,0
58858,15503,0,0,66,66,0,1,0,1,0
11716,37965,0,0,62,62,0,1,0,1,0
14618,6881,0,0,62,62,0,1,0,1,0
443,47582,0,0,100,100,0,1,0,1,0
59128,44847,0,0,62,62,0,1,0,1,0
58638,5900,0,0,62,62,0,1,0,1,0
34349,25174,0,0,146,146,0,1,0,1,0
50052,65008,0,0,60,60,0,1,0,1,0
50254,44847,0,0,66,66,0,1,0,1,0
58509,21247,0,0,66,66,0,1,0,1,0
48071,25174,0,0,146,146,0,1,0,1,0
58445,17500,0,0,66,66,0,1,0,1,0
58359,64147,0,0,72,72,0,1,0,1,0
31539,37965,0,0,62,62,0,1,0,1,0
45964,5333,0,0,60,60,0,1,0,1,0
55032,62413,0,0,66,66,0,1,0,1,0
16330,50584,0,0,62,62,0,1,0,1,0
10331,6881,0,0,146,146,0,1,0,1,0
17702,6881,0,0,66,66,0,1,0,1,0
62064,22114,0,0,66,66,0,1,0,1,0
50470,61463,0,0,86,86,0,1,0,1,0
63380,23,0,0,60,60,0,1,0,1,0
58627,64097,0,0,66,66,0,1,0,1,0
14360,64147,0,0,62,62,0,1,0,1,0
64948,25198,0,0,145,145,0,1,0,1,0
60049,25174,0,0,66,66,0,1,0,1,0
51232,23,0,0,60,60,0,1,0,1,0
53143,50584,0,0,66,66,0,1,0,1,0
9552,57470,0,0,66,66,0,1,0,1,0
51760,50584,0,0,66,66,0,1,0,1,0
58751,51221,0,0,62,62,0,1,0,1,0
2918,37965,0,0,62,62,0,1,0,1,0
53692,44512,0,0,66,66,0,1,0,1,0
7877,22114,0,0,66,66,0,1,0,1,0
64940,26467,0,0,62,62,0,1,0,1,0
29884,25174,0,0,146,146,0,1,0,1,0
64890,51180,0,0,66,66,0,1,0,1,0
55524,46232,0,0,66,66,0,1,0,1,0
53479,23,0,0,60,60,0,1,0,1,0
62549,53733,0,0,66,66,0,1,0,1,0
1080,8391,0,0,66,66,0,1,0,1,0
37837,37965,0,0,62,62,0,1,0,1,0
16654,50265,0,0,62,62,0,1,0,1,0
54746,22114,0,0,146,146,0,1,0,1,0
47910,7454,0,0,60,60,0,1,0,1,0
32307,22114,0,0,146,146,0,1,0,1,0
56411,50584,0,0,62,62,0,1,0,1,0
47812,30627,0,0,62,62,0,1,0,1,0
57550,50584,0,0,66,66,0,1,0,1,0
39063,44847,0,0,66,66,0,1,0,1,0
49380,21247,0,0,66,66,0,1,0,1,0
60398,46776,0,0,74,74,0,1,0,1,0
65270,3855,0,0,78,78,0,1,0,1,0
18203,23,0,0,60,60,0,1,0,1,0
1024,9319,0,0,62,62,0,1,0,1,0
51155,56205,0,0,66,66,0,1,0,1,0
37014,25174,0,0,66,66,0,1,0,1,0
30574,64147,0,0,62,62,0,1,0,1,0
62849,62413,0,0,66,66,0,1,0,1,0
17702,6881,0,0,62,62,0,1,0,1,0
53012,51050,0,0,66,66,0,1,0,1,0
22029,50584,0,0,66,66,0,1,0,1,0
61559,23,0,0,60,60,0,1,0,1,0
4760,44847,0,0,62,62,0,1,0,1,0
80,37649,0,0,60,60,0,1,0,1,0
443,59493,0,0,60,60,0,1,0,1,0
59611,56205,0,0,66,66,0,1,0,1,0
59763,25604,0,0,66,66,0,1,0,1,0
30114,65151,0,0,60,60,0,1,0,1,0
59965,36237,0,0,66,66,0,1,0,1,0
46670,51505,0,0,62,62,0,1,0,1,0
59209,25174,0,0,66,66,0,1,0,1,0
58638,5900,0,0,62,62,0,1,0,1,0
21420,44847,0,0,66,66,0,1,0,1,0
46945,64147,0,0,62,62,0,1,0,1,0
42361,23,0,0,60,60,0,1,0,1,0
58811,53976,0,0,66,66,0,1,0,1,0
49529,21247,0,0,62,62,0,1,0,1,0
11136,57587,0,0,62,62,0,1,0,1,0
55496,64097,0,0,66,66,0,1,0,1,0
58638,5900,0,0,62,62,0,1,0,1,0
80,9918,0,0,60,60,0,1,0,1,0
68,67,0,0,594,594,0,1,0,1,0
63079,64147,0,0,66,66,0,1,0,1,0
50994,35974,0,0,60,60,0,1,0,1,0
46670,51505,0,0,62,62,0,1,0,1,0
44849,46478,0,0,74,74,0,1,0,1,0
35408,56205,0,0,62,62,0,1,0,1,0
48692,57470,0,0,62,62,0,1,0,1,0
49841,1433,0,0,60,60,0,1,0,1,0
38976,46824,0,0,62,62,0,1,0,1,0
3478,61463,0,0,301,301,0,1,0,1,0
59235,52700,0,0,145,145,0,1,0,1,0
14343,6881,0,0,62,62,0,1,0,1,0
59214,57866,0,0,66,66,0,1,0,1,0
28830,37965,0,0,62,62,0,1,0,1,0
50355,43890,0,0,62,62,0,1,0,1,0
9528,44847,0,0,62,62,0,1,0,1,0
31066,57470,0,0,74,74,0,1,0,1,0
57325,60043,0,0,66,66,0,1,0,1,0
1873,37965,0,0,62,62,0,1,0,1,0
56098,64147,0,0,66,66,0,1,0,1,0
50251,35440,0,0,66,66,0,1,0,1,0
56770,26467,0,0,66,66,0,1,0,1,0
20706,37965,0,0,62,62,0,1,0,1,0
61033,39004,0,0,66,66,0,1,0,1,0
61736,50584,0,0,66,66,0,1,0,1,0
48016,57470,0,0,62,62,0,1,0,1,0
62888,23,0,0,60,60,0,1,0,1,0
50160,57470,0,0,146,146,0,1,0,1,0
58638,5900,0,0,62,62,0,1,0,1,0
57545,35440,0,0,66,66,0,1,0,1,0
62307,8055,0,0,159,159,0,1,0,1,0
26879,37965,0,0,62,62,0,1,0,1,0
45964,2225,0,0,60,60,0,1,0,1,0
44414,23718,0,0,66,66,0,1,0,1,0
54693,30188,0,0,66,66,0,1,0,1,0
57151,39004,0,0,66,66,0,1,0,1,0
1045,36237,0,0,66,66,0,1,0,1,0
29000,48817,0,0,148,148,0,1,0,1,0
55254,50584,0,0,66,66,0,1,0,1,0
19610,9571,0,0,62,62,0,1,0,1,0
65096,37807,0,0,62,62,0,1,0,1,0
63213,15503,0,0,66,66,0,1,0,1,0
57578,51221,0,0,62,62,0,1,0,1,0
12465,11392,0,0,146,146,0,1,0,1,0
50593,64147,0,0,66,66,0,1,0,1,0
64335,35440,0,0,62,62,0,1,0,1,0
58022,5601,0,0,60,60,0,1,0,1,0
42532,22114,0,0,62,62,0,1,0,1,0
39132,44847,0,0,66,66,0,1,0,1,0
42946,31573,0,0,146,146,0,1,0,1,0
1238,51505,0,0,146,146,0,1,0,1,0
46662,36237,0,0,62,62,0,1,0,1,0
25453,35776,0,0,145,145,0,1,0,1,0
52749,64147,0,0,66,66,0,1,0,1,0
30644,25174,0,0,62,62,0,1,0,1,0
34112,44847,0,0,66,66,0,1,0,1,0
52934,26467,0,0,66,66,0,1,0,1,0
58501,44847,0,0,66,66,0,1,0,1,0
52626,44847,0,0,66,66,0,1,0,1,0
63791,48817,0,0,145,145,0,1,0,1,0
57964,44847,0,0,62,62,0,1,0,1,0
80,65095,0,0,66,66,0,1,0,1,0
51535,64147,0,0,66,66,0,1,0,1,0
57726,37965,0,0,62,62,0,1,0,1,0
0,0,0,0,98,98,0,1,0,1,0
49191,35440,0,0,66,66,0,1,0,1,0
48676,53395,0,0,60,60,0,1,0,1,0
58914,37965,0,0,66,66,0,1,0,1,0
11951,45026,0,0,60,60,0,1,0,1,0
16620,25174,0,0,62,62,0,1,0,1,0
6881,6881,0,0,62,62,0,1,0,1,0
59365,42873,0,0,74,74,0,1,0,1,0
58638,5900,0,0,62,62,0,1,0,1,0
17781,44847,0,0,146,146,0,1,0,1,0
29159,39004,0,0,62,62,0,1,0,1,0
48706,23393,0,0,60,60,0,1,0,1,0
51414,22,0,0,60,60,0,1,0,1,0
48676,53393,0,0,60,60,0,1,0,1,0
5223,13602,0,0,66,66,0,1,0,1,0
9506,2323,0,0,60,60,0,1,0,1,0
64940,26467,0,0,62,62,0,1,0,1,0
58638,5900,0,0,62,62,0,1,0,1,0
6057,51221,0,0,78,78,0,1,0,1,0
53475,3389,0,0,66,66,0,1,0,1,0
35937,25174,0,0,66,66,0,1,0,1,0
58638,5900,0,0,62,62,0,1,0,1,0
55199,21247,0,0,66,66,0,1,0,1,0
40185,64147,0,0,62,62,0,1,0,1,0
9969,2323,0,0,60,60,0,1,0,1,0
23939,41615,0,0,146,146,0,1,0,1,0
58248,50584,0,0,62,62,0,1,0,1,0
58638,5900,0,0,62,62,0,1,0,1,0
30794,37965,0,0,62,62,0,1,0,1,0
52459,33890,0,0,60,60,0,1,0,1,0
6712,44818,0,0,66,66,0,1,0,1,0
33289,50584,0,0,62,62,0,1,0,1,0
30046,15503,0,0,62,62,0,1,0,1,0
25470,24748,0,0,143,143,0,1,0,1,0
6881,33156,0,0,146,146,0,1,0,1,0
51548,995,0,0,60,60,0,1,0,1,0
51356,22114,0,0,66,66,0,1,0,1,0
47342,36237,0,0,62,62,0,1,0,1,0
1866,51505,0,0,66,66,0,1,0,1,0
9717,22114,0,0,146,146,0,1,0,1,0
58664,64147,0,0,62,62,0,1,0,1,0
58638,5900,0,0,62,62,0,1,0,1,0
43679,44847,0,0,62,62,0,1,0,1,0
58486,57470,0,0,66,66,0,1,0,1,0
11362,64147,0,0,145,145,0,1,0,1,0
68,67,0,0,346,346,0,1,0,1,0
63640,57866,0,0,66,66,0,1,0,1,0
2849,30188,0,0,66,66,0,1,0,1,0
50820,57470,0,0,66,66,0,1,0,1,0
34166,22114,0,0,62,62,0,1,0,1,0
10166,44847,0,0,62,62,0,1,0,1,0
57339,50584,0,0,62,62,0,1,0,1,0
61315,48817,0,0,62,62,0,1,0,1,0
59874,22114,0,0,66,66,0,1,0,1,0
55396,26467,0,0,62,62,0,1,0,1,0
52745,25174,0,0,66,66,0,1,0,1,0
55562,50584,0,0,62,62,0,1,0,1,0
9283,57470,0,0,66,66,0,1,0,1,0
57643,28189,0,0,60,60,0,1,0,1,0
27446,30188,0,0,66,66,0,1,0,1,0
42685,51180,0,0,62,62,0,1,0,1,0
19068,37965,0,0,62,62,0,1,0,1,0
58131,29072,0,0,146,146,0,1,0,1,0
18745,64147,0,0,66,66,0,1,0,1,0
64333,57470,0,0,78,78,0,1,0,1,0
23131,25174,0,0,62,62,0,1,0,1,0
52361,23718,0,0,66,66,0,1,0,1,0
51620,56205,0,0,66,66,0,1,0,1,0
27507,25174,0,0,62,62,0,1,0,1,0
59772,62413,0,0,66,66,0,1,0,1,0
30542,25174,0,0,62,62,0,1,0,1,0
52459,5555,0,0,60,60,0,1,0,1,0
63379,36237,0,0,62,62,0,1,0,1,0
46362,35440,0,0,66,66,0,1,0,1,0
33801,62413,0,0,66,66,0,1,0,1,0
40400,22114,0,0,62,62,0,1,0,1,0
57860,51505,0,0,62,62,0,1,0,1,0
35558,15503,0,0,66,66,0,1,0,1,0
59943,37807,0,0,146,146,0,1,0,1,0
25583,2323,0,0,60,60,0,1,0,1,0
26713,64147,0,0,62,62,0,1,0,1,0
33556,25174,0,0,62,62,0,1,0,1,0
21502,44847,0,0,66,66,0,1,0,1,0
21892,15503,0,0,62,62,0,1,0,1,0
51598,56079,0,0,66,66,0,1,0,1,0
46516,57470,0,0,62,62,0,1,0,1,0
17213,22114,0,0,62,62,0,1,0,1,0
42951,44847,0,0,66,66,0,1,0,1,0
45375,1900,0,0,139,139,0,1,0,1,0
16490,25174,0,0,66,66,0,1,0,1,0
11692,25174,0,0,66,66,0,1,0,1,0
43671,17372,0,0,62,62,0,1,0,1,0
53406,44847,0,0,62,62,0,1,0,1,0
62991,51221,0,0,66,66,0,1,0,1,0
3478,61463,0,0,1267,1267,0,1,0,1,0
16059,22114,0,0,62,62,0,1,0,1,0
57351,62413,0,0,62,62,0,1,0,1,0
59020,9600,0,0,60,60,0,1,0,1,0
36804,25174,0,0,66,66,0,1,0,1,0
3717,25174,0,0,62,62,0,1,0,1,0
60426,57470,0,0,62,62,0,1,0,1,0
54339,23117,0,0,66,66,0,1,0,1,0
48420,48637,0,0,146,146,0,1,0,1,0
22636,30188,0,0,62,62,0,1,0,1,0
27969,25174,0,0,62,62,0,1,0,1,0
58638,5900,0,0,62,62,0,1,0,1,0
12986,64147,0,0,62,62,0,1,0,1,0
12318,41864,0,0,139,139,0,1,0,1,0
50994,35974,0,0,60,60,0,1,0,1,0
37008,42707,0,0,62,62,0,1,0,1,0
61221,35440,0,0,66,66,0,1,0,1,0
10036,44847,0,0,66,66,0,1,0,1,0
34489,35440,0,0,66,66,0,1,0,1,0
58627,64097,0,0,66,66,0,1,0,1,0
9473,26467,0,0,66,66,0,1,0,1,0
25015,64147,0,0,66,66,0,1,0,1,0
64808,27098,0,0,66,66,0,1,0,1,0
7588,1962,0,0,60,60,0,1,0,1,0
25067,50265,0,0,145,145,0,1,0,1,0
33401,51505,0,0,62,62,0,1,0,1,0
49570,5900,0,0,60,60,0,1,0,1,0
26053,33720,0,0,160,160,0,1,0,1,0
1024,29892,0,0,145,145,0,1,0,1,0
58638,5900,0,0,62,62,0,1,0,1,0
1955,35974,0,0,60,60,0,1,0,1,0
58638,5900,0,0,62,62,0,1,0,1,0
34176,51505,0,0,62,62,0,1,0,1,0
20650,26467,0,0,62,62,0,1,0,1,0
55874,64147,0,0,66,66,0,1,0,1,0
3667,56205,0,0,62,62,0,1,0,1,0
63331,51221,0,0,62,62,0,1,0,1,0
0,0,0,0,98,98,0,1,0,1,0
60605,3389,0,0,60,60,0,1,0,1,0
19594,23117,0,0,62,62,0,1,0,1,0
50424,55777,0,0,62,62,0,1,0,1,0
51130,61689,0,0,62,62,0,1,0,1,0
58638,5900,0,0,62,62,0,1,0,1,0
1227,56205,0,0,66,66,0,1,0,1,0
55116,7574,0,0,62,62,0,1,0,1,0
28110,22,0,0,60,60,0,1,0,1,0
32282,8604,0,0,62,62,0,1,0,1,0
63708,25174,0,0,62,62,0,1,0,1,0
43704,37965,0,0,66,66,0,1,0,1,0
53044,36237,0,0,62,62,0,1,0,1,0
50470,61463,0,0,86,86,0,1,0,1,0
50116,22,0,0,60,60,0,1,0,1,0
53676,35974,0,0,60,60,0,1,0,1,0
8999,52290,0,0,146,146,0,1,0,1,0
15854,50584,0,0,146,146,0,1,0,1,0
59486,50584,0,0,62,62,0,1,0,1,0
1262,23,0,0,60,60,0,1,0,1,0
55620,30188,0,0,66,66,0,1,0,1,0
1955,35974,0,0,60,60,0,1,0,1,0
57555,35440,0,0,66,66,0,1,0,1,0
46518,44847,0,0,146,146,0,1,0,1,0
45964,2228,0,0,60,60,0,1,0,1,0
6666,21,0,0,60,60,0,1,0,1,0
35194,57470,0,0,74,74,0,1,0,1,0
58638,5900,0,0,62,62,0,1,0,1,0
45941,23388,0,0,60,60,0,1,0,1,0
63577,30188,0,0,66,66,0,1,0,1,0
7000,23117,0,0,66,66,0,1,0,1,0
64035,25174,0,0,62,62,0,1,0,1,0
51525,35440,0,0,66,66,0,1,0,1,0
55713,25174,0,0,146,146,0,1,0,1,0
55496,64097,0,0,62,62,0,1,0,1,0
63397,26467,0,0,66,66,0,1,0,1,0
56909,50584,0,0,66,66,0,1,0,1,0
19875,30170,0,0,145,145,0,1,0,1,0
13160,7905,0,0,62,62,0,1,0,1,0
27300,36237,0,0,146,146,0,1,0,1,0
53166,61600,0,0,66,66,0,1,0,1,0
443,43775,0,0,97,97,0,1,0,1,0
63503,42707,0,0,66,66,0,1,0,1,0
23197,44847,0,0,62,62,0,1,0,1,0
50470,61463,0,0,86,86,0,1,0,1,0
52217,22114,0,0,66,66,0,1,0,1,0
56388,22114,0,0,66,66,0,1,0,1,0
55311,44847,0,0,66,66,0,1,0,1,0
3564,57470,0,0,62,62,0,1,0,1,0
28649,43890,0,0,62,62,0,1,0,1,0
24450,48817,0,0,157,157,0,1,0,1,0
52519,44847,0,0,66,66,0,1,0,1,0
24375,12809,0,0,60,60,0,1,0,1,0
3945,35440,0,0,66,66,0,1,0,1,0
29203,26467,0,0,62,62,0,1,0,1,0
64016,25174,0,0,62,62,0,1,0,1,0
63701,46824,0,0,66,66,0,1,0,1,0
23277,53733,0,0,62,62,0,1,0,1,0
58608,62413,0,0,62,62,0,1,0,1,0
58744,1433,0,0,60,60,0,1,0,1,0
39313,37965,0,0,62,62,0,1,0,1,0
56376,44847,0,0,66,66,0,1,0,1,0
443,20087,0,0,83,83,0,1,0,1,0
24376,50584,0,0,66,66,0,1,0,1,0
18085,26467,0,0,66,66,0,1,0,1,0
18357,51180,0,0,62,62,0,1,0,1,0
59934,35440,0,0,66,66,0,1,0,1,0
58638,5900,0,0,62,62,0,1,0,1,0
41852,35440,0,0,62,62,0,1,0,1,0
28973,30188,0,0,66,66,0,1,0,1,0
38306,51221,0,0,62,62,0,1,0,1,0
24534,50584,0,0,62,62,0,1,0,1,0
61183,25174,0,0,62,62,0,1,0,1,0
57969,42873,0,0,66,66,0,1,0,1,0
58638,5900,0,0,62,62,0,1,0,1,0
13413,44847,0,0,62,62,0,1,0,1,0
14183,26467,0,0,62,62,0,1,0,1,0
45964,2225,0,0,60,60,0,1,0,1,0
58638,5900,0,0,62,62,0,1,0,1,0
62250,23117,0,0,66,66,0,1,0,1,0
1943,48817,0,0,66,66,0,1,0,1,0
56039,50584,0,0,66,66,0,1,0,1,0
58638,5900,0,0,62,62,0,1,0,1,0
58638,5900,0,0,62,62,0,1,0,1,0
60579,25174,0,0,66,66,0,1,0,1,0
55144,30188,0,0,66,66,0,1,0,1,0
65501,57470,0,0,72,72,0,1,0,1,0
58638,5900,0,0,62,62,0,1,0,1,0
1536,48817,0,0,62,62,0,1,0,1,0
31727,57470,0,0,62,62,0,1,0,1,0
6889,11119,0,0,143,143,0,1,0,1,0
52095,56079,0,0,62,62,0,1,0,1,0
50321,18593,0,0,143,143,0,1,0,1,0
20400,64147,0,0,145,145,0,1,0,1,0
0,0,0,0,98,98,0,1,0,1,0
59692,57470,0,0,78,78,0,1,0,1,0
13840,37965,0,0,146,146,0,1,0,1,0
51453,64147,0,0,62,62,0,1,0,1,0
58148,43890,0,0,62,62,0,1,0,1,0
26881,25174,0,0,62,62,0,1,0,1,0
12942,10387,0,0,159,159,0,1,0,1,0
26531,37965,0,0,62,62,0,1,0,1,0
33710,22114,0,0,146,146,0,1,0,1,0
52989,51505,0,0,66,66,0,1,0,1,0
59889,30188,0,0,66,66,0,1,0,1,0
62183,57470,0,0,74,74,0,1,0,1,0
30456,36237,0,0,62,62,0,1,0,1,0
30179,23,0,0,60,60,0,1,0,1,0
10462,25174,0,0,146,146,0,1,0,1,0
45832,51050,0,0,62,62,0,1,0,1,0
51222,35440,0,0,62,62,0,1,0,1,0
49502,44847,0,0,66,66,0,1,0,1,0
50637,44847,0,0,62,62,0,1,0,1,0
19875,30170,0,0,145,145,0,1,0,1,0
27407,36237,0,0,146,146,0,1,0,1,0
26795,6881,0,0,146,146,0,1,0,1,0
55517,25174,0,0,66,66,0,1,0,1,0
21294,57470,0,0,62,62,0,1,0,1,0
33543,44847,0,0,66,66,0,1,0,1,0
10965,22114,0,0,146,146,0,1,0,1,0
54142,20541,0,0,66,66,0,1,0,1,0
28194,32468,0,0,62,62,0,1,0,1,0
32342,62413,0,0,66,66,0,1,0,1,0
50280,57470,0,0,78,78,0,1,0,1,0
58638,5900,0,0,62,62,0,1,0,1,0
59535,25174,0,0,62,62,0,1,0,1,0
21750,39004,0,0,62,62,0,1,0,1,0
59511,21247,0,0,66,66,0,1,0,1,0
46116,51505,0,0,62,62,0,1,0,1,0
60627,51050,0,0,62,62,0,1,0,1,0
47173,35440,0,0,62,62,0,1,0,1,0
59611,56205,0,0,62,62,0,1,0,1,0
50102,17546,0,0,66,66,0,1,0,1,0
58976,43890,0,0,66,66,0,1,0,1,0
57131,35776,0,0,145,145,0,1,0,1,0
56119,37965,0,0,62,62,0,1,0,1,0
58326,50584,0,0,62,62,0,1,0,1,0
61043,57470,0,0,78,78,0,1,0,1,0
56278,52752,0,0,62,62,0,1,0,1,0
1582,56205,0,0,62,62,0,1,0,1,0
3270,35440,0,0,62,62,0,1,0,1,0
9087,37965,0,0,62,62,0,1,0,1,0
55600,22,0,0,60,60,0,1,0,1,0
55427,64147,0,0,66,66,0,1,0,1,0
20650,26467,0,0,66,66,0,1,0,1,0
31281,30188,0,0,62,62,0,1,0,1,0
51728,44847,0,0,66,66,0,1,0,1,0
11777,37965,0,0,62,62,0,1,0,1,0
61234,48817,0,0,106,106,0,1,0,1,0
26888,23,0,0,60,60,0,1,0,1,0
50602,26467,0,0,66,66,0,1,0,1,0
30179,57470,0,0,60,60,0,1,0,1,0
7310,44847,0,0,66,66,0,1,0,1,0
26792,37965,0,0,62,62,0,1,0,1,0
42034,28189,0,0,62,62,0,1,0,1,0
30304,64147,0,0,66,66,0,1,0,1,0
56157,50584,0,0,66,66,0,1,0,1,0
54593,51505,0,0,62,62,0,1,0,1,0
1733,65448,0,0,66,66,0,1,0,1,0
52166,26467,0,0,66,66,0,1,0,1,0
55338,11744,0,0,145,145,0,1,0,1,0
53500,1,0,0,66,66,0,1,0,1,0
60610,58414,0,0,62,62,0,1,0,1,0
34470,57470,0,0,66,66,0,1,0,1,0
55408,64147,0,0,66,66,0,1,0,1,0
19270,56448,0,0,78,78,0,1,0,1,0
29577,64147,0,0,62,62,0,1,0,1,0
59126,57470,0,0,66,66,0,1,0,1,0
64279,23718,0,0,146,146,0,1,0,1,0
65018,7302,0,0,146,146,0,1,0,1,0
5223,44091,0,0,220,220,0,1,0,1,0
3818,37965,0,0,66,66,0,1,0,1,0
59699,55783,0,0,62,62,0,1,0,1,0
48676,53392,0,0,60,60,0,1,0,1,0
4127,26467,0,0,66,66,0,1,0,1,0
68,67,0,0,594,594,0,1,0,1,0
36992,25174,0,0,62,62,0,1,0,1,0
54545,49344,0,0,66,66,0,1,0,1,0
61624,30317,0,0,66,66,0,1,0,1,0
27898,52700,0,0,62,62,0,1,0,1,0
53667,56205,0,0,62,62,0,1,0,1,0
50424,55777,0,0,62,62,0,1,0,1,0
11842,23,0,0,60,60,0,1,0,1,0
50784,50584,0,0,62,62,0,1,0,1,0
64587,43890,0,0,62,62,0,1,0,1,0
38645,51221,0,0,62,62,0,1,0,1,0
59413,51505,0,0,62,62,0,1,0,1,0
42576,30188,0,0,146,146,0,1,0,1,0
9529,26467,0,0,62,62,0,1,0,1,0
9448,57866,0,0,62,62,0,1,0,1,0
59451,50584,0,0,66,66,0,1,0,1,0
6999,2310,0,0,143,143,0,1,0,1,0
63542,15503,0,0,66,66,0,1,0,1,0
8999,42873,0,0,146,146,0,1,0,1,0
54868,1433,0,0,60,60,0,1,0,1,0
57677,57470,0,0,62,62,0,1,0,1,0
63878,22114,0,0,62,62,0,1,0,1,0
58638,5900,0,0,62,62,0,1,0,1,0
32096,55108,0,0,139,139,0,1,0,1,0
43100,22114,0,0,146,146,0,1,0,1,0
58638,5900,0,0,62,62,0,1,0,1,0
41840,50584,0,0,66,66,0,1,0,1,0
1873,37965,0,0,62,62,0,1,0,1,0
33886,52255,0,0,162,162,0,1,0,1,0
1534,54369,0,0,66,66,0,1,0,1,0
41220,59356,0,0,62,62,0,1,0,1,0
55341,39004,0,0,74,74,0,1,0,1,0
64334,25174,0,0,62,62,0,1,0,1,0
20576,37965,0,0,62,62,0,1,0,1,0
29512,30188,0,0,62,62,0,1,0,1,0
6712,44818,0,0,66,66,0,1,0,1,0
56636,43890,0,0,66,66,0,1,0,1,0
53844,22114,0,0,66,66,0,1,0,1,0
40095,23,0,0,60,60,0,1,0,1,0
13285,29892,0,0,145,145,0,1,0,1,0
48826,25174,0,0,62,62,0,1,0,1,0
59934,35440,0,0,62,62,0,1,0,1,0
48448,48817,0,0,66,66,0,1,0,1,0
22922,35440,0,0,66,66,0,1,0,1,0
14925,57470,0,0,145,145,0,1,0,1,0
18415,37965,0,0,62,62,0,1,0,1,0
48676,53392,0,0,60,60,0,1,0,1,0
1053,2310,0,0,148,148,0,1,0,1,0
61550,5529,0,0,145,145,0,1,0,1,0
65153,38303,0,0,66,66,0,1,0,1,0
48125,7558,0,0,60,60,0,1,0,1,0
51339,50584,0,0,66,66,0,1,0,1,0
25222,37965,0,0,62,62,0,1,0,1,0
36258,23,0,0,60,60,0,1,0,1,0
63895,44847,0,0,62,62,0,1,0,1,0
58638,5900,0,0,62,62,0,1,0,1,0
10480,26467,0,0,62,62,0,1,0,1,0
28795,37965,0,0,62,62,0,1,0,1,0
57220,26467,0,0,66,66,0,1,0,1,0
50901,26467,0,0,66,66,0,1,0,1,0
6037,43890,0,0,70,70,0,1,0,1,0
10006,64147,0,0,62,62,0,1,0,1,0
20682,57470,0,0,62,62,0,1,0,1,0
58381,57470,0,0,66,66,0,1,0,1,0
1638,22114,0,0,62,62,0,1,0,1,0
55759,5900,0,0,60,60,0,1,0,1,0
2541,51505,0,0,66,66,0,1,0,1,0
443,4512,0,0,60,60,0,1,0,1,0
57500,23,0,0,60,60,0,1,0,1,0
19623,25174,0,0,62,62,0,1,0,1,0
26497,64147,0,0,66,66,0,1,0,1,0
55919,64147,0,0,62,62,0,1,0,1,0
42344,48637,0,0,60,60,0,1,0,1,0
54631,44847,0,0,74,74,0,1,0,1,0
15605,50265,0,0,62,62,0,1,0,1,0
1660,8696,0,0,62,62,0,1,0,1,0
30303,30303,0,0,171,171,0,1,0,1,0
53779,51505,0,0,66,66,0,1,0,1,0
28040,64147,0,0,62,62,0,1,0,1,0
38565,51505,0,0,66,66,0,1,0,1,0
47962,16069,0,0,62,62,0,1,0,1,0
50946,44847,0,0,66,66,0,1,0,1,0
38852,37965,0,0,62,62,0,1,0,1,0
56491,56205,0,0,146,146,0,1,0,1,0
57478,7302,0,0,66,66,0,1,0,1,0
57459,51505,0,0,66,66,0,1,0,1,0
1377,44847,0,0,62,62,0,1,0,1,0
37234,44847,0,0,66,66,0,1,0,1,0
65270,3855,0,0,78,78,0,1,0,1,0
58638,5900,0,0,62,62,0,1,0,1,0
1582,56205,0,0,62,62,0,1,0,1,0
1024,57470,0,0,72,72,0,1,0,1,0
40797,25174,0,0,62,62,0,1,0,1,0
48706,23393,0,0,60,60,0,1,0,1,0
6666,62078,0,0,60,60,0,1,0,1,0
59745,53635,0,0,66,66,0,1,0,1,0
51550,11392,0,0,66,66,0,1,0,1,0
54011,44847,0,0,66,66,0,1,0,1,0
59763,25604,0,0,62,62,0,1,0,1,0
55136,11392,0,0,62,62,0,1,0,1,0
58303,22114,0,0,62,62,0,1,0,1,0
31974,51505,0,0,66,66,0,1,0,1,0
28999,37807,0,0,62,62,0,1,0,1,0
45964,2666,0,0,60,60,0,1,0,1,0
55056,44512,0,0,62,62,0,1,0,1,0
28192,50584,0,0,66,66,0,1,0,1,0
16322,57470,0,0,62,62,0,1,0,1,0
49690,50265,0,0,62,62,0,1,0,1,0
63910,44847,0,0,66,66,0,1,0,1,0
30181,61689,0,0,62,62,0,1,0,1,0
64677,57470,0,0,66,66,0,1,0,1,0
42951,22114,0,0,66,66,0,1,0,1,0
4438,23,0,0,60,60,0,1,0,1,0
62765,16933,0,0,66,66,0,1,0,1,0
61808,18375,0,0,66,66,0,1,0,1,0
443,44138,0,0,60,60,0,1,0,1,0
10754,28793,0,0,66,66,0,1,0,1,0
52210,51505,0,0,66,66,0,1,0,1,0
52024,25174,0,0,62,62,0,1,0,1,0
56098,64147,0,0,66,66,0,1,0,1,0
20389,64147,0,0,62,62,0,1,0,1,0
10003,64147,0,0,62,62,0,1,0,1,0
57283,64147,0,0,66,66,0,1,0,1,0
1035,26467,0,0,62,62,0,1,0,1,0
64815,37965,0,0,66,66,0,1,0,1,0
58721,51505,0,0,66,66,0,1,0,1,0
51953,37965,0,0,66,66,0,1,0,1,0
32551,51221,0,0,66,66,0,1,0,1,0
41898,22114,0,0,146,146,0,1,0,1,0
64878,26467,0,0,62,62,0,1,0,1,0
22346,51505,0,0,62,62,0,1,0,1,0
55386,32480,0,0,66,66,0,1,0,1,0
33931,50584,0,0,62,62,0,1,0,1,0
51930,57470,0,0,62,62,0,1,0,1,0
56369,22114,0,0,62,62,0,1,0,1,0
64437,56205,0,0,66,66,0,1,0,1,0
51999,37965,0,0,62,62,0,1,0,1,0
62273,50584,0,0,66,66,0,1,0,1,0
61865,35440,0,0,66,66,0,1,0,1,0
59055,11392,0,0,66,66,0,1,0,1,0
55732,5900,0,0,60,60,0,1,0,1,0
58638,5900,0,0,62,62,0,1,0,1,0
16330,50584,0,0,146,146,0,1,0,1,0
59192,25174,0,0,66,66,0,1,0,1,0
53532,22114,0,0,62,62,0,1,0,1,0
5637,37965,0,0,62,62,0,1,0,1,0
43916,21,0,0,60,60,0,1,0,1,0
2383,37965,0,0,66,66,0,1,0,1,0
16524,22114,0,0,62,62,0,1,0,1,0
29139,64147,0,0,62,62,0,1,0,1,0
65317,51221,0,0,78,78,0,1,0,1,0
11951,45026,0,0,60,60,0,1,0,1,0
64166,35440,0,0,66,66,0,1,0,1,0
54773,50584,0,0,62,62,0,1,0,1,0
58638,5900,0,0,62,62,0,1,0,1,0
38484,48637,0,0,60,60,0,1,0,1,0
443,35385,0,0,66,66,0,1,0,1,0
65493,51221,0,0,62,62,0,1,0,1,0
65501,26467,0,0,66,66,0,1,0,1,0
54539,26467,0,0,62,62,0,1,0,1,0
58326,50584,0,0,146,146,0,1,0,1,0
30496,57470,0,0,62,62,0,1,0,1,0
44612,25174,0,0,66,66,0,1,0,1,0
50442,37807,0,0,66,66,0,1,0,1,0
27642,23,0,0,60,60,0,1,0,1,0
35974,23,0,0,60,60,0,1,0,1,0
61550,5529,0,0,145,145,0,1,0,1,0
33215,37965,0,0,62,62,0,1,0,1,0
60403,22114,0,0,66,66,0,1,0,1,0
52459,5555,0,0,60,60,0,1,0,1,0
57607,21247,0,0,66,66,0,1,0,1,0
3478,61463,0,0,928,928,0,1,0,1,0
45941,23388,0,0,60,60,0,1,0,1,0
49716,5900,0,0,60,60,0,1,0,1,0
14869,44847,0,0,62,62,0,1,0,1,0
52494,36237,0,0,146,146,0,1,0,1,0
58085,57470,0,0,66,66,0,1,0,1,0
43155,35440,0,0,66,66,0,1,0,1,0
58638,5900,0,0,62,62,0,1,0,1,0
58638,5900,0,0,62,62,0,1,0,1,0
28875,51505,0,0,146,146,0,1,0,1,0
44594,64147,0,0,66,66,0,1,0,1,0
3478,61463,0,0,743,743,0,1,0,1,0
50052,65008,0,0,60,60,0,1,0,1,0
4793,50584,0,0,66,66,0,1,0,1,0
65285,50584,0,0,62,62,0,1,0,1,0
36080,26467,0,0,62,62,0,1,0,1,0
60180,31573,0,0,146,146,0,1,0,1,0
64727,25174,0,0,66,66,0,1,0,1,0
60248,30188,0,0,62,62,0,1,0,1,0
48478,49903,0,0,62,62,0,1,0,1,0
30542,25174,0,0,62,62,0,1,0,1,0
64219,51050,0,0,66,66,0,1,0,1,0
51783,50584,0,0,62,62,0,1,0,1,0
58638,5900,0,0,62,62,0,1,0,1,0
58638,5900,0,0,62,62,0,1,0,1,0
19875,30170,0,0,145,145,0,1,0,1,0
35207,22114,0,0,62,62,0,1,0,1,0
48430,22,0,0,60,60,0,1,0,1,0
3478,61463,0,0,1162,1162,0,1,0,1,0
58638,5900,0,0,62,62,0,1,0,1,0
63813,26467,0,0,66,66,0,1,0,1,0
31974,51505,0,0,66,66,0,1,0,1,0
2695,48817,0,0,62,62,0,1,0,1,0
3225,64147,0,0,62,62,0,1,0,1,0
52925,3389,0,0,60,60,0,1,0,1,0
56494,3033,0,0,146,146,0,1,0,1,0
34677,51185,0,0,60,60,0,1,0,1,0
53015,64147,0,0,145,145,0,1,0,1,0
57917,44847,0,0,66,66,0,1,0,1,0
34400,39004,0,0,74,74,0,1,0,1,0
4127,26467,0,0,66,66,0,1,0,1,0
45304,64147,0,0,72,72,0,1,0,1,0
42231,57470,0,0,78,78,0,1,0,1,0
51558,37965,0,0,72,72,0,1,0,1,0
56131,37807,0,0,66,66,0,1,0,1,0
22922,35440,0,0,62,62,0,1,0,1,0
10701,11392,0,0,146,146,0,1,0,1,0
52208,43890,0,0,66,66,0,1,0,1,0
52146,1433,0,0,60,60,0,1,0,1,0
37213,36237,0,0,66,66,0,1,0,1,0
43207,26467,0,0,62,62,0,1,0,1,0
59095,57470,0,0,66,66,0,1,0,1,0
23415,11392,0,0,62,62,0,1,0,1,0
10532,26672,0,0,60,60,0,1,0,1,0
443,3846,0,0,100,100,0,1,0,1,0
49855,36180,0,0,62,62,0,1,0,1,0
9283,57470,0,0,66,66,0,1,0,1,0
29697,51221,0,0,62,62,0,1,0,1,0
8211,28793,0,0,66,66,0,1,0,1,0
56367,44847,0,0,62,62,0,1,0,1,0
443,45940,0,0,85,85,0,1,0,1,0
23519,25174,0,0,146,146,0,1,0,1,0
47063,15503,0,0,62,62,0,1,0,1,0
43271,50584,0,0,62,62,0,1,0,1,0
45472,8168,0,0,62,62,0,1,0,1,0
21892,15503,0,0,62,62,0,1,0,1,0
61845,11392,0,0,66,66,0,1,0,1,0
54109,36829,0,0,66,66,0,1,0,1,0
62348,51221,0,0,72,72,0,1,0,1,0
63190,35440,0,0,62,62,0,1,0,1,0
44933,23,0,0,60,60,0,1,0,1,0
993,49276,0,0,129,129,0,1,0,1,0
64756,11392,0,0,146,146,0,1,0,1,0
1025,35447,0,0,62,62,0,1,0,1,0
11859,64147,0,0,62,62,0,1,0,1,0
59095,57470,0,0,66,66,0,1,0,1,0
51592,51505,0,0,62,62,0,1,0,1,0
20962,22114,0,0,62,62,0,1,0,1,0
27785,37965,0,0,66,66,0,1,0,1,0
57325,60043,0,0,66,66,0,1,0,1,0
52860,9694,0,0,146,146,0,1,0,1,0
52633,30188,0,0,66,66,0,1,0,1,0
28192,50584,0,0,66,66,0,1,0,1,0
58475,11392,0,0,66,66,0,1,0,1,0
993,3979,0,0,129,129,0,1,0,1,0
55770,64147,0,0,66,66,0,1,0,1,0
59196,34962,0,0,148,148,0,1,0,1,0
2946,25174,0,0,146,146,0,1,0,1,0
59918,44847,0,0,66,66,0,1,0,1,0
42034,28189,0,0,62,62,0,1,0,1,0
59153,35440,0,0,62,62,0,1,0,1,0
49514,65504,0,0,162,162,0,1,0,1,0
36357,25174,0,0,66,66,0,1,0,1,0
32609,64097,0,0,62,62,0,1,0,1,0
61804,51505,0,0,66,66,0,1,0,1,0
55484,25174,0,0,62,62,0,1,0,1,0
50851,25864,0,0,74,74,0,1,0,1,0
1987,26467,0,0,62,62,0,1,0,1,0
15333,44847,0,0,146,146,0,1,0,1,0
53500,1,0,0,66,66,0,1,0,1,0
19156,3846,0,0,145,145,0,1,0,1,0
45964,2225,0,0,60,60,0,1,0,1,0
26879,37965,0,0,145,145,0,1,0,1,0
51544,44847,0,0,146,146,0,1,0,1,0
515,10214,0,0,62,62,0,1,0,1,0
1063,7302,0,0,62,62,0,1,0,1,0
49426,57470,0,0,62,62,0,1,0,1,0
27745,50584,0,0,62,62,0,1,0,1,0
37420,44847,0,0,66,66,0,1,0,1,0
1024,44847,0,0,146,146,0,1,0,1,0
63456,37965,0,0,62,62,0,1,0,1,0
4000,44847,0,0,66,66,0,1,0,1,0
53626,30317,0,0,66,66,0,1,0,1,0
56835,35894,0,0,66,66,0,1,0,1,0
6356,26467,0,0,62,62,0,1,0,1,0
48298,2043,0,0,60,60,0,1,0,1,0
61808,18375,0,0,66,66,0,1,0,1,0
62731,21247,0,0,62,62,0,1,0,1,0
64940,36237,0,0,62,62,0,1,0,1,0
37008,42707,0,0,62,62,0,1,0,1,0
55238,21247,0,0,62,62,0,1,0,1,0
58925,25174,0,0,66,66,0,1,0,1,0
2780,23117,0,0,66,66,0,1,0,1,0
3478,61463,0,0,928,928,0,1,0,1,0
3478,61463,0,0,686,686,0,1,0,1,0
1024,60043,0,0,145,145,0,1,0,1,0
56249,55442,0,0,66,66,0,1,0,1,0
53822,25174,0,0,66,66,0,1,0,1,0
26629,56079,0,0,62,62,0,1,0,1,0
56876,30188,0,0,66,66,0,1,0,1,0
7444,57470,0,0,66,66,0,1,0,1,0
48025,44847,0,0,62,62,0,1,0,1,0
38741,37965,0,0,146,146,0,1,0,1,0
47944,50584,0,0,62,62,0,1,0,1,0
53971,50265,0,0,66,66,0,1,0,1,0
51109,11392,0,0,66,66,0,1,0,1,0
64104,22114,0,0,62,62,0,1,0,1,0
17262,25174,0,0,62,62,0,1,0,1,0
19632,37965,0,0,62,62,0,1,0,1,0
27824,51505,0,0,62,62,0,1,0,1,0
52519,44847,0,0,66,66,0,1,0,1,0
58638,5900,0,0,62,62,0,1,0,1,0
58922,57470,0,0,66,66,0,1,0,1,0
58638,5900,0,0,62,62,0,1,0,1,0
55116,7574,0,0,66,66,0,1,0,1,0
51726,64147,0,0,66,66,0,1,0,1,0
53166,61600,0,0,62,62,0,1,0,1,0
22530,25174,0,0,62,62,0,1,0,1,0
63984,25174,0,0,146,146,0,1,0,1,0
17640,55442,0,0,66,66,0,1,0,1,0
61420,64097,0,0,62,62,0,1,0,1,0
48840,50584,0,0,62,62,0,1,0,1,0
27343,55839,0,0,137,137,0,1,0,1,0
56400,35440,0,0,66,66,0,1,0,1,0
30129,37965,0,0,72,72,0,1,0,1,0
58118,22114,0,0,66,66,0,1,0,1,0
58022,9200,0,0,60,60,0,1,0,1,0
27621,50584,0,0,62,62,0,1,0,1,0
443,10010,0,0,60,60,0,1,0,1,0
63116,22114,0,0,62,62,0,1,0,1,0
51535,44847,0,0,62,62,0,1,0,1,0
42865,55839,0,0,137,137,0,1,0,1,0
47357,50584,0,0,66,66,0,1,0,1,0
62744,62413,0,0,66,66,0,1,0,1,0
51676,23718,0,0,66,66,0,1,0,1,0
30861,46783,0,0,62,62,0,1,0,1,0
44854,26467,0,0,62,62,0,1,0,1,0
59845,44847,0,0,66,66,0,1,0,1,0
443,32698,0,0,89,89,0,1,0,1,0
56922,29434,0,0,107,107,0,1,0,1,0
14103,35440,0,0,62,62,0,1,0,1,0
58638,5900,0,0,62,62,0,1,0,1,0
51310,64147,0,0,62,62,0,1,0,1,0
7749,36237,0,0,66,66,0,1,0,1,0
55201,26467,0,0,62,62,0,1,0,1,0
42366,57470,0,0,66,66,0,1,0,1,0
53779,37965,0,0,66,66,0,1,0,1,0
51944,56205,0,0,66,66,0,1,0,1,0
3578,51505,0,0,66,66,0,1,0,1,0
55123,64097,0,0,66,66,0,1,0,1,0
33405,37965,0,0,62,62,0,1,0,1,0
53406,44847,0,0,66,66,0,1,0,1,0
46495,4607,0,0,60,60,0,1,0,1,0
59377,9319,0,0,62,62,0,1,0,1,0
50788,48817,0,0,62,62,0,1,0,1,0
59874,22114,0,0,66,66,0,1,0,1,0
8239,37965,0,0,146,146,0,1,0,1,0
58638,5900,0,0,62,62,0,1,0,1,0
52658,64147,0,0,145,145,0,1,0,1,0
31112,50584,0,0,66,66,0,1,0,1,0
61461,50584,0,0,66,66,0,1,0,1,0
49818,37965,0,0,66,66,0,1,0,1,0
63173,36237,0,0,62,62,0,1,0,1,0
5223,14446,0,0,220,220,0,1,0,1,0
26699,35253,0,0,62,62,0,1,0,1,0
26082,26296,0,0,159,159,0,1,0,1,0
3478,61463,0,0,252,252,0,1,0,1,0
18291,37807,0,0,146,146,0,1,0,1,0
14923,51505,0,0,66,66,0,1,0,1,0
55562,50584,0,0,66,66,0,1,0,1,0
59949,44847,0,0,66,66,0,1,0,1,0
9687,57470,0,0,78,78,0,1,0,1,0
42973,57470,0,0,62,62,0,1,0,1,0
55862,62413,0,0,66,66,0,1,0,1,0
7356,25174,0,0,66,66,0,1,0,1,0
6666,5000,0,0,60,60,0,1,0,1,0
28040,64147,0,0,66,66,0,1,0,1,0
38053,50584,0,0,62,62,0,1,0,1,0
58638,5900,0,0,62,62,0,1,0,1,0
42252,33303,0,0,60,60,0,1,0,1,0
48706,23393,0,0,60,60,0,1,0,1,0
5200,6643,0,0,145,145,0,1,0,1,0
58638,5900,0,0,62,62,0,1,0,1,0
58550,21247,0,0,66,66,0,1,0,1,0
54166,25174,0,0,66,66,0,1,0,1,0
63023,51505,0,0,66,66,0,1,0,1,0
443,60496,0,0,320,320,0,1,0,1,0
59227,11392,0,0,62,62,0,1,0,1,0
58638,5900,0,0,62,62,0,1,0,1,0
45269,50584,0,0,62,62,0,1,0,1,0
1036,64147,0,0,62,62,0,1,0,1,0
63627,26296,0,0,159,159,0,1,0,1,0
48929,62609,0,0,148,148,0,1,0,1,0
63982,25174,0,0,62,62,0,1,0,1,0
58638,5900,0,0,62,62,0,1,0,1,0
58638,5900,0,0,62,62,0,1,0,1,0
1712,23,0,0,60,60,0,1,0,1,0
36154,47807,0,0,146,146,0,1,0,1,0
39213,25174,0,0,62,62,0,1,0,1,0
12531,22114,0,0,146,146,0,1,0,1,0
45682,37965,0,0,62,62,0,1,0,1,0
3521,6881,0,0,66,66,0,1,0,1,0
33503,5529,0,0,146,146,0,1,0,1,0
54575,11392,0,0,66,66,0,1,0,1,0
61744,11392,0,0,66,66,0,1,0,1,0
63717,37965,0,0,66,66,0,1,0,1,0
49938,57470,0,0,66,66,0,1,0,1,0
51414,22,0,0,60,60,0,1,0,1,0
57665,52700,0,0,66,66,0,1,0,1,0
56897,11446,0,0,66,66,0,1,0,1,0
38093,11392,0,0,62,62,0,1,0,1,0
60426,57470,0,0,62,62,0,1,0,1,0
62731,21247,0,0,66,66,0,1,0,1,0
45218,25174,0,0,62,62,0,1,0,1,0
53650,64147,0,0,62,62,0,1,0,1,0
3478,61463,0,0,174,174,0,1,0,1,0
58638,5900,0,0,62,62,0,1,0,1,0
18001,35440,0,0,146,146,0,1,0,1,0
57987,56125,0,0,90,90,0,1,0,1,0
61382,25174,0,0,66,66,0,1,0,1,0
443,54507,0,0,82,82,0,1,0,1,0
36945,23,0,0,60,60,0,1,0,1,0
43671,17372,0,0,62,62,0,1,0,1,0
5894,44847,0,0,62,62,0,1,0,1,0
3478,61463,0,0,68,68,0,1,0,1,0
50914,51505,0,0,66,66,0,1,0,1,0
55825,52700,0,0,62,62,0,1,0,1,0
60058,25174,0,0,66,66,0,1,0,1,0
10425,23,0,0,60,60,0,1,0,1,0
38484,48637,0,0,60,60,0,1,0,1,0
39531,19473,0,0,62,62,0,1,0,1,0
55600,22,0,0,60,60,0,1,0,1,0
62575,12207,0,0,66,66,0,1,0,1,0
63878,22114,0,0,62,62,0,1,0,1,0
16862,21247,0,0,62,62,0,1,0,1,0
14336,64147,0,0,62,62,0,1,0,1,0
59326,57470,0,0,74,74,0,1,0,1,0
51183,56205,0,0,66,66,0,1,0,1,0
58638,5900,0,0,62,62,0,1,0,1,0
50067,64147,0,0,66,66,0,1,0,1,0
36903,56205,0,0,146,146,0,1,0,1,0
22948,26467,0,0,62,62,0,1,0,1,0
51865,61689,0,0,66,66,0,1,0,1,0
58497,39004,0,0,66,66,0,1,0,1,0
60294,30188,0,0,62,62,0,1,0,1,0
59241,62413,0,0,66,66,0,1,0,1,0
50577,23,0,0,60,60,0,1,0,1,0
49336,25174,0,0,66,66,0,1,0,1,0
51244,14984,0,0,100,100,0,1,0,1,0
7968,2767,0,0,66,66,0,1,0,1,0
1903,43890,0,0,62,62,0,1,0,1,0
58638,5900,0,0,62,62,0,1,0,1,0
58638,5900,0,0,62,62,0,1,0,1,0
58672,43890,0,0,66,66,0,1,0,1,0
13166,57470,0,0,62,62,0,1,0,1,0
20962,22114,0,0,62,62,0,1,0,1,0
60976,22114,0,0,66,66,0,1,0,1,0
1574,50584,0,0,62,62,0,1,0,1,0
62971,44847,0,0,66,66,0,1,0,1,0
58638,5900,0,0,62,62,0,1,0,1,0
51920,30188,0,0,66,66,0,1,0,1,0
20726,2767,0,0,66,66,0,1,0,1,0
9605,57470,0,0,62,62,0,1,0,1,0
51291,25174,0,0,62,62,0,1,0,1,0
25197,1433,0,0,60,60,0,1,0,1,0
61185,54532,0,0,145,145,0,1,0,1,0
58687,11392,0,0,66,66,0,1,0,1,0
56999,25174,0,0,62,62,0,1,0,1,0
17270,44847,0,0,146,146,0,1,0,1,0
57964,44847,0,0,62,62,0,1,0,1,0
54601,26467,0,0,62,62,0,1,0,1,0
443,23622,0,0,74,74,0,1,0,1,0
57165,34101,0,0,62,62,0,1,0,1,0
53816,22114,0,0,146,146,0,1,0,1,0
34932,38608,0,0,62,62,0,1,0,1,0
7275,39827,0,0,74,74,0,1,0,1,0
80,37649,0,0,60,60,0,1,0,1,0
42231,57470,0,0,78,78,0,1,0,1,0
7310,44847,0,0,66,66,0,1,0,1,0
50116,22,0,0,60,60,0,1,0,1,0
60462,47967,0,0,148,148,0,1,0,1,0
29080,50265,0,0,62,62,0,1,0,1,0
2886,35440,0,0,66,66,0,1,0,1,0
54021,25174,0,0,146,146,0,1,0,1,0
58399,56205,0,0,66,66,0,1,0,1,0
1323,64147,0,0,66,66,0,1,0,1,0
16430,31573,0,0,62,62,0,1,0,1,0
6881,6881,0,0,62,62,0,1,0,1,0
26110,2310,0,0,148,148,0,1,0,1,0
51866,22114,0,0,62,62,0,1,0,1,0
28897,35440,0,0,66,66,0,1,0,1,0
46162,25174,0,0,62,62,0,1,0,1,0
58638,5900,0,0,62,62,0,1,0,1,0
52339,26467,0,0,66,66,0,1,0,1,0
24376,50584,0,0,62,62,0,1,0,1,0
58638,5900,0,0,62,62,0,1,0,1,0
59355,51505,0,0,66,66,0,1,0,1,0
55893,45711,0,0,78,78,0,1,0,1,0
19367,35440,0,0,146,146,0,1,0,1,0
57339,50584,0,0,66,66,0,1,0,1,0
10467,25174,0,0,62,62,0,1,0,1,0
15806,11392,0,0,66,66,0,1,0,1,0
11552,44847,0,0,146,146,0,1,0,1,0
62575,12207,0,0,66,66,0,1,0,1,0
58638,5900,0,0,62,62,0,1,0,1,0
51617,21247,0,0,66,66,0,1,0,1,0
41176,64147,0,0,145,145,0,1,0,1,0
32051,37965,0,0,62,62,0,1,0,1,0
65512,44847,0,0,66,66,0,1,0,1,0
8560,50584,0,0,66,66,0,1,0,1,0
10669,49756,0,0,60,60,0,1,0,1,0
39313,37965,0,0,62,62,0,1,0,1,0
8211,28793,0,0,66,66,0,1,0,1,0
62424,37965,0,0,62,62,0,1,0,1,0
443,62732,0,0,332,332,0,1,0,1,0
7992,64147,0,0,62,62,0,1,0,1,0
45964,2225,0,0,60,60,0,1,0,1,0
58535,30317,0,0,62,62,0,1,0,1,0
50298,37965,0,0,66,66,0,1,0,1,0
42332,22114,0,0,66,66,0,1,0,1,0
10775,35440,0,0,66,66,0,1,0,1,0
27442,44847,0,0,62,62,0,1,0,1,0
64878,26467,0,0,62,62,0,1,0,1,0
6889,9074,0,0,143,143,0,1,0,1,0
55835,62413,0,0,66,66,0,1,0,1,0
27783,57470,0,0,62,62,0,1,0,1,0
54742,50584,0,0,66,66,0,1,0,1,0
58276,43890,0,0,66,66,0,1,0,1,0
45941,23386,0,0,60,60,0,1,0,1,0
1480,12447,0,0,62,62,0,1,0,1,0
58638,5900,0,0,62,62,0,1,0,1,0
58638,5900,0,0,62,62,0,1,0,1,0
28832,36237,0,0,66,66,0,1,0,1,0
32648,55108,0,0,145,145,0,1,0,1,0
52914,37965,0,0,66,66,0,1,0,1,0
9018,23,0,0,60,60,0,1,0,1,0
1530,62413,0,0,62,62,0,1,0,1,0
46116,57470,0,0,74,74,0,1,0,1,0
45726,64147,0,0,62,62,0,1,0,1,0
18011,44847,0,0,66,66,0,1,0,1,0
53815,44847,0,0,66,66,0,1,0,1,0
8889,52294,0,0,60,60,0,1,0,1,0
51745,57470,0,0,62,62,0,1,0,1,0
7041,37965,0,0,66,66,0,1,0,1,0
49915,35440,0,0,62,62,0,1,0,1,0
14692,25174,0,0,62,62,0,1,0,1,0
53353,26467,0,0,62,62,0,1,0,1,0
51382,56205,0,0,62,62,0,1,0,1,0
40772,15503,0,0,74,74,0,1,0,1,0
8884,2323,0,0,60,60,0,1,0,1,0
44981,57470,0,0,66,66,0,1,0,1,0
55406,25174,0,0,66,66,0,1,0,1,0
51922,44847,0,0,66,66,0,1,0,1,0
59326,57470,0,0,74,74,0,1,0,1,0
4540,23,0,0,60,60,0,1,0,1,0
58638,5900,0,0,62,62,0,1,0,1,0
6881,6881,0,0,62,62,0,1,0,1,0
7226,50584,0,0,62,62,0,1,0,1,0
26235,37965,0,0,66,66,0,1,0,1,0
36656,64147,0,0,62,62,0,1,0,1,0
53207,50584,0,0,66,66,0,1,0,1,0
25620,50432,0,0,146,146,0,1,0,1,0
58638,5900,0,0,62,62,0,1,0,1,0
53194,35440,0,0,66,66,0,1,0,1,0
56442,11392,0,0,62,62,0,1,0,1,0
43333,50584,0,0,146,146,0,1,0,1,0
20005,37965,0,0,62,62,0,1,0,1,0
29512,30188,0,0,66,66,0,1,0,1,0
43461,35440,0,0,62,62,0,1,0,1,0
25565,62979,0,0,60,60,0,1,0,1,0
443,28417,0,0,82,82,0,1,0,1,0
6666,8530,0,0,60,60,0,1,0,1,0
59803,22114,0,0,62,62,0,1,0,1,0
59876,44847,0,0,66,66,0,1,0,1,0
56453,37965,0,0,62,62,0,1,0,1,0
443,48346,0,0,81,81,0,1,0,1,0
57504,44847,0,0,66,66,0,1,0,1,0
58079,50584,0,0,66,66,0,1,0,1,0
16944,50584,0,0,62,62,0,1,0,1,0
65317,51221,0,0,78,78,0,1,0,1,0
2919,57866,0,0,66,66,0,1,0,1,0
26408,64147,0,0,66,66,0,1,0,1,0
6999,11119,0,0,143,143,0,1,0,1,0
44147,64147,0,0,62,62,0,1,0,1,0
42968,56205,0,0,62,62,0,1,0,1,0
25202,25174,0,0,62,62,0,1,0,1,0
40512,57470,0,0,74,74,0,1,0,1,0
51754,18375,0,0,62,62,0,1,0,1,0
22724,9822,0,0,62,62,0,1,0,1,0
443,14591,0,0,100,100,0,1,0,1,0
59032,25174,0,0,66,66,0,1,0,1,0
2332,35440,0,0,66,66,0,1,0,1,0
19875,30170,0,0,145,145,0,1,0,1,0
48706,23393,0,0,60,60,0,1,0,1,0
54134,64147,0,0,66,66,0,1,0,1,0
57779,22114,0,0,146,146,0,1,0,1,0
61369,64147,0,0,66,66,0,1,0,1,0
49001,40108,0,0,161,161,0,1,0,1,0
6057,51221,0,0,78,78,0,1,0,1,0
56944,35894,0,0,62,62,0,1,0,1,0
58638,5900,0,0,62,62,0,1,0,1,0
16387,24782,0,0,60,60,0,1,0,1,0
2572,35440,0,0,66,66,0,1,0,1,0
48025,44847,0,0,62,62,0,1,0,1,0
61523,37807,0,0,66,66,0,1,0,1,0
16716,57470,0,0,145,145,0,1,0,1,0
17315,11392,0,0,62,62,0,1,0,1,0
63433,57866,0,0,62,62,0,1,0,1,0
50084,26672,0,0,62,62,0,1,0,1,0
17171,22114,0,0,66,66,0,1,0,1,0
23553,37965,0,0,62,62,0,1,0,1,0
25085,30188,0,0,66,66,0,1,0,1,0
52514,23,0,0,60,60,0,1,0,1,0
2904,44847,0,0,78,78,0,1,0,1,0
48676,53395,0,0,60,60,0,1,0,1,0
43260,41615,0,0,145,145,0,1,0,1,0
43916,21,0,0,60,60,0,1,0,1,0
5,47993,0,0,62,62,0,1,0,1,0
9448,57866,0,0,146,146,0,1,0,1,0
16057,56205,0,0,62,62,0,1,0,1,0
11136,15503,0,0,62,62,0,1,0,1,0
28809,50584,0,0,66,66,0,1,0,1,0
1024,25174,0,0,62,62,0,1,0,1,0
34916,51185,0,0,62,62,0,1,0,1,0
63347,25174,0,0,66,66,0,1,0,1,0
57768,37965,0,0,66,66,0,1,0,1,0
41694,26296,0,0,145,145,0,1,0,1,0
64106,64147,0,0,62,62,0,1,0,1,0
51655,26467,0,0,62,62,0,1,0,1,0
61766,44847,0,0,66,66,0,1,0,1,0
60423,35440,0,0,62,62,0,1,0,1,0
58638,5900,0,0,62,62,0,1,0,1,0
53676,35974,0,0,60,60,0,1,0,1,0
43916,21,0,0,60,60,0,1,0,1,0
29145,8168,0,0,62,62,0,1,0,1,0
33215,37965,0,0,62,62,0,1,0,1,0
48676,53393,0,0,60,60,0,1,0,1,0
38645,51221,0,0,62,62,0,1,0,1,0
62632,35440,0,0,66,66,0,1,0,1,0
27081,10197,0,0,62,62,0,1,0,1,0
46478,64147,0,0,145,145,0,1,0,1,0
58638,5900,0,0,62,62,0,1,0,1,0
56943,44847,0,0,62,62,0,1,0,1,0
57226,51505,0,0,66,66,0,1,0,1,0
25565,44521,0,0,60,60,0,1,0,1,0
62688,32480,0,0,109,109,0,1,0,1,0
61451,17500,0,0,66,66,0,1,0,1,0
23553,37965,0,0,62,62,0,1,0,1,0
45941,23386,0,0,60,60,0,1,0,1,0
45682,37965,0,0,62,62,0,1,0,1,0
9745,26467,0,0,62,62,0,1,0,1,0
51032,30188,0,0,66,66,0,1,0,1,0
3945,35440,0,0,66,66,0,1,0,1,0
18130,25174,0,0,62,62,0,1,0,1,0
443,54154,0,0,60,60,0,1,0,1,0
51446,3033,0,0,100,100,0,1,0,1,0
58638,5900,0,0,62,62,0,1,0,1,0
42798,26467,0,0,62,62,0,1,0,1,0
54043,36237,0,0,66,66,0,1,0,1,0
14360,64147,0,0,145,145,0,1,0,1,0
58638,5900,0,0,62,62,0,1,0,1,0
64605,25174,0,0,66,66,0,1,0,1,0
58638,5900,0,0,62,62,0,1,0,1,0
45964,5333,0,0,60,60,0,1,0,1,0
64368,22114,0,0,66,66,0,1,0,1,0
34400,39004,0,0,74,74,0,1,0,1,0
3980,63710,0,0,66,66,0,1,0,1,0
35516,22,0,0,60,60,0,1,0,1,0
23528,44847,0,0,62,62,0,1,0,1,0
57761,30317,0,0,66,66,0,1,0,1,0
42429,22114,0,0,62,62,0,1,0,1,0
39586,22114,0,0,66,66,0,1,0,1,0
34916,51185,0,0,62,62,0,1,0,1,0
51191,26467,0,0,66,66,0,1,0,1,0
2394,43890,0,0,62,62,0,1,0,1,0
7892,50584,0,0,62,62,0,1,0,1,0
64989,50265,0,0,66,66,0,1,0,1,0
57337,64147,0,0,66,66,0,1,0,1,0
31845,55777,0,0,62,62,0,1,0,1,0
58977,37965,0,0,66,66,0,1,0,1,0
59696,57470,0,0,62,62,0,1,0,1,0
15922,44847,0,0,66,66,0,1,0,1,0
25565,1726,0,0,60,60,0,1,0,1,0
46275,64147,0,0,62,62,0,1,0,1,0
58638,5900,0,0,62,62,0,1,0,1,0
36992,25174,0,0,146,146,0,1,0,1,0
62250,23117,0,0,66,66,0,1,0,1,0
6666,138,0,0,60,60,0,1,0,1,0
26183,22114,0,0,62,62,0,1,0,1,0
39098,51505,0,0,146,146,0,1,0,1,0
53640,25174,0,0,62,62,0,1,0,1,0
35015,17,0,0,60,60,0,1,0,1,0
43916,21,0,0,60,60,0,1,0,1,0
64681,35993,0,0,66,66,0,1,0,1,0
59374,51505,0,0,62,62,0,1,0,1,0
43129,15503,0,0,62,62,0,1,0,1,0
16270,56205,0,0,62,62,0,1,0,1,0
2707,37,0,0,60,60,0,1,0,1,0
53178,26467,0,0,62,62,0,1,0,1,0
62452,21247,0,0,66,66,0,1,0,1,0
5222,27389,0,0,66,66,0,1,0,1,0
38565,51505,0,0,62,62,0,1,0,1,0
40418,25174,0,0,66,66,0,1,0,1,0
39100,2767,0,0,62,62,0,1,0,1,0
23277,53733,0,0,66,66,0,1,0,1,0
61057,25174,0,0,62,62,0,1,0,1,0
55146,1433,0,0,60,60,0,1,0,1,0
3478,61463,0,0,164,164,0,1,0,1,0
24127,56205,0,0,66,66,0,1,0,1,0
58638,5900,0,0,62,62,0,1,0,1,0
25532,35440,0,0,146,146,0,1,0,1,0
61865,35440,0,0,66,66,0,1,0,1,0
53323,35253,0,0,66,66,0,1,0,1,0
45682,37965,0,0,62,62,0,1,0,1,0
5223,11387,0,0,66,66,0,1,0,1,0
38549,22114,0,0,62,62,0,1,0,1,0
2083,25174,0,0,146,146,0,1,0,1,0
58638,5900,0,0,62,62,0,1,0,1,0
47910,7454,0,0,60,60,0,1,0,1,0
51300,64147,0,0,62,62,0,1,0,1,0
26424,27189,0,0,66,66,0,1,0,1,0
25901,50265,0,0,62,62,0,1,0,1,0
20012,311,0,0,60,60,0,1,0,1,0
10427,32480,0,0,66,66,0,1,0,1,0
55893,45711,0,0,78,78,0,1,0,1,0
61085,37965,0,0,62,62,0,1,0,1,0
52740,51505,0,0,66,66,0,1,0,1,0
25010,30188,0,0,146,146,0,1,0,1,0
63171,2323,0,0,60,60,0,1,0,1,0
50674,35440,0,0,146,146,0,1,0,1,0
58638,5900,0,0,62,62,0,1,0,1,0
54989,50265,0,0,66,66,0,1,0,1,0
14487,38303,0,0,146,146,0,1,0,1,0
11552,44847,0,0,62,62,0,1,0,1,0
62132,42873,0,0,66,66,0,1,0,1,0
17811,23,0,0,60,60,0,1,0,1,0
6881,6881,0,0,146,146,0,1,0,1,0
1027,11392,0,0,62,62,0,1,0,1,0
53781,37965,0,0,62,62,0,1,0,1,0
40834,50584,0,0,146,146,0,1,0,1,0
443,64347,0,0,131,131,0,1,0,1,0
37168,5900,0,0,60,60,0,1,0,1,0
18642,42707,0,0,145,145,0,1,0,1,0
16429,56205,0,0,146,146,0,1,0,1,0
58638,5900,0,0,62,62,0,1,0,1,0
10910,57866,0,0,62,62,0,1,0,1,0
61419,57470,0,0,66,66,0,1,0,1,0
62813,25174,0,0,62,62,0,1,0,1,0
6057,51221,0,0,78,78,0,1,0,1,0
52611,9571,0,0,62,62,0,1,0,1,0
36034,35440,0,0,62,62,0,1,0,1,0
53987,57470,0,0,66,66,0,1,0,1,0
58481,15503,0,0,146,146,0,1,0,1,0
49514,39127,0,0,162,162,0,1,0,1,0
25523,35974,0,0,62,62,0,1,0,1,0
29016,25174,0,0,146,146,0,1,0,1,0
31281,30188,0,0,62,62,0,1,0,1,0
11562,30188,0,0,62,62,0,1,0,1,0
54210,36237,0,0,62,62,0,1,0,1,0
17251,10387,0,0,159,159,0,1,0,1,0
58638,5900,0,0,62,62,0,1,0,1,0
51426,52700,0,0,100,100,0,1,0,1,0
54131,57866,0,0,66,66,0,1,0,1,0
61945,48817,0,0,66,66,0,1,0,1,0
25237,57470,0,0,62,62,0,1,0,1,0
55565,64147,0,0,66,66,0,1,0,1,0
50052,65008,0,0,60,60,0,1,0,1,0
1036,64147,0,0,62,62,0,1,0,1,0
3478,61463,0,0,1288,1288,0,1,0,1,0
33814,22114,0,0,62,62,0,1,0,1,0
51185,37965,0,0,66,66,0,1,0,1,0
1027,57866,0,0,146,146,0,1,0,1,0
62109,44847,0,0,66,66,0,1,0,1,0
34993,15503,0,0,62,62,0,1,0,1,0
62056,30317,0,0,146,146,0,1,0,1,0
1660,8696,0,0,145,145,0,1,0,1,0
58638,5900,0,0,62,62,0,1,0,1,0
27147,22114,0,0,146,146,0,1,0,1,0
63116,22114,0,0,62,62,0,1,0,1,0
50486,56205,0,0,66,66,0,1,0,1,0
44913,36866,0,0,148,148,0,1,0,1,0
11478,51221,0,0,66,66,0,1,0,1,0
42252,33303,0,0,60,60,0,1,0,1,0
54578,26467,0,0,66,66,0,1,0,1,0
6666,443,0,0,60,60,0,1,0,1,0
23519,25174,0,0,62,62,0,1,0,1,0
35356,25174,0,0,146,146,0,1,0,1,0
54555,25174,0,0,66,66,0,1,0,1,0
5664,36237,0,0,66,66,0,1,0,1,0
29145,8168,0,0,62,62,0,1,0,1,0
22094,23,0,0,60,60,0,1,0,1,0
49164,25174,0,0,146,146,0,1,0,1,0
0,0,0,0,70,70,0,1,0,1,0
1694,30188,0,0,62,62,0,1,0,1,0
57060,50584,0,0,62,62,0,1,0,1,0
20804,64147,0,0,145,145,0,1,0,1,0
55311,44847,0,0,66,66,0,1,0,1,0
59366,35440,0,0,66,66,0,1,0,1,0
53766,51505,0,0,62,62,0,1,0,1,0
44117,6881,0,0,146,146,0,1,0,1,0
33405,37965,0,0,62,62,0,1,0,1,0
22528,25174,0,0,62,62,0,1,0,1,0
1821,64147,0,0,66,66,0,1,0,1,0
51259,1433,0,0,60,60,0,1,0,1,0
46839,51050,0,0,62,62,0,1,0,1,0
35626,22114,0,0,66,66,0,1,0,1,0
14447,25174,0,0,146,146,0,1,0,1,0
26553,57470,0,0,66,66,0,1,0,1,0
29145,8168,0,0,62,62,0,1,0,1,0
44681,31573,0,0,146,146,0,1,0,1,0
48706,23393,0,0,60,60,0,1,0,1,0
18574,56205,0,0,66,66,0,1,0,1,0
40787,57470,0,0,62,62,0,1,0,1,0
49415,22114,0,0,66,66,0,1,0,1,0
8999,49001,0,0,146,146,0,1,0,1,0
21348,22,0,0,60,60,0,1,0,1,0
18011,44847,0,0,66,66,0,1,0,1,0
60152,26467,0,0,62,62,0,1,0,1,0
51183,56205,0,0,62,62,0,1,0,1,0
5790,43890,0,0,62,62,0,1,0,1,0
13441,57470,0,0,62,62,0,1,0,1,0
9605,57470,0,0,62,62,0,1,0,1,0
40834,50584,0,0,62,62,0,1,0,1,0
50512,1212,0,0,145,145,0,1,0,1,0
64990,55442,0,0,66,66,0,1,0,1,0
24040,22114,0,0,62,62,0,1,0,1,0
51815,51221,0,0,74,74,0,1,0,1,0
10115,52700,0,0,62,62,0,1,0,1,0
14309,56205,0,0,146,146,0,1,0,1,0
55973,25174,0,0,62,62,0,1,0,1,0
39617,50584,0,0,62,62,0,1,0,1,0
58638,5900,0,0,62,62,0,1,0,1,0
33469,61903,0,0,145,145,0,1,0,1,0
52650,36237,0,0,62,62,0,1,0,1,0
53447,22114,0,0,146,146,0,1,0,1,0
6881,26296,0,0,157,157,0,1,0,1,0
43747,22114,0,0,66,66,0,1,0,1,0
6712,5632,0,0,60,60,0,1,0,1,0
55312,64147,0,0,66,66,0,1,0,1,0
2541,51505,0,0,62,62,0,1,0,1,0
34810,25174,0,0,62,62,0,1,0,1,0
49622,50584,0,0,62,62,0,1,0,1,0
57987,56125,0,0,90,90,0,1,0,1,0
22439,25174,0,0,66,66,0,1,0,1,0
23844,26467,0,0,62,62,0,1,0,1,0
65400,36237,0,0,66,66,0,1,0,1,0
50478,51505,0,0,66,66,0,1,0,1,0
53073,32468,0,0,62,62,0,1,0,1,0
47700,51505,0,0,66,66,0,1,0,1,0
62348,50584,0,0,66,66,0,1,0,1,0
63079,64147,0,0,66,66,0,1,0,1,0
3064,44847,0,0,62,62,0,1,0,1,0
47632,25174,0,0,146,146,0,1,0,1,0
51320,44847,0,0,62,62,0,1,0,1,0
60403,22114,0,0,66,66,0,1,0,1,0
65209,57866,0,0,62,62,0,1,0,1,0
2837,25174,0,0,66,66,0,1,0,1,0
51865,61689,0,0,66,66,0,1,0,1,0
50459,62413,0,0,66,66,0,1,0,1,0
5222,21212,0,0,66,66,0,1,0,1,0
40547,24051,0,0,74,74,0,1,0,1,0
55424,38303,0,0,66,66,0,1,0,1,0
19875,30170,0,0,145,145,0,1,0,1,0
52459,5555,0,0,60,60,0,1,0,1,0
56275,65348,0,0,142,142,0,1,0,1,0
4706,36237,0,0,146,146,0,1,0,1,0
58638,5900,0,0,62,62,0,1,0,1,0
56614,25174,0,0,66,66,0,1,0,1,0
10477,44847,0,0,66,66,0,1,0,1,0
53495,37807,0,0,66,66,0,1,0,1,0
45941,23386,0,0,60,60,0,1,0,1,0
50261,64147,0,0,66,66,0,1,0,1,0
54280,3385,0,0,60,60,0,1,0,1,0
8889,29421,0,0,60,60,0,1,0,1,0
62930,21247,0,0,66,66,0,1,0,1,0
60720,23718,0,0,66,66,0,1,0,1,0
1117,37965,0,0,62,62,0,1,0,1,0
53243,57470,0,0,74,74,0,1,0,1,0
46409,35440,0,0,66,66,0,1,0,1,0
59592,37965,0,0,62,62,0,1,0,1,0
10416,64147,0,0,62,62,0,1,0,1,0
58638,5900,0,0,62,62,0,1,0,1,0
54080,26467,0,0,62,62,0,1,0,1,0
59781,56205,0,0,66,66,0,1,0,1,0
31660,35440,0,0,66,66,0,1,0,1,0
50415,64147,0,0,66,66,0,1,0,1,0
58638,5900,0,0,62,62,0,1,0,1,0
58638,5900,0,0,62,62,0,1,0,1,0
26623,22114,0,0,146,146,0,1,0,1,0
50949,45960,0,0,62,62,0,1,0,1,0
59497,64097,0,0,66,66,0,1,0,1,0
34531,23117,0,0,62,62,0,1,0,1,0
443,50238,0,0,331,331,0,1,0,1,0
64940,36237,0,0,62,62,0,1,0,1,0
64586,50584,0,0,62,62,0,1,0,1,0
48706,23393,0,0,60,60,0,1,0,1,0
58638,5900,0,0,62,62,0,1,0,1,0
14993,50584,0,0,62,62,0,1,0,1,0
65417,44847,0,0,66,66,0,1,0,1,0
52318,22114,0,0,62,62,0,1,0,1,0
38306,51221,0,0,62,62,0,1,0,1,0
52643,36237,0,0,66,66,0,1,0,1,0
20198,17372,0,0,62,62,0,1,0,1,0
7288,25174,0,0,62,62,0,1,0,1,0
10248,21247,0,0,62,62,0,1,0,1,0
51903,26467,0,0,62,62,0,1,0,1,0
44933,26467,0,0,62,62,0,1,0,1,0
3270,35440,0,0,66,66,0,1,0,1,0
51105,50584,0,0,66,66,0,1,0,1,0
443,35385,0,0,66,66,0,1,0,1,0
27517,23,0,0,60,60,0,1,0,1,0
40512,57470,0,0,74,74,0,1,0,1,0
57982,25174,0,0,62,62,0,1,0,1,0
54300,22114,0,0,66,66,0,1,0,1,0
53692,44512,0,0,66,66,0,1,0,1,0
52103,53733,0,0,66,66,0,1,0,1,0
10088,37807,0,0,66,66,0,1,0,1,0
52336,64097,0,0,62,62,0,1,0,1,0
20706,37965,0,0,62,62,0,1,0,1,0
22948,26467,0,0,62,62,0,1,0,1,0
64509,9571,0,0,62,62,0,1,0,1,0
58638,5900,0,0,62,62,0,1,0,1,0
24144,57470,0,0,62,62,0,1,0,1,0
58638,5900,0,0,62,62,0,1,0,1,0
61711,35440,0,0,66,66,0,1,0,1,0
57325,37965,0,0,62,62,0,1,0,1,0
5244,35440,0,0,66,66,0,1,0,1,0
58021,22114,0,0,66,66,0,1,0,1,0
5955,55160,0,0,74,74,0,1,0,1,0
14777,25174,0,0,62,62,0,1,0,1,0
40642,23889,0,0,146,146,0,1,0,1,0
0,0,0,0,98,98,0,1,0,1,0
51866,22114,0,0,66,66,0,1,0,1,0
11450,57470,0,0,66,66,0,1,0,1,0
42995,26467,0,0,62,62,0,1,0,1,0
51192,15503,0,0,66,66,0,1,0,1,0
52103,53733,0,0,66,66,0,1,0,1,0
64124,25174,0,0,62,62,0,1,0,1,0
13525,51505,0,0,146,146,0,1,0,1,0
57643,28189,0,0,60,60,0,1,0,1,0
58338,3369,0,0,60,60,0,1,0,1,0
46604,57866,0,0,66,66,0,1,0,1,0
63716,23,0,0,60,60,0,1,0,1,0
61945,48817,0,0,62,62,0,1,0,1,0
35944,23,0,0,60,60,0,1,0,1,0
53030,56205,0,0,66,66,0,1,0,1,0
58638,5900,0,0,62,62,0,1,0,1,0
1814,62413,0,0,66,66,0,1,0,1,0
10965,22114,0,0,62,62,0,1,0,1,0
9393,51505,0,0,66,66,0,1,0,1,0
17777,30188,0,0,62,62,0,1,0,1,0
10669,49756,0,0,60,60,0,1,0,1,0
64788,43890,0,0,66,66,0,1,0,1,0
443,28417,0,0,82,82,0,1,0,1,0
0,0,0,0,98,98,0,1,0,1,0
6881,26296,0,0,143,143,0,1,0,1,0
56688,25174,0,0,62,62,0,1,0,1,0
62930,21247,0,0,66,66,0,1,0,1,0
54346,44847,0,0,66,66,0,1,0,1,0
56255,44847,0,0,66,66,0,1,0,1,0
42094,35440,0,0,62,62,0,1,0,1,0
62029,22114,0,0,66,66,0,1,0,1,0
10822,48817,0,0,140,140,0,1,0,1,0
33498,5529,0,0,145,145,0,1,0,1,0
7184,15503,0,0,66,66,0,1,0,1,0
46640,3780,0,0,60,60,0,1,0,1,0
44154,22114,0,0,62,62,0,1,0,1,0
43129,15503,0,0,62,62,0,1,0,1,0
6666,3389,0,0,60,60,0,1,0,1,0
57164,50584,0,0,62,62,0,1,0,1,0
59241,62413,0,0,62,62,0,1,0,1,0
38358,22300,0,0,60,60,0,1,0,1,0
61392,50584,0,0,62,62,0,1,0,1,0
58686,18375,0,0,66,66,0,1,0,1,0
63460,55160,0,0,66,66,0,1,0,1,0
58638,5900,0,0,62,62,0,1,0,1,0
58574,21247,0,0,66,66,0,1,0,1,0
40108,23,0,0,60,60,0,1,0,1,0
36685,35440,0,0,62,62,0,1,0,1,0
48388,44847,0,0,146,146,0,1,0,1,0
48230,57866,0,0,62,62,0,1,0,1,0
62580,25174,0,0,62,62,0,1,0,1,0
56306,1,0,0,146,146,0,1,0,1,0
27679,37965,0,0,62,62,0,1,0,1,0
26921,26467,0,0,62,62,0,1,0,1,0
8889,26330,0,0,60,60,0,1,0,1,0
10306,44847,0,0,62,62,0,1,0,1,0
14777,25174,0,0,62,62,0,1,0,1,0
57564,56205,0,0,66,66,0,1,0,1,0
1537,22114,0,0,62,62,0,1,0,1,0
27785,37965,0,0,66,66,0,1,0,1,0
55994,22114,0,0,66,66,0,1,0,1,0
22357,6004,0,0,62,62,0,1,0,1,0
4269,26672,0,0,60,60,0,1,0,1,0
50442,37807,0,0,62,62,0,1,0,1,0
52230,50265,0,0,66,66,0,1,0,1,0
39981,57470,0,0,62,62,0,1,0,1,0
49590,57470,0,0,78,78,0,1,0,1,0
6881,55108,0,0,143,143,0,1,0,1,0
13287,16933,0,0,62,62,0,1,0,1,0
51356,22114,0,0,62,62,0,1,0,1,0
57236,53733,0,0,62,62,0,1,0,1,0
56075,23,0,0,60,60,0,1,0,1,0
37902,23718,0,0,146,146,0,1,0,1,0
11815,30188,0,0,146,146,0,1,0,1,0
8403,46824,0,0,62,62,0,1,0,1,0
35461,44847,0,0,146,146,0,1,0,1,0
32736,22114,0,0,66,66,0,1,0,1,0
60188,15503,0,0,66,66,0,1,0,1,0
19875,30170,0,0,145,145,0,1,0,1,0
12668,42707,0,0,62,62,0,1,0,1,0
30443,44847,0,0,62,62,0,1,0,1,0
32976,37965,0,0,66,66,0,1,0,1,0
17027,1,0,0,62,62,0,1,0,1,0
12226,37965,0,0,62,62,0,1,0,1,0
49644,30188,0,0,66,66,0,1,0,1,0
60962,64147,0,0,66,66,0,1,0,1,0
60248,46776,0,0,66,66,0,1,0,1,0
61457,21247,0,0,62,62,0,1,0,1,0
61148,37965,0,0,66,66,0,1,0,1,0
63840,36829,0,0,66,66,0,1,0,1,0
63578,35440,0,0,66,66,0,1,0,1,0
3047,50584,0,0,62,62,0,1,0,1,0
50046,22114,0,0,62,62,0,1,0,1,0
61798,35440,0,0,66,66,0,1,0,1,0
27337,51505,0,0,66,66,0,1,0,1,0
55145,11392,0,0,66,66,0,1,0,1,0
62514,37807,0,0,66,66,0,1,0,1,0
47910,7461,0,0,60,60,0,1,0,1,0
14309,56205,0,0,62,62,0,1,0,1,0
5617,64147,0,0,145,145,0,1,0,1,0
52143,37807,0,0,66,66,0,1,0,1,0
48676,53399,0,0,60,60,0,1,0,1,0
20508,57470,0,0,62,62,0,1,0,1,0
37028,51505,0,0,62,62,0,1,0,1,0
19875,30170,0,0,145,145,0,1,0,1,0
1081,64910,0,0,146,146,0,1,0,1,0
6721,37965,0,0,66,66,0,1,0,1,0
39941,2767,0,0,62,62,0,1,0,1,0
47013,37965,0,0,62,62,0,1,0,1,0
33931,50584,0,0,62,62,0,1,0,1,0
50901,26467,0,0,66,66,0,1,0,1,0
58638,5900,0,0,62,62,0,1,0,1,0
25857,57354,0,0,145,145,0,1,0,1,0
64363,22114,0,0,66,66,0,1,0,1,0
47424,25174,0,0,66,66,0,1,0,1,0
42034,28189,0,0,62,62,0,1,0,1,0
2932,44847,0,0,66,66,0,1,0,1,0
35450,23,0,0,60,60,0,1,0,1,0
55666,35440,0,0,66,66,0,1,0,1,0
45964,2225,0,0,60,60,0,1,0,1,0
18130,25174,0,0,62,62,0,1,0,1,0
51455,53733,0,0,66,66,0,1,0,1,0
27844,52700,0,0,70,70,0,1,0,1,0
56794,46824,0,0,66,66,0,1,0,1,0
37011,25174,0,0,146,146,0,1,0,1,0
55496,64097,0,0,66,66,0,1,0,1,0
15465,64147,0,0,66,66,0,1,0,1,0
3170,53567,0,0,66,66,0,1,0,1,0
55921,43890,0,0,66,66,0,1,0,1,0
59223,17500,0,0,66,66,0,1,0,1,0
58638,5900,0,0,62,62,0,1,0,1,0
53835,62413,0,0,146,146,0,1,0,1,0
58638,5900,0,0,62,62,0,1,0,1,0
16387,44427,0,0,60,60,0,1,0,1,0
1026,57866,0,0,146,146,0,1,0,1,0
60126,35440,0,0,66,66,0,1,0,1,0
59076,25174,0,0,62,62,0,1,0,1,0
62769,25174,0,0,62,62,0,1,0,1,0
12909,47807,0,0,148,148,0,1,0,1,0
6889,41615,0,0,143,143,0,1,0,1,0
58638,5900,0,0,62,62,0,1,0,1,0
42968,56205,0,0,62,62,0,1,0,1,0
6666,50070,0,0,60,60,0,1,0,1,0
3549,64147,0,0,62,62,0,1,0,1,0
7423,22114,0,0,146,146,0,1,0,1,0
3730,37965,0,0,62,62,0,1,0,1,0
443,39851,0,0,112,112,0,1,0,1,0
58638,5900,0,0,62,62,0,1,0,1,0
6652,25174,0,0,62,62,0,1,0,1,0
58638,5900,0,0,62,62,0,1,0,1,0
443,61686,0,0,78,78,0,1,0,1,0
17226,35440,0,0,62,62,0,1,0,1,0
443,9986,0,0,352,352,0,1,0,1,0
58638,5900,0,0,62,62,0,1,0,1,0
20378,23,0,0,60,60,0,1,0,1,0
51646,37965,0,0,62,62,0,1,0,1,0
9226,57470,0,0,66,66,0,1,0,1,0
49276,51505,0,0,66,66,0,1,0,1,0
48706,23393,0,0,60,60,0,1,0,1,0
50245,44847,0,0,62,62,0,1,0,1,0
25085,30188,0,0,62,62,0,1,0,1,0
10091,22114,0,0,62,62,0,1,0,1,0
58638,5900,0,0,62,62,0,1,0,1,0
13485,43708,0,0,554,554,0,1,0,1,0
51046,25174,0,0,66,66,0,1,0,1,0
44414,23718,0,0,62,62,0,1,0,1,0
48176,50584,0,0,146,146,0,1,0,1,0
27272,64147,0,0,62,62,0,1,0,1,0
47943,50584,0,0,74,74,0,1,0,1,0
51045,25174,0,0,62,62,0,1,0,1,0
58022,5560,0,0,60,60,0,1,0,1,0
22390,19473,0,0,66,66,0,1,0,1,0
34916,51185,0,0,62,62,0,1,0,1,0
31404,36841,0,0,100,100,0,1,0,1,0
27046,51505,0,0,66,66,0,1,0,1,0
57098,1,0,0,78,78,0,1,0,1,0
60052,37965,0,0,66,66,0,1,0,1,0
39132,44847,0,0,66,66,0,1,0,1,0
40400,22114,0,0,62,62,0,1,0,1,0
19204,57866,0,0,66,66,0,1,0,1,0
56369,22114,0,0,62,62,0,1,0,1,0
57991,22114,0,0,66,66,0,1,0,1,0
58638,5900,0,0,62,62,0,1,0,1,0
52830,22114,0,0,62,62,0,1,0,1,0
59523,37965,0,0,62,62,0,1,0,1,0
60141,62413,0,0,66,66,0,1,0,1,0
49514,65504,0,0,162,162,0,1,0,1,0
64000,44847,0,0,66,66,0,1,0,1,0
6889,48817,0,0,143,143,0,1,0,1,0
59303,21247,0,0,66,66,0,1,0,1,0
443,1785,0,0,97,97,0,1,0,1,0
47210,50584,0,0,146,146,0,1,0,1,0
58638,5900,0,0,62,62,0,1,0,1,0
58638,5900,0,0,62,62,0,1,0,1,0
56909,50584,0,0,62,62,0,1,0,1,0
49931,25174,0,0,62,62,0,1,0,1,0
63578,35440,0,0,62,62,0,1,0,1,0
24144,57470,0,0,62,62,0,1,0,1,0
49057,5900,0,0,60,60,0,1,0,1,0
56676,37965,0,0,66,66,0,1,0,1,0
42745,50011,0,0,62,62,0,1,0,1,0
21492,51505,0,0,146,146,0,1,0,1,0
1116,44847,0,0,66,66,0,1,0,1,0
18771,35440,0,0,66,66,0,1,0,1,0
51414,22,0,0,60,60,0,1,0,1,0
1054,15503,0,0,62,62,0,1,0,1,0
7912,35440,0,0,146,146,0,1,0,1,0
62489,23117,0,0,66,66,0,1,0,1,0
57500,37965,0,0,62,62,0,1,0,1,0
58638,5900,0,0,62,62,0,1,0,1,0
19270,56448,0,0,78,78,0,1,0,1,0
30861,46783,0,0,62,62,0,1,0,1,0
51432,25174,0,0,146,146,0,1,0,1,0
7664,2149,0,0,66,66,0,1,0,1,0
58131,42416,0,0,146,146,0,1,0,1,0
51382,56205,0,0,66,66,0,1,0,1,0
51944,56205,0,0,66,66,0,1,0,1,0
61591,22114,0,0,62,62,0,1,0,1,0
6703,21247,0,0,62,62,0,1,0,1,0
53500,1,0,0,66,66,0,1,0,1,0
58501,44847,0,0,62,62,0,1,0,1,0
59535,25174,0,0,62,62,0,1,0,1,0
58715,64097,0,0,62,62,0,1,0,1,0
45941,23386,0,0,60,60,0,1,0,1,0
59315,35440,0,0,62,62,0,1,0,1,0
15978,50584,0,0,146,146,0,1,0,1,0
17947,36237,0,0,62,62,0,1,0,1,0
17837,62609,0,0,148,148,0,1,0,1,0
27785,37965,0,0,66,66,0,1,0,1,0
51368,1900,0,0,139,139,0,1,0,1,0
27539,25174,0,0,146,146,0,1,0,1,0
49308,22114,0,0,62,62,0,1,0,1,0
21542,57470,0,0,74,74,0,1,0,1,0
61550,5529,0,0,145,145,0,1,0,1,0
12240,48817,0,0,146,146,0,1,0,1,0
33948,1375,0,0,146,146,0,1,0,1,0
51172,44847,0,0,66,66,0,1,0,1,0
30922,22,0,0,60,60,0,1,0,1,0
24809,52700,0,0,66,66,0,1,0,1,0
61510,37965,0,0,66,66,0,1,0,1,0
51575,9694,0,0,62,62,0,1,0,1,0
58638,5900,0,0,62,62,0,1,0,1,0
22916,25174,0,0,146,146,0,1,0,1,0
58638,5900,0,0,62,62,0,1,0,1,0
3717,25174,0,0,62,62,0,1,0,1,0
443,20550,0,0,97,97,0,1,0,1,0
16944,50584,0,0,62,62,0,1,0,1,0
58101,46314,0,0,72,72,0,1,0,1,0
13285,29892,0,0,145,145,0,1,0,1,0
58638,5900,0,0,62,62,0,1,0,1,0
51743,64147,0,0,62,62,0,1,0,1,0
8403,46824,0,0,62,62,0,1,0,1,0
34983,26543,0,0,145,145,0,1,0,1,0
1253,25174,0,0,146,146,0,1,0,1,0
22987,15503,0,0,146,146,0,1,0,1,0
31627,64147,0,0,62,62,0,1,0,1,0
47771,25174,0,0,62,62,0,1,0,1,0
9445,56205,0,0,66,66,0,1,0,1,0
80,9918,0,0,60,60,0,1,0,1,0
50470,61463,0,0,86,86,0,1,0,1,0
18904,57470,0,0,62,62,0,1,0,1,0
51578,44847,0,0,66,66,0,1,0,1,0
62776,62413,0,0,146,146,0,1,0,1,0
6773,57470,0,0,62,62,0,1,0,1,0
53816,22114,0,0,62,62,0,1,0,1,0
60188,15503,0,0,66,66,0,1,0,1,0
52462,25174,0,0,66,66,0,1,0,1,0
49516,35894,0,0,62,62,0,1,0,1,0
48681,11392,0,0,62,62,0,1,0,1,0
53928,15503,0,0,62,62,0,1,0,1,0
47788,1879,0,0,146,146,0,1,0,1,0
58638,5900,0,0,62,62,0,1,0,1,0
58079,50584,0,0,66,66,0,1,0,1,0
17719,49153,0,0,145,145,0,1,0,1,0
58213,37807,0,0,66,66,0,1,0,1,0
58638,5900,0,0,62,62,0,1,0,1,0
15585,64147,0,0,62,62,0,1,0,1,0
35610,37965,0,0,62,62,0,1,0,1,0
7301,14914,0,0,157,157,0,1,0,1,0
51413,54751,0,0,136,136,0,1,0,1,0
57750,37965,0,0,62,62,0,1,0,1,0
63271,52752,0,0,78,78,0,1,0,1,0
10462,25174,0,0,62,62,0,1,0,1,0
43111,8080,0,0,60,60,0,1,0,1,0
40312,55442,0,0,62,62,0,1,0,1,0
2849,30188,0,0,66,66,0,1,0,1,0
51046,25174,0,0,62,62,0,1,0,1,0
9212,51505,0,0,146,146,0,1,0,1,0
54280,3398,0,0,60,60,0,1,0,1,0
51456,45680,0,0,139,139,0,1,0,1,0
47962,16069,0,0,62,62,0,1,0,1,0
6036,51505,0,0,66,66,0,1,0,1,0
36663,22114,0,0,146,146,0,1,0,1,0
443,62732,0,0,199,199,0,1,0,1,0
9412,7302,0,0,62,62,0,1,0,1,0
55586,23,0,0,60,60,0,1,0,1,0
10736,35440,0,0,66,66,0,1,0,1,0
6224,37965,0,0,62,62,0,1,0,1,0
17010,57470,0,0,62,62,0,1,0,1,0
49800,5900,0,0,60,60,0,1,0,1,0
2437,23117,0,0,146,146,0,1,0,1,0
53513,56205,0,0,146,146,0,1,0,1,0
51909,6881,0,0,62,62,0,1,0,1,0
34212,11392,0,0,62,62,0,1,0,1,0
13285,29892,0,0,145,145,0,1,0,1,0
59599,62413,0,0,62,62,0,1,0,1,0
10467,25174,0,0,146,146,0,1,0,1,0
18570,2323,0,0,60,60,0,1,0,1,0
36770,56205,0,0,62,62,0,1,0,1,0
51313,64147,0,0,62,62,0,1,0,1,0
14397,37965,0,0,62,62,0,1,0,1,0
60260,22114,0,0,62,62,0,1,0,1,0
29291,48983,0,0,150,150,0,1,0,1,0
11821,64147,0,0,62,62,0,1,0,1,0
21322,25174,0,0,146,146,0,1,0,1,0
11983,57470,0,0,62,62,0,1,0,1,0
50881,50584,0,0,66,66,0,1,0,1,0
30654,51221,0,0,72,72,0,1,0,1,0
58646,44847,0,0,66,66,0,1,0,1,0
10736,35440,0,0,66,66,0,1,0,1,0
25565,30367,0,0,60,60,0,1,0,1,0
63032,22114,0,0,66,66,0,1,0,1,0
19004,51505,0,0,66,66,0,1,0,1,0
54827,50432,0,0,109,109,0,1,0,1,0
55899,57470,0,0,78,78,0,1,0,1,0
28221,37965,0,0,62,62,0,1,0,1,0
1847,64147,0,0,66,66,0,1,0,1,0
34470,57470,0,0,66,66,0,1,0,1,0
52537,57866,0,0,66,66,0,1,0,1,0
3765,64147,0,0,66,66,0,1,0,1,0
61522,64147,0,0,66,66,0,1,0,1,0
61616,23,0,0,60,60,0,1,0,1,0
55116,7574,0,0,66,66,0,1,0,1,0
49516,35894,0,0,62,62,0,1,0,1,0
50772,35440,0,0,62,62,0,1,0,1,0
27860,23,0,0,60,60,0,1,0,1,0
443,4205,0,0,320,320,0,1,0,1,0
48019,22114,0,0,66,66,0,1,0,1,0
52557,44847,0,0,66,66,0,1,0,1,0
48706,23393,0,0,60,60,0,1,0,1,0
46849,36237,0,0,66,66,0,1,0,1,0
62489,23117,0,0,62,62,0,1,0,1,0
49717,57470,0,0,62,62,0,1,0,1,0
58638,5900,0,0,62,62,0,1,0,1,0
50799,37807,0,0,66,66,0,1,0,1,0
45908,33330,0,0,60,60,0,1,0,1,0
50292,22114,0,0,66,66,0,1,0,1,0
34086,25174,0,0,66,66,0,1,0,1,0
49699,64147,0,0,66,66,0,1,0,1,0
63461,51505,0,0,66,66,0,1,0,1,0
15513,25174,0,0,62,62,0,1,0,1,0
43063,57470,0,0,62,62,0,1,0,1,0
19330,25174,0,0,62,62,0,1,0,1,0
52128,37807,0,0,62,62,0,1,0,1,0
0,0,0,0,98,98,0,1,0,1,0
7931,30170,0,0,146,146,0,1,0,1,0
1030,64147,0,0,62,62,0,1,0,1,0
51464,23,0,0,60,60,0,1,0,1,0
61595,50939,0,0,145,145,0,1,0,1,0
60962,64147,0,0,66,66,0,1,0,1,0
42722,56448,0,0,70,70,0,1,0,1,0
11136,15503,0,0,62,62,0,1,0,1,0
11464,37965,0,0,62,62,0,1,0,1,0
21542,57470,0,0,74,74,0,1,0,1,0
58638,5900,0,0,62,62,0,1,0,1,0
61221,35440,0,0,66,66,0,1,0,1,0
2522,64147,0,0,62,62,0,1,0,1,0
59282,51050,0,0,66,66,0,1,0,1,0
52356,55442,0,0,66,66,0,1,0,1,0
55920,25174,0,0,146,146,0,1,0,1,0
46640,4443,0,0,60,60,0,1,0,1,0
3064,44847,0,0,62,62,0,1,0,1,0
27000,23117,0,0,62,62,0,1,0,1,0
6895,57354,0,0,148,148,0,1,0,1,0
12074,10197,0,0,72,72,0,1,0,1,0
44821,64147,0,0,62,62,0,1,0,1,0
61140,27520,0,0,62,62,0,1,0,1,0
43642,48817,0,0,134,134,0,1,0,1,0
35657,48637,0,0,62,62,0,1,0,1,0
42465,57470,0,0,60,60,0,1,0,1,0
42542,25174,0,0,146,146,0,1,0,1,0
17009,53733,0,0,62,62,0,1,0,1,0
33359,30188,0,0,62,62,0,1,0,1,0
57289,31573,0,0,66,66,0,1,0,1,0
61643,22114,0,0,62,62,0,1,0,1,0
50386,22114,0,0,66,66,0,1,0,1,0
53030,56205,0,0,66,66,0,1,0,1,0
19632,37965,0,0,62,62,0,1,0,1,0
65501,26467,0,0,62,62,0,1,0,1,0
38518,1900,0,0,139,139,0,1,0,1,0
16393,22114,0,0,66,66,0,1,0,1,0
55733,51505,0,0,66,66,0,1,0,1,0
58131,1,0,0,146,146,0,1,0,1,0
54062,31573,0,0,66,66,0,1,0,1,0
50573,22114,0,0,62,62,0,1,0,1,0
13911,57470,0,0,60,60,0,1,0,1,0
1025,46776,0,0,62,62,0,1,0,1,0
56636,43890,0,0,66,66,0,1,0,1,0
18203,23,0,0,60,60,0,1,0,1,0
58638,5900,0,0,62,62,0,1,0,1,0
63593,22114,0,0,66,66,0,1,0,1,0
55427,64147,0,0,66,66,0,1,0,1,0
56798,9571,0,0,66,66,0,1,0,1,0
64343,6004,0,0,66,66,0,1,0,1,0
58638,5900,0,0,62,62,0,1,0,1,0
7001,6881,0,0,62,62,0,1,0,1,0
59985,57470,0,0,62,62,0,1,0,1,0
56369,22114,0,0,146,146,0,1,0,1,0
53470,22114,0,0,66,66,0,1,0,1,0
58638,5900,0,0,62,62,0,1,0,1,0
57410,37965,0,0,66,66,0,1,0,1,0
11136,57587,0,0,62,62,0,1,0,1,0
26750,57470,0,0,66,66,0,1,0,1,0
59422,51221,0,0,66,66,0,1,0,1,0
53227,64097,0,0,66,66,0,1,0,1,0
10886,51505,0,0,62,62,0,1,0,1,0
49001,40108,0,0,161,161,0,1,0,1,0
58638,5900,0,0,62,62,0,1,0,1,0
45941,23388,0,0,60,60,0,1,0,1,0
36908,26467,0,0,62,62,0,1,0,1,0
53816,22114,0,0,62,62,0,1,0,1,0
64341,57470,0,0,62,62,0,1,0,1,0
39213,25174,0,0,62,62,0,1,0,1,0
64733,35440,0,0,66,66,0,1,0,1,0
12545,25174,0,0,146,146,0,1,0,1,0
24768,22114,0,0,146,146,0,1,0,1,0
11716,37965,0,0,62,62,0,1,0,1,0
25063,64147,0,0,62,62,0,1,0,1,0
39586,22114,0,0,66,66,0,1,0,1,0
40294,28680,0,0,145,145,0,1,0,1,0
45912,44847,0,0,62,62,0,1,0,1,0
52614,44847,0,0,62,62,0,1,0,1,0
19875,30170,0,0,145,145,0,1,0,1,0
6889,40740,0,0,143,143,0,1,0,1,0
31003,10511,0,0,145,145,0,1,0,1,0
1865,25174,0,0,62,62,0,1,0,1,0
60627,51050,0,0,66,66,0,1,0,1,0
6796,50584,0,0,62,62,0,1,0,1,0
65317,51221,0,0,78,78,0,1,0,1,0
26531,37965,0,0,62,62,0,1,0,1,0
56835,35894,0,0,66,66,0,1,0,1,0
47105,64147,0,0,62,62,0,1,0,1,0
64997,51221,0,0,66,66,0,1,0,1,0
48019,22114,0,0,66,66,0,1,0,1,0
18745,64147,0,0,62,62,0,1,0,1,0
58638,5900,0,0,62,62,0,1,0,1,0
54726,30041,0,0,66,66,0,1,0,1,0
56719,37807,0,0,66,66,0,1,0,1,0
51996,35440,0,0,66,66,0,1,0,1,0
6057,51221,0,0,62,62,0,1,0,1,0
62415,57470,0,0,66,66,0,1,0,1,0
9666,25174,0,0,86,86,0,1,0,1,0
8682,56205,0,0,66,66,0,1,0,1,0
53290,35299,0,0,66,66,0,1,0,1,0
11066,50584,0,0,62,62,0,1,0,1,0
1024,64147,0,0,62,62,0,1,0,1,0
6879,57470,0,0,99,99,0,1,0,1,0
24931,64147,0,0,66,66,0,1,0,1,0
24410,48895,0,0,153,153,0,1,0,1,0
50254,44847,0,0,65,65,0,1,0,1,0
51494,50584,0,0,66,66,0,1,0,1,0
680,57446,0,0,701,701,0,1,0,1,0
42073,35440,0,0,62,62,0,1,0,1,0
27348,22114,0,0,65,65,0,1,0,1,0
52737,25174,0,0,62,62,0,1,0,1,0
3709,56070,0,0,120,120,0,1,0,1,0
447,4509,0,0,60,60,0,1,0,1,0
3524,25174,0,0,62,62,0,1,0,1,0
27772,55990,0,0,105,105,0,1,0,1,0
30368,51454,0,0,63,63,0,1,0,1,0
54438,62413,0,0,66,66,0,1,0,1,0
14199,42820,0,0,64,64,0,1,0,1,0
6881,26296,0,0,149,149,0,1,0,1,0
43407,15503,0,0,69,69,0,1,0,1,0
46552,57822,0,0,65,65,0,1,0,1,0
3093,50584,0,0,62,62,0,1,0,1,0
58638,5900,0,0,62,62,0,1,0,1,0
13285,29892,0,0,145,145,0,1,0,1,0
54688,36829,0,0,134,134,0,1,0,1,0
52143,23718,0,0,66,66,0,1,0,1,0
58638,5900,0,0,62,62,0,1,0,1,0
64878,26467,0,0,62,62,0,1,0,1,0
59201,51221,0,0,66,66,0,1,0,1,0
64890,51180,0,0,63,63,0,1,0,1,0
443,62732,0,0,269,269,0,1,0,1,0
25679,27189,0,0,62,62,0,1,0,1,0
59594,37965,0,0,64,64,0,1,0,1,0
16645,10268,0,0,66,66,0,1,0,1,0
55516,25174,0,0,65,65,0,1,0,1,0
47966,50584,0,0,81,81,0,1,0,1,0
1026,64147,0,0,62,62,0,1,0,1,0
37343,44847,0,0,66,66,0,1,0,1,0
3937,25174,0,0,84,84,0,1,0,1,0
53459,37807,0,0,65,65,0,1,0,1,0
6666,138,0,0,60,60,0,1,0,1,0
23553,37965,0,0,62,62,0,1,0,1,0
58916,147,0,0,61,61,0,1,0,1,0
9555,35440,0,0,64,64,0,1,0,1,0
3478,61463,0,0,373,373,0,1,0,1,0
57991,30188,0,0,62,62,0,1,0,1,0
2949,44847,0,0,66,66,0,1,0,1,0
14008,42864,0,0,65,65,0,1,0,1,0
62538,53733,0,0,65,65,0,1,0,1,0
65025,57866,0,0,66,66,0,1,0,1,0
64035,25174,0,0,62,62,0,1,0,1,0
63511,50541,0,0,66,66,0,1,0,1,0
24750,25174,0,0,62,62,0,1,0,1,0
56564,9571,0,0,78,78,0,1,0,1,0
38832,11124,0,0,146,146,0,1,0,1,0
13528,51221,0,0,62,62,0,1,0,1,0
29934,37965,0,0,66,66,0,1,0,1,0
11967,57470,0,0,62,62,0,1,0,1,0
443,3144,0,0,120,120,0,1,0,1,0
59144,8419,0,0,66,66,0,1,0,1,0
48706,23393,0,0,60,60,0,1,0,1,0
9662,57470,0,0,73,73,0,1,0,1,0
19632,37965,0,0,62,62,0,1,0,1,0
58638,5900,0,0,62,62,0,1,0,1,0
24789,26794,0,0,63,63,0,1,0,1,0
53277,64097,0,0,66,66,0,1,0,1,0
50439,49060,0,0,64,64,0,1,0,1,0
58638,5900,0,0,62,62,0,1,0,1,0
49640,64147,0,0,65,65,0,1,0,1,0
48826,25174,0,0,62,62,0,1,0,1,0
61825,11392,0,0,62,62,0,1,0,1,0
36613,64147,0,0,62,62,0,1,0,1,0
1136,23,0,0,60,60,0,1,0,1,0
10597,36097,0,0,60,60,0,1,0,1,0
1038,37965,0,0,62,62,0,1,0,1,0
2995,64147,0,0,65,65,0,1,0,1,0
42973,57470,0,0,62,62,0,1,0,1,0
33774,23,0,0,60,60,0,1,0,1,0
63699,30188,0,0,62,62,0,1,0,1,0
38852,37965,0,0,62,62,0,1,0,1,0
59784,46811,0,0,66,66,0,1,0,1,0
53007,35374,0,0,66,66,0,1,0,1,0
36991,24,0,0,60,60,0,1,0,1,0
58638,5900,0,0,62,62,0,1,0,1,0
2615,17537,0,0,65,65,0,1,0,1,0
23643,23,0,0,60,60,0,1,0,1,0
54887,56205,0,0,66,66,0,1,0,1,0
30646,51217,0,0,73,73,0,1,0,1,0
51823,48817,0,0,126,126,0,1,0,1,0
13285,29892,0,0,145,145,0,1,0,1,0
57131,26296,0,0,145,145,0,1,0,1,0
44546,32468,0,0,62,62,0,1,0,1,0
52716,9623,0,0,97,97,0,1,0,1,0
38756,22114,0,0,66,66,0,1,0,1,0
38055,10468,0,0,146,146,0,1,0,1,0
15806,11392,0,0,66,66,0,1,0,1,0
52424,1433,0,0,60,60,0,1,0,1,0
30615,25174,0,0,64,64,0,1,0,1,0
61172,22114,0,0,66,66,0,1,0,1,0
12019,56205,0,0,124,124,0,1,0,1,0
50350,37965,0,0,66,66,0,1,0,1,0
13588,15503,0,0,62,62,0,1,0,1,0
23089,48817,0,0,62,62,0,1,0,1,0
59434,50584,0,0,66,66,0,1,0,1,0
778,33618,0,0,74,74,0,1,0,1,0
49164,25174,0,0,106,106,0,1,0,1,0
45550,8125,0,0,98,98,0,1,0,1,0
21098,25174,0,0,62,62,0,1,0,1,0
38920,22114,0,0,62,62,0,1,0,1,0
40155,44746,0,0,145,145,0,1,0,1,0
33248,50584,0,0,97,97,0,1,0,1,0
35376,12625,0,0,142,142,0,1,0,1,0
51463,14917,0,0,137,137,0,1,0,1,0
26446,64147,0,0,63,63,0,1,0,1,0
10983,57775,0,0,62,62,0,1,0,1,0
62142,56205,0,0,66,66,0,1,0,1,0
21191,25174,0,0,62,62,0,1,0,1,0
59798,36237,0,0,66,66,0,1,0,1,0
50535,51505,0,0,63,63,0,1,0,1,0
7790,44847,0,0,64,64,0,1,0,1,0
28795,44693,0,0,66,66,0,1,0,1,0
58638,5900,0,0,62,62,0,1,0,1,0
53957,35440,0,0,62,62,0,1,0,1,0
59051,27520,0,0,62,62,0,1,0,1,0
58767,43890,0,0,66,66,0,1,0,1,0
56289,25174,0,0,66,66,0,1,0,1,0
54397,64147,0,0,62,62,0,1,0,1,0
13285,29892,0,0,145,145,0,1,0,1,0
56731,46824,0,0,66,66,0,1,0,1,0
54989,50265,0,0,66,66,0,1,0,1,0
25369,51540,0,0,61,61,0,1,0,1,0
32051,37965,0,0,62,62,0,1,0,1,0
59204,25174,0,0,66,66,0,1,0,1,0
6259,11296,0,0,93,93,0,1,0,1,0
57585,51221,0,0,62,62,0,1,0,1,0
62365,50236,0,0,63,63,0,1,0,1,0
63405,37965,0,0,63,63,0,1,0,1,0
80,53945,0,0,60,60,0,1,0,1,0
23168,35364,0,0,66,66,0,1,0,1,0
0,0,0,0,60,60,0,1,0,1,0
80,53945,0,0,60,60,0,1,0,1,0
52410,8607,0,0,65,65,0,1,0,1,0
29184,35466,0,0,68,68,0,1,0,1,0
52847,37934,0,0,66,66,0,1,0,1,0
36457,29,0,0,60,60,0,1,0,1,0
64368,22114,0,0,66,66,0,1,0,1,0
16221,50584,0,0,62,62,0,1,0,1,0
43008,8080,0,0,60,60,0,1,0,1,0
54047,50011,0,0,62,62,0,1,0,1,0
80,9918,0,0,60,60,0,1,0,1,0
443,56219,0,0,92,92,0,1,0,1,0
36770,56205,0,0,62,62,0,1,0,1,0
19576,25174,0,0,62,62,0,1,0,1,0
62189,37869,0,0,64,64,0,1,0,1,0
52328,64098,0,0,65,65,0,1,0,1,0
46482,36237,0,0,109,109,0,1,0,1,0
63637,30188,0,0,62,62,0,1,0,1,0
57693,52707,0,0,65,65,0,1,0,1,0
1184,23,0,0,60,60,0,1,0,1,0
52575,22114,0,0,66,66,0,1,0,1,0
28926,51505,0,0,146,146,0,1,0,1,0
48767,1568,0,0,106,106,0,1,0,1,0
1029,64147,0,0,62,62,0,1,0,1,0
15222,25174,0,0,116,116,0,1,0,1,0
47910,7454,0,0,60,60,0,1,0,1,0
39405,36703,0,0,128,128,0,1,0,1,0
52596,17372,0,0,66,66,0,1,0,1,0
62551,62047,0,0,64,64,0,1,0,1,0
41393,50584,0,0,84,84,0,1,0,1,0
22530,25056,0,0,62,62,0,1,0,1,0
6359,26467,0,0,64,64,0,1,0,1,0
6725,21268,0,0,72,72,0,1,0,1,0
43270,50584,0,0,63,63,0,1,0,1,0
54619,44847,0,0,69,69,0,1,0,1,0
35558,15503,0,0,66,66,0,1,0,1,0
10951,22114,0,0,77,77,0,1,0,1,0
50245,44847,0,0,66,66,0,1,0,1,0
61013,41705,0,0,66,66,0,1,0,1,0
33861,57470,0,0,70,70,0,1,0,1,0
52670,36135,0,0,62,62,0,1,0,1,0
15889,50584,0,0,73,73,0,1,0,1,0
54812,2998,0,0,63,63,0,1,0,1,0
0,0,0,0,98,98,0,1,0,1,0
52759,15503,0,0,66,66,0,1,0,1,0
51944,56205,0,0,64,64,0,1,0,1,0
58638,5900,0,0,62,62,0,1,0,1,0
16106,22136,0,0,61,61,0,1,0,1,0
1124,44847,0,0,63,63,0,1,0,1,0
17240,25174,0,0,146,146,0,1,0,1,0
10099,44847,0,0,64,64,0,1,0,1,0
43347,15503,0,0,67,67,0,1,0,1,0
61322,23,0,0,60,60,0,1,0,1,0
6970,26531,0,0,139,139,0,1,0,1,0
37959,3855,0,0,72,72,0,1,0,1,0
48706,23393,0,0,60,60,0,1,0,1,0
53089,24211,0,0,66,66,0,1,0,1,0
61515,64147,0,0,66,66,0,1,0,1,0
62191,22114,0,0,66,66,0,1,0,1,0
50104,1544,0,0,75,75,0,1,0,1,0
37802,5900,0,0,60,60,0,1,0,1,0
59116,57470,0,0,66,66,0,1,0,1,0
54748,36829,0,0,119,119,0,1,0,1,0
62000,8928,0,0,61,61,0,1,0,1,0
38852,37965,0,0,62,62,0,1,0,1,0
58638,5900,0,0,62,62,0,1,0,1,0
52091,11392,0,0,66,66,0,1,0,1,0
62709,57470,0,0,62,62,0,1,0,1,0
41967,27995,0,0,135,135,0,1,0,1,0
1024,25174,0,0,146,146,0,1,0,1,0
42684,51179,0,0,62,62,0,1,0,1,0
3478,61463,0,0,892,892,0,1,0,1,0
15874,50584,0,0,62,62,0,1,0,1,0
58238,23,0,0,60,60,0,1,0,1,0
51414,22,0,0,60,60,0,1,0,1,0
38565,51505,0,0,66,66,0,1,0,1,0
64756,11392,0,0,70,70,0,1,0,1,0
63328,37807,0,0,66,66,0,1,0,1,0
54550,37864,0,0,64,64,0,1,0,1,0
60249,25174,0,0,63,63,0,1,0,1,0
58638,5900,0,0,62,62,0,1,0,1,0
10440,57470,0,0,62,62,0,1,0,1,0
58638,5900,0,0,62,62,0,1,0,1,0
49144,25174,0,0,137,137,0,1,0,1,0
28493,64147,0,0,64,64,0,1,0,1,0
53462,23,0,0,60,60,0,1,0,1,0
3478,61463,0,0,335,335,0,1,0,1,0
33686,37965,0,0,62,62,0,1,0,1,0
1028,30185,0,0,147,147,0,1,0,1,0
6195,44847,0,0,65,65,0,1,0,1,0
5825,44847,0,0,64,64,0,1,0,1,0
34879,51185,0,0,61,61,0,1,0,1,0
62792,53,0,0,88,88,0,1,0,1,0
49529,35870,0,0,80,80,0,1,0,1,0
60793,53733,0,0,66,66,0,1,0,1,0
17415,54833,0,0,62,62,0,1,0,1,0
58638,5900,0,0,62,62,0,1,0,1,0
58638,5900,0,0,62,62,0,1,0,1,0
18016,11392,0,0,62,62,0,1,0,1,0
9762,73,0,0,60,60,0,1,0,1,0
2920,25174,0,0,127,127,0,1,0,1,0
58638,5900,0,0,62,62,0,1,0,1,0
9687,57470,0,0,78,78,0,1,0,1,0
62731,51221,0,0,66,66,0,1,0,1,0
0,0,0,0,98,98,0,1,0,1,0
10669,49756,0,0,60,60,0,1,0,1,0
31422,12047,0,0,102,102,0,1,0,1,0
17292,22114,0,0,65,65,0,1,0,1,0
11982,57470,0,0,62,62,0,1,0,1,0
59781,56205,0,0,66,66,0,1,0,1,0
53782,30260,0,0,66,66,0,1,0,1,0
47910,7463,0,0,60,60,0,1,0,1,0
56947,9,0,0,63,63,0,1,0,1,0
54742,37965,0,0,66,66,0,1,0,1,0
63324,54375,0,0,77,77,0,1,0,1,0
52761,15503,0,0,66,66,0,1,0,1,0
42112,36237,0,0,85,85,0,1,0,1,0
20389,44847,0,0,62,62,0,1,0,1,0
10540,25174,0,0,62,62,0,1,0,1,0
60845,25174,0,0,64,64,0,1,0,1,0
58436,44847,0,0,62,62,0,1,0,1,0
10416,11392,0,0,64,64,0,1,0,1,0
59394,51505,0,0,64,64,0,1,0,1,0
43207,26467,0,0,62,62,0,1,0,1,0
35154,42707,0,0,62,62,0,1,0,1,0
49418,22114,0,0,62,62,0,1,0,1,0
61945,48817,0,0,77,77,0,1,0,1,0
52244,26467,0,0,62,62,0,1,0,1,0
24227,50584,0,0,62,62,0,1,0,1,0
29057,44847,0,0,66,66,0,1,0,1,0
57239,42707,0,0,63,63,0,1,0,1,0
56329,1395,0,0,61,61,0,1,0,1,0
56223,22114,0,0,65,65,0,1,0,1,0
22271,22,0,0,60,60,0,1,0,1,0
2087,3013,0,0,63,63,0,1,0,1,0
63780,35440,0,0,66,66,0,1,0,1,0
62164,57470,0,0,71,71,0,1,0,1,0
3059,50584,0,0,97,97,0,1,0,1,0
5223,14446,0,0,220,220,0,1,0,1,0
27507,25174,0,0,62,62,0,1,0,1,0
64808,62413,0,0,64,64,0,1,0,1,0
58638,5900,0,0,62,62,0,1,0,1,0
58833,21,0,0,60,60,0,1,0,1,0
11939,35850,0,0,66,66,0,1,0,1,0
17248,35440,0,0,62,62,0,1,0,1,0
52709,25174,0,0,66,66,0,1,0,1,0
45964,2225,0,0,60,60,0,1,0,1,0
63398,25174,0,0,66,66,0,1,0,1,0
23324,25174,0,0,85,85,0,1,0,1,0
26706,25174,0,0,62,62,0,1,0,1,0
56197,1357,0,0,63,63,0,1,0,1,0
48071,25174,0,0,122,122,0,1,0,1,0
55849,62413,0,0,66,66,0,1,0,1,0
56140,37965,0,0,66,66,0,1,0,1,0
57654,50584,0,0,66,66,0,1,0,1,0
1824,64147,0,0,66,66,0,1,0,1,0
56860,11421,0,0,66,66,0,1,0,1,0
61451,17500,0,0,63,63,0,1,0,1,0
3174,44847,0,0,67,67,0,1,0,1,0
14916,57553,0,0,69,69,0,1,0,1,0
62080,54532,0,0,60,60,0,1,0,1,0
56865,11424,0,0,63,63,0,1,0,1,0
10158,57470,0,0,62,62,0,1,0,1,0
26419,37965,0,0,66,66,0,1,0,1,0
50637,36237,0,0,66,66,0,1,0,1,0
47440,25174,0,0,65,65,0,1,0,1,0
57990,22114,0,0,66,66,0,1,0,1,0
59726,55925,0,0,63,63,0,1,0,1,0
22587,30188,0,0,66,66,0,1,0,1,0
30409,56278,0,0,145,145,0,1,0,1,0
10073,64147,0,0,62,62,0,1,0,1,0
56857,18375,0,0,63,63,0,1,0,1,0
63988,25174,0,0,134,134,0,1,0,1,0
1025,64147,0,0,62,62,0,1,0,1,0
55890,64132,0,0,64,64,0,1,0,1,0
30998,35440,0,0,75,75,0,1,0,1,0
52982,57543,0,0,87,87,0,1,0,1,0
22407,30188,0,0,63,63,0,1,0,1,0
57131,31061,0,0,145,145,0,1,0,1,0
51288,37965,0,0,64,64,0,1,0,1,0
52903,37901,0,0,66,66,0,1,0,1,0
42798,26467,0,0,62,62,0,1,0,1,0
55375,26467,0,0,62,62,0,1,0,1,0
22724,9822,0,0,64,64,0,1,0,1,0
53469,44847,0,0,66,66,0,1,0,1,0
6889,48720,0,0,143,143,0,1,0,1,0
56318,62413,0,0,66,66,0,1,0,1,0
44594,64147,0,0,66,66,0,1,0,1,0
39195,25174,0,0,136,136,0,1,0,1,0
32143,61999,0,0,109,109,0,1,0,1,0
13526,51327,0,0,62,62,0,1,0,1,0
11044,30188,0,0,132,132,0,1,0,1,0
27527,25174,0,0,116,116,0,1,0,1,0
443,4205,0,0,242,242,0,1,0,1,0
59918,44847,0,0,66,66,0,1,0,1,0
48706,23393,0,0,60,60,0,1,0,1,0
60052,37965,0,0,66,66,0,1,0,1,0
58638,5900,0,0,62,62,0,1,0,1,0
58638,5900,0,0,62,62,0,1,0,1,0
56270,4,0,0,132,132,0,1,0,1,0
63629,56273,0,0,66,66,0,1,0,1,0
55289,22114,0,0,64,64,0,1,0,1,0
494,10154,0,0,61,61,0,1,0,1,0
50052,65008,0,0,60,60,0,1,0,1,0
51614,21374,0,0,66,66,0,1,0,1,0
59117,57470,0,0,66,66,0,1,0,1,0
62810,37807,0,0,63,63,0,1,0,1,0
58464,11392,0,0,66,66,0,1,0,1,0
26277,37965,0,0,66,66,0,1,0,1,0
5010,44847,0,0,62,62,0,1,0,1,0
6666,3083,0,0,60,60,0,1,0,1,0
34095,5702,0,0,105,105,0,1,0,1,0
65494,53,0,0,88,88,0,1,0,1,0
59173,35440,0,0,62,62,0,1,0,1,0
59567,25174,0,0,62,62,0,1,0,1,0
22591,9914,0,0,62,62,0,1,0,1,0
6881,51473,0,0,66,66,0,1,0,1,0
56431,50520,0,0,99,99,0,1,0,1,0
29697,51221,0,0,62,62,0,1,0,1,0
49811,5900,0,0,60,60,0,1,0,1,0
61241,22114,0,0,66,66,0,1,0,1,0
13429,35440,0,0,65,65,0,1,0,1,0
35924,19,0,0,72,72,0,1,0,1,0
48706,23393,0,0,60,60,0,1,0,1,0
0,0,0,0,98,98,0,1,0,1,0
58638,5900,0,0,62,62,0,1,0,1,0
58638,5900,0,0,62,62,0,1,0,1,0
10595,37965,0,0,62,62,0,1,0,1,0
55418,64147,0,0,66,66,0,1,0,1,0
2714,30188,0,0,63,63,0,1,0,1,0
59783,62413,0,0,62,62,0,1,0,1,0
46859,50584,0,0,62,62,0,1,0,1,0
38586,51221,0,0,62,62,0,1,0,1,0
61916,64097,0,0,66,66,0,1,0,1,0
58791,25174,0,0,125,125,0,1,0,1,0
1186,64147,0,0,65,65,0,1,0,1,0
50041,64147,0,0,62,62,0,1,0,1,0
443,62451,0,0,199,199,0,1,0,1,0
26392,44847,0,0,146,146,0,1,0,1,0
6744,4897,0,0,72,72,0,1,0,1,0
49664,37965,0,0,66,66,0,1,0,1,0
443,45788,0,0,199,199,0,1,0,1,0
56677,50584,0,0,64,64,0,1,0,1,0
7319,50584,0,0,64,64,0,1,0,1,0
52631,30188,0,0,66,66,0,1,0,1,0
54488,36237,0,0,66,66,0,1,0,1,0
10669,49756,0,0,60,60,0,1,0,1,0
16382,35527,0,0,60,60,0,1,0,1,0
63505,44847,0,0,63,63,0,1,0,1,0
50873,44847,0,0,66,66,0,1,0,1,0
20624,25388,0,0,62,62,0,1,0,1,0
50392,37884,0,0,66,66,0,1,0,1,0
14398,37970,0,0,63,63,0,1,0,1,0
57885,30220,0,0,63,63,0,1,0,1,0
53164,44847,0,0,143,143,0,1,0,1,0
59366,35440,0,0,63,63,0,1,0,1,0
443,39799,0,0,75,75,0,1,0,1,0
53844,31573,0,0,66,66,0,1,0,1,0
58638,5900,0,0,62,62,0,1,0,1,0
56947,8,0,0,63,63,0,1,0,1,0
51045,51817,0,0,79,79,0,1,0,1,0
42114,36237,0,0,65,65,0,1,0,1,0
7037,40387,0,0,116,116,0,1,0,1,0
44472,50584,0,0,146,146,0,1,0,1,0
54346,44847,0,0,65,65,0,1,0,1,0
45208,25174,0,0,146,146,0,1,0,1,0
2394,43890,0,0,62,62,0,1,0,1,0
53113,25174,0,0,63,63,0,1,0,1,0
51983,25174,0,0,64,64,0,1,0,1,0
64058,23718,0,0,62,62,0,1,0,1,0
58797,44847,0,0,72,72,0,1,0,1,0
58790,30188,0,0,66,66,0,1,0,1,0
58217,9007,0,0,60,60,0,1,0,1,0
19875,30170,0,0,145,145,0,1,0,1,0
54835,56205,0,0,66,66,0,1,0,1,0
58102,22114,0,0,65,65,0,1,0,1,0
45941,23388,0,0,60,60,0,1,0,1,0
27507,25174,0,0,62,62,0,1,0,1,0
8239,37965,0,0,146,146,0,1,0,1,0
32608,47431,0,0,63,63,0,1,0,1,0
45269,50584,0,0,62,62,0,1,0,1,0
50620,50584,0,0,66,66,0,1,0,1,0
63561,37965,0,0,66,66,0,1,0,1,0
48487,44847,0,0,79,79,0,1,0,1,0
28824,44847,0,0,63,63,0,1,0,1,0
28221,37965,0,0,62,62,0,1,0,1,0
52947,23718,0,0,72,72,0,1,0,1,0
12998,55804,0,0,65,65,0,1,0,1,0
23939,41615,0,0,145,145,0,1,0,1,0
27035,22114,0,0,62,62,0,1,0,1,0
57688,64147,0,0,64,64,0,1,0,1,0
38364,11293,0,0,92,92,0,1,0,1,0
6550,25174,0,0,64,64,0,1,0,1,0
31555,11803,0,0,118,118,0,1,0,1,0
45419,64147,0,0,69,69,0,1,0,1,0
17022,62378,0,0,67,67,0,1,0,1,0
59591,56205,0,0,63,63,0,1,0,1,0
18029,50584,0,0,66,66,0,1,0,1,0
63079,64147,0,0,62,62,0,1,0,1,0
20819,23,0,0,60,60,0,1,0,1,0
51873,46570,0,0,64,64,0,1,0,1,0
62849,21247,0,0,66,66,0,1,0,1,0
51413,57470,0,0,72,72,0,1,0,1,0
4162,35440,0,0,62,62,0,1,0,1,0
23531,48962,0,0,146,146,0,1,0,1,0
53319,26467,0,0,62,62,0,1,0,1,0
56100,50584,0,0,66,66,0,1,0,1,0
58638,5900,0,0,62,62,0,1,0,1,0
61223,37965,0,0,64,64,0,1,0,1,0
56403,51494,0,0,66,66,0,1,0,1,0
58638,5900,0,0,62,62,0,1,0,1,0
62126,64147,0,0,64,64,0,1,0,1,0
58638,5900,0,0,62,62,0,1,0,1,0
60091,56205,0,0,62,62,0,1,0,1,0
49336,35960,0,0,92,92,0,1,0,1,0
8999,49152,0,0,137,137,0,1,0,1,0
64535,37965,0,0,62,62,0,1,0,1,0
46078,32713,0,0,72,72,0,1,0,1,0
51979,25174,0,0,66,66,0,1,0,1,0
57317,64147,0,0,66,66,0,1,0,1,0
48071,25174,0,0,62,62,0,1,0,1,0
21145,11392,0,0,75,75,0,1,0,1,0
61185,54532,0,0,131,131,0,1,0,1,0
45964,2225,0,0,60,60,0,1,0,1,0
1024,57470,0,0,62,62,0,1,0,1,0
4565,23,0,0,60,60,0,1,0,1,0
7174,64147,0,0,64,64,0,1,0,1,0
34489,35440,0,0,65,65,0,1,0,1,0
1024,64147,0,0,62,62,0,1,0,1,0
35187,26467,0,0,62,62,0,1,0,1,0
17842,49124,0,0,145,145,0,1,0,1,0
15573,64147,0,0,66,66,0,1,0,1,0
38880,37965,0,0,62,62,0,1,0,1,0
61870,22114,0,0,65,65,0,1,0,1,0
24373,6779,0,0,61,61,0,1,0,1,0
63483,30346,0,0,86,86,0,1,0,1,0
10003,64147,0,0,62,62,0,1,0,1,0
47030,25174,0,0,62,62,0,1,0,1,0
52103,53733,0,0,66,66,0,1,0,1,0
6893,55847,0,0,144,144,0,1,0,1,0
50675,56205,0,0,66,66,0,1,0,1,0
26921,57470,0,0,62,62,0,1,0,1,0
1024,57470,0,0,62,62,0,1,0,1,0
5234,32923,0,0,114,114,0,1,0,1,0
15502,64147,0,0,66,66,0,1,0,1,0
63540,30232,0,0,72,72,0,1,0,1,0
56269,26467,0,0,62,62,0,1,0,1,0
41677,57470,0,0,66,66,0,1,0,1,0
58250,64147,0,0,66,66,0,1,0,1,0
30233,57470,0,0,60,60,0,1,0,1,0
4257,35440,0,0,62,62,0,1,0,1,0
28513,64147,0,0,62,62,0,1,0,1,0
50470,61463,0,0,86,86,0,1,0,1,0
9541,26467,0,0,64,64,0,1,0,1,0
53195,51221,0,0,69,69,0,1,0,1,0
32103,51221,0,0,62,62,0,1,0,1,0
22264,22114,0,0,134,134,0,1,0,1,0
29576,37807,0,0,66,66,0,1,0,1,0
10396,22114,0,0,89,89,0,1,0,1,0
56135,37807,0,0,62,62,0,1,0,1,0
63465,37807,0,0,62,62,0,1,0,1,0
12644,11395,0,0,62,62,0,1,0,1,0
10532,26672,0,0,60,60,0,1,0,1,0
29300,36237,0,0,136,136,0,1,0,1,0
32464,50391,0,0,113,113,0,1,0,1,0
40797,25174,0,0,62,62,0,1,0,1,0
61276,23718,0,0,62,62,0,1,0,1,0
5228,3434,0,0,544,544,0,1,0,1,0
54796,22114,0,0,63,63,0,1,0,1,0
52338,64122,0,0,64,64,0,1,0,1,0
12242,51221,0,0,62,62,0,1,0,1,0
54280,3385,0,0,60,60,0,1,0,1,0
59315,57482,0,0,73,73,0,1,0,1,0
45565,22114,0,0,100,100,0,1,0,1,0
1187,64147,0,0,66,66,0,1,0,1,0
49001,40108,0,0,161,161,0,1,0,1,0
45540,64147,0,0,62,62,0,1,0,1,0
47910,7461,0,0,60,60,0,1,0,1,0
3478,61463,0,0,1049,1049,0,1,0,1,0
43260,41615,0,0,145,145,0,1,0,1,0
49416,22114,0,0,62,62,0,1,0,1,0
59664,37953,0,0,66,66,0,1,0,1,0
15249,36312,0,0,62,62,0,1,0,1,0
52459,5555,0,0,60,60,0,1,0,1,0
5423,64147,0,0,110,110,0,1,0,1,0
3407,57866,0,0,66,66,0,1,0,1,0
63830,25174,0,0,65,65,0,1,0,1,0
62982,11525,0,0,62,62,0,1,0,1,0
55145,11392,0,0,66,66,0,1,0,1,0
16387,35244,0,0,60,60,0,1,0,1,0
61961,11392,0,0,66,66,0,1,0,1,0
63385,25174,0,0,66,66,0,1,0,1,0
56623,51505,0,0,62,62,0,1,0,1,0
1035,35944,0,0,112,112,0,1,0,1,0
58905,179,0,0,62,62,0,1,0,1,0
14089,50627,0,0,69,69,0,1,0,1,0
58638,5900,0,0,62,62,0,1,0,1,0
3520,57580,0,0,63,63,0,1,0,1,0
3005,37965,0,0,62,62,0,1,0,1,0
19960,30173,0,0,145,145,0,1,0,1,0
63027,35440,0,0,66,66,0,1,0,1,0
9442,56205,0,0,65,65,0,1,0,1,0
57696,64147,0,0,66,66,0,1,0,1,0
49796,25174,0,0,87,87,0,1,0,1,0
56595,11392,0,0,66,66,0,1,0,1,0
50052,65008,0,0,60,60,0,1,0,1,0
63388,62413,0,0,66,66,0,1,0,1,0
41196,25174,0,0,62,62,0,1,0,1,0
23277,25174,0,0,64,64,0,1,0,1,0
36317,64147,0,0,63,63,0,1,0,1,0
56540,23718,0,0,66,66,0,1,0,1,0
57206,26441,0,0,77,77,0,1,0,1,0
11698,25174,0,0,65,65,0,1,0,1,0
1098,51272,0,0,77,77,0,1,0,1,0
57466,34189,0,0,96,96,0,1,0,1,0
5617,64147,0,0,83,83,0,1,0,1,0
33558,44847,0,0,64,64,0,1,0,1,0
57164,50584,0,0,62,62,0,1,0,1,0
1024,64147,0,0,62,62,0,1,0,1,0
56209,22114,0,0,64,64,0,1,0,1,0
63341,37907,0,0,66,66,0,1,0,1,0
48706,23393,0,0,60,60,0,1,0,1,0
36038,35440,0,0,62,62,0,1,0,1,0
43260,41615,0,0,145,145,0,1,0,1,0
6182,26467,0,0,63,63,0,1,0,1,0
49717,57470,0,0,62,62,0,1,0,1,0
50211,51050,0,0,66,66,0,1,0,1,0
45980,5362,0,0,60,60,0,1,0,1,0
49187,25174,0,0,88,88,0,1,0,1,0
14370,51421,0,0,122,122,0,1,0,1,0
38899,37965,0,0,62,62,0,1,0,1,0
31839,57470,0,0,61,61,0,1,0,1,0
8239,37965,0,0,146,146,0,1,0,1,0
26287,56205,0,0,62,62,0,1,0,1,0
35111,22114,0,0,66,66,0,1,0,1,0
65146,5607,0,0,60,60,0,1,0,1,0
58754,64114,0,0,62,62,0,1,0,1,0
19556,30179,0,0,99,99,0,1,0,1,0
42252,33303,0,0,60,60,0,1,0,1,0
40547,24051,0,0,74,74,0,1,0,1,0
53104,36237,0,0,64,64,0,1,0,1,0
29945,23,0,0,60,60,0,1,0,1,0
443,60496,0,0,320,320,0,1,0,1,0
52259,39321,0,0,83,83,0,1,0,1,0
55057,44556,0,0,62,62,0,1,0,1,0
49699,64147,0,0,66,66,0,1,0,1,0
15594,50191,0,0,73,73,0,1,0,1,0
32215,22114,0,0,63,63,0,1,0,1,0
57339,50584,0,0,65,65,0,1,0,1,0
61374,44847,0,0,66,66,0,1,0,1,0
9506,23,0,0,60,60,0,1,0,1,0
61861,50584,0,0,66,66,0,1,0,1,0
62386,37965,0,0,62,62,0,1,0,1,0
443,44683,0,0,83,83,0,1,0,1,0
3562,64147,0,0,62,62,0,1,0,1,0
10074,32480,0,0,66,66,0,1,0,1,0
22654,30188,0,0,62,62,0,1,0,1,0
43948,21,0,0,60,60,0,1,0,1,0
27272,6881,0,0,66,66,0,1,0,1,0
56604,17372,0,0,66,66,0,1,0,1,0
58778,64124,0,0,62,62,0,1,0,1,0
443,44683,0,0,83,83,0,1,0,1,0
49001,40108,0,0,161,161,0,1,0,1,0
60842,15503,0,0,114,114,0,1,0,1,0
3478,61463,0,0,221,221,0,1,0,1,0
12969,55777,0,0,66,66,0,1,0,1,0
62797,37831,0,0,66,66,0,1,0,1,0
6884,65130,0,0,144,144,0,1,0,1,0
58638,5900,0,0,62,62,0,1,0,1,0
14612,6881,0,0,63,63,0,1,0,1,0
58638,5900,0,0,62,62,0,1,0,1,0
57259,51054,0,0,66,66,0,1,0,1,0
28061,64147,0,0,65,65,0,1,0,1,0
50713,57470,0,0,66,66,0,1,0,1,0
56079,56205,0,0,131,131,0,1,0,1,0
47763,25174,0,0,62,62,0,1,0,1,0
58638,5900,0,0,62,62,0,1,0,1,0
9193,7701,0,0,106,106,0,1,0,1,0
63647,35440,0,0,64,64,0,1,0,1,0
42796,22114,0,0,62,62,0,1,0,1,0
1024,64147,0,0,62,62,0,1,0,1,0
35880,47981,0,0,60,60,0,1,0,1,0
1023,57901,0,0,144,144,0,1,0,1,0
58638,5900,0,0,62,62,0,1,0,1,0
52430,8702,0,0,65,65,0,1,0,1,0
60192,35440,0,0,65,65,0,1,0,1,0
7992,64147,0,0,62,62,0,1,0,1,0
46283,64147,0,0,62,62,0,1,0,1,0
61036,38938,0,0,65,65,0,1,0,1,0
6881,6881,0,0,62,62,0,1,0,1,0
12156,22114,0,0,62,62,0,1,0,1,0
61315,48817,0,0,62,62,0,1,0,1,0
61292,56205,0,0,62,62,0,1,0,1,0
11344,42873,0,0,62,62,0,1,0,1,0
59584,36237,0,0,64,64,0,1,0,1,0
57797,64147,0,0,64,64,0,1,0,1,0
1036,64147,0,0,79,79,0,1,0,1,0
1477,35440,0,0,126,126,0,1,0,1,0
979,47763,0,0,144,144,0,1,0,1,0
64759,57470,0,0,69,69,0,1,0,1,0
61055,38547,0,0,64,64,0,1,0,1,0
27144,25174,0,0,66,66,0,1,0,1,0
23218,62413,0,0,62,62,0,1,0,1,0
45659,54,0,0,60,60,0,1,0,1,0
443,64347,0,0,84,84,0,1,0,1,0
16387,8455,0,0,60,60,0,1,0,1,0
55757,30188,0,0,66,66,0,1,0,1,0
51635,21430,0,0,66,66,0,1,0,1,0
9448,57866,0,0,120,120,0,1,0,1,0
53969,62413,0,0,128,128,0,1,0,1,0
4128,55785,0,0,67,67,0,1,0,1,0
41672,56205,0,0,65,65,0,1,0,1,0
49809,25174,0,0,63,63,0,1,0,1,0
59421,50584,0,0,66,66,0,1,0,1,0
36740,22400,0,0,63,63,0,1,0,1,0
53376,22114,0,0,80,80,0,1,0,1,0
9456,44847,0,0,132,132,0,1,0,1,0
58151,57470,0,0,66,66,0,1,0,1,0
23691,44847,0,0,113,113,0,1,0,1,0
60184,35440,0,0,66,66,0,1,0,1,0
11068,23,0,0,60,60,0,1,0,1,0
53829,36237,0,0,62,62,0,1,0,1,0
9745,26467,0,0,62,62,0,1,0,1,0
12183,22114,0,0,62,62,0,1,0,1,0
44886,31573,0,0,104,104,0,1,0,1,0
1024,25174,0,0,62,62,0,1,0,1,0
58638,5900,0,0,62,62,0,1,0,1,0
16387,35583,0,0,60,60,0,1,0,1,0
57131,35776,0,0,145,145,0,1,0,1,0
7249,44845,0,0,66,66,0,1,0,1,0
42965,44847,0,0,64,64,0,1,0,1,0
63984,57470,0,0,62,62,0,1,0,1,0
37779,37965,0,0,62,62,0,1,0,1,0
26953,6881,0,0,120,120,0,1,0,1,0
52830,44847,0,0,66,66,0,1,0,1,0
58638,5900,0,0,62,62,0,1,0,1,0
56448,1430,0,0,60,60,0,1,0,1,0
10390,26467,0,0,62,62,0,1,0,1,0
64392,25174,0,0,65,65,0,1,0,1,0
32342,62413,0,0,64,64,0,1,0,1,0
57500,37965,0,0,62,62,0,1,0,1,0
6692,62096,0,0,62,62,0,1,0,1,0
524,32762,0,0,96,96,0,1,0,1,0
53260,36237,0,0,87,87,0,1,0,1,0
54035,50265,0,0,64,64,0,1,0,1,0
515,10214,0,0,63,63,0,1,0,1,0
32971,51221,0,0,66,66,0,1,0,1,0
56442,11392,0,0,66,66,0,1,0,1,0
61902,50532,0,0,92,92,0,1,0,1,0
32510,47191,0,0,100,100,0,1,0,1,0
56826,22114,0,0,63,63,0,1,0,1,0
10003,64147,0,0,62,62,0,1,0,1,0
0,0,0,0,98,98,0,1,0,1,0
2565,7001,0,0,62,62,0,1,0,1,0
16464,25174,0,0,66,66,0,1,0,1,0
52561,22,0,0,60,60,0,1,0,1,0
50606,57470,0,0,66,66,0,1,0,1,0
14263,51289,0,0,65,65,0,1,0,1,0
50542,51505,0,0,66,66,0,1,0,1,0
6666,2547,0,0,60,60,0,1,0,1,0
61519,37812,0,0,66,66,0,1,0,1,0
64727,25174,0,0,66,66,0,1,0,1,0
29016,25174,0,0,62,62,0,1,0,1,0
54513,37837,0,0,65,65,0,1,0,1,0
62206,37965,0,0,65,65,0,1,0,1,0
48559,48719,0,0,149,149,0,1,0,1,0
13842,48643,0,0,76,76,0,1,0,1,0
51558,37965,0,0,72,72,0,1,0,1,0
51634,25174,0,0,66,66,0,1,0,1,0
50439,64147,0,0,66,66,0,1,0,1,0
59498,44847,0,0,66,66,0,1,0,1,0
59030,44847,0,0,67,67,0,1,0,1,0
31588,50584,0,0,130,130,0,1,0,1,0
43248,19,0,0,60,60,0,1,0,1,0
58500,44847,0,0,66,66,0,1,0,1,0
1026,64147,0,0,62,62,0,1,0,1,0
41744,37965,0,0,62,62,0,1,0,1,0
57302,62413,0,0,66,66,0,1,0,1,0
63263,57470,0,0,66,66,0,1,0,1,0
59584,36237,0,0,66,66,0,1,0,1,0
41213,25174,0,0,62,62,0,1,0,1,0
53676,35974,0,0,60,60,0,1,0,1,0
58638,5900,0,0,62,62,0,1,0,1,0
58814,9545,0,0,62,62,0,1,0,1,0
59943,37807,0,0,62,62,0,1,0,1,0
60002,37965,0,0,66,66,0,1,0,1,0
64907,44248,0,0,66,66,0,1,0,1,0
58463,62413,0,0,63,63,0,1,0,1,0
57987,56125,0,0,90,90,0,1,0,1,0
22354,22114,0,0,62,62,0,1,0,1,0
62303,44847,0,0,65,65,0,1,0,1,0
9079,23,0,0,60,60,0,1,0,1,0
46596,57866,0,0,66,66,0,1,0,1,0
57811,28900,0,0,96,96,0,1,0,1,0
28898,44847,0,0,62,62,0,1,0,1,0
60101,31506,0,0,71,71,0,1,0,1,0
4697,23,0,0,60,60,0,1,0,1,0
46547,36237,0,0,65,65,0,1,0,1,0
37894,37965,0,0,62,62,0,1,0,1,0
63302,57470,0,0,66,66,0,1,0,1,0
64867,57470,0,0,73,73,0,1,0,1,0
443,61686,0,0,436,436,0,1,0,1,0
11136,19910,0,0,62,62,0,1,0,1,0
53871,37965,0,0,66,66,0,1,0,1,0
16620,25174,0,0,62,62,0,1,0,1,0
10467,25174,0,0,69,69,0,1,0,1,0
52706,57866,0,0,62,62,0,1,0,1,0
49846,35440,0,0,62,62,0,1,0,1,0
22330,25174,0,0,105,105,0,1,0,1,0
61076,37965,0,0,70,70,0,1,0,1,0
16693,10,0,0,61,61,0,1,0,1,0
59097,2767,0,0,66,66,0,1,0,1,0
46201,21466,0,0,124,124,0,1,0,1,0
60646,51299,0,0,66,66,0,1,0,1,0
49502,44847,0,0,66,66,0,1,0,1,0
61876,25174,0,0,62,62,0,1,0,1,0
57131,35776,0,0,145,145,0,1,0,1,0
57837,64147,0,0,65,65,0,1,0,1,0
15847,64147,0,0,64,64,0,1,0,1,0
49540,50584,0,0,66,66,0,1,0,1,0
4663,36144,0,0,115,115,0,1,0,1,0
59134,25174,0,0,120,120,0,1,0,1,0
50296,25174,0,0,63,63,0,1,0,1,0
64279,23718,0,0,97,97,0,1,0,1,0
54016,42707,0,0,62,62,0,1,0,1,0
63037,22114,0,0,65,65,0,1,0,1,0
13285,29892,0,0,145,145,0,1,0,1,0
42306,51003,0,0,100,100,0,1,0,1,0
56622,50584,0,0,62,62,0,1,0,1,0
17358,25174,0,0,64,64,0,1,0,1,0
26053,33720,0,0,160,160,0,1,0,1,0
52700,56205,0,0,66,66,0,1,0,1,0
13154,35710,0,0,66,66,0,1,0,1,0
3478,61463,0,0,164,164,0,1,0,1,0
55890,64147,0,0,64,64,0,1,0,1,0
63238,25174,0,0,66,66,0,1,0,1,0
58638,5900,0,0,62,62,0,1,0,1,0
47009,64147,0,0,62,62,0,1,0,1,0
35944,51220,0,0,69,69,0,1,0,1,0
23377,35301,0,0,64,64,0,1,0,1,0
14740,26467,0,0,62,62,0,1,0,1,0
64857,57470,0,0,72,72,0,1,0,1,0
24503,50584,0,0,62,62,0,1,0,1,0
62631,37965,0,0,66,66,0,1,0,1,0
40254,25174,0,0,62,62,0,1,0,1,0
57244,51057,0,0,66,66,0,1,0,1,0
45964,2225,0,0,60,60,0,1,0,1,0
51093,57470,0,0,66,66,0,1,0,1,0
14178,21755,0,0,64,64,0,1,0,1,0
9229,42844,0,0,131,131,0,1,0,1,0
48676,53395,0,0,60,60,0,1,0,1,0
23089,48817,0,0,62,62,0,1,0,1,0
59427,50436,0,0,67,67,0,1,0,1,0
50558,22114,0,0,62,62,0,1,0,1,0
24206,26308,0,0,141,141,0,1,0,1,0
57987,56125,0,0,90,90,0,1,0,1,0
21407,23,0,0,60,60,0,1,0,1,0
56299,52712,0,0,65,65,0,1,0,1,0
56060,22114,0,0,66,66,0,1,0,1,0
37678,15503,0,0,104,104,0,1,0,1,0
16330,57281,0,0,61,61,0,1,0,1,0
51222,59409,0,0,97,97,0,1,0,1,0
54304,50584,0,0,66,66,0,1,0,1,0
19875,30170,0,0,145,145,0,1,0,1,0
60059,18130,0,0,66,66,0,1,0,1,0
35834,4,0,0,131,131,0,1,0,1,0
59475,22114,0,0,66,66,0,1,0,1,0
26180,35440,0,0,64,64,0,1,0,1,0
58638,5900,0,0,62,62,0,1,0,1,0
27402,22114,0,0,62,62,0,1,0,1,0
51428,14927,0,0,131,131,0,1,0,1,0
61610,23,0,0,60,60,0,1,0,1,0
17264,22114,0,0,62,62,0,1,0,1,0
26881,25174,0,0,65,65,0,1,0,1,0
58627,15503,0,0,66,66,0,1,0,1,0
54530,35440,0,0,66,66,0,1,0,1,0
56475,50457,0,0,132,132,0,1,0,1,0
35537,22114,0,0,62,62,0,1,0,1,0
56794,46824,0,0,66,66,0,1,0,1,0
65384,57470,0,0,66,66,0,1,0,1,0
59389,51505,0,0,62,62,0,1,0,1,0
62791,25174,0,0,62,62,0,1,0,1,0
6638,37965,0,0,64,64,0,1,0,1,0
28378,56205,0,0,65,65,0,1,0,1,0
61763,44847,0,0,63,63,0,1,0,1,0
64229,51315,0,0,66,66,0,1,0,1,0
2704,37,0,0,60,60,0,1,0,1,0
65338,56158,0,0,66,66,0,1,0,1,0
57173,44847,0,0,62,62,0,1,0,1,0
57484,30317,0,0,63,63,0,1,0,1,0
52447,50339,0,0,62,62,0,1,0,1,0
53770,37965,0,0,66,66,0,1,0,1,0
57131,7774,0,0,145,145,0,1,0,1,0
14386,51282,0,0,104,104,0,1,0,1,0
58638,5900,0,0,62,62,0,1,0,1,0
28965,2242,0,0,60,60,0,1,0,1,0
24327,48817,0,0,150,150,0,1,0,1,0
23331,25174,0,0,63,63,0,1,0,1,0
61094,21247,0,0,66,66,0,1,0,1,0
4117,55777,0,0,66,66,0,1,0,1,0
8999,57470,0,0,146,146,0,1,0,1,0
6103,51505,0,0,62,62,0,1,0,1,0
50888,22114,0,0,63,63,0,1,0,1,0
58638,5900,0,0,62,62,0,1,0,1,0
11030,17372,0,0,62,62,0,1,0,1,0
19212,64147,0,0,65,65,0,1,0,1,0
49930,22114,0,0,65,65,0,1,0,1,0
56401,64745,0,0,101,101,0,1,0,1,0
59587,56205,0,0,63,63,0,1,0,1,0
3145,62283,0,0,62,62,0,1,0,1,0
25085,30188,0,0,65,65,0,1,0,1,0
30128,25174,0,0,62,62,0,1,0,1,0
4366,51505,0,0,62,62,0,1,0,1,0
48840,50584,0,0,62,62,0,1,0,1,0
59091,17456,0,0,66,66,0,1,0,1,0
42231,57470,0,0,78,78,0,1,0,1,0
21124,57470,0,0,62,62,0,1,0,1,0
60135,25194,0,0,137,137,0,1,0,1,0
59592,56205,0,0,63,63,0,1,0,1,0
36582,25174,0,0,62,62,0,1,0,1,0
53561,22114,0,0,62,62,0,1,0,1,0
56467,30263,0,0,113,113,0,1,0,1,0
58831,64147,0,0,62,62,0,1,0,1,0
65501,26467,0,0,64,64,0,1,0,1,0
47124,35310,0,0,61,61,0,1,0,1,0
64618,50584,0,0,62,62,0,1,0,1,0
443,56513,0,0,78,78,0,1,0,1,0
54714,23352,0,0,66,66,0,1,0,1,0
50427,26467,0,0,66,66,0,1,0,1,0
7014,43115,0,0,62,62,0,1,0,1,0
53567,3388,0,0,65,65,0,1,0,1,0
9514,26467,0,0,63,63,0,1,0,1,0
1052,64425,0,0,145,145,0,1,0,1,0
64294,64147,0,0,62,62,0,1,0,1,0
55466,25174,0,0,63,63,0,1,0,1,0
1025,30170,0,0,66,66,0,1,0,1,0
58971,37965,0,0,66,66,0,1,0,1,0
3406,17372,0,0,76,76,0,1,0,1,0
6881,6881,0,0,146,146,0,1,0,1,0
50413,37862,0,0,66,66,0,1,0,1,0
58638,5900,0,0,62,62,0,1,0,1,0
53743,22114,0,0,66,66,0,1,0,1,0
11136,15503,0,0,62,62,0,1,0,1,0
56657,26467,0,0,66,66,0,1,0,1,0
47823,51034,0,0,62,62,0,1,0,1,0
62684,57470,0,0,62,62,0,1,0,1,0
2878,35440,0,0,62,62,0,1,0,1,0
6917,51505,0,0,64,64,0,1,0,1,0
56350,64987,0,0,118,118,0,1,0,1,0
55649,42862,0,0,72,72,0,1,0,1,0
53752,23,0,0,60,60,0,1,0,1,0
16386,16969,0,0,60,60,0,1,0,1,0
31943,51480,0,0,65,65,0,1,0,1,0
6881,6881,0,0,62,62,0,1,0,1,0
45941,23385,0,0,60,60,0,1,0,1,0
8999,57470,0,0,146,146,0,1,0,1,0
38653,21247,0,0,62,62,0,1,0,1,0
23670,23,0,0,60,60,0,1,0,1,0
6885,45423,0,0,133,133,0,1,0,1,0
65362,55975,0,0,64,64,0,1,0,1,0
53260,36237,0,0,115,115,0,1,0,1,0
27404,22114,0,0,63,63,0,1,0,1,0
40216,50265,0,0,62,62,0,1,0,1,0
58022,5559,0,0,60,60,0,1,0,1,0
59813,22114,0,0,62,62,0,1,0,1,0
52612,30188,0,0,66,66,0,1,0,1,0
45964,2225,0,0,60,60,0,1,0,1,0
4241,51505,0,0,62,62,0,1,0,1,0
64914,64147,0,0,63,63,0,1,0,1,0
1029,44847,0,0,62,62,0,1,0,1,0
60899,25174,0,0,65,65,0,1,0,1,0
22240,22114,0,0,87,87,0,1,0,1,0
58638,5900,0,0,62,62,0,1,0,1,0
39297,23,0,0,60,60,0,1,0,1,0
31977,57470,0,0,60,60,0,1,0,1,0
38388,22270,0,0,73,73,0,1,0,1,0
2385,23117,0,0,62,62,0,1,0,1,0
2171,23,0,0,60,60,0,1,0,1,0
64923,25174,0,0,66,66,0,1,0,1,0
18574,56205,0,0,66,66,0,1,0,1,0
12916,43818,0,0,307,307,0,1,0,1,0
43310,50625,0,0,71,71,0,1,0,1,0
25031,25174,0,0,131,131,0,1,0,1,0
23089,48817,0,0,62,62,0,1,0,1,0
51534,44847,0,0,63,63,0,1,0,1,0
61637,37965,0,0,66,66,0,1,0,1,0
58638,5900,0,0,62,62,0,1,0,1,0
52254,22114,0,0,62,62,0,1,0,1,0
51783,51112,0,0,101,101,0,1,0,1,0
62968,9672,0,0,132,132,0,1,0,1,0
51365,59793,0,0,93,93,0,1,0,1,0
58791,25174,0,0,83,83,0,1,0,1,0
58021,22114,0,0,66,66,0,1,0,1,0
54212,55816,0,0,62,62,0,1,0,1,0
47802,7422,0,0,60,60,0,1,0,1,0
10390,26467,0,0,66,66,0,1,0,1,0
45326,13908,0,0,70,70,0,1,0,1,0
15120,26467,0,0,62,62,0,1,0,1,0
25039,64147,0,0,66,66,0,1,0,1,0
43584,24748,0,0,156,156,0,1,0,1,0
49084,22,0,0,60,60,0,1,0,1,0
26656,57470,0,0,62,62,0,1,0,1,0
48459,44847,0,0,146,146,0,1,0,1,0
50617,56205,0,0,64,64,0,1,0,1,0
7572,57470,0,0,65,65,0,1,0,1,0
7131,34453,0,0,136,136,0,1,0,1,0
38716,15503,0,0,74,74,0,1,0,1,0
48676,53395,0,0,60,60,0,1,0,1,0
22551,55661,0,0,70,70,0,1,0,1,0
26301,22114,0,0,100,100,0,1,0,1,0
5228,3434,0,0,560,560,0,1,0,1,0
58638,5900,0,0,62,62,0,1,0,1,0
45544,21904,0,0,125,125,0,1,0,1,0
54753,37965,0,0,62,62,0,1,0,1,0
12290,22114,0,0,62,62,0,1,0,1,0
50101,18593,0,0,145,145,0,1,0,1,0
4509,35676,0,0,66,66,0,1,0,1,0
62591,24,0,0,61,61,0,1,0,1,0
1127,50584,0,0,62,62,0,1,0,1,0
51413,57470,0,0,72,72,0,1,0,1,0
55727,26467,0,0,62,62,0,1,0,1,0
25234,52465,0,0,62,62,0,1,0,1,0
26507,26467,0,0,62,62,0,1,0,1,0
34677,51185,0,0,60,60,0,1,0,1,0
23021,25174,0,0,66,66,0,1,0,1,0
37420,44847,0,0,63,63,0,1,0,1,0
51072,53733,0,0,62,62,0,1,0,1,0
52026,25176,0,0,66,66,0,1,0,1,0
56327,44512,0,0,66,66,0,1,0,1,0
26698,25174,0,0,64,64,0,1,0,1,0
52238,26467,0,0,62,62,0,1,0,1,0
46511,51505,0,0,110,110,0,1,0,1,0
10811,35578,0,0,61,61,0,1,0,1,0
59656,41799,0,0,63,63,0,1,0,1,0
7810,25174,0,0,66,66,0,1,0,1,0
1026,35852,0,0,89,89,0,1,0,1,0
18592,11392,0,0,65,65,0,1,0,1,0
12969,55777,0,0,66,66,0,1,0,1,0
61231,26467,0,0,66,66,0,1,0,1,0
2913,25174,0,0,63,63,0,1,0,1,0
50231,44847,0,0,69,69,0,1,0,1,0
56441,30298,0,0,82,82,0,1,0,1,0
45964,55559,0,0,60,60,0,1,0,1,0
1356,30065,0,0,80,80,0,1,0,1,0
1553,56205,0,0,62,62,0,1,0,1,0
55631,26467,0,0,62,62,0,1,0,1,0
32282,8604,0,0,65,65,0,1,0,1,0
58638,5900,0,0,62,62,0,1,0,1,0
11136,57587,0,0,62,62,0,1,0,1,0
443,20995,0,0,83,83,0,1,0,1,0
58549,62413,0,0,62,62,0,1,0,1,0
61140,27520,0,0,65,65,0,1,0,1,0
59823,62413,0,0,62,62,0,1,0,1,0
65244,25879,0,0,71,71,0,1,0,1,0
31779,25174,0,0,144,144,0,1,0,1,0
57054,35806,0,0,124,124,0,1,0,1,0
49301,41506,0,0,157,157,0,1,0,1,0
56922,44847,0,0,62,62,0,1,0,1,0
56369,44847,0,0,66,66,0,1,0,1,0
45908,33330,0,0,60,60,0,1,0,1,0
37955,50584,0,0,62,62,0,1,0,1,0
61550,5529,0,0,145,145,0,1,0,1,0
36630,25174,0,0,74,74,0,1,0,1,0
6843,42873,0,0,62,62,0,1,0,1,0
30920,64147,0,0,62,62,0,1,0,1,0
6666,16010,0,0,60,60,0,1,0,1,0
1865,25174,0,0,62,62,0,1,0,1,0
48898,53902,0,0,60,60,0,1,0,1,0
55744,43890,0,0,66,66,0,1,0,1,0
3667,56205,0,0,64,64,0,1,0,1,0
61216,37965,0,0,66,66,0,1,0,1,0
31463,57470,0,0,136,136,0,1,0,1,0
8944,9663,0,0,60,60,0,1,0,1,0
53209,36237,0,0,62,62,0,1,0,1,0
20400,64147,0,0,62,62,0,1,0,1,0
27018,64053,0,0,87,87,0,1,0,1,0
62152,56205,0,0,66,66,0,1,0,1,0
64811,51221,0,0,66,66,0,1,0,1,0
16029,44847,0,0,87,87,0,1,0,1,0
36635,35440,0,0,62,62,0,1,0,1,0
52253,47,0,0,69,69,0,1,0,1,0
2332,25174,0,0,65,65,0,1,0,1,0
58638,5900,0,0,62,62,0,1,0,1,0
1026,64147,0,0,62,62,0,1,0,1,0
59586,50584,0,0,66,66,0,1,0,1,0
1049,26467,0,0,62,62,0,1,0,1,0
27707,50584,0,0,87,87,0,1,0,1,0
42735,56434,0,0,73,73,0,1,0,1,0
51045,25174,0,0,63,63,0,1,0,1,0
64380,37965,0,0,66,66,0,1,0,1,0
7498,32672,0,0,85,85,0,1,0,1,0
46356,35440,0,0,66,66,0,1,0,1,0
21322,25174,0,0,62,62,0,1,0,1,0
60141,62413,0,0,66,66,0,1,0,1,0
6189,37965,0,0,62,62,0,1,0,1,0
61185,54532,0,0,77,77,0,1,0,1,0
10477,44847,0,0,66,66,0,1,0,1,0
58638,5900,0,0,62,62,0,1,0,1,0
38631,22,0,0,60,60,0,1,0,1,0
51165,56205,0,0,64,64,0,1,0,1,0
63379,36237,0,0,66,66,0,1,0,1,0
58638,5900,0,0,62,62,0,1,0,1,0
60906,64147,0,0,68,68,0,1,0,1,0
3478,61463,0,0,834,834,0,1,0,1,0
42231,57470,0,0,78,78,0,1,0,1,0
57683,28831,0,0,76,76,0,1,0,1,0
58638,5900,0,0,62,62,0,1,0,1,0
57497,44847,0,0,62,62,0,1,0,1,0
60684,5900,0,0,60,60,0,1,0,1,0
4907,35440,0,0,63,63,0,1,0,1,0
56451,22114,0,0,136,136,0,1,0,1,0
33672,51923,0,0,90,90,0,1,0,1,0
7648,2110,0,0,64,64,0,1,0,1,0
62770,47,0,0,82,82,0,1,0,1,0
443,48346,0,0,81,81,0,1,0,1,0
443,50238,0,0,331,331,0,1,0,1,0
51546,17534,0,0,71,71,0,1,0,1,0
25370,51720,0,0,64,64,0,1,0,1,0
56278,52751,0,0,62,62,0,1,0,1,0
59202,25174,0,0,66,66,0,1,0,1,0
24890,25174,0,0,120,120,0,1,0,1,0
11136,17500,0,0,105,105,0,1,0,1,0
60818,37965,0,0,64,64,0,1,0,1,0
23753,25174,0,0,62,62,0,1,0,1,0
11066,50584,0,0,62,62,0,1,0,1,0
39588,37965,0,0,65,65,0,1,0,1,0
13260,48121,0,0,122,122,0,1,0,1,0
64235,51467,0,0,62,62,0,1,0,1,0
49267,21247,0,0,66,66,0,1,0,1,0
42298,30188,0,0,62,62,0,1,0,1,0
55600,22,0,0,60,60,0,1,0,1,0
52724,64147,0,0,62,62,0,1,0,1,0
35534,22114,0,0,63,63,0,1,0,1,0
58464,11392,0,0,66,66,0,1,0,1,0
64549,2311,0,0,142,142,0,1,0,1,0
58638,5900,0,0,62,62,0,1,0,1,0
52874,23718,0,0,85,85,0,1,0,1,0
58638,5900,0,0,62,62,0,1,0,1,0
3731,25174,0,0,62,62,0,1,0,1,0
54738,50584,0,0,66,66,0,1,0,1,0
57222,31356,0,0,99,99,0,1,0,1,0
61629,22114,0,0,62,62,0,1,0,1,0
58638,5900,0,0,62,62,0,1,0,1,0
51953,37965,0,0,66,66,0,1,0,1,0
3537,25174,0,0,62,62,0,1,0,1,0
6828,15850,0,0,61,61,0,1,0,1,0
58638,5900,0,0,62,62,0,1,0,1,0
12242,22114,0,0,64,64,0,1,0,1,0
14220,51203,0,0,65,65,0,1,0,1,0
40105,21,0,0,60,60,0,1,0,1,0
22982,25174,0,0,64,64,0,1,0,1,0
62399,50510,0,0,65,65,0,1,0,1,0
25201,25246,0,0,62,62,0,1,0,1,0
10187,25174,0,0,65,65,0,1,0,1,0
58638,5900,0,0,62,62,0,1,0,1,0
59535,25174,0,0,62,62,0,1,0,1,0
18011,44847,0,0,64,64,0,1,0,1,0
60894,50584,0,0,66,66,0,1,0,1,0
51953,37965,0,0,66,66,0,1,0,1,0
26771,30279,0,0,62,62,0,1,0,1,0
55520,64147,0,0,62,62,0,1,0,1,0
49659,37965,0,0,68,68,0,1,0,1,0
48676,53398,0,0,60,60,0,1,0,1,0
10260,21247,0,0,107,107,0,1,0,1,0
6660,37965,0,0,64,64,0,1,0,1,0
49485,11392,0,0,63,63,0,1,0,1,0
443,64347,0,0,131,131,0,1,0,1,0
36349,50584,0,0,135,135,0,1,0,1,0
7068,25174,0,0,63,63,0,1,0,1,0
443,9989,0,0,303,303,0,1,0,1,0
53979,50265,0,0,66,66,0,1,0,1,0
61130,25174,0,0,62,62,0,1,0,1,0
58638,5900,0,0,62,62,0,1,0,1,0
28066,22,0,0,60,60,0,1,0,1,0
58638,5900,0,0,62,62,0,1,0,1,0
58638,5900,0,0,62,62,0,1,0,1,0
25961,55783,0,0,60,60,0,1,0,1,0
5835,44847,0,0,64,64,0,1,0,1,0
11023,30188,0,0,139,139,0,1,0,1,0
51301,64147,0,0,66,66,0,1,0,1,0
50842,35440,0,0,62,62,0,1,0,1,0
22724,9822,0,0,62,62,0,1,0,1,0
51743,64147,0,0,62,62,0,1,0,1,0
16037,25174,0,0,62,62,0,1,0,1,0
64425,57470,0,0,72,72,0,1,0,1,0
56843,22114,0,0,76,76,0,1,0,1,0
58250,35440,0,0,66,66,0,1,0,1,0
17760,50584,0,0,105,105,0,1,0,1,0
52975,23718,0,0,63,63,0,1,0,1,0
60438,17372,0,0,66,66,0,1,0,1,0
17106,62413,0,0,62,62,0,1,0,1,0
58638,5900,0,0,62,62,0,1,0,1,0
58638,5900,0,0,62,62,0,1,0,1,0
1031,35591,0,0,142,142,0,1,0,1,0
19789,22437,0,0,118,118,0,1,0,1,0
32525,50272,0,0,145,145,0,1,0,1,0
22657,9822,0,0,62,62,0,1,0,1,0
63228,53337,0,0,64,64,0,1,0,1,0
59413,37949,0,0,66,66,0,1,0,1,0
33289,50584,0,0,62,62,0,1,0,1,0
53477,37807,0,0,105,105,0,1,0,1,0
47012,64147,0,0,62,62,0,1,0,1,0
63217,50423,0,0,66,66,0,1,0,1,0
50747,37932,0,0,62,62,0,1,0,1,0
42252,33303,0,0,60,60,0,1,0,1,0
59157,50584,0,0,66,66,0,1,0,1,0
50106,31497,0,0,62,62,0,1,0,1,0
35494,22114,0,0,63,63,0,1,0,1,0
45964,2225,0,0,60,60,0,1,0,1,0
27368,22114,0,0,62,62,0,1,0,1,0
45472,8168,0,0,62,62,0,1,0,1,0
19870,64147,0,0,62,62,0,1,0,1,0
58638,5900,0,0,62,62,0,1,0,1,0
5206,22114,0,0,62,62,0,1,0,1,0
43155,26467,0,0,62,62,0,1,0,1,0
42517,25174,0,0,139,139,0,1,0,1,0
36277,23,0,0,60,60,0,1,0,1,0
1972,57470,0,0,78,78,0,1,0,1,0
80,9918,0,0,60,60,0,1,0,1,0
0,0,0,0,99,99,0,1,0,1,0
45941,23386,0,0,60,60,0,1,0,1,0
16229,22,0,0,60,60,0,1,0,1,0
19195,4448,0,0,115,115,0,1,0,1,0
54295,22114,0,0,76,76,0,1,0,1,0
55893,45711,0,0,78,78,0,1,0,1,0
42898,43890,0,0,62,62,0,1,0,1,0
49405,22114,0,0,66,66,0,1,0,1,0
37913,3619,0,0,70,70,0,1,0,1,0
55064,25174,0,0,66,66,0,1,0,1,0
16189,37807,0,0,64,64,0,1,0,1,0
46019,32928,0,0,68,68,0,1,0,1,0
64441,30188,0,0,65,65,0,1,0,1,0
51582,17551,0,0,65,65,0,1,0,1,0
52806,56205,0,0,117,117,0,1,0,1,0
59878,5900,0,0,60,60,0,1,0,1,0
55288,82,0,0,108,108,0,1,0,1,0
23753,25174,0,0,62,62,0,1,0,1,0
64280,64147,0,0,62,62,0,1,0,1,0
56328,36237,0,0,62,62,0,1,0,1,0
56035,1310,0,0,62,62,0,1,0,1,0
55849,54365,0,0,73,73,0,1,0,1,0
14427,38325,0,0,90,90,0,1,0,1,0
28378,56205,0,0,113,113,0,1,0,1,0
60495,23718,0,0,66,66,0,1,0,1,0
51541,17455,0,0,66,66,0,1,0,1,0
62213,44583,0,0,66,66,0,1,0,1,0
64016,57470,0,0,71,71,0,1,0,1,0
15154,6881,0,0,95,95,0,1,0,1,0
2337,35440,0,0,68,68,0,1,0,1,0
3952,55945,0,0,97,97,0,1,0,1,0
53622,28383,0,0,61,61,0,1,0,1,0
443,9992,0,0,127,127,0,1,0,1,0
2879,35440,0,0,63,63,0,1,0,1,0
58638,5900,0,0,62,62,0,1,0,1,0
58591,3157,0,0,62,62,0,1,0,1,0
50538,22114,0,0,62,62,0,1,0,1,0
50675,23,0,0,60,60,0,1,0,1,0
25970,25174,0,0,64,64,0,1,0,1,0
54178,25174,0,0,63,63,0,1,0,1,0
29795,37965,0,0,62,62,0,1,0,1,0
57062,5,0,0,73,73,0,1,0,1,0
32675,62413,0,0,62,62,0,1,0,1,0
57951,26467,0,0,62,62,0,1,0,1,0
50563,37965,0,0,66,66,0,1,0,1,0
56283,9,0,0,112,112,0,1,0,1,0
17407,44847,0,0,74,74,0,1,0,1,0
52518,35440,0,0,62,62,0,1,0,1,0
22924,25174,0,0,131,131,0,1,0,1,0
6919,10438,0,0,118,118,0,1,0,1,0
56067,25174,0,0,62,62,0,1,0,1,0
20706,37965,0,0,62,62,0,1,0,1,0
41217,30500,0,0,99,99,0,1,0,1,0
57396,7302,0,0,66,66,0,1,0,1,0
48301,25174,0,0,63,63,0,1,0,1,0
64066,23718,0,0,65,65,0,1,0,1,0
23843,26467,0,0,62,62,0,1,0,1,0
28846,30188,0,0,141,141,0,1,0,1,0
28009,36237,0,0,75,75,0,1,0,1,0
58638,5900,0,0,62,62,0,1,0,1,0
55430,64147,0,0,66,66,0,1,0,1,0
48706,23393,0,0,60,60,0,1,0,1,0
51414,22,0,0,60,60,0,1,0,1,0
43260,41615,0,0,145,145,0,1,0,1,0
18102,23,0,0,60,60,0,1,0,1,0
58638,5900,0,0,62,62,0,1,0,1,0
18067,25174,0,0,62,62,0,1,0,1,0
10780,49071,0,0,118,118,0,1,0,1,0
53676,35974,0,0,60,60,0,1,0,1,0
6362,22,0,0,60,60,0,1,0,1,0
16660,55783,0,0,62,62,0,1,0,1,0
1023,49009,0,0,90,90,0,1,0,1,0
64933,26403,0,0,94,94,0,1,0,1,0
26499,64147,0,0,63,63,0,1,0,1,0
56006,25174,0,0,62,62,0,1,0,1,0
5223,44091,0,0,66,66,0,1,0,1,0
22383,22114,0,0,62,62,0,1,0,1,0
47442,26503,0,0,61,61,0,1,0,1,0
53353,26467,0,0,62,62,0,1,0,1,0
62575,12207,0,0,66,66,0,1,0,1,0
16341,22613,0,0,94,94,0,1,0,1,0
58746,51505,0,0,66,66,0,1,0,1,0
15867,50584,0,0,62,62,0,1,0,1,0
62562,26467,0,0,64,64,0,1,0,1,0
60824,25174,0,0,66,66,0,1,0,1,0
32796,37965,0,0,63,63,0,1,0,1,0
46597,57470,0,0,62,62,0,1,0,1,0
40331,23117,0,0,85,85,0,1,0,1,0
56146,37965,0,0,66,66,0,1,0,1,0
54530,35440,0,0,66,66,0,1,0,1,0
58933,102,0,0,61,61,0,1,0,1,0
63775,35440,0,0,65,65,0,1,0,1,0
47771,25174,0,0,62,62,0,1,0,1,0
51148,9571,0,0,66,66,0,1,0,1,0
51898,53733,0,0,66,66,0,1,0,1,0
80,53945,0,0,60,60,0,1,0,1,0
43903,64147,0,0,79,79,0,1,0,1,0
80,9918,0,0,60,60,0,1,0,1,0
58699,21247,0,0,98,98,0,1,0,1,0
13970,42873,0,0,64,64,0,1,0,1,0
62326,25174,0,0,74,74,0,1,0,1,0
25673,8229,0,0,102,102,0,1,0,1,0
63351,51264,0,0,62,62,0,1,0,1,0
28841,44847,0,0,66,66,0,1,0,1,0
2550,23540,0,0,62,62,0,1,0,1,0
52625,25174,0,0,65,65,0,1,0,1,0
2606,29,0,0,60,60,0,1,0,1,0
49315,51505,0,0,84,84,0,1,0,1,0
32716,22114,0,0,63,63,0,1,0,1,0
33495,44489,0,0,93,93,0,1,0,1,0
541,48994,0,0,85,85,0,1,0,1,0
57964,30188,0,0,62,62,0,1,0,1,0
57131,26296,0,0,145,145,0,1,0,1,0
58638,5900,0,0,62,62,0,1,0,1,0
49630,50584,0,0,62,62,0,1,0,1,0
50066,57470,0,0,66,66,0,1,0,1,0
43260,41615,0,0,145,145,0,1,0,1,0
65419,26467,0,0,62,62,0,1,0,1,0
4862,37965,0,0,66,66,0,1,0,1,0
12649,11510,0,0,74,74,0,1,0,1,0
5398,44028,0,0,64,64,0,1,0,1,0
5204,50435,0,0,62,62,0,1,0,1,0
53227,64097,0,0,64,64,0,1,0,1,0
26407,44847,0,0,146,146,0,1,0,1,0
3738,56139,0,0,62,62,0,1,0,1,0
55475,64147,0,0,64,64,0,1,0,1,0
54742,37965,0,0,66,66,0,1,0,1,0
13285,29892,0,0,145,145,0,1,0,1,0
58638,5900,0,0,62,62,0,1,0,1,0
17811,23,0,0,60,60,0,1,0,1,0
62064,22114,0,0,66,66,0,1,0,1,0
49311,51505,0,0,66,66,0,1,0,1,0
52,38171,0,0,65,65,0,1,0,1,0
58638,5900,0,0,62,62,0,1,0,1,0
0,0,0,0,98,98,0,1,0,1,0
15922,44847,0,0,66,66,0,1,0,1,0
27821,23,0,0,60,60,0,1,0,1,0
17330,54603,0,0,62,62,0,1,0,1,0
35207,22114,0,0,118,118,0,1,0,1,0
49496,64147,0,0,62,62,0,1,0,1,0
31691,50584,0,0,77,77,0,1,0,1,0
26958,50584,0,0,64,64,0,1,0,1,0
36355,50584,0,0,128,128,0,1,0,1,0
51356,22114,0,0,66,66,0,1,0,1,0
7287,44847,0,0,66,66,0,1,0,1,0
35722,30188,0,0,62,62,0,1,0,1,0
51183,56205,0,0,66,66,0,1,0,1,0
51663,17372,0,0,64,64,0,1,0,1,0
57954,15,0,0,90,90,0,1,0,1,0
62223,8265,0,0,123,123,0,1,0,1,0
6867,2275,0,0,110,110,0,1,0,1,0
33771,36103,0,0,62,62,0,1,0,1,0
4170,26529,0,0,64,64,0,1,0,1,0
58839,5900,0,0,60,60,0,1,0,1,0
3635,64147,0,0,63,63,0,1,0,1,0
27679,37965,0,0,62,62,0,1,0,1,0
61049,22114,0,0,66,66,0,1,0,1,0
58638,5900,0,0,62,62,0,1,0,1,0
38776,64147,0,0,63,63,0,1,0,1,0
57154,31136,0,0,132,132,0,1,0,1,0
51414,22,0,0,60,60,0,1,0,1,0
32342,62413,0,0,66,66,0,1,0,1,0
6697,6451,0,0,60,60,0,1,0,1,0
56621,25174,0,0,65,65,0,1,0,1,0
63091,22114,0,0,63,63,0,1,0,1,0
25570,35440,0,0,145,145,0,1,0,1,0
0,0,0,0,98,98,0,1,0,1,0
42099,25174,0,0,66,66,0,1,0,1,0
58638,5900,0,0,62,62,0,1,0,1,0
10261,21247,0,0,103,103,0,1,0,1,0
54791,37965,0,0,62,62,0,1,0,1,0
58638,5900,0,0,62,62,0,1,0,1,0
6666,3389,0,0,60,60,0,1,0,1,0
63688,64142,0,0,66,66,0,1,0,1,0
58638,5900,0,0,62,62,0,1,0,1,0
36385,25174,0,0,64,64,0,1,0,1,0
54512,44847,0,0,66,66,0,1,0,1,0
24511,48878,0,0,152,152,0,1,0,1,0
9025,26560,0,0,60,60,0,1,0,1,0
67,67,0,0,346,346,0,1,0,1,0
47334,15674,0,0,120,120,0,1,0,1,0
51083,44847,0,0,66,66,0,1,0,1,0
20706,37965,0,0,62,62,0,1,0,1,0
40434,22114,0,0,63,63,0,1,0,1,0
63949,22114,0,0,64,64,0,1,0,1,0
58638,5900,0,0,62,62,0,1,0,1,0
54280,3382,0,0,60,60,0,1,0,1,0
55666,35440,0,0,64,64,0,1,0,1,0
34059,35848,0,0,63,63,0,1,0,1,0
58638,5900,0,0,62,62,0,1,0,1,0
52596,17372,0,0,66,66,0,1,0,1,0
3375,35253,0,0,63,63,0,1,0,1,0
10472,25174,0,0,146,146,0,1,0,1,0
63639,64104,0,0,65,65,0,1,0,1,0
46684,64147,0,0,66,66,0,1,0,1,0
50249,50584,0,0,64,64,0,1,0,1,0
60337,30188,0,0,66,66,0,1,0,1,0
58914,37965,0,0,66,66,0,1,0,1,0
38314,51221,0,0,62,62,0,1,0,1,0
49386,64147,0,0,62,62,0,1,0,1,0
58489,30265,0,0,63,63,0,1,0,1,0
22266,30188,0,0,66,66,0,1,0,1,0
791,56376,0,0,72,72,0,1,0,1,0
16990,11211,0,0,120,120,0,1,0,1,0
58638,5900,0,0,62,62,0,1,0,1,0
3478,61463,0,0,932,932,0,1,0,1,0
5246,32879,0,0,193,193,0,1,0,1,0
37420,44847,0,0,64,64,0,1,0,1,0
55375,38711,0,0,70,70,0,1,0,1,0
56291,32476,0,0,63,63,0,1,0,1,0
186,12,0,0,60,60,0,1,0,1,0
61550,5529,0,0,145,145,0,1,0,1,0
63499,22114,0,0,74,74,0,1,0,1,0
16035,6881,0,0,143,143,0,1,0,1,0
61765,44847,0,0,62,62,0,1,0,1,0
50861,50584,0,0,63,63,0,1,0,1,0
46798,25174,0,0,142,142,0,1,0,1,0
62792,53,0,0,88,88,0,1,0,1,0
5279,11387,0,0,66,66,0,1,0,1,0
50052,22193,0,0,66,66,0,1,0,1,0
63080,37965,0,0,66,66,0,1,0,1,0
64878,26467,0,0,62,62,0,1,0,1,0
60183,50834,0,0,62,62,0,1,0,1,0
51491,34292,0,0,128,128,0,1,0,1,0
1685,30188,0,0,62,62,0,1,0,1,0
30143,25174,0,0,112,112,0,1,0,1,0
25449,62867,0,0,86,86,0,1,0,1,0
58632,64103,0,0,66,66,0,1,0,1,0
36686,25174,0,0,62,62,0,1,0,1,0
58638,5900,0,0,62,62,0,1,0,1,0
17010,57470,0,0,62,62,0,1,0,1,0
8976,44847,0,0,62,62,0,1,0,1,0
27080,35339,0,0,63,63,0,1,0,1,0
64693,26467,0,0,62,62,0,1,0,1,0
26531,25174,0,0,90,90,0,1,0,1,0
60914,25174,0,0,64,64,0,1,0,1,0
1934,44847,0,0,65,65,0,1,0,1,0
26048,21,0,0,60,60,0,1,0,1,0
52018,57866,0,0,65,65,0,1,0,1,0
10669,49756,0,0,60,60,0,1,0,1,0
49702,37965,0,0,64,64,0,1,0,1,0
4575,1921,0,0,130,130,0,1,0,1,0
62377,25174,0,0,62,62,0,1,0,1,0
7746,23,0,0,60,60,0,1,0,1,0
1818,22114,0,0,120,120,0,1,0,1,0
19324,25174,0,0,72,72,0,1,0,1,0
35206,22114,0,0,62,62,0,1,0,1,0
24041,37837,0,0,62,62,0,1,0,1,0
12243,64147,0,0,65,65,0,1,0,1,0
57302,62413,0,0,66,66,0,1,0,1,0
16463,26099,0,0,63,63,0,1,0,1,0
1024,57470,0,0,62,62,0,1,0,1,0
45941,23388,0,0,60,60,0,1,0,1,0
33245,30188,0,0,75,75,0,1,0,1,0
45964,5333,0,0,60,60,0,1,0,1,0
915,60127,0,0,177,177,0,1,0,1,0
2387,35440,0,0,132,132,0,1,0,1,0
18116,37807,0,0,65,65,0,1,0,1,0
4335,35440,0,0,63,63,0,1,0,1,0
1865,25174,0,0,62,62,0,1,0,1,0
50280,57470,0,0,78,78,0,1,0,1,0
5953,23,0,0,60,60,0,1,0,1,0
45682,37965,0,0,90,90,0,1,0,1,0
59367,9253,0,0,62,62,0,1,0,1,0
58597,36070,0,0,66,66,0,1,0,1,0
20596,57470,0,0,62,62,0,1,0,1,0
50357,49117,0,0,66,66,0,1,0,1,0
15131,50584,0,0,62,62,0,1,0,1,0
21607,51505,0,0,62,62,0,1,0,1,0
58638,5900,0,0,62,62,0,1,0,1,0
63249,44847,0,0,62,62,0,1,0,1,0
3478,61463,0,0,977,977,0,1,0,1,0
61861,17946,0,0,63,63,0,1,0,1,0
11136,19910,0,0,62,62,0,1,0,1,0
63340,37894,0,0,66,66,0,1,0,1,0
30276,37965,0,0,64,64,0,1,0,1,0
3006,36204,0,0,73,73,0,1,0,1,0
59994,11446,0,0,66,66,0,1,0,1,0
43584,24748,0,0,156,156,0,1,0,1,0
44971,57470,0,0,67,67,0,1,0,1,0
64926,64147,0,0,66,66,0,1,0,1,0
58638,5900,0,0,62,62,0,1,0,1,0
7445,57470,0,0,66,66,0,1,0,1,0
49491,11392,0,0,63,63,0,1,0,1,0
50298,37965,0,0,64,64,0,1,0,1,0
33086,9942,0,0,126,126,0,1,0,1,0
33349,50584,0,0,142,142,0,1,0,1,0
58268,36237,0,0,62,62,0,1,0,1,0
57921,4,0,0,91,91,0,1,0,1,0
11770,37965,0,0,62,62,0,1,0,1,0
43623,16426,0,0,68,68,0,1,0,1,0
63065,35440,0,0,66,66,0,1,0,1,0
52454,50364,0,0,64,64,0,1,0,1,0
63223,53396,0,0,62,62,0,1,0,1,0
34677,51185,0,0,60,60,0,1,0,1,0
58638,5900,0,0,62,62,0,1,0,1,0
15881,50584,0,0,146,146,0,1,0,1,0
1014,19871,0,0,75,75,0,1,0,1,0
29027,8297,0,0,61,61,0,1,0,1,0
23904,26467,0,0,62,62,0,1,0,1,0
35529,22114,0,0,62,62,0,1,0,1,0
37647,36237,0,0,62,62,0,1,0,1,0
0,0,0,0,98,98,0,1,0,1,0
19068,37965,0,0,62,62,0,1,0,1,0
48845,50584,0,0,63,63,0,1,0,1,0
30132,37965,0,0,65,65,0,1,0,1,0
54280,3385,0,0,60,60,0,1,0,1,0
25095,50532,0,0,145,145,0,1,0,1,0
49704,57470,0,0,63,63,0,1,0,1,0
52648,35440,0,0,66,66,0,1,0,1,0
63677,64114,0,0,66,66,0,1,0,1,0
10736,35440,0,0,66,66,0,1,0,1,0
65105,35440,0,0,63,63,0,1,0,1,0
443,54507,0,0,82,82,0,1,0,1,0
47173,35440,0,0,94,94,0,1,0,1,0
11541,44787,0,0,62,62,0,1,0,1,0
21802,22114,0,0,62,62,0,1,0,1,0
60582,50584,0,0,62,62,0,1,0,1,0
12503,22114,0,0,66,66,0,1,0,1,0
625,9951,0,0,86,86,0,1,0,1,0
56058,57470,0,0,69,69,0,1,0,1,0
2419,23117,0,0,65,65,0,1,0,1,0
22056,18237,0,0,64,64,0,1,0,1,0
58638,5900,0,0,62,62,0,1,0,1,0
443,50178,0,0,65,65,0,1,0,1,0
8569,56205,0,0,65,65,0,1,0,1,0
16904,50540,0,0,62,62,0,1,0,1,0
6666,256,0,0,60,60,0,1,0,1,0
49068,44758,0,0,84,84,0,1,0,1,0
62914,11392,0,0,128,128,0,1,0,1,0
60393,17462,0,0,66,66,0,1,0,1,0
56408,51340,0,0,66,66,0,1,0,1,0
44114,44847,0,0,65,65,0,1,0,1,0
22924,25174,0,0,62,62,0,1,0,1,0
9319,11187,0,0,61,61,0,1,0,1,0
53026,35440,0,0,66,66,0,1,0,1,0
57277,51134,0,0,66,66,0,1,0,1,0
54236,22114,0,0,63,63,0,1,0,1,0
40254,25174,0,0,71,71,0,1,0,1,0
14955,57512,0,0,70,70,0,1,0,1,0
35657,48637,0,0,62,62,0,1,0,1,0
62575,12207,0,0,66,66,0,1,0,1,0
54776,22,0,0,60,60,0,1,0,1,0
51096,63710,0,0,63,63,0,1,0,1,0
50798,36237,0,0,63,63,0,1,0,1,0
62765,35440,0,0,66,66,0,1,0,1,0
32698,51412,0,0,63,63,0,1,0,1,0
443,21808,0,0,99,99,0,1,0,1,0
45964,2225,0,0,60,60,0,1,0,1,0
31220,15503,0,0,137,137,0,1,0,1,0
8081,64147,0,0,62,62,0,1,0,1,0
54046,50265,0,0,62,62,0,1,0,1,0
56593,64147,0,0,64,64,0,1,0,1,0
55079,25174,0,0,65,65,0,1,0,1,0
59749,44847,0,0,66,66,0,1,0,1,0
64664,30188,0,0,66,66,0,1,0,1,0
36375,25174,0,0,65,65,0,1,0,1,0
24036,35440,0,0,62,62,0,1,0,1,0
64250,64147,0,0,62,62,0,1,0,1,0
51953,37965,0,0,66,66,0,1,0,1,0
58638,5900,0,0,62,62,0,1,0,1,0
26679,25174,0,0,64,64,0,1,0,1,0
64535,37965,0,0,63,63,0,1,0,1,0
16337,23150,0,0,97,97,0,1,0,1,0
46557,57866,0,0,66,66,0,1,0,1,0
58662,35819,0,0,66,66,0,1,0,1,0
46091,51505,0,0,62,62,0,1,0,1,0
5023,3402,0,0,150,150,0,1,0,1,0
18203,23,0,0,60,60,0,1,0,1,0
61057,25174,0,0,62,62,0,1,0,1,0
3893,63874,0,0,97,97,0,1,0,1,0
6057,51221,0,0,78,78,0,1,0,1,0
62436,37820,0,0,66,66,0,1,0,1,0
12107,22114,0,0,66,66,0,1,0,1,0
52696,15706,0,0,64,64,0,1,0,1,0
38871,51505,0,0,85,85,0,1,0,1,0
59611,56205,0,0,66,66,0,1,0,1,0
43648,38860,0,0,133,133,0,1,0,1,0
46346,35440,0,0,66,66,0,1,0,1,0
21064,25174,0,0,77,77,0,1,0,1,0
32945,51221,0,0,66,66,0,1,0,1,0
44568,3389,0,0,60,60,0,1,0,1,0
53317,42707,0,0,66,66,0,1,0,1,0
53577,35894,0,0,63,63,0,1,0,1,0
4236,26625,0,0,60,60,0,1,0,1,0
51310,64147,0,0,66,66,0,1,0,1,0
40772,15503,0,0,74,74,0,1,0,1,0
4428,26791,0,0,61,61,0,1,0,1,0
45964,3111,0,0,60,60,0,1,0,1,0
3521,6881,0,0,63,63,0,1,0,1,0
1464,53567,0,0,107,107,0,1,0,1,0
14637,25174,0,0,62,62,0,1,0,1,0
26864,50584,0,0,66,66,0,1,0,1,0
31050,23,0,0,60,60,0,1,0,1,0
58016,5555,0,0,60,60,0,1,0,1,0
59505,53733,0,0,65,65,0,1,0,1,0
6828,64322,0,0,60,60,0,1,0,1,0
80,37649,0,0,60,60,0,1,0,1,0
6881,6881,0,0,62,62,0,1,0,1,0
37652,3616,0,0,69,69,0,1,0,1,0
22815,44847,0,0,62,62,0,1,0,1,0
25376,48817,0,0,105,105,0,1,0,1,0
54755,6998,0,0,66,66,0,1,0,1,0
49575,35794,0,0,142,142,0,1,0,1,0
9632,57470,0,0,67,67,0,1,0,1,0
13285,29892,0,0,145,145,0,1,0,1,0
60267,37965,0,0,66,66,0,1,0,1,0
57442,57470,0,0,65,65,0,1,0,1,0
54584,36237,0,0,66,66,0,1,0,1,0
60188,15503,0,0,66,66,0,1,0,1,0
10901,6501,0,0,81,81,0,1,0,1,0
53649,20,0,0,60,60,0,1,0,1,0
17956,23,0,0,60,60,0,1,0,1,0
23614,11189,0,0,79,79,0,1,0,1,0
48706,23393,0,0,60,60,0,1,0,1,0
63271,15503,0,0,66,66,0,1,0,1,0
58638,5900,0,0,62,62,0,1,0,1,0
45777,7925,0,0,60,60,0,1,0,1,0
52539,37965,0,0,62,62,0,1,0,1,0
57943,42861,0,0,66,66,0,1,0,1,0
37011,25174,0,0,62,62,0,1,0,1,0
1426,26467,0,0,62,62,0,1,0,1,0
34424,48712,0,0,95,95,0,1,0,1,0
28161,22,0,0,60,60,0,1,0,1,0
58022,7590,0,0,60,60,0,1,0,1,0
58638,5900,0,0,62,62,0,1,0,1,0
50804,1,0,0,62,62,0,1,0,1,0
45878,7860,0,0,89,89,0,1,0,1,0
30282,57470,0,0,124,124,0,1,0,1,0
58638,5900,0,0,62,62,0,1,0,1,0
63524,37965,0,0,65,65,0,1,0,1,0
53816,22114,0,0,110,110,0,1,0,1,0
51999,37965,0,0,62,62,0,1,0,1,0
58419,15503,0,0,115,115,0,1,0,1,0
61140,27520,0,0,62,62,0,1,0,1,0
54062,49813,0,0,62,62,0,1,0,1,0
3582,25174,0,0,62,62,0,1,0,1,0
22971,50584,0,0,62,62,0,1,0,1,0
57398,57470,0,0,63,63,0,1,0,1,0
10763,35440,0,0,66,66,0,1,0,1,0
4800,37965,0,0,66,66,0,1,0,1,0
1155,25174,0,0,62,62,0,1,0,1,0
50052,65008,0,0,60,60,0,1,0,1,0
64756,11392,0,0,80,80,0,1,0,1,0
3448,25174,0,0,64,64,0,1,0,1,0
42258,51007,0,0,65,65,0,1,0,1,0
26739,50584,0,0,69,69,0,1,0,1,0
15797,41328,0,0,64,64,0,1,0,1,0
25334,24995,0,0,95,95,0,1,0,1,0
3361,22114,0,0,62,62,0,1,0,1,0
5617,64147,0,0,130,130,0,1,0,1,0
58674,64136,0,0,65,65,0,1,0,1,0
27643,51505,0,0,135,135,0,1,0,1,0
45941,23386,0,0,60,60,0,1,0,1,0
2424,37850,0,0,66,66,0,1,0,1,0
3585,64147,0,0,62,62,0,1,0,1,0
45985,51505,0,0,143,143,0,1,0,1,0
50251,35440,0,0,66,66,0,1,0,1,0
45682,37965,0,0,62,62,0,1,0,1,0
61762,44847,0,0,65,65,0,1,0,1,0
41760,50584,0,0,66,66,0,1,0,1,0
56616,51505,0,0,62,62,0,1,0,1,0
53960,30041,0,0,62,62,0,1,0,1,0
1972,57470,0,0,78,78,0,1,0,1,0
25183,25174,0,0,62,62,0,1,0,1,0
11068,44102,0,0,66,66,0,1,0,1,0
50756,37909,0,0,63,63,0,1,0,1,0
60689,23606,0,0,66,66,0,1,0,1,0
443,22110,0,0,108,108,0,1,0,1,0
14183,26467,0,0,62,62,0,1,0,1,0
53608,18,0,0,64,64,0,1,0,1,0
58638,5900,0,0,62,62,0,1,0,1,0
15387,51505,0,0,65,65,0,1,0,1,0
59965,36237,0,0,64,64,0,1,0,1,0
51466,25174,0,0,62,62,0,1,0,1,0
6881,6881,0,0,62,62,0,1,0,1,0
49001,40108,0,0,161,161,0,1,0,1,0
10003,64147,0,0,62,62,0,1,0,1,0
58638,5900,0,0,62,62,0,1,0,1,0
0,0,0,0,70,70,0,1,0,1,0
443,64347,0,0,114,114,0,1,0,1,0
32231,62182,0,0,91,91,0,1,0,1,0
7469,44238,0,0,66,66,0,1,0,1,0
63323,54369,0,0,78,78,0,1,0,1,0
51778,51444,0,0,67,67,0,1,0,1,0
6866,23117,0,0,62,62,0,1,0,1,0
51320,44847,0,0,66,66,0,1,0,1,0
45662,46,0,0,60,60,0,1,0,1,0
64925,22114,0,0,66,66,0,1,0,1,0
50859,26467,0,0,66,66,0,1,0,1,0
10178,6962,0,0,129,129,0,1,0,1,0
43688,22114,0,0,64,64,0,1,0,1,0
18652,64147,0,0,62,62,0,1,0,1,0
33547,23,0,0,60,60,0,1,0,1,0
27606,22114,0,0,120,120,0,1,0,1,0
56364,25174,0,0,62,62,0,1,0,1,0
20110,21880,0,0,66,66,0,1,0,1,0
12533,31249,0,0,62,62,0,1,0,1,0
64803,51221,0,0,65,65,0,1,0,1,0
53480,21,0,0,60,60,0,1,0,1,0
58638,5900,0,0,62,62,0,1,0,1,0
58716,9693,0,0,62,62,0,1,0,1,0
4365,50584,0,0,62,62,0,1,0,1,0
49802,37965,0,0,65,65,0,1,0,1,0
50127,64147,0,0,62,62,0,1,0,1,0
18703,44847,0,0,66,66,0,1,0,1,0
63235,46789,0,0,73,73,0,1,0,1,0
4091,51505,0,0,62,62,0,1,0,1,0
51605,26467,0,0,64,64,0,1,0,1,0
25523,35974,0,0,62,62,0,1,0,1,0
80,37649,0,0,60,60,0,1,0,1,0
25570,35440,0,0,71,71,0,1,0,1,0
55628,42888,0,0,73,73,0,1,0,1,0
6057,51221,0,0,78,78,0,1,0,1,0
59099,25174,0,0,66,66,0,1,0,1,0
58638,5900,0,0,62,62,0,1,0,1,0
43853,44847,0,0,66,66,0,1,0,1,0
63379,36237,0,0,66,66,0,1,0,1,0
54287,11392,0,0,66,66,0,1,0,1,0
39115,46932,0,0,69,69,0,1,0,1,0
55862,62413,0,0,62,62,0,1,0,1,0
54305,39004,0,0,122,122,0,1,0,1,0
10921,51505,0,0,63,63,0,1,0,1,0
53305,22114,0,0,66,66,0,1,0,1,0
58638,5900,0,0,62,62,0,1,0,1,0
58638,5900,0,0,62,62,0,1,0,1,0
22342,51505,0,0,62,62,0,1,0,1,0
18950,50584,0,0,119,119,0,1,0,1,0
870,62583,0,0,125,125,0,1,0,1,0
53089,57470,0,0,74,74,0,1,0,1,0
59554,64147,0,0,62,62,0,1,0,1,0
63485,51505,0,0,66,66,0,1,0,1,0
28844,37965,0,0,62,62,0,1,0,1,0
47362,37823,0,0,62,62,0,1,0,1,0
57500,37965,0,0,62,62,0,1,0,1,0
34803,15503,0,0,77,77,0,1,0,1,0
57287,64147,0,0,65,65,0,1,0,1,0
56249,55442,0,0,66,66,0,1,0,1,0
18116,37807,0,0,63,63,0,1,0,1,0
55851,62413,0,0,63,63,0,1,0,1,0
34947,38478,0,0,62,62,0,1,0,1,0
14360,64147,0,0,126,126,0,1,0,1,0
58950,57470,0,0,72,72,0,1,0,1,0
49148,44847,0,0,62,62,0,1,0,1,0
23752,11889,0,0,61,61,0,1,0,1,0
56397,26467,0,0,62,62,0,1,0,1,0
19204,57866,0,0,66,66,0,1,0,1,0
42465,57470,0,0,60,60,0,1,0,1,0
26758,50584,0,0,66,66,0,1,0,1,0
63290,26347,0,0,131,131,0,1,0,1,0
55008,21247,0,0,66,66,0,1,0,1,0
49583,50584,0,0,63,63,0,1,0,1,0
28779,50584,0,0,63,63,0,1,0,1,0
2464,50584,0,0,63,63,0,1,0,1,0
443,50238,0,0,331,331,0,1,0,1,0
62764,62413,0,0,116,116,0,1,0,1,0
19747,37965,0,0,62,62,0,1,0,1,0
62930,21247,0,0,66,66,0,1,0,1,0
3117,37965,0,0,62,62,0,1,0,1,0
49397,5900,0,0,60,60,0,1,0,1,0
53650,64147,0,0,62,62,0,1,0,1,0
35431,25174,0,0,64,64,0,1,0,1,0
50052,65008,0,0,60,60,0,1,0,1,0
1024,44847,0,0,62,62,0,1,0,1,0
1873,37965,0,0,62,62,0,1,0,1,0
44147,64147,0,0,62,62,0,1,0,1,0
42030,25,0,0,74,74,0,1,0,1,0
52906,37919,0,0,66,66,0,1,0,1,0
55934,56291,0,0,64,64,0,1,0,1,0
62811,44847,0,0,87,87,0,1,0,1,0
52322,64147,0,0,62,62,0,1,0,1,0
50920,60182,0,0,64,64,0,1,0,1,0
51343,64147,0,0,66,66,0,1,0,1,0
52650,57222,0,0,65,65,0,1,0,1,0
17516,44847,0,0,121,121,0,1,0,1,0
5831,22114,0,0,65,65,0,1,0,1,0
12830,37965,0,0,65,65,0,1,0,1,0
58565,21247,0,0,66,66,0,1,0,1,0
27785,37965,0,0,66,66,0,1,0,1,0
31497,2,0,0,139,139,0,1,0,1,0
49506,21247,0,0,62,62,0,1,0,1,0
14678,25174,0,0,62,62,0,1,0,1,0
52509,35894,0,0,67,67,0,1,0,1,0
50645,36237,0,0,65,65,0,1,0,1,0
42259,57470,0,0,69,69,0,1,0,1,0
63782,35440,0,0,66,66,0,1,0,1,0
3210,17413,0,0,62,62,0,1,0,1,0
56274,22114,0,0,115,115,0,1,0,1,0
15697,64147,0,0,66,66,0,1,0,1,0
45908,33330,0,0,60,60,0,1,0,1,0
17738,49504,0,0,118,118,0,1,0,1,0
64727,25174,0,0,66,66,0,1,0,1,0
49253,44847,0,0,65,65,0,1,0,1,0
58589,62413,0,0,66,66,0,1,0,1,0
51319,30296,0,0,62,62,0,1,0,1,0
27843,51380,0,0,63,63,0,1,0,1,0
62339,25174,0,0,64,64,0,1,0,1,0
57414,25174,0,0,146,146,0,1,0,1,0
37001,25174,0,0,62,62,0,1,0,1,0
49780,64147,0,0,66,66,0,1,0,1,0
44258,25,0,0,74,74,0,1,0,1,0
21623,50218,0,0,66,66,0,1,0,1,0
443,45788,0,0,269,269,0,1,0,1,0
42030,25,0,0,74,74,0,1,0,1,0
58638,5900,0,0,62,62,0,1,0,1,0
3411,6979,0,0,62,62,0,1,0,1,0
35596,35440,0,0,62,62,0,1,0,1,0
58638,5900,0,0,62,62,0,1,0,1,0
65419,26467,0,0,62,62,0,1,0,1,0
12096,37965,0,0,63,63,0,1,0,1,0
54140,43890,0,0,64,64,0,1,0,1,0
21840,23718,0,0,63,63,0,1,0,1,0
57498,7308,0,0,65,65,0,1,0,1,0
50429,25174,0,0,62,62,0,1,0,1,0
1873,37965,0,0,62,62,0,1,0,1,0
56252,57515,0,0,94,94,0,1,0,1,0
26332,22114,0,0,92,92,0,1,0,1,0
60803,25174,0,0,66,66,0,1,0,1,0
2475,6881,0,0,64,64,0,1,0,1,0
57747,37965,0,0,64,64,0,1,0,1,0
16141,44847,0,0,63,63,0,1,0,1,0
14036,48817,0,0,63,63,0,1,0,1,0
62684,64147,0,0,64,64,0,1,0,1,0
57481,56205,0,0,66,66,0,1,0,1,0
57187,57470,0,0,66,66,0,1,0,1,0
54196,11392,0,0,66,66,0,1,0,1,0
10028,25604,0,0,62,62,0,1,0,1,0
29839,50584,0,0,63,63,0,1,0,1,0
7732,2288,0,0,65,65,0,1,0,1,0
26899,57470,0,0,62,62,0,1,0,1,0
53756,37965,0,0,66,66,0,1,0,1,0
52108,22114,0,0,66,66,0,1,0,1,0
43584,35440,0,0,106,106,0,1,0,1,0
58638,5900,0,0,62,62,0,1,0,1,0
29733,50584,0,0,62,62,0,1,0,1,0
56449,11392,0,0,66,66,0,1,0,1,0
12223,48817,0,0,64,64,0,1,0,1,0
63586,46824,0,0,62,62,0,1,0,1,0
46764,25174,0,0,62,62,0,1,0,1,0
18727,35440,0,0,142,142,0,1,0,1,0
26557,44847,0,0,70,70,0,1,0,1,0
61268,57470,0,0,64,64,0,1,0,1,0
39959,23117,0,0,66,66,0,1,0,1,0
43692,44847,0,0,62,62,0,1,0,1,0
43752,44847,0,0,63,63,0,1,0,1,0
18904,57470,0,0,62,62,0,1,0,1,0
51698,6881,0,0,63,63,0,1,0,1,0
51147,64116,0,0,65,65,0,1,0,1,0
515,10214,0,0,65,65,0,1,0,1,0
63387,25174,0,0,66,66,0,1,0,1,0
58638,5900,0,0,62,62,0,1,0,1,0
63454,50433,0,0,66,66,0,1,0,1,0
44551,57470,0,0,67,67,0,1,0,1,0
19654,64147,0,0,62,62,0,1,0,1,0
49657,37965,0,0,69,69,0,1,0,1,0
50788,48817,0,0,64,64,0,1,0,1,0
16383,35350,0,0,60,60,0,1,0,1,0
9756,30172,0,0,61,61,0,1,0,1,0
18495,26467,0,0,62,62,0,1,0,1,0
40908,1653,0,0,60,60,0,1,0,1,0
32808,9719,0,0,60,60,0,1,0,1,0
1045,36237,0,0,66,66,0,1,0,1,0
65498,57470,0,0,111,111,0,1,0,1,0
14517,37965,0,0,62,62,0,1,0,1,0
46581,49911,0,0,91,91,0,1,0,1,0
53591,35905,0,0,61,61,0,1,0,1,0
60935,25174,0,0,62,62,0,1,0,1,0
54742,50584,0,0,66,66,0,1,0,1,0
443,62451,0,0,124,124,0,1,0,1,0
59246,21247,0,0,62,62,0,1,0,1,0
5474,64147,0,0,97,97,0,1,0,1,0
61463,57470,0,0,66,66,0,1,0,1,0
55111,39004,0,0,66,66,0,1,0,1,0
41709,57470,0,0,62,62,0,1,0,1,0
1873,37965,0,0,62,62,0,1,0,1,0
19301,37965,0,0,62,62,0,1,0,1,0
26841,50438,0,0,63,63,0,1,0,1,0
1025,64147,0,0,62,62,0,1,0,1,0
58516,30295,0,0,62,62,0,1,0,1,0
44930,57470,0,0,72,72,0,1,0,1,0
60840,50584,0,0,62,62,0,1,0,1,0
51546,51505,0,0,64,64,0,1,0,1,0
16669,36187,0,0,65,65,0,1,0,1,0
65433,44847,0,0,63,63,0,1,0,1,0
33151,64129,0,0,62,62,0,1,0,1,0
43874,26467,0,0,62,62,0,1,0,1,0
52050,11392,0,0,62,62,0,1,0,1,0
13285,29892,0,0,145,145,0,1,0,1,0
49938,57470,0,0,66,66,0,1,0,1,0
64228,50844,0,0,66,66,0,1,0,1,0
55205,11392,0,0,66,66,0,1,0,1,0
28181,25174,0,0,99,99,0,1,0,1,0
53794,64147,0,0,66,66,0,1,0,1,0
26528,51221,0,0,78,78,0,1,0,1,0
10675,36685,0,0,131,131,0,1,0,1,0
63023,51505,0,0,63,63,0,1,0,1,0
1025,35447,0,0,62,62,0,1,0,1,0
2610,64147,0,0,62,62,0,1,0,1,0
6881,6881,0,0,146,146,0,1,0,1,0
43344,57470,0,0,107,107,0,1,0,1,0
443,60496,0,0,320,320,0,1,0,1,0
50236,25174,0,0,64,64,0,1,0,1,0
25764,30212,0,0,134,134,0,1,0,1,0
49575,21247,0,0,66,66,0,1,0,1,0
52574,22114,0,0,65,65,0,1,0,1,0
52519,44847,0,0,63,63,0,1,0,1,0
62699,42861,0,0,66,66,0,1,0,1,0
1873,37965,0,0,62,62,0,1,0,1,0
55877,64147,0,0,65,65,0,1,0,1,0
44554,57470,0,0,66,66,0,1,0,1,0
59511,21247,0,0,62,62,0,1,0,1,0
7532,64147,0,0,62,62,0,1,0,1,0
37941,5900,0,0,60,60,0,1,0,1,0
58638,5900,0,0,62,62,0,1,0,1,0
35993,22,0,0,60,60,0,1,0,1,0
0,0,0,0,70,70,0,1,0,1,0
50616,64147,0,0,62,62,0,1,0,1,0
0,0,0,0,70,70,0,1,0,1,0
36998,23,0,0,60,60,0,1,0,1,0
56946,35892,0,0,63,63,0,1,0,1,0
59528,37965,0,0,62,62,0,1,0,1,0
22856,22114,0,0,66,66,0,1,0,1,0
50249,44847,0,0,66,66,0,1,0,1,0
50172,64147,0,0,64,64,0,1,0,1,0
53540,44847,0,0,64,64,0,1,0,1,0
51024,60100,0,0,62,62,0,1,0,1,0
54793,22114,0,0,62,62,0,1,0,1,0
26876,22114,0,0,65,65,0,1,0,1,0
58659,35633,0,0,66,66,0,1,0,1,0
2699,36,0,0,60,60,0,1,0,1,0
37520,50584,0,0,66,66,0,1,0,1,0
58822,15503,0,0,66,66,0,1,0,1,0
6901,21459,0,0,141,141,0,1,0,1,0
24832,55141,0,0,140,140,0,1,0,1,0
64019,57470,0,0,66,66,0,1,0,1,0
32481,22114,0,0,109,109,0,1,0,1,0
63708,25174,0,0,62,62,0,1,0,1,0
1283,44847,0,0,62,62,0,1,0,1,0
50048,64147,0,0,66,66,0,1,0,1,0
6666,8582,0,0,60,60,0,1,0,1,0
1725,22114,0,0,109,109,0,1,0,1,0
52206,22114,0,0,62,62,0,1,0,1,0
59611,56205,0,0,63,63,0,1,0,1,0
47036,2313,0,0,61,61,0,1,0,1,0
29988,44847,0,0,66,66,0,1,0,1,0
58638,5900,0,0,62,62,0,1,0,1,0
63545,50584,0,0,66,66,0,1,0,1,0
62080,54532,0,0,60,60,0,1,0,1,0
54172,57683,0,0,66,66,0,1,0,1,0
51882,26467,0,0,62,62,0,1,0,1,0
25028,25174,0,0,62,62,0,1,0,1,0
28156,37965,0,0,62,62,0,1,0,1,0
6180,37965,0,0,62,62,0,1,0,1,0
58638,5900,0,0,62,62,0,1,0,1,0
53886,37965,0,0,63,63,0,1,0,1,0
51996,35440,0,0,66,66,0,1,0,1,0
26419,56156,0,0,64,64,0,1,0,1,0
57756,37965,0,0,62,62,0,1,0,1,0
51745,57470,0,0,111,111,0,1,0,1,0
53770,51505,0,0,66,66,0,1,0,1,0
63136,25174,0,0,64,64,0,1,0,1,0
34715,22114,0,0,143,143,0,1,0,1,0
33218,50584,0,0,146,146,0,1,0,1,0
27289,25174,0,0,62,62,0,1,0,1,0
52545,51221,0,0,70,70,0,1,0,1,0
6052,37965,0,0,65,65,0,1,0,1,0
59772,62413,0,0,66,66,0,1,0,1,0
6716,4933,0,0,67,67,0,1,0,1,0
62930,21247,0,0,66,66,0,1,0,1,0
9644,26467,0,0,62,62,0,1,0,1,0
1110,42986,0,0,102,102,0,1,0,1,0
17976,23,0,0,60,60,0,1,0,1,0
23696,64147,0,0,65,65,0,1,0,1,0
24481,48817,0,0,130,130,0,1,0,1,0
51177,56205,0,0,65,65,0,1,0,1,0
60986,50341,0,0,132,132,0,1,0,1,0
45964,2666,0,0,60,60,0,1,0,1,0
32658,64099,0,0,65,65,0,1,0,1,0
19394,44847,0,0,64,64,0,1,0,1,0
51271,37965,0,0,66,66,0,1,0,1,0
35722,30188,0,0,68,68,0,1,0,1,0
45941,23386,0,0,60,60,0,1,0,1,0
22278,30188,0,0,62,62,0,1,0,1,0
58638,5900,0,0,62,62,0,1,0,1,0
63532,62413,0,0,62,62,0,1,0,1,0
64300,64147,0,0,102,102,0,1,0,1,0
58638,5900,0,0,62,62,0,1,0,1,0
16387,16862,0,0,60,60,0,1,0,1,0
11136,15503,0,0,62,62,0,1,0,1,0
54276,37628,0,0,66,66,0,1,0,1,0
31663,25174,0,0,146,146,0,1,0,1,0
80,56913,0,0,1326,1326,0,1,0,1,0
51455,53733,0,0,65,65,0,1,0,1,0
58638,5900,0,0,62,62,0,1,0,1,0
59124,25174,0,0,64,64,0,1,0,1,0
16576,21247,0,0,62,62,0,1,0,1,0
62988,51505,0,0,62,62,0,1,0,1,0
14023,37965,0,0,62,62,0,1,0,1,0
949,34086,0,0,67,67,0,1,0,1,0
9646,57470,0,0,70,70,0,1,0,1,0
31705,51428,0,0,62,62,0,1,0,1,0
40465,57470,0,0,70,70,0,1,0,1,0
46478,50584,0,0,66,66,0,1,0,1,0
43270,50584,0,0,62,62,0,1,0,1,0
14621,25174,0,0,65,65,0,1,0,1,0
58370,56199,0,0,67,67,0,1,0,1,0
49001,11392,0,0,108,108,0,1,0,1,0
55056,44512,0,0,62,62,0,1,0,1,0
47085,64147,0,0,62,62,0,1,0,1,0
61431,64753,0,0,66,66,0,1,0,1,0
54663,36237,0,0,62,62,0,1,0,1,0
44890,26467,0,0,62,62,0,1,0,1,0
51740,57470,0,0,139,139,0,1,0,1,0
26169,21,0,0,60,60,0,1,0,1,0
11427,44847,0,0,62,62,0,1,0,1,0
64324,37807,0,0,80,80,0,1,0,1,0
34337,22114,0,0,66,66,0,1,0,1,0
31475,30188,0,0,62,62,0,1,0,1,0
48889,50584,0,0,66,66,0,1,0,1,0
17215,25174,0,0,136,136,0,1,0,1,0
49284,22114,0,0,65,65,0,1,0,1,0
1672,30188,0,0,62,62,0,1,0,1,0
59840,22114,0,0,83,83,0,1,0,1,0
49186,57470,0,0,138,138,0,1,0,1,0
62990,11511,0,0,62,62,0,1,0,1,0
59115,11392,0,0,64,64,0,1,0,1,0
48706,23393,0,0,60,60,0,1,0,1,0
10028,25604,0,0,62,62,0,1,0,1,0
64077,25174,0,0,66,66,0,1,0,1,0
1024,64147,0,0,62,62,0,1,0,1,0
43815,50584,0,0,132,132,0,1,0,1,0
59480,44,0,0,60,60,0,1,0,1,0
63848,25174,0,0,63,63,0,1,0,1,0
27368,22114,0,0,67,67,0,1,0,1,0
51295,30216,0,0,89,89,0,1,0,1,0
54590,44847,0,0,66,66,0,1,0,1,0
46028,51505,0,0,116,116,0,1,0,1,0
63394,15503,0,0,65,65,0,1,0,1,0
26522,56106,0,0,62,62,0,1,0,1,0
443,49859,0,0,72,72,0,1,0,1,0
24323,35409,0,0,66,66,0,1,0,1,0
62489,23117,0,0,64,64,0,1,0,1,0
6703,21247,0,0,62,62,0,1,0,1,0
43260,41615,0,0,145,145,0,1,0,1,0
17106,57470,0,0,62,62,0,1,0,1,0
1886,51505,0,0,62,62,0,1,0,1,0
616,3100,0,0,97,97,0,1,0,1,0
26698,25174,0,0,65,65,0,1,0,1,0
65004,35440,0,0,66,66,0,1,0,1,0
20619,25174,0,0,62,62,0,1,0,1,0
42745,50011,0,0,62,62,0,1,0,1,0
26149,56055,0,0,63,63,0,1,0,1,0
6712,5632,0,0,60,60,0,1,0,1,0
63331,51221,0,0,62,62,0,1,0,1,0
52519,44847,0,0,65,65,0,1,0,1,0
41893,35587,0,0,77,77,0,1,0,1,0
26821,9785,0,0,95,95,0,1,0,1,0
14841,37965,0,0,62,62,0,1,0,1,0
48868,22114,0,0,146,146,0,1,0,1,0
50881,50584,0,0,66,66,0,1,0,1,0
51310,64147,0,0,65,65,0,1,0,1,0
50066,30188,0,0,64,64,0,1,0,1,0
10257,21247,0,0,62,62,0,1,0,1,0
3737,37965,0,0,62,62,0,1,0,1,0
51479,25174,0,0,63,63,0,1,0,1,0
62989,44847,0,0,62,62,0,1,0,1,0
26448,9192,0,0,145,145,0,1,0,1,0
11574,51505,0,0,64,64,0,1,0,1,0
3478,61463,0,0,1162,1162,0,1,0,1,0
58638,5900,0,0,62,62,0,1,0,1,0
22677,30188,0,0,63,63,0,1,0,1,0
53093,51139,0,0,70,70,0,1,0,1,0
18945,50584,0,0,68,68,0,1,0,1,0
52448,22114,0,0,63,63,0,1,0,1,0
44894,26467,0,0,62,62,0,1,0,1,0
33291,50584,0,0,62,62,0,1,0,1,0
59878,2767,0,0,66,66,0,1,0,1,0
56386,50584,0,0,62,62,0,1,0,1,0
64207,36829,0,0,63,63,0,1,0,1,0
45079,31573,0,0,66,66,0,1,0,1,0
52459,5555,0,0,60,60,0,1,0,1,0
51550,43260,0,0,66,66,0,1,0,1,0
57395,62413,0,0,66,66,0,1,0,1,0
53272,37580,0,0,66,66,0,1,0,1,0
63930,30188,0,0,63,63,0,1,0,1,0
38374,51505,0,0,120,120,0,1,0,1,0
58638,5900,0,0,62,62,0,1,0,1,0
53855,37965,0,0,65,65,0,1,0,1,0
28057,36237,0,0,71,71,0,1,0,1,0
54305,39004,0,0,62,62,0,1,0,1,0
16473,25174,0,0,63,63,0,1,0,1,0
443,64347,0,0,91,91,0,1,0,1,0
50765,22114,0,0,62,62,0,1,0,1,0
58638,5900,0,0,62,62,0,1,0,1,0
63252,53000,0,0,72,72,0,1,0,1,0
13285,29892,0,0,145,145,0,1,0,1,0
51626,37880,0,0,62,62,0,1,0,1,0
0,0,0,0,98,98,0,1,0,1,0
37892,3512,0,0,69,69,0,1,0,1,0
44135,64147,0,0,113,113,0,1,0,1,0
9448,57866,0,0,102,102,0,1,0,1,0
48676,53398,0,0,60,60,0,1,0,1,0
60904,48752,0,0,67,67,0,1,0,1,0
38040,15503,0,0,65,65,0,1,0,1,0
55926,57633,0,0,73,73,0,1,0,1,0
56350,22114,0,0,62,62,0,1,0,1,0
65221,37965,0,0,68,68,0,1,0,1,0
42446,48667,0,0,76,76,0,1,0,1,0
60002,37965,0,0,66,66,0,1,0,1,0
1284,50584,0,0,65,65,0,1,0,1,0
35394,30188,0,0,137,137,0,1,0,1,0
63392,57470,0,0,65,65,0,1,0,1,0
51560,46783,0,0,63,63,0,1,0,1,0
25063,64147,0,0,62,62,0,1,0,1,0
60625,64147,0,0,62,62,0,1,0,1,0
58638,5900,0,0,62,62,0,1,0,1,0
57394,25174,0,0,146,146,0,1,0,1,0
25269,58815,0,0,61,61,0,1,0,1,0
49282,35980,0,0,76,76,0,1,0,1,0
49708,50357,0,0,62,62,0,1,0,1,0
58638,5900,0,0,62,62,0,1,0,1,0
35232,36602,0,0,74,74,0,1,0,1,0
28681,35440,0,0,66,66,0,1,0,1,0
24149,26467,0,0,62,62,0,1,0,1,0
50424,50584,0,0,74,74,0,1,0,1,0
61628,5785,0,0,145,145,0,1,0,1,0
3251,11392,0,0,65,65,0,1,0,1,0
62709,57470,0,0,62,62,0,1,0,1,0
9408,37965,0,0,64,64,0,1,0,1,0
25879,35388,0,0,62,62,0,1,0,1,0
3478,61463,0,0,282,282,0,1,0,1,0
60413,15503,0,0,140,140,0,1,0,1,0
1284,50584,0,0,63,63,0,1,0,1,0
58638,5900,0,0,62,62,0,1,0,1,0
59732,53611,0,0,67,67,0,1,0,1,0
28328,64147,0,0,62,62,0,1,0,1,0
58234,22,0,0,60,60,0,1,0,1,0
55267,50584,0,0,66,66,0,1,0,1,0
61399,64147,0,0,62,62,0,1,0,1,0
53483,62413,0,0,62,62,0,1,0,1,0
44517,31164,0,0,146,146,0,1,0,1,0
59139,35440,0,0,64,64,0,1,0,1,0
57762,25174,0,0,94,94,0,1,0,1,0
57843,64147,0,0,66,66,0,1,0,1,0
63003,44847,0,0,64,64,0,1,0,1,0
44147,64147,0,0,62,62,0,1,0,1,0
58638,5900,0,0,62,62,0,1,0,1,0
14959,26467,0,0,62,62,0,1,0,1,0
58638,5900,0,0,62,62,0,1,0,1,0
10262,37862,0,0,64,64,0,1,0,1,0
52762,57500,0,0,66,66,0,1,0,1,0
60976,22114,0,0,64,64,0,1,0,1,0
54309,56205,0,0,62,62,0,1,0,1,0
57987,56125,0,0,90,90,0,1,0,1,0
63542,37965,0,0,65,65,0,1,0,1,0
443,48066,0,0,128,128,0,1,0,1,0
12820,22114,0,0,65,65,0,1,0,1,0
61295,25174,0,0,62,62,0,1,0,1,0
42252,33303,0,0,60,60,0,1,0,1,0
60435,22114,0,0,66,66,0,1,0,1,0
65396,26467,0,0,62,62,0,1,0,1,0
58638,5900,0,0,62,62,0,1,0,1,0
54550,25315,0,0,66,66,0,1,0,1,0
61392,50584,0,0,82,82,0,1,0,1,0
59412,37957,0,0,66,66,0,1,0,1,0
9748,26467,0,0,63,63,0,1,0,1,0
443,59535,0,0,60,60,0,1,0,1,0
53908,44847,0,0,66,66,0,1,0,1,0
61761,44847,0,0,66,66,0,1,0,1,0
5342,21229,0,0,63,63,0,1,0,1,0
26487,64147,0,0,62,62,0,1,0,1,0
55155,2767,0,0,66,66,0,1,0,1,0
23662,23,0,0,60,60,0,1,0,1,0
35261,15503,0,0,74,74,0,1,0,1,0
45839,25174,0,0,133,133,0,1,0,1,0
55985,44847,0,0,62,62,0,1,0,1,0
58638,5900,0,0,62,62,0,1,0,1,0
47746,15933,0,0,62,62,0,1,0,1,0
50649,56205,0,0,66,66,0,1,0,1,0
26296,8352,0,0,76,76,0,1,0,1,0
51376,11392,0,0,66,66,0,1,0,1,0
13285,29892,0,0,145,145,0,1,0,1,0
40229,64147,0,0,62,62,0,1,0,1,0
443,45788,0,0,332,332,0,1,0,1,0
50134,1433,0,0,60,60,0,1,0,1,0
63956,57470,0,0,68,68,0,1,0,1,0
34212,21818,0,0,62,62,0,1,0,1,0
817,43384,0,0,125,125,0,1,0,1,0
19125,64147,0,0,62,62,0,1,0,1,0
443,9986,0,0,327,327,0,1,0,1,0
10669,49756,0,0,60,60,0,1,0,1,0
26658,44847,0,0,62,62,0,1,0,1,0
46047,50584,0,0,76,76,0,1,0,1,0
42231,57470,0,0,78,78,0,1,0,1,0
10279,22114,0,0,62,62,0,1,0,1,0
50737,17524,0,0,82,82,0,1,0,1,0
62820,45,0,0,81,81,0,1,0,1,0
58638,5900,0,0,62,62,0,1,0,1,0
52676,53733,0,0,65,65,0,1,0,1,0
51571,44847,0,0,62,62,0,1,0,1,0
32509,179,0,0,60,60,0,1,0,1,0
36754,25174,0,0,64,64,0,1,0,1,0
11821,64147,0,0,62,62,0,1,0,1,0
1038,5957,0,0,79,79,0,1,0,1,0
443,20087,0,0,83,83,0,1,0,1,0
58958,37965,0,0,66,66,0,1,0,1,0
52596,17372,0,0,66,66,0,1,0,1,0
54600,6881,0,0,66,66,0,1,0,1,0
49929,26467,0,0,66,66,0,1,0,1,0
57339,50584,0,0,63,63,0,1,0,1,0
27248,25174,0,0,63,63,0,1,0,1,0
58638,5900,0,0,62,62,0,1,0,1,0
56264,44847,0,0,66,66,0,1,0,1,0
17558,55535,0,0,66,66,0,1,0,1,0
46734,50265,0,0,74,74,0,1,0,1,0
58705,43890,0,0,64,64,0,1,0,1,0
52690,7302,0,0,66,66,0,1,0,1,0
60179,35440,0,0,102,102,0,1,0,1,0
55439,37965,0,0,66,66,0,1,0,1,0
54715,30188,0,0,66,66,0,1,0,1,0
6121,51505,0,0,66,66,0,1,0,1,0
58496,18375,0,0,66,66,0,1,0,1,0
2792,2227,0,0,63,63,0,1,0,1,0
54305,39004,0,0,83,83,0,1,0,1,0
5555,64147,0,0,77,77,0,1,0,1,0
56825,5900,0,0,60,60,0,1,0,1,0
53030,56205,0,0,66,66,0,1,0,1,0
59424,50265,0,0,74,74,0,1,0,1,0
49897,26467,0,0,64,64,0,1,0,1,0
26526,44847,0,0,84,84,0,1,0,1,0
7445,50584,0,0,91,91,0,1,0,1,0
19875,30170,0,0,145,145,0,1,0,1,0
18708,64147,0,0,62,62,0,1,0,1,0
39668,2767,0,0,62,62,0,1,0,1,0
976,33247,0,0,66,66,0,1,0,1,0
1026,44847,0,0,62,62,0,1,0,1,0
5617,64147,0,0,103,103,0,1,0,1,0
29243,51477,0,0,137,137,0,1,0,1,0
53970,30101,0,0,63,63,0,1,0,1,0
51310,64147,0,0,66,66,0,1,0,1,0
33215,37965,0,0,62,62,0,1,0,1,0
43306,26467,0,0,65,65,0,1,0,1,0
50092,22,0,0,60,60,0,1,0,1,0
39195,25174,0,0,62,62,0,1,0,1,0
6666,50070,0,0,60,60,0,1,0,1,0
59147,57866,0,0,66,66,0,1,0,1,0
28834,44847,0,0,65,65,0,1,0,1,0
26401,26348,0,0,64,64,0,1,0,1,0
63269,57470,0,0,66,66,0,1,0,1,0
4041,50584,0,0,62,62,0,1,0,1,0
64932,44611,0,0,66,66,0,1,0,1,0
50592,23117,0,0,62,62,0,1,0,1,0
64823,26467,0,0,62,62,0,1,0,1,0
50563,37965,0,0,66,66,0,1,0,1,0
13285,29892,0,0,145,145,0,1,0,1,0
62283,44847,0,0,66,66,0,1,0,1,0
46725,57470,0,0,62,62,0,1,0,1,0
61916,64097,0,0,62,62,0,1,0,1,0
47499,12433,0,0,133,133,0,1,0,1,0
62072,30223,0,0,88,88,0,1,0,1,0
61513,17473,0,0,66,66,0,1,0,1,0
55503,64128,0,0,62,62,0,1,0,1,0
40301,8696,0,0,60,60,0,1,0,1,0
6666,185,0,0,60,60,0,1,0,1,0
16387,44427,0,0,60,60,0,1,0,1,0
45198,25174,0,0,123,123,0,1,0,1,0
63854,25174,0,0,62,62,0,1,0,1,0
42978,44816,0,0,62,62,0,1,0,1,0
3478,61463,0,0,287,287,0,1,0,1,0
64214,25174,0,0,62,62,0,1,0,1,0
51845,35440,0,0,66,66,0,1,0,1,0
20649,37965,0,0,62,62,0,1,0,1,0
52912,43890,0,0,65,65,0,1,0,1,0
25236,25174,0,0,145,145,0,1,0,1,0
19875,30170,0,0,145,145,0,1,0,1,0
48706,23393,0,0,60,60,0,1,0,1,0
18949,50584,0,0,146,146,0,1,0,1,0
51999,37965,0,0,62,62,0,1,0,1,0
36408,52,0,0,60,60,0,1,0,1,0
53294,62413,0,0,63,63,0,1,0,1,0
29016,25174,0,0,62,62,0,1,0,1,0
63323,54369,0,0,78,78,0,1,0,1,0
60238,50752,0,0,62,62,0,1,0,1,0
31667,35440,0,0,62,62,0,1,0,1,0
21322,25174,0,0,117,117,0,1,0,1,0
2116,62413,0,0,66,66,0,1,0,1,0
58776,30188,0,0,66,66,0,1,0,1,0
54789,50538,0,0,78,78,0,1,0,1,0
36419,50584,0,0,136,136,0,1,0,1,0
60054,25174,0,0,66,66,0,1,0,1,0
57334,37965,0,0,62,62,0,1,0,1,0
56226,65018,0,0,121,121,0,1,0,1,0
63786,25174,0,0,65,65,0,1,0,1,0
43756,5983,0,0,67,67,0,1,0,1,0
60075,30188,0,0,62,62,0,1,0,1,0
56062,64147,0,0,64,64,0,1,0,1,0
56249,55442,0,0,66,66,0,1,0,1,0
62368,48817,0,0,145,145,0,1,0,1,0
16461,25174,0,0,66,66,0,1,0,1,0
45848,25174,0,0,62,62,0,1,0,1,0
50637,44847,0,0,63,63,0,1,0,1,0
488,10139,0,0,61,61,0,1,0,1,0
45908,33330,0,0,60,60,0,1,0,1,0
10464,25174,0,0,62,62,0,1,0,1,0
9587,57470,0,0,63,63,0,1,0,1,0
44861,58315,0,0,63,63,0,1,0,1,0
60170,32,0,0,77,77,0,1,0,1,0
25342,8168,0,0,63,63,0,1,0,1,0
50254,25174,0,0,66,66,0,1,0,1,0
443,54507,0,0,82,82,0,1,0,1,0
39627,2575,0,0,78,78,0,1,0,1,0
5790,43890,0,0,62,62,0,1,0,1,0
33324,44577,0,0,85,85,0,1,0,1,0
52195,50322,0,0,65,65,0,1,0,1,0
50282,2323,0,0,60,60,0,1,0,1,0
53019,24211,0,0,66,66,0,1,0,1,0
58399,56205,0,0,64,64,0,1,0,1,0
54593,51505,0,0,66,66,0,1,0,1,0
34112,44847,0,0,66,66,0,1,0,1,0
443,62732,0,0,332,332,0,1,0,1,0
5099,3414,0,0,222,222,0,1,0,1,0
8528,48921,0,0,146,146,0,1,0,1,0
27847,51356,0,0,64,64,0,1,0,1,0
21746,22114,0,0,62,62,0,1,0,1,0
12122,56205,0,0,66,66,0,1,0,1,0
13004,10387,0,0,159,159,0,1,0,1,0
45908,3383,0,0,60,60,0,1,0,1,0
30598,25174,0,0,65,65,0,1,0,1,0
30829,13162,0,0,146,146,0,1,0,1,0
51871,36152,0,0,66,66,0,1,0,1,0
49744,64147,0,0,66,66,0,1,0,1,0
22374,25174,0,0,66,66,0,1,0,1,0
65494,53,0,0,88,88,0,1,0,1,0
0,0,0,0,98,98,0,1,0,1,0
61766,44847,0,0,64,64,0,1,0,1,0
57131,26296,0,0,145,145,0,1,0,1,0
58638,5900,0,0,62,62,0,1,0,1,0
53838,22114,0,0,62,62,0,1,0,1,0
9621,57470,0,0,65,65,0,1,0,1,0
51767,51505,0,0,66,66,0,1,0,1,0
58724,43890,0,0,66,66,0,1,0,1,0
58638,5900,0,0,62,62,0,1,0,1,0
3478,61463,0,0,639,639,0,1,0,1,0
49001,40108,0,0,161,161,0,1,0,1,0
48071,25174,0,0,62,62,0,1,0,1,0
52654,7282,0,0,66,66,0,1,0,1,0
41029,64147,0,0,62,62,0,1,0,1,0
62767,25174,0,0,62,62,0,1,0,1,0
39593,23117,0,0,62,62,0,1,0,1,0
23353,25174,0,0,62,62,0,1,0,1,0
29689,37892,0,0,63,63,0,1,0,1,0
58596,25128,0,0,71,71,0,1,0,1,0
30521,57519,0,0,62,62,0,1,0,1,0
1261,19779,0,0,72,72,0,1,0,1,0
50719,36237,0,0,63,63,0,1,0,1,0
27160,22114,0,0,146,146,0,1,0,1,0
65090,22114,0,0,66,66,0,1,0,1,0
24193,57470,0,0,62,62,0,1,0,1,0
49971,26467,0,0,64,64,0,1,0,1,0
28685,8676,0,0,60,60,0,1,0,1,0
62646,2389,0,0,60,60,0,1,0,1,0
51939,26467,0,0,61,61,0,1,0,1,0
55973,25174,0,0,62,62,0,1,0,1,0
64154,64147,0,0,86,86,0,1,0,1,0
38553,22114,0,0,62,62,0,1,0,1,0
1170,54021,0,0,98,98,0,1,0,1,0
49799,64147,0,0,66,66,0,1,0,1,0
65270,3855,0,0,78,78,0,1,0,1,0
10914,35974,0,0,60,60,0,1,0,1,0
30628,46819,0,0,62,62,0,1,0,1,0
5223,14084,0,0,153,153,0,1,0,1,0
49880,35440,0,0,62,62,0,1,0,1,0
43155,35440,0,0,66,66,0,1,0,1,0
16387,16862,0,0,60,60,0,1,0,1,0
51414,54719,0,0,133,133,0,1,0,1,0
56676,37965,0,0,64,64,0,1,0,1,0
34603,26359,0,0,118,118,0,1,0,1,0
53291,3389,0,0,64,64,0,1,0,1,0
1055,44847,0,0,146,146,0,1,0,1,0
50757,48838,0,0,66,66,0,1,0,1,0
58638,5900,0,0,62,62,0,1,0,1,0
22683,39210,0,0,60,60,0,1,0,1,0
1024,44847,0,0,103,103,0,1,0,1,0
53491,57470,0,0,62,62,0,1,0,1,0
50192,35338,0,0,66,66,0,1,0,1,0
15296,37965,0,0,63,63,0,1,0,1,0
58638,5900,0,0,62,62,0,1,0,1,0
22574,64147,0,0,66,66,0,1,0,1,0
58338,3368,0,0,60,60,0,1,0,1,0
52727,25174,0,0,66,66,0,1,0,1,0
14468,64147,0,0,62,62,0,1,0,1,0
23120,6881,0,0,146,146,0,1,0,1,0
58638,5900,0,0,62,62,0,1,0,1,0
50090,50265,0,0,66,66,0,1,0,1,0
36475,54,0,0,60,60,0,1,0,1,0
18950,50584,0,0,79,79,0,1,0,1,0
10766,35440,0,0,62,62,0,1,0,1,0
80,53945,0,0,60,60,0,1,0,1,0
63855,25174,0,0,143,143,0,1,0,1,0
27493,55952,0,0,139,139,0,1,0,1,0
1026,64147,0,0,62,62,0,1,0,1,0
25570,35440,0,0,62,62,0,1,0,1,0
65089,30188,0,0,66,66,0,1,0,1,0
34932,38608,0,0,62,62,0,1,0,1,0
16387,8455,0,0,60,60,0,1,0,1,0
62296,25174,0,0,94,94,0,1,0,1,0
63852,25174,0,0,62,62,0,1,0,1,0
52934,26467,0,0,66,66,0,1,0,1,0
59445,50584,0,0,63,63,0,1,0,1,0
45964,2228,0,0,60,60,0,1,0,1,0
64838,37004,0,0,66,66,0,1,0,1,0
59463,24,0,0,60,60,0,1,0,1,0
29584,37807,0,0,65,65,0,1,0,1,0
65254,37960,0,0,62,62,0,1,0,1,0
443,2898,0,0,127,127,0,1,0,1,0
59924,22114,0,0,63,63,0,1,0,1,0
45941,23386,0,0,60,60,0,1,0,1,0
56202,22114,0,0,62,62,0,1,0,1,0
62782,35440,0,0,66,66,0,1,0,1,0
11847,64147,0,0,62,62,0,1,0,1,0
25018,51505,0,0,62,62,0,1,0,1,0
65003,57470,0,0,78,78,0,1,0,1,0
63433,57866,0,0,62,62,0,1,0,1,0
16647,21247,0,0,62,62,0,1,0,1,0
41829,50584,0,0,72,72,0,1,0,1,0
56655,11392,0,0,63,63,0,1,0,1,0
47910,7454,0,0,60,60,0,1,0,1,0
45994,22002,0,0,72,72,0,1,0,1,0
54294,28612,0,0,66,66,0,1,0,1,0
10455,46202,0,0,63,63,0,1,0,1,0
42753,44847,0,0,63,63,0,1,0,1,0
25656,39956,0,0,98,98,0,1,0,1,0
3069,50584,0,0,125,125,0,1,0,1,0
14075,48768,0,0,64,64,0,1,0,1,0
57797,62413,0,0,62,62,0,1,0,1,0
6057,51221,0,0,72,72,0,1,0,1,0
52711,37965,0,0,62,62,0,1,0,1,0
56796,35440,0,0,62,62,0,1,0,1,0
57849,64147,0,0,65,65,0,1,0,1,0
57902,30207,0,0,62,62,0,1,0,1,0
53499,1,0,0,65,65,0,1,0,1,0
53161,51221,0,0,66,66,0,1,0,1,0
52725,37965,0,0,62,62,0,1,0,1,0
33215,37965,0,0,62,62,0,1,0,1,0
58638,5900,0,0,62,62,0,1,0,1,0
35388,44021,0,0,73,73,0,1,0,1,0
4380,11389,0,0,66,66,0,1,0,1,0
51094,35440,0,0,66,66,0,1,0,1,0
42465,57470,0,0,60,60,0,1,0,1,0
55335,62413,0,0,66,66,0,1,0,1,0
23071,37891,0,0,64,64,0,1,0,1,0
30892,50493,0,0,63,63,0,1,0,1,0
55850,64147,0,0,66,66,0,1,0,1,0
56163,56205,0,0,65,65,0,1,0,1,0
57325,37965,0,0,62,62,0,1,0,1,0
21628,51505,0,0,105,105,0,1,0,1,0
58965,24,0,0,60,60,0,1,0,1,0
45941,23386,0,0,60,60,0,1,0,1,0
50561,22114,0,0,62,62,0,1,0,1,0
59154,57866,0,0,66,66,0,1,0,1,0
1030,64147,0,0,127,127,0,1,0,1,0
50333,22114,0,0,62,62,0,1,0,1,0
49552,21247,0,0,66,66,0,1,0,1,0
3755,17372,0,0,62,62,0,1,0,1,0
62914,11392,0,0,143,143,0,1,0,1,0
49791,25174,0,0,78,78,0,1,0,1,0
24221,37835,0,0,62,62,0,1,0,1,0
63132,56205,0,0,63,63,0,1,0,1,0
39296,44847,0,0,91,91,0,1,0,1,0
63792,64147,0,0,66,66,0,1,0,1,0
52128,37807,0,0,64,64,0,1,0,1,0
33556,23,0,0,60,60,0,1,0,1,0
55893,45711,0,0,78,78,0,1,0,1,0
63863,25174,0,0,63,63,0,1,0,1,0
49616,30188,0,0,65,65,0,1,0,1,0
53268,57470,0,0,72,72,0,1,0,1,0
39332,50021,0,0,131,131,0,1,0,1,0
52744,25174,0,0,63,63,0,1,0,1,0
4696,37918,0,0,89,89,0,1,0,1,0
58638,5900,0,0,62,62,0,1,0,1,0
58118,22114,0,0,64,64,0,1,0,1,0
65488,6058,0,0,62,62,0,1,0,1,0
24500,55783,0,0,70,70,0,1,0,1,0
39039,18,0,0,60,60,0,1,0,1,0
63080,37965,0,0,66,66,0,1,0,1,0
443,14591,0,0,126,126,0,1,0,1,0
56756,18375,0,0,63,63,0,1,0,1,0
44147,64147,0,0,62,62,0,1,0,1,0
58638,5900,0,0,62,62,0,1,0,1,0
46346,35440,0,0,66,66,0,1,0,1,0
5616,37965,0,0,64,64,0,1,0,1,0
64918,26467,0,0,62,62,0,1,0,1,0
6811,45137,0,0,107,107,0,1,0,1,0
56614,43890,0,0,65,65,0,1,0,1,0
9727,26467,0,0,62,62,0,1,0,1,0
8939,23,0,0,60,60,0,1,0,1,0
16614,25174,0,0,62,62,0,1,0,1,0
52074,11392,0,0,64,64,0,1,0,1,0
31744,51505,0,0,62,62,0,1,0,1,0
64245,51505,0,0,62,62,0,1,0,1,0
33968,25174,0,0,120,120,0,1,0,1,0
16378,21247,0,0,62,62,0,1,0,1,0
18495,64127,0,0,62,62,0,1,0,1,0
36167,22,0,0,60,60,0,1,0,1,0
25433,58790,0,0,60,60,0,1,0,1,0
3363,45248,0,0,96,96,0,1,0,1,0
57524,42707,0,0,65,65,0,1,0,1,0
65233,44847,0,0,64,64,0,1,0,1,0
6247,51221,0,0,75,75,0,1,0,1,0
56929,22820,0,0,146,146,0,1,0,1,0
63460,55160,0,0,63,63,0,1,0,1,0
50383,49099,0,0,66,66,0,1,0,1,0
58357,62413,0,0,142,142,0,1,0,1,0
41220,59356,0,0,62,62,0,1,0,1,0
60960,49049,0,0,62,62,0,1,0,1,0
52284,51424,0,0,68,68,0,1,0,1,0
10003,64147,0,0,62,62,0,1,0,1,0
58638,5900,0,0,62,62,0,1,0,1,0
16091,22114,0,0,137,137,0,1,0,1,0
55295,44847,0,0,64,64,0,1,0,1,0
58638,5900,0,0,62,62,0,1,0,1,0
16920,50558,0,0,139,139,0,1,0,1,0
9370,51505,0,0,62,62,0,1,0,1,0
50340,64147,0,0,66,66,0,1,0,1,0
51162,56205,0,0,62,62,0,1,0,1,0
1024,64147,0,0,62,62,0,1,0,1,0
44147,64147,0,0,62,62,0,1,0,1,0
63397,26467,0,0,66,66,0,1,0,1,0
59493,44847,0,0,66,66,0,1,0,1,0
14693,64147,0,0,66,66,0,1,0,1,0
41244,2331,0,0,107,107,0,1,0,1,0
61461,50587,0,0,62,62,0,1,0,1,0
24346,22578,0,0,66,66,0,1,0,1,0
51560,46783,0,0,64,64,0,1,0,1,0
31793,56003,0,0,62,62,0,1,0,1,0
15271,44847,0,0,62,62,0,1,0,1,0
49424,38601,0,0,73,73,0,1,0,1,0
19661,37965,0,0,62,62,0,1,0,1,0
14823,57599,0,0,119,119,0,1,0,1,0
57569,64147,0,0,66,66,0,1,0,1,0
46204,51505,0,0,102,102,0,1,0,1,0
54055,36237,0,0,65,65,0,1,0,1,0
37401,36237,0,0,66,66,0,1,0,1,0
11465,30188,0,0,63,63,0,1,0,1,0
51895,56205,0,0,65,65,0,1,0,1,0
28637,37965,0,0,62,62,0,1,0,1,0
36420,23,0,0,60,60,0,1,0,1,0
2113,25174,0,0,62,62,0,1,0,1,0
60141,64147,0,0,64,64,0,1,0,1,0
56467,56205,0,0,134,134,0,1,0,1,0
49288,25174,0,0,62,62,0,1,0,1,0
17222,22114,0,0,64,64,0,1,0,1,0
58008,22114,0,0,66,66,0,1,0,1,0
56349,25174,0,0,63,63,0,1,0,1,0
65387,44847,0,0,66,66,0,1,0,1,0
37398,44847,0,0,62,62,0,1,0,1,0
28564,64147,0,0,62,62,0,1,0,1,0
23771,44847,0,0,62,62,0,1,0,1,0
58638,5900,0,0,62,62,0,1,0,1,0
37075,48817,0,0,62,62,0,1,0,1,0
58638,5900,0,0,62,62,0,1,0,1,0
46272,35440,0,0,65,65,0,1,0,1,0
58638,5900,0,0,62,62,0,1,0,1,0
48706,23393,0,0,60,60,0,1,0,1,0
50341,37965,0,0,66,66,0,1,0,1,0
65345,56100,0,0,66,66,0,1,0,1,0
55134,26467,0,0,66,66,0,1,0,1,0
3511,11392,0,0,66,66,0,1,0,1,0
10547,57470,0,0,62,62,0,1,0,1,0
11831,64147,0,0,62,62,0,1,0,1,0
7440,32717,0,0,91,91,0,1,0,1,0
54745,50584,0,0,64,64,0,1,0,1,0
7373,50584,0,0,65,65,0,1,0,1,0
6908,64280,0,0,61,61,0,1,0,1,0
39685,36377,0,0,62,62,0,1,0,1,0
64632,25174,0,0,66,66,0,1,0,1,0
54775,50584,0,0,64,64,0,1,0,1,0
47561,26467,0,0,62,62,0,1,0,1,0
3580,25174,0,0,62,62,0,1,0,1,0
14637,57843,0,0,62,62,0,1,0,1,0
1114,37965,0,0,62,62,0,1,0,1,0
58593,36708,0,0,68,68,0,1,0,1,0
1104,57470,0,0,145,145,0,1,0,1,0
45941,23386,0,0,60,60,0,1,0,1,0
14932,26467,0,0,62,62,0,1,0,1,0
58638,5900,0,0,62,62,0,1,0,1,0
63469,64147,0,0,62,62,0,1,0,1,0
65140,57866,0,0,63,63,0,1,0,1,0
61643,22114,0,0,62,62,0,1,0,1,0
34400,39004,0,0,74,74,0,1,0,1,0
8783,29323,0,0,60,60,0,1,0,1,0
56385,22114,0,0,65,65,0,1,0,1,0
62728,32477,0,0,100,100,0,1,0,1,0
3068,36237,0,0,62,62,0,1,0,1,0
26304,22114,0,0,140,140,0,1,0,1,0
64088,23718,0,0,83,83,0,1,0,1,0
43747,22114,0,0,62,62,0,1,0,1,0
58765,22114,0,0,120,120,0,1,0,1,0
15972,48817,0,0,141,141,0,1,0,1,0
29763,44847,0,0,66,66,0,1,0,1,0
27027,35327,0,0,63,63,0,1,0,1,0
52898,26467,0,0,65,65,0,1,0,1,0
22405,22114,0,0,66,66,0,1,0,1,0
58638,5900,0,0,62,62,0,1,0,1,0
52337,64121,0,0,63,63,0,1,0,1,0
44208,26467,0,0,62,62,0,1,0,1,0
61808,18375,0,0,66,66,0,1,0,1,0
12173,56205,0,0,124,124,0,1,0,1,0
38420,51221,0,0,66,66,0,1,0,1,0
21064,25174,0,0,97,97,0,1,0,1,0
25104,25174,0,0,146,146,0,1,0,1,0
26881,37965,0,0,105,105,0,1,0,1,0
22513,30188,0,0,62,62,0,1,0,1,0
50063,35776,0,0,148,148,0,1,0,1,0
9430,51505,0,0,64,64,0,1,0,1,0
6832,51505,0,0,66,66,0,1,0,1,0
44928,57470,0,0,73,73,0,1,0,1,0
60671,35440,0,0,66,66,0,1,0,1,0
12226,37965,0,0,62,62,0,1,0,1,0
22636,30188,0,0,66,66,0,1,0,1,0
43916,21,0,0,60,60,0,1,0,1,0
52238,26467,0,0,62,62,0,1,0,1,0
53463,44847,0,0,62,62,0,1,0,1,0
26923,37965,0,0,65,65,0,1,0,1,0
51402,64147,0,0,63,63,0,1,0,1,0
54737,50584,0,0,66,66,0,1,0,1,0
3717,25174,0,0,62,62,0,1,0,1,0
20716,2767,0,0,62,62,0,1,0,1,0
56967,35440,0,0,66,66,0,1,0,1,0
14634,26467,0,0,62,62,0,1,0,1,0
45964,55559,0,0,60,60,0,1,0,1,0
53676,35974,0,0,60,60,0,1,0,1,0
64183,44847,0,0,62,62,0,1,0,1,0
63941,38094,0,0,63,63,0,1,0,1,0
2801,64147,0,0,65,65,0,1,0,1,0
7394,44847,0,0,66,66,0,1,0,1,0
58638,5900,0,0,62,62,0,1,0,1,0
64940,36237,0,0,62,62,0,1,0,1,0
54220,35440,0,0,63,63,0,1,0,1,0
5223,44091,0,0,121,121,0,1,0,1,0
49313,44847,0,0,62,62,0,1,0,1,0
58715,57470,0,0,64,64,0,1,0,1,0
58464,35637,0,0,66,66,0,1,0,1,0
43485,35440,0,0,63,63,0,1,0,1,0
1972,57470,0,0,78,78,0,1,0,1,0
58919,11392,0,0,65,65,0,1,0,1,0
26660,25174,0,0,62,62,0,1,0,1,0
51834,51505,0,0,66,66,0,1,0,1,0
53960,44847,0,0,66,66,0,1,0,1,0
62704,35440,0,0,63,63,0,1,0,1,0
443,7387,0,0,60,60,0,1,0,1,0
1024,44847,0,0,146,146,0,1,0,1,0
45964,2225,0,0,60,60,0,1,0,1,0
60267,56205,0,0,66,66,0,1,0,1,0
63293,37965,0,0,66,66,0,1,0,1,0
49250,25174,0,0,64,64,0,1,0,1,0
27533,23,0,0,60,60,0,1,0,1,0
50748,37929,0,0,62,62,0,1,0,1,0
36057,35440,0,0,62,62,0,1,0,1,0
41412,40,0,0,89,89,0,1,0,1,0
515,10214,0,0,63,63,0,1,0,1,0
58638,5900,0,0,62,62,0,1,0,1,0
41737,27319,0,0,62,62,0,1,0,1,0
28136,37965,0,0,62,62,0,1,0,1,0
0,0,0,0,70,70,0,1,0,1,0
54769,50584,0,0,62,62,0,1,0,1,0
50846,64147,0,0,67,67,0,1,0,1,0
33504,57395,0,0,119,119,0,1,0,1,0
7482,57470,0,0,66,66,0,1,0,1,0
50398,43890,0,0,62,62,0,1,0,1,0
55966,57866,0,0,66,66,0,1,0,1,0
64339,18375,0,0,66,66,0,1,0,1,0
59136,17500,0,0,66,66,0,1,0,1,0
25523,35974,0,0,62,62,0,1,0,1,0
55972,23718,0,0,63,63,0,1,0,1,0
20576,37965,0,0,62,62,0,1,0,1,0
58638,5900,0,0,62,62,0,1,0,1,0
50431,55826,0,0,62,62,0,1,0,1,0
17514,44847,0,0,64,64,0,1,0,1,0
41737,56205,0,0,62,62,0,1,0,1,0
51132,44847,0,0,62,62,0,1,0,1,0
57987,56125,0,0,90,90,0,1,0,1,0
51533,44847,0,0,66,66,0,1,0,1,0
55778,64147,0,0,66,66,0,1,0,1,0
7342,22114,0,0,66,66,0,1,0,1,0
24204,23,0,0,60,60,0,1,0,1,0
41929,35440,0,0,62,62,0,1,0,1,0
12080,37965,0,0,64,64,0,1,0,1,0
39313,37965,0,0,62,62,0,1,0,1,0
52459,5555,0,0,60,60,0,1,0,1,0
57436,42707,0,0,62,62,0,1,0,1,0
63993,21638,0,0,66,66,0,1,0,1,0
6247,51221,0,0,78,78,0,1,0,1,0
27046,51412,0,0,121,121,0,1,0,1,0
65258,35440,0,0,62,62,0,1,0,1,0
62130,35440,0,0,66,66,0,1,0,1,0
2559,64147,0,0,62,62,0,1,0,1,0
35689,20238,0,0,62,62,0,1,0,1,0
80,53945,0,0,60,60,0,1,0,1,0
61910,54532,0,0,60,60,0,1,0,1,0
45964,5333,0,0,60,60,0,1,0,1,0
56063,23718,0,0,66,66,0,1,0,1,0
58638,5900,0,0,62,62,0,1,0,1,0
3478,61463,0,0,1143,1143,0,1,0,1,0
56265,52750,0,0,62,62,0,1,0,1,0
6971,48470,0,0,139,139,0,1,0,1,0
48501,44847,0,0,146,146,0,1,0,1,0
43207,26467,0,0,62,62,0,1,0,1,0
21512,22114,0,0,62,62,0,1,0,1,0
3117,37965,0,0,62,62,0,1,0,1,0
27690,35989,0,0,85,85,0,1,0,1,0
64164,44847,0,0,62,62,0,1,0,1,0
57834,64147,0,0,66,66,0,1,0,1,0
55436,64147,0,0,66,66,0,1,0,1,0
43443,35440,0,0,141,141,0,1,0,1,0
5173,23,0,0,60,60,0,1,0,1,0
52803,58119,0,0,62,62,0,1,0,1,0
52275,64124,0,0,63,63,0,1,0,1,0
37972,50379,0,0,64,64,0,1,0,1,0
58638,5900,0,0,62,62,0,1,0,1,0
53613,15,0,0,61,61,0,1,0,1,0
60168,35440,0,0,65,65,0,1,0,1,0
52763,53686,0,0,66,66,0,1,0,1,0
1228,62530,0,0,113,113,0,1,0,1,0
1046,46787,0,0,62,62,0,1,0,1,0
1873,37965,0,0,62,62,0,1,0,1,0
16835,57470,0,0,111,111,0,1,0,1,0
49991,37965,0,0,66,66,0,1,0,1,0
33938,50517,0,0,98,98,0,1,0,1,0
22346,51505,0,0,62,62,0,1,0,1,0
6889,8180,0,0,143,143,0,1,0,1,0
53353,26467,0,0,62,62,0,1,0,1,0
53459,9,0,0,63,63,0,1,0,1,0
37269,44386,0,0,64,64,0,1,0,1,0
64392,25174,0,0,63,63,0,1,0,1,0
35279,25174,0,0,134,134,0,1,0,1,0
49734,35478,0,0,72,72,0,1,0,1,0
18398,21247,0,0,66,66,0,1,0,1,0
53848,37965,0,0,66,66,0,1,0,1,0
19920,22114,0,0,96,96,0,1,0,1,0
63719,25174,0,0,62,62,0,1,0,1,0
58644,52700,0,0,87,87,0,1,0,1,0
58638,5900,0,0,62,62,0,1,0,1,0
51712,25174,0,0,66,66,0,1,0,1,0
26872,50584,0,0,63,63,0,1,0,1,0
30307,56728,0,0,160,160,0,1,0,1,0
57676,19750,0,0,66,66,0,1,0,1,0
1375,56205,0,0,64,64,0,1,0,1,0
11505,31203,0,0,115,115,0,1,0,1,0
46593,57632,0,0,66,66,0,1,0,1,0
64675,35993,0,0,62,62,0,1,0,1,0
25076,64147,0,0,63,63,0,1,0,1,0
54534,35440,0,0,99,99,0,1,0,1,0
62150,56205,0,0,65,65,0,1,0,1,0
16150,50408,0,0,62,62,0,1,0,1,0
58638,5900,0,0,62,62,0,1,0,1,0
60866,42745,0,0,66,66,0,1,0,1,0
58638,5900,0,0,62,62,0,1,0,1,0
9324,37965,0,0,63,63,0,1,0,1,0
48019,22114,0,0,66,66,0,1,0,1,0
62628,56205,0,0,63,63,0,1,0,1,0
34071,44847,0,0,65,65,0,1,0,1,0
63674,64108,0,0,66,66,0,1,0,1,0
17760,50584,0,0,145,145,0,1,0,1,0
64932,26467,0,0,62,62,0,1,0,1,0
45755,7,0,0,61,61,0,1,0,1,0
38629,25174,0,0,65,65,0,1,0,1,0
28824,44847,0,0,64,64,0,1,0,1,0
13963,50584,0,0,65,65,0,1,0,1,0
58638,5900,0,0,62,62,0,1,0,1,0
5617,37965,0,0,64,64,0,1,0,1,0
3478,61463,0,0,444,444,0,1,0,1,0
7914,50584,0,0,62,62,0,1,0,1,0
10177,31879,0,0,119,119,0,1,0,1,0
45964,2666,0,0,60,60,0,1,0,1,0
64114,43374,0,0,63,63,0,1,0,1,0
443,47582,0,0,97,97,0,1,0,1,0
1951,57470,0,0,92,92,0,1,0,1,0
11136,15503,0,0,62,62,0,1,0,1,0
50907,30070,0,0,66,66,0,1,0,1,0
64379,37965,0,0,65,65,0,1,0,1,0
33490,22,0,0,60,60,0,1,0,1,0
41422,50584,0,0,66,66,0,1,0,1,0
41170,23,0,0,60,60,0,1,0,1,0
51148,9571,0,0,66,66,0,1,0,1,0
26287,56205,0,0,62,62,0,1,0,1,0
2990,64147,0,0,63,63,0,1,0,1,0
16387,20045,0,0,60,60,0,1,0,1,0
21050,51505,0,0,62,62,0,1,0,1,0
42805,57470,0,0,62,62,0,1,0,1,0
26025,1433,0,0,60,60,0,1,0,1,0
45551,38205,0,0,64,64,0,1,0,1,0
17947,36237,0,0,62,62,0,1,0,1,0
49191,35440,0,0,62,62,0,1,0,1,0
50205,44847,0,0,69,69,0,1,0,1,0
10319,44847,0,0,66,66,0,1,0,1,0
57236,31404,0,0,92,92,0,1,0,1,0
62811,32473,0,0,84,84,0,1,0,1,0
62337,44847,0,0,66,66,0,1,0,1,0
62930,11392,0,0,62,62,0,1,0,1,0
61550,5529,0,0,145,145,0,1,0,1,0
8856,47684,0,0,64,64,0,1,0,1,0
68,37870,0,0,62,62,0,1,0,1,0
8999,57470,0,0,146,146,0,1,0,1,0
5805,37965,0,0,65,65,0,1,0,1,0
34060,5692,0,0,107,107,0,1,0,1,0
6057,51221,0,0,78,78,0,1,0,1,0
62064,22114,0,0,65,65,0,1,0,1,0
7310,44847,0,0,66,66,0,1,0,1,0
58893,26649,0,0,65,65,0,1,0,1,0
51483,17417,0,0,78,78,0,1,0,1,0
51437,25174,0,0,132,132,0,1,0,1,0
61692,30317,0,0,78,78,0,1,0,1,0
63081,26467,0,0,63,63,0,1,0,1,0
443,14377,0,0,151,151,0,1,0,1,0
45964,2228,0,0,60,60,0,1,0,1,0
24039,26467,0,0,62,62,0,1,0,1,0
53844,22114,0,0,62,62,0,1,0,1,0
10394,22114,0,0,115,115,0,1,0,1,0
9756,26467,0,0,65,65,0,1,0,1,0
64344,25174,0,0,62,62,0,1,0,1,0
53369,50369,0,0,115,115,0,1,0,1,0
443,39960,0,0,74,74,0,1,0,1,0
47910,7462,0,0,60,60,0,1,0,1,0
51088,56205,0,0,66,66,0,1,0,1,0
46812,50584,0,0,62,62,0,1,0,1,0
62722,64147,0,0,65,65,0,1,0,1,0
53257,37450,0,0,63,63,0,1,0,1,0
38976,46824,0,0,62,62,0,1,0,1,0
35318,44541,0,0,62,62,0,1,0,1,0
28824,44847,0,0,66,66,0,1,0,1,0
50052,65008,0,0,60,60,0,1,0,1,0
37592,48750,0,0,61,61,0,1,0,1,0
54582,36237,0,0,66,66,0,1,0,1,0
14766,58325,0,0,62,62,0,1,0,1,0
45941,23386,0,0,60,60,0,1,0,1,0
19748,64147,0,0,62,62,0,1,0,1,0
1214,57470,0,0,104,104,0,1,0,1,0
51414,22,0,0,60,60,0,1,0,1,0
1042,57470,0,0,68,68,0,1,0,1,0
53500,36237,0,0,66,66,0,1,0,1,0
1116,37965,0,0,62,62,0,1,0,1,0
3478,61463,0,0,724,724,0,1,0,1,0
58638,5900,0,0,62,62,0,1,0,1,0
58677,64097,0,0,62,62,0,1,0,1,0
60476,3189,0,0,61,61,0,1,0,1,0
58635,5930,0,0,64,64,0,1,0,1,0
16856,64147,0,0,104,104,0,1,0,1,0
27953,25174,0,0,62,62,0,1,0,1,0
50335,22114,0,0,62,62,0,1,0,1,0
60335,30188,0,0,65,65,0,1,0,1,0
34318,23,0,0,60,60,0,1,0,1,0
56257,44847,0,0,66,66,0,1,0,1,0
36302,35440,0,0,62,62,0,1,0,1,0
51892,26467,0,0,62,62,0,1,0,1,0
2878,25174,0,0,65,65,0,1,0,1,0
57584,51221,0,0,62,62,0,1,0,1,0
31845,55777,0,0,62,62,0,1,0,1,0
58638,5900,0,0,62,62,0,1,0,1,0
6057,51221,0,0,78,78,0,1,0,1,0
63630,50584,0,0,62,62,0,1,0,1,0
57495,44847,0,0,66,66,0,1,0,1,0
10635,57567,0,0,62,62,0,1,0,1,0
26742,57470,0,0,65,65,0,1,0,1,0
24086,51645,0,0,136,136,0,1,0,1,0
58452,15503,0,0,132,132,0,1,0,1,0
18853,44847,0,0,66,66,0,1,0,1,0
35657,48637,0,0,62,62,0,1,0,1,0
28294,22,0,0,60,60,0,1,0,1,0
38147,37863,0,0,62,62,0,1,0,1,0
50859,50584,0,0,66,66,0,1,0,1,0
53226,57470,0,0,74,74,0,1,0,1,0
58963,37965,0,0,66,66,0,1,0,1,0
3521,6881,0,0,64,64,0,1,0,1,0
60665,58414,0,0,62,62,0,1,0,1,0
56705,25174,0,0,62,62,0,1,0,1,0
26472,44847,0,0,135,135,0,1,0,1,0
12348,50265,0,0,62,62,0,1,0,1,0
27369,30208,0,0,65,65,0,1,0,1,0
60338,64147,0,0,62,62,0,1,0,1,0
443,14591,0,0,91,91,0,1,0,1,0
58638,5900,0,0,62,62,0,1,0,1,0
59493,44847,0,0,66,66,0,1,0,1,0
40333,1308,0,0,60,60,0,1,0,1,0
443,35385,0,0,74,74,0,1,0,1,0
30780,36237,0,0,62,62,0,1,0,1,0
27528,23,0,0,60,60,0,1,0,1,0
25901,50265,0,0,62,62,0,1,0,1,0
58547,62413,0,0,85,85,0,1,0,1,0
61312,23,0,0,60,60,0,1,0,1,0
1038,37965,0,0,62,62,0,1,0,1,0
51999,37965,0,0,62,62,0,1,0,1,0
4447,35440,0,0,66,66,0,1,0,1,0
61550,5529,0,0,145,145,0,1,0,1,0
17234,25174,0,0,140,140,0,1,0,1,0
63080,64147,0,0,65,65,0,1,0,1,0
5448,50584,0,0,64,64,0,1,0,1,0
50360,37965,0,0,66,66,0,1,0,1,0
14220,21934,0,0,65,65,0,1,0,1,0
49499,57470,0,0,66,66,0,1,0,1,0
10193,44847,0,0,66,66,0,1,0,1,0
48676,53395,0,0,60,60,0,1,0,1,0
53895,37965,0,0,63,63,0,1,0,1,0
11677,56205,0,0,64,64,0,1,0,1,0
60981,15503,0,0,145,145,0,1,0,1,0
37345,48782,0,0,61,61,0,1,0,1,0
48191,57795,0,0,62,62,0,1,0,1,0
19612,44847,0,0,62,62,0,1,0,1,0
55386,32480,0,0,63,63,0,1,0,1,0
36885,50584,0,0,62,62,0,1,0,1,0
7037,15646,0,0,64,64,0,1,0,1,0
25222,37965,0,0,62,62,0,1,0,1,0
25544,41,0,0,60,60,0,1,0,1,0
51414,22,0,0,60,60,0,1,0,1,0
61533,64147,0,0,66,66,0,1,0,1,0
54912,64147,0,0,66,66,0,1,0,1,0
59182,50584,0,0,66,66,0,1,0,1,0
56940,22114,0,0,138,138,0,1,0,1,0
58798,51505,0,0,66,66,0,1,0,1,0
63881,25174,0,0,66,66,0,1,0,1,0
25701,7062,0,0,65,65,0,1,0,1,0
58638,5900,0,0,62,62,0,1,0,1,0
53088,25174,0,0,66,66,0,1,0,1,0
51414,50584,0,0,62,62,0,1,0,1,0
58743,25174,0,0,121,121,0,1,0,1,0
27825,51591,0,0,62,62,0,1,0,1,0
61550,5529,0,0,145,145,0,1,0,1,0
11686,25174,0,0,89,89,0,1,0,1,0
57777,37906,0,0,66,66,0,1,0,1,0
3478,61463,0,0,68,68,0,1,0,1,0
30757,36237,0,0,62,62,0,1,0,1,0
56688,25174,0,0,63,63,0,1,0,1,0
32342,62413,0,0,66,66,0,1,0,1,0
41003,5000,0,0,60,60,0,1,0,1,0
53257,37450,0,0,63,63,0,1,0,1,0
10357,22114,0,0,62,62,0,1,0,1,0
47114,35440,0,0,62,62,0,1,0,1,0
48706,23393,0,0,60,60,0,1,0,1,0
9141,51765,0,0,89,89,0,1,0,1,0
58638,5900,0,0,62,62,0,1,0,1,0
2419,37862,0,0,66,66,0,1,0,1,0
50567,22114,0,0,62,62,0,1,0,1,0
58055,56138,0,0,85,85,0,1,0,1,0
58469,11392,0,0,66,66,0,1,0,1,0
52862,37885,0,0,63,63,0,1,0,1,0
63011,11476,0,0,62,62,0,1,0,1,0
50949,45960,0,0,62,62,0,1,0,1,0
23349,25174,0,0,146,146,0,1,0,1,0
50311,15382,0,0,127,127,0,1,0,1,0
19862,22180,0,0,140,140,0,1,0,1,0
3478,61463,0,0,1303,1303,0,1,0,1,0
58638,5900,0,0,62,62,0,1,0,1,0
40143,50303,0,0,62,62,0,1,0,1,0
443,35385,0,0,66,66,0,1,0,1,0
64878,26467,0,0,62,62,0,1,0,1,0
52913,51214,0,0,77,77,0,1,0,1,0
57236,53733,0,0,63,63,0,1,0,1,0
42108,36237,0,0,84,84,0,1,0,1,0
30637,50307,0,0,65,65,0,1,0,1,0
58638,5900,0,0,62,62,0,1,0,1,0
24384,55978,0,0,69,69,0,1,0,1,0
17133,62422,0,0,66,66,0,1,0,1,0
1144,25174,0,0,62,62,0,1,0,1,0
52720,64147,0,0,63,63,0,1,0,1,0
3097,37965,0,0,62,62,0,1,0,1,0
58638,5900,0,0,62,62,0,1,0,1,0
28853,37965,0,0,62,62,0,1,0,1,0
927,36812,0,0,319,319,0,1,0,1,0
41976,25174,0,0,66,66,0,1,0,1,0
26418,25174,0,0,64,64,0,1,0,1,0
12790,63095,0,0,64,64,0,1,0,1,0
10028,32480,0,0,62,62,0,1,0,1,0
58008,11819,0,0,68,68,0,1,0,1,0
25599,50367,0,0,113,113,0,1,0,1,0
38438,51505,0,0,126,126,0,1,0,1,0
64491,5966,0,0,65,65,0,1,0,1,0
56874,35894,0,0,64,64,0,1,0,1,0
65012,32468,0,0,62,62,0,1,0,1,0
47910,7454,0,0,60,60,0,1,0,1,0
14448,10387,0,0,159,159,0,1,0,1,0
57131,7774,0,0,145,145,0,1,0,1,0
6666,8725,0,0,60,60,0,1,0,1,0
12333,50584,0,0,63,63,0,1,0,1,0
61250,42873,0,0,66,66,0,1,0,1,0
60057,25174,0,0,66,66,0,1,0,1,0
61715,25302,0,0,72,72,0,1,0,1,0
33451,22,0,0,60,60,0,1,0,1,0
59976,56205,0,0,66,66,0,1,0,1,0
59056,25174,0,0,66,66,0,1,0,1,0
57499,25174,0,0,75,75,0,1,0,1,0
53486,15,0,0,62,62,0,1,0,1,0
27333,22703,0,0,113,113,0,1,0,1,0
53983,50265,0,0,66,66,0,1,0,1,0
56382,51505,0,0,62,62,0,1,0,1,0
3478,61463,0,0,950,950,0,1,0,1,0
56908,50584,0,0,65,65,0,1,0,1,0
54166,25174,0,0,63,63,0,1,0,1,0
52642,44847,0,0,66,66,0,1,0,1,0
2180,63710,0,0,63,63,0,1,0,1,0
54152,28500,0,0,97,97,0,1,0,1,0
42625,25174,0,0,126,126,0,1,0,1,0
26758,50584,0,0,66,66,0,1,0,1,0
53408,44847,0,0,66,66,0,1,0,1,0
59459,37807,0,0,66,66,0,1,0,1,0
56764,46824,0,0,66,66,0,1,0,1,0
52907,37965,0,0,66,66,0,1,0,1,0
443,62732,0,0,260,260,0,1,0,1,0
443,64347,0,0,69,69,0,1,0,1,0
43584,24748,0,0,156,156,0,1,0,1,0
58638,5900,0,0,62,62,0,1,0,1,0
61709,11392,0,0,65,65,0,1,0,1,0
45908,33330,0,0,60,60,0,1,0,1,0
51922,44847,0,0,62,62,0,1,0,1,0
22390,30188,0,0,64,64,0,1,0,1,0
55367,50584,0,0,66,66,0,1,0,1,0
26233,10358,0,0,135,135,0,1,0,1,0
60565,51221,0,0,62,62,0,1,0,1,0
55145,11392,0,0,66,66,0,1,0,1,0
56700,25174,0,0,64,64,0,1,0,1,0
61895,25174,0,0,84,84,0,1,0,1,0
38483,51221,0,0,66,66,0,1,0,1,0
43671,17372,0,0,62,62,0,1,0,1,0
6881,33372,0,0,112,112,0,1,0,1,0
55508,64147,0,0,62,62,0,1,0,1,0
53928,15503,0,0,62,62,0,1,0,1,0
20489,26467,0,0,66,66,0,1,0,1,0
443,61686,0,0,1484,1484,0,1,0,1,0
37014,25174,0,0,66,66,0,1,0,1,0
4492,30188,0,0,62,62,0,1,0,1,0
45964,2225,0,0,60,60,0,1,0,1,0
63500,23,0,0,60,60,0,1,0,1,0
43644,49025,0,0,121,121,0,1,0,1,0
15891,37813,0,0,65,65,0,1,0,1,0
45941,23388,0,0,60,60,0,1,0,1,0
12553,25174,0,0,62,62,0,1,0,1,0
58638,5900,0,0,62,62,0,1,0,1,0
57613,42707,0,0,62,62,0,1,0,1,0
62792,53,0,0,88,88,0,1,0,1,0
14912,57485,0,0,141,141,0,1,0,1,0
26084,36237,0,0,66,66,0,1,0,1,0
60153,35440,0,0,66,66,0,1,0,1,0
54047,50265,0,0,66,66,0,1,0,1,0
47293,50584,0,0,100,100,0,1,0,1,0
45941,23384,0,0,60,60,0,1,0,1,0
1026,44847,0,0,62,62,0,1,0,1,0
50775,48817,0,0,68,68,0,1,0,1,0
58673,15503,0,0,96,96,0,1,0,1,0
51174,56205,0,0,66,66,0,1,0,1,0
64604,50584,0,0,108,108,0,1,0,1,0
64792,26467,0,0,62,62,0,1,0,1,0
58836,51505,0,0,66,66,0,1,0,1,0
45941,23386,0,0,60,60,0,1,0,1,0
5071,4915,0,0,354,354,0,1,0,1,0
13963,50584,0,0,64,64,0,1,0,1,0
65317,51221,0,0,78,78,0,1,0,1,0
16536,25174,0,0,64,64,0,1,0,1,0
64106,64147,0,0,66,66,0,1,0,1,0
61793,11392,0,0,66,66,0,1,0,1,0
58638,5900,0,0,62,62,0,1,0,1,0
52459,5555,0,0,60,60,0,1,0,1,0
59817,22114,0,0,62,62,0,1,0,1,0
57768,37965,0,0,63,63,0,1,0,1,0
53730,31573,0,0,66,66,0,1,0,1,0
14923,51505,0,0,66,66,0,1,0,1,0
443,20087,0,0,83,83,0,1,0,1,0
52818,44847,0,0,66,66,0,1,0,1,0
62953,51221,0,0,65,65,0,1,0,1,0
57669,64147,0,0,64,64,0,1,0,1,0
3478,61463,0,0,608,608,0,1,0,1,0
50459,62413,0,0,62,62,0,1,0,1,0
60316,36237,0,0,66,66,0,1,0,1,0
53815,62413,0,0,131,131,0,1,0,1,0
63354,51273,0,0,62,62,0,1,0,1,0
2611,7062,0,0,64,64,0,1,0,1,0
14349,42786,0,0,63,63,0,1,0,1,0
27006,25174,0,0,63,63,0,1,0,1,0
51914,30188,0,0,65,65,0,1,0,1,0
65518,5710,0,0,62,62,0,1,0,1,0
23430,64147,0,0,62,62,0,1,0,1,0
27794,51505,0,0,73,73,0,1,0,1,0
60767,37965,0,0,62,62,0,1,0,1,0
59675,44847,0,0,66,66,0,1,0,1,0
42639,25174,0,0,62,62,0,1,0,1,0
58472,11392,0,0,66,66,0,1,0,1,0
64697,25293,0,0,66,66,0,1,0,1,0
62711,11979,0,0,64,64,0,1,0,1,0
60188,15503,0,0,66,66,0,1,0,1,0
443,60496,0,0,320,320,0,1,0,1,0
45964,2225,0,0,60,60,0,1,0,1,0
21420,44847,0,0,66,66,0,1,0,1,0
50280,57470,0,0,78,78,0,1,0,1,0
43584,24748,0,0,156,156,0,1,0,1,0
45964,3111,0,0,60,60,0,1,0,1,0
63852,25174,0,0,62,62,0,1,0,1,0
16477,37807,0,0,66,66,0,1,0,1,0
8353,23,0,0,60,60,0,1,0,1,0
50419,64147,0,0,66,66,0,1,0,1,0
46495,4607,0,0,60,60,0,1,0,1,0
56294,35440,0,0,64,64,0,1,0,1,0
39195,25174,0,0,88,88,0,1,0,1,0
13993,34251,0,0,62,62,0,1,0,1,0
11479,51243,0,0,72,72,0,1,0,1,0
63227,15503,0,0,64,64,0,1,0,1,0
30114,65151,0,0,60,60,0,1,0,1,0
55666,35440,0,0,63,63,0,1,0,1,0
53432,14,0,0,62,62,0,1,0,1,0
56305,25174,0,0,65,65,0,1,0,1,0
45074,14124,0,0,74,74,0,1,0,1,0
13559,57866,0,0,65,65,0,1,0,1,0
15341,23,0,0,60,60,0,1,0,1,0
57297,51221,0,0,66,66,0,1,0,1,0
55856,62413,0,0,62,62,0,1,0,1,0
63461,51505,0,0,66,66,0,1,0,1,0
23532,50584,0,0,62,62,0,1,0,1,0
2705,37,0,0,60,60,0,1,0,1,0
1024,57470,0,0,62,62,0,1,0,1,0
60626,58414,0,0,62,62,0,1,0,1,0
53634,64147,0,0,64,64,0,1,0,1,0
55429,25174,0,0,66,66,0,1,0,1,0
49191,35440,0,0,65,65,0,1,0,1,0
28174,37965,0,0,62,62,0,1,0,1,0
51648,26467,0,0,62,62,0,1,0,1,0
51910,37965,0,0,62,62,0,1,0,1,0
618,56136,0,0,90,90,0,1,0,1,0
61838,37965,0,0,62,62,0,1,0,1,0
14083,43884,0,0,62,62,0,1,0,1,0
64935,36258,0,0,62,62,0,1,0,1,0
443,10006,0,0,72,72,0,1,0,1,0
59281,22114,0,0,83,83,0,1,0,1,0
58638,5900,0,0,62,62,0,1,0,1,0
44895,23,0,0,60,60,0,1,0,1,0
51439,3057,0,0,100,100,0,1,0,1,0
36962,2605,0,0,61,61,0,1,0,1,0
65345,22347,0,0,66,66,0,1,0,1,0
34321,21626,0,0,62,62,0,1,0,1,0
39586,22114,0,0,66,66,0,1,0,1,0
2425,37846,0,0,66,66,0,1,0,1,0
51395,56205,0,0,65,65,0,1,0,1,0
58638,5900,0,0,62,62,0,1,0,1,0
68,67,0,0,594,594,0,1,0,1,0
10463,25174,0,0,92,92,0,1,0,1,0
17140,57470,0,0,62,62,0,1,0,1,0
26502,64147,0,0,62,62,0,1,0,1,0
63433,57866,0,0,66,66,0,1,0,1,0
53468,7,0,0,64,64,0,1,0,1,0
56375,44847,0,0,66,66,0,1,0,1,0
43063,57470,0,0,62,62,0,1,0,1,0
58860,17380,0,0,66,66,0,1,0,1,0
48388,44847,0,0,126,126,0,1,0,1,0
14924,57544,0,0,70,70,0,1,0,1,0
1883,51505,0,0,62,62,0,1,0,1,0
48676,53395,0,0,60,60,0,1,0,1,0
58638,5900,0,0,62,62,0,1,0,1,0
1471,56205,0,0,63,63,0,1,0,1,0
29723,44847,0,0,66,66,0,1,0,1,0
52536,37965,0,0,62,62,0,1,0,1,0
48706,23393,0,0,60,60,0,1,0,1,0
55502,64124,0,0,63,63,0,1,0,1,0
21945,50584,0,0,64,64,0,1,0,1,0
46901,26672,0,0,60,60,0,1,0,1,0
59739,55750,0,0,62,62,0,1,0,1,0
7062,25174,0,0,63,63,0,1,0,1,0
45941,23386,0,0,60,60,0,1,0,1,0
59161,17479,0,0,66,66,0,1,0,1,0
54438,37776,0,0,66,66,0,1,0,1,0
57841,50584,0,0,66,66,0,1,0,1,0
443,61686,0,0,1219,1219,0,1,0,1,0
4535,35440,0,0,65,65,0,1,0,1,0
58638,5900,0,0,62,62,0,1,0,1,0
11022,22114,0,0,97,97,0,1,0,1,0
41448,59546,0,0,63,63,0,1,0,1,0
56604,25174,0,0,66,66,0,1,0,1,0
54785,22114,0,0,63,63,0,1,0,1,0
34677,51185,0,0,60,60,0,1,0,1,0
64934,26467,0,0,62,62,0,1,0,1,0
53147,37965,0,0,62,62,0,1,0,1,0
52395,35911,0,0,73,73,0,1,0,1,0
53772,30196,0,0,64,64,0,1,0,1,0
58638,5900,0,0,62,62,0,1,0,1,0
35157,30188,0,0,62,62,0,1,0,1,0
0,0,0,0,70,70,0,1,0,1,0
65155,35440,0,0,63,63,0,1,0,1,0
46090,50584,0,0,63,63,0,1,0,1,0
30634,46421,0,0,61,61,0,1,0,1,0
51726,64147,0,0,62,62,0,1,0,1,0
40107,22,0,0,60,60,0,1,0,1,0
15609,64147,0,0,86,86,0,1,0,1,0
43355,26467,0,0,65,65,0,1,0,1,0
52051,25174,0,0,66,66,0,1,0,1,0
52644,36237,0,0,65,65,0,1,0,1,0
53475,3389,0,0,66,66,0,1,0,1,0
1024,25174,0,0,62,62,0,1,0,1,0
35178,30188,0,0,70,70,0,1,0,1,0
51253,35440,0,0,62,62,0,1,0,1,0
62745,44847,0,0,146,146,0,1,0,1,0
1252,65465,0,0,127,127,0,1,0,1,0
54055,50265,0,0,62,62,0,1,0,1,0
6881,6881,0,0,146,146,0,1,0,1,0
51367,22,0,0,60,60,0,1,0,1,0
61404,64135,0,0,62,62,0,1,0,1,0
3133,340,0,0,64,64,0,1,0,1,0
56501,44847,0,0,64,64,0,1,0,1,0
3169,22114,0,0,66,66,0,1,0,1,0
0,0,0,0,78,78,0,1,0,1,0
26178,56205,0,0,62,62,0,1,0,1,0
45682,37965,0,0,62,62,0,1,0,1,0
55438,37968,0,0,66,66,0,1,0,1,0
9058,29591,0,0,130,130,0,1,0,1,0
27674,50584,0,0,62,62,0,1,0,1,0
50789,50584,0,0,62,62,0,1,0,1,0
18422,51502,0,0,65,65,0,1,0,1,0
59316,35440,0,0,62,62,0,1,0,1,0
42745,50011,0,0,62,62,0,1,0,1,0
16381,22114,0,0,65,65,0,1,0,1,0
22877,22114,0,0,75,75,0,1,0,1,0
64655,35440,0,0,65,65,0,1,0,1,0
14558,26467,0,0,62,62,0,1,0,1,0
32830,9517,0,0,107,107,0,1,0,1,0
65270,3855,0,0,78,78,0,1,0,1,0
9034,26574,0,0,60,60,0,1,0,1,0
62043,25174,0,0,62,62,0,1,0,1,0
63273,52766,0,0,76,76,0,1,0,1,0
42977,26467,0,0,62,62,0,1,0,1,0
11765,56205,0,0,66,66,0,1,0,1,0
39863,35848,0,0,102,102,0,1,0,1,0
58706,43890,0,0,66,66,0,1,0,1,0
37875,37965,0,0,62,62,0,1,0,1,0
26527,25174,0,0,62,62,0,1,0,1,0
3716,56047,0,0,116,116,0,1,0,1,0
48845,50584,0,0,63,63,0,1,0,1,0
21659,22114,0,0,62,62,0,1,0,1,0
24002,26397,0,0,96,96,0,1,0,1,0
7977,25174,0,0,93,93,0,1,0,1,0
2440,37807,0,0,66,66,0,1,0,1,0
43593,26467,0,0,65,65,0,1,0,1,0
47061,44598,0,0,63,63,0,1,0,1,0
443,43775,0,0,97,97,0,1,0,1,0
14844,37965,0,0,62,62,0,1,0,1,0
25572,1973,0,0,60,60,0,1,0,1,0
63403,54832,0,0,70,70,0,1,0,1,0
17004,64147,0,0,66,66,0,1,0,1,0
31013,23,0,0,60,60,0,1,0,1,0
51244,30222,0,0,64,64,0,1,0,1,0
65047,37902,0,0,64,64,0,1,0,1,0
25425,22114,0,0,64,64,0,1,0,1,0
60312,57470,0,0,74,74,0,1,0,1,0
52855,37965,0,0,66,66,0,1,0,1,0
58562,21247,0,0,66,66,0,1,0,1,0
28554,64147,0,0,62,62,0,1,0,1,0
59790,55783,0,0,64,64,0,1,0,1,0
18140,26467,0,0,65,65,0,1,0,1,0
62410,50584,0,0,64,64,0,1,0,1,0
54506,36829,0,0,119,119,0,1,0,1,0
50136,51397,0,0,66,66,0,1,0,1,0
64755,31573,0,0,65,65,0,1,0,1,0
61832,56205,0,0,66,66,0,1,0,1,0
46385,64147,0,0,62,62,0,1,0,1,0
20576,37965,0,0,62,62,0,1,0,1,0
13939,42925,0,0,96,96,0,1,0,1,0
65132,26017,0,0,99,99,0,1,0,1,0
9969,2456,0,0,60,60,0,1,0,1,0
62049,48817,0,0,146,146,0,1,0,1,0
443,28417,0,0,82,82,0,1,0,1,0
3945,35440,0,0,66,66,0,1,0,1,0
55893,45711,0,0,78,78,0,1,0,1,0
32169,51221,0,0,62,62,0,1,0,1,0
23969,57470,0,0,62,62,0,1,0,1,0
43946,44847,0,0,66,66,0,1,0,1,0
48706,23393,0,0,60,60,0,1,0,1,0
54858,51505,0,0,62,62,0,1,0,1,0
51915,37965,0,0,66,66,0,1,0,1,0
63221,53436,0,0,62,62,0,1,0,1,0
37081,25174,0,0,62,62,0,1,0,1,0
40185,64147,0,0,65,65,0,1,0,1,0
58542,57587,0,0,66,66,0,1,0,1,0
11664,56205,0,0,62,62,0,1,0,1,0
8239,37965,0,0,146,146,0,1,0,1,0
65270,3855,0,0,78,78,0,1,0,1,0
55627,46334,0,0,65,65,0,1,0,1,0
1860,25174,0,0,65,65,0,1,0,1,0
46821,25174,0,0,82,82,0,1,0,1,0
62147,56205,0,0,65,65,0,1,0,1,0
39833,47490,0,0,109,109,0,1,0,1,0
19698,502,0,0,60,60,0,1,0,1,0
57131,31061,0,0,145,145,0,1,0,1,0
19954,346,0,0,60,60,0,1,0,1,0
27036,63853,0,0,140,140,0,1,0,1,0
61685,44847,0,0,66,66,0,1,0,1,0
7751,25174,0,0,64,64,0,1,0,1,0
58638,5900,0,0,62,62,0,1,0,1,0
16387,3655,0,0,60,60,0,1,0,1,0
32358,34497,0,0,62,62,0,1,0,1,0
26523,37965,0,0,62,62,0,1,0,1,0
60184,37965,0,0,66,66,0,1,0,1,0
26397,22114,0,0,115,115,0,1,0,1,0
30753,30302,0,0,62,62,0,1,0,1,0
62325,30080,0,0,145,145,0,1,0,1,0
57131,35776,0,0,145,145,0,1,0,1,0
36801,25174,0,0,65,65,0,1,0,1,0
13166,57470,0,0,62,62,0,1,0,1,0
18642,42707,0,0,62,62,0,1,0,1,0
2922,57508,0,0,66,66,0,1,0,1,0
51414,22,0,0,60,60,0,1,0,1,0
58285,44847,0,0,66,66,0,1,0,1,0
10273,21247,0,0,63,63,0,1,0,1,0
26651,25174,0,0,62,62,0,1,0,1,0
26812,37965,0,0,62,62,0,1,0,1,0
2924,44847,0,0,69,69,0,1,0,1,0
25991,55859,0,0,60,60,0,1,0,1,0
43269,50584,0,0,64,64,0,1,0,1,0
51414,22,0,0,60,60,0,1,0,1,0
62921,64147,0,0,66,66,0,1,0,1,0
61109,37965,0,0,63,63,0,1,0,1,0
29789,26467,0,0,64,64,0,1,0,1,0
50813,26467,0,0,66,66,0,1,0,1,0
59502,64118,0,0,64,64,0,1,0,1,0
60671,22114,0,0,66,66,0,1,0,1,0
60188,15503,0,0,65,65,0,1,0,1,0
22706,9822,0,0,62,62,0,1,0,1,0
59567,37965,0,0,62,62,0,1,0,1,0
14248,56205,0,0,62,62,0,1,0,1,0
49858,22,0,0,60,60,0,1,0,1,0
43684,44847,0,0,62,62,0,1,0,1,0
1040,6004,0,0,72,72,0,1,0,1,0
57894,44847,0,0,64,64,0,1,0,1,0
38906,37965,0,0,62,62,0,1,0,1,0
19046,57866,0,0,64,64,0,1,0,1,0
45964,2226,0,0,60,60,0,1,0,1,0
33822,57470,0,0,66,66,0,1,0,1,0
58337,18375,0,0,62,62,0,1,0,1,0
58435,18375,0,0,66,66,0,1,0,1,0
63840,25174,0,0,64,64,0,1,0,1,0
17584,52666,0,0,62,62,0,1,0,1,0
53166,61600,0,0,66,66,0,1,0,1,0
58638,5900,0,0,62,62,0,1,0,1,0
52726,25174,0,0,66,66,0,1,0,1,0
61112,25174,0,0,62,62,0,1,0,1,0
50301,37965,0,0,66,66,0,1,0,1,0
58638,5900,0,0,62,62,0,1,0,1,0
3478,61463,0,0,1143,1143,0,1,0,1,0
42603,54532,0,0,74,74,0,1,0,1,0
49824,25174,0,0,113,113,0,1,0,1,0
51062,30188,0,0,62,62,0,1,0,1,0
56564,9571,0,0,78,78,0,1,0,1,0
57165,57470,0,0,65,65,0,1,0,1,0
65276,22114,0,0,62,62,0,1,0,1,0
54522,25174,0,0,62,62,0,1,0,1,0
10483,30369,0,0,146,146,0,1,0,1,0
56494,15503,0,0,146,146,0,1,0,1,0
36752,25174,0,0,66,66,0,1,0,1,0
5223,14017,0,0,141,141,0,1,0,1,0
1235,51200,0,0,103,103,0,1,0,1,0
5228,3434,0,0,828,828,0,1,0,1,0
58580,50506,0,0,66,66,0,1,0,1,0
40704,38137,0,0,134,134,0,1,0,1,0
59059,25174,0,0,66,66,0,1,0,1,0
1035,64147,0,0,145,145,0,1,0,1,0
63690,64147,0,0,66,66,0,1,0,1,0
39675,62413,0,0,94,94,0,1,0,1,0
52612,9571,0,0,62,62,0,1,0,1,0
21420,44847,0,0,66,66,0,1,0,1,0
52461,30188,0,0,63,63,0,1,0,1,0
52111,7032,0,0,66,66,0,1,0,1,0
63450,93,0,0,60,60,0,1,0,1,0
56670,37965,0,0,66,66,0,1,0,1,0
49307,5900,0,0,60,60,0,1,0,1,0
4621,36053,0,0,85,85,0,1,0,1,0
63907,22114,0,0,124,124,0,1,0,1,0
64695,50584,0,0,66,66,0,1,0,1,0
27159,25174,0,0,65,65,0,1,0,1,0
64691,25320,0,0,66,66,0,1,0,1,0
55655,50584,0,0,62,62,0,1,0,1,0
26053,33720,0,0,160,160,0,1,0,1,0
54989,50265,0,0,66,66,0,1,0,1,0
58933,25174,0,0,65,65,0,1,0,1,0
63904,44847,0,0,62,62,0,1,0,1,0
18642,42707,0,0,62,62,0,1,0,1,0
6902,64275,0,0,60,60,0,1,0,1,0
57448,57470,0,0,63,63,0,1,0,1,0
59048,57470,0,0,66,66,0,1,0,1,0
63703,35440,0,0,66,66,0,1,0,1,0
44317,50426,0,0,145,145,0,1,0,1,0
13525,51505,0,0,139,139,0,1,0,1,0
48106,21509,0,0,66,66,0,1,0,1,0
26762,22114,0,0,62,62,0,1,0,1,0
53692,44512,0,0,66,66,0,1,0,1,0
54693,30188,0,0,64,64,0,1,0,1,0
58638,5900,0,0,62,62,0,1,0,1,0
25551,38294,0,0,60,60,0,1,0,1,0
6921,6881,0,0,62,62,0,1,0,1,0
11293,15503,0,0,62,62,0,1,0,1,0
57261,51505,0,0,66,66,0,1,0,1,0
58638,5900,0,0,62,62,0,1,0,1,0
61374,21247,0,0,66,66,0,1,0,1,0
58638,5900,0,0,62,62,0,1,0,1,0
8560,50584,0,0,66,66,0,1,0,1,0
2238,22114,0,0,76,76,0,1,0,1,0
58638,5900,0,0,62,62,0,1,0,1,0
26872,44847,0,0,62,62,0,1,0,1,0
48706,23393,0,0,60,60,0,1,0,1,0
63461,51505,0,0,66,66,0,1,0,1,0
58463,11392,0,0,66,66,0,1,0,1,0
62157,22114,0,0,66,66,0,1,0,1,0
52207,22114,0,0,66,66,0,1,0,1,0
22932,25174,0,0,133,133,0,1,0,1,0
443,50238,0,0,331,331,0,1,0,1,0
64997,51221,0,0,66,66,0,1,0,1,0
38970,25174,0,0,139,139,0,1,0,1,0
31246,50584,0,0,62,62,0,1,0,1,0
6166,37965,0,0,63,63,0,1,0,1,0
61464,64147,0,0,65,65,0,1,0,1,0
40990,21247,0,0,62,62,0,1,0,1,0
35663,30188,0,0,78,78,0,1,0,1,0
41734,57470,0,0,62,62,0,1,0,1,0
58638,5900,0,0,62,62,0,1,0,1,0
45941,23385,0,0,60,60,0,1,0,1,0
13285,29892,0,0,145,145,0,1,0,1,0
60986,20733,0,0,66,66,0,1,0,1,0
57452,57470,0,0,62,62,0,1,0,1,0
49483,56788,0,0,62,62,0,1,0,1,0
1009,11404,0,0,62,62,0,1,0,1,0
1036,64147,0,0,62,62,0,1,0,1,0
51414,50584,0,0,62,62,0,1,0,1,0
57407,34172,0,0,92,92,0,1,0,1,0
24161,22300,0,0,61,61,0,1,0,1,0
50085,57470,0,0,66,66,0,1,0,1,0
15761,37917,0,0,120,120,0,1,0,1,0
51024,22114,0,0,110,110,0,1,0,1,0
26400,9075,0,0,145,145,0,1,0,1,0
65518,5710,0,0,62,62,0,1,0,1,0
58638,5900,0,0,62,62,0,1,0,1,0
14614,25174,0,0,62,62,0,1,0,1,0
25523,35974,0,0,122,122,0,1,0,1,0
47254,50584,0,0,121,121,0,1,0,1,0
5223,13602,0,0,66,66,0,1,0,1,0
39660,50779,0,0,62,62,0,1,0,1,0
58638,5900,0,0,62,62,0,1,0,1,0
56926,26467,0,0,62,62,0,1,0,1,0
58305,51180,0,0,66,66,0,1,0,1,0
63273,57470,0,0,66,66,0,1,0,1,0
0,0,0,0,98,98,0,1,0,1,0
52054,11392,0,0,62,62,0,1,0,1,0
65316,7092,0,0,62,62,0,1,0,1,0
45941,23388,0,0,60,60,0,1,0,1,0
48706,23393,0,0,60,60,0,1,0,1,0
59939,37908,0,0,64,64,0,1,0,1,0
54192,57596,0,0,66,66,0,1,0,1,0
0,0,0,0,102,102,0,1,0,1,0
443,20994,0,0,84,84,0,1,0,1,0
46815,25174,0,0,62,62,0,1,0,1,0
23034,35440,0,0,62,62,0,1,0,1,0
52505,51221,0,0,72,72,0,1,0,1,0
58858,15503,0,0,66,66,0,1,0,1,0
20576,37965,0,0,62,62,0,1,0,1,0
15747,11326,0,0,72,72,0,1,0,1,0
11288,57530,0,0,63,63,0,1,0,1,0
20394,64147,0,0,102,102,0,1,0,1,0
55508,64147,0,0,62,62,0,1,0,1,0
11878,37807,0,0,138,138,0,1,0,1,0
6717,5628,0,0,62,62,0,1,0,1,0
17010,57470,0,0,62,62,0,1,0,1,0
996,11949,0,0,65,65,0,1,0,1,0
34930,35440,0,0,64,64,0,1,0,1,0
17235,25174,0,0,146,146,0,1,0,1,0
58638,5900,0,0,62,62,0,1,0,1,0
45682,37965,0,0,101,101,0,1,0,1,0
3478,61463,0,0,931,931,0,1,0,1,0
45941,23386,0,0,60,60,0,1,0,1,0
60196,53,0,0,88,88,0,1,0,1,0
12660,62413,0,0,65,65,0,1,0,1,0
51413,25864,0,0,72,72,0,1,0,1,0
15280,26467,0,0,62,62,0,1,0,1,0
16751,22,0,0,60,60,0,1,0,1,0
3868,51505,0,0,64,64,0,1,0,1,0
26722,11446,0,0,66,66,0,1,0,1,0
46777,64147,0,0,145,145,0,1,0,1,0
25049,25174,0,0,62,62,0,1,0,1,0
14036,48817,0,0,66,66,0,1,0,1,0
20164,8440,0,0,60,60,0,1,0,1,0
8905,26357,0,0,60,60,0,1,0,1,0
28378,56205,0,0,62,62,0,1,0,1,0
26883,37965,0,0,65,65,0,1,0,1,0
54280,3398,0,0,60,60,0,1,0,1,0
65449,57470,0,0,112,112,0,1,0,1,0
42789,48771,0,0,131,131,0,1,0,1,0
39837,36237,0,0,65,65,0,1,0,1,0
68,67,0,0,394,394,0,1,0,1,0
61550,5529,0,0,145,145,0,1,0,1,0
6666,138,0,0,60,60,0,1,0,1,0
14339,37965,0,0,62,62,0,1,0,1,0
59168,39004,0,0,62,62,0,1,0,1,0
22743,2305,0,0,60,60,0,1,0,1,0
61745,50584,0,0,66,66,0,1,0,1,0
58900,37807,0,0,64,64,0,1,0,1,0
443,50025,0,0,118,118,0,1,0,1,0
21322,25174,0,0,134,134,0,1,0,1,0
64853,51141,0,0,66,66,0,1,0,1,0
50416,49076,0,0,64,64,0,1,0,1,0
25031,25174,0,0,80,80,0,1,0,1,0
58119,22114,0,0,62,62,0,1,0,1,0
54741,50584,0,0,66,66,0,1,0,1,0
9214,37965,0,0,62,62,0,1,0,1,0
45386,13858,0,0,69,69,0,1,0,1,0
59765,25174,0,0,62,62,0,1,0,1,0
23892,64147,0,0,62,62,0,1,0,1,0
54991,36829,0,0,63,63,0,1,0,1,0
50194,22114,0,0,66,66,0,1,0,1,0
54636,26467,0,0,66,66,0,1,0,1,0
58022,5601,0,0,60,60,0,1,0,1,0
2108,23,0,0,60,60,0,1,0,1,0
32282,8604,0,0,64,64,0,1,0,1,0
50652,53,0,0,112,112,0,1,0,1,0
58638,5900,0,0,62,62,0,1,0,1,0
34205,51880,0,0,84,84,0,1,0,1,0
62291,8093,0,0,152,152,0,1,0,1,0
63501,25174,0,0,66,66,0,1,0,1,0
2430,23117,0,0,146,146,0,1,0,1,0
45682,37965,0,0,62,62,0,1,0,1,0
34809,56962,0,0,66,66,0,1,0,1,0
57837,64147,0,0,66,66,0,1,0,1,0
63080,64147,0,0,64,64,0,1,0,1,0
1865,25174,0,0,62,62,0,1,0,1,0
58638,5900,0,0,62,62,0,1,0,1,0
1702,51387,0,0,62,62,0,1,0,1,0
64339,57470,0,0,64,64,0,1,0,1,0
63677,64115,0,0,66,66,0,1,0,1,0
51011,22114,0,0,142,142,0,1,0,1,0
12969,55777,0,0,66,66,0,1,0,1,0
19194,64147,0,0,64,64,0,1,0,1,0
50622,26467,0,0,66,66,0,1,0,1,0
15457,22114,0,0,64,64,0,1,0,1,0
39341,19856,0,0,62,62,0,1,0,1,0
7189,51367,0,0,62,62,0,1,0,1,0
1340,30007,0,0,80,80,0,1,0,1,0
56962,1,0,0,67,67,0,1,0,1,0
58638,5900,0,0,62,62,0,1,0,1,0
5916,22114,0,0,62,62,0,1,0,1,0
59711,44847,0,0,66,66,0,1,0,1,0
6190,22114,0,0,64,64,0,1,0,1,0
443,20087,0,0,83,83,0,1,0,1,0
52459,33890,0,0,60,60,0,1,0,1,0
24673,51351,0,0,90,90,0,1,0,1,0
53101,25174,0,0,62,62,0,1,0,1,0
39313,37965,0,0,62,62,0,1,0,1,0
16378,35478,0,0,61,61,0,1,0,1,0
6057,51221,0,0,78,78,0,1,0,1,0
45964,2228,0,0,60,60,0,1,0,1,0
18961,44847,0,0,66,66,0,1,0,1,0
49277,30188,0,0,62,62,0,1,0,1,0
58715,57470,0,0,64,64,0,1,0,1,0
51224,57470,0,0,66,66,0,1,0,1,0
42231,57470,0,0,78,78,0,1,0,1,0
50412,62413,0,0,62,62,0,1,0,1,0
60627,51050,0,0,63,63,0,1,0,1,0
65287,44847,0,0,65,65,0,1,0,1,0
45795,5,0,0,61,61,0,1,0,1,0
59073,51505,0,0,63,63,0,1,0,1,0
55431,25174,0,0,64,64,0,1,0,1,0
56920,21247,0,0,69,69,0,1,0,1,0
57633,50584,0,0,66,66,0,1,0,1,0
57292,51201,0,0,66,66,0,1,0,1,0
57894,44847,0,0,63,63,0,1,0,1,0
31748,56205,0,0,62,62,0,1,0,1,0
2461,25174,0,0,122,122,0,1,0,1,0
56735,46824,0,0,65,65,0,1,0,1,0
36490,25174,0,0,62,62,0,1,0,1,0
56688,25174,0,0,62,62,0,1,0,1,0
2681,35440,0,0,66,66,0,1,0,1,0
51742,30317,0,0,66,66,0,1,0,1,0
7570,43944,0,0,66,66,0,1,0,1,0
19875,30170,0,0,145,145,0,1,0,1,0
62575,12207,0,0,66,66,0,1,0,1,0
27366,22114,0,0,146,146,0,1,0,1,0
64392,25174,0,0,64,64,0,1,0,1,0
6666,50070,0,0,60,60,0,1,0,1,0
26524,57470,0,0,62,62,0,1,0,1,0
59809,44847,0,0,66,66,0,1,0,1,0
13311,57470,0,0,62,62,0,1,0,1,0
58638,5900,0,0,62,62,0,1,0,1,0
53387,23,0,0,60,60,0,1,0,1,0
57643,28189,0,0,60,60,0,1,0,1,0
515,10214,0,0,66,66,0,1,0,1,0
19394,44847,0,0,64,64,0,1,0,1,0
7446,36117,0,0,62,62,0,1,0,1,0
64367,22114,0,0,66,66,0,1,0,1,0
22977,25174,0,0,64,64,0,1,0,1,0
60342,17563,0,0,66,66,0,1,0,1,0
60414,15503,0,0,141,141,0,1,0,1,0
16442,57470,0,0,87,87,0,1,0,1,0
62205,50584,0,0,66,66,0,1,0,1,0
58638,5900,0,0,62,62,0,1,0,1,0
58638,5900,0,0,62,62,0,1,0,1,0
27371,23,0,0,60,60,0,1,0,1,0
27348,22114,0,0,63,63,0,1,0,1,0
41459,5900,0,0,60,60,0,1,0,1,0
11080,17433,0,0,62,62,0,1,0,1,0
26893,37965,0,0,62,62,0,1,0,1,0
19875,30170,0,0,145,145,0,1,0,1,0
63672,46824,0,0,65,65,0,1,0,1,0
62792,53,0,0,88,88,0,1,0,1,0
50854,50584,0,0,66,66,0,1,0,1,0
54021,25174,0,0,62,62,0,1,0,1,0
48706,23393,0,0,60,60,0,1,0,1,0
0,0,0,0,98,98,0,1,0,1,0
51413,25864,0,0,72,72,0,1,0,1,0
52647,64147,0,0,62,62,0,1,0,1,0
34940,22114,0,0,63,63,0,1,0,1,0
30272,57470,0,0,60,60,0,1,0,1,0
26438,22114,0,0,139,139,0,1,0,1,0
25537,22114,0,0,62,62,0,1,0,1,0
21335,24731,0,0,62,62,0,1,0,1,0
36483,25174,0,0,62,62,0,1,0,1,0
62859,35440,0,0,66,66,0,1,0,1,0
5218,50524,0,0,62,62,0,1,0,1,0
15249,22114,0,0,62,62,0,1,0,1,0
34740,51185,0,0,60,60,0,1,0,1,0
51105,50584,0,0,65,65,0,1,0,1,0
52707,64147,0,0,62,62,0,1,0,1,0
20220,68,0,0,60,60,0,1,0,1,0
63808,37965,0,0,66,66,0,1,0,1,0
6881,6881,0,0,62,62,0,1,0,1,0
40117,23,0,0,60,60,0,1,0,1,0
49501,11392,0,0,63,63,0,1,0,1,0
0,0,0,0,60,60,0,1,0,1,0
6835,64318,0,0,60,60,0,1,0,1,0
24710,42166,0,0,105,105,0,1,0,1,0
65167,57866,0,0,62,62,0,1,0,1,0
37049,42872,0,0,62,62,0,1,0,1,0
55342,26467,0,0,63,63,0,1,0,1,0
3754,55927,0,0,64,64,0,1,0,1,0
0,0,0,0,73,73,0,1,0,1,0
44923,26467,0,0,62,62,0,1,0,1,0
59269,25174,0,0,62,62,0,1,0,1,0
62390,37965,0,0,62,62,0,1,0,1,0
51741,57470,0,0,126,126,0,1,0,1,0
60736,58414,0,0,65,65,0,1,0,1,0
6666,16010,0,0,60,60,0,1,0,1,0
1663,30190,0,0,67,67,0,1,0,1,0
56919,18375,0,0,64,64,0,1,0,1,0
51988,25174,0,0,66,66,0,1,0,1,0
55599,46124,0,0,68,68,0,1,0,1,0
59166,39004,0,0,62,62,0,1,0,1,0
55012,25174,0,0,66,66,0,1,0,1,0
64808,62413,0,0,63,63,0,1,0,1,0
6860,42486,0,0,92,92,0,1,0,1,0
43129,20220,0,0,62,62,0,1,0,1,0
10765,37965,0,0,62,62,0,1,0,1,0
63397,26467,0,0,66,66,0,1,0,1,0
881,54698,0,0,69,69,0,1,0,1,0
58638,5900,0,0,62,62,0,1,0,1,0
58638,5900,0,0,62,62,0,1,0,1,0
52923,3297,0,0,60,60,0,1,0,1,0
45964,55559,0,0,60,60,0,1,0,1,0
2964,44847,0,0,62,62,0,1,0,1,0
38118,2463,0,0,60,60,0,1,0,1,0
3034,57561,0,0,66,66,0,1,0,1,0
58638,5900,0,0,62,62,0,1,0,1,0
19875,30170,0,0,145,145,0,1,0,1,0
51239,35440,0,0,63,63,0,1,0,1,0
443,62451,0,0,199,199,0,1,0,1,0
51729,50584,0,0,62,62,0,1,0,1,0
53727,25174,0,0,64,64,0,1,0,1,0
61358,25174,0,0,65,65,0,1,0,1,0
50292,22114,0,0,65,65,0,1,0,1,0
2383,37965,0,0,66,66,0,1,0,1,0
64769,36113,0,0,62,62,0,1,0,1,0
443,38956,0,0,82,82,0,1,0,1,0
21011,23,0,0,60,60,0,1,0,1,0
58638,5900,0,0,62,62,0,1,0,1,0
59358,35440,0,0,65,65,0,1,0,1,0
58732,9588,0,0,62,62,0,1,0,1,0
60103,22114,0,0,65,65,0,1,0,1,0
37843,26116,0,0,64,64,0,1,0,1,0
19204,57866,0,0,66,66,0,1,0,1,0
59433,44847,0,0,66,66,0,1,0,1,0
39890,266,0,0,60,60,0,1,0,1,0
64394,25174,0,0,62,62,0,1,0,1,0
59781,56205,0,0,66,66,0,1,0,1,0
11772,25174,0,0,62,62,0,1,0,1,0
55874,64147,0,0,66,66,0,1,0,1,0
50121,50584,0,0,63,63,0,1,0,1,0
53776,51505,0,0,66,66,0,1,0,1,0
17357,44847,0,0,78,78,0,1,0,1,0
30335,64147,0,0,65,65,0,1,0,1,0
3406,17372,0,0,80,80,0,1,0,1,0
1646,22114,0,0,65,65,0,1,0,1,0
6057,51221,0,0,78,78,0,1,0,1,0
50160,1703,0,0,80,80,0,1,0,1,0
34166,22114,0,0,62,62,0,1,0,1,0
38638,21422,0,0,62,62,0,1,0,1,0
51726,64147,0,0,62,62,0,1,0,1,0
34932,38608,0,0,62,62,0,1,0,1,0
22557,25174,0,0,62,62,0,1,0,1,0
6057,51221,0,0,78,78,0,1,0,1,0
23171,64147,0,0,63,63,0,1,0,1,0
39123,44847,0,0,62,62,0,1,0,1,0
9757,7479,0,0,92,92,0,1,0,1,0
35078,30188,0,0,62,62,0,1,0,1,0
4366,51505,0,0,62,62,0,1,0,1,0
58638,5900,0,0,62,62,0,1,0,1,0
29851,7531,0,0,127,127,0,1,0,1,0
14068,22114,0,0,88,88,0,1,0,1,0
59897,30188,0,0,62,62,0,1,0,1,0
57767,37965,0,0,62,62,0,1,0,1,0
15139,36237,0,0,62,62,0,1,0,1,0
52150,39109,0,0,66,66,0,1,0,1,0
63180,50584,0,0,64,64,0,1,0,1,0
443,20925,0,0,85,85,0,1,0,1,0
52129,37807,0,0,62,62,0,1,0,1,0
54291,64123,0,0,63,63,0,1,0,1,0
45964,2227,0,0,60,60,0,1,0,1,0
62231,57470,0,0,66,66,0,1,0,1,0
52973,57470,0,0,74,74,0,1,0,1,0
51373,22114,0,0,66,66,0,1,0,1,0
58131,15503,0,0,146,146,0,1,0,1,0
63021,51490,0,0,66,66,0,1,0,1,0
10464,25174,0,0,62,62,0,1,0,1,0
57750,15503,0,0,65,65,0,1,0,1,0
6881,6881,0,0,146,146,0,1,0,1,0
53771,51505,0,0,66,66,0,1,0,1,0
37002,25174,0,0,63,63,0,1,0,1,0
42010,29,0,0,71,71,0,1,0,1,0
50855,51505,0,0,66,66,0,1,0,1,0
62821,37807,0,0,62,62,0,1,0,1,0
26048,21,0,0,60,60,0,1,0,1,0
58366,50584,0,0,62,62,0,1,0,1,0
39369,1,0,0,142,142,0,1,0,1,0
58638,5900,0,0,62,62,0,1,0,1,0
50901,26467,0,0,66,66,0,1,0,1,0
7301,44847,0,0,63,63,0,1,0,1,0
13285,29892,0,0,145,145,0,1,0,1,0
58743,23718,0,0,66,66,0,1,0,1,0
19875,30170,0,0,145,145,0,1,0,1,0
64586,50584,0,0,134,134,0,1,0,1,0
30861,46783,0,0,62,62,0,1,0,1,0
34993,15503,0,0,62,62,0,1,0,1,0
59266,35440,0,0,66,66,0,1,0,1,0
42157,36237,0,0,100,100,0,1,0,1,0
52753,56205,0,0,66,66,0,1,0,1,0
9166,37965,0,0,62,62,0,1,0,1,0
9772,30188,0,0,61,61,0,1,0,1,0
47063,15503,0,0,104,104,0,1,0,1,0
64358,25174,0,0,66,66,0,1,0,1,0
10207,25604,0,0,64,64,0,1,0,1,0
58638,5900,0,0,62,62,0,1,0,1,0
60192,35440,0,0,65,65,0,1,0,1,0
59911,62413,0,0,62,62,0,1,0,1,0
40088,22,0,0,60,60,0,1,0,1,0
52321,26467,0,0,62,62,0,1,0,1,0
49520,35897,0,0,62,62,0,1,0,1,0
25092,25174,0,0,115,115,0,1,0,1,0
64953,26467,0,0,62,62,0,1,0,1,0
1072,44847,0,0,62,62,0,1,0,1,0
29710,50584,0,0,62,62,0,1,0,1,0
6840,9039,0,0,127,127,0,1,0,1,0
23207,25174,0,0,62,62,0,1,0,1,0
58437,44847,0,0,66,66,0,1,0,1,0
443,4316,0,0,140,140,0,1,0,1,0
39361,15,0,0,90,90,0,1,0,1,0
30132,35883,0,0,137,137,0,1,0,1,0
55225,11392,0,0,65,65,0,1,0,1,0
13734,57470,0,0,62,62,0,1,0,1,0
59600,56205,0,0,66,66,0,1,0,1,0
54957,36768,0,0,66,66,0,1,0,1,0
55111,39004,0,0,66,66,0,1,0,1,0
62368,50584,0,0,66,66,0,1,0,1,0
17289,25174,0,0,64,64,0,1,0,1,0
44758,31573,0,0,130,130,0,1,0,1,0
9749,26467,0,0,63,63,0,1,0,1,0
64915,26467,0,0,62,62,0,1,0,1,0
62386,37965,0,0,64,64,0,1,0,1,0
47910,7463,0,0,60,60,0,1,0,1,0
5295,23,0,0,60,60,0,1,0,1,0
58185,62413,0,0,63,63,0,1,0,1,0
64560,37965,0,0,66,66,0,1,0,1,0
7959,57470,0,0,62,62,0,1,0,1,0
57627,50584,0,0,62,62,0,1,0,1,0
59223,17500,0,0,66,66,0,1,0,1,0
51841,36139,0,0,66,66,0,1,0,1,0
17675,44847,0,0,63,63,0,1,0,1,0
5223,21557,0,0,79,79,0,1,0,1,0
9687,57470,0,0,78,78,0,1,0,1,0
29356,64147,0,0,62,62,0,1,0,1,0
443,50217,0,0,310,310,0,1,0,1,0
63983,25174,0,0,62,62,0,1,0,1,0
45893,50584,0,0,113,113,0,1,0,1,0
34196,21918,0,0,62,62,0,1,0,1,0
61876,17542,0,0,62,62,0,1,0,1,0
27464,37965,0,0,65,65,0,1,0,1,0
14689,42708,0,0,62,62,0,1,0,1,0
4232,35440,0,0,62,62,0,1,0,1,0
18686,42640,0,0,69,69,0,1,0,1,0
28063,22114,0,0,62,62,0,1,0,1,0
50298,37965,0,0,63,63,0,1,0,1,0
2945,64147,0,0,62,62,0,1,0,1,0
12545,25174,0,0,69,69,0,1,0,1,0
62172,57470,0,0,72,72,0,1,0,1,0
1272,30098,0,0,94,94,0,1,0,1,0
11847,64147,0,0,62,62,0,1,0,1,0
56235,7,0,0,119,119,0,1,0,1,0
10157,25604,0,0,63,63,0,1,0,1,0
57987,56125,0,0,90,90,0,1,0,1,0
55893,45711,0,0,78,78,0,1,0,1,0
9580,2884,0,0,63,63,0,1,0,1,0
58638,5900,0,0,62,62,0,1,0,1,0
57837,64147,0,0,62,62,0,1,0,1,0
49073,54298,0,0,60,60,0,1,0,1,0
10161,30262,0,0,110,110,0,1,0,1,0
58344,15503,0,0,78,78,0,1,0,1,0
42810,56017,0,0,100,100,0,1,0,1,0
47081,37965,0,0,62,62,0,1,0,1,0
63780,35440,0,0,66,66,0,1,0,1,0
31683,51272,0,0,62,62,0,1,0,1,0
12775,11184,0,0,82,82,0,1,0,1,0
993,4046,0,0,114,114,0,1,0,1,0
36894,56205,0,0,112,112,0,1,0,1,0
23766,57354,0,0,145,145,0,1,0,1,0
45964,2666,0,0,60,60,0,1,0,1,0
52276,38014,0,0,66,66,0,1,0,1,0
5688,44847,0,0,66,66,0,1,0,1,0
40075,22,0,0,60,60,0,1,0,1,0
53141,51221,0,0,73,73,0,1,0,1,0
51450,35440,0,0,66,66,0,1,0,1,0
54059,49845,0,0,62,62,0,1,0,1,0
13285,29892,0,0,145,145,0,1,0,1,0
60771,58414,0,0,64,64,0,1,0,1,0
40356,22114,0,0,84,84,0,1,0,1,0
1030,26395,0,0,102,102,0,1,0,1,0
43584,24748,0,0,156,156,0,1,0,1,0
21703,51893,0,0,91,91,0,1,0,1,0
1013,57991,0,0,139,139,0,1,0,1,0
63094,57470,0,0,72,72,0,1,0,1,0
35083,15503,0,0,66,66,0,1,0,1,0
57377,57470,0,0,64,64,0,1,0,1,0
19885,64147,0,0,138,138,0,1,0,1,0
12164,22114,0,0,62,62,0,1,0,1,0
14309,56205,0,0,62,62,0,1,0,1,0
55874,64147,0,0,66,66,0,1,0,1,0
34934,56205,0,0,62,62,0,1,0,1,0
59696,57470,0,0,62,62,0,1,0,1,0
44147,64147,0,0,62,62,0,1,0,1,0
55344,37965,0,0,66,66,0,1,0,1,0
50052,65008,0,0,60,60,0,1,0,1,0
37075,48817,0,0,62,62,0,1,0,1,0
39586,22114,0,0,63,63,0,1,0,1,0
58421,30188,0,0,66,66,0,1,0,1,0
22448,25174,0,0,65,65,0,1,0,1,0
12021,6881,0,0,62,62,0,1,0,1,0
39498,25174,0,0,65,65,0,1,0,1,0
60935,64147,0,0,68,68,0,1,0,1,0
54991,36829,0,0,65,65,0,1,0,1,0
18415,37965,0,0,62,62,0,1,0,1,0
33057,30188,0,0,62,62,0,1,0,1,0
56664,50584,0,0,64,64,0,1,0,1,0
49481,52086,0,0,140,140,0,1,0,1,0
55415,37965,0,0,66,66,0,1,0,1,0
37959,3855,0,0,72,72,0,1,0,1,0
16387,16862,0,0,60,60,0,1,0,1,0
1033,36048,0,0,62,62,0,1,0,1,0
53087,24203,0,0,62,62,0,1,0,1,0
14672,25174,0,0,62,62,0,1,0,1,0
59306,44847,0,0,65,65,0,1,0,1,0
58968,57470,0,0,65,65,0,1,0,1,0
52445,11392,0,0,66,66,0,1,0,1,0
6881,6881,0,0,146,146,0,1,0,1,0
37029,25174,0,0,62,62,0,1,0,1,0
443,62451,0,0,162,162,0,1,0,1,0
53779,37965,0,0,66,66,0,1,0,1,0
20929,57470,0,0,65,65,0,1,0,1,0
62832,62413,0,0,62,62,0,1,0,1,0
58638,5900,0,0,62,62,0,1,0,1,0
44411,37965,0,0,62,62,0,1,0,1,0
1115,37965,0,0,62,62,0,1,0,1,0
23558,37955,0,0,62,62,0,1,0,1,0
1072,46801,0,0,62,62,0,1,0,1,0
23874,64147,0,0,62,62,0,1,0,1,0
53676,35974,0,0,60,60,0,1,0,1,0
64386,37965,0,0,66,66,0,1,0,1,0
51551,50584,0,0,65,65,0,1,0,1,0
1139,51341,0,0,145,145,0,1,0,1,0
6974,37510,0,0,105,105,0,1,0,1,0
58638,5900,0,0,62,62,0,1,0,1,0
59449,50584,0,0,62,62,0,1,0,1,0
35506,22114,0,0,62,62,0,1,0,1,0
15084,50584,0,0,62,62,0,1,0,1,0
58638,5900,0,0,62,62,0,1,0,1,0
17552,50584,0,0,146,146,0,1,0,1,0
38484,48637,0,0,60,60,0,1,0,1,0
62549,53733,0,0,66,66,0,1,0,1,0
7063,51360,0,0,63,63,0,1,0,1,0
51725,51505,0,0,66,66,0,1,0,1,0
18857,30188,0,0,62,62,0,1,0,1,0
58638,5900,0,0,62,62,0,1,0,1,0
15563,41297,0,0,65,65,0,1,0,1,0
16387,44427,0,0,60,60,0,1,0,1,0
63212,57470,0,0,67,67,0,1,0,1,0
53030,56205,0,0,66,66,0,1,0,1,0
58738,9614,0,0,62,62,0,1,0,1,0
64135,2767,0,0,66,66,0,1,0,1,0
17236,22114,0,0,62,62,0,1,0,1,0
18416,51473,0,0,65,65,0,1,0,1,0
33453,64147,0,0,62,62,0,1,0,1,0
4693,26991,0,0,62,62,0,1,0,1,0
51219,57470,0,0,66,66,0,1,0,1,0
26391,44847,0,0,146,146,0,1,0,1,0
56381,25174,0,0,62,62,0,1,0,1,0
56141,57470,0,0,62,62,0,1,0,1,0
18880,50584,0,0,81,81,0,1,0,1,0
60183,17881,0,0,66,66,0,1,0,1,0
24144,57470,0,0,62,62,0,1,0,1,0
28899,23,0,0,60,60,0,1,0,1,0
1208,51455,0,0,145,145,0,1,0,1,0
56415,35350,0,0,66,66,0,1,0,1,0
21275,23,0,0,60,60,0,1,0,1,0
21208,51376,0,0,62,62,0,1,0,1,0
24075,55950,0,0,63,63,0,1,0,1,0
38593,64147,0,0,64,64,0,1,0,1,0
40339,23117,0,0,83,83,0,1,0,1,0
55141,11392,0,0,66,66,0,1,0,1,0
25187,48822,0,0,64,64,0,1,0,1,0
51871,30222,0,0,66,66,0,1,0,1,0
61752,23,0,0,60,60,0,1,0,1,0
52410,8604,0,0,66,66,0,1,0,1,0
15806,11392,0,0,66,66,0,1,0,1,0
45941,23388,0,0,60,60,0,1,0,1,0
61550,5529,0,0,145,145,0,1,0,1,0
61221,35435,0,0,66,66,0,1,0,1,0
64368,22114,0,0,65,65,0,1,0,1,0
51016,64147,0,0,144,144,0,1,0,1,0
9503,35440,0,0,64,64,0,1,0,1,0
63379,36237,0,0,64,64,0,1,0,1,0
56482,25174,0,0,62,62,0,1,0,1,0
14436,64147,0,0,62,62,0,1,0,1,0
51732,50893,0,0,146,146,0,1,0,1,0
30521,57519,0,0,62,62,0,1,0,1,0
7482,57470,0,0,66,66,0,1,0,1,0
443,47605,0,0,85,85,0,1,0,1,0
64379,37965,0,0,66,66,0,1,0,1,0
61536,61689,0,0,66,66,0,1,0,1,0
50723,35440,0,0,66,66,0,1,0,1,0
55617,56205,0,0,62,62,0,1,0,1,0
53437,44847,0,0,66,66,0,1,0,1,0
35651,30188,0,0,135,135,0,1,0,1,0
57987,56125,0,0,90,90,0,1,0,1,0
5223,14049,0,0,147,147,0,1,0,1,0
50788,48817,0,0,66,66,0,1,0,1,0
46663,26869,0,0,62,62,0,1,0,1,0
1650,22114,0,0,62,62,0,1,0,1,0
54637,36237,0,0,66,66,0,1,0,1,0
58638,5900,0,0,62,62,0,1,0,1,0
58638,5900,0,0,62,62,0,1,0,1,0
33803,37965,0,0,62,62,0,1,0,1,0
58255,43890,0,0,62,62,0,1,0,1,0
50217,44847,0,0,68,68,0,1,0,1,0
42954,56205,0,0,140,140,0,1,0,1,0
45371,25174,0,0,105,105,0,1,0,1,0
50878,17519,0,0,85,85,0,1,0,1,0
62829,9245,0,0,66,66,0,1,0,1,0
64034,25174,0,0,62,62,0,1,0,1,0
47910,7454,0,0,60,60,0,1,0,1,0
21135,57470,0,0,62,62,0,1,0,1,0
3478,61463,0,0,1297,1297,0,1,0,1,0
2046,35440,0,0,65,65,0,1,0,1,0
1897,57470,0,0,133,133,0,1,0,1,0
59852,62413,0,0,66,66,0,1,0,1,0
60218,37965,0,0,66,66,0,1,0,1,0
42034,28189,0,0,62,62,0,1,0,1,0
5738,43908,0,0,62,62,0,1,0,1,0
45908,33330,0,0,60,60,0,1,0,1,0
1100,50584,0,0,89,89,0,1,0,1,0
60308,30646,0,0,65,65,0,1,0,1,0
54336,26467,0,0,64,64,0,1,0,1,0
53843,37965,0,0,66,66,0,1,0,1,0
46116,57470,0,0,74,74,0,1,0,1,0
57978,2988,0,0,114,114,0,1,0,1,0
39583,37965,0,0,66,66,0,1,0,1,0
57699,64147,0,0,66,66,0,1,0,1,0
45941,23386,0,0,60,60,0,1,0,1,0
443,22447,0,0,85,85,0,1,0,1,0
65313,46797,0,0,66,66,0,1,0,1,0
13660,56205,0,0,62,62,0,1,0,1,0
49184,25174,0,0,64,64,0,1,0,1,0
9403,32737,0,0,106,106,0,1,0,1,0
56376,44847,0,0,64,64,0,1,0,1,0
7479,57470,0,0,66,66,0,1,0,1,0
12593,48534,0,0,86,86,0,1,0,1,0
58350,43890,0,0,62,62,0,1,0,1,0
49209,51505,0,0,108,108,0,1,0,1,0
976,48834,0,0,139,139,0,1,0,1,0
9265,57470,0,0,66,66,0,1,0,1,0
23622,25174,0,0,101,101,0,1,0,1,0
51430,11392,0,0,66,66,0,1,0,1,0
53652,35955,0,0,60,60,0,1,0,1,0
53023,24211,0,0,62,62,0,1,0,1,0
15306,26467,0,0,62,62,0,1,0,1,0
58787,1380,0,0,60,60,0,1,0,1,0
51172,44847,0,0,62,62,0,1,0,1,0
63927,44847,0,0,66,66,0,1,0,1,0
43344,51450,0,0,146,146,0,1,0,1,0
49228,23,0,0,60,60,0,1,0,1,0
14708,10387,0,0,159,159,0,1,0,1,0
17150,11083,0,0,66,66,0,1,0,1,0
48706,23393,0,0,60,60,0,1,0,1,0
65509,44847,0,0,62,62,0,1,0,1,0
30169,64857,0,0,61,61,0,1,0,1,0
1190,25174,0,0,66,66,0,1,0,1,0
49293,21247,0,0,66,66,0,1,0,1,0
55172,26467,0,0,66,66,0,1,0,1,0
54120,17381,0,0,65,65,0,1,0,1,0
14923,51505,0,0,64,64,0,1,0,1,0
45062,14135,0,0,74,74,0,1,0,1,0
2422,50584,0,0,66,66,0,1,0,1,0
45964,2225,0,0,60,60,0,1,0,1,0
63832,25174,0,0,65,65,0,1,0,1,0
24376,50584,0,0,66,66,0,1,0,1,0
56854,18375,0,0,63,63,0,1,0,1,0
1860,25174,0,0,65,65,0,1,0,1,0
3478,61463,0,0,1079,1079,0,1,0,1,0
56335,26467,0,0,66,66,0,1,0,1,0
28879,30188,0,0,63,63,0,1,0,1,0
7711,23,0,0,60,60,0,1,0,1,0
62912,2259,0,0,63,63,0,1,0,1,0
60890,61689,0,0,140,140,0,1,0,1,0
45941,23386,0,0,60,60,0,1,0,1,0
26053,33720,0,0,160,160,0,1,0,1,0
10003,64147,0,0,62,62,0,1,0,1,0
50067,64147,0,0,65,65,0,1,0,1,0
53500,1,0,0,66,66,0,1,0,1,0
58638,5900,0,0,62,62,0,1,0,1,0
27295,25174,0,0,134,134,0,1,0,1,0
52326,44847,0,0,62,62,0,1,0,1,0
18650,23718,0,0,62,62,0,1,0,1,0
35319,25174,0,0,126,126,0,1,0,1,0
53422,44847,0,0,66,66,0,1,0,1,0
63680,64124,0,0,66,66,0,1,0,1,0
0,0,0,0,70,70,0,1,0,1,0
46224,44847,0,0,104,104,0,1,0,1,0
59601,62413,0,0,62,62,0,1,0,1,0
54379,36829,0,0,94,94,0,1,0,1,0
26609,44847,0,0,65,65,0,1,0,1,0
44599,31192,0,0,124,124,0,1,0,1,0
10709,50584,0,0,81,81,0,1,0,1,0
443,20087,0,0,83,83,0,1,0,1,0
44299,1036,0,0,60,60,0,1,0,1,0
48222,122,0,0,60,60,0,1,0,1,0
48855,50584,0,0,65,65,0,1,0,1,0
50102,17546,0,0,66,66,0,1,0,1,0
42452,22114,0,0,62,62,0,1,0,1,0
7331,23,0,0,60,60,0,1,0,1,0
55037,25174,0,0,66,66,0,1,0,1,0
62849,62413,0,0,62,62,0,1,0,1,0
29177,44847,0,0,64,64,0,1,0,1,0
53030,56205,0,0,66,66,0,1,0,1,0
59894,22114,0,0,64,64,0,1,0,1,0
5660,37965,0,0,62,62,0,1,0,1,0
30654,51221,0,0,72,72,0,1,0,1,0
3862,63949,0,0,64,64,0,1,0,1,0
62380,48817,0,0,116,116,0,1,0,1,0
58638,5900,0,0,62,62,0,1,0,1,0
55451,56205,0,0,66,66,0,1,0,1,0
46292,42873,0,0,72,72,0,1,0,1,0
3181,22114,0,0,89,89,0,1,0,1,0
50470,61463,0,0,86,86,0,1,0,1,0
45410,1,0,0,62,62,0,1,0,1,0
16893,36375,0,0,65,65,0,1,0,1,0
5223,44091,0,0,155,155,0,1,0,1,0
58638,5900,0,0,62,62,0,1,0,1,0
7310,44847,0,0,66,66,0,1,0,1,0
2500,35440,0,0,66,66,0,1,0,1,0
63653,26325,0,0,142,142,0,1,0,1,0
1981,35440,0,0,64,64,0,1,0,1,0
27690,37965,0,0,62,62,0,1,0,1,0
19703,4388,0,0,146,146,0,1,0,1,0
52715,64147,0,0,62,62,0,1,0,1,0
45941,23386,0,0,60,60,0,1,0,1,0
64772,64147,0,0,66,66,0,1,0,1,0
3478,61463,0,0,238,238,0,1,0,1,0
22529,25174,0,0,62,62,0,1,0,1,0
10996,22114,0,0,88,88,0,1,0,1,0
23365,48907,0,0,115,115,0,1,0,1,0
80,53945,0,0,60,60,0,1,0,1,0
63851,26467,0,0,65,65,0,1,0,1,0
55203,37861,0,0,66,66,0,1,0,1,0
50052,65008,0,0,60,60,0,1,0,1,0
51217,30202,0,0,65,65,0,1,0,1,0
44455,37818,0,0,62,62,0,1,0,1,0
28143,37965,0,0,128,128,0,1,0,1,0
51973,25174,0,0,64,64,0,1,0,1,0
50084,26672,0,0,62,62,0,1,0,1,0
54311,11392,0,0,66,66,0,1,0,1,0
2832,7142,0,0,66,66,0,1,0,1,0
11574,51505,0,0,62,62,0,1,0,1,0
33943,22114,0,0,146,146,0,1,0,1,0
56074,64147,0,0,64,64,0,1,0,1,0
53022,64147,0,0,62,62,0,1,0,1,0
61550,5529,0,0,145,145,0,1,0,1,0
53313,35266,0,0,66,66,0,1,0,1,0
58638,5900,0,0,62,62,0,1,0,1,0
62277,48817,0,0,131,131,0,1,0,1,0
1373,22114,0,0,64,64,0,1,0,1,0
52506,44675,0,0,65,65,0,1,0,1,0
34860,51185,0,0,61,61,0,1,0,1,0
58638,5900,0,0,62,62,0,1,0,1,0
27679,37965,0,0,62,62,0,1,0,1,0
58638,5900,0,0,62,62,0,1,0,1,0
47702,15905,0,0,62,62,0,1,0,1,0
47132,1433,0,0,60,60,0,1,0,1,0
50426,50584,0,0,130,130,0,1,0,1,0
45913,44847,0,0,62,62,0,1,0,1,0
1206,51451,0,0,145,145,0,1,0,1,0
40326,25174,0,0,63,63,0,1,0,1,0
58247,57866,0,0,66,66,0,1,0,1,0
1083,57470,0,0,124,124,0,1,0,1,0
50817,22114,0,0,64,64,0,1,0,1,0
58638,5900,0,0,62,62,0,1,0,1,0
28916,30188,0,0,64,64,0,1,0,1,0
42558,885,0,0,60,60,0,1,0,1,0
58723,43890,0,0,66,66,0,1,0,1,0
57468,59443,0,0,63,63,0,1,0,1,0
29217,44847,0,0,62,62,0,1,0,1,0
55194,37863,0,0,94,94,0,1,0,1,0
18729,44847,0,0,66,66,0,1,0,1,0
60264,30188,0,0,62,62,0,1,0,1,0
61766,44847,0,0,62,62,0,1,0,1,0
3478,61463,0,0,1291,1291,0,1,0,1,0
5223,14446,0,0,220,220,0,1,0,1,0
6882,8259,0,0,143,143,0,1,0,1,0
10006,64147,0,0,62,62,0,1,0,1,0
56679,51505,0,0,97,97,0,1,0,1,0
57987,56125,0,0,90,90,0,1,0,1,0
55411,37965,0,0,66,66,0,1,0,1,0
10477,44847,0,0,64,64,0,1,0,1,0
58638,5900,0,0,62,62,0,1,0,1,0
1692,30188,0,0,62,62,0,1,0,1,0
63009,51383,0,0,63,63,0,1,0,1,0
24211,22431,0,0,60,60,0,1,0,1,0
15937,36829,0,0,62,62,0,1,0,1,0
29071,41859,0,0,158,158,0,1,0,1,0
59008,51221,0,0,66,66,0,1,0,1,0
443,22622,0,0,74,74,0,1,0,1,0
43311,50584,0,0,117,117,0,1,0,1,0
49628,57470,0,0,73,73,0,1,0,1,0
13285,29892,0,0,145,145,0,1,0,1,0
49977,5900,0,0,60,60,0,1,0,1,0
56545,48817,0,0,62,62,0,1,0,1,0
5697,44847,0,0,66,66,0,1,0,1,0
39132,44847,0,0,64,64,0,1,0,1,0
50349,37965,0,0,63,63,0,1,0,1,0
24373,52700,0,0,66,66,0,1,0,1,0
59313,35432,0,0,63,63,0,1,0,1,0
60064,25175,0,0,72,72,0,1,0,1,0
25285,7162,0,0,64,64,0,1,0,1,0
53771,57470,0,0,66,66,0,1,0,1,0
58638,5900,0,0,62,62,0,1,0,1,0
19875,30170,0,0,145,145,0,1,0,1,0
59097,57470,0,0,66,66,0,1,0,1,0
58638,5900,0,0,62,62,0,1,0,1,0
1480,12447,0,0,66,66,0,1,0,1,0
56324,51505,0,0,63,63,0,1,0,1,0
60098,66,0,0,74,74,0,1,0,1,0
36538,64147,0,0,62,62,0,1,0,1,0
14023,37965,0,0,62,62,0,1,0,1,0
53638,64147,0,0,63,63,0,1,0,1,0
58501,35671,0,0,64,64,0,1,0,1,0
63330,62413,0,0,65,65,0,1,0,1,0
1543,56205,0,0,62,62,0,1,0,1,0
45462,47593,0,0,65,65,0,1,0,1,0
51560,46783,0,0,63,63,0,1,0,1,0
55346,50584,0,0,66,66,0,1,0,1,0
51155,56205,0,0,64,64,0,1,0,1,0
51128,57470,0,0,66,66,0,1,0,1,0
6889,34789,0,0,145,145,0,1,0,1,0
46558,1433,0,0,60,60,0,1,0,1,0
54145,6004,0,0,70,70,0,1,0,1,0
33944,49699,0,0,98,98,0,1,0,1,0
56397,26467,0,0,64,64,0,1,0,1,0
37013,25174,0,0,65,65,0,1,0,1,0
41978,37,0,0,67,67,0,1,0,1,0
25052,64147,0,0,62,62,0,1,0,1,0
13188,35440,0,0,65,65,0,1,0,1,0
0,0,0,0,70,70,0,1,0,1,0
44849,46478,0,0,74,74,0,1,0,1,0
58477,37965,0,0,64,64,0,1,0,1,0
62080,54532,0,0,60,60,0,1,0,1,0
19686,37965,0,0,62,62,0,1,0,1,0
49054,44847,0,0,62,62,0,1,0,1,0
705,60291,0,0,168,168,0,1,0,1,0
64264,23718,0,0,62,62,0,1,0,1,0
26241,56205,0,0,64,64,0,1,0,1,0
63501,46815,0,0,64,64,0,1,0,1,0
58118,22114,0,0,66,66,0,1,0,1,0
58638,5900,0,0,62,62,0,1,0,1,0
58638,5900,0,0,62,62,0,1,0,1,0
3371,22114,0,0,105,105,0,1,0,1,0
22516,51505,0,0,62,62,0,1,0,1,0
63062,25174,0,0,63,63,0,1,0,1,0
10965,22114,0,0,62,62,0,1,0,1,0
64237,51505,0,0,64,64,0,1,0,1,0
58638,5900,0,0,62,62,0,1,0,1,0
63469,64147,0,0,62,62,0,1,0,1,0
58463,11392,0,0,66,66,0,1,0,1,0
50623,50584,0,0,65,65,0,1,0,1,0
53180,62123,0,0,63,63,0,1,0,1,0
62137,56205,0,0,65,65,0,1,0,1,0
49415,22114,0,0,65,65,0,1,0,1,0
57394,25174,0,0,62,62,0,1,0,1,0
3061,64147,0,0,62,62,0,1,0,1,0
53232,51221,0,0,66,66,0,1,0,1,0
13919,6881,0,0,62,62,0,1,0,1,0
29278,39218,0,0,68,68,0,1,0,1,0
50097,30213,0,0,65,65,0,1,0,1,0
14632,25174,0,0,65,65,0,1,0,1,0
53469,44847,0,0,65,65,0,1,0,1,0
59717,46817,0,0,67,67,0,1,0,1,0
63734,25174,0,0,62,62,0,1,0,1,0
46846,1433,0,0,60,60,0,1,0,1,0
19331,35440,0,0,141,141,0,1,0,1,0
50872,22114,0,0,66,66,0,1,0,1,0
5223,32965,0,0,137,137,0,1,0,1,0
7165,23,0,0,60,60,0,1,0,1,0
60914,64147,0,0,68,68,0,1,0,1,0
62358,25174,0,0,65,65,0,1,0,1,0
1024,25174,0,0,62,62,0,1,0,1,0
21759,51505,0,0,63,63,0,1,0,1,0
47682,25174,0,0,146,146,0,1,0,1,0
52262,50971,0,0,63,63,0,1,0,1,0
46855,25174,0,0,146,146,0,1,0,1,0
2937,25174,0,0,62,62,0,1,0,1,0
60792,25174,0,0,66,66,0,1,0,1,0
51401,6881,0,0,66,66,0,1,0,1,0
61376,21247,0,0,64,64,0,1,0,1,0
6247,51221,0,0,78,78,0,1,0,1,0
1026,64147,0,0,62,62,0,1,0,1,0
1024,50578,0,0,62,62,0,1,0,1,0
26146,56050,0,0,63,63,0,1,0,1,0
39063,44847,0,0,66,66,0,1,0,1,0
28883,8457,0,0,60,60,0,1,0,1,0
51556,17490,0,0,63,63,0,1,0,1,0
51429,22114,0,0,63,63,0,1,0,1,0
55841,62413,0,0,66,66,0,1,0,1,0
44117,6881,0,0,101,101,0,1,0,1,0
9451,11307,0,0,61,61,0,1,0,1,0
12231,57677,0,0,64,64,0,1,0,1,0
61229,22114,0,0,66,66,0,1,0,1,0
43129,20220,0,0,62,62,0,1,0,1,0
8842,29378,0,0,60,60,0,1,0,1,0
26059,44847,0,0,146,146,0,1,0,1,0
8404,64147,0,0,64,64,0,1,0,1,0
17099,64147,0,0,63,63,0,1,0,1,0
1035,26467,0,0,62,62,0,1,0,1,0
58638,5900,0,0,62,62,0,1,0,1,0
1024,64147,0,0,62,62,0,1,0,1,0
64363,22114,0,0,65,65,0,1,0,1,0
6247,51221,0,0,65,65,0,1,0,1,0
58651,17500,0,0,66,66,0,1,0,1,0
58638,5900,0,0,62,62,0,1,0,1,0
27022,50584,0,0,66,66,0,1,0,1,0
38484,48637,0,0,60,60,0,1,0,1,0
62064,22114,0,0,66,66,0,1,0,1,0
60126,50722,0,0,62,62,0,1,0,1,0
3478,61463,0,0,440,440,0,1,0,1,0
32619,22114,0,0,87,87,0,1,0,1,0
55893,45711,0,0,78,78,0,1,0,1,0
5673,37965,0,0,66,66,0,1,0,1,0
46630,50470,0,0,68,68,0,1,0,1,0
1736,65198,0,0,62,62,0,1,0,1,0
55228,21247,0,0,62,62,0,1,0,1,0
34932,38608,0,0,62,62,0,1,0,1,0
54088,25174,0,0,64,64,0,1,0,1,0
34932,38608,0,0,62,62,0,1,0,1,0
55435,25174,0,0,62,62,0,1,0,1,0
3977,5039,0,0,328,328,0,1,0,1,0
38852,37965,0,0,62,62,0,1,0,1,0
59244,22114,0,0,64,64,0,1,0,1,0
26270,37965,0,0,65,65,0,1,0,1,0
26448,9192,0,0,145,145,0,1,0,1,0
44675,25174,0,0,143,143,0,1,0,1,0
22832,48817,0,0,125,125,0,1,0,1,0
47664,25174,0,0,146,146,0,1,0,1,0
56249,55442,0,0,66,66,0,1,0,1,0
48676,53398,0,0,60,60,0,1,0,1,0
56433,15503,0,0,146,146,0,1,0,1,0
47910,7462,0,0,60,60,0,1,0,1,0
63397,25174,0,0,66,66,0,1,0,1,0
53105,35365,0,0,66,66,0,1,0,1,0
46283,64147,0,0,62,62,0,1,0,1,0
64302,37891,0,0,68,68,0,1,0,1,0
45093,45452,0,0,68,68,0,1,0,1,0
16693,36237,0,0,66,66,0,1,0,1,0
62616,44847,0,0,88,88,0,1,0,1,0
63678,35440,0,0,66,66,0,1,0,1,0
1582,56205,0,0,62,62,0,1,0,1,0
53115,42707,0,0,66,66,0,1,0,1,0
1882,43890,0,0,62,62,0,1,0,1,0
42085,35808,0,0,100,100,0,1,0,1,0
10965,22114,0,0,62,62,0,1,0,1,0
36432,35440,0,0,62,62,0,1,0,1,0
42030,25,0,0,74,74,0,1,0,1,0
51757,47688,0,0,113,113,0,1,0,1,0
15333,51505,0,0,66,66,0,1,0,1,0
54008,25174,0,0,66,66,0,1,0,1,0
54600,6881,0,0,66,66,0,1,0,1,0
53442,57470,0,0,63,63,0,1,0,1,0
44280,26467,0,0,62,62,0,1,0,1,0
52489,1433,0,0,60,60,0,1,0,1,0
49415,22114,0,0,65,65,0,1,0,1,0
64453,30207,0,0,65,65,0,1,0,1,0
43789,44847,0,0,64,64,0,1,0,1,0
31309,50584,0,0,88,88,0,1,0,1,0
63460,55160,0,0,63,63,0,1,0,1,0
34742,20821,0,0,62,62,0,1,0,1,0
50802,57470,0,0,65,65,0,1,0,1,0
31272,47101,0,0,92,92,0,1,0,1,0
32796,37965,0,0,66,66,0,1,0,1,0
14175,64147,0,0,98,98,0,1,0,1,0
39238,8984,0,0,77,77,0,1,0,1,0
58638,5900,0,0,62,62,0,1,0,1,0
1038,37965,0,0,62,62,0,1,0,1,0
47910,7454,0,0,60,60,0,1,0,1,0
11136,57587,0,0,62,62,0,1,0,1,0
41692,59750,0,0,62,62,0,1,0,1,0
49767,5900,0,0,60,60,0,1,0,1,0
22530,23718,0,0,66,66,0,1,0,1,0
11945,27,0,0,60,60,0,1,0,1,0
1117,37965,0,0,62,62,0,1,0,1,0
4366,51505,0,0,62,62,0,1,0,1,0
56033,1311,0,0,66,66,0,1,0,1,0
65110,50572,0,0,62,62,0,1,0,1,0
54431,34984,0,0,64,64,0,1,0,1,0
54277,22114,0,0,62,62,0,1,0,1,0
42152,48695,0,0,87,87,0,1,0,1,0
4619,1856,0,0,128,128,0,1,0,1,0
6098,51404,0,0,64,64,0,1,0,1,0
38602,64147,0,0,119,119,0,1,0,1,0
16387,35583,0,0,60,60,0,1,0,1,0
58348,37891,0,0,66,66,0,1,0,1,0
3945,35440,0,0,66,66,0,1,0,1,0
25341,11523,0,0,139,139,0,1,0,1,0
59179,25174,0,0,64,64,0,1,0,1,0
43640,57470,0,0,130,130,0,1,0,1,0
58638,5900,0,0,62,62,0,1,0,1,0
23685,37930,0,0,62,62,0,1,0,1,0
54777,50584,0,0,65,65,0,1,0,1,0
33086,62413,0,0,66,66,0,1,0,1,0
58638,5900,0,0,62,62,0,1,0,1,0
4112,35440,0,0,65,65,0,1,0,1,0
38783,22114,0,0,66,66,0,1,0,1,0
34916,51185,0,0,62,62,0,1,0,1,0
57235,50959,0,0,66,66,0,1,0,1,0
59422,22114,0,0,66,66,0,1,0,1,0
19626,38359,0,0,93,93,0,1,0,1,0
10451,30323,0,0,146,146,0,1,0,1,0
62930,21247,0,0,66,66,0,1,0,1,0
51240,46215,0,0,121,121,0,1,0,1,0
47722,1834,0,0,137,137,0,1,0,1,0
65344,46824,0,0,63,63,0,1,0,1,0
32791,30188,0,0,113,113,0,1,0,1,0
57643,28189,0,0,60,60,0,1,0,1,0
60186,31528,0,0,62,62,0,1,0,1,0
37323,21872,0,0,62,62,0,1,0,1,0
552,48068,0,0,107,107,0,1,0,1,0
62906,42821,0,0,66,66,0,1,0,1,0
2729,48817,0,0,62,62,0,1,0,1,0
39887,47533,0,0,112,112,0,1,0,1,0
34106,11237,0,0,80,80,0,1,0,1,0
63094,64147,0,0,62,62,0,1,0,1,0
43733,22114,0,0,62,62,0,1,0,1,0
30778,37965,0,0,62,62,0,1,0,1,0
1616,22114,0,0,79,79,0,1,0,1,0
53156,35993,0,0,66,66,0,1,0,1,0
58664,50584,0,0,66,66,0,1,0,1,0
30456,36237,0,0,62,62,0,1,0,1,0
58638,5900,0,0,62,62,0,1,0,1,0
5213,44847,0,0,62,62,0,1,0,1,0
443,28398,0,0,80,80,0,1,0,1,0
38959,25174,0,0,62,62,0,1,0,1,0
0,0,0,0,162,162,0,2,0,2,0
13285,29892,0,0,145,145,0,1,0,1,0
58967,37965,0,0,66,66,0,1,0,1,0
0,0,0,0,98,98,0,1,0,1,0
5648,37965,0,0,62,62,0,1,0,1,0
1616,22114,0,0,62,62,0,1,0,1,0
12761,50483,0,0,64,64,0,1,0,1,0
8080,37965,0,0,62,62,0,1,0,1,0
30713,50362,0,0,64,64,0,1,0,1,0
61341,56205,0,0,65,65,0,1,0,1,0
1814,62413,0,0,66,66,0,1,0,1,0
6941,64147,0,0,129,129,0,1,0,1,0
58638,5900,0,0,62,62,0,1,0,1,0
58638,5900,0,0,62,62,0,1,0,1,0
25511,23,0,0,60,60,0,1,0,1,0
9238,37965,0,0,65,65,0,1,0,1,0
16345,56205,0,0,101,101,0,1,0,1,0
10151,23,0,0,60,60,0,1,0,1,0
49726,5900,0,0,60,60,0,1,0,1,0
1024,45036,0,0,145,145,0,1,0,1,0
38087,11251,0,0,71,71,0,1,0,1,0
10789,6881,0,0,92,92,0,1,0,1,0
35657,48637,0,0,62,62,0,1,0,1,0
63506,50584,0,0,64,64,0,1,0,1,0
58638,5900,0,0,62,62,0,1,0,1,0
9283,3186,0,0,64,64,0,1,0,1,0
59845,15503,0,0,66,66,0,1,0,1,0
9673,57470,0,0,75,75,0,1,0,1,0
16001,41512,0,0,63,63,0,1,0,1,0
46815,25174,0,0,62,62,0,1,0,1,0
53981,30168,0,0,65,65,0,1,0,1,0
52458,2780,0,0,66,66,0,1,0,1,0
54145,6004,0,0,70,70,0,1,0,1,0
55069,44847,0,0,66,66,0,1,0,1,0
16387,7837,0,0,60,60,0,1,0,1,0
26921,57470,0,0,62,62,0,1,0,1,0
50470,61463,0,0,86,86,0,1,0,1,0
515,10214,0,0,65,65,0,1,0,1,0
25044,30188,0,0,62,62,0,1,0,1,0
58964,30188,0,0,62,62,0,1,0,1,0
54192,57597,0,0,66,66,0,1,0,1,0
1847,44847,0,0,64,64,0,1,0,1,0
8129,21150,0,0,71,71,0,1,0,1,0
36463,63,0,0,60,60,0,1,0,1,0
50138,64147,0,0,66,66,0,1,0,1,0
59018,22114,0,0,64,64,0,1,0,1,0
42934,44847,0,0,65,65,0,1,0,1,0
0,0,0,0,98,98,0,1,0,1,0
25263,2280,0,0,60,60,0,1,0,1,0
23218,62413,0,0,63,63,0,1,0,1,0
57754,37965,0,0,62,62,0,1,0,1,0
53621,5923,0,0,61,61,0,1,0,1,0
57544,56205,0,0,66,66,0,1,0,1,0
64854,51198,0,0,63,63,0,1,0,1,0
47910,7454,0,0,60,60,0,1,0,1,0
23353,25174,0,0,135,135,0,1,0,1,0
15783,6881,0,0,123,123,0,1,0,1,0
22637,64147,0,0,66,66,0,1,0,1,0
52315,64106,0,0,65,65,0,1,0,1,0
60624,26566,0,0,62,62,0,1,0,1,0
58872,57470,0,0,109,109,0,1,0,1,0
38604,22,0,0,60,60,0,1,0,1,0
10406,26467,0,0,62,62,0,1,0,1,0
2108,3000,0,0,63,63,0,1,0,1,0
50207,5900,0,0,60,60,0,1,0,1,0
26423,26416,0,0,62,62,0,1,0,1,0
33788,23,0,0,60,60,0,1,0,1,0
51393,51425,0,0,64,64,0,1,0,1,0
46479,57470,0,0,63,63,0,1,0,1,0
45682,37965,0,0,62,62,0,1,0,1,0
50529,44847,0,0,66,66,0,1,0,1,0
1898,22114,0,0,62,62,0,1,0,1,0
56604,17372,0,0,66,66,0,1,0,1,0
58553,57574,0,0,66,66,0,1,0,1,0
52037,56126,0,0,63,63,0,1,0,1,0
55254,50584,0,0,66,66,0,1,0,1,0
9573,35440,0,0,64,64,0,1,0,1,0
55205,38791,0,0,66,66,0,1,0,1,0
54471,35440,0,0,64,64,0,1,0,1,0
58638,5900,0,0,62,62,0,1,0,1,0
3117,37965,0,0,62,62,0,1,0,1,0
13997,43114,0,0,65,65,0,1,0,1,0
58876,57470,0,0,66,66,0,1,0,1,0
18602,26467,0,0,62,62,0,1,0,1,0
45941,23388,0,0,60,60,0,1,0,1,0
51816,48599,0,0,85,85,0,1,0,1,0
48071,25174,0,0,62,62,0,1,0,1,0
12545,25174,0,0,62,62,0,1,0,1,0
15701,37965,0,0,146,146,0,1,0,1,0
26501,64147,0,0,62,62,0,1,0,1,0
58638,5900,0,0,62,62,0,1,0,1,0
57349,62413,0,0,62,62,0,1,0,1,0
63191,35440,0,0,68,68,0,1,0,1,0
3534,25174,0,0,65,65,0,1,0,1,0
59920,44847,0,0,66,66,0,1,0,1,0
50590,51505,0,0,66,66,0,1,0,1,0
51376,52587,0,0,100,100,0,1,0,1,0
64365,22114,0,0,63,63,0,1,0,1,0
49363,35586,0,0,103,103,0,1,0,1,0
56521,32480,0,0,62,62,0,1,0,1,0
59288,57513,0,0,71,71,0,1,0,1,0
63331,51221,0,0,62,62,0,1,0,1,0
12562,22114,0,0,130,130,0,1,0,1,0
30256,23,0,0,60,60,0,1,0,1,0
58213,37807,0,0,66,66,0,1,0,1,0
36258,23,0,0,60,60,0,1,0,1,0
60153,37965,0,0,66,66,0,1,0,1,0
50470,61463,0,0,86,86,0,1,0,1,0
46569,1433,0,0,60,60,0,1,0,1,0
443,38956,0,0,82,82,0,1,0,1,0
49693,30188,0,0,66,66,0,1,0,1,0
3478,61463,0,0,1296,1296,0,1,0,1,0
50297,22114,0,0,62,62,0,1,0,1,0
51737,35440,0,0,66,66,0,1,0,1,0
49406,50584,0,0,63,63,0,1,0,1,0
33709,23,0,0,60,60,0,1,0,1,0
49701,36050,0,0,62,62,0,1,0,1,0
45941,23388,0,0,60,60,0,1,0,1,0
65391,26467,0,0,62,62,0,1,0,1,0
54601,36237,0,0,66,66,0,1,0,1,0
56532,18265,0,0,62,62,0,1,0,1,0
55246,25174,0,0,144,144,0,1,0,1,0
50470,61463,0,0,86,86,0,1,0,1,0
3107,44847,0,0,64,64,0,1,0,1,0
64966,56205,0,0,62,62,0,1,0,1,0
53536,56205,0,0,132,132,0,1,0,1,0
42995,26467,0,0,62,62,0,1,0,1,0
32941,64142,0,0,138,138,0,1,0,1,0
6032,25174,0,0,64,64,0,1,0,1,0
59733,51505,0,0,62,62,0,1,0,1,0
7578,44847,0,0,64,64,0,1,0,1,0
6896,34943,0,0,143,143,0,1,0,1,0
17760,50584,0,0,82,82,0,1,0,1,0
64247,44847,0,0,62,62,0,1,0,1,0
3478,61463,0,0,164,164,0,1,0,1,0
35692,48534,0,0,61,61,0,1,0,1,0
55514,64147,0,0,62,62,0,1,0,1,0
59946,44847,0,0,62,62,0,1,0,1,0
42517,51030,0,0,115,115,0,1,0,1,0
51477,9665,0,0,66,66,0,1,0,1,0
50588,9961,0,0,64,64,0,1,0,1,0
1904,25174,0,0,64,64,0,1,0,1,0
27850,52700,0,0,72,72,0,1,0,1,0
1025,50584,0,0,62,62,0,1,0,1,0
13285,29892,0,0,145,145,0,1,0,1,0
55173,62413,0,0,66,66,0,1,0,1,0
26879,37965,0,0,136,136,0,1,0,1,0
59490,5900,0,0,60,60,0,1,0,1,0
23658,11738,0,0,64,64,0,1,0,1,0
58638,5900,0,0,62,62,0,1,0,1,0
61140,27520,0,0,63,63,0,1,0,1,0
17315,35440,0,0,90,90,0,1,0,1,0
54400,35440,0,0,65,65,0,1,0,1,0
16584,10350,0,0,66,66,0,1,0,1,0
58638,5900,0,0,62,62,0,1,0,1,0
33232,50584,0,0,62,62,0,1,0,1,0
42769,56401,0,0,68,68,0,1,0,1,0
61513,50955,0,0,66,66,0,1,0,1,0
58397,18375,0,0,62,62,0,1,0,1,0
45941,23386,0,0,60,60,0,1,0,1,0
26238,37965,0,0,66,66,0,1,0,1,0
48706,23393,0,0,60,60,0,1,0,1,0
30205,23,0,0,60,60,0,1,0,1,0
58638,5900,0,0,62,62,0,1,0,1,0
56673,17441,0,0,66,66,0,1,0,1,0
51346,51221,0,0,69,69,0,1,0,1,0
47100,64147,0,0,62,62,0,1,0,1,0
54269,28631,0,0,63,63,0,1,0,1,0
3478,61463,0,0,214,214,0,1,0,1,0
63321,37807,0,0,66,66,0,1,0,1,0
19014,56205,0,0,62,62,0,1,0,1,0
6247,51221,0,0,78,78,0,1,0,1,0
51942,57470,0,0,66,66,0,1,0,1,0
63426,30411,0,0,96,96,0,1,0,1,0
50994,35974,0,0,60,60,0,1,0,1,0
26663,25174,0,0,62,62,0,1,0,1,0
42034,28189,0,0,119,119,0,1,0,1,0
14353,64147,0,0,62,62,0,1,0,1,0
24351,57470,0,0,62,62,0,1,0,1,0
7106,25174,0,0,66,66,0,1,0,1,0
37549,44847,0,0,63,63,0,1,0,1,0
21145,11392,0,0,118,118,0,1,0,1,0
58638,5900,0,0,62,62,0,1,0,1,0
64727,25174,0,0,66,66,0,1,0,1,0
61140,27520,0,0,64,64,0,1,0,1,0
53351,22114,0,0,66,66,0,1,0,1,0
65012,2767,0,0,66,66,0,1,0,1,0
2946,64147,0,0,62,62,0,1,0,1,0
10669,49756,0,0,60,60,0,1,0,1,0
50280,57470,0,0,78,78,0,1,0,1,0
51595,26467,0,0,65,65,0,1,0,1,0
2598,23718,0,0,62,62,0,1,0,1,0
443,35085,0,0,122,122,0,1,0,1,0
48449,50584,0,0,62,62,0,1,0,1,0
65344,46824,0,0,66,66,0,1,0,1,0
58381,15503,0,0,97,97,0,1,0,1,0
49985,22114,0,0,65,65,0,1,0,1,0
40500,1433,0,0,60,60,0,1,0,1,0
55201,22114,0,0,66,66,0,1,0,1,0
1490,65456,0,0,97,97,0,1,0,1,0
11983,57470,0,0,62,62,0,1,0,1,0
55825,52700,0,0,62,62,0,1,0,1,0
45051,22,0,0,60,60,0,1,0,1,0
46734,50265,0,0,74,74,0,1,0,1,0
43863,22114,0,0,62,62,0,1,0,1,0
58603,40792,0,0,135,135,0,1,0,1,0
7423,22114,0,0,144,144,0,1,0,1,0
58638,5900,0,0,62,62,0,1,0,1,0
60650,23461,0,0,66,66,0,1,0,1,0
28918,44847,0,0,63,63,0,1,0,1,0
60722,51221,0,0,65,65,0,1,0,1,0
11093,51505,0,0,64,64,0,1,0,1,0
1028,64147,0,0,62,62,0,1,0,1,0
65309,51221,0,0,70,70,0,1,0,1,0
43260,41615,0,0,145,145,0,1,0,1,0
51770,50584,0,0,81,81,0,1,0,1,0
51312,64147,0,0,65,65,0,1,0,1,0
22606,51353,0,0,62,62,0,1,0,1,0
14627,37965,0,0,62,62,0,1,0,1,0
55429,25174,0,0,65,65,0,1,0,1,0
56679,51505,0,0,110,110,0,1,0,1,0
58660,64142,0,0,62,62,0,1,0,1,0
51302,64147,0,0,66,66,0,1,0,1,0
1039,26467,0,0,62,62,0,1,0,1,0
39313,37965,0,0,62,62,0,1,0,1,0
53052,64147,0,0,66,66,0,1,0,1,0
47407,25174,0,0,74,74,0,1,0,1,0
37802,23,0,0,60,60,0,1,0,1,0
57472,37,0,0,62,62,0,1,0,1,0
25063,64147,0,0,62,62,0,1,0,1,0
56194,22114,0,0,62,62,0,1,0,1,0
19875,30170,0,0,145,145,0,1,0,1,0
56367,44847,0,0,65,65,0,1,0,1,0
10749,35440,0,0,63,63,0,1,0,1,0
10360,22114,0,0,62,62,0,1,0,1,0
39742,62413,0,0,63,63,0,1,0,1,0
60250,22114,0,0,62,62,0,1,0,1,0
28973,30188,0,0,66,66,0,1,0,1,0
36886,56205,0,0,146,146,0,1,0,1,0
64571,37965,0,0,66,66,0,1,0,1,0
58638,5900,0,0,62,62,0,1,0,1,0
52050,11392,0,0,62,62,0,1,0,1,0
25150,50391,0,0,145,145,0,1,0,1,0
14348,64147,0,0,62,62,0,1,0,1,0
59121,11392,0,0,64,64,0,1,0,1,0
40787,57470,0,0,62,62,0,1,0,1,0
58899,57470,0,0,66,66,0,1,0,1,0
60067,55525,0,0,66,66,0,1,0,1,0
39581,36566,0,0,108,108,0,1,0,1,0
59765,25550,0,0,66,66,0,1,0,1,0
31070,46570,0,0,76,76,0,1,0,1,0
443,48346,0,0,81,81,0,1,0,1,0
1407,35440,0,0,62,62,0,1,0,1,0
15499,22114,0,0,109,109,0,1,0,1,0
30718,13493,0,0,134,134,0,1,0,1,0
40190,22114,0,0,62,62,0,1,0,1,0
12605,73,0,0,60,60,0,1,0,1,0
63341,30478,0,0,109,109,0,1,0,1,0
52471,50442,0,0,64,64,0,1,0,1,0
59097,2767,0,0,66,66,0,1,0,1,0
11716,37965,0,0,62,62,0,1,0,1,0
16387,26193,0,0,60,60,0,1,0,1,0
48025,44847,0,0,131,131,0,1,0,1,0
58148,43890,0,0,62,62,0,1,0,1,0
45941,23385,0,0,60,60,0,1,0,1,0
26345,22,0,0,60,60,0,1,0,1,0
2909,17,0,0,63,63,0,1,0,1,0
5228,3434,0,0,600,600,0,1,0,1,0
56001,56205,0,0,66,66,0,1,0,1,0
22156,19850,0,0,83,83,0,1,0,1,0
20894,51505,0,0,62,62,0,1,0,1,0
58638,5900,0,0,62,62,0,1,0,1,0
32801,37965,0,0,66,66,0,1,0,1,0
10477,44847,0,0,64,64,0,1,0,1,0
58256,10226,0,0,88,88,0,1,0,1,0
59051,27520,0,0,62,62,0,1,0,1,0
31916,57470,0,0,60,60,0,1,0,1,0
1024,64147,0,0,62,62,0,1,0,1,0
6819,2316,0,0,99,99,0,1,0,1,0
5223,44091,0,0,220,220,0,1,0,1,0
62409,50584,0,0,66,66,0,1,0,1,0
19885,64147,0,0,62,62,0,1,0,1,0
29736,50584,0,0,132,132,0,1,0,1,0
65489,22114,0,0,66,66,0,1,0,1,0
26412,44847,0,0,140,140,0,1,0,1,0
37025,25174,0,0,62,62,0,1,0,1,0
47306,35608,0,0,146,146,0,1,0,1,0
1009,51630,0,0,65,65,0,1,0,1,0
48934,51176,0,0,62,62,0,1,0,1,0
57226,51317,0,0,66,66,0,1,0,1,0
54991,36829,0,0,62,62,0,1,0,1,0
34916,51185,0,0,62,62,0,1,0,1,0
50035,57470,0,0,66,66,0,1,0,1,0
25283,51505,0,0,65,65,0,1,0,1,0
54205,11392,0,0,66,66,0,1,0,1,0
37429,25174,0,0,62,62,0,1,0,1,0
55440,1569,0,0,79,79,0,1,0,1,0
49163,50584,0,0,132,132,0,1,0,1,0
51414,22,0,0,60,60,0,1,0,1,0
56679,51505,0,0,62,62,0,1,0,1,0
51320,44847,0,0,65,65,0,1,0,1,0
57137,31083,0,0,141,141,0,1,0,1,0
55863,64147,0,0,66,66,0,1,0,1,0
58791,25174,0,0,68,68,0,1,0,1,0
58638,5900,0,0,62,62,0,1,0,1,0
59694,50584,0,0,64,64,0,1,0,1,0
41677,57470,0,0,65,65,0,1,0,1,0
59031,25174,0,0,63,63,0,1,0,1,0
58452,30223,0,0,64,64,0,1,0,1,0
64024,57470,0,0,64,64,0,1,0,1,0
52726,56205,0,0,64,64,0,1,0,1,0
57424,37965,0,0,65,65,0,1,0,1,0
53841,22114,0,0,65,65,0,1,0,1,0
56861,22114,0,0,63,63,0,1,0,1,0
37802,30344,0,0,143,143,0,1,0,1,0
51667,51505,0,0,66,66,0,1,0,1,0
56579,64147,0,0,65,65,0,1,0,1,0
52513,22114,0,0,66,66,0,1,0,1,0
59500,42832,0,0,91,91,0,1,0,1,0
64272,35338,0,0,107,107,0,1,0,1,0
62008,64127,0,0,66,66,0,1,0,1,0
30567,64147,0,0,62,62,0,1,0,1,0
43584,24748,0,0,156,156,0,1,0,1,0
19875,30170,0,0,145,145,0,1,0,1,0
26048,21,0,0,60,60,0,1,0,1,0
45941,23386,0,0,60,60,0,1,0,1,0
10467,25174,0,0,131,131,0,1,0,1,0
52067,22114,0,0,62,62,0,1,0,1,0
11136,15503,0,0,62,62,0,1,0,1,0
51769,51505,0,0,66,66,0,1,0,1,0
0,0,0,0,98,98,0,1,0,1,0
35193,38359,0,0,62,62,0,1,0,1,0
61800,25225,0,0,62,62,0,1,0,1,0
60984,64147,0,0,64,64,0,1,0,1,0
26387,8858,0,0,117,117,0,1,0,1,0
52976,51505,0,0,66,66,0,1,0,1,0
1431,44847,0,0,62,62,0,1,0,1,0
9604,35440,0,0,64,64,0,1,0,1,0
55855,64147,0,0,66,66,0,1,0,1,0
27160,22114,0,0,110,110,0,1,0,1,0
56788,23350,0,0,114,114,0,1,0,1,0
52177,25320,0,0,66,66,0,1,0,1,0
3478,61463,0,0,252,252,0,1,0,1,0
61945,48817,0,0,84,84,0,1,0,1,0
58638,5900,0,0,62,62,0,1,0,1,0
48676,53396,0,0,60,60,0,1,0,1,0
50901,26467,0,0,66,66,0,1,0,1,0
45064,57470,0,0,63,63,0,1,0,1,0
55869,64147,0,0,66,66,0,1,0,1,0
1097,46815,0,0,62,62,0,1,0,1,0
5060,37965,0,0,66,66,0,1,0,1,0
50562,37965,0,0,65,65,0,1,0,1,0
43290,35440,0,0,62,62,0,1,0,1,0
19245,64147,0,0,66,66,0,1,0,1,0
59481,41182,0,0,63,63,0,1,0,1,0
1955,35974,0,0,60,60,0,1,0,1,0
49386,64147,0,0,62,62,0,1,0,1,0
2372,51505,0,0,66,66,0,1,0,1,0
64237,44847,0,0,62,62,0,1,0,1,0
59161,51505,0,0,66,66,0,1,0,1,0
14134,1,0,0,65,65,0,1,0,1,0
52144,49344,0,0,62,62,0,1,0,1,0
52766,35440,0,0,65,65,0,1,0,1,0
50427,26467,0,0,63,63,0,1,0,1,0
40122,55611,0,0,93,93,0,1,0,1,0
63681,64124,0,0,63,63,0,1,0,1,0
58238,23,0,0,60,60,0,1,0,1,0
58638,5900,0,0,62,62,0,1,0,1,0
53776,57470,0,0,65,65,0,1,0,1,0
51577,44847,0,0,65,65,0,1,0,1,0
51088,9624,0,0,62,62,0,1,0,1,0
50406,1684,0,0,60,60,0,1,0,1,0
55968,56205,0,0,66,66,0,1,0,1,0
27359,22114,0,0,63,63,0,1,0,1,0
22995,9724,0,0,62,62,0,1,0,1,0
62784,51223,0,0,65,65,0,1,0,1,0
10138,25174,0,0,101,101,0,1,0,1,0
62437,37812,0,0,65,65,0,1,0,1,0
3047,50584,0,0,116,116,0,1,0,1,0
38565,51505,0,0,65,65,0,1,0,1,0
58638,5900,0,0,62,62,0,1,0,1,0
44412,37960,0,0,62,62,0,1,0,1,0
443,10010,0,0,60,60,0,1,0,1,0
53207,50584,0,0,66,66,0,1,0,1,0
21469,44847,0,0,66,66,0,1,0,1,0
63598,46824,0,0,62,62,0,1,0,1,0
60160,23,0,0,73,73,0,1,0,1,0
1280,25174,0,0,62,62,0,1,0,1,0
65285,44847,0,0,145,145,0,1,0,1,0
51571,22114,0,0,66,66,0,1,0,1,0
16374,45069,0,0,60,60,0,1,0,1,0
51052,50584,0,0,66,66,0,1,0,1,0
1227,50584,0,0,62,62,0,1,0,1,0
35570,22114,0,0,62,62,0,1,0,1,0
0,0,0,0,98,98,0,1,0,1,0
50859,50584,0,0,62,62,0,1,0,1,0
2752,25174,0,0,129,129,0,1,0,1,0
59927,62413,0,0,66,66,0,1,0,1,0
3649,51505,0,0,66,66,0,1,0,1,0
63775,35440,0,0,66,66,0,1,0,1,0
1026,44847,0,0,62,62,0,1,0,1,0
32225,30188,0,0,62,62,0,1,0,1,0
6957,48612,0,0,140,140,0,1,0,1,0
63117,57470,0,0,111,111,0,1,0,1,0
10398,22114,0,0,118,118,0,1,0,1,0
37770,44847,0,0,62,62,0,1,0,1,0
33939,50506,0,0,104,104,0,1,0,1,0
65317,51221,0,0,78,78,0,1,0,1,0
61522,64147,0,0,65,65,0,1,0,1,0
58638,5900,0,0,62,62,0,1,0,1,0
59363,25174,0,0,63,63,0,1,0,1,0
65417,26467,0,0,62,62,0,1,0,1,0
54426,64147,0,0,62,62,0,1,0,1,0
20621,25277,0,0,66,66,0,1,0,1,0
504,32761,0,0,86,86,0,1,0,1,0
28824,44847,0,0,65,65,0,1,0,1,0
9503,26467,0,0,63,63,0,1,0,1,0
55299,22114,0,0,64,64,0,1,0,1,0
57418,25174,0,0,62,62,0,1,0,1,0
11136,15503,0,0,62,62,0,1,0,1,0
36933,49735,0,0,151,151,0,1,0,1,0
64049,59596,0,0,66,66,0,1,0,1,0
58638,5900,0,0,62,62,0,1,0,1,0
53677,25174,0,0,64,64,0,1,0,1,0
46712,36237,0,0,94,94,0,1,0,1,0
3560,11392,0,0,66,66,0,1,0,1,0
1026,44847,0,0,62,62,0,1,0,1,0
14755,37965,0,0,62,62,0,1,0,1,0
54782,22114,0,0,63,63,0,1,0,1,0
24271,52700,0,0,66,66,0,1,0,1,0
11977,30820,0,0,62,62,0,1,0,1,0
58638,5900,0,0,62,62,0,1,0,1,0
49663,30188,0,0,66,66,0,1,0,1,0
63988,22114,0,0,66,66,0,1,0,1,0
48020,50584,0,0,62,62,0,1,0,1,0
52339,64140,0,0,66,66,0,1,0,1,0
65043,22114,0,0,66,66,0,1,0,1,0
23006,25174,0,0,65,65,0,1,0,1,0
36360,50584,0,0,146,146,0,1,0,1,0
34236,52283,0,0,109,109,0,1,0,1,0
61051,50470,0,0,116,116,0,1,0,1,0
58281,52700,0,0,66,66,0,1,0,1,0
3945,55951,0,0,98,98,0,1,0,1,0
40310,57470,0,0,69,69,0,1,0,1,0
13969,50584,0,0,121,121,0,1,0,1,0
63786,35440,0,0,64,64,0,1,0,1,0
176,37566,0,0,75,75,0,1,0,1,0
48288,25174,0,0,98,98,0,1,0,1,0
31845,55777,0,0,62,62,0,1,0,1,0
58638,5900,0,0,62,62,0,1,0,1,0
62823,44847,0,0,77,77,0,1,0,1,0
45941,23386,0,0,60,60,0,1,0,1,0
61132,42873,0,0,66,66,0,1,0,1,0
62895,22,0,0,60,60,0,1,0,1,0
52,38157,0,0,65,65,0,1,0,1,0
9687,57470,0,0,78,78,0,1,0,1,0
51505,17372,0,0,66,66,0,1,0,1,0
16754,57470,0,0,134,134,0,1,0,1,0
443,43956,0,0,77,77,0,1,0,1,0
7762,25174,0,0,96,96,0,1,0,1,0
61617,37927,0,0,66,66,0,1,0,1,0
55199,21247,0,0,62,62,0,1,0,1,0
1144,57470,0,0,62,62,0,1,0,1,0
59784,25209,0,0,66,66,0,1,0,1,0
43697,38071,0,0,74,74,0,1,0,1,0
16620,25174,0,0,62,62,0,1,0,1,0
26334,26351,0,0,62,62,0,1,0,1,0
11136,15503,0,0,62,62,0,1,0,1,0
59378,50584,0,0,64,64,0,1,0,1,0
61831,35440,0,0,66,66,0,1,0,1,0
50296,35440,0,0,64,64,0,1,0,1,0
57131,7911,0,0,145,145,0,1,0,1,0
44147,64147,0,0,62,62,0,1,0,1,0
12492,31464,0,0,62,62,0,1,0,1,0
43827,50429,0,0,66,66,0,1,0,1,0
64896,51182,0,0,66,66,0,1,0,1,0
49622,44847,0,0,63,63,0,1,0,1,0
58638,5900,0,0,62,62,0,1,0,1,0
63852,25174,0,0,62,62,0,1,0,1,0
52432,35440,0,0,143,143,0,1,0,1,0
20939,60461,0,0,60,60,0,1,0,1,0
6885,55108,0,0,143,143,0,1,0,1,0
38723,15503,0,0,146,146,0,1,0,1,0
23379,57866,0,0,67,67,0,1,0,1,0
45079,45511,0,0,69,69,0,1,0,1,0
58638,5900,0,0,62,62,0,1,0,1,0
51308,25174,0,0,65,65,0,1,0,1,0
48853,50584,0,0,84,84,0,1,0,1,0
55802,36656,0,0,89,89,0,1,0,1,0
12617,35440,0,0,64,64,0,1,0,1,0
17104,57572,0,0,63,63,0,1,0,1,0
42637,50351,0,0,62,62,0,1,0,1,0
25473,35834,0,0,120,120,0,1,0,1,0
14560,13,0,0,60,60,0,1,0,1,0
27576,25195,0,0,140,140,0,1,0,1,0
51053,26467,0,0,66,66,0,1,0,1,0
60377,25174,0,0,64,64,0,1,0,1,0
44997,31709,0,0,65,65,0,1,0,1,0
58638,5900,0,0,62,62,0,1,0,1,0
27102,25174,0,0,64,64,0,1,0,1,0
16387,8455,0,0,60,60,0,1,0,1,0
30303,30303,0,0,178,178,0,1,0,1,0
60073,55517,0,0,62,62,0,1,0,1,0
43294,8,0,0,61,61,0,1,0,1,0
34212,22114,0,0,124,124,0,1,0,1,0
18029,50584,0,0,66,66,0,1,0,1,0
54991,64147,0,0,66,66,0,1,0,1,0
3478,61463,0,0,164,164,0,1,0,1,0
64811,51221,0,0,66,66,0,1,0,1,0
18674,64147,0,0,62,62,0,1,0,1,0
1609,22114,0,0,85,85,0,1,0,1,0
58928,30188,0,0,62,62,0,1,0,1,0
52734,22114,0,0,91,91,0,1,0,1,0
61764,44847,0,0,64,64,0,1,0,1,0
51215,15265,0,0,81,81,0,1,0,1,0
33569,50584,0,0,114,114,0,1,0,1,0
62902,32468,0,0,66,66,0,1,0,1,0
58638,5900,0,0,62,62,0,1,0,1,0
45673,30188,0,0,62,62,0,1,0,1,0
51456,22,0,0,60,60,0,1,0,1,0
36753,21942,0,0,62,62,0,1,0,1,0
63251,15503,0,0,66,66,0,1,0,1,0
1955,35974,0,0,60,60,0,1,0,1,0
58638,5900,0,0,62,62,0,1,0,1,0
62970,44847,0,0,64,64,0,1,0,1,0
40787,57470,0,0,62,62,0,1,0,1,0
982,23,0,0,60,60,0,1,0,1,0
65069,2714,0,0,65,65,0,1,0,1,0
11716,37965,0,0,62,62,0,1,0,1,0
59822,44847,0,0,66,66,0,1,0,1,0
23071,63586,0,0,62,62,0,1,0,1,0
23798,64147,0,0,62,62,0,1,0,1,0
13985,34159,0,0,64,64,0,1,0,1,0
5797,43890,0,0,62,62,0,1,0,1,0
49531,35868,0,0,82,82,0,1,0,1,0
29013,8313,0,0,61,61,0,1,0,1,0
55452,23718,0,0,66,66,0,1,0,1,0
62982,37965,0,0,63,63,0,1,0,1,0
6666,369,0,0,60,60,0,1,0,1,0
51564,50584,0,0,66,66,0,1,0,1,0
36026,23,0,0,60,60,0,1,0,1,0
62947,44847,0,0,66,66,0,1,0,1,0
6381,51300,0,0,62,62,0,1,0,1,0
50953,30113,0,0,66,66,0,1,0,1,0
26502,64147,0,0,62,62,0,1,0,1,0
31539,37965,0,0,62,62,0,1,0,1,0
21164,57470,0,0,68,68,0,1,0,1,0
58638,5900,0,0,62,62,0,1,0,1,0
26967,50584,0,0,64,64,0,1,0,1,0
58750,1341,0,0,60,60,0,1,0,1,0
64414,50584,0,0,64,64,0,1,0,1,0
65044,50404,0,0,64,64,0,1,0,1,0
28529,32468,0,0,62,62,0,1,0,1,0
9405,56205,0,0,66,66,0,1,0,1,0
60103,25187,0,0,111,111,0,1,0,1,0
56278,52752,0,0,62,62,0,1,0,1,0
62538,25174,0,0,62,62,0,1,0,1,0
58638,5900,0,0,62,62,0,1,0,1,0
40061,55092,0,0,79,79,0,1,0,1,0
56266,43890,0,0,66,66,0,1,0,1,0
20043,64147,0,0,62,62,0,1,0,1,0
49842,1433,0,0,60,60,0,1,0,1,0
1024,44847,0,0,146,146,0,1,0,1,0
22619,55766,0,0,68,68,0,1,0,1,0
45941,23386,0,0,60,60,0,1,0,1,0
50806,51505,0,0,66,66,0,1,0,1,0
34627,38834,0,0,68,68,0,1,0,1,0
4089,25174,0,0,62,62,0,1,0,1,0
34098,37965,0,0,62,62,0,1,0,1,0
58638,5900,0,0,62,62,0,1,0,1,0
1523,8612,0,0,146,146,0,1,0,1,0
53982,50265,0,0,63,63,0,1,0,1,0
17685,35440,0,0,97,97,0,1,0,1,0
5774,37965,0,0,66,66,0,1,0,1,0
0,0,0,0,98,98,0,1,0,1,0
58638,5900,0,0,62,62,0,1,0,1,0
63326,54387,0,0,77,77,0,1,0,1,0
58513,21247,0,0,66,66,0,1,0,1,0
54526,44847,0,0,64,64,0,1,0,1,0
59965,36237,0,0,64,64,0,1,0,1,0
51377,25959,0,0,71,71,0,1,0,1,0
14788,26467,0,0,62,62,0,1,0,1,0
20682,57470,0,0,62,62,0,1,0,1,0
30271,37965,0,0,66,66,0,1,0,1,0
23089,48817,0,0,62,62,0,1,0,1,0
7052,37965,0,0,66,66,0,1,0,1,0
58638,5900,0,0,62,62,0,1,0,1,0
52715,25174,0,0,66,66,0,1,0,1,0
49386,64147,0,0,62,62,0,1,0,1,0
2345,43890,0,0,62,62,0,1,0,1,0
5229,32942,0,0,212,212,0,1,0,1,0
5664,36220,0,0,65,65,0,1,0,1,0
53147,50584,0,0,66,66,0,1,0,1,0
55878,64147,0,0,65,65,0,1,0,1,0
6655,2386,0,0,60,60,0,1,0,1,0
64106,64147,0,0,66,66,0,1,0,1,0
52721,15503,0,0,113,113,0,1,0,1,0
52307,50265,0,0,66,66,0,1,0,1,0
1833,51483,0,0,62,62,0,1,0,1,0
58574,50520,0,0,66,66,0,1,0,1,0
57698,64147,0,0,66,66,0,1,0,1,0
53308,57470,0,0,70,70,0,1,0,1,0
50052,65008,0,0,60,60,0,1,0,1,0
58638,5900,0,0,62,62,0,1,0,1,0
44673,31624,0,0,141,141,0,1,0,1,0
534,21019,0,0,92,92,0,1,0,1,0
56457,15503,0,0,146,146,0,1,0,1,0
62400,35993,0,0,66,66,0,1,0,1,0
5665,36187,0,0,65,65,0,1,0,1,0
80,37649,0,0,60,60,0,1,0,1,0
49721,30188,0,0,66,66,0,1,0,1,0
40571,26467,0,0,62,62,0,1,0,1,0
64379,37965,0,0,66,66,0,1,0,1,0
56864,22114,0,0,63,63,0,1,0,1,0
443,45788,0,0,239,239,0,1,0,1,0
58638,5900,0,0,62,62,0,1,0,1,0
64577,30771,0,0,64,64,0,1,0,1,0
2095,57401,0,0,117,117,0,1,0,1,0
63786,25174,0,0,62,62,0,1,0,1,0
49422,51788,0,0,102,102,0,1,0,1,0
1044,59795,0,0,145,145,0,1,0,1,0
3478,61463,0,0,995,995,0,1,0,1,0
53062,56205,0,0,65,65,0,1,0,1,0
62111,2767,0,0,66,66,0,1,0,1,0
26072,10456,0,0,142,142,0,1,0,1,0
2029,51505,0,0,62,62,0,1,0,1,0
58038,17,0,0,60,60,0,1,0,1,0
18357,51180,0,0,62,62,0,1,0,1,0
38852,37965,0,0,62,62,0,1,0,1,0
6888,47709,0,0,143,143,0,1,0,1,0
6881,6881,0,0,62,62,0,1,0,1,0
49699,64147,0,0,62,62,0,1,0,1,0
57793,37807,0,0,66,66,0,1,0,1,0
60809,25174,0,0,64,64,0,1,0,1,0
52075,11392,0,0,64,64,0,1,0,1,0
48542,44847,0,0,145,145,0,1,0,1,0
39672,37965,0,0,66,66,0,1,0,1,0
15499,25174,0,0,66,66,0,1,0,1,0
12243,51248,0,0,62,62,0,1,0,1,0
13553,51505,0,0,64,64,0,1,0,1,0
391,37382,0,0,109,109,0,1,0,1,0
58638,5900,0,0,62,62,0,1,0,1,0
38459,22201,0,0,61,61,0,1,0,1,0
60888,50584,0,0,65,65,0,1,0,1,0
60017,48567,0,0,119,119,0,1,0,1,0
49746,6236,0,0,62,62,0,1,0,1,0
52562,22114,0,0,65,65,0,1,0,1,0
1024,25174,0,0,62,62,0,1,0,1,0
51310,64147,0,0,62,62,0,1,0,1,0
60585,51153,0,0,63,63,0,1,0,1,0
58638,5900,0,0,62,62,0,1,0,1,0
5223,14139,0,0,164,164,0,1,0,1,0
24551,57470,0,0,62,62,0,1,0,1,0
7255,43456,0,0,64,64,0,1,0,1,0
11967,57470,0,0,62,62,0,1,0,1,0
61746,50584,0,0,66,66,0,1,0,1,0
19068,37965,0,0,62,62,0,1,0,1,0
50470,61463,0,0,86,86,0,1,0,1,0
51710,57470,0,0,99,99,0,1,0,1,0
12852,37965,0,0,64,64,0,1,0,1,0
58638,5900,0,0,62,62,0,1,0,1,0
26351,22114,0,0,62,62,0,1,0,1,0
56007,57470,0,0,69,69,0,1,0,1,0
51382,56205,0,0,62,62,0,1,0,1,0
42455,22114,0,0,62,62,0,1,0,1,0
58526,21247,0,0,66,66,0,1,0,1,0
26682,57470,0,0,62,62,0,1,0,1,0
35876,42707,0,0,62,62,0,1,0,1,0
27882,23,0,0,60,60,0,1,0,1,0
4679,36178,0,0,126,126,0,1,0,1,0
58638,5900,0,0,62,62,0,1,0,1,0
60454,22114,0,0,66,66,0,1,0,1,0
52838,53646,0,0,64,64,0,1,0,1,0
58638,5900,0,0,62,62,0,1,0,1,0
53519,22114,0,0,62,62,0,1,0,1,0
50085,57470,0,0,66,66,0,1,0,1,0
15915,48900,0,0,140,140,0,1,0,1,0
30413,25174,0,0,85,85,0,1,0,1,0
59105,57470,0,0,66,66,0,1,0,1,0
24592,50584,0,0,62,62,0,1,0,1,0
64376,44847,0,0,62,62,0,1,0,1,0
46734,50265,0,0,74,74,0,1,0,1,0
30283,64257,0,0,65,65,0,1,0,1,0
2390,25174,0,0,146,146,0,1,0,1,0
15465,64147,0,0,64,64,0,1,0,1,0
3009,44847,0,0,63,63,0,1,0,1,0
14023,37965,0,0,62,62,0,1,0,1,0
55419,64147,0,0,66,66,0,1,0,1,0
10213,21247,0,0,64,64,0,1,0,1,0
52687,64147,0,0,64,64,0,1,0,1,0
17830,50584,0,0,63,63,0,1,0,1,0
12608,21247,0,0,66,66,0,1,0,1,0
17548,57470,0,0,62,62,0,1,0,1,0
60743,35440,0,0,63,63,0,1,0,1,0
1128,44847,0,0,62,62,0,1,0,1,0
37856,64147,0,0,65,65,0,1,0,1,0
57777,37902,0,0,63,63,0,1,0,1,0
62838,40,0,0,76,76,0,1,0,1,0
50963,45979,0,0,62,62,0,1,0,1,0
55059,44601,0,0,63,63,0,1,0,1,0
1054,15503,0,0,62,62,0,1,0,1,0
4861,37965,0,0,66,66,0,1,0,1,0
64794,9665,0,0,65,65,0,1,0,1,0
13356,35440,0,0,65,65,0,1,0,1,0
4583,30188,0,0,62,62,0,1,0,1,0
55735,50584,0,0,62,62,0,1,0,1,0
35306,44674,0,0,62,62,0,1,0,1,0
58173,9,0,0,111,111,0,1,0,1,0
64915,46824,0,0,63,63,0,1,0,1,0
50784,57470,0,0,64,64,0,1,0,1,0
1841,8586,0,0,85,85,0,1,0,1,0
52830,22114,0,0,117,117,0,1,0,1,0
5223,59023,0,0,66,66,0,1,0,1,0
50684,43890,0,0,66,66,0,1,0,1,0
11030,17372,0,0,62,62,0,1,0,1,0
61392,50584,0,0,121,121,0,1,0,1,0
1046,26299,0,0,156,156,0,1,0,1,0
18936,35440,0,0,89,89,0,1,0,1,0
51942,56205,0,0,65,65,0,1,0,1,0
2168,22114,0,0,62,62,0,1,0,1,0
61785,42873,0,0,66,66,0,1,0,1,0
58638,5900,0,0,62,62,0,1,0,1,0
35047,56205,0,0,64,64,0,1,0,1,0
54418,44847,0,0,64,64,0,1,0,1,0
45837,25174,0,0,121,121,0,1,0,1,0
28221,37965,0,0,62,62,0,1,0,1,0
58557,35440,0,0,66,66,0,1,0,1,0
62812,25174,0,0,62,62,0,1,0,1,0
51741,57470,0,0,127,127,0,1,0,1,0
39403,36666,0,0,62,62,0,1,0,1,0
59572,25174,0,0,84,84,0,1,0,1,0
57321,62413,0,0,66,66,0,1,0,1,0
12074,10197,0,0,72,72,0,1,0,1,0
27344,21983,0,0,66,66,0,1,0,1,0
63354,37807,0,0,65,65,0,1,0,1,0
30129,37965,0,0,71,71,0,1,0,1,0
57131,35776,0,0,145,145,0,1,0,1,0
58795,51505,0,0,65,65,0,1,0,1,0
61514,37915,0,0,66,66,0,1,0,1,0
58393,15503,0,0,103,103,0,1,0,1,0
58638,5900,0,0,62,62,0,1,0,1,0
53032,35364,0,0,66,66,0,1,0,1,0
16037,25174,0,0,62,62,0,1,0,1,0
3220,50584,0,0,62,62,0,1,0,1,0
57325,60043,0,0,62,62,0,1,0,1,0
7686,25174,0,0,62,62,0,1,0,1,0
56296,1417,0,0,60,60,0,1,0,1,0
57782,57470,0,0,66,66,0,1,0,1,0
64923,25174,0,0,66,66,0,1,0,1,0
60781,50584,0,0,63,63,0,1,0,1,0
52459,5555,0,0,60,60,0,1,0,1,0
60887,48864,0,0,62,62,0,1,0,1,0
4323,64147,0,0,62,62,0,1,0,1,0
13122,35440,0,0,62,62,0,1,0,1,0
40097,17,0,0,60,60,0,1,0,1,0
53906,44512,0,0,62,62,0,1,0,1,0
56731,9571,0,0,66,66,0,1,0,1,0
60789,51050,0,0,66,66,0,1,0,1,0
57015,25174,0,0,66,66,0,1,0,1,0
32215,22114,0,0,65,65,0,1,0,1,0
39617,50584,0,0,62,62,0,1,0,1,0
16944,50584,0,0,141,141,0,1,0,1,0
37957,50341,0,0,85,85,0,1,0,1,0
22542,30188,0,0,62,62,0,1,0,1,0
25665,22114,0,0,110,110,0,1,0,1,0
1025,35447,0,0,62,62,0,1,0,1,0
12551,25174,0,0,139,139,0,1,0,1,0
51414,22,0,0,60,60,0,1,0,1,0
62194,37859,0,0,62,62,0,1,0,1,0
55938,64098,0,0,62,62,0,1,0,1,0
29697,51221,0,0,62,62,0,1,0,1,0
45142,47011,0,0,69,69,0,1,0,1,0
50052,65008,0,0,60,60,0,1,0,1,0
50784,50584,0,0,62,62,0,1,0,1,0
46842,35440,0,0,63,63,0,1,0,1,0
16365,44560,0,0,87,87,0,1,0,1,0
58912,11392,0,0,65,65,0,1,0,1,0
58638,5900,0,0,62,62,0,1,0,1,0
64155,60043,0,0,64,64,0,1,0,1,0
9252,44847,0,0,95,95,0,1,0,1,0
36918,23,0,0,60,60,0,1,0,1,0
58726,64101,0,0,62,62,0,1,0,1,0
6666,138,0,0,60,60,0,1,0,1,0
58638,5900,0,0,62,62,0,1,0,1,0
49307,22114,0,0,65,65,0,1,0,1,0
48556,48718,0,0,149,149,0,1,0,1,0
57131,7838,0,0,145,145,0,1,0,1,0
443,28417,0,0,82,82,0,1,0,1,0
50771,22114,0,0,66,66,0,1,0,1,0
58638,5900,0,0,62,62,0,1,0,1,0
10333,22114,0,0,62,62,0,1,0,1,0
18125,25174,0,0,62,62,0,1,0,1,0
23690,50584,0,0,62,62,0,1,0,1,0
2819,64147,0,0,62,62,0,1,0,1,0
46336,51505,0,0,73,73,0,1,0,1,0
41165,23,0,0,60,60,0,1,0,1,0
0,0,0,0,70,70,0,1,0,1,0
50585,47,0,0,60,60,0,1,0,1,0
53065,35352,0,0,66,66,0,1,0,1,0
48706,23393,0,0,60,60,0,1,0,1,0
1182,64147,0,0,64,64,0,1,0,1,0
58638,5900,0,0,62,62,0,1,0,1,0
41256,50655,0,0,65,65,0,1,0,1,0
19759,64147,0,0,62,62,0,1,0,1,0
59091,57470,0,0,66,66,0,1,0,1,0
31550,46298,0,0,96,96,0,1,0,1,0
6861,57470,0,0,62,62,0,1,0,1,0
443,28417,0,0,82,82,0,1,0,1,0
59563,56205,0,0,65,65,0,1,0,1,0
31247,50584,0,0,78,78,0,1,0,1,0
58190,51505,0,0,66,66,0,1,0,1,0
1190,25174,0,0,109,109,0,1,0,1,0
58640,44847,0,0,65,65,0,1,0,1,0
13297,16883,0,0,62,62,0,1,0,1,0
44849,46478,0,0,74,74,0,1,0,1,0
54786,51505,0,0,62,62,0,1,0,1,0
59295,51066,0,0,66,66,0,1,0,1,0
59943,37807,0,0,62,62,0,1,0,1,0
6885,35851,0,0,62,62,0,1,0,1,0
26206,25174,0,0,66,66,0,1,0,1,0
3653,21023,0,0,126,126,0,1,0,1,0
61516,37965,0,0,66,66,0,1,0,1,0
52519,44847,0,0,62,62,0,1,0,1,0
49426,35927,0,0,63,63,0,1,0,1,0
54047,50011,0,0,66,66,0,1,0,1,0
57131,7934,0,0,145,145,0,1,0,1,0
54288,22114,0,0,62,62,0,1,0,1,0
62922,50584,0,0,62,62,0,1,0,1,0
48283,25174,0,0,110,110,0,1,0,1,0
46270,5882,0,0,60,60,0,1,0,1,0
53458,7,0,0,64,64,0,1,0,1,0
52515,37965,0,0,63,63,0,1,0,1,0
61854,51505,0,0,64,64,0,1,0,1,0
56580,25174,0,0,132,132,0,1,0,1,0
9566,23,0,0,60,60,0,1,0,1,0
58638,5900,0,0,62,62,0,1,0,1,0
57991,30188,0,0,62,62,0,1,0,1,0
2672,23117,0,0,64,64,0,1,0,1,0
63586,46824,0,0,62,62,0,1,0,1,0
1990,35796,0,0,61,61,0,1,0,1,0
4610,50584,0,0,64,64,0,1,0,1,0
60153,22114,0,0,62,62,0,1,0,1,0
59681,64147,0,0,65,65,0,1,0,1,0
9095,51789,0,0,61,61,0,1,0,1,0
9799,32480,0,0,67,67,0,1,0,1,0
55940,36237,0,0,63,63,0,1,0,1,0
57845,50584,0,0,66,66,0,1,0,1,0
51472,25174,0,0,74,74,0,1,0,1,0
54074,5987,0,0,75,75,0,1,0,1,0
20211,22114,0,0,64,64,0,1,0,1,0
52128,37807,0,0,62,62,0,1,0,1,0
49480,56351,0,0,62,62,0,1,0,1,0
7928,2686,0,0,65,65,0,1,0,1,0
54189,22114,0,0,66,66,0,1,0,1,0
45081,38350,0,0,66,66,0,1,0,1,0
53395,17,0,0,61,61,0,1,0,1,0
45964,55559,0,0,60,60,0,1,0,1,0
59153,35440,0,0,65,65,0,1,0,1,0
58638,5900,0,0,62,62,0,1,0,1,0
52529,51221,0,0,71,71,0,1,0,1,0
41721,57470,0,0,62,62,0,1,0,1,0
3976,25174,0,0,62,62,0,1,0,1,0
1972,57470,0,0,78,78,0,1,0,1,0
58638,5900,0,0,62,62,0,1,0,1,0
58760,30188,0,0,66,66,0,1,0,1,0
60817,35440,0,0,66,66,0,1,0,1,0
54079,36237,0,0,62,62,0,1,0,1,0
56614,64147,0,0,62,62,0,1,0,1,0
26471,37965,0,0,64,64,0,1,0,1,0
28080,36237,0,0,71,71,0,1,0,1,0
56084,55381,0,0,66,66,0,1,0,1,0
1078,23,0,0,60,60,0,1,0,1,0
59530,25174,0,0,63,63,0,1,0,1,0
55594,44847,0,0,64,64,0,1,0,1,0
58246,57866,0,0,66,66,0,1,0,1,0
45941,23386,0,0,60,60,0,1,0,1,0
60852,50584,0,0,64,64,0,1,0,1,0
56946,1,0,0,66,66,0,1,0,1,0
9522,51505,0,0,66,66,0,1,0,1,0
59584,36237,0,0,62,62,0,1,0,1,0
4257,50584,0,0,62,62,0,1,0,1,0
31330,35440,0,0,63,63,0,1,0,1,0
58751,22114,0,0,142,142,0,1,0,1,0
4019,50584,0,0,66,66,0,1,0,1,0
3521,6881,0,0,66,66,0,1,0,1,0
43902,44847,0,0,62,62,0,1,0,1,0
58638,5900,0,0,62,62,0,1,0,1,0
10101,11392,0,0,65,65,0,1,0,1,0
60049,25174,0,0,66,66,0,1,0,1,0
48004,21123,0,0,66,66,0,1,0,1,0
53208,26467,0,0,62,62,0,1,0,1,0
10273,21247,0,0,66,66,0,1,0,1,0
57516,30239,0,0,64,64,0,1,0,1,0
13285,29892,0,0,145,145,0,1,0,1,0
58411,18,0,0,60,60,0,1,0,1,0
58866,57470,0,0,65,65,0,1,0,1,0
54226,22114,0,0,64,64,0,1,0,1,0
58638,5900,0,0,62,62,0,1,0,1,0
18445,25174,0,0,62,62,0,1,0,1,0
58022,5569,0,0,60,60,0,1,0,1,0
3117,37965,0,0,62,62,0,1,0,1,0
53073,32468,0,0,64,64,0,1,0,1,0
23776,35365,0,0,63,63,0,1,0,1,0
17640,55442,0,0,63,63,0,1,0,1,0
33826,22114,0,0,62,62,0,1,0,1,0
58669,50584,0,0,66,66,0,1,0,1,0
58638,5900,0,0,62,62,0,1,0,1,0
58638,5900,0,0,62,62,0,1,0,1,0
6666,6379,0,0,60,60,0,1,0,1,0
65270,3855,0,0,78,78,0,1,0,1,0
42330,57470,0,0,64,64,0,1,0,1,0
47013,37965,0,0,62,62,0,1,0,1,0
13383,57470,0,0,62,62,0,1,0,1,0
47727,25174,0,0,62,62,0,1,0,1,0
5090,35498,0,0,68,68,0,1,0,1,0
38651,51505,0,0,62,62,0,1,0,1,0
54796,22114,0,0,63,63,0,1,0,1,0
57911,22114,0,0,146,146,0,1,0,1,0
58638,5900,0,0,62,62,0,1,0,1,0
14052,50584,0,0,62,62,0,1,0,1,0
63370,2416,0,0,60,60,0,1,0,1,0
26501,64147,0,0,62,62,0,1,0,1,0
52326,43890,0,0,64,64,0,1,0,1,0
46361,43477,0,0,68,68,0,1,0,1,0
5047,44378,0,0,64,64,0,1,0,1,0
54965,1433,0,0,60,60,0,1,0,1,0
27446,30188,0,0,66,66,0,1,0,1,0
34938,36142,0,0,70,70,0,1,0,1,0
15539,64147,0,0,63,63,0,1,0,1,0
52094,44847,0,0,64,64,0,1,0,1,0
7249,50584,0,0,66,66,0,1,0,1,0
52759,57709,0,0,62,62,0,1,0,1,0
27062,51234,0,0,71,71,0,1,0,1,0
12668,42707,0,0,62,62,0,1,0,1,0
53283,64097,0,0,66,66,0,1,0,1,0
59451,50584,0,0,64,64,0,1,0,1,0
443,32698,0,0,89,89,0,1,0,1,0
58568,50471,0,0,66,66,0,1,0,1,0
48857,50584,0,0,66,66,0,1,0,1,0
9504,25174,0,0,140,140,0,1,0,1,0
58638,5900,0,0,62,62,0,1,0,1,0
58022,5574,0,0,60,60,0,1,0,1,0
57897,44847,0,0,65,65,0,1,0,1,0
54693,30188,0,0,62,62,0,1,0,1,0
52715,64147,0,0,65,65,0,1,0,1,0
8191,51221,0,0,62,62,0,1,0,1,0
443,48183,0,0,92,92,0,1,0,1,0
44529,26467,0,0,62,62,0,1,0,1,0
48692,57470,0,0,62,62,0,1,0,1,0
59592,37965,0,0,62,62,0,1,0,1,0
50928,44847,0,0,62,62,0,1,0,1,0
6881,6881,0,0,62,62,0,1,0,1,0
62524,57361,0,0,152,152,0,1,0,1,0
3047,50584,0,0,62,62,0,1,0,1,0
58638,5900,0,0,62,62,0,1,0,1,0
7423,22114,0,0,132,132,0,1,0,1,0
50570,44847,0,0,66,66,0,1,0,1,0
448,48117,0,0,97,97,0,1,0,1,0
49942,26467,0,0,66,66,0,1,0,1,0
52324,64147,0,0,65,65,0,1,0,1,0
60896,50520,0,0,66,66,0,1,0,1,0
52499,50588,0,0,62,62,0,1,0,1,0
48300,25174,0,0,62,62,0,1,0,1,0
0,0,0,0,65,65,0,1,0,1,0
48852,50584,0,0,88,88,0,1,0,1,0
58638,5900,0,0,62,62,0,1,0,1,0
60279,37965,0,0,66,66,0,1,0,1,0
33198,50584,0,0,62,62,0,1,0,1,0
443,10010,0,0,60,60,0,1,0,1,0
1025,35447,0,0,62,62,0,1,0,1,0
57372,25174,0,0,112,112,0,1,0,1,0
18298,37903,0,0,63,63,0,1,0,1,0
3541,22114,0,0,62,62,0,1,0,1,0
31597,25174,0,0,141,141,0,1,0,1,0
55423,64147,0,0,66,66,0,1,0,1,0
55893,45711,0,0,78,78,0,1,0,1,0
47817,26528,0,0,87,87,0,1,0,1,0
58531,50584,0,0,123,123,0,1,0,1,0
23414,53590,0,0,62,62,0,1,0,1,0
443,14591,0,0,97,97,0,1,0,1,0
58638,5900,0,0,62,62,0,1,0,1,0
40400,22114,0,0,62,62,0,1,0,1,0
58638,5900,0,0,62,62,0,1,0,1,0
53731,5900,0,0,60,60,0,1,0,1,0
25015,64147,0,0,66,66,0,1,0,1,0
52596,44847,0,0,62,62,0,1,0,1,0
65025,57866,0,0,62,62,0,1,0,1,0
51052,37537,0,0,66,66,0,1,0,1,0
28221,37965,0,0,62,62,0,1,0,1,0
61925,15503,0,0,91,91,0,1,0,1,0
65323,44847,0,0,65,65,0,1,0,1,0
57422,25174,0,0,62,62,0,1,0,1,0
39681,37965,0,0,63,63,0,1,0,1,0
49479,56205,0,0,63,63,0,1,0,1,0
29681,37885,0,0,64,64,0,1,0,1,0
53687,36017,0,0,60,60,0,1,0,1,0
51678,17372,0,0,64,64,0,1,0,1,0
7697,25174,0,0,138,138,0,1,0,1,0
47557,37854,0,0,120,120,0,1,0,1,0
41719,56205,0,0,63,63,0,1,0,1,0
62897,22,0,0,60,60,0,1,0,1,0
56129,37869,0,0,66,66,0,1,0,1,0
22670,30188,0,0,64,64,0,1,0,1,0
51109,11392,0,0,65,65,0,1,0,1,0
46557,25174,0,0,68,68,0,1,0,1,0
23014,10799,0,0,66,66,0,1,0,1,0
40383,25174,0,0,82,82,0,1,0,1,0
57283,31554,0,0,68,68,0,1,0,1,0
59113,25174,0,0,65,65,0,1,0,1,0
60207,48310,0,0,131,131,0,1,0,1,0
56127,37965,0,0,66,66,0,1,0,1,0
58638,5900,0,0,62,62,0,1,0,1,0
14208,51221,0,0,66,66,0,1,0,1,0
45078,50584,0,0,124,124,0,1,0,1,0
52064,22114,0,0,63,63,0,1,0,1,0
61550,5529,0,0,145,145,0,1,0,1,0
50833,64147,0,0,62,62,0,1,0,1,0
56042,26467,0,0,62,62,0,1,0,1,0
50299,43467,0,0,63,63,0,1,0,1,0
10003,64147,0,0,62,62,0,1,0,1,0
59002,22114,0,0,62,62,0,1,0,1,0
56826,22114,0,0,65,65,0,1,0,1,0
51586,3445,0,0,86,86,0,1,0,1,0
1147,57470,0,0,62,62,0,1,0,1,0
52431,50265,0,0,62,62,0,1,0,1,0
29988,44847,0,0,66,66,0,1,0,1,0
58638,5900,0,0,62,62,0,1,0,1,0
36235,23,0,0,60,60,0,1,0,1,0
58291,11848,0,0,68,68,0,1,0,1,0
29697,51221,0,0,62,62,0,1,0,1,0
986,43207,0,0,138,138,0,1,0,1,0
11643,56205,0,0,66,66,0,1,0,1,0
33514,61972,0,0,134,134,0,1,0,1,0
50766,52938,0,0,67,67,0,1,0,1,0
47910,7454,0,0,60,60,0,1,0,1,0
51999,22114,0,0,64,64,0,1,0,1,0
49255,44847,0,0,65,65,0,1,0,1,0
65512,44847,0,0,66,66,0,1,0,1,0
31782,57470,0,0,61,61,0,1,0,1,0
16387,35235,0,0,60,60,0,1,0,1,0
58638,5900,0,0,62,62,0,1,0,1,0
3074,64147,0,0,62,62,0,1,0,1,0
48114,1983,0,0,90,90,0,1,0,1,0
53689,62413,0,0,62,62,0,1,0,1,0
55357,26467,0,0,62,62,0,1,0,1,0
16514,25308,0,0,61,61,0,1,0,1,0
63719,23,0,0,60,60,0,1,0,1,0
46918,64147,0,0,80,80,0,1,0,1,0
57262,37965,0,0,62,62,0,1,0,1,0
1717,22114,0,0,62,62,0,1,0,1,0
33951,50428,0,0,62,62,0,1,0,1,0
58638,5900,0,0,62,62,0,1,0,1,0
29469,26467,0,0,63,63,0,1,0,1,0
50108,35694,0,0,128,128,0,1,0,1,0
6712,123,0,0,90,90,0,1,0,1,0
65357,22114,0,0,65,65,0,1,0,1,0
58638,5900,0,0,62,62,0,1,0,1,0
12853,37965,0,0,62,62,0,1,0,1,0
56274,35349,0,0,63,63,0,1,0,1,0
47161,50584,0,0,62,62,0,1,0,1,0
52238,26467,0,0,62,62,0,1,0,1,0
61600,56205,0,0,64,64,0,1,0,1,0
42928,44440,0,0,64,64,0,1,0,1,0
57131,8055,0,0,145,145,0,1,0,1,0
13654,22114,0,0,143,143,0,1,0,1,0
49317,57470,0,0,65,65,0,1,0,1,0
60123,25192,0,0,128,128,0,1,0,1,0
53517,22114,0,0,62,62,0,1,0,1,0
59338,9220,0,0,62,62,0,1,0,1,0
22683,39210,0,0,60,60,0,1,0,1,0
60913,64147,0,0,72,72,0,1,0,1,0
54128,44847,0,0,66,66,0,1,0,1,0
9348,35440,0,0,66,66,0,1,0,1,0
55124,2682,0,0,64,64,0,1,0,1,0
6881,6881,0,0,62,62,0,1,0,1,0
53436,44847,0,0,66,66,0,1,0,1,0
21542,44847,0,0,65,65,0,1,0,1,0
56084,57515,0,0,62,62,0,1,0,1,0
1024,25174,0,0,62,62,0,1,0,1,0
58638,5900,0,0,62,62,0,1,0,1,0
63852,35440,0,0,62,62,0,1,0,1,0
58638,5900,0,0,62,62,0,1,0,1,0
60155,23718,0,0,66,66,0,1,0,1,0
11136,57587,0,0,62,62,0,1,0,1,0
8239,37965,0,0,146,146,0,1,0,1,0
1733,65448,0,0,65,65,0,1,0,1,0
55600,22,0,0,60,60,0,1,0,1,0
443,21043,0,0,79,79,0,1,0,1,0
57549,35440,0,0,66,66,0,1,0,1,0
47173,35440,0,0,62,62,0,1,0,1,0
21833,22114,0,0,62,62,0,1,0,1,0
11074,44071,0,0,66,66,0,1,0,1,0
58638,5900,0,0,62,62,0,1,0,1,0
993,11931,0,0,65,65,0,1,0,1,0
51999,37965,0,0,62,62,0,1,0,1,0
49165,39793,0,0,161,161,0,1,0,1,0
64818,37965,0,0,62,62,0,1,0,1,0
11478,51221,0,0,66,66,0,1,0,1,0
49555,35828,0,0,115,115,0,1,0,1,0
58638,5900,0,0,62,62,0,1,0,1,0
31845,55777,0,0,62,62,0,1,0,1,0
46951,57470,0,0,71,71,0,1,0,1,0
1480,12447,0,0,64,64,0,1,0,1,0
64185,44847,0,0,64,64,0,1,0,1,0
38395,22114,0,0,62,62,0,1,0,1,0
12673,12006,0,0,63,63,0,1,0,1,0
64233,2642,0,0,86,86,0,1,0,1,0
58638,5900,0,0,62,62,0,1,0,1,0
59988,64147,0,0,66,66,0,1,0,1,0
10799,50584,0,0,62,62,0,1,0,1,0
26660,20341,0,0,63,63,0,1,0,1,0
32673,51221,0,0,66,66,0,1,0,1,0
58638,5900,0,0,62,62,0,1,0,1,0
8186,23,0,0,60,60,0,1,0,1,0
14282,36795,0,0,62,62,0,1,0,1,0
39192,25174,0,0,62,62,0,1,0,1,0
16387,3655,0,0,60,60,0,1,0,1,0
51182,57470,0,0,66,66,0,1,0,1,0
60938,26467,0,0,62,62,0,1,0,1,0
22542,39179,0,0,60,60,0,1,0,1,0
64000,44847,0,0,66,66,0,1,0,1,0
0,0,0,0,70,70,0,1,0,1,0
9037,9444,0,0,60,60,0,1,0,1,0
58638,5900,0,0,62,62,0,1,0,1,0
55990,56205,0,0,66,66,0,1,0,1,0
1025,35447,0,0,62,62,0,1,0,1,0
50877,30041,0,0,62,62,0,1,0,1,0
38625,51505,0,0,62,62,0,1,0,1,0
8876,30430,0,0,61,61,0,1,0,1,0
43430,58085,0,0,93,93,0,1,0,1,0
60074,36237,0,0,63,63,0,1,0,1,0
5202,58457,0,0,66,66,0,1,0,1,0
53228,50584,0,0,66,66,0,1,0,1,0
57545,35440,0,0,66,66,0,1,0,1,0
19847,411,0,0,60,60,0,1,0,1,0
14074,21314,0,0,139,139,0,1,0,1,0
51778,50584,0,0,66,66,0,1,0,1,0
53285,37690,0,0,63,63,0,1,0,1,0
50186,1740,0,0,79,79,0,1,0,1,0
60117,50934,0,0,65,65,0,1,0,1,0
62121,8594,0,0,102,102,0,1,0,1,0
57346,37965,0,0,63,63,0,1,0,1,0
45308,64147,0,0,67,67,0,1,0,1,0
45941,23386,0,0,60,60,0,1,0,1,0
51964,57470,0,0,66,66,0,1,0,1,0
8486,56205,0,0,65,65,0,1,0,1,0
60371,25174,0,0,66,66,0,1,0,1,0
30130,37965,0,0,70,70,0,1,0,1,0
14733,26467,0,0,62,62,0,1,0,1,0
52270,26467,0,0,62,62,0,1,0,1,0
48676,53395,0,0,60,60,0,1,0,1,0
58638,5900,0,0,62,62,0,1,0,1,0
64457,44492,0,0,62,62,0,1,0,1,0
23091,35440,0,0,65,65,0,1,0,1,0
12211,79,0,0,60,60,0,1,0,1,0
50305,37965,0,0,63,63,0,1,0,1,0
10011,64082,0,0,65,65,0,1,0,1,0
19803,37965,0,0,62,62,0,1,0,1,0
1897,57470,0,0,133,133,0,1,0,1,0
29797,7597,0,0,130,130,0,1,0,1,0
26663,57470,0,0,62,62,0,1,0,1,0
62681,57470,0,0,62,62,0,1,0,1,0
8228,47405,0,0,118,118,0,1,0,1,0
63499,22114,0,0,74,74,0,1,0,1,0
51183,56205,0,0,64,64,0,1,0,1,0
38852,37965,0,0,62,62,0,1,0,1,0
13173,35440,0,0,63,63,0,1,0,1,0
16716,64147,0,0,139,139,0,1,0,1,0
27876,22114,0,0,62,62,0,1,0,1,0
3585,64147,0,0,62,62,0,1,0,1,0
52551,30188,0,0,64,64,0,1,0,1,0
59934,35440,0,0,66,66,0,1,0,1,0
11842,35440,0,0,66,66,0,1,0,1,0
50732,36237,0,0,63,63,0,1,0,1,0
60052,25174,0,0,66,66,0,1,0,1,0
12608,21247,0,0,66,66,0,1,0,1,0
43260,41615,0,0,145,145,0,1,0,1,0
57987,56125,0,0,90,90,0,1,0,1,0
52743,50584,0,0,66,66,0,1,0,1,0
38093,11392,0,0,85,85,0,1,0,1,0
52122,17333,0,0,64,64,0,1,0,1,0
19017,50584,0,0,146,146,0,1,0,1,0
59210,8168,0,0,66,66,0,1,0,1,0
10893,50584,0,0,64,64,0,1,0,1,0
35199,31464,0,0,62,62,0,1,0,1,0
57845,26460,0,0,65,65,0,1,0,1,0
11983,57470,0,0,62,62,0,1,0,1,0
59573,56205,0,0,66,66,0,1,0,1,0
11136,17500,0,0,62,62,0,1,0,1,0
44940,57470,0,0,71,71,0,1,0,1,0
52805,56205,0,0,106,106,0,1,0,1,0
58638,5900,0,0,62,62,0,1,0,1,0
9270,57470,0,0,66,66,0,1,0,1,0
1037,57470,0,0,70,70,0,1,0,1,0
63629,22114,0,0,63,63,0,1,0,1,0
34756,22114,0,0,62,62,0,1,0,1,0
13410,44847,0,0,64,64,0,1,0,1,0
23934,41615,0,0,145,145,0,1,0,1,0
53015,64147,0,0,62,62,0,1,0,1,0
34269,25174,0,0,64,64,0,1,0,1,0
12203,37965,0,0,62,62,0,1,0,1,0
7108,56017,0,0,103,103,0,1,0,1,0
57057,44847,0,0,65,65,0,1,0,1,0
61838,37965,0,0,62,62,0,1,0,1,0
59854,22114,0,0,64,64,0,1,0,1,0
12655,62413,0,0,63,63,0,1,0,1,0
47173,35440,0,0,62,62,0,1,0,1,0
33405,37965,0,0,62,62,0,1,0,1,0
55069,44847,0,0,66,66,0,1,0,1,0
56821,25174,0,0,63,63,0,1,0,1,0
56142,55442,0,0,66,66,0,1,0,1,0
57423,62413,0,0,63,63,0,1,0,1,0
58638,5900,0,0,62,62,0,1,0,1,0
750,54641,0,0,73,73,0,1,0,1,0
58638,5900,0,0,62,62,0,1,0,1,0
48082,2183,0,0,104,104,0,1,0,1,0
58638,5900,0,0,62,62,0,1,0,1,0
58638,5900,0,0,62,62,0,1,0,1,0
890,60147,0,0,154,154,0,1,0,1,0
9984,7039,0,0,114,114,0,1,0,1,0
54154,25174,0,0,64,64,0,1,0,1,0
59440,50584,0,0,66,66,0,1,0,1,0
41055,5229,0,0,60,60,0,1,0,1,0
60619,26449,0,0,71,71,0,1,0,1,0
62654,35440,0,0,62,62,0,1,0,1,0
20216,67,0,0,60,60,0,1,0,1,0
40286,57470,0,0,68,68,0,1,0,1,0
3775,64102,0,0,135,135,0,1,0,1,0
1035,26467,0,0,62,62,0,1,0,1,0
48230,57866,0,0,62,62,0,1,0,1,0
64346,51505,0,0,66,66,0,1,0,1,0
35957,51185,0,0,60,60,0,1,0,1,0
58638,5900,0,0,62,62,0,1,0,1,0
55891,35440,0,0,66,66,0,1,0,1,0
60457,35440,0,0,63,63,0,1,0,1,0
39551,37965,0,0,66,66,0,1,0,1,0
14023,37965,0,0,62,62,0,1,0,1,0
63672,64102,0,0,66,66,0,1,0,1,0
16201,7005,0,0,112,112,0,1,0,1,0
65270,3855,0,0,78,78,0,1,0,1,0
62689,34039,0,0,66,66,0,1,0,1,0
58638,5900,0,0,62,62,0,1,0,1,0
6121,51505,0,0,64,64,0,1,0,1,0
56835,35894,0,0,66,66,0,1,0,1,0
51979,57470,0,0,66,66,0,1,0,1,0
58710,43890,0,0,64,64,0,1,0,1,0
58303,1433,0,0,60,60,0,1,0,1,0
38581,22114,0,0,104,104,0,1,0,1,0
50066,30188,0,0,64,64,0,1,0,1,0
30456,36237,0,0,63,63,0,1,0,1,0
24376,50584,0,0,62,62,0,1,0,1,0
6909,64271,0,0,60,60,0,1,0,1,0
9073,51844,0,0,61,61,0,1,0,1,0
37613,50568,0,0,66,66,0,1,0,1,0
1024,25174,0,0,62,62,0,1,0,1,0
24806,37965,0,0,62,62,0,1,0,1,0
5764,44847,0,0,66,66,0,1,0,1,0
45908,33330,0,0,60,60,0,1,0,1,0
58638,5900,0,0,62,62,0,1,0,1,0
43916,21,0,0,60,60,0,1,0,1,0
37034,25174,0,0,62,62,0,1,0,1,0
5087,22114,0,0,66,66,0,1,0,1,0
10192,22114,0,0,62,62,0,1,0,1,0
58007,62413,0,0,62,62,0,1,0,1,0
41785,1610,0,0,90,90,0,1,0,1,0
36671,25174,0,0,66,66,0,1,0,1,0
3478,61463,0,0,249,249,0,1,0,1,0
62080,54532,0,0,60,60,0,1,0,1,0
31674,25174,0,0,121,121,0,1,0,1,0
16477,37807,0,0,66,66,0,1,0,1,0
26131,1469,0,0,60,60,0,1,0,1,0
15004,50584,0,0,62,62,0,1,0,1,0
50995,30153,0,0,66,66,0,1,0,1,0
58638,5900,0,0,62,62,0,1,0,1,0
33290,50584,0,0,63,63,0,1,0,1,0
56417,1421,0,0,60,60,0,1,0,1,0
45923,44847,0,0,91,91,0,1,0,1,0
22547,48817,0,0,72,72,0,1,0,1,0
52234,51505,0,0,117,117,0,1,0,1,0
41359,50584,0,0,75,75,0,1,0,1,0
43269,50584,0,0,65,65,0,1,0,1,0
19477,23117,0,0,64,64,0,1,0,1,0
50902,48784,0,0,67,67,0,1,0,1,0
49315,21247,0,0,62,62,0,1,0,1,0
35555,22114,0,0,62,62,0,1,0,1,0
49289,51505,0,0,66,66,0,1,0,1,0
59048,57470,0,0,66,66,0,1,0,1,0
5672,35930,0,0,64,64,0,1,0,1,0
50095,30188,0,0,62,62,0,1,0,1,0
26257,21585,0,0,64,64,0,1,0,1,0
12986,64147,0,0,128,128,0,1,0,1,0
7535,64147,0,0,62,62,0,1,0,1,0
53771,57470,0,0,66,66,0,1,0,1,0
64558,50381,0,0,64,64,0,1,0,1,0
38852,37965,0,0,62,62,0,1,0,1,0
6666,5000,0,0,60,60,0,1,0,1,0
58638,5900,0,0,62,62,0,1,0,1,0
34337,35584,0,0,65,65,0,1,0,1,0
42968,56205,0,0,88,88,0,1,0,1,0
26804,51221,0,0,74,74,0,1,0,1,0
59432,8150,0,0,78,78,0,1,0,1,0
59509,64147,0,0,62,62,0,1,0,1,0
3281,53424,0,0,65,65,0,1,0,1,0
64283,37962,0,0,75,75,0,1,0,1,0
58638,5900,0,0,62,62,0,1,0,1,0
22877,9766,0,0,62,62,0,1,0,1,0
52326,51378,0,0,69,69,0,1,0,1,0
39098,51505,0,0,62,62,0,1,0,1,0
54293,22114,0,0,62,62,0,1,0,1,0
61523,51022,0,0,66,66,0,1,0,1,0
51952,26467,0,0,61,61,0,1,0,1,0
43040,57470,0,0,62,62,0,1,0,1,0
50084,26672,0,0,62,62,0,1,0,1,0
61549,37807,0,0,66,66,0,1,0,1,0
38138,11392,0,0,136,136,0,1,0,1,0
443,46124,0,0,77,77,0,1,0,1,0
25022,30192,0,0,61,61,0,1,0,1,0
54412,26467,0,0,62,62,0,1,0,1,0
50438,64147,0,0,66,66,0,1,0,1,0
56128,37912,0,0,66,66,0,1,0,1,0
34993,15503,0,0,62,62,0,1,0,1,0
24376,50584,0,0,65,65,0,1,0,1,0
43740,50714,0,0,145,145,0,1,0,1,0
0,0,0,0,98,98,0,1,0,1,0
54093,26467,0,0,62,62,0,1,0,1,0
56376,44847,0,0,65,65,0,1,0,1,0
49579,57470,0,0,67,67,0,1,0,1,0
5644,37965,0,0,63,63,0,1,0,1,0
40834,50584,0,0,143,143,0,1,0,1,0
18750,57866,0,0,100,100,0,1,0,1,0
60356,11415,0,0,66,66,0,1,0,1,0
443,45788,0,0,199,199,0,1,0,1,0
58625,44847,0,0,66,66,0,1,0,1,0
43879,6288,0,0,94,94,0,1,0,1,0
51225,7759,0,0,61,61,0,1,0,1,0
58638,5900,0,0,62,62,0,1,0,1,0
63000,44847,0,0,62,62,0,1,0,1,0
9024,44847,0,0,63,63,0,1,0,1,0
13276,51043,0,0,66,66,0,1,0,1,0
58638,5900,0,0,62,62,0,1,0,1,0
443,28417,0,0,82,82,0,1,0,1,0
56913,36039,0,0,66,66,0,1,0,1,0
59661,41340,0,0,63,63,0,1,0,1,0
10006,64147,0,0,62,62,0,1,0,1,0
7034,62332,0,0,102,102,0,1,0,1,0
24376,50584,0,0,62,62,0,1,0,1,0
58638,5900,0,0,62,62,0,1,0,1,0
10325,32480,0,0,65,65,0,1,0,1,0
26732,57470,0,0,65,65,0,1,0,1,0
1865,25174,0,0,62,62,0,1,0,1,0
60312,57470,0,0,74,74,0,1,0,1,0
16077,50584,0,0,64,64,0,1,0,1,0
1693,30342,0,0,144,144,0,1,0,1,0
58638,5900,0,0,62,62,0,1,0,1,0
45969,51468,0,0,62,62,0,1,0,1,0
63045,37965,0,0,64,64,0,1,0,1,0
49663,22114,0,0,63,63,0,1,0,1,0
33822,57470,0,0,66,66,0,1,0,1,0
15197,51505,0,0,62,62,0,1,0,1,0
28368,50584,0,0,62,62,0,1,0,1,0
58638,5900,0,0,62,62,0,1,0,1,0
61233,22114,0,0,63,63,0,1,0,1,0
38782,25174,0,0,146,146,0,1,0,1,0
37993,2425,0,0,60,60,0,1,0,1,0
58358,21,0,0,64,64,0,1,0,1,0
19046,23383,0,0,64,64,0,1,0,1,0
39754,35549,0,0,134,134,0,1,0,1,0
52914,37965,0,0,66,66,0,1,0,1,0
26816,50441,0,0,64,64,0,1,0,1,0
44291,26467,0,0,62,62,0,1,0,1,0
59879,15051,0,0,124,124,0,1,0,1,0
55710,5900,0,0,60,60,0,1,0,1,0
58638,5900,0,0,62,62,0,1,0,1,0
49887,21247,0,0,66,66,0,1,0,1,0
51045,25174,0,0,66,66,0,1,0,1,0
36380,50584,0,0,102,102,0,1,0,1,0
5222,7493,0,0,66,66,0,1,0,1,0
48258,37965,0,0,62,62,0,1,0,1,0
52631,44847,0,0,66,66,0,1,0,1,0
39570,19061,0,0,62,62,0,1,0,1,0
64832,64147,0,0,63,63,0,1,0,1,0
62174,22114,0,0,66,66,0,1,0,1,0
6848,51505,0,0,65,65,0,1,0,1,0
50562,43890,0,0,62,62,0,1,0,1,0
60961,48992,0,0,67,67,0,1,0,1,0
26052,36222,0,0,65,65,0,1,0,1,0
49558,50584,0,0,65,65,0,1,0,1,0
12348,50265,0,0,62,62,0,1,0,1,0
64592,9598,0,0,62,62,0,1,0,1,0
10003,64147,0,0,62,62,0,1,0,1,0
60036,30188,0,0,64,64,0,1,0,1,0
5187,5029,0,0,218,218,0,1,0,1,0
41208,34,0,0,79,79,0,1,0,1,0
52941,44847,0,0,66,66,0,1,0,1,0
62773,62413,0,0,62,62,0,1,0,1,0
2910,7302,0,0,63,63,0,1,0,1,0
54358,64147,0,0,62,62,0,1,0,1,0
61774,11392,0,0,64,64,0,1,0,1,0
46275,64147,0,0,62,62,0,1,0,1,0
62792,53,0,0,88,88,0,1,0,1,0
49191,35440,0,0,65,65,0,1,0,1,0
3818,37965,0,0,66,66,0,1,0,1,0
61550,5529,0,0,145,145,0,1,0,1,0
55479,57470,0,0,70,70,0,1,0,1,0
10004,64147,0,0,62,62,0,1,0,1,0
1942,57470,0,0,100,100,0,1,0,1,0
60579,25174,0,0,66,66,0,1,0,1,0
43129,20220,0,0,62,62,0,1,0,1,0
42942,50227,0,0,63,63,0,1,0,1,0
33949,44847,0,0,64,64,0,1,0,1,0
64691,25320,0,0,66,66,0,1,0,1,0
58638,5900,0,0,62,62,0,1,0,1,0
63221,53436,0,0,62,62,0,1,0,1,0
57762,25174,0,0,111,111,0,1,0,1,0
58815,51505,0,0,66,66,0,1,0,1,0
3478,61463,0,0,934,934,0,1,0,1,0
49284,21247,0,0,62,62,0,1,0,1,0
52748,56205,0,0,87,87,0,1,0,1,0
13285,29892,0,0,145,145,0,1,0,1,0
49915,35440,0,0,69,69,0,1,0,1,0
46752,57470,0,0,62,62,0,1,0,1,0
62340,50584,0,0,66,66,0,1,0,1,0
54622,36237,0,0,66,66,0,1,0,1,0
11344,42873,0,0,62,62,0,1,0,1,0
13965,37965,0,0,88,88,0,1,0,1,0
58638,5900,0,0,62,62,0,1,0,1,0
1024,64147,0,0,62,62,0,1,0,1,0
45964,2666,0,0,60,60,0,1,0,1,0
48826,25174,0,0,64,64,0,1,0,1,0
7892,50584,0,0,62,62,0,1,0,1,0
22973,64147,0,0,64,64,0,1,0,1,0
3964,51505,0,0,62,62,0,1,0,1,0
40429,28641,0,0,138,138,0,1,0,1,0
57991,22114,0,0,65,65,0,1,0,1,0
47510,26482,0,0,61,61,0,1,0,1,0
48706,23393,0,0,60,60,0,1,0,1,0
57339,50584,0,0,66,66,0,1,0,1,0
55428,25174,0,0,66,66,0,1,0,1,0
60093,62413,0,0,66,66,0,1,0,1,0
36566,50584,0,0,87,87,0,1,0,1,0
58638,5900,0,0,62,62,0,1,0,1,0
26921,37965,0,0,62,62,0,1,0,1,0
60855,35440,0,0,66,66,0,1,0,1,0
58638,5900,0,0,62,62,0,1,0,1,0
63607,30188,0,0,63,63,0,1,0,1,0
443,1721,0,0,95,95,0,1,0,1,0
58638,5900,0,0,62,62,0,1,0,1,0
10681,25174,0,0,146,146,0,1,0,1,0
10006,64147,0,0,62,62,0,1,0,1,0
47173,35440,0,0,98,98,0,1,0,1,0
13577,1810,0,0,62,62,0,1,0,1,0
52624,36237,0,0,62,62,0,1,0,1,0
45964,2225,0,0,60,60,0,1,0,1,0
18037,23,0,0,60,60,0,1,0,1,0
25032,47738,0,0,118,118,0,1,0,1,0
47910,7454,0,0,60,60,0,1,0,1,0
45964,3111,0,0,60,60,0,1,0,1,0
63297,44847,0,0,62,62,0,1,0,1,0
443,49286,0,0,94,94,0,1,0,1,0
31785,56040,0,0,62,62,0,1,0,1,0
41003,5002,0,0,60,60,0,1,0,1,0
58638,5900,0,0,62,62,0,1,0,1,0
57860,51505,0,0,64,64,0,1,0,1,0
51163,26467,0,0,66,66,0,1,0,1,0
59670,50584,0,0,62,62,0,1,0,1,0
62832,44847,0,0,71,71,0,1,0,1,0
65194,50584,0,0,62,62,0,1,0,1,0
5926,25174,0,0,124,124,0,1,0,1,0
58638,5900,0,0,62,62,0,1,0,1,0
41826,2079,0,0,60,60,0,1,0,1,0
43997,44847,0,0,66,66,0,1,0,1,0
45964,5333,0,0,60,60,0,1,0,1,0
45941,23386,0,0,60,60,0,1,0,1,0
49336,25174,0,0,64,64,0,1,0,1,0
52738,22114,0,0,62,62,0,1,0,1,0
1531,30104,0,0,62,62,0,1,0,1,0
56378,51505,0,0,62,62,0,1,0,1,0
30181,61689,0,0,62,62,0,1,0,1,0
7107,25174,0,0,66,66,0,1,0,1,0
57987,56125,0,0,90,90,0,1,0,1,0
443,50075,0,0,74,74,0,1,0,1,0
12545,35440,0,0,65,65,0,1,0,1,0
54765,21247,0,0,66,66,0,1,0,1,0
59465,21247,0,0,66,66,0,1,0,1,0
52863,50584,0,0,66,66,0,1,0,1,0
43707,62687,0,0,117,117,0,1,0,1,0
58638,5900,0,0,62,62,0,1,0,1,0
40092,22,0,0,60,60,0,1,0,1,0
19098,50584,0,0,126,126,0,1,0,1,0
55116,7574,0,0,64,64,0,1,0,1,0
2627,64147,0,0,62,62,0,1,0,1,0
1536,50584,0,0,146,146,0,1,0,1,0
54666,36237,0,0,62,62,0,1,0,1,0
35835,35440,0,0,62,62,0,1,0,1,0
3992,51505,0,0,62,62,0,1,0,1,0
12383,64147,0,0,71,71,0,1,0,1,0
2505,11392,0,0,117,117,0,1,0,1,0
56824,26467,0,0,64,64,0,1,0,1,0
39107,57305,0,0,62,62,0,1,0,1,0
62043,25174,0,0,82,82,0,1,0,1,0
7332,50584,0,0,66,66,0,1,0,1,0
27216,64147,0,0,64,64,0,1,0,1,0
12660,11730,0,0,62,62,0,1,0,1,0
34932,38608,0,0,62,62,0,1,0,1,0
26494,26467,0,0,62,62,0,1,0,1,0
21716,22114,0,0,62,62,0,1,0,1,0
57545,35440,0,0,66,66,0,1,0,1,0
22470,25174,0,0,63,63,0,1,0,1,0
6881,33499,0,0,152,152,0,1,0,1,0
62788,62413,0,0,62,62,0,1,0,1,0
40084,22,0,0,60,60,0,1,0,1,0
41649,25174,0,0,66,66,0,1,0,1,0
45908,33330,0,0,60,60,0,1,0,1,0
64677,57470,0,0,66,66,0,1,0,1,0
64941,44738,0,0,66,66,0,1,0,1,0
54616,56205,0,0,63,63,0,1,0,1,0
50635,50584,0,0,66,66,0,1,0,1,0
57166,35747,0,0,138,138,0,1,0,1,0
35894,12,0,0,102,102,0,1,0,1,0
44423,37922,0,0,62,62,0,1,0,1,0
16719,41861,0,0,93,93,0,1,0,1,0
443,29326,0,0,82,82,0,1,0,1,0
58910,57470,0,0,83,83,0,1,0,1,0
14170,3,0,0,61,61,0,1,0,1,0
58638,5900,0,0,62,62,0,1,0,1,0
10205,50584,0,0,128,128,0,1,0,1,0
53575,56101,0,0,135,135,0,1,0,1,0
60079,188,0,0,81,81,0,1,0,1,0
62122,56205,0,0,64,64,0,1,0,1,0
34392,64147,0,0,142,142,0,1,0,1,0
51445,53411,0,0,76,76,0,1,0,1,0
443,49988,0,0,82,82,0,1,0,1,0
65270,3855,0,0,78,78,0,1,0,1,0
63116,22114,0,0,62,62,0,1,0,1,0
51735,25174,0,0,63,63,0,1,0,1,0
46495,4607,0,0,60,60,0,1,0,1,0
10058,25305,0,0,62,62,0,1,0,1,0
58638,5900,0,0,62,62,0,1,0,1,0
58739,64107,0,0,62,62,0,1,0,1,0
38852,37965,0,0,62,62,0,1,0,1,0
47943,50584,0,0,74,74,0,1,0,1,0
53459,37807,0,0,145,145,0,1,0,1,0
52956,64108,0,0,65,65,0,1,0,1,0
58022,8722,0,0,60,60,0,1,0,1,0
63083,64147,0,0,66,66,0,1,0,1,0
26011,7725,0,0,64,64,0,1,0,1,0
443,64347,0,0,122,122,0,1,0,1,0
58638,5900,0,0,62,62,0,1,0,1,0
41448,25174,0,0,64,64,0,1,0,1,0
18160,20,0,0,60,60,0,1,0,1,0
13985,29993,0,0,145,145,0,1,0,1,0
45915,44847,0,0,62,62,0,1,0,1,0
3478,61463,0,0,159,159,0,1,0,1,0
24977,1538,0,0,60,60,0,1,0,1,0
53820,42832,0,0,71,71,0,1,0,1,0
1024,64147,0,0,62,62,0,1,0,1,0
26502,64147,0,0,62,62,0,1,0,1,0
55437,50584,0,0,66,66,0,1,0,1,0
58638,5900,0,0,62,62,0,1,0,1,0
63889,35440,0,0,66,66,0,1,0,1,0
59541,25174,0,0,135,135,0,1,0,1,0
47227,7771,0,0,122,122,0,1,0,1,0
6132,25174,0,0,66,66,0,1,0,1,0
15465,64147,0,0,66,66,0,1,0,1,0
8999,57470,0,0,146,146,0,1,0,1,0
15701,37965,0,0,146,146,0,1,0,1,0
62799,37870,0,0,66,66,0,1,0,1,0
58651,64129,0,0,63,63,0,1,0,1,0
42886,55914,0,0,121,121,0,1,0,1,0
57015,42707,0,0,62,62,0,1,0,1,0
58501,30279,0,0,63,63,0,1,0,1,0
1045,36237,0,0,64,64,0,1,0,1,0
15836,49132,0,0,144,144,0,1,0,1,0
41012,1433,0,0,60,60,0,1,0,1,0
53300,37807,0,0,65,65,0,1,0,1,0
27886,52517,0,0,62,62,0,1,0,1,0
58638,5900,0,0,62,62,0,1,0,1,0
58638,5900,0,0,62,62,0,1,0,1,0
15565,64147,0,0,62,62,0,1,0,1,0
44905,57470,0,0,66,66,0,1,0,1,0
58638,5900,0,0,62,62,0,1,0,1,0
6242,37965,0,0,62,62,0,1,0,1,0
3943,17372,0,0,65,65,0,1,0,1,0
11136,19910,0,0,134,134,0,1,0,1,0
54044,64147,0,0,66,66,0,1,0,1,0
57394,34168,0,0,87,87,0,1,0,1,0
47771,25174,0,0,62,62,0,1,0,1,0
53966,57470,0,0,62,62,0,1,0,1,0
64198,25174,0,0,65,65,0,1,0,1,0
29529,37853,0,0,64,64,0,1,0,1,0
60312,57470,0,0,74,74,0,1,0,1,0
61119,50284,0,0,71,71,0,1,0,1,0
43985,6554,0,0,117,117,0,1,0,1,0
7718,57470,0,0,64,64,0,1,0,1,0
50757,64147,0,0,66,66,0,1,0,1,0
56843,44847,0,0,62,62,0,1,0,1,0
50722,57470,0,0,66,66,0,1,0,1,0
63297,30531,0,0,117,117,0,1,0,1,0
22530,24359,0,0,64,64,0,1,0,1,0
35054,21,0,0,60,60,0,1,0,1,0
56386,50584,0,0,64,64,0,1,0,1,0
57094,26461,0,0,64,64,0,1,0,1,0
11942,57470,0,0,64,64,0,1,0,1,0
25048,50599,0,0,125,125,0,1,0,1,0
56050,51505,0,0,140,140,0,1,0,1,0
13188,35440,0,0,66,66,0,1,0,1,0
59223,17500,0,0,66,66,0,1,0,1,0
56374,22114,0,0,63,63,0,1,0,1,0
61109,54377,0,0,62,62,0,1,0,1,0
57388,25174,0,0,62,62,0,1,0,1,0
21998,51221,0,0,62,62,0,1,0,1,0
54976,15503,0,0,64,64,0,1,0,1,0
6885,8401,0,0,143,143,0,1,0,1,0
60107,22114,0,0,64,64,0,1,0,1,0
36597,25174,0,0,64,64,0,1,0,1,0
11493,51498,0,0,144,144,0,1,0,1,0
17315,11392,0,0,65,65,0,1,0,1,0
10003,64147,0,0,62,62,0,1,0,1,0
10085,63255,0,0,111,111,0,1,0,1,0
65200,51050,0,0,62,62,0,1,0,1,0
14862,42524,0,0,80,80,0,1,0,1,0
27705,36001,0,0,88,88,0,1,0,1,0
57131,35776,0,0,145,145,0,1,0,1,0
44706,37943,0,0,62,62,0,1,0,1,0
62801,37909,0,0,66,66,0,1,0,1,0
55992,56205,0,0,63,63,0,1,0,1,0
3117,37965,0,0,62,62,0,1,0,1,0
5554,64147,0,0,77,77,0,1,0,1,0
43584,24748,0,0,156,156,0,1,0,1,0
27424,23,0,0,60,60,0,1,0,1,0
56341,22114,0,0,62,62,0,1,0,1,0
10688,25174,0,0,145,145,0,1,0,1,0
58638,5900,0,0,62,62,0,1,0,1,0
59579,57470,0,0,66,66,0,1,0,1,0
50095,30199,0,0,62,62,0,1,0,1,0
52674,64147,0,0,120,120,0,1,0,1,0
54547,25174,0,0,83,83,0,1,0,1,0
48706,23393,0,0,60,60,0,1,0,1,0
43671,17372,0,0,62,62,0,1,0,1,0
80,53945,0,0,60,60,0,1,0,1,0
16944,50584,0,0,96,96,0,1,0,1,0
63351,54532,0,0,75,75,0,1,0,1,0
53946,44847,0,0,66,66,0,1,0,1,0
55839,42927,0,0,62,62,0,1,0,1,0
51952,44847,0,0,62,62,0,1,0,1,0
58638,5900,0,0,62,62,0,1,0,1,0
59435,22114,0,0,66,66,0,1,0,1,0
41955,43,0,0,64,64,0,1,0,1,0
29437,37807,0,0,66,66,0,1,0,1,0
625,8413,0,0,116,116,0,1,0,1,0
59842,62413,0,0,65,65,0,1,0,1,0
63331,51221,0,0,62,62,0,1,0,1,0
3575,25174,0,0,62,62,0,1,0,1,0
36437,35440,0,0,62,62,0,1,0,1,0
61177,48906,0,0,62,62,0,1,0,1,0
53453,25174,0,0,142,142,0,1,0,1,0
59529,25174,0,0,63,63,0,1,0,1,0
63354,51272,0,0,62,62,0,1,0,1,0
55915,43890,0,0,66,66,0,1,0,1,0
3439,61558,0,0,67,67,0,1,0,1,0
36608,50584,0,0,146,146,0,1,0,1,0
22636,30188,0,0,62,62,0,1,0,1,0
53143,50584,0,0,66,66,0,1,0,1,0
58638,5900,0,0,62,62,0,1,0,1,0
7222,57470,0,0,62,62,0,1,0,1,0
63711,50584,0,0,66,66,0,1,0,1,0
16387,16862,0,0,60,60,0,1,0,1,0
62014,8876,0,0,61,61,0,1,0,1,0
52851,53639,0,0,63,63,0,1,0,1,0
57761,57470,0,0,65,65,0,1,0,1,0
63996,36829,0,0,62,62,0,1,0,1,0
18011,44847,0,0,64,64,0,1,0,1,0
58486,57470,0,0,66,66,0,1,0,1,0
58399,56205,0,0,63,63,0,1,0,1,0
2873,25174,0,0,92,92,0,1,0,1,0
60962,64147,0,0,66,66,0,1,0,1,0
31300,35440,0,0,63,63,0,1,0,1,0
47107,8084,0,0,155,155,0,1,0,1,0
11371,22,0,0,60,60,0,1,0,1,0
982,38367,0,0,66,66,0,1,0,1,0
56563,64147,0,0,62,62,0,1,0,1,0
3937,36829,0,0,62,62,0,1,0,1,0
64694,25306,0,0,66,66,0,1,0,1,0
57131,31061,0,0,145,145,0,1,0,1,0
15153,25174,0,0,62,62,0,1,0,1,0
59607,25174,0,0,62,62,0,1,0,1,0
5055,44364,0,0,64,64,0,1,0,1,0
2927,25174,0,0,62,62,0,1,0,1,0
26053,33720,0,0,160,160,0,1,0,1,0
58486,57470,0,0,66,66,0,1,0,1,0
43916,21,0,0,60,60,0,1,0,1,0
58638,5900,0,0,62,62,0,1,0,1,0
11136,15503,0,0,62,62,0,1,0,1,0
61242,35253,0,0,62,62,0,1,0,1,0
56676,37965,0,0,66,66,0,1,0,1,0
443,22845,0,0,92,92,0,1,0,1,0
57626,28517,0,0,63,63,0,1,0,1,0
56385,25174,0,0,62,62,0,1,0,1,0
443,62451,0,0,157,157,0,1,0,1,0
1699,51393,0,0,64,64,0,1,0,1,0
43732,35354,0,0,69,69,0,1,0,1,0
47745,25174,0,0,146,146,0,1,0,1,0
62088,35440,0,0,63,63,0,1,0,1,0
38570,22114,0,0,90,90,0,1,0,1,0
44901,57759,0,0,70,70,0,1,0,1,0
31021,35440,0,0,86,86,0,1,0,1,0
50878,53733,0,0,62,62,0,1,0,1,0
146,54587,0,0,68,68,0,1,0,1,0
1412,51189,0,0,124,124,0,1,0,1,0
58997,64103,0,0,66,66,0,1,0,1,0
11716,37965,0,0,62,62,0,1,0,1,0
65025,57866,0,0,62,62,0,1,0,1,0
11508,51310,0,0,66,66,0,1,0,1,0
59037,51505,0,0,62,62,0,1,0,1,0
48857,50584,0,0,66,66,0,1,0,1,0
54189,22114,0,0,66,66,0,1,0,1,0
58638,5900,0,0,62,62,0,1,0,1,0
1024,64147,0,0,62,62,0,1,0,1,0
39190,23,0,0,60,60,0,1,0,1,0
2288,25174,0,0,146,146,0,1,0,1,0
16387,35307,0,0,60,60,0,1,0,1,0
443,10010,0,0,60,60,0,1,0,1,0
52223,62225,0,0,66,66,0,1,0,1,0
46440,64147,0,0,62,62,0,1,0,1,0
45908,33330,0,0,60,60,0,1,0,1,0
61857,35440,0,0,66,66,0,1,0,1,0
28502,64147,0,0,62,62,0,1,0,1,0
54989,50265,0,0,66,66,0,1,0,1,0
64722,25190,0,0,66,66,0,1,0,1,0
46535,4560,0,0,60,60,0,1,0,1,0
49899,23,0,0,60,60,0,1,0,1,0
54510,26467,0,0,63,63,0,1,0,1,0
58638,5900,0,0,62,62,0,1,0,1,0
25463,2323,0,0,60,60,0,1,0,1,0
56711,25174,0,0,62,62,0,1,0,1,0
51519,50584,0,0,62,62,0,1,0,1,0
9246,57470,0,0,66,66,0,1,0,1,0
58638,5900,0,0,62,62,0,1,0,1,0
57093,57470,0,0,62,62,0,1,0,1,0
9261,2323,0,0,60,60,0,1,0,1,0
51622,50321,0,0,66,66,0,1,0,1,0
6923,55108,0,0,139,139,0,1,0,1,0
62812,37807,0,0,62,62,0,1,0,1,0
22916,25174,0,0,62,62,0,1,0,1,0
42301,26390,0,0,99,99,0,1,0,1,0
56310,15503,0,0,146,146,0,1,0,1,0
3016,7302,0,0,65,65,0,1,0,1,0
14148,1,0,0,62,62,0,1,0,1,0
35651,30188,0,0,81,81,0,1,0,1,0
54143,5955,0,0,69,69,0,1,0,1,0
31572,64147,0,0,62,62,0,1,0,1,0
14488,276,0,0,62,62,0,1,0,1,0
4161,35440,0,0,63,63,0,1,0,1,0
54786,30188,0,0,66,66,0,1,0,1,0
54530,35440,0,0,66,66,0,1,0,1,0
2283,51505,0,0,66,66,0,1,0,1,0
54189,64147,0,0,66,66,0,1,0,1,0
26471,25174,0,0,64,64,0,1,0,1,0
59315,35440,0,0,65,65,0,1,0,1,0
16590,25174,0,0,62,62,0,1,0,1,0
55921,43890,0,0,66,66,0,1,0,1,0
2780,23117,0,0,65,65,0,1,0,1,0
53024,35367,0,0,66,66,0,1,0,1,0
45682,37965,0,0,62,62,0,1,0,1,0
51655,26467,0,0,62,62,0,1,0,1,0
44174,6881,0,0,73,73,0,1,0,1,0
58638,5900,0,0,62,62,0,1,0,1,0
57273,31523,0,0,70,70,0,1,0,1,0
53928,15503,0,0,62,62,0,1,0,1,0
52627,36237,0,0,74,74,0,1,0,1,0
3483,11392,0,0,66,66,0,1,0,1,0
26656,25174,0,0,146,146,0,1,0,1,0
1873,37965,0,0,62,62,0,1,0,1,0
43584,24748,0,0,156,156,0,1,0,1,0
28942,8392,0,0,61,61,0,1,0,1,0
26944,25174,0,0,62,62,0,1,0,1,0
63736,25174,0,0,62,62,0,1,0,1,0
49855,36180,0,0,62,62,0,1,0,1,0
26752,64147,0,0,62,62,0,1,0,1,0
60390,26467,0,0,65,65,0,1,0,1,0
63827,38078,0,0,64,64,0,1,0,1,0
49516,35894,0,0,62,62,0,1,0,1,0
50292,22114,0,0,63,63,0,1,0,1,0
64615,57470,0,0,66,66,0,1,0,1,0
13441,57470,0,0,62,62,0,1,0,1,0
3580,25174,0,0,62,62,0,1,0,1,0
22118,44847,0,0,62,62,0,1,0,1,0
1663,30188,0,0,63,63,0,1,0,1,0
39626,18469,0,0,63,63,0,1,0,1,0
19104,37965,0,0,62,62,0,1,0,1,0
19875,30170,0,0,145,145,0,1,0,1,0
53491,42707,0,0,66,66,0,1,0,1,0
45908,33330,0,0,60,60,0,1,0,1,0
14142,48688,0,0,60,60,0,1,0,1,0
58471,11392,0,0,66,66,0,1,0,1,0
49485,56972,0,0,66,66,0,1,0,1,0
60248,46776,0,0,66,66,0,1,0,1,0
42722,56448,0,0,73,73,0,1,0,1,0
43926,22114,0,0,62,62,0,1,0,1,0
25337,5836,0,0,60,60,0,1,0,1,0
26779,50584,0,0,64,64,0,1,0,1,0
22005,55897,0,0,69,69,0,1,0,1,0
24071,22173,0,0,61,61,0,1,0,1,0
49196,51505,0,0,129,129,0,1,0,1,0
6891,55108,0,0,142,142,0,1,0,1,0
49485,56972,0,0,64,64,0,1,0,1,0
57468,57470,0,0,66,66,0,1,0,1,0
11235,30188,0,0,63,63,0,1,0,1,0
57098,51505,0,0,62,62,0,1,0,1,0
2530,23117,0,0,64,64,0,1,0,1,0
57500,37965,0,0,62,62,0,1,0,1,0
14523,25174,0,0,63,63,0,1,0,1,0
63457,55147,0,0,66,66,0,1,0,1,0
53676,35974,0,0,60,60,0,1,0,1,0
30406,57470,0,0,61,61,0,1,0,1,0
23553,37965,0,0,62,62,0,1,0,1,0
3951,25174,0,0,62,62,0,1,0,1,0
58638,5900,0,0,62,62,0,1,0,1,0
23596,9866,0,0,90,90,0,1,0,1,0
22559,30188,0,0,66,66,0,1,0,1,0
45682,37965,0,0,62,62,0,1,0,1,0
48857,50584,0,0,66,66,0,1,0,1,0
39132,44847,0,0,66,66,0,1,0,1,0
58638,5900,0,0,62,62,0,1,0,1,0
23717,41615,0,0,145,145,0,1,0,1,0
443,1741,0,0,95,95,0,1,0,1,0
39721,62413,0,0,75,75,0,1,0,1,0
38925,57334,0,0,62,62,0,1,0,1,0
45941,23386,0,0,60,60,0,1,0,1,0
54197,64126,0,0,66,66,0,1,0,1,0
29098,64147,0,0,62,62,0,1,0,1,0
50113,51505,0,0,65,65,0,1,0,1,0
57113,35739,0,0,136,136,0,1,0,1,0
53980,37965,0,0,62,62,0,1,0,1,0
27534,25174,0,0,135,135,0,1,0,1,0
55874,64147,0,0,66,66,0,1,0,1,0
45941,23388,0,0,60,60,0,1,0,1,0
44431,50584,0,0,115,115,0,1,0,1,0
35111,22114,0,0,66,66,0,1,0,1,0
22161,15503,0,0,62,62,0,1,0,1,0
5333,32554,0,0,66,66,0,1,0,1,0
46907,64147,0,0,89,89,0,1,0,1,0
62701,57470,0,0,62,62,0,1,0,1,0
63130,57470,0,0,70,70,0,1,0,1,0
46394,8479,0,0,60,60,0,1,0,1,0
57580,15503,0,0,66,66,0,1,0,1,0
39032,22114,0,0,110,110,0,1,0,1,0
63477,37965,0,0,62,62,0,1,0,1,0
61762,44847,0,0,62,62,0,1,0,1,0
27041,51505,0,0,63,63,0,1,0,1,0
33617,64662,0,0,99,99,0,1,0,1,0
30114,65151,0,0,60,60,0,1,0,1,0
52745,57866,0,0,62,62,0,1,0,1,0
14208,51221,0,0,66,66,0,1,0,1,0
51479,25174,0,0,62,62,0,1,0,1,0
60802,35440,0,0,66,66,0,1,0,1,0
25673,19245,0,0,60,60,0,1,0,1,0
9577,52,0,0,60,60,0,1,0,1,0
49744,50584,0,0,62,62,0,1,0,1,0
58550,21247,0,0,66,66,0,1,0,1,0
64623,35993,0,0,62,62,0,1,0,1,0
45941,23386,0,0,60,60,0,1,0,1,0
10690,25174,0,0,62,62,0,1,0,1,0
59966,37965,0,0,66,66,0,1,0,1,0
54752,30188,0,0,66,66,0,1,0,1,0
21072,22114,0,0,62,62,0,1,0,1,0
31988,30188,0,0,62,62,0,1,0,1,0
45908,3383,0,0,60,60,0,1,0,1,0
46495,4607,0,0,60,60,0,1,0,1,0
21978,50538,0,0,66,66,0,1,0,1,0
17835,23,0,0,60,60,0,1,0,1,0
51414,22,0,0,60,60,0,1,0,1,0
10757,35440,0,0,66,66,0,1,0,1,0
17302,35440,0,0,63,63,0,1,0,1,0
57583,51221,0,0,62,62,0,1,0,1,0
30129,37965,0,0,72,72,0,1,0,1,0
65308,51221,0,0,69,69,0,1,0,1,0
7395,57470,0,0,63,63,0,1,0,1,0
443,60496,0,0,187,187,0,1,0,1,0
56453,37965,0,0,65,65,0,1,0,1,0
65512,44847,0,0,63,63,0,1,0,1,0
38926,37965,0,0,62,62,0,1,0,1,0
57837,64147,0,0,63,63,0,1,0,1,0
58638,5900,0,0,62,62,0,1,0,1,0
55824,36237,0,0,62,62,0,1,0,1,0
43786,50191,0,0,69,69,0,1,0,1,0
53012,51050,0,0,65,65,0,1,0,1,0
62778,11717,0,0,114,114,0,1,0,1,0
54280,3385,0,0,60,60,0,1,0,1,0
58638,5900,0,0,62,62,0,1,0,1,0
8313,51505,0,0,66,66,0,1,0,1,0
64626,6756,0,0,66,66,0,1,0,1,0
51680,51505,0,0,66,66,0,1,0,1,0
26053,33720,0,0,160,160,0,1,0,1,0
62413,50584,0,0,62,62,0,1,0,1,0
46495,4607,0,0,60,60,0,1,0,1,0
52562,7302,0,0,66,66,0,1,0,1,0
7260,39607,0,0,73,73,0,1,0,1,0
61086,50324,0,0,91,91,0,1,0,1,0
41383,28372,0,0,145,145,0,1,0,1,0
58638,5900,0,0,62,62,0,1,0,1,0
45573,8087,0,0,61,61,0,1,0,1,0
13285,29892,0,0,145,145,0,1,0,1,0
48987,25174,0,0,104,104,0,1,0,1,0
65344,46824,0,0,62,62,0,1,0,1,0
52512,30,0,0,60,60,0,1,0,1,0
60855,35440,0,0,66,66,0,1,0,1,0
59668,51505,0,0,66,66,0,1,0,1,0
63912,44847,0,0,62,62,0,1,0,1,0
16566,21247,0,0,62,62,0,1,0,1,0
58326,50584,0,0,62,62,0,1,0,1,0
65494,53,0,0,88,88,0,1,0,1,0
13285,29892,0,0,145,145,0,1,0,1,0
51300,64147,0,0,62,62,0,1,0,1,0
2918,37965,0,0,62,62,0,1,0,1,0
45941,23386,0,0,60,60,0,1,0,1,0
26301,22114,0,0,62,62,0,1,0,1,0
6057,51221,0,0,78,78,0,1,0,1,0
55851,62413,0,0,66,66,0,1,0,1,0
64322,37812,0,0,143,143,0,1,0,1,0
443,50104,0,0,71,71,0,1,0,1,0
2318,25174,0,0,96,96,0,1,0,1,0
11136,15503,0,0,62,62,0,1,0,1,0
443,21724,0,0,88,88,0,1,0,1,0
64379,37965,0,0,66,66,0,1,0,1,0
26527,25174,0,0,64,64,0,1,0,1,0
26461,64147,0,0,62,62,0,1,0,1,0
16387,16862,0,0,60,60,0,1,0,1,0
7000,23117,0,0,65,65,0,1,0,1,0
1865,25174,0,0,74,74,0,1,0,1,0
58906,26717,0,0,65,65,0,1,0,1,0
55552,50584,0,0,66,66,0,1,0,1,0
56174,44847,0,0,89,89,0,1,0,1,0
17537,36829,0,0,63,63,0,1,0,1,0
38893,51505,0,0,115,115,0,1,0,1,0
621,36660,0,0,82,82,0,1,0,1,0
48151,57720,0,0,62,62,0,1,0,1,0
1616,22114,0,0,62,62,0,1,0,1,0
13790,22114,0,0,146,146,0,1,0,1,0
59126,57470,0,0,66,66,0,1,0,1,0
48395,44847,0,0,141,141,0,1,0,1,0
61856,35440,0,0,66,66,0,1,0,1,0
13166,57470,0,0,62,62,0,1,0,1,0
30560,64147,0,0,62,62,0,1,0,1,0
49368,51514,0,0,67,67,0,1,0,1,0
27985,25194,0,0,62,62,0,1,0,1,0
57104,35440,0,0,62,62,0,1,0,1,0
22948,26467,0,0,62,62,0,1,0,1,0
58638,5900,0,0,62,62,0,1,0,1,0
48674,50584,0,0,146,146,0,1,0,1,0
25523,35974,0,0,74,74,0,1,0,1,0
1190,25174,0,0,144,144,0,1,0,1,0
33614,25174,0,0,62,62,0,1,0,1,0
26239,25174,0,0,64,64,0,1,0,1,0
65162,30188,0,0,66,66,0,1,0,1,0
63712,37965,0,0,66,66,0,1,0,1,0
7448,57470,0,0,66,66,0,1,0,1,0
33892,25174,0,0,135,135,0,1,0,1,0
3478,61463,0,0,1149,1149,0,1,0,1,0
65492,26467,0,0,62,62,0,1,0,1,0
13460,35440,0,0,66,66,0,1,0,1,0
58638,5900,0,0,62,62,0,1,0,1,0
25136,25174,0,0,146,146,0,1,0,1,0
26084,56088,0,0,62,62,0,1,0,1,0
33862,57470,0,0,70,70,0,1,0,1,0
58638,5900,0,0,62,62,0,1,0,1,0
58638,5900,0,0,62,62,0,1,0,1,0
52732,56205,0,0,66,66,0,1,0,1,0
16387,63852,0,0,60,60,0,1,0,1,0
51908,1258,0,0,60,60,0,1,0,1,0
16776,10441,0,0,83,83,0,1,0,1,0
23344,25174,0,0,62,62,0,1,0,1,0
2775,11392,0,0,62,62,0,1,0,1,0
19073,56205,0,0,62,62,0,1,0,1,0
50222,42873,0,0,66,66,0,1,0,1,0
51933,57470,0,0,66,66,0,1,0,1,0
62804,37965,0,0,65,65,0,1,0,1,0
9753,22114,0,0,121,121,0,1,0,1,0
65079,37965,0,0,69,69,0,1,0,1,0
63592,22114,0,0,65,65,0,1,0,1,0
23538,57360,0,0,140,140,0,1,0,1,0
61550,5529,0,0,145,145,0,1,0,1,0
48258,37965,0,0,62,62,0,1,0,1,0
43584,24748,0,0,156,156,0,1,0,1,0
57693,39004,0,0,63,63,0,1,0,1,0
4794,37965,0,0,66,66,0,1,0,1,0
36798,25174,0,0,66,66,0,1,0,1,0
47384,26521,0,0,61,61,0,1,0,1,0
22922,35440,0,0,66,66,0,1,0,1,0
31774,56086,0,0,62,62,0,1,0,1,0
40104,20,0,0,60,60,0,1,0,1,0
54280,3364,0,0,60,60,0,1,0,1,0
9252,7132,0,0,62,62,0,1,0,1,0
3334,35325,0,0,66,66,0,1,0,1,0
35179,26467,0,0,62,62,0,1,0,1,0
57595,50584,0,0,109,109,0,1,0,1,0
45955,11,0,0,61,61,0,1,0,1,0
61315,48817,0,0,62,62,0,1,0,1,0
443,62732,0,0,230,230,0,1,0,1,0
47013,37965,0,0,62,62,0,1,0,1,0
48077,51151,0,0,62,62,0,1,0,1,0
59632,47419,0,0,63,63,0,1,0,1,0
55396,32479,0,0,66,66,0,1,0,1,0
6044,25174,0,0,98,98,0,1,0,1,0
4041,50584,0,0,62,62,0,1,0,1,0
50062,5772,0,0,90,90,0,1,0,1,0
27107,50584,0,0,93,93,0,1,0,1,0
33292,50584,0,0,65,65,0,1,0,1,0
20576,37965,0,0,62,62,0,1,0,1,0
9254,42840,0,0,129,129,0,1,0,1,0
15329,51505,0,0,66,66,0,1,0,1,0
52188,2830,0,0,65,65,0,1,0,1,0
58638,5900,0,0,62,62,0,1,0,1,0
46483,334,0,0,830,830,0,1,0,1,0
26686,64147,0,0,62,62,0,1,0,1,0
36882,50093,0,0,147,147,0,1,0,1,0
57402,62413,0,0,66,66,0,1,0,1,0
7080,64191,0,0,64,64,0,1,0,1,0
23753,25174,0,0,62,62,0,1,0,1,0
55618,32470,0,0,66,66,0,1,0,1,0
63894,36829,0,0,66,66,0,1,0,1,0
10624,23,0,0,60,60,0,1,0,1,0
35193,22114,0,0,62,62,0,1,0,1,0
59425,50325,0,0,69,69,0,1,0,1,0
49778,36115,0,0,62,62,0,1,0,1,0
50215,64147,0,0,66,66,0,1,0,1,0
1114,37965,0,0,62,62,0,1,0,1,0
53027,64147,0,0,118,118,0,1,0,1,0
60863,25174,0,0,66,66,0,1,0,1,0
52405,22114,0,0,63,63,0,1,0,1,0
55184,37823,0,0,66,66,0,1,0,1,0
62359,26467,0,0,62,62,0,1,0,1,0
53227,64097,0,0,66,66,0,1,0,1,0
65340,57569,0,0,66,66,0,1,0,1,0
30719,51366,0,0,66,66,0,1,0,1,0
13285,29892,0,0,145,145,0,1,0,1,0
50297,35440,0,0,66,66,0,1,0,1,0
27402,37661,0,0,62,62,0,1,0,1,0
62804,37965,0,0,66,66,0,1,0,1,0
51045,25174,0,0,66,66,0,1,0,1,0
12094,56205,0,0,131,131,0,1,0,1,0
33201,50584,0,0,138,138,0,1,0,1,0
56129,57470,0,0,64,64,0,1,0,1,0
14693,64147,0,0,66,66,0,1,0,1,0
9216,26406,0,0,63,63,0,1,0,1,0
10669,49756,0,0,60,60,0,1,0,1,0
17789,44847,0,0,62,62,0,1,0,1,0
43172,12,0,0,60,60,0,1,0,1,0
25523,35974,0,0,79,79,0,1,0,1,0
52909,46573,0,0,64,64,0,1,0,1,0
39313,37965,0,0,62,62,0,1,0,1,0
5098,43670,0,0,128,128,0,1,0,1,0
17134,25174,0,0,86,86,0,1,0,1,0
5888,37965,0,0,64,64,0,1,0,1,0
443,44683,0,0,83,83,0,1,0,1,0
42252,33303,0,0,60,60,0,1,0,1,0
52740,51505,0,0,66,66,0,1,0,1,0
61537,57866,0,0,66,66,0,1,0,1,0
64219,51050,0,0,66,66,0,1,0,1,0
49529,21247,0,0,62,62,0,1,0,1,0
16995,57702,0,0,64,64,0,1,0,1,0
17208,64125,0,0,100,100,0,1,0,1,0
19245,64147,0,0,66,66,0,1,0,1,0
50442,25174,0,0,62,62,0,1,0,1,0
1837,64147,0,0,63,63,0,1,0,1,0
42733,25174,0,0,63,63,0,1,0,1,0
18332,25174,0,0,62,62,0,1,0,1,0
62288,7990,0,0,158,158,0,1,0,1,0
13566,64147,0,0,111,111,0,1,0,1,0
41416,59519,0,0,62,62,0,1,0,1,0
443,36653,0,0,65,65,0,1,0,1,0
36538,50584,0,0,125,125,0,1,0,1,0
61433,37958,0,0,66,66,0,1,0,1,0
63362,36,0,0,65,65,0,1,0,1,0
62080,54532,0,0,60,60,0,1,0,1,0
2584,64147,0,0,62,62,0,1,0,1,0
48157,51076,0,0,62,62,0,1,0,1,0
63537,62413,0,0,64,64,0,1,0,1,0
20650,26467,0,0,64,64,0,1,0,1,0
11136,15503,0,0,62,62,0,1,0,1,0
55450,64147,0,0,66,66,0,1,0,1,0
57451,57470,0,0,62,62,0,1,0,1,0
51315,43727,0,0,66,66,0,1,0,1,0
27759,37965,0,0,65,65,0,1,0,1,0
6933,63,0,0,72,72,0,1,0,1,0
52058,25206,0,0,66,66,0,1,0,1,0
33101,64126,0,0,62,62,0,1,0,1,0
59966,37965,0,0,66,66,0,1,0,1,0
61450,50584,0,0,78,78,0,1,0,1,0
58638,5900,0,0,62,62,0,1,0,1,0
65200,50584,0,0,66,66,0,1,0,1,0
38264,15503,0,0,68,68,0,1,0,1,0
5792,5015,0,0,156,156,0,1,0,1,0
55825,52700,0,0,64,64,0,1,0,1,0
64676,5759,0,0,62,62,0,1,0,1,0
54622,37825,0,0,65,65,0,1,0,1,0
44546,64084,0,0,66,66,0,1,0,1,0
63771,25174,0,0,62,62,0,1,0,1,0
23886,23,0,0,60,60,0,1,0,1,0
54062,50265,0,0,66,66,0,1,0,1,0
55110,64099,0,0,66,66,0,1,0,1,0
9494,23,0,0,60,60,0,1,0,1,0
443,49521,0,0,76,76,0,1,0,1,0
42156,25174,0,0,62,62,0,1,0,1,0
42605,50787,0,0,62,62,0,1,0,1,0
22625,55775,0,0,68,68,0,1,0,1,0
44932,57470,0,0,72,72,0,1,0,1,0
1024,64147,0,0,62,62,0,1,0,1,0
62183,57470,0,0,74,74,0,1,0,1,0
58638,5900,0,0,62,62,0,1,0,1,0
49248,35993,0,0,66,66,0,1,0,1,0
1027,33200,0,0,122,122,0,1,0,1,0
54685,307,0,0,66,66,0,1,0,1,0
56645,23604,0,0,81,81,0,1,0,1,0
38696,15503,0,0,99,99,0,1,0,1,0
59842,62413,0,0,65,65,0,1,0,1,0
44538,50584,0,0,139,139,0,1,0,1,0
55289,50584,0,0,66,66,0,1,0,1,0
58638,5900,0,0,62,62,0,1,0,1,0
10003,64147,0,0,62,62,0,1,0,1,0
51386,50584,0,0,66,66,0,1,0,1,0
51183,56205,0,0,62,62,0,1,0,1,0
65096,37807,0,0,63,63,0,1,0,1,0
45162,37965,0,0,62,62,0,1,0,1,0
58638,5900,0,0,62,62,0,1,0,1,0
29424,37807,0,0,66,66,0,1,0,1,0
59505,53733,0,0,63,63,0,1,0,1,0
58828,44847,0,0,124,124,0,1,0,1,0
25719,7407,0,0,66,66,0,1,0,1,0
1920,25174,0,0,62,62,0,1,0,1,0
11136,15503,0,0,62,62,0,1,0,1,0
3478,61463,0,0,909,909,0,1,0,1,0
24144,57470,0,0,62,62,0,1,0,1,0
64381,37965,0,0,66,66,0,1,0,1,0
56955,35886,0,0,66,66,0,1,0,1,0
50072,30188,0,0,62,62,0,1,0,1,0
44849,46478,0,0,74,74,0,1,0,1,0
25784,50366,0,0,62,62,0,1,0,1,0
6881,6881,0,0,62,62,0,1,0,1,0
35657,48637,0,0,62,62,0,1,0,1,0
11716,37965,0,0,62,62,0,1,0,1,0
22288,6881,0,0,140,140,0,1,0,1,0
54305,39004,0,0,104,104,0,1,0,1,0
54280,3389,0,0,60,60,0,1,0,1,0
21955,55954,0,0,68,68,0,1,0,1,0
52679,17509,0,0,65,65,0,1,0,1,0
57131,35776,0,0,145,145,0,1,0,1,0
58638,5900,0,0,62,62,0,1,0,1,0
30667,25174,0,0,62,62,0,1,0,1,0
55162,11392,0,0,66,66,0,1,0,1,0
5228,3434,0,0,836,836,0,1,0,1,0
42034,28189,0,0,129,129,0,1,0,1,0
443,20087,0,0,83,83,0,1,0,1,0
2866,25174,0,0,64,64,0,1,0,1,0
24009,52971,0,0,66,66,0,1,0,1,0
45852,25174,0,0,71,71,0,1,0,1,0
58475,11392,0,0,66,66,0,1,0,1,0
53478,37807,0,0,64,64,0,1,0,1,0
63916,36829,0,0,62,62,0,1,0,1,0
26140,23,0,0,60,60,0,1,0,1,0
29080,50265,0,0,62,62,0,1,0,1,0
20324,49989,0,0,92,92,0,1,0,1,0
49044,22114,0,0,62,62,0,1,0,1,0
11031,50584,0,0,62,62,0,1,0,1,0
65020,36052,0,0,72,72,0,1,0,1,0
45941,23386,0,0,60,60,0,1,0,1,0
51615,25174,0,0,66,66,0,1,0,1,0
58638,5900,0,0,62,62,0,1,0,1,0
14693,64147,0,0,65,65,0,1,0,1,0
51772,44847,0,0,66,66,0,1,0,1,0
51414,22,0,0,60,60,0,1,0,1,0
32308,8659,0,0,65,65,0,1,0,1,0
57613,15503,0,0,64,64,0,1,0,1,0
57131,31061,0,0,145,145,0,1,0,1,0
31681,35440,0,0,62,62,0,1,0,1,0
64093,64147,0,0,66,66,0,1,0,1,0
62408,23117,0,0,66,66,0,1,0,1,0
15794,50507,0,0,62,62,0,1,0,1,0
38183,37965,0,0,62,62,0,1,0,1,0
59103,50584,0,0,66,66,0,1,0,1,0
57442,57470,0,0,65,65,0,1,0,1,0
49225,41153,0,0,158,158,0,1,0,1,0
59407,51505,0,0,62,62,0,1,0,1,0
59592,37965,0,0,62,62,0,1,0,1,0
13917,18033,0,0,62,62,0,1,0,1,0
25862,8168,0,0,64,64,0,1,0,1,0
58686,50584,0,0,66,66,0,1,0,1,0
27869,51221,0,0,66,66,0,1,0,1,0
16399,55516,0,0,65,65,0,1,0,1,0
443,29318,0,0,82,82,0,1,0,1,0
53419,28189,0,0,60,60,0,1,0,1,0
23044,50584,0,0,62,62,0,1,0,1,0
62200,37843,0,0,62,62,0,1,0,1,0
56494,15503,0,0,146,146,0,1,0,1,0
4090,23,0,0,60,60,0,1,0,1,0
55525,56205,0,0,64,64,0,1,0,1,0
55594,25174,0,0,102,102,0,1,0,1,0
55054,25174,0,0,66,66,0,1,0,1,0
63080,64147,0,0,62,62,0,1,0,1,0
50439,64147,0,0,66,66,0,1,0,1,0
58638,5900,0,0,62,62,0,1,0,1,0
50301,37965,0,0,66,66,0,1,0,1,0
57691,57470,0,0,62,62,0,1,0,1,0
8918,2122,0,0,60,60,0,1,0,1,0
45941,23386,0,0,60,60,0,1,0,1,0
37302,44847,0,0,64,64,0,1,0,1,0
24696,57470,0,0,62,62,0,1,0,1,0
20576,37965,0,0,62,62,0,1,0,1,0
47060,44596,0,0,63,63,0,1,0,1,0
25820,8168,0,0,63,63,0,1,0,1,0
31994,23,0,0,60,60,0,1,0,1,0
23843,26467,0,0,62,62,0,1,0,1,0
56698,25174,0,0,64,64,0,1,0,1,0
1028,63911,0,0,359,359,0,1,0,1,0
8854,42057,0,0,143,143,0,1,0,1,0
14341,56205,0,0,62,62,0,1,0,1,0
26722,57470,0,0,65,65,0,1,0,1,0
3348,44847,0,0,76,76,0,1,0,1,0
26792,37965,0,0,62,62,0,1,0,1,0
34569,57470,0,0,67,67,0,1,0,1,0
11842,37861,0,0,116,116,0,1,0,1,0
55587,43890,0,0,66,66,0,1,0,1,0
46290,1433,0,0,60,60,0,1,0,1,0
4002,55894,0,0,64,64,0,1,0,1,0
59201,51221,0,0,66,66,0,1,0,1,0
43916,21,0,0,60,60,0,1,0,1,0
27160,64147,0,0,63,63,0,1,0,1,0
53981,28394,0,0,61,61,0,1,0,1,0
51337,15198,0,0,103,103,0,1,0,1,0
32501,48643,0,0,129,129,0,1,0,1,0
12418,50827,0,0,62,62,0,1,0,1,0
46358,35440,0,0,66,66,0,1,0,1,0
165,47842,0,0,75,75,0,1,0,1,0
26417,22114,0,0,62,62,0,1,0,1,0
52696,21247,0,0,64,64,0,1,0,1,0
64712,50584,0,0,64,64,0,1,0,1,0
22680,22,0,0,60,60,0,1,0,1,0
42432,42959,0,0,72,72,0,1,0,1,0
55225,11392,0,0,66,66,0,1,0,1,0
4210,26587,0,0,62,62,0,1,0,1,0
51537,44847,0,0,82,82,0,1,0,1,0
43916,21,0,0,60,60,0,1,0,1,0
52177,25320,0,0,66,66,0,1,0,1,0
61085,37965,0,0,62,62,0,1,0,1,0
43260,41615,0,0,145,145,0,1,0,1,0
52335,22114,0,0,65,65,0,1,0,1,0
15403,22114,0,0,65,65,0,1,0,1,0
52217,26467,0,0,63,63,0,1,0,1,0
18683,26467,0,0,62,62,0,1,0,1,0
20084,2767,0,0,65,65,0,1,0,1,0
50470,61463,0,0,86,86,0,1,0,1,0
10669,49756,0,0,60,60,0,1,0,1,0
443,48120,0,0,97,97,0,1,0,1,0
58638,5900,0,0,62,62,0,1,0,1,0
52018,57866,0,0,62,62,0,1,0,1,0
44928,26467,0,0,62,62,0,1,0,1,0
58118,22114,0,0,63,63,0,1,0,1,0
25086,64147,0,0,65,65,0,1,0,1,0
53022,24211,0,0,66,66,0,1,0,1,0
62587,23,0,0,60,60,0,1,0,1,0
64051,36829,0,0,63,63,0,1,0,1,0
2361,8354,0,0,142,142,0,1,0,1,0
7744,50584,0,0,113,113,0,1,0,1,0
52740,25174,0,0,62,62,0,1,0,1,0
58715,64097,0,0,62,62,0,1,0,1,0
6916,35287,0,0,90,90,0,1,0,1,0
16213,22188,0,0,61,61,0,1,0,1,0
7396,57470,0,0,63,63,0,1,0,1,0
46199,20,0,0,60,60,0,1,0,1,0
63935,30188,0,0,62,62,0,1,0,1,0
443,20087,0,0,83,83,0,1,0,1,0
29748,37936,0,0,62,62,0,1,0,1,0
59694,50584,0,0,63,63,0,1,0,1,0
51414,50584,0,0,64,64,0,1,0,1,0
50106,30317,0,0,65,65,0,1,0,1,0
63574,37965,0,0,62,62,0,1,0,1,0
62817,35440,0,0,66,66,0,1,0,1,0
62665,34676,0,0,64,64,0,1,0,1,0
30301,26467,0,0,62,62,0,1,0,1,0
33886,65504,0,0,162,162,0,1,0,1,0
36680,110,0,0,194,194,0,1,0,1,0
53923,62413,0,0,134,134,0,1,0,1,0
59048,57470,0,0,66,66,0,1,0,1,0
32004,51505,0,0,79,79,0,1,0,1,0
57405,35440,0,0,64,64,0,1,0,1,0
57284,50584,0,0,62,62,0,1,0,1,0
58765,17500,0,0,66,66,0,1,0,1,0
58638,5900,0,0,62,62,0,1,0,1,0
58638,5900,0,0,62,62,0,1,0,1,0
16441,45059,0,0,60,60,0,1,0,1,0
61467,189,0,0,63,63,0,1,0,1,0
6037,43890,0,0,72,72,0,1,0,1,0
51363,30201,0,0,77,77,0,1,0,1,0
28221,37965,0,0,62,62,0,1,0,1,0
25593,7660,0,0,66,66,0,1,0,1,0
20006,8457,0,0,60,60,0,1,0,1,0
41322,50584,0,0,80,80,0,1,0,1,0
30750,46605,0,0,61,61,0,1,0,1,0
65407,2400,0,0,60,60,0,1,0,1,0
54062,31573,0,0,66,66,0,1,0,1,0
3950,63960,0,0,63,63,0,1,0,1,0
58638,5900,0,0,62,62,0,1,0,1,0
57471,62413,0,0,66,66,0,1,0,1,0
47063,15503,0,0,117,117,0,1,0,1,0
52459,33890,0,0,60,60,0,1,0,1,0
24970,25174,0,0,62,62,0,1,0,1,0
12214,22114,0,0,113,113,0,1,0,1,0
64626,36008,0,0,62,62,0,1,0,1,0
55921,43890,0,0,66,66,0,1,0,1,0
36566,37965,0,0,62,62,0,1,0,1,0
51312,64147,0,0,62,62,0,1,0,1,0
13188,35440,0,0,63,63,0,1,0,1,0
55728,50584,0,0,62,62,0,1,0,1,0
38808,22114,0,0,63,63,0,1,0,1,0
10263,25604,0,0,64,64,0,1,0,1,0
40312,22114,0,0,107,107,0,1,0,1,0
26651,25174,0,0,69,69,0,1,0,1,0
59425,21247,0,0,64,64,0,1,0,1,0
59694,50584,0,0,66,66,0,1,0,1,0
60097,55484,0,0,66,66,0,1,0,1,0
50765,57470,0,0,62,62,0,1,0,1,0
16948,990,0,0,60,60,0,1,0,1,0
50326,46824,0,0,66,66,0,1,0,1,0
36456,25174,0,0,93,93,0,1,0,1,0
0,0,0,0,72,72,0,1,0,1,0
56233,23718,0,0,63,63,0,1,0,1,0
31021,35440,0,0,86,86,0,1,0,1,0
16387,22647,0,0,60,60,0,1,0,1,0
55608,56205,0,0,62,62,0,1,0,1,0
7277,65092,0,0,149,149,0,1,0,1,0
51745,57470,0,0,102,102,0,1,0,1,0
45304,64147,0,0,72,72,0,1,0,1,0
1024,29903,0,0,145,145,0,1,0,1,0
46319,8603,0,0,93,93,0,1,0,1,0
53650,25174,0,0,66,66,0,1,0,1,0
58638,5900,0,0,62,62,0,1,0,1,0
1483,44847,0,0,62,62,0,1,0,1,0
52103,53733,0,0,66,66,0,1,0,1,0
14441,38131,0,0,103,103,0,1,0,1,0
58318,15503,0,0,66,66,0,1,0,1,0
25523,35974,0,0,131,131,0,1,0,1,0
40736,25174,0,0,62,62,0,1,0,1,0
64936,36215,0,0,63,63,0,1,0,1,0
57366,37965,0,0,63,63,0,1,0,1,0
48762,11392,0,0,136,136,0,1,0,1,0
57131,31061,0,0,145,145,0,1,0,1,0
38590,51221,0,0,62,62,0,1,0,1,0
16601,21247,0,0,62,62,0,1,0,1,0
58638,5900,0,0,62,62,0,1,0,1,0
42252,33303,0,0,60,60,0,1,0,1,0
45941,23388,0,0,60,60,0,1,0,1,0
56583,25174,0,0,139,139,0,1,0,1,0
10003,64147,0,0,62,62,0,1,0,1,0
65107,44847,0,0,63,63,0,1,0,1,0
1664,23,0,0,60,60,0,1,0,1,0
60693,51050,0,0,66,66,0,1,0,1,0
22482,51505,0,0,62,62,0,1,0,1,0
23369,64147,0,0,62,62,0,1,0,1,0
57612,28793,0,0,66,66,0,1,0,1,0
2782,7290,0,0,62,62,0,1,0,1,0
28652,35440,0,0,66,66,0,1,0,1,0
32483,51269,0,0,79,79,0,1,0,1,0
43671,17372,0,0,62,62,0,1,0,1,0
65057,56205,0,0,64,64,0,1,0,1,0
2541,51505,0,0,64,64,0,1,0,1,0
59253,57554,0,0,68,68,0,1,0,1,0
58867,23718,0,0,66,66,0,1,0,1,0
11346,30188,0,0,78,78,0,1,0,1,0
36678,50584,0,0,106,106,0,1,0,1,0
34932,38608,0,0,62,62,0,1,0,1,0
7467,57470,0,0,66,66,0,1,0,1,0
31715,37965,0,0,62,62,0,1,0,1,0
58638,5900,0,0,62,62,0,1,0,1,0
57507,57470,0,0,65,65,0,1,0,1,0
55617,56205,0,0,65,65,0,1,0,1,0
58638,5900,0,0,62,62,0,1,0,1,0
1390,22114,0,0,74,74,0,1,0,1,0
9492,30236,0,0,98,98,0,1,0,1,0
58751,51221,0,0,62,62,0,1,0,1,0
3705,26467,0,0,66,66,0,1,0,1,0
3478,61463,0,0,1271,1271,0,1,0,1,0
9448,57866,0,0,142,142,0,1,0,1,0
49790,25174,0,0,65,65,0,1,0,1,0
51455,53733,0,0,64,64,0,1,0,1,0
54094,31573,0,0,65,65,0,1,0,1,0
62696,50584,0,0,62,62,0,1,0,1,0
514,10213,0,0,61,61,0,1,0,1,0
20398,64147,0,0,136,136,0,1,0,1,0
59781,56205,0,0,66,66,0,1,0,1,0
58250,35440,0,0,63,63,0,1,0,1,0
62337,44847,0,0,66,66,0,1,0,1,0
58638,5900,0,0,62,62,0,1,0,1,0
24287,23,0,0,60,60,0,1,0,1,0
19599,25174,0,0,62,62,0,1,0,1,0
6876,64296,0,0,60,60,0,1,0,1,0
22856,22114,0,0,63,63,0,1,0,1,0
56413,51221,0,0,66,66,0,1,0,1,0
28192,50584,0,0,66,66,0,1,0,1,0
9122,26384,0,0,62,62,0,1,0,1,0
55929,57651,0,0,72,72,0,1,0,1,0
13285,29892,0,0,145,145,0,1,0,1,0
25080,64147,0,0,64,64,0,1,0,1,0
40077,22114,0,0,62,62,0,1,0,1,0
26528,51221,0,0,78,78,0,1,0,1,0
26920,37965,0,0,62,62,0,1,0,1,0
63931,64147,0,0,66,66,0,1,0,1,0
46386,36237,0,0,82,82,0,1,0,1,0
56837,35894,0,0,65,65,0,1,0,1,0
62791,25174,0,0,62,62,0,1,0,1,0
9955,10197,0,0,61,61,0,1,0,1,0
37357,21269,0,0,62,62,0,1,0,1,0
59631,47355,0,0,64,64,0,1,0,1,0
60823,25174,0,0,66,66,0,1,0,1,0
53771,57470,0,0,66,66,0,1,0,1,0
60861,25174,0,0,66,66,0,1,0,1,0
1032,44847,0,0,146,146,0,1,0,1,0
60141,60,0,0,80,80,0,1,0,1,0
48039,16069,0,0,64,64,0,1,0,1,0
52617,44847,0,0,63,63,0,1,0,1,0
62424,57460,0,0,73,73,0,1,0,1,0
37012,25174,0,0,62,62,0,1,0,1,0
46352,35440,0,0,66,66,0,1,0,1,0
62064,22114,0,0,66,66,0,1,0,1,0
7016,64224,0,0,61,61,0,1,0,1,0
64955,44847,0,0,66,66,0,1,0,1,0
57557,7302,0,0,105,105,0,1,0,1,0
58638,5900,0,0,62,62,0,1,0,1,0
1824,64147,0,0,66,66,0,1,0,1,0
43451,15503,0,0,70,70,0,1,0,1,0
45908,33330,0,0,60,60,0,1,0,1,0
10814,35593,0,0,64,64,0,1,0,1,0
4857,37965,0,0,66,66,0,1,0,1,0
10901,7070,0,0,79,79,0,1,0,1,0
38904,37965,0,0,62,62,0,1,0,1,0
49239,11392,0,0,87,87,0,1,0,1,0
41648,56205,0,0,66,66,0,1,0,1,0
58638,5900,0,0,62,62,0,1,0,1,0
9493,44847,0,0,62,62,0,1,0,1,0
13528,57763,0,0,62,62,0,1,0,1,0
7965,65409,0,0,155,155,0,1,0,1,0
59497,64098,0,0,65,65,0,1,0,1,0
19260,55962,0,0,113,113,0,1,0,1,0
53655,5900,0,0,60,60,0,1,0,1,0
22666,48817,0,0,94,94,0,1,0,1,0
19617,38935,0,0,139,139,0,1,0,1,0
13221,57866,0,0,62,62,0,1,0,1,0
51486,9681,0,0,62,62,0,1,0,1,0
56675,37965,0,0,66,66,0,1,0,1,0
58638,5900,0,0,62,62,0,1,0,1,0
64753,50584,0,0,66,66,0,1,0,1,0
51829,36134,0,0,66,66,0,1,0,1,0
7066,25174,0,0,66,66,0,1,0,1,0
64755,31573,0,0,66,66,0,1,0,1,0
50002,22114,0,0,66,66,0,1,0,1,0
3410,17372,0,0,62,62,0,1,0,1,0
64406,50584,0,0,64,64,0,1,0,1,0
4960,62741,0,0,66,66,0,1,0,1,0
33822,57470,0,0,66,66,0,1,0,1,0
10669,49756,0,0,60,60,0,1,0,1,0
29490,62402,0,0,130,130,0,1,0,1,0
45908,3383,0,0,60,60,0,1,0,1,0
3050,50584,0,0,72,72,0,1,0,1,0
59774,62413,0,0,66,66,0,1,0,1,0
38724,25174,0,0,117,117,0,1,0,1,0
49001,48983,0,0,161,161,0,1,0,1,0
19797,441,0,0,60,60,0,1,0,1,0
55158,26467,0,0,66,66,0,1,0,1,0
443,20995,0,0,83,83,0,1,0,1,0
3319,45189,0,0,91,91,0,1,0,1,0
22346,51505,0,0,62,62,0,1,0,1,0
49954,57470,0,0,64,64,0,1,0,1,0
7619,50584,0,0,97,97,0,1,0,1,0
53222,26467,0,0,62,62,0,1,0,1,0
4026,50584,0,0,64,64,0,1,0,1,0
52892,1433,0,0,60,60,0,1,0,1,0
63843,35440,0,0,62,62,0,1,0,1,0
58994,25174,0,0,63,63,0,1,0,1,0
51125,56205,0,0,66,66,0,1,0,1,0
41268,64147,0,0,116,116,0,1,0,1,0
52850,37925,0,0,66,66,0,1,0,1,0
58638,5900,0,0,62,62,0,1,0,1,0
443,60496,0,0,240,240,0,1,0,1,0
3478,61463,0,0,164,164,0,1,0,1,0
58638,5900,0,0,62,62,0,1,0,1,0
58638,5900,0,0,62,62,0,1,0,1,0
17865,44847,0,0,116,116,0,1,0,1,0
49675,26467,0,0,139,139,0,1,0,1,0
47943,50584,0,0,62,62,0,1,0,1,0
35431,15503,0,0,69,69,0,1,0,1,0
58954,11392,0,0,66,66,0,1,0,1,0
33996,37873,0,0,62,62,0,1,0,1,0
19619,38839,0,0,131,131,0,1,0,1,0
61761,51505,0,0,66,66,0,1,0,1,0
46495,4607,0,0,60,60,0,1,0,1,0
11136,15503,0,0,62,62,0,1,0,1,0
443,54507,0,0,82,82,0,1,0,1,0
17252,32021,0,0,63,63,0,1,0,1,0
61642,44847,0,0,66,66,0,1,0,1,0
30559,64147,0,0,62,62,0,1,0,1,0
38678,37965,0,0,78,78,0,1,0,1,0
58638,5900,0,0,62,62,0,1,0,1,0
45354,64147,0,0,70,70,0,1,0,1,0
25236,25174,0,0,144,144,0,1,0,1,0
23957,26467,0,0,62,62,0,1,0,1,0
12446,50440,0,0,62,62,0,1,0,1,0
62849,62413,0,0,66,66,0,1,0,1,0
59527,44847,0,0,66,66,0,1,0,1,0
59621,36237,0,0,65,65,0,1,0,1,0
53852,37965,0,0,66,66,0,1,0,1,0
59385,2767,0,0,66,66,0,1,0,1,0
38699,15503,0,0,106,106,0,1,0,1,0
54471,36237,0,0,66,66,0,1,0,1,0
55709,37965,0,0,66,66,0,1,0,1,0
1127,44847,0,0,62,62,0,1,0,1,0
17019,35440,0,0,141,141,0,1,0,1,0
58638,5900,0,0,62,62,0,1,0,1,0
39825,15503,0,0,107,107,0,1,0,1,0
21626,51505,0,0,64,64,0,1,0,1,0
59413,51505,0,0,62,62,0,1,0,1,0
51479,25174,0,0,62,62,0,1,0,1,0
50504,51505,0,0,66,66,0,1,0,1,0
9087,37965,0,0,62,62,0,1,0,1,0
51754,18375,0,0,62,62,0,1,0,1,0
27888,57246,0,0,62,62,0,1,0,1,0
56372,44847,0,0,64,64,0,1,0,1,0
64701,25278,0,0,66,66,0,1,0,1,0
41187,23,0,0,60,60,0,1,0,1,0
58638,5900,0,0,62,62,0,1,0,1,0
443,60496,0,0,267,267,0,1,0,1,0
57236,53733,0,0,65,65,0,1,0,1,0
51574,17532,0,0,66,66,0,1,0,1,0
59345,25174,0,0,62,62,0,1,0,1,0
3583,25174,0,0,62,62,0,1,0,1,0
28517,64147,0,0,62,62,0,1,0,1,0
53709,42827,0,0,71,71,0,1,0,1,0
61395,50584,0,0,62,62,0,1,0,1,0
48706,23393,0,0,60,60,0,1,0,1,0
52474,22114,0,0,63,63,0,1,0,1,0
58638,5900,0,0,62,62,0,1,0,1,0
57550,56205,0,0,66,66,0,1,0,1,0
34723,22114,0,0,98,98,0,1,0,1,0
1680,30188,0,0,63,63,0,1,0,1,0
3976,25174,0,0,62,62,0,1,0,1,0
64692,25312,0,0,66,66,0,1,0,1,0
22856,22114,0,0,65,65,0,1,0,1,0
9631,57470,0,0,67,67,0,1,0,1,0
49210,23,0,0,60,60,0,1,0,1,0
59895,30188,0,0,66,66,0,1,0,1,0
1873,35440,0,0,62,62,0,1,0,1,0
58638,5900,0,0,62,62,0,1,0,1,0
27484,22114,0,0,62,62,0,1,0,1,0
50943,44847,0,0,75,75,0,1,0,1,0
35261,15503,0,0,74,74,0,1,0,1,0
22639,64147,0,0,66,66,0,1,0,1,0
52271,42707,0,0,66,66,0,1,0,1,0
17823,36037,0,0,62,62,0,1,0,1,0
28194,32468,0,0,62,62,0,1,0,1,0
43187,8078,0,0,66,66,0,1,0,1,0
11716,37965,0,0,62,62,0,1,0,1,0
59786,14932,0,0,140,140,0,1,0,1,0
20699,37965,0,0,62,62,0,1,0,1,0
8229,22114,0,0,66,66,0,1,0,1,0
62220,23593,0,0,65,65,0,1,0,1,0
52658,15503,0,0,144,144,0,1,0,1,0
62151,64147,0,0,120,120,0,1,0,1,0
22093,39079,0,0,61,61,0,1,0,1,0
56108,57470,0,0,65,65,0,1,0,1,0
58638,5900,0,0,62,62,0,1,0,1,0
55874,64147,0,0,66,66,0,1,0,1,0
60929,17434,0,0,66,66,0,1,0,1,0
46369,35440,0,0,66,66,0,1,0,1,0
38688,37912,0,0,96,96,0,1,0,1,0
6844,2262,0,0,98,98,0,1,0,1,0
26053,33720,0,0,160,160,0,1,0,1,0
10259,21247,0,0,62,62,0,1,0,1,0
56005,64147,0,0,62,62,0,1,0,1,0
20619,25174,0,0,63,63,0,1,0,1,0
57152,34186,0,0,66,66,0,1,0,1,0
143,4943,0,0,120,120,0,1,0,1,0
52755,24211,0,0,66,66,0,1,0,1,0
63380,37807,0,0,64,64,0,1,0,1,0
1663,30188,0,0,62,62,0,1,0,1,0
16918,50556,0,0,62,62,0,1,0,1,0
22547,25174,0,0,62,62,0,1,0,1,0
10134,64147,0,0,62,62,0,1,0,1,0
18683,26467,0,0,62,62,0,1,0,1,0
63321,57470,0,0,65,65,0,1,0,1,0
32342,62413,0,0,64,64,0,1,0,1,0
58638,5900,0,0,62,62,0,1,0,1,0
49711,14984,0,0,66,66,0,1,0,1,0
54744,22114,0,0,66,66,0,1,0,1,0
56761,25174,0,0,62,62,0,1,0,1,0
13441,57470,0,0,62,62,0,1,0,1,0
5223,14160,0,0,167,167,0,1,0,1,0
30283,51327,0,0,94,94,0,1,0,1,0
58312,52700,0,0,66,66,0,1,0,1,0
50111,22,0,0,60,60,0,1,0,1,0
52269,37950,0,0,66,66,0,1,0,1,0
38852,37965,0,0,62,62,0,1,0,1,0
30654,51221,0,0,72,72,0,1,0,1,0
40531,23850,0,0,71,71,0,1,0,1,0
58638,5900,0,0,62,62,0,1,0,1,0
64346,35359,0,0,98,98,0,1,0,1,0
64824,37965,0,0,62,62,0,1,0,1,0
2833,64147,0,0,65,65,0,1,0,1,0
28960,23,0,0,60,60,0,1,0,1,0
53602,64147,0,0,66,66,0,1,0,1,0
10914,35974,0,0,60,60,0,1,0,1,0
47910,7454,0,0,60,60,0,1,0,1,0
53864,37965,0,0,66,66,0,1,0,1,0
48125,7548,0,0,60,60,0,1,0,1,0
26869,50584,0,0,66,66,0,1,0,1,0
26641,57470,0,0,62,62,0,1,0,1,0
60511,2626,0,0,64,64,0,1,0,1,0
58245,38115,0,0,66,66,0,1,0,1,0
51439,9654,0,0,63,63,0,1,0,1,0
48095,57470,0,0,83,83,0,1,0,1,0
19697,9325,0,0,61,61,0,1,0,1,0
22856,22114,0,0,63,63,0,1,0,1,0
65016,37965,0,0,66,66,0,1,0,1,0
27440,23,0,0,60,60,0,1,0,1,0
443,10010,0,0,60,60,0,1,0,1,0
56378,22114,0,0,106,106,0,1,0,1,0
2704,37,0,0,60,60,0,1,0,1,0
44381,45289,0,0,68,68,0,1,0,1,0
18029,50584,0,0,66,66,0,1,0,1,0
58825,57470,0,0,66,66,0,1,0,1,0
34236,39043,0,0,102,102,0,1,0,1,0
58638,5900,0,0,62,62,0,1,0,1,0
3064,44847,0,0,62,62,0,1,0,1,0
46957,64147,0,0,62,62,0,1,0,1,0
51924,17372,0,0,62,62,0,1,0,1,0
56345,22114,0,0,62,62,0,1,0,1,0
16563,25174,0,0,62,62,0,1,0,1,0
21672,22114,0,0,62,62,0,1,0,1,0
443,20993,0,0,85,85,0,1,0,1,0
50113,51505,0,0,65,65,0,1,0,1,0
9246,35440,0,0,63,63,0,1,0,1,0
3478,61463,0,0,892,892,0,1,0,1,0
24351,57470,0,0,62,62,0,1,0,1,0
30206,61689,0,0,63,63,0,1,0,1,0
11316,42868,0,0,62,62,0,1,0,1,0
65340,46824,0,0,66,66,0,1,0,1,0
19617,39004,0,0,139,139,0,1,0,1,0
50637,36237,0,0,65,65,0,1,0,1,0
58638,5900,0,0,62,62,0,1,0,1,0
56780,15,0,0,61,61,0,1,0,1,0
36357,25174,0,0,64,64,0,1,0,1,0
61798,35440,0,0,66,66,0,1,0,1,0
21889,15520,0,0,62,62,0,1,0,1,0
26484,44847,0,0,126,126,0,1,0,1,0
62814,32472,0,0,83,83,0,1,0,1,0
56096,56205,0,0,139,139,0,1,0,1,0
26901,37965,0,0,104,104,0,1,0,1,0
50106,30898,0,0,64,64,0,1,0,1,0
12342,36966,0,0,130,130,0,1,0,1,0
60014,35440,0,0,64,64,0,1,0,1,0
58638,5900,0,0,62,62,0,1,0,1,0
51032,30188,0,0,62,62,0,1,0,1,0
1227,56205,0,0,66,66,0,1,0,1,0
51093,23373,0,0,66,66,0,1,0,1,0
59496,37965,0,0,62,62,0,1,0,1,0
57987,56125,0,0,90,90,0,1,0,1,0
61035,37965,0,0,111,111,0,1,0,1,0
3478,61463,0,0,1270,1270,0,1,0,1,0
11102,17459,0,0,62,62,0,1,0,1,0
30275,56557,0,0,145,145,0,1,0,1,0
30194,64725,0,0,60,60,0,1,0,1,0
52026,26467,0,0,60,60,0,1,0,1,0
62838,37965,0,0,65,65,0,1,0,1,0
12174,10219,0,0,82,82,0,1,0,1,0
26833,44847,0,0,62,62,0,1,0,1,0
48383,54696,0,0,130,130,0,1,0,1,0
60883,64147,0,0,71,71,0,1,0,1,0
11213,44847,0,0,64,64,0,1,0,1,0
50052,65009,0,0,60,60,0,1,0,1,0
35111,22114,0,0,66,66,0,1,0,1,0
29027,23,0,0,60,60,0,1,0,1,0
61745,50455,0,0,66,66,0,1,0,1,0
19335,25174,0,0,146,146,0,1,0,1,0
31727,57470,0,0,62,62,0,1,0,1,0
21674,28189,0,0,60,60,0,1,0,1,0
50564,22120,0,0,62,62,0,1,0,1,0
5733,25174,0,0,113,113,0,1,0,1,0
3051,36227,0,0,65,65,0,1,0,1,0
25546,23,0,0,60,60,0,1,0,1,0
65486,44847,0,0,66,66,0,1,0,1,0
27300,6881,0,0,62,62,0,1,0,1,0
53183,50584,0,0,66,66,0,1,0,1,0
16995,57692,0,0,64,64,0,1,0,1,0
64626,35993,0,0,66,66,0,1,0,1,0
10586,37965,0,0,62,62,0,1,0,1,0
26508,56123,0,0,62,62,0,1,0,1,0
4701,50584,0,0,64,64,0,1,0,1,0
55365,26467,0,0,62,62,0,1,0,1,0
64605,35993,0,0,62,62,0,1,0,1,0
53058,32337,0,0,66,66,0,1,0,1,0
11634,56205,0,0,66,66,0,1,0,1,0
57131,7842,0,0,145,145,0,1,0,1,0
16387,63752,0,0,60,60,0,1,0,1,0
36040,62313,0,0,145,145,0,1,0,1,0
50693,35440,0,0,62,62,0,1,0,1,0
1024,57470,0,0,62,62,0,1,0,1,0
25222,37965,0,0,62,62,0,1,0,1,0
28650,43884,0,0,62,62,0,1,0,1,0
34167,37965,0,0,62,62,0,1,0,1,0
27233,30448,0,0,113,113,0,1,0,1,0
27275,30397,0,0,104,104,0,1,0,1,0
57987,56125,0,0,90,90,0,1,0,1,0
53841,37965,0,0,66,66,0,1,0,1,0
10778,35568,0,0,61,61,0,1,0,1,0
63985,50584,0,0,66,66,0,1,0,1,0
64940,111,0,0,62,62,0,1,0,1,0
1750,44847,0,0,66,66,0,1,0,1,0
53977,57470,0,0,64,64,0,1,0,1,0
58638,5900,0,0,62,62,0,1,0,1,0
58638,5900,0,0,62,62,0,1,0,1,0
12856,37965,0,0,62,62,0,1,0,1,0
443,32698,0,0,89,89,0,1,0,1,0
21545,52175,0,0,108,108,0,1,0,1,0
64923,25174,0,0,66,66,0,1,0,1,0
59688,51505,0,0,64,64,0,1,0,1,0
42231,57470,0,0,78,78,0,1,0,1,0
55893,45711,0,0,78,78,0,1,0,1,0
54176,25174,0,0,62,62,0,1,0,1,0
43482,5900,0,0,60,60,0,1,0,1,0
13437,44847,0,0,65,65,0,1,0,1,0
59743,56205,0,0,66,66,0,1,0,1,0
39313,37965,0,0,62,62,0,1,0,1,0
7222,57470,0,0,62,62,0,1,0,1,0
54206,25174,0,0,62,62,0,1,0,1,0
54552,64147,0,0,62,62,0,1,0,1,0
14806,10783,0,0,153,153,0,1,0,1,0
56638,64147,0,0,62,62,0,1,0,1,0
61684,64123,0,0,62,62,0,1,0,1,0
59810,44847,0,0,66,66,0,1,0,1,0
55938,25174,0,0,146,146,0,1,0,1,0
57529,44847,0,0,63,63,0,1,0,1,0
28973,30188,0,0,66,66,0,1,0,1,0
8999,57470,0,0,146,146,0,1,0,1,0
35908,51505,0,0,146,146,0,1,0,1,0
65015,22114,0,0,65,65,0,1,0,1,0
28975,30313,0,0,66,66,0,1,0,1,0
7105,25174,0,0,66,66,0,1,0,1,0
12879,25174,0,0,145,145,0,1,0,1,0
10289,32480,0,0,63,63,0,1,0,1,0
6843,42873,0,0,62,62,0,1,0,1,0
39583,37965,0,0,66,66,0,1,0,1,0
53368,23,0,0,60,60,0,1,0,1,0
3359,11392,0,0,66,66,0,1,0,1,0
28483,50584,0,0,63,63,0,1,0,1,0
22383,25174,0,0,86,86,0,1,0,1,0
58638,5900,0,0,62,62,0,1,0,1,0
64874,26467,0,0,62,62,0,1,0,1,0
6881,6881,0,0,62,62,0,1,0,1,0
63438,17549,0,0,66,66,0,1,0,1,0
26742,64147,0,0,62,62,0,1,0,1,0
54118,36237,0,0,64,64,0,1,0,1,0
54354,48972,0,0,152,152,0,1,0,1,0
45941,23388,0,0,60,60,0,1,0,1,0
52078,49202,0,0,84,84,0,1,0,1,0
50084,26672,0,0,62,62,0,1,0,1,0
49711,37965,0,0,66,66,0,1,0,1,0
54487,37807,0,0,66,66,0,1,0,1,0
52722,64147,0,0,62,62,0,1,0,1,0
0,0,0,0,98,98,0,1,0,1,0
21129,22,0,0,60,60,0,1,0,1,0
9619,57470,0,0,64,64,0,1,0,1,0
64749,5902,0,0,64,64,0,1,0,1,0
52459,5555,0,0,60,60,0,1,0,1,0
58638,5900,0,0,62,62,0,1,0,1,0
41490,25174,0,0,62,62,0,1,0,1,0
65178,7031,0,0,62,62,0,1,0,1,0
43194,35440,0,0,65,65,0,1,0,1,0
51944,56205,0,0,64,64,0,1,0,1,0
55809,64147,0,0,66,66,0,1,0,1,0
65120,55263,0,0,66,66,0,1,0,1,0
19634,64147,0,0,62,62,0,1,0,1,0
45198,25174,0,0,146,146,0,1,0,1,0
5464,23,0,0,60,60,0,1,0,1,0
49384,5900,0,0,60,60,0,1,0,1,0
21802,56205,0,0,65,65,0,1,0,1,0
57449,57470,0,0,62,62,0,1,0,1,0
62801,37915,0,0,64,64,0,1,0,1,0
38435,5900,0,0,60,60,0,1,0,1,0
46593,57866,0,0,66,66,0,1,0,1,0
50624,44847,0,0,62,62,0,1,0,1,0
55017,56205,0,0,66,66,0,1,0,1,0
59200,49981,0,0,72,72,0,1,0,1,0
58638,5900,0,0,62,62,0,1,0,1,0
52585,44847,0,0,66,66,0,1,0,1,0
19875,30170,0,0,145,145,0,1,0,1,0
37891,37965,0,0,62,62,0,1,0,1,0
50634,25174,0,0,122,122,0,1,0,1,0
56719,37807,0,0,62,62,0,1,0,1,0
36787,23,0,0,60,60,0,1,0,1,0
33189,29405,0,0,64,64,0,1,0,1,0
5060,37965,0,0,66,66,0,1,0,1,0
16809,55980,0,0,63,63,0,1,0,1,0
42437,1520,0,0,60,60,0,1,0,1,0
2129,22114,0,0,62,62,0,1,0,1,0
16293,57470,0,0,62,62,0,1,0,1,0
45964,55559,0,0,60,60,0,1,0,1,0
47910,7454,0,0,60,60,0,1,0,1,0
58696,64115,0,0,62,62,0,1,0,1,0
27206,64147,0,0,66,66,0,1,0,1,0
55347,22114,0,0,63,63,0,1,0,1,0
35597,22114,0,0,62,62,0,1,0,1,0
38681,15503,0,0,74,74,0,1,0,1,0
22583,9822,0,0,62,62,0,1,0,1,0
17319,25174,0,0,62,62,0,1,0,1,0
27583,37965,0,0,63,63,0,1,0,1,0
57627,6934,0,0,62,62,0,1,0,1,0
57152,48,0,0,82,82,0,1,0,1,0
50757,64147,0,0,66,66,0,1,0,1,0
60750,42707,0,0,63,63,0,1,0,1,0
14183,26467,0,0,62,62,0,1,0,1,0
11854,64147,0,0,72,72,0,1,0,1,0
45964,2225,0,0,60,60,0,1,0,1,0
62153,50584,0,0,63,63,0,1,0,1,0
56577,56205,0,0,62,62,0,1,0,1,0
50967,44847,0,0,132,132,0,1,0,1,0
49187,25174,0,0,64,64,0,1,0,1,0
58079,22114,0,0,63,63,0,1,0,1,0
42090,35594,0,0,62,62,0,1,0,1,0
30280,37965,0,0,66,66,0,1,0,1,0
58638,5900,0,0,62,62,0,1,0,1,0
26323,22114,0,0,108,108,0,1,0,1,0
3478,61463,0,0,465,465,0,1,0,1,0
1024,44847,0,0,146,146,0,1,0,1,0
59563,56205,0,0,66,66,0,1,0,1,0
13285,29892,0,0,145,145,0,1,0,1,0
28385,50584,0,0,136,136,0,1,0,1,0
60661,11392,0,0,65,65,0,1,0,1,0
50083,30188,0,0,66,66,0,1,0,1,0
33464,44847,0,0,64,64,0,1,0,1,0
10640,20677,0,0,62,62,0,1,0,1,0
59511,21247,0,0,63,63,0,1,0,1,0
49738,50514,0,0,62,62,0,1,0,1,0
54961,2161,0,0,60,60,0,1,0,1,0
48295,44847,0,0,62,62,0,1,0,1,0
1025,35447,0,0,62,62,0,1,0,1,0
6930,48709,0,0,139,139,0,1,0,1,0
32702,46835,0,0,66,66,0,1,0,1,0
62153,35440,0,0,65,65,0,1,0,1,0
58638,5900,0,0,62,62,0,1,0,1,0
33403,37965,0,0,62,62,0,1,0,1,0
48488,50584,0,0,111,111,0,1,0,1,0
35124,30188,0,0,62,62,0,1,0,1,0
50095,30188,0,0,64,64,0,1,0,1,0
55820,30188,0,0,66,66,0,1,0,1,0
443,45788,0,0,332,332,0,1,0,1,0
32342,62413,0,0,62,62,0,1,0,1,0
45410,1,0,0,62,62,0,1,0,1,0
46449,21164,0,0,62,62,0,1,0,1,0
55297,50584,0,0,66,66,0,1,0,1,0
54249,22114,0,0,63,63,0,1,0,1,0
51999,37965,0,0,62,62,0,1,0,1,0
50295,37965,0,0,66,66,0,1,0,1,0
49414,44847,0,0,66,66,0,1,0,1,0
58638,5900,0,0,62,62,0,1,0,1,0
23338,25174,0,0,64,64,0,1,0,1,0
63142,54369,0,0,69,69,0,1,0,1,0
30179,57470,0,0,60,60,0,1,0,1,0
58638,5900,0,0,62,62,0,1,0,1,0
65017,57470,0,0,77,77,0,1,0,1,0
22166,15503,0,0,62,62,0,1,0,1,0
36804,25174,0,0,66,66,0,1,0,1,0
64589,56205,0,0,63,63,0,1,0,1,0
57988,2969,0,0,71,71,0,1,0,1,0
56851,26467,0,0,64,64,0,1,0,1,0
10004,64147,0,0,62,62,0,1,0,1,0
41187,50584,0,0,62,62,0,1,0,1,0
19651,22263,0,0,62,62,0,1,0,1,0
19141,64147,0,0,62,62,0,1,0,1,0
12313,22,0,0,60,60,0,1,0,1,0
34877,38648,0,0,63,63,0,1,0,1,0
62033,64135,0,0,66,66,0,1,0,1,0
59150,8742,0,0,65,65,0,1,0,1,0
34382,39008,0,0,77,77,0,1,0,1,0
7648,2111,0,0,64,64,0,1,0,1,0
48492,49877,0,0,64,64,0,1,0,1,0
62889,21247,0,0,65,65,0,1,0,1,0
15956,50584,0,0,131,131,0,1,0,1,0
54392,35440,0,0,63,63,0,1,0,1,0
40319,23,0,0,60,60,0,1,0,1,0
15542,37965,0,0,114,114,0,1,0,1,0
58638,5900,0,0,62,62,0,1,0,1,0
18011,44847,0,0,63,63,0,1,0,1,0
62293,15503,0,0,122,122,0,1,0,1,0
1694,30259,0,0,100,100,0,1,0,1,0
1025,50584,0,0,62,62,0,1,0,1,0
30114,65151,0,0,60,60,0,1,0,1,0
50914,36080,0,0,60,60,0,1,0,1,0
59169,51221,0,0,66,66,0,1,0,1,0
17193,25174,0,0,66,66,0,1,0,1,0
11638,37965,0,0,140,140,0,1,0,1,0
33776,23,0,0,60,60,0,1,0,1,0
64339,57470,0,0,65,65,0,1,0,1,0
59093,25174,0,0,66,66,0,1,0,1,0
56368,44847,0,0,65,65,0,1,0,1,0
23911,26437,0,0,76,76,0,1,0,1,0
59156,44847,0,0,62,62,0,1,0,1,0
65494,53,0,0,88,88,0,1,0,1,0
10267,22114,0,0,62,62,0,1,0,1,0
37198,36215,0,0,65,65,0,1,0,1,0
35111,22114,0,0,66,66,0,1,0,1,0
60179,39,0,0,81,81,0,1,0,1,0
63213,57866,0,0,62,62,0,1,0,1,0
26285,37965,0,0,65,65,0,1,0,1,0
26582,57470,0,0,66,66,0,1,0,1,0
80,53945,0,0,60,60,0,1,0,1,0
47173,35440,0,0,62,62,0,1,0,1,0
52811,44847,0,0,66,66,0,1,0,1,0
58638,5900,0,0,62,62,0,1,0,1,0
58638,5900,0,0,62,62,0,1,0,1,0
58370,38085,0,0,66,66,0,1,0,1,0
58638,5900,0,0,62,62,0,1,0,1,0
49514,52255,0,0,162,162,0,1,0,1,0
58638,5900,0,0,62,62,0,1,0,1,0
27163,57577,0,0,84,84,0,1,0,1,0
58932,57470,0,0,63,63,0,1,0,1,0
58638,5900,0,0,62,62,0,1,0,1,0
56676,37965,0,0,63,63,0,1,0,1,0
54854,19847,0,0,62,62,0,1,0,1,0
43584,24748,0,0,156,156,0,1,0,1,0
22811,26467,0,0,62,62,0,1,0,1,0
63798,26467,0,0,66,66,0,1,0,1,0
35827,48137,0,0,60,60,0,1,0,1,0
7086,25174,0,0,64,64,0,1,0,1,0
8239,37965,0,0,146,146,0,1,0,1,0
443,14591,0,0,131,131,0,1,0,1,0
58638,5900,0,0,62,62,0,1,0,1,0
57504,35472,0,0,73,73,0,1,0,1,0
54280,3394,0,0,60,60,0,1,0,1,0
57429,57470,0,0,99,99,0,1,0,1,0
1220,25174,0,0,146,146,0,1,0,1,0
61190,37965,0,0,63,63,0,1,0,1,0
3580,25174,0,0,62,62,0,1,0,1,0
58638,5900,0,0,62,62,0,1,0,1,0
58521,30301,0,0,62,62,0,1,0,1,0
56582,23718,0,0,66,66,0,1,0,1,0
58638,5900,0,0,62,62,0,1,0,1,0
50470,61463,0,0,86,86,0,1,0,1,0
6649,37965,0,0,64,64,0,1,0,1,0
34176,51505,0,0,140,140,0,1,0,1,0
33359,30188,0,0,64,64,0,1,0,1,0
64190,64147,0,0,64,64,0,1,0,1,0
42143,30188,0,0,116,116,0,1,0,1,0
22674,30188,0,0,62,62,0,1,0,1,0
3678,17372,0,0,62,62,0,1,0,1,0
56352,22114,0,0,62,62,0,1,0,1,0
55740,37965,0,0,66,66,0,1,0,1,0
57987,56125,0,0,90,90,0,1,0,1,0
35659,48629,0,0,61,61,0,1,0,1,0
60750,42707,0,0,65,65,0,1,0,1,0
51311,64147,0,0,66,66,0,1,0,1,0
57414,37965,0,0,65,65,0,1,0,1,0
58638,5900,0,0,62,62,0,1,0,1,0
42465,57470,0,0,60,60,0,1,0,1,0
6666,138,0,0,60,60,0,1,0,1,0
62482,37861,0,0,64,64,0,1,0,1,0
55717,43890,0,0,66,66,0,1,0,1,0
11028,6814,0,0,61,61,0,1,0,1,0
24144,57470,0,0,62,62,0,1,0,1,0
58486,57470,0,0,66,66,0,1,0,1,0
10978,57781,0,0,120,120,0,1,0,1,0
39420,51505,0,0,62,62,0,1,0,1,0
51742,64147,0,0,62,62,0,1,0,1,0
20170,8358,0,0,60,60,0,1,0,1,0
49322,35965,0,0,64,64,0,1,0,1,0
51732,57470,0,0,75,75,0,1,0,1,0
53095,35440,0,0,66,66,0,1,0,1,0
29253,48961,0,0,149,149,0,1,0,1,0
61125,37965,0,0,64,64,0,1,0,1,0
1383,44847,0,0,65,65,0,1,0,1,0
63533,107,0,0,60,60,0,1,0,1,0
57722,52715,0,0,65,65,0,1,0,1,0
2491,35440,0,0,64,64,0,1,0,1,0
65083,35440,0,0,66,66,0,1,0,1,0
58638,5900,0,0,62,62,0,1,0,1,0
1723,22114,0,0,107,107,0,1,0,1,0
58638,5900,0,0,62,62,0,1,0,1,0
16104,6881,0,0,146,146,0,1,0,1,0
13567,51505,0,0,65,65,0,1,0,1,0
42030,25,0,0,74,74,0,1,0,1,0
53433,44847,0,0,62,62,0,1,0,1,0
54552,64147,0,0,62,62,0,1,0,1,0
1227,8452,0,0,113,113,0,1,0,1,0
57425,42707,0,0,64,64,0,1,0,1,0
3583,25174,0,0,62,62,0,1,0,1,0
58638,5900,0,0,62,62,0,1,0,1,0
61563,64147,0,0,64,64,0,1,0,1,0
54414,35440,0,0,63,63,0,1,0,1,0
18715,44847,0,0,66,66,0,1,0,1,0
26973,10026,0,0,76,76,0,1,0,1,0
65003,57485,0,0,77,77,0,1,0,1,0
51320,44847,0,0,66,66,0,1,0,1,0
58021,22114,0,0,63,63,0,1,0,1,0
51299,37965,0,0,63,63,0,1,0,1,0
61164,21163,0,0,66,66,0,1,0,1,0
29843,25174,0,0,62,62,0,1,0,1,0
28809,37965,0,0,62,62,0,1,0,1,0
51365,22114,0,0,65,65,0,1,0,1,0
32395,30188,0,0,62,62,0,1,0,1,0
58979,57866,0,0,66,66,0,1,0,1,0
60687,23596,0,0,62,62,0,1,0,1,0
61589,50947,0,0,138,138,0,1,0,1,0
11716,37965,0,0,62,62,0,1,0,1,0
45941,23388,0,0,60,60,0,1,0,1,0
3551,25174,0,0,62,62,0,1,0,1,0
31025,15503,0,0,125,125,0,1,0,1,0
42410,22114,0,0,62,62,0,1,0,1,0
1024,64147,0,0,62,62,0,1,0,1,0
64944,25194,0,0,132,132,0,1,0,1,0
50788,48817,0,0,65,65,0,1,0,1,0
43084,22114,0,0,141,141,0,1,0,1,0
61269,56205,0,0,65,65,0,1,0,1,0
27947,26467,0,0,66,66,0,1,0,1,0
42056,36169,0,0,138,138,0,1,0,1,0
59498,64097,0,0,66,66,0,1,0,1,0
13889,12,0,0,62,62,0,1,0,1,0
63902,44847,0,0,62,62,0,1,0,1,0
59945,22114,0,0,143,143,0,1,0,1,0
58638,5900,0,0,62,62,0,1,0,1,0
61901,23,0,0,60,60,0,1,0,1,0
43584,24748,0,0,156,156,0,1,0,1,0
7622,50584,0,0,64,64,0,1,0,1,0
58587,18375,0,0,64,64,0,1,0,1,0
59965,36237,0,0,62,62,0,1,0,1,0
58638,5900,0,0,62,62,0,1,0,1,0
49603,26467,0,0,102,102,0,1,0,1,0
62086,56205,0,0,66,66,0,1,0,1,0
58638,5900,0,0,62,62,0,1,0,1,0
44374,886,0,0,60,60,0,1,0,1,0
15363,51505,0,0,66,66,0,1,0,1,0
36538,64147,0,0,62,62,0,1,0,1,0
52530,30188,0,0,66,66,0,1,0,1,0
45908,33330,0,0,60,60,0,1,0,1,0
64648,57470,0,0,66,66,0,1,0,1,0
58638,5900,0,0,62,62,0,1,0,1,0
50442,37807,0,0,63,63,0,1,0,1,0
65117,55267,0,0,66,66,0,1,0,1,0
3112,50584,0,0,136,136,0,1,0,1,0
52017,49225,0,0,62,62,0,1,0,1,0
1530,62413,0,0,62,62,0,1,0,1,0
62904,21,0,0,60,60,0,1,0,1,0
2584,23667,0,0,62,62,0,1,0,1,0
14923,51505,0,0,62,62,0,1,0,1,0
51389,56205,0,0,62,62,0,1,0,1,0
62414,50584,0,0,65,65,0,1,0,1,0
53928,15503,0,0,62,62,0,1,0,1,0
59876,44847,0,0,62,62,0,1,0,1,0
30004,26467,0,0,65,65,0,1,0,1,0
55946,62413,0,0,66,66,0,1,0,1,0
49383,57470,0,0,66,66,0,1,0,1,0
10668,44847,0,0,66,66,0,1,0,1,0
49110,44644,0,0,112,112,0,1,0,1,0
6828,64322,0,0,60,60,0,1,0,1,0
3225,64147,0,0,62,62,0,1,0,1,0
63968,44847,0,0,62,62,0,1,0,1,0
50298,37965,0,0,66,66,0,1,0,1,0
52726,56205,0,0,66,66,0,1,0,1,0
18379,37946,0,0,62,62,0,1,0,1,0
12545,25174,0,0,64,64,0,1,0,1,0
61427,64147,0,0,66,66,0,1,0,1,0
3270,35440,0,0,64,64,0,1,0,1,0
9124,2323,0,0,60,60,0,1,0,1,0
15977,37807,0,0,62,62,0,1,0,1,0
25523,35974,0,0,113,113,0,1,0,1,0
38057,10524,0,0,146,146,0,1,0,1,0
443,44683,0,0,83,83,0,1,0,1,0
16339,55454,0,0,65,65,0,1,0,1,0
3478,61463,0,0,1071,1071,0,1,0,1,0
64605,35993,0,0,63,63,0,1,0,1,0
58638,5900,0,0,62,62,0,1,0,1,0
43584,24748,0,0,156,156,0,1,0,1,0
60505,5931,0,0,61,61,0,1,0,1,0
51741,25174,0,0,62,62,0,1,0,1,0
59805,62413,0,0,64,64,0,1,0,1,0
42034,28189,0,0,104,104,0,1,0,1,0
54917,60043,0,0,66,66,0,1,0,1,0
19913,22202,0,0,65,65,0,1,0,1,0
63893,64147,0,0,63,63,0,1,0,1,0
61126,22114,0,0,66,66,0,1,0,1,0
64654,64147,0,0,66,66,0,1,0,1,0
28967,2241,0,0,60,60,0,1,0,1,0
6666,16010,0,0,60,60,0,1,0,1,0
58638,5900,0,0,62,62,0,1,0,1,0
49162,44847,0,0,64,64,0,1,0,1,0
51472,25174,0,0,76,76,0,1,0,1,0
1057,6980,0,0,64,64,0,1,0,1,0
57874,50542,0,0,76,76,0,1,0,1,0
39195,25174,0,0,122,122,0,1,0,1,0
60052,37965,0,0,66,66,0,1,0,1,0
56344,50584,0,0,66,66,0,1,0,1,0
14628,25174,0,0,80,80,0,1,0,1,0
62769,51221,0,0,62,62,0,1,0,1,0
50086,57470,0,0,66,66,0,1,0,1,0
13285,29892,0,0,145,145,0,1,0,1,0
1862,25174,0,0,64,64,0,1,0,1,0
16414,56205,0,0,62,62,0,1,0,1,0
58638,5900,0,0,62,62,0,1,0,1,0
52328,44847,0,0,64,64,0,1,0,1,0
443,54507,0,0,82,82,0,1,0,1,0
20939,60461,0,0,60,60,0,1,0,1,0
5223,44091,0,0,220,220,0,1,0,1,0
47731,25174,0,0,62,62,0,1,0,1,0
4083,26467,0,0,62,62,0,1,0,1,0
33765,64147,0,0,88,88,0,1,0,1,0
50524,56205,0,0,66,66,0,1,0,1,0
26531,37965,0,0,62,62,0,1,0,1,0
50189,64147,0,0,63,63,0,1,0,1,0
80,53945,0,0,60,60,0,1,0,1,0
53779,37965,0,0,66,66,0,1,0,1,0
45575,1,0,0,62,62,0,1,0,1,0
57987,56125,0,0,90,90,0,1,0,1,0
1663,30188,0,0,64,64,0,1,0,1,0
60148,22114,0,0,62,62,0,1,0,1,0
23383,64147,0,0,62,62,0,1,0,1,0
26728,64147,0,0,62,62,0,1,0,1,0
35482,35271,0,0,96,96,0,1,0,1,0
64978,62197,0,0,63,63,0,1,0,1,0
56675,21247,0,0,71,71,0,1,0,1,0
57283,64147,0,0,66,66,0,1,0,1,0
48706,23393,0,0,60,60,0,1,0,1,0
56383,26467,0,0,66,66,0,1,0,1,0
0,0,0,0,70,70,0,1,0,1,0
63743,25174,0,0,62,62,0,1,0,1,0
45964,5333,0,0,60,60,0,1,0,1,0
6882,8254,0,0,143,143,0,1,0,1,0
50629,57470,0,0,66,66,0,1,0,1,0
43111,50411,0,0,64,64,0,1,0,1,0
13285,29892,0,0,145,145,0,1,0,1,0
50901,26467,0,0,66,66,0,1,0,1,0
17286,25174,0,0,146,146,0,1,0,1,0
26420,64147,0,0,65,65,0,1,0,1,0
50797,23,0,0,60,60,0,1,0,1,0
11851,64147,0,0,62,62,0,1,0,1,0
641,60141,0,0,174,174,0,1,0,1,0
63495,50584,0,0,66,66,0,1,0,1,0
63187,36237,0,0,62,62,0,1,0,1,0
39148,20245,0,0,62,62,0,1,0,1,0
51579,37896,0,0,67,67,0,1,0,1,0
61185,54532,0,0,62,62,0,1,0,1,0
59708,53650,0,0,66,66,0,1,0,1,0
58638,5900,0,0,62,62,0,1,0,1,0
50994,35974,0,0,60,60,0,1,0,1,0
19875,30170,0,0,145,145,0,1,0,1,0
64832,46789,0,0,66,66,0,1,0,1,0
11744,37965,0,0,62,62,0,1,0,1,0
26531,37965,0,0,62,62,0,1,0,1,0
61221,35440,0,0,66,66,0,1,0,1,0
48706,23393,0,0,60,60,0,1,0,1,0
6869,57258,0,0,83,83,0,1,0,1,0
44258,25,0,0,74,74,0,1,0,1,0
47074,64147,0,0,62,62,0,1,0,1,0
13062,52274,0,0,66,66,0,1,0,1,0
16387,16862,0,0,60,60,0,1,0,1,0
59115,9424,0,0,62,62,0,1,0,1,0
33405,37965,0,0,62,62,0,1,0,1,0
7207,39986,0,0,86,86,0,1,0,1,0
58638,5900,0,0,62,62,0,1,0,1,0
36358,51505,0,0,69,69,0,1,0,1,0
52561,30188,0,0,66,66,0,1,0,1,0
13304,16962,0,0,62,62,0,1,0,1,0
690,9930,0,0,96,96,0,1,0,1,0
16454,25174,0,0,65,65,0,1,0,1,0
45908,33330,0,0,60,60,0,1,0,1,0
57972,7458,0,0,60,60,0,1,0,1,0
50113,51505,0,0,65,65,0,1,0,1,0
54521,25233,0,0,62,62,0,1,0,1,0
53534,44847,0,0,62,62,0,1,0,1,0
60750,42707,0,0,64,64,0,1,0,1,0
30082,37965,0,0,70,70,0,1,0,1,0
25407,47885,0,0,60,60,0,1,0,1,0
7285,51221,0,0,62,62,0,1,0,1,0
54742,50584,0,0,66,66,0,1,0,1,0
45941,23388,0,0,60,60,0,1,0,1,0
17198,10368,0,0,148,148,0,1,0,1,0
10467,25174,0,0,137,137,0,1,0,1,0
57378,87,0,0,70,70,0,1,0,1,0
13285,29892,0,0,145,145,0,1,0,1,0
54280,22114,0,0,62,62,0,1,0,1,0
31547,7,0,0,122,122,0,1,0,1,0
3544,25174,0,0,64,64,0,1,0,1,0
58638,5900,0,0,62,62,0,1,0,1,0
6881,6881,0,0,62,62,0,1,0,1,0
62912,26467,0,0,62,62,0,1,0,1,0
45682,37965,0,0,62,62,0,1,0,1,0
57441,57470,0,0,66,66,0,1,0,1,0
44822,64147,0,0,62,62,0,1,0,1,0
1024,64147,0,0,62,62,0,1,0,1,0
25455,64147,0,0,116,116,0,1,0,1,0
61523,37807,0,0,66,66,0,1,0,1,0
56034,64127,0,0,64,64,0,1,0,1,0
1072,44847,0,0,146,146,0,1,0,1,0
58842,2966,0,0,63,63,0,1,0,1,0
60798,53744,0,0,65,65,0,1,0,1,0
31136,50584,0,0,62,62,0,1,0,1,0
61185,54532,0,0,62,62,0,1,0,1,0
60120,25190,0,0,123,123,0,1,0,1,0
55422,25174,0,0,63,63,0,1,0,1,0
51615,25174,0,0,65,65,0,1,0,1,0
55818,36237,0,0,62,62,0,1,0,1,0
26915,37965,0,0,62,62,0,1,0,1,0
27271,11427,0,0,66,66,0,1,0,1,0
63156,36237,0,0,62,62,0,1,0,1,0
62639,51359,0,0,62,62,0,1,0,1,0
15590,41361,0,0,87,87,0,1,0,1,0
51135,23848,0,0,66,66,0,1,0,1,0
44521,50584,0,0,116,116,0,1,0,1,0
58638,5900,0,0,62,62,0,1,0,1,0
56264,44847,0,0,64,64,0,1,0,1,0
58797,51505,0,0,66,66,0,1,0,1,0
60104,22114,0,0,66,66,0,1,0,1,0
42489,22114,0,0,62,62,0,1,0,1,0
35494,22114,0,0,63,63,0,1,0,1,0
30729,37965,0,0,62,62,0,1,0,1,0
58638,5900,0,0,62,62,0,1,0,1,0
45304,64147,0,0,72,72,0,1,0,1,0
9550,26467,0,0,62,62,0,1,0,1,0
50990,23884,0,0,64,64,0,1,0,1,0
52975,51454,0,0,68,68,0,1,0,1,0
62953,11392,0,0,62,62,0,1,0,1,0
45908,33330,0,0,60,60,0,1,0,1,0
52988,53567,0,0,62,62,0,1,0,1,0
14484,38927,0,0,145,145,0,1,0,1,0
21218,51505,0,0,62,62,0,1,0,1,0
22494,25174,0,0,63,63,0,1,0,1,0
52325,44847,0,0,107,107,0,1,0,1,0
34828,15503,0,0,124,124,0,1,0,1,0
27406,30198,0,0,65,65,0,1,0,1,0
58638,5900,0,0,62,62,0,1,0,1,0
46859,25174,0,0,146,146,0,1,0,1,0
54300,22114,0,0,65,65,0,1,0,1,0
58638,5900,0,0,62,62,0,1,0,1,0
52508,43890,0,0,62,62,0,1,0,1,0
12000,36839,0,0,144,144,0,1,0,1,0
52679,37965,0,0,62,62,0,1,0,1,0
54203,64111,0,0,66,66,0,1,0,1,0
43654,50863,0,0,145,145,0,1,0,1,0
62607,25174,0,0,63,63,0,1,0,1,0
19658,9436,0,0,61,61,0,1,0,1,0
46187,23,0,0,60,60,0,1,0,1,0
60068,62413,0,0,66,66,0,1,0,1,0
17781,50265,0,0,62,62,0,1,0,1,0
31031,23,0,0,60,60,0,1,0,1,0
45410,1,0,0,62,62,0,1,0,1,0
64388,37965,0,0,66,66,0,1,0,1,0
39369,25174,0,0,63,63,0,1,0,1,0
45941,23386,0,0,60,60,0,1,0,1,0
65085,22114,0,0,64,64,0,1,0,1,0
0,0,0,0,99,99,0,1,0,1,0
61412,64115,0,0,64,64,0,1,0,1,0
56051,56205,0,0,63,63,0,1,0,1,0
56040,1311,0,0,65,65,0,1,0,1,0
46670,51505,0,0,141,141,0,1,0,1,0
61189,37965,0,0,66,66,0,1,0,1,0
60534,35440,0,0,62,62,0,1,0,1,0
13658,22,0,0,60,60,0,1,0,1,0
52073,22114,0,0,62,62,0,1,0,1,0
3406,17372,0,0,62,62,0,1,0,1,0
40165,57470,0,0,62,62,0,1,0,1,0
61900,35440,0,0,66,66,0,1,0,1,0
23379,57866,0,0,115,115,0,1,0,1,0
26900,22114,0,0,62,62,0,1,0,1,0
23077,50584,0,0,62,62,0,1,0,1,0
52439,22114,0,0,62,62,0,1,0,1,0
62549,64147,0,0,62,62,0,1,0,1,0
40318,2861,0,0,62,62,0,1,0,1,0
41706,57470,0,0,63,63,0,1,0,1,0
63908,44847,0,0,62,62,0,1,0,1,0
10390,22114,0,0,112,112,0,1,0,1,0
53482,37807,0,0,92,92,0,1,0,1,0
22922,35440,0,0,66,66,0,1,0,1,0
64334,57470,0,0,75,75,0,1,0,1,0
51324,64147,0,0,62,62,0,1,0,1,0
36117,51309,0,0,62,62,0,1,0,1,0
16460,25061,0,0,61,61,0,1,0,1,0
5979,25174,0,0,63,63,0,1,0,1,0
9283,57470,0,0,66,66,0,1,0,1,0
8552,47086,0,0,61,61,0,1,0,1,0
30235,15503,0,0,74,74,0,1,0,1,0
34693,51185,0,0,60,60,0,1,0,1,0
24381,52700,0,0,66,66,0,1,0,1,0
25523,52126,0,0,60,60,0,1,0,1,0
45941,23386,0,0,60,60,0,1,0,1,0
24042,23,0,0,60,60,0,1,0,1,0
48676,53392,0,0,60,60,0,1,0,1,0
26608,64147,0,0,62,62,0,1,0,1,0
14472,38247,0,0,132,132,0,1,0,1,0
19893,22114,0,0,131,131,0,1,0,1,0
64697,37965,0,0,66,66,0,1,0,1,0
8887,42244,0,0,144,144,0,1,0,1,0
53227,64097,0,0,65,65,0,1,0,1,0
42680,51158,0,0,62,62,0,1,0,1,0
0,0,0,0,98,98,0,1,0,1,0
55939,25174,0,0,62,62,0,1,0,1,0
56022,26467,0,0,62,62,0,1,0,1,0
45965,3414,0,0,60,60,0,1,0,1,0
42564,56205,0,0,62,62,0,1,0,1,0
58638,5900,0,0,62,62,0,1,0,1,0
60027,62413,0,0,66,66,0,1,0,1,0
50624,26467,0,0,66,66,0,1,0,1,0
65390,26467,0,0,62,62,0,1,0,1,0
1282,57470,0,0,132,132,0,1,0,1,0
30250,23,0,0,60,60,0,1,0,1,0
54059,50265,0,0,62,62,0,1,0,1,0
1847,64147,0,0,62,62,0,1,0,1,0
58482,57470,0,0,66,66,0,1,0,1,0
50753,36237,0,0,62,62,0,1,0,1,0
58259,24848,0,0,127,127,0,1,0,1,0
26872,26467,0,0,62,62,0,1,0,1,0
14923,51505,0,0,66,66,0,1,0,1,0
43796,50204,0,0,69,69,0,1,0,1,0
30557,25174,0,0,63,63,0,1,0,1,0
52079,26467,0,0,63,63,0,1,0,1,0
17232,22114,0,0,62,62,0,1,0,1,0
16277,56205,0,0,66,66,0,1,0,1,0
49051,11157,0,0,134,134,0,1,0,1,0
42587,51152,0,0,62,62,0,1,0,1,0
49241,22114,0,0,65,65,0,1,0,1,0
23990,26467,0,0,62,62,0,1,0,1,0
38806,22114,0,0,66,66,0,1,0,1,0
45964,2225,0,0,60,60,0,1,0,1,0
58638,5900,0,0,62,62,0,1,0,1,0
53260,62413,0,0,62,62,0,1,0,1,0
31845,55777,0,0,62,62,0,1,0,1,0
52382,35916,0,0,73,73,0,1,0,1,0
23004,48817,0,0,104,104,0,1,0,1,0
47357,50584,0,0,66,66,0,1,0,1,0
53071,25174,0,0,66,66,0,1,0,1,0
25523,35974,0,0,62,62,0,1,0,1,0
54858,51505,0,0,62,62,0,1,0,1,0
9136,56205,0,0,62,62,0,1,0,1,0
49577,35946,0,0,129,129,0,1,0,1,0
58924,37965,0,0,66,66,0,1,0,1,0
26084,36237,0,0,64,64,0,1,0,1,0
38664,37965,0,0,62,62,0,1,0,1,0
35374,56205,0,0,62,62,0,1,0,1,0
36001,30205,0,0,97,97,0,1,0,1,0
56337,22114,0,0,63,63,0,1,0,1,0
1660,8696,0,0,62,62,0,1,0,1,0
59074,25174,0,0,66,66,0,1,0,1,0
50081,44847,0,0,70,70,0,1,0,1,0
54414,50584,0,0,136,136,0,1,0,1,0
41495,5900,0,0,60,60,0,1,0,1,0
56622,25174,0,0,66,66,0,1,0,1,0
61395,50584,0,0,141,141,0,1,0,1,0
52962,58804,0,0,64,64,0,1,0,1,0
6666,5000,0,0,60,60,0,1,0,1,0
23934,41615,0,0,145,145,0,1,0,1,0
14148,1,0,0,62,62,0,1,0,1,0
58638,5900,0,0,62,62,0,1,0,1,0
57987,56125,0,0,90,90,0,1,0,1,0
53960,30041,0,0,66,66,0,1,0,1,0
50934,53733,0,0,66,66,0,1,0,1,0
35490,44847,0,0,67,67,0,1,0,1,0
50040,44847,0,0,67,67,0,1,0,1,0
7222,57470,0,0,62,62,0,1,0,1,0
58856,9582,0,0,61,61,0,1,0,1,0
27368,22114,0,0,85,85,0,1,0,1,0
56622,25174,0,0,66,66,0,1,0,1,0
4642,1842,0,0,125,125,0,1,0,1,0
7725,25174,0,0,63,63,0,1,0,1,0
1097,50355,0,0,62,62,0,1,0,1,0
56437,43890,0,0,66,66,0,1,0,1,0
62008,23718,0,0,66,66,0,1,0,1,0
53928,15503,0,0,62,62,0,1,0,1,0
22733,26467,0,0,62,62,0,1,0,1,0
3761,64147,0,0,65,65,0,1,0,1,0
3330,7052,0,0,66,66,0,1,0,1,0
13518,25174,0,0,101,101,0,1,0,1,0
51174,56205,0,0,64,64,0,1,0,1,0
58638,5900,0,0,62,62,0,1,0,1,0
43826,30188,0,0,86,86,0,1,0,1,0
62806,25174,0,0,98,98,0,1,0,1,0
60427,22114,0,0,64,64,0,1,0,1,0
17171,22114,0,0,66,66,0,1,0,1,0
30093,48855,0,0,146,146,0,1,0,1,0
58638,5900,0,0,62,62,0,1,0,1,0
63460,55160,0,0,65,65,0,1,0,1,0
45941,23386,0,0,60,60,0,1,0,1,0
53714,50584,0,0,62,62,0,1,0,1,0
16296,57470,0,0,62,62,0,1,0,1,0
46839,51050,0,0,62,62,0,1,0,1,0
0,0,0,0,70,70,0,1,0,1,0
56613,9571,0,0,75,75,0,1,0,1,0
52838,37965,0,0,66,66,0,1,0,1,0
59377,2491,0,0,90,90,0,1,0,1,0
52439,35894,0,0,73,73,0,1,0,1,0
55525,56205,0,0,66,66,0,1,0,1,0
19936,22114,0,0,76,76,0,1,0,1,0
58207,51505,0,0,62,62,0,1,0,1,0
41841,25174,0,0,65,65,0,1,0,1,0
18837,57642,0,0,62,62,0,1,0,1,0
37164,21247,0,0,65,65,0,1,0,1,0
60476,64147,0,0,62,62,0,1,0,1,0
58638,5900,0,0,62,62,0,1,0,1,0
32796,50584,0,0,129,129,0,1,0,1,0
51298,57470,0,0,66,66,0,1,0,1,0
26799,57747,0,0,63,63,0,1,0,1,0
50496,23736,0,0,122,122,0,1,0,1,0
53775,51505,0,0,66,66,0,1,0,1,0
44664,50949,0,0,62,62,0,1,0,1,0
19875,30170,0,0,145,145,0,1,0,1,0
443,4205,0,0,248,248,0,1,0,1,0
1865,25174,0,0,62,62,0,1,0,1,0
35479,15503,0,0,63,63,0,1,0,1,0
45291,25174,0,0,62,62,0,1,0,1,0
48953,50584,0,0,146,146,0,1,0,1,0
53097,36237,0,0,62,62,0,1,0,1,0
58638,5900,0,0,62,62,0,1,0,1,0
13526,51383,0,0,62,62,0,1,0,1,0
49492,11392,0,0,62,62,0,1,0,1,0
49730,14983,0,0,66,66,0,1,0,1,0
29424,37807,0,0,66,66,0,1,0,1,0
24706,51438,0,0,74,74,0,1,0,1,0
54773,50584,0,0,65,65,0,1,0,1,0
1972,57470,0,0,78,78,0,1,0,1,0
19617,39004,0,0,137,137,0,1,0,1,0
52726,56205,0,0,64,64,0,1,0,1,0
10306,57470,0,0,62,62,0,1,0,1,0
21861,39028,0,0,61,61,0,1,0,1,0
80,9918,0,0,60,60,0,1,0,1,0
56388,22114,0,0,66,66,0,1,0,1,0
64214,25174,0,0,65,65,0,1,0,1,0
10669,49756,0,0,60,60,0,1,0,1,0
25588,2323,0,0,60,60,0,1,0,1,0
1027,33472,0,0,122,122,0,1,0,1,0
16330,50584,0,0,62,62,0,1,0,1,0
59430,50584,0,0,66,66,0,1,0,1,0
50052,65008,0,0,60,60,0,1,0,1,0
39619,37965,0,0,66,66,0,1,0,1,0
22677,25174,0,0,66,66,0,1,0,1,0
49544,22114,0,0,66,66,0,1,0,1,0
53188,26467,0,0,64,64,0,1,0,1,0
29512,30188,0,0,66,66,0,1,0,1,0
46495,4607,0,0,60,60,0,1,0,1,0
32721,37965,0,0,62,62,0,1,0,1,0
21043,57470,0,0,62,62,0,1,0,1,0
30311,48817,0,0,145,145,0,1,0,1,0
43584,24748,0,0,156,156,0,1,0,1,0
31667,35440,0,0,62,62,0,1,0,1,0
54681,21247,0,0,66,66,0,1,0,1,0
38589,11212,0,0,117,117,0,1,0,1,0
18124,37807,0,0,69,69,0,1,0,1,0
61503,50887,0,0,66,66,0,1,0,1,0
22604,64147,0,0,65,65,0,1,0,1,0
43840,50265,0,0,72,72,0,1,0,1,0
55587,43890,0,0,66,66,0,1,0,1,0
17027,1,0,0,62,62,0,1,0,1,0
14757,25174,0,0,81,81,0,1,0,1,0
64878,25174,0,0,66,66,0,1,0,1,0
443,61686,0,0,1016,1016,0,1,0,1,0
49351,22114,0,0,62,62,0,1,0,1,0
10939,30203,0,0,146,146,0,1,0,1,0
18752,35440,0,0,97,97,0,1,0,1,0
64940,26467,0,0,62,62,0,1,0,1,0
61888,1,0,0,142,142,0,1,0,1,0
57431,15503,0,0,66,66,0,1,0,1,0
51279,52369,0,0,100,100,0,1,0,1,0
55853,62413,0,0,63,63,0,1,0,1,0
3938,50584,0,0,62,62,0,1,0,1,0
8071,22114,0,0,66,66,0,1,0,1,0
15205,25174,0,0,141,141,0,1,0,1,0
14989,57470,0,0,79,79,0,1,0,1,0
58638,5900,0,0,62,62,0,1,0,1,0
59024,2822,0,0,65,65,0,1,0,1,0
26425,26417,0,0,62,62,0,1,0,1,0
39178,22114,0,0,143,143,0,1,0,1,0
58638,5900,0,0,62,62,0,1,0,1,0
44411,37965,0,0,62,62,0,1,0,1,0
34489,35440,0,0,63,63,0,1,0,1,0
49797,30188,0,0,66,66,0,1,0,1,0
56353,26467,0,0,66,66,0,1,0,1,0
65082,30188,0,0,66,66,0,1,0,1,0
51413,57470,0,0,72,72,0,1,0,1,0
43688,22114,0,0,66,66,0,1,0,1,0
63385,25174,0,0,66,66,0,1,0,1,0
58638,5900,0,0,62,62,0,1,0,1,0
15278,25174,0,0,146,146,0,1,0,1,0
45964,55559,0,0,60,60,0,1,0,1,0
16378,35410,0,0,61,61,0,1,0,1,0
53525,62413,0,0,65,65,0,1,0,1,0
443,1785,0,0,97,97,0,1,0,1,0
56397,26467,0,0,65,65,0,1,0,1,0
58638,5900,0,0,62,62,0,1,0,1,0
53285,37686,0,0,62,62,0,1,0,1,0
58638,5900,0,0,62,62,0,1,0,1,0
52363,64111,0,0,64,64,0,1,0,1,0
62029,57703,0,0,63,63,0,1,0,1,0
1884,43890,0,0,62,62,0,1,0,1,0
33725,22114,0,0,146,146,0,1,0,1,0
40241,50135,0,0,69,69,0,1,0,1,0
11756,23,0,0,60,60,0,1,0,1,0
52295,64115,0,0,64,64,0,1,0,1,0
25656,11655,0,0,65,65,0,1,0,1,0
34786,37965,0,0,62,62,0,1,0,1,0
54181,57470,0,0,66,66,0,1,0,1,0
6881,6881,0,0,146,146,0,1,0,1,0
37063,22774,0,0,64,64,0,1,0,1,0
48583,48687,0,0,149,149,0,1,0,1,0
59781,56205,0,0,66,66,0,1,0,1,0
52889,37965,0,0,66,66,0,1,0,1,0
60136,56205,0,0,63,63,0,1,0,1,0
56545,11392,0,0,64,64,0,1,0,1,0
58914,37965,0,0,66,66,0,1,0,1,0
65040,37915,0,0,64,64,0,1,0,1,0
10669,49756,0,0,60,60,0,1,0,1,0
51737,25174,0,0,66,66,0,1,0,1,0
42238,25174,0,0,62,62,0,1,0,1,0
46511,50584,0,0,66,66,0,1,0,1,0
44906,26467,0,0,62,62,0,1,0,1,0
3478,61463,0,0,1294,1294,0,1,0,1,0
11704,25174,0,0,62,62,0,1,0,1,0
59241,62413,0,0,63,63,0,1,0,1,0
3169,22114,0,0,64,64,0,1,0,1,0
58638,5900,0,0,62,62,0,1,0,1,0
2409,37891,0,0,63,63,0,1,0,1,0
65287,44847,0,0,80,80,0,1,0,1,0
25249,22114,0,0,113,113,0,1,0,1,0
26011,1433,0,0,60,60,0,1,0,1,0
58638,5900,0,0,62,62,0,1,0,1,0
28938,30188,0,0,64,64,0,1,0,1,0
38629,25174,0,0,65,65,0,1,0,1,0
60568,25174,0,0,66,66,0,1,0,1,0
49415,22114,0,0,62,62,0,1,0,1,0
64535,37965,0,0,65,65,0,1,0,1,0
10215,44847,0,0,66,66,0,1,0,1,0
50877,30041,0,0,63,63,0,1,0,1,0
13285,29892,0,0,145,145,0,1,0,1,0
26593,35290,0,0,62,62,0,1,0,1,0
56557,64147,0,0,62,62,0,1,0,1,0
16387,35308,0,0,60,60,0,1,0,1,0
3073,44847,0,0,62,62,0,1,0,1,0
31605,50584,0,0,133,133,0,1,0,1,0
47943,50584,0,0,70,70,0,1,0,1,0
58638,5900,0,0,62,62,0,1,0,1,0
10273,21247,0,0,66,66,0,1,0,1,0
3478,61463,0,0,236,236,0,1,0,1,0
61185,54532,0,0,62,62,0,1,0,1,0
51300,64147,0,0,66,66,0,1,0,1,0
26555,22114,0,0,86,86,0,1,0,1,0
57837,64147,0,0,66,66,0,1,0,1,0
16306,50584,0,0,127,127,0,1,0,1,0
63993,25174,0,0,62,62,0,1,0,1,0
50613,26467,0,0,66,66,0,1,0,1,0
443,62732,0,0,227,227,0,1,0,1,0
30213,64623,0,0,61,61,0,1,0,1,0
80,9918,0,0,60,60,0,1,0,1,0
60140,37965,0,0,66,66,0,1,0,1,0
27096,64147,0,0,64,64,0,1,0,1,0
10253,21247,0,0,62,62,0,1,0,1,0
2883,35440,0,0,64,64,0,1,0,1,0
58638,5900,0,0,62,62,0,1,0,1,0
52125,49303,0,0,68,68,0,1,0,1,0
23218,62413,0,0,65,65,0,1,0,1,0
56906,50584,0,0,62,62,0,1,0,1,0
50662,35440,0,0,115,115,0,1,0,1,0
62115,57470,0,0,66,66,0,1,0,1,0
11136,15503,0,0,145,145,0,1,0,1,0
58638,5900,0,0,62,62,0,1,0,1,0
53782,25174,0,0,66,66,0,1,0,1,0
20632,57470,0,0,62,62,0,1,0,1,0
443,18459,0,0,61,61,0,1,0,1,0
65003,57470,0,0,78,78,0,1,0,1,0
58638,5900,0,0,62,62,0,1,0,1,0
22443,30188,0,0,63,63,0,1,0,1,0
1190,25174,0,0,91,91,0,1,0,1,0
26881,37965,0,0,64,64,0,1,0,1,0
60646,11392,0,0,66,66,0,1,0,1,0
15854,50584,0,0,97,97,0,1,0,1,0
3272,35436,0,0,66,66,0,1,0,1,0
50535,51505,0,0,64,64,0,1,0,1,0
58562,11392,0,0,66,66,0,1,0,1,0
61392,64147,0,0,62,62,0,1,0,1,0
14327,56205,0,0,100,100,0,1,0,1,0
43149,31850,0,0,134,134,0,1,0,1,0
35125,57470,0,0,72,72,0,1,0,1,0
61803,35440,0,0,66,66,0,1,0,1,0
20453,64147,0,0,62,62,0,1,0,1,0
40283,48817,0,0,144,144,0,1,0,1,0
50628,23117,0,0,62,62,0,1,0,1,0
61149,57470,0,0,62,62,0,1,0,1,0
35205,22114,0,0,62,62,0,1,0,1,0
14319,51358,0,0,64,64,0,1,0,1,0
63690,64147,0,0,62,62,0,1,0,1,0
59084,25174,0,0,66,66,0,1,0,1,0
18645,42707,0,0,63,63,0,1,0,1,0
62924,25174,0,0,146,146,0,1,0,1,0
48088,57470,0,0,64,64,0,1,0,1,0
14824,57649,0,0,69,69,0,1,0,1,0
31767,56119,0,0,62,62,0,1,0,1,0
3478,61463,0,0,228,228,0,1,0,1,0
45941,23388,0,0,60,60,0,1,0,1,0
63206,35440,0,0,123,123,0,1,0,1,0
59413,51505,0,0,62,62,0,1,0,1,0
58638,5900,0,0,62,62,0,1,0,1,0
18745,64147,0,0,66,66,0,1,0,1,0
6902,55540,0,0,143,143,0,1,0,1,0
36564,25174,0,0,62,62,0,1,0,1,0
57116,35496,0,0,76,76,0,1,0,1,0
11019,30188,0,0,140,140,0,1,0,1,0
49656,37965,0,0,70,70,0,1,0,1,0
28875,51505,0,0,88,88,0,1,0,1,0
52735,25174,0,0,62,62,0,1,0,1,0
1498,22114,0,0,62,62,0,1,0,1,0
48706,23393,0,0,60,60,0,1,0,1,0
65094,37810,0,0,62,62,0,1,0,1,0
2800,25174,0,0,93,93,0,1,0,1,0
58543,30188,0,0,66,66,0,1,0,1,0
61114,37965,0,0,63,63,0,1,0,1,0
26689,57470,0,0,62,62,0,1,0,1,0
18203,23,0,0,60,60,0,1,0,1,0
52862,56205,0,0,66,66,0,1,0,1,0
60899,25174,0,0,63,63,0,1,0,1,0
65040,26467,0,0,64,64,0,1,0,1,0
443,21947,0,0,71,71,0,1,0,1,0
50085,57470,0,0,66,66,0,1,0,1,0
22445,51447,0,0,62,62,0,1,0,1,0
53928,15503,0,0,92,92,0,1,0,1,0
51681,44847,0,0,65,65,0,1,0,1,0
46572,324,0,0,759,759,0,1,0,1,0
57343,18375,0,0,65,65,0,1,0,1,0
32536,47889,0,0,66,66,0,1,0,1,0
65270,3855,0,0,78,78,0,1,0,1,0
1067,51221,0,0,136,136,0,1,0,1,0
26935,25174,0,0,62,62,0,1,0,1,0
55938,43890,0,0,65,65,0,1,0,1,0
43483,35440,0,0,62,62,0,1,0,1,0
57832,52700,0,0,66,66,0,1,0,1,0
11551,23,0,0,60,60,0,1,0,1,0
16654,50265,0,0,62,62,0,1,0,1,0
2727,7217,0,0,62,62,0,1,0,1,0
52166,26467,0,0,66,66,0,1,0,1,0
45941,23386,0,0,60,60,0,1,0,1,0
1433,51221,0,0,63,63,0,1,0,1,0
7396,32752,0,0,95,95,0,1,0,1,0
57849,64147,0,0,66,66,0,1,0,1,0
50094,30188,0,0,66,66,0,1,0,1,0
58638,5900,0,0,62,62,0,1,0,1,0
52819,15503,0,0,66,66,0,1,0,1,0
18398,21247,0,0,66,66,0,1,0,1,0
40424,25187,0,0,72,72,0,1,0,1,0
52338,64122,0,0,66,66,0,1,0,1,0
2990,64147,0,0,65,65,0,1,0,1,0
52712,22114,0,0,62,62,0,1,0,1,0
51562,37950,0,0,71,71,0,1,0,1,0
41648,56205,0,0,66,66,0,1,0,1,0
58638,5900,0,0,62,62,0,1,0,1,0
64049,23718,0,0,66,66,0,1,0,1,0
50794,23117,0,0,63,63,0,1,0,1,0
2447,35440,0,0,124,124,0,1,0,1,0
26571,44847,0,0,65,65,0,1,0,1,0
58638,5900,0,0,62,62,0,1,0,1,0
17176,22114,0,0,65,65,0,1,0,1,0
5433,23,0,0,60,60,0,1,0,1,0
46112,44847,0,0,146,146,0,1,0,1,0
535,1864,0,0,104,104,0,1,0,1,0
62791,56205,0,0,63,63,0,1,0,1,0
52701,9615,0,0,92,92,0,1,0,1,0
58288,5272,0,0,135,135,0,1,0,1,0
56587,25174,0,0,130,130,0,1,0,1,0
57290,51193,0,0,66,66,0,1,0,1,0
54280,3398,0,0,60,60,0,1,0,1,0
58021,22114,0,0,65,65,0,1,0,1,0
3866,37965,0,0,66,66,0,1,0,1,0
21071,25174,0,0,62,62,0,1,0,1,0
11100,57631,0,0,62,62,0,1,0,1,0
51746,64147,0,0,66,66,0,1,0,1,0
55498,50584,0,0,66,66,0,1,0,1,0
45614,2159,0,0,90,90,0,1,0,1,0
53075,25174,0,0,66,66,0,1,0,1,0
24279,26446,0,0,72,72,0,1,0,1,0
6061,25174,0,0,91,91,0,1,0,1,0
14731,57744,0,0,67,67,0,1,0,1,0
57448,57470,0,0,63,63,0,1,0,1,0
19527,212,0,0,60,60,0,1,0,1,0
45908,33330,0,0,60,60,0,1,0,1,0
57137,51505,0,0,66,66,0,1,0,1,0
12616,12087,0,0,62,62,0,1,0,1,0
3169,22114,0,0,62,62,0,1,0,1,0
1972,8508,0,0,101,101,0,1,0,1,0
40426,22114,0,0,63,63,0,1,0,1,0
49283,25174,0,0,64,64,0,1,0,1,0
43734,22114,0,0,66,66,0,1,0,1,0
58326,50584,0,0,108,108,0,1,0,1,0
57913,26467,0,0,62,62,0,1,0,1,0
49364,50584,0,0,62,62,0,1,0,1,0
0,0,0,0,161,161,0,2,0,2,0
54103,5940,0,0,62,62,0,1,0,1,0
61844,25174,0,0,63,63,0,1,0,1,0
50438,25174,0,0,65,65,0,1,0,1,0
35539,15503,0,0,64,64,0,1,0,1,0
65051,37895,0,0,66,66,0,1,0,1,0
50674,35440,0,0,139,139,0,1,0,1,0
19496,25174,0,0,62,62,0,1,0,1,0
63689,64146,0,0,66,66,0,1,0,1,0
28804,37965,0,0,62,62,0,1,0,1,0
58638,5900,0,0,62,62,0,1,0,1,0
62181,22114,0,0,66,66,0,1,0,1,0
59123,57470,0,0,66,66,0,1,0,1,0
58406,62413,0,0,129,129,0,1,0,1,0
23274,50584,0,0,62,62,0,1,0,1,0
62392,57470,0,0,66,66,0,1,0,1,0
0,0,0,0,99,99,0,1,0,1,0
35465,26467,0,0,62,62,0,1,0,1,0
58638,5900,0,0,62,62,0,1,0,1,0
12119,22114,0,0,65,65,0,1,0,1,0
22984,15503,0,0,107,107,0,1,0,1,0
59784,25174,0,0,65,65,0,1,0,1,0
59965,62413,0,0,63,63,0,1,0,1,0
2732,30188,0,0,62,62,0,1,0,1,0
63677,15503,0,0,66,66,0,1,0,1,0
54854,37965,0,0,62,62,0,1,0,1,0
6356,26467,0,0,62,62,0,1,0,1,0
51018,22114,0,0,125,125,0,1,0,1,0
17678,44847,0,0,146,146,0,1,0,1,0
3478,61463,0,0,252,252,0,1,0,1,0
23535,57663,0,0,145,145,0,1,0,1,0
62575,12207,0,0,66,66,0,1,0,1,0
51414,22,0,0,60,60,0,1,0,1,0
2014,43890,0,0,65,65,0,1,0,1,0
58638,5900,0,0,62,62,0,1,0,1,0
54367,64147,0,0,62,62,0,1,0,1,0
53455,23,0,0,60,60,0,1,0,1,0
64889,35993,0,0,73,73,0,1,0,1,0
60129,55442,0,0,62,62,0,1,0,1,0
11435,30188,0,0,63,63,0,1,0,1,0
49378,57470,0,0,63,63,0,1,0,1,0
53445,44847,0,0,64,64,0,1,0,1,0
5164,50427,0,0,62,62,0,1,0,1,0
42354,22114,0,0,65,65,0,1,0,1,0
42252,33303,0,0,60,60,0,1,0,1,0
7001,22114,0,0,62,62,0,1,0,1,0
56386,50584,0,0,63,63,0,1,0,1,0
34910,31768,0,0,62,62,0,1,0,1,0
56213,26467,0,0,63,63,0,1,0,1,0
55353,50584,0,0,66,66,0,1,0,1,0
80,53945,0,0,60,60,0,1,0,1,0
37831,55150,0,0,144,144,0,1,0,1,0
53030,56205,0,0,66,66,0,1,0,1,0
60588,23718,0,0,62,62,0,1,0,1,0
16500,25174,0,0,65,65,0,1,0,1,0
18357,51180,0,0,62,62,0,1,0,1,0
31566,22114,0,0,63,63,0,1,0,1,0
63388,25174,0,0,66,66,0,1,0,1,0
58638,5900,0,0,62,62,0,1,0,1,0
51094,35440,0,0,62,62,0,1,0,1,0
58638,5900,0,0,62,62,0,1,0,1,0
25207,48817,0,0,62,62,0,1,0,1,0
10477,44847,0,0,63,63,0,1,0,1,0
55515,50584,0,0,66,66,0,1,0,1,0
14309,56205,0,0,96,96,0,1,0,1,0
57131,8055,0,0,145,145,0,1,0,1,0
64363,22114,0,0,66,66,0,1,0,1,0
49976,22114,0,0,63,63,0,1,0,1,0
34677,51185,0,0,60,60,0,1,0,1,0
53714,36117,0,0,63,63,0,1,0,1,0
33524,44847,0,0,62,62,0,1,0,1,0
50470,61463,0,0,86,86,0,1,0,1,0
54917,60043,0,0,66,66,0,1,0,1,0
58638,5900,0,0,62,62,0,1,0,1,0
50160,57470,0,0,146,146,0,1,0,1,0
13985,34159,0,0,66,66,0,1,0,1,0
32728,30188,0,0,62,62,0,1,0,1,0
10028,25604,0,0,62,62,0,1,0,1,0
9440,51505,0,0,66,66,0,1,0,1,0
10864,23,0,0,60,60,0,1,0,1,0
15605,50265,0,0,62,62,0,1,0,1,0
3680,56163,0,0,138,138,0,1,0,1,0
16387,64075,0,0,60,60,0,1,0,1,0
58413,56205,0,0,64,64,0,1,0,1,0
57967,22114,0,0,100,100,0,1,0,1,0
7688,23,0,0,60,60,0,1,0,1,0
22683,39210,0,0,60,60,0,1,0,1,0
49394,50584,0,0,62,62,0,1,0,1,0
47930,25174,0,0,62,62,0,1,0,1,0
51474,11392,0,0,66,66,0,1,0,1,0
51904,22114,0,0,63,63,0,1,0,1,0
30625,25174,0,0,62,62,0,1,0,1,0
50072,23,0,0,60,60,0,1,0,1,0
55501,64117,0,0,62,62,0,1,0,1,0
23233,11238,0,0,111,111,0,1,0,1,0
25473,35717,0,0,130,130,0,1,0,1,0
49323,51505,0,0,66,66,0,1,0,1,0
42074,22114,0,0,117,117,0,1,0,1,0
50052,65008,0,0,60,60,0,1,0,1,0
54142,64147,0,0,66,66,0,1,0,1,0
1025,30047,0,0,101,101,0,1,0,1,0
13285,29892,0,0,145,145,0,1,0,1,0
5705,37965,0,0,66,66,0,1,0,1,0
10069,22114,0,0,62,62,0,1,0,1,0
2098,25174,0,0,62,62,0,1,0,1,0
60196,53,0,0,88,88,0,1,0,1,0
55145,11392,0,0,66,66,0,1,0,1,0
39068,64147,0,0,110,110,0,1,0,1,0
58638,5900,0,0,62,62,0,1,0,1,0
1114,37965,0,0,62,62,0,1,0,1,0
50644,51505,0,0,66,66,0,1,0,1,0
46116,51505,0,0,62,62,0,1,0,1,0
60481,48007,0,0,143,143,0,1,0,1,0
51632,61689,0,0,66,66,0,1,0,1,0
52531,36237,0,0,125,125,0,1,0,1,0
64541,43840,0,0,62,62,0,1,0,1,0
443,20087,0,0,83,83,0,1,0,1,0
49226,21247,0,0,62,62,0,1,0,1,0
64586,50584,0,0,84,84,0,1,0,1,0
62849,62413,0,0,64,64,0,1,0,1,0
51492,17479,0,0,94,94,0,1,0,1,0
50427,44847,0,0,64,64,0,1,0,1,0
20619,25174,0,0,65,65,0,1,0,1,0
13285,29892,0,0,145,145,0,1,0,1,0
52487,50512,0,0,62,62,0,1,0,1,0
60438,50584,0,0,101,101,0,1,0,1,0
35349,35440,0,0,136,136,0,1,0,1,0
37025,25174,0,0,146,146,0,1,0,1,0
42034,28189,0,0,126,126,0,1,0,1,0
4772,37965,0,0,66,66,0,1,0,1,0
60854,26991,0,0,63,63,0,1,0,1,0
58879,43890,0,0,66,66,0,1,0,1,0
55565,64147,0,0,65,65,0,1,0,1,0
25638,27460,0,0,61,61,0,1,0,1,0
57704,64147,0,0,66,66,0,1,0,1,0
42799,22114,0,0,62,62,0,1,0,1,0
35506,22114,0,0,66,66,0,1,0,1,0
62696,50584,0,0,62,62,0,1,0,1,0
58638,5900,0,0,62,62,0,1,0,1,0
39098,51505,0,0,119,119,0,1,0,1,0
55600,22,0,0,60,60,0,1,0,1,0
27154,22114,0,0,75,75,0,1,0,1,0
55997,44847,0,0,62,62,0,1,0,1,0
52604,25174,0,0,65,65,0,1,0,1,0
58462,10011,0,0,73,73,0,1,0,1,0
11136,17500,0,0,62,62,0,1,0,1,0
54365,64147,0,0,62,62,0,1,0,1,0
57557,30199,0,0,66,66,0,1,0,1,0
53266,64097,0,0,63,63,0,1,0,1,0
30563,25174,0,0,64,64,0,1,0,1,0
60890,25174,0,0,66,66,0,1,0,1,0
19394,44847,0,0,66,66,0,1,0,1,0
42749,42352,0,0,103,103,0,1,0,1,0
54991,36829,0,0,63,63,0,1,0,1,0
2097,8432,0,0,117,117,0,1,0,1,0
38852,37965,0,0,62,62,0,1,0,1,0
443,54507,0,0,82,82,0,1,0,1,0
51768,26467,0,0,62,62,0,1,0,1,0
64333,57470,0,0,78,78,0,1,0,1,0
443,62455,0,0,189,189,0,1,0,1,0
50302,1450,0,0,62,62,0,1,0,1,0
21081,25174,0,0,112,112,0,1,0,1,0
443,45940,0,0,85,85,0,1,0,1,0
443,20087,0,0,83,83,0,1,0,1,0
61433,50584,0,0,64,64,0,1,0,1,0
56020,64147,0,0,62,62,0,1,0,1,0
58638,5900,0,0,62,62,0,1,0,1,0
5228,3434,0,0,345,345,0,1,0,1,0
53742,37965,0,0,66,66,0,1,0,1,0
47962,16069,0,0,62,62,0,1,0,1,0
58638,5900,0,0,62,62,0,1,0,1,0
35496,15503,0,0,67,67,0,1,0,1,0
40600,23959,0,0,114,114,0,1,0,1,0
17026,57762,0,0,64,64,0,1,0,1,0
32611,51299,0,0,64,64,0,1,0,1,0
30820,13188,0,0,145,145,0,1,0,1,0
62442,2635,0,0,66,66,0,1,0,1,0
47962,16069,0,0,62,62,0,1,0,1,0
28378,56205,0,0,62,62,0,1,0,1,0
50116,22,0,0,60,60,0,1,0,1,0
18070,25174,0,0,62,62,0,1,0,1,0
55967,35440,0,0,65,65,0,1,0,1,0
57029,35016,0,0,64,64,0,1,0,1,0
56761,9571,0,0,64,64,0,1,0,1,0
58213,37807,0,0,66,66,0,1,0,1,0
60793,53733,0,0,66,66,0,1,0,1,0
39982,257,0,0,60,60,0,1,0,1,0
19116,56230,0,0,63,63,0,1,0,1,0
52238,46323,0,0,62,62,0,1,0,1,0
1026,64147,0,0,62,62,0,1,0,1,0
14867,57603,0,0,69,69,0,1,0,1,0
51619,56205,0,0,66,66,0,1,0,1,0
51228,44847,0,0,66,66,0,1,0,1,0
23456,57566,0,0,110,110,0,1,0,1,0
57993,22114,0,0,65,65,0,1,0,1,0
24297,50584,0,0,63,63,0,1,0,1,0
13100,52155,0,0,129,129,0,1,0,1,0
52126,50744,0,0,62,62,0,1,0,1,0
62696,50584,0,0,65,65,0,1,0,1,0
11036,22114,0,0,135,135,0,1,0,1,0
12645,22114,0,0,89,89,0,1,0,1,0
43615,50931,0,0,143,143,0,1,0,1,0
5223,44091,0,0,84,84,0,1,0,1,0
58766,9564,0,0,62,62,0,1,0,1,0
11864,22,0,0,60,60,0,1,0,1,0
58638,5900,0,0,62,62,0,1,0,1,0
22971,50584,0,0,62,62,0,1,0,1,0
3709,56071,0,0,63,63,0,1,0,1,0
34474,51198,0,0,60,60,0,1,0,1,0
56909,50584,0,0,65,65,0,1,0,1,0
63023,51505,0,0,66,66,0,1,0,1,0
53714,25174,0,0,66,66,0,1,0,1,0
36785,25174,0,0,66,66,0,1,0,1,0
14423,37965,0,0,62,62,0,1,0,1,0
26068,38050,0,0,64,64,0,1,0,1,0
64548,50306,0,0,65,65,0,1,0,1,0
56321,15503,0,0,146,146,0,1,0,1,0
11716,37965,0,0,62,62,0,1,0,1,0
58250,23,0,0,60,60,0,1,0,1,0
52190,46355,0,0,62,62,0,1,0,1,0
37571,44847,0,0,62,62,0,1,0,1,0
15403,51505,0,0,66,66,0,1,0,1,0
9067,44847,0,0,62,62,0,1,0,1,0
60312,57470,0,0,74,74,0,1,0,1,0
50084,57470,0,0,66,66,0,1,0,1,0
46611,50584,0,0,64,64,0,1,0,1,0
54740,50584,0,0,66,66,0,1,0,1,0
57853,64147,0,0,66,66,0,1,0,1,0
64880,9694,0,0,66,66,0,1,0,1,0
61644,22114,0,0,62,62,0,1,0,1,0
10961,22114,0,0,62,62,0,1,0,1,0
13227,57470,0,0,62,62,0,1,0,1,0
37034,25174,0,0,98,98,0,1,0,1,0
50734,37965,0,0,62,62,0,1,0,1,0
1402,56191,0,0,67,67,0,1,0,1,0
56442,11392,0,0,65,65,0,1,0,1,0
44173,37965,0,0,63,63,0,1,0,1,0
42044,60043,0,0,66,66,0,1,0,1,0
13062,52304,0,0,66,66,0,1,0,1,0
49925,26411,0,0,89,89,0,1,0,1,0
50811,64147,0,0,63,63,0,1,0,1,0
23179,11193,0,0,125,125,0,1,0,1,0
28853,30188,0,0,62,62,0,1,0,1,0
59248,51120,0,0,63,63,0,1,0,1,0
64822,37965,0,0,62,62,0,1,0,1,0
20528,26467,0,0,66,66,0,1,0,1,0
56067,25174,0,0,62,62,0,1,0,1,0
63880,22114,0,0,62,62,0,1,0,1,0
6917,37965,0,0,66,66,0,1,0,1,0
49911,25174,0,0,64,64,0,1,0,1,0
50099,30736,0,0,62,62,0,1,0,1,0
35957,51185,0,0,60,60,0,1,0,1,0
65136,55567,0,0,66,66,0,1,0,1,0
36212,51383,0,0,63,63,0,1,0,1,0
60322,30188,0,0,64,64,0,1,0,1,0
11040,50584,0,0,66,66,0,1,0,1,0
55109,25174,0,0,63,63,0,1,0,1,0
56337,44601,0,0,64,64,0,1,0,1,0
58638,5900,0,0,62,62,0,1,0,1,0
6738,25174,0,0,62,62,0,1,0,1,0
58894,9586,0,0,60,60,0,1,0,1,0
46739,64147,0,0,95,95,0,1,0,1,0
45682,37965,0,0,62,62,0,1,0,1,0
64252,62413,0,0,63,63,0,1,0,1,0
26084,36237,0,0,64,64,0,1,0,1,0
56127,37965,0,0,66,66,0,1,0,1,0
64844,37762,0,0,63,63,0,1,0,1,0
22856,22114,0,0,64,64,0,1,0,1,0
39132,44847,0,0,63,63,0,1,0,1,0
6336,44843,0,0,66,66,0,1,0,1,0
33130,50584,0,0,119,119,0,1,0,1,0
80,37649,0,0,60,60,0,1,0,1,0
53048,57470,0,0,74,74,0,1,0,1,0
50186,25174,0,0,66,66,0,1,0,1,0
26795,9744,0,0,99,99,0,1,0,1,0
29424,37807,0,0,66,66,0,1,0,1,0
63387,25174,0,0,66,66,0,1,0,1,0
50132,31573,0,0,66,66,0,1,0,1,0
16660,55783,0,0,62,62,0,1,0,1,0
63990,25174,0,0,62,62,0,1,0,1,0
57131,7774,0,0,145,145,0,1,0,1,0
58638,5900,0,0,62,62,0,1,0,1,0
50806,51505,0,0,66,66,0,1,0,1,0
54593,51505,0,0,66,66,0,1,0,1,0
14191,51154,0,0,96,96,0,1,0,1,0
28855,35954,0,0,66,66,0,1,0,1,0
443,61686,0,0,1484,1484,0,1,0,1,0
53186,50584,0,0,66,66,0,1,0,1,0
5623,37965,0,0,63,63,0,1,0,1,0
60002,64147,0,0,64,64,0,1,0,1,0
3234,45074,0,0,81,81,0,1,0,1,0
52074,11392,0,0,64,64,0,1,0,1,0
23623,37850,0,0,62,62,0,1,0,1,0
57352,37965,0,0,63,63,0,1,0,1,0
61345,21247,0,0,62,62,0,1,0,1,0
53811,22114,0,0,62,62,0,1,0,1,0
1818,22114,0,0,62,62,0,1,0,1,0
30496,57470,0,0,62,62,0,1,0,1,0
61848,17328,0,0,66,66,0,1,0,1,0
15239,36259,0,0,62,62,0,1,0,1,0
59893,62413,0,0,66,66,0,1,0,1,0
8117,22114,0,0,66,66,0,1,0,1,0
11926,57470,0,0,64,64,0,1,0,1,0
41111,55883,0,0,145,145,0,1,0,1,0
0,0,0,0,98,98,0,1,0,1,0
57283,64147,0,0,66,66,0,1,0,1,0
37182,21247,0,0,64,64,0,1,0,1,0
58638,5900,0,0,62,62,0,1,0,1,0
50086,22,0,0,60,60,0,1,0,1,0
50354,37965,0,0,66,66,0,1,0,1,0
6931,26429,0,0,140,140,0,1,0,1,0
51594,21350,0,0,65,65,0,1,0,1,0
55061,44651,0,0,63,63,0,1,0,1,0
33912,39120,0,0,157,157,0,1,0,1,0
26412,26348,0,0,64,64,0,1,0,1,0
10464,25174,0,0,62,62,0,1,0,1,0
1024,25174,0,0,62,62,0,1,0,1,0
14061,35440,0,0,62,62,0,1,0,1,0
25430,24819,0,0,143,143,0,1,0,1,0
58175,3751,0,0,127,127,0,1,0,1,0
58638,5900,0,0,62,62,0,1,0,1,0
58638,5900,0,0,62,62,0,1,0,1,0
56719,37807,0,0,66,66,0,1,0,1,0
57601,64147,0,0,64,64,0,1,0,1,0
3791,55810,0,0,72,72,0,1,0,1,0
7303,44847,0,0,63,63,0,1,0,1,0
16387,64075,0,0,60,60,0,1,0,1,0
49915,25174,0,0,63,63,0,1,0,1,0
60196,53,0,0,88,88,0,1,0,1,0
23546,64147,0,0,62,62,0,1,0,1,0
26310,56196,0,0,65,65,0,1,0,1,0
53784,44847,0,0,65,65,0,1,0,1,0
12608,21247,0,0,66,66,0,1,0,1,0
26650,57470,0,0,62,62,0,1,0,1,0
16244,50584,0,0,63,63,0,1,0,1,0
64621,64147,0,0,66,66,0,1,0,1,0
48849,50584,0,0,64,64,0,1,0,1,0
2394,43890,0,0,62,62,0,1,0,1,0
27869,51221,0,0,66,66,0,1,0,1,0
62669,34366,0,0,65,65,0,1,0,1,0
56863,22114,0,0,63,63,0,1,0,1,0
55330,44847,0,0,66,66,0,1,0,1,0
45207,25174,0,0,129,129,0,1,0,1,0
49195,44847,0,0,62,62,0,1,0,1,0
58638,5900,0,0,62,62,0,1,0,1,0
58638,5900,0,0,62,62,0,1,0,1,0
55605,179,0,0,63,63,0,1,0,1,0
57782,57470,0,0,66,66,0,1,0,1,0
62411,35993,0,0,65,65,0,1,0,1,0
29341,64147,0,0,62,62,0,1,0,1,0
60617,64147,0,0,62,62,0,1,0,1,0
57319,64147,0,0,66,66,0,1,0,1,0
7446,57470,0,0,66,66,0,1,0,1,0
49707,26467,0,0,128,128,0,1,0,1,0
8583,3462,0,0,60,60,0,1,0,1,0
47645,36034,0,0,146,146,0,1,0,1,0
46774,51050,0,0,62,62,0,1,0,1,0
25053,30188,0,0,64,64,0,1,0,1,0
50453,55777,0,0,62,62,0,1,0,1,0
64988,35440,0,0,66,66,0,1,0,1,0
7695,32535,0,0,64,64,0,1,0,1,0
18438,64131,0,0,63,63,0,1,0,1,0
7753,25174,0,0,64,64,0,1,0,1,0
65494,26467,0,0,62,62,0,1,0,1,0
9219,32480,0,0,72,72,0,1,0,1,0
6712,123,0,0,90,90,0,1,0,1,0
61738,50555,0,0,66,66,0,1,0,1,0
59387,51505,0,0,63,63,0,1,0,1,0
45013,50584,0,0,74,74,0,1,0,1,0
22036,44847,0,0,62,62,0,1,0,1,0
49159,50584,0,0,146,146,0,1,0,1,0
1184,64147,0,0,65,65,0,1,0,1,0
62801,37905,0,0,66,66,0,1,0,1,0
56386,50584,0,0,63,63,0,1,0,1,0
51464,23478,0,0,66,66,0,1,0,1,0
49197,30188,0,0,102,102,0,1,0,1,0
59906,22114,0,0,64,64,0,1,0,1,0
26531,37965,0,0,62,62,0,1,0,1,0
37175,48804,0,0,61,61,0,1,0,1,0
16179,50584,0,0,64,64,0,1,0,1,0
45944,44847,0,0,93,93,0,1,0,1,0
54239,23117,0,0,66,66,0,1,0,1,0
443,62451,0,0,199,199,0,1,0,1,0
49516,35894,0,0,62,62,0,1,0,1,0
3478,61463,0,0,1271,1271,0,1,0,1,0
55386,32480,0,0,65,65,0,1,0,1,0
22636,30188,0,0,62,62,0,1,0,1,0
57730,34867,0,0,106,106,0,1,0,1,0
58965,52700,0,0,118,118,0,1,0,1,0
5228,3434,0,0,1020,1020,0,1,0,1,0
15104,44847,0,0,64,64,0,1,0,1,0
48448,86,0,0,60,60,0,1,0,1,0
25342,8168,0,0,62,62,0,1,0,1,0
54305,35440,0,0,62,62,0,1,0,1,0
61810,64137,0,0,66,66,0,1,0,1,0
1187,64147,0,0,66,66,0,1,0,1,0
1031,44847,0,0,62,62,0,1,0,1,0
52740,51505,0,0,66,66,0,1,0,1,0
573,7592,0,0,61,61,0,1,0,1,0
1378,44847,0,0,62,62,0,1,0,1,0
54923,64147,0,0,66,66,0,1,0,1,0
49501,11392,0,0,64,64,0,1,0,1,0
34396,42775,0,0,62,62,0,1,0,1,0
19875,30170,0,0,145,145,0,1,0,1,0
52315,51418,0,0,124,124,0,1,0,1,0
58638,5900,0,0,62,62,0,1,0,1,0
12969,55777,0,0,66,66,0,1,0,1,0
27498,23,0,0,60,60,0,1,0,1,0
53629,38817,0,0,66,66,0,1,0,1,0
58638,5900,0,0,62,62,0,1,0,1,0
58714,15503,0,0,96,96,0,1,0,1,0
14023,37965,0,0,62,62,0,1,0,1,0
11018,22114,0,0,100,100,0,1,0,1,0
5067,6500,0,0,128,128,0,1,0,1,0
53626,23117,0,0,66,66,0,1,0,1,0
9560,57470,0,0,65,65,0,1,0,1,0
1238,51505,0,0,101,101,0,1,0,1,0
58687,11392,0,0,62,62,0,1,0,1,0
63466,64201,0,0,62,62,0,1,0,1,0
26905,37965,0,0,62,62,0,1,0,1,0
57239,161,0,0,82,82,0,1,0,1,0
37032,25174,0,0,62,62,0,1,0,1,0
58851,15503,0,0,66,66,0,1,0,1,0
26642,57470,0,0,62,62,0,1,0,1,0
58638,5900,0,0,62,62,0,1,0,1,0
430,5684,0,0,60,60,0,1,0,1,0
3976,25174,0,0,62,62,0,1,0,1,0
56500,37965,0,0,66,66,0,1,0,1,0
42247,61,0,0,60,60,0,1,0,1,0
6881,26296,0,0,144,144,0,1,0,1,0
40115,22,0,0,60,60,0,1,0,1,0
53152,25174,0,0,62,62,0,1,0,1,0
1660,8696,0,0,135,135,0,1,0,1,0
18494,11392,0,0,65,65,0,1,0,1,0
61838,37965,0,0,66,66,0,1,0,1,0
60801,25174,0,0,66,66,0,1,0,1,0
26556,57470,0,0,62,62,0,1,0,1,0
1234,57470,0,0,105,105,0,1,0,1,0
58638,5900,0,0,62,62,0,1,0,1,0
19148,49200,0,0,147,147,0,1,0,1,0
60093,25184,0,0,103,103,0,1,0,1,0
9400,23,0,0,60,60,0,1,0,1,0
17165,55607,0,0,64,64,0,1,0,1,0
54032,25174,0,0,62,62,0,1,0,1,0
33498,5529,0,0,145,145,0,1,0,1,0
19629,38161,0,0,62,62,0,1,0,1,0
31945,25174,0,0,96,96,0,1,0,1,0
55222,25174,0,0,138,138,0,1,0,1,0
32745,37965,0,0,64,64,0,1,0,1,0
20619,25174,0,0,64,64,0,1,0,1,0
52569,30188,0,0,66,66,0,1,0,1,0
9472,23,0,0,60,60,0,1,0,1,0
60091,11437,0,0,66,66,0,1,0,1,0
14760,25174,0,0,62,62,0,1,0,1,0
4619,36048,0,0,84,84,0,1,0,1,0
3478,61463,0,0,1299,1299,0,1,0,1,0
51362,50584,0,0,66,66,0,1,0,1,0
58638,5900,0,0,62,62,0,1,0,1,0
22344,22114,0,0,64,64,0,1,0,1,0
18727,64147,0,0,65,65,0,1,0,1,0
63221,53436,0,0,62,62,0,1,0,1,0
19875,30170,0,0,145,145,0,1,0,1,0
9344,23,0,0,60,60,0,1,0,1,0
18685,64147,0,0,63,63,0,1,0,1,0
10516,44847,0,0,62,62,0,1,0,1,0
58376,64147,0,0,71,71,0,1,0,1,0
49495,11392,0,0,64,64,0,1,0,1,0
40400,22114,0,0,62,62,0,1,0,1,0
51847,57470,0,0,101,101,0,1,0,1,0
59937,41960,0,0,64,64,0,1,0,1,0
50653,35440,0,0,64,64,0,1,0,1,0
19632,37965,0,0,62,62,0,1,0,1,0
23969,57470,0,0,62,62,0,1,0,1,0
49424,57470,0,0,66,66,0,1,0,1,0
29902,61976,0,0,89,89,0,1,0,1,0
6848,45540,0,0,93,93,0,1,0,1,0
56436,50513,0,0,103,103,0,1,0,1,0
18029,50584,0,0,66,66,0,1,0,1,0
64484,56205,0,0,65,65,0,1,0,1,0
65424,6809,0,0,62,62,0,1,0,1,0
49485,56972,0,0,62,62,0,1,0,1,0
60285,53494,0,0,66,66,0,1,0,1,0
32736,22114,0,0,66,66,0,1,0,1,0
57762,25174,0,0,66,66,0,1,0,1,0
17196,22114,0,0,63,63,0,1,0,1,0
3478,61463,0,0,1289,1289,0,1,0,1,0
59386,51505,0,0,63,63,0,1,0,1,0
56876,30188,0,0,62,62,0,1,0,1,0
10388,36179,0,0,61,61,0,1,0,1,0
57803,42844,0,0,65,65,0,1,0,1,0
52715,64147,0,0,65,65,0,1,0,1,0
58638,5900,0,0,62,62,0,1,0,1,0
443,21096,0,0,76,76,0,1,0,1,0
23770,50584,0,0,63,63,0,1,0,1,0
61140,27520,0,0,65,65,0,1,0,1,0
17323,22080,0,0,62,62,0,1,0,1,0
65512,44847,0,0,64,64,0,1,0,1,0
54929,37965,0,0,94,94,0,1,0,1,0
57244,51053,0,0,66,66,0,1,0,1,0
63849,25174,0,0,62,62,0,1,0,1,0
65501,26467,0,0,62,62,0,1,0,1,0
12299,64147,0,0,65,65,0,1,0,1,0
56013,25174,0,0,62,62,0,1,0,1,0
53166,61600,0,0,62,62,0,1,0,1,0
34503,51196,0,0,60,60,0,1,0,1,0
6677,50114,0,0,60,60,0,1,0,1,0
27874,52324,0,0,62,62,0,1,0,1,0
8800,3708,0,0,60,60,0,1,0,1,0
38629,25174,0,0,66,66,0,1,0,1,0
53648,35952,0,0,61,61,0,1,0,1,0
3254,50584,0,0,64,64,0,1,0,1,0
27785,37965,0,0,66,66,0,1,0,1,0
63116,46778,0,0,77,77,0,1,0,1,0
54314,22114,0,0,62,62,0,1,0,1,0
56162,1362,0,0,63,63,0,1,0,1,0
992,15410,0,0,61,61,0,1,0,1,0
22800,10562,0,0,97,97,0,1,0,1,0
55834,25174,0,0,106,106,0,1,0,1,0
51096,63710,0,0,63,63,0,1,0,1,0
47260,26560,0,0,61,61,0,1,0,1,0
56719,38383,0,0,97,97,0,1,0,1,0
18014,64097,0,0,65,65,0,1,0,1,0
30686,51293,0,0,69,69,0,1,0,1,0
48840,50584,0,0,62,62,0,1,0,1,0
51045,25174,0,0,66,66,0,1,0,1,0
50141,51371,0,0,66,66,0,1,0,1,0
45941,23386,0,0,60,60,0,1,0,1,0
7419,44847,0,0,66,66,0,1,0,1,0
9397,37965,0,0,62,62,0,1,0,1,0
49636,50517,0,0,62,62,0,1,0,1,0
58638,5900,0,0,62,62,0,1,0,1,0
51350,11392,0,0,64,64,0,1,0,1,0
1061,44847,0,0,146,146,0,1,0,1,0
55600,22,0,0,60,60,0,1,0,1,0
60155,23718,0,0,66,66,0,1,0,1,0
49001,40108,0,0,161,161,0,1,0,1,0
57643,28189,0,0,60,60,0,1,0,1,0
58638,5900,0,0,62,62,0,1,0,1,0
55505,30188,0,0,66,66,0,1,0,1,0
58917,44847,0,0,71,71,0,1,0,1,0
6768,15909,0,0,61,61,0,1,0,1,0
61055,37965,0,0,91,91,0,1,0,1,0
443,64347,0,0,88,88,0,1,0,1,0
45964,3111,0,0,60,60,0,1,0,1,0
56377,15503,0,0,146,146,0,1,0,1,0
58638,5900,0,0,62,62,0,1,0,1,0
58638,5900,0,0,62,62,0,1,0,1,0
65259,37965,0,0,66,66,0,1,0,1,0
26800,57470,0,0,64,64,0,1,0,1,0
5189,35440,0,0,62,62,0,1,0,1,0
58318,15503,0,0,66,66,0,1,0,1,0
49618,57470,0,0,74,74,0,1,0,1,0
44964,57470,0,0,68,68,0,1,0,1,0
60297,30285,0,0,62,62,0,1,0,1,0
10750,35440,0,0,64,64,0,1,0,1,0
53487,37807,0,0,65,65,0,1,0,1,0
56238,44847,0,0,70,70,0,1,0,1,0
62400,23117,0,0,66,66,0,1,0,1,0
53978,44847,0,0,66,66,0,1,0,1,0
57643,28189,0,0,60,60,0,1,0,1,0
6848,37965,0,0,66,66,0,1,0,1,0
50242,57470,0,0,69,69,0,1,0,1,0
28185,50584,0,0,65,65,0,1,0,1,0
50425,37832,0,0,62,62,0,1,0,1,0
49982,37965,0,0,66,66,0,1,0,1,0
58638,5900,0,0,62,62,0,1,0,1,0
60108,65,0,0,75,75,0,1,0,1,0
53111,35440,0,0,66,66,0,1,0,1,0
1187,64147,0,0,66,66,0,1,0,1,0
29486,7860,0,0,93,93,0,1,0,1,0
48676,53395,0,0,60,60,0,1,0,1,0
61833,51505,0,0,62,62,0,1,0,1,0
55799,36237,0,0,62,62,0,1,0,1,0
4545,1900,0,0,136,136,0,1,0,1,0
35549,22114,0,0,62,62,0,1,0,1,0
28575,50584,0,0,62,62,0,1,0,1,0
28798,2309,0,0,60,60,0,1,0,1,0
50804,1,0,0,62,62,0,1,0,1,0
14049,21739,0,0,62,62,0,1,0,1,0
6881,33230,0,0,134,134,0,1,0,1,0
7258,30277,0,0,99,99,0,1,0,1,0
26885,37965,0,0,62,62,0,1,0,1,0
61808,18375,0,0,66,66,0,1,0,1,0
3096,50584,0,0,62,62,0,1,0,1,0
57651,56205,0,0,66,66,0,1,0,1,0
7786,25174,0,0,80,80,0,1,0,1,0
14698,64147,0,0,66,66,0,1,0,1,0
26053,33720,0,0,160,160,0,1,0,1,0
46901,26672,0,0,60,60,0,1,0,1,0
58638,5900,0,0,62,62,0,1,0,1,0
49452,11392,0,0,63,63,0,1,0,1,0
35718,20238,0,0,62,62,0,1,0,1,0
47107,35440,0,0,62,62,0,1,0,1,0
58638,5900,0,0,62,62,0,1,0,1,0
2705,37,0,0,60,60,0,1,0,1,0
34524,48653,0,0,67,67,0,1,0,1,0
45941,23386,0,0,60,60,0,1,0,1,0
58638,5900,0,0,62,62,0,1,0,1,0
11667,56205,0,0,66,66,0,1,0,1,0
53224,42707,0,0,66,66,0,1,0,1,0
52816,25174,0,0,63,63,0,1,0,1,0
55105,57470,0,0,77,77,0,1,0,1,0
1181,64147,0,0,63,63,0,1,0,1,0
58638,5900,0,0,62,62,0,1,0,1,0
1844,64147,0,0,66,66,0,1,0,1,0
3074,64147,0,0,62,62,0,1,0,1,0
61611,23,0,0,60,60,0,1,0,1,0
58638,5900,0,0,62,62,0,1,0,1,0
53637,18,0,0,61,61,0,1,0,1,0
1064,46797,0,0,62,62,0,1,0,1,0
58638,5900,0,0,62,62,0,1,0,1,0
61639,2689,0,0,64,64,0,1,0,1,0
51865,61689,0,0,66,66,0,1,0,1,0
443,54335,0,0,71,71,0,1,0,1,0
60313,46776,0,0,69,69,0,1,0,1,0
62355,50584,0,0,66,66,0,1,0,1,0
18942,50584,0,0,72,72,0,1,0,1,0
2343,19733,0,0,76,76,0,1,0,1,0
258,56398,0,0,332,332,0,1,0,1,0
10697,44847,0,0,66,66,0,1,0,1,0
56112,56205,0,0,66,66,0,1,0,1,0
33271,51417,0,0,66,66,0,1,0,1,0
50102,17546,0,0,66,66,0,1,0,1,0
62991,51221,0,0,66,66,0,1,0,1,0
27503,37965,0,0,64,64,0,1,0,1,0
54080,37965,0,0,62,62,0,1,0,1,0
49992,37965,0,0,66,66,0,1,0,1,0
56948,18,0,0,61,61,0,1,0,1,0
15403,51505,0,0,66,66,0,1,0,1,0
60893,50584,0,0,66,66,0,1,0,1,0
53698,64147,0,0,66,66,0,1,0,1,0
57131,35776,0,0,145,145,0,1,0,1,0
61523,37807,0,0,66,66,0,1,0,1,0
61442,64128,0,0,64,64,0,1,0,1,0
26489,64147,0,0,62,62,0,1,0,1,0
58638,5900,0,0,62,62,0,1,0,1,0
53463,22114,0,0,90,90,0,1,0,1,0
29576,37807,0,0,66,66,0,1,0,1,0
56627,5900,0,0,60,60,0,1,0,1,0
53353,26467,0,0,62,62,0,1,0,1,0
1033,35889,0,0,121,121,0,1,0,1,0
51525,1433,0,0,60,60,0,1,0,1,0
59411,37965,0,0,66,66,0,1,0,1,0
43757,353,0,0,60,60,0,1,0,1,0
56381,25174,0,0,62,62,0,1,0,1,0
25772,7302,0,0,66,66,0,1,0,1,0
9099,26441,0,0,119,119,0,1,0,1,0
63364,54609,0,0,74,74,0,1,0,1,0
57372,75,0,0,62,62,0,1,0,1,0
45940,44847,0,0,62,62,0,1,0,1,0
26239,25174,0,0,65,65,0,1,0,1,0
33932,44847,0,0,64,64,0,1,0,1,0
33841,36038,0,0,62,62,0,1,0,1,0
54373,26467,0,0,62,62,0,1,0,1,0
21176,62912,0,0,145,145,0,1,0,1,0
59524,25174,0,0,66,66,0,1,0,1,0
63109,54369,0,0,68,68,0,1,0,1,0
31031,50584,0,0,62,62,0,1,0,1,0
57853,64147,0,0,66,66,0,1,0,1,0
14844,37965,0,0,62,62,0,1,0,1,0
26522,44847,0,0,85,85,0,1,0,1,0
40464,26467,0,0,62,62,0,1,0,1,0
52494,50545,0,0,66,66,0,1,0,1,0
45941,23388,0,0,60,60,0,1,0,1,0
43256,26467,0,0,63,63,0,1,0,1,0
64044,23718,0,0,68,68,0,1,0,1,0
53437,44847,0,0,63,63,0,1,0,1,0
16739,10214,0,0,63,63,0,1,0,1,0
55275,50584,0,0,66,66,0,1,0,1,0
9688,32604,0,0,83,83,0,1,0,1,0
58638,5900,0,0,62,62,0,1,0,1,0
28533,23,0,0,60,60,0,1,0,1,0
41715,57470,0,0,63,63,0,1,0,1,0
60184,43,0,0,83,83,0,1,0,1,0
48139,57470,0,0,95,95,0,1,0,1,0
39274,36797,0,0,62,62,0,1,0,1,0
50434,43532,0,0,66,66,0,1,0,1,0
18130,25174,0,0,62,62,0,1,0,1,0
52730,51221,0,0,66,66,0,1,0,1,0
26872,44847,0,0,62,62,0,1,0,1,0
44147,64147,0,0,62,62,0,1,0,1,0
56907,50584,0,0,64,64,0,1,0,1,0
13527,51303,0,0,62,62,0,1,0,1,0
53676,29,0,0,63,63,0,1,0,1,0
46972,64147,0,0,62,62,0,1,0,1,0
51396,56205,0,0,62,62,0,1,0,1,0
33266,50584,0,0,64,64,0,1,0,1,0
62792,53,0,0,88,88,0,1,0,1,0
34988,51242,0,0,77,77,0,1,0,1,0
11741,25174,0,0,75,75,0,1,0,1,0
26879,37965,0,0,62,62,0,1,0,1,0
18717,64147,0,0,62,62,0,1,0,1,0
16944,50584,0,0,111,111,0,1,0,1,0
7598,57470,0,0,65,65,0,1,0,1,0
20576,37965,0,0,62,62,0,1,0,1,0
45908,33330,0,0,60,60,0,1,0,1,0
59609,22114,0,0,65,65,0,1,0,1,0
53186,25174,0,0,62,62,0,1,0,1,0
50901,26467,0,0,66,66,0,1,0,1,0
9252,37965,0,0,65,65,0,1,0,1,0
62748,62413,0,0,65,65,0,1,0,1,0
56138,57470,0,0,64,64,0,1,0,1,0
17027,1,0,0,62,62,0,1,0,1,0
58638,5900,0,0,62,62,0,1,0,1,0
57761,15503,0,0,66,66,0,1,0,1,0
56007,25174,0,0,62,62,0,1,0,1,0
61683,37965,0,0,66,66,0,1,0,1,0
17919,23,0,0,60,60,0,1,0,1,0
51022,9571,0,0,64,64,0,1,0,1,0
49540,22114,0,0,62,62,0,1,0,1,0
42983,22114,0,0,83,83,0,1,0,1,0
51094,35440,0,0,65,65,0,1,0,1,0
63628,35440,0,0,63,63,0,1,0,1,0
58638,5900,0,0,62,62,0,1,0,1,0
6878,8306,0,0,142,142,0,1,0,1,0
51994,57470,0,0,66,66,0,1,0,1,0
48706,23393,0,0,60,60,0,1,0,1,0
53118,61699,0,0,96,96,0,1,0,1,0
12543,48649,0,0,76,76,0,1,0,1,0
51730,25174,0,0,66,66,0,1,0,1,0
3799,26467,0,0,66,66,0,1,0,1,0
5223,44091,0,0,220,220,0,1,0,1,0
59180,11392,0,0,63,63,0,1,0,1,0
60672,26467,0,0,62,62,0,1,0,1,0
7034,13,0,0,77,77,0,1,0,1,0
58638,5900,0,0,62,62,0,1,0,1,0
63433,62413,0,0,66,66,0,1,0,1,0
26079,22,0,0,60,60,0,1,0,1,0
33833,57470,0,0,67,67,0,1,0,1,0
31653,61689,0,0,130,130,0,1,0,1,0
59582,56205,0,0,66,66,0,1,0,1,0
54147,5999,0,0,77,77,0,1,0,1,0
6666,8484,0,0,60,60,0,1,0,1,0
2828,35253,0,0,66,66,0,1,0,1,0
58638,5900,0,0,62,62,0,1,0,1,0
60052,37965,0,0,66,66,0,1,0,1,0
3059,50584,0,0,97,97,0,1,0,1,0
63670,64097,0,0,66,66,0,1,0,1,0
2910,7302,0,0,63,63,0,1,0,1,0
749,4079,0,0,154,154,0,1,0,1,0
22978,35440,0,0,62,62,0,1,0,1,0
46901,26672,0,0,60,60,0,1,0,1,0
12647,22114,0,0,64,64,0,1,0,1,0
58638,5900,0,0,62,62,0,1,0,1,0
30660,57794,0,0,62,62,0,1,0,1,0
50877,30041,0,0,64,64,0,1,0,1,0
3410,17372,0,0,62,62,0,1,0,1,0
51985,25174,0,0,64,64,0,1,0,1,0
60191,51,0,0,86,86,0,1,0,1,0
52679,2568,0,0,63,63,0,1,0,1,0
24982,64147,0,0,66,66,0,1,0,1,0
58638,5900,0,0,62,62,0,1,0,1,0
19747,37965,0,0,62,62,0,1,0,1,0
6881,6881,0,0,146,146,0,1,0,1,0
58638,5900,0,0,62,62,0,1,0,1,0
54600,6881,0,0,66,66,0,1,0,1,0
43997,37965,0,0,64,64,0,1,0,1,0
27382,57470,0,0,62,62,0,1,0,1,0
58638,5900,0,0,62,62,0,1,0,1,0
13285,29892,0,0,145,145,0,1,0,1,0
58179,43890,0,0,66,66,0,1,0,1,0
13489,22114,0,0,91,91,0,1,0,1,0
36980,5900,0,0,60,60,0,1,0,1,0
49485,11392,0,0,63,63,0,1,0,1,0
30580,50265,0,0,66,66,0,1,0,1,0
0,0,0,0,98,98,0,1,0,1,0
61527,37807,0,0,66,66,0,1,0,1,0
7166,64147,0,0,66,66,0,1,0,1,0
11054,29665,0,0,63,63,0,1,0,1,0
29588,25174,0,0,62,62,0,1,0,1,0
59879,15503,0,0,70,70,0,1,0,1,0
23351,25174,0,0,62,62,0,1,0,1,0
33290,50584,0,0,63,63,0,1,0,1,0
63314,57470,0,0,66,66,0,1,0,1,0
58079,50584,0,0,66,66,0,1,0,1,0
3478,61463,0,0,1008,1008,0,1,0,1,0
51105,50584,0,0,62,62,0,1,0,1,0
50349,22114,0,0,62,62,0,1,0,1,0
60214,46778,0,0,66,66,0,1,0,1,0
1026,25174,0,0,146,146,0,1,0,1,0
10964,22114,0,0,62,62,0,1,0,1,0
57837,64147,0,0,62,62,0,1,0,1,0
51762,50584,0,0,66,66,0,1,0,1,0
60827,11392,0,0,64,64,0,1,0,1,0
1024,29996,0,0,145,145,0,1,0,1,0
28306,25604,0,0,62,62,0,1,0,1,0
63773,35440,0,0,66,66,0,1,0,1,0
46401,35440,0,0,66,66,0,1,0,1,0
32974,51232,0,0,65,65,0,1,0,1,0
33964,25174,0,0,120,120,0,1,0,1,0
16376,35438,0,0,61,61,0,1,0,1,0
51944,56205,0,0,64,64,0,1,0,1,0
58638,5900,0,0,62,62,0,1,0,1,0
65253,50584,0,0,64,64,0,1,0,1,0
3005,37965,0,0,62,62,0,1,0,1,0
58638,5900,0,0,62,62,0,1,0,1,0
60246,44612,0,0,66,66,0,1,0,1,0
32496,1287,0,0,60,60,0,1,0,1,0
21512,51765,0,0,145,145,0,1,0,1,0
56484,57587,0,0,146,146,0,1,0,1,0
51679,25174,0,0,66,66,0,1,0,1,0
19875,30170,0,0,145,145,0,1,0,1,0
19198,49146,0,0,147,147,0,1,0,1,0
26521,22114,0,0,102,102,0,1,0,1,0
1059,7128,0,0,63,63,0,1,0,1,0
10514,25174,0,0,62,62,0,1,0,1,0
58638,5900,0,0,62,62,0,1,0,1,0
19501,23,0,0,60,60,0,1,0,1,0
58638,5900,0,0,62,62,0,1,0,1,0
38535,22127,0,0,139,139,0,1,0,1,0
51109,11392,0,0,66,66,0,1,0,1,0
2932,44847,0,0,62,62,0,1,0,1,0
1025,29912,0,0,146,146,0,1,0,1,0
59862,47986,0,0,84,84,0,1,0,1,0
443,39092,0,0,80,80,0,1,0,1,0
54323,35440,0,0,65,65,0,1,0,1,0
23936,35440,0,0,62,62,0,1,0,1,0
866,24970,0,0,147,147,0,1,0,1,0
6679,50082,0,0,60,60,0,1,0,1,0
26085,22,0,0,60,60,0,1,0,1,0
3073,64147,0,0,62,62,0,1,0,1,0
38484,48637,0,0,60,60,0,1,0,1,0
14631,37965,0,0,62,62,0,1,0,1,0
45964,2227,0,0,60,60,0,1,0,1,0
58638,5900,0,0,62,62,0,1,0,1,0
43437,58054,0,0,96,96,0,1,0,1,0
53971,55442,0,0,66,66,0,1,0,1,0
64339,57470,0,0,65,65,0,1,0,1,0
62142,57470,0,0,69,69,0,1,0,1,0
59355,51505,0,0,65,65,0,1,0,1,0
15056,37965,0,0,62,62,0,1,0,1,0
4041,50584,0,0,62,62,0,1,0,1,0
32339,47513,0,0,131,131,0,1,0,1,0
54553,44847,0,0,67,67,0,1,0,1,0
61719,61689,0,0,66,66,0,1,0,1,0
17900,30188,0,0,62,62,0,1,0,1,0
10238,11392,0,0,64,64,0,1,0,1,0
55614,43223,0,0,71,71,0,1,0,1,0
59277,50078,0,0,74,74,0,1,0,1,0
58638,5900,0,0,62,62,0,1,0,1,0
58638,5900,0,0,62,62,0,1,0,1,0
10696,25174,0,0,102,102,0,1,0,1,0
58638,5900,0,0,62,62,0,1,0,1,0
59564,37965,0,0,62,62,0,1,0,1,0
60312,57470,0,0,74,74,0,1,0,1,0
46478,64147,0,0,83,83,0,1,0,1,0
58638,5900,0,0,62,62,0,1,0,1,0
2823,35440,0,0,62,62,0,1,0,1,0
7473,44223,0,0,66,66,0,1,0,1,0
11848,64147,0,0,85,85,0,1,0,1,0
58338,3362,0,0,60,60,0,1,0,1,0
58338,3368,0,0,60,60,0,1,0,1,0
443,64347,0,0,131,131,0,1,0,1,0
60163,37965,0,0,66,66,0,1,0,1,0
51560,22114,0,0,66,66,0,1,0,1,0
8191,51221,0,0,62,62,0,1,0,1,0
35361,25174,0,0,144,144,0,1,0,1,0
1309,51221,0,0,62,62,0,1,0,1,0
58758,22114,0,0,66,66,0,1,0,1,0
9088,6957,0,0,65,65,0,1,0,1,0
57620,28632,0,0,64,64,0,1,0,1,0
45445,25174,0,0,64,64,0,1,0,1,0
42252,33303,0,0,60,60,0,1,0,1,0
39173,25174,0,0,62,62,0,1,0,1,0
59424,50265,0,0,74,74,0,1,0,1,0
55669,1516,0,0,77,77,0,1,0,1,0
10694,25174,0,0,114,114,0,1,0,1,0
9212,51505,0,0,137,137,0,1,0,1,0
57133,21247,0,0,64,64,0,1,0,1,0
38549,22114,0,0,62,62,0,1,0,1,0
53643,25174,0,0,62,62,0,1,0,1,0
4004,35440,0,0,64,64,0,1,0,1,0
51413,15,0,0,63,63,0,1,0,1,0
58638,5900,0,0,62,62,0,1,0,1,0
56816,11392,0,0,62,62,0,1,0,1,0
52077,22114,0,0,63,63,0,1,0,1,0
62186,23497,0,0,66,66,0,1,0,1,0
58638,5900,0,0,62,62,0,1,0,1,0
14642,25174,0,0,62,62,0,1,0,1,0
35557,15503,0,0,65,65,0,1,0,1,0
50573,22114,0,0,62,62,0,1,0,1,0
48048,44847,0,0,67,67,0,1,0,1,0
27866,51235,0,0,69,69,0,1,0,1,0
63049,22114,0,0,64,64,0,1,0,1,0
45186,25174,0,0,110,110,0,1,0,1,0
56576,44847,0,0,65,65,0,1,0,1,0
3976,35440,0,0,66,66,0,1,0,1,0
63002,42873,0,0,66,66,0,1,0,1,0
3478,61463,0,0,1297,1297,0,1,0,1,0
64976,2732,0,0,71,71,0,1,0,1,0
27659,51505,0,0,146,146,0,1,0,1,0
11066,50584,0,0,66,66,0,1,0,1,0
23815,64147,0,0,62,62,0,1,0,1,0
53864,31573,0,0,66,66,0,1,0,1,0
38121,48683,0,0,60,60,0,1,0,1,0
29053,23,0,0,60,60,0,1,0,1,0
58330,50584,0,0,62,62,0,1,0,1,0
0,0,0,0,98,98,0,1,0,1,0
30363,36237,0,0,62,62,0,1,0,1,0
30572,64147,0,0,62,62,0,1,0,1,0
1033,11367,0,0,69,69,0,1,0,1,0
9656,30206,0,0,79,79,0,1,0,1,0
54593,51505,0,0,66,66,0,1,0,1,0
22044,10673,0,0,64,64,0,1,0,1,0
6689,8504,0,0,69,69,0,1,0,1,0
59803,35315,0,0,63,63,0,1,0,1,0
63783,35440,0,0,62,62,0,1,0,1,0
52784,21247,0,0,66,66,0,1,0,1,0
50453,25174,0,0,81,81,0,1,0,1,0
41003,64147,0,0,62,62,0,1,0,1,0
26285,8293,0,0,75,75,0,1,0,1,0
50920,60182,0,0,66,66,0,1,0,1,0
58638,5900,0,0,62,62,0,1,0,1,0
65068,60,0,0,80,80,0,1,0,1,0
64835,26467,0,0,62,62,0,1,0,1,0
7481,57470,0,0,66,66,0,1,0,1,0
45998,51505,0,0,62,62,0,1,0,1,0
25834,1862,0,0,60,60,0,1,0,1,0
30179,57470,0,0,60,60,0,1,0,1,0
63670,64098,0,0,66,66,0,1,0,1,0
6881,6881,0,0,62,62,0,1,0,1,0
56707,25174,0,0,62,62,0,1,0,1,0
13531,51505,0,0,62,62,0,1,0,1,0
45964,2666,0,0,60,60,0,1,0,1,0
60346,40950,0,0,107,107,0,1,0,1,0
4951,3391,0,0,81,81,0,1,0,1,0
58638,5900,0,0,62,62,0,1,0,1,0
48992,50584,0,0,146,146,0,1,0,1,0
26048,21,0,0,60,60,0,1,0,1,0
7378,57470,0,0,62,62,0,1,0,1,0
17766,50481,0,0,62,62,0,1,0,1,0
57325,60043,0,0,66,66,0,1,0,1,0
27045,51505,0,0,65,65,0,1,0,1,0
28961,64147,0,0,62,62,0,1,0,1,0
64678,35993,0,0,68,68,0,1,0,1,0
0,0,0,0,70,70,0,1,0,1,0
19875,30170,0,0,145,145,0,1,0,1,0
58638,5900,0,0,62,62,0,1,0,1,0
54002,25174,0,0,89,89,0,1,0,1,0
58332,37965,0,0,65,65,0,1,0,1,0
49619,64147,0,0,62,62,0,1,0,1,0
11829,64147,0,0,62,62,0,1,0,1,0
15922,44847,0,0,66,66,0,1,0,1,0
54704,51505,0,0,66,66,0,1,0,1,0
42294,57470,0,0,62,62,0,1,0,1,0
45964,2734,0,0,60,60,0,1,0,1,0
43785,44847,0,0,62,62,0,1,0,1,0
46626,416,0,0,1035,1035,0,1,0,1,0
64601,50584,0,0,63,63,0,1,0,1,0
55429,25174,0,0,66,66,0,1,0,1,0
50765,22114,0,0,62,62,0,1,0,1,0
12471,48817,0,0,62,62,0,1,0,1,0
64242,35366,0,0,94,94,0,1,0,1,0
61057,50360,0,0,110,110,0,1,0,1,0
9586,55,0,0,60,60,0,1,0,1,0
58638,5900,0,0,62,62,0,1,0,1,0
65094,36237,0,0,63,63,0,1,0,1,0
9957,32480,0,0,66,66,0,1,0,1,0
62756,62413,0,0,64,64,0,1,0,1,0
1446,44847,0,0,62,62,0,1,0,1,0
39481,36586,0,0,63,63,0,1,0,1,0
61895,51505,0,0,62,62,0,1,0,1,0
65409,26467,0,0,62,62,0,1,0,1,0
34042,39089,0,0,135,135,0,1,0,1,0
11382,43890,0,0,66,66,0,1,0,1,0
5028,37965,0,0,66,66,0,1,0,1,0
65414,57470,0,0,88,88,0,1,0,1,0
58638,5900,0,0,62,62,0,1,0,1,0
6881,26296,0,0,144,144,0,1,0,1,0
43260,41615,0,0,145,145,0,1,0,1,0
64386,37965,0,0,66,66,0,1,0,1,0
50639,57470,0,0,71,71,0,1,0,1,0
5774,37965,0,0,66,66,0,1,0,1,0
64472,57470,0,0,64,64,0,1,0,1,0
51741,64147,0,0,62,62,0,1,0,1,0
64878,26467,0,0,62,62,0,1,0,1,0
19296,25174,0,0,140,140,0,1,0,1,0
2569,25174,0,0,93,93,0,1,0,1,0
49082,22114,0,0,102,102,0,1,0,1,0
56911,26467,0,0,62,62,0,1,0,1,0
2492,23117,0,0,66,66,0,1,0,1,0
57452,35515,0,0,83,83,0,1,0,1,0
27785,37965,0,0,66,66,0,1,0,1,0
60264,53484,0,0,66,66,0,1,0,1,0
10669,49756,0,0,60,60,0,1,0,1,0
443,54507,0,0,82,82,0,1,0,1,0
58638,5900,0,0,62,62,0,1,0,1,0
59611,56205,0,0,66,66,0,1,0,1,0
61518,61689,0,0,66,66,0,1,0,1,0
52838,37965,0,0,66,66,0,1,0,1,0
4110,35440,0,0,65,65,0,1,0,1,0
23514,25174,0,0,146,146,0,1,0,1,0
5462,23,0,0,60,60,0,1,0,1,0
35261,15503,0,0,74,74,0,1,0,1,0
3478,61463,0,0,1262,1262,0,1,0,1,0
51922,44847,0,0,66,66,0,1,0,1,0
54256,64112,0,0,64,64,0,1,0,1,0
47910,7454,0,0,60,60,0,1,0,1,0
28878,51505,0,0,103,103,0,1,0,1,0
515,10214,0,0,63,63,0,1,0,1,0
58638,5900,0,0,62,62,0,1,0,1,0
3302,61896,0,0,65,65,0,1,0,1,0
58638,5900,0,0,62,62,0,1,0,1,0
56099,36237,0,0,64,64,0,1,0,1,0
53156,35993,0,0,66,66,0,1,0,1,0
61905,50499,0,0,110,110,0,1,0,1,0
64916,35440,0,0,66,66,0,1,0,1,0
48676,53395,0,0,60,60,0,1,0,1,0
58791,51505,0,0,66,66,0,1,0,1,0
63032,25174,0,0,144,144,0,1,0,1,0
23939,41615,0,0,146,146,0,1,0,1,0
57545,35440,0,0,66,66,0,1,0,1,0
960,33230,0,0,67,67,0,1,0,1,0
57131,35776,0,0,145,145,0,1,0,1,0
7992,64147,0,0,62,62,0,1,0,1,0
54150,5912,0,0,62,62,0,1,0,1,0
55316,22114,0,0,99,99,0,1,0,1,0
6881,6881,0,0,62,62,0,1,0,1,0
16379,35485,0,0,118,118,0,1,0,1,0
56453,22114,0,0,139,139,0,1,0,1,0
62148,57470,0,0,69,69,0,1,0,1,0
21759,51505,0,0,66,66,0,1,0,1,0
41223,38128,0,0,130,130,0,1,0,1,0
9267,7147,0,0,62,62,0,1,0,1,0
50562,37965,0,0,66,66,0,1,0,1,0
52423,55987,0,0,66,66,0,1,0,1,0
44706,25174,0,0,71,71,0,1,0,1,0
49056,51361,0,0,63,63,0,1,0,1,0
65153,38303,0,0,62,62,0,1,0,1,0
61089,21247,0,0,66,66,0,1,0,1,0
50052,65008,0,0,60,60,0,1,0,1,0
60572,51184,0,0,62,62,0,1,0,1,0
52111,22114,0,0,66,66,0,1,0,1,0
33586,23,0,0,60,60,0,1,0,1,0
51299,61689,0,0,65,65,0,1,0,1,0
4323,64147,0,0,63,63,0,1,0,1,0
52905,44847,0,0,63,63,0,1,0,1,0
57969,25174,0,0,62,62,0,1,0,1,0
43517,26529,0,0,139,139,0,1,0,1,0
65453,57470,0,0,69,69,0,1,0,1,0
18670,44847,0,0,66,66,0,1,0,1,0
32051,37965,0,0,62,62,0,1,0,1,0
34569,5840,0,0,73,73,0,1,0,1,0
50920,60182,0,0,66,66,0,1,0,1,0
64877,51184,0,0,65,65,0,1,0,1,0
23697,44847,0,0,62,62,0,1,0,1,0
10306,44847,0,0,65,65,0,1,0,1,0
25397,22114,0,0,65,65,0,1,0,1,0
1024,44847,0,0,62,62,0,1,0,1,0
58638,5900,0,0,62,62,0,1,0,1,0
52751,24211,0,0,65,65,0,1,0,1,0
50149,17771,0,0,82,82,0,1,0,1,0
57507,23,0,0,60,60,0,1,0,1,0
35752,48356,0,0,61,61,0,1,0,1,0
50232,44847,0,0,65,65,0,1,0,1,0
52459,33890,0,0,60,60,0,1,0,1,0
8084,30212,0,0,132,132,0,1,0,1,0
57131,8002,0,0,145,145,0,1,0,1,0
26424,27189,0,0,66,66,0,1,0,1,0
40736,2657,0,0,61,61,0,1,0,1,0
57443,57470,0,0,65,65,0,1,0,1,0
55496,32475,0,0,66,66,0,1,0,1,0
26502,64147,0,0,62,62,0,1,0,1,0
44935,57470,0,0,73,73,0,1,0,1,0
53260,36237,0,0,62,62,0,1,0,1,0
47910,7454,0,0,60,60,0,1,0,1,0
55301,22114,0,0,133,133,0,1,0,1,0
62004,22114,0,0,66,66,0,1,0,1,0
56581,25174,0,0,139,139,0,1,0,1,0
3146,35928,0,0,62,62,0,1,0,1,0
53105,42707,0,0,66,66,0,1,0,1,0
54587,26467,0,0,64,64,0,1,0,1,0
23443,57615,0,0,145,145,0,1,0,1,0
64912,36076,0,0,69,69,0,1,0,1,0
48676,53395,0,0,60,60,0,1,0,1,0
52504,35440,0,0,65,65,0,1,0,1,0
59995,22114,0,0,62,62,0,1,0,1,0
17151,64147,0,0,62,62,0,1,0,1,0
35220,30188,0,0,80,80,0,1,0,1,0
16415,15843,0,0,61,61,0,1,0,1,0
25214,1660,0,0,60,60,0,1,0,1,0
1039,30120,0,0,156,156,0,1,0,1,0
58526,30307,0,0,62,62,0,1,0,1,0
48416,55561,0,0,62,62,0,1,0,1,0
56806,44847,0,0,62,62,0,1,0,1,0
52934,26467,0,0,66,66,0,1,0,1,0
7358,50584,0,0,66,66,0,1,0,1,0
50239,2260,0,0,62,62,0,1,0,1,0
51087,9571,0,0,65,65,0,1,0,1,0
51278,44847,0,0,64,64,0,1,0,1,0
52503,7302,0,0,66,66,0,1,0,1,0
63786,25174,0,0,63,63,0,1,0,1,0
50084,26672,0,0,62,62,0,1,0,1,0
63671,22114,0,0,66,66,0,1,0,1,0
1638,22114,0,0,62,62,0,1,0,1,0
56883,30059,0,0,72,72,0,1,0,1,0
4989,62552,0,0,76,76,0,1,0,1,0
39461,51505,0,0,62,62,0,1,0,1,0
1246,12369,0,0,62,62,0,1,0,1,0
22288,51505,0,0,62,62,0,1,0,1,0
58638,5900,0,0,62,62,0,1,0,1,0
1178,64990,0,0,134,134,0,1,0,1,0
443,20087,0,0,83,83,0,1,0,1,0
42465,57470,0,0,60,60,0,1,0,1,0
52519,44847,0,0,66,66,0,1,0,1,0
38968,25174,0,0,126,126,0,1,0,1,0
51959,22114,0,0,66,66,0,1,0,1,0
56028,36237,0,0,108,108,0,1,0,1,0
56473,30255,0,0,120,120,0,1,0,1,0
31566,50584,0,0,62,62,0,1,0,1,0
54387,35440,0,0,63,63,0,1,0,1,0
54593,51505,0,0,64,64,0,1,0,1,0
59451,50584,0,0,64,64,0,1,0,1,0
16370,62071,0,0,117,117,0,1,0,1,0
58007,62413,0,0,66,66,0,1,0,1,0
1024,44847,0,0,146,146,0,1,0,1,0
58638,5900,0,0,62,62,0,1,0,1,0
54539,26467,0,0,62,62,0,1,0,1,0
443,4074,0,0,240,240,0,1,0,1,0
60442,57470,0,0,62,62,0,1,0,1,0
63474,50442,0,0,63,63,0,1,0,1,0
22696,30188,0,0,62,62,0,1,0,1,0
62390,57470,0,0,66,66,0,1,0,1,0
676,23646,0,0,108,108,0,1,0,1,0
49786,25174,0,0,66,66,0,1,0,1,0
54575,11392,0,0,66,66,0,1,0,1,0
443,60496,0,0,254,254,0,1,0,1,0
57323,62413,0,0,64,64,0,1,0,1,0
59202,11392,0,0,62,62,0,1,0,1,0
10306,44847,0,0,66,66,0,1,0,1,0
49177,57470,0,0,136,136,0,1,0,1,0
55433,22114,0,0,62,62,0,1,0,1,0
39299,23,0,0,60,60,0,1,0,1,0
50352,50584,0,0,65,65,0,1,0,1,0
27876,52700,0,0,66,66,0,1,0,1,0
58638,5900,0,0,62,62,0,1,0,1,0
42947,22114,0,0,65,65,0,1,0,1,0
1350,8506,0,0,147,147,0,1,0,1,0
6881,6881,0,0,62,62,0,1,0,1,0
51122,1378,0,0,60,60,0,1,0,1,0
27015,64147,0,0,62,62,0,1,0,1,0
52327,26467,0,0,63,63,0,1,0,1,0
47910,7461,0,0,60,60,0,1,0,1,0
50407,43890,0,0,62,62,0,1,0,1,0
29544,51122,0,0,92,92,0,1,0,1,0
63889,50584,0,0,103,103,0,1,0,1,0
13701,50584,0,0,63,63,0,1,0,1,0
58638,5900,0,0,62,62,0,1,0,1,0
22916,25174,0,0,130,130,0,1,0,1,0
58638,5900,0,0,62,62,0,1,0,1,0
9448,57866,0,0,87,87,0,1,0,1,0
16387,35583,0,0,60,60,0,1,0,1,0
36772,153,0,0,221,221,0,1,0,1,0
46561,57811,0,0,66,66,0,1,0,1,0
37111,21240,0,0,65,65,0,1,0,1,0
53419,28189,0,0,60,60,0,1,0,1,0
57131,31061,0,0,145,145,0,1,0,1,0
65279,44847,0,0,65,65,0,1,0,1,0
11235,30188,0,0,62,62,0,1,0,1,0
443,60496,0,0,320,320,0,1,0,1,0
11878,37566,0,0,82,82,0,1,0,1,0
1026,57470,0,0,64,64,0,1,0,1,0
57782,57470,0,0,66,66,0,1,0,1,0
58550,21247,0,0,64,64,0,1,0,1,0
11533,51505,0,0,106,106,0,1,0,1,0
33618,44847,0,0,62,62,0,1,0,1,0
51130,61689,0,0,62,62,0,1,0,1,0
57687,57470,0,0,62,62,0,1,0,1,0
48183,51045,0,0,62,62,0,1,0,1,0
53757,25174,0,0,62,62,0,1,0,1,0
35577,22114,0,0,62,62,0,1,0,1,0
23939,41615,0,0,146,146,0,1,0,1,0
6889,8361,0,0,143,143,0,1,0,1,0
443,45788,0,0,199,199,0,1,0,1,0
39932,876,0,0,60,60,0,1,0,1,0
15323,51505,0,0,62,62,0,1,0,1,0
50677,58841,0,0,66,66,0,1,0,1,0
11827,64147,0,0,62,62,0,1,0,1,0
1136,44847,0,0,62,62,0,1,0,1,0
53166,61600,0,0,64,64,0,1,0,1,0
48706,23393,0,0,60,60,0,1,0,1,0
57674,64147,0,0,66,66,0,1,0,1,0
35989,64147,0,0,64,64,0,1,0,1,0
1024,57470,0,0,62,62,0,1,0,1,0
50260,50584,0,0,62,62,0,1,0,1,0
27122,22114,0,0,90,90,0,1,0,1,0
27348,22114,0,0,66,66,0,1,0,1,0
57760,37965,0,0,65,65,0,1,0,1,0
54809,37965,0,0,63,63,0,1,0,1,0
11106,51505,0,0,66,66,0,1,0,1,0
45682,37965,0,0,86,86,0,1,0,1,0
65115,50584,0,0,65,65,0,1,0,1,0
25201,22114,0,0,109,109,0,1,0,1,0
4752,30188,0,0,62,62,0,1,0,1,0
57394,18375,0,0,66,66,0,1,0,1,0
55372,7,0,0,66,66,0,1,0,1,0
2170,22114,0,0,62,62,0,1,0,1,0
52904,44847,0,0,63,63,0,1,0,1,0
32159,51505,0,0,145,145,0,1,0,1,0
30158,35806,0,0,152,152,0,1,0,1,0
18573,11392,0,0,65,65,0,1,0,1,0
13910,57470,0,0,60,60,0,1,0,1,0
52465,50414,0,0,66,66,0,1,0,1,0
60174,35440,0,0,66,66,0,1,0,1,0
63132,25174,0,0,62,62,0,1,0,1,0
21960,23,0,0,60,60,0,1,0,1,0
5211,21602,0,0,60,60,0,1,0,1,0
9265,44847,0,0,98,98,0,1,0,1,0
0,0,0,0,71,71,0,1,0,1,0
63506,64137,0,0,62,62,0,1,0,1,0
64289,35322,0,0,116,116,0,1,0,1,0
50300,37965,0,0,66,66,0,1,0,1,0
58638,5900,0,0,62,62,0,1,0,1,0
61229,35367,0,0,66,66,0,1,0,1,0
7166,64147,0,0,63,63,0,1,0,1,0
54572,26467,0,0,65,65,0,1,0,1,0
58638,5900,0,0,62,62,0,1,0,1,0
443,54507,0,0,82,82,0,1,0,1,0
63535,44847,0,0,64,64,0,1,0,1,0
62290,57470,0,0,70,70,0,1,0,1,0
61649,25222,0,0,119,119,0,1,0,1,0
65381,55830,0,0,65,65,0,1,0,1,0
58421,30188,0,0,66,66,0,1,0,1,0
63553,44847,0,0,66,66,0,1,0,1,0
55342,210,0,0,67,67,0,1,0,1,0
3462,1502,0,0,71,71,0,1,0,1,0
59076,39004,0,0,73,73,0,1,0,1,0
58638,5900,0,0,62,62,0,1,0,1,0
3535,25174,0,0,62,62,0,1,0,1,0
58251,22114,0,0,63,63,0,1,0,1,0
57167,57470,0,0,65,65,0,1,0,1,0
60789,50584,0,0,63,63,0,1,0,1,0
61162,22114,0,0,66,66,0,1,0,1,0
63487,64142,0,0,62,62,0,1,0,1,0
46901,36237,0,0,62,62,0,1,0,1,0
53773,37965,0,0,65,65,0,1,0,1,0
63765,51221,0,0,62,62,0,1,0,1,0
59326,57470,0,0,74,74,0,1,0,1,0
58638,5900,0,0,62,62,0,1,0,1,0
12902,37965,0,0,62,62,0,1,0,1,0
55893,45711,0,0,78,78,0,1,0,1,0
5233,32926,0,0,66,66,0,1,0,1,0
62749,44847,0,0,146,146,0,1,0,1,0
26263,64147,0,0,63,63,0,1,0,1,0
49984,37965,0,0,66,66,0,1,0,1,0
21790,22114,0,0,62,62,0,1,0,1,0
702,7795,0,0,62,62,0,1,0,1,0
58638,5900,0,0,62,62,0,1,0,1,0
48676,53393,0,0,60,60,0,1,0,1,0
1172,57470,0,0,146,146,0,1,0,1,0
1515,50584,0,0,139,139,0,1,0,1,0
7076,51352,0,0,63,63,0,1,0,1,0
50467,26467,0,0,66,66,0,1,0,1,0
52596,17372,0,0,64,64,0,1,0,1,0
46093,32661,0,0,74,74,0,1,0,1,0
3478,61463,0,0,227,227,0,1,0,1,0
53760,36237,0,0,65,65,0,1,0,1,0
34845,35440,0,0,92,92,0,1,0,1,0
58638,5900,0,0,62,62,0,1,0,1,0
3766,37965,0,0,63,63,0,1,0,1,0
57987,56125,0,0,90,90,0,1,0,1,0
17342,32071,0,0,62,62,0,1,0,1,0
48850,50584,0,0,64,64,0,1,0,1,0
34483,48678,0,0,79,79,0,1,0,1,0
1688,30188,0,0,62,62,0,1,0,1,0
42419,22114,0,0,62,62,0,1,0,1,0
45964,3111,0,0,60,60,0,1,0,1,0
15537,22,0,0,60,60,0,1,0,1,0
56899,22114,0,0,112,112,0,1,0,1,0
39211,25174,0,0,62,62,0,1,0,1,0
51735,25174,0,0,63,63,0,1,0,1,0
443,39985,0,0,77,77,0,1,0,1,0
3483,25174,0,0,66,66,0,1,0,1,0
55835,62413,0,0,66,66,0,1,0,1,0
59736,51505,0,0,143,143,0,1,0,1,0
9195,37965,0,0,64,64,0,1,0,1,0
24456,26384,0,0,105,105,0,1,0,1,0
41311,30188,0,0,62,62,0,1,0,1,0
58460,36236,0,0,66,66,0,1,0,1,0
53332,22114,0,0,86,86,0,1,0,1,0
52646,35440,0,0,66,66,0,1,0,1,0
993,34160,0,0,66,66,0,1,0,1,0
35455,57470,0,0,104,104,0,1,0,1,0
61382,25174,0,0,64,64,0,1,0,1,0
14750,25174,0,0,62,62,0,1,0,1,0
63209,50584,0,0,65,65,0,1,0,1,0
36244,23,0,0,60,60,0,1,0,1,0
9457,37965,0,0,64,64,0,1,0,1,0
58486,57470,0,0,66,66,0,1,0,1,0
19797,9189,0,0,61,61,0,1,0,1,0
63903,44847,0,0,62,62,0,1,0,1,0
51244,15933,0,0,100,100,0,1,0,1,0
24174,57470,0,0,62,62,0,1,0,1,0
48706,23393,0,0,60,60,0,1,0,1,0
5637,37965,0,0,62,62,0,1,0,1,0
61149,37965,0,0,65,65,0,1,0,1,0
63085,25174,0,0,101,101,0,1,0,1,0
44438,26467,0,0,62,62,0,1,0,1,0
16653,36152,0,0,65,65,0,1,0,1,0
3409,17372,0,0,62,62,0,1,0,1,0
55711,26467,0,0,65,65,0,1,0,1,0
16979,56205,0,0,66,66,0,1,0,1,0
41018,25174,0,0,62,62,0,1,0,1,0
27538,25180,0,0,146,146,0,1,0,1,0
39686,23117,0,0,62,62,0,1,0,1,0
6436,26440,0,0,74,74,0,1,0,1,0
11534,25174,0,0,63,63,0,1,0,1,0
57747,37965,0,0,62,62,0,1,0,1,0
50160,50584,0,0,65,65,0,1,0,1,0
10903,15503,0,0,145,145,0,1,0,1,0
1024,44847,0,0,146,146,0,1,0,1,0
55711,26467,0,0,62,62,0,1,0,1,0
1268,12229,0,0,66,66,0,1,0,1,0
44422,37928,0,0,62,62,0,1,0,1,0
58638,5900,0,0,62,62,0,1,0,1,0
25168,25174,0,0,146,146,0,1,0,1,0
6666,138,0,0,60,60,0,1,0,1,0
51739,25174,0,0,62,62,0,1,0,1,0
53316,3389,0,0,64,64,0,1,0,1,0
50075,26653,0,0,62,62,0,1,0,1,0
54232,20767,0,0,63,63,0,1,0,1,0
61268,48817,0,0,87,87,0,1,0,1,0
64079,22114,0,0,66,66,0,1,0,1,0
26427,44847,0,0,146,146,0,1,0,1,0
58638,5900,0,0,62,62,0,1,0,1,0
25053,64147,0,0,66,66,0,1,0,1,0
63451,23,0,0,60,60,0,1,0,1,0
29721,50584,0,0,62,62,0,1,0,1,0
50751,37922,0,0,63,63,0,1,0,1,0
20576,37965,0,0,62,62,0,1,0,1,0
58638,5900,0,0,62,62,0,1,0,1,0
46808,44650,0,0,96,96,0,1,0,1,0
38782,22114,0,0,66,66,0,1,0,1,0
34404,11392,0,0,65,65,0,1,0,1,0
12219,22114,0,0,62,62,0,1,0,1,0
64018,25174,0,0,62,62,0,1,0,1,0
38777,2286,0,0,104,104,0,1,0,1,0
31609,25174,0,0,65,65,0,1,0,1,0
49938,35420,0,0,62,62,0,1,0,1,0
42085,35798,0,0,99,99,0,1,0,1,0
53849,44512,0,0,63,63,0,1,0,1,0
42589,25174,0,0,146,146,0,1,0,1,0
2988,10,0,0,61,61,0,1,0,1,0
21075,25174,0,0,123,123,0,1,0,1,0
58638,5900,0,0,62,62,0,1,0,1,0
63365,62413,0,0,65,65,0,1,0,1,0
58638,5900,0,0,62,62,0,1,0,1,0
63547,37965,0,0,66,66,0,1,0,1,0
58638,5900,0,0,62,62,0,1,0,1,0
46739,34776,0,0,61,61,0,1,0,1,0
62109,44847,0,0,65,65,0,1,0,1,0
54227,50584,0,0,64,64,0,1,0,1,0
62054,25174,0,0,62,62,0,1,0,1,0
58638,5900,0,0,62,62,0,1,0,1,0
53288,25174,0,0,90,90,0,1,0,1,0
26888,41864,0,0,147,147,0,1,0,1,0
57302,100,0,0,77,77,0,1,0,1,0
54188,1680,0,0,101,101,0,1,0,1,0
11983,57470,0,0,62,62,0,1,0,1,0
51320,37965,0,0,62,62,0,1,0,1,0
10072,25174,0,0,141,141,0,1,0,1,0
40308,25214,0,0,146,146,0,1,0,1,0
56946,1,0,0,66,66,0,1,0,1,0
26265,56205,0,0,64,64,0,1,0,1,0
52592,7302,0,0,64,64,0,1,0,1,0
80,57411,0,0,1514,1514,0,1,0,1,0
17391,25174,0,0,62,62,0,1,0,1,0
37837,37965,0,0,62,62,0,1,0,1,0
44177,1433,0,0,60,60,0,1,0,1,0
52477,25174,0,0,66,66,0,1,0,1,0
59132,50584,0,0,66,66,0,1,0,1,0
54510,44847,0,0,66,66,0,1,0,1,0
59929,30188,0,0,65,65,0,1,0,1,0
8655,29212,0,0,106,106,0,1,0,1,0
46704,55228,0,0,116,116,0,1,0,1,0
5251,7936,457,730,101,101,0,1,0,1,0
26758,50584,0,0,66,66,0,1,0,1,0
49181,25174,0,0,101,101,0,1,0,1,0
59424,50265,0,0,70,70,0,1,0,1,0
50077,44847,0,0,63,63,0,1,0,1,0
21610,51505,0,0,63,63,0,1,0,1,0
56404,50584,0,0,63,63,0,1,0,1,0
27144,25174,0,0,66,66,0,1,0,1,0
59941,37852,0,0,63,63,0,1,0,1,0
6660,44821,0,0,66,66,0,1,0,1,0
43260,41615,0,0,145,145,0,1,0,1,0
58638,5900,0,0,62,62,0,1,0,1,0
29145,8168,0,0,62,62,0,1,0,1,0
16376,35440,0,0,66,66,0,1,0,1,0
1025,64147,0,0,62,62,0,1,0,1,0
4111,25174,0,0,79,79,0,1,0,1,0
52210,51505,0,0,66,66,0,1,0,1,0
12462,48817,0,0,64,64,0,1,0,1,0
58930,57470,0,0,68,68,0,1,0,1,0
443,21949,0,0,103,103,0,1,0,1,0
49655,22114,0,0,63,63,0,1,0,1,0
18950,50584,0,0,117,117,0,1,0,1,0
60785,51128,0,0,66,66,0,1,0,1,0
53013,32405,0,0,65,65,0,1,0,1,0
58509,21247,0,0,66,66,0,1,0,1,0
49217,44847,0,0,65,65,0,1,0,1,0
55254,50584,0,0,66,66,0,1,0,1,0
51093,57470,0,0,66,66,0,1,0,1,0
59336,57470,0,0,67,67,0,1,0,1,0
62803,25174,0,0,62,62,0,1,0,1,0
45964,2666,0,0,60,60,0,1,0,1,0
63114,25174,0,0,82,82,0,1,0,1,0
39056,22114,0,0,62,62,0,1,0,1,0
53298,26467,0,0,63,63,0,1,0,1,0
58253,51352,0,0,63,63,0,1,0,1,0
63755,58837,0,0,62,62,0,1,0,1,0
61830,51505,0,0,65,65,0,1,0,1,0
56788,35440,0,0,62,62,0,1,0,1,0
24704,48817,0,0,112,112,0,1,0,1,0
32007,61714,0,0,143,143,0,1,0,1,0
58638,5900,0,0,62,62,0,1,0,1,0
61799,17534,0,0,62,62,0,1,0,1,0
443,10010,0,0,60,60,0,1,0,1,0
50562,37965,0,0,64,64,0,1,0,1,0
61749,50387,0,0,66,66,0,1,0,1,0
1733,65448,0,0,66,66,0,1,0,1,0
32502,48590,0,0,124,124,0,1,0,1,0
5223,14446,0,0,220,220,0,1,0,1,0
25451,50584,0,0,89,89,0,1,0,1,0
43645,1433,0,0,60,60,0,1,0,1,0
4050,25174,0,0,62,62,0,1,0,1,0
45879,7861,0,0,89,89,0,1,0,1,0
26408,64147,0,0,66,66,0,1,0,1,0
10190,57470,0,0,62,62,0,1,0,1,0
17784,44847,0,0,80,80,0,1,0,1,0
2198,25174,0,0,146,146,0,1,0,1,0
59710,51505,0,0,63,63,0,1,0,1,0
12226,37965,0,0,62,62,0,1,0,1,0
29184,25174,0,0,62,62,0,1,0,1,0
59196,25174,0,0,64,64,0,1,0,1,0
52735,25174,0,0,62,62,0,1,0,1,0
58638,5900,0,0,62,62,0,1,0,1,0
59988,64147,0,0,66,66,0,1,0,1,0
20675,37965,0,0,62,62,0,1,0,1,0
52526,30188,0,0,64,64,0,1,0,1,0
35034,30188,0,0,79,79,0,1,0,1,0
61031,53330,0,0,68,68,0,1,0,1,0
33030,62413,0,0,66,66,0,1,0,1,0
63293,50265,0,0,66,66,0,1,0,1,0
322,54539,0,0,76,76,0,1,0,1,0
64950,26467,0,0,62,62,0,1,0,1,0
30141,23,0,0,60,60,0,1,0,1,0
3892,25174,0,0,131,131,0,1,0,1,0
55496,64097,0,0,66,66,0,1,0,1,0
61639,37965,0,0,66,66,0,1,0,1,0
3716,25174,0,0,62,62,0,1,0,1,0
43828,44847,0,0,66,66,0,1,0,1,0
45964,2225,0,0,60,60,0,1,0,1,0
53152,25174,0,0,63,63,0,1,0,1,0
60955,49036,0,0,65,65,0,1,0,1,0
13419,44847,0,0,66,66,0,1,0,1,0
31006,50584,0,0,74,74,0,1,0,1,0
58638,5900,0,0,62,62,0,1,0,1,0
53863,44512,0,0,62,62,0,1,0,1,0
1316,56205,0,0,64,64,0,1,0,1,0
58638,5900,0,0,62,62,0,1,0,1,0
22677,25174,0,0,66,66,0,1,0,1,0
34348,22114,0,0,62,62,0,1,0,1,0
59538,37965,0,0,62,62,0,1,0,1,0
59091,57866,0,0,66,66,0,1,0,1,0
56616,64079,0,0,65,65,0,1,0,1,0
34500,57470,0,0,66,66,0,1,0,1,0
45964,55559,0,0,60,60,0,1,0,1,0
7752,25174,0,0,103,103,0,1,0,1,0
56494,15503,0,0,146,146,0,1,0,1,0
60042,35440,0,0,64,64,0,1,0,1,0
54786,30188,0,0,66,66,0,1,0,1,0
58638,5900,0,0,62,62,0,1,0,1,0
3885,57543,0,0,62,62,0,1,0,1,0
30435,44961,0,0,61,61,0,1,0,1,0
52650,37965,0,0,63,63,0,1,0,1,0
65375,44847,0,0,66,66,0,1,0,1,0
58343,23718,0,0,66,66,0,1,0,1,0
46021,51505,0,0,120,120,0,1,0,1,0
65218,55637,0,0,66,66,0,1,0,1,0
30046,15503,0,0,62,62,0,1,0,1,0
30943,22114,0,0,64,64,0,1,0,1,0
27621,50584,0,0,111,111,0,1,0,1,0
57699,50584,0,0,107,107,0,1,0,1,0
60557,23117,0,0,64,64,0,1,0,1,0
53285,56205,0,0,108,108,0,1,0,1,0
58625,44847,0,0,62,62,0,1,0,1,0
65515,22114,0,0,66,66,0,1,0,1,0
62193,22114,0,0,66,66,0,1,0,1,0
48706,23393,0,0,60,60,0,1,0,1,0
55838,64147,0,0,66,66,0,1,0,1,0
21687,30188,0,0,63,63,0,1,0,1,0
58020,5555,0,0,60,60,0,1,0,1,0
24193,23,0,0,60,60,0,1,0,1,0
443,21096,0,0,76,76,0,1,0,1,0
1068,46799,0,0,62,62,0,1,0,1,0
64787,35993,0,0,67,67,0,1,0,1,0
22677,25174,0,0,66,66,0,1,0,1,0
55479,56205,0,0,65,65,0,1,0,1,0
3170,22114,0,0,62,62,0,1,0,1,0
59201,51221,0,0,66,66,0,1,0,1,0
58582,50584,0,0,66,66,0,1,0,1,0
7250,64147,0,0,66,66,0,1,0,1,0
6873,48116,0,0,145,145,0,1,0,1,0
9937,52342,0,0,63,63,0,1,0,1,0
16270,50584,0,0,63,63,0,1,0,1,0
34652,22506,0,0,62,62,0,1,0,1,0
59597,37965,0,0,62,62,0,1,0,1,0
34174,51488,0,0,62,62,0,1,0,1,0
1064,9212,0,0,73,73,0,1,0,1,0
10965,22114,0,0,62,62,0,1,0,1,0
6666,3389,0,0,60,60,0,1,0,1,0
59849,44847,0,0,65,65,0,1,0,1,0
52214,25226,0,0,66,66,0,1,0,1,0
61838,37965,0,0,66,66,0,1,0,1,0
58638,5900,0,0,62,62,0,1,0,1,0
11217,30188,0,0,71,71,0,1,0,1,0
14333,51050,0,0,62,62,0,1,0,1,0
59524,25174,0,0,66,66,0,1,0,1,0
48706,23393,0,0,60,60,0,1,0,1,0
30277,37965,0,0,65,65,0,1,0,1,0
63433,57866,0,0,63,63,0,1,0,1,0
52217,22114,0,0,62,62,0,1,0,1,0
42956,44847,0,0,65,65,0,1,0,1,0
51270,37965,0,0,63,63,0,1,0,1,0
15006,44847,0,0,78,78,0,1,0,1,0
56820,26467,0,0,64,64,0,1,0,1,0
28767,50584,0,0,66,66,0,1,0,1,0
29742,50584,0,0,145,145,0,1,0,1,0
51094,35440,0,0,62,62,0,1,0,1,0
58638,5900,0,0,62,62,0,1,0,1,0
62955,11569,0,0,62,62,0,1,0,1,0
43152,15503,0,0,62,62,0,1,0,1,0
42951,22114,0,0,64,64,0,1,0,1,0
62694,57470,0,0,71,71,0,1,0,1,0
59602,56205,0,0,62,62,0,1,0,1,0
39622,37965,0,0,64,64,0,1,0,1,0
58922,57470,0,0,66,66,0,1,0,1,0
57551,23,0,0,60,60,0,1,0,1,0
43116,19,0,0,60,60,0,1,0,1,0
51815,51221,0,0,74,74,0,1,0,1,0
16621,21247,0,0,62,62,0,1,0,1,0
1114,37965,0,0,62,62,0,1,0,1,0
10504,57470,0,0,62,62,0,1,0,1,0
58370,50584,0,0,62,62,0,1,0,1,0
59584,56205,0,0,64,64,0,1,0,1,0
45964,2226,0,0,60,60,0,1,0,1,0
60265,30188,0,0,62,62,0,1,0,1,0
2612,64147,0,0,62,62,0,1,0,1,0
58465,11392,0,0,66,66,0,1,0,1,0
57046,35829,0,0,107,107,0,1,0,1,0
61782,50584,0,0,66,66,0,1,0,1,0
59598,37965,0,0,62,62,0,1,0,1,0
2814,64147,0,0,62,62,0,1,0,1,0
20576,37965,0,0,62,62,0,1,0,1,0
60196,30188,0,0,66,66,0,1,0,1,0
54330,64147,0,0,64,64,0,1,0,1,0
21185,23,0,0,60,60,0,1,0,1,0
50967,45949,0,0,64,64,0,1,0,1,0
22400,22114,0,0,69,69,0,1,0,1,0
57767,30285,0,0,65,65,0,1,0,1,0
5023,43417,0,0,134,134,0,1,0,1,0
23179,48846,0,0,79,79,0,1,0,1,0
58638,5900,0,0,62,62,0,1,0,1,0
26064,21,0,0,60,60,0,1,0,1,0
26912,22179,0,0,65,65,0,1,0,1,0
27720,57470,0,0,62,62,0,1,0,1,0
57090,51505,0,0,66,66,0,1,0,1,0
29139,64147,0,0,62,62,0,1,0,1,0
35019,26467,0,0,62,62,0,1,0,1,0
51625,26467,0,0,63,63,0,1,0,1,0
57131,35776,0,0,145,145,0,1,0,1,0
54280,3397,0,0,60,60,0,1,0,1,0
63512,44847,0,0,66,66,0,1,0,1,0
61768,11392,0,0,65,65,0,1,0,1,0
56127,37965,0,0,66,66,0,1,0,1,0
52185,22114,0,0,65,65,0,1,0,1,0
41249,50584,0,0,63,63,0,1,0,1,0
58638,5900,0,0,62,62,0,1,0,1,0
6666,961,0,0,60,60,0,1,0,1,0
1026,44847,0,0,62,62,0,1,0,1,0
63948,38154,0,0,62,62,0,1,0,1,0
47774,51505,0,0,63,63,0,1,0,1,0
27359,30210,0,0,65,65,0,1,0,1,0
50637,44847,0,0,63,63,0,1,0,1,0
30027,23,0,0,60,60,0,1,0,1,0
64953,26467,0,0,62,62,0,1,0,1,0
58638,5900,0,0,62,62,0,1,0,1,0
22981,15503,0,0,65,65,0,1,0,1,0
51936,36178,0,0,66,66,0,1,0,1,0
4039,50584,0,0,62,62,0,1,0,1,0
56452,11392,0,0,62,62,0,1,0,1,0
62744,62413,0,0,66,66,0,1,0,1,0
45941,23386,0,0,60,60,0,1,0,1,0
54062,49813,0,0,62,62,0,1,0,1,0
68,67,0,0,346,346,0,1,0,1,0
50312,37965,0,0,66,66,0,1,0,1,0
58638,5900,0,0,62,62,0,1,0,1,0
59443,50584,0,0,63,63,0,1,0,1,0
60298,26467,0,0,65,65,0,1,0,1,0
28933,44847,0,0,66,66,0,1,0,1,0
6881,6881,0,0,146,146,0,1,0,1,0
45187,25174,0,0,96,96,0,1,0,1,0
10938,51505,0,0,62,62,0,1,0,1,0
42276,25174,0,0,72,72,0,1,0,1,0
56378,51505,0,0,64,64,0,1,0,1,0
1173,25174,0,0,62,62,0,1,0,1,0
1863,25174,0,0,62,62,0,1,0,1,0
24144,57470,0,0,62,62,0,1,0,1,0
51482,46606,0,0,93,93,0,1,0,1,0
46719,36237,0,0,62,62,0,1,0,1,0
58638,5900,0,0,62,62,0,1,0,1,0
53902,44512,0,0,62,62,0,1,0,1,0
51769,51505,0,0,66,66,0,1,0,1,0
58638,5900,0,0,62,62,0,1,0,1,0
58345,38116,0,0,66,66,0,1,0,1,0
54179,64147,0,0,66,66,0,1,0,1,0
10449,36555,0,0,107,107,0,1,0,1,0
51215,44847,0,0,64,64,0,1,0,1,0
22913,22114,0,0,89,89,0,1,0,1,0
43822,6147,0,0,60,60,0,1,0,1,0
48920,51183,0,0,62,62,0,1,0,1,0
35184,32370,0,0,62,62,0,1,0,1,0
6057,51221,0,0,78,78,0,1,0,1,0
46734,50265,0,0,74,74,0,1,0,1,0
6881,6881,0,0,62,62,0,1,0,1,0
58638,5900,0,0,62,62,0,1,0,1,0
55978,56205,0,0,66,66,0,1,0,1,0
3541,22114,0,0,62,62,0,1,0,1,0
21207,44847,0,0,62,62,0,1,0,1,0
58638,5900,0,0,62,62,0,1,0,1,0
62148,37965,0,0,62,62,0,1,0,1,0
1114,46824,0,0,62,62,0,1,0,1,0
50124,1577,0,0,80,80,0,1,0,1,0
52459,5555,0,0,60,60,0,1,0,1,0
54788,37965,0,0,64,64,0,1,0,1,0
21482,22114,0,0,62,62,0,1,0,1,0
57838,21247,0,0,66,66,0,1,0,1,0
18002,44847,0,0,65,65,0,1,0,1,0
19849,22114,0,0,133,133,0,1,0,1,0
25222,37965,0,0,62,62,0,1,0,1,0
58778,51505,0,0,66,66,0,1,0,1,0
10508,26581,0,0,60,60,0,1,0,1,0
34932,38608,0,0,62,62,0,1,0,1,0
9605,57470,0,0,62,62,0,1,0,1,0
47943,50584,0,0,63,63,0,1,0,1,0
16387,3655,0,0,60,60,0,1,0,1,0
58250,35440,0,0,63,63,0,1,0,1,0
58638,5900,0,0,62,62,0,1,0,1,0
27319,44847,0,0,62,62,0,1,0,1,0
39804,55193,0,0,139,139,0,1,0,1,0
55390,22114,0,0,63,63,0,1,0,1,0
22265,30188,0,0,66,66,0,1,0,1,0
22690,50584,0,0,101,101,0,1,0,1,0
3406,17372,0,0,65,65,0,1,0,1,0
22452,25174,0,0,64,64,0,1,0,1,0
56026,62413,0,0,62,62,0,1,0,1,0
58638,5900,0,0,62,62,0,1,0,1,0
11836,37847,0,0,62,62,0,1,0,1,0
11444,30188,0,0,92,92,0,1,0,1,0
35261,15503,0,0,74,74,0,1,0,1,0
61945,48817,0,0,64,64,0,1,0,1,0
9394,35440,0,0,63,63,0,1,0,1,0
53200,50584,0,0,66,66,0,1,0,1,0
49941,26467,0,0,66,66,0,1,0,1,0
52783,53676,0,0,62,62,0,1,0,1,0
58638,5900,0,0,62,62,0,1,0,1,0
58638,5900,0,0,62,62,0,1,0,1,0
25378,52109,0,0,60,60,0,1,0,1,0
36833,88,0,0,173,173,0,1,0,1,0
10397,21054,0,0,62,62,0,1,0,1,0
5223,14446,0,0,220,220,0,1,0,1,0
59290,2576,0,0,82,82,0,1,0,1,0
68,67,0,0,424,424,0,1,0,1,0
1024,25174,0,0,62,62,0,1,0,1,0
10743,37965,0,0,62,62,0,1,0,1,0
28869,30188,0,0,127,127,0,1,0,1,0
15832,64147,0,0,64,64,0,1,0,1,0
1882,43890,0,0,62,62,0,1,0,1,0
58930,37868,0,0,63,63,0,1,0,1,0
49629,26467,0,0,66,66,0,1,0,1,0
36750,25174,0,0,66,66,0,1,0,1,0
62489,23117,0,0,63,63,0,1,0,1,0
20726,2767,0,0,62,62,0,1,0,1,0
53769,30198,0,0,66,66,0,1,0,1,0
54447,56205,0,0,62,62,0,1,0,1,0
5343,21401,0,0,63,63,0,1,0,1,0
22010,42120,0,0,81,81,0,1,0,1,0
55989,57795,0,0,65,65,0,1,0,1,0
50755,37912,0,0,63,63,0,1,0,1,0
6666,3389,0,0,60,60,0,1,0,1,0
12878,25174,0,0,146,146,0,1,0,1,0
33920,11051,0,0,91,91,0,1,0,1,0
53094,25174,0,0,62,62,0,1,0,1,0
64865,11392,0,0,62,62,0,1,0,1,0
65371,55904,0,0,66,66,0,1,0,1,0
54600,6881,0,0,66,66,0,1,0,1,0
42951,22114,0,0,63,63,0,1,0,1,0
3212,22114,0,0,89,89,0,1,0,1,0
53382,23,0,0,60,60,0,1,0,1,0
22683,39210,0,0,60,60,0,1,0,1,0
18728,56258,0,0,68,68,0,1,0,1,0
49182,21247,0,0,62,62,0,1,0,1,0
27982,56205,0,0,146,146,0,1,0,1,0
4257,35440,0,0,62,62,0,1,0,1,0
61798,35440,0,0,66,66,0,1,0,1,0
57053,64064,0,0,62,62,0,1,0,1,0
62946,11392,0,0,62,62,0,1,0,1,0
45462,13796,0,0,67,67,0,1,0,1,0
9405,30290,0,0,61,61,0,1,0,1,0
43916,21,0,0,60,60,0,1,0,1,0
61230,22114,0,0,65,65,0,1,0,1,0
44069,44847,0,0,66,66,0,1,0,1,0
10127,63022,0,0,124,124,0,1,0,1,0
13285,29892,0,0,145,145,0,1,0,1,0
9602,57528,0,0,89,89,0,1,0,1,0
62414,50584,0,0,62,62,0,1,0,1,0
23347,25174,0,0,62,62,0,1,0,1,0
17097,62413,0,0,62,62,0,1,0,1,0
1030,64147,0,0,62,62,0,1,0,1,0
1025,35447,0,0,62,62,0,1,0,1,0
58638,5900,0,0,62,62,0,1,0,1,0
32974,37965,0,0,66,66,0,1,0,1,0
59554,64109,0,0,66,66,0,1,0,1,0
9448,37965,0,0,62,62,0,1,0,1,0
58638,5900,0,0,62,62,0,1,0,1,0
28363,64147,0,0,62,62,0,1,0,1,0
57318,60043,0,0,62,62,0,1,0,1,0
6889,48817,0,0,143,143,0,1,0,1,0
42400,22114,0,0,63,63,0,1,0,1,0
45682,37965,0,0,62,62,0,1,0,1,0
55163,44847,0,0,64,64,0,1,0,1,0
12138,22114,0,0,62,62,0,1,0,1,0
54412,26467,0,0,62,62,0,1,0,1,0
57987,28994,0,0,123,123,0,1,0,1,0
29369,7481,0,0,82,82,0,1,0,1,0
58686,18375,0,0,66,66,0,1,0,1,0
11683,25174,0,0,106,106,0,1,0,1,0
46346,35440,0,0,66,66,0,1,0,1,0
41527,56132,0,0,83,83,0,1,0,1,0
24144,57470,0,0,62,62,0,1,0,1,0
47910,7461,0,0,60,60,0,1,0,1,0
31965,51505,0,0,65,65,0,1,0,1,0
59772,62413,0,0,62,62,0,1,0,1,0
42285,57470,0,0,62,62,0,1,0,1,0
54393,22114,0,0,65,65,0,1,0,1,0
58638,5900,0,0,62,62,0,1,0,1,0
10336,6684,0,0,146,146,0,1,0,1,0
58827,57470,0,0,64,64,0,1,0,1,0
5230,35440,0,0,65,65,0,1,0,1,0
56619,56205,0,0,63,63,0,1,0,1,0
443,54507,0,0,82,82,0,1,0,1,0
43036,51352,0,0,106,106,0,1,0,1,0
64000,22114,0,0,64,64,0,1,0,1,0
49267,57470,0,0,66,66,0,1,0,1,0
63379,36237,0,0,66,66,0,1,0,1,0
6498,44832,0,0,66,66,0,1,0,1,0
3521,6881,0,0,63,63,0,1,0,1,0
58638,5900,0,0,62,62,0,1,0,1,0
19975,2940,0,0,75,75,0,1,0,1,0
4390,35440,0,0,64,64,0,1,0,1,0
49331,51505,0,0,66,66,0,1,0,1,0
62809,25174,0,0,62,62,0,1,0,1,0
50304,64147,0,0,66,66,0,1,0,1,0
52836,24211,0,0,64,64,0,1,0,1,0
63392,25174,0,0,66,66,0,1,0,1,0
58638,5900,0,0,62,62,0,1,0,1,0
58550,21247,0,0,66,66,0,1,0,1,0
53296,3389,0,0,64,64,0,1,0,1,0
55966,57866,0,0,66,66,0,1,0,1,0
1023,33567,0,0,114,114,0,1,0,1,0
56977,25174,0,0,62,62,0,1,0,1,0
10416,64147,0,0,62,62,0,1,0,1,0
54565,36237,0,0,66,66,0,1,0,1,0
6721,37965,0,0,66,66,0,1,0,1,0
58016,22114,0,0,62,62,0,1,0,1,0
1170,25174,0,0,62,62,0,1,0,1,0
62858,9614,0,0,140,140,0,1,0,1,0
58638,5900,0,0,62,62,0,1,0,1,0
53237,64097,0,0,66,66,0,1,0,1,0
32483,50385,0,0,145,145,0,1,0,1,0
57691,64147,0,0,64,64,0,1,0,1,0
45285,47271,0,0,67,67,0,1,0,1,0
41567,59645,0,0,62,62,0,1,0,1,0
52489,35440,0,0,134,134,0,1,0,1,0
30831,10754,0,0,146,146,0,1,0,1,0
59432,50584,0,0,65,65,0,1,0,1,0
16387,26193,0,0,60,60,0,1,0,1,0
16746,10605,0,0,101,101,0,1,0,1,0
53311,36237,0,0,126,126,0,1,0,1,0
26911,37965,0,0,63,63,0,1,0,1,0
68,67,0,0,346,346,0,1,0,1,0
4050,4964,0,0,402,402,0,1,0,1,0
49336,25174,0,0,64,64,0,1,0,1,0
13178,57836,0,0,62,62,0,1,0,1,0
9985,25174,0,0,74,74,0,1,0,1,0
48854,50584,0,0,65,65,0,1,0,1,0
31887,57470,0,0,60,60,0,1,0,1,0
7417,30330,0,0,96,96,0,1,0,1,0
56703,50584,0,0,63,63,0,1,0,1,0
23777,44847,0,0,140,140,0,1,0,1,0
25544,35440,0,0,117,117,0,1,0,1,0
29829,23,0,0,60,60,0,1,0,1,0
57599,42707,0,0,65,65,0,1,0,1,0
58564,17500,0,0,66,66,0,1,0,1,0
443,4205,0,0,226,226,0,1,0,1,0
1227,25174,0,0,62,62,0,1,0,1,0
59734,57470,0,0,62,62,0,1,0,1,0
24271,52700,0,0,66,66,0,1,0,1,0
57133,50584,0,0,62,62,0,1,0,1,0
58638,5900,0,0,62,62,0,1,0,1,0
13021,52608,0,0,65,65,0,1,0,1,0
4368,44847,0,0,64,64,0,1,0,1,0
42436,22114,0,0,62,62,0,1,0,1,0
21649,51505,0,0,62,62,0,1,0,1,0
18549,26467,0,0,62,62,0,1,0,1,0
59649,50584,0,0,62,62,0,1,0,1,0
17345,35440,0,0,62,62,0,1,0,1,0
56629,25174,0,0,66,66,0,1,0,1,0
17378,44847,0,0,63,63,0,1,0,1,0
51311,64147,0,0,64,64,0,1,0,1,0
28882,37965,0,0,62,62,0,1,0,1,0
22998,22114,0,0,131,131,0,1,0,1,0
33215,37965,0,0,62,62,0,1,0,1,0
62698,57470,0,0,62,62,0,1,0,1,0
45013,50584,0,0,62,62,0,1,0,1,0
12134,37965,0,0,62,62,0,1,0,1,0
53038,25174,0,0,66,66,0,1,0,1,0
58638,5900,0,0,62,62,0,1,0,1,0
47405,23,0,0,60,60,0,1,0,1,0
34161,51541,0,0,146,146,0,1,0,1,0
58629,50584,0,0,63,63,0,1,0,1,0
58230,37843,0,0,66,66,0,1,0,1,0
50858,26467,0,0,66,66,0,1,0,1,0
38948,20649,0,0,62,62,0,1,0,1,0
52689,25174,0,0,66,66,0,1,0,1,0
57504,44847,0,0,66,66,0,1,0,1,0
56154,5900,0,0,60,60,0,1,0,1,0
56098,64147,0,0,66,66,0,1,0,1,0
47928,7467,0,0,60,60,0,1,0,1,0
57174,57470,0,0,66,66,0,1,0,1,0
28813,35440,0,0,66,66,0,1,0,1,0
50459,62413,0,0,63,63,0,1,0,1,0
48706,23393,0,0,60,60,0,1,0,1,0
15403,51505,0,0,66,66,0,1,0,1,0
443,44683,0,0,83,83,0,1,0,1,0
26353,23,0,0,60,60,0,1,0,1,0
58660,64142,0,0,66,66,0,1,0,1,0
1072,11223,0,0,113,113,0,1,0,1,0
58638,5900,0,0,62,62,0,1,0,1,0
39980,57470,0,0,62,62,0,1,0,1,0
2920,37965,0,0,62,62,0,1,0,1,0
42392,18,0,0,62,62,0,1,0,1,0
61983,8990,0,0,60,60,0,1,0,1,0
16387,35583,0,0,60,60,0,1,0,1,0
1291,44847,0,0,64,64,0,1,0,1,0
443,63113,0,0,100,100,0,1,0,1,0
15766,36829,0,0,63,63,0,1,0,1,0
15415,23,0,0,60,60,0,1,0,1,0
19906,38129,0,0,117,117,0,1,0,1,0
16887,88,0,0,60,60,0,1,0,1,0
50053,25174,0,0,62,62,0,1,0,1,0
51313,25174,0,0,63,63,0,1,0,1,0
55527,57470,0,0,66,66,0,1,0,1,0
55484,32475,0,0,66,66,0,1,0,1,0
59671,37883,0,0,64,64,0,1,0,1,0
26899,37965,0,0,64,64,0,1,0,1,0
24351,57470,0,0,62,62,0,1,0,1,0
53423,22114,0,0,64,64,0,1,0,1,0
21938,51291,0,0,62,62,0,1,0,1,0
50261,1433,0,0,60,60,0,1,0,1,0
61945,48817,0,0,63,63,0,1,0,1,0
54984,37965,0,0,122,122,0,1,0,1,0
52043,22114,0,0,99,99,0,1,0,1,0
62549,25174,0,0,62,62,0,1,0,1,0
52503,39793,0,0,122,122,0,1,0,1,0
58638,5900,0,0,62,62,0,1,0,1,0
30949,50584,0,0,114,114,0,1,0,1,0
56679,9571,0,0,70,70,0,1,0,1,0
58638,5900,0,0,62,62,0,1,0,1,0
55459,50584,0,0,65,65,0,1,0,1,0
48317,44847,0,0,129,129,0,1,0,1,0
21252,22,0,0,60,60,0,1,0,1,0
5809,10390,0,0,94,94,0,1,0,1,0
44662,32271,0,0,62,62,0,1,0,1,0
0,0,0,0,82,82,0,1,0,1,0
26893,37965,0,0,64,64,0,1,0,1,0
2338,35440,0,0,73,73,0,1,0,1,0
7682,2186,0,0,62,62,0,1,0,1,0
56619,25174,0,0,66,66,0,1,0,1,0
12596,22114,0,0,113,113,0,1,0,1,0
58638,5900,0,0,62,62,0,1,0,1,0
51939,56205,0,0,62,62,0,1,0,1,0
62957,50584,0,0,62,62,0,1,0,1,0
57797,64147,0,0,65,65,0,1,0,1,0
50342,37965,0,0,66,66,0,1,0,1,0
60239,30188,0,0,66,66,0,1,0,1,0
58479,57512,0,0,66,66,0,1,0,1,0
63480,125,0,0,60,60,0,1,0,1,0
51053,46051,0,0,83,83,0,1,0,1,0
7202,41918,0,0,130,130,0,1,0,1,0
59131,51505,0,0,65,65,0,1,0,1,0
21845,22,0,0,60,60,0,1,0,1,0
45908,3383,0,0,60,60,0,1,0,1,0
58638,5900,0,0,62,62,0,1,0,1,0
32463,22114,0,0,66,66,0,1,0,1,0
3270,35440,0,0,65,65,0,1,0,1,0
53023,25174,0,0,66,66,0,1,0,1,0
57131,35776,0,0,145,145,0,1,0,1,0
52830,36810,0,0,62,62,0,1,0,1,0
50316,37965,0,0,66,66,0,1,0,1,0
10669,49756,0,0,60,60,0,1,0,1,0
0,0,0,0,98,98,0,1,0,1,0
63013,51505,0,0,65,65,0,1,0,1,0
54772,50584,0,0,65,65,0,1,0,1,0
53437,44847,0,0,66,66,0,1,0,1,0
34233,39043,0,0,102,102,0,1,0,1,0
7594,44847,0,0,66,66,0,1,0,1,0
3407,57866,0,0,66,66,0,1,0,1,0
45211,25174,0,0,101,101,0,1,0,1,0
45410,1,0,0,62,62,0,1,0,1,0
35011,37965,0,0,62,62,0,1,0,1,0
52914,58597,0,0,63,63,0,1,0,1,0
13441,57470,0,0,62,62,0,1,0,1,0
6356,26467,0,0,62,62,0,1,0,1,0
62703,25174,0,0,64,64,0,1,0,1,0
55308,50584,0,0,66,66,0,1,0,1,0
45964,55559,0,0,60,60,0,1,0,1,0
51999,56158,0,0,64,64,0,1,0,1,0
53642,25174,0,0,66,66,0,1,0,1,0
64878,26467,0,0,62,62,0,1,0,1,0
65224,44847,0,0,98,98,0,1,0,1,0
45908,33330,0,0,60,60,0,1,0,1,0
1824,64147,0,0,66,66,0,1,0,1,0
18502,64128,0,0,63,63,0,1,0,1,0
58638,5900,0,0,62,62,0,1,0,1,0
8976,44847,0,0,63,63,0,1,0,1,0
63108,35440,0,0,65,65,0,1,0,1,0
1027,25174,0,0,67,67,0,1,0,1,0
54773,50584,0,0,64,64,0,1,0,1,0
27059,64147,0,0,63,63,0,1,0,1,0
54906,60043,0,0,64,64,0,1,0,1,0
25585,50327,0,0,92,92,0,1,0,1,0
45964,3111,0,0,60,60,0,1,0,1,0
50857,25864,0,0,73,73,0,1,0,1,0
60079,25179,0,0,85,85,0,1,0,1,0
33399,22,0,0,60,60,0,1,0,1,0
19896,22114,0,0,62,62,0,1,0,1,0
59067,25174,0,0,66,66,0,1,0,1,0
56005,64147,0,0,62,62,0,1,0,1,0
58344,24708,0,0,144,144,0,1,0,1,0
53481,37807,0,0,95,95,0,1,0,1,0
1025,35447,0,0,62,62,0,1,0,1,0
10969,22114,0,0,64,64,0,1,0,1,0
12554,22114,0,0,62,62,0,1,0,1,0
18542,26467,0,0,62,62,0,1,0,1,0
64022,57470,0,0,67,67,0,1,0,1,0
2656,11392,0,0,128,128,0,1,0,1,0
64815,37965,0,0,65,65,0,1,0,1,0
0,0,0,0,98,98,0,1,0,1,0
22408,22114,0,0,66,66,0,1,0,1,0
37196,5900,0,0,60,60,0,1,0,1,0
60208,31364,0,0,128,128,0,1,0,1,0
58638,5900,0,0,62,62,0,1,0,1,0
51146,23117,0,0,66,66,0,1,0,1,0
64482,64147,0,0,66,66,0,1,0,1,0
28875,51505,0,0,62,62,0,1,0,1,0
59668,37913,0,0,66,66,0,1,0,1,0
58638,5900,0,0,62,62,0,1,0,1,0
443,21343,0,0,71,71,0,1,0,1,0
51421,22114,0,0,65,65,0,1,0,1,0
58638,5900,0,0,62,62,0,1,0,1,0
62067,22114,0,0,63,63,0,1,0,1,0
51559,44847,0,0,64,64,0,1,0,1,0
58638,5900,0,0,62,62,0,1,0,1,0
1175,62551,0,0,122,122,0,1,0,1,0
32760,37965,0,0,64,64,0,1,0,1,0
49606,18593,0,0,151,151,0,1,0,1,0
80,53945,0,0,60,60,0,1,0,1,0
1035,64147,0,0,145,145,0,1,0,1,0
5151,50573,0,0,62,62,0,1,0,1,0
29300,44847,0,0,65,65,0,1,0,1,0
51826,17372,0,0,63,63,0,1,0,1,0
60818,37965,0,0,66,66,0,1,0,1,0
42433,1527,0,0,60,60,0,1,0,1,0
34500,19662,0,0,61,61,0,1,0,1,0
1574,44847,0,0,62,62,0,1,0,1,0
46901,26672,0,0,60,60,0,1,0,1,0
39055,15503,0,0,108,108,0,1,0,1,0
62729,50584,0,0,62,62,0,1,0,1,0
34446,38969,0,0,72,72,0,1,0,1,0
19344,44847,0,0,66,66,0,1,0,1,0
33595,23,0,0,60,60,0,1,0,1,0
6787,4842,0,0,78,78,0,1,0,1,0
5228,3434,0,0,440,440,0,1,0,1,0
4772,50584,0,0,65,65,0,1,0,1,0
45964,2225,0,0,60,60,0,1,0,1,0
26464,25174,0,0,65,65,0,1,0,1,0
1052,51705,0,0,134,134,0,1,0,1,0
27834,51437,0,0,126,126,0,1,0,1,0
19159,57866,0,0,65,65,0,1,0,1,0
33565,51758,0,0,98,98,0,1,0,1,0
6853,26379,0,0,105,105,0,1,0,1,0
60714,50584,0,0,66,66,0,1,0,1,0
18852,57602,0,0,62,62,0,1,0,1,0
58571,57579,0,0,65,65,0,1,0,1,0
50734,37965,0,0,62,62,0,1,0,1,0
52988,53567,0,0,62,62,0,1,0,1,0
55377,44847,0,0,65,65,0,1,0,1,0
45941,23388,0,0,60,60,0,1,0,1,0
443,22260,0,0,104,104,0,1,0,1,0
29319,48817,0,0,145,145,0,1,0,1,0
50307,37965,0,0,66,66,0,1,0,1,0
47943,50584,0,0,74,74,0,1,0,1,0
1865,25174,0,0,62,62,0,1,0,1,0
47066,1956,0,0,60,60,0,1,0,1,0
49455,22114,0,0,62,62,0,1,0,1,0
1024,57470,0,0,62,62,0,1,0,1,0
62709,57470,0,0,62,62,0,1,0,1,0
48706,23393,0,0,60,60,0,1,0,1,0
37034,25174,0,0,62,62,0,1,0,1,0
17774,11392,0,0,62,62,0,1,0,1,0
443,47748,0,0,88,88,0,1,0,1,0
62970,44847,0,0,65,65,0,1,0,1,0
7108,25174,0,0,66,66,0,1,0,1,0
65424,22114,0,0,66,66,0,1,0,1,0
43584,24748,0,0,156,156,0,1,0,1,0
52619,37965,0,0,62,62,0,1,0,1,0
44136,64147,0,0,112,112,0,1,0,1,0
2691,64147,0,0,62,62,0,1,0,1,0
11391,64147,0,0,139,139,0,1,0,1,0
55157,21247,0,0,66,66,0,1,0,1,0
25498,6380,0,0,62,62,0,1,0,1,0
41113,38163,0,0,145,145,0,1,0,1,0
56457,22114,0,0,143,143,0,1,0,1,0
26481,26407,0,0,63,63,0,1,0,1,0
53047,36237,0,0,63,63,0,1,0,1,0
29742,50584,0,0,104,104,0,1,0,1,0
57627,28495,0,0,63,63,0,1,0,1,0
38680,15503,0,0,73,73,0,1,0,1,0
9531,35440,0,0,66,66,0,1,0,1,0
64068,25174,0,0,62,62,0,1,0,1,0
53952,30047,0,0,66,66,0,1,0,1,0
58638,5900,0,0,62,62,0,1,0,1,0
63035,35440,0,0,66,66,0,1,0,1,0
10270,32480,0,0,66,66,0,1,0,1,0
52901,37965,0,0,66,66,0,1,0,1,0
45941,23386,0,0,60,60,0,1,0,1,0
16961,57470,0,0,75,75,0,1,0,1,0
7748,25174,0,0,64,64,0,1,0,1,0
50402,62413,0,0,66,66,0,1,0,1,0
22439,25174,0,0,66,66,0,1,0,1,0
11136,17500,0,0,76,76,0,1,0,1,0
54904,51505,0,0,64,64,0,1,0,1,0
38484,48637,0,0,60,60,0,1,0,1,0
61537,57866,0,0,66,66,0,1,0,1,0
26252,22,0,0,60,60,0,1,0,1,0
58638,5900,0,0,62,62,0,1,0,1,0
62112,22114,0,0,64,64,0,1,0,1,0
65285,44847,0,0,138,138,0,1,0,1,0
27328,21247,0,0,65,65,0,1,0,1,0
46499,36237,0,0,129,129,0,1,0,1,0
51512,48673,0,0,87,87,0,1,0,1,0
54280,3398,0,0,60,60,0,1,0,1,0
56112,51505,0,0,63,63,0,1,0,1,0
5060,37965,0,0,66,66,0,1,0,1,0
28774,64147,0,0,62,62,0,1,0,1,0
51186,11650,0,0,74,74,0,1,0,1,0
52526,23,0,0,60,60,0,1,0,1,0
53869,37965,0,0,66,66,0,1,0,1,0
28300,50584,0,0,146,146,0,1,0,1,0
4248,35440,0,0,62,62,0,1,0,1,0
6029,23,0,0,60,60,0,1,0,1,0
60428,64147,0,0,62,62,0,1,0,1,0
56363,44847,0,0,66,66,0,1,0,1,0
623,40243,0,0,99,99,0,1,0,1,0
16917,57470,0,0,88,88,0,1,0,1,0
60017,64147,0,0,62,62,0,1,0,1,0
26376,27189,0,0,65,65,0,1,0,1,0
47480,26510,0,0,62,62,0,1,0,1,0
50746,64147,0,0,66,66,0,1,0,1,0
56211,55442,0,0,66,66,0,1,0,1,0
16383,61029,0,0,70,70,0,1,0,1,0
58343,23718,0,0,66,66,0,1,0,1,0
28128,37965,0,0,62,62,0,1,0,1,0
48681,11392,0,0,121,121,0,1,0,1,0
29015,25174,0,0,63,63,0,1,0,1,0
29593,37807,0,0,64,64,0,1,0,1,0
6883,55603,0,0,140,140,0,1,0,1,0
49644,30188,0,0,65,65,0,1,0,1,0
55968,56205,0,0,66,66,0,1,0,1,0
40033,50362,0,0,62,62,0,1,0,1,0
9402,56205,0,0,66,66,0,1,0,1,0
58638,5900,0,0,62,62,0,1,0,1,0
55537,64147,0,0,64,64,0,1,0,1,0
5223,14446,0,0,220,220,0,1,0,1,0
58124,29,0,0,207,207,0,1,0,1,0
3478,61463,0,0,1289,1289,0,1,0,1,0
54220,50584,0,0,64,64,0,1,0,1,0
37612,44847,0,0,62,62,0,1,0,1,0
32499,50331,0,0,145,145,0,1,0,1,0
11677,37965,0,0,108,108,0,1,0,1,0
57408,37965,0,0,65,65,0,1,0,1,0
58638,5900,0,0,62,62,0,1,0,1,0
54250,11392,0,0,66,66,0,1,0,1,0
0,0,0,0,71,71,0,1,0,1,0
10513,35799,0,0,64,64,0,1,0,1,0
39126,25174,0,0,146,146,0,1,0,1,0
1309,51404,0,0,116,116,0,1,0,1,0
63349,36237,0,0,66,66,0,1,0,1,0
62189,64147,0,0,62,62,0,1,0,1,0
16597,21247,0,0,62,62,0,1,0,1,0
49829,7160,0,0,66,66,0,1,0,1,0
10003,64147,0,0,62,62,0,1,0,1,0
33930,39116,0,0,154,154,0,1,0,1,0
59401,51505,0,0,64,64,0,1,0,1,0
47256,37807,0,0,64,64,0,1,0,1,0
40135,57470,0,0,65,65,0,1,0,1,0
58638,5900,0,0,62,62,0,1,0,1,0
51046,25174,0,0,66,66,0,1,0,1,0
63529,51092,0,0,65,65,0,1,0,1,0
19875,30170,0,0,145,145,0,1,0,1,0
45654,21806,0,0,116,116,0,1,0,1,0
59411,37965,0,0,66,66,0,1,0,1,0
15087,50584,0,0,62,62,0,1,0,1,0
58509,21247,0,0,66,66,0,1,0,1,0
45964,2225,0,0,60,60,0,1,0,1,0
20706,37965,0,0,62,62,0,1,0,1,0
28134,37965,0,0,62,62,0,1,0,1,0
11951,45026,0,0,60,60,0,1,0,1,0
34932,38608,0,0,62,62,0,1,0,1,0
26531,37965,0,0,62,62,0,1,0,1,0
18308,64104,0,0,65,65,0,1,0,1,0
58842,64147,0,0,66,66,0,1,0,1,0
65328,44847,0,0,119,119,0,1,0,1,0
61924,50584,0,0,66,66,0,1,0,1,0
44491,50584,0,0,62,62,0,1,0,1,0
36751,26467,0,0,62,62,0,1,0,1,0
1250,25174,0,0,146,146,0,1,0,1,0
54151,25174,0,0,62,62,0,1,0,1,0
42010,35440,0,0,62,62,0,1,0,1,0
48887,49182,0,0,139,139,0,1,0,1,0
49305,57470,0,0,66,66,0,1,0,1,0
52459,5555,0,0,60,60,0,1,0,1,0
60141,30188,0,0,66,66,0,1,0,1,0
56397,62413,0,0,66,66,0,1,0,1,0
55456,8,0,0,63,63,0,1,0,1,0
443,23395,0,0,84,84,0,1,0,1,0
26553,57470,0,0,63,63,0,1,0,1,0
45269,50584,0,0,62,62,0,1,0,1,0
64379,37965,0,0,65,65,0,1,0,1,0
58638,5900,0,0,62,62,0,1,0,1,0
17640,55442,0,0,66,66,0,1,0,1,0
673,52779,0,0,109,109,0,1,0,1,0
14343,6881,0,0,75,75,0,1,0,1,0
62491,48817,0,0,128,128,0,1,0,1,0
20706,37965,0,0,62,62,0,1,0,1,0
57336,26467,0,0,65,65,0,1,0,1,0
443,48129,0,0,96,96,0,1,0,1,0
47344,50584,0,0,72,72,0,1,0,1,0
58638,5900,0,0,62,62,0,1,0,1,0
32609,64097,0,0,62,62,0,1,0,1,0
35910,23,0,0,60,60,0,1,0,1,0
3532,22114,0,0,62,62,0,1,0,1,0
50855,64147,0,0,64,64,0,1,0,1,0
28949,35440,0,0,66,66,0,1,0,1,0
59290,11396,0,0,62,62,0,1,0,1,0
52833,51221,0,0,66,66,0,1,0,1,0
1045,36237,0,0,62,62,0,1,0,1,0
9553,35440,0,0,64,64,0,1,0,1,0
10358,32480,0,0,66,66,0,1,0,1,0
16162,56205,0,0,62,62,0,1,0,1,0
37277,44286,0,0,62,62,0,1,0,1,0
32520,47993,0,0,66,66,0,1,0,1,0
56386,50584,0,0,62,62,0,1,0,1,0
58338,3366,0,0,60,60,0,1,0,1,0
49479,21247,0,0,63,63,0,1,0,1,0
52600,7253,0,0,66,66,0,1,0,1,0
59377,21247,0,0,66,66,0,1,0,1,0
33291,50584,0,0,62,62,0,1,0,1,0
60557,23117,0,0,66,66,0,1,0,1,0
43522,10785,0,0,145,145,0,1,0,1,0
64214,25174,0,0,64,64,0,1,0,1,0
58638,5900,0,0,62,62,0,1,0,1,0
43129,15503,0,0,62,62,0,1,0,1,0
53067,44847,0,0,74,74,0,1,0,1,0
58638,5900,0,0,62,62,0,1,0,1,0
52832,53596,0,0,66,66,0,1,0,1,0
51577,1679,0,0,101,101,0,1,0,1,0
51947,57470,0,0,64,64,0,1,0,1,0
47616,2314,0,0,118,118,0,1,0,1,0
50280,57470,0,0,78,78,0,1,0,1,0
12382,22114,0,0,62,62,0,1,0,1,0
59893,22114,0,0,62,62,0,1,0,1,0
29145,8168,0,0,62,62,0,1,0,1,0
49937,35491,0,0,75,75,0,1,0,1,0
44173,30188,0,0,131,131,0,1,0,1,0
443,60496,0,0,305,305,0,1,0,1,0
10095,22114,0,0,62,62,0,1,0,1,0
49611,50584,0,0,62,62,0,1,0,1,0
6882,45118,0,0,155,155,0,1,0,1,0
36496,63500,0,0,93,93,0,1,0,1,0
61066,38341,0,0,63,63,0,1,0,1,0
17147,22046,0,0,72,72,0,1,0,1,0
12074,10197,0,0,72,72,0,1,0,1,0
60923,50584,0,0,96,96,0,1,0,1,0
3409,17372,0,0,128,128,0,1,0,1,0
58460,30232,0,0,64,64,0,1,0,1,0
42889,22114,0,0,87,87,0,1,0,1,0
64365,22114,0,0,66,66,0,1,0,1,0
23459,57560,0,0,98,98,0,1,0,1,0
3181,22114,0,0,88,88,0,1,0,1,0
5223,44091,0,0,118,118,0,1,0,1,0
50923,44847,0,0,62,62,0,1,0,1,0
10391,25438,0,0,64,64,0,1,0,1,0
39676,22114,0,0,64,64,0,1,0,1,0
64652,37965,0,0,66,66,0,1,0,1,0
16387,44427,0,0,60,60,0,1,0,1,0
55429,25174,0,0,66,66,0,1,0,1,0
57738,52700,0,0,66,66,0,1,0,1,0
443,54507,0,0,82,82,0,1,0,1,0
61351,8195,0,0,61,61,0,1,0,1,0
6881,26296,0,0,150,150,0,1,0,1,0
1059,26427,0,0,84,84,0,1,0,1,0
24387,6905,0,0,62,62,0,1,0,1,0
58638,5900,0,0,62,62,0,1,0,1,0
62709,57470,0,0,62,62,0,1,0,1,0
54046,25174,0,0,65,65,0,1,0,1,0
6666,3389,0,0,60,60,0,1,0,1,0
59949,44847,0,0,63,63,0,1,0,1,0
60049,25174,0,0,66,66,0,1,0,1,0
11716,37965,0,0,62,62,0,1,0,1,0
27773,37965,0,0,65,65,0,1,0,1,0
49336,25174,0,0,64,64,0,1,0,1,0
54298,22114,0,0,62,62,0,1,0,1,0
6331,10562,0,0,116,116,0,1,0,1,0
51633,56205,0,0,66,66,0,1,0,1,0
24248,7825,0,0,131,131,0,1,0,1,0
51732,25174,0,0,63,63,0,1,0,1,0
60916,25174,0,0,62,62,0,1,0,1,0
52177,25320,0,0,66,66,0,1,0,1,0
58529,39004,0,0,66,66,0,1,0,1,0
59938,37917,0,0,89,89,0,1,0,1,0
7383,22114,0,0,62,62,0,1,0,1,0
64551,9585,0,0,62,62,0,1,0,1,0
443,54507,0,0,82,82,0,1,0,1,0
23810,53373,0,0,63,63,0,1,0,1,0
59803,6002,0,0,65,65,0,1,0,1,0
28311,25610,0,0,62,62,0,1,0,1,0
31069,56205,0,0,64,64,0,1,0,1,0
51172,44847,0,0,66,66,0,1,0,1,0
59590,56205,0,0,63,63,0,1,0,1,0
58638,5900,0,0,62,62,0,1,0,1,0
18726,35440,0,0,142,142,0,1,0,1,0
65270,3855,0,0,78,78,0,1,0,1,0
58638,5900,0,0,62,62,0,1,0,1,0
880,15243,0,0,61,61,0,1,0,1,0
54500,36237,0,0,66,66,0,1,0,1,0
49538,26467,0,0,62,62,0,1,0,1,0
3478,61463,0,0,1171,1171,0,1,0,1,0
41677,57470,0,0,63,63,0,1,0,1,0
50297,49035,0,0,95,95,0,1,0,1,0
43666,30188,0,0,64,64,0,1,0,1,0
29203,26467,0,0,62,62,0,1,0,1,0
24582,50725,0,0,87,87,0,1,0,1,0
50113,51505,0,0,64,64,0,1,0,1,0
5886,37965,0,0,66,66,0,1,0,1,0
42287,57470,0,0,62,62,0,1,0,1,0
53205,51221,0,0,66,66,0,1,0,1,0
55874,64147,0,0,66,66,0,1,0,1,0
50385,43890,0,0,65,65,0,1,0,1,0
10701,25174,0,0,62,62,0,1,0,1,0
59688,51505,0,0,64,64,0,1,0,1,0
39861,22114,0,0,62,62,0,1,0,1,0
51541,17455,0,0,64,64,0,1,0,1,0
1694,30188,0,0,62,62,0,1,0,1,0
44928,26467,0,0,62,62,0,1,0,1,0
58638,5900,0,0,62,62,0,1,0,1,0
51107,44847,0,0,62,62,0,1,0,1,0
61239,22114,0,0,66,66,0,1,0,1,0
1026,64147,0,0,62,62,0,1,0,1,0
56666,50584,0,0,64,64,0,1,0,1,0
28842,2352,0,0,65,65,0,1,0,1,0
23939,41615,0,0,146,146,0,1,0,1,0
54836,37965,0,0,62,62,0,1,0,1,0
33965,50316,0,0,87,87,0,1,0,1,0
59622,44847,0,0,66,66,0,1,0,1,0
3698,56104,0,0,127,127,0,1,0,1,0
55074,48834,0,0,75,75,0,1,0,1,0
1885,22114,0,0,62,62,0,1,0,1,0
58638,5900,0,0,62,62,0,1,0,1,0
51320,44847,0,0,65,65,0,1,0,1,0
53763,22114,0,0,63,63,0,1,0,1,0
12694,22114,0,0,66,66,0,1,0,1,0
31132,50584,0,0,62,62,0,1,0,1,0
25608,44566,0,0,71,71,0,1,0,1,0
61322,8306,0,0,108,108,0,1,0,1,0
51894,51505,0,0,86,86,0,1,0,1,0
56483,56205,0,0,132,132,0,1,0,1,0
1864,25174,0,0,141,141,0,1,0,1,0
49618,30188,0,0,66,66,0,1,0,1,0
27824,51505,0,0,93,93,0,1,0,1,0
53303,26467,0,0,65,65,0,1,0,1,0
24273,57470,0,0,62,62,0,1,0,1,0
52705,64147,0,0,65,65,0,1,0,1,0
24145,35440,0,0,62,62,0,1,0,1,0
58050,57866,0,0,66,66,0,1,0,1,0
52631,36237,0,0,62,62,0,1,0,1,0
5713,10554,0,0,90,90,0,1,0,1,0
27147,22114,0,0,94,94,0,1,0,1,0
1079,62588,0,0,139,139,0,1,0,1,0
51045,25174,0,0,62,62,0,1,0,1,0
58218,38213,0,0,66,66,0,1,0,1,0
50569,22114,0,0,62,62,0,1,0,1,0
815,36766,0,0,477,477,0,1,0,1,0
59653,51505,0,0,66,66,0,1,0,1,0
57448,57470,0,0,63,63,0,1,0,1,0
62637,56205,0,0,63,63,0,1,0,1,0
2947,64147,0,0,62,62,0,1,0,1,0
62038,11392,0,0,66,66,0,1,0,1,0
3877,63905,0,0,106,106,0,1,0,1,0
25777,30203,0,0,138,138,0,1,0,1,0
443,22300,0,0,74,74,0,1,0,1,0
806,59649,0,0,108,108,0,1,0,1,0
60129,30188,0,0,66,66,0,1,0,1,0
33142,50584,0,0,62,62,0,1,0,1,0
1029,44847,0,0,62,62,0,1,0,1,0
64346,51505,0,0,66,66,0,1,0,1,0
53129,56205,0,0,82,82,0,1,0,1,0
26529,25174,0,0,124,124,0,1,0,1,0
58638,5900,0,0,62,62,0,1,0,1,0
48815,50584,0,0,70,70,0,1,0,1,0
43348,26467,0,0,65,65,0,1,0,1,0
3478,61463,0,0,1094,1094,0,1,0,1,0
46269,5881,0,0,60,60,0,1,0,1,0
59799,30188,0,0,66,66,0,1,0,1,0
23459,57558,0,0,98,98,0,1,0,1,0
28034,22114,0,0,62,62,0,1,0,1,0
48360,54802,0,0,121,121,0,1,0,1,0
63779,26467,0,0,65,65,0,1,0,1,0
26316,22114,0,0,62,62,0,1,0,1,0
9687,57470,0,0,78,78,0,1,0,1,0
60855,35440,0,0,66,66,0,1,0,1,0
16406,21247,0,0,62,62,0,1,0,1,0
57698,64147,0,0,66,66,0,1,0,1,0
18743,64147,0,0,65,65,0,1,0,1,0
58638,5900,0,0,62,62,0,1,0,1,0
50283,49169,0,0,66,66,0,1,0,1,0
63836,25174,0,0,65,65,0,1,0,1,0
53165,25174,0,0,62,62,0,1,0,1,0
44339,30188,0,0,65,65,0,1,0,1,0
7360,22114,0,0,65,65,0,1,0,1,0
62022,35440,0,0,66,66,0,1,0,1,0
51732,64147,0,0,62,62,0,1,0,1,0
55893,45711,0,0,78,78,0,1,0,1,0
10692,25174,0,0,124,124,0,1,0,1,0
54821,37965,0,0,62,62,0,1,0,1,0
11045,17390,0,0,62,62,0,1,0,1,0
17004,64147,0,0,66,66,0,1,0,1,0
61401,50584,0,0,62,62,0,1,0,1,0
65286,44847,0,0,63,63,0,1,0,1,0
60173,17900,0,0,66,66,0,1,0,1,0
41298,51048,0,0,62,62,0,1,0,1,0
19844,23,0,0,60,60,0,1,0,1,0
22655,30188,0,0,62,62,0,1,0,1,0
65006,26467,0,0,66,66,0,1,0,1,0
63314,26374,0,0,116,116,0,1,0,1,0
62983,51505,0,0,62,62,0,1,0,1,0
38428,51505,0,0,131,131,0,1,0,1,0
57131,31061,0,0,145,145,0,1,0,1,0
2919,57831,0,0,66,66,0,1,0,1,0
53026,64147,0,0,63,63,0,1,0,1,0
24798,52544,0,0,65,65,0,1,0,1,0
58638,5900,0,0,62,62,0,1,0,1,0
42332,22114,0,0,66,66,0,1,0,1,0
25781,55783,0,0,63,63,0,1,0,1,0
30697,57866,0,0,62,62,0,1,0,1,0
21597,51505,0,0,112,112,0,1,0,1,0
56127,37965,0,0,66,66,0,1,0,1,0
61234,35315,0,0,66,66,0,1,0,1,0
56494,15503,0,0,146,146,0,1,0,1,0
25735,27806,0,0,61,61,0,1,0,1,0
50067,30194,0,0,62,62,0,1,0,1,0
0,0,0,0,98,98,0,1,0,1,0
58638,5900,0,0,62,62,0,1,0,1,0
34236,57470,0,0,69,69,0,1,0,1,0
58025,22114,0,0,66,66,0,1,0,1,0
18252,37879,0,0,62,62,0,1,0,1,0
31470,2,0,0,140,140,0,1,0,1,0
27077,51391,0,0,64,64,0,1,0,1,0
59051,27520,0,0,62,62,0,1,0,1,0
27414,56161,0,0,117,117,0,1,0,1,0
35261,15503,0,0,74,74,0,1,0,1,0
10033,31737,0,0,131,131,0,1,0,1,0
49786,25174,0,0,66,66,0,1,0,1,0
648,35404,0,0,155,155,0,1,0,1,0
57726,37965,0,0,62,62,0,1,0,1,0
59202,51217,0,0,66,66,0,1,0,1,0
59430,50584,0,0,66,66,0,1,0,1,0
31132,50584,0,0,62,62,0,1,0,1,0
1141,25174,0,0,62,62,0,1,0,1,0
63991,36829,0,0,66,66,0,1,0,1,0
61355,51505,0,0,62,62,0,1,0,1,0
36129,47807,0,0,136,136,0,1,0,1,0
1336,44847,0,0,62,62,0,1,0,1,0
6881,26296,0,0,148,148,0,1,0,1,0
8886,3134,0,0,60,60,0,1,0,1,0
61477,37884,0,0,66,66,0,1,0,1,0
44260,6881,0,0,91,91,0,1,0,1,0
58338,3374,0,0,60,60,0,1,0,1,0
24351,57470,0,0,62,62,0,1,0,1,0
58638,5900,0,0,62,62,0,1,0,1,0
61432,37960,0,0,66,66,0,1,0,1,0
22356,22114,0,0,64,64,0,1,0,1,0
62073,16,0,0,85,85,0,1,0,1,0
60424,26467,0,0,63,63,0,1,0,1,0
13831,64147,0,0,135,135,0,1,0,1,0
52720,35894,0,0,62,62,0,1,0,1,0
50763,26467,0,0,66,66,0,1,0,1,0
27188,22114,0,0,137,137,0,1,0,1,0
9135,7007,0,0,64,64,0,1,0,1,0
4359,21536,0,0,135,135,0,1,0,1,0
26083,56087,0,0,62,62,0,1,0,1,0
37430,29952,0,0,128,128,0,1,0,1,0
62644,51178,0,0,85,85,0,1,0,1,0
56353,5878,0,0,60,60,0,1,0,1,0
27864,52700,0,0,69,69,0,1,0,1,0
1123,25174,0,0,62,62,0,1,0,1,0
54346,44847,0,0,64,64,0,1,0,1,0
53622,62413,0,0,94,94,0,1,0,1,0
22431,25174,0,0,68,68,0,1,0,1,0
25085,30188,0,0,65,65,0,1,0,1,0
51754,18375,0,0,63,63,0,1,0,1,0
17880,23,0,0,60,60,0,1,0,1,0
53779,51505,0,0,66,66,0,1,0,1,0
23195,50584,0,0,62,62,0,1,0,1,0
26742,64147,0,0,62,62,0,1,0,1,0
26792,37965,0,0,62,62,0,1,0,1,0
25873,41488,0,0,89,89,0,1,0,1,0
57819,30188,0,0,62,62,0,1,0,1,0
58638,5900,0,0,62,62,0,1,0,1,0
11716,37965,0,0,62,62,0,1,0,1,0
58828,44847,0,0,124,124,0,1,0,1,0
49304,1231,0,0,126,126,0,1,0,1,0
16486,25174,0,0,62,62,0,1,0,1,0
56146,55442,0,0,66,66,0,1,0,1,0
29986,61890,0,0,81,81,0,1,0,1,0
7301,44847,0,0,66,66,0,1,0,1,0
60294,23509,0,0,66,66,0,1,0,1,0
64051,36829,0,0,64,64,0,1,0,1,0
56328,36237,0,0,62,62,0,1,0,1,0
63607,30188,0,0,63,63,0,1,0,1,0
6714,2220,0,0,60,60,0,1,0,1,0
17236,22114,0,0,63,63,0,1,0,1,0
41062,5900,0,0,60,60,0,1,0,1,0
52810,25174,0,0,66,66,0,1,0,1,0
22536,48817,0,0,115,115,0,1,0,1,0
58292,3309,0,0,60,60,0,1,0,1,0
50370,62413,0,0,106,106,0,1,0,1,0
1035,44847,0,0,146,146,0,1,0,1,0
50644,35440,0,0,66,66,0,1,0,1,0
33641,23,0,0,60,60,0,1,0,1,0
37075,48817,0,0,62,62,0,1,0,1,0
58638,5900,0,0,62,62,0,1,0,1,0
38629,25174,0,0,64,64,0,1,0,1,0
53061,56205,0,0,65,65,0,1,0,1,0
59904,42710,0,0,143,143,0,1,0,1,0
12110,22114,0,0,62,62,0,1,0,1,0
15173,59560,0,0,62,62,0,1,0,1,0
48417,44847,0,0,126,126,0,1,0,1,0
49644,22114,0,0,63,63,0,1,0,1,0
1024,57470,0,0,62,62,0,1,0,1,0
58978,32,0,0,60,60,0,1,0,1,0
45845,25174,0,0,62,62,0,1,0,1,0
59430,50584,0,0,66,66,0,1,0,1,0
26906,22114,0,0,66,66,0,1,0,1,0
64380,37965,0,0,65,65,0,1,0,1,0
61936,11392,0,0,66,66,0,1,0,1,0
46534,4562,0,0,60,60,0,1,0,1,0
60099,25186,0,0,108,108,0,1,0,1,0
31962,55463,0,0,98,98,0,1,0,1,0
60646,5900,0,0,60,60,0,1,0,1,0
49415,22114,0,0,66,66,0,1,0,1,0
56278,52752,0,0,62,62,0,1,0,1,0
53355,23117,0,0,66,66,0,1,0,1,0
61838,37965,0,0,63,63,0,1,0,1,0
32563,51236,0,0,65,65,0,1,0,1,0
15394,51505,0,0,66,66,0,1,0,1,0
1196,35444,0,0,62,62,0,1,0,1,0
55837,62413,0,0,65,65,0,1,0,1,0
57545,35440,0,0,66,66,0,1,0,1,0
4876,37965,0,0,66,66,0,1,0,1,0
49159,40846,0,0,159,159,0,1,0,1,0
43063,57470,0,0,62,62,0,1,0,1,0
56250,36237,0,0,66,66,0,1,0,1,0
52211,22114,0,0,62,62,0,1,0,1,0
30847,65304,0,0,101,101,0,1,0,1,0
30619,25174,0,0,63,63,0,1,0,1,0
43705,461,0,0,60,60,0,1,0,1,0
30654,51221,0,0,72,72,0,1,0,1,0
58638,5900,0,0,62,62,0,1,0,1,0
45964,2228,0,0,60,60,0,1,0,1,0
22683,39210,0,0,60,60,0,1,0,1,0
59067,35440,0,0,62,62,0,1,0,1,0
43129,15503,0,0,62,62,0,1,0,1,0
58475,11392,0,0,66,66,0,1,0,1,0
51974,57470,0,0,66,66,0,1,0,1,0
16911,11167,0,0,133,133,0,1,0,1,0
13964,50584,0,0,78,78,0,1,0,1,0
58001,57866,0,0,66,66,0,1,0,1,0
19747,37965,0,0,62,62,0,1,0,1,0
26030,55872,0,0,62,62,0,1,0,1,0
1283,3389,0,0,64,64,0,1,0,1,0
58686,35933,0,0,65,65,0,1,0,1,0
59081,57470,0,0,66,66,0,1,0,1,0
52812,25174,0,0,66,66,0,1,0,1,0
6769,64147,0,0,123,123,0,1,0,1,0
37268,64147,0,0,64,64,0,1,0,1,0
53650,64147,0,0,66,66,0,1,0,1,0
53967,30087,0,0,66,66,0,1,0,1,0
32917,25174,0,0,62,62,0,1,0,1,0
58486,57470,0,0,66,66,0,1,0,1,0
14844,50584,0,0,64,64,0,1,0,1,0
12680,12157,0,0,63,63,0,1,0,1,0
61550,5529,0,0,145,145,0,1,0,1,0
1024,64147,0,0,62,62,0,1,0,1,0
20956,57470,0,0,62,62,0,1,0,1,0
51029,22114,0,0,97,97,0,1,0,1,0
51564,50584,0,0,66,66,0,1,0,1,0
443,61686,0,0,1484,1484,0,1,0,1,0
28994,30188,0,0,65,65,0,1,0,1,0
9650,23,0,0,60,60,0,1,0,1,0
54807,50540,0,0,66,66,0,1,0,1,0
56484,15503,0,0,146,146,0,1,0,1,0
43586,35440,0,0,62,62,0,1,0,1,0
52522,37965,0,0,63,63,0,1,0,1,0
8560,50584,0,0,62,62,0,1,0,1,0
3478,61463,0,0,931,931,0,1,0,1,0
64843,44218,0,0,66,66,0,1,0,1,0
52837,35440,0,0,66,66,0,1,0,1,0
3778,64094,0,0,145,145,0,1,0,1,0
28644,35440,0,0,66,66,0,1,0,1,0
55459,50584,0,0,66,66,0,1,0,1,0
55055,64127,0,0,66,66,0,1,0,1,0
39066,48716,0,0,98,98,0,1,0,1,0
62743,51505,0,0,62,62,0,1,0,1,0
36910,5900,0,0,60,60,0,1,0,1,0
62997,51505,0,0,62,62,0,1,0,1,0
51984,57470,0,0,66,66,0,1,0,1,0
26481,30188,0,0,62,62,0,1,0,1,0
2062,35440,0,0,66,66,0,1,0,1,0
51391,50584,0,0,66,66,0,1,0,1,0
58638,5900,0,0,62,62,0,1,0,1,0
47802,50787,0,0,62,62,0,1,0,1,0
39719,22114,0,0,64,64,0,1,0,1,0
51388,6944,0,0,65,65,0,1,0,1,0
60140,30188,0,0,65,65,0,1,0,1,0
63991,36829,0,0,66,66,0,1,0,1,0
56955,44847,0,0,62,62,0,1,0,1,0
59535,25174,0,0,87,87,0,1,0,1,0
58338,50584,0,0,62,62,0,1,0,1,0
45964,3111,0,0,60,60,0,1,0,1,0
22636,30188,0,0,66,66,0,1,0,1,0
42252,33303,0,0,60,60,0,1,0,1,0
58399,56205,0,0,64,64,0,1,0,1,0
30868,30781,0,0,136,136,0,1,0,1,0
30162,23,0,0,60,60,0,1,0,1,0
35482,25174,0,0,64,64,0,1,0,1,0
60234,37965,0,0,66,66,0,1,0,1,0
53776,28530,0,0,63,63,0,1,0,1,0
13441,57470,0,0,62,62,0,1,0,1,0
32215,22114,0,0,63,63,0,1,0,1,0
35233,25174,0,0,62,62,0,1,0,1,0
50994,35974,0,0,60,60,0,1,0,1,0
49437,38678,0,0,86,86,0,1,0,1,0
64047,23718,0,0,63,63,0,1,0,1,0
63741,25174,0,0,62,62,0,1,0,1,0
14194,50584,0,0,66,66,0,1,0,1,0
45908,48430,0,0,106,106,0,1,0,1,0
23766,35360,0,0,63,63,0,1,0,1,0
27367,36002,0,0,122,122,0,1,0,1,0
33608,23,0,0,60,60,0,1,0,1,0
19173,2515,0,0,62,62,0,1,0,1,0
7129,23,0,0,60,60,0,1,0,1,0
29060,51505,0,0,110,110,0,1,0,1,0
12899,25174,0,0,62,62,0,1,0,1,0
4857,37965,0,0,66,66,0,1,0,1,0
55288,45,0,0,61,61,0,1,0,1,0
4001,25174,0,0,62,62,0,1,0,1,0
14239,30030,0,0,145,145,0,1,0,1,0
56580,25174,0,0,62,62,0,1,0,1,0
58455,15503,0,0,146,146,0,1,0,1,0
53037,64140,0,0,66,66,0,1,0,1,0
58638,5900,0,0,62,62,0,1,0,1,0
23069,35440,0,0,63,63,0,1,0,1,0
1900,51505,0,0,66,66,0,1,0,1,0
10799,28924,0,0,66,66,0,1,0,1,0
56540,64147,0,0,62,62,0,1,0,1,0
1733,65448,0,0,64,64,0,1,0,1,0
51118,57470,0,0,66,66,0,1,0,1,0
51560,46783,0,0,65,65,0,1,0,1,0
45908,33330,0,0,60,60,0,1,0,1,0
57987,56125,0,0,90,90,0,1,0,1,0
63678,64117,0,0,66,66,0,1,0,1,0
36124,47807,0,0,134,134,0,1,0,1,0
22574,44847,0,0,62,62,0,1,0,1,0
50443,62413,0,0,66,66,0,1,0,1,0
48676,53392,0,0,60,60,0,1,0,1,0
56641,46824,0,0,65,65,0,1,0,1,0
61583,64147,0,0,66,66,0,1,0,1,0
54160,5973,0,0,72,72,0,1,0,1,0
49731,30188,0,0,66,66,0,1,0,1,0
34318,21576,0,0,62,62,0,1,0,1,0
45971,35440,0,0,63,63,0,1,0,1,0
50562,37965,0,0,66,66,0,1,0,1,0
55170,11392,0,0,66,66,0,1,0,1,0
44215,23963,0,0,87,87,0,1,0,1,0
53419,28189,0,0,60,60,0,1,0,1,0
21759,51505,0,0,66,66,0,1,0,1,0
50138,51505,0,0,62,62,0,1,0,1,0
59048,57470,0,0,66,66,0,1,0,1,0
47187,37851,0,0,62,62,0,1,0,1,0
54302,22167,0,0,62,62,0,1,0,1,0
55303,44847,0,0,65,65,0,1,0,1,0
7444,57470,0,0,66,66,0,1,0,1,0
3467,45342,0,0,105,105,0,1,0,1,0
80,53945,0,0,60,60,0,1,0,1,0
59283,57519,0,0,70,70,0,1,0,1,0
15382,63653,0,0,66,66,0,1,0,1,0
25654,27191,0,0,61,61,0,1,0,1,0
3126,7235,0,0,66,66,0,1,0,1,0
59845,44847,0,0,66,66,0,1,0,1,0
1029,57470,0,0,66,66,0,1,0,1,0
11569,51505,0,0,70,70,0,1,0,1,0
9272,51505,0,0,130,130,0,1,0,1,0
58638,5900,0,0,62,62,0,1,0,1,0
21179,44847,0,0,79,79,0,1,0,1,0
58480,37965,0,0,63,63,0,1,0,1,0
58638,5900,0,0,62,62,0,1,0,1,0
3352,50584,0,0,65,65,0,1,0,1,0
64342,37965,0,0,69,69,0,1,0,1,0
51130,61689,0,0,64,64,0,1,0,1,0
53143,50584,0,0,66,66,0,1,0,1,0
58638,5900,0,0,62,62,0,1,0,1,0
23222,64147,0,0,63,63,0,1,0,1,0
50368,37962,0,0,66,66,0,1,0,1,0
57445,34183,0,0,93,93,0,1,0,1,0
443,48346,0,0,81,81,0,1,0,1,0
50378,50584,0,0,62,62,0,1,0,1,0
30179,57470,0,0,60,60,0,1,0,1,0
30280,37965,0,0,66,66,0,1,0,1,0
14449,25174,0,0,67,67,0,1,0,1,0
443,47582,0,0,96,96,0,1,0,1,0
63765,51221,0,0,62,62,0,1,0,1,0
51413,8,0,0,67,67,0,1,0,1,0
2083,25174,0,0,62,62,0,1,0,1,0
50152,57470,0,0,138,138,0,1,0,1,0
59365,42873,0,0,74,74,0,1,0,1,0
26676,25174,0,0,63,63,0,1,0,1,0
56442,11392,0,0,65,65,0,1,0,1,0
65494,53,0,0,88,88,0,1,0,1,0
14828,10694,0,0,155,155,0,1,0,1,0
51559,17372,0,0,65,65,0,1,0,1,0
9627,35440,0,0,66,66,0,1,0,1,0
48125,7548,0,0,60,60,0,1,0,1,0
57538,30188,0,0,66,66,0,1,0,1,0
7877,25174,0,0,98,98,0,1,0,1,0
54738,50584,0,0,66,66,0,1,0,1,0
57136,51505,0,0,63,63,0,1,0,1,0
45679,7,0,0,61,61,0,1,0,1,0
58213,37807,0,0,66,66,0,1,0,1,0
63314,57470,0,0,66,66,0,1,0,1,0
50593,64147,0,0,64,64,0,1,0,1,0
26722,11446,0,0,66,66,0,1,0,1,0
52519,44847,0,0,65,65,0,1,0,1,0
2598,23718,0,0,63,63,0,1,0,1,0
5747,37965,0,0,65,65,0,1,0,1,0
50315,37965,0,0,66,66,0,1,0,1,0
47910,7461,0,0,60,60,0,1,0,1,0
58638,5900,0,0,62,62,0,1,0,1,0
7186,64147,0,0,66,66,0,1,0,1,0
56272,5900,0,0,60,60,0,1,0,1,0
23601,57422,0,0,123,123,0,1,0,1,0
59988,64147,0,0,66,66,0,1,0,1,0
62707,57470,0,0,62,62,0,1,0,1,0
26501,64147,0,0,62,62,0,1,0,1,0
4257,35440,0,0,62,62,0,1,0,1,0
30945,57598,0,0,70,70,0,1,0,1,0
58638,5900,0,0,62,62,0,1,0,1,0
3478,61463,0,0,1162,1162,0,1,0,1,0
52975,23718,0,0,66,66,0,1,0,1,0
51186,44847,0,0,62,62,0,1,0,1,0
16597,41599,0,0,113,113,0,1,0,1,0
60300,30188,0,0,66,66,0,1,0,1,0
45941,23388,0,0,60,60,0,1,0,1,0
35232,36602,0,0,74,74,0,1,0,1,0
45964,3111,0,0,60,60,0,1,0,1,0
58638,5900,0,0,62,62,0,1,0,1,0
13708,29953,0,0,145,145,0,1,0,1,0
45908,3383,0,0,60,60,0,1,0,1,0
58638,5900,0,0,62,62,0,1,0,1,0
57183,26396,0,0,98,98,0,1,0,1,0
57556,59075,0,0,66,66,0,1,0,1,0
27505,25174,0,0,62,62,0,1,0,1,0
58812,64139,0,0,65,65,0,1,0,1,0
26531,37965,0,0,62,62,0,1,0,1,0
3478,61463,0,0,168,168,0,1,0,1,0
57987,56125,0,0,90,90,0,1,0,1,0
6970,2134,0,0,120,120,0,1,0,1,0
80,9918,0,0,60,60,0,1,0,1,0
60192,35440,0,0,111,111,0,1,0,1,0
26404,35358,0,0,64,64,0,1,0,1,0
17781,44847,0,0,137,137,0,1,0,1,0
5012,44847,0,0,64,64,0,1,0,1,0
40110,23,0,0,60,60,0,1,0,1,0
52519,44847,0,0,66,66,0,1,0,1,0
58648,64125,0,0,62,62,0,1,0,1,0
9448,57866,0,0,62,62,0,1,0,1,0
22924,25174,0,0,62,62,0,1,0,1,0
64823,37965,0,0,62,62,0,1,0,1,0
34923,31795,0,0,62,62,0,1,0,1,0
6666,424,0,0,60,60,0,1,0,1,0
56409,1646,0,0,107,107,0,1,0,1,0
27847,52700,0,0,73,73,0,1,0,1,0
3155,64147,0,0,64,64,0,1,0,1,0
58896,39004,0,0,70,70,0,1,0,1,0
59207,25174,0,0,66,66,0,1,0,1,0
60771,58414,0,0,66,66,0,1,0,1,0
55507,57470,0,0,68,68,0,1,0,1,0
1027,11392,0,0,62,62,0,1,0,1,0
61430,64781,0,0,66,66,0,1,0,1,0
56265,44847,0,0,65,65,0,1,0,1,0
56148,43890,0,0,66,66,0,1,0,1,0
59086,49836,0,0,74,74,0,1,0,1,0
16273,19986,0,0,60,60,0,1,0,1,0
1024,44847,0,0,62,62,0,1,0,1,0
9554,35440,0,0,66,66,0,1,0,1,0
50280,57470,0,0,78,78,0,1,0,1,0
58638,5900,0,0,62,62,0,1,0,1,0
42458,22114,0,0,62,62,0,1,0,1,0
36663,22114,0,0,62,62,0,1,0,1,0
51305,64147,0,0,63,63,0,1,0,1,0
55600,22,0,0,60,60,0,1,0,1,0
45860,9,0,0,61,61,0,1,0,1,0
51960,57470,0,0,66,66,0,1,0,1,0
64336,57470,0,0,70,70,0,1,0,1,0
913,8128,0,0,131,131,0,1,0,1,0
65518,5710,0,0,62,62,0,1,0,1,0
80,37649,0,0,60,60,0,1,0,1,0
1326,51331,0,0,145,145,0,1,0,1,0
34623,25174,0,0,63,63,0,1,0,1,0
59912,22114,0,0,63,63,0,1,0,1,0
22724,9822,0,0,63,63,0,1,0,1,0
46556,57858,0,0,65,65,0,1,0,1,0
64516,5960,0,0,65,65,0,1,0,1,0
52144,49344,0,0,62,62,0,1,0,1,0
32567,22114,0,0,91,91,0,1,0,1,0
64551,50331,0,0,65,65,0,1,0,1,0
56691,50584,0,0,62,62,0,1,0,1,0
52934,56205,0,0,66,66,0,1,0,1,0
35429,44486,0,0,114,114,0,1,0,1,0
2107,62413,0,0,66,66,0,1,0,1,0
13394,57866,0,0,62,62,0,1,0,1,0
58638,5900,0,0,62,62,0,1,0,1,0
59447,37807,0,0,66,66,0,1,0,1,0
9614,26467,0,0,62,62,0,1,0,1,0
27091,25174,0,0,63,63,0,1,0,1,0
59739,35253,0,0,62,62,0,1,0,1,0
58638,5900,0,0,62,62,0,1,0,1,0
9750,26467,0,0,64,64,0,1,0,1,0
52766,51221,0,0,67,67,0,1,0,1,0
52389,55707,0,0,66,66,0,1,0,1,0
37341,21307,0,0,140,140,0,1,0,1,0
50091,30188,0,0,62,62,0,1,0,1,0
65294,7175,0,0,84,84,0,1,0,1,0
51903,26467,0,0,62,62,0,1,0,1,0
39145,64147,0,0,96,96,0,1,0,1,0
26727,7591,0,0,66,66,0,1,0,1,0
28219,37965,0,0,62,62,0,1,0,1,0
63770,25174,0,0,64,64,0,1,0,1,0
53175,35329,0,0,66,66,0,1,0,1,0
19731,64147,0,0,62,62,0,1,0,1,0
21891,15507,0,0,62,62,0,1,0,1,0
2182,25174,0,0,77,77,0,1,0,1,0
58638,5900,0,0,62,62,0,1,0,1,0
17838,50584,0,0,63,63,0,1,0,1,0
58295,50584,0,0,62,62,0,1,0,1,0
10125,44847,0,0,63,63,0,1,0,1,0
44854,26467,0,0,62,62,0,1,0,1,0
27049,51505,0,0,66,66,0,1,0,1,0
51446,13,0,0,76,76,0,1,0,1,0
53419,28189,0,0,60,60,0,1,0,1,0
3478,61463,0,0,252,252,0,1,0,1,0
63114,25174,0,0,63,63,0,1,0,1,0
30782,36237,0,0,62,62,0,1,0,1,0
57987,56125,0,0,90,90,0,1,0,1,0
30574,64147,0,0,62,62,0,1,0,1,0
51391,22114,0,0,64,64,0,1,0,1,0
58638,5900,0,0,62,62,0,1,0,1,0
4116,35440,0,0,62,62,0,1,0,1,0
56147,37965,0,0,66,66,0,1,0,1,0
37011,25174,0,0,128,128,0,1,0,1,0
58627,64097,0,0,65,65,0,1,0,1,0
58639,18375,0,0,66,66,0,1,0,1,0
58713,26467,0,0,65,65,0,1,0,1,0
58638,5900,0,0,62,62,0,1,0,1,0
64365,37965,0,0,67,67,0,1,0,1,0
16387,64075,0,0,60,60,0,1,0,1,0
443,39326,0,0,94,94,0,1,0,1,0
31801,37965,0,0,62,62,0,1,0,1,0
62349,61720,0,0,66,66,0,1,0,1,0
58638,5900,0,0,62,62,0,1,0,1,0
28067,64147,0,0,65,65,0,1,0,1,0
1823,64147,0,0,66,66,0,1,0,1,0
26855,50584,0,0,66,66,0,1,0,1,0
25580,2247,0,0,60,60,0,1,0,1,0
13571,57470,0,0,61,61,0,1,0,1,0
13285,29892,0,0,145,145,0,1,0,1,0
55422,37965,0,0,66,66,0,1,0,1,0
52273,64125,0,0,62,62,0,1,0,1,0
56140,52736,0,0,63,63,0,1,0,1,0
14324,56205,0,0,92,92,0,1,0,1,0
63478,50003,0,0,80,80,0,1,0,1,0
36180,22,0,0,60,60,0,1,0,1,0
55711,26467,0,0,66,66,0,1,0,1,0
34351,25174,0,0,126,126,0,1,0,1,0
5223,14446,0,0,220,220,0,1,0,1,0
19341,25174,0,0,146,146,0,1,0,1,0
4545,1900,0,0,136,136,0,1,0,1,0
55673,64107,0,0,66,66,0,1,0,1,0
44465,25174,0,0,62,62,0,1,0,1,0
8967,52320,0,0,60,60,0,1,0,1,0
443,62451,0,0,199,199,0,1,0,1,0
45682,25604,0,0,62,62,0,1,0,1,0
7094,30170,0,0,143,143,0,1,0,1,0
29758,23,0,0,60,60,0,1,0,1,0
36499,25174,0,0,62,62,0,1,0,1,0
52147,64147,0,0,62,62,0,1,0,1,0
22699,51299,0,0,62,62,0,1,0,1,0
32542,30188,0,0,62,62,0,1,0,1,0
51344,25174,0,0,62,62,0,1,0,1,0
7877,22114,0,0,66,66,0,1,0,1,0
62386,37965,0,0,66,66,0,1,0,1,0
1183,64147,0,0,64,64,0,1,0,1,0
52366,55528,0,0,62,62,0,1,0,1,0
51685,1566,0,0,82,82,0,1,0,1,0
48706,23393,0,0,60,60,0,1,0,1,0
39313,37965,0,0,62,62,0,1,0,1,0
59728,64147,0,0,66,66,0,1,0,1,0
11636,56205,0,0,64,64,0,1,0,1,0
49001,40108,0,0,161,161,0,1,0,1,0
53523,44847,0,0,66,66,0,1,0,1,0
36228,22,0,0,60,60,0,1,0,1,0
52415,1433,0,0,60,60,0,1,0,1,0
27162,64147,0,0,66,66,0,1,0,1,0
9687,57470,0,0,78,78,0,1,0,1,0
58729,35910,0,0,66,66,0,1,0,1,0
62144,8463,0,0,89,89,0,1,0,1,0
47173,35440,0,0,81,81,0,1,0,1,0
59562,25174,0,0,63,63,0,1,0,1,0
51096,63710,0,0,62,62,0,1,0,1,0
58638,5900,0,0,62,62,0,1,0,1,0
51551,46763,0,0,69,69,0,1,0,1,0
46890,44847,0,0,64,64,0,1,0,1,0
53300,37807,0,0,62,62,0,1,0,1,0
42268,48660,0,0,70,70,0,1,0,1,0
33326,51454,0,0,66,66,0,1,0,1,0
57585,51221,0,0,62,62,0,1,0,1,0
50949,45960,0,0,62,62,0,1,0,1,0
59332,22114,0,0,62,62,0,1,0,1,0
54693,321,0,0,67,67,0,1,0,1,0
35652,22114,0,0,63,63,0,1,0,1,0
56836,11405,0,0,65,65,0,1,0,1,0
443,48156,0,0,116,116,0,1,0,1,0
45099,57470,0,0,62,62,0,1,0,1,0
50326,22114,0,0,62,62,0,1,0,1,0
65326,10927,0,0,66,66,0,1,0,1,0
41052,1494,0,0,70,70,0,1,0,1,0
58638,5900,0,0,62,62,0,1,0,1,0
20576,37965,0,0,62,62,0,1,0,1,0
41663,48757,0,0,145,145,0,1,0,1,0
6887,8461,0,0,143,143,0,1,0,1,0
16387,16862,0,0,60,60,0,1,0,1,0
9120,37965,0,0,62,62,0,1,0,1,0
45013,50584,0,0,144,144,0,1,0,1,0
42866,55845,0,0,135,135,0,1,0,1,0
19166,4008,0,0,136,136,0,1,0,1,0
28900,35440,0,0,66,66,0,1,0,1,0
10088,37807,0,0,66,66,0,1,0,1,0
58638,5900,0,0,62,62,0,1,0,1,0
52479,3398,0,0,60,60,0,1,0,1,0
54543,25567,0,0,66,66,0,1,0,1,0
22924,25174,0,0,62,62,0,1,0,1,0
45985,25174,0,0,62,62,0,1,0,1,0
15633,50301,0,0,62,62,0,1,0,1,0
8045,29609,0,0,113,113,0,1,0,1,0
58338,3372,0,0,60,60,0,1,0,1,0
48948,25174,0,0,62,62,0,1,0,1,0
25515,23,0,0,60,60,0,1,0,1,0
13526,51363,0,0,62,62,0,1,0,1,0
16693,36237,0,0,66,66,0,1,0,1,0
58638,5900,0,0,62,62,0,1,0,1,0
58638,5900,0,0,62,62,0,1,0,1,0
52748,37965,0,0,63,63,0,1,0,1,0
25475,27854,0,0,60,60,0,1,0,1,0
17279,25174,0,0,146,146,0,1,0,1,0
12132,22114,0,0,101,101,0,1,0,1,0
52156,53733,0,0,65,65,0,1,0,1,0
443,62771,0,0,64,64,0,1,0,1,0
58501,44847,0,0,63,63,0,1,0,1,0
28165,23,0,0,60,60,0,1,0,1,0
34932,38608,0,0,62,62,0,1,0,1,0
58972,37965,0,0,66,66,0,1,0,1,0
22656,30188,0,0,64,64,0,1,0,1,0
51093,57470,0,0,66,66,0,1,0,1,0
63558,46812,0,0,68,68,0,1,0,1,0
61945,48817,0,0,66,66,0,1,0,1,0
9276,7088,0,0,62,62,0,1,0,1,0
58638,5900,0,0,62,62,0,1,0,1,0
26923,57470,0,0,62,62,0,1,0,1,0
62015,54092,0,0,61,61,0,1,0,1,0
58907,25174,0,0,65,65,0,1,0,1,0
56451,30310,0,0,66,66,0,1,0,1,0
14025,43370,0,0,64,64,0,1,0,1,0
40440,23117,0,0,67,67,0,1,0,1,0
3117,37965,0,0,62,62,0,1,0,1,0
64755,31573,0,0,64,64,0,1,0,1,0
61744,11392,0,0,66,66,0,1,0,1,0
36058,23,0,0,60,60,0,1,0,1,0
31830,55839,0,0,62,62,0,1,0,1,0
53097,25174,0,0,66,66,0,1,0,1,0
59474,50584,0,0,62,62,0,1,0,1,0
49897,26467,0,0,63,63,0,1,0,1,0
58638,5900,0,0,62,62,0,1,0,1,0
6666,420,0,0,60,60,0,1,0,1,0
29710,37890,0,0,62,62,0,1,0,1,0
29469,37807,0,0,66,66,0,1,0,1,0
50147,5900,0,0,60,60,0,1,0,1,0
49514,39127,0,0,162,162,0,1,0,1,0
54688,25174,0,0,64,64,0,1,0,1,0
58481,37965,0,0,62,62,0,1,0,1,0
47806,31433,0,0,145,145,0,1,0,1,0
62214,37845,0,0,66,66,0,1,0,1,0
3478,61463,0,0,1302,1302,0,1,0,1,0
31536,25174,0,0,146,146,0,1,0,1,0
56949,21247,0,0,68,68,0,1,0,1,0
14850,50584,0,0,63,63,0,1,0,1,0
65196,50584,0,0,62,62,0,1,0,1,0
22922,35440,0,0,65,65,0,1,0,1,0
53179,35440,0,0,66,66,0,1,0,1,0
63095,22114,0,0,62,62,0,1,0,1,0
38367,51221,0,0,65,65,0,1,0,1,0
22683,39210,0,0,60,60,0,1,0,1,0
60636,35440,0,0,62,62,0,1,0,1,0
53461,37807,0,0,141,141,0,1,0,1,0
45682,37965,0,0,62,62,0,1,0,1,0
64585,57470,0,0,66,66,0,1,0,1,0
23806,44847,0,0,66,66,0,1,0,1,0
50106,31566,0,0,62,62,0,1,0,1,0
59049,25174,0,0,64,64,0,1,0,1,0
53022,64147,0,0,62,62,0,1,0,1,0
63610,30188,0,0,62,62,0,1,0,1,0
3407,17372,0,0,62,62,0,1,0,1,0
38918,37965,0,0,62,62,0,1,0,1,0
40779,64147,0,0,62,62,0,1,0,1,0
17261,25174,0,0,146,146,0,1,0,1,0
42285,57470,0,0,62,62,0,1,0,1,0
26814,57659,0,0,69,69,0,1,0,1,0
10465,45548,0,0,64,64,0,1,0,1,0
35615,22114,0,0,62,62,0,1,0,1,0
45974,23405,0,0,60,60,0,1,0,1,0
58638,5900,0,0,62,62,0,1,0,1,0
26450,64147,0,0,63,63,0,1,0,1,0
27081,10197,0,0,62,62,0,1,0,1,0
13413,44847,0,0,62,62,0,1,0,1,0
0,0,0,0,98,98,0,1,0,1,0
3456,11392,0,0,66,66,0,1,0,1,0
50225,35395,0,0,66,66,0,1,0,1,0
20509,57470,0,0,62,62,0,1,0,1,0
62731,57470,0,0,69,69,0,1,0,1,0
25314,57470,0,0,62,62,0,1,0,1,0
49553,44847,0,0,64,64,0,1,0,1,0
41285,50927,0,0,63,63,0,1,0,1,0
58638,5900,0,0,62,62,0,1,0,1,0
53721,44470,0,0,66,66,0,1,0,1,0
28378,56205,0,0,115,115,0,1,0,1,0
63495,50584,0,0,66,66,0,1,0,1,0
50232,57470,0,0,67,67,0,1,0,1,0
61428,50584,0,0,62,62,0,1,0,1,0
3478,61463,0,0,1062,1062,0,1,0,1,0
58638,5900,0,0,62,62,0,1,0,1,0
28845,37965,0,0,62,62,0,1,0,1,0
63658,22114,0,0,76,76,0,1,0,1,0
55061,64124,0,0,66,66,0,1,0,1,0
51955,17370,0,0,62,62,0,1,0,1,0
51036,22114,0,0,79,79,0,1,0,1,0
65004,57492,0,0,77,77,0,1,0,1,0
40107,22,0,0,60,60,0,1,0,1,0
55144,30188,0,0,66,66,0,1,0,1,0
5955,55160,0,0,74,74,0,1,0,1,0
18116,37807,0,0,62,62,0,1,0,1,0
26002,25174,0,0,64,64,0,1,0,1,0
43584,24748,0,0,156,156,0,1,0,1,0
57535,44847,0,0,62,62,0,1,0,1,0
59159,57866,0,0,66,66,0,1,0,1,0
1027,44847,0,0,62,62,0,1,0,1,0
34212,11392,0,0,65,65,0,1,0,1,0
57817,50584,0,0,65,65,0,1,0,1,0
48840,50584,0,0,141,141,0,1,0,1,0
13090,36237,0,0,62,62,0,1,0,1,0
53437,44847,0,0,62,62,0,1,0,1,0
63094,2268,0,0,63,63,0,1,0,1,0
59855,53582,0,0,66,66,0,1,0,1,0
58638,5900,0,0,62,62,0,1,0,1,0
62386,42873,0,0,66,66,0,1,0,1,0
52446,25174,0,0,66,66,0,1,0,1,0
62628,12077,0,0,78,78,0,1,0,1,0
33651,36237,0,0,62,62,0,1,0,1,0
63677,15503,0,0,66,66,0,1,0,1,0
48787,11294,0,0,91,91,0,1,0,1,0
61778,11392,0,0,66,66,0,1,0,1,0
22975,15503,0,0,62,62,0,1,0,1,0
47943,50584,0,0,74,74,0,1,0,1,0
3831,51505,0,0,63,63,0,1,0,1,0
55917,62413,0,0,66,66,0,1,0,1,0
37057,35748,0,0,63,63,0,1,0,1,0
55425,25174,0,0,66,66,0,1,0,1,0
29922,23,0,0,60,60,0,1,0,1,0
443,61686,0,0,1484,1484,0,1,0,1,0
1027,64147,0,0,62,62,0,1,0,1,0
443,4205,0,0,320,320,0,1,0,1,0
38729,51505,0,0,62,62,0,1,0,1,0
33466,5704,0,0,104,104,0,1,0,1,0
48676,53392,0,0,60,60,0,1,0,1,0
53486,14,0,0,62,62,0,1,0,1,0
58638,5900,0,0,62,62,0,1,0,1,0
65287,44847,0,0,65,65,0,1,0,1,0
59184,51221,0,0,66,66,0,1,0,1,0
6712,123,0,0,90,90,0,1,0,1,0
51774,50584,0,0,63,63,0,1,0,1,0
61765,44847,0,0,66,66,0,1,0,1,0
61515,23704,0,0,67,67,0,1,0,1,0
58638,5900,0,0,62,62,0,1,0,1,0
27001,7251,0,0,62,62,0,1,0,1,0
42344,48637,0,0,60,60,0,1,0,1,0
55386,37969,0,0,66,66,0,1,0,1,0
51533,44847,0,0,62,62,0,1,0,1,0
6890,48817,0,0,142,142,0,1,0,1,0
22683,39210,0,0,60,60,0,1,0,1,0
57319,64147,0,0,66,66,0,1,0,1,0
51592,17540,0,0,65,65,0,1,0,1,0
43350,58414,0,0,66,66,0,1,0,1,0
57987,56125,0,0,90,90,0,1,0,1,0
45006,50624,0,0,62,62,0,1,0,1,0
58638,5900,0,0,62,62,0,1,0,1,0
56122,1335,0,0,64,64,0,1,0,1,0
52585,44847,0,0,62,62,0,1,0,1,0
80,9918,0,0,60,60,0,1,0,1,0
12602,37837,0,0,62,62,0,1,0,1,0
49959,57470,0,0,66,66,0,1,0,1,0
44933,26467,0,0,62,62,0,1,0,1,0
9476,57759,0,0,124,124,0,1,0,1,0
65328,26208,0,0,66,66,0,1,0,1,0
48706,23393,0,0,60,60,0,1,0,1,0
34228,37965,0,0,62,62,0,1,0,1,0
64637,30188,0,0,66,66,0,1,0,1,0
54539,26467,0,0,62,62,0,1,0,1,0
52740,51505,0,0,66,66,0,1,0,1,0
63485,37965,0,0,63,63,0,1,0,1,0
60544,36516,0,0,62,62,0,1,0,1,0
55698,5900,0,0,60,60,0,1,0,1,0
25523,35974,0,0,62,62,0,1,0,1,0
49261,57470,0,0,115,115,0,1,0,1,0
61026,37965,0,0,120,120,0,1,0,1,0
58638,5900,0,0,62,62,0,1,0,1,0
12118,41,0,0,60,60,0,1,0,1,0
39342,23,0,0,60,60,0,1,0,1,0
19146,50584,0,0,135,135,0,1,0,1,0
52590,17348,0,0,66,66,0,1,0,1,0
1499,62424,0,0,67,67,0,1,0,1,0
33401,51505,0,0,66,66,0,1,0,1,0
16828,21247,0,0,62,62,0,1,0,1,0
63641,59,0,0,60,60,0,1,0,1,0
8560,50584,0,0,63,63,0,1,0,1,0
63323,54369,0,0,78,78,0,1,0,1,0
58638,5900,0,0,62,62,0,1,0,1,0
4545,1900,0,0,136,136,0,1,0,1,0
46901,26672,0,0,60,60,0,1,0,1,0
26493,64147,0,0,62,62,0,1,0,1,0
20026,26467,0,0,66,66,0,1,0,1,0
61192,17467,0,0,66,66,0,1,0,1,0
5617,64147,0,0,136,136,0,1,0,1,0
15459,50362,0,0,62,62,0,1,0,1,0
63012,51505,0,0,62,62,0,1,0,1,0
34400,39004,0,0,74,74,0,1,0,1,0
1062,44847,0,0,146,146,0,1,0,1,0
52548,30188,0,0,64,64,0,1,0,1,0
62798,37859,0,0,62,62,0,1,0,1,0
18363,64111,0,0,64,64,0,1,0,1,0
51922,44847,0,0,66,66,0,1,0,1,0
64810,35440,0,0,65,65,0,1,0,1,0
26141,21,0,0,60,60,0,1,0,1,0
443,14591,0,0,62,62,0,1,0,1,0
61904,22114,0,0,66,66,0,1,0,1,0
52181,37851,0,0,66,66,0,1,0,1,0
1861,25174,0,0,64,64,0,1,0,1,0
53250,36213,0,0,62,62,0,1,0,1,0
443,4001,0,0,195,195,0,1,0,1,0
22948,26467,0,0,62,62,0,1,0,1,0
19617,39004,0,0,71,71,0,1,0,1,0
61457,21247,0,0,66,66,0,1,0,1,0
80,9918,0,0,60,60,0,1,0,1,0
10834,50584,0,0,66,66,0,1,0,1,0
49805,6881,0,0,66,66,0,1,0,1,0
15728,37942,0,0,134,134,0,1,0,1,0
80,9918,0,0,60,60,0,1,0,1,0
64046,23718,0,0,62,62,0,1,0,1,0
61439,50584,0,0,64,64,0,1,0,1,0
58638,5900,0,0,62,62,0,1,0,1,0
30262,37965,0,0,62,62,0,1,0,1,0
64944,25194,0,0,133,133,0,1,0,1,0
50688,51505,0,0,66,66,0,1,0,1,0
43277,58175,0,0,62,62,0,1,0,1,0
6881,6881,0,0,62,62,0,1,0,1,0
58457,18375,0,0,66,66,0,1,0,1,0
55853,56497,0,0,62,62,0,1,0,1,0
64090,64147,0,0,66,66,0,1,0,1,0
58832,22114,0,0,124,124,0,1,0,1,0
59511,21247,0,0,62,62,0,1,0,1,0
443,20995,0,0,83,83,0,1,0,1,0
8999,57470,0,0,146,146,0,1,0,1,0
19875,30170,0,0,145,145,0,1,0,1,0
38084,11177,0,0,146,146,0,1,0,1,0
25084,64147,0,0,65,65,0,1,0,1,0
60398,46776,0,0,74,74,0,1,0,1,0
30712,37965,0,0,62,62,0,1,0,1,0
59988,64147,0,0,66,66,0,1,0,1,0
62390,48817,0,0,145,145,0,1,0,1,0
52480,50481,0,0,66,66,0,1,0,1,0
51907,42707,0,0,66,66,0,1,0,1,0
49415,22114,0,0,63,63,0,1,0,1,0
3972,17372,0,0,65,65,0,1,0,1,0
38880,37965,0,0,62,62,0,1,0,1,0
10792,25174,0,0,62,62,0,1,0,1,0
60688,51050,0,0,66,66,0,1,0,1,0
52238,26467,0,0,62,62,0,1,0,1,0
27062,25174,0,0,62,62,0,1,0,1,0
41670,56205,0,0,65,65,0,1,0,1,0
65203,30188,0,0,66,66,0,1,0,1,0
30270,37965,0,0,63,63,0,1,0,1,0
37597,50584,0,0,66,66,0,1,0,1,0
40694,57470,0,0,66,66,0,1,0,1,0
45964,3111,0,0,60,60,0,1,0,1,0
46901,26672,0,0,60,60,0,1,0,1,0
51266,37965,0,0,66,66,0,1,0,1,0
52511,37965,0,0,64,64,0,1,0,1,0
54518,25174,0,0,111,111,0,1,0,1,0
23844,26467,0,0,62,62,0,1,0,1,0
61203,42857,0,0,65,65,0,1,0,1,0
61218,48880,0,0,62,62,0,1,0,1,0
65281,44847,0,0,62,62,0,1,0,1,0
31536,5,0,0,127,127,0,1,0,1,0
1054,57470,0,0,62,62,0,1,0,1,0
51106,56205,0,0,66,66,0,1,0,1,0
30542,25174,0,0,62,62,0,1,0,1,0
5955,55160,0,0,74,74,0,1,0,1,0
23763,56205,0,0,64,64,0,1,0,1,0
12138,22,0,0,60,60,0,1,0,1,0
25387,50584,0,0,62,62,0,1,0,1,0
64396,25174,0,0,66,66,0,1,0,1,0
53384,19,0,0,60,60,0,1,0,1,0
54939,50299,0,0,66,66,0,1,0,1,0
8999,57470,0,0,146,146,0,1,0,1,0
17624,6900,0,0,65,65,0,1,0,1,0
45524,64147,0,0,66,66,0,1,0,1,0
26095,25174,0,0,66,66,0,1,0,1,0
62008,22114,0,0,66,66,0,1,0,1,0
30783,51505,0,0,62,62,0,1,0,1,0
58638,5900,0,0,62,62,0,1,0,1,0
9687,57470,0,0,78,78,0,1,0,1,0
54111,36829,0,0,66,66,0,1,0,1,0
17918,11392,0,0,62,62,0,1,0,1,0
22920,26467,0,0,62,62,0,1,0,1,0
13911,57470,0,0,60,60,0,1,0,1,0
16955,10296,0,0,110,110,0,1,0,1,0
20051,252,0,0,60,60,0,1,0,1,0
36448,25174,0,0,62,62,0,1,0,1,0
48036,7494,0,0,60,60,0,1,0,1,0
49327,25174,0,0,69,69,0,1,0,1,0
56532,64147,0,0,62,62,0,1,0,1,0
33916,10960,0,0,103,103,0,1,0,1,0
58638,5900,0,0,62,62,0,1,0,1,0
22492,51505,0,0,62,62,0,1,0,1,0
23513,57691,0,0,145,145,0,1,0,1,0
32974,37965,0,0,66,66,0,1,0,1,0
59408,51505,0,0,66,66,0,1,0,1,0
58638,5900,0,0,62,62,0,1,0,1,0
51855,35440,0,0,66,66,0,1,0,1,0
5440,44013,0,0,64,64,0,1,0,1,0
22240,22114,0,0,62,62,0,1,0,1,0
10769,42779,0,0,62,62,0,1,0,1,0
31285,50584,0,0,62,62,0,1,0,1,0
45255,50584,0,0,66,66,0,1,0,1,0
60557,23117,0,0,66,66,0,1,0,1,0
48676,53399,0,0,60,60,0,1,0,1,0
49118,50584,0,0,69,69,0,1,0,1,0
61522,64147,0,0,63,63,0,1,0,1,0
41495,28341,0,0,145,145,0,1,0,1,0
57174,57470,0,0,66,66,0,1,0,1,0
27570,23,0,0,60,60,0,1,0,1,0
60857,50584,0,0,64,64,0,1,0,1,0
58641,35964,0,0,65,65,0,1,0,1,0
57221,50584,0,0,63,63,0,1,0,1,0
24527,26413,0,0,91,91,0,1,0,1,0
58811,53976,0,0,66,66,0,1,0,1,0
25080,30188,0,0,62,62,0,1,0,1,0
57127,57470,0,0,64,64,0,1,0,1,0
37876,50313,0,0,66,66,0,1,0,1,0
3680,10156,0,0,66,66,0,1,0,1,0
65014,33,0,0,70,70,0,1,0,1,0
58638,5900,0,0,62,62,0,1,0,1,0
64798,51221,0,0,64,64,0,1,0,1,0
62617,26414,0,0,94,94,0,1,0,1,0
57637,50584,0,0,62,62,0,1,0,1,0
48865,63448,0,0,70,70,0,1,0,1,0
39812,50480,0,0,62,62,0,1,0,1,0
2873,25174,0,0,65,65,0,1,0,1,0
51530,11392,0,0,65,65,0,1,0,1,0
52720,35894,0,0,62,62,0,1,0,1,0
42034,28189,0,0,108,108,0,1,0,1,0
45586,50584,0,0,115,115,0,1,0,1,0
26531,37965,0,0,62,62,0,1,0,1,0
58638,5900,0,0,62,62,0,1,0,1,0
26089,8301,0,0,145,145,0,1,0,1,0
9533,10042,0,0,61,61,0,1,0,1,0
64926,25177,0,0,76,76,0,1,0,1,0
443,45788,0,0,253,253,0,1,0,1,0
12666,37875,0,0,63,63,0,1,0,1,0
62624,53699,0,0,65,65,0,1,0,1,0
54547,25174,0,0,65,65,0,1,0,1,0
13430,22114,0,0,70,70,0,1,0,1,0
443,62743,0,0,195,195,0,1,0,1,0
64927,87,0,0,61,61,0,1,0,1,0
47448,36222,0,0,83,83,0,1,0,1,0
57311,37965,0,0,63,63,0,1,0,1,0
61475,50686,0,0,66,66,0,1,0,1,0
22752,2301,0,0,60,60,0,1,0,1,0
41993,35440,0,0,62,62,0,1,0,1,0
39586,22114,0,0,62,62,0,1,0,1,0
6772,15905,0,0,61,61,0,1,0,1,0
1067,59355,0,0,144,144,0,1,0,1,0
59965,56205,0,0,66,66,0,1,0,1,0
443,20995,0,0,83,83,0,1,0,1,0
33023,50584,0,0,62,62,0,1,0,1,0
42285,57470,0,0,62,62,0,1,0,1,0
57613,42707,0,0,63,63,0,1,0,1,0
15137,44847,0,0,63,63,0,1,0,1,0
30214,23,0,0,60,60,0,1,0,1,0
13437,44847,0,0,65,65,0,1,0,1,0
39212,25174,0,0,62,62,0,1,0,1,0
41476,38049,0,0,97,97,0,1,0,1,0
52451,22114,0,0,62,62,0,1,0,1,0
58919,57470,0,0,102,102,0,1,0,1,0
39763,44847,0,0,118,118,0,1,0,1,0
54280,3398,0,0,60,60,0,1,0,1,0
52589,30188,0,0,62,62,0,1,0,1,0
4221,35440,0,0,62,62,0,1,0,1,0
56311,9571,0,0,76,76,0,1,0,1,0
64653,35993,0,0,63,63,0,1,0,1,0
1972,57470,0,0,78,78,0,1,0,1,0
3169,22114,0,0,64,64,0,1,0,1,0
60480,57470,0,0,62,62,0,1,0,1,0
49616,30188,0,0,63,63,0,1,0,1,0
53300,37807,0,0,62,62,0,1,0,1,0
58971,44847,0,0,70,70,0,1,0,1,0
62716,51221,0,0,66,66,0,1,0,1,0
80,37649,0,0,60,60,0,1,0,1,0
63339,54462,0,0,76,76,0,1,0,1,0
21889,5802,0,0,84,84,0,1,0,1,0
26499,22114,0,0,146,146,0,1,0,1,0
13886,17978,0,0,62,62,0,1,0,1,0
54951,21247,0,0,66,66,0,1,0,1,0
57991,22114,0,0,66,66,0,1,0,1,0
58381,57470,0,0,66,66,0,1,0,1,0
52369,55547,0,0,66,66,0,1,0,1,0
502,2789,0,0,122,122,0,1,0,1,0
58542,44847,0,0,62,62,0,1,0,1,0
64387,37965,0,0,65,65,0,1,0,1,0
45807,48236,0,0,86,86,0,1,0,1,0
287,64267,0,0,60,60,0,1,0,1,0
53406,50551,0,0,69,69,0,1,0,1,0
60771,58414,0,0,63,63,0,1,0,1,0
14681,25174,0,0,62,62,0,1,0,1,0
58497,39004,0,0,66,66,0,1,0,1,0
17511,50584,0,0,139,139,0,1,0,1,0
48676,53393,0,0,60,60,0,1,0,1,0
58638,5900,0,0,62,62,0,1,0,1,0
61415,56205,0,0,64,64,0,1,0,1,0
57562,64147,0,0,66,66,0,1,0,1,0
18401,51399,0,0,62,62,0,1,0,1,0
64077,25174,0,0,64,64,0,1,0,1,0
58638,5900,0,0,62,62,0,1,0,1,0
2738,35318,0,0,66,66,0,1,0,1,0
58715,64097,0,0,62,62,0,1,0,1,0
58022,17,0,0,60,60,0,1,0,1,0
57749,15503,0,0,62,62,0,1,0,1,0
15410,50395,0,0,62,62,0,1,0,1,0
59223,17500,0,0,66,66,0,1,0,1,0
57896,80,0,0,94,94,0,1,0,1,0
50412,37864,0,0,63,63,0,1,0,1,0
57688,57470,0,0,62,62,0,1,0,1,0
57452,57470,0,0,62,62,0,1,0,1,0
23537,35253,0,0,66,66,0,1,0,1,0
17544,55552,0,0,66,66,0,1,0,1,0
61187,57470,0,0,63,63,0,1,0,1,0
5693,44847,0,0,66,66,0,1,0,1,0
61889,48817,0,0,136,136,0,1,0,1,0
26698,57470,0,0,66,66,0,1,0,1,0
53831,22114,0,0,64,64,0,1,0,1,0
16413,45090,0,0,60,60,0,1,0,1,0
58041,51505,0,0,140,140,0,1,0,1,0
58276,43890,0,0,64,64,0,1,0,1,0
58638,5900,0,0,62,62,0,1,0,1,0
62773,56205,0,0,63,63,0,1,0,1,0
58638,5900,0,0,62,62,0,1,0,1,0
30395,57470,0,0,108,108,0,1,0,1,0
52264,64147,0,0,64,64,0,1,0,1,0
42349,22114,0,0,65,65,0,1,0,1,0
47704,51505,0,0,65,65,0,1,0,1,0
12567,11392,0,0,100,100,0,1,0,1,0
53283,62413,0,0,62,62,0,1,0,1,0
26741,64147,0,0,62,62,0,1,0,1,0
38360,51221,0,0,62,62,0,1,0,1,0
58834,52758,0,0,112,112,0,1,0,1,0
54070,36237,0,0,65,65,0,1,0,1,0
62080,64147,0,0,65,65,0,1,0,1,0
46328,50584,0,0,66,66,0,1,0,1,0
63286,52864,0,0,65,65,0,1,0,1,0
43865,24398,0,0,124,124,0,1,0,1,0
58638,5900,0,0,62,62,0,1,0,1,0
54084,36237,0,0,65,65,0,1,0,1,0
49223,44847,0,0,65,65,0,1,0,1,0
58638,5900,0,0,62,62,0,1,0,1,0
80,37649,0,0,60,60,0,1,0,1,0
57633,50584,0,0,137,137,0,1,0,1,0
58638,5900,0,0,62,62,0,1,0,1,0
9144,52343,0,0,135,135,0,1,0,1,0
59641,30188,0,0,66,66,0,1,0,1,0
21076,25174,0,0,122,122,0,1,0,1,0
59617,53687,0,0,63,63,0,1,0,1,0
15327,44847,0,0,62,62,0,1,0,1,0
1984,57463,0,0,81,81,0,1,0,1,0
58638,5900,0,0,62,62,0,1,0,1,0
64737,57470,0,0,68,68,0,1,0,1,0
49196,63791,0,0,140,140,0,1,0,1,0
3314,35360,0,0,66,66,0,1,0,1,0
90,48017,0,0,68,68,0,1,0,1,0
58102,21247,0,0,62,62,0,1,0,1,0
58292,64147,0,0,68,68,0,1,0,1,0
3199,22114,0,0,63,63,0,1,0,1,0
57761,15503,0,0,65,65,0,1,0,1,0
443,39866,0,0,89,89,0,1,0,1,0
14059,21247,0,0,120,120,0,1,0,1,0
9156,26392,0,0,62,62,0,1,0,1,0
42355,22114,0,0,65,65,0,1,0,1,0
58638,5900,0,0,62,62,0,1,0,1,0
30638,37965,0,0,62,62,0,1,0,1,0
50660,50584,0,0,67,67,0,1,0,1,0
42484,22114,0,0,107,107,0,1,0,1,0
17438,22114,0,0,62,62,0,1,0,1,0
29139,64147,0,0,62,62,0,1,0,1,0
51815,51221,0,0,74,74,0,1,0,1,0
63246,57866,0,0,66,66,0,1,0,1,0
52448,35440,0,0,128,128,0,1,0,1,0
49484,11392,0,0,66,66,0,1,0,1,0
55069,64109,0,0,66,66,0,1,0,1,0
58638,5900,0,0,62,62,0,1,0,1,0
51045,25174,0,0,66,66,0,1,0,1,0
17145,18,0,0,60,60,0,1,0,1,0
54058,49860,0,0,62,62,0,1,0,1,0
60636,58414,0,0,62,62,0,1,0,1,0
62438,37807,0,0,65,65,0,1,0,1,0
43260,41615,0,0,145,145,0,1,0,1,0
55562,50584,0,0,66,66,0,1,0,1,0
1024,25174,0,0,62,62,0,1,0,1,0
53406,50584,0,0,63,63,0,1,0,1,0
2502,23360,0,0,63,63,0,1,0,1,0
28732,44347,0,0,63,63,0,1,0,1,0
15585,64147,0,0,65,65,0,1,0,1,0
14979,57487,0,0,71,71,0,1,0,1,0
1038,37965,0,0,62,62,0,1,0,1,0
16387,3655,0,0,60,60,0,1,0,1,0
28013,22,0,0,60,60,0,1,0,1,0
1068,57470,0,0,90,90,0,1,0,1,0
7958,48825,0,0,146,146,0,1,0,1,0
29011,25174,0,0,112,112,0,1,0,1,0
49427,21247,0,0,64,64,0,1,0,1,0
54332,26467,0,0,64,64,0,1,0,1,0
42869,25174,0,0,91,91,0,1,0,1,0
64917,30188,0,0,66,66,0,1,0,1,0
53494,37807,0,0,65,65,0,1,0,1,0
31125,30199,0,0,67,67,0,1,0,1,0
25901,50265,0,0,62,62,0,1,0,1,0
14912,44847,0,0,62,62,0,1,0,1,0
56374,22114,0,0,66,66,0,1,0,1,0
56896,11445,0,0,62,62,0,1,0,1,0
50442,26467,0,0,65,65,0,1,0,1,0
16387,35270,0,0,60,60,0,1,0,1,0
35405,23,0,0,60,60,0,1,0,1,0
5288,35440,0,0,66,66,0,1,0,1,0
16421,24981,0,0,61,61,0,1,0,1,0
51139,9571,0,0,65,65,0,1,0,1,0
45941,23386,0,0,60,60,0,1,0,1,0
16352,57170,0,0,60,60,0,1,0,1,0
443,9986,0,0,302,302,0,1,0,1,0
7664,36203,0,0,65,65,0,1,0,1,0
14853,26467,0,0,62,62,0,1,0,1,0
11201,57562,0,0,62,62,0,1,0,1,0
52191,22114,0,0,66,66,0,1,0,1,0
13285,29892,0,0,145,145,0,1,0,1,0
48488,50584,0,0,70,70,0,1,0,1,0
1225,25174,0,0,63,63,0,1,0,1,0
31691,50584,0,0,87,87,0,1,0,1,0
50880,30044,0,0,62,62,0,1,0,1,0
26229,21247,0,0,66,66,0,1,0,1,0
51582,14972,0,0,132,132,0,1,0,1,0
30583,25174,0,0,65,65,0,1,0,1,0
51603,51505,0,0,62,62,0,1,0,1,0
48706,23393,0,0,60,60,0,1,0,1,0
58638,5900,0,0,62,62,0,1,0,1,0
49606,57470,0,0,65,65,0,1,0,1,0
43129,15503,0,0,62,62,0,1,0,1,0
5228,3434,0,0,345,345,0,1,0,1,0
16342,44943,0,0,61,61,0,1,0,1,0
58974,9595,0,0,60,60,0,1,0,1,0
36707,50584,0,0,62,62,0,1,0,1,0
8999,57470,0,0,146,146,0,1,0,1,0
30280,37965,0,0,66,66,0,1,0,1,0
63423,44847,0,0,65,65,0,1,0,1,0
54642,6913,0,0,66,66,0,1,0,1,0
13340,35440,0,0,66,66,0,1,0,1,0
7119,22114,0,0,63,63,0,1,0,1,0
51526,50584,0,0,63,63,0,1,0,1,0
26820,37965,0,0,62,62,0,1,0,1,0
61582,37965,0,0,66,66,0,1,0,1,0
22574,30188,0,0,62,62,0,1,0,1,0
443,54320,0,0,70,70,0,1,0,1,0
26176,1433,0,0,60,60,0,1,0,1,0
40512,57470,0,0,74,74,0,1,0,1,0
22143,23718,0,0,64,64,0,1,0,1,0
30677,51273,0,0,70,70,0,1,0,1,0
45941,23388,0,0,60,60,0,1,0,1,0
52232,26467,0,0,62,62,0,1,0,1,0
49336,25174,0,0,64,64,0,1,0,1,0
65104,57866,0,0,66,66,0,1,0,1,0
52184,5779,0,0,60,60,0,1,0,1,0
38053,5392,0,0,60,60,0,1,0,1,0
1090,57470,0,0,62,62,0,1,0,1,0
50052,65008,0,0,60,60,0,1,0,1,0
57751,50584,0,0,65,65,0,1,0,1,0
2443,23117,0,0,62,62,0,1,0,1,0
46093,25174,0,0,146,146,0,1,0,1,0
25523,35974,0,0,62,62,0,1,0,1,0
51094,35440,0,0,66,66,0,1,0,1,0
10700,25174,0,0,81,81,0,1,0,1,0
9969,32353,0,0,77,77,0,1,0,1,0
18567,2,0,0,65,65,0,1,0,1,0
15726,41862,0,0,123,123,0,1,0,1,0
55304,53577,0,0,66,66,0,1,0,1,0
22949,25174,0,0,63,63,0,1,0,1,0
52838,37965,0,0,66,66,0,1,0,1,0
58638,5900,0,0,62,62,0,1,0,1,0
30654,51221,0,0,72,72,0,1,0,1,0
51413,6,0,0,69,69,0,1,0,1,0
51930,57470,0,0,66,66,0,1,0,1,0
3834,17372,0,0,63,63,0,1,0,1,0
63398,48817,0,0,73,73,0,1,0,1,0
45964,5333,0,0,60,60,0,1,0,1,0
36258,23,0,0,60,60,0,1,0,1,0
58512,50584,0,0,62,62,0,1,0,1,0
17275,25174,0,0,122,122,0,1,0,1,0
16853,6,0,0,61,61,0,1,0,1,0
63894,26467,0,0,64,64,0,1,0,1,0
21072,51315,0,0,62,62,0,1,0,1,0
27110,22114,0,0,61,61,0,1,0,1,0
65209,44847,0,0,88,88,0,1,0,1,0
61168,22114,0,0,66,66,0,1,0,1,0
50734,37965,0,0,62,62,0,1,0,1,0
14350,64147,0,0,112,112,0,1,0,1,0
7354,44677,0,0,66,66,0,1,0,1,0
28032,22114,0,0,62,62,0,1,0,1,0
53871,37965,0,0,66,66,0,1,0,1,0
42231,57470,0,0,78,78,0,1,0,1,0
10006,64147,0,0,62,62,0,1,0,1,0
24144,57470,0,0,62,62,0,1,0,1,0
58638,5900,0,0,62,62,0,1,0,1,0
35163,30188,0,0,65,65,0,1,0,1,0
35045,22114,0,0,66,66,0,1,0,1,0
62250,23117,0,0,66,66,0,1,0,1,0
60250,50584,0,0,66,66,0,1,0,1,0
12226,37965,0,0,62,62,0,1,0,1,0
45941,23386,0,0,60,60,0,1,0,1,0
15977,56205,0,0,63,63,0,1,0,1,0
46780,51050,0,0,62,62,0,1,0,1,0
22212,19502,0,0,63,63,0,1,0,1,0
26357,26368,0,0,62,62,0,1,0,1,0
443,46223,0,0,66,66,0,1,0,1,0
17465,44847,0,0,99,99,0,1,0,1,0
45964,55559,0,0,60,60,0,1,0,1,0
25076,25174,0,0,62,62,0,1,0,1,0
56947,22114,0,0,143,143,0,1,0,1,0
59251,51115,0,0,66,66,0,1,0,1,0
62792,53,0,0,88,88,0,1,0,1,0
63569,62413,0,0,66,66,0,1,0,1,0
48079,51141,0,0,62,62,0,1,0,1,0
50753,44847,0,0,63,63,0,1,0,1,0
57463,62413,0,0,66,66,0,1,0,1,0
26068,21,0,0,60,60,0,1,0,1,0
6881,6881,0,0,62,62,0,1,0,1,0
60444,25174,0,0,66,66,0,1,0,1,0
63469,64147,0,0,62,62,0,1,0,1,0
3478,61463,0,0,238,238,0,1,0,1,0
6910,35612,0,0,62,62,0,1,0,1,0
34641,57470,0,0,66,66,0,1,0,1,0
11136,19910,0,0,121,121,0,1,0,1,0
1036,37979,0,0,62,62,0,1,0,1,0
52812,25174,0,0,66,66,0,1,0,1,0
42252,33303,0,0,60,60,0,1,0,1,0
62115,22114,0,0,63,63,0,1,0,1,0
58638,5900,0,0,62,62,0,1,0,1,0
33808,65261,0,0,144,144,0,1,0,1,0
54413,26467,0,0,64,64,0,1,0,1,0
28875,51505,0,0,146,146,0,1,0,1,0
65242,22579,0,0,66,66,0,1,0,1,0
52621,44847,0,0,64,64,0,1,0,1,0
1847,64147,0,0,64,64,0,1,0,1,0
61850,50584,0,0,66,66,0,1,0,1,0
62970,44847,0,0,65,65,0,1,0,1,0
22668,23,0,0,60,60,0,1,0,1,0
16387,35583,0,0,60,60,0,1,0,1,0
64392,25174,0,0,64,64,0,1,0,1,0
14153,48675,0,0,61,61,0,1,0,1,0
10544,37965,0,0,62,62,0,1,0,1,0
3410,17372,0,0,120,120,0,1,0,1,0
25283,63896,0,0,146,146,0,1,0,1,0
19875,30170,0,0,145,145,0,1,0,1,0
42617,43329,0,0,68,68,0,1,0,1,0
64492,2371,0,0,132,132,0,1,0,1,0
44388,63874,0,0,66,66,0,1,0,1,0
80,57411,0,0,1514,1514,0,1,0,1,0
59141,57866,0,0,66,66,0,1,0,1,0
54884,60043,0,0,62,62,0,1,0,1,0
58338,3363,0,0,60,60,0,1,0,1,0
1405,56205,0,0,63,63,0,1,0,1,0
58638,5900,0,0,62,62,0,1,0,1,0
42981,57470,0,0,62,62,0,1,0,1,0
59358,51505,0,0,66,66,0,1,0,1,0
16387,35259,0,0,60,60,0,1,0,1,0
64898,51098,0,0,64,64,0,1,0,1,0
61993,30212,0,0,62,62,0,1,0,1,0
25528,35910,0,0,62,62,0,1,0,1,0
58638,5900,0,0,62,62,0,1,0,1,0
11136,15503,0,0,62,62,0,1,0,1,0
62440,37935,0,0,62,62,0,1,0,1,0
56586,64147,0,0,62,62,0,1,0,1,0
50084,26672,0,0,62,62,0,1,0,1,0
57010,36219,0,0,62,62,0,1,0,1,0
63314,57470,0,0,66,66,0,1,0,1,0
57316,62413,0,0,64,64,0,1,0,1,0
58638,5900,0,0,62,62,0,1,0,1,0
57552,52970,0,0,66,66,0,1,0,1,0
2064,43890,0,0,62,62,0,1,0,1,0
3730,37965,0,0,62,62,0,1,0,1,0
53143,50584,0,0,66,66,0,1,0,1,0
58638,5900,0,0,62,62,0,1,0,1,0
51297,1792,0,0,120,120,0,1,0,1,0
60253,36237,0,0,62,62,0,1,0,1,0
3725,15,0,0,61,61,0,1,0,1,0
2083,25174,0,0,62,62,0,1,0,1,0
16861,62302,0,0,80,80,0,1,0,1,0
60558,51221,0,0,62,62,0,1,0,1,0
27056,22114,0,0,63,63,0,1,0,1,0
45941,23388,0,0,60,60,0,1,0,1,0
54280,3398,0,0,60,60,0,1,0,1,0
1114,37965,0,0,62,62,0,1,0,1,0
63098,22114,0,0,62,62,0,1,0,1,0
15605,50265,0,0,62,62,0,1,0,1,0
24057,22146,0,0,61,61,0,1,0,1,0
9957,32480,0,0,63,63,0,1,0,1,0
60798,51078,0,0,66,66,0,1,0,1,0
51562,17372,0,0,65,65,0,1,0,1,0
25010,30188,0,0,79,79,0,1,0,1,0
44862,26467,0,0,62,62,0,1,0,1,0
29706,50584,0,0,62,62,0,1,0,1,0
40449,25243,0,0,96,96,0,1,0,1,0
34796,51185,0,0,61,61,0,1,0,1,0
5541,37965,0,0,63,63,0,1,0,1,0
58914,37965,0,0,66,66,0,1,0,1,0
33964,50327,0,0,62,62,0,1,0,1,0
16577,25174,0,0,62,62,0,1,0,1,0
55424,64147,0,0,66,66,0,1,0,1,0
55131,44,0,0,60,60,0,1,0,1,0
3316,36406,0,0,62,62,0,1,0,1,0
1126,25174,0,0,62,62,0,1,0,1,0
64878,26467,0,0,62,62,0,1,0,1,0
25015,64147,0,0,66,66,0,1,0,1,0
28824,44847,0,0,66,66,0,1,0,1,0
58638,5900,0,0,62,62,0,1,0,1,0
50570,57470,0,0,66,66,0,1,0,1,0
43350,58414,0,0,64,64,0,1,0,1,0
55604,22,0,0,60,60,0,1,0,1,0
45908,3383,0,0,60,60,0,1,0,1,0
63926,36829,0,0,66,66,0,1,0,1,0
26390,22114,0,0,146,146,0,1,0,1,0
45241,50584,0,0,71,71,0,1,0,1,0
45146,25174,0,0,62,62,0,1,0,1,0
4333,51505,0,0,62,62,0,1,0,1,0
30591,65250,0,0,87,87,0,1,0,1,0
65295,51205,0,0,65,65,0,1,0,1,0
58638,5900,0,0,62,62,0,1,0,1,0
6666,50070,0,0,60,60,0,1,0,1,0
0,0,0,0,161,161,0,2,0,2,0
38316,22429,0,0,67,67,0,1,0,1,0
47962,16069,0,0,62,62,0,1,0,1,0
63863,36829,0,0,62,62,0,1,0,1,0
45964,2225,0,0,60,60,0,1,0,1,0
5328,32575,0,0,66,66,0,1,0,1,0
51988,52809,0,0,73,73,0,1,0,1,0
57089,50584,0,0,62,62,0,1,0,1,0
63558,37965,0,0,64,64,0,1,0,1,0
1821,64147,0,0,66,66,0,1,0,1,0
50033,65025,0,0,63,63,0,1,0,1,0
59093,57470,0,0,64,64,0,1,0,1,0
18642,42707,0,0,110,110,0,1,0,1,0
61494,23639,0,0,76,76,0,1,0,1,0
3478,61463,0,0,164,164,0,1,0,1,0
59696,57470,0,0,62,62,0,1,0,1,0
45908,33330,0,0,60,60,0,1,0,1,0
80,53945,0,0,60,60,0,1,0,1,0
46672,30432,0,0,155,155,0,1,0,1,0
57131,31061,0,0,145,145,0,1,0,1,0
5060,37965,0,0,66,66,0,1,0,1,0
63786,25174,0,0,62,62,0,1,0,1,0
63346,37965,0,0,66,66,0,1,0,1,0
13177,35440,0,0,66,66,0,1,0,1,0
52576,44847,0,0,66,66,0,1,0,1,0
42452,22114,0,0,62,62,0,1,0,1,0
1728,54937,0,0,114,114,0,1,0,1,0
17043,3,0,0,61,61,0,1,0,1,0
28886,50492,0,0,64,64,0,1,0,1,0
57495,37965,0,0,62,62,0,1,0,1,0
27060,25174,0,0,62,62,0,1,0,1,0
68,67,0,0,380,380,0,1,0,1,0
51214,1433,0,0,60,60,0,1,0,1,0
443,54507,0,0,82,82,0,1,0,1,0
17702,6881,0,0,65,65,0,1,0,1,0
57648,6881,0,0,62,62,0,1,0,1,0
58638,5900,0,0,62,62,0,1,0,1,0
45785,35975,0,0,126,126,0,1,0,1,0
443,62732,0,0,315,315,0,1,0,1,0
59441,50584,0,0,63,63,0,1,0,1,0
64338,37965,0,0,69,69,0,1,0,1,0
51469,26098,0,0,69,69,0,1,0,1,0
57543,34212,0,0,106,106,0,1,0,1,0
60014,64147,0,0,62,62,0,1,0,1,0
58638,5900,0,0,62,62,0,1,0,1,0
20037,30177,0,0,145,145,0,1,0,1,0
62861,62413,0,0,66,66,0,1,0,1,0
58638,5900,0,0,62,62,0,1,0,1,0
62524,57361,0,0,153,153,0,1,0,1,0
26372,37965,0,0,66,66,0,1,0,1,0
64024,57470,0,0,65,65,0,1,0,1,0
52566,44847,0,0,62,62,0,1,0,1,0
24460,37944,0,0,62,62,0,1,0,1,0
9649,57470,0,0,70,70,0,1,0,1,0
1155,57470,0,0,146,146,0,1,0,1,0
38076,10977,0,0,89,89,0,1,0,1,0
58638,5900,0,0,62,62,0,1,0,1,0
1435,51228,0,0,64,64,0,1,0,1,0
44902,26467,0,0,62,62,0,1,0,1,0
54295,22114,0,0,65,65,0,1,0,1,0
17959,36046,0,0,82,82,0,1,0,1,0
34149,51256,0,0,72,72,0,1,0,1,0
548,24290,0,0,152,152,0,1,0,1,0
23128,26467,0,0,62,62,0,1,0,1,0
64350,46804,0,0,66,66,0,1,0,1,0
22752,9700,0,0,62,62,0,1,0,1,0
41684,6061,0,0,60,60,0,1,0,1,0
54280,3385,0,0,60,60,0,1,0,1,0
41819,21458,0,0,62,62,0,1,0,1,0
64649,35993,0,0,62,62,0,1,0,1,0
56235,26467,0,0,65,65,0,1,0,1,0
56410,51284,0,0,65,65,0,1,0,1,0
51046,25174,0,0,63,63,0,1,0,1,0
51116,45867,0,0,87,87,0,1,0,1,0
58638,5900,0,0,62,62,0,1,0,1,0
55337,64147,0,0,66,66,0,1,0,1,0
47249,7711,0,0,114,114,0,1,0,1,0
10758,35440,0,0,66,66,0,1,0,1,0
47934,7468,0,0,60,60,0,1,0,1,0
2085,57407,0,0,114,114,0,1,0,1,0
25523,35974,0,0,133,133,0,1,0,1,0
26642,57470,0,0,62,62,0,1,0,1,0
52459,33890,0,0,60,60,0,1,0,1,0
56239,55442,0,0,66,66,0,1,0,1,0
8239,37965,0,0,146,146,0,1,0,1,0
64822,37965,0,0,62,62,0,1,0,1,0
59193,57549,0,0,66,66,0,1,0,1,0
63488,56205,0,0,66,66,0,1,0,1,0
52744,25174,0,0,66,66,0,1,0,1,0
53057,25174,0,0,66,66,0,1,0,1,0
6692,8425,0,0,70,70,0,1,0,1,0
10336,22114,0,0,62,62,0,1,0,1,0
13285,29892,0,0,145,145,0,1,0,1,0
20269,17351,0,0,62,62,0,1,0,1,0
57789,30188,0,0,62,62,0,1,0,1,0
964,15369,0,0,61,61,0,1,0,1,0
50046,57470,0,0,66,66,0,1,0,1,0
43578,15503,0,0,74,74,0,1,0,1,0
55022,26467,0,0,66,66,0,1,0,1,0
58638,5900,0,0,62,62,0,1,0,1,0
17111,13,0,0,60,60,0,1,0,1,0
9327,57470,0,0,62,62,0,1,0,1,0
4366,51505,0,0,62,62,0,1,0,1,0
22896,22114,0,0,84,84,0,1,0,1,0
53024,51050,0,0,63,63,0,1,0,1,0
1115,37965,0,0,68,68,0,1,0,1,0
61651,57470,0,0,73,73,0,1,0,1,0
64215,64147,0,0,63,63,0,1,0,1,0
58638,5900,0,0,62,62,0,1,0,1,0
53038,58185,0,0,128,128,0,1,0,1,0
58786,57470,0,0,63,63,0,1,0,1,0
60530,35440,0,0,66,66,0,1,0,1,0
14993,50584,0,0,62,62,0,1,0,1,0
28423,35440,0,0,66,66,0,1,0,1,0
50567,22114,0,0,62,62,0,1,0,1,0
49841,7287,0,0,61,61,0,1,0,1,0
59841,36237,0,0,62,62,0,1,0,1,0
30594,25174,0,0,65,65,0,1,0,1,0
19720,37965,0,0,62,62,0,1,0,1,0
56063,22114,0,0,64,64,0,1,0,1,0
63437,51454,0,0,65,65,0,1,0,1,0
443,62487,0,0,122,122,0,1,0,1,0
58398,44847,0,0,65,65,0,1,0,1,0
34993,15503,0,0,62,62,0,1,0,1,0
63729,17817,0,0,66,66,0,1,0,1,0
31727,57470,0,0,62,62,0,1,0,1,0
51666,34397,0,0,126,126,0,1,0,1,0
51662,37965,0,0,62,62,0,1,0,1,0
52703,9616,0,0,62,62,0,1,0,1,0
443,35385,0,0,84,84,0,1,0,1,0
58638,5900,0,0,62,62,0,1,0,1,0
443,20995,0,0,83,83,0,1,0,1,0
59763,25599,0,0,62,62,0,1,0,1,0
23917,37807,0,0,62,62,0,1,0,1,0
37857,37965,0,0,62,62,0,1,0,1,0
49191,35440,0,0,63,63,0,1,0,1,0
24582,26811,0,0,61,61,0,1,0,1,0
65420,26467,0,0,62,62,0,1,0,1,0
1025,35447,0,0,62,62,0,1,0,1,0
907,9317,0,0,64,64,0,1,0,1,0
51308,64147,0,0,66,66,0,1,0,1,0
443,38956,0,0,82,82,0,1,0,1,0
62759,21247,0,0,62,62,0,1,0,1,0
17648,50584,0,0,142,142,0,1,0,1,0
61065,37965,0,0,81,81,0,1,0,1,0
1865,25174,0,0,62,62,0,1,0,1,0
56564,9571,0,0,78,78,0,1,0,1,0
43833,50350,0,0,69,69,0,1,0,1,0
43815,50584,0,0,62,62,0,1,0,1,0
3765,64147,0,0,62,62,0,1,0,1,0
18252,26467,0,0,62,62,0,1,0,1,0
53668,28427,0,0,62,62,0,1,0,1,0
7796,23,0,0,60,60,0,1,0,1,0
10028,25604,0,0,62,62,0,1,0,1,0
58043,26467,0,0,62,62,0,1,0,1,0
57101,5,0,0,78,78,0,1,0,1,0
49426,57470,0,0,64,64,0,1,0,1,0
59724,44847,0,0,66,66,0,1,0,1,0
9329,7130,0,0,62,62,0,1,0,1,0
48706,23393,0,0,60,60,0,1,0,1,0
51027,22114,0,0,65,65,0,1,0,1,0
45682,37965,0,0,62,62,0,1,0,1,0
46484,64147,0,0,62,62,0,1,0,1,0
58627,25174,0,0,62,62,0,1,0,1,0
59418,17739,0,0,64,64,0,1,0,1,0
51474,12038,0,0,86,86,0,1,0,1,0
55985,44847,0,0,111,111,0,1,0,1,0
59880,35388,0,0,64,64,0,1,0,1,0
33800,65234,0,0,142,142,0,1,0,1,0
52112,56035,0,0,62,62,0,1,0,1,0
63334,37807,0,0,66,66,0,1,0,1,0
1339,8500,0,0,146,146,0,1,0,1,0
8924,30299,0,0,74,74,0,1,0,1,0
39738,52669,0,0,105,105,0,1,0,1,0
58909,25174,0,0,65,65,0,1,0,1,0
49452,35917,0,0,126,126,0,1,0,1,0
52696,57606,0,0,66,66,0,1,0,1,0
2950,9,0,0,61,61,0,1,0,1,0
48840,50584,0,0,62,62,0,1,0,1,0
26127,35440,0,0,65,65,0,1,0,1,0
65251,22988,0,0,66,66,0,1,0,1,0
46512,57470,0,0,62,62,0,1,0,1,0
58238,23,0,0,60,60,0,1,0,1,0
62225,49988,0,0,62,62,0,1,0,1,0
56636,43890,0,0,66,66,0,1,0,1,0
56188,22114,0,0,62,62,0,1,0,1,0
56904,7,0,0,64,64,0,1,0,1,0
59937,18375,0,0,66,66,0,1,0,1,0
443,9986,0,0,224,224,0,1,0,1,0
24552,50920,0,0,122,122,0,1,0,1,0
24354,50584,0,0,65,65,0,1,0,1,0
18655,44847,0,0,66,66,0,1,0,1,0
52480,30188,0,0,63,63,0,1,0,1,0
51735,57470,0,0,72,72,0,1,0,1,0
48676,53392,0,0,60,60,0,1,0,1,0
57079,1,0,0,76,76,0,1,0,1,0
3478,61463,0,0,284,284,0,1,0,1,0
48676,53395,0,0,60,60,0,1,0,1,0
34881,22114,0,0,63,63,0,1,0,1,0
17244,22114,0,0,62,62,0,1,0,1,0
49321,44847,0,0,63,63,0,1,0,1,0
1111,25174,0,0,62,62,0,1,0,1,0
59933,44847,0,0,66,66,0,1,0,1,0
56472,56205,0,0,115,115,0,1,0,1,0
25085,30188,0,0,65,65,0,1,0,1,0
49204,35574,0,0,66,66,0,1,0,1,0
63778,14481,0,0,121,121,0,1,0,1,0
6247,51221,0,0,78,78,0,1,0,1,0
65282,57470,0,0,69,69,0,1,0,1,0
443,28417,0,0,82,82,0,1,0,1,0
52828,9678,0,0,62,62,0,1,0,1,0
57193,18124,0,0,66,66,0,1,0,1,0
64903,26369,0,0,111,111,0,1,0,1,0
993,4277,0,0,66,66,0,1,0,1,0
55510,30188,0,0,66,66,0,1,0,1,0
443,45788,0,0,207,207,0,1,0,1,0
57131,7774,0,0,145,145,0,1,0,1,0
58751,9571,0,0,62,62,0,1,0,1,0
49416,22114,0,0,66,66,0,1,0,1,0
19617,39004,0,0,128,128,0,1,0,1,0
9397,57701,0,0,111,111,0,1,0,1,0
51484,51505,0,0,63,63,0,1,0,1,0
22835,51221,0,0,62,62,0,1,0,1,0
49075,44847,0,0,62,62,0,1,0,1,0
34715,51185,0,0,60,60,0,1,0,1,0
32637,62279,0,0,86,86,0,1,0,1,0
58672,43890,0,0,65,65,0,1,0,1,0
51152,11392,0,0,66,66,0,1,0,1,0
2032,25174,0,0,63,63,0,1,0,1,0
58638,5900,0,0,62,62,0,1,0,1,0
53757,62413,0,0,88,88,0,1,0,1,0
49805,64147,0,0,62,62,0,1,0,1,0
63105,64147,0,0,62,62,0,1,0,1,0
53437,44847,0,0,62,62,0,1,0,1,0
51743,30260,0,0,64,64,0,1,0,1,0
56202,22114,0,0,63,63,0,1,0,1,0
80,9918,0,0,60,60,0,1,0,1,0
56947,35440,0,0,62,62,0,1,0,1,0
48025,44847,0,0,113,113,0,1,0,1,0
53860,42807,0,0,70,70,0,1,0,1,0
46048,51505,0,0,62,62,0,1,0,1,0
46537,25174,0,0,62,62,0,1,0,1,0
63092,35440,0,0,66,66,0,1,0,1,0
58638,5900,0,0,62,62,0,1,0,1,0
23126,35440,0,0,62,62,0,1,0,1,0
53114,25174,0,0,63,63,0,1,0,1,0
59591,64147,0,0,63,63,0,1,0,1,0
52596,17372,0,0,65,65,0,1,0,1,0
58904,43890,0,0,66,66,0,1,0,1,0
35376,22,0,0,60,60,0,1,0,1,0
38414,22252,0,0,60,60,0,1,0,1,0
30354,36074,0,0,150,150,0,1,0,1,0
8239,37965,0,0,146,146,0,1,0,1,0
3478,61463,0,0,924,924,0,1,0,1,0
61220,37965,0,0,62,62,0,1,0,1,0
55186,11392,0,0,66,66,0,1,0,1,0
10669,49756,0,0,60,60,0,1,0,1,0
39098,51505,0,0,62,62,0,1,0,1,0
10004,64147,0,0,62,62,0,1,0,1,0
1024,64147,0,0,62,62,0,1,0,1,0
62842,62413,0,0,66,66,0,1,0,1,0
37013,25174,0,0,64,64,0,1,0,1,0
8899,52293,0,0,68,68,0,1,0,1,0
26921,57470,0,0,62,62,0,1,0,1,0
62987,64147,0,0,66,66,0,1,0,1,0
10322,21170,0,0,70,70,0,1,0,1,0
54897,7279,0,0,66,66,0,1,0,1,0
1528,35440,0,0,65,65,0,1,0,1,0
60861,25174,0,0,66,66,0,1,0,1,0
1027,25174,0,0,62,62,0,1,0,1,0
57969,42873,0,0,66,66,0,1,0,1,0
60774,50584,0,0,63,63,0,1,0,1,0
50236,25174,0,0,65,65,0,1,0,1,0
56753,44847,0,0,62,62,0,1,0,1,0
58638,5900,0,0,62,62,0,1,0,1,0
17501,11392,0,0,62,62,0,1,0,1,0
19984,30174,0,0,145,145,0,1,0,1,0
58638,5900,0,0,62,62,0,1,0,1,0
55208,21247,0,0,65,65,0,1,0,1,0
1035,26467,0,0,62,62,0,1,0,1,0
13108,25174,0,0,62,62,0,1,0,1,0
6881,6881,0,0,146,146,0,1,0,1,0
44433,30424,0,0,79,79,0,1,0,1,0
33134,50584,0,0,121,121,0,1,0,1,0
44416,50584,0,0,146,146,0,1,0,1,0
58535,30317,0,0,62,62,0,1,0,1,0
49684,35440,0,0,65,65,0,1,0,1,0
57784,37863,0,0,66,66,0,1,0,1,0
4690,23,0,0,60,60,0,1,0,1,0
58251,50584,0,0,62,62,0,1,0,1,0
2101,25174,0,0,146,146,0,1,0,1,0
36928,35641,0,0,63,63,0,1,0,1,0
7232,44844,0,0,66,66,0,1,0,1,0
59097,2767,0,0,66,66,0,1,0,1,0
10381,22114,0,0,62,62,0,1,0,1,0
21502,44847,0,0,66,66,0,1,0,1,0
62797,37837,0,0,62,62,0,1,0,1,0
59343,44847,0,0,65,65,0,1,0,1,0
38132,15503,0,0,110,110,0,1,0,1,0
59112,57470,0,0,66,66,0,1,0,1,0
2062,35440,0,0,66,66,0,1,0,1,0
27944,25174,0,0,63,63,0,1,0,1,0
51999,37965,0,0,62,62,0,1,0,1,0
51491,9669,0,0,66,66,0,1,0,1,0
45941,23386,0,0,60,60,0,1,0,1,0
35266,57040,0,0,69,69,0,1,0,1,0
3911,25174,0,0,62,62,0,1,0,1,0
49113,50584,0,0,65,65,0,1,0,1,0
57131,7774,0,0,145,145,0,1,0,1,0
53020,64147,0,0,62,62,0,1,0,1,0
47013,37965,0,0,62,62,0,1,0,1,0
59197,25174,0,0,66,66,0,1,0,1,0
61766,11392,0,0,65,65,0,1,0,1,0
57452,57470,0,0,62,62,0,1,0,1,0
49001,48921,0,0,160,160,0,1,0,1,0
57131,35776,0,0,145,145,0,1,0,1,0
49738,50584,0,0,62,62,0,1,0,1,0
57478,7302,0,0,66,66,0,1,0,1,0
193,64220,0,0,87,87,0,1,0,1,0
24036,35440,0,0,62,62,0,1,0,1,0
58638,5900,0,0,62,62,0,1,0,1,0
6855,42600,0,0,83,83,0,1,0,1,0
3999,36749,0,0,62,62,0,1,0,1,0
12471,35440,0,0,63,63,0,1,0,1,0
22587,48817,0,0,79,79,0,1,0,1,0
58238,23,0,0,60,60,0,1,0,1,0
63521,48817,0,0,77,77,0,1,0,1,0
16806,7,0,0,61,61,0,1,0,1,0
65301,11392,0,0,64,64,0,1,0,1,0
62187,64147,0,0,62,62,0,1,0,1,0
58638,5900,0,0,62,62,0,1,0,1,0
16376,35440,0,0,124,124,0,1,0,1,0
41993,33,0,0,69,69,0,1,0,1,0
3305,35377,0,0,66,66,0,1,0,1,0
54119,36829,0,0,65,65,0,1,0,1,0
33280,37965,0,0,62,62,0,1,0,1,0
5160,50479,0,0,62,62,0,1,0,1,0
42367,22,0,0,60,60,0,1,0,1,0
3895,25174,0,0,128,128,0,1,0,1,0
64623,26467,0,0,62,62,0,1,0,1,0
17249,22114,0,0,62,62,0,1,0,1,0
62401,56205,0,0,66,66,0,1,0,1,0
52321,26467,0,0,62,62,0,1,0,1,0
54886,60043,0,0,62,62,0,1,0,1,0
443,50238,0,0,331,331,0,1,0,1,0
51925,44847,0,0,65,65,0,1,0,1,0
53300,37807,0,0,66,66,0,1,0,1,0
64923,25174,0,0,66,66,0,1,0,1,0
23182,50584,0,0,120,120,0,1,0,1,0
43129,15503,0,0,62,62,0,1,0,1,0
46376,35440,0,0,66,66,0,1,0,1,0
56975,26467,0,0,62,62,0,1,0,1,0
51474,50584,0,0,66,66,0,1,0,1,0
337,37085,0,0,521,521,0,1,0,1,0
20110,35440,0,0,62,62,0,1,0,1,0
26882,50281,0,0,62,62,0,1,0,1,0
19290,1974,0,0,79,79,0,1,0,1,0
49441,44847,0,0,66,66,0,1,0,1,0
57793,37807,0,0,66,66,0,1,0,1,0
57987,56125,0,0,90,90,0,1,0,1,0
51534,44847,0,0,62,62,0,1,0,1,0
55369,26467,0,0,62,62,0,1,0,1,0
54305,39004,0,0,62,62,0,1,0,1,0
6888,45188,0,0,152,152,0,1,0,1,0
41723,50584,0,0,142,142,0,1,0,1,0
52943,44847,0,0,62,62,0,1,0,1,0
52938,44847,0,0,62,62,0,1,0,1,0
51745,57470,0,0,89,89,0,1,0,1,0
18913,56323,0,0,71,71,0,1,0,1,0
52782,25174,0,0,66,66,0,1,0,1,0
51686,26467,0,0,62,62,0,1,0,1,0
47092,64147,0,0,62,62,0,1,0,1,0
7071,30218,0,0,146,146,0,1,0,1,0
2938,64147,0,0,62,62,0,1,0,1,0
3375,35253,0,0,62,62,0,1,0,1,0
42407,55926,0,0,61,61,0,1,0,1,0
55351,22114,0,0,63,63,0,1,0,1,0
58638,5900,0,0,62,62,0,1,0,1,0
52247,22114,0,0,90,90,0,1,0,1,0
58638,5900,0,0,62,62,0,1,0,1,0
28160,64147,0,0,62,62,0,1,0,1,0
26166,1821,0,0,98,98,0,1,0,1,0
58638,5900,0,0,62,62,0,1,0,1,0
9504,25174,0,0,62,62,0,1,0,1,0
53059,24082,0,0,66,66,0,1,0,1,0
16040,22,0,0,60,60,0,1,0,1,0
22973,22114,0,0,118,118,0,1,0,1,0
27869,51221,0,0,66,66,0,1,0,1,0
58638,5900,0,0,62,62,0,1,0,1,0
57131,31061,0,0,145,145,0,1,0,1,0
1866,51505,0,0,65,65,0,1,0,1,0
49300,11292,0,0,92,92,0,1,0,1,0
51164,64147,0,0,65,65,0,1,0,1,0
24173,37813,0,0,62,62,0,1,0,1,0
42542,25174,0,0,107,107,0,1,0,1,0
26184,30188,0,0,84,84,0,1,0,1,0
10390,26467,0,0,66,66,0,1,0,1,0
54631,44847,0,0,73,73,0,1,0,1,0
58638,5900,0,0,62,62,0,1,0,1,0
35953,48141,0,0,112,112,0,1,0,1,0
64539,64147,0,0,66,66,0,1,0,1,0
51285,11392,0,0,65,65,0,1,0,1,0
9518,2323,0,0,60,60,0,1,0,1,0
64341,57470,0,0,62,62,0,1,0,1,0
8023,29713,0,0,119,119,0,1,0,1,0
62895,9426,0,0,64,64,0,1,0,1,0
10477,57470,0,0,62,62,0,1,0,1,0
2849,30188,0,0,63,63,0,1,0,1,0
9909,32502,0,0,69,69,0,1,0,1,0
17414,25174,0,0,62,62,0,1,0,1,0
50375,48817,0,0,134,134,0,1,0,1,0
56381,51505,0,0,62,62,0,1,0,1,0
63786,25174,0,0,66,66,0,1,0,1,0
23964,35440,0,0,62,62,0,1,0,1,0
22710,30188,0,0,62,62,0,1,0,1,0
43813,44847,0,0,62,62,0,1,0,1,0
39624,18485,0,0,63,63,0,1,0,1,0
863,54411,0,0,68,68,0,1,0,1,0
63463,46812,0,0,65,65,0,1,0,1,0
57606,64147,0,0,64,64,0,1,0,1,0
56127,37965,0,0,62,62,0,1,0,1,0
35508,22,0,0,60,60,0,1,0,1,0
52874,37848,0,0,63,63,0,1,0,1,0
19837,64147,0,0,62,62,0,1,0,1,0
61820,42873,0,0,66,66,0,1,0,1,0
21199,5899,0,0,147,147,0,1,0,1,0
23936,41615,0,0,145,145,0,1,0,1,0
43584,24748,0,0,156,156,0,1,0,1,0
49762,5900,0,0,60,60,0,1,0,1,0
7445,57470,0,0,66,66,0,1,0,1,0
50474,61464,0,0,85,85,0,1,0,1,0
51246,48685,0,0,70,70,0,1,0,1,0
42231,57470,0,0,78,78,0,1,0,1,0
50806,51505,0,0,66,66,0,1,0,1,0
10466,25174,0,0,146,146,0,1,0,1,0
37429,25174,0,0,72,72,0,1,0,1,0
50927,44847,0,0,134,134,0,1,0,1,0
60579,51505,0,0,63,63,0,1,0,1,0
26801,44847,0,0,62,62,0,1,0,1,0
61604,22114,0,0,62,62,0,1,0,1,0
62001,22114,0,0,66,66,0,1,0,1,0
54785,30188,0,0,66,66,0,1,0,1,0
63840,35440,0,0,66,66,0,1,0,1,0
18650,44828,0,0,65,65,0,1,0,1,0
51307,1211,0,0,60,60,0,1,0,1,0
45065,20,0,0,60,60,0,1,0,1,0
46670,8856,0,0,64,64,0,1,0,1,0
998,58083,0,0,120,120,0,1,0,1,0
58638,5900,0,0,62,62,0,1,0,1,0
53107,25174,0,0,64,64,0,1,0,1,0
48515,21517,0,0,121,121,0,1,0,1,0
53085,25174,0,0,63,63,0,1,0,1,0
62847,51221,0,0,66,66,0,1,0,1,0
64427,57470,0,0,63,63,0,1,0,1,0
52024,25174,0,0,65,65,0,1,0,1,0
1026,25174,0,0,146,146,0,1,0,1,0
37937,22133,0,0,65,65,0,1,0,1,0
33453,64147,0,0,62,62,0,1,0,1,0
10474,45025,0,0,62,62,0,1,0,1,0
17315,11392,0,0,66,66,0,1,0,1,0
6057,51221,0,0,78,78,0,1,0,1,0
50280,57470,0,0,78,78,0,1,0,1,0
57131,8055,0,0,145,145,0,1,0,1,0
30573,25174,0,0,65,65,0,1,0,1,0
27038,51505,0,0,109,109,0,1,0,1,0
2922,37965,0,0,62,62,0,1,0,1,0
58338,3360,0,0,60,60,0,1,0,1,0
4471,23,0,0,60,60,0,1,0,1,0
33768,25174,0,0,62,62,0,1,0,1,0
43671,17372,0,0,62,62,0,1,0,1,0
56125,37965,0,0,65,65,0,1,0,1,0
55455,8,0,0,63,63,0,1,0,1,0
42083,41615,0,0,150,150,0,1,0,1,0
58656,64136,0,0,62,62,0,1,0,1,0
57131,31061,0,0,145,145,0,1,0,1,0
58638,5900,0,0,62,62,0,1,0,1,0
45941,23388,0,0,60,60,0,1,0,1,0
56357,62413,0,0,64,64,0,1,0,1,0
63660,11392,0,0,91,91,0,1,0,1,0
52789,9659,0,0,122,122,0,1,0,1,0
1026,35445,0,0,79,79,0,1,0,1,0
52232,52,0,0,70,70,0,1,0,1,0
23936,35440,0,0,62,62,0,1,0,1,0
16387,16862,0,0,60,60,0,1,0,1,0
59095,57470,0,0,66,66,0,1,0,1,0
1062,26467,0,0,62,62,0,1,0,1,0
443,54468,0,0,79,79,0,1,0,1,0
58638,5900,0,0,62,62,0,1,0,1,0
56116,36237,0,0,62,62,0,1,0,1,0
22637,10143,0,0,66,66,0,1,0,1,0
31727,57470,0,0,62,62,0,1,0,1,0
59781,56205,0,0,66,66,0,1,0,1,0
26372,22114,0,0,62,62,0,1,0,1,0
8996,42856,0,0,143,143,0,1,0,1,0
55989,25174,0,0,62,62,0,1,0,1,0
61421,17496,0,0,66,66,0,1,0,1,0
52144,1433,0,0,60,60,0,1,0,1,0
25203,58002,0,0,62,62,0,1,0,1,0
10250,21247,0,0,136,136,0,1,0,1,0
54758,35993,0,0,66,66,0,1,0,1,0
1828,64147,0,0,64,64,0,1,0,1,0
60160,22114,0,0,62,62,0,1,0,1,0
44536,50584,0,0,62,62,0,1,0,1,0
30719,51365,0,0,66,66,0,1,0,1,0
7052,57470,0,0,103,103,0,1,0,1,0
3478,61463,0,0,225,225,0,1,0,1,0
59668,51505,0,0,62,62,0,1,0,1,0
50037,44847,0,0,69,69,0,1,0,1,0
37278,55765,0,0,96,96,0,1,0,1,0
5345,32502,0,0,66,66,0,1,0,1,0
32553,9055,0,0,83,83,0,1,0,1,0
64559,35440,0,0,64,64,0,1,0,1,0
54517,37807,0,0,66,66,0,1,0,1,0
1163,25174,0,0,62,62,0,1,0,1,0
56124,37965,0,0,64,64,0,1,0,1,0
25182,48823,0,0,65,65,0,1,0,1,0
42632,44847,0,0,62,62,0,1,0,1,0
42231,57470,0,0,78,78,0,1,0,1,0
49110,11189,0,0,124,124,0,1,0,1,0
47837,25174,0,0,62,62,0,1,0,1,0
57462,25174,0,0,81,81,0,1,0,1,0
9979,25174,0,0,62,62,0,1,0,1,0
64335,57470,0,0,73,73,0,1,0,1,0
9522,51505,0,0,66,66,0,1,0,1,0
21613,19602,0,0,71,71,0,1,0,1,0
54517,35440,0,0,65,65,0,1,0,1,0
57097,44847,0,0,62,62,0,1,0,1,0
16319,44847,0,0,83,83,0,1,0,1,0
16387,35244,0,0,60,60,0,1,0,1,0
58497,39004,0,0,66,66,0,1,0,1,0
2170,22114,0,0,146,146,0,1,0,1,0
55408,22114,0,0,94,94,0,1,0,1,0
54008,25174,0,0,63,63,0,1,0,1,0
35250,43219,0,0,62,62,0,1,0,1,0
58638,5900,0,0,62,62,0,1,0,1,0
20399,64147,0,0,62,62,0,1,0,1,0
43485,34957,0,0,106,106,0,1,0,1,0
443,62451,0,0,199,199,0,1,0,1,0
35779,48279,0,0,61,61,0,1,0,1,0
10350,42712,0,0,62,62,0,1,0,1,0
23803,37899,0,0,62,62,0,1,0,1,0
45941,23386,0,0,60,60,0,1,0,1,0
52177,25320,0,0,66,66,0,1,0,1,0
63061,22114,0,0,64,64,0,1,0,1,0
3478,61463,0,0,1298,1298,0,1,0,1,0
16433,35682,0,0,60,60,0,1,0,1,0
26048,21,0,0,60,60,0,1,0,1,0
6881,6881,0,0,146,146,0,1,0,1,0
56124,37965,0,0,64,64,0,1,0,1,0
14779,58364,0,0,65,65,0,1,0,1,0
59696,57470,0,0,62,62,0,1,0,1,0
52759,57711,0,0,62,62,0,1,0,1,0
45964,3111,0,0,60,60,0,1,0,1,0
53012,51050,0,0,64,64,0,1,0,1,0
42745,50011,0,0,62,62,0,1,0,1,0
42931,44496,0,0,64,64,0,1,0,1,0
61436,21247,0,0,62,62,0,1,0,1,0
11702,37965,0,0,78,78,0,1,0,1,0
60857,50584,0,0,64,64,0,1,0,1,0
40534,57470,0,0,73,73,0,1,0,1,0
60188,15503,0,0,64,64,0,1,0,1,0
47950,7469,0,0,60,60,0,1,0,1,0
51392,14938,0,0,125,125,0,1,0,1,0
6805,99,0,0,82,82,0,1,0,1,0
11831,15503,0,0,62,62,0,1,0,1,0
56327,44512,0,0,66,66,0,1,0,1,0
64878,26467,0,0,62,62,0,1,0,1,0
51475,9665,0,0,66,66,0,1,0,1,0
45079,31573,0,0,66,66,0,1,0,1,0
53135,25174,0,0,62,62,0,1,0,1,0
33204,29475,0,0,64,64,0,1,0,1,0
51781,35440,0,0,66,66,0,1,0,1,0
52154,39066,0,0,66,66,0,1,0,1,0
55144,30188,0,0,66,66,0,1,0,1,0
58638,5900,0,0,62,62,0,1,0,1,0
29145,8168,0,0,62,62,0,1,0,1,0
56123,37965,0,0,64,64,0,1,0,1,0
64318,2603,0,0,93,93,0,1,0,1,0
57762,25174,0,0,69,69,0,1,0,1,0
58638,5900,0,0,62,62,0,1,0,1,0
55260,50584,0,0,66,66,0,1,0,1,0
6920,4668,0,0,99,99,0,1,0,1,0
41999,28088,0,0,62,62,0,1,0,1,0
45941,23386,0,0,60,60,0,1,0,1,0
48025,44847,0,0,62,62,0,1,0,1,0
16392,22115,0,0,61,61,0,1,0,1,0
64543,50265,0,0,66,66,0,1,0,1,0
23524,57678,0,0,145,145,0,1,0,1,0
13285,29892,0,0,145,145,0,1,0,1,0
62785,62413,0,0,135,135,0,1,0,1,0
17097,62413,0,0,62,62,0,1,0,1,0
4111,25174,0,0,70,70,0,1,0,1,0
56559,37965,0,0,65,65,0,1,0,1,0
58638,5900,0,0,62,62,0,1,0,1,0
19870,64147,0,0,62,62,0,1,0,1,0
1035,26467,0,0,62,62,0,1,0,1,0
61616,37965,0,0,66,66,0,1,0,1,0
7467,57470,0,0,66,66,0,1,0,1,0
50668,58833,0,0,66,66,0,1,0,1,0
57236,53733,0,0,64,64,0,1,0,1,0
54616,44847,0,0,69,69,0,1,0,1,0
55134,39004,0,0,66,66,0,1,0,1,0
3064,44847,0,0,62,62,0,1,0,1,0
55496,57470,0,0,68,68,0,1,0,1,0
16379,35397,0,0,61,61,0,1,0,1,0
26253,37965,0,0,66,66,0,1,0,1,0
52974,30188,0,0,66,66,0,1,0,1,0
52814,35440,0,0,65,65,0,1,0,1,0
16149,37807,0,0,63,63,0,1,0,1,0
50949,45960,0,0,62,62,0,1,0,1,0
43244,10843,0,0,109,109,0,1,0,1,0
46534,57470,0,0,63,63,0,1,0,1,0
443,38957,0,0,81,81,0,1,0,1,0
10269,21247,0,0,65,65,0,1,0,1,0
443,10010,0,0,60,60,0,1,0,1,0
28875,51505,0,0,70,70,0,1,0,1,0
23274,50584,0,0,103,103,0,1,0,1,0
44849,46478,0,0,74,74,0,1,0,1,0
39231,53733,0,0,146,146,0,1,0,1,0
56582,23718,0,0,63,63,0,1,0,1,0
37027,25174,0,0,62,62,0,1,0,1,0
38641,25174,0,0,65,65,0,1,0,1,0
58539,9347,0,0,61,61,0,1,0,1,0
61961,11392,0,0,66,66,0,1,0,1,0
62143,50584,0,0,62,62,0,1,0,1,0
45964,3111,0,0,60,60,0,1,0,1,0
24270,57470,0,0,62,62,0,1,0,1,0
42531,1209,0,0,60,60,0,1,0,1,0
53928,15503,0,0,62,62,0,1,0,1,0
19617,39004,0,0,79,79,0,1,0,1,0
15812,37876,0,0,146,146,0,1,0,1,0
16930,11178,0,0,130,130,0,1,0,1,0
59941,37852,0,0,122,122,0,1,0,1,0
64891,26467,0,0,62,62,0,1,0,1,0
29871,25174,0,0,143,143,0,1,0,1,0
64786,35440,0,0,65,65,0,1,0,1,0
56582,25174,0,0,66,66,0,1,0,1,0
45908,33330,0,0,60,60,0,1,0,1,0
56862,22114,0,0,63,63,0,1,0,1,0
54204,56205,0,0,65,65,0,1,0,1,0
58638,5900,0,0,62,62,0,1,0,1,0
27505,25174,0,0,62,62,0,1,0,1,0
1034,64147,0,0,62,62,0,1,0,1,0
34864,25174,0,0,62,62,0,1,0,1,0
24967,64147,0,0,66,66,0,1,0,1,0
61167,22114,0,0,66,66,0,1,0,1,0
45908,3383,0,0,60,60,0,1,0,1,0
8008,50584,0,0,62,62,0,1,0,1,0
7227,63865,0,0,80,80,0,1,0,1,0
50870,26467,0,0,66,66,0,1,0,1,0
55940,54749,0,0,71,71,0,1,0,1,0
29124,44847,0,0,62,62,0,1,0,1,0
55124,44512,0,0,62,62,0,1,0,1,0
59771,25174,0,0,64,64,0,1,0,1,0
56227,51505,0,0,98,98,0,1,0,1,0
35790,26487,0,0,83,83,0,1,0,1,0
1159,53796,0,0,61,61,0,1,0,1,0
59857,44847,0,0,66,66,0,1,0,1,0
12876,37965,0,0,66,66,0,1,0,1,0
43044,57470,0,0,62,62,0,1,0,1,0
53282,22114,0,0,66,66,0,1,0,1,0
17777,30188,0,0,62,62,0,1,0,1,0
51903,26467,0,0,62,62,0,1,0,1,0
48348,50584,0,0,99,99,0,1,0,1,0
53756,50584,0,0,63,63,0,1,0,1,0
51999,37965,0,0,62,62,0,1,0,1,0
58638,5900,0,0,62,62,0,1,0,1,0
57090,51505,0,0,66,66,0,1,0,1,0
53073,32468,0,0,65,65,0,1,0,1,0
41309,50584,0,0,126,126,0,1,0,1,0
54762,50584,0,0,126,126,0,1,0,1,0
64727,25174,0,0,66,66,0,1,0,1,0
63508,62413,0,0,66,66,0,1,0,1,0
43568,48806,0,0,129,129,0,1,0,1,0
1018,49059,0,0,97,97,0,1,0,1,0
50668,35440,0,0,130,130,0,1,0,1,0
59772,62413,0,0,66,66,0,1,0,1,0
10957,51505,0,0,64,64,0,1,0,1,0
16506,55625,0,0,63,63,0,1,0,1,0
43282,50584,0,0,77,77,0,1,0,1,0
3056,64147,0,0,62,62,0,1,0,1,0
60443,22114,0,0,66,66,0,1,0,1,0
64340,57470,0,0,62,62,0,1,0,1,0
46858,25174,0,0,137,137,0,1,0,1,0
45048,50584,0,0,62,62,0,1,0,1,0
37959,3855,0,0,72,72,0,1,0,1,0
23106,50584,0,0,99,99,0,1,0,1,0
59437,50584,0,0,64,64,0,1,0,1,0
7193,51360,0,0,64,64,0,1,0,1,0
56299,26467,0,0,66,66,0,1,0,1,0
61795,56205,0,0,62,62,0,1,0,1,0
26207,10590,0,0,132,132,0,1,0,1,0
57277,37965,0,0,62,62,0,1,0,1,0
50758,57470,0,0,66,66,0,1,0,1,0
2024,35440,0,0,65,65,0,1,0,1,0
3478,61463,0,0,905,905,0,1,0,1,0
58638,5900,0,0,62,62,0,1,0,1,0
60585,51153,0,0,62,62,0,1,0,1,0
30337,25174,0,0,62,62,0,1,0,1,0
64872,31981,0,0,66,66,0,1,0,1,0
42328,30188,0,0,129,129,0,1,0,1,0
5040,63086,0,0,85,85,0,1,0,1,0
41428,23,0,0,60,60,0,1,0,1,0
50366,62413,0,0,91,91,0,1,0,1,0
51533,44847,0,0,65,65,0,1,0,1,0
5220,58945,0,0,66,66,0,1,0,1,0
80,9918,0,0,60,60,0,1,0,1,0
56237,22114,0,0,82,82,0,1,0,1,0
443,46208,0,0,66,66,0,1,0,1,0
52605,30188,0,0,63,63,0,1,0,1,0
57951,44847,0,0,65,65,0,1,0,1,0
60200,64147,0,0,62,62,0,1,0,1,0
64134,22114,0,0,64,64,0,1,0,1,0
58807,15503,0,0,66,66,0,1,0,1,0
26456,26348,0,0,65,65,0,1,0,1,0
62884,9421,0,0,64,64,0,1,0,1,0
13527,51505,0,0,62,62,0,1,0,1,0
57987,56125,0,0,90,90,0,1,0,1,0
30280,37965,0,0,66,66,0,1,0,1,0
49485,11392,0,0,64,64,0,1,0,1,0
1926,43831,0,0,62,62,0,1,0,1,0
35555,22114,0,0,62,62,0,1,0,1,0
30134,37965,0,0,62,62,0,1,0,1,0
58638,5900,0,0,62,62,0,1,0,1,0
58638,5900,0,0,62,62,0,1,0,1,0
31712,51444,0,0,62,62,0,1,0,1,0
6881,45670,0,0,104,104,0,1,0,1,0
60074,25178,0,0,80,80,0,1,0,1,0
53315,37807,0,0,65,65,0,1,0,1,0
60084,25174,0,0,66,66,0,1,0,1,0
39693,17752,0,0,65,65,0,1,0,1,0
1033,57470,0,0,70,70,0,1,0,1,0
17546,32182,0,0,64,64,0,1,0,1,0
1974,35874,0,0,61,61,0,1,0,1,0
24286,23,0,0,60,60,0,1,0,1,0
45941,23386,0,0,60,60,0,1,0,1,0
58638,5900,0,0,62,62,0,1,0,1,0
62068,64147,0,0,66,66,0,1,0,1,0
63398,25174,0,0,66,66,0,1,0,1,0
19004,51505,0,0,66,66,0,1,0,1,0
1865,25174,0,0,62,62,0,1,0,1,0
53779,51505,0,0,66,66,0,1,0,1,0
58638,5900,0,0,62,62,0,1,0,1,0
51595,34443,0,0,132,132,0,1,0,1,0
21575,23718,0,0,62,62,0,1,0,1,0
26579,57470,0,0,62,62,0,1,0,1,0
58062,51505,0,0,134,134,0,1,0,1,0
43986,22,0,0,60,60,0,1,0,1,0
29656,26467,0,0,62,62,0,1,0,1,0
45352,64147,0,0,70,70,0,1,0,1,0
52993,57625,0,0,102,102,0,1,0,1,0
50497,46585,0,0,64,64,0,1,0,1,0
7461,57470,0,0,66,66,0,1,0,1,0
58318,35503,0,0,66,66,0,1,0,1,0
58472,11392,0,0,66,66,0,1,0,1,0
57720,50584,0,0,64,64,0,1,0,1,0
58638,5900,0,0,62,62,0,1,0,1,0
18118,25174,0,0,62,62,0,1,0,1,0
27925,22114,0,0,62,62,0,1,0,1,0
14616,64147,0,0,65,65,0,1,0,1,0
8968,29508,0,0,135,135,0,1,0,1,0
64811,51221,0,0,66,66,0,1,0,1,0
62386,37965,0,0,62,62,0,1,0,1,0
1025,57706,0,0,116,116,0,1,0,1,0
63775,50584,0,0,141,141,0,1,0,1,0
3117,37965,0,0,62,62,0,1,0,1,0
58638,5900,0,0,62,62,0,1,0,1,0
58638,5900,0,0,62,62,0,1,0,1,0
31736,15503,0,0,64,64,0,1,0,1,0
62262,44847,0,0,66,66,0,1,0,1,0
27401,37965,0,0,66,66,0,1,0,1,0
16387,56995,0,0,60,60,0,1,0,1,0
6921,10452,0,0,119,119,0,1,0,1,0
19318,25174,0,0,146,146,0,1,0,1,0
40343,8678,0,0,60,60,0,1,0,1,0
53870,31573,0,0,66,66,0,1,0,1,0
55855,62413,0,0,66,66,0,1,0,1,0
52366,22114,0,0,64,64,0,1,0,1,0
30852,22,0,0,60,60,0,1,0,1,0
56091,21,0,0,66,66,0,1,0,1,0
41917,35440,0,0,62,62,0,1,0,1,0
1349,12312,0,0,66,66,0,1,0,1,0
43789,22114,0,0,62,62,0,1,0,1,0
16283,50584,0,0,62,62,0,1,0,1,0
50562,37965,0,0,66,66,0,1,0,1,0
24271,52700,0,0,66,66,0,1,0,1,0
56711,25174,0,0,62,62,0,1,0,1,0
61500,37965,0,0,66,66,0,1,0,1,0
40447,2893,0,0,62,62,0,1,0,1,0
47133,8497,0,0,125,125,0,1,0,1,0
45908,33330,0,0,60,60,0,1,0,1,0
63385,25174,0,0,66,66,0,1,0,1,0
26448,9192,0,0,145,145,0,1,0,1,0
4233,35440,0,0,62,62,0,1,0,1,0
54728,37965,0,0,62,62,0,1,0,1,0
47252,50584,0,0,121,121,0,1,0,1,0
6451,37965,0,0,62,62,0,1,0,1,0
4028,50584,0,0,64,64,0,1,0,1,0
37462,25174,0,0,64,64,0,1,0,1,0
62187,37874,0,0,64,64,0,1,0,1,0
32717,22114,0,0,63,63,0,1,0,1,0
48085,7523,0,0,60,60,0,1,0,1,0
52576,30188,0,0,66,66,0,1,0,1,0
61973,25174,0,0,62,62,0,1,0,1,0
65379,51221,0,0,72,72,0,1,0,1,0
2533,30188,0,0,62,62,0,1,0,1,0
13580,15540,0,0,62,62,0,1,0,1,0
41220,59356,0,0,62,62,0,1,0,1,0
48676,53395,0,0,60,60,0,1,0,1,0
58638,5900,0,0,62,62,0,1,0,1,0
52848,37965,0,0,66,66,0,1,0,1,0
3401,11392,0,0,65,65,0,1,0,1,0
58009,47701,0,0,64,64,0,1,0,1,0
58638,5900,0,0,62,62,0,1,0,1,0
44115,32052,0,0,126,126,0,1,0,1,0
41751,59799,0,0,62,62,0,1,0,1,0
52397,64147,0,0,63,63,0,1,0,1,0
9677,57476,0,0,79,79,0,1,0,1,0
2522,64147,0,0,62,62,0,1,0,1,0
64318,37965,0,0,71,71,0,1,0,1,0
25711,19053,0,0,60,60,0,1,0,1,0
443,9887,0,0,60,60,0,1,0,1,0
16387,22337,0,0,60,60,0,1,0,1,0
25759,2318,0,0,89,89,0,1,0,1,0
35834,4,0,0,131,131,0,1,0,1,0
62042,22114,0,0,66,66,0,1,0,1,0
10078,10644,0,0,63,63,0,1,0,1,0
63461,51505,0,0,66,66,0,1,0,1,0
18769,57816,0,0,62,62,0,1,0,1,0
59066,35440,0,0,65,65,0,1,0,1,0
0,0,0,0,98,98,0,1,0,1,0
45964,5333,0,0,60,60,0,1,0,1,0
50694,35440,0,0,62,62,0,1,0,1,0
41789,2009,0,0,60,60,0,1,0,1,0
13285,29892,0,0,145,145,0,1,0,1,0
48478,49903,0,0,62,62,0,1,0,1,0
55430,25174,0,0,65,65,0,1,0,1,0
45211,25174,0,0,69,69,0,1,0,1,0
51318,37965,0,0,62,62,0,1,0,1,0
38741,51505,0,0,92,92,0,1,0,1,0
29641,36237,0,0,111,111,0,1,0,1,0
49415,22114,0,0,63,63,0,1,0,1,0
58829,64147,0,0,63,63,0,1,0,1,0
63799,26467,0,0,64,64,0,1,0,1,0
55032,62413,0,0,66,66,0,1,0,1,0
52709,36441,0,0,66,66,0,1,0,1,0
24159,57470,0,0,62,62,0,1,0,1,0
55508,64147,0,0,62,62,0,1,0,1,0
19330,25174,0,0,125,125,0,1,0,1,0
42771,56144,0,0,74,74,0,1,0,1,0
43076,31751,0,0,138,138,0,1,0,1,0
59424,50265,0,0,72,72,0,1,0,1,0
64915,44364,0,0,66,66,0,1,0,1,0
6057,51221,0,0,78,78,0,1,0,1,0
7093,23,0,0,60,60,0,1,0,1,0
62709,57470,0,0,62,62,0,1,0,1,0
33543,44847,0,0,65,65,0,1,0,1,0
1035,64147,0,0,144,144,0,1,0,1,0
29016,25174,0,0,100,100,0,1,0,1,0
11136,57587,0,0,62,62,0,1,0,1,0
1832,64147,0,0,64,64,0,1,0,1,0
27062,25174,0,0,62,62,0,1,0,1,0
18314,51655,0,0,65,65,0,1,0,1,0
36902,56205,0,0,145,145,0,1,0,1,0
6881,6881,0,0,62,62,0,1,0,1,0
16387,7853,0,0,60,60,0,1,0,1,0
38852,37965,0,0,62,62,0,1,0,1,0
38069,10803,0,0,100,100,0,1,0,1,0
64636,50584,0,0,66,66,0,1,0,1,0
2587,6963,0,0,66,66,0,1,0,1,0
49416,22114,0,0,64,64,0,1,0,1,0
60180,46781,0,0,66,66,0,1,0,1,0
53365,36237,0,0,64,64,0,1,0,1,0
51045,25174,0,0,62,62,0,1,0,1,0
51996,57470,0,0,66,66,0,1,0,1,0
5222,21217,0,0,65,65,0,1,0,1,0
38903,47091,0,0,61,61,0,1,0,1,0
14309,56205,0,0,62,62,0,1,0,1,0
1015,57969,0,0,140,140,0,1,0,1,0
59037,28309,0,0,62,62,0,1,0,1,0
62841,39,0,0,76,76,0,1,0,1,0
61550,5529,0,0,145,145,0,1,0,1,0
16387,7205,0,0,60,60,0,1,0,1,0
34851,15503,0,0,115,115,0,1,0,1,0
56937,22,0,0,60,60,0,1,0,1,0
37634,36237,0,0,62,62,0,1,0,1,0
58638,5900,0,0,62,62,0,1,0,1,0
7019,55947,0,0,122,122,0,1,0,1,0
63344,37942,0,0,66,66,0,1,0,1,0
25664,27284,0,0,61,61,0,1,0,1,0
45941,23388,0,0,60,60,0,1,0,1,0
49001,48920,0,0,160,160,0,1,0,1,0
61443,50584,0,0,83,83,0,1,0,1,0
33151,50510,0,0,81,81,0,1,0,1,0
48478,49903,0,0,62,62,0,1,0,1,0
55893,64130,0,0,64,64,0,1,0,1,0
58161,57470,0,0,66,66,0,1,0,1,0
25901,50265,0,0,62,62,0,1,0,1,0
57868,57470,0,0,66,66,0,1,0,1,0
1025,64147,0,0,62,62,0,1,0,1,0
19440,25174,0,0,146,146,0,1,0,1,0
51177,30188,0,0,65,65,0,1,0,1,0
60194,37965,0,0,66,66,0,1,0,1,0
55405,64147,0,0,66,66,0,1,0,1,0
7765,23,0,0,60,60,0,1,0,1,0
17579,57470,0,0,62,62,0,1,0,1,0
7222,57470,0,0,62,62,0,1,0,1,0
10907,22114,0,0,84,84,0,1,0,1,0
41323,50584,0,0,119,119,0,1,0,1,0
55289,37965,0,0,66,66,0,1,0,1,0
61899,50568,0,0,74,74,0,1,0,1,0
41732,57470,0,0,62,62,0,1,0,1,0
64993,22114,0,0,62,62,0,1,0,1,0
52744,25174,0,0,63,63,0,1,0,1,0
58638,5900,0,0,62,62,0,1,0,1,0
30746,51425,0,0,64,64,0,1,0,1,0
52206,201,0,0,62,62,0,1,0,1,0
37049,48945,0,0,137,137,0,1,0,1,0
0,0,0,0,98,98,0,1,0,1,0
25089,64147,0,0,65,65,0,1,0,1,0
10477,44847,0,0,62,62,0,1,0,1,0
24455,50584,0,0,62,62,0,1,0,1,0
46836,51050,0,0,62,62,0,1,0,1,0
62804,37965,0,0,64,64,0,1,0,1,0
57093,64125,0,0,62,62,0,1,0,1,0
51414,22,0,0,60,60,0,1,0,1,0
50877,50584,0,0,66,66,0,1,0,1,0
5626,35440,0,0,65,65,0,1,0,1,0
23519,25174,0,0,131,131,0,1,0,1,0
53495,37807,0,0,66,66,0,1,0,1,0
41351,64147,0,0,91,91,0,1,0,1,0
52683,22056,0,0,62,62,0,1,0,1,0
58638,5900,0,0,62,62,0,1,0,1,0
1054,15503,0,0,62,62,0,1,0,1,0
35423,20238,0,0,62,62,0,1,0,1,0
25245,2049,0,0,60,60,0,1,0,1,0
56636,43890,0,0,66,66,0,1,0,1,0
13696,2598,0,0,113,113,0,1,0,1,0
50470,61463,0,0,86,86,0,1,0,1,0
9678,23,0,0,60,60,0,1,0,1,0
25485,38228,0,0,60,60,0,1,0,1,0
0,0,0,0,98,98,0,1,0,1,0
1943,48817,0,0,62,62,0,1,0,1,0
15329,51505,0,0,66,66,0,1,0,1,0
50052,65008,0,0,60,60,0,1,0,1,0
40775,57470,0,0,62,62,0,1,0,1,0
63494,25174,0,0,66,66,0,1,0,1,0
80,53945,0,0,60,60,0,1,0,1,0
27272,64147,0,0,62,62,0,1,0,1,0
37472,25174,0,0,64,64,0,1,0,1,0
23715,25174,0,0,73,73,0,1,0,1,0
63898,44847,0,0,62,62,0,1,0,1,0
23176,11191,0,0,125,125,0,1,0,1,0
2335,23117,0,0,136,136,0,1,0,1,0
65501,26467,0,0,63,63,0,1,0,1,0
40238,23,0,0,60,60,0,1,0,1,0
24206,22395,0,0,60,60,0,1,0,1,0
58638,5900,0,0,62,62,0,1,0,1,0
50052,65008,0,0,60,60,0,1,0,1,0
33886,39127,0,0,162,162,0,1,0,1,0
40956,29785,0,0,84,84,0,1,0,1,0
58638,5900,0,0,62,62,0,1,0,1,0
64675,64147,0,0,66,66,0,1,0,1,0
52971,44847,0,0,62,62,0,1,0,1,0
43711,50087,0,0,65,65,0,1,0,1,0
26658,25174,0,0,135,135,0,1,0,1,0
10669,49756,0,0,60,60,0,1,0,1,0
13364,57470,0,0,62,62,0,1,0,1,0
62654,35440,0,0,62,62,0,1,0,1,0
41347,25174,0,0,63,63,0,1,0,1,0
28941,37851,0,0,62,62,0,1,0,1,0
60322,30431,0,0,66,66,0,1,0,1,0
6881,6881,0,0,146,146,0,1,0,1,0
28965,37860,0,0,62,62,0,1,0,1,0
58638,5900,0,0,62,62,0,1,0,1,0
59782,57470,0,0,62,62,0,1,0,1,0
3142,2,0,0,61,61,0,1,0,1,0
63396,57866,0,0,62,62,0,1,0,1,0
61498,57470,0,0,66,66,0,1,0,1,0
17315,11392,0,0,62,62,0,1,0,1,0
31046,23,0,0,60,60,0,1,0,1,0
51455,53733,0,0,66,66,0,1,0,1,0
39959,23117,0,0,70,70,0,1,0,1,0
60321,46776,0,0,69,69,0,1,0,1,0
45724,3383,0,0,60,60,0,1,0,1,0
9002,30008,0,0,106,106,0,1,0,1,0
26060,21,0,0,60,60,0,1,0,1,0
57296,50584,0,0,65,65,0,1,0,1,0
57550,50584,0,0,66,66,0,1,0,1,0
50040,35725,0,0,147,147,0,1,0,1,0
58638,5900,0,0,62,62,0,1,0,1,0
60034,37965,0,0,66,66,0,1,0,1,0
2917,44847,0,0,72,72,0,1,0,1,0
61756,11392,0,0,66,66,0,1,0,1,0
53500,1,0,0,66,66,0,1,0,1,0
26189,37988,0,0,65,65,0,1,0,1,0
51830,56205,0,0,66,66,0,1,0,1,0
58638,5900,0,0,62,62,0,1,0,1,0
58309,21,0,0,60,60,0,1,0,1,0
53626,64147,0,0,66,66,0,1,0,1,0
40254,25174,0,0,102,102,0,1,0,1,0
22294,22114,0,0,62,62,0,1,0,1,0
58311,37965,0,0,65,65,0,1,0,1,0
59533,25174,0,0,132,132,0,1,0,1,0
22683,39210,0,0,60,60,0,1,0,1,0
22867,26467,0,0,62,62,0,1,0,1,0
10463,25174,0,0,119,119,0,1,0,1,0
45908,33330,0,0,60,60,0,1,0,1,0
26293,25174,0,0,66,66,0,1,0,1,0
21735,22114,0,0,62,62,0,1,0,1,0
53419,28189,0,0,60,60,0,1,0,1,0
1694,30188,0,0,62,62,0,1,0,1,0
55043,57470,0,0,78,78,0,1,0,1,0
29227,48946,0,0,149,149,0,1,0,1,0
52410,22114,0,0,62,62,0,1,0,1,0
50787,57470,0,0,66,66,0,1,0,1,0
52727,9628,0,0,62,62,0,1,0,1,0
62747,62413,0,0,65,65,0,1,0,1,0
49641,26467,0,0,85,85,0,1,0,1,0
43919,21,0,0,60,60,0,1,0,1,0
63147,37965,0,0,66,66,0,1,0,1,0
51875,37965,0,0,63,63,0,1,0,1,0
53642,56205,0,0,75,75,0,1,0,1,0
62943,50584,0,0,62,62,0,1,0,1,0
35441,15503,0,0,69,69,0,1,0,1,0
31942,55693,0,0,61,61,0,1,0,1,0
60204,2767,0,0,66,66,0,1,0,1,0
63331,37807,0,0,66,66,0,1,0,1,0
38737,37941,0,0,146,146,0,1,0,1,0
51960,26467,0,0,61,61,0,1,0,1,0
10198,30269,0,0,114,114,0,1,0,1,0
56390,21247,0,0,68,68,0,1,0,1,0
58638,5900,0,0,62,62,0,1,0,1,0
57337,64147,0,0,66,66,0,1,0,1,0
51582,37889,0,0,67,67,0,1,0,1,0
30617,30313,0,0,86,86,0,1,0,1,0
11136,57587,0,0,62,62,0,1,0,1,0
2636,11392,0,0,62,62,0,1,0,1,0
53971,50265,0,0,62,62,0,1,0,1,0
28697,35440,0,0,66,66,0,1,0,1,0
65192,56205,0,0,62,62,0,1,0,1,0
8239,37965,0,0,146,146,0,1,0,1,0
31525,30188,0,0,62,62,0,1,0,1,0
40117,23,0,0,60,60,0,1,0,1,0
62495,35765,0,0,66,66,0,1,0,1,0
27486,37965,0,0,64,64,0,1,0,1,0
2383,37965,0,0,63,63,0,1,0,1,0
50851,50584,0,0,66,66,0,1,0,1,0
54040,50265,0,0,66,66,0,1,0,1,0
50067,5900,0,0,60,60,0,1,0,1,0
10487,26497,0,0,61,61,0,1,0,1,0
10655,11392,0,0,62,62,0,1,0,1,0
18191,51826,0,0,62,62,0,1,0,1,0
14872,37965,0,0,62,62,0,1,0,1,0
49786,25174,0,0,66,66,0,1,0,1,0
443,18950,0,0,67,67,0,1,0,1,0
978,11427,0,0,62,62,0,1,0,1,0
52001,44529,0,0,66,66,0,1,0,1,0
53489,2,0,0,65,65,0,1,0,1,0
28513,64147,0,0,63,63,0,1,0,1,0
53691,5948,0,0,68,68,0,1,0,1,0
31979,42249,0,0,103,103,0,1,0,1,0
443,64347,0,0,73,73,0,1,0,1,0
63898,64147,0,0,64,64,0,1,0,1,0
57987,56125,0,0,90,90,0,1,0,1,0
58638,5900,0,0,62,62,0,1,0,1,0
0,0,0,0,98,98,0,1,0,1,0
12348,50265,0,0,62,62,0,1,0,1,0
28872,37965,0,0,62,62,0,1,0,1,0
59786,56205,0,0,66,66,0,1,0,1,0
41698,57470,0,0,64,64,0,1,0,1,0
9010,7273,0,0,92,92,0,1,0,1,0
17027,1,0,0,62,62,0,1,0,1,0
33651,23,0,0,60,60,0,1,0,1,0
58638,5900,0,0,62,62,0,1,0,1,0
37694,37965,0,0,64,64,0,1,0,1,0
35421,25174,0,0,123,123,0,1,0,1,0
58638,5900,0,0,62,62,0,1,0,1,0
28797,37965,0,0,62,62,0,1,0,1,0
1268,44847,0,0,64,64,0,1,0,1,0
63541,37965,0,0,65,65,0,1,0,1,0
628,25967,0,0,109,109,0,1,0,1,0
53539,44847,0,0,62,62,0,1,0,1,0
11136,15503,0,0,109,109,0,1,0,1,0
40070,23,0,0,60,60,0,1,0,1,0
53154,51221,0,0,68,68,0,1,0,1,0
58638,5900,0,0,62,62,0,1,0,1,0
52776,56205,0,0,114,114,0,1,0,1,0
61185,54532,0,0,62,62,0,1,0,1,0
14048,21759,0,0,146,146,0,1,0,1,0
49654,37965,0,0,71,71,0,1,0,1,0
58638,5900,0,0,62,62,0,1,0,1,0
64542,37965,0,0,66,66,0,1,0,1,0
58638,5900,0,0,62,62,0,1,0,1,0
16944,50584,0,0,85,85,0,1,0,1,0
64914,22,0,0,60,60,0,1,0,1,0
38712,15503,0,0,128,128,0,1,0,1,0
5834,22114,0,0,64,64,0,1,0,1,0
9448,57866,0,0,138,138,0,1,0,1,0
65086,44847,0,0,64,64,0,1,0,1,0
49260,22114,0,0,64,64,0,1,0,1,0
9283,57470,0,0,66,66,0,1,0,1,0
58369,11629,0,0,67,67,0,1,0,1,0
10669,49756,0,0,60,60,0,1,0,1,0
54593,51505,0,0,66,66,0,1,0,1,0
50560,26467,0,0,66,66,0,1,0,1,0
11347,57508,0,0,62,62,0,1,0,1,0
16376,35440,0,0,62,62,0,1,0,1,0
27272,64147,0,0,64,64,0,1,0,1,0
39797,36050,0,0,81,81,0,1,0,1,0
62549,64147,0,0,62,62,0,1,0,1,0
44147,64147,0,0,62,62,0,1,0,1,0
6927,35424,0,0,64,64,0,1,0,1,0
53587,62413,0,0,64,64,0,1,0,1,0
443,10004,0,0,81,81,0,1,0,1,0
20882,51396,0,0,62,62,0,1,0,1,0
30181,61689,0,0,62,62,0,1,0,1,0
54740,50584,0,0,65,65,0,1,0,1,0
8239,37965,0,0,146,146,0,1,0,1,0
60102,22114,0,0,62,62,0,1,0,1,0
23934,41615,0,0,145,145,0,1,0,1,0
6881,6881,0,0,146,146,0,1,0,1,0
48676,53392,0,0,60,60,0,1,0,1,0
53974,44729,0,0,64,64,0,1,0,1,0
28435,23,0,0,60,60,0,1,0,1,0
5685,35440,0,0,64,64,0,1,0,1,0
36369,51505,0,0,66,66,0,1,0,1,0
13970,42873,0,0,64,64,0,1,0,1,0
54206,25174,0,0,62,62,0,1,0,1,0
32796,37965,0,0,64,64,0,1,0,1,0
55985,44847,0,0,83,83,0,1,0,1,0
48103,44847,0,0,80,80,0,1,0,1,0
11123,17484,0,0,62,62,0,1,0,1,0
2919,37965,0,0,62,62,0,1,0,1,0
56724,9571,0,0,67,67,0,1,0,1,0
61550,5529,0,0,145,145,0,1,0,1,0
65262,44847,0,0,128,128,0,1,0,1,0
56688,25174,0,0,64,64,0,1,0,1,0
30409,57470,0,0,101,101,0,1,0,1,0
25320,39584,0,0,60,60,0,1,0,1,0
27684,36017,0,0,92,92,0,1,0,1,0
6857,51838,0,0,75,75,0,1,0,1,0
49929,26467,0,0,65,65,0,1,0,1,0
12249,51337,0,0,62,62,0,1,0,1,0
14906,37965,0,0,62,62,0,1,0,1,0
61733,37965,0,0,66,66,0,1,0,1,0
58638,5900,0,0,62,62,0,1,0,1,0
2028,43890,0,0,62,62,0,1,0,1,0
8999,57470,0,0,146,146,0,1,0,1,0
56199,55442,0,0,66,66,0,1,0,1,0
24929,25174,0,0,62,62,0,1,0,1,0
8907,16353,0,0,74,74,0,1,0,1,0
10379,22114,0,0,62,62,0,1,0,1,0
5685,35440,0,0,65,65,0,1,0,1,0
35499,15503,0,0,67,67,0,1,0,1,0
56342,15503,0,0,146,146,0,1,0,1,0
33222,29558,0,0,62,62,0,1,0,1,0
51234,30219,0,0,93,93,0,1,0,1,0
58638,5900,0,0,62,62,0,1,0,1,0
65200,44847,0,0,63,63,0,1,0,1,0
62400,44847,0,0,66,66,0,1,0,1,0
25523,35974,0,0,139,139,0,1,0,1,0
40275,26467,0,0,62,62,0,1,0,1,0
1006,23,0,0,60,60,0,1,0,1,0
24115,35440,0,0,62,62,0,1,0,1,0
23516,25174,0,0,66,66,0,1,0,1,0
58488,37965,0,0,62,62,0,1,0,1,0
23484,50584,0,0,63,63,0,1,0,1,0
27321,25174,0,0,96,96,0,1,0,1,0
20650,26467,0,0,64,64,0,1,0,1,0
59519,44847,0,0,66,66,0,1,0,1,0
59396,21247,0,0,66,66,0,1,0,1,0
41964,41,0,0,65,65,0,1,0,1,0
51420,51505,0,0,62,62,0,1,0,1,0
59430,50584,0,0,66,66,0,1,0,1,0
443,14591,0,0,131,131,0,1,0,1,0
3769,64128,0,0,93,93,0,1,0,1,0
28495,36237,0,0,66,66,0,1,0,1,0
60441,23718,0,0,66,66,0,1,0,1,0
29572,25174,0,0,62,62,0,1,0,1,0
62060,25174,0,0,70,70,0,1,0,1,0
443,20995,0,0,83,83,0,1,0,1,0
59569,22114,0,0,66,66,0,1,0,1,0
58509,21247,0,0,66,66,0,1,0,1,0
50442,25174,0,0,65,65,0,1,0,1,0
23014,48817,0,0,99,99,0,1,0,1,0
33469,37945,0,0,62,62,0,1,0,1,0
51352,51250,0,0,72,72,0,1,0,1,0
4545,1900,0,0,136,136,0,1,0,1,0
1865,25174,0,0,62,62,0,1,0,1,0
14615,64147,0,0,65,65,0,1,0,1,0
64940,26467,0,0,62,62,0,1,0,1,0
60864,42270,0,0,66,66,0,1,0,1,0
60157,2566,0,0,83,83,0,1,0,1,0
45276,25174,0,0,131,131,0,1,0,1,0
60384,25174,0,0,64,64,0,1,0,1,0
45941,23386,0,0,60,60,0,1,0,1,0
8999,57470,0,0,146,146,0,1,0,1,0
64707,9636,0,0,64,64,0,1,0,1,0
58638,5900,0,0,62,62,0,1,0,1,0
16564,57470,0,0,112,112,0,1,0,1,0
31249,23,0,0,60,60,0,1,0,1,0
28877,51505,0,0,62,62,0,1,0,1,0
14704,64147,0,0,66,66,0,1,0,1,0
3200,57687,0,0,66,66,0,1,0,1,0
31876,61689,0,0,140,140,0,1,0,1,0
21053,57470,0,0,67,67,0,1,0,1,0
60141,62413,0,0,66,66,0,1,0,1,0
58001,22114,0,0,66,66,0,1,0,1,0
57131,31061,0,0,145,145,0,1,0,1,0
51535,44847,0,0,62,62,0,1,0,1,0
54302,44847,0,0,66,66,0,1,0,1,0
2324,35440,0,0,62,62,0,1,0,1,0
21674,28189,0,0,60,60,0,1,0,1,0
11969,57470,0,0,62,62,0,1,0,1,0
58638,5900,0,0,62,62,0,1,0,1,0
443,28417,0,0,82,82,0,1,0,1,0
2936,25174,0,0,137,137,0,1,0,1,0
30135,37965,0,0,65,65,0,1,0,1,0
26893,37965,0,0,66,66,0,1,0,1,0
58638,5900,0,0,62,62,0,1,0,1,0
3478,61463,0,0,169,169,0,1,0,1,0
19771,457,0,0,60,60,0,1,0,1,0
56707,37847,0,0,63,63,0,1,0,1,0
62223,57470,0,0,72,72,0,1,0,1,0
13007,26415,0,0,89,89,0,1,0,1,0
51532,48764,0,0,67,67,0,1,0,1,0
47915,50584,0,0,62,62,0,1,0,1,0
9014,23,0,0,60,60,0,1,0,1,0
20003,8467,0,0,60,60,0,1,0,1,0
59310,8861,0,0,63,63,0,1,0,1,0
54627,26467,0,0,66,66,0,1,0,1,0
45941,23386,0,0,60,60,0,1,0,1,0
58638,5900,0,0,62,62,0,1,0,1,0
22939,25174,0,0,62,62,0,1,0,1,0
52177,25320,0,0,66,66,0,1,0,1,0
58646,44847,0,0,65,65,0,1,0,1,0
4597,30188,0,0,62,62,0,1,0,1,0
24255,57470,0,0,62,62,0,1,0,1,0
28194,32468,0,0,62,62,0,1,0,1,0
11066,17415,0,0,90,90,0,1,0,1,0
30469,25174,0,0,62,62,0,1,0,1,0
65420,26467,0,0,62,62,0,1,0,1,0
7816,35907,0,0,99,99,0,1,0,1,0
57545,35440,0,0,66,66,0,1,0,1,0
23768,44847,0,0,62,62,0,1,0,1,0
37308,43890,0,0,62,62,0,1,0,1,0
1231,62529,0,0,113,113,0,1,0,1,0
12694,22114,0,0,66,66,0,1,0,1,0
35869,26467,0,0,62,62,0,1,0,1,0
30647,37965,0,0,62,62,0,1,0,1,0
53796,30176,0,0,66,66,0,1,0,1,0
58638,5900,0,0,62,62,0,1,0,1,0
57302,62413,0,0,66,66,0,1,0,1,0
57089,50584,0,0,62,62,0,1,0,1,0
64190,2767,0,0,66,66,0,1,0,1,0
2540,25174,0,0,67,67,0,1,0,1,0
43129,15503,0,0,62,62,0,1,0,1,0
55510,32474,0,0,63,63,0,1,0,1,0
49799,65240,0,0,107,107,0,1,0,1,0
4657,50584,0,0,64,64,0,1,0,1,0
65379,22114,0,0,66,66,0,1,0,1,0
6951,33100,0,0,139,139,0,1,0,1,0
3092,37965,0,0,62,62,0,1,0,1,0
10953,22114,0,0,84,84,0,1,0,1,0
56064,32473,0,0,64,64,0,1,0,1,0
58638,5900,0,0,62,62,0,1,0,1,0
50488,22114,0,0,62,62,0,1,0,1,0
57248,50584,0,0,63,63,0,1,0,1,0
18080,29917,0,0,92,92,0,1,0,1,0
28649,43890,0,0,62,62,0,1,0,1,0
50145,64147,0,0,66,66,0,1,0,1,0
58638,5900,0,0,62,62,0,1,0,1,0
58463,15503,0,0,137,137,0,1,0,1,0
57124,64147,0,0,62,62,0,1,0,1,0
31153,56050,0,0,64,64,0,1,0,1,0
5223,32965,0,0,72,72,0,1,0,1,0
63293,57470,0,0,66,66,0,1,0,1,0
59415,37933,0,0,66,66,0,1,0,1,0
65343,26269,0,0,65,65,0,1,0,1,0
443,62732,0,0,332,332,0,1,0,1,0
56366,44845,0,0,66,66,0,1,0,1,0
59994,44810,0,0,66,66,0,1,0,1,0
3117,37965,0,0,62,62,0,1,0,1,0
51534,23752,0,0,65,65,0,1,0,1,0
443,3939,0,0,122,122,0,1,0,1,0
9588,37965,0,0,65,65,0,1,0,1,0
25592,18892,0,0,60,60,0,1,0,1,0
63513,44847,0,0,63,63,0,1,0,1,0
11136,15503,0,0,62,62,0,1,0,1,0
42854,44847,0,0,64,64,0,1,0,1,0
57814,7408,0,0,62,62,0,1,0,1,0
60005,55610,0,0,66,66,0,1,0,1,0
12604,25174,0,0,62,62,0,1,0,1,0
65141,36,0,0,72,72,0,1,0,1,0
55854,54369,0,0,74,74,0,1,0,1,0
7074,22114,0,0,62,62,0,1,0,1,0
23119,25174,0,0,62,62,0,1,0,1,0
53470,22114,0,0,66,66,0,1,0,1,0
43584,24748,0,0,156,156,0,1,0,1,0
56327,44518,0,0,66,66,0,1,0,1,0
50987,35982,0,0,62,62,0,1,0,1,0
58638,5900,0,0,62,62,0,1,0,1,0
62629,44847,0,0,91,91,0,1,0,1,0
52074,49193,0,0,86,86,0,1,0,1,0
64427,57470,0,0,72,72,0,1,0,1,0
57555,50584,0,0,65,65,0,1,0,1,0
3664,64126,0,0,96,96,0,1,0,1,0
58343,23718,0,0,66,66,0,1,0,1,0
49648,26467,0,0,127,127,0,1,0,1,0
44207,44847,0,0,66,66,0,1,0,1,0
25017,30188,0,0,137,137,0,1,0,1,0
12629,11392,0,0,62,62,0,1,0,1,0
53504,44847,0,0,62,62,0,1,0,1,0
17629,23,0,0,60,60,0,1,0,1,0
53159,56205,0,0,63,63,0,1,0,1,0
53030,56205,0,0,66,66,0,1,0,1,0
4388,30188,0,0,62,62,0,1,0,1,0
31954,57470,0,0,60,60,0,1,0,1,0
13285,29892,0,0,145,145,0,1,0,1,0
58371,21247,0,0,64,64,0,1,0,1,0
64810,27073,0,0,65,65,0,1,0,1,0
57621,28610,0,0,64,64,0,1,0,1,0
443,29024,0,0,82,82,0,1,0,1,0
58630,44847,0,0,62,62,0,1,0,1,0
56950,22114,0,0,144,144,0,1,0,1,0
15333,44847,0,0,142,142,0,1,0,1,0
50864,26467,0,0,66,66,0,1,0,1,0
47910,7464,0,0,60,60,0,1,0,1,0
2458,50584,0,0,62,62,0,1,0,1,0
52734,44847,0,0,66,66,0,1,0,1,0
43828,50248,0,0,71,71,0,1,0,1,0
11090,22114,0,0,126,126,0,1,0,1,0
60430,51395,0,0,64,64,0,1,0,1,0
60772,36829,0,0,66,66,0,1,0,1,0
50637,36237,0,0,63,63,0,1,0,1,0
26053,33720,0,0,160,160,0,1,0,1,0
11113,51505,0,0,66,66,0,1,0,1,0
59672,37870,0,0,66,66,0,1,0,1,0
17781,50265,0,0,62,62,0,1,0,1,0
48071,25174,0,0,86,86,0,1,0,1,0
34822,31573,0,0,62,62,0,1,0,1,0
6057,51221,0,0,78,78,0,1,0,1,0
56741,9571,0,0,65,65,0,1,0,1,0
60104,22114,0,0,66,66,0,1,0,1,0
22446,25174,0,0,65,65,0,1,0,1,0
58638,5900,0,0,62,62,0,1,0,1,0
36571,50584,0,0,146,146,0,1,0,1,0
51441,46515,0,0,109,109,0,1,0,1,0
31173,64147,0,0,62,62,0,1,0,1,0
52142,53733,0,0,65,65,0,1,0,1,0
25570,35440,0,0,91,91,0,1,0,1,0
40142,27,0,0,60,60,0,1,0,1,0
55412,25174,0,0,65,65,0,1,0,1,0
9118,6881,0,0,72,72,0,1,0,1,0
61185,54532,0,0,62,62,0,1,0,1,0
856,11985,0,0,66,66,0,1,0,1,0
16387,20045,0,0,60,60,0,1,0,1,0
58638,5900,0,0,62,62,0,1,0,1,0
58555,50584,0,0,105,105,0,1,0,1,0
27907,36028,0,0,62,62,0,1,0,1,0
44930,26467,0,0,62,62,0,1,0,1,0
55646,50584,0,0,62,62,0,1,0,1,0
53353,26467,0,0,62,62,0,1,0,1,0
10283,25604,0,0,65,65,0,1,0,1,0
15701,37965,0,0,146,146,0,1,0,1,0
22983,15503,0,0,101,101,0,1,0,1,0
41429,50584,0,0,66,66,0,1,0,1,0
12709,51505,0,0,62,62,0,1,0,1,0
19991,64147,0,0,63,63,0,1,0,1,0
2634,11392,0,0,66,66,0,1,0,1,0
50205,44847,0,0,67,67,0,1,0,1,0
58888,23718,0,0,62,62,0,1,0,1,0
45908,3383,0,0,60,60,0,1,0,1,0
44948,57470,0,0,70,70,0,1,0,1,0
45941,23386,0,0,60,60,0,1,0,1,0
443,4205,0,0,320,320,0,1,0,1,0
55439,64147,0,0,66,66,0,1,0,1,0
1024,44847,0,0,62,62,0,1,0,1,0
1054,15503,0,0,62,62,0,1,0,1,0
61768,11392,0,0,65,65,0,1,0,1,0
50035,23,0,0,60,60,0,1,0,1,0
52563,22114,0,0,66,66,0,1,0,1,0
53260,36237,0,0,62,62,0,1,0,1,0
53009,64143,0,0,62,62,0,1,0,1,0
34993,15503,0,0,62,62,0,1,0,1,0
49418,22114,0,0,65,65,0,1,0,1,0
80,9918,0,0,60,60,0,1,0,1,0
58638,5900,0,0,62,62,0,1,0,1,0
37343,21247,0,0,87,87,0,1,0,1,0
52385,43890,0,0,66,66,0,1,0,1,0
2305,35440,0,0,62,62,0,1,0,1,0
47910,7454,0,0,60,60,0,1,0,1,0
19642,9478,0,0,61,61,0,1,0,1,0
54097,36237,0,0,64,64,0,1,0,1,0
60787,50584,0,0,66,66,0,1,0,1,0
45714,35825,0,0,133,133,0,1,0,1,0
14415,37965,0,0,62,62,0,1,0,1,0
3478,61463,0,0,1129,1129,0,1,0,1,0
3478,61463,0,0,1002,1002,0,1,0,1,0
8560,50584,0,0,63,63,0,1,0,1,0
28197,41864,0,0,154,154,0,1,0,1,0
25060,37965,0,0,62,62,0,1,0,1,0
987,62617,0,0,151,151,0,1,0,1,0
3324,50584,0,0,70,70,0,1,0,1,0
42423,22114,0,0,62,62,0,1,0,1,0
55510,64147,0,0,62,62,0,1,0,1,0
54189,22114,0,0,66,66,0,1,0,1,0
14206,51213,0,0,69,69,0,1,0,1,0
57108,46812,0,0,75,75,0,1,0,1,0
50660,50584,0,0,69,69,0,1,0,1,0
1028,35814,0,0,113,113,0,1,0,1,0
65405,26467,0,0,62,62,0,1,0,1,0
13285,29892,0,0,145,145,0,1,0,1,0
65393,26467,0,0,62,62,0,1,0,1,0
6247,51221,0,0,78,78,0,1,0,1,0
55620,30188,0,0,66,66,0,1,0,1,0
80,57411,0,0,1514,1514,0,1,0,1,0
42516,25174,0,0,139,139,0,1,0,1,0
34497,5818,0,0,78,78,0,1,0,1,0
52462,25174,0,0,62,62,0,1,0,1,0
12086,50421,0,0,63,63,0,1,0,1,0
50225,64147,0,0,66,66,0,1,0,1,0
51721,64147,0,0,66,66,0,1,0,1,0
47700,51505,0,0,66,66,0,1,0,1,0
61575,64147,0,0,66,66,0,1,0,1,0
52776,56205,0,0,112,112,0,1,0,1,0
64823,37965,0,0,62,62,0,1,0,1,0
15561,49951,0,0,110,110,0,1,0,1,0
2440,37807,0,0,66,66,0,1,0,1,0
50095,30188,0,0,66,66,0,1,0,1,0
45079,31573,0,0,66,66,0,1,0,1,0
56815,35440,0,0,62,62,0,1,0,1,0
1030,64147,0,0,62,62,0,1,0,1,0
59668,51505,0,0,66,66,0,1,0,1,0
52743,15503,0,0,66,66,0,1,0,1,0
443,10010,0,0,60,60,0,1,0,1,0
62930,36237,0,0,62,62,0,1,0,1,0
36244,23,0,0,60,60,0,1,0,1,0
1865,25174,0,0,62,62,0,1,0,1,0
58560,57587,0,0,66,66,0,1,0,1,0
53772,55773,0,0,98,98,0,1,0,1,0
29370,64147,0,0,62,62,0,1,0,1,0
55376,37965,0,0,84,84,0,1,0,1,0
46579,43527,0,0,68,68,0,1,0,1,0
674,54038,0,0,60,60,0,1,0,1,0
53369,64144,0,0,62,62,0,1,0,1,0
1868,23,0,0,60,60,0,1,0,1,0
51129,43890,0,0,66,66,0,1,0,1,0
34099,25174,0,0,66,66,0,1,0,1,0
50386,22114,0,0,64,64,0,1,0,1,0
57233,50934,0,0,66,66,0,1,0,1,0
17097,62413,0,0,62,62,0,1,0,1,0
27516,37965,0,0,64,64,0,1,0,1,0
58638,5900,0,0,62,62,0,1,0,1,0
58638,5900,0,0,62,62,0,1,0,1,0
50757,64147,0,0,66,66,0,1,0,1,0
56137,37965,0,0,66,66,0,1,0,1,0
53242,26467,0,0,62,62,0,1,0,1,0
9337,56205,0,0,65,65,0,1,0,1,0
58483,37965,0,0,62,62,0,1,0,1,0
43260,41615,0,0,145,145,0,1,0,1,0
25347,24942,0,0,106,106,0,1,0,1,0
58638,5900,0,0,62,62,0,1,0,1,0
2819,25174,0,0,79,79,0,1,0,1,0
6715,21259,0,0,68,68,0,1,0,1,0
17195,35440,0,0,112,112,0,1,0,1,0
50810,7,0,0,61,61,0,1,0,1,0
58638,5900,0,0,62,62,0,1,0,1,0
33405,37965,0,0,62,62,0,1,0,1,0
3981,17372,0,0,65,65,0,1,0,1,0
7032,14,0,0,75,75,0,1,0,1,0
60228,56205,0,0,64,64,0,1,0,1,0
55805,35440,0,0,64,64,0,1,0,1,0
51515,6881,0,0,65,65,0,1,0,1,0
57079,26338,0,0,124,124,0,1,0,1,0
54280,3385,0,0,60,60,0,1,0,1,0
65131,22114,0,0,66,66,0,1,0,1,0
43828,44847,0,0,64,64,0,1,0,1,0
49600,22114,0,0,62,62,0,1,0,1,0
30679,51276,0,0,70,70,0,1,0,1,0
13985,34159,0,0,62,62,0,1,0,1,0
10383,5231,0,0,147,147,0,1,0,1,0
21733,56205,0,0,66,66,0,1,0,1,0
58638,5900,0,0,62,62,0,1,0,1,0
50428,62413,0,0,80,80,0,1,0,1,0
45908,33330,0,0,60,60,0,1,0,1,0
443,64347,0,0,104,104,0,1,0,1,0
36249,22,0,0,60,60,0,1,0,1,0
19875,30170,0,0,145,145,0,1,0,1,0
340,35689,0,0,542,542,0,1,0,1,0
6040,51505,0,0,65,65,0,1,0,1,0
10688,25174,0,0,93,93,0,1,0,1,0
51586,64147,0,0,66,66,0,1,0,1,0
49516,35894,0,0,77,77,0,1,0,1,0
22401,22,0,0,60,60,0,1,0,1,0
55396,26467,0,0,62,62,0,1,0,1,0
17065,64147,0,0,64,64,0,1,0,1,0
18767,35440,0,0,132,132,0,1,0,1,0
36434,25174,0,0,128,128,0,1,0,1,0
63209,35440,0,0,132,132,0,1,0,1,0
59421,37931,0,0,66,66,0,1,0,1,0
1564,44847,0,0,63,63,0,1,0,1,0
49151,51505,0,0,145,145,0,1,0,1,0
64971,26467,0,0,62,62,0,1,0,1,0
60459,25174,0,0,66,66,0,1,0,1,0
43584,24748,0,0,156,156,0,1,0,1,0
14488,25174,0,0,144,144,0,1,0,1,0
55198,64147,0,0,66,66,0,1,0,1,0
43839,26511,0,0,117,117,0,1,0,1,0
59055,11392,0,0,63,63,0,1,0,1,0
59694,50584,0,0,62,62,0,1,0,1,0
49498,52175,0,0,151,151,0,1,0,1,0
54413,37752,0,0,66,66,0,1,0,1,0
9679,26467,0,0,62,62,0,1,0,1,0
60173,50584,0,0,66,66,0,1,0,1,0
67,67,0,0,346,346,0,1,0,1,0
34360,25174,0,0,66,66,0,1,0,1,0
6881,6881,0,0,62,62,0,1,0,1,0
42898,43890,0,0,62,62,0,1,0,1,0
18600,56214,0,0,66,66,0,1,0,1,0
45520,30,0,0,61,61,0,1,0,1,0
61478,57470,0,0,67,67,0,1,0,1,0
55893,45711,0,0,78,78,0,1,0,1,0
29679,23,0,0,60,60,0,1,0,1,0
124,37610,0,0,67,67,0,1,0,1,0
51100,1491,0,0,69,69,0,1,0,1,0
51692,44847,0,0,65,65,0,1,0,1,0
62808,21247,0,0,66,66,0,1,0,1,0
56966,21247,0,0,70,70,0,1,0,1,0
17250,25174,0,0,146,146,0,1,0,1,0
3478,61463,0,0,164,164,0,1,0,1,0
37012,25174,0,0,146,146,0,1,0,1,0
59093,25174,0,0,66,66,0,1,0,1,0
2989,37965,0,0,62,62,0,1,0,1,0
44255,38176,0,0,78,78,0,1,0,1,0
54196,11392,0,0,66,66,0,1,0,1,0
26368,57470,0,0,62,62,0,1,0,1,0
33553,44847,0,0,64,64,0,1,0,1,0
63875,36829,0,0,62,62,0,1,0,1,0
30456,36237,0,0,86,86,0,1,0,1,0
58764,64118,0,0,63,63,0,1,0,1,0
45964,5333,0,0,60,60,0,1,0,1,0
54105,17389,0,0,65,65,0,1,0,1,0
6712,123,0,0,90,90,0,1,0,1,0
55273,37965,0,0,99,99,0,1,0,1,0
46495,4607,0,0,60,60,0,1,0,1,0
46522,64147,0,0,62,62,0,1,0,1,0
56453,15503,0,0,146,146,0,1,0,1,0
32796,37965,0,0,62,62,0,1,0,1,0
56428,35273,0,0,66,66,0,1,0,1,0
19805,38095,0,0,105,105,0,1,0,1,0
58968,37965,0,0,66,66,0,1,0,1,0
53481,20,0,0,60,60,0,1,0,1,0
443,29326,0,0,82,82,0,1,0,1,0
1025,35447,0,0,62,62,0,1,0,1,0
63651,26323,0,0,144,144,0,1,0,1,0
58638,5900,0,0,62,62,0,1,0,1,0
32796,37965,0,0,65,65,0,1,0,1,0
10390,26467,0,0,63,63,0,1,0,1,0
50535,51505,0,0,64,64,0,1,0,1,0
57793,37807,0,0,66,66,0,1,0,1,0
12060,37965,0,0,66,66,0,1,0,1,0
60259,37965,0,0,66,66,0,1,0,1,0
44981,57470,0,0,66,66,0,1,0,1,0
10054,22114,0,0,62,62,0,1,0,1,0
62080,54532,0,0,60,60,0,1,0,1,0
22583,9822,0,0,62,62,0,1,0,1,0
45941,23386,0,0,60,60,0,1,0,1,0
25380,50584,0,0,112,112,0,1,0,1,0
64605,35993,0,0,66,66,0,1,0,1,0
57991,22114,0,0,66,66,0,1,0,1,0
53954,57470,0,0,62,62,0,1,0,1,0
6881,6881,0,0,146,146,0,1,0,1,0
25551,35440,0,0,146,146,0,1,0,1,0
45837,25174,0,0,89,89,0,1,0,1,0
48706,23393,0,0,60,60,0,1,0,1,0
26488,64147,0,0,62,62,0,1,0,1,0
58638,5900,0,0,62,62,0,1,0,1,0
58675,64135,0,0,65,65,0,1,0,1,0
27402,37799,0,0,64,64,0,1,0,1,0
56839,11407,0,0,66,66,0,1,0,1,0
58638,5900,0,0,62,62,0,1,0,1,0
49609,44847,0,0,63,63,0,1,0,1,0
16387,7668,0,0,60,60,0,1,0,1,0
1025,35447,0,0,62,62,0,1,0,1,0
25078,25174,0,0,146,146,0,1,0,1,0
51999,37965,0,0,62,62,0,1,0,1,0
45941,23386,0,0,60,60,0,1,0,1,0
57452,57470,0,0,62,62,0,1,0,1,0
2460,50584,0,0,62,62,0,1,0,1,0
58743,35894,0,0,66,66,0,1,0,1,0
58638,5900,0,0,62,62,0,1,0,1,0
1304,51374,0,0,145,145,0,1,0,1,0
2110,22114,0,0,123,123,0,1,0,1,0
12928,37965,0,0,63,63,0,1,0,1,0
56603,37965,0,0,65,65,0,1,0,1,0
54286,11392,0,0,66,66,0,1,0,1,0
58638,5900,0,0,62,62,0,1,0,1,0
65459,57470,0,0,69,69,0,1,0,1,0
17981,64097,0,0,66,66,0,1,0,1,0
51243,37965,0,0,66,66,0,1,0,1,0
65494,53,0,0,88,88,0,1,0,1,0
58550,21247,0,0,66,66,0,1,0,1,0
1860,25174,0,0,65,65,0,1,0,1,0
61200,48757,0,0,67,67,0,1,0,1,0
80,37649,0,0,60,60,0,1,0,1,0
64907,36046,0,0,71,71,0,1,0,1,0
64224,51192,0,0,66,66,0,1,0,1,0
49405,11392,0,0,64,64,0,1,0,1,0
32470,50377,0,0,117,117,0,1,0,1,0
28579,64147,0,0,62,62,0,1,0,1,0
54619,1433,0,0,60,60,0,1,0,1,0
20939,60461,0,0,60,60,0,1,0,1,0
61140,27520,0,0,65,65,0,1,0,1,0
13524,51504,0,0,62,62,0,1,0,1,0
52533,37965,0,0,62,62,0,1,0,1,0
45964,3111,0,0,60,60,0,1,0,1,0
61708,30292,0,0,65,65,0,1,0,1,0
9012,7160,0,0,82,82,0,1,0,1,0
5613,11390,0,0,66,66,0,1,0,1,0
63346,37965,0,0,66,66,0,1,0,1,0
53437,44847,0,0,65,65,0,1,0,1,0
51528,50584,0,0,66,66,0,1,0,1,0
12563,25174,0,0,62,62,0,1,0,1,0
80,37649,0,0,60,60,0,1,0,1,0
58638,5900,0,0,62,62,0,1,0,1,0
50275,35440,0,0,66,66,0,1,0,1,0
43341,26467,0,0,65,65,0,1,0,1,0
30304,26467,0,0,62,62,0,1,0,1,0
56714,30204,0,0,99,99,0,1,0,1,0
60159,35440,0,0,65,65,0,1,0,1,0
51505,17372,0,0,66,66,0,1,0,1,0
38014,44847,0,0,64,64,0,1,0,1,0
53983,30177,0,0,66,66,0,1,0,1,0
23843,26467,0,0,62,62,0,1,0,1,0
51618,25174,0,0,66,66,0,1,0,1,0
64835,26846,0,0,64,64,0,1,0,1,0
58582,50584,0,0,66,66,0,1,0,1,0
64399,25174,0,0,66,66,0,1,0,1,0
59966,37965,0,0,66,66,0,1,0,1,0
37835,50353,0,0,66,66,0,1,0,1,0
21353,22,0,0,60,60,0,1,0,1,0
59366,35440,0,0,63,63,0,1,0,1,0
44058,22,0,0,60,60,0,1,0,1,0
20389,64147,0,0,62,62,0,1,0,1,0
54193,44847,0,0,66,66,0,1,0,1,0
11136,15503,0,0,62,62,0,1,0,1,0
64587,57470,0,0,66,66,0,1,0,1,0
56101,35440,0,0,61,61,0,1,0,1,0
50914,36080,0,0,94,94,0,1,0,1,0
5168,21778,0,0,60,60,0,1,0,1,0
58638,5900,0,0,62,62,0,1,0,1,0
61135,54431,0,0,62,62,0,1,0,1,0
59492,25174,0,0,66,66,0,1,0,1,0
36246,23,0,0,60,60,0,1,0,1,0
22527,25174,0,0,62,62,0,1,0,1,0
443,45997,0,0,81,81,0,1,0,1,0
1028,64147,0,0,62,62,0,1,0,1,0
23679,35281,0,0,66,66,0,1,0,1,0
39681,37965,0,0,66,66,0,1,0,1,0
20400,64147,0,0,62,62,0,1,0,1,0
6881,6881,0,0,62,62,0,1,0,1,0
455,10046,0,0,61,61,0,1,0,1,0
16572,21247,0,0,62,62,0,1,0,1,0
51930,57470,0,0,66,66,0,1,0,1,0
5223,44091,0,0,202,202,0,1,0,1,0
51489,48665,0,0,83,83,0,1,0,1,0
45908,3383,0,0,60,60,0,1,0,1,0
45941,23386,0,0,60,60,0,1,0,1,0
22664,11178,0,0,129,129,0,1,0,1,0
53776,51505,0,0,66,66,0,1,0,1,0
18518,25174,0,0,62,62,0,1,0,1,0
26363,23,0,0,60,60,0,1,0,1,0
56141,37915,0,0,62,62,0,1,0,1,0
9515,26467,0,0,65,65,0,1,0,1,0
4691,1814,0,0,120,120,0,1,0,1,0
51727,51505,0,0,66,66,0,1,0,1,0
53426,44847,0,0,66,66,0,1,0,1,0
6383,8888,1444,2303,173,173,0,1,0,1,0
62065,22114,0,0,65,65,0,1,0,1,0
50386,22114,0,0,62,62,0,1,0,1,0
55322,37965,0,0,66,66,0,1,0,1,0
10637,37965,0,0,62,62,0,1,0,1,0
63817,35440,0,0,64,64,0,1,0,1,0
3196,64147,0,0,65,65,0,1,0,1,0
27532,25194,0,0,136,136,0,1,0,1,0
1427,22114,0,0,92,92,0,1,0,1,0
3478,61463,0,0,240,240,0,1,0,1,0
53852,3387,0,0,63,63,0,1,0,1,0
14234,22114,0,0,65,65,0,1,0,1,0
56688,25174,0,0,65,65,0,1,0,1,0
61765,44847,0,0,62,62,0,1,0,1,0
778,3509,0,0,85,85,0,1,0,1,0
12218,22114,0,0,63,63,0,1,0,1,0
53406,44847,0,0,65,65,0,1,0,1,0
28066,22114,0,0,62,62,0,1,0,1,0
41852,35440,0,0,62,62,0,1,0,1,0
59557,37965,0,0,62,62,0,1,0,1,0
80,53945,0,0,60,60,0,1,0,1,0
55493,25174,0,0,64,64,0,1,0,1,0
4110,64147,0,0,62,62,0,1,0,1,0
22984,22114,0,0,124,124,0,1,0,1,0
53500,1,0,0,66,66,0,1,0,1,0
53928,15503,0,0,80,80,0,1,0,1,0
59413,51505,0,0,64,64,0,1,0,1,0
1190,25174,0,0,62,62,0,1,0,1,0
18577,25174,0,0,62,62,0,1,0,1,0
9272,42838,0,0,128,128,0,1,0,1,0
7810,25174,0,0,66,66,0,1,0,1,0
48706,23393,0,0,60,60,0,1,0,1,0
58638,5900,0,0,62,62,0,1,0,1,0
53156,35993,0,0,66,66,0,1,0,1,0
443,4000,0,0,194,194,0,1,0,1,0
7070,20,0,0,64,64,0,1,0,1,0
2704,37,0,0,60,60,0,1,0,1,0
63878,22114,0,0,84,84,0,1,0,1,0
58614,6146,0,0,83,83,0,1,0,1,0
48706,23393,0,0,60,60,0,1,0,1,0
64364,44847,0,0,66,66,0,1,0,1,0
45881,22114,0,0,62,62,0,1,0,1,0
443,48219,0,0,89,89,0,1,0,1,0
59461,41173,0,0,67,67,0,1,0,1,0
60771,58414,0,0,66,66,0,1,0,1,0
60414,22114,0,0,66,66,0,1,0,1,0
21499,51600,0,0,68,68,0,1,0,1,0
21213,23,0,0,60,60,0,1,0,1,0
50994,35974,0,0,60,60,0,1,0,1,0
52050,11392,0,0,62,62,0,1,0,1,0
51225,44847,0,0,66,66,0,1,0,1,0
58276,43890,0,0,62,62,0,1,0,1,0
59919,15503,0,0,65,65,0,1,0,1,0
16370,7173,0,0,68,68,0,1,0,1,0
33499,5529,0,0,144,144,0,1,0,1,0
13838,43098,0,0,197,197,0,1,0,1,0
27272,64147,0,0,63,63,0,1,0,1,0
56610,43890,0,0,66,66,0,1,0,1,0
6392,37965,0,0,62,62,0,1,0,1,0
52761,56205,0,0,63,63,0,1,0,1,0
50859,50584,0,0,62,62,0,1,0,1,0
443,60306,0,0,134,134,0,1,0,1,0
1027,64147,0,0,62,62,0,1,0,1,0
17431,55514,0,0,65,65,0,1,0,1,0
31727,57470,0,0,62,62,0,1,0,1,0
46143,1567,0,0,60,60,0,1,0,1,0
52800,1433,0,0,60,60,0,1,0,1,0
52796,35440,0,0,66,66,0,1,0,1,0
38640,51221,0,0,63,63,0,1,0,1,0
14059,21247,0,0,139,139,0,1,0,1,0
45982,51505,0,0,62,62,0,1,0,1,0
58638,5900,0,0,62,62,0,1,0,1,0
63879,35440,0,0,65,65,0,1,0,1,0
443,9989,0,0,258,258,0,1,0,1,0
58381,62413,0,0,138,138,0,1,0,1,0
52727,64147,0,0,62,62,0,1,0,1,0
60351,50584,0,0,64,64,0,1,0,1,0
6224,37965,0,0,62,62,0,1,0,1,0
39959,23117,0,0,132,132,0,1,0,1,0
9452,30144,0,0,95,95,0,1,0,1,0
27854,51310,0,0,64,64,0,1,0,1,0
58927,37965,0,0,66,66,0,1,0,1,0
22923,25174,0,0,62,62,0,1,0,1,0
58638,5900,0,0,62,62,0,1,0,1,0
56305,1,0,0,145,145,0,1,0,1,0
50757,64147,0,0,66,66,0,1,0,1,0
1793,23,0,0,60,60,0,1,0,1,0
54803,37965,0,0,64,64,0,1,0,1,0
28577,64147,0,0,62,62,0,1,0,1,0
53500,1,0,0,66,66,0,1,0,1,0
62862,50584,0,0,62,62,0,1,0,1,0
443,60496,0,0,320,320,0,1,0,1,0
58838,64147,0,0,66,66,0,1,0,1,0
15319,51505,0,0,63,63,0,1,0,1,0
35412,22,0,0,60,60,0,1,0,1,0
55853,64147,0,0,66,66,0,1,0,1,0
16956,11192,0,0,124,124,0,1,0,1,0
39495,48774,0,0,127,127,0,1,0,1,0
23866,19185,0,0,61,61,0,1,0,1,0
13906,37965,0,0,115,115,0,1,0,1,0
11136,15503,0,0,62,62,0,1,0,1,0
55760,23718,0,0,65,65,0,1,0,1,0
50629,17,0,0,60,60,0,1,0,1,0
64483,37965,0,0,66,66,0,1,0,1,0
54768,30188,0,0,65,65,0,1,0,1,0
15909,26368,0,0,61,61,0,1,0,1,0
58761,30188,0,0,66,66,0,1,0,1,0
65269,22114,0,0,62,62,0,1,0,1,0
59451,50584,0,0,65,65,0,1,0,1,0
59978,57470,0,0,65,65,0,1,0,1,0
11052,44847,0,0,65,65,0,1,0,1,0
50520,51505,0,0,63,63,0,1,0,1,0
57517,44847,0,0,64,64,0,1,0,1,0
52837,35440,0,0,66,66,0,1,0,1,0
58638,5900,0,0,62,62,0,1,0,1,0
50104,50371,0,0,64,64,0,1,0,1,0
28046,22114,0,0,62,62,0,1,0,1,0
4862,37965,0,0,66,66,0,1,0,1,0
54773,50584,0,0,66,66,0,1,0,1,0
58858,15503,0,0,66,66,0,1,0,1,0
17788,30177,0,0,63,63,0,1,0,1,0
58486,57470,0,0,66,66,0,1,0,1,0
21823,22114,0,0,62,62,0,1,0,1,0
16387,7396,0,0,60,60,0,1,0,1,0
39082,57470,0,0,62,62,0,1,0,1,0
62671,34277,0,0,65,65,0,1,0,1,0
53300,37807,0,0,62,62,0,1,0,1,0
58011,42752,0,0,87,87,0,1,0,1,0
35657,48637,0,0,62,62,0,1,0,1,0
51262,37965,0,0,63,63,0,1,0,1,0
53224,37885,0,0,64,64,0,1,0,1,0
53780,37965,0,0,63,63,0,1,0,1,0
18415,37965,0,0,62,62,0,1,0,1,0
26422,22114,0,0,62,62,0,1,0,1,0
443,43936,0,0,79,79,0,1,0,1,0
51312,64147,0,0,65,65,0,1,0,1,0
58811,53976,0,0,64,64,0,1,0,1,0
6893,48804,0,0,142,142,0,1,0,1,0
51442,22,0,0,60,60,0,1,0,1,0
34808,22114,0,0,62,62,0,1,0,1,0
6057,51221,0,0,62,62,0,1,0,1,0
41278,38111,0,0,123,123,0,1,0,1,0
55608,64131,0,0,63,63,0,1,0,1,0
1470,54118,0,0,91,91,0,1,0,1,0
64035,25174,0,0,123,123,0,1,0,1,0
58972,37965,0,0,66,66,0,1,0,1,0
45908,33330,0,0,60,60,0,1,0,1,0
58596,50584,0,0,66,66,0,1,0,1,0
23323,25174,0,0,86,86,0,1,0,1,0
62580,25174,0,0,64,64,0,1,0,1,0
44690,25174,0,0,62,62,0,1,0,1,0
58755,51221,0,0,62,62,0,1,0,1,0
58638,5900,0,0,62,62,0,1,0,1,0
26836,57470,0,0,63,63,0,1,0,1,0
60113,25189,0,0,117,117,0,1,0,1,0
63984,25174,0,0,62,62,0,1,0,1,0
80,37649,0,0,60,60,0,1,0,1,0
28806,37965,0,0,62,62,0,1,0,1,0
5848,22114,0,0,62,62,0,1,0,1,0
60058,25174,0,0,66,66,0,1,0,1,0
49541,35851,0,0,95,95,0,1,0,1,0
57281,50584,0,0,64,64,0,1,0,1,0
443,22307,0,0,70,70,0,1,0,1,0
26920,37965,0,0,62,62,0,1,0,1,0
54280,3390,0,0,60,60,0,1,0,1,0
57637,56205,0,0,66,66,0,1,0,1,0
63229,50499,0,0,66,66,0,1,0,1,0
61866,17910,0,0,63,63,0,1,0,1,0
41733,57470,0,0,62,62,0,1,0,1,0
3357,45240,0,0,95,95,0,1,0,1,0
63467,64176,0,0,62,62,0,1,0,1,0
30181,26467,0,0,63,63,0,1,0,1,0
45982,51505,0,0,62,62,0,1,0,1,0
63767,26467,0,0,66,66,0,1,0,1,0
443,62732,0,0,330,330,0,1,0,1,0
53315,35264,0,0,66,66,0,1,0,1,0
49546,26467,0,0,62,62,0,1,0,1,0
58638,5900,0,0,62,62,0,1,0,1,0
62575,12207,0,0,66,66,0,1,0,1,0
52752,26467,0,0,62,62,0,1,0,1,0
16387,16862,0,0,60,60,0,1,0,1,0
31033,50584,0,0,62,62,0,1,0,1,0
56835,35894,0,0,66,66,0,1,0,1,0
47339,15676,0,0,62,62,0,1,0,1,0
50734,37965,0,0,62,62,0,1,0,1,0
38970,25174,0,0,139,139,0,1,0,1,0
56346,56205,0,0,63,63,0,1,0,1,0
58638,5900,0,0,62,62,0,1,0,1,0
43129,20220,0,0,62,62,0,1,0,1,0
20400,64147,0,0,107,107,0,1,0,1,0
58638,5900,0,0,62,62,0,1,0,1,0
55350,12,0,0,64,64,0,1,0,1,0
7445,57470,0,0,66,66,0,1,0,1,0
40116,23,0,0,60,60,0,1,0,1,0
57293,42755,0,0,63,63,0,1,0,1,0
58306,18375,0,0,62,62,0,1,0,1,0
13285,29892,0,0,145,145,0,1,0,1,0
30746,37965,0,0,62,62,0,1,0,1,0
6930,6881,0,0,62,62,0,1,0,1,0
23519,25174,0,0,67,67,0,1,0,1,0
53945,44406,0,0,62,62,0,1,0,1,0
59758,55783,0,0,63,63,0,1,0,1,0
60831,50584,0,0,62,62,0,1,0,1,0
45633,10001,0,0,62,62,0,1,0,1,0
1921,48817,0,0,66,66,0,1,0,1,0
63463,50584,0,0,65,65,0,1,0,1,0
57513,56205,0,0,66,66,0,1,0,1,0
61660,64097,0,0,62,62,0,1,0,1,0
57026,35440,0,0,64,64,0,1,0,1,0
56738,23439,0,0,100,100,0,1,0,1,0
56249,55442,0,0,66,66,0,1,0,1,0
49658,57470,0,0,63,63,0,1,0,1,0
31660,35440,0,0,66,66,0,1,0,1,0
51248,37450,0,0,66,66,0,1,0,1,0
61450,50584,0,0,65,65,0,1,0,1,0
9595,57533,0,0,89,89,0,1,0,1,0
47250,15621,0,0,62,62,0,1,0,1,0
33296,50584,0,0,72,72,0,1,0,1,0
56676,37965,0,0,66,66,0,1,0,1,0
52343,51360,0,0,70,70,0,1,0,1,0
50705,57470,0,0,66,66,0,1,0,1,0
32646,50443,0,0,145,145,0,1,0,1,0
31084,36637,0,0,115,115,0,1,0,1,0
63838,35440,0,0,62,62,0,1,0,1,0
56494,15503,0,0,146,146,0,1,0,1,0
51167,56205,0,0,66,66,0,1,0,1,0
39557,37965,0,0,66,66,0,1,0,1,0
52459,5555,0,0,60,60,0,1,0,1,0
4653,63044,0,0,64,64,0,1,0,1,0
11978,57470,0,0,62,62,0,1,0,1,0
12625,35440,0,0,62,62,0,1,0,1,0
29266,40281,0,0,150,150,0,1,0,1,0
50148,50798,0,0,66,66,0,1,0,1,0
51291,9612,0,0,66,66,0,1,0,1,0
32294,22114,0,0,134,134,0,1,0,1,0
28149,37965,0,0,62,62,0,1,0,1,0
41508,25174,0,0,63,63,0,1,0,1,0
14306,56205,0,0,62,62,0,1,0,1,0
50315,51505,0,0,64,64,0,1,0,1,0
54280,3398,0,0,60,60,0,1,0,1,0
27920,25174,0,0,62,62,0,1,0,1,0
57772,37935,0,0,66,66,0,1,0,1,0
45200,25174,0,0,146,146,0,1,0,1,0
38633,51221,0,0,65,65,0,1,0,1,0
6247,51221,0,0,78,78,0,1,0,1,0
51320,37965,0,0,62,62,0,1,0,1,0
14385,51277,0,0,62,62,0,1,0,1,0
59934,35440,0,0,66,66,0,1,0,1,0
43584,24748,0,0,156,156,0,1,0,1,0
14378,51431,0,0,125,125,0,1,0,1,0
58638,5900,0,0,62,62,0,1,0,1,0
36997,25174,0,0,124,124,0,1,0,1,0
44446,37848,0,0,62,62,0,1,0,1,0
16872,50505,0,0,62,62,0,1,0,1,0
30181,61689,0,0,62,62,0,1,0,1,0
62181,56205,0,0,66,66,0,1,0,1,0
6293,25174,0,0,66,66,0,1,0,1,0
51093,57470,0,0,66,66,0,1,0,1,0
443,45788,0,0,291,291,0,1,0,1,0
50065,64147,0,0,62,62,0,1,0,1,0
17702,6881,0,0,66,66,0,1,0,1,0
64693,25310,0,0,62,62,0,1,0,1,0
41773,21400,0,0,62,62,0,1,0,1,0
57987,56125,0,0,90,90,0,1,0,1,0
45964,2225,0,0,60,60,0,1,0,1,0
44849,46478,0,0,74,74,0,1,0,1,0
4258,35440,0,0,62,62,0,1,0,1,0
47915,44847,0,0,62,62,0,1,0,1,0
60869,11392,0,0,66,66,0,1,0,1,0
63231,53296,0,0,65,65,0,1,0,1,0
63331,51221,0,0,62,62,0,1,0,1,0
21333,22,0,0,60,60,0,1,0,1,0
49803,38911,0,0,124,124,0,1,0,1,0
20767,2238,0,0,63,63,0,1,0,1,0
6881,6881,0,0,146,146,0,1,0,1,0
19553,25174,0,0,62,62,0,1,0,1,0
55439,37965,0,0,66,66,0,1,0,1,0
55538,22,0,0,60,60,0,1,0,1,0
1373,22114,0,0,63,63,0,1,0,1,0
63216,50415,0,0,64,64,0,1,0,1,0
57400,7252,0,0,65,65,0,1,0,1,0
30063,64147,0,0,64,64,0,1,0,1,0
58638,5900,0,0,62,62,0,1,0,1,0
51973,44847,0,0,66,66,0,1,0,1,0
35194,57470,0,0,74,74,0,1,0,1,0
10427,26467,0,0,62,62,0,1,0,1,0
58638,5900,0,0,62,62,0,1,0,1,0
63438,37965,0,0,62,62,0,1,0,1,0
62678,57470,0,0,62,62,0,1,0,1,0
53490,62413,0,0,64,64,0,1,0,1,0
56171,62413,0,0,66,66,0,1,0,1,0
62341,26467,0,0,63,63,0,1,0,1,0
44999,23,0,0,60,60,0,1,0,1,0
443,45940,0,0,85,85,0,1,0,1,0
58638,5900,0,0,62,62,0,1,0,1,0
56141,57470,0,0,62,62,0,1,0,1,0
61016,61689,0,0,118,118,0,1,0,1,0
64655,35993,0,0,66,66,0,1,0,1,0
60192,35440,0,0,63,63,0,1,0,1,0
58638,5900,0,0,62,62,0,1,0,1,0
59565,56205,0,0,65,65,0,1,0,1,0
22559,30188,0,0,62,62,0,1,0,1,0
46849,36237,0,0,65,65,0,1,0,1,0
14975,3067,0,0,61,61,0,1,0,1,0
35201,35440,0,0,63,63,0,1,0,1,0
1008,49048,0,0,136,136,0,1,0,1,0
13285,29892,0,0,145,145,0,1,0,1,0
60818,37965,0,0,63,63,0,1,0,1,0
55994,22114,0,0,66,66,0,1,0,1,0
55101,64106,0,0,66,66,0,1,0,1,0
11863,37820,0,0,138,138,0,1,0,1,0
46649,64147,0,0,62,62,0,1,0,1,0
26489,44847,0,0,102,102,0,1,0,1,0
7128,64147,0,0,63,63,0,1,0,1,0
58638,5900,0,0,62,62,0,1,0,1,0
51030,22114,0,0,95,95,0,1,0,1,0
443,60496,0,0,320,320,0,1,0,1,0
19703,9308,0,0,61,61,0,1,0,1,0
65025,37946,0,0,65,65,0,1,0,1,0
6666,3389,0,0,60,60,0,1,0,1,0
443,9999,0,0,189,189,0,1,0,1,0
48706,23393,0,0,60,60,0,1,0,1,0
50335,37965,0,0,66,66,0,1,0,1,0
34166,51418,0,0,62,62,0,1,0,1,0
1660,8696,0,0,92,92,0,1,0,1,0
59563,30188,0,0,66,66,0,1,0,1,0
41995,35440,0,0,62,62,0,1,0,1,0
58638,5900,0,0,62,62,0,1,0,1,0
17781,50265,0,0,62,62,0,1,0,1,0
53755,37965,0,0,66,66,0,1,0,1,0
27584,23,0,0,60,60,0,1,0,1,0
48706,23393,0,0,60,60,0,1,0,1,0
46499,50584,0,0,66,66,0,1,0,1,0
50890,6,0,0,61,61,0,1,0,1,0
58681,36829,0,0,74,74,0,1,0,1,0
58638,5900,0,0,62,62,0,1,0,1,0
59498,64105,0,0,65,65,0,1,0,1,0
58638,5900,0,0,62,62,0,1,0,1,0
9739,26467,0,0,62,62,0,1,0,1,0
8889,9805,0,0,60,60,0,1,0,1,0
64496,2378,0,0,131,131,0,1,0,1,0
54993,1433,0,0,60,60,0,1,0,1,0
61185,54532,0,0,62,62,0,1,0,1,0
50052,65008,0,0,60,60,0,1,0,1,0
51053,23572,0,0,63,63,0,1,0,1,0
53459,37807,0,0,82,82,0,1,0,1,0
7875,25174,0,0,97,97,0,1,0,1,0
63418,62413,0,0,66,66,0,1,0,1,0
1571,62413,0,0,62,62,0,1,0,1,0
53455,22114,0,0,65,65,0,1,0,1,0
7643,44387,0,0,66,66,0,1,0,1,0
60558,51221,0,0,62,62,0,1,0,1,0
63569,62413,0,0,66,66,0,1,0,1,0
5189,43978,0,0,121,121,0,1,0,1,0
51815,51221,0,0,74,74,0,1,0,1,0
33192,30188,0,0,62,62,0,1,0,1,0
24192,50897,0,0,90,90,0,1,0,1,0
61734,23718,0,0,63,63,0,1,0,1,0
49404,57470,0,0,62,62,0,1,0,1,0
52969,44847,0,0,65,65,0,1,0,1,0
12545,22114,0,0,138,138,0,1,0,1,0
58972,57866,0,0,66,66,0,1,0,1,0
53756,36237,0,0,65,65,0,1,0,1,0
50051,22,0,0,60,60,0,1,0,1,0
26792,25174,0,0,62,62,0,1,0,1,0
2693,48817,0,0,72,72,0,1,0,1,0
2777,7102,0,0,66,66,0,1,0,1,0
22374,22114,0,0,82,82,0,1,0,1,0
54186,64147,0,0,66,66,0,1,0,1,0
52648,64147,0,0,99,99,0,1,0,1,0
32859,30188,0,0,63,63,0,1,0,1,0
35015,56205,0,0,62,62,0,1,0,1,0
0,0,0,0,98,98,0,1,0,1,0
61616,37965,0,0,66,66,0,1,0,1,0
36939,50584,0,0,62,62,0,1,0,1,0
53008,62413,0,0,62,62,0,1,0,1,0
58338,3371,0,0,60,60,0,1,0,1,0
30143,64997,0,0,60,60,0,1,0,1,0
51582,48817,0,0,66,66,0,1,0,1,0
52241,53733,0,0,66,66,0,1,0,1,0
65043,55487,0,0,66,66,0,1,0,1,0
51979,44778,0,0,66,66,0,1,0,1,0
3945,35440,0,0,66,66,0,1,0,1,0
47910,7454,0,0,60,60,0,1,0,1,0
53772,37965,0,0,66,66,0,1,0,1,0
42625,22114,0,0,90,90,0,1,0,1,0
51762,51039,0,0,119,119,0,1,0,1,0
19330,25174,0,0,137,137,0,1,0,1,0
51414,22,0,0,60,60,0,1,0,1,0
11847,64147,0,0,62,62,0,1,0,1,0
7660,2139,0,0,65,65,0,1,0,1,0
993,4039,0,0,116,116,0,1,0,1,0
36325,64147,0,0,63,63,0,1,0,1,0
52556,57866,0,0,65,65,0,1,0,1,0
58638,5900,0,0,62,62,0,1,0,1,0
20087,8402,0,0,60,60,0,1,0,1,0
59508,22114,0,0,66,66,0,1,0,1,0
22285,25174,0,0,105,105,0,1,0,1,0
62776,62413,0,0,78,78,0,1,0,1,0
56309,22114,0,0,62,62,0,1,0,1,0
443,64347,0,0,87,87,0,1,0,1,0
58638,5900,0,0,62,62,0,1,0,1,0
61085,37965,0,0,62,62,0,1,0,1,0
25581,2269,0,0,60,60,0,1,0,1,0
49236,25174,0,0,66,66,0,1,0,1,0
61015,15503,0,0,144,144,0,1,0,1,0
0,0,0,0,98,98,0,1,0,1,0
61425,50584,0,0,62,62,0,1,0,1,0
59041,28116,0,0,62,62,0,1,0,1,0
64993,32404,0,0,66,66,0,1,0,1,0
39895,26467,0,0,62,62,0,1,0,1,0
45964,5333,0,0,60,60,0,1,0,1,0
37363,44847,0,0,66,66,0,1,0,1,0
62362,64147,0,0,62,62,0,1,0,1,0
26053,33720,0,0,160,160,0,1,0,1,0
53459,37807,0,0,62,62,0,1,0,1,0
1029,26379,0,0,111,111,0,1,0,1,0
8999,57470,0,0,146,146,0,1,0,1,0
43584,24748,0,0,156,156,0,1,0,1,0
57136,47098,0,0,64,64,0,1,0,1,0
62489,23117,0,0,66,66,0,1,0,1,0
5668,36060,0,0,65,65,0,1,0,1,0
2404,37904,0,0,66,66,0,1,0,1,0
33612,5562,0,0,137,137,0,1,0,1,0
443,48346,0,0,81,81,0,1,0,1,0
63173,36237,0,0,62,62,0,1,0,1,0
51191,26467,0,0,66,66,0,1,0,1,0
58638,5900,0,0,62,62,0,1,0,1,0
58071,18,0,0,60,60,0,1,0,1,0
45526,64147,0,0,66,66,0,1,0,1,0
43910,43,0,0,98,98,0,1,0,1,0
54496,25174,0,0,66,66,0,1,0,1,0
443,50199,0,0,63,63,0,1,0,1,0
58687,64123,0,0,64,64,0,1,0,1,0
48125,7557,0,0,60,60,0,1,0,1,0
64674,64147,0,0,66,66,0,1,0,1,0
58638,5900,0,0,62,62,0,1,0,1,0
15585,64147,0,0,62,62,0,1,0,1,0
30156,15503,0,0,69,69,0,1,0,1,0
55603,44847,0,0,64,64,0,1,0,1,0
65192,35440,0,0,63,63,0,1,0,1,0
61943,48817,0,0,68,68,0,1,0,1,0
20094,246,0,0,60,60,0,1,0,1,0
59667,62413,0,0,62,62,0,1,0,1,0
58638,5900,0,0,62,62,0,1,0,1,0
61804,64139,0,0,65,65,0,1,0,1,0
23379,57866,0,0,116,116,0,1,0,1,0
23363,63944,0,0,62,62,0,1,0,1,0
28023,36237,0,0,123,123,0,1,0,1,0
59241,62413,0,0,64,64,0,1,0,1,0
57274,51121,0,0,66,66,0,1,0,1,0
6005,22114,0,0,64,64,0,1,0,1,0
55300,57470,0,0,75,75,0,1,0,1,0
47350,50584,0,0,62,62,0,1,0,1,0
9845,64266,0,0,75,75,0,1,0,1,0
45160,3386,0,0,60,60,0,1,0,1,0
17400,62493,0,0,97,97,0,1,0,1,0
13900,37965,0,0,118,118,0,1,0,1,0
10678,44847,0,0,66,66,0,1,0,1,0
4323,64147,0,0,66,66,0,1,0,1,0
50569,22114,0,0,62,62,0,1,0,1,0
35486,30188,0,0,110,110,0,1,0,1,0
58638,5900,0,0,62,62,0,1,0,1,0
46790,50584,0,0,62,62,0,1,0,1,0
26497,64147,0,0,65,65,0,1,0,1,0
30181,61689,0,0,62,62,0,1,0,1,0
58638,5900,0,0,62,62,0,1,0,1,0
56258,44847,0,0,66,66,0,1,0,1,0
56609,51505,0,0,62,62,0,1,0,1,0
6868,48660,0,0,145,145,0,1,0,1,0
11695,23,0,0,60,60,0,1,0,1,0
57075,44847,0,0,62,62,0,1,0,1,0
60312,57470,0,0,74,74,0,1,0,1,0
65249,25864,0,0,72,72,0,1,0,1,0
52810,25174,0,0,66,66,0,1,0,1,0
53773,44847,0,0,66,66,0,1,0,1,0
55536,56205,0,0,66,66,0,1,0,1,0
49796,25174,0,0,66,66,0,1,0,1,0
60717,58414,0,0,62,62,0,1,0,1,0
54418,22114,0,0,66,66,0,1,0,1,0
22683,39210,0,0,60,60,0,1,0,1,0
51568,17518,0,0,62,62,0,1,0,1,0
57330,37965,0,0,62,62,0,1,0,1,0
63242,53137,0,0,68,68,0,1,0,1,0
52898,43890,0,0,65,65,0,1,0,1,0
56705,35401,0,0,62,62,0,1,0,1,0
41681,30616,0,0,113,113,0,1,0,1,0
11057,57683,0,0,91,91,0,1,0,1,0
9231,51505,0,0,137,137,0,1,0,1,0
48676,53392,0,0,60,60,0,1,0,1,0
40967,1433,0,0,60,60,0,1,0,1,0
49590,57470,0,0,78,78,0,1,0,1,0
15318,22114,0,0,63,63,0,1,0,1,0
58908,25174,0,0,65,65,0,1,0,1,0
19875,30170,0,0,145,145,0,1,0,1,0
58799,30188,0,0,66,66,0,1,0,1,0
5179,50265,0,0,62,62,0,1,0,1,0
41961,35440,0,0,62,62,0,1,0,1,0
7800,25174,0,0,65,65,0,1,0,1,0
59694,50584,0,0,64,64,0,1,0,1,0
65392,7126,0,0,65,65,0,1,0,1,0
57144,57470,0,0,63,63,0,1,0,1,0
45028,17,0,0,60,60,0,1,0,1,0
56265,43890,0,0,62,62,0,1,0,1,0
53967,57470,0,0,62,62,0,1,0,1,0
47802,25174,0,0,80,80,0,1,0,1,0
60422,25190,0,0,65,65,0,1,0,1,0
26464,37965,0,0,64,64,0,1,0,1,0
58638,5900,0,0,62,62,0,1,0,1,0
50920,60182,0,0,64,64,0,1,0,1,0
1861,25174,0,0,64,64,0,1,0,1,0
4207,55852,0,0,65,65,0,1,0,1,0
53631,64147,0,0,64,64,0,1,0,1,0
1183,64147,0,0,64,64,0,1,0,1,0
64481,37965,0,0,62,62,0,1,0,1,0
3169,22114,0,0,66,66,0,1,0,1,0
58638,5900,0,0,62,62,0,1,0,1,0
49043,40303,0,0,160,160,0,1,0,1,0
56196,51505,0,0,105,105,0,1,0,1,0
11761,44993,0,0,61,61,0,1,0,1,0
1026,25174,0,0,62,62,0,1,0,1,0
62768,35440,0,0,65,65,0,1,0,1,0
58452,44847,0,0,63,63,0,1,0,1,0
59453,37807,0,0,66,66,0,1,0,1,0
3926,50584,0,0,62,62,0,1,0,1,0
55201,26467,0,0,66,66,0,1,0,1,0
59694,50584,0,0,65,65,0,1,0,1,0
58972,57866,0,0,66,66,0,1,0,1,0
51560,46783,0,0,65,65,0,1,0,1,0
39881,62413,0,0,62,62,0,1,0,1,0
7080,21,0,0,61,61,0,1,0,1,0
56984,35868,0,0,79,79,0,1,0,1,0
10754,35440,0,0,66,66,0,1,0,1,0
1887,25174,0,0,62,62,0,1,0,1,0
19617,39004,0,0,142,142,0,1,0,1,0
50525,50584,0,0,62,62,0,1,0,1,0
22948,26467,0,0,62,62,0,1,0,1,0
59239,8370,0,0,65,65,0,1,0,1,0
30649,37965,0,0,62,62,0,1,0,1,0
59005,17428,0,0,66,66,0,1,0,1,0
59451,50584,0,0,62,62,0,1,0,1,0
40977,21247,0,0,62,62,0,1,0,1,0
64678,35993,0,0,62,62,0,1,0,1,0
1373,22114,0,0,63,63,0,1,0,1,0
58638,5900,0,0,62,62,0,1,0,1,0
60702,64147,0,0,62,62,0,1,0,1,0
58638,5900,0,0,62,62,0,1,0,1,0
58638,5900,0,0,62,62,0,1,0,1,0
52456,50379,0,0,62,62,0,1,0,1,0
62854,62413,0,0,62,62,0,1,0,1,0
62034,22114,0,0,66,66,0,1,0,1,0
33314,57359,0,0,141,141,0,1,0,1,0
43671,17372,0,0,62,62,0,1,0,1,0
443,20105,0,0,83,83,0,1,0,1,0
55111,39004,0,0,66,66,0,1,0,1,0
62039,64137,0,0,65,65,0,1,0,1,0
8352,37965,0,0,62,62,0,1,0,1,0
7233,22114,0,0,62,62,0,1,0,1,0
443,61686,0,0,1326,1326,0,1,0,1,0
28567,23,0,0,60,60,0,1,0,1,0
64586,50584,0,0,124,124,0,1,0,1,0
45941,23386,0,0,60,60,0,1,0,1,0
50306,48952,0,0,111,111,0,1,0,1,0
53539,44847,0,0,64,64,0,1,0,1,0
45964,55559,0,0,60,60,0,1,0,1,0
10208,11392,0,0,65,65,0,1,0,1,0
22771,48817,0,0,113,113,0,1,0,1,0
52553,30188,0,0,64,64,0,1,0,1,0
32678,64106,0,0,81,81,0,1,0,1,0
54815,50460,0,0,116,116,0,1,0,1,0
11458,2767,0,0,62,62,0,1,0,1,0
18563,35440,0,0,146,146,0,1,0,1,0
53461,37807,0,0,62,62,0,1,0,1,0
41607,1868,0,0,133,133,0,1,0,1,0
58638,5900,0,0,62,62,0,1,0,1,0
16380,35382,0,0,61,61,0,1,0,1,0
45513,25174,0,0,71,71,0,1,0,1,0
64989,50265,0,0,66,66,0,1,0,1,0
68,67,0,0,594,594,0,1,0,1,0
22856,22114,0,0,66,66,0,1,0,1,0
9297,57470,0,0,64,64,0,1,0,1,0
55428,25174,0,0,62,62,0,1,0,1,0
52195,22114,0,0,64,64,0,1,0,1,0
57410,37965,0,0,66,66,0,1,0,1,0
10005,64147,0,0,62,62,0,1,0,1,0
48022,22086,0,0,66,66,0,1,0,1,0
57837,64147,0,0,66,66,0,1,0,1,0
6933,57119,0,0,97,97,0,1,0,1,0
33478,5637,0,0,120,120,0,1,0,1,0
62421,37965,0,0,62,62,0,1,0,1,0
1114,37965,0,0,62,62,0,1,0,1,0
57492,56205,0,0,66,66,0,1,0,1,0
27677,22114,0,0,74,74,0,1,0,1,0
45713,25516,0,0,62,62,0,1,0,1,0
6666,50070,0,0,60,60,0,1,0,1,0
12751,35440,0,0,62,62,0,1,0,1,0
56391,51505,0,0,63,63,0,1,0,1,0
64075,50584,0,0,66,66,0,1,0,1,0
62845,37965,0,0,64,64,0,1,0,1,0
50554,51505,0,0,66,66,0,1,0,1,0
58638,5900,0,0,62,62,0,1,0,1,0
35487,35234,0,0,151,151,0,1,0,1,0
58638,5900,0,0,62,62,0,1,0,1,0
6712,5632,0,0,60,60,0,1,0,1,0
59739,35253,0,0,62,62,0,1,0,1,0
26884,37965,0,0,66,66,0,1,0,1,0
23553,37965,0,0,62,62,0,1,0,1,0
18271,11392,0,0,62,62,0,1,0,1,0
23942,26467,0,0,62,62,0,1,0,1,0
58638,5900,0,0,62,62,0,1,0,1,0
30432,36199,0,0,69,69,0,1,0,1,0
50921,53733,0,0,65,65,0,1,0,1,0
43052,57470,0,0,62,62,0,1,0,1,0
3478,61463,0,0,164,164,0,1,0,1,0
50716,50584,0,0,72,72,0,1,0,1,0
50562,37965,0,0,66,66,0,1,0,1,0
51991,25174,0,0,62,62,0,1,0,1,0
60044,15503,0,0,93,93,0,1,0,1,0
60049,25174,0,0,66,66,0,1,0,1,0
58638,5900,0,0,62,62,0,1,0,1,0
7619,50584,0,0,129,129,0,1,0,1,0
39577,37965,0,0,66,66,0,1,0,1,0
19669,451,0,0,60,60,0,1,0,1,0
65115,50584,0,0,66,66,0,1,0,1,0
43584,24748,0,0,156,156,0,1,0,1,0
28973,30188,0,0,66,66,0,1,0,1,0
36424,25174,0,0,119,119,0,1,0,1,0
58638,5900,0,0,62,62,0,1,0,1,0
61233,42867,0,0,66,66,0,1,0,1,0
24079,22127,0,0,61,61,0,1,0,1,0
49336,25174,0,0,66,66,0,1,0,1,0
35454,12410,0,0,128,128,0,1,0,1,0
741,33004,0,0,76,76,0,1,0,1,0
53837,22114,0,0,62,62,0,1,0,1,0
14309,56205,0,0,62,62,0,1,0,1,0
62733,44847,0,0,142,142,0,1,0,1,0
47708,25174,0,0,78,78,0,1,0,1,0
22948,26467,0,0,62,62,0,1,0,1,0
24545,22358,0,0,104,104,0,1,0,1,0
3802,55777,0,0,66,66,0,1,0,1,0
51475,26120,0,0,69,69,0,1,0,1,0
2782,25174,0,0,107,107,0,1,0,1,0
48706,23393,0,0,60,60,0,1,0,1,0
25007,1523,0,0,60,60,0,1,0,1,0
42632,44847,0,0,87,87,0,1,0,1,0
53979,5981,0,0,64,64,0,1,0,1,0
59934,35440,0,0,64,64,0,1,0,1,0
51106,23309,0,0,66,66,0,1,0,1,0
45904,2192,0,0,67,67,0,1,0,1,0
43815,22114,0,0,64,64,0,1,0,1,0
61290,48804,0,0,63,63,0,1,0,1,0
56873,50584,0,0,62,62,0,1,0,1,0
58594,50584,0,0,66,66,0,1,0,1,0
51534,44847,0,0,62,62,0,1,0,1,0
6830,5563,0,0,115,115,0,1,0,1,0
57462,57470,0,0,64,64,0,1,0,1,0
63276,52950,0,0,65,65,0,1,0,1,0
19925,22114,0,0,90,90,0,1,0,1,0
58638,5900,0,0,62,62,0,1,0,1,0
43688,22114,0,0,64,64,0,1,0,1,0
34134,5818,0,0,78,78,0,1,0,1,0
55676,37965,0,0,66,66,0,1,0,1,0
54754,50584,0,0,103,103,0,1,0,1,0
56041,25174,0,0,62,62,0,1,0,1,0
53406,44847,0,0,66,66,0,1,0,1,0
50222,42873,0,0,66,66,0,1,0,1,0
1201,8454,0,0,65,65,0,1,0,1,0
24663,26472,0,0,65,65,0,1,0,1,0
25477,35706,0,0,145,145,0,1,0,1,0
28973,11392,0,0,131,131,0,1,0,1,0
16387,63826,0,0,60,60,0,1,0,1,0
41444,23,0,0,60,60,0,1,0,1,0
60842,50584,0,0,63,63,0,1,0,1,0
19634,64147,0,0,62,62,0,1,0,1,0
10834,50584,0,0,66,66,0,1,0,1,0
63259,22114,0,0,62,62,0,1,0,1,0
57035,21247,0,0,68,68,0,1,0,1,0
18782,56277,0,0,69,69,0,1,0,1,0
60096,37965,0,0,66,66,0,1,0,1,0
19638,3200,0,0,97,97,0,1,0,1,0
54471,36237,0,0,66,66,0,1,0,1,0
58638,5900,0,0,62,62,0,1,0,1,0
43665,35440,0,0,80,80,0,1,0,1,0
57706,62413,0,0,66,66,0,1,0,1,0
58213,5368,0,0,114,114,0,1,0,1,0
58805,64136,0,0,62,62,0,1,0,1,0
60765,15503,0,0,145,145,0,1,0,1,0
58638,5900,0,0,62,62,0,1,0,1,0
37075,48817,0,0,62,62,0,1,0,1,0
50735,64147,0,0,66,66,0,1,0,1,0
35232,20174,0,0,64,64,0,1,0,1,0
60041,37965,0,0,66,66,0,1,0,1,0
31780,23,0,0,60,60,0,1,0,1,0
57357,51221,0,0,66,66,0,1,0,1,0
14693,64147,0,0,62,62,0,1,0,1,0
58638,5900,0,0,62,62,0,1,0,1,0
37959,3855,0,0,72,72,0,1,0,1,0
50080,30188,0,0,66,66,0,1,0,1,0
8921,48075,0,0,85,85,0,1,0,1,0
56358,35297,0,0,65,65,0,1,0,1,0
53439,44847,0,0,66,66,0,1,0,1,0
30580,41581,0,0,145,145,0,1,0,1,0
45964,2225,0,0,60,60,0,1,0,1,0
48706,23393,0,0,60,60,0,1,0,1,0
58638,5900,0,0,62,62,0,1,0,1,0
16380,35504,0,0,61,61,0,1,0,1,0
3441,45194,0,0,97,97,0,1,0,1,0
43270,50584,0,0,62,62,0,1,0,1,0
63105,25174,0,0,66,66,0,1,0,1,0
54043,36237,0,0,66,66,0,1,0,1,0
53778,25174,0,0,63,63,0,1,0,1,0
53540,44847,0,0,64,64,0,1,0,1,0
1337,22114,0,0,74,74,0,1,0,1,0
60426,57470,0,0,62,62,0,1,0,1,0
7889,22114,0,0,66,66,0,1,0,1,0
58638,5900,0,0,62,62,0,1,0,1,0
61522,64147,0,0,63,63,0,1,0,1,0
62339,25174,0,0,64,64,0,1,0,1,0
5926,25174,0,0,126,126,0,1,0,1,0
53302,2309,0,0,104,104,0,1,0,1,0
59034,51221,0,0,66,66,0,1,0,1,0
9327,57470,0,0,62,62,0,1,0,1,0
10427,32480,0,0,65,65,0,1,0,1,0
2704,37,0,0,60,60,0,1,0,1,0
32334,47890,0,0,117,117,0,1,0,1,0
58638,5900,0,0,62,62,0,1,0,1,0
58638,5900,0,0,62,62,0,1,0,1,0
10240,46936,0,0,61,61,0,1,0,1,0
63242,50584,0,0,63,63,0,1,0,1,0
20576,37965,0,0,62,62,0,1,0,1,0
22701,30188,0,0,62,62,0,1,0,1,0
53271,36237,0,0,62,62,0,1,0,1,0
56124,22114,0,0,66,66,0,1,0,1,0
21581,50214,0,0,65,65,0,1,0,1,0
61692,37965,0,0,66,66,0,1,0,1,0
39709,36467,0,0,62,62,0,1,0,1,0
24165,57470,0,0,62,62,0,1,0,1,0
14070,21297,0,0,141,141,0,1,0,1,0
61233,22114,0,0,63,63,0,1,0,1,0
62070,22114,0,0,62,62,0,1,0,1,0
35453,35440,0,0,145,145,0,1,0,1,0
62836,35440,0,0,66,66,0,1,0,1,0
7900,22114,0,0,66,66,0,1,0,1,0
53884,31573,0,0,66,66,0,1,0,1,0
18758,35440,0,0,128,128,0,1,0,1,0
16733,10228,0,0,73,73,0,1,0,1,0
58638,5900,0,0,62,62,0,1,0,1,0
4427,23,0,0,60,60,0,1,0,1,0
19875,30170,0,0,145,145,0,1,0,1,0
1077,51237,0,0,62,62,0,1,0,1,0
51789,22114,0,0,62,62,0,1,0,1,0
58638,5900,0,0,62,62,0,1,0,1,0
1025,35447,0,0,62,62,0,1,0,1,0
47910,7454,0,0,60,60,0,1,0,1,0
80,9918,0,0,60,60,0,1,0,1,0
56025,22114,0,0,66,66,0,1,0,1,0
39297,51505,0,0,62,62,0,1,0,1,0
15238,25174,0,0,146,146,0,1,0,1,0
443,45912,0,0,105,105,0,1,0,1,0
32611,50584,0,0,64,64,0,1,0,1,0
3434,17372,0,0,62,62,0,1,0,1,0
58638,5900,0,0,62,62,0,1,0,1,0
16191,50584,0,0,81,81,0,1,0,1,0
26944,44847,0,0,62,62,0,1,0,1,0
57131,7909,0,0,145,145,0,1,0,1,0
44229,64053,0,0,63,63,0,1,0,1,0
10723,50584,0,0,78,78,0,1,0,1,0
11692,25174,0,0,64,64,0,1,0,1,0
44198,44847,0,0,65,65,0,1,0,1,0
58089,21247,0,0,66,66,0,1,0,1,0
52917,3017,0,0,63,63,0,1,0,1,0
22301,30188,0,0,65,65,0,1,0,1,0
57364,34159,0,0,84,84,0,1,0,1,0
37308,43890,0,0,62,62,0,1,0,1,0
51778,30188,0,0,65,65,0,1,0,1,0
63733,50584,0,0,66,66,0,1,0,1,0
53051,44847,0,0,65,65,0,1,0,1,0
56676,37965,0,0,66,66,0,1,0,1,0
2705,37,0,0,60,60,0,1,0,1,0
51027,2089,0,0,103,103,0,1,0,1,0
60754,42714,0,0,66,66,0,1,0,1,0
52963,37965,0,0,65,65,0,1,0,1,0
26714,25174,0,0,62,62,0,1,0,1,0
59933,44847,0,0,63,63,0,1,0,1,0
3802,51575,0,0,65,65,0,1,0,1,0
57070,26346,0,0,120,120,0,1,0,1,0
55240,57470,0,0,75,75,0,1,0,1,0
58638,5900,0,0,62,62,0,1,0,1,0
45941,23386,0,0,60,60,0,1,0,1,0
52805,57470,0,0,137,137,0,1,0,1,0
59837,62413,0,0,66,66,0,1,0,1,0
56255,36237,0,0,65,65,0,1,0,1,0
52517,36237,0,0,62,62,0,1,0,1,0
33738,44847,0,0,63,63,0,1,0,1,0
34812,51185,0,0,61,61,0,1,0,1,0
38549,22114,0,0,120,120,0,1,0,1,0
54328,28587,0,0,66,66,0,1,0,1,0
18618,26467,0,0,62,62,0,1,0,1,0
6666,62078,0,0,60,60,0,1,0,1,0
48712,54532,0,0,112,112,0,1,0,1,0
1323,12082,0,0,64,64,0,1,0,1,0
46827,8734,0,0,85,85,0,1,0,1,0
59731,51505,0,0,141,141,0,1,0,1,0
49483,56728,0,0,64,64,0,1,0,1,0
55406,22114,0,0,95,95,0,1,0,1,0
59596,57470,0,0,65,65,0,1,0,1,0
58638,5900,0,0,62,62,0,1,0,1,0
57578,51221,0,0,65,65,0,1,0,1,0
43691,538,0,0,60,60,0,1,0,1,0
28335,64147,0,0,66,66,0,1,0,1,0
11349,43021,0,0,62,62,0,1,0,1,0
57538,51314,0,0,66,66,0,1,0,1,0
38591,22114,0,0,62,62,0,1,0,1,0
9279,22114,0,0,146,146,0,1,0,1,0
37528,50584,0,0,66,66,0,1,0,1,0
19875,30170,0,0,145,145,0,1,0,1,0
50971,59195,0,0,79,79,0,1,0,1,0
25635,8168,0,0,63,63,0,1,0,1,0
58638,5900,0,0,62,62,0,1,0,1,0
55600,22,0,0,60,60,0,1,0,1,0
35437,44847,0,0,135,135,0,1,0,1,0
62413,50584,0,0,66,66,0,1,0,1,0
53746,36237,0,0,66,66,0,1,0,1,0
13628,43460,0,0,409,409,0,1,0,1,0
25253,50584,0,0,146,146,0,1,0,1,0
6666,3389,0,0,60,60,0,1,0,1,0
50470,61463,0,0,86,86,0,1,0,1,0
31151,18,0,0,77,77,0,1,0,1,0
45941,23386,0,0,60,60,0,1,0,1,0
58284,50584,0,0,62,62,0,1,0,1,0
47814,20362,0,0,70,70,0,1,0,1,0
56104,50584,0,0,66,66,0,1,0,1,0
40512,57470,0,0,74,74,0,1,0,1,0
53428,36237,0,0,65,65,0,1,0,1,0
58638,5900,0,0,62,62,0,1,0,1,0
49956,57470,0,0,64,64,0,1,0,1,0
56098,64147,0,0,66,66,0,1,0,1,0
58305,51180,0,0,66,66,0,1,0,1,0
59545,53716,0,0,62,62,0,1,0,1,0
58638,5900,0,0,62,62,0,1,0,1,0
37952,50328,0,0,82,82,0,1,0,1,0
49331,22114,0,0,62,62,0,1,0,1,0
51322,7272,0,0,61,61,0,1,0,1,0
34932,38608,0,0,62,62,0,1,0,1,0
7899,22114,0,0,66,66,0,1,0,1,0
56179,55442,0,0,66,66,0,1,0,1,0
49842,7302,0,0,64,64,0,1,0,1,0
5304,21450,0,0,62,62,0,1,0,1,0
52232,56127,0,0,63,63,0,1,0,1,0
6881,6881,0,0,62,62,0,1,0,1,0
36996,25174,0,0,146,146,0,1,0,1,0
50642,57470,0,0,66,66,0,1,0,1,0
60720,23718,0,0,62,62,0,1,0,1,0
61266,26571,0,0,66,66,0,1,0,1,0
64878,26467,0,0,62,62,0,1,0,1,0
26616,22114,0,0,123,123,0,1,0,1,0
16876,16,0,0,60,60,0,1,0,1,0
52310,44847,0,0,63,63,0,1,0,1,0
16415,55532,0,0,64,64,0,1,0,1,0
51361,22114,0,0,65,65,0,1,0,1,0
57942,10297,0,0,107,107,0,1,0,1,0
61457,37917,0,0,66,66,0,1,0,1,0
35319,51505,0,0,118,118,0,1,0,1,0
6885,55108,0,0,147,147,0,1,0,1,0
59868,36237,0,0,62,62,0,1,0,1,0
64727,25174,0,0,66,66,0,1,0,1,0
63910,44847,0,0,64,64,0,1,0,1,0
53992,50265,0,0,64,64,0,1,0,1,0
58638,5900,0,0,62,62,0,1,0,1,0
63779,26467,0,0,62,62,0,1,0,1,0
58638,5900,0,0,62,62,0,1,0,1,0
42440,22114,0,0,62,62,0,1,0,1,0
58638,5900,0,0,62,62,0,1,0,1,0
63290,57470,0,0,66,66,0,1,0,1,0
23616,37861,0,0,62,62,0,1,0,1,0
56753,44847,0,0,62,62,0,1,0,1,0
22790,30180,0,0,102,102,0,1,0,1,0
58638,5900,0,0,62,62,0,1,0,1,0
42591,51097,0,0,91,91,0,1,0,1,0
51114,46182,0,0,62,62,0,1,0,1,0
43584,24748,0,0,156,156,0,1,0,1,0
36610,51505,0,0,64,64,0,1,0,1,0
10534,20841,0,0,62,62,0,1,0,1,0
58638,5900,0,0,62,62,0,1,0,1,0
58638,5900,0,0,62,62,0,1,0,1,0
58638,5900,0,0,62,62,0,1,0,1,0
51582,11392,0,0,66,66,0,1,0,1,0
58638,5900,0,0,62,62,0,1,0,1,0
50135,22,0,0,60,60,0,1,0,1,0
58453,57470,0,0,66,66,0,1,0,1,0
59244,21247,0,0,62,62,0,1,0,1,0
443,10010,0,0,60,60,0,1,0,1,0
50759,37901,0,0,63,63,0,1,0,1,0
37013,25174,0,0,68,68,0,1,0,1,0
50910,30072,0,0,66,66,0,1,0,1,0
56693,25174,0,0,65,65,0,1,0,1,0
41710,56205,0,0,63,63,0,1,0,1,0
48706,23393,0,0,60,60,0,1,0,1,0
21420,44847,0,0,66,66,0,1,0,1,0
46407,35440,0,0,66,66,0,1,0,1,0
29512,30188,0,0,62,62,0,1,0,1,0
18403,51407,0,0,62,62,0,1,0,1,0
16059,22114,0,0,62,62,0,1,0,1,0
58638,5900,0,0,62,62,0,1,0,1,0
45529,8122,0,0,61,61,0,1,0,1,0
27637,50584,0,0,63,63,0,1,0,1,0
65200,44847,0,0,62,62,0,1,0,1,0
16378,21099,0,0,61,61,0,1,0,1,0
58283,37850,0,0,66,66,0,1,0,1,0
64363,22114,0,0,62,62,0,1,0,1,0
61369,64147,0,0,62,62,0,1,0,1,0
27055,25174,0,0,64,64,0,1,0,1,0
58638,5900,0,0,62,62,0,1,0,1,0
6881,6881,0,0,62,62,0,1,0,1,0
59679,37807,0,0,66,66,0,1,0,1,0
58638,5900,0,0,62,62,0,1,0,1,0
49483,56810,0,0,62,62,0,1,0,1,0
42056,1433,0,0,60,60,0,1,0,1,0
14203,51201,0,0,75,75,0,1,0,1,0
26494,26467,0,0,62,62,0,1,0,1,0
2340,23117,0,0,146,146,0,1,0,1,0
60800,25174,0,0,66,66,0,1,0,1,0
42372,22114,0,0,64,64,0,1,0,1,0
4486,35589,0,0,66,66,0,1,0,1,0
59214,57866,0,0,66,66,0,1,0,1,0
27010,44847,0,0,62,62,0,1,0,1,0
38852,37965,0,0,62,62,0,1,0,1,0
59747,25174,0,0,62,62,0,1,0,1,0
14618,6881,0,0,64,64,0,1,0,1,0
58638,5900,0,0,62,62,0,1,0,1,0
19348,25174,0,0,146,146,0,1,0,1,0
57131,35776,0,0,145,145,0,1,0,1,0
58638,5900,0,0,62,62,0,1,0,1,0
27110,22114,0,0,61,61,0,1,0,1,0
49628,30188,0,0,63,63,0,1,0,1,0
33208,50584,0,0,62,62,0,1,0,1,0
15341,23,0,0,60,60,0,1,0,1,0
22528,24759,0,0,63,63,0,1,0,1,0
25928,27189,0,0,63,63,0,1,0,1,0
61176,27248,0,0,63,63,0,1,0,1,0
53047,25174,0,0,66,66,0,1,0,1,0
55234,37858,0,0,63,63,0,1,0,1,0
55297,50584,0,0,66,66,0,1,0,1,0
62680,35440,0,0,66,66,0,1,0,1,0
32715,22114,0,0,62,62,0,1,0,1,0
18142,23,0,0,60,60,0,1,0,1,0
29565,26467,0,0,63,63,0,1,0,1,0
12144,22114,0,0,118,118,0,1,0,1,0
2238,22114,0,0,84,84,0,1,0,1,0
6974,33742,0,0,115,115,0,1,0,1,0
6924,33812,0,0,155,155,0,1,0,1,0
62895,22,0,0,60,60,0,1,0,1,0
64066,23718,0,0,62,62,0,1,0,1,0
53551,28315,0,0,61,61,0,1,0,1,0
35682,48562,0,0,61,61,0,1,0,1,0
3478,61463,0,0,157,157,0,1,0,1,0
64403,36829,0,0,64,64,0,1,0,1,0
47910,7454,0,0,60,60,0,1,0,1,0
59008,51221,0,0,66,66,0,1,0,1,0
20576,37965,0,0,62,62,0,1,0,1,0
3223,50584,0,0,62,62,0,1,0,1,0
9437,2323,0,0,60,60,0,1,0,1,0
58343,23718,0,0,66,66,0,1,0,1,0
50084,26672,0,0,119,119,0,1,0,1,0
56712,25174,0,0,62,62,0,1,0,1,0
46853,1433,0,0,60,60,0,1,0,1,0
45682,37965,0,0,86,86,0,1,0,1,0
58638,5900,0,0,62,62,0,1,0,1,0
45941,23388,0,0,60,60,0,1,0,1,0
6052,25174,0,0,64,64,0,1,0,1,0
80,53945,0,0,60,60,0,1,0,1,0
38667,37958,0,0,145,145,0,1,0,1,0
57564,56205,0,0,66,66,0,1,0,1,0
45941,23388,0,0,60,60,0,1,0,1,0
19875,30170,0,0,145,145,0,1,0,1,0
63702,50584,0,0,62,62,0,1,0,1,0
38386,51505,0,0,132,132,0,1,0,1,0
53454,44847,0,0,62,62,0,1,0,1,0
53485,37807,0,0,88,88,0,1,0,1,0
2083,25174,0,0,86,86,0,1,0,1,0
58638,5900,0,0,62,62,0,1,0,1,0
56198,44847,0,0,65,65,0,1,0,1,0
1861,25174,0,0,64,64,0,1,0,1,0
14659,64147,0,0,73,73,0,1,0,1,0
10650,5898,0,0,81,81,0,1,0,1,0
58590,25119,0,0,72,72,0,1,0,1,0
3478,61463,0,0,164,164,0,1,0,1,0
59149,50584,0,0,66,66,0,1,0,1,0
16387,64075,0,0,60,60,0,1,0,1,0
59440,50584,0,0,64,64,0,1,0,1,0
58284,64147,0,0,68,68,0,1,0,1,0
3003,50584,0,0,62,62,0,1,0,1,0
60130,29,0,0,66,66,0,1,0,1,0
65486,57470,0,0,71,71,0,1,0,1,0
18745,64147,0,0,64,64,0,1,0,1,0
56007,56205,0,0,66,66,0,1,0,1,0
59424,50265,0,0,71,71,0,1,0,1,0
52144,49344,0,0,62,62,0,1,0,1,0
60285,23522,0,0,66,66,0,1,0,1,0
31021,35440,0,0,62,62,0,1,0,1,0
443,44683,0,0,83,83,0,1,0,1,0
63439,50584,0,0,66,66,0,1,0,1,0
22530,23718,0,0,66,66,0,1,0,1,0
59845,44847,0,0,66,66,0,1,0,1,0
50562,37965,0,0,63,63,0,1,0,1,0
58098,50344,0,0,125,125,0,1,0,1,0
60905,25174,0,0,65,65,0,1,0,1,0
65231,25925,0,0,71,71,0,1,0,1,0
23935,41615,0,0,145,145,0,1,0,1,0
54737,50584,0,0,66,66,0,1,0,1,0
12531,22114,0,0,62,62,0,1,0,1,0
19875,30170,0,0,145,145,0,1,0,1,0
50907,30069,0,0,66,66,0,1,0,1,0
1605,53700,0,0,66,66,0,1,0,1,0
49805,6881,0,0,66,66,0,1,0,1,0
57607,21247,0,0,66,66,0,1,0,1,0
26315,22114,0,0,121,121,0,1,0,1,0
57761,15503,0,0,62,62,0,1,0,1,0
58855,30188,0,0,63,63,0,1,0,1,0
30149,64147,0,0,62,62,0,1,0,1,0
53357,26467,0,0,63,63,0,1,0,1,0
26423,64147,0,0,62,62,0,1,0,1,0
65421,26467,0,0,62,62,0,1,0,1,0
63838,64147,0,0,66,66,0,1,0,1,0
58638,5900,0,0,62,62,0,1,0,1,0
443,9979,0,0,60,60,0,1,0,1,0
57588,26401,0,0,93,93,0,1,0,1,0
51062,1433,0,0,60,60,0,1,0,1,0
2598,23718,0,0,66,66,0,1,0,1,0
60481,36428,0,0,64,64,0,1,0,1,0
41911,59932,0,0,65,65,0,1,0,1,0
63786,25174,0,0,62,62,0,1,0,1,0
443,10010,0,0,60,60,0,1,0,1,0
443,50140,0,0,233,233,0,1,0,1,0
31688,25174,0,0,146,146,0,1,0,1,0
57471,62413,0,0,62,62,0,1,0,1,0
58921,51505,0,0,64,64,0,1,0,1,0
59523,37965,0,0,62,62,0,1,0,1,0
5213,44847,0,0,65,65,0,1,0,1,0
61637,37965,0,0,66,66,0,1,0,1,0
53144,50584,0,0,66,66,0,1,0,1,0
4520,35666,0,0,88,88,0,1,0,1,0
58638,5900,0,0,62,62,0,1,0,1,0
12438,22114,0,0,62,62,0,1,0,1,0
44251,26467,0,0,62,62,0,1,0,1,0
7794,23,0,0,60,60,0,1,0,1,0
64333,57470,0,0,78,78,0,1,0,1,0
57239,161,0,0,83,83,0,1,0,1,0
46355,35440,0,0,66,66,0,1,0,1,0
3023,44847,0,0,62,62,0,1,0,1,0
2932,44847,0,0,66,66,0,1,0,1,0
43063,57470,0,0,62,62,0,1,0,1,0
1907,44847,0,0,65,65,0,1,0,1,0
57564,56205,0,0,66,66,0,1,0,1,0
14288,64147,0,0,76,76,0,1,0,1,0
6865,9054,0,0,134,134,0,1,0,1,0
24930,37965,0,0,62,62,0,1,0,1,0
12530,35440,0,0,62,62,0,1,0,1,0
57438,51505,0,0,66,66,0,1,0,1,0
32296,30188,0,0,62,62,0,1,0,1,0
6881,6881,0,0,62,62,0,1,0,1,0
58638,5900,0,0,62,62,0,1,0,1,0
19875,30170,0,0,145,145,0,1,0,1,0
59145,50584,0,0,66,66,0,1,0,1,0
35494,22114,0,0,62,62,0,1,0,1,0
25556,64147,0,0,63,63,0,1,0,1,0
443,54507,0,0,82,82,0,1,0,1,0
3096,64147,0,0,62,62,0,1,0,1,0
41962,26337,0,0,124,124,0,1,0,1,0
58638,5900,0,0,62,62,0,1,0,1,0
63409,26458,0,0,70,70,0,1,0,1,0
6897,57470,0,0,97,97,0,1,0,1,0
58447,44847,0,0,62,62,0,1,0,1,0
56696,25174,0,0,64,64,0,1,0,1,0
1024,64147,0,0,62,62,0,1,0,1,0
64878,26467,0,0,62,62,0,1,0,1,0
38852,37965,0,0,62,62,0,1,0,1,0
60028,15503,0,0,66,66,0,1,0,1,0
11136,17500,0,0,106,106,0,1,0,1,0
56383,26467,0,0,66,66,0,1,0,1,0
58638,5900,0,0,62,62,0,1,0,1,0
53706,36087,0,0,62,62,0,1,0,1,0
15524,64147,0,0,64,64,0,1,0,1,0
28887,37965,0,0,62,62,0,1,0,1,0
26531,37965,0,0,62,62,0,1,0,1,0
12494,42289,0,0,100,100,0,1,0,1,0
59938,22114,0,0,135,135,0,1,0,1,0
59111,57866,0,0,66,66,0,1,0,1,0
45941,23386,0,0,60,60,0,1,0,1,0
59462,5920,0,0,61,61,0,1,0,1,0
35186,30997,0,0,62,62,0,1,0,1,0
6740,37965,0,0,75,75,0,1,0,1,0
52594,22114,0,0,65,65,0,1,0,1,0
50512,25174,0,0,100,100,0,1,0,1,0
34140,11287,0,0,75,75,0,1,0,1,0
21492,51505,0,0,63,63,0,1,0,1,0
49126,21286,0,0,74,74,0,1,0,1,0
18704,64147,0,0,62,62,0,1,0,1,0
26747,44847,0,0,63,63,0,1,0,1,0
58638,5900,0,0,62,62,0,1,0,1,0
38774,22114,0,0,65,65,0,1,0,1,0
52284,50265,0,0,66,66,0,1,0,1,0
50998,46026,0,0,62,62,0,1,0,1,0
11983,57470,0,0,62,62,0,1,0,1,0
56515,32479,0,0,62,62,0,1,0,1,0
59544,25174,0,0,131,131,0,1,0,1,0
27906,56205,0,0,134,134,0,1,0,1,0
51607,17372,0,0,65,65,0,1,0,1,0
63302,57470,0,0,66,66,0,1,0,1,0
22611,10134,0,0,65,65,0,1,0,1,0
16951,12,0,0,60,60,0,1,0,1,0
52015,44568,0,0,66,66,0,1,0,1,0
16038,44847,0,0,64,64,0,1,0,1,0
60221,26467,0,0,64,64,0,1,0,1,0
21311,22,0,0,60,60,0,1,0,1,0
49485,11392,0,0,62,62,0,1,0,1,0
65001,57470,0,0,77,77,0,1,0,1,0
55199,21247,0,0,66,66,0,1,0,1,0
17043,57470,0,0,62,62,0,1,0,1,0
51407,46438,0,0,124,124,0,1,0,1,0
2165,51505,0,0,62,62,0,1,0,1,0
27442,44847,0,0,62,62,0,1,0,1,0
41405,56066,0,0,65,65,0,1,0,1,0
45964,2710,0,0,60,60,0,1,0,1,0
5255,44847,0,0,62,62,0,1,0,1,0
43828,44847,0,0,66,66,0,1,0,1,0
80,9918,0,0,60,60,0,1,0,1,0
65115,50584,0,0,62,62,0,1,0,1,0
18374,64112,0,0,62,62,0,1,0,1,0
19114,64147,0,0,62,62,0,1,0,1,0
8229,22114,0,0,66,66,0,1,0,1,0
49578,26467,0,0,63,63,0,1,0,1,0
443,43944,0,0,79,79,0,1,0,1,0
60789,35440,0,0,64,64,0,1,0,1,0
62408,50584,0,0,66,66,0,1,0,1,0
54434,11392,0,0,66,66,0,1,0,1,0
11716,37965,0,0,62,62,0,1,0,1,0
34956,22114,0,0,66,66,0,1,0,1,0
58638,5900,0,0,62,62,0,1,0,1,0
64077,25174,0,0,65,65,0,1,0,1,0
63270,53001,0,0,64,64,0,1,0,1,0
54319,11392,0,0,66,66,0,1,0,1,0
28993,8335,0,0,61,61,0,1,0,1,0
749,5963,0,0,69,69,0,1,0,1,0
62866,21247,0,0,66,66,0,1,0,1,0
3047,50584,0,0,62,62,0,1,0,1,0
443,39992,0,0,74,74,0,1,0,1,0
31173,30188,0,0,62,62,0,1,0,1,0
36154,22,0,0,60,60,0,1,0,1,0
27507,25174,0,0,65,65,0,1,0,1,0
8239,37965,0,0,146,146,0,1,0,1,0
54771,50584,0,0,105,105,0,1,0,1,0
52538,43890,0,0,66,66,0,1,0,1,0
37692,25770,0,0,109,109,0,1,0,1,0
10669,49756,0,0,60,60,0,1,0,1,0
58638,5900,0,0,62,62,0,1,0,1,0
58347,52756,0,0,64,64,0,1,0,1,0
49161,50584,0,0,128,128,0,1,0,1,0
60682,51050,0,0,66,66,0,1,0,1,0
59555,64109,0,0,66,66,0,1,0,1,0
34918,44945,0,0,92,92,0,1,0,1,0
443,54507,0,0,82,82,0,1,0,1,0
20107,64147,0,0,62,62,0,1,0,1,0
49587,57470,0,0,76,76,0,1,0,1,0
972,34219,0,0,65,65,0,1,0,1,0
35694,20230,0,0,61,61,0,1,0,1,0
34146,42798,0,0,62,62,0,1,0,1,0
9027,26563,0,0,60,60,0,1,0,1,0
55806,62413,0,0,66,66,0,1,0,1,0
9512,7302,0,0,62,62,0,1,0,1,0
45981,51505,0,0,62,62,0,1,0,1,0
42133,26364,0,0,111,111,0,1,0,1,0
33941,50494,0,0,111,111,0,1,0,1,0
16057,56205,0,0,63,63,0,1,0,1,0
1972,57470,0,0,78,78,0,1,0,1,0
8982,26315,0,0,101,101,0,1,0,1,0
45964,5333,0,0,60,60,0,1,0,1,0
49576,35792,0,0,143,143,0,1,0,1,0
80,57411,0,0,1514,1514,0,1,0,1,0
52307,44847,0,0,117,117,0,1,0,1,0
10965,22114,0,0,62,62,0,1,0,1,0
26652,25174,0,0,62,62,0,1,0,1,0
52086,44847,0,0,63,63,0,1,0,1,0
58638,5900,0,0,62,62,0,1,0,1,0
61916,64097,0,0,65,65,0,1,0,1,0
50644,35440,0,0,66,66,0,1,0,1,0
50419,26467,0,0,66,66,0,1,0,1,0
12620,21373,0,0,66,66,0,1,0,1,0
34795,51185,0,0,60,60,0,1,0,1,0
56604,17372,0,0,66,66,0,1,0,1,0
65153,38303,0,0,65,65,0,1,0,1,0
56639,48817,0,0,62,62,0,1,0,1,0
58429,36483,0,0,66,66,0,1,0,1,0
44799,39464,0,0,120,120,0,1,0,1,0
58638,5900,0,0,62,62,0,1,0,1,0
443,28417,0,0,82,82,0,1,0,1,0
51211,59435,0,0,96,96,0,1,0,1,0
34271,25174,0,0,121,121,0,1,0,1,0
1120,25174,0,0,62,62,0,1,0,1,0
33405,37965,0,0,62,62,0,1,0,1,0
42285,57470,0,0,62,62,0,1,0,1,0
58638,5900,0,0,62,62,0,1,0,1,0
54993,25174,0,0,65,65,0,1,0,1,0
57987,56125,0,0,90,90,0,1,0,1,0
38049,11352,0,0,65,65,0,1,0,1,0
31691,50584,0,0,138,138,0,1,0,1,0
50596,57470,0,0,66,66,0,1,0,1,0
64387,37965,0,0,64,64,0,1,0,1,0
56255,44847,0,0,65,65,0,1,0,1,0
59040,57866,0,0,66,66,0,1,0,1,0
62801,37907,0,0,62,62,0,1,0,1,0
49173,57470,0,0,141,141,0,1,0,1,0
58638,5900,0,0,62,62,0,1,0,1,0
59696,57470,0,0,62,62,0,1,0,1,0
3730,37965,0,0,62,62,0,1,0,1,0
58638,5900,0,0,62,62,0,1,0,1,0
18365,64126,0,0,63,63,0,1,0,1,0
12523,23,0,0,60,60,0,1,0,1,0
45941,23386,0,0,60,60,0,1,0,1,0
18745,64147,0,0,62,62,0,1,0,1,0
50470,61463,0,0,86,86,0,1,0,1,0
49823,25174,0,0,62,62,0,1,0,1,0
60998,25174,0,0,62,62,0,1,0,1,0
55399,37965,0,0,66,66,0,1,0,1,0
61818,15503,0,0,79,79,0,1,0,1,0
26408,64147,0,0,66,66,0,1,0,1,0
49614,50584,0,0,64,64,0,1,0,1,0
62776,62413,0,0,62,62,0,1,0,1,0
22835,51221,0,0,62,62,0,1,0,1,0
54528,25356,0,0,62,62,0,1,0,1,0
1089,46810,0,0,62,62,0,1,0,1,0
63832,25174,0,0,66,66,0,1,0,1,0
18941,57866,0,0,63,63,0,1,0,1,0
22408,22114,0,0,66,66,0,1,0,1,0
14615,57866,0,0,63,63,0,1,0,1,0
17908,44847,0,0,64,64,0,1,0,1,0
59238,35440,0,0,64,64,0,1,0,1,0
50490,64147,0,0,64,64,0,1,0,1,0
62496,57389,0,0,130,130,0,1,0,1,0
58366,24781,0,0,141,141,0,1,0,1,0
16506,25174,0,0,62,62,0,1,0,1,0
15952,50584,0,0,128,128,0,1,0,1,0
35566,20238,0,0,63,63,0,1,0,1,0
18891,44847,0,0,65,65,0,1,0,1,0
57931,22114,0,0,88,88,0,1,0,1,0
52744,25174,0,0,62,62,0,1,0,1,0
58021,40,0,0,60,60,0,1,0,1,0
62109,44847,0,0,62,62,0,1,0,1,0
58914,37965,0,0,66,66,0,1,0,1,0
57131,7908,0,0,145,145,0,1,0,1,0
45967,11,0,0,61,61,0,1,0,1,0
42548,56205,0,0,121,121,0,1,0,1,0
46495,4607,0,0,60,60,0,1,0,1,0
64025,25174,0,0,62,62,0,1,0,1,0
59167,50584,0,0,64,64,0,1,0,1,0
56277,36237,0,0,66,66,0,1,0,1,0
59426,50410,0,0,70,70,0,1,0,1,0
0,0,0,0,70,70,0,1,0,1,0
3478,61463,0,0,164,164,0,1,0,1,0
9745,26467,0,0,62,62,0,1,0,1,0
12545,25174,0,0,134,134,0,1,0,1,0
56442,11392,0,0,63,63,0,1,0,1,0
17010,57470,0,0,62,62,0,1,0,1,0
65039,37918,0,0,66,66,0,1,0,1,0
60887,50584,0,0,66,66,0,1,0,1,0
46495,4607,0,0,60,60,0,1,0,1,0
29989,26467,0,0,64,64,0,1,0,1,0
31224,11873,0,0,110,110,0,1,0,1,0
60114,23,0,0,60,60,0,1,0,1,0
4186,35440,0,0,62,62,0,1,0,1,0
49479,56205,0,0,66,66,0,1,0,1,0
29154,8139,0,0,62,62,0,1,0,1,0
45964,2666,0,0,60,60,0,1,0,1,0
910,9859,0,0,128,128,0,1,0,1,0
47335,50584,0,0,62,62,0,1,0,1,0
24475,55898,0,0,70,70,0,1,0,1,0
0,0,0,0,98,98,0,1,0,1,0
21435,44847,0,0,66,66,0,1,0,1,0
49616,30188,0,0,66,66,0,1,0,1,0
48176,50584,0,0,137,137,0,1,0,1,0
62764,62413,0,0,117,117,0,1,0,1,0
51613,51505,0,0,66,66,0,1,0,1,0
34046,52501,0,0,123,123,0,1,0,1,0
34524,23080,0,0,62,62,0,1,0,1,0
64243,44847,0,0,66,66,0,1,0,1,0
63443,37807,0,0,62,62,0,1,0,1,0
0,0,0,0,98,98,0,1,0,1,0
15837,62010,0,0,128,128,0,1,0,1,0
33178,50584,0,0,139,139,0,1,0,1,0
41103,5900,0,0,60,60,0,1,0,1,0
25940,1502,0,0,60,60,0,1,0,1,0
1482,56205,0,0,63,63,0,1,0,1,0
50143,44847,0,0,69,69,0,1,0,1,0
63563,22114,0,0,64,64,0,1,0,1,0
58627,64097,0,0,65,65,0,1,0,1,0
64814,64147,0,0,66,66,0,1,0,1,0
12609,25174,0,0,83,83,0,1,0,1,0
54287,22114,0,0,63,63,0,1,0,1,0
695,48941,0,0,68,68,0,1,0,1,0
443,62615,0,0,63,63,0,1,0,1,0
1861,48817,0,0,64,64,0,1,0,1,0
63434,62413,0,0,66,66,0,1,0,1,0
30306,56688,0,0,161,161,0,1,0,1,0
10907,57863,0,0,62,62,0,1,0,1,0
51697,48925,0,0,65,65,0,1,0,1,0
16862,21247,0,0,113,113,0,1,0,1,0
58185,3726,0,0,123,123,0,1,0,1,0
52503,50584,0,0,63,63,0,1,0,1,0
25360,51505,0,0,62,62,0,1,0,1,0
63740,37965,0,0,66,66,0,1,0,1,0
58638,5900,0,0,62,62,0,1,0,1,0
0,0,0,0,73,73,0,1,0,1,0
54124,3385,0,0,61,61,0,1,0,1,0
54576,56205,0,0,63,63,0,1,0,1,0
48676,53395,0,0,60,60,0,1,0,1,0
61646,64105,0,0,62,62,0,1,0,1,0
24551,50894,0,0,146,146,0,1,0,1,0
64815,37965,0,0,66,66,0,1,0,1,0
36464,25174,0,0,138,138,0,1,0,1,0
53497,3,0,0,65,65,0,1,0,1,0
58638,5900,0,0,62,62,0,1,0,1,0
52050,17372,0,0,62,62,0,1,0,1,0
64036,23718,0,0,62,62,0,1,0,1,0
6933,51441,0,0,65,65,0,1,0,1,0
57131,31061,0,0,145,145,0,1,0,1,0
63172,50584,0,0,64,64,0,1,0,1,0
60149,30188,0,0,65,65,0,1,0,1,0
51903,26467,0,0,62,62,0,1,0,1,0
12543,2403,0,0,60,60,0,1,0,1,0
45908,33330,0,0,60,60,0,1,0,1,0
58388,43890,0,0,62,62,0,1,0,1,0
57452,57470,0,0,62,62,0,1,0,1,0
56403,51505,0,0,64,64,0,1,0,1,0
55079,25174,0,0,65,65,0,1,0,1,0
9671,42342,0,0,97,97,0,1,0,1,0
48325,25174,0,0,62,62,0,1,0,1,0
60793,53733,0,0,66,66,0,1,0,1,0
56649,9571,0,0,73,73,0,1,0,1,0
53245,64097,0,0,65,65,0,1,0,1,0
65028,26467,0,0,66,66,0,1,0,1,0
38312,51348,0,0,63,63,0,1,0,1,0
62948,17100,0,0,66,66,0,1,0,1,0
50873,36135,0,0,112,112,0,1,0,1,0
1024,25174,0,0,62,62,0,1,0,1,0
3478,61463,0,0,231,231,0,1,0,1,0
50571,22114,0,0,62,62,0,1,0,1,0
64962,37589,0,0,62,62,0,1,0,1,0
14134,1,0,0,61,61,0,1,0,1,0
63440,62413,0,0,63,63,0,1,0,1,0
12107,22114,0,0,64,64,0,1,0,1,0
56378,51505,0,0,64,64,0,1,0,1,0
28242,50584,0,0,86,86,0,1,0,1,0
24163,57470,0,0,62,62,0,1,0,1,0
16387,56995,0,0,60,60,0,1,0,1,0
62814,9232,0,0,66,66,0,1,0,1,0
63982,25174,0,0,62,62,0,1,0,1,0
16828,50456,0,0,62,62,0,1,0,1,0
54745,50536,0,0,66,66,0,1,0,1,0
58638,5900,0,0,62,62,0,1,0,1,0
57987,56125,0,0,90,90,0,1,0,1,0
53626,64147,0,0,66,66,0,1,0,1,0
2852,35347,0,0,63,63,0,1,0,1,0
6666,82,0,0,60,60,0,1,0,1,0
29120,44847,0,0,65,65,0,1,0,1,0
26866,50347,0,0,64,64,0,1,0,1,0
44482,50573,0,0,64,64,0,1,0,1,0
48096,7530,0,0,60,60,0,1,0,1,0
10212,50584,0,0,146,146,0,1,0,1,0
58638,5900,0,0,62,62,0,1,0,1,0
35140,22114,0,0,64,64,0,1,0,1,0
59595,37965,0,0,64,64,0,1,0,1,0
56864,25174,0,0,62,62,0,1,0,1,0
54797,23,0,0,60,60,0,1,0,1,0
55167,11432,0,0,75,75,0,1,0,1,0
65082,132,0,0,62,62,0,1,0,1,0
58486,57470,0,0,66,66,0,1,0,1,0
80,36466,0,0,1514,1514,0,1,0,1,0
63213,35440,0,0,142,142,0,1,0,1,0
44703,25174,0,0,62,62,0,1,0,1,0
45941,23386,0,0,60,60,0,1,0,1,0
62386,37965,0,0,66,66,0,1,0,1,0
56186,57470,0,0,62,62,0,1,0,1,0
4269,26672,0,0,60,60,0,1,0,1,0
55056,44512,0,0,62,62,0,1,0,1,0
2394,43890,0,0,62,62,0,1,0,1,0
55649,22,0,0,60,60,0,1,0,1,0
2966,44847,0,0,62,62,0,1,0,1,0
54029,25174,0,0,63,63,0,1,0,1,0
3478,61463,0,0,1162,1162,0,1,0,1,0
443,14591,0,0,121,121,0,1,0,1,0
7496,50584,0,0,107,107,0,1,0,1,0
2340,35440,0,0,71,71,0,1,0,1,0
58914,37965,0,0,66,66,0,1,0,1,0
27869,51221,0,0,66,66,0,1,0,1,0
57622,50584,0,0,136,136,0,1,0,1,0
58587,50584,0,0,62,62,0,1,0,1,0
859,23525,0,0,141,141,0,1,0,1,0
33405,37965,0,0,62,62,0,1,0,1,0
59972,62413,0,0,63,63,0,1,0,1,0
33941,50493,0,0,111,111,0,1,0,1,0
3478,61463,0,0,588,588,0,1,0,1,0
61976,8560,0,0,72,72,0,1,0,1,0
15706,11479,0,0,66,66,0,1,0,1,0
60055,25174,0,0,66,66,0,1,0,1,0
58638,5900,0,0,62,62,0,1,0,1,0
9668,2757,0,0,62,62,0,1,0,1,0
9832,37887,0,0,63,63,0,1,0,1,0
80,53945,0,0,60,60,0,1,0,1,0
58967,37965,0,0,66,66,0,1,0,1,0
29434,25174,0,0,62,62,0,1,0,1,0
51413,14,0,0,64,64,0,1,0,1,0
9212,56205,0,0,65,65,0,1,0,1,0
1028,50584,0,0,62,62,0,1,0,1,0
59920,44847,0,0,65,65,0,1,0,1,0
58638,5900,0,0,62,62,0,1,0,1,0
57581,51221,0,0,64,64,0,1,0,1,0
51259,37965,0,0,63,63,0,1,0,1,0
15748,26427,0,0,61,61,0,1,0,1,0
53354,44847,0,0,66,66,0,1,0,1,0
52772,36625,0,0,64,64,0,1,0,1,0
52715,26467,0,0,62,62,0,1,0,1,0
35566,22114,0,0,62,62,0,1,0,1,0
51311,64147,0,0,66,66,0,1,0,1,0
50765,22114,0,0,65,65,0,1,0,1,0
55116,7574,0,0,63,63,0,1,0,1,0
64002,35440,0,0,63,63,0,1,0,1,0
44524,50584,0,0,122,122,0,1,0,1,0
443,38956,0,0,82,82,0,1,0,1,0
46495,4607,0,0,60,60,0,1,0,1,0
57681,64147,0,0,63,63,0,1,0,1,0
8999,57470,0,0,146,146,0,1,0,1,0
57579,51221,0,0,64,64,0,1,0,1,0
53281,22114,0,0,146,146,0,1,0,1,0
59095,51166,0,0,62,62,0,1,0,1,0
28133,37965,0,0,136,136,0,1,0,1,0
58638,5900,0,0,62,62,0,1,0,1,0
23181,50584,0,0,62,62,0,1,0,1,0
58749,9576,0,0,62,62,0,1,0,1,0
27586,37965,0,0,63,63,0,1,0,1,0
46124,30177,0,0,118,118,0,1,0,1,0
64818,37965,0,0,64,64,0,1,0,1,0
6888,55108,0,0,143,143,0,1,0,1,0
48676,53392,0,0,60,60,0,1,0,1,0
46516,57470,0,0,62,62,0,1,0,1,0
57579,51221,0,0,62,62,0,1,0,1,0
56602,37965,0,0,66,66,0,1,0,1,0
56564,9571,0,0,78,78,0,1,0,1,0
59782,5927,0,0,61,61,0,1,0,1,0
56334,25174,0,0,64,64,0,1,0,1,0
40597,23965,0,0,111,111,0,1,0,1,0
27592,50584,0,0,64,64,0,1,0,1,0
58638,5900,0,0,62,62,0,1,0,1,0
7472,57470,0,0,66,66,0,1,0,1,0
10669,49756,0,0,60,60,0,1,0,1,0
23473,25174,0,0,62,62,0,1,0,1,0
58638,5900,0,0,62,62,0,1,0,1,0
55432,25174,0,0,63,63,0,1,0,1,0
52228,122,0,0,70,70,0,1,0,1,0
443,62732,0,0,252,252,0,1,0,1,0
59211,25174,0,0,66,66,0,1,0,1,0
59037,51505,0,0,64,64,0,1,0,1,0
15701,37965,0,0,146,146,0,1,0,1,0
58638,5900,0,0,62,62,0,1,0,1,0
19858,8874,0,0,60,60,0,1,0,1,0
29831,7550,0,0,125,125,0,1,0,1,0
6996,51505,0,0,63,63,0,1,0,1,0
16246,22,0,0,60,60,0,1,0,1,0
18754,35440,0,0,94,94,0,1,0,1,0
34932,38608,0,0,62,62,0,1,0,1,0
7325,25174,0,0,64,64,0,1,0,1,0
1224,51518,0,0,62,62,0,1,0,1,0
7488,44165,0,0,66,66,0,1,0,1,0
62961,51221,0,0,66,66,0,1,0,1,0
57266,51221,0,0,66,66,0,1,0,1,0
61205,21247,0,0,66,66,0,1,0,1,0
55996,25174,0,0,62,62,0,1,0,1,0
10003,64147,0,0,62,62,0,1,0,1,0
25492,58781,0,0,75,75,0,1,0,1,0
58638,5900,0,0,62,62,0,1,0,1,0
45908,33330,0,0,60,60,0,1,0,1,0
1047,6444,0,0,68,68,0,1,0,1,0
56249,55442,0,0,66,66,0,1,0,1,0
42632,44847,0,0,71,71,0,1,0,1,0
9745,26467,0,0,62,62,0,1,0,1,0
56747,22,0,0,60,60,0,1,0,1,0
59724,55913,0,0,63,63,0,1,0,1,0
59694,64140,0,0,66,66,0,1,0,1,0
38093,11392,0,0,73,73,0,1,0,1,0
36004,48723,0,0,86,86,0,1,0,1,0
64723,56205,0,0,62,62,0,1,0,1,0
7235,15241,0,0,106,106,0,1,0,1,0
58638,5900,0,0,62,62,0,1,0,1,0
55600,22,0,0,60,60,0,1,0,1,0
50772,9571,0,0,62,62,0,1,0,1,0
6819,26305,0,0,138,138,0,1,0,1,0
61844,2767,0,0,66,66,0,1,0,1,0
60852,25174,0,0,65,65,0,1,0,1,0
43942,21,0,0,60,60,0,1,0,1,0
18771,35440,0,0,66,66,0,1,0,1,0
60771,58414,0,0,65,65,0,1,0,1,0
48071,25174,0,0,66,66,0,1,0,1,0
33332,50584,0,0,119,119,0,1,0,1,0
54224,36829,0,0,66,66,0,1,0,1,0
64379,26467,0,0,62,62,0,1,0,1,0
58073,44847,0,0,62,62,0,1,0,1,0
47954,25174,0,0,62,62,0,1,0,1,0
63551,50584,0,0,66,66,0,1,0,1,0
2711,23117,0,0,62,62,0,1,0,1,0
49763,22114,0,0,63,63,0,1,0,1,0
3478,61463,0,0,474,474,0,1,0,1,0
63460,55160,0,0,63,63,0,1,0,1,0
50285,49146,0,0,67,67,0,1,0,1,0
28875,51505,0,0,72,72,0,1,0,1,0
49386,51852,0,0,110,110,0,1,0,1,0
27518,22114,0,0,62,62,0,1,0,1,0
62562,2551,0,0,66,66,0,1,0,1,0
30166,23,0,0,60,60,0,1,0,1,0
64684,57470,0,0,66,66,0,1,0,1,0
23120,35440,0,0,62,62,0,1,0,1,0
60946,50063,0,0,90,90,0,1,0,1,0
14069,48776,0,0,64,64,0,1,0,1,0
40238,23117,0,0,62,62,0,1,0,1,0
63605,30188,0,0,63,63,0,1,0,1,0
44491,50584,0,0,62,62,0,1,0,1,0
58598,50584,0,0,64,64,0,1,0,1,0
58638,5900,0,0,62,62,0,1,0,1,0
20773,26675,0,0,61,61,0,1,0,1,0
63577,22114,0,0,65,65,0,1,0,1,0
50092,22,0,0,60,60,0,1,0,1,0
38671,37965,0,0,69,69,0,1,0,1,0
5282,32684,0,0,66,66,0,1,0,1,0
63346,42777,0,0,66,66,0,1,0,1,0
40275,25174,0,0,62,62,0,1,0,1,0
19068,37965,0,0,62,62,0,1,0,1,0
57915,3,0,0,93,93,0,1,0,1,0
45964,3111,0,0,60,60,0,1,0,1,0
56098,64147,0,0,66,66,0,1,0,1,0
51380,1433,0,0,60,60,0,1,0,1,0
10345,11392,0,0,62,62,0,1,0,1,0
68,67,0,0,346,346,0,1,0,1,0
58638,5900,0,0,62,62,0,1,0,1,0
64500,37965,0,0,62,62,0,1,0,1,0
58615,11392,0,0,63,63,0,1,0,1,0
64824,37965,0,0,62,62,0,1,0,1,0
50470,61463,0,0,86,86,0,1,0,1,0
5248,27348,0,0,65,65,0,1,0,1,0
49255,44847,0,0,63,63,0,1,0,1,0
443,50238,0,0,183,183,0,1,0,1,0
58638,5900,0,0,62,62,0,1,0,1,0
57097,57470,0,0,62,62,0,1,0,1,0
58638,5900,0,0,62,62,0,1,0,1,0
52591,9475,0,0,62,62,0,1,0,1,0
38417,10577,0,0,146,146,0,1,0,1,0
26462,64147,0,0,66,66,0,1,0,1,0
60188,15503,0,0,62,62,0,1,0,1,0
21258,22,0,0,60,60,0,1,0,1,0
65313,51221,0,0,74,74,0,1,0,1,0
49786,25174,0,0,66,66,0,1,0,1,0
20962,22114,0,0,62,62,0,1,0,1,0
62187,42873,0,0,66,66,0,1,0,1,0
48263,55468,0,0,66,66,0,1,0,1,0
58405,44847,0,0,62,62,0,1,0,1,0
28544,64147,0,0,62,62,0,1,0,1,0
58406,37965,0,0,63,63,0,1,0,1,0
1115,37965,0,0,62,62,0,1,0,1,0
45964,2225,0,0,60,60,0,1,0,1,0
51766,50584,0,0,66,66,0,1,0,1,0
62407,8880,0,0,66,66,0,1,0,1,0
50091,64147,0,0,63,63,0,1,0,1,0
14591,42730,0,0,62,62,0,1,0,1,0
6739,6549,0,0,60,60,0,1,0,1,0
5222,7493,0,0,66,66,0,1,0,1,0
10740,35440,0,0,62,62,0,1,0,1,0
58638,5900,0,0,62,62,0,1,0,1,0
5060,62079,0,0,102,102,0,1,0,1,0
1045,62602,0,0,145,145,0,1,0,1,0
59210,57866,0,0,66,66,0,1,0,1,0
26271,56205,0,0,66,66,0,1,0,1,0
51655,26467,0,0,62,62,0,1,0,1,0
55539,57470,0,0,66,66,0,1,0,1,0
58638,5900,0,0,62,62,0,1,0,1,0
19275,44847,0,0,66,66,0,1,0,1,0
45941,23388,0,0,60,60,0,1,0,1,0
3478,61463,0,0,1266,1266,0,1,0,1,0
1733,65448,0,0,62,62,0,1,0,1,0
35559,16,0,0,86,86,0,1,0,1,0
6365,64147,0,0,140,140,0,1,0,1,0
64706,64147,0,0,66,66,0,1,0,1,0
43756,50686,0,0,145,145,0,1,0,1,0
50489,64147,0,0,64,64,0,1,0,1,0
52750,53693,0,0,62,62,0,1,0,1,0
65196,30188,0,0,66,66,0,1,0,1,0
57959,25174,0,0,62,62,0,1,0,1,0
40108,23,0,0,60,60,0,1,0,1,0
59962,46802,0,0,69,69,0,1,0,1,0
56166,50584,0,0,65,65,0,1,0,1,0
59934,35440,0,0,66,66,0,1,0,1,0
58638,5900,0,0,62,62,0,1,0,1,0
9621,35440,0,0,66,66,0,1,0,1,0
58658,36797,0,0,73,73,0,1,0,1,0
57732,37965,0,0,62,62,0,1,0,1,0
54527,26467,0,0,62,62,0,1,0,1,0
43584,24748,0,0,156,156,0,1,0,1,0
49831,25174,0,0,62,62,0,1,0,1,0
45964,3111,0,0,60,60,0,1,0,1,0
35589,25174,0,0,66,66,0,1,0,1,0
10182,44847,0,0,62,62,0,1,0,1,0
2433,50584,0,0,66,66,0,1,0,1,0
15019,26467,0,0,62,62,0,1,0,1,0
60609,23311,0,0,66,66,0,1,0,1,0
5937,43890,0,0,66,66,0,1,0,1,0
61676,64114,0,0,62,62,0,1,0,1,0
13420,44847,0,0,66,66,0,1,0,1,0
55309,44847,0,0,65,65,0,1,0,1,0
37969,50373,0,0,93,93,0,1,0,1,0
44871,51414,0,0,70,70,0,1,0,1,0
61223,35420,0,0,66,66,0,1,0,1,0
23935,35439,0,0,62,62,0,1,0,1,0
59591,37965,0,0,62,62,0,1,0,1,0
58598,50584,0,0,66,66,0,1,0,1,0
51041,61658,0,0,65,65,0,1,0,1,0
53030,56205,0,0,66,66,0,1,0,1,0
7749,36237,0,0,64,64,0,1,0,1,0
42656,42486,0,0,95,95,0,1,0,1,0
9327,57470,0,0,62,62,0,1,0,1,0
58561,62413,0,0,65,65,0,1,0,1,0
50797,64147,0,0,63,63,0,1,0,1,0
15033,44847,0,0,62,62,0,1,0,1,0
37008,42707,0,0,62,62,0,1,0,1,0
42574,43243,0,0,69,69,0,1,0,1,0
54166,25174,0,0,64,64,0,1,0,1,0
64820,37965,0,0,62,62,0,1,0,1,0
30552,25174,0,0,63,63,0,1,0,1,0
30025,23,0,0,60,60,0,1,0,1,0
59739,35253,0,0,62,62,0,1,0,1,0
61945,48817,0,0,64,64,0,1,0,1,0
44709,25174,0,0,62,62,0,1,0,1,0
2265,51505,0,0,64,64,0,1,0,1,0
56160,37887,0,0,66,66,0,1,0,1,0
58456,57602,0,0,66,66,0,1,0,1,0
443,48005,0,0,131,131,0,1,0,1,0
2675,35364,0,0,66,66,0,1,0,1,0
46012,23424,0,0,60,60,0,1,0,1,0
53682,25174,0,0,64,64,0,1,0,1,0
52438,50293,0,0,65,65,0,1,0,1,0
24793,55310,0,0,123,123,0,1,0,1,0
31691,50584,0,0,130,130,0,1,0,1,0
40323,64147,0,0,62,62,0,1,0,1,0
2683,48817,0,0,131,131,0,1,0,1,0
54471,64147,0,0,62,62,0,1,0,1,0
3524,25174,0,0,65,65,0,1,0,1,0
59931,44847,0,0,66,66,0,1,0,1,0
52960,56205,0,0,66,66,0,1,0,1,0
7753,25174,0,0,102,102,0,1,0,1,0
53567,5900,0,0,60,60,0,1,0,1,0
41206,5899,0,0,60,60,0,1,0,1,0
54051,49950,0,0,62,62,0,1,0,1,0
80,9918,0,0,60,60,0,1,0,1,0
7891,22114,0,0,66,66,0,1,0,1,0
43692,22114,0,0,66,66,0,1,0,1,0
6881,6881,0,0,62,62,0,1,0,1,0
53156,35993,0,0,66,66,0,1,0,1,0
6773,64293,0,0,60,60,0,1,0,1,0
53237,23212,0,0,78,78,0,1,0,1,0
45964,2225,0,0,60,60,0,1,0,1,0
34808,22114,0,0,65,65,0,1,0,1,0
53332,36237,0,0,63,63,0,1,0,1,0
4485,23,0,0,60,60,0,1,0,1,0
59882,64147,0,0,71,71,0,1,0,1,0
44135,64147,0,0,115,115,0,1,0,1,0
51111,44847,0,0,85,85,0,1,0,1,0
14446,10949,0,0,151,151,0,1,0,1,0
443,20897,0,0,86,86,0,1,0,1,0
64294,64147,0,0,62,62,0,1,0,1,0
5115,43728,0,0,197,197,0,1,0,1,0
58638,5900,0,0,62,62,0,1,0,1,0
4144,50584,0,0,62,62,0,1,0,1,0
50798,43890,0,0,66,66,0,1,0,1,0
19164,64147,0,0,63,63,0,1,0,1,0
63136,25174,0,0,64,64,0,1,0,1,0
30583,25174,0,0,66,66,0,1,0,1,0
53732,31573,0,0,66,66,0,1,0,1,0
58638,5900,0,0,62,62,0,1,0,1,0
14557,38083,0,0,71,71,0,1,0,1,0
24572,50584,0,0,62,62,0,1,0,1,0
52424,51272,0,0,72,72,0,1,0,1,0
10163,25604,0,0,63,63,0,1,0,1,0
50360,37965,0,0,66,66,0,1,0,1,0
46142,50584,0,0,66,66,0,1,0,1,0
56273,57503,0,0,85,85,0,1,0,1,0
55201,22114,0,0,66,66,0,1,0,1,0
28012,36237,0,0,142,142,0,1,0,1,0
10490,30379,0,0,146,146,0,1,0,1,0
7156,30139,0,0,143,143,0,1,0,1,0
63011,51505,0,0,65,65,0,1,0,1,0
36672,25174,0,0,66,66,0,1,0,1,0
58638,5900,0,0,62,62,0,1,0,1,0
3213,64147,0,0,65,65,0,1,0,1,0
19658,163,0,0,60,60,0,1,0,1,0
33526,23,0,0,60,60,0,1,0,1,0
54560,1433,0,0,60,60,0,1,0,1,0
55254,50584,0,0,66,66,0,1,0,1,0
51561,44847,0,0,66,66,0,1,0,1,0
46577,26941,0,0,63,63,0,1,0,1,0
51191,23835,0,0,63,63,0,1,0,1,0
56279,22114,0,0,62,62,0,1,0,1,0
17453,35440,0,0,64,64,0,1,0,1,0
58638,5900,0,0,62,62,0,1,0,1,0
47910,7463,0,0,60,60,0,1,0,1,0
58638,5900,0,0,62,62,0,1,0,1,0
45309,64147,0,0,65,65,0,1,0,1,0
17027,1,0,0,62,62,0,1,0,1,0
65012,2767,0,0,66,66,0,1,0,1,0
3478,61463,0,0,936,936,0,1,0,1,0
50835,26467,0,0,66,66,0,1,0,1,0
58638,5900,0,0,62,62,0,1,0,1,0
58638,5900,0,0,62,62,0,1,0,1,0
54904,7111,0,0,66,66,0,1,0,1,0
23528,44847,0,0,62,62,0,1,0,1,0
5223,44091,0,0,220,220,0,1,0,1,0
17781,50265,0,0,62,62,0,1,0,1,0
21817,44847,0,0,63,63,0,1,0,1,0
57521,44847,0,0,64,64,0,1,0,1,0
56337,30292,0,0,66,66,0,1,0,1,0
42465,57470,0,0,60,60,0,1,0,1,0
54403,35440,0,0,63,63,0,1,0,1,0
51847,11392,0,0,66,66,0,1,0,1,0
47256,37807,0,0,88,88,0,1,0,1,0
13800,17829,0,0,62,62,0,1,0,1,0
17594,55319,0,0,62,62,0,1,0,1,0
61972,25174,0,0,116,116,0,1,0,1,0
27110,22114,0,0,60,60,0,1,0,1,0
55493,26467,0,0,62,62,0,1,0,1,0
45634,1,0,0,62,62,0,1,0,1,0
52519,44847,0,0,64,64,0,1,0,1,0
45472,8168,0,0,62,62,0,1,0,1,0
11684,25174,0,0,100,100,0,1,0,1,0
52719,51221,0,0,68,68,0,1,0,1,0
33875,57470,0,0,71,71,0,1,0,1,0
40099,23,0,0,60,60,0,1,0,1,0
58638,5900,0,0,62,62,0,1,0,1,0
59303,21247,0,0,64,64,0,1,0,1,0
33718,44847,0,0,66,66,0,1,0,1,0
54479,25174,0,0,62,62,0,1,0,1,0
54767,1433,0,0,60,60,0,1,0,1,0
58638,5900,0,0,62,62,0,1,0,1,0
38759,22114,0,0,66,66,0,1,0,1,0
54568,36237,0,0,66,66,0,1,0,1,0
63397,26467,0,0,66,66,0,1,0,1,0
52168,26467,0,0,65,65,0,1,0,1,0
48706,23393,0,0,60,60,0,1,0,1,0
31077,22,0,0,60,60,0,1,0,1,0
10029,25174,0,0,62,62,0,1,0,1,0
52913,44012,0,0,66,66,0,1,0,1,0
24091,26467,0,0,62,62,0,1,0,1,0
62826,51221,0,0,66,66,0,1,0,1,0
10425,44847,0,0,66,66,0,1,0,1,0
16583,64120,0,0,113,113,0,1,0,1,0
52239,50265,0,0,66,66,0,1,0,1,0
53183,50584,0,0,66,66,0,1,0,1,0
63950,44847,0,0,62,62,0,1,0,1,0
48706,23393,0,0,60,60,0,1,0,1,0
58638,5900,0,0,62,62,0,1,0,1,0
58638,5900,0,0,62,62,0,1,0,1,0
23936,35440,0,0,62,62,0,1,0,1,0
11496,51274,0,0,66,66,0,1,0,1,0
65234,23041,0,0,65,65,0,1,0,1,0
56540,49915,0,0,120,120,0,1,0,1,0
58638,5900,0,0,62,62,0,1,0,1,0
58497,39004,0,0,66,66,0,1,0,1,0
58638,5900,0,0,62,62,0,1,0,1,0
62125,57470,0,0,67,67,0,1,0,1,0
19183,35440,0,0,64,64,0,1,0,1,0
32037,51505,0,0,93,93,0,1,0,1,0
58638,5900,0,0,62,62,0,1,0,1,0
61470,30188,0,0,65,65,0,1,0,1,0
20706,37965,0,0,62,62,0,1,0,1,0
3583,25174,0,0,62,62,0,1,0,1,0
20198,17372,0,0,62,62,0,1,0,1,0
16571,25174,0,0,63,63,0,1,0,1,0
58827,5900,0,0,60,60,0,1,0,1,0
59014,27319,0,0,62,62,0,1,0,1,0
54238,50584,0,0,66,66,0,1,0,1,0
29203,26467,0,0,62,62,0,1,0,1,0
57225,57470,0,0,66,66,0,1,0,1,0
54795,22114,0,0,66,66,0,1,0,1,0
16979,56205,0,0,66,66,0,1,0,1,0
9092,26672,0,0,60,60,0,1,0,1,0
58316,21247,0,0,66,66,0,1,0,1,0
62991,51221,0,0,66,66,0,1,0,1,0
17711,50584,0,0,77,77,0,1,0,1,0
57484,30317,0,0,65,65,0,1,0,1,0
54914,51505,0,0,62,62,0,1,0,1,0
24575,10210,0,0,144,144,0,1,0,1,0
443,62496,0,0,103,103,0,1,0,1,0
50816,50584,0,0,62,62,0,1,0,1,0
54131,37905,0,0,62,62,0,1,0,1,0
46774,51050,0,0,62,62,0,1,0,1,0
38991,46836,0,0,62,62,0,1,0,1,0
25034,30188,0,0,120,120,0,1,0,1,0
58638,5900,0,0,62,62,0,1,0,1,0
38330,44847,0,0,66,66,0,1,0,1,0
55069,44847,0,0,66,66,0,1,0,1,0
58638,5900,0,0,62,62,0,1,0,1,0
1713,22114,0,0,62,62,0,1,0,1,0
58638,5900,0,0,62,62,0,1,0,1,0
50427,55798,0,0,62,62,0,1,0,1,0
22319,51505,0,0,62,62,0,1,0,1,0
9687,57470,0,0,78,78,0,1,0,1,0
56688,25174,0,0,66,66,0,1,0,1,0
27006,57470,0,0,62,62,0,1,0,1,0
59411,37965,0,0,66,66,0,1,0,1,0
50836,44847,0,0,62,62,0,1,0,1,0
42231,57470,0,0,78,78,0,1,0,1,0
10462,25174,0,0,107,107,0,1,0,1,0
56256,44847,0,0,66,66,0,1,0,1,0
9132,30354,0,0,75,75,0,1,0,1,0
58638,5900,0,0,62,62,0,1,0,1,0
65254,6165,0,0,62,62,0,1,0,1,0
52818,30188,0,0,66,66,0,1,0,1,0
443,3952,0,0,165,165,0,1,0,1,0
17194,57470,0,0,62,62,0,1,0,1,0
50765,22114,0,0,65,65,0,1,0,1,0
40074,23,0,0,60,60,0,1,0,1,0
32971,50584,0,0,70,70,0,1,0,1,0
54989,50265,0,0,66,66,0,1,0,1,0
3478,61463,0,0,855,855,0,1,0,1,0
58638,5900,0,0,62,62,0,1,0,1,0
45682,37965,0,0,62,62,0,1,0,1,0
49501,35899,0,0,62,62,0,1,0,1,0
50052,65008,0,0,60,60,0,1,0,1,0
51539,17531,0,0,73,73,0,1,0,1,0
12545,25174,0,0,93,93,0,1,0,1,0
55587,22,0,0,60,60,0,1,0,1,0
65196,55618,0,0,66,66,0,1,0,1,0
18398,21247,0,0,66,66,0,1,0,1,0
50093,30188,0,0,65,65,0,1,0,1,0
31925,57470,0,0,60,60,0,1,0,1,0
63772,35440,0,0,66,66,0,1,0,1,0
59947,37840,0,0,62,62,0,1,0,1,0
43584,24748,0,0,156,156,0,1,0,1,0
35375,37965,0,0,62,62,0,1,0,1,0
41734,57470,0,0,62,62,0,1,0,1,0
25678,64147,0,0,62,62,0,1,0,1,0
993,4489,0,0,66,66,0,1,0,1,0
51496,17447,0,0,86,86,0,1,0,1,0
57987,56125,0,0,90,90,0,1,0,1,0
54513,62413,0,0,66,66,0,1,0,1,0
47864,50584,0,0,65,65,0,1,0,1,0
62410,37889,0,0,66,66,0,1,0,1,0
38339,51221,0,0,63,63,0,1,0,1,0
21341,23,0,0,60,60,0,1,0,1,0
16293,22,0,0,60,60,0,1,0,1,0
30897,46745,0,0,64,64,0,1,0,1,0
64026,36829,0,0,66,66,0,1,0,1,0
52007,25174,0,0,66,66,0,1,0,1,0
7156,44840,0,0,66,66,0,1,0,1,0
3478,61463,0,0,269,269,0,1,0,1,0
31136,50584,0,0,62,62,0,1,0,1,0
3478,61463,0,0,231,231,0,1,0,1,0
17815,35440,0,0,118,118,0,1,0,1,0
52091,11392,0,0,66,66,0,1,0,1,0
49587,5900,0,0,60,60,0,1,0,1,0
54489,36237,0,0,66,66,0,1,0,1,0
0,0,0,0,98,98,0,1,0,1,0
44472,6881,0,0,134,134,0,1,0,1,0
57283,64147,0,0,66,66,0,1,0,1,0
36358,25174,0,0,62,62,0,1,0,1,0
63765,51221,0,0,62,62,0,1,0,1,0
33912,25174,0,0,100,100,0,1,0,1,0
14223,35886,0,0,65,65,0,1,0,1,0
51534,44847,0,0,62,62,0,1,0,1,0
62970,44847,0,0,62,62,0,1,0,1,0
1187,64147,0,0,66,66,0,1,0,1,0
1038,37965,0,0,62,62,0,1,0,1,0
13547,57827,0,0,62,62,0,1,0,1,0
57584,56205,0,0,66,66,0,1,0,1,0
39098,51505,0,0,62,62,0,1,0,1,0
58638,5900,0,0,62,62,0,1,0,1,0
50245,44847,0,0,62,62,0,1,0,1,0
1029,64147,0,0,62,62,0,1,0,1,0
41986,35440,0,0,62,62,0,1,0,1,0
55164,11392,0,0,66,66,0,1,0,1,0
62067,22114,0,0,63,63,0,1,0,1,0
63252,53002,0,0,72,72,0,1,0,1,0
57726,37965,0,0,62,62,0,1,0,1,0
42872,56205,0,0,62,62,0,1,0,1,0
58638,5900,0,0,62,62,0,1,0,1,0
28858,36237,0,0,69,69,0,1,0,1,0
58638,5900,0,0,62,62,0,1,0,1,0
59173,57866,0,0,66,66,0,1,0,1,0
58638,5900,0,0,62,62,0,1,0,1,0
58638,5900,0,0,62,62,0,1,0,1,0
3529,25174,0,0,62,62,0,1,0,1,0
51493,11392,0,0,66,66,0,1,0,1,0
65491,44847,0,0,62,62,0,1,0,1,0
41006,25174,0,0,62,62,0,1,0,1,0
58020,22114,0,0,62,62,0,1,0,1,0
6881,6881,0,0,146,146,0,1,0,1,0
58790,51221,0,0,62,62,0,1,0,1,0
60375,26467,0,0,64,64,0,1,0,1,0
19895,38148,0,0,123,123,0,1,0,1,0
9705,26467,0,0,62,62,0,1,0,1,0
59383,22114,0,0,62,62,0,1,0,1,0
29010,25174,0,0,132,132,0,1,0,1,0
64279,23718,0,0,92,92,0,1,0,1,0
49616,30188,0,0,64,64,0,1,0,1,0
58638,5900,0,0,62,62,0,1,0,1,0
2780,11392,0,0,63,63,0,1,0,1,0
55585,30188,0,0,66,66,0,1,0,1,0
6666,16010,0,0,60,60,0,1,0,1,0
58638,5900,0,0,62,62,0,1,0,1,0
60068,41699,0,0,65,65,0,1,0,1,0
54666,36237,0,0,64,64,0,1,0,1,0
64923,26467,0,0,62,62,0,1,0,1,0
58638,5900,0,0,62,62,0,1,0,1,0
31522,25174,0,0,109,109,0,1,0,1,0
49578,57470,0,0,67,67,0,1,0,1,0
26921,26467,0,0,62,62,0,1,0,1,0
56639,48817,0,0,62,62,0,1,0,1,0
7444,57470,0,0,66,66,0,1,0,1,0
61431,51269,0,0,64,64,0,1,0,1,0
3478,61463,0,0,886,886,0,1,0,1,0
17641,50584,0,0,146,146,0,1,0,1,0
22753,50584,0,0,92,92,0,1,0,1,0
56707,37849,0,0,62,62,0,1,0,1,0
41398,56022,0,0,109,109,0,1,0,1,0
10532,26672,0,0,60,60,0,1,0,1,0
54024,37965,0,0,62,62,0,1,0,1,0
51997,57488,0,0,66,66,0,1,0,1,0
53847,37965,0,0,66,66,0,1,0,1,0
50116,22,0,0,60,60,0,1,0,1,0
26094,2042,0,0,121,121,0,1,0,1,0
57476,42787,0,0,63,63,0,1,0,1,0
26528,25174,0,0,62,62,0,1,0,1,0
59793,44847,0,0,62,62,0,1,0,1,0
64103,25174,0,0,62,62,0,1,0,1,0
6900,57470,0,0,73,73,0,1,0,1,0
7109,64147,0,0,62,62,0,1,0,1,0
56712,46824,0,0,66,66,0,1,0,1,0
26881,25174,0,0,66,66,0,1,0,1,0
50085,64147,0,0,66,66,0,1,0,1,0
52620,44847,0,0,64,64,0,1,0,1,0
27064,51221,0,0,72,72,0,1,0,1,0
27538,25176,0,0,146,146,0,1,0,1,0
21674,28189,0,0,60,60,0,1,0,1,0
51956,50584,0,0,63,63,0,1,0,1,0
16327,55442,0,0,66,66,0,1,0,1,0
4545,1900,0,0,136,136,0,1,0,1,0
45964,7777,0,0,60,60,0,1,0,1,0
13951,2675,0,0,61,61,0,1,0,1,0
58638,5900,0,0,62,62,0,1,0,1,0
45964,2225,0,0,60,60,0,1,0,1,0
45941,23386,0,0,60,60,0,1,0,1,0
18653,42707,0,0,66,66,0,1,0,1,0
57152,26337,0,0,125,125,0,1,0,1,0
52957,50584,0,0,66,66,0,1,0,1,0
45908,3383,0,0,60,60,0,1,0,1,0
51594,2980,0,0,92,92,0,1,0,1,0
1582,56205,0,0,62,62,0,1,0,1,0
443,64347,0,0,103,103,0,1,0,1,0
54035,35440,0,0,62,62,0,1,0,1,0
49683,50584,0,0,63,63,0,1,0,1,0
7029,51505,0,0,63,63,0,1,0,1,0
53175,25174,0,0,64,64,0,1,0,1,0
443,48107,0,0,104,104,0,1,0,1,0
13168,35440,0,0,62,62,0,1,0,1,0
3478,61463,0,0,164,164,0,1,0,1,0
26127,55998,0,0,61,61,0,1,0,1,0
49717,37965,0,0,63,63,0,1,0,1,0
54280,3398,0,0,60,60,0,1,0,1,0
56054,1315,0,0,61,61,0,1,0,1,0
51774,22114,0,0,64,64,0,1,0,1,0
14893,37965,0,0,62,62,0,1,0,1,0
3478,61463,0,0,164,164,0,1,0,1,0
46495,4607,0,0,60,60,0,1,0,1,0
32353,34492,0,0,62,62,0,1,0,1,0
52334,26467,0,0,65,65,0,1,0,1,0
58638,5900,0,0,62,62,0,1,0,1,0
10261,21247,0,0,64,64,0,1,0,1,0
27500,55957,0,0,139,139,0,1,0,1,0
10193,44847,0,0,62,62,0,1,0,1,0
9623,68,0,0,60,60,0,1,0,1,0
13285,29892,0,0,145,145,0,1,0,1,0
25164,50584,0,0,146,146,0,1,0,1,0
63709,23,0,0,60,60,0,1,0,1,0
59526,22114,0,0,66,66,0,1,0,1,0
60823,25174,0,0,63,63,0,1,0,1,0
64115,2767,0,0,62,62,0,1,0,1,0
49001,48900,0,0,160,160,0,1,0,1,0
11136,15503,0,0,62,62,0,1,0,1,0
26681,57470,0,0,62,62,0,1,0,1,0
14615,57866,0,0,64,64,0,1,0,1,0
50881,50584,0,0,66,66,0,1,0,1,0
63116,35440,0,0,62,62,0,1,0,1,0
15701,37965,0,0,146,146,0,1,0,1,0
35914,51305,0,0,92,92,0,1,0,1,0
27853,52700,0,0,71,71,0,1,0,1,0
52223,44,0,0,68,68,0,1,0,1,0
58638,5900,0,0,62,62,0,1,0,1,0
13959,22114,0,0,105,105,0,1,0,1,0
62970,44847,0,0,64,64,0,1,0,1,0
12761,62413,0,0,65,65,0,1,0,1,0
50486,56205,0,0,66,66,0,1,0,1,0
26954,44847,0,0,62,62,0,1,0,1,0
49633,50584,0,0,64,64,0,1,0,1,0
47936,7466,0,0,60,60,0,1,0,1,0
51374,445,0,0,70,70,0,1,0,1,0
53624,445,0,0,66,66,0,1,0,1,0
56746,445,0,0,70,70,0,1,0,1,0
65526,445,0,0,70,70,0,1,0,1,0
60239,445,0,0,66,66,0,1,0,1,0
56567,445,0,0,70,70,0,1,0,1,0
61384,445,0,0,70,70,0,1,0,1,0
65387,445,0,0,70,70,0,1,0,1,0
52827,445,0,0,70,70,0,1,0,1,0
57162,445,0,0,66,66,0,1,0,1,0
64227,445,0,0,66,66,0,1,0,1,0
51312,445,0,0,66,66,0,1,0,1,0
50895,445,0,0,66,66,0,1,0,1,0
51948,445,0,0,70,70,0,1,0,1,0
65456,445,0,0,70,70,0,1,0,1,0
52254,445,0,0,70,70,0,1,0,1,0
55743,445,0,0,70,70,0,1,0,1,0
58649,445,0,0,70,70,0,1,0,1,0
50444,445,0,0,70,70,0,1,0,1,0
58959,445,0,0,70,70,0,1,0,1,0
60292,445,0,0,70,70,0,1,0,1,0
49525,445,0,0,70,70,0,1,0,1,0
64614,445,0,0,66,66,0,1,0,1,0
61057,445,0,0,70,70,0,1,0,1,0
60328,445,0,0,70,70,0,1,0,1,0
54629,445,0,0,70,70,0,1,0,1,0
60748,445,0,0,66,66,0,1,0,1,0
58013,445,0,0,70,70,0,1,0,1,0
51143,445,0,0,70,70,0,1,0,1,0
56905,445,0,0,66,66,0,1,0,1,0
59673,445,0,0,66,66,0,1,0,1,0
51457,445,0,0,70,70,0,1,0,1,0
59680,445,0,0,66,66,0,1,0,1,0
63326,445,0,0,66,66,0,1,0,1,0
50195,445,0,0,70,70,0,1,0,1,0
63053,445,0,0,70,70,0,1,0,1,0
56148,445,0,0,70,70,0,1,0,1,0
53106,445,0,0,70,70,0,1,0,1,0
58435,445,0,0,66,66,0,1,0,1,0
62125,445,0,0,66,66,0,1,0,1,0
59347,445,0,0,70,70,0,1,0,1,0
63333,445,0,0,70,70,0,1,0,1,0
58754,445,0,0,70,70,0,1,0,1,0
62044,445,0,0,70,70,0,1,0,1,0
58628,445,0,0,70,70,0,1,0,1,0
59112,445,0,0,70,70,0,1,0,1,0
54458,445,0,0,70,70,0,1,0,1,0
49874,445,0,0,70,70,0,1,0,1,0
52255,445,0,0,66,66,0,1,0,1,0
63841,445,0,0,70,70,0,1,0,1,0
60939,445,0,0,70,70,0,1,0,1,0
61395,445,0,0,70,70,0,1,0,1,0
55012,445,0,0,70,70,0,1,0,1,0
54717,445,0,0,66,66,0,1,0,1,0
52569,445,0,0,70,70,0,1,0,1,0
62617,445,0,0,70,70,0,1,0,1,0
53498,445,0,0,66,66,0,1,0,1,0
62872,445,0,0,66,66,0,1,0,1,0
56277,445,0,0,66,66,0,1,0,1,0
49897,445,0,0,66,66,0,1,0,1,0
62559,445,0,0,70,70,0,1,0,1,0
57378,445,0,0,66,66,0,1,0,1,0
50787,445,0,0,66,66,0,1,0,1,0
65252,445,0,0,70,70,0,1,0,1,0
53792,445,0,0,70,70,0,1,0,1,0
50613,445,0,0,70,70,0,1,0,1,0
51067,445,0,0,70,70,0,1,0,1,0
55423,445,0,0,70,70,0,1,0,1,0
57399,445,0,0,70,70,0,1,0,1,0
53933,445,0,0,66,66,0,1,0,1,0
59936,445,0,0,66,66,0,1,0,1,0
59552,445,0,0,70,70,0,1,0,1,0
63665,445,0,0,70,70,0,1,0,1,0
64862,445,0,0,66,66,0,1,0,1,0
53934,445,0,0,70,70,0,1,0,1,0
49879,445,0,0,70,70,0,1,0,1,0
54308,445,0,0,70,70,0,1,0,1,0
54587,445,0,0,66,66,0,1,0,1,0
62900,445,0,0,70,70,0,1,0,1,0
49193,445,0,0,70,70,0,1,0,1,0
63581,445,0,0,66,66,0,1,0,1,0
54797,445,0,0,70,70,0,1,0,1,0
61915,445,0,0,70,70,0,1,0,1,0
65259,445,0,0,66,66,0,1,0,1,0
51992,445,0,0,70,70,0,1,0,1,0
53830,445,0,0,70,70,0,1,0,1,0
57827,445,0,0,70,70,0,1,0,1,0
55960,445,0,0,70,70,0,1,0,1,0
53804,445,0,0,66,66,0,1,0,1,0
63622,445,0,0,70,70,0,1,0,1,0
63795,445,0,0,66,66,0,1,0,1,0
53394,445,0,0,70,70,0,1,0,1,0
50907,445,0,0,70,70,0,1,0,1,0
57545,445,0,0,70,70,0,1,0,1,0
58865,445,0,0,70,70,0,1,0,1,0
57371,445,0,0,70,70,0,1,0,1,0
57934,445,0,0,66,66,0,1,0,1,0
53632,445,0,0,70,70,0,1,0,1,0
57396,445,0,0,66,66,0,1,0,1,0
65197,445,0,0,70,70,0,1,0,1,0
55808,445,0,0,66,66,0,1,0,1,0
55762,445,0,0,70,70,0,1,0,1,0
52919,445,0,0,66,66,0,1,0,1,0
54225,445,0,0,70,70,0,1,0,1,0
57506,445,0,0,66,66,0,1,0,1,0
57534,445,0,0,70,70,0,1,0,1,0
55401,445,0,0,66,66,0,1,0,1,0
57023,445,0,0,66,66,0,1,0,1,0
61862,445,0,0,70,70,0,1,0,1,0
52926,445,0,0,66,66,0,1,0,1,0
57095,445,0,0,66,66,0,1,0,1,0
64476,445,0,0,66,66,0,1,0,1,0
58245,445,0,0,70,70,0,1,0,1,0
61735,445,0,0,66,66,0,1,0,1,0
62992,445,0,0,70,70,0,1,0,1,0
54909,445,0,0,70,70,0,1,0,1,0
63208,445,0,0,66,66,0,1,0,1,0
62255,445,0,0,70,70,0,1,0,1,0
61997,445,0,0,66,66,0,1,0,1,0
50366,445,0,0,66,66,0,1,0,1,0
53728,445,0,0,70,70,0,1,0,1,0
62301,445,0,0,70,70,0,1,0,1,0
53951,445,0,0,66,66,0,1,0,1,0
55470,445,0,0,70,70,0,1,0,1,0
59455,445,0,0,70,70,0,1,0,1,0
63877,445,0,0,70,70,0,1,0,1,0
58091,445,0,0,70,70,0,1,0,1,0
58975,445,0,0,70,70,0,1,0,1,0
55703,445,0,0,70,70,0,1,0,1,0
53493,445,0,0,70,70,0,1,0,1,0
49567,445,0,0,66,66,0,1,0,1,0
50658,445,0,0,66,66,0,1,0,1,0
54892,445,0,0,70,70,0,1,0,1,0
49192,445,0,0,70,70,0,1,0,1,0
50006,445,0,0,70,70,0,1,0,1,0
58180,445,0,0,66,66,0,1,0,1,0
63714,445,0,0,70,70,0,1,0,1,0
63983,445,0,0,70,70,0,1,0,1,0
51676,445,0,0,70,70,0,1,0,1,0
55016,445,0,0,66,66,0,1,0,1,0
55538,445,0,0,70,70,0,1,0,1,0
55123,445,0,0,70,70,0,1,0,1,0
54648,445,0,0,70,70,0,1,0,1,0
49480,445,0,0,70,70,0,1,0,1,0
54781,445,0,0,70,70,0,1,0,1,0
60848,445,0,0,70,70,0,1,0,1,0
56324,445,0,0,70,70,0,1,0,1,0
61953,445,0,0,70,70,0,1,0,1,0
55244,445,0,0,70,70,0,1,0,1,0
59841,445,0,0,70,70,0,1,0,1,0
50070,445,0,0,70,70,0,1,0,1,0
55628,445,0,0,70,70,0,1,0,1,0
61333,445,0,0,66,66,0,1,0,1,0
50143,445,0,0,70,70,0,1,0,1,0
54755,445,0,0,70,70,0,1,0,1,0
60953,445,0,0,66,66,0,1,0,1,0
61571,445,0,0,70,70,0,1,0,1,0
50233,445,0,0,70,70,0,1,0,1,0
58881,445,0,0,70,70,0,1,0,1,0
58023,445,0,0,70,70,0,1,0,1,0
65304,445,0,0,66,66,0,1,0,1,0
53176,445,0,0,70,70,0,1,0,1,0
57930,445,0,0,70,70,0,1,0,1,0
56298,445,0,0,70,70,0,1,0,1,0
62296,445,0,0,66,66,0,1,0,1,0
55504,445,0,0,66,66,0,1,0,1,0
64198,445,0,0,70,70,0,1,0,1,0
55446,445,0,0,70,70,0,1,0,1,0
58917,445,0,0,70,70,0,1,0,1,0
55573,445,0,0,66,66,0,1,0,1,0
52900,445,0,0,70,70,0,1,0,1,0
50986,445,0,0,70,70,0,1,0,1,0
57943,445,0,0,70,70,0,1,0,1,0
59857,445,0,0,66,66,0,1,0,1,0
49403,445,0,0,66,66,0,1,0,1,0
58690,445,0,0,66,66,0,1,0,1,0
51657,445,0,0,70,70,0,1,0,1,0
59122,445,0,0,70,70,0,1,0,1,0
63389,445,0,0,66,66,0,1,0,1,0
60970,445,0,0,66,66,0,1,0,1,0
50676,445,0,0,66,66,0,1,0,1,0
54628,445,0,0,70,70,0,1,0,1,0
62212,445,0,0,70,70,0,1,0,1,0
50775,445,0,0,66,66,0,1,0,1,0
61993,445,0,0,66,66,0,1,0,1,0
63807,445,0,0,70,70,0,1,0,1,0
49505,445,0,0,70,70,0,1,0,1,0
60977,445,0,0,70,70,0,1,0,1,0
61808,445,0,0,70,70,0,1,0,1,0
51568,445,0,0,70,70,0,1,0,1,0
62468,445,0,0,70,70,0,1,0,1,0
50336,445,0,0,70,70,0,1,0,1,0
50044,445,0,0,70,70,0,1,0,1,0
56255,445,0,0,70,70,0,1,0,1,0
61229,445,0,0,66,66,0,1,0,1,0
57798,445,0,0,70,70,0,1,0,1,0
58963,445,0,0,66,66,0,1,0,1,0
65305,445,0,0,66,66,0,1,0,1,0
63388,445,0,0,70,70,0,1,0,1,0
50225,445,0,0,70,70,0,1,0,1,0
63778,445,0,0,66,66,0,1,0,1,0
54045,445,0,0,70,70,0,1,0,1,0
62492,445,0,0,66,66,0,1,0,1,0
55358,445,0,0,66,66,0,1,0,1,0
61190,445,0,0,66,66,0,1,0,1,0
52660,445,0,0,66,66,0,1,0,1,0
56635,445,0,0,66,66,0,1,0,1,0
49328,445,0,0,66,66,0,1,0,1,0
64006,445,0,0,70,70,0,1,0,1,0
53250,445,0,0,70,70,0,1,0,1,0
64695,445,0,0,70,70,0,1,0,1,0
57199,445,0,0,70,70,0,1,0,1,0
52063,445,0,0,70,70,0,1,0,1,0
61275,445,0,0,70,70,0,1,0,1,0
63424,445,0,0,70,70,0,1,0,1,0
53870,445,0,0,70,70,0,1,0,1,0
49230,445,0,0,70,70,0,1,0,1,0
52652,445,0,0,66,66,0,1,0,1,0
51738,445,0,0,70,70,0,1,0,1,0
53510,445,0,0,70,70,0,1,0,1,0
59194,445,0,0,66,66,0,1,0,1,0
58372,445,0,0,70,70,0,1,0,1,0
59033,445,0,0,70,70,0,1,0,1,0
55083,445,0,0,66,66,0,1,0,1,0
59862,445,0,0,70,70,0,1,0,1,0
60019,445,0,0,70,70,0,1,0,1,0
50898,445,0,0,70,70,0,1,0,1,0
57398,445,0,0,70,70,0,1,0,1,0
60873,445,0,0,70,70,0,1,0,1,0
57292,445,0,0,66,66,0,1,0,1,0
57642,445,0,0,70,70,0,1,0,1,0
56519,445,0,0,66,66,0,1,0,1,0
65354,445,0,0,70,70,0,1,0,1,0
59571,445,0,0,70,70,0,1,0,1,0
64274,445,0,0,66,66,0,1,0,1,0
59229,445,0,0,70,70,0,1,0,1,0
56133,445,0,0,70,70,0,1,0,1,0
63716,445,0,0,70,70,0,1,0,1,0
50678,445,0,0,70,70,0,1,0,1,0
52087,445,0,0,66,66,0,1,0,1,0
50318,445,0,0,70,70,0,1,0,1,0
62791,445,0,0,70,70,0,1,0,1,0
59613,445,0,0,70,70,0,1,0,1,0
56106,445,0,0,70,70,0,1,0,1,0
55850,445,0,0,70,70,0,1,0,1,0
50198,445,0,0,70,70,0,1,0,1,0
55043,445,0,0,66,66,0,1,0,1,0
58914,445,0,0,70,70,0,1,0,1,0
54057,445,0,0,70,70,0,1,0,1,0
51441,445,0,0,70,70,0,1,0,1,0
49798,445,0,0,70,70,0,1,0,1,0
59799,445,0,0,70,70,0,1,0,1,0
52076,445,0,0,70,70,0,1,0,1,0
57752,445,0,0,70,70,0,1,0,1,0
64280,445,0,0,70,70,0,1,0,1,0
50048,445,0,0,70,70,0,1,0,1,0
57014,445,0,0,66,66,0,1,0,1,0
56517,445,0,0,66,66,0,1,0,1,0
56502,445,0,0,66,66,0,1,0,1,0
49809,445,0,0,70,70,0,1,0,1,0
60616,445,0,0,66,66,0,1,0,1,0
49494,445,0,0,66,66,0,1,0,1,0
57211,445,0,0,70,70,0,1,0,1,0
50511,445,0,0,70,70,0,1,0,1,0
53166,445,0,0,70,70,0,1,0,1,0
61004,445,0,0,66,66,0,1,0,1,0
58515,445,0,0,70,70,0,1,0,1,0
50753,445,0,0,66,66,0,1,0,1,0
56851,445,0,0,70,70,0,1,0,1,0
56490,445,0,0,70,70,0,1,0,1,0
52257,445,0,0,70,70,0,1,0,1,0
53377,445,0,0,70,70,0,1,0,1,0
62690,445,0,0,66,66,0,1,0,1,0
61200,445,0,0,70,70,0,1,0,1,0
63590,445,0,0,70,70,0,1,0,1,0
55695,445,0,0,66,66,0,1,0,1,0
57146,445,0,0,66,66,0,1,0,1,0
49640,445,0,0,66,66,0,1,0,1,0
54935,445,0,0,70,70,0,1,0,1,0
58354,445,0,0,66,66,0,1,0,1,0
52509,445,0,0,70,70,0,1,0,1,0
62521,445,0,0,70,70,0,1,0,1,0
59663,445,0,0,70,70,0,1,0,1,0
51753,445,0,0,70,70,0,1,0,1,0
54152,445,0,0,70,70,0,1,0,1,0
63450,445,0,0,66,66,0,1,0,1,0
51647,445,0,0,70,70,0,1,0,1,0
59220,445,0,0,70,70,0,1,0,1,0
63599,445,0,0,66,66,0,1,0,1,0
52020,445,0,0,70,70,0,1,0,1,0
57000,445,0,0,70,70,0,1,0,1,0
50293,445,0,0,70,70,0,1,0,1,0
52206,445,0,0,70,70,0,1,0,1,0
50932,445,0,0,66,66,0,1,0,1,0
50402,445,0,0,70,70,0,1,0,1,0
49300,445,0,0,70,70,0,1,0,1,0
57918,445,0,0,70,70,0,1,0,1,0
63079,445,0,0,66,66,0,1,0,1,0
64410,445,0,0,70,70,0,1,0,1,0
50547,445,0,0,70,70,0,1,0,1,0
62972,445,0,0,70,70,0,1,0,1,0
58606,445,0,0,70,70,0,1,0,1,0
52671,445,0,0,66,66,0,1,0,1,0
63751,445,0,0,70,70,0,1,0,1,0
56062,445,0,0,66,66,0,1,0,1,0
51222,445,0,0,70,70,0,1,0,1,0
55072,445,0,0,70,70,0,1,0,1,0
61878,445,0,0,66,66,0,1,0,1,0
60091,445,0,0,70,70,0,1,0,1,0
58314,445,0,0,66,66,0,1,0,1,0
53850,445,0,0,70,70,0,1,0,1,0
53550,445,0,0,66,66,0,1,0,1,0
54472,445,0,0,70,70,0,1,0,1,0
50559,445,0,0,70,70,0,1,0,1,0
51641,445,0,0,66,66,0,1,0,1,0
58501,445,0,0,66,66,0,1,0,1,0
52988,445,0,0,70,70,0,1,0,1,0
55273,445,0,0,70,70,0,1,0,1,0
50444,445,0,0,70,70,0,1,0,1,0
60668,445,0,0,70,70,0,1,0,1,0
62486,445,0,0,66,66,0,1,0,1,0
51003,445,0,0,70,70,0,1,0,1,0
57515,445,0,0,70,70,0,1,0,1,0
54318,445,0,0,66,66,0,1,0,1,0
55944,445,0,0,70,70,0,1,0,1,0
65286,445,0,0,70,70,0,1,0,1,0
59030,445,0,0,70,70,0,1,0,1,0
62939,445,0,0,66,66,0,1,0,1,0
53734,445,0,0,66,66,0,1,0,1,0
58307,445,0,0,70,70,0,1,0,1,0
63663,445,0,0,70,70,0,1,0,1,0
59612,445,0,0,70,70,0,1,0,1,0
54192,445,0,0,70,70,0,1,0,1,0
55725,445,0,0,66,66,0,1,0,1,0
64742,445,0,0,66,66,0,1,0,1,0
50195,445,0,0,70,70,0,1,0,1,0
63176,445,0,0,66,66,0,1,0,1,0
50766,445,0,0,70,70,0,1,0,1,0
62082,445,0,0,70,70,0,1,0,1,0
61742,445,0,0,70,70,0,1,0,1,0
60607,445,0,0,70,70,0,1,0,1,0
52115,445,0,0,70,70,0,1,0,1,0
58328,445,0,0,70,70,0,1,0,1,0
50692,445,0,0,66,66,0,1,0,1,0
62830,445,0,0,66,66,0,1,0,1,0
57708,445,0,0,70,70,0,1,0,1,0
62061,445,0,0,66,66,0,1,0,1,0
51833,445,0,0,70,70,0,1,0,1,0
58402,445,0,0,70,70,0,1,0,1,0
59270,445,0,0,70,70,0,1,0,1,0
60191,445,0,0,70,70,0,1,0,1,0
62380,445,0,0,70,70,0,1,0,1,0
65205,445,0,0,70,70,0,1,0,1,0
55842,445,0,0,70,70,0,1,0,1,0
56304,445,0,0,66,66,0,1,0,1,0
58166,445,0,0,66,66,0,1,0,1,0
50511,445,0,0,70,70,0,1,0,1,0
57314,445,0,0,70,70,0,1,0,1,0
59402,445,0,0,66,66,0,1,0,1,0
56776,445,0,0,70,70,0,1,0,1,0
56532,445,0,0,66,66,0,1,0,1,0
61447,445,0,0,66,66,0,1,0,1,0
64177,445,0,0,70,70,0,1,0,1,0
50650,445,0,0,70,70,0,1,0,1,0
58629,445,0,0,66,66,0,1,0,1,0
54064,445,0,0,66,66,0,1,0,1,0
52017,445,0,0,66,66,0,1,0,1,0
50548,445,0,0,66,66,0,1,0,1,0
64213,445,0,0,70,70,0,1,0,1,0
59587,445,0,0,66,66,0,1,0,1,0
55033,445,0,0,66,66,0,1,0,1,0
56125,445,0,0,66,66,0,1,0,1,0
55811,445,0,0,66,66,0,1,0,1,0
50407,445,0,0,66,66,0,1,0,1,0
57032,445,0,0,70,70,0,1,0,1,0
51145,445,0,0,70,70,0,1,0,1,0
64598,445,0,0,70,70,0,1,0,1,0
56798,445,0,0,66,66,0,1,0,1,0
52626,445,0,0,66,66,0,1,0,1,0
58934,445,0,0,70,70,0,1,0,1,0
50268,445,0,0,66,66,0,1,0,1,0
54263,445,0,0,66,66,0,1,0,1,0
61897,445,0,0,66,66,0,1,0,1,0
58814,445,0,0,70,70,0,1,0,1,0
49919,445,0,0,70,70,0,1,0,1,0
62267,445,0,0,70,70,0,1,0,1,0
60549,445,0,0,66,66,0,1,0,1,0
55646,445,0,0,70,70,0,1,0,1,0
52374,445,0,0,70,70,0,1,0,1,0
64000,445,0,0,70,70,0,1,0,1,0
52570,445,0,0,70,70,0,1,0,1,0
64276,445,0,0,66,66,0,1,0,1,0
54526,445,0,0,66,66,0,1,0,1,0
55363,445,0,0,70,70,0,1,0,1,0
63328,445,0,0,66,66,0,1,0,1,0
53809,445,0,0,66,66,0,1,0,1,0
53149,445,0,0,70,70,0,1,0,1,0
60255,445,0,0,70,70,0,1,0,1,0
58691,445,0,0,66,66,0,1,0,1,0
58502,445,0,0,70,70,0,1,0,1,0
57603,445,0,0,70,70,0,1,0,1,0
65453,445,0,0,66,66,0,1,0,1,0
59709,445,0,0,70,70,0,1,0,1,0
56987,445,0,0,70,70,0,1,0,1,0
58782,445,0,0,70,70,0,1,0,1,0
54862,445,0,0,70,70,0,1,0,1,0
55116,445,0,0,66,66,0,1,0,1,0
60400,445,0,0,70,70,0,1,0,1,0
65515,445,0,0,70,70,0,1,0,1,0
63469,445,0,0,70,70,0,1,0,1,0
53155,445,0,0,70,70,0,1,0,1,0
54471,445,0,0,66,66,0,1,0,1,0
58374,445,0,0,66,66,0,1,0,1,0
60936,445,0,0,66,66,0,1,0,1,0
61851,445,0,0,66,66,0,1,0,1,0
62150,445,0,0,70,70,0,1,0,1,0
55402,445,0,0,66,66,0,1,0,1,0
52083,445,0,0,70,70,0,1,0,1,0
55211,445,0,0,70,70,0,1,0,1,0
51961,445,0,0,66,66,0,1,0,1,0
56576,445,0,0,66,66,0,1,0,1,0
56586,445,0,0,70,70,0,1,0,1,0
61593,445,0,0,70,70,0,1,0,1,0
49701,445,0,0,70,70,0,1,0,1,0
61293,445,0,0,66,66,0,1,0,1,0
60175,445,0,0,66,66,0,1,0,1,0
56916,445,0,0,66,66,0,1,0,1,0
49905,445,0,0,70,70,0,1,0,1,0
50418,445,0,0,66,66,0,1,0,1,0
65190,445,0,0,70,70,0,1,0,1,0
56324,445,0,0,66,66,0,1,0,1,0
57765,445,0,0,70,70,0,1,0,1,0
52531,445,0,0,70,70,0,1,0,1,0
60374,445,0,0,70,70,0,1,0,1,0
50107,445,0,0,70,70,0,1,0,1,0
50826,445,0,0,70,70,0,1,0,1,0
63147,445,0,0,70,70,0,1,0,1,0
55942,445,0,0,70,70,0,1,0,1,0
58387,445,0,0,70,70,0,1,0,1,0
50308,445,0,0,70,70,0,1,0,1,0
63149,445,0,0,70,70,0,1,0,1,0
62921,445,0,0,66,66,0,1,0,1,0
55418,445,0,0,70,70,0,1,0,1,0
58234,445,0,0,70,70,0,1,0,1,0
56474,445,0,0,70,70,0,1,0,1,0
53707,445,0,0,66,66,0,1,0,1,0
57450,445,0,0,70,70,0,1,0,1,0
61743,445,0,0,70,70,0,1,0,1,0
59214,445,0,0,66,66,0,1,0,1,0
55053,445,0,0,70,70,0,1,0,1,0
51206,445,0,0,70,70,0,1,0,1,0
54777,445,0,0,70,70,0,1,0,1,0
61996,445,0,0,70,70,0,1,0,1,0
61512,445,0,0,70,70,0,1,0,1,0
50097,445,0,0,66,66,0,1,0,1,0
61502,445,0,0,66,66,0,1,0,1,0
53448,445,0,0,70,70,0,1,0,1,0
51553,445,0,0,70,70,0,1,0,1,0
51753,445,0,0,70,70,0,1,0,1,0
65098,445,0,0,70,70,0,1,0,1,0
57474,445,0,0,70,70,0,1,0,1,0
56773,445,0,0,70,70,0,1,0,1,0
51653,445,0,0,66,66,0,1,0,1,0
56563,445,0,0,66,66,0,1,0,1,0
52685,445,0,0,70,70,0,1,0,1,0
52209,445,0,0,70,70,0,1,0,1,0
62725,445,0,0,70,70,0,1,0,1,0
58298,445,0,0,66,66,0,1,0,1,0
51575,445,0,0,66,66,0,1,0,1,0
50368,445,0,0,66,66,0,1,0,1,0
63057,445,0,0,66,66,0,1,0,1,0
58220,445,0,0,70,70,0,1,0,1,0
56142,445,0,0,70,70,0,1,0,1,0
63027,445,0,0,70,70,0,1,0,1,0
62284,445,0,0,70,70,0,1,0,1,0
55872,445,0,0,66,66,0,1,0,1,0
52303,445,0,0,66,66,0,1,0,1,0
65352,445,0,0,66,66,0,1,0,1,0
49442,445,0,0,66,66,0,1,0,1,0
58959,445,0,0,66,66,0,1,0,1,0
52733,445,0,0,70,70,0,1,0,1,0
49402,445,0,0,66,66,0,1,0,1,0
65274,445,0,0,70,70,0,1,0,1,0
50677,445,0,0,70,70,0,1,0,1,0
63084,445,0,0,70,70,0,1,0,1,0
64605,445,0,0,70,70,0,1,0,1,0
51438,445,0,0,66,66,0,1,0,1,0
64947,445,0,0,70,70,0,1,0,1,0
55515,445,0,0,70,70,0,1,0,1,0
53461,445,0,0,70,70,0,1,0,1,0
52843,445,0,0,70,70,0,1,0,1,0
65183,445,0,0,70,70,0,1,0,1,0
51273,445,0,0,66,66,0,1,0,1,0
50282,445,0,0,66,66,0,1,0,1,0
56128,445,0,0,70,70,0,1,0,1,0
53531,445,0,0,70,70,0,1,0,1,0
50035,445,0,0,70,70,0,1,0,1,0
53365,445,0,0,70,70,0,1,0,1,0
52044,445,0,0,70,70,0,1,0,1,0
59583,445,0,0,70,70,0,1,0,1,0
64729,445,0,0,66,66,0,1,0,1,0
54904,445,0,0,66,66,0,1,0,1,0
60075,445,0,0,66,66,0,1,0,1,0
52940,445,0,0,66,66,0,1,0,1,0
65377,445,0,0,66,66,0,1,0,1,0
59466,445,0,0,66,66,0,1,0,1,0
53728,445,0,0,70,70,0,1,0,1,0
50606,445,0,0,66,66,0,1,0,1,0
55392,445,0,0,70,70,0,1,0,1,0
50751,445,0,0,70,70,0,1,0,1,0
51004,445,0,0,66,66,0,1,0,1,0
54459,445,0,0,66,66,0,1,0,1,0
53779,445,0,0,66,66,0,1,0,1,0
62360,445,0,0,66,66,0,1,0,1,0
65376,445,0,0,66,66,0,1,0,1,0
53366,445,0,0,70,70,0,1,0,1,0
62363,445,0,0,66,66,0,1,0,1,0
55616,445,0,0,66,66,0,1,0,1,0
62429,445,0,0,70,70,0,1,0,1,0
59991,445,0,0,66,66,0,1,0,1,0
49493,445,0,0,70,70,0,1,0,1,0
56391,445,0,0,70,70,0,1,0,1,0
49982,445,0,0,66,66,0,1,0,1,0
56301,445,0,0,70,70,0,1,0,1,0
52772,445,0,0,70,70,0,1,0,1,0
65268,445,0,0,66,66,0,1,0,1,0
65029,445,0,0,70,70,0,1,0,1,0
51281,445,0,0,70,70,0,1,0,1,0
51045,445,0,0,70,70,0,1,0,1,0
52726,445,0,0,66,66,0,1,0,1,0
64567,445,0,0,66,66,0,1,0,1,0
59700,445,0,0,70,70,0,1,0,1,0
54717,445,0,0,70,70,0,1,0,1,0
59206,445,0,0,70,70,0,1,0,1,0
63544,445,0,0,70,70,0,1,0,1,0
57561,445,0,0,70,70,0,1,0,1,0
58892,445,0,0,70,70,0,1,0,1,0
50917,445,0,0,70,70,0,1,0,1,0
57676,445,0,0,70,70,0,1,0,1,0
55713,445,0,0,66,66,0,1,0,1,0
50325,445,0,0,66,66,0,1,0,1,0
61226,445,0,0,66,66,0,1,0,1,0
52779,445,0,0,66,66,0,1,0,1,0
61455,445,0,0,70,70,0,1,0,1,0
65236,445,0,0,70,70,0,1,0,1,0
57547,445,0,0,70,70,0,1,0,1,0
63254,445,0,0,70,70,0,1,0,1,0
50816,445,0,0,66,66,0,1,0,1,0
63976,445,0,0,66,66,0,1,0,1,0
55288,445,0,0,70,70,0,1,0,1,0
64321,445,0,0,66,66,0,1,0,1,0
50018,445,0,0,70,70,0,1,0,1,0
60120,445,0,0,66,66,0,1,0,1,0
61698,445,0,0,70,70,0,1,0,1,0
64332,445,0,0,70,70,0,1,0,1,0
52527,445,0,0,70,70,0,1,0,1,0
60376,445,0,0,70,70,0,1,0,1,0
53496,445,0,0,66,66,0,1,0,1,0
60876,445,0,0,66,66,0,1,0,1,0
50464,445,0,0,66,66,0,1,0,1,0
50433,445,0,0,70,70,0,1,0,1,0
56860,445,0,0,70,70,0,1,0,1,0
50261,445,0,0,70,70,0,1,0,1,0
63617,445,0,0,70,70,0,1,0,1,0
63271,445,0,0,70,70,0,1,0,1,0
55223,445,0,0,70,70,0,1,0,1,0
52090,445,0,0,66,66,0,1,0,1,0
50620,445,0,0,70,70,0,1,0,1,0
64873,445,0,0,66,66,0,1,0,1,0
53652,445,0,0,66,66,0,1,0,1,0
58960,445,0,0,70,70,0,1,0,1,0
50523,445,0,0,70,70,0,1,0,1,0
53634,445,0,0,70,70,0,1,0,1,0
50170,445,0,0,70,70,0,1,0,1,0
54268,445,0,0,70,70,0,1,0,1,0
51571,445,0,0,66,66,0,1,0,1,0
52084,445,0,0,66,66,0,1,0,1,0
57240,445,0,0,66,66,0,1,0,1,0
61250,445,0,0,70,70,0,1,0,1,0
61591,445,0,0,70,70,0,1,0,1,0
54386,445,0,0,70,70,0,1,0,1,0
57034,445,0,0,66,66,0,1,0,1,0
58248,445,0,0,70,70,0,1,0,1,0
53639,445,0,0,66,66,0,1,0,1,0
49845,445,0,0,66,66,0,1,0,1,0
50230,445,0,0,70,70,0,1,0,1,0
49687,445,0,0,70,70,0,1,0,1,0
61218,445,0,0,70,70,0,1,0,1,0
61763,445,0,0,70,70,0,1,0,1,0
57186,445,0,0,70,70,0,1,0,1,0
54533,445,0,0,70,70,0,1,0,1,0
60222,445,0,0,70,70,0,1,0,1,0
53800,445,0,0,70,70,0,1,0,1,0
50385,445,0,0,70,70,0,1,0,1,0
56710,445,0,0,66,66,0,1,0,1,0
64676,445,0,0,70,70,0,1,0,1,0
53037,445,0,0,70,70,0,1,0,1,0
60474,445,0,0,66,66,0,1,0,1,0
61722,445,0,0,70,70,0,1,0,1,0
50269,445,0,0,70,70,0,1,0,1,0
50354,445,0,0,70,70,0,1,0,1,0
49566,445,0,0,70,70,0,1,0,1,0
55777,445,0,0,70,70,0,1,0,1,0
50914,445,0,0,70,70,0,1,0,1,0
49761,445,0,0,70,70,0,1,0,1,0
57222,445,0,0,66,66,0,1,0,1,0
55901,445,0,0,70,70,0,1,0,1,0
63329,445,0,0,66,66,0,1,0,1,0
50008,445,0,0,70,70,0,1,0,1,0
51708,445,0,0,70,70,0,1,0,1,0
53309,445,0,0,66,66,0,1,0,1,0
62736,445,0,0,70,70,0,1,0,1,0
50595,445,0,0,66,66,0,1,0,1,0
65435,445,0,0,66,66,0,1,0,1,0
59565,445,0,0,70,70,0,1,0,1,0
51700,445,0,0,66,66,0,1,0,1,0
52349,445,0,0,70,70,0,1,0,1,0
50485,445,0,0,70,70,0,1,0,1,0
59609,445,0,0,70,70,0,1,0,1,0
63904,445,0,0,70,70,0,1,0,1,0
61770,445,0,0,70,70,0,1,0,1,0
65009,445,0,0,66,66,0,1,0,1,0
61473,445,0,0,70,70,0,1,0,1,0
61554,445,0,0,70,70,0,1,0,1,0
57263,445,0,0,70,70,0,1,0,1,0
53309,445,0,0,70,70,0,1,0,1,0
50698,445,0,0,70,70,0,1,0,1,0
64092,445,0,0,70,70,0,1,0,1,0
49939,445,0,0,70,70,0,1,0,1,0
53427,445,0,0,66,66,0,1,0,1,0
50007,445,0,0,70,70,0,1,0,1,0
63902,445,0,0,66,66,0,1,0,1,0
55858,445,0,0,66,66,0,1,0,1,0
57170,445,0,0,70,70,0,1,0,1,0
64825,445,0,0,70,70,0,1,0,1,0
61291,445,0,0,70,70,0,1,0,1,0
59114,445,0,0,70,70,0,1,0,1,0
64819,445,0,0,70,70,0,1,0,1,0
53928,445,0,0,66,66,0,1,0,1,0
63846,445,0,0,70,70,0,1,0,1,0
63543,445,0,0,66,66,0,1,0,1,0
50792,445,0,0,70,70,0,1,0,1,0
52236,445,0,0,70,70,0,1,0,1,0
61910,445,0,0,66,66,0,1,0,1,0
53423,445,0,0,70,70,0,1,0,1,0
64585,445,0,0,70,70,0,1,0,1,0
53469,445,0,0,70,70,0,1,0,1,0
64450,445,0,0,66,66,0,1,0,1,0
50772,445,0,0,70,70,0,1,0,1,0
57225,445,0,0,66,66,0,1,0,1,0
58004,445,0,0,70,70,0,1,0,1,0
57010,445,0,0,70,70,0,1,0,1,0
53803,445,0,0,70,70,0,1,0,1,0
59089,445,0,0,70,70,0,1,0,1,0
51764,445,0,0,66,66,0,1,0,1,0
62178,445,0,0,66,66,0,1,0,1,0
56067,445,0,0,66,66,0,1,0,1,0
60216,445,0,0,70,70,0,1,0,1,0
52583,445,0,0,70,70,0,1,0,1,0
50638,445,0,0,70,70,0,1,0,1,0
50999,445,0,0,70,70,0,1,0,1,0
49625,445,0,0,70,70,0,1,0,1,0
54236,445,0,0,70,70,0,1,0,1,0
56839,445,0,0,66,66,0,1,0,1,0
65533,445,0,0,66,66,0,1,0,1,0
49328,445,0,0,70,70,0,1,0,1,0
61898,445,0,0,66,66,0,1,0,1,0
57285,445,0,0,66,66,0,1,0,1,0
49588,445,0,0,66,66,0,1,0,1,0
55268,445,0,0,70,70,0,1,0,1,0
49869,445,0,0,70,70,0,1,0,1,0
55158,445,0,0,70,70,0,1,0,1,0
55679,445,0,0,70,70,0,1,0,1,0
60722,445,0,0,70,70,0,1,0,1,0
57687,445,0,0,66,66,0,1,0,1,0
60805,445,0,0,66,66,0,1,0,1,0
49966,445,0,0,66,66,0,1,0,1,0
65119,445,0,0,70,70,0,1,0,1,0
54858,445,0,0,66,66,0,1,0,1,0
57732,445,0,0,70,70,0,1,0,1,0
56584,445,0,0,66,66,0,1,0,1,0
52183,445,0,0,70,70,0,1,0,1,0
58468,445,0,0,70,70,0,1,0,1,0
58694,445,0,0,70,70,0,1,0,1,0
55598,445,0,0,70,70,0,1,0,1,0
53527,445,0,0,70,70,0,1,0,1,0
54827,445,0,0,70,70,0,1,0,1,0
59145,445,0,0,70,70,0,1,0,1,0
57945,445,0,0,70,70,0,1,0,1,0
50837,445,0,0,66,66,0,1,0,1,0
55938,445,0,0,70,70,0,1,0,1,0
50843,445,0,0,70,70,0,1,0,1,0
52769,445,0,0,70,70,0,1,0,1,0
54945,445,0,0,70,70,0,1,0,1,0
54314,445,0,0,70,70,0,1,0,1,0
60692,445,0,0,66,66,0,1,0,1,0
61790,445,0,0,66,66,0,1,0,1,0
54293,445,0,0,70,70,0,1,0,1,0
59696,445,0,0,70,70,0,1,0,1,0
57488,445,0,0,70,70,0,1,0,1,0
56358,445,0,0,70,70,0,1,0,1,0
57987,445,0,0,66,66,0,1,0,1,0
52186,445,0,0,70,70,0,1,0,1,0
50619,445,0,0,70,70,0,1,0,1,0
65381,445,0,0,70,70,0,1,0,1,0
54997,445,0,0,70,70,0,1,0,1,0
52892,445,0,0,70,70,0,1,0,1,0
55558,445,0,0,70,70,0,1,0,1,0
56395,445,0,0,70,70,0,1,0,1,0
61420,445,0,0,70,70,0,1,0,1,0
53278,445,0,0,70,70,0,1,0,1,0
61973,445,0,0,70,70,0,1,0,1,0
51549,445,0,0,70,70,0,1,0,1,0
55727,445,0,0,70,70,0,1,0,1,0
53349,445,0,0,66,66,0,1,0,1,0
57602,445,0,0,66,66,0,1,0,1,0
65002,445,0,0,70,70,0,1,0,1,0
59902,445,0,0,66,66,0,1,0,1,0
60725,445,0,0,70,70,0,1,0,1,0
56919,445,0,0,70,70,0,1,0,1,0
50358,445,0,0,70,70,0,1,0,1,0
61392,445,0,0,70,70,0,1,0,1,0
53458,445,0,0,70,70,0,1,0,1,0
51722,445,0,0,70,70,0,1,0,1,0
59588,445,0,0,70,70,0,1,0,1,0
57167,445,0,0,70,70,0,1,0,1,0
54734,445,0,0,70,70,0,1,0,1,0
62294,445,0,0,70,70,0,1,0,1,0
62627,445,0,0,70,70,0,1,0,1,0
52680,445,0,0,66,66,0,1,0,1,0
56616,445,0,0,70,70,0,1,0,1,0
53949,445,0,0,70,70,0,1,0,1,0
51049,445,0,0,70,70,0,1,0,1,0
64418,445,0,0,66,66,0,1,0,1,0
63130,445,0,0,70,70,0,1,0,1,0
50687,445,0,0,70,70,0,1,0,1,0
50515,445,0,0,70,70,0,1,0,1,0
50812,445,0,0,70,70,0,1,0,1,0
59198,445,0,0,66,66,0,1,0,1,0
51730,445,0,0,66,66,0,1,0,1,0
62591,445,0,0,70,70,0,1,0,1,0
50876,445,0,0,70,70,0,1,0,1,0
63272,445,0,0,66,66,0,1,0,1,0
54109,445,0,0,70,70,0,1,0,1,0
60955,445,0,0,66,66,0,1,0,1,0
52593,445,0,0,70,70,0,1,0,1,0
54199,445,0,0,66,66,0,1,0,1,0
54400,445,0,0,70,70,0,1,0,1,0
52758,445,0,0,70,70,0,1,0,1,0
62007,445,0,0,70,70,0,1,0,1,0
63005,445,0,0,66,66,0,1,0,1,0
65508,445,0,0,70,70,0,1,0,1,0
49248,445,0,0,66,66,0,1,0,1,0
52983,445,0,0,66,66,0,1,0,1,0
50549,445,0,0,66,66,0,1,0,1,0
53761,445,0,0,70,70,0,1,0,1,0
64781,445,0,0,70,70,0,1,0,1,0
59624,445,0,0,70,70,0,1,0,1,0
50502,445,0,0,66,66,0,1,0,1,0
61491,445,0,0,70,70,0,1,0,1,0
55761,445,0,0,70,70,0,1,0,1,0
54612,445,0,0,70,70,0,1,0,1,0
50502,445,0,0,70,70,0,1,0,1,0
60176,445,0,0,66,66,0,1,0,1,0
60084,445,0,0,70,70,0,1,0,1,0
56206,445,0,0,70,70,0,1,0,1,0
62504,445,0,0,70,70,0,1,0,1,0
61187,445,0,0,70,70,0,1,0,1,0
62525,445,0,0,66,66,0,1,0,1,0
65092,445,0,0,70,70,0,1,0,1,0
53047,445,0,0,66,66,0,1,0,1,0
52747,445,0,0,66,66,0,1,0,1,0
62587,445,0,0,70,70,0,1,0,1,0
61692,445,0,0,70,70,0,1,0,1,0
50162,445,0,0,70,70,0,1,0,1,0
58562,445,0,0,70,70,0,1,0,1,0
60560,445,0,0,70,70,0,1,0,1,0
50632,445,0,0,66,66,0,1,0,1,0
55419,445,0,0,70,70,0,1,0,1,0
61462,445,0,0,70,70,0,1,0,1,0
63288,445,0,0,70,70,0,1,0,1,0
49922,445,0,0,70,70,0,1,0,1,0
64478,445,0,0,70,70,0,1,0,1,0
61386,445,0,0,66,66,0,1,0,1,0
63239,445,0,0,70,70,0,1,0,1,0
53049,445,0,0,70,70,0,1,0,1,0
52602,445,0,0,66,66,0,1,0,1,0
62875,445,0,0,66,66,0,1,0,1,0
51902,445,0,0,70,70,0,1,0,1,0
61659,445,0,0,70,70,0,1,0,1,0
59070,445,0,0,70,70,0,1,0,1,0
50518,445,0,0,70,70,0,1,0,1,0
57452,445,0,0,70,70,0,1,0,1,0
59013,445,0,0,70,70,0,1,0,1,0
49627,445,0,0,70,70,0,1,0,1,0
52332,445,0,0,70,70,0,1,0,1,0
63200,445,0,0,70,70,0,1,0,1,0
56222,445,0,0,70,70,0,1,0,1,0
61318,445,0,0,66,66,0,1,0,1,0
61127,445,0,0,70,70,0,1,0,1,0
54575,445,0,0,66,66,0,1,0,1,0
55546,445,0,0,70,70,0,1,0,1,0
60501,445,0,0,70,70,0,1,0,1,0
61255,445,0,0,70,70,0,1,0,1,0
54639,445,0,0,70,70,0,1,0,1,0
51179,445,0,0,66,66,0,1,0,1,0
65455,445,0,0,70,70,0,1,0,1,0
59728,445,0,0,70,70,0,1,0,1,0
65051,445,0,0,70,70,0,1,0,1,0
58007,445,0,0,66,66,0,1,0,1,0
55338,445,0,0,66,66,0,1,0,1,0
50677,445,0,0,66,66,0,1,0,1,0
63517,445,0,0,70,70,0,1,0,1,0
55479,445,0,0,66,66,0,1,0,1,0
54461,445,0,0,70,70,0,1,0,1,0
59510,445,0,0,70,70,0,1,0,1,0
50896,445,0,0,70,70,0,1,0,1,0
58633,445,0,0,70,70,0,1,0,1,0
55591,445,0,0,70,70,0,1,0,1,0
59109,445,0,0,70,70,0,1,0,1,0
56115,445,0,0,66,66,0,1,0,1,0
65002,445,0,0,66,66,0,1,0,1,0
61975,445,0,0,66,66,0,1,0,1,0
58510,445,0,0,66,66,0,1,0,1,0
57121,445,0,0,70,70,0,1,0,1,0
52361,445,0,0,66,66,0,1,0,1,0
63248,445,0,0,70,70,0,1,0,1,0
61038,445,0,0,66,66,0,1,0,1,0
51235,445,0,0,70,70,0,1,0,1,0
52950,445,0,0,70,70,0,1,0,1,0
54971,445,0,0,70,70,0,1,0,1,0
55528,445,0,0,66,66,0,1,0,1,0
58443,445,0,0,70,70,0,1,0,1,0
59019,445,0,0,66,66,0,1,0,1,0
63527,445,0,0,70,70,0,1,0,1,0
59703,445,0,0,70,70,0,1,0,1,0
60815,445,0,0,70,70,0,1,0,1,0
63472,445,0,0,66,66,0,1,0,1,0
55033,445,0,0,70,70,0,1,0,1,0
65221,445,0,0,66,66,0,1,0,1,0
56131,445,0,0,66,66,0,1,0,1,0
57870,445,0,0,70,70,0,1,0,1,0
54974,445,0,0,70,70,0,1,0,1,0
60660,445,0,0,70,70,0,1,0,1,0
57851,445,0,0,70,70,0,1,0,1,0
62774,445,0,0,66,66,0,1,0,1,0
50304,445,0,0,70,70,0,1,0,1,0
55758,445,0,0,70,70,0,1,0,1,0
57837,445,0,0,70,70,0,1,0,1,0
60489,445,0,0,66,66,0,1,0,1,0
54256,445,0,0,70,70,0,1,0,1,0
53860,445,0,0,70,70,0,1,0,1,0
52246,445,0,0,70,70,0,1,0,1,0
65349,445,0,0,66,66,0,1,0,1,0
62914,445,0,0,70,70,0,1,0,1,0
62035,445,0,0,70,70,0,1,0,1,0
56157,445,0,0,70,70,0,1,0,1,0
53884,445,0,0,66,66,0,1,0,1,0
56258,445,0,0,66,66,0,1,0,1,0
50886,445,0,0,70,70,0,1,0,1,0
60884,445,0,0,70,70,0,1,0,1,0
58057,445,0,0,66,66,0,1,0,1,0
53470,445,0,0,70,70,0,1,0,1,0
55084,445,0,0,70,70,0,1,0,1,0
52562,445,0,0,70,70,0,1,0,1,0
58472,445,0,0,66,66,0,1,0,1,0
59395,445,0,0,70,70,0,1,0,1,0
61784,445,0,0,70,70,0,1,0,1,0
49886,445,0,0,70,70,0,1,0,1,0
64733,445,0,0,70,70,0,1,0,1,0
53930,445,0,0,66,66,0,1,0,1,0
59734,445,0,0,70,70,0,1,0,1,0
54651,445,0,0,66,66,0,1,0,1,0
52313,445,0,0,70,70,0,1,0,1,0
65026,445,0,0,70,70,0,1,0,1,0
65012,445,0,0,70,70,0,1,0,1,0
54643,445,0,0,70,70,0,1,0,1,0
60306,445,0,0,66,66,0,1,0,1,0
51767,445,0,0,70,70,0,1,0,1,0
57763,445,0,0,70,70,0,1,0,1,0
63237,445,0,0,70,70,0,1,0,1,0
64555,445,0,0,70,70,0,1,0,1,0
62267,445,0,0,70,70,0,1,0,1,0
60158,445,0,0,70,70,0,1,0,1,0
61301,445,0,0,70,70,0,1,0,1,0
51655,445,0,0,70,70,0,1,0,1,0
62465,445,0,0,70,70,0,1,0,1,0
55093,445,0,0,66,66,0,1,0,1,0
52210,445,0,0,70,70,0,1,0,1,0
56251,445,0,0,70,70,0,1,0,1,0
53551,445,0,0,66,66,0,1,0,1,0
54007,445,0,0,66,66,0,1,0,1,0
63158,445,0,0,66,66,0,1,0,1,0
56991,445,0,0,66,66,0,1,0,1,0
56624,445,0,0,70,70,0,1,0,1,0
61880,445,0,0,70,70,0,1,0,1,0
59593,445,0,0,66,66,0,1,0,1,0
54932,445,0,0,66,66,0,1,0,1,0
64921,445,0,0,66,66,0,1,0,1,0
51419,445,0,0,70,70,0,1,0,1,0
50050,445,0,0,66,66,0,1,0,1,0
56747,445,0,0,70,70,0,1,0,1,0
49652,445,0,0,70,70,0,1,0,1,0
62951,445,0,0,66,66,0,1,0,1,0
57122,445,0,0,66,66,0,1,0,1,0
53947,445,0,0,66,66,0,1,0,1,0
64576,445,0,0,66,66,0,1,0,1,0
51021,445,0,0,66,66,0,1,0,1,0
53664,445,0,0,66,66,0,1,0,1,0
49476,445,0,0,70,70,0,1,0,1,0
56555,445,0,0,70,70,0,1,0,1,0
61124,445,0,0,70,70,0,1,0,1,0
58054,445,0,0,70,70,0,1,0,1,0
60052,445,0,0,66,66,0,1,0,1,0
60338,445,0,0,70,70,0,1,0,1,0
61640,445,0,0,66,66,0,1,0,1,0
49280,445,0,0,70,70,0,1,0,1,0
53308,445,0,0,70,70,0,1,0,1,0
55619,445,0,0,70,70,0,1,0,1,0
51716,445,0,0,70,70,0,1,0,1,0
61180,445,0,0,70,70,0,1,0,1,0
50838,445,0,0,70,70,0,1,0,1,0
55760,445,0,0,66,66,0,1,0,1,0
51723,445,0,0,70,70,0,1,0,1,0
58541,445,0,0,70,70,0,1,0,1,0
53500,445,0,0,66,66,0,1,0,1,0
54735,445,0,0,70,70,0,1,0,1,0
60288,445,0,0,70,70,0,1,0,1,0
59211,445,0,0,66,66,0,1,0,1,0
56553,445,0,0,70,70,0,1,0,1,0
56539,445,0,0,70,70,0,1,0,1,0
59617,445,0,0,66,66,0,1,0,1,0
58889,445,0,0,66,66,0,1,0,1,0
57418,445,0,0,66,66,0,1,0,1,0
51525,445,0,0,70,70,0,1,0,1,0
64390,445,0,0,70,70,0,1,0,1,0
63032,445,0,0,70,70,0,1,0,1,0
61464,445,0,0,66,66,0,1,0,1,0
62727,445,0,0,70,70,0,1,0,1,0
63391,445,0,0,70,70,0,1,0,1,0
64985,445,0,0,66,66,0,1,0,1,0
50497,445,0,0,70,70,0,1,0,1,0
50291,445,0,0,66,66,0,1,0,1,0
59127,445,0,0,66,66,0,1,0,1,0
50525,445,0,0,70,70,0,1,0,1,0
60337,445,0,0,70,70,0,1,0,1,0
62075,445,0,0,70,70,0,1,0,1,0
56224,445,0,0,70,70,0,1,0,1,0
63841,445,0,0,66,66,0,1,0,1,0
57573,445,0,0,70,70,0,1,0,1,0
60632,445,0,0,70,70,0,1,0,1,0
52647,445,0,0,70,70,0,1,0,1,0
60706,445,0,0,70,70,0,1,0,1,0
58419,445,0,0,70,70,0,1,0,1,0
50132,445,0,0,70,70,0,1,0,1,0
51639,445,0,0,66,66,0,1,0,1,0
59576,445,0,0,70,70,0,1,0,1,0
51658,445,0,0,70,70,0,1,0,1,0
50030,445,0,0,70,70,0,1,0,1,0
50415,445,0,0,70,70,0,1,0,1,0
60086,445,0,0,70,70,0,1,0,1,0
62659,445,0,0,70,70,0,1,0,1,0
58513,445,0,0,70,70,0,1,0,1,0
49237,445,0,0,70,70,0,1,0,1,0
65013,445,0,0,70,70,0,1,0,1,0
52238,445,0,0,70,70,0,1,0,1,0
56547,445,0,0,70,70,0,1,0,1,0
56236,445,0,0,70,70,0,1,0,1,0
61110,445,0,0,70,70,0,1,0,1,0
52860,445,0,0,66,66,0,1,0,1,0
59321,445,0,0,66,66,0,1,0,1,0
53252,445,0,0,70,70,0,1,0,1,0
63557,445,0,0,70,70,0,1,0,1,0
62373,445,0,0,66,66,0,1,0,1,0
50112,445,0,0,70,70,0,1,0,1,0
57063,445,0,0,70,70,0,1,0,1,0
52474,445,0,0,66,66,0,1,0,1,0
51014,445,0,0,66,66,0,1,0,1,0
53115,445,0,0,66,66,0,1,0,1,0
50535,445,0,0,66,66,0,1,0,1,0
62811,445,0,0,66,66,0,1,0,1,0
53724,445,0,0,70,70,0,1,0,1,0
64514,445,0,0,70,70,0,1,0,1,0
53068,445,0,0,70,70,0,1,0,1,0
59738,445,0,0,66,66,0,1,0,1,0
63753,445,0,0,70,70,0,1,0,1,0
49194,445,0,0,70,70,0,1,0,1,0
49543,445,0,0,66,66,0,1,0,1,0
57148,445,0,0,66,66,0,1,0,1,0
57986,445,0,0,66,66,0,1,0,1,0
56715,445,0,0,70,70,0,1,0,1,0
55352,445,0,0,66,66,0,1,0,1,0
55952,445,0,0,66,66,0,1,0,1,0
64602,445,0,0,66,66,0,1,0,1,0
56678,445,0,0,70,70,0,1,0,1,0
65396,445,0,0,70,70,0,1,0,1,0
63202,445,0,0,66,66,0,1,0,1,0
53080,445,0,0,70,70,0,1,0,1,0
59659,445,0,0,66,66,0,1,0,1,0
50795,445,0,0,66,66,0,1,0,1,0
50429,445,0,0,70,70,0,1,0,1,0
55128,445,0,0,70,70,0,1,0,1,0
64455,445,0,0,70,70,0,1,0,1,0
54142,445,0,0,70,70,0,1,0,1,0
58353,445,0,0,70,70,0,1,0,1,0
65502,445,0,0,70,70,0,1,0,1,0
49168,445,0,0,70,70,0,1,0,1,0
59213,445,0,0,70,70,0,1,0,1,0
49242,445,0,0,70,70,0,1,0,1,0
64689,445,0,0,70,70,0,1,0,1,0
57346,445,0,0,66,66,0,1,0,1,0
57653,445,0,0,70,70,0,1,0,1,0
56608,445,0,0,70,70,0,1,0,1,0
53692,445,0,0,66,66,0,1,0,1,0
61868,445,0,0,70,70,0,1,0,1,0
58188,445,0,0,70,70,0,1,0,1,0
65165,445,0,0,66,66,0,1,0,1,0
52015,445,0,0,70,70,0,1,0,1,0
64730,445,0,0,70,70,0,1,0,1,0
54593,445,0,0,70,70,0,1,0,1,0
58120,445,0,0,66,66,0,1,0,1,0
63297,445,0,0,70,70,0,1,0,1,0
62103,445,0,0,66,66,0,1,0,1,0
58409,445,0,0,70,70,0,1,0,1,0
62211,445,0,0,70,70,0,1,0,1,0
50079,445,0,0,66,66,0,1,0,1,0
57491,445,0,0,66,66,0,1,0,1,0
49318,445,0,0,70,70,0,1,0,1,0
55212,445,0,0,70,70,0,1,0,1,0
50009,445,0,0,70,70,0,1,0,1,0
65506,445,0,0,66,66,0,1,0,1,0
59914,445,0,0,66,66,0,1,0,1,0
49891,445,0,0,66,66,0,1,0,1,0
64307,445,0,0,70,70,0,1,0,1,0
61872,445,0,0,70,70,0,1,0,1,0
60387,445,0,0,66,66,0,1,0,1,0
55164,445,0,0,70,70,0,1,0,1,0
57107,445,0,0,70,70,0,1,0,1,0
58824,445,0,0,70,70,0,1,0,1,0
56703,445,0,0,70,70,0,1,0,1,0
55288,445,0,0,70,70,0,1,0,1,0
49393,445,0,0,66,66,0,1,0,1,0
61772,445,0,0,66,66,0,1,0,1,0
56316,445,0,0,70,70,0,1,0,1,0
50858,445,0,0,70,70,0,1,0,1,0
60161,445,0,0,66,66,0,1,0,1,0
55490,445,0,0,70,70,0,1,0,1,0
56959,445,0,0,70,70,0,1,0,1,0
57745,445,0,0,70,70,0,1,0,1,0
65093,445,0,0,70,70,0,1,0,1,0
54782,445,0,0,66,66,0,1,0,1,0
50803,445,0,0,66,66,0,1,0,1,0
55543,445,0,0,70,70,0,1,0,1,0
59398,445,0,0,66,66,0,1,0,1,0
52045,445,0,0,70,70,0,1,0,1,0
63931,445,0,0,70,70,0,1,0,1,0
58912,445,0,0,70,70,0,1,0,1,0
57203,445,0,0,66,66,0,1,0,1,0
65276,445,0,0,66,66,0,1,0,1,0
53270,445,0,0,70,70,0,1,0,1,0
63727,445,0,0,70,70,0,1,0,1,0
55159,445,0,0,66,66,0,1,0,1,0
55084,445,0,0,70,70,0,1,0,1,0
56606,445,0,0,66,66,0,1,0,1,0
50033,445,0,0,66,66,0,1,0,1,0
61704,445,0,0,66,66,0,1,0,1,0
62835,445,0,0,70,70,0,1,0,1,0
57533,445,0,0,70,70,0,1,0,1,0
50711,445,0,0,70,70,0,1,0,1,0
61861,445,0,0,70,70,0,1,0,1,0
50269,445,0,0,66,66,0,1,0,1,0
50929,445,0,0,66,66,0,1,0,1,0
49497,445,0,0,70,70,0,1,0,1,0
51012,445,0,0,70,70,0,1,0,1,0
62213,445,0,0,70,70,0,1,0,1,0
54700,445,0,0,70,70,0,1,0,1,0
64676,445,0,0,70,70,0,1,0,1,0
64853,445,0,0,70,70,0,1,0,1,0
57497,445,0,0,66,66,0,1,0,1,0
63888,445,0,0,70,70,0,1,0,1,0
54204,445,0,0,66,66,0,1,0,1,0
59733,445,0,0,70,70,0,1,0,1,0
62566,445,0,0,66,66,0,1,0,1,0
60658,445,0,0,70,70,0,1,0,1,0
57639,445,0,0,70,70,0,1,0,1,0
50717,445,0,0,70,70,0,1,0,1,0
60857,445,0,0,70,70,0,1,0,1,0
54069,445,0,0,66,66,0,1,0,1,0
52497,445,0,0,70,70,0,1,0,1,0
54820,445,0,0,70,70,0,1,0,1,0
52651,445,0,0,66,66,0,1,0,1,0
58279,445,0,0,70,70,0,1,0,1,0
54492,445,0,0,70,70,0,1,0,1,0
50243,445,0,0,70,70,0,1,0,1,0
65470,445,0,0,70,70,0,1,0,1,0
57523,445,0,0,70,70,0,1,0,1,0
64937,445,0,0,66,66,0,1,0,1,0
56318,445,0,0,70,70,0,1,0,1,0
58352,445,0,0,70,70,0,1,0,1,0
54358,445,0,0,70,70,0,1,0,1,0
64812,445,0,0,66,66,0,1,0,1,0
62050,445,0,0,66,66,0,1,0,1,0
50049,445,0,0,70,70,0,1,0,1,0
49678,445,0,0,70,70,0,1,0,1,0
49795,445,0,0,70,70,0,1,0,1,0
58677,445,0,0,70,70,0,1,0,1,0
65069,445,0,0,70,70,0,1,0,1,0
49892,445,0,0,70,70,0,1,0,1,0
51656,445,0,0,70,70,0,1,0,1,0
59862,445,0,0,70,70,0,1,0,1,0
62438,445,0,0,70,70,0,1,0,1,0
54867,445,0,0,70,70,0,1,0,1,0
50445,445,0,0,70,70,0,1,0,1,0
64230,445,0,0,70,70,0,1,0,1,0
60360,445,0,0,66,66,0,1,0,1,0
54631,445,0,0,66,66,0,1,0,1,0
50020,445,0,0,70,70,0,1,0,1,0
63210,445,0,0,70,70,0,1,0,1,0
56385,445,0,0,70,70,0,1,0,1,0
49905,445,0,0,70,70,0,1,0,1,0
53032,445,0,0,70,70,0,1,0,1,0
57594,445,0,0,70,70,0,1,0,1,0
64914,445,0,0,70,70,0,1,0,1,0
54888,445,0,0,66,66,0,1,0,1,0
59970,445,0,0,66,66,0,1,0,1,0
54261,445,0,0,66,66,0,1,0,1,0
51604,445,0,0,70,70,0,1,0,1,0
59938,445,0,0,70,70,0,1,0,1,0
58891,445,0,0,70,70,0,1,0,1,0
55668,445,0,0,70,70,0,1,0,1,0
58042,445,0,0,66,66,0,1,0,1,0
50264,445,0,0,70,70,0,1,0,1,0
55883,445,0,0,70,70,0,1,0,1,0
64404,445,0,0,66,66,0,1,0,1,0
54940,445,0,0,70,70,0,1,0,1,0
50740,445,0,0,66,66,0,1,0,1,0
52696,445,0,0,70,70,0,1,0,1,0
51701,445,0,0,66,66,0,1,0,1,0
60575,445,0,0,66,66,0,1,0,1,0
53899,445,0,0,70,70,0,1,0,1,0
54086,445,0,0,66,66,0,1,0,1,0
49590,445,0,0,66,66,0,1,0,1,0
49454,445,0,0,70,70,0,1,0,1,0
62889,445,0,0,66,66,0,1,0,1,0
56427,445,0,0,70,70,0,1,0,1,0
60720,445,0,0,70,70,0,1,0,1,0
49263,445,0,0,66,66,0,1,0,1,0
59579,445,0,0,66,66,0,1,0,1,0
59404,445,0,0,66,66,0,1,0,1,0
62085,445,0,0,70,70,0,1,0,1,0
56241,445,0,0,70,70,0,1,0,1,0
60057,445,0,0,70,70,0,1,0,1,0
50137,445,0,0,70,70,0,1,0,1,0
56577,445,0,0,70,70,0,1,0,1,0
58033,445,0,0,70,70,0,1,0,1,0
56111,445,0,0,70,70,0,1,0,1,0
53085,445,0,0,70,70,0,1,0,1,0
56118,445,0,0,70,70,0,1,0,1,0
64237,445,0,0,70,70,0,1,0,1,0
58971,445,0,0,66,66,0,1,0,1,0
51436,445,0,0,70,70,0,1,0,1,0
60581,445,0,0,70,70,0,1,0,1,0
64963,445,0,0,70,70,0,1,0,1,0
51711,445,0,0,70,70,0,1,0,1,0
54355,445,0,0,70,70,0,1,0,1,0
59293,445,0,0,70,70,0,1,0,1,0
55686,445,0,0,70,70,0,1,0,1,0
50442,445,0,0,70,70,0,1,0,1,0
56192,445,0,0,66,66,0,1,0,1,0
50104,445,0,0,70,70,0,1,0,1,0
61256,445,0,0,70,70,0,1,0,1,0
65522,445,0,0,70,70,0,1,0,1,0
53501,445,0,0,66,66,0,1,0,1,0
53074,445,0,0,70,70,0,1,0,1,0
64211,445,0,0,66,66,0,1,0,1,0
51325,445,0,0,66,66,0,1,0,1,0
65308,445,0,0,70,70,0,1,0,1,0
49926,445,0,0,70,70,0,1,0,1,0
60051,445,0,0,66,66,0,1,0,1,0
53450,445,0,0,70,70,0,1,0,1,0
61892,445,0,0,70,70,0,1,0,1,0
52460,445,0,0,70,70,0,1,0,1,0
62049,445,0,0,66,66,0,1,0,1,0
60693,445,0,0,66,66,0,1,0,1,0
58497,445,0,0,70,70,0,1,0,1,0
53606,445,0,0,66,66,0,1,0,1,0
50568,445,0,0,66,66,0,1,0,1,0
53749,445,0,0,70,70,0,1,0,1,0
57454,445,0,0,70,70,0,1,0,1,0
53462,445,0,0,70,70,0,1,0,1,0
52624,445,0,0,70,70,0,1,0,1,0
58321,445,0,0,66,66,0,1,0,1,0
52933,445,0,0,66,66,0,1,0,1,0
57617,445,0,0,70,70,0,1,0,1,0
56275,445,0,0,66,66,0,1,0,1,0
63884,445,0,0,66,66,0,1,0,1,0
65057,445,0,0,70,70,0,1,0,1,0
54059,445,0,0,70,70,0,1,0,1,0
62463,445,0,0,70,70,0,1,0,1,0
53316,445,0,0,70,70,0,1,0,1,0
52821,445,0,0,70,70,0,1,0,1,0
59989,445,0,0,70,70,0,1,0,1,0
52369,445,0,0,70,70,0,1,0,1,0
50383,445,0,0,70,70,0,1,0,1,0
52861,445,0,0,70,70,0,1,0,1,0
50647,445,0,0,70,70,0,1,0,1,0
53761,445,0,0,70,70,0,1,0,1,0
56901,445,0,0,66,66,0,1,0,1,0
50927,445,0,0,70,70,0,1,0,1,0
62485,445,0,0,66,66,0,1,0,1,0
51104,445,0,0,66,66,0,1,0,1,0
53115,445,0,0,70,70,0,1,0,1,0
63358,445,0,0,70,70,0,1,0,1,0
60498,445,0,0,66,66,0,1,0,1,0
64263,445,0,0,70,70,0,1,0,1,0
59165,445,0,0,70,70,0,1,0,1,0
65116,445,0,0,66,66,0,1,0,1,0
55302,445,0,0,70,70,0,1,0,1,0
60161,445,0,0,70,70,0,1,0,1,0
62509,445,0,0,66,66,0,1,0,1,0
53382,445,0,0,70,70,0,1,0,1,0
52334,445,0,0,70,70,0,1,0,1,0
51243,445,0,0,66,66,0,1,0,1,0
56426,445,0,0,70,70,0,1,0,1,0
59826,445,0,0,66,66,0,1,0,1,0
56317,445,0,0,70,70,0,1,0,1,0
49455,445,0,0,66,66,0,1,0,1,0
54532,445,0,0,70,70,0,1,0,1,0
50071,445,0,0,70,70,0,1,0,1,0
51845,445,0,0,70,70,0,1,0,1,0
60915,445,0,0,70,70,0,1,0,1,0
56052,445,0,0,70,70,0,1,0,1,0
64427,445,0,0,70,70,0,1,0,1,0
65456,445,0,0,70,70,0,1,0,1,0
57777,445,0,0,70,70,0,1,0,1,0
50622,445,0,0,66,66,0,1,0,1,0
58999,445,0,0,66,66,0,1,0,1,0
61420,445,0,0,66,66,0,1,0,1,0
52496,445,0,0,70,70,0,1,0,1,0
63652,445,0,0,70,70,0,1,0,1,0
55146,445,0,0,70,70,0,1,0,1,0
55722,445,0,0,70,70,0,1,0,1,0
53864,445,0,0,66,66,0,1,0,1,0
50456,445,0,0,70,70,0,1,0,1,0
64524,445,0,0,70,70,0,1,0,1,0
57182,445,0,0,66,66,0,1,0,1,0
63643,445,0,0,70,70,0,1,0,1,0
63547,445,0,0,70,70,0,1,0,1,0
58439,445,0,0,66,66,0,1,0,1,0
54539,445,0,0,70,70,0,1,0,1,0
51892,445,0,0,66,66,0,1,0,1,0
61625,445,0,0,70,70,0,1,0,1,0
54739,445,0,0,66,66,0,1,0,1,0
63074,445,0,0,70,70,0,1,0,1,0
51597,445,0,0,70,70,0,1,0,1,0
57348,445,0,0,66,66,0,1,0,1,0
61193,445,0,0,66,66,0,1,0,1,0
64845,445,0,0,70,70,0,1,0,1,0
51359,445,0,0,70,70,0,1,0,1,0
58049,445,0,0,70,70,0,1,0,1,0
60230,445,0,0,70,70,0,1,0,1,0
54577,445,0,0,66,66,0,1,0,1,0
63170,445,0,0,70,70,0,1,0,1,0
64927,445,0,0,70,70,0,1,0,1,0
58330,445,0,0,70,70,0,1,0,1,0
54857,445,0,0,70,70,0,1,0,1,0
56778,445,0,0,66,66,0,1,0,1,0
52271,445,0,0,70,70,0,1,0,1,0
53150,445,0,0,70,70,0,1,0,1,0
59015,445,0,0,70,70,0,1,0,1,0
54301,445,0,0,70,70,0,1,0,1,0
50508,445,0,0,66,66,0,1,0,1,0
53816,445,0,0,66,66,0,1,0,1,0
54474,445,0,0,66,66,0,1,0,1,0
57116,445,0,0,70,70,0,1,0,1,0
55744,445,0,0,66,66,0,1,0,1,0
64413,445,0,0,70,70,0,1,0,1,0
61620,445,0,0,70,70,0,1,0,1,0
53291,445,0,0,70,70,0,1,0,1,0
60508,445,0,0,70,70,0,1,0,1,0
51829,445,0,0,66,66,0,1,0,1,0
50309,445,0,0,70,70,0,1,0,1,0
61140,445,0,0,70,70,0,1,0,1,0
53416,445,0,0,70,70,0,1,0,1,0
49215,445,0,0,70,70,0,1,0,1,0
53365,445,0,0,66,66,0,1,0,1,0
53437,445,0,0,70,70,0,1,0,1,0
55698,445,0,0,70,70,0,1,0,1,0
50985,445,0,0,66,66,0,1,0,1,0
54060,445,0,0,70,70,0,1,0,1,0
58198,445,0,0,70,70,0,1,0,1,0
64011,445,0,0,70,70,0,1,0,1,0
63498,445,0,0,66,66,0,1,0,1,0
50041,445,0,0,70,70,0,1,0,1,0
65295,445,0,0,70,70,0,1,0,1,0
55611,445,0,0,70,70,0,1,0,1,0
59676,445,0,0,70,70,0,1,0,1,0
52472,445,0,0,66,66,0,1,0,1,0
64448,445,0,0,66,66,0,1,0,1,0
50325,445,0,0,66,66,0,1,0,1,0
53028,445,0,0,70,70,0,1,0,1,0
58699,445,0,0,70,70,0,1,0,1,0
60093,445,0,0,70,70,0,1,0,1,0
55697,445,0,0,70,70,0,1,0,1,0
60100,445,0,0,66,66,0,1,0,1,0
64603,445,0,0,66,66,0,1,0,1,0
50692,445,0,0,70,70,0,1,0,1,0
61183,445,0,0,70,70,0,1,0,1,0
53675,445,0,0,66,66,0,1,0,1,0
57547,445,0,0,66,66,0,1,0,1,0
58765,445,0,0,70,70,0,1,0,1,0
59845,445,0,0,70,70,0,1,0,1,0
50137,445,0,0,70,70,0,1,0,1,0
63237,445,0,0,70,70,0,1,0,1,0
51288,445,0,0,70,70,0,1,0,1,0
56306,445,0,0,66,66,0,1,0,1,0
61015,445,0,0,66,66,0,1,0,1,0
55034,445,0,0,66,66,0,1,0,1,0
53523,445,0,0,70,70,0,1,0,1,0
50002,445,0,0,70,70,0,1,0,1,0
49970,445,0,0,66,66,0,1,0,1,0
52812,445,0,0,66,66,0,1,0,1,0
61750,445,0,0,70,70,0,1,0,1,0
53706,445,0,0,70,70,0,1,0,1,0
61294,445,0,0,70,70,0,1,0,1,0
59399,445,0,0,66,66,0,1,0,1,0
64534,445,0,0,66,66,0,1,0,1,0
50780,445,0,0,66,66,0,1,0,1,0
65374,445,0,0,70,70,0,1,0,1,0
54841,445,0,0,70,70,0,1,0,1,0
63279,445,0,0,70,70,0,1,0,1,0
49927,445,0,0,70,70,0,1,0,1,0
50378,445,0,0,70,70,0,1,0,1,0
57218,445,0,0,66,66,0,1,0,1,0
58348,445,0,0,70,70,0,1,0,1,0
54646,445,0,0,70,70,0,1,0,1,0
50821,445,0,0,66,66,0,1,0,1,0
50550,445,0,0,70,70,0,1,0,1,0
59270,445,0,0,66,66,0,1,0,1,0
55225,445,0,0,66,66,0,1,0,1,0
60038,445,0,0,70,70,0,1,0,1,0
55011,445,0,0,70,70,0,1,0,1,0
51014,445,0,0,70,70,0,1,0,1,0
56377,445,0,0,66,66,0,1,0,1,0
61355,445,0,0,70,70,0,1,0,1,0
54248,445,0,0,66,66,0,1,0,1,0
64094,445,0,0,70,70,0,1,0,1,0
50591,445,0,0,70,70,0,1,0,1,0
50258,445,0,0,70,70,0,1,0,1,0
57782,445,0,0,66,66,0,1,0,1,0
52415,445,0,0,70,70,0,1,0,1,0
56104,445,0,0,70,70,0,1,0,1,0
57667,445,0,0,66,66,0,1,0,1,0
51196,445,0,0,70,70,0,1,0,1,0
50786,445,0,0,66,66,0,1,0,1,0
56696,445,0,0,70,70,0,1,0,1,0
55610,445,0,0,66,66,0,1,0,1,0
54454,445,0,0,66,66,0,1,0,1,0
55339,445,0,0,70,70,0,1,0,1,0
51098,445,0,0,70,70,0,1,0,1,0
55109,445,0,0,70,70,0,1,0,1,0
49878,445,0,0,70,70,0,1,0,1,0
59361,445,0,0,70,70,0,1,0,1,0
49990,445,0,0,66,66,0,1,0,1,0
59389,445,0,0,70,70,0,1,0,1,0
51329,445,0,0,70,70,0,1,0,1,0
50408,445,0,0,70,70,0,1,0,1,0
58282,445,0,0,66,66,0,1,0,1,0
56901,445,0,0,70,70,0,1,0,1,0
54938,445,0,0,70,70,0,1,0,1,0
50271,445,0,0,70,70,0,1,0,1,0
64949,445,0,0,70,70,0,1,0,1,0
52406,445,0,0,66,66,0,1,0,1,0
59664,445,0,0,66,66,0,1,0,1,0
50833,445,0,0,70,70,0,1,0,1,0
64157,445,0,0,70,70,0,1,0,1,0
62961,445,0,0,70,70,0,1,0,1,0
59769,445,0,0,70,70,0,1,0,1,0
54523,445,0,0,70,70,0,1,0,1,0
50546,445,0,0,70,70,0,1,0,1,0
60549,445,0,0,70,70,0,1,0,1,0
59219,445,0,0,70,70,0,1,0,1,0
60927,445,0,0,70,70,0,1,0,1,0
65023,445,0,0,66,66,0,1,0,1,0
61406,445,0,0,70,70,0,1,0,1,0
51398,445,0,0,70,70,0,1,0,1,0
60980,445,0,0,70,70,0,1,0,1,0
62096,445,0,0,70,70,0,1,0,1,0
52602,445,0,0,70,70,0,1,0,1,0
51075,445,0,0,70,70,0,1,0,1,0
61555,445,0,0,70,70,0,1,0,1,0
55640,445,0,0,70,70,0,1,0,1,0
63165,445,0,0,70,70,0,1,0,1,0
56237,445,0,0,70,70,0,1,0,1,0
60278,445,0,0,70,70,0,1,0,1,0
64437,445,0,0,70,70,0,1,0,1,0
59321,445,0,0,70,70,0,1,0,1,0
54307,445,0,0,70,70,0,1,0,1,0
62946,445,0,0,70,70,0,1,0,1,0
57543,445,0,0,70,70,0,1,0,1,0
58113,445,0,0,66,66,0,1,0,1,0
53215,445,0,0,70,70,0,1,0,1,0
52405,445,0,0,70,70,0,1,0,1,0
65443,445,0,0,70,70,0,1,0,1,0
50423,445,0,0,70,70,0,1,0,1,0
49615,445,0,0,70,70,0,1,0,1,0
58079,445,0,0,66,66,0,1,0,1,0
60441,445,0,0,70,70,0,1,0,1,0
52001,445,0,0,70,70,0,1,0,1,0
50116,445,0,0,66,66,0,1,0,1,0
61847,445,0,0,70,70,0,1,0,1,0
62586,445,0,0,70,70,0,1,0,1,0
61981,445,0,0,70,70,0,1,0,1,0
51770,445,0,0,70,70,0,1,0,1,0
64487,445,0,0,70,70,0,1,0,1,0
54442,445,0,0,66,66,0,1,0,1,0
60493,445,0,0,66,66,0,1,0,1,0
60993,445,0,0,70,70,0,1,0,1,0
63788,445,0,0,70,70,0,1,0,1,0
64375,445,0,0,66,66,0,1,0,1,0
65314,445,0,0,70,70,0,1,0,1,0
55489,445,0,0,66,66,0,1,0,1,0
61467,445,0,0,70,70,0,1,0,1,0
52788,445,0,0,66,66,0,1,0,1,0
61318,445,0,0,70,70,0,1,0,1,0
50714,445,0,0,70,70,0,1,0,1,0
53813,445,0,0,66,66,0,1,0,1,0
52399,445,0,0,66,66,0,1,0,1,0
55745,445,0,0,66,66,0,1,0,1,0
58754,445,0,0,66,66,0,1,0,1,0
57808,445,0,0,70,70,0,1,0,1,0
52799,445,0,0,66,66,0,1,0,1,0
57929,445,0,0,70,70,0,1,0,1,0
50777,445,0,0,70,70,0,1,0,1,0
56964,445,0,0,66,66,0,1,0,1,0
60598,445,0,0,70,70,0,1,0,1,0
65199,445,0,0,70,70,0,1,0,1,0
61094,445,0,0,70,70,0,1,0,1,0
53371,445,0,0,66,66,0,1,0,1,0
52403,445,0,0,66,66,0,1,0,1,0
60074,445,0,0,70,70,0,1,0,1,0
60340,445,0,0,70,70,0,1,0,1,0
52050,445,0,0,70,70,0,1,0,1,0
49933,445,0,0,70,70,0,1,0,1,0
63291,445,0,0,70,70,0,1,0,1,0
55105,445,0,0,70,70,0,1,0,1,0
51035,445,0,0,70,70,0,1,0,1,0
55031,445,0,0,66,66,0,1,0,1,0
56467,445,0,0,70,70,0,1,0,1,0
52630,445,0,0,70,70,0,1,0,1,0
52565,445,0,0,70,70,0,1,0,1,0
56449,445,0,0,66,66,0,1,0,1,0
59077,445,0,0,66,66,0,1,0,1,0
64333,445,0,0,70,70,0,1,0,1,0
60997,445,0,0,70,70,0,1,0,1,0
65343,445,0,0,70,70,0,1,0,1,0
50382,445,0,0,70,70,0,1,0,1,0
62147,445,0,0,70,70,0,1,0,1,0
62556,445,0,0,66,66,0,1,0,1,0
51554,445,0,0,66,66,0,1,0,1,0
52037,445,0,0,66,66,0,1,0,1,0
64874,445,0,0,70,70,0,1,0,1,0
53086,445,0,0,70,70,0,1,0,1,0
57884,445,0,0,70,70,0,1,0,1,0
52655,445,0,0,70,70,0,1,0,1,0
56128,445,0,0,66,66,0,1,0,1,0
61385,445,0,0,70,70,0,1,0,1,0
57090,445,0,0,70,70,0,1,0,1,0
50366,445,0,0,70,70,0,1,0,1,0
53922,445,0,0,70,70,0,1,0,1,0
64132,445,0,0,70,70,0,1,0,1,0
62540,445,0,0,70,70,0,1,0,1,0
65050,445,0,0,66,66,0,1,0,1,0
62527,445,0,0,70,70,0,1,0,1,0
51813,445,0,0,66,66,0,1,0,1,0
50583,445,0,0,70,70,0,1,0,1,0
55402,445,0,0,70,70,0,1,0,1,0
62003,445,0,0,66,66,0,1,0,1,0
49969,445,0,0,66,66,0,1,0,1,0
53726,445,0,0,70,70,0,1,0,1,0
60411,445,0,0,70,70,0,1,0,1,0
60654,445,0,0,70,70,0,1,0,1,0
54667,445,0,0,70,70,0,1,0,1,0
56252,445,0,0,66,66,0,1,0,1,0
50289,445,0,0,70,70,0,1,0,1,0
61916,445,0,0,70,70,0,1,0,1,0
62225,445,0,0,70,70,0,1,0,1,0
54958,445,0,0,70,70,0,1,0,1,0
52522,445,0,0,70,70,0,1,0,1,0
59139,445,0,0,70,70,0,1,0,1,0
50464,445,0,0,70,70,0,1,0,1,0
64811,445,0,0,66,66,0,1,0,1,0
61238,445,0,0,66,66,0,1,0,1,0
51877,445,0,0,70,70,0,1,0,1,0
64579,445,0,0,70,70,0,1,0,1,0
64010,445,0,0,70,70,0,1,0,1,0
63211,445,0,0,66,66,0,1,0,1,0
50333,445,0,0,66,66,0,1,0,1,0
60701,445,0,0,70,70,0,1,0,1,0
55364,445,0,0,70,70,0,1,0,1,0
51315,445,0,0,66,66,0,1,0,1,0
57966,445,0,0,70,70,0,1,0,1,0
49507,445,0,0,66,66,0,1,0,1,0
52665,445,0,0,66,66,0,1,0,1,0
55333,445,0,0,70,70,0,1,0,1,0
63924,445,0,0,70,70,0,1,0,1,0
54955,445,0,0,66,66,0,1,0,1,0
61876,445,0,0,70,70,0,1,0,1,0
53226,445,0,0,70,70,0,1,0,1,0
59377,445,0,0,70,70,0,1,0,1,0
62630,445,0,0,66,66,0,1,0,1,0
57888,445,0,0,70,70,0,1,0,1,0
58741,445,0,0,70,70,0,1,0,1,0
53236,445,0,0,66,66,0,1,0,1,0
56801,445,0,0,70,70,0,1,0,1,0
64441,445,0,0,70,70,0,1,0,1,0
57407,445,0,0,70,70,0,1,0,1,0
55196,445,0,0,70,70,0,1,0,1,0
63100,445,0,0,70,70,0,1,0,1,0
56712,445,0,0,66,66,0,1,0,1,0
53614,445,0,0,70,70,0,1,0,1,0
54876,445,0,0,70,70,0,1,0,1,0
49960,445,0,0,70,70,0,1,0,1,0
63052,445,0,0,70,70,0,1,0,1,0
56855,445,0,0,66,66,0,1,0,1,0
64429,445,0,0,70,70,0,1,0,1,0
55235,445,0,0,70,70,0,1,0,1,0
51998,445,0,0,70,70,0,1,0,1,0
51985,445,0,0,70,70,0,1,0,1,0
55012,445,0,0,70,70,0,1,0,1,0
52090,445,0,0,70,70,0,1,0,1,0
55742,445,0,0,70,70,0,1,0,1,0
60621,445,0,0,66,66,0,1,0,1,0
63086,445,0,0,70,70,0,1,0,1,0
52402,445,0,0,70,70,0,1,0,1,0
51623,445,0,0,70,70,0,1,0,1,0
55240,445,0,0,70,70,0,1,0,1,0
51231,445,0,0,70,70,0,1,0,1,0
60118,445,0,0,70,70,0,1,0,1,0
56060,445,0,0,70,70,0,1,0,1,0
60432,445,0,0,70,70,0,1,0,1,0
54867,445,0,0,66,66,0,1,0,1,0
51932,445,0,0,70,70,0,1,0,1,0
59938,445,0,0,70,70,0,1,0,1,0
50306,445,0,0,70,70,0,1,0,1,0
51088,445,0,0,70,70,0,1,0,1,0
49974,445,0,0,66,66,0,1,0,1,0
58292,445,0,0,66,66,0,1,0,1,0
54074,445,0,0,70,70,0,1,0,1,0
52518,445,0,0,70,70,0,1,0,1,0
50026,445,0,0,70,70,0,1,0,1,0
58685,445,0,0,70,70,0,1,0,1,0
65130,445,0,0,66,66,0,1,0,1,0
59020,445,0,0,70,70,0,1,0,1,0
50479,445,0,0,66,66,0,1,0,1,0
54104,445,0,0,70,70,0,1,0,1,0
61935,445,0,0,70,70,0,1,0,1,0
57482,445,0,0,70,70,0,1,0,1,0
60178,445,0,0,66,66,0,1,0,1,0
61431,445,0,0,70,70,0,1,0,1,0
51567,445,0,0,70,70,0,1,0,1,0
49961,445,0,0,70,70,0,1,0,1,0
65038,445,0,0,66,66,0,1,0,1,0
50839,445,0,0,70,70,0,1,0,1,0
65193,445,0,0,66,66,0,1,0,1,0
54749,445,0,0,70,70,0,1,0,1,0
63731,445,0,0,66,66,0,1,0,1,0
53827,445,0,0,70,70,0,1,0,1,0
60853,445,0,0,66,66,0,1,0,1,0
61522,445,0,0,70,70,0,1,0,1,0
62175,445,0,0,70,70,0,1,0,1,0
51885,445,0,0,70,70,0,1,0,1,0
58665,445,0,0,70,70,0,1,0,1,0
58758,445,0,0,66,66,0,1,0,1,0
56129,445,0,0,70,70,0,1,0,1,0
58321,445,0,0,70,70,0,1,0,1,0
50930,445,0,0,66,66,0,1,0,1,0
53629,445,0,0,66,66,0,1,0,1,0
49584,445,0,0,66,66,0,1,0,1,0
51001,445,0,0,70,70,0,1,0,1,0
58043,445,0,0,70,70,0,1,0,1,0
51634,445,0,0,66,66,0,1,0,1,0
56389,445,0,0,70,70,0,1,0,1,0
65342,445,0,0,66,66,0,1,0,1,0
52779,445,0,0,70,70,0,1,0,1,0
52485,445,0,0,70,70,0,1,0,1,0
61343,445,0,0,70,70,0,1,0,1,0
61729,445,0,0,70,70,0,1,0,1,0
64395,445,0,0,70,70,0,1,0,1,0
61933,445,0,0,70,70,0,1,0,1,0
50945,445,0,0,66,66,0,1,0,1,0
56990,445,0,0,70,70,0,1,0,1,0
55174,445,0,0,66,66,0,1,0,1,0
50470,445,0,0,70,70,0,1,0,1,0
61960,445,0,0,70,70,0,1,0,1,0
50266,445,0,0,70,70,0,1,0,1,0
55411,445,0,0,70,70,0,1,0,1,0
63255,445,0,0,66,66,0,1,0,1,0
56580,445,0,0,66,66,0,1,0,1,0
60856,445,0,0,70,70,0,1,0,1,0
56480,445,0,0,70,70,0,1,0,1,0
56478,445,0,0,70,70,0,1,0,1,0
59173,445,0,0,66,66,0,1,0,1,0
51290,445,0,0,70,70,0,1,0,1,0
63905,445,0,0,66,66,0,1,0,1,0
54999,445,0,0,70,70,0,1,0,1,0
62236,445,0,0,70,70,0,1,0,1,0
50353,445,0,0,66,66,0,1,0,1,0
54002,445,0,0,70,70,0,1,0,1,0
55622,445,0,0,70,70,0,1,0,1,0
64200,445,0,0,66,66,0,1,0,1,0
63033,445,0,0,70,70,0,1,0,1,0
53985,445,0,0,70,70,0,1,0,1,0
56893,445,0,0,66,66,0,1,0,1,0
61631,445,0,0,70,70,0,1,0,1,0
64890,445,0,0,66,66,0,1,0,1,0
61072,445,0,0,70,70,0,1,0,1,0
51554,445,0,0,70,70,0,1,0,1,0
60952,445,0,0,66,66,0,1,0,1,0
59327,445,0,0,70,70,0,1,0,1,0
58869,445,0,0,66,66,0,1,0,1,0
49367,445,0,0,66,66,0,1,0,1,0
65227,445,0,0,70,70,0,1,0,1,0
65500,445,0,0,66,66,0,1,0,1,0
63265,445,0,0,70,70,0,1,0,1,0
63625,445,0,0,70,70,0,1,0,1,0
62954,445,0,0,70,70,0,1,0,1,0
51488,445,0,0,70,70,0,1,0,1,0
51221,445,0,0,66,66,0,1,0,1,0
55481,445,0,0,70,70,0,1,0,1,0
49407,445,0,0,70,70,0,1,0,1,0
59514,445,0,0,70,70,0,1,0,1,0
51579,445,0,0,70,70,0,1,0,1,0
62137,445,0,0,70,70,0,1,0,1,0
59802,445,0,0,70,70,0,1,0,1,0
59967,445,0,0,70,70,0,1,0,1,0
64438,445,0,0,70,70,0,1,0,1,0
64550,445,0,0,66,66,0,1,0,1,0
59384,445,0,0,66,66,0,1,0,1,0
58786,445,0,0,66,66,0,1,0,1,0
64948,445,0,0,70,70,0,1,0,1,0
57934,445,0,0,70,70,0,1,0,1,0
64285,445,0,0,70,70,0,1,0,1,0
49298,445,0,0,70,70,0,1,0,1,0
54364,445,0,0,70,70,0,1,0,1,0
56028,445,0,0,70,70,0,1,0,1,0
56445,445,0,0,70,70,0,1,0,1,0
57972,445,0,0,66,66,0,1,0,1,0
58125,445,0,0,70,70,0,1,0,1,0
57647,445,0,0,70,70,0,1,0,1,0
59535,445,0,0,66,66,0,1,0,1,0
65038,445,0,0,70,70,0,1,0,1,0
52907,445,0,0,70,70,0,1,0,1,0
51172,445,0,0,70,70,0,1,0,1,0
61133,445,0,0,66,66,0,1,0,1,0
52482,445,0,0,70,70,0,1,0,1,0
64569,445,0,0,70,70,0,1,0,1,0
50424,445,0,0,66,66,0,1,0,1,0
50779,445,0,0,70,70,0,1,0,1,0
64795,445,0,0,70,70,0,1,0,1,0
50357,445,0,0,66,66,0,1,0,1,0
49335,445,0,0,70,70,0,1,0,1,0
57141,445,0,0,70,70,0,1,0,1,0
64708,445,0,0,70,70,0,1,0,1,0
64589,445,0,0,70,70,0,1,0,1,0
58228,445,0,0,66,66,0,1,0,1,0
55387,445,0,0,70,70,0,1,0,1,0
50982,445,0,0,70,70,0,1,0,1,0
54047,445,0,0,66,66,0,1,0,1,0
53619,445,0,0,70,70,0,1,0,1,0
65269,445,0,0,70,70,0,1,0,1,0
60459,445,0,0,70,70,0,1,0,1,0
58968,445,0,0,70,70,0,1,0,1,0
53139,445,0,0,66,66,0,1,0,1,0
59324,445,0,0,66,66,0,1,0,1,0
60629,445,0,0,66,66,0,1,0,1,0
49761,445,0,0,66,66,0,1,0,1,0
53614,445,0,0,70,70,0,1,0,1,0
56628,445,0,0,70,70,0,1,0,1,0
60509,445,0,0,66,66,0,1,0,1,0
62288,445,0,0,66,66,0,1,0,1,0
62074,445,0,0,70,70,0,1,0,1,0
49554,445,0,0,70,70,0,1,0,1,0
56130,445,0,0,66,66,0,1,0,1,0
52007,445,0,0,70,70,0,1,0,1,0
51063,445,0,0,66,66,0,1,0,1,0
62686,445,0,0,70,70,0,1,0,1,0
55374,445,0,0,66,66,0,1,0,1,0
50603,445,0,0,66,66,0,1,0,1,0
60594,445,0,0,70,70,0,1,0,1,0
52802,445,0,0,70,70,0,1,0,1,0
51589,445,0,0,70,70,0,1,0,1,0
63731,445,0,0,70,70,0,1,0,1,0
53366,445,0,0,66,66,0,1,0,1,0
54184,445,0,0,70,70,0,1,0,1,0
55545,445,0,0,66,66,0,1,0,1,0
54749,445,0,0,70,70,0,1,0,1,0
63785,445,0,0,70,70,0,1,0,1,0
64735,445,0,0,70,70,0,1,0,1,0
56895,445,0,0,66,66,0,1,0,1,0
55173,445,0,0,70,70,0,1,0,1,0
52311,445,0,0,70,70,0,1,0,1,0
50358,445,0,0,66,66,0,1,0,1,0
52470,445,0,0,66,66,0,1,0,1,0
53421,445,0,0,66,66,0,1,0,1,0
58309,445,0,0,66,66,0,1,0,1,0
51068,445,0,0,70,70,0,1,0,1,0
63180,445,0,0,66,66,0,1,0,1,0
63775,445,0,0,70,70,0,1,0,1,0
62739,445,0,0,70,70,0,1,0,1,0
62247,445,0,0,70,70,0,1,0,1,0
51684,445,0,0,70,70,0,1,0,1,0
53431,445,0,0,70,70,0,1,0,1,0
64017,445,0,0,70,70,0,1,0,1,0
62559,445,0,0,70,70,0,1,0,1,0
65316,445,0,0,70,70,0,1,0,1,0
50165,445,0,0,70,70,0,1,0,1,0
56991,445,0,0,70,70,0,1,0,1,0
52217,445,0,0,66,66,0,1,0,1,0
53368,445,0,0,66,66,0,1,0,1,0
64752,445,0,0,70,70,0,1,0,1,0
61622,445,0,0,70,70,0,1,0,1,0
55436,445,0,0,70,70,0,1,0,1,0
64505,445,0,0,66,66,0,1,0,1,0
55384,445,0,0,70,70,0,1,0,1,0
61665,445,0,0,66,66,0,1,0,1,0
54183,445,0,0,70,70,0,1,0,1,0
57369,445,0,0,66,66,0,1,0,1,0
52590,445,0,0,70,70,0,1,0,1,0
50334,445,0,0,70,70,0,1,0,1,0
50427,445,0,0,70,70,0,1,0,1,0
57987,445,0,0,70,70,0,1,0,1,0
52263,445,0,0,66,66,0,1,0,1,0
51555,445,0,0,66,66,0,1,0,1,0
51517,445,0,0,70,70,0,1,0,1,0
50847,445,0,0,70,70,0,1,0,1,0
53883,445,0,0,66,66,0,1,0,1,0
55432,445,0,0,70,70,0,1,0,1,0
56265,445,0,0,66,66,0,1,0,1,0
53303,445,0,0,70,70,0,1,0,1,0
54267,445,0,0,66,66,0,1,0,1,0
53263,445,0,0,70,70,0,1,0,1,0
59013,445,0,0,70,70,0,1,0,1,0
57732,445,0,0,66,66,0,1,0,1,0
56102,445,0,0,66,66,0,1,0,1,0
56143,445,0,0,66,66,0,1,0,1,0
57070,445,0,0,70,70,0,1,0,1,0
62047,445,0,0,66,66,0,1,0,1,0
52117,445,0,0,66,66,0,1,0,1,0
53939,445,0,0,66,66,0,1,0,1,0
52341,445,0,0,66,66,0,1,0,1,0
62812,445,0,0,66,66,0,1,0,1,0
50827,445,0,0,66,66,0,1,0,1,0
51599,445,0,0,70,70,0,1,0,1,0
53568,445,0,0,66,66,0,1,0,1,0
65081,445,0,0,70,70,0,1,0,1,0
63362,445,0,0,70,70,0,1,0,1,0
60689,445,0,0,70,70,0,1,0,1,0
53036,445,0,0,70,70,0,1,0,1,0
52909,445,0,0,66,66,0,1,0,1,0
56579,445,0,0,66,66,0,1,0,1,0
56767,445,0,0,66,66,0,1,0,1,0
55567,445,0,0,70,70,0,1,0,1,0
64045,445,0,0,70,70,0,1,0,1,0
61059,445,0,0,70,70,0,1,0,1,0
50080,445,0,0,66,66,0,1,0,1,0
58382,445,0,0,70,70,0,1,0,1,0
58708,445,0,0,66,66,0,1,0,1,0
59257,445,0,0,70,70,0,1,0,1,0
61833,445,0,0,66,66,0,1,0,1,0
59103,445,0,0,70,70,0,1,0,1,0
54889,445,0,0,70,70,0,1,0,1,0
52416,445,0,0,70,70,0,1,0,1,0
55453,445,0,0,70,70,0,1,0,1,0
53423,445,0,0,70,70,0,1,0,1,0
50652,445,0,0,70,70,0,1,0,1,0
59141,445,0,0,66,66,0,1,0,1,0
64547,445,0,0,66,66,0,1,0,1,0
60018,445,0,0,70,70,0,1,0,1,0
50397,445,0,0,66,66,0,1,0,1,0
62902,445,0,0,66,66,0,1,0,1,0
53104,445,0,0,70,70,0,1,0,1,0
59861,445,0,0,66,66,0,1,0,1,0
49198,445,0,0,66,66,0,1,0,1,0
60786,445,0,0,70,70,0,1,0,1,0
55389,445,0,0,70,70,0,1,0,1,0
50734,445,0,0,66,66,0,1,0,1,0
63197,445,0,0,70,70,0,1,0,1,0
62779,445,0,0,70,70,0,1,0,1,0
62508,445,0,0,70,70,0,1,0,1,0
65324,445,0,0,66,66,0,1,0,1,0
54475,445,0,0,66,66,0,1,0,1,0
63872,445,0,0,70,70,0,1,0,1,0
64846,445,0,0,70,70,0,1,0,1,0
50432,445,0,0,70,70,0,1,0,1,0
50483,445,0,0,66,66,0,1,0,1,0
55833,445,0,0,70,70,0,1,0,1,0
61548,445,0,0,70,70,0,1,0,1,0
56600,445,0,0,66,66,0,1,0,1,0
55108,445,0,0,70,70,0,1,0,1,0
58041,445,0,0,70,70,0,1,0,1,0
58425,445,0,0,70,70,0,1,0,1,0
60095,445,0,0,66,66,0,1,0,1,0
52854,445,0,0,66,66,0,1,0,1,0
59285,445,0,0,70,70,0,1,0,1,0
56061,445,0,0,66,66,0,1,0,1,0
49577,445,0,0,70,70,0,1,0,1,0
63573,445,0,0,66,66,0,1,0,1,0
52522,445,0,0,66,66,0,1,0,1,0
50965,445,0,0,66,66,0,1,0,1,0
56763,445,0,0,70,70,0,1,0,1,0
51836,445,0,0,70,70,0,1,0,1,0
60657,445,0,0,70,70,0,1,0,1,0
65077,445,0,0,70,70,0,1,0,1,0
57246,445,0,0,70,70,0,1,0,1,0
55261,445,0,0,70,70,0,1,0,1,0
50492,445,0,0,70,70,0,1,0,1,0
64819,445,0,0,70,70,0,1,0,1,0
59840,445,0,0,66,66,0,1,0,1,0
64746,445,0,0,70,70,0,1,0,1,0
59200,445,0,0,70,70,0,1,0,1,0
59651,445,0,0,70,70,0,1,0,1,0
64351,445,0,0,70,70,0,1,0,1,0
55146,445,0,0,66,66,0,1,0,1,0
64389,445,0,0,70,70,0,1,0,1,0
57012,445,0,0,66,66,0,1,0,1,0
53078,445,0,0,70,70,0,1,0,1,0
53408,445,0,0,70,70,0,1,0,1,0
55327,445,0,0,66,66,0,1,0,1,0
51334,445,0,0,70,70,0,1,0,1,0
55037,445,0,0,70,70,0,1,0,1,0
64420,445,0,0,70,70,0,1,0,1,0
55049,445,0,0,70,70,0,1,0,1,0
53559,445,0,0,70,70,0,1,0,1,0
61664,445,0,0,70,70,0,1,0,1,0
65138,445,0,0,66,66,0,1,0,1,0
56331,445,0,0,70,70,0,1,0,1,0
58574,445,0,0,70,70,0,1,0,1,0
58692,445,0,0,66,66,0,1,0,1,0
62373,445,0,0,70,70,0,1,0,1,0
65441,445,0,0,70,70,0,1,0,1,0
55955,445,0,0,70,70,0,1,0,1,0
58578,445,0,0,70,70,0,1,0,1,0
62420,445,0,0,70,70,0,1,0,1,0
52709,445,0,0,66,66,0,1,0,1,0
65196,445,0,0,70,70,0,1,0,1,0
58997,445,0,0,70,70,0,1,0,1,0
62405,445,0,0,70,70,0,1,0,1,0
57101,445,0,0,70,70,0,1,0,1,0
61755,445,0,0,70,70,0,1,0,1,0
62787,445,0,0,70,70,0,1,0,1,0
61478,445,0,0,70,70,0,1,0,1,0
61408,445,0,0,66,66,0,1,0,1,0
57232,445,0,0,70,70,0,1,0,1,0
61782,445,0,0,66,66,0,1,0,1,0
51766,445,0,0,70,70,0,1,0,1,0
57157,445,0,0,70,70,0,1,0,1,0
49631,445,0,0,70,70,0,1,0,1,0
56537,445,0,0,70,70,0,1,0,1,0
58851,445,0,0,70,70,0,1,0,1,0
50761,445,0,0,70,70,0,1,0,1,0
54849,445,0,0,66,66,0,1,0,1,0
55656,445,0,0,70,70,0,1,0,1,0
53165,445,0,0,70,70,0,1,0,1,0
58944,445,0,0,66,66,0,1,0,1,0
63556,445,0,0,70,70,0,1,0,1,0
58389,445,0,0,70,70,0,1,0,1,0
50478,445,0,0,70,70,0,1,0,1,0
64682,445,0,0,66,66,0,1,0,1,0
50500,445,0,0,70,70,0,1,0,1,0
51749,445,0,0,70,70,0,1,0,1,0
54676,445,0,0,66,66,0,1,0,1,0
60153,445,0,0,70,70,0,1,0,1,0
55814,445,0,0,70,70,0,1,0,1,0
55466,445,0,0,66,66,0,1,0,1,0
61349,445,0,0,66,66,0,1,0,1,0
53910,445,0,0,70,70,0,1,0,1,0
60738,445,0,0,70,70,0,1,0,1,0
52465,445,0,0,70,70,0,1,0,1,0
57403,445,0,0,66,66,0,1,0,1,0
64860,445,0,0,70,70,0,1,0,1,0
57931,445,0,0,70,70,0,1,0,1,0
50749,445,0,0,66,66,0,1,0,1,0
58530,445,0,0,70,70,0,1,0,1,0
64646,445,0,0,70,70,0,1,0,1,0
63672,445,0,0,66,66,0,1,0,1,0
50524,445,0,0,66,66,0,1,0,1,0
56962,445,0,0,70,70,0,1,0,1,0
59685,445,0,0,70,70,0,1,0,1,0
61121,445,0,0,70,70,0,1,0,1,0
49646,445,0,0,70,70,0,1,0,1,0
64950,445,0,0,70,70,0,1,0,1,0
51911,445,0,0,66,66,0,1,0,1,0
59964,445,0,0,70,70,0,1,0,1,0
49904,445,0,0,70,70,0,1,0,1,0
50665,445,0,0,66,66,0,1,0,1,0
52291,445,0,0,70,70,0,1,0,1,0
52012,445,0,0,70,70,0,1,0,1,0
56453,445,0,0,66,66,0,1,0,1,0
61280,445,0,0,66,66,0,1,0,1,0
63748,445,0,0,70,70,0,1,0,1,0
64216,445,0,0,66,66,0,1,0,1,0
65306,445,0,0,66,66,0,1,0,1,0
50441,445,0,0,66,66,0,1,0,1,0
59761,445,0,0,66,66,0,1,0,1,0
59935,445,0,0,66,66,0,1,0,1,0
54067,445,0,0,66,66,0,1,0,1,0
53930,445,0,0,70,70,0,1,0,1,0
63170,445,0,0,70,70,0,1,0,1,0
61060,445,0,0,70,70,0,1,0,1,0
63192,445,0,0,70,70,0,1,0,1,0
65079,445,0,0,70,70,0,1,0,1,0
62136,445,0,0,70,70,0,1,0,1,0
53776,445,0,0,70,70,0,1,0,1,0
51236,445,0,0,70,70,0,1,0,1,0
50973,445,0,0,66,66,0,1,0,1,0
64001,445,0,0,70,70,0,1,0,1,0
51181,445,0,0,66,66,0,1,0,1,0
52921,445,0,0,70,70,0,1,0,1,0
54139,445,0,0,66,66,0,1,0,1,0
63125,445,0,0,66,66,0,1,0,1,0
50118,445,0,0,70,70,0,1,0,1,0
53436,445,0,0,70,70,0,1,0,1,0
51149,445,0,0,70,70,0,1,0,1,0
50882,445,0,0,66,66,0,1,0,1,0
49825,445,0,0,70,70,0,1,0,1,0
58399,445,0,0,66,66,0,1,0,1,0
53214,445,0,0,70,70,0,1,0,1,0
63001,445,0,0,70,70,0,1,0,1,0
64633,445,0,0,66,66,0,1,0,1,0
62263,445,0,0,70,70,0,1,0,1,0
56873,445,0,0,70,70,0,1,0,1,0
62371,445,0,0,70,70,0,1,0,1,0
61753,445,0,0,70,70,0,1,0,1,0
55081,445,0,0,70,70,0,1,0,1,0
55160,445,0,0,70,70,0,1,0,1,0
63203,445,0,0,70,70,0,1,0,1,0
59027,445,0,0,66,66,0,1,0,1,0
64822,445,0,0,70,70,0,1,0,1,0
58409,445,0,0,66,66,0,1,0,1,0
56669,445,0,0,70,70,0,1,0,1,0
53676,445,0,0,70,70,0,1,0,1,0
58553,445,0,0,70,70,0,1,0,1,0
59967,445,0,0,66,66,0,1,0,1,0
59909,445,0,0,70,70,0,1,0,1,0
64991,445,0,0,66,66,0,1,0,1,0
59441,445,0,0,70,70,0,1,0,1,0
53364,445,0,0,70,70,0,1,0,1,0
64167,445,0,0,66,66,0,1,0,1,0
51965,445,0,0,70,70,0,1,0,1,0
63941,445,0,0,70,70,0,1,0,1,0
57376,445,0,0,66,66,0,1,0,1,0
51158,445,0,0,70,70,0,1,0,1,0
60404,445,0,0,70,70,0,1,0,1,0
54012,445,0,0,66,66,0,1,0,1,0
53755,445,0,0,66,66,0,1,0,1,0
57671,445,0,0,70,70,0,1,0,1,0
56282,445,0,0,70,70,0,1,0,1,0
51216,445,0,0,70,70,0,1,0,1,0
51673,445,0,0,70,70,0,1,0,1,0
65120,445,0,0,66,66,0,1,0,1,0
50545,445,0,0,66,66,0,1,0,1,0
55095,445,0,0,70,70,0,1,0,1,0
49761,445,0,0,70,70,0,1,0,1,0
59295,445,0,0,70,70,0,1,0,1,0
50253,445,0,0,70,70,0,1,0,1,0
58169,445,0,0,70,70,0,1,0,1,0
50082,445,0,0,66,66,0,1,0,1,0
62064,445,0,0,70,70,0,1,0,1,0
55564,445,0,0,70,70,0,1,0,1,0
57278,445,0,0,70,70,0,1,0,1,0
60257,445,0,0,66,66,0,1,0,1,0
50817,445,0,0,70,70,0,1,0,1,0
59335,445,0,0,66,66,0,1,0,1,0
57889,445,0,0,70,70,0,1,0,1,0
53687,445,0,0,66,66,0,1,0,1,0
57800,445,0,0,66,66,0,1,0,1,0
54627,445,0,0,70,70,0,1,0,1,0
61465,445,0,0,70,70,0,1,0,1,0
54774,445,0,0,70,70,0,1,0,1,0
55927,445,0,0,70,70,0,1,0,1,0
50667,445,0,0,66,66,0,1,0,1,0
50372,445,0,0,66,66,0,1,0,1,0
59734,445,0,0,70,70,0,1,0,1,0
62048,445,0,0,70,70,0,1,0,1,0
60537,445,0,0,66,66,0,1,0,1,0
63717,445,0,0,70,70,0,1,0,1,0
52976,445,0,0,70,70,0,1,0,1,0
60165,445,0,0,70,70,0,1,0,1,0
64739,445,0,0,70,70,0,1,0,1,0
63194,445,0,0,70,70,0,1,0,1,0
58949,445,0,0,70,70,0,1,0,1,0
57828,445,0,0,70,70,0,1,0,1,0
64084,445,0,0,70,70,0,1,0,1,0
49980,445,0,0,70,70,0,1,0,1,0
60496,445,0,0,70,70,0,1,0,1,0
52441,445,0,0,70,70,0,1,0,1,0
65001,445,0,0,70,70,0,1,0,1,0
55320,445,0,0,70,70,0,1,0,1,0
62013,445,0,0,66,66,0,1,0,1,0
63316,445,0,0,70,70,0,1,0,1,0
50672,445,0,0,66,66,0,1,0,1,0
63724,445,0,0,66,66,0,1,0,1,0
56887,445,0,0,66,66,0,1,0,1,0
61006,445,0,0,66,66,0,1,0,1,0
57586,445,0,0,66,66,0,1,0,1,0
58495,445,0,0,70,70,0,1,0,1,0
53340,445,0,0,70,70,0,1,0,1,0
52266,445,0,0,70,70,0,1,0,1,0
56126,445,0,0,66,66,0,1,0,1,0
62586,445,0,0,66,66,0,1,0,1,0
50931,445,0,0,70,70,0,1,0,1,0
51380,445,0,0,66,66,0,1,0,1,0
50720,445,0,0,66,66,0,1,0,1,0
64804,445,0,0,66,66,0,1,0,1,0
55131,445,0,0,70,70,0,1,0,1,0
56454,445,0,0,66,66,0,1,0,1,0
59403,445,0,0,70,70,0,1,0,1,0
53931,445,0,0,70,70,0,1,0,1,0
57652,445,0,0,66,66,0,1,0,1,0
60183,445,0,0,70,70,0,1,0,1,0
64339,445,0,0,70,70,0,1,0,1,0
56764,445,0,0,66,66,0,1,0,1,0
55877,445,0,0,66,66,0,1,0,1,0
59848,445,0,0,70,70,0,1,0,1,0
49331,445,0,0,66,66,0,1,0,1,0
58430,445,0,0,70,70,0,1,0,1,0
64867,445,0,0,70,70,0,1,0,1,0
61230,445,0,0,70,70,0,1,0,1,0
51540,445,0,0,70,70,0,1,0,1,0
64821,445,0,0,70,70,0,1,0,1,0
62234,445,0,0,70,70,0,1,0,1,0
55221,445,0,0,70,70,0,1,0,1,0
63582,445,0,0,70,70,0,1,0,1,0
54740,445,0,0,70,70,0,1,0,1,0
64494,445,0,0,66,66,0,1,0,1,0
59841,445,0,0,66,66,0,1,0,1,0
50736,445,0,0,66,66,0,1,0,1,0
50297,445,0,0,66,66,0,1,0,1,0
60816,445,0,0,70,70,0,1,0,1,0
49966,445,0,0,70,70,0,1,0,1,0
56495,445,0,0,70,70,0,1,0,1,0
53806,445,0,0,66,66,0,1,0,1,0
65452,445,0,0,66,66,0,1,0,1,0
63728,445,0,0,70,70,0,1,0,1,0
57399,445,0,0,66,66,0,1,0,1,0
62765,445,0,0,66,66,0,1,0,1,0
51471,445,0,0,70,70,0,1,0,1,0
58418,445,0,0,70,70,0,1,0,1,0
64993,445,0,0,66,66,0,1,0,1,0
63347,445,0,0,70,70,0,1,0,1,0
64672,445,0,0,70,70,0,1,0,1,0
58053,445,0,0,66,66,0,1,0,1,0
57926,445,0,0,66,66,0,1,0,1,0
55458,445,0,0,70,70,0,1,0,1,0
57918,445,0,0,70,70,0,1,0,1,0
52996,445,0,0,70,70,0,1,0,1,0
51451,445,0,0,70,70,0,1,0,1,0
57816,445,0,0,70,70,0,1,0,1,0
52548,445,0,0,70,70,0,1,0,1,0
63370,445,0,0,66,66,0,1,0,1,0
51344,445,0,0,70,70,0,1,0,1,0
63228,445,0,0,70,70,0,1,0,1,0
59642,445,0,0,66,66,0,1,0,1,0
57859,445,0,0,66,66,0,1,0,1,0
50913,445,0,0,66,66,0,1,0,1,0
52054,445,0,0,70,70,0,1,0,1,0
53692,445,0,0,70,70,0,1,0,1,0
54188,445,0,0,66,66,0,1,0,1,0
59468,445,0,0,70,70,0,1,0,1,0
61850,445,0,0,70,70,0,1,0,1,0
61405,445,0,0,66,66,0,1,0,1,0
55291,445,0,0,66,66,0,1,0,1,0
50075,445,0,0,70,70,0,1,0,1,0
50712,445,0,0,70,70,0,1,0,1,0
62530,445,0,0,70,70,0,1,0,1,0
50906,445,0,0,70,70,0,1,0,1,0
56633,445,0,0,66,66,0,1,0,1,0
51309,445,0,0,66,66,0,1,0,1,0
50984,445,0,0,70,70,0,1,0,1,0
65280,445,0,0,66,66,0,1,0,1,0
53963,445,0,0,66,66,0,1,0,1,0
55686,445,0,0,70,70,0,1,0,1,0
52629,445,0,0,70,70,0,1,0,1,0
62832,445,0,0,70,70,0,1,0,1,0
61810,445,0,0,70,70,0,1,0,1,0
51651,445,0,0,66,66,0,1,0,1,0
55784,445,0,0,70,70,0,1,0,1,0
63066,445,0,0,66,66,0,1,0,1,0
63595,445,0,0,70,70,0,1,0,1,0
61702,445,0,0,66,66,0,1,0,1,0
52779,445,0,0,70,70,0,1,0,1,0
56335,445,0,0,70,70,0,1,0,1,0
56259,445,0,0,70,70,0,1,0,1,0
64031,445,0,0,70,70,0,1,0,1,0
62956,445,0,0,70,70,0,1,0,1,0
49377,445,0,0,70,70,0,1,0,1,0
56627,445,0,0,70,70,0,1,0,1,0
63957,445,0,0,70,70,0,1,0,1,0
59442,445,0,0,70,70,0,1,0,1,0
64123,445,0,0,70,70,0,1,0,1,0
63446,445,0,0,70,70,0,1,0,1,0
51528,445,0,0,66,66,0,1,0,1,0
62888,445,0,0,70,70,0,1,0,1,0
56938,445,0,0,70,70,0,1,0,1,0
58936,445,0,0,66,66,0,1,0,1,0
60982,445,0,0,66,66,0,1,0,1,0
52347,445,0,0,66,66,0,1,0,1,0
59401,445,0,0,70,70,0,1,0,1,0
63020,445,0,0,70,70,0,1,0,1,0
62105,445,0,0,66,66,0,1,0,1,0
60036,445,0,0,70,70,0,1,0,1,0
63352,445,0,0,70,70,0,1,0,1,0
54516,445,0,0,70,70,0,1,0,1,0
56662,445,0,0,66,66,0,1,0,1,0
53623,445,0,0,66,66,0,1,0,1,0
54986,445,0,0,66,66,0,1,0,1,0
50544,445,0,0,70,70,0,1,0,1,0
58728,445,0,0,66,66,0,1,0,1,0
56119,445,0,0,70,70,0,1,0,1,0
53171,445,0,0,66,66,0,1,0,1,0
57276,445,0,0,70,70,0,1,0,1,0
55199,445,0,0,70,70,0,1,0,1,0
49591,445,0,0,70,70,0,1,0,1,0
58843,445,0,0,66,66,0,1,0,1,0
61009,445,0,0,66,66,0,1,0,1,0
49423,445,0,0,70,70,0,1,0,1,0
59629,445,0,0,70,70,0,1,0,1,0
59725,445,0,0,66,66,0,1,0,1,0
49784,445,0,0,70,70,0,1,0,1,0
58413,445,0,0,70,70,0,1,0,1,0
65157,445,0,0,70,70,0,1,0,1,0
50975,445,0,0,66,66,0,1,0,1,0
60599,445,0,0,70,70,0,1,0,1,0
53388,445,0,0,66,66,0,1,0,1,0
64719,445,0,0,70,70,0,1,0,1,0
60869,445,0,0,70,70,0,1,0,1,0
57426,445,0,0,70,70,0,1,0,1,0
60885,445,0,0,66,66,0,1,0,1,0
49832,445,0,0,70,70,0,1,0,1,0
58565,445,0,0,70,70,0,1,0,1,0
63308,445,0,0,66,66,0,1,0,1,0
59956,445,0,0,70,70,0,1,0,1,0
59016,445,0,0,66,66,0,1,0,1,0
53352,445,0,0,66,66,0,1,0,1,0
55915,445,0,0,70,70,0,1,0,1,0
55339,445,0,0,70,70,0,1,0,1,0
55272,445,0,0,66,66,0,1,0,1,0
55373,445,0,0,70,70,0,1,0,1,0
56661,445,0,0,70,70,0,1,0,1,0
63497,445,0,0,66,66,0,1,0,1,0
52822,445,0,0,70,70,0,1,0,1,0
55083,445,0,0,70,70,0,1,0,1,0
60058,445,0,0,70,70,0,1,0,1,0
56805,445,0,0,70,70,0,1,0,1,0
50207,445,0,0,70,70,0,1,0,1,0
58575,445,0,0,70,70,0,1,0,1,0
56568,445,0,0,70,70,0,1,0,1,0
61666,445,0,0,66,66,0,1,0,1,0
60572,445,0,0,70,70,0,1,0,1,0
64230,445,0,0,70,70,0,1,0,1,0
61068,445,0,0,70,70,0,1,0,1,0
59450,445,0,0,66,66,0,1,0,1,0
65030,445,0,0,70,70,0,1,0,1,0
62379,445,0,0,70,70,0,1,0,1,0
53611,445,0,0,70,70,0,1,0,1,0
60044,445,0,0,66,66,0,1,0,1,0
58296,445,0,0,66,66,0,1,0,1,0
55420,445,0,0,66,66,0,1,0,1,0
62746,445,0,0,66,66,0,1,0,1,0
54005,445,0,0,70,70,0,1,0,1,0
60714,445,0,0,66,66,0,1,0,1,0
60096,445,0,0,70,70,0,1,0,1,0
52903,445,0,0,66,66,0,1,0,1,0
57996,445,0,0,70,70,0,1,0,1,0
57668,445,0,0,66,66,0,1,0,1,0
57034,445,0,0,70,70,0,1,0,1,0
64601,445,0,0,66,66,0,1,0,1,0
59099,445,0,0,70,70,0,1,0,1,0
59403,445,0,0,66,66,0,1,0,1,0
52859,445,0,0,70,70,0,1,0,1,0
51502,445,0,0,66,66,0,1,0,1,0
62283,445,0,0,66,66,0,1,0,1,0
61781,445,0,0,70,70,0,1,0,1,0
58886,445,0,0,66,66,0,1,0,1,0
56666,445,0,0,70,70,0,1,0,1,0
50306,445,0,0,66,66,0,1,0,1,0
55377,445,0,0,70,70,0,1,0,1,0
61644,445,0,0,66,66,0,1,0,1,0
50399,445,0,0,70,70,0,1,0,1,0
56129,445,0,0,70,70,0,1,0,1,0
54832,445,0,0,66,66,0,1,0,1,0
63517,445,0,0,66,66,0,1,0,1,0
51968,445,0,0,70,70,0,1,0,1,0
59649,445,0,0,70,70,0,1,0,1,0
59373,445,0,0,70,70,0,1,0,1,0
50465,445,0,0,70,70,0,1,0,1,0
54306,445,0,0,70,70,0,1,0,1,0
56000,445,0,0,70,70,0,1,0,1,0
50735,445,0,0,70,70,0,1,0,1,0
59148,445,0,0,70,70,0,1,0,1,0
58424,445,0,0,66,66,0,1,0,1,0
59523,445,0,0,70,70,0,1,0,1,0
63385,445,0,0,70,70,0,1,0,1,0
58933,445,0,0,70,70,0,1,0,1,0
51058,445,0,0,70,70,0,1,0,1,0
57999,445,0,0,70,70,0,1,0,1,0
50661,445,0,0,70,70,0,1,0,1,0
58901,445,0,0,70,70,0,1,0,1,0
54826,445,0,0,66,66,0,1,0,1,0
59124,445,0,0,70,70,0,1,0,1,0
55498,445,0,0,66,66,0,1,0,1,0
49384,445,0,0,66,66,0,1,0,1,0
54772,445,0,0,70,70,0,1,0,1,0
50313,445,0,0,66,66,0,1,0,1,0
54505,445,0,0,66,66,0,1,0,1,0
53333,445,0,0,70,70,0,1,0,1,0
61316,445,0,0,70,70,0,1,0,1,0
50251,445,0,0,70,70,0,1,0,1,0
64056,445,0,0,70,70,0,1,0,1,0
58020,445,0,0,70,70,0,1,0,1,0
62361,445,0,0,70,70,0,1,0,1,0
54990,445,0,0,70,70,0,1,0,1,0
57005,445,0,0,70,70,0,1,0,1,0
50674,445,0,0,70,70,0,1,0,1,0
56879,445,0,0,70,70,0,1,0,1,0
54295,445,0,0,70,70,0,1,0,1,0
55520,445,0,0,70,70,0,1,0,1,0
63646,445,0,0,66,66,0,1,0,1,0
61447,445,0,0,70,70,0,1,0,1,0
51126,445,0,0,70,70,0,1,0,1,0
60342,445,0,0,70,70,0,1,0,1,0
50555,445,0,0,70,70,0,1,0,1,0
55934,445,0,0,66,66,0,1,0,1,0
63004,445,0,0,66,66,0,1,0,1,0
55483,445,0,0,70,70,0,1,0,1,0
53142,445,0,0,70,70,0,1,0,1,0
50544,445,0,0,66,66,0,1,0,1,0
61875,445,0,0,70,70,0,1,0,1,0
59089,445,0,0,70,70,0,1,0,1,0
52498,445,0,0,70,70,0,1,0,1,0
50633,445,0,0,70,70,0,1,0,1,0
65024,445,0,0,70,70,0,1,0,1,0
63813,445,0,0,70,70,0,1,0,1,0
61158,445,0,0,70,70,0,1,0,1,0
51981,445,0,0,70,70,0,1,0,1,0
50131,445,0,0,70,70,0,1,0,1,0
50991,445,0,0,70,70,0,1,0,1,0
61332,445,0,0,70,70,0,1,0,1,0
55504,445,0,0,70,70,0,1,0,1,0
65335,445,0,0,70,70,0,1,0,1,0
56272,445,0,0,70,70,0,1,0,1,0
57375,445,0,0,70,70,0,1,0,1,0
58952,445,0,0,66,66,0,1,0,1,0
54700,445,0,0,66,66,0,1,0,1,0
54483,445,0,0,70,70,0,1,0,1,0
52862,445,0,0,70,70,0,1,0,1,0
64952,445,0,0,70,70,0,1,0,1,0
63310,445,0,0,66,66,0,1,0,1,0
61750,445,0,0,66,66,0,1,0,1,0
52905,445,0,0,66,66,0,1,0,1,0
60874,445,0,0,66,66,0,1,0,1,0
63811,445,0,0,70,70,0,1,0,1,0
58485,445,0,0,66,66,0,1,0,1,0
58030,445,0,0,70,70,0,1,0,1,0
64806,445,0,0,66,66,0,1,0,1,0
50094,445,0,0,66,66,0,1,0,1,0
58861,445,0,0,70,70,0,1,0,1,0
57419,445,0,0,66,66,0,1,0,1,0
64804,445,0,0,70,70,0,1,0,1,0
64288,445,0,0,70,70,0,1,0,1,0
59068,445,0,0,66,66,0,1,0,1,0
57657,445,0,0,66,66,0,1,0,1,0
57197,445,0,0,70,70,0,1,0,1,0
61257,445,0,0,70,70,0,1,0,1,0
51751,445,0,0,70,70,0,1,0,1,0
56939,445,0,0,70,70,0,1,0,1,0
49779,445,0,0,70,70,0,1,0,1,0
58594,445,0,0,70,70,0,1,0,1,0
56200,445,0,0,70,70,0,1,0,1,0
61630,445,0,0,70,70,0,1,0,1,0
55289,445,0,0,66,66,0,1,0,1,0
50666,445,0,0,66,66,0,1,0,1,0
51047,445,0,0,66,66,0,1,0,1,0
50415,445,0,0,70,70,0,1,0,1,0
57439,445,0,0,66,66,0,1,0,1,0
52401,445,0,0,70,70,0,1,0,1,0
52240,445,0,0,70,70,0,1,0,1,0
60911,445,0,0,70,70,0,1,0,1,0
50796,445,0,0,66,66,0,1,0,1,0
62243,445,0,0,70,70,0,1,0,1,0
56017,445,0,0,66,66,0,1,0,1,0
58654,445,0,0,70,70,0,1,0,1,0
49259,445,0,0,70,70,0,1,0,1,0
58036,445,0,0,66,66,0,1,0,1,0
57933,445,0,0,66,66,0,1,0,1,0
50735,445,0,0,70,70,0,1,0,1,0
53076,445,0,0,70,70,0,1,0,1,0
53090,445,0,0,70,70,0,1,0,1,0
56090,445,0,0,70,70,0,1,0,1,0
62453,445,0,0,70,70,0,1,0,1,0
51792,445,0,0,70,70,0,1,0,1,0
52984,445,0,0,66,66,0,1,0,1,0
56045,445,0,0,70,70,0,1,0,1,0
58980,445,0,0,70,70,0,1,0,1,0
61931,445,0,0,66,66,0,1,0,1,0
65406,445,0,0,70,70,0,1,0,1,0
56606,445,0,0,70,70,0,1,0,1,0
51105,445,0,0,66,66,0,1,0,1,0
58377,445,0,0,70,70,0,1,0,1,0
62885,445,0,0,70,70,0,1,0,1,0
51984,445,0,0,70,70,0,1,0,1,0
53876,445,0,0,70,70,0,1,0,1,0
50159,445,0,0,70,70,0,1,0,1,0
50596,445,0,0,66,66,0,1,0,1,0
50613,445,0,0,66,66,0,1,0,1,0
64493,445,0,0,66,66,0,1,0,1,0
52957,445,0,0,70,70,0,1,0,1,0
51754,445,0,0,70,70,0,1,0,1,0
56218,445,0,0,70,70,0,1,0,1,0
57653,445,0,0,70,70,0,1,0,1,0
51705,445,0,0,66,66,0,1,0,1,0
61041,445,0,0,70,70,0,1,0,1,0
56234,445,0,0,70,70,0,1,0,1,0
58161,445,0,0,70,70,0,1,0,1,0
50040,445,0,0,66,66,0,1,0,1,0
61115,445,0,0,70,70,0,1,0,1,0
53666,445,0,0,70,70,0,1,0,1,0
56367,445,0,0,70,70,0,1,0,1,0
51340,445,0,0,70,70,0,1,0,1,0
57117,445,0,0,70,70,0,1,0,1,0
54759,445,0,0,66,66,0,1,0,1,0
54089,445,0,0,66,66,0,1,0,1,0
52053,445,0,0,70,70,0,1,0,1,0
57331,445,0,0,66,66,0,1,0,1,0
63527,445,0,0,66,66,0,1,0,1,0
50875,445,0,0,66,66,0,1,0,1,0
62845,445,0,0,66,66,0,1,0,1,0
52739,445,0,0,70,70,0,1,0,1,0
50953,445,0,0,66,66,0,1,0,1,0
58568,445,0,0,70,70,0,1,0,1,0
65388,445,0,0,66,66,0,1,0,1,0
52398,445,0,0,70,70,0,1,0,1,0
51617,445,0,0,70,70,0,1,0,1,0
64789,445,0,0,66,66,0,1,0,1,0
62579,445,0,0,70,70,0,1,0,1,0
59244,445,0,0,70,70,0,1,0,1,0
63812,445,0,0,70,70,0,1,0,1,0
53937,445,0,0,66,66,0,1,0,1,0
55902,445,0,0,70,70,0,1,0,1,0
50571,445,0,0,66,66,0,1,0,1,0
59257,445,0,0,66,66,0,1,0,1,0
51884,445,0,0,66,66,0,1,0,1,0
53123,445,0,0,70,70,0,1,0,1,0
51411,445,0,0,70,70,0,1,0,1,0
63015,445,0,0,70,70,0,1,0,1,0
57607,445,0,0,66,66,0,1,0,1,0
56754,445,0,0,70,70,0,1,0,1,0
55636,445,0,0,66,66,0,1,0,1,0
60347,445,0,0,70,70,0,1,0,1,0
53117,445,0,0,70,70,0,1,0,1,0
58442,445,0,0,66,66,0,1,0,1,0
64419,445,0,0,66,66,0,1,0,1,0
51164,445,0,0,70,70,0,1,0,1,0
56706,445,0,0,66,66,0,1,0,1,0
50033,445,0,0,70,70,0,1,0,1,0
59663,445,0,0,66,66,0,1,0,1,0
56175,445,0,0,66,66,0,1,0,1,0
64499,445,0,0,70,70,0,1,0,1,0
56595,445,0,0,70,70,0,1,0,1,0
53756,445,0,0,66,66,0,1,0,1,0
57985,445,0,0,70,70,0,1,0,1,0
53836,445,0,0,70,70,0,1,0,1,0
56442,445,0,0,70,70,0,1,0,1,0
64771,445,0,0,70,70,0,1,0,1,0
57504,445,0,0,70,70,0,1,0,1,0
49594,445,0,0,70,70,0,1,0,1,0
64713,445,0,0,70,70,0,1,0,1,0
56940,445,0,0,70,70,0,1,0,1,0
55723,445,0,0,70,70,0,1,0,1,0
55888,445,0,0,70,70,0,1,0,1,0
51401,445,0,0,70,70,0,1,0,1,0
63947,445,0,0,70,70,0,1,0,1,0
62941,445,0,0,70,70,0,1,0,1,0
54306,445,0,0,70,70,0,1,0,1,0
65014,445,0,0,66,66,0,1,0,1,0
56099,445,0,0,70,70,0,1,0,1,0
49804,445,0,0,70,70,0,1,0,1,0
60302,445,0,0,66,66,0,1,0,1,0
62471,445,0,0,66,66,0,1,0,1,0
51858,445,0,0,70,70,0,1,0,1,0
51070,445,0,0,70,70,0,1,0,1,0
61977,445,0,0,66,66,0,1,0,1,0
53192,445,0,0,70,70,0,1,0,1,0
57217,445,0,0,66,66,0,1,0,1,0
58813,445,0,0,70,70,0,1,0,1,0
58270,445,0,0,70,70,0,1,0,1,0
57404,445,0,0,70,70,0,1,0,1,0
62487,445,0,0,66,66,0,1,0,1,0
58056,445,0,0,66,66,0,1,0,1,0
55165,445,0,0,66,66,0,1,0,1,0
60728,445,0,0,70,70,0,1,0,1,0
55717,445,0,0,70,70,0,1,0,1,0
64544,445,0,0,70,70,0,1,0,1,0
60077,445,0,0,66,66,0,1,0,1,0
53910,445,0,0,66,66,0,1,0,1,0
62577,445,0,0,70,70,0,1,0,1,0
65207,445,0,0,66,66,0,1,0,1,0
54424,445,0,0,70,70,0,1,0,1,0
65407,445,0,0,66,66,0,1,0,1,0
58549,445,0,0,66,66,0,1,0,1,0
50339,445,0,0,70,70,0,1,0,1,0
54794,445,0,0,70,70,0,1,0,1,0
59382,445,0,0,70,70,0,1,0,1,0
50164,445,0,0,70,70,0,1,0,1,0
59828,445,0,0,70,70,0,1,0,1,0
61532,445,0,0,66,66,0,1,0,1,0
64770,445,0,0,70,70,0,1,0,1,0
52020,445,0,0,66,66,0,1,0,1,0
57988,445,0,0,66,66,0,1,0,1,0
50950,445,0,0,66,66,0,1,0,1,0
57821,445,0,0,66,66,0,1,0,1,0
62156,445,0,0,66,66,0,1,0,1,0
62489,445,0,0,70,70,0,1,0,1,0
53336,445,0,0,70,70,0,1,0,1,0
52282,445,0,0,66,66,0,1,0,1,0
64543,445,0,0,70,70,0,1,0,1,0
56412,445,0,0,70,70,0,1,0,1,0
49950,445,0,0,70,70,0,1,0,1,0
51292,445,0,0,70,70,0,1,0,1,0
54121,445,0,0,66,66,0,1,0,1,0
50552,445,0,0,70,70,0,1,0,1,0
52866,445,0,0,70,70,0,1,0,1,0
63658,445,0,0,66,66,0,1,0,1,0
55315,445,0,0,70,70,0,1,0,1,0
55290,445,0,0,70,70,0,1,0,1,0
50308,445,0,0,66,66,0,1,0,1,0
60380,445,0,0,66,66,0,1,0,1,0
51324,445,0,0,70,70,0,1,0,1,0
60825,445,0,0,66,66,0,1,0,1,0
56794,445,0,0,70,70,0,1,0,1,0
56810,445,0,0,70,70,0,1,0,1,0
54944,445,0,0,70,70,0,1,0,1,0
64958,445,0,0,66,66,0,1,0,1,0
49464,445,0,0,70,70,0,1,0,1,0
50201,445,0,0,70,70,0,1,0,1,0
63648,445,0,0,70,70,0,1,0,1,0
64677,445,0,0,66,66,0,1,0,1,0
51361,445,0,0,70,70,0,1,0,1,0
58698,445,0,0,66,66,0,1,0,1,0
50516,445,0,0,70,70,0,1,0,1,0
49812,445,0,0,66,66,0,1,0,1,0
59699,445,0,0,70,70,0,1,0,1,0
60724,445,0,0,66,66,0,1,0,1,0
54397,445,0,0,66,66,0,1,0,1,0
58285,445,0,0,70,70,0,1,0,1,0
55360,445,0,0,70,70,0,1,0,1,0
50756,445,0,0,66,66,0,1,0,1,0
54516,445,0,0,70,70,0,1,0,1,0
58214,445,0,0,70,70,0,1,0,1,0
49421,445,0,0,70,70,0,1,0,1,0
56751,445,0,0,70,70,0,1,0,1,0
54541,445,0,0,70,70,0,1,0,1,0
50894,445,0,0,70,70,0,1,0,1,0
64164,445,0,0,66,66,0,1,0,1,0
51491,445,0,0,70,70,0,1,0,1,0
63294,445,0,0,66,66,0,1,0,1,0
52998,445,0,0,70,70,0,1,0,1,0
57524,445,0,0,70,70,0,1,0,1,0
52269,445,0,0,66,66,0,1,0,1,0
64005,445,0,0,70,70,0,1,0,1,0
52589,445,0,0,70,70,0,1,0,1,0
54134,445,0,0,70,70,0,1,0,1,0
56244,445,0,0,66,66,0,1,0,1,0
50299,445,0,0,70,70,0,1,0,1,0
56616,445,0,0,66,66,0,1,0,1,0
65239,445,0,0,70,70,0,1,0,1,0
62816,445,0,0,66,66,0,1,0,1,0
52395,445,0,0,66,66,0,1,0,1,0
60174,445,0,0,66,66,0,1,0,1,0
63041,445,0,0,70,70,0,1,0,1,0
50506,445,0,0,70,70,0,1,0,1,0
55706,445,0,0,66,66,0,1,0,1,0
53506,445,0,0,66,66,0,1,0,1,0
61661,445,0,0,70,70,0,1,0,1,0
54444,445,0,0,70,70,0,1,0,1,0
52701,445,0,0,70,70,0,1,0,1,0
54155,445,0,0,70,70,0,1,0,1,0
60304,445,0,0,70,70,0,1,0,1,0
61294,445,0,0,66,66,0,1,0,1,0
52067,445,0,0,70,70,0,1,0,1,0
49534,445,0,0,70,70,0,1,0,1,0
64073,445,0,0,70,70,0,1,0,1,0
51928,445,0,0,70,70,0,1,0,1,0
59013,445,0,0,66,66,0,1,0,1,0
50383,445,0,0,66,66,0,1,0,1,0
54048,445,0,0,70,70,0,1,0,1,0
62265,445,0,0,70,70,0,1,0,1,0
50463,445,0,0,66,66,0,1,0,1,0
61522,445,0,0,70,70,0,1,0,1,0
50969,445,0,0,70,70,0,1,0,1,0
55335,445,0,0,70,70,0,1,0,1,0
58887,445,0,0,66,66,0,1,0,1,0
64631,445,0,0,70,70,0,1,0,1,0
52437,445,0,0,70,70,0,1,0,1,0
49580,445,0,0,70,70,0,1,0,1,0
53015,445,0,0,70,70,0,1,0,1,0
63429,445,0,0,70,70,0,1,0,1,0
62665,445,0,0,66,66,0,1,0,1,0
55851,445,0,0,70,70,0,1,0,1,0
49582,445,0,0,70,70,0,1,0,1,0
51024,445,0,0,66,66,0,1,0,1,0
50280,445,0,0,66,66,0,1,0,1,0
65231,445,0,0,70,70,0,1,0,1,0
61536,445,0,0,70,70,0,1,0,1,0
50594,445,0,0,66,66,0,1,0,1,0
65294,445,0,0,70,70,0,1,0,1,0
56053,445,0,0,70,70,0,1,0,1,0
56683,445,0,0,70,70,0,1,0,1,0
55973,445,0,0,66,66,0,1,0,1,0
50154,445,0,0,70,70,0,1,0,1,0
62630,445,0,0,70,70,0,1,0,1,0
50837,445,0,0,70,70,0,1,0,1,0
59094,445,0,0,66,66,0,1,0,1,0
54428,445,0,0,70,70,0,1,0,1,0
58685,445,0,0,70,70,0,1,0,1,0
61984,445,0,0,70,70,0,1,0,1,0
58549,445,0,0,70,70,0,1,0,1,0
62902,445,0,0,70,70,0,1,0,1,0
60432,445,0,0,66,66,0,1,0,1,0
51944,445,0,0,70,70,0,1,0,1,0
53239,445,0,0,66,66,0,1,0,1,0
64988,445,0,0,70,70,0,1,0,1,0
57908,445,0,0,66,66,0,1,0,1,0
52775,445,0,0,66,66,0,1,0,1,0
55855,445,0,0,70,70,0,1,0,1,0
50267,445,0,0,70,70,0,1,0,1,0
52447,445,0,0,70,70,0,1,0,1,0
54692,445,0,0,70,70,0,1,0,1,0
53416,445,0,0,70,70,0,1,0,1,0
54071,445,0,0,70,70,0,1,0,1,0
50209,445,0,0,70,70,0,1,0,1,0
50008,445,0,0,70,70,0,1,0,1,0
55710,445,0,0,70,70,0,1,0,1,0
50858,445,0,0,66,66,0,1,0,1,0
59779,445,0,0,70,70,0,1,0,1,0
58628,445,0,0,66,66,0,1,0,1,0
54650,445,0,0,66,66,0,1,0,1,0
58987,445,0,0,70,70,0,1,0,1,0
62775,445,0,0,70,70,0,1,0,1,0
61415,445,0,0,70,70,0,1,0,1,0
51018,445,0,0,70,70,0,1,0,1,0
61673,445,0,0,70,70,0,1,0,1,0
55010,445,0,0,70,70,0,1,0,1,0
56867,445,0,0,70,70,0,1,0,1,0
62130,445,0,0,70,70,0,1,0,1,0
57150,445,0,0,70,70,0,1,0,1,0
52521,445,0,0,66,66,0,1,0,1,0
63702,445,0,0,70,70,0,1,0,1,0
61886,445,0,0,70,70,0,1,0,1,0
55214,445,0,0,70,70,0,1,0,1,0
56523,445,0,0,66,66,0,1,0,1,0
51744,445,0,0,70,70,0,1,0,1,0
64342,445,0,0,66,66,0,1,0,1,0
53033,445,0,0,66,66,0,1,0,1,0
52534,445,0,0,70,70,0,1,0,1,0
53220,445,0,0,70,70,0,1,0,1,0
59875,445,0,0,70,70,0,1,0,1,0
60241,445,0,0,70,70,0,1,0,1,0
63512,445,0,0,66,66,0,1,0,1,0
50589,445,0,0,70,70,0,1,0,1,0
64623,445,0,0,66,66,0,1,0,1,0
59591,445,0,0,70,70,0,1,0,1,0
50779,445,0,0,66,66,0,1,0,1,0
57964,445,0,0,70,70,0,1,0,1,0
58729,445,0,0,70,70,0,1,0,1,0
57447,445,0,0,70,70,0,1,0,1,0
60698,445,0,0,66,66,0,1,0,1,0
56737,445,0,0,66,66,0,1,0,1,0
49953,445,0,0,66,66,0,1,0,1,0
55102,445,0,0,66,66,0,1,0,1,0
64808,445,0,0,66,66,0,1,0,1,0
61497,445,0,0,70,70,0,1,0,1,0
50790,445,0,0,66,66,0,1,0,1,0
64373,445,0,0,70,70,0,1,0,1,0
57455,445,0,0,70,70,0,1,0,1,0
58439,445,0,0,70,70,0,1,0,1,0
61258,445,0,0,66,66,0,1,0,1,0
60697,445,0,0,66,66,0,1,0,1,0
64030,445,0,0,70,70,0,1,0,1,0
55727,445,0,0,66,66,0,1,0,1,0
57031,445,0,0,70,70,0,1,0,1,0
61329,445,0,0,70,70,0,1,0,1,0
55394,445,0,0,70,70,0,1,0,1,0
57637,445,0,0,70,70,0,1,0,1,0
57429,445,0,0,66,66,0,1,0,1,0
62110,445,0,0,70,70,0,1,0,1,0
52480,445,0,0,70,70,0,1,0,1,0
50813,445,0,0,70,70,0,1,0,1,0
55549,445,0,0,66,66,0,1,0,1,0
63131,445,0,0,66,66,0,1,0,1,0
64860,445,0,0,66,66,0,1,0,1,0
62285,445,0,0,70,70,0,1,0,1,0
50204,445,0,0,70,70,0,1,0,1,0
61920,445,0,0,70,70,0,1,0,1,0
60731,445,0,0,66,66,0,1,0,1,0
64035,445,0,0,66,66,0,1,0,1,0
55044,445,0,0,70,70,0,1,0,1,0
54013,445,0,0,66,66,0,1,0,1,0
53267,445,0,0,66,66,0,1,0,1,0
50437,445,0,0,66,66,0,1,0,1,0
52121,445,0,0,70,70,0,1,0,1,0
65245,445,0,0,70,70,0,1,0,1,0
49968,445,0,0,66,66,0,1,0,1,0
52888,445,0,0,70,70,0,1,0,1,0
56214,445,0,0,66,66,0,1,0,1,0
62683,445,0,0,66,66,0,1,0,1,0
54088,445,0,0,70,70,0,1,0,1,0
55408,445,0,0,70,70,0,1,0,1,0
63602,445,0,0,70,70,0,1,0,1,0
56469,445,0,0,70,70,0,1,0,1,0
52558,445,0,0,70,70,0,1,0,1,0
60564,445,0,0,66,66,0,1,0,1,0
55516,445,0,0,70,70,0,1,0,1,0
52021,445,0,0,66,66,0,1,0,1,0
51391,445,0,0,70,70,0,1,0,1,0
58183,445,0,0,70,70,0,1,0,1,0
61287,445,0,0,70,70,0,1,0,1,0
59737,445,0,0,70,70,0,1,0,1,0
49218,445,0,0,70,70,0,1,0,1,0
56895,445,0,0,70,70,0,1,0,1,0
60752,445,0,0,66,66,0,1,0,1,0
61142,445,0,0,66,66,0,1,0,1,0
51029,445,0,0,70,70,0,1,0,1,0
50868,445,0,0,70,70,0,1,0,1,0
62035,445,0,0,70,70,0,1,0,1,0
60038,445,0,0,70,70,0,1,0,1,0
61385,445,0,0,66,66,0,1,0,1,0
60960,445,0,0,70,70,0,1,0,1,0
60999,445,0,0,70,70,0,1,0,1,0
58883,445,0,0,66,66,0,1,0,1,0
55428,445,0,0,70,70,0,1,0,1,0
50228,445,0,0,70,70,0,1,0,1,0
59430,445,0,0,70,70,0,1,0,1,0
65442,445,0,0,70,70,0,1,0,1,0
53834,445,0,0,70,70,0,1,0,1,0
61549,445,0,0,66,66,0,1,0,1,0
62171,445,0,0,66,66,0,1,0,1,0
50017,445,0,0,70,70,0,1,0,1,0
58941,445,0,0,70,70,0,1,0,1,0
51961,445,0,0,70,70,0,1,0,1,0
63971,445,0,0,66,66,0,1,0,1,0
58627,445,0,0,66,66,0,1,0,1,0
57537,445,0,0,70,70,0,1,0,1,0
65495,445,0,0,70,70,0,1,0,1,0
53265,445,0,0,70,70,0,1,0,1,0
55145,445,0,0,70,70,0,1,0,1,0
52750,445,0,0,70,70,0,1,0,1,0
58884,445,0,0,66,66,0,1,0,1,0
51879,445,0,0,70,70,0,1,0,1,0
64366,445,0,0,66,66,0,1,0,1,0
64384,445,0,0,70,70,0,1,0,1,0
52918,445,0,0,70,70,0,1,0,1,0
56707,445,0,0,66,66,0,1,0,1,0
52885,445,0,0,66,66,0,1,0,1,0
57625,445,0,0,70,70,0,1,0,1,0
62544,445,0,0,66,66,0,1,0,1,0
62643,445,0,0,70,70,0,1,0,1,0
58007,445,0,0,70,70,0,1,0,1,0
59397,445,0,0,70,70,0,1,0,1,0
62896,445,0,0,70,70,0,1,0,1,0
54376,445,0,0,66,66,0,1,0,1,0
52719,445,0,0,70,70,0,1,0,1,0
58648,445,0,0,66,66,0,1,0,1,0
61205,445,0,0,70,70,0,1,0,1,0
62724,445,0,0,70,70,0,1,0,1,0
62666,445,0,0,66,66,0,1,0,1,0
53740,445,0,0,70,70,0,1,0,1,0
53641,445,0,0,70,70,0,1,0,1,0
51363,445,0,0,66,66,0,1,0,1,0
64765,445,0,0,70,70,0,1,0,1,0
51471,445,0,0,66,66,0,1,0,1,0
58191,445,0,0,70,70,0,1,0,1,0
64177,445,0,0,70,70,0,1,0,1,0
64306,445,0,0,70,70,0,1,0,1,0
58223,445,0,0,70,70,0,1,0,1,0
61368,445,0,0,70,70,0,1,0,1,0
50870,445,0,0,66,66,0,1,0,1,0
65216,445,0,0,70,70,0,1,0,1,0
51038,445,0,0,70,70,0,1,0,1,0
55063,445,0,0,66,66,0,1,0,1,0
56766,445,0,0,70,70,0,1,0,1,0
56643,445,0,0,70,70,0,1,0,1,0
53616,445,0,0,70,70,0,1,0,1,0
51941,445,0,0,70,70,0,1,0,1,0
57319,445,0,0,70,70,0,1,0,1,0
64556,445,0,0,70,70,0,1,0,1,0
60097,445,0,0,66,66,0,1,0,1,0
57539,445,0,0,66,66,0,1,0,1,0
60111,445,0,0,66,66,0,1,0,1,0
63640,445,0,0,70,70,0,1,0,1,0
56253,445,0,0,66,66,0,1,0,1,0
53370,445,0,0,66,66,0,1,0,1,0
62306,445,0,0,66,66,0,1,0,1,0
63647,445,0,0,66,66,0,1,0,1,0
65028,445,0,0,70,70,0,1,0,1,0
49349,445,0,0,66,66,0,1,0,1,0
61045,445,0,0,70,70,0,1,0,1,0
60127,445,0,0,70,70,0,1,0,1,0
55566,445,0,0,70,70,0,1,0,1,0
59580,445,0,0,70,70,0,1,0,1,0
55556,445,0,0,70,70,0,1,0,1,0
53289,445,0,0,66,66,0,1,0,1,0
53415,445,0,0,70,70,0,1,0,1,0
53077,445,0,0,70,70,0,1,0,1,0
50093,445,0,0,70,70,0,1,0,1,0
51262,445,0,0,66,66,0,1,0,1,0
60825,445,0,0,70,70,0,1,0,1,0
63745,445,0,0,66,66,0,1,0,1,0
49391,445,0,0,70,70,0,1,0,1,0
51233,445,0,0,66,66,0,1,0,1,0
62549,445,0,0,70,70,0,1,0,1,0
50524,445,0,0,70,70,0,1,0,1,0
51144,445,0,0,66,66,0,1,0,1,0
60291,445,0,0,70,70,0,1,0,1,0
59773,445,0,0,66,66,0,1,0,1,0
59833,445,0,0,70,70,0,1,0,1,0
51084,445,0,0,70,70,0,1,0,1,0
63685,445,0,0,70,70,0,1,0,1,0
55661,445,0,0,66,66,0,1,0,1,0
53280,445,0,0,70,70,0,1,0,1,0
61530,445,0,0,70,70,0,1,0,1,0
50664,445,0,0,70,70,0,1,0,1,0
58242,445,0,0,66,66,0,1,0,1,0
62913,445,0,0,70,70,0,1,0,1,0
51675,445,0,0,70,70,0,1,0,1,0
62945,445,0,0,66,66,0,1,0,1,0
58658,445,0,0,66,66,0,1,0,1,0
52184,445,0,0,70,70,0,1,0,1,0
56620,445,0,0,70,70,0,1,0,1,0
62819,445,0,0,70,70,0,1,0,1,0
54335,445,0,0,70,70,0,1,0,1,0
58503,445,0,0,70,70,0,1,0,1,0
64671,445,0,0,70,70,0,1,0,1,0
61865,445,0,0,70,70,0,1,0,1,0
62893,445,0,0,70,70,0,1,0,1,0
49324,445,0,0,70,70,0,1,0,1,0
64290,445,0,0,70,70,0,1,0,1,0
54895,445,0,0,70,70,0,1,0,1,0
55074,445,0,0,70,70,0,1,0,1,0
54779,445,0,0,70,70,0,1,0,1,0
49304,445,0,0,70,70,0,1,0,1,0
55107,445,0,0,70,70,0,1,0,1,0
51126,445,0,0,66,66,0,1,0,1,0
64793,445,0,0,70,70,0,1,0,1,0
54342,445,0,0,66,66,0,1,0,1,0
56771,445,0,0,70,70,0,1,0,1,0
63254,445,0,0,66,66,0,1,0,1,0
60443,445,0,0,70,70,0,1,0,1,0
58555,445,0,0,70,70,0,1,0,1,0
51372,445,0,0,70,70,0,1,0,1,0
57956,445,0,0,70,70,0,1,0,1,0
58255,445,0,0,70,70,0,1,0,1,0
65111,445,0,0,70,70,0,1,0,1,0
54869,445,0,0,70,70,0,1,0,1,0
60290,445,0,0,66,66,0,1,0,1,0
61937,445,0,0,70,70,0,1,0,1,0
52717,445,0,0,70,70,0,1,0,1,0
56005,445,0,0,70,70,0,1,0,1,0
63030,445,0,0,66,66,0,1,0,1,0
50807,445,0,0,70,70,0,1,0,1,0
59018,445,0,0,70,70,0,1,0,1,0
58818,445,0,0,70,70,0,1,0,1,0
52931,445,0,0,70,70,0,1,0,1,0
65049,445,0,0,66,66,0,1,0,1,0
50806,445,0,0,70,70,0,1,0,1,0
51023,445,0,0,70,70,0,1,0,1,0
53557,445,0,0,66,66,0,1,0,1,0
56894,445,0,0,70,70,0,1,0,1,0
53548,445,0,0,70,70,0,1,0,1,0
50853,445,0,0,70,70,0,1,0,1,0
50246,445,0,0,70,70,0,1,0,1,0
64193,445,0,0,70,70,0,1,0,1,0
61100,445,0,0,66,66,0,1,0,1,0
51055,445,0,0,66,66,0,1,0,1,0
56131,445,0,0,70,70,0,1,0,1,0
53911,445,0,0,70,70,0,1,0,1,0
52387,445,0,0,70,70,0,1,0,1,0
51495,445,0,0,66,66,0,1,0,1,0
53357,445,0,0,70,70,0,1,0,1,0
50848,445,0,0,66,66,0,1,0,1,0
60151,445,0,0,70,70,0,1,0,1,0
55154,445,0,0,70,70,0,1,0,1,0
61939,445,0,0,70,70,0,1,0,1,0
51108,445,0,0,70,70,0,1,0,1,0
57905,445,0,0,70,70,0,1,0,1,0
61379,445,0,0,70,70,0,1,0,1,0
55166,445,0,0,66,66,0,1,0,1,0
50163,445,0,0,70,70,0,1,0,1,0
50811,445,0,0,70,70,0,1,0,1,0
54137,445,0,0,66,66,0,1,0,1,0
63278,445,0,0,66,66,0,1,0,1,0
64436,445,0,0,70,70,0,1,0,1,0
58764,445,0,0,70,70,0,1,0,1,0
58501,445,0,0,70,70,0,1,0,1,0
58215,445,0,0,70,70,0,1,0,1,0
63453,445,0,0,66,66,0,1,0,1,0
55660,445,0,0,70,70,0,1,0,1,0
58167,445,0,0,70,70,0,1,0,1,0
52147,445,0,0,70,70,0,1,0,1,0
51877,445,0,0,70,70,0,1,0,1,0
50938,445,0,0,70,70,0,1,0,1,0
57286,445,0,0,70,70,0,1,0,1,0
59691,445,0,0,70,70,0,1,0,1,0
58556,445,0,0,66,66,0,1,0,1,0
64233,445,0,0,66,66,0,1,0,1,0
55355,445,0,0,66,66,0,1,0,1,0
61017,445,0,0,70,70,0,1,0,1,0
50100,445,0,0,66,66,0,1,0,1,0
53117,445,0,0,70,70,0,1,0,1,0
63217,445,0,0,70,70,0,1,0,1,0
64420,445,0,0,66,66,0,1,0,1,0
52154,445,0,0,66,66,0,1,0,1,0
49156,445,0,0,66,66,0,1,0,1,0
52584,445,0,0,66,66,0,1,0,1,0
52474,445,0,0,70,70,0,1,0,1,0
52174,445,0,0,66,66,0,1,0,1,0
64329,445,0,0,66,66,0,1,0,1,0
49620,445,0,0,70,70,0,1,0,1,0
63101,445,0,0,70,70,0,1,0,1,0
53845,445,0,0,70,70,0,1,0,1,0
64338,445,0,0,70,70,0,1,0,1,0
58096,445,0,0,70,70,0,1,0,1,0
53820,445,0,0,70,70,0,1,0,1,0
64166,445,0,0,66,66,0,1,0,1,0
59215,445,0,0,70,70,0,1,0,1,0
63696,445,0,0,66,66,0,1,0,1,0
55437,445,0,0,66,66,0,1,0,1,0
50728,445,0,0,66,66,0,1,0,1,0
54932,445,0,0,70,70,0,1,0,1,0
54967,445,0,0,70,70,0,1,0,1,0
56836,445,0,0,66,66,0,1,0,1,0
50592,445,0,0,70,70,0,1,0,1,0
62717,445,0,0,70,70,0,1,0,1,0
49654,445,0,0,70,70,0,1,0,1,0
49474,445,0,0,70,70,0,1,0,1,0
57080,445,0,0,70,70,0,1,0,1,0
58069,445,0,0,66,66,0,1,0,1,0
54135,445,0,0,66,66,0,1,0,1,0
53369,445,0,0,66,66,0,1,0,1,0
64823,445,0,0,70,70,0,1,0,1,0
56656,445,0,0,70,70,0,1,0,1,0
60206,445,0,0,66,66,0,1,0,1,0
54065,445,0,0,70,70,0,1,0,1,0
52480,445,0,0,70,70,0,1,0,1,0
63553,445,0,0,66,66,0,1,0,1,0
58294,445,0,0,66,66,0,1,0,1,0
49160,445,0,0,70,70,0,1,0,1,0
57748,445,0,0,70,70,0,1,0,1,0
62854,445,0,0,70,70,0,1,0,1,0
57455,445,0,0,70,70,0,1,0,1,0
62259,445,0,0,70,70,0,1,0,1,0
53221,445,0,0,66,66,0,1,0,1,0
50997,445,0,0,70,70,0,1,0,1,0
60665,445,0,0,66,66,0,1,0,1,0
56343,445,0,0,70,70,0,1,0,1,0
64504,445,0,0,70,70,0,1,0,1,0
49467,445,0,0,70,70,0,1,0,1,0
63668,445,0,0,70,70,0,1,0,1,0
49302,445,0,0,70,70,0,1,0,1,0
56353,445,0,0,66,66,0,1,0,1,0
63839,445,0,0,70,70,0,1,0,1,0
57624,445,0,0,70,70,0,1,0,1,0
65095,445,0,0,70,70,0,1,0,1,0
63686,445,0,0,70,70,0,1,0,1,0
62619,445,0,0,66,66,0,1,0,1,0
50878,445,0,0,66,66,0,1,0,1,0
62818,445,0,0,70,70,0,1,0,1,0
63711,445,0,0,66,66,0,1,0,1,0
50802,445,0,0,70,70,0,1,0,1,0
50391,445,0,0,66,66,0,1,0,1,0
64503,445,0,0,70,70,0,1,0,1,0
61338,445,0,0,70,70,0,1,0,1,0
65002,445,0,0,70,70,0,1,0,1,0
52415,445,0,0,66,66,0,1,0,1,0
50885,445,0,0,66,66,0,1,0,1,0
52250,445,0,0,70,70,0,1,0,1,0
53928,445,0,0,70,70,0,1,0,1,0
50710,445,0,0,70,70,0,1,0,1,0
55699,445,0,0,70,70,0,1,0,1,0
50610,445,0,0,70,70,0,1,0,1,0
59180,445,0,0,70,70,0,1,0,1,0
55172,445,0,0,70,70,0,1,0,1,0
60440,445,0,0,66,66,0,1,0,1,0
54794,445,0,0,66,66,0,1,0,1,0
55897,445,0,0,70,70,0,1,0,1,0
58778,445,0,0,70,70,0,1,0,1,0
58308,445,0,0,66,66,0,1,0,1,0
50467,445,0,0,66,66,0,1,0,1,0
56047,445,0,0,70,70,0,1,0,1,0
51968,445,0,0,70,70,0,1,0,1,0
50570,445,0,0,70,70,0,1,0,1,0
53702,445,0,0,70,70,0,1,0,1,0
56276,445,0,0,70,70,0,1,0,1,0
62359,445,0,0,70,70,0,1,0,1,0
60373,445,0,0,70,70,0,1,0,1,0
55310,445,0,0,66,66,0,1,0,1,0
60009,445,0,0,70,70,0,1,0,1,0
58668,445,0,0,70,70,0,1,0,1,0
53964,445,0,0,70,70,0,1,0,1,0
56279,445,0,0,70,70,0,1,0,1,0
62690,445,0,0,70,70,0,1,0,1,0
53995,445,0,0,70,70,0,1,0,1,0
51461,445,0,0,66,66,0,1,0,1,0
49845,445,0,0,70,70,0,1,0,1,0
52159,445,0,0,66,66,0,1,0,1,0
51378,445,0,0,66,66,0,1,0,1,0
56499,445,0,0,66,66,0,1,0,1,0
55997,445,0,0,70,70,0,1,0,1,0
59245,445,0,0,70,70,0,1,0,1,0
49713,445,0,0,66,66,0,1,0,1,0
56124,445,0,0,70,70,0,1,0,1,0
59334,445,0,0,70,70,0,1,0,1,0
61879,445,0,0,70,70,0,1,0,1,0
61777,445,0,0,66,66,0,1,0,1,0
51167,445,0,0,66,66,0,1,0,1,0
65196,445,0,0,66,66,0,1,0,1,0
60917,445,0,0,70,70,0,1,0,1,0
50352,445,0,0,66,66,0,1,0,1,0
60276,445,0,0,66,66,0,1,0,1,0
51861,445,0,0,70,70,0,1,0,1,0
56387,445,0,0,70,70,0,1,0,1,0
50615,445,0,0,70,70,0,1,0,1,0
58059,445,0,0,66,66,0,1,0,1,0
55090,445,0,0,66,66,0,1,0,1,0
50100,445,0,0,70,70,0,1,0,1,0
62776,445,0,0,70,70,0,1,0,1,0
58773,445,0,0,70,70,0,1,0,1,0
55992,445,0,0,70,70,0,1,0,1,0
50691,445,0,0,66,66,0,1,0,1,0
64933,445,0,0,66,66,0,1,0,1,0
64039,445,0,0,66,66,0,1,0,1,0
57352,445,0,0,66,66,0,1,0,1,0
63939,445,0,0,70,70,0,1,0,1,0
56896,445,0,0,70,70,0,1,0,1,0
57302,445,0,0,66,66,0,1,0,1,0
64296,445,0,0,66,66,0,1,0,1,0
65000,445,0,0,70,70,0,1,0,1,0
55443,445,0,0,70,70,0,1,0,1,0
54583,445,0,0,66,66,0,1,0,1,0
52189,445,0,0,70,70,0,1,0,1,0
50142,445,0,0,70,70,0,1,0,1,0
64211,445,0,0,70,70,0,1,0,1,0
51226,445,0,0,70,70,0,1,0,1,0
49641,445,0,0,70,70,0,1,0,1,0
49371,445,0,0,70,70,0,1,0,1,0
57389,445,0,0,70,70,0,1,0,1,0
65461,445,0,0,70,70,0,1,0,1,0
49381,445,0,0,66,66,0,1,0,1,0
59444,445,0,0,70,70,0,1,0,1,0
63849,445,0,0,70,70,0,1,0,1,0
49782,445,0,0,70,70,0,1,0,1,0
61273,445,0,0,70,70,0,1,0,1,0
55586,445,0,0,70,70,0,1,0,1,0
51105,445,0,0,66,66,0,1,0,1,0
58238,445,0,0,70,70,0,1,0,1,0
49913,445,0,0,70,70,0,1,0,1,0
56514,445,0,0,70,70,0,1,0,1,0
61214,445,0,0,70,70,0,1,0,1,0
64194,445,0,0,70,70,0,1,0,1,0
56137,445,0,0,66,66,0,1,0,1,0
52532,445,0,0,66,66,0,1,0,1,0
50007,445,0,0,70,70,0,1,0,1,0
56800,445,0,0,70,70,0,1,0,1,0
59437,445,0,0,70,70,0,1,0,1,0
54263,445,0,0,70,70,0,1,0,1,0
62829,445,0,0,66,66,0,1,0,1,0
52790,445,0,0,70,70,0,1,0,1,0
57603,445,0,0,66,66,0,1,0,1,0
55956,445,0,0,70,70,0,1,0,1,0
65321,445,0,0,66,66,0,1,0,1,0
55129,445,0,0,70,70,0,1,0,1,0
60375,445,0,0,70,70,0,1,0,1,0
52734,445,0,0,70,70,0,1,0,1,0
57589,445,0,0,66,66,0,1,0,1,0
58259,445,0,0,66,66,0,1,0,1,0
55567,445,0,0,70,70,0,1,0,1,0
57415,445,0,0,70,70,0,1,0,1,0
63331,445,0,0,66,66,0,1,0,1,0
61826,445,0,0,70,70,0,1,0,1,0
64669,445,0,0,70,70,0,1,0,1,0
62444,445,0,0,70,70,0,1,0,1,0
51212,445,0,0,70,70,0,1,0,1,0
55470,445,0,0,66,66,0,1,0,1,0
55497,445,0,0,66,66,0,1,0,1,0
62976,445,0,0,70,70,0,1,0,1,0
51009,445,0,0,70,70,0,1,0,1,0
51175,445,0,0,70,70,0,1,0,1,0
62421,445,0,0,70,70,0,1,0,1,0
51041,445,0,0,70,70,0,1,0,1,0
53660,445,0,0,70,70,0,1,0,1,0
63641,445,0,0,66,66,0,1,0,1,0
52630,445,0,0,70,70,0,1,0,1,0
52014,445,0,0,70,70,0,1,0,1,0
63284,445,0,0,70,70,0,1,0,1,0
50217,445,0,0,70,70,0,1,0,1,0
50284,445,0,0,66,66,0,1,0,1,0
57240,445,0,0,70,70,0,1,0,1,0
61033,445,0,0,70,70,0,1,0,1,0
63871,445,0,0,70,70,0,1,0,1,0
54173,445,0,0,70,70,0,1,0,1,0
53547,445,0,0,66,66,0,1,0,1,0
56631,445,0,0,66,66,0,1,0,1,0
55932,445,0,0,70,70,0,1,0,1,0
57940,445,0,0,70,70,0,1,0,1,0
58847,445,0,0,70,70,0,1,0,1,0
58317,445,0,0,70,70,0,1,0,1,0
51112,445,0,0,66,66,0,1,0,1,0
56697,445,0,0,70,70,0,1,0,1,0
57621,445,0,0,70,70,0,1,0,1,0
59513,445,0,0,66,66,0,1,0,1,0
63405,445,0,0,70,70,0,1,0,1,0
49907,445,0,0,70,70,0,1,0,1,0
59838,445,0,0,66,66,0,1,0,1,0
50533,445,0,0,70,70,0,1,0,1,0
58973,445,0,0,70,70,0,1,0,1,0
64344,445,0,0,66,66,0,1,0,1,0
60376,445,0,0,70,70,0,1,0,1,0
49885,445,0,0,70,70,0,1,0,1,0
58969,445,0,0,70,70,0,1,0,1,0
60149,445,0,0,66,66,0,1,0,1,0
50051,445,0,0,70,70,0,1,0,1,0
62315,445,0,0,70,70,0,1,0,1,0
59404,445,0,0,70,70,0,1,0,1,0
60724,445,0,0,70,70,0,1,0,1,0
50082,445,0,0,70,70,0,1,0,1,0
54786,445,0,0,70,70,0,1,0,1,0
59075,445,0,0,70,70,0,1,0,1,0
52430,445,0,0,70,70,0,1,0,1,0
60677,445,0,0,66,66,0,1,0,1,0
50080,445,0,0,70,70,0,1,0,1,0
50944,445,0,0,70,70,0,1,0,1,0
62785,445,0,0,70,70,0,1,0,1,0
63305,445,0,0,70,70,0,1,0,1,0
60429,445,0,0,70,70,0,1,0,1,0
51307,445,0,0,70,70,0,1,0,1,0
52407,445,0,0,66,66,0,1,0,1,0
50353,445,0,0,70,70,0,1,0,1,0
62980,445,0,0,70,70,0,1,0,1,0
58638,445,0,0,70,70,0,1,0,1,0
59944,445,0,0,66,66,0,1,0,1,0
57788,445,0,0,70,70,0,1,0,1,0
49908,445,0,0,70,70,0,1,0,1,0
52626,445,0,0,70,70,0,1,0,1,0
55984,445,0,0,66,66,0,1,0,1,0
55204,445,0,0,70,70,0,1,0,1,0
50674,445,0,0,66,66,0,1,0,1,0
62392,445,0,0,70,70,0,1,0,1,0
56983,445,0,0,66,66,0,1,0,1,0
53790,445,0,0,66,66,0,1,0,1,0
51453,445,0,0,70,70,0,1,0,1,0
51596,445,0,0,70,70,0,1,0,1,0
50041,445,0,0,70,70,0,1,0,1,0
61700,445,0,0,70,70,0,1,0,1,0
50889,445,0,0,70,70,0,1,0,1,0
51293,445,0,0,70,70,0,1,0,1,0
59823,445,0,0,70,70,0,1,0,1,0
65191,445,0,0,66,66,0,1,0,1,0
54327,445,0,0,70,70,0,1,0,1,0
61244,445,0,0,70,70,0,1,0,1,0
64467,445,0,0,70,70,0,1,0,1,0
54830,445,0,0,66,66,0,1,0,1,0
62277,445,0,0,70,70,0,1,0,1,0
64037,445,0,0,70,70,0,1,0,1,0
62747,445,0,0,70,70,0,1,0,1,0
49343,445,0,0,70,70,0,1,0,1,0
53901,445,0,0,66,66,0,1,0,1,0
57415,445,0,0,70,70,0,1,0,1,0
61102,445,0,0,70,70,0,1,0,1,0
53419,445,0,0,66,66,0,1,0,1,0
59503,445,0,0,66,66,0,1,0,1,0
50361,445,0,0,70,70,0,1,0,1,0
51268,445,0,0,70,70,0,1,0,1,0
62698,445,0,0,66,66,0,1,0,1,0
55890,445,0,0,70,70,0,1,0,1,0
61379,445,0,0,70,70,0,1,0,1,0
63273,445,0,0,70,70,0,1,0,1,0
49256,445,0,0,70,70,0,1,0,1,0
51156,445,0,0,70,70,0,1,0,1,0
60807,445,0,0,66,66,0,1,0,1,0
59478,445,0,0,70,70,0,1,0,1,0
62688,445,0,0,66,66,0,1,0,1,0
57148,445,0,0,70,70,0,1,0,1,0
58710,445,0,0,66,66,0,1,0,1,0
49778,445,0,0,66,66,0,1,0,1,0
50807,445,0,0,66,66,0,1,0,1,0
63133,445,0,0,70,70,0,1,0,1,0
56574,445,0,0,70,70,0,1,0,1,0
55415,445,0,0,66,66,0,1,0,1,0
50653,445,0,0,70,70,0,1,0,1,0
57076,445,0,0,66,66,0,1,0,1,0
53577,445,0,0,66,66,0,1,0,1,0
51623,445,0,0,66,66,0,1,0,1,0
52165,445,0,0,70,70,0,1,0,1,0
56339,445,0,0,70,70,0,1,0,1,0
63230,445,0,0,66,66,0,1,0,1,0
64229,445,0,0,70,70,0,1,0,1,0
59884,445,0,0,70,70,0,1,0,1,0
52543,445,0,0,66,66,0,1,0,1,0
61619,445,0,0,70,70,0,1,0,1,0
49773,445,0,0,70,70,0,1,0,1,0
55236,445,0,0,70,70,0,1,0,1,0
56728,445,0,0,70,70,0,1,0,1,0
49641,445,0,0,70,70,0,1,0,1,0
55196,445,0,0,70,70,0,1,0,1,0
56784,445,0,0,70,70,0,1,0,1,0
65515,445,0,0,66,66,0,1,0,1,0
49445,445,0,0,70,70,0,1,0,1,0
53748,445,0,0,70,70,0,1,0,1,0
49756,445,0,0,70,70,0,1,0,1,0
60508,445,0,0,66,66,0,1,0,1,0
64887,445,0,0,66,66,0,1,0,1,0
64415,445,0,0,70,70,0,1,0,1,0
52522,445,0,0,70,70,0,1,0,1,0
63712,445,0,0,66,66,0,1,0,1,0
61085,445,0,0,70,70,0,1,0,1,0
63546,445,0,0,66,66,0,1,0,1,0
49613,445,0,0,66,66,0,1,0,1,0
51503,445,0,0,70,70,0,1,0,1,0
54633,445,0,0,66,66,0,1,0,1,0
61514,445,0,0,70,70,0,1,0,1,0
64758,445,0,0,66,66,0,1,0,1,0
65325,445,0,0,70,70,0,1,0,1,0
55416,445,0,0,66,66,0,1,0,1,0
54566,445,0,0,70,70,0,1,0,1,0
60947,445,0,0,70,70,0,1,0,1,0
61733,445,0,0,70,70,0,1,0,1,0
56872,445,0,0,70,70,0,1,0,1,0
57775,445,0,0,70,70,0,1,0,1,0
60905,445,0,0,70,70,0,1,0,1,0
52611,445,0,0,70,70,0,1,0,1,0
63774,445,0,0,70,70,0,1,0,1,0
51794,445,0,0,70,70,0,1,0,1,0
58301,445,0,0,66,66,0,1,0,1,0
51296,445,0,0,66,66,0,1,0,1,0
55856,445,0,0,70,70,0,1,0,1,0
63008,445,0,0,70,70,0,1,0,1,0
52406,445,0,0,70,70,0,1,0,1,0
59079,445,0,0,70,70,0,1,0,1,0
58524,445,0,0,70,70,0,1,0,1,0
58061,445,0,0,70,70,0,1,0,1,0
63903,445,0,0,70,70,0,1,0,1,0
63749,445,0,0,70,70,0,1,0,1,0
51244,445,0,0,66,66,0,1,0,1,0
57541,445,0,0,66,66,0,1,0,1,0
50668,445,0,0,66,66,0,1,0,1,0
59356,445,0,0,70,70,0,1,0,1,0
53880,445,0,0,66,66,0,1,0,1,0
65418,445,0,0,70,70,0,1,0,1,0
54259,445,0,0,70,70,0,1,0,1,0
49398,445,0,0,70,70,0,1,0,1,0
50925,445,0,0,70,70,0,1,0,1,0
50398,445,0,0,70,70,0,1,0,1,0
56410,445,0,0,70,70,0,1,0,1,0
62296,445,0,0,70,70,0,1,0,1,0
54252,445,0,0,70,70,0,1,0,1,0
61381,445,0,0,70,70,0,1,0,1,0
53317,445,0,0,66,66,0,1,0,1,0
49539,445,0,0,70,70,0,1,0,1,0
50180,445,0,0,66,66,0,1,0,1,0
63645,445,0,0,70,70,0,1,0,1,0
55361,445,0,0,70,70,0,1,0,1,0
55628,445,0,0,66,66,0,1,0,1,0
57390,445,0,0,70,70,0,1,0,1,0
63730,445,0,0,70,70,0,1,0,1,0
49323,445,0,0,70,70,0,1,0,1,0
56940,445,0,0,70,70,0,1,0,1,0
65403,445,0,0,66,66,0,1,0,1,0
63360,445,0,0,70,70,0,1,0,1,0
50050,445,0,0,70,70,0,1,0,1,0
52386,445,0,0,70,70,0,1,0,1,0
65480,445,0,0,66,66,0,1,0,1,0
60332,445,0,0,66,66,0,1,0,1,0
60516,445,0,0,66,66,0,1,0,1,0
61213,445,0,0,66,66,0,1,0,1,0
52757,445,0,0,66,66,0,1,0,1,0
58958,445,0,0,66,66,0,1,0,1,0
53043,445,0,0,70,70,0,1,0,1,0
63666,445,0,0,70,70,0,1,0,1,0
54778,445,0,0,66,66,0,1,0,1,0
49493,445,0,0,70,70,0,1,0,1,0
51330,445,0,0,70,70,0,1,0,1,0
50192,445,0,0,70,70,0,1,0,1,0
63855,445,0,0,66,66,0,1,0,1,0
62789,445,0,0,70,70,0,1,0,1,0
59432,445,0,0,66,66,0,1,0,1,0
60603,445,0,0,70,70,0,1,0,1,0
62126,445,0,0,70,70,0,1,0,1,0
59208,445,0,0,66,66,0,1,0,1,0
55850,445,0,0,70,70,0,1,0,1,0
50176,445,0,0,70,70,0,1,0,1,0
54679,445,0,0,70,70,0,1,0,1,0
60563,445,0,0,70,70,0,1,0,1,0
53268,445,0,0,70,70,0,1,0,1,0
62014,445,0,0,70,70,0,1,0,1,0
56464,445,0,0,70,70,0,1,0,1,0
56630,445,0,0,66,66,0,1,0,1,0
58246,445,0,0,66,66,0,1,0,1,0
57244,445,0,0,70,70,0,1,0,1,0
58284,445,0,0,70,70,0,1,0,1,0
50004,445,0,0,70,70,0,1,0,1,0
62362,445,0,0,66,66,0,1,0,1,0
50720,445,0,0,66,66,0,1,0,1,0
62758,445,0,0,70,70,0,1,0,1,0
54666,445,0,0,66,66,0,1,0,1,0
63192,445,0,0,66,66,0,1,0,1,0
59199,445,0,0,70,70,0,1,0,1,0
50353,445,0,0,66,66,0,1,0,1,0
59198,445,0,0,70,70,0,1,0,1,0
60861,445,0,0,70,70,0,1,0,1,0
57306,445,0,0,70,70,0,1,0,1,0
64044,445,0,0,70,70,0,1,0,1,0
61170,445,0,0,70,70,0,1,0,1,0
61595,445,0,0,66,66,0,1,0,1,0
51071,445,0,0,66,66,0,1,0,1,0
56865,445,0,0,66,66,0,1,0,1,0
63567,445,0,0,70,70,0,1,0,1,0
52221,445,0,0,70,70,0,1,0,1,0
60510,445,0,0,70,70,0,1,0,1,0
54194,445,0,0,70,70,0,1,0,1,0
50908,445,0,0,66,66,0,1,0,1,0
59373,445,0,0,66,66,0,1,0,1,0
58183,445,0,0,70,70,0,1,0,1,0
58773,445,0,0,66,66,0,1,0,1,0
63987,445,0,0,70,70,0,1,0,1,0
57441,445,0,0,70,70,0,1,0,1,0
54038,445,0,0,66,66,0,1,0,1,0
63531,445,0,0,70,70,0,1,0,1,0
52949,445,0,0,70,70,0,1,0,1,0
55441,445,0,0,70,70,0,1,0,1,0
55648,445,0,0,70,70,0,1,0,1,0
63334,445,0,0,70,70,0,1,0,1,0
53987,445,0,0,70,70,0,1,0,1,0
50558,445,0,0,70,70,0,1,0,1,0
49625,445,0,0,70,70,0,1,0,1,0
55618,445,0,0,70,70,0,1,0,1,0
51263,445,0,0,66,66,0,1,0,1,0
55206,445,0,0,70,70,0,1,0,1,0
58446,445,0,0,70,70,0,1,0,1,0
52138,445,0,0,70,70,0,1,0,1,0
62337,445,0,0,70,70,0,1,0,1,0
49679,445,0,0,70,70,0,1,0,1,0
52649,445,0,0,70,70,0,1,0,1,0
59162,445,0,0,66,66,0,1,0,1,0
61389,445,0,0,66,66,0,1,0,1,0
57330,445,0,0,66,66,0,1,0,1,0
51800,445,0,0,70,70,0,1,0,1,0
61711,445,0,0,70,70,0,1,0,1,0
64746,445,0,0,66,66,0,1,0,1,0
50159,445,0,0,66,66,0,1,0,1,0
59989,445,0,0,66,66,0,1,0,1,0
60471,445,0,0,70,70,0,1,0,1,0
54440,445,0,0,70,70,0,1,0,1,0
58703,445,0,0,70,70,0,1,0,1,0
63113,445,0,0,70,70,0,1,0,1,0
62806,445,0,0,70,70,0,1,0,1,0
51799,445,0,0,70,70,0,1,0,1,0
62726,445,0,0,66,66,0,1,0,1,0
50036,445,0,0,70,70,0,1,0,1,0
52725,445,0,0,66,66,0,1,0,1,0
51043,445,0,0,70,70,0,1,0,1,0
58245,445,0,0,66,66,0,1,0,1,0
57241,445,0,0,70,70,0,1,0,1,0
49972,445,0,0,66,66,0,1,0,1,0
59954,445,0,0,70,70,0,1,0,1,0
49305,445,0,0,70,70,0,1,0,1,0
63021,445,0,0,70,70,0,1,0,1,0
59631,445,0,0,70,70,0,1,0,1,0
62413,445,0,0,66,66,0,1,0,1,0
62365,445,0,0,66,66,0,1,0,1,0
53877,445,0,0,70,70,0,1,0,1,0
53674,445,0,0,70,70,0,1,0,1,0
63691,445,0,0,70,70,0,1,0,1,0
53223,445,0,0,70,70,0,1,0,1,0
57321,445,0,0,70,70,0,1,0,1,0
53206,445,0,0,70,70,0,1,0,1,0
63468,445,0,0,66,66,0,1,0,1,0
50902,445,0,0,70,70,0,1,0,1,0
56363,445,0,0,70,70,0,1,0,1,0
58196,445,0,0,70,70,0,1,0,1,0
51259,445,0,0,70,70,0,1,0,1,0
52179,445,0,0,70,70,0,1,0,1,0
60900,445,0,0,70,70,0,1,0,1,0
59454,445,0,0,66,66,0,1,0,1,0
49948,445,0,0,70,70,0,1,0,1,0
53203,445,0,0,70,70,0,1,0,1,0
50848,445,0,0,70,70,0,1,0,1,0
57016,445,0,0,66,66,0,1,0,1,0
62424,445,0,0,66,66,0,1,0,1,0
52007,445,0,0,66,66,0,1,0,1,0
59326,445,0,0,66,66,0,1,0,1,0
63241,445,0,0,66,66,0,1,0,1,0
56670,445,0,0,66,66,0,1,0,1,0
62187,445,0,0,70,70,0,1,0,1,0
56691,445,0,0,66,66,0,1,0,1,0
60471,445,0,0,70,70,0,1,0,1,0
54908,445,0,0,66,66,0,1,0,1,0
55854,445,0,0,66,66,0,1,0,1,0
52024,445,0,0,70,70,0,1,0,1,0
57120,445,0,0,66,66,0,1,0,1,0
57679,445,0,0,70,70,0,1,0,1,0
58569,445,0,0,66,66,0,1,0,1,0
64716,445,0,0,66,66,0,1,0,1,0
50694,445,0,0,70,70,0,1,0,1,0
49408,445,0,0,66,66,0,1,0,1,0
60094,445,0,0,70,70,0,1,0,1,0
54837,445,0,0,66,66,0,1,0,1,0
63201,445,0,0,66,66,0,1,0,1,0
56092,445,0,0,70,70,0,1,0,1,0
55675,445,0,0,70,70,0,1,0,1,0
65073,445,0,0,70,70,0,1,0,1,0
56005,445,0,0,70,70,0,1,0,1,0
65268,445,0,0,70,70,0,1,0,1,0
56957,445,0,0,70,70,0,1,0,1,0
58036,445,0,0,70,70,0,1,0,1,0
57470,445,0,0,70,70,0,1,0,1,0
55864,445,0,0,66,66,0,1,0,1,0
55251,445,0,0,70,70,0,1,0,1,0
56982,445,0,0,70,70,0,1,0,1,0
59502,445,0,0,70,70,0,1,0,1,0
53103,445,0,0,70,70,0,1,0,1,0
49726,445,0,0,66,66,0,1,0,1,0
50265,445,0,0,70,70,0,1,0,1,0
53252,445,0,0,70,70,0,1,0,1,0
50337,445,0,0,66,66,0,1,0,1,0
54138,445,0,0,66,66,0,1,0,1,0
57870,445,0,0,66,66,0,1,0,1,0
60282,445,0,0,70,70,0,1,0,1,0
54883,445,0,0,70,70,0,1,0,1,0
60228,445,0,0,70,70,0,1,0,1,0
49997,445,0,0,66,66,0,1,0,1,0
49869,445,0,0,66,66,0,1,0,1,0
59507,445,0,0,70,70,0,1,0,1,0
50799,445,0,0,70,70,0,1,0,1,0
62106,445,0,0,70,70,0,1,0,1,0
62873,445,0,0,70,70,0,1,0,1,0
64219,445,0,0,70,70,0,1,0,1,0
50881,445,0,0,66,66,0,1,0,1,0
57655,445,0,0,70,70,0,1,0,1,0
58827,445,0,0,66,66,0,1,0,1,0
53573,445,0,0,70,70,0,1,0,1,0
54510,445,0,0,70,70,0,1,0,1,0
55061,445,0,0,66,66,0,1,0,1,0
65184,445,0,0,70,70,0,1,0,1,0
56197,445,0,0,66,66,0,1,0,1,0
54957,445,0,0,70,70,0,1,0,1,0
49565,445,0,0,70,70,0,1,0,1,0
65039,445,0,0,70,70,0,1,0,1,0
51691,445,0,0,70,70,0,1,0,1,0
55131,445,0,0,70,70,0,1,0,1,0
54270,445,0,0,70,70,0,1,0,1,0
55335,445,0,0,70,70,0,1,0,1,0
58889,445,0,0,70,70,0,1,0,1,0
64131,445,0,0,70,70,0,1,0,1,0
62502,445,0,0,70,70,0,1,0,1,0
59405,445,0,0,66,66,0,1,0,1,0
53000,445,0,0,66,66,0,1,0,1,0
65487,445,0,0,70,70,0,1,0,1,0
59787,445,0,0,70,70,0,1,0,1,0
50865,445,0,0,66,66,0,1,0,1,0
52453,445,0,0,66,66,0,1,0,1,0
50356,445,0,0,66,66,0,1,0,1,0
56601,445,0,0,70,70,0,1,0,1,0
64511,445,0,0,70,70,0,1,0,1,0
55217,445,0,0,66,66,0,1,0,1,0
57432,445,0,0,66,66,0,1,0,1,0
58043,445,0,0,66,66,0,1,0,1,0
50194,445,0,0,70,70,0,1,0,1,0
54189,445,0,0,66,66,0,1,0,1,0
50564,445,0,0,66,66,0,1,0,1,0
62705,445,0,0,70,70,0,1,0,1,0
53972,445,0,0,70,70,0,1,0,1,0
49814,445,0,0,70,70,0,1,0,1,0
56189,445,0,0,70,70,0,1,0,1,0
61018,445,0,0,70,70,0,1,0,1,0
55559,445,0,0,70,70,0,1,0,1,0
49505,445,0,0,66,66,0,1,0,1,0
55678,445,0,0,66,66,0,1,0,1,0
55590,445,0,0,70,70,0,1,0,1,0
52007,445,0,0,70,70,0,1,0,1,0
54651,445,0,0,70,70,0,1,0,1,0
55207,445,0,0,70,70,0,1,0,1,0
60637,445,0,0,70,70,0,1,0,1,0
54911,445,0,0,70,70,0,1,0,1,0
62529,445,0,0,70,70,0,1,0,1,0
61560,445,0,0,70,70,0,1,0,1,0
55728,445,0,0,70,70,0,1,0,1,0
59485,445,0,0,70,70,0,1,0,1,0
54063,445,0,0,70,70,0,1,0,1,0
50928,445,0,0,70,70,0,1,0,1,0
60830,445,0,0,70,70,0,1,0,1,0
54187,445,0,0,70,70,0,1,0,1,0
51681,445,0,0,70,70,0,1,0,1,0
53031,445,0,0,66,66,0,1,0,1,0
56587,445,0,0,70,70,0,1,0,1,0
56146,445,0,0,70,70,0,1,0,1,0
65392,445,0,0,66,66,0,1,0,1,0
53494,445,0,0,66,66,0,1,0,1,0
53794,445,0,0,70,70,0,1,0,1,0
56637,445,0,0,70,70,0,1,0,1,0
50312,445,0,0,70,70,0,1,0,1,0
64804,445,0,0,70,70,0,1,0,1,0
53643,445,0,0,70,70,0,1,0,1,0
53144,445,0,0,70,70,0,1,0,1,0
64723,445,0,0,70,70,0,1,0,1,0
60517,445,0,0,70,70,0,1,0,1,0
50413,445,0,0,66,66,0,1,0,1,0
55683,445,0,0,70,70,0,1,0,1,0
57304,445,0,0,70,70,0,1,0,1,0
56383,445,0,0,70,70,0,1,0,1,0
59598,445,0,0,70,70,0,1,0,1,0
61533,445,0,0,70,70,0,1,0,1,0
49812,445,0,0,70,70,0,1,0,1,0
50581,445,0,0,66,66,0,1,0,1,0
62229,445,0,0,70,70,0,1,0,1,0
62215,445,0,0,66,66,0,1,0,1,0
58611,445,0,0,66,66,0,1,0,1,0
60420,445,0,0,70,70,0,1,0,1,0
50148,445,0,0,66,66,0,1,0,1,0
62723,445,0,0,70,70,0,1,0,1,0
61887,445,0,0,70,70,0,1,0,1,0
62027,445,0,0,66,66,0,1,0,1,0
50288,445,0,0,66,66,0,1,0,1,0
62527,445,0,0,70,70,0,1,0,1,0
54101,445,0,0,70,70,0,1,0,1,0
52089,445,0,0,70,70,0,1,0,1,0
57215,445,0,0,70,70,0,1,0,1,0
62188,445,0,0,70,70,0,1,0,1,0
60213,445,0,0,70,70,0,1,0,1,0
50685,445,0,0,70,70,0,1,0,1,0
62810,445,0,0,70,70,0,1,0,1,0
58812,445,0,0,70,70,0,1,0,1,0
49769,445,0,0,70,70,0,1,0,1,0
65397,445,0,0,70,70,0,1,0,1,0
60852,445,0,0,70,70,0,1,0,1,0
55911,445,0,0,70,70,0,1,0,1,0
64909,445,0,0,70,70,0,1,0,1,0
63968,445,0,0,66,66,0,1,0,1,0
58272,445,0,0,66,66,0,1,0,1,0
52115,445,0,0,66,66,0,1,0,1,0
64070,445,0,0,70,70,0,1,0,1,0
63226,445,0,0,70,70,0,1,0,1,0
61417,445,0,0,70,70,0,1,0,1,0
59844,445,0,0,70,70,0,1,0,1,0
56946,445,0,0,66,66,0,1,0,1,0
64835,445,0,0,66,66,0,1,0,1,0
49867,445,0,0,70,70,0,1,0,1,0
50868,445,0,0,66,66,0,1,0,1,0
53799,445,0,0,70,70,0,1,0,1,0
57857,445,0,0,66,66,0,1,0,1,0
56165,445,0,0,70,70,0,1,0,1,0
53501,445,0,0,70,70,0,1,0,1,0
57110,445,0,0,70,70,0,1,0,1,0
56069,445,0,0,70,70,0,1,0,1,0
64932,445,0,0,70,70,0,1,0,1,0
65463,445,0,0,70,70,0,1,0,1,0
58884,445,0,0,70,70,0,1,0,1,0
50000,445,0,0,70,70,0,1,0,1,0
60900,445,0,0,66,66,0,1,0,1,0
52946,445,0,0,70,70,0,1,0,1,0
55031,445,0,0,70,70,0,1,0,1,0
57251,445,0,0,70,70,0,1,0,1,0
60855,445,0,0,70,70,0,1,0,1,0
54894,445,0,0,70,70,0,1,0,1,0
62184,445,0,0,70,70,0,1,0,1,0
50859,445,0,0,70,70,0,1,0,1,0
49888,445,0,0,70,70,0,1,0,1,0
55592,445,0,0,70,70,0,1,0,1,0
60506,445,0,0,66,66,0,1,0,1,0
60913,445,0,0,70,70,0,1,0,1,0
54967,445,0,0,66,66,0,1,0,1,0
54849,445,0,0,70,70,0,1,0,1,0
50298,445,0,0,70,70,0,1,0,1,0
49456,445,0,0,70,70,0,1,0,1,0
61275,445,0,0,66,66,0,1,0,1,0
61116,445,0,0,70,70,0,1,0,1,0
54371,445,0,0,70,70,0,1,0,1,0
59355,445,0,0,66,66,0,1,0,1,0
59465,445,0,0,66,66,0,1,0,1,0
50421,445,0,0,66,66,0,1,0,1,0
50338,445,0,0,66,66,0,1,0,1,0
50868,445,0,0,66,66,0,1,0,1,0
62635,445,0,0,66,66,0,1,0,1,0
64486,445,0,0,66,66,0,1,0,1,0
50711,445,0,0,70,70,0,1,0,1,0
54051,445,0,0,70,70,0,1,0,1,0
59929,445,0,0,70,70,0,1,0,1,0
59225,445,0,0,70,70,0,1,0,1,0
53120,445,0,0,70,70,0,1,0,1,0
55229,445,0,0,66,66,0,1,0,1,0
59440,445,0,0,66,66,0,1,0,1,0
58895,445,0,0,66,66,0,1,0,1,0
58011,445,0,0,70,70,0,1,0,1,0
60477,445,0,0,70,70,0,1,0,1,0
57924,445,0,0,66,66,0,1,0,1,0
62595,445,0,0,70,70,0,1,0,1,0
54408,445,0,0,70,70,0,1,0,1,0
54078,445,0,0,66,66,0,1,0,1,0
50941,445,0,0,70,70,0,1,0,1,0
54021,445,0,0,70,70,0,1,0,1,0
58631,445,0,0,70,70,0,1,0,1,0
54272,445,0,0,70,70,0,1,0,1,0
50210,445,0,0,66,66,0,1,0,1,0
52164,445,0,0,70,70,0,1,0,1,0
53532,445,0,0,70,70,0,1,0,1,0
59301,445,0,0,70,70,0,1,0,1,0
53777,445,0,0,70,70,0,1,0,1,0
61471,445,0,0,70,70,0,1,0,1,0
64908,445,0,0,66,66,0,1,0,1,0
49840,445,0,0,66,66,0,1,0,1,0
65498,445,0,0,70,70,0,1,0,1,0
64641,445,0,0,70,70,0,1,0,1,0
58596,445,0,0,70,70,0,1,0,1,0
58839,445,0,0,66,66,0,1,0,1,0
55418,445,0,0,66,66,0,1,0,1,0
62679,445,0,0,70,70,0,1,0,1,0
52790,445,0,0,70,70,0,1,0,1,0
64240,445,0,0,70,70,0,1,0,1,0
59543,445,0,0,66,66,0,1,0,1,0
57869,445,0,0,70,70,0,1,0,1,0
52981,445,0,0,66,66,0,1,0,1,0
64936,445,0,0,66,66,0,1,0,1,0
57685,445,0,0,70,70,0,1,0,1,0
55276,445,0,0,70,70,0,1,0,1,0
59470,445,0,0,66,66,0,1,0,1,0
55246,445,0,0,70,70,0,1,0,1,0
58185,445,0,0,70,70,0,1,0,1,0
64364,445,0,0,66,66,0,1,0,1,0
60987,445,0,0,70,70,0,1,0,1,0
52150,445,0,0,70,70,0,1,0,1,0
61725,445,0,0,66,66,0,1,0,1,0
50849,445,0,0,70,70,0,1,0,1,0
52678,445,0,0,66,66,0,1,0,1,0
52502,445,0,0,70,70,0,1,0,1,0
51832,445,0,0,66,66,0,1,0,1,0
52889,445,0,0,70,70,0,1,0,1,0
64853,445,0,0,70,70,0,1,0,1,0
57272,445,0,0,66,66,0,1,0,1,0
57550,445,0,0,66,66,0,1,0,1,0
59251,445,0,0,70,70,0,1,0,1,0
57325,445,0,0,70,70,0,1,0,1,0
49411,445,0,0,66,66,0,1,0,1,0
51298,445,0,0,70,70,0,1,0,1,0
57159,445,0,0,70,70,0,1,0,1,0
56448,445,0,0,66,66,0,1,0,1,0
51046,445,0,0,66,66,0,1,0,1,0
52710,445,0,0,66,66,0,1,0,1,0
63191,445,0,0,70,70,0,1,0,1,0
49560,445,0,0,70,70,0,1,0,1,0
58284,445,0,0,70,70,0,1,0,1,0
51184,445,0,0,66,66,0,1,0,1,0
57218,445,0,0,70,70,0,1,0,1,0
62231,445,0,0,70,70,0,1,0,1,0
55136,445,0,0,70,70,0,1,0,1,0
52327,445,0,0,70,70,0,1,0,1,0
50682,445,0,0,66,66,0,1,0,1,0
54711,445,0,0,66,66,0,1,0,1,0
62353,445,0,0,70,70,0,1,0,1,0
55259,445,0,0,70,70,0,1,0,1,0
60245,445,0,0,66,66,0,1,0,1,0
60828,445,0,0,66,66,0,1,0,1,0
59358,445,0,0,70,70,0,1,0,1,0
60485,445,0,0,66,66,0,1,0,1,0
53864,445,0,0,70,70,0,1,0,1,0
62541,445,0,0,66,66,0,1,0,1,0
53673,445,0,0,66,66,0,1,0,1,0
61968,445,0,0,70,70,0,1,0,1,0
59947,445,0,0,70,70,0,1,0,1,0
64212,445,0,0,66,66,0,1,0,1,0
49709,445,0,0,70,70,0,1,0,1,0
58464,445,0,0,70,70,0,1,0,1,0
63771,445,0,0,66,66,0,1,0,1,0
55844,445,0,0,70,70,0,1,0,1,0
57613,445,0,0,70,70,0,1,0,1,0
54446,445,0,0,66,66,0,1,0,1,0
50609,445,0,0,70,70,0,1,0,1,0
62213,445,0,0,70,70,0,1,0,1,0
64369,445,0,0,66,66,0,1,0,1,0
57734,445,0,0,66,66,0,1,0,1,0
59041,445,0,0,70,70,0,1,0,1,0
52475,445,0,0,66,66,0,1,0,1,0
60803,445,0,0,70,70,0,1,0,1,0
53944,445,0,0,70,70,0,1,0,1,0
59792,445,0,0,70,70,0,1,0,1,0
65232,445,0,0,66,66,0,1,0,1,0
62813,445,0,0,66,66,0,1,0,1,0
56325,445,0,0,66,66,0,1,0,1,0
51753,445,0,0,66,66,0,1,0,1,0
63563,445,0,0,70,70,0,1,0,1,0
60344,445,0,0,70,70,0,1,0,1,0
50184,445,0,0,70,70,0,1,0,1,0
60835,445,0,0,70,70,0,1,0,1,0
61801,445,0,0,70,70,0,1,0,1,0
57293,445,0,0,70,70,0,1,0,1,0
60179,445,0,0,66,66,0,1,0,1,0
64838,445,0,0,70,70,0,1,0,1,0
60764,445,0,0,70,70,0,1,0,1,0
51101,445,0,0,66,66,0,1,0,1,0
58645,445,0,0,70,70,0,1,0,1,0
55188,445,0,0,66,66,0,1,0,1,0
53980,445,0,0,70,70,0,1,0,1,0
55168,445,0,0,70,70,0,1,0,1,0
50038,445,0,0,66,66,0,1,0,1,0
49508,445,0,0,70,70,0,1,0,1,0
55287,445,0,0,66,66,0,1,0,1,0
64083,445,0,0,70,70,0,1,0,1,0
49289,445,0,0,70,70,0,1,0,1,0
55705,445,0,0,70,70,0,1,0,1,0
52885,445,0,0,70,70,0,1,0,1,0
61248,445,0,0,70,70,0,1,0,1,0
60648,445,0,0,66,66,0,1,0,1,0
65055,445,0,0,70,70,0,1,0,1,0
53678,445,0,0,70,70,0,1,0,1,0
56404,445,0,0,70,70,0,1,0,1,0
52096,445,0,0,70,70,0,1,0,1,0
64221,445,0,0,70,70,0,1,0,1,0
59357,445,0,0,66,66,0,1,0,1,0
53781,445,0,0,70,70,0,1,0,1,0
55037,445,0,0,66,66,0,1,0,1,0
50031,445,0,0,66,66,0,1,0,1,0
61167,445,0,0,70,70,0,1,0,1,0
64690,445,0,0,70,70,0,1,0,1,0
59083,445,0,0,66,66,0,1,0,1,0
49913,445,0,0,70,70,0,1,0,1,0
57941,445,0,0,66,66,0,1,0,1,0
65233,445,0,0,70,70,0,1,0,1,0
54312,445,0,0,70,70,0,1,0,1,0
60483,445,0,0,70,70,0,1,0,1,0
59164,445,0,0,70,70,0,1,0,1,0
54739,445,0,0,70,70,0,1,0,1,0
62364,445,0,0,66,66,0,1,0,1,0
63838,445,0,0,70,70,0,1,0,1,0
54162,445,0,0,70,70,0,1,0,1,0
59837,445,0,0,66,66,0,1,0,1,0
57179,445,0,0,70,70,0,1,0,1,0
62235,445,0,0,66,66,0,1,0,1,0
50263,445,0,0,70,70,0,1,0,1,0
49440,445,0,0,66,66,0,1,0,1,0
54874,445,0,0,70,70,0,1,0,1,0
56941,445,0,0,70,70,0,1,0,1,0
58447,445,0,0,70,70,0,1,0,1,0
62618,445,0,0,70,70,0,1,0,1,0
65242,445,0,0,66,66,0,1,0,1,0
50828,445,0,0,70,70,0,1,0,1,0
55050,445,0,0,70,70,0,1,0,1,0
56193,445,0,0,66,66,0,1,0,1,0
50942,445,0,0,70,70,0,1,0,1,0
52920,445,0,0,66,66,0,1,0,1,0
60263,445,0,0,66,66,0,1,0,1,0
51532,445,0,0,70,70,0,1,0,1,0
53746,445,0,0,70,70,0,1,0,1,0
50089,445,0,0,70,70,0,1,0,1,0
58542,445,0,0,70,70,0,1,0,1,0
62934,445,0,0,70,70,0,1,0,1,0
50682,445,0,0,70,70,0,1,0,1,0
53931,445,0,0,66,66,0,1,0,1,0
51372,445,0,0,66,66,0,1,0,1,0
51941,445,0,0,66,66,0,1,0,1,0
62699,445,0,0,70,70,0,1,0,1,0
57224,445,0,0,70,70,0,1,0,1,0
55059,445,0,0,70,70,0,1,0,1,0
59693,445,0,0,70,70,0,1,0,1,0
55741,445,0,0,66,66,0,1,0,1,0
58948,445,0,0,66,66,0,1,0,1,0
51622,445,0,0,66,66,0,1,0,1,0
53397,445,0,0,66,66,0,1,0,1,0
64871,445,0,0,70,70,0,1,0,1,0
56993,445,0,0,70,70,0,1,0,1,0
54996,445,0,0,66,66,0,1,0,1,0
65199,445,0,0,66,66,0,1,0,1,0
57678,445,0,0,66,66,0,1,0,1,0
61074,445,0,0,70,70,0,1,0,1,0
59050,445,0,0,70,70,0,1,0,1,0
56754,445,0,0,70,70,0,1,0,1,0
54846,445,0,0,66,66,0,1,0,1,0
60515,445,0,0,70,70,0,1,0,1,0
50820,445,0,0,70,70,0,1,0,1,0
60089,445,0,0,70,70,0,1,0,1,0
53544,445,0,0,70,70,0,1,0,1,0
52714,445,0,0,70,70,0,1,0,1,0
51104,445,0,0,66,66,0,1,0,1,0
52511,445,0,0,70,70,0,1,0,1,0
58968,445,0,0,66,66,0,1,0,1,0
60358,445,0,0,70,70,0,1,0,1,0
64883,445,0,0,70,70,0,1,0,1,0
50847,445,0,0,66,66,0,1,0,1,0
63124,445,0,0,70,70,0,1,0,1,0
54963,445,0,0,70,70,0,1,0,1,0
51581,445,0,0,70,70,0,1,0,1,0
62340,445,0,0,70,70,0,1,0,1,0
62425,445,0,0,66,66,0,1,0,1,0
63883,445,0,0,70,70,0,1,0,1,0
60015,445,0,0,70,70,0,1,0,1,0
55708,445,0,0,70,70,0,1,0,1,0
59174,445,0,0,70,70,0,1,0,1,0
54981,445,0,0,70,70,0,1,0,1,0
52040,445,0,0,66,66,0,1,0,1,0
50673,445,0,0,70,70,0,1,0,1,0
61117,445,0,0,66,66,0,1,0,1,0
56792,445,0,0,70,70,0,1,0,1,0
63831,445,0,0,70,70,0,1,0,1,0
52397,445,0,0,70,70,0,1,0,1,0
53961,445,0,0,66,66,0,1,0,1,0
58728,445,0,0,70,70,0,1,0,1,0
55596,445,0,0,70,70,0,1,0,1,0
50205,445,0,0,70,70,0,1,0,1,0
55270,445,0,0,70,70,0,1,0,1,0
57790,445,0,0,70,70,0,1,0,1,0
55875,445,0,0,66,66,0,1,0,1,0
59974,445,0,0,66,66,0,1,0,1,0
55971,445,0,0,70,70,0,1,0,1,0
58054,445,0,0,70,70,0,1,0,1,0
51831,445,0,0,66,66,0,1,0,1,0
62554,445,0,0,66,66,0,1,0,1,0
61570,445,0,0,70,70,0,1,0,1,0
56852,445,0,0,70,70,0,1,0,1,0
64967,445,0,0,70,70,0,1,0,1,0
63726,445,0,0,66,66,0,1,0,1,0
58582,445,0,0,66,66,0,1,0,1,0
58157,445,0,0,70,70,0,1,0,1,0
52224,445,0,0,70,70,0,1,0,1,0
62909,445,0,0,66,66,0,1,0,1,0
65365,445,0,0,70,70,0,1,0,1,0
64041,445,0,0,70,70,0,1,0,1,0
55351,445,0,0,70,70,0,1,0,1,0
60979,445,0,0,66,66,0,1,0,1,0
61817,445,0,0,70,70,0,1,0,1,0
62670,445,0,0,70,70,0,1,0,1,0
63151,445,0,0,70,70,0,1,0,1,0
55191,445,0,0,66,66,0,1,0,1,0
54398,445,0,0,66,66,0,1,0,1,0
63649,445,0,0,66,66,0,1,0,1,0
58890,445,0,0,66,66,0,1,0,1,0
62767,445,0,0,70,70,0,1,0,1,0
64469,445,0,0,70,70,0,1,0,1,0
55920,445,0,0,66,66,0,1,0,1,0
52893,445,0,0,70,70,0,1,0,1,0
61592,445,0,0,70,70,0,1,0,1,0
51230,445,0,0,66,66,0,1,0,1,0
61302,445,0,0,70,70,0,1,0,1,0
50297,445,0,0,70,70,0,1,0,1,0
59129,445,0,0,70,70,0,1,0,1,0
62878,445,0,0,70,70,0,1,0,1,0
55968,445,0,0,70,70,0,1,0,1,0
54189,445,0,0,70,70,0,1,0,1,0
63817,445,0,0,70,70,0,1,0,1,0
57964,445,0,0,70,70,0,1,0,1,0
52187,445,0,0,70,70,0,1,0,1,0
64357,445,0,0,66,66,0,1,0,1,0
54991,445,0,0,70,70,0,1,0,1,0
52649,445,0,0,66,66,0,1,0,1,0
53565,445,0,0,66,66,0,1,0,1,0
52327,445,0,0,66,66,0,1,0,1,0
52357,445,0,0,70,70,0,1,0,1,0
65067,445,0,0,66,66,0,1,0,1,0
63643,445,0,0,70,70,0,1,0,1,0
57474,445,0,0,66,66,0,1,0,1,0
58519,445,0,0,70,70,0,1,0,1,0
56451,445,0,0,66,66,0,1,0,1,0
49311,445,0,0,66,66,0,1,0,1,0
55836,445,0,0,66,66,0,1,0,1,0
50854,445,0,0,70,70,0,1,0,1,0
55569,445,0,0,70,70,0,1,0,1,0
59313,445,0,0,70,70,0,1,0,1,0
60789,445,0,0,70,70,0,1,0,1,0
50872,445,0,0,70,70,0,1,0,1,0
61563,445,0,0,66,66,0,1,0,1,0
50692,445,0,0,70,70,0,1,0,1,0
52764,445,0,0,70,70,0,1,0,1,0
61465,445,0,0,66,66,0,1,0,1,0
55488,445,0,0,70,70,0,1,0,1,0
58349,445,0,0,70,70,0,1,0,1,0
64318,445,0,0,66,66,0,1,0,1,0
52989,445,0,0,70,70,0,1,0,1,0
50965,445,0,0,70,70,0,1,0,1,0
54666,445,0,0,70,70,0,1,0,1,0
64410,445,0,0,70,70,0,1,0,1,0
50351,445,0,0,66,66,0,1,0,1,0
55487,445,0,0,70,70,0,1,0,1,0
64128,445,0,0,70,70,0,1,0,1,0
60873,445,0,0,66,66,0,1,0,1,0
50486,445,0,0,66,66,0,1,0,1,0
53048,445,0,0,66,66,0,1,0,1,0
52506,445,0,0,70,70,0,1,0,1,0
53526,445,0,0,70,70,0,1,0,1,0
64435,445,0,0,70,70,0,1,0,1,0
49937,445,0,0,70,70,0,1,0,1,0
64163,445,0,0,66,66,0,1,0,1,0
51122,445,0,0,66,66,0,1,0,1,0
50169,445,0,0,70,70,0,1,0,1,0
53923,445,0,0,70,70,0,1,0,1,0
57730,445,0,0,70,70,0,1,0,1,0
50708,445,0,0,70,70,0,1,0,1,0
60013,445,0,0,70,70,0,1,0,1,0
51351,445,0,0,66,66,0,1,0,1,0
55407,445,0,0,70,70,0,1,0,1,0
61020,445,0,0,66,66,0,1,0,1,0
50449,445,0,0,70,70,0,1,0,1,0
49895,445,0,0,70,70,0,1,0,1,0
61703,445,0,0,66,66,0,1,0,1,0
56231,445,0,0,66,66,0,1,0,1,0
62278,445,0,0,70,70,0,1,0,1,0
56311,445,0,0,70,70,0,1,0,1,0
52420,445,0,0,66,66,0,1,0,1,0
49502,445,0,0,70,70,0,1,0,1,0
58893,445,0,0,70,70,0,1,0,1,0
53232,445,0,0,70,70,0,1,0,1,0
64217,445,0,0,70,70,0,1,0,1,0
59704,445,0,0,70,70,0,1,0,1,0
62088,445,0,0,66,66,0,1,0,1,0
62552,445,0,0,70,70,0,1,0,1,0
55120,445,0,0,70,70,0,1,0,1,0
52070,445,0,0,66,66,0,1,0,1,0
49227,445,0,0,66,66,0,1,0,1,0
55868,445,0,0,66,66,0,1,0,1,0
52264,445,0,0,70,70,0,1,0,1,0
55251,445,0,0,70,70,0,1,0,1,0
53305,445,0,0,70,70,0,1,0,1,0
56181,445,0,0,70,70,0,1,0,1,0
58760,445,0,0,66,66,0,1,0,1,0
65250,445,0,0,66,66,0,1,0,1,0
61080,445,0,0,66,66,0,1,0,1,0
57774,445,0,0,70,70,0,1,0,1,0
62517,445,0,0,70,70,0,1,0,1,0
53055,445,0,0,66,66,0,1,0,1,0
57250,445,0,0,66,66,0,1,0,1,0
56510,445,0,0,70,70,0,1,0,1,0
61764,445,0,0,70,70,0,1,0,1,0
54642,445,0,0,70,70,0,1,0,1,0
58971,445,0,0,70,70,0,1,0,1,0
61405,445,0,0,70,70,0,1,0,1,0
63175,445,0,0,70,70,0,1,0,1,0
62646,445,0,0,66,66,0,1,0,1,0
65006,445,0,0,66,66,0,1,0,1,0
64539,445,0,0,70,70,0,1,0,1,0
54844,445,0,0,66,66,0,1,0,1,0
63495,445,0,0,70,70,0,1,0,1,0
50579,445,0,0,70,70,0,1,0,1,0
55525,445,0,0,70,70,0,1,0,1,0
59029,445,0,0,70,70,0,1,0,1,0
64877,445,0,0,70,70,0,1,0,1,0
61468,445,0,0,66,66,0,1,0,1,0
60756,445,0,0,66,66,0,1,0,1,0
51107,445,0,0,66,66,0,1,0,1,0
50424,445,0,0,70,70,0,1,0,1,0
62044,445,0,0,66,66,0,1,0,1,0
62431,445,0,0,70,70,0,1,0,1,0
59789,445,0,0,66,66,0,1,0,1,0
60570,445,0,0,70,70,0,1,0,1,0
59328,445,0,0,66,66,0,1,0,1,0
63467,445,0,0,70,70,0,1,0,1,0
53293,445,0,0,66,66,0,1,0,1,0
60419,445,0,0,66,66,0,1,0,1,0
62443,445,0,0,70,70,0,1,0,1,0
58397,445,0,0,70,70,0,1,0,1,0
62900,445,0,0,66,66,0,1,0,1,0
55546,445,0,0,66,66,0,1,0,1,0
54518,445,0,0,70,70,0,1,0,1,0
64414,445,0,0,70,70,0,1,0,1,0
60246,445,0,0,70,70,0,1,0,1,0
56320,445,0,0,66,66,0,1,0,1,0
54508,445,0,0,70,70,0,1,0,1,0
51997,445,0,0,66,66,0,1,0,1,0
63916,445,0,0,70,70,0,1,0,1,0
64257,445,0,0,70,70,0,1,0,1,0
51806,445,0,0,70,70,0,1,0,1,0
54166,445,0,0,66,66,0,1,0,1,0
55745,445,0,0,70,70,0,1,0,1,0
63984,445,0,0,66,66,0,1,0,1,0
62109,445,0,0,66,66,0,1,0,1,0
54564,445,0,0,70,70,0,1,0,1,0
57602,445,0,0,70,70,0,1,0,1,0
50289,445,0,0,66,66,0,1,0,1,0
64229,445,0,0,66,66,0,1,0,1,0
49428,445,0,0,70,70,0,1,0,1,0
54660,445,0,0,70,70,0,1,0,1,0
60530,445,0,0,70,70,0,1,0,1,0
61145,445,0,0,70,70,0,1,0,1,0
49999,445,0,0,70,70,0,1,0,1,0
55085,445,0,0,66,66,0,1,0,1,0
63301,445,0,0,70,70,0,1,0,1,0
52283,445,0,0,66,66,0,1,0,1,0
49550,445,0,0,70,70,0,1,0,1,0
55228,445,0,0,70,70,0,1,0,1,0
61341,445,0,0,70,70,0,1,0,1,0
53286,445,0,0,70,70,0,1,0,1,0
61551,445,0,0,70,70,0,1,0,1,0
57487,445,0,0,70,70,0,1,0,1,0
63919,445,0,0,70,70,0,1,0,1,0
52603,445,0,0,70,70,0,1,0,1,0
60994,445,0,0,70,70,0,1,0,1,0
60632,445,0,0,70,70,0,1,0,1,0
56049,445,0,0,66,66,0,1,0,1,0
50655,445,0,0,70,70,0,1,0,1,0
51856,445,0,0,66,66,0,1,0,1,0
56820,445,0,0,66,66,0,1,0,1,0
61461,445,0,0,70,70,0,1,0,1,0
60015,445,0,0,70,70,0,1,0,1,0
53342,445,0,0,70,70,0,1,0,1,0
54855,445,0,0,66,66,0,1,0,1,0
55203,445,0,0,70,70,0,1,0,1,0
51769,445,0,0,66,66,0,1,0,1,0
63614,445,0,0,70,70,0,1,0,1,0
55724,445,0,0,70,70,0,1,0,1,0
50645,445,0,0,70,70,0,1,0,1,0
59724,445,0,0,66,66,0,1,0,1,0
57749,445,0,0,70,70,0,1,0,1,0
62671,445,0,0,66,66,0,1,0,1,0
49254,445,0,0,66,66,0,1,0,1,0
49718,445,0,0,66,66,0,1,0,1,0
61538,445,0,0,66,66,0,1,0,1,0
57496,445,0,0,70,70,0,1,0,1,0
52220,445,0,0,70,70,0,1,0,1,0
52790,445,0,0,66,66,0,1,0,1,0
59589,445,0,0,70,70,0,1,0,1,0
59679,445,0,0,70,70,0,1,0,1,0
53244,445,0,0,70,70,0,1,0,1,0
50949,445,0,0,70,70,0,1,0,1,0
51724,445,0,0,70,70,0,1,0,1,0
59271,445,0,0,66,66,0,1,0,1,0
60399,445,0,0,70,70,0,1,0,1,0
63359,445,0,0,70,70,0,1,0,1,0
58163,445,0,0,70,70,0,1,0,1,0
53523,445,0,0,66,66,0,1,0,1,0
55806,445,0,0,66,66,0,1,0,1,0
51052,445,0,0,66,66,0,1,0,1,0
49321,445,0,0,70,70,0,1,0,1,0
54538,445,0,0,70,70,0,1,0,1,0
64763,445,0,0,70,70,0,1,0,1,0
55207,445,0,0,70,70,0,1,0,1,0
52214,445,0,0,66,66,0,1,0,1,0
60232,445,0,0,66,66,0,1,0,1,0
55339,445,0,0,70,70,0,1,0,1,0
50662,445,0,0,66,66,0,1,0,1,0
51602,445,0,0,70,70,0,1,0,1,0
51506,445,0,0,70,70,0,1,0,1,0
63324,445,0,0,70,70,0,1,0,1,0
49488,445,0,0,70,70,0,1,0,1,0
51636,445,0,0,70,70,0,1,0,1,0
59665,445,0,0,66,66,0,1,0,1,0
62744,445,0,0,66,66,0,1,0,1,0
61622,445,0,0,66,66,0,1,0,1,0
60843,445,0,0,70,70,0,1,0,1,0
64583,445,0,0,70,70,0,1,0,1,0
59610,445,0,0,70,70,0,1,0,1,0
59930,445,0,0,70,70,0,1,0,1,0
51020,445,0,0,70,70,0,1,0,1,0
52813,445,0,0,70,70,0,1,0,1,0
58524,445,0,0,70,70,0,1,0,1,0
62427,445,0,0,70,70,0,1,0,1,0
50992,445,0,0,70,70,0,1,0,1,0
59146,445,0,0,66,66,0,1,0,1,0
56345,445,0,0,70,70,0,1,0,1,0
60519,445,0,0,70,70,0,1,0,1,0
54127,445,0,0,70,70,0,1,0,1,0
58446,445,0,0,66,66,0,1,0,1,0
64751,445,0,0,66,66,0,1,0,1,0
57498,445,0,0,70,70,0,1,0,1,0
57348,445,0,0,70,70,0,1,0,1,0
52851,445,0,0,70,70,0,1,0,1,0
56224,445,0,0,66,66,0,1,0,1,0
54775,445,0,0,70,70,0,1,0,1,0
55604,445,0,0,66,66,0,1,0,1,0
59616,445,0,0,66,66,0,1,0,1,0
64807,445,0,0,66,66,0,1,0,1,0
54018,445,0,0,70,70,0,1,0,1,0
57757,445,0,0,70,70,0,1,0,1,0
58879,445,0,0,70,70,0,1,0,1,0
52348,445,0,0,70,70,0,1,0,1,0
62107,445,0,0,66,66,0,1,0,1,0
64965,445,0,0,70,70,0,1,0,1,0
65208,445,0,0,70,70,0,1,0,1,0
58825,445,0,0,66,66,0,1,0,1,0
60569,445,0,0,70,70,0,1,0,1,0
61373,445,0,0,70,70,0,1,0,1,0
65325,445,0,0,66,66,0,1,0,1,0
59476,445,0,0,70,70,0,1,0,1,0
55542,445,0,0,70,70,0,1,0,1,0
60357,445,0,0,66,66,0,1,0,1,0
62009,445,0,0,70,70,0,1,0,1,0
59802,445,0,0,70,70,0,1,0,1,0
57281,445,0,0,70,70,0,1,0,1,0
49978,445,0,0,70,70,0,1,0,1,0
57927,445,0,0,70,70,0,1,0,1,0
49917,445,0,0,70,70,0,1,0,1,0
55597,445,0,0,70,70,0,1,0,1,0
57879,445,0,0,66,66,0,1,0,1,0
54009,445,0,0,66,66,0,1,0,1,0
57413,445,0,0,70,70,0,1,0,1,0
63985,445,0,0,70,70,0,1,0,1,0
58583,445,0,0,66,66,0,1,0,1,0
62640,445,0,0,70,70,0,1,0,1,0
65153,445,0,0,70,70,0,1,0,1,0
51080,445,0,0,66,66,0,1,0,1,0
61839,445,0,0,70,70,0,1,0,1,0
54986,445,0,0,70,70,0,1,0,1,0
50998,445,0,0,70,70,0,1,0,1,0
64273,445,0,0,66,66,0,1,0,1,0
57925,445,0,0,70,70,0,1,0,1,0
63068,445,0,0,66,66,0,1,0,1,0
61791,445,0,0,66,66,0,1,0,1,0
52804,445,0,0,70,70,0,1,0,1,0
54958,445,0,0,66,66,0,1,0,1,0
58138,445,0,0,70,70,0,1,0,1,0
51293,445,0,0,66,66,0,1,0,1,0
55166,445,0,0,70,70,0,1,0,1,0
59569,445,0,0,70,70,0,1,0,1,0
51788,445,0,0,70,70,0,1,0,1,0
61085,445,0,0,66,66,0,1,0,1,0
65071,445,0,0,70,70,0,1,0,1,0
55782,445,0,0,70,70,0,1,0,1,0
53294,445,0,0,70,70,0,1,0,1,0
50076,445,0,0,70,70,0,1,0,1,0
60861,445,0,0,66,66,0,1,0,1,0
52294,445,0,0,66,66,0,1,0,1,0
54359,445,0,0,70,70,0,1,0,1,0
57862,445,0,0,66,66,0,1,0,1,0
64101,445,0,0,66,66,0,1,0,1,0
62694,445,0,0,66,66,0,1,0,1,0
57572,445,0,0,70,70,0,1,0,1,0
59988,445,0,0,70,70,0,1,0,1,0
55342,445,0,0,70,70,0,1,0,1,0
52941,445,0,0,70,70,0,1,0,1,0
56081,445,0,0,70,70,0,1,0,1,0
60904,445,0,0,66,66,0,1,0,1,0
63440,445,0,0,66,66,0,1,0,1,0
58730,445,0,0,70,70,0,1,0,1,0
62748,445,0,0,66,66,0,1,0,1,0
49850,445,0,0,70,70,0,1,0,1,0
57493,445,0,0,70,70,0,1,0,1,0
59443,445,0,0,70,70,0,1,0,1,0
64839,445,0,0,70,70,0,1,0,1,0
62169,445,0,0,70,70,0,1,0,1,0
59652,445,0,0,70,70,0,1,0,1,0
63582,445,0,0,70,70,0,1,0,1,0
52641,445,0,0,70,70,0,1,0,1,0
60233,445,0,0,70,70,0,1,0,1,0
64183,445,0,0,66,66,0,1,0,1,0
55605,445,0,0,70,70,0,1,0,1,0
56025,445,0,0,70,70,0,1,0,1,0
53686,445,0,0,66,66,0,1,0,1,0
49542,445,0,0,66,66,0,1,0,1,0
61981,445,0,0,66,66,0,1,0,1,0
54247,445,0,0,66,66,0,1,0,1,0
64904,445,0,0,70,70,0,1,0,1,0
51289,445,0,0,70,70,0,1,0,1,0
49628,445,0,0,70,70,0,1,0,1,0
64418,445,0,0,70,70,0,1,0,1,0
56735,445,0,0,70,70,0,1,0,1,0
54231,445,0,0,70,70,0,1,0,1,0
63262,445,0,0,66,66,0,1,0,1,0
60859,445,0,0,70,70,0,1,0,1,0
57286,445,0,0,70,70,0,1,0,1,0
55551,445,0,0,70,70,0,1,0,1,0
53654,445,0,0,70,70,0,1,0,1,0
58949,445,0,0,66,66,0,1,0,1,0
58692,445,0,0,70,70,0,1,0,1,0
62717,445,0,0,66,66,0,1,0,1,0
59549,445,0,0,70,70,0,1,0,1,0
62597,445,0,0,70,70,0,1,0,1,0
58373,445,0,0,70,70,0,1,0,1,0
61156,445,0,0,70,70,0,1,0,1,0
59583,445,0,0,66,66,0,1,0,1,0
63500,445,0,0,66,66,0,1,0,1,0
52461,445,0,0,70,70,0,1,0,1,0
53083,445,0,0,70,70,0,1,0,1,0
55746,445,0,0,70,70,0,1,0,1,0
63955,445,0,0,66,66,0,1,0,1,0
58221,445,0,0,70,70,0,1,0,1,0
64305,445,0,0,70,70,0,1,0,1,0
64135,445,0,0,70,70,0,1,0,1,0
51492,445,0,0,70,70,0,1,0,1,0
61819,445,0,0,66,66,0,1,0,1,0
57527,445,0,0,70,70,0,1,0,1,0
62562,445,0,0,70,70,0,1,0,1,0
56833,445,0,0,70,70,0,1,0,1,0
56639,445,0,0,70,70,0,1,0,1,0
64660,445,0,0,66,66,0,1,0,1,0
50183,445,0,0,70,70,0,1,0,1,0
64070,445,0,0,70,70,0,1,0,1,0
52793,445,0,0,70,70,0,1,0,1,0
50867,445,0,0,70,70,0,1,0,1,0
54423,445,0,0,70,70,0,1,0,1,0
62995,445,0,0,70,70,0,1,0,1,0
61899,445,0,0,70,70,0,1,0,1,0
65072,445,0,0,70,70,0,1,0,1,0
57229,445,0,0,70,70,0,1,0,1,0
63064,445,0,0,70,70,0,1,0,1,0
50123,445,0,0,70,70,0,1,0,1,0
50546,445,0,0,66,66,0,1,0,1,0
50512,445,0,0,70,70,0,1,0,1,0
50095,445,0,0,66,66,0,1,0,1,0
65178,445,0,0,66,66,0,1,0,1,0
57632,445,0,0,66,66,0,1,0,1,0
65143,445,0,0,70,70,0,1,0,1,0
60444,445,0,0,70,70,0,1,0,1,0
62203,445,0,0,70,70,0,1,0,1,0
62081,445,0,0,70,70,0,1,0,1,0
64681,445,0,0,66,66,0,1,0,1,0
62781,445,0,0,70,70,0,1,0,1,0
57187,445,0,0,70,70,0,1,0,1,0
56014,445,0,0,70,70,0,1,0,1,0
64520,445,0,0,70,70,0,1,0,1,0
50934,445,0,0,66,66,0,1,0,1,0
64679,445,0,0,66,66,0,1,0,1,0
56572,445,0,0,70,70,0,1,0,1,0
53392,445,0,0,70,70,0,1,0,1,0
58685,445,0,0,66,66,0,1,0,1,0
51811,445,0,0,70,70,0,1,0,1,0
63908,445,0,0,66,66,0,1,0,1,0
56456,445,0,0,66,66,0,1,0,1,0
50895,445,0,0,70,70,0,1,0,1,0
49367,445,0,0,70,70,0,1,0,1,0
53986,445,0,0,70,70,0,1,0,1,0
60302,445,0,0,70,70,0,1,0,1,0
61650,445,0,0,70,70,0,1,0,1,0
51039,445,0,0,70,70,0,1,0,1,0
61145,445,0,0,70,70,0,1,0,1,0
51880,445,0,0,70,70,0,1,0,1,0
53193,445,0,0,70,70,0,1,0,1,0
57196,445,0,0,70,70,0,1,0,1,0
51080,445,0,0,70,70,0,1,0,1,0
60116,445,0,0,70,70,0,1,0,1,0
63482,445,0,0,70,70,0,1,0,1,0
65503,445,0,0,70,70,0,1,0,1,0
62057,445,0,0,70,70,0,1,0,1,0
51159,445,0,0,70,70,0,1,0,1,0
52693,445,0,0,70,70,0,1,0,1,0
50589,445,0,0,66,66,0,1,0,1,0
49860,445,0,0,70,70,0,1,0,1,0
53626,445,0,0,66,66,0,1,0,1,0
60502,445,0,0,66,66,0,1,0,1,0
63621,445,0,0,70,70,0,1,0,1,0
61599,445,0,0,70,70,0,1,0,1,0
50535,445,0,0,70,70,0,1,0,1,0
54559,445,0,0,66,66,0,1,0,1,0
52191,445,0,0,70,70,0,1,0,1,0
64457,445,0,0,70,70,0,1,0,1,0
55514,445,0,0,70,70,0,1,0,1,0
53467,445,0,0,70,70,0,1,0,1,0
56239,445,0,0,70,70,0,1,0,1,0
61630,445,0,0,66,66,0,1,0,1,0
50839,445,0,0,70,70,0,1,0,1,0
56535,445,0,0,70,70,0,1,0,1,0
58263,445,0,0,66,66,0,1,0,1,0
53235,445,0,0,70,70,0,1,0,1,0
53102,445,0,0,70,70,0,1,0,1,0
52699,445,0,0,70,70,0,1,0,1,0
60392,445,0,0,70,70,0,1,0,1,0
51007,445,0,0,70,70,0,1,0,1,0
51632,445,0,0,66,66,0,1,0,1,0
56059,445,0,0,70,70,0,1,0,1,0
62276,445,0,0,70,70,0,1,0,1,0
50068,445,0,0,66,66,0,1,0,1,0
50230,445,0,0,66,66,0,1,0,1,0
63348,445,0,0,70,70,0,1,0,1,0
56481,445,0,0,66,66,0,1,0,1,0
57140,445,0,0,70,70,0,1,0,1,0
57428,445,0,0,66,66,0,1,0,1,0
59787,445,0,0,66,66,0,1,0,1,0
50457,445,0,0,70,70,0,1,0,1,0
55514,445,0,0,70,70,0,1,0,1,0
59916,445,0,0,70,70,0,1,0,1,0
51858,445,0,0,70,70,0,1,0,1,0
50947,445,0,0,70,70,0,1,0,1,0
61377,445,0,0,70,70,0,1,0,1,0
51042,445,0,0,70,70,0,1,0,1,0
59867,445,0,0,70,70,0,1,0,1,0
57993,445,0,0,66,66,0,1,0,1,0
54699,445,0,0,70,70,0,1,0,1,0
60218,445,0,0,70,70,0,1,0,1,0
60214,445,0,0,66,66,0,1,0,1,0
61236,445,0,0,70,70,0,1,0,1,0
59718,445,0,0,70,70,0,1,0,1,0
52407,445,0,0,70,70,0,1,0,1,0
60849,445,0,0,70,70,0,1,0,1,0
51065,445,0,0,70,70,0,1,0,1,0
50119,445,0,0,70,70,0,1,0,1,0
54902,445,0,0,70,70,0,1,0,1,0
51684,445,0,0,66,66,0,1,0,1,0
60018,445,0,0,70,70,0,1,0,1,0
55803,445,0,0,66,66,0,1,0,1,0
53010,445,0,0,70,70,0,1,0,1,0
53169,445,0,0,66,66,0,1,0,1,0
57558,445,0,0,66,66,0,1,0,1,0
51548,445,0,0,70,70,0,1,0,1,0
49797,445,0,0,70,70,0,1,0,1,0
56544,445,0,0,70,70,0,1,0,1,0
52740,445,0,0,66,66,0,1,0,1,0
64922,445,0,0,70,70,0,1,0,1,0
61619,445,0,0,66,66,0,1,0,1,0
52443,445,0,0,70,70,0,1,0,1,0
60167,445,0,0,70,70,0,1,0,1,0
51959,445,0,0,70,70,0,1,0,1,0
60717,445,0,0,70,70,0,1,0,1,0
59630,445,0,0,70,70,0,1,0,1,0
52352,445,0,0,70,70,0,1,0,1,0
52471,445,0,0,66,66,0,1,0,1,0
63423,445,0,0,66,66,0,1,0,1,0
50229,445,0,0,66,66,0,1,0,1,0
65185,445,0,0,70,70,0,1,0,1,0
51908,445,0,0,66,66,0,1,0,1,0
59592,445,0,0,70,70,0,1,0,1,0
51203,445,0,0,70,70,0,1,0,1,0
49723,445,0,0,70,70,0,1,0,1,0
59518,445,0,0,70,70,0,1,0,1,0
51197,445,0,0,70,70,0,1,0,1,0
53428,445,0,0,66,66,0,1,0,1,0
54053,445,0,0,70,70,0,1,0,1,0
60148,445,0,0,70,70,0,1,0,1,0
64102,445,0,0,70,70,0,1,0,1,0
56399,445,0,0,70,70,0,1,0,1,0
49715,445,0,0,66,66,0,1,0,1,0
58503,445,0,0,66,66,0,1,0,1,0
58862,445,0,0,70,70,0,1,0,1,0
61419,445,0,0,66,66,0,1,0,1,0
62493,445,0,0,66,66,0,1,0,1,0
64975,445,0,0,70,70,0,1,0,1,0
63384,445,0,0,70,70,0,1,0,1,0
54874,445,0,0,70,70,0,1,0,1,0
49753,445,0,0,70,70,0,1,0,1,0
50880,445,0,0,70,70,0,1,0,1,0
64990,445,0,0,70,70,0,1,0,1,0
54330,445,0,0,66,66,0,1,0,1,0
59274,445,0,0,70,70,0,1,0,1,0
64714,445,0,0,70,70,0,1,0,1,0
64360,445,0,0,70,70,0,1,0,1,0
49894,445,0,0,66,66,0,1,0,1,0
51067,445,0,0,66,66,0,1,0,1,0
50285,445,0,0,66,66,0,1,0,1,0
61485,445,0,0,66,66,0,1,0,1,0
61063,445,0,0,66,66,0,1,0,1,0
49499,445,0,0,70,70,0,1,0,1,0
54652,445,0,0,66,66,0,1,0,1,0
59386,445,0,0,66,66,0,1,0,1,0
61107,445,0,0,70,70,0,1,0,1,0
55884,445,0,0,66,66,0,1,0,1,0
56439,445,0,0,70,70,0,1,0,1,0
51692,445,0,0,70,70,0,1,0,1,0
63111,445,0,0,70,70,0,1,0,1,0
54797,445,0,0,66,66,0,1,0,1,0
61051,445,0,0,70,70,0,1,0,1,0
63598,445,0,0,66,66,0,1,0,1,0
53578,445,0,0,70,70,0,1,0,1,0
55059,445,0,0,70,70,0,1,0,1,0
49266,445,0,0,70,70,0,1,0,1,0
58426,445,0,0,66,66,0,1,0,1,0
49487,445,0,0,66,66,0,1,0,1,0
63518,445,0,0,66,66,0,1,0,1,0
61235,445,0,0,70,70,0,1,0,1,0
61532,445,0,0,70,70,0,1,0,1,0
64468,445,0,0,70,70,0,1,0,1,0
62123,445,0,0,70,70,0,1,0,1,0
50747,445,0,0,70,70,0,1,0,1,0
51042,445,0,0,66,66,0,1,0,1,0
52355,445,0,0,70,70,0,1,0,1,0
51092,445,0,0,66,66,0,1,0,1,0
50750,445,0,0,66,66,0,1,0,1,0
59581,445,0,0,70,70,0,1,0,1,0
50128,445,0,0,70,70,0,1,0,1,0
53942,445,0,0,66,66,0,1,0,1,0
59062,445,0,0,70,70,0,1,0,1,0
58755,445,0,0,66,66,0,1,0,1,0
64151,445,0,0,70,70,0,1,0,1,0
58248,445,0,0,66,66,0,1,0,1,0
63852,445,0,0,66,66,0,1,0,1,0
58331,445,0,0,70,70,0,1,0,1,0
58402,445,0,0,66,66,0,1,0,1,0
57839,445,0,0,70,70,0,1,0,1,0
55651,445,0,0,70,70,0,1,0,1,0
59481,445,0,0,70,70,0,1,0,1,0
50065,445,0,0,70,70,0,1,0,1,0
59476,445,0,0,66,66,0,1,0,1,0
59159,445,0,0,70,70,0,1,0,1,0
50997,445,0,0,66,66,0,1,0,1,0
53688,445,0,0,70,70,0,1,0,1,0
57197,445,0,0,70,70,0,1,0,1,0
53259,445,0,0,70,70,0,1,0,1,0
50317,445,0,0,70,70,0,1,0,1,0
61691,445,0,0,70,70,0,1,0,1,0
56581,445,0,0,70,70,0,1,0,1,0
58311,445,0,0,66,66,0,1,0,1,0
62852,445,0,0,70,70,0,1,0,1,0
57071,445,0,0,70,70,0,1,0,1,0
63599,445,0,0,70,70,0,1,0,1,0
50597,445,0,0,70,70,0,1,0,1,0
50377,445,0,0,70,70,0,1,0,1,0
49369,445,0,0,70,70,0,1,0,1,0
52450,445,0,0,70,70,0,1,0,1,0
49524,445,0,0,66,66,0,1,0,1,0
60856,445,0,0,70,70,0,1,0,1,0
59038,445,0,0,70,70,0,1,0,1,0
60351,445,0,0,70,70,0,1,0,1,0
62553,445,0,0,66,66,0,1,0,1,0
58483,445,0,0,70,70,0,1,0,1,0
52608,445,0,0,70,70,0,1,0,1,0
58343,445,0,0,70,70,0,1,0,1,0
62560,445,0,0,70,70,0,1,0,1,0
55560,445,0,0,70,70,0,1,0,1,0
52786,445,0,0,66,66,0,1,0,1,0
56047,445,0,0,66,66,0,1,0,1,0
54351,445,0,0,70,70,0,1,0,1,0
60337,445,0,0,70,70,0,1,0,1,0
52228,445,0,0,70,70,0,1,0,1,0
63240,445,0,0,66,66,0,1,0,1,0
59601,445,0,0,70,70,0,1,0,1,0
63258,445,0,0,66,66,0,1,0,1,0
49533,445,0,0,70,70,0,1,0,1,0
64887,445,0,0,70,70,0,1,0,1,0
56815,445,0,0,70,70,0,1,0,1,0
50752,445,0,0,70,70,0,1,0,1,0
63957,445,0,0,66,66,0,1,0,1,0
57620,445,0,0,66,66,0,1,0,1,0
59896,445,0,0,70,70,0,1,0,1,0
59504,445,0,0,70,70,0,1,0,1,0
49954,445,0,0,66,66,0,1,0,1,0
55216,445,0,0,70,70,0,1,0,1,0
63104,445,0,0,70,70,0,1,0,1,0
54968,445,0,0,66,66,0,1,0,1,0
65423,445,0,0,70,70,0,1,0,1,0
56834,445,0,0,70,70,0,1,0,1,0
57379,445,0,0,70,70,0,1,0,1,0
55123,445,0,0,66,66,0,1,0,1,0
49727,445,0,0,70,70,0,1,0,1,0
54503,445,0,0,66,66,0,1,0,1,0
51433,445,0,0,70,70,0,1,0,1,0
62983,445,0,0,70,70,0,1,0,1,0
59961,445,0,0,70,70,0,1,0,1,0
50350,445,0,0,66,66,0,1,0,1,0
52049,445,0,0,70,70,0,1,0,1,0
55123,445,0,0,70,70,0,1,0,1,0
51525,445,0,0,70,70,0,1,0,1,0
54112,445,0,0,70,70,0,1,0,1,0
58286,445,0,0,70,70,0,1,0,1,0
50397,445,0,0,70,70,0,1,0,1,0
62668,445,0,0,70,70,0,1,0,1,0
60050,445,0,0,66,66,0,1,0,1,0
55919,445,0,0,66,66,0,1,0,1,0
65388,445,0,0,70,70,0,1,0,1,0
56789,445,0,0,70,70,0,1,0,1,0
55848,445,0,0,70,70,0,1,0,1,0
49708,445,0,0,70,70,0,1,0,1,0
53560,445,0,0,66,66,0,1,0,1,0
59712,445,0,0,70,70,0,1,0,1,0
56592,445,0,0,70,70,0,1,0,1,0
53718,445,0,0,70,70,0,1,0,1,0
55738,445,0,0,66,66,0,1,0,1,0
54493,445,0,0,70,70,0,1,0,1,0
50428,445,0,0,70,70,0,1,0,1,0
52483,445,0,0,70,70,0,1,0,1,0
64982,445,0,0,70,70,0,1,0,1,0
50475,445,0,0,70,70,0,1,0,1,0
52339,445,0,0,70,70,0,1,0,1,0
52393,445,0,0,66,66,0,1,0,1,0
56790,445,0,0,66,66,0,1,0,1,0
55500,445,0,0,70,70,0,1,0,1,0
63416,445,0,0,70,70,0,1,0,1,0
54040,445,0,0,70,70,0,1,0,1,0
52792,445,0,0,70,70,0,1,0,1,0
53597,445,0,0,70,70,0,1,0,1,0
64561,445,0,0,70,70,0,1,0,1,0
59062,445,0,0,70,70,0,1,0,1,0
61729,445,0,0,70,70,0,1,0,1,0
55339,445,0,0,66,66,0,1,0,1,0
60539,445,0,0,70,70,0,1,0,1,0
60110,445,0,0,66,66,0,1,0,1,0
51472,445,0,0,70,70,0,1,0,1,0
56171,445,0,0,70,70,0,1,0,1,0
49997,445,0,0,70,70,0,1,0,1,0
53114,445,0,0,66,66,0,1,0,1,0
65374,445,0,0,66,66,0,1,0,1,0
63827,445,0,0,66,66,0,1,0,1,0
64591,445,0,0,70,70,0,1,0,1,0
63132,445,0,0,70,70,0,1,0,1,0
58497,445,0,0,66,66,0,1,0,1,0
56709,445,0,0,66,66,0,1,0,1,0
65447,445,0,0,66,66,0,1,0,1,0
64800,445,0,0,70,70,0,1,0,1,0
54004,445,0,0,70,70,0,1,0,1,0
62620,445,0,0,70,70,0,1,0,1,0
56745,445,0,0,66,66,0,1,0,1,0
57322,445,0,0,70,70,0,1,0,1,0
65062,445,0,0,70,70,0,1,0,1,0
56961,445,0,0,66,66,0,1,0,1,0
58505,445,0,0,70,70,0,1,0,1,0
57357,445,0,0,70,70,0,1,0,1,0
59116,445,0,0,66,66,0,1,0,1,0
60957,445,0,0,70,70,0,1,0,1,0
55004,445,0,0,70,70,0,1,0,1,0
50659,445,0,0,66,66,0,1,0,1,0
61549,445,0,0,70,70,0,1,0,1,0
62053,445,0,0,66,66,0,1,0,1,0
57786,445,0,0,66,66,0,1,0,1,0
61515,445,0,0,66,66,0,1,0,1,0
58821,445,0,0,70,70,0,1,0,1,0
63873,445,0,0,66,66,0,1,0,1,0
49874,445,0,0,70,70,0,1,0,1,0
52420,445,0,0,70,70,0,1,0,1,0
63945,445,0,0,70,70,0,1,0,1,0
51672,445,0,0,70,70,0,1,0,1,0
50854,445,0,0,66,66,0,1,0,1,0
52474,445,0,0,70,70,0,1,0,1,0
50111,445,0,0,70,70,0,1,0,1,0
60896,445,0,0,66,66,0,1,0,1,0
60439,445,0,0,66,66,0,1,0,1,0
49808,445,0,0,70,70,0,1,0,1,0
60313,445,0,0,70,70,0,1,0,1,0
56984,445,0,0,70,70,0,1,0,1,0
54560,445,0,0,70,70,0,1,0,1,0
50850,445,0,0,66,66,0,1,0,1,0
52916,445,0,0,66,66,0,1,0,1,0
53317,445,0,0,70,70,0,1,0,1,0
53689,445,0,0,70,70,0,1,0,1,0
49182,445,0,0,66,66,0,1,0,1,0
55733,445,0,0,66,66,0,1,0,1,0
54113,445,0,0,70,70,0,1,0,1,0
63600,445,0,0,70,70,0,1,0,1,0
60989,445,0,0,66,66,0,1,0,1,0
49605,445,0,0,70,70,0,1,0,1,0
59197,445,0,0,70,70,0,1,0,1,0
55223,445,0,0,66,66,0,1,0,1,0
61494,445,0,0,66,66,0,1,0,1,0
53063,445,0,0,70,70,0,1,0,1,0
64611,445,0,0,70,70,0,1,0,1,0
54390,445,0,0,70,70,0,1,0,1,0
62340,445,0,0,70,70,0,1,0,1,0
59228,445,0,0,70,70,0,1,0,1,0
59482,445,0,0,70,70,0,1,0,1,0
57508,445,0,0,70,70,0,1,0,1,0
56322,445,0,0,66,66,0,1,0,1,0
50673,445,0,0,66,66,0,1,0,1,0
57862,445,0,0,70,70,0,1,0,1,0
57294,445,0,0,70,70,0,1,0,1,0
50521,445,0,0,70,70,0,1,0,1,0
58374,445,0,0,70,70,0,1,0,1,0
63904,445,0,0,66,66,0,1,0,1,0
51485,445,0,0,70,70,0,1,0,1,0
59383,445,0,0,70,70,0,1,0,1,0
61906,445,0,0,70,70,0,1,0,1,0
58165,445,0,0,66,66,0,1,0,1,0
49907,445,0,0,70,70,0,1,0,1,0
63772,445,0,0,66,66,0,1,0,1,0
50475,445,0,0,66,66,0,1,0,1,0
52220,445,0,0,70,70,0,1,0,1,0
50927,445,0,0,66,66,0,1,0,1,0
64030,445,0,0,70,70,0,1,0,1,0
63780,445,0,0,70,70,0,1,0,1,0
52139,445,0,0,66,66,0,1,0,1,0
54520,445,0,0,66,66,0,1,0,1,0
58826,445,0,0,66,66,0,1,0,1,0
64926,445,0,0,70,70,0,1,0,1,0
58784,445,0,0,66,66,0,1,0,1,0
50799,445,0,0,66,66,0,1,0,1,0
50977,445,0,0,66,66,0,1,0,1,0
53993,445,0,0,70,70,0,1,0,1,0
52977,445,0,0,70,70,0,1,0,1,0
57990,445,0,0,70,70,0,1,0,1,0
58566,445,0,0,70,70,0,1,0,1,0
58384,445,0,0,70,70,0,1,0,1,0
51712,445,0,0,70,70,0,1,0,1,0
53665,445,0,0,70,70,0,1,0,1,0
50528,445,0,0,70,70,0,1,0,1,0
62134,445,0,0,66,66,0,1,0,1,0
63264,445,0,0,70,70,0,1,0,1,0
49622,445,0,0,66,66,0,1,0,1,0
51514,445,0,0,66,66,0,1,0,1,0
57957,445,0,0,70,70,0,1,0,1,0
53764,445,0,0,70,70,0,1,0,1,0
56479,445,0,0,66,66,0,1,0,1,0
55874,445,0,0,70,70,0,1,0,1,0
51452,445,0,0,70,70,0,1,0,1,0
64388,445,0,0,70,70,0,1,0,1,0
58375,445,0,0,66,66,0,1,0,1,0
60424,445,0,0,70,70,0,1,0,1,0
54728,445,0,0,66,66,0,1,0,1,0
62108,445,0,0,70,70,0,1,0,1,0
50389,445,0,0,70,70,0,1,0,1,0
60143,445,0,0,70,70,0,1,0,1,0
52275,445,0,0,66,66,0,1,0,1,0
51931,445,0,0,70,70,0,1,0,1,0
51057,445,0,0,66,66,0,1,0,1,0
61482,445,0,0,70,70,0,1,0,1,0
49971,445,0,0,66,66,0,1,0,1,0
63053,445,0,0,66,66,0,1,0,1,0
62609,445,0,0,70,70,0,1,0,1,0
51669,445,0,0,70,70,0,1,0,1,0
51325,445,0,0,70,70,0,1,0,1,0
64245,445,0,0,70,70,0,1,0,1,0
64616,445,0,0,70,70,0,1,0,1,0
60665,445,0,0,70,70,0,1,0,1,0
58411,445,0,0,70,70,0,1,0,1,0
53865,445,0,0,66,66,0,1,0,1,0
63981,445,0,0,70,70,0,1,0,1,0
56556,445,0,0,70,70,0,1,0,1,0
63016,445,0,0,70,70,0,1,0,1,0
61108,445,0,0,66,66,0,1,0,1,0
58901,445,0,0,70,70,0,1,0,1,0
63494,445,0,0,70,70,0,1,0,1,0
52876,445,0,0,70,70,0,1,0,1,0
50328,445,0,0,70,70,0,1,0,1,0
49269,445,0,0,70,70,0,1,0,1,0
60817,445,0,0,70,70,0,1,0,1,0
50545,445,0,0,66,66,0,1,0,1,0
54432,445,0,0,66,66,0,1,0,1,0
50800,445,0,0,66,66,0,1,0,1,0
56004,445,0,0,66,66,0,1,0,1,0
56074,445,0,0,70,70,0,1,0,1,0
59908,445,0,0,70,70,0,1,0,1,0
57918,445,0,0,66,66,0,1,0,1,0
64707,445,0,0,70,70,0,1,0,1,0
63588,445,0,0,70,70,0,1,0,1,0
57350,445,0,0,66,66,0,1,0,1,0
55469,445,0,0,66,66,0,1,0,1,0
54178,445,0,0,70,70,0,1,0,1,0
61869,445,0,0,66,66,0,1,0,1,0
50352,445,0,0,66,66,0,1,0,1,0
52923,445,0,0,66,66,0,1,0,1,0
58190,445,0,0,70,70,0,1,0,1,0
63295,445,0,0,70,70,0,1,0,1,0
51461,445,0,0,70,70,0,1,0,1,0
50530,445,0,0,70,70,0,1,0,1,0
53343,445,0,0,70,70,0,1,0,1,0
57129,445,0,0,70,70,0,1,0,1,0
58435,445,0,0,70,70,0,1,0,1,0
55725,445,0,0,70,70,0,1,0,1,0
51313,445,0,0,66,66,0,1,0,1,0
63437,445,0,0,66,66,0,1,0,1,0
60593,445,0,0,66,66,0,1,0,1,0
57217,445,0,0,70,70,0,1,0,1,0
61235,445,0,0,66,66,0,1,0,1,0
62491,445,0,0,66,66,0,1,0,1,0
57628,445,0,0,70,70,0,1,0,1,0
50294,445,0,0,70,70,0,1,0,1,0
61248,445,0,0,70,70,0,1,0,1,0
63628,445,0,0,66,66,0,1,0,1,0
64928,445,0,0,70,70,0,1,0,1,0
61173,445,0,0,70,70,0,1,0,1,0
50969,445,0,0,70,70,0,1,0,1,0
50689,445,0,0,66,66,0,1,0,1,0
61467,445,0,0,66,66,0,1,0,1,0
49373,445,0,0,70,70,0,1,0,1,0
64813,445,0,0,70,70,0,1,0,1,0
60986,445,0,0,70,70,0,1,0,1,0
52766,445,0,0,66,66,0,1,0,1,0
63438,445,0,0,70,70,0,1,0,1,0
59718,445,0,0,66,66,0,1,0,1,0
55568,445,0,0,70,70,0,1,0,1,0
50422,445,0,0,66,66,0,1,0,1,0
63679,445,0,0,70,70,0,1,0,1,0
64685,445,0,0,70,70,0,1,0,1,0
57224,445,0,0,66,66,0,1,0,1,0
58962,445,0,0,70,70,0,1,0,1,0
49279,445,0,0,70,70,0,1,0,1,0
55456,445,0,0,70,70,0,1,0,1,0
57583,445,0,0,70,70,0,1,0,1,0
50192,445,0,0,70,70,0,1,0,1,0
55807,445,0,0,70,70,0,1,0,1,0
58505,445,0,0,66,66,0,1,0,1,0
63872,445,0,0,70,70,0,1,0,1,0
59099,445,0,0,66,66,0,1,0,1,0
60537,445,0,0,70,70,0,1,0,1,0
50705,445,0,0,70,70,0,1,0,1,0
63026,445,0,0,70,70,0,1,0,1,0
59474,445,0,0,66,66,0,1,0,1,0
50095,445,0,0,70,70,0,1,0,1,0
50808,445,0,0,66,66,0,1,0,1,0
55409,445,0,0,70,70,0,1,0,1,0
62371,445,0,0,70,70,0,1,0,1,0
57417,445,0,0,70,70,0,1,0,1,0
54807,445,0,0,66,66,0,1,0,1,0
50773,445,0,0,70,70,0,1,0,1,0
55042,445,0,0,70,70,0,1,0,1,0
58868,445,0,0,66,66,0,1,0,1,0
61073,445,0,0,70,70,0,1,0,1,0
63852,445,0,0,70,70,0,1,0,1,0
63037,445,0,0,70,70,0,1,0,1,0
62405,445,0,0,70,70,0,1,0,1,0
49941,445,0,0,70,70,0,1,0,1,0
52596,445,0,0,66,66,0,1,0,1,0
54033,445,0,0,70,70,0,1,0,1,0
50020,445,0,0,70,70,0,1,0,1,0
60417,445,0,0,66,66,0,1,0,1,0
51861,445,0,0,70,70,0,1,0,1,0
63213,445,0,0,70,70,0,1,0,1,0
51116,445,0,0,70,70,0,1,0,1,0
57132,445,0,0,70,70,0,1,0,1,0
61616,445,0,0,70,70,0,1,0,1,0
64727,445,0,0,66,66,0,1,0,1,0
57857,445,0,0,70,70,0,1,0,1,0
53855,445,0,0,70,70,0,1,0,1,0
55843,445,0,0,70,70,0,1,0,1,0
50152,445,0,0,70,70,0,1,0,1,0
52074,445,0,0,70,70,0,1,0,1,0
52307,445,0,0,70,70,0,1,0,1,0
53214,445,0,0,70,70,0,1,0,1,0
51080,445,0,0,66,66,0,1,0,1,0
54178,445,0,0,70,70,0,1,0,1,0
60760,445,0,0,70,70,0,1,0,1,0
51304,445,0,0,70,70,0,1,0,1,0
57258,445,0,0,66,66,0,1,0,1,0
58416,445,0,0,70,70,0,1,0,1,0
62541,445,0,0,70,70,0,1,0,1,0
57806,445,0,0,66,66,0,1,0,1,0
56206,445,0,0,70,70,0,1,0,1,0
54430,445,0,0,70,70,0,1,0,1,0
63795,445,0,0,70,70,0,1,0,1,0
60419,445,0,0,70,70,0,1,0,1,0
58287,445,0,0,70,70,0,1,0,1,0
51087,445,0,0,70,70,0,1,0,1,0
56153,445,0,0,70,70,0,1,0,1,0
54891,445,0,0,70,70,0,1,0,1,0
54612,445,0,0,66,66,0,1,0,1,0
63339,445,0,0,70,70,0,1,0,1,0
60048,445,0,0,66,66,0,1,0,1,0
56672,445,0,0,70,70,0,1,0,1,0
57325,445,0,0,70,70,0,1,0,1,0
62019,445,0,0,70,70,0,1,0,1,0
56980,445,0,0,66,66,0,1,0,1,0
56706,445,0,0,70,70,0,1,0,1,0
60558,445,0,0,70,70,0,1,0,1,0
53745,445,0,0,70,70,0,1,0,1,0
56020,445,0,0,66,66,0,1,0,1,0
50862,445,0,0,70,70,0,1,0,1,0
59053,445,0,0,70,70,0,1,0,1,0
63296,445,0,0,70,70,0,1,0,1,0
51897,445,0,0,66,66,0,1,0,1,0
52457,445,0,0,70,70,0,1,0,1,0
57859,445,0,0,70,70,0,1,0,1,0
59338,445,0,0,66,66,0,1,0,1,0
64389,445,0,0,70,70,0,1,0,1,0
57970,445,0,0,66,66,0,1,0,1,0
55625,445,0,0,66,66,0,1,0,1,0
61199,445,0,0,70,70,0,1,0,1,0
61276,445,0,0,70,70,0,1,0,1,0
50917,445,0,0,70,70,0,1,0,1,0
52536,445,0,0,66,66,0,1,0,1,0
64303,445,0,0,66,66,0,1,0,1,0
56964,445,0,0,70,70,0,1,0,1,0
53715,445,0,0,70,70,0,1,0,1,0
60650,445,0,0,70,70,0,1,0,1,0
58023,445,0,0,70,70,0,1,0,1,0
58249,445,0,0,66,66,0,1,0,1,0
60625,445,0,0,70,70,0,1,0,1,0
61017,445,0,0,70,70,0,1,0,1,0
52060,445,0,0,70,70,0,1,0,1,0
55030,445,0,0,70,70,0,1,0,1,0
54836,445,0,0,70,70,0,1,0,1,0
50586,445,0,0,70,70,0,1,0,1,0
61243,445,0,0,70,70,0,1,0,1,0
65077,445,0,0,70,70,0,1,0,1,0
64355,445,0,0,66,66,0,1,0,1,0
56220,445,0,0,70,70,0,1,0,1,0
63409,445,0,0,70,70,0,1,0,1,0
55300,445,0,0,70,70,0,1,0,1,0
62981,445,0,0,70,70,0,1,0,1,0
58200,445,0,0,70,70,0,1,0,1,0
59890,445,0,0,70,70,0,1,0,1,0
56503,445,0,0,66,66,0,1,0,1,0
60528,445,0,0,70,70,0,1,0,1,0
51620,445,0,0,70,70,0,1,0,1,0
51439,445,0,0,70,70,0,1,0,1,0
54789,445,0,0,70,70,0,1,0,1,0
55172,445,0,0,70,70,0,1,0,1,0
60117,445,0,0,70,70,0,1,0,1,0
62430,445,0,0,70,70,0,1,0,1,0
52524,445,0,0,66,66,0,1,0,1,0
65335,445,0,0,66,66,0,1,0,1,0
54950,445,0,0,70,70,0,1,0,1,0
64661,445,0,0,66,66,0,1,0,1,0
61927,445,0,0,70,70,0,1,0,1,0
57706,445,0,0,70,70,0,1,0,1,0
64461,445,0,0,70,70,0,1,0,1,0
49790,445,0,0,66,66,0,1,0,1,0
60866,445,0,0,70,70,0,1,0,1,0
65365,445,0,0,70,70,0,1,0,1,0
50739,445,0,0,66,66,0,1,0,1,0
59216,445,0,0,70,70,0,1,0,1,0
51938,445,0,0,70,70,0,1,0,1,0
51183,445,0,0,66,66,0,1,0,1,0
51048,445,0,0,70,70,0,1,0,1,0
61189,445,0,0,70,70,0,1,0,1,0
62867,445,0,0,70,70,0,1,0,1,0
58342,445,0,0,70,70,0,1,0,1,0
51051,445,0,0,66,66,0,1,0,1,0
63305,445,0,0,70,70,0,1,0,1,0
64689,445,0,0,66,66,0,1,0,1,0
50738,445,0,0,70,70,0,1,0,1,0
50970,445,0,0,70,70,0,1,0,1,0
59635,445,0,0,70,70,0,1,0,1,0
54988,445,0,0,66,66,0,1,0,1,0
58093,445,0,0,70,70,0,1,0,1,0
62798,445,0,0,66,66,0,1,0,1,0
51695,445,0,0,70,70,0,1,0,1,0
64632,445,0,0,66,66,0,1,0,1,0
52041,445,0,0,66,66,0,1,0,1,0
57089,445,0,0,70,70,0,1,0,1,0
58059,445,0,0,70,70,0,1,0,1,0
65355,445,0,0,70,70,0,1,0,1,0
53165,445,0,0,70,70,0,1,0,1,0
54654,445,0,0,66,66,0,1,0,1,0
53727,445,0,0,70,70,0,1,0,1,0
54234,445,0,0,70,70,0,1,0,1,0
56547,445,0,0,70,70,0,1,0,1,0
53404,445,0,0,70,70,0,1,0,1,0
51104,445,0,0,70,70,0,1,0,1,0
59101,445,0,0,70,70,0,1,0,1,0
64591,445,0,0,70,70,0,1,0,1,0
57038,445,0,0,70,70,0,1,0,1,0
63320,445,0,0,70,70,0,1,0,1,0
52476,445,0,0,66,66,0,1,0,1,0
61731,445,0,0,70,70,0,1,0,1,0
64939,445,0,0,70,70,0,1,0,1,0
55463,445,0,0,70,70,0,1,0,1,0
50118,445,0,0,70,70,0,1,0,1,0
50635,445,0,0,70,70,0,1,0,1,0
50485,445,0,0,66,66,0,1,0,1,0
54902,445,0,0,66,66,0,1,0,1,0
59210,445,0,0,66,66,0,1,0,1,0
54569,445,0,0,70,70,0,1,0,1,0
62833,445,0,0,70,70,0,1,0,1,0
60916,445,0,0,70,70,0,1,0,1,0
64075,445,0,0,70,70,0,1,0,1,0
49942,445,0,0,70,70,0,1,0,1,0
63435,445,0,0,70,70,0,1,0,1,0
57026,445,0,0,70,70,0,1,0,1,0
50023,445,0,0,66,66,0,1,0,1,0
50404,445,0,0,70,70,0,1,0,1,0
54200,445,0,0,70,70,0,1,0,1,0
54006,445,0,0,66,66,0,1,0,1,0
64790,445,0,0,66,66,0,1,0,1,0
64165,445,0,0,66,66,0,1,0,1,0
54010,445,0,0,66,66,0,1,0,1,0
53487,445,0,0,70,70,0,1,0,1,0
59954,445,0,0,66,66,0,1,0,1,0
58040,445,0,0,70,70,0,1,0,1,0
65158,445,0,0,70,70,0,1,0,1,0
56641,445,0,0,66,66,0,1,0,1,0
50066,445,0,0,70,70,0,1,0,1,0
50274,445,0,0,70,70,0,1,0,1,0
54592,445,0,0,70,70,0,1,0,1,0
62869,445,0,0,66,66,0,1,0,1,0
61656,445,0,0,66,66,0,1,0,1,0
60594,445,0,0,70,70,0,1,0,1,0
56552,445,0,0,70,70,0,1,0,1,0
52501,445,0,0,70,70,0,1,0,1,0
59341,445,0,0,66,66,0,1,0,1,0
56900,445,0,0,70,70,0,1,0,1,0
49781,445,0,0,70,70,0,1,0,1,0
60504,445,0,0,66,66,0,1,0,1,0
62548,445,0,0,70,70,0,1,0,1,0
51308,445,0,0,70,70,0,1,0,1,0
55645,445,0,0,70,70,0,1,0,1,0
54028,445,0,0,70,70,0,1,0,1,0
65058,445,0,0,70,70,0,1,0,1,0
50487,445,0,0,70,70,0,1,0,1,0
56200,445,0,0,70,70,0,1,0,1,0
61546,445,0,0,66,66,0,1,0,1,0
62516,445,0,0,70,70,0,1,0,1,0
63882,445,0,0,70,70,0,1,0,1,0
49379,445,0,0,66,66,0,1,0,1,0
56819,445,0,0,66,66,0,1,0,1,0
57601,445,0,0,66,66,0,1,0,1,0
52978,445,0,0,70,70,0,1,0,1,0
50432,445,0,0,66,66,0,1,0,1,0
53672,445,0,0,70,70,0,1,0,1,0
64489,445,0,0,70,70,0,1,0,1,0
59303,445,0,0,66,66,0,1,0,1,0
62982,445,0,0,66,66,0,1,0,1,0
50478,445,0,0,70,70,0,1,0,1,0
61688,445,0,0,70,70,0,1,0,1,0
53665,445,0,0,70,70,0,1,0,1,0
50863,445,0,0,66,66,0,1,0,1,0
61751,445,0,0,70,70,0,1,0,1,0
61029,445,0,0,70,70,0,1,0,1,0
58482,445,0,0,70,70,0,1,0,1,0
54594,445,0,0,70,70,0,1,0,1,0
58645,445,0,0,70,70,0,1,0,1,0
49462,445,0,0,66,66,0,1,0,1,0
52591,445,0,0,70,70,0,1,0,1,0
61339,445,0,0,66,66,0,1,0,1,0
51052,445,0,0,70,70,0,1,0,1,0
50466,445,0,0,66,66,0,1,0,1,0
49448,445,0,0,70,70,0,1,0,1,0
61571,445,0,0,70,70,0,1,0,1,0
57804,445,0,0,70,70,0,1,0,1,0
51918,445,0,0,70,70,0,1,0,1,0
50722,445,0,0,70,70,0,1,0,1,0
59401,445,0,0,66,66,0,1,0,1,0
55712,445,0,0,70,70,0,1,0,1,0
51882,445,0,0,70,70,0,1,0,1,0
61204,445,0,0,70,70,0,1,0,1,0
65487,445,0,0,70,70,0,1,0,1,0
50674,445,0,0,66,66,0,1,0,1,0
59868,445,0,0,70,70,0,1,0,1,0
60142,445,0,0,70,70,0,1,0,1,0
63071,445,0,0,70,70,0,1,0,1,0
59142,445,0,0,66,66,0,1,0,1,0
51487,445,0,0,70,70,0,1,0,1,0
60868,445,0,0,70,70,0,1,0,1,0
62352,445,0,0,70,70,0,1,0,1,0
50721,445,0,0,66,66,0,1,0,1,0
59293,445,0,0,66,66,0,1,0,1,0
53819,445,0,0,70,70,0,1,0,1,0
52435,445,0,0,70,70,0,1,0,1,0
49934,445,0,0,70,70,0,1,0,1,0
61475,445,0,0,66,66,0,1,0,1,0
55769,445,0,0,66,66,0,1,0,1,0
65145,445,0,0,70,70,0,1,0,1,0
55303,445,0,0,70,70,0,1,0,1,0
61885,445,0,0,66,66,0,1,0,1,0
52385,445,0,0,70,70,0,1,0,1,0
51913,445,0,0,70,70,0,1,0,1,0
60792,445,0,0,70,70,0,1,0,1,0
58777,445,0,0,70,70,0,1,0,1,0
65265,445,0,0,70,70,0,1,0,1,0
65247,445,0,0,70,70,0,1,0,1,0
58859,445,0,0,70,70,0,1,0,1,0
64553,445,0,0,66,66,0,1,0,1,0
52072,445,0,0,66,66,0,1,0,1,0
57711,445,0,0,70,70,0,1,0,1,0
49753,445,0,0,70,70,0,1,0,1,0
52748,445,0,0,70,70,0,1,0,1,0
55400,445,0,0,66,66,0,1,0,1,0
63672,445,0,0,70,70,0,1,0,1,0
55120,445,0,0,70,70,0,1,0,1,0
53504,445,0,0,70,70,0,1,0,1,0
49535,445,0,0,66,66,0,1,0,1,0
52117,445,0,0,70,70,0,1,0,1,0
54873,445,0,0,70,70,0,1,0,1,0
55484,445,0,0,66,66,0,1,0,1,0
61435,445,0,0,70,70,0,1,0,1,0
50720,445,0,0,70,70,0,1,0,1,0
52292,445,0,0,70,70,0,1,0,1,0
58952,445,0,0,70,70,0,1,0,1,0
58519,445,0,0,66,66,0,1,0,1,0
63002,445,0,0,70,70,0,1,0,1,0
50880,445,0,0,70,70,0,1,0,1,0
60666,445,0,0,70,70,0,1,0,1,0
50228,445,0,0,66,66,0,1,0,1,0
52120,445,0,0,70,70,0,1,0,1,0
56006,445,0,0,70,70,0,1,0,1,0
51773,445,0,0,66,66,0,1,0,1,0
54795,445,0,0,70,70,0,1,0,1,0
57444,445,0,0,70,70,0,1,0,1,0
53964,445,0,0,70,70,0,1,0,1,0
55593,445,0,0,70,70,0,1,0,1,0
54360,445,0,0,70,70,0,1,0,1,0
63537,445,0,0,70,70,0,1,0,1,0
55681,445,0,0,66,66,0,1,0,1,0
53487,445,0,0,70,70,0,1,0,1,0
49685,445,0,0,70,70,0,1,0,1,0
52749,445,0,0,70,70,0,1,0,1,0
49363,445,0,0,70,70,0,1,0,1,0
53409,445,0,0,70,70,0,1,0,1,0
60701,445,0,0,70,70,0,1,0,1,0
50899,445,0,0,70,70,0,1,0,1,0
49396,445,0,0,66,66,0,1,0,1,0
62804,445,0,0,70,70,0,1,0,1,0
54701,445,0,0,70,70,0,1,0,1,0
61761,445,0,0,70,70,0,1,0,1,0
50893,445,0,0,70,70,0,1,0,1,0
53635,445,0,0,70,70,0,1,0,1,0
49451,445,0,0,70,70,0,1,0,1,0
50778,445,0,0,70,70,0,1,0,1,0
53981,445,0,0,70,70,0,1,0,1,0
64717,445,0,0,70,70,0,1,0,1,0
50415,445,0,0,66,66,0,1,0,1,0
55415,445,0,0,70,70,0,1,0,1,0
53258,445,0,0,66,66,0,1,0,1,0
64629,445,0,0,66,66,0,1,0,1,0
62795,445,0,0,66,66,0,1,0,1,0
63427,445,0,0,70,70,0,1,0,1,0
52486,445,0,0,66,66,0,1,0,1,0
50522,445,0,0,70,70,0,1,0,1,0
54874,445,0,0,70,70,0,1,0,1,0
65511,445,0,0,70,70,0,1,0,1,0
51463,445,0,0,70,70,0,1,0,1,0
54387,445,0,0,70,70,0,1,0,1,0
64878,445,0,0,66,66,0,1,0,1,0
50980,445,0,0,70,70,0,1,0,1,0
63776,445,0,0,66,66,0,1,0,1,0
55714,445,0,0,70,70,0,1,0,1,0
61334,445,0,0,70,70,0,1,0,1,0
63851,445,0,0,70,70,0,1,0,1,0
63989,445,0,0,66,66,0,1,0,1,0
55583,445,0,0,66,66,0,1,0,1,0
63669,445,0,0,70,70,0,1,0,1,0
50652,445,0,0,70,70,0,1,0,1,0
54176,445,0,0,66,66,0,1,0,1,0
59407,445,0,0,70,70,0,1,0,1,0
49961,445,0,0,70,70,0,1,0,1,0
49754,445,0,0,70,70,0,1,0,1,0
49508,445,0,0,66,66,0,1,0,1,0
59191,445,0,0,70,70,0,1,0,1,0
61147,445,0,0,70,70,0,1,0,1,0
51504,445,0,0,66,66,0,1,0,1,0
62598,445,0,0,66,66,0,1,0,1,0
57343,445,0,0,70,70,0,1,0,1,0
50496,445,0,0,70,70,0,1,0,1,0
54114,445,0,0,70,70,0,1,0,1,0
62157,445,0,0,66,66,0,1,0,1,0
61800,445,0,0,66,66,0,1,0,1,0
60557,445,0,0,70,70,0,1,0,1,0
58536,445,0,0,70,70,0,1,0,1,0
52930,445,0,0,70,70,0,1,0,1,0
61002,445,0,0,66,66,0,1,0,1,0
56755,445,0,0,70,70,0,1,0,1,0
59016,445,0,0,70,70,0,1,0,1,0
60171,445,0,0,70,70,0,1,0,1,0
63558,445,0,0,70,70,0,1,0,1,0
60774,445,0,0,66,66,0,1,0,1,0
59824,445,0,0,70,70,0,1,0,1,0
59661,445,0,0,66,66,0,1,0,1,0
59658,445,0,0,70,70,0,1,0,1,0
57097,445,0,0,66,66,0,1,0,1,0
51370,445,0,0,70,70,0,1,0,1,0
59015,445,0,0,66,66,0,1,0,1,0
64336,445,0,0,70,70,0,1,0,1,0
58913,445,0,0,66,66,0,1,0,1,0
61162,445,0,0,70,70,0,1,0,1,0
57123,445,0,0,70,70,0,1,0,1,0
60805,445,0,0,70,70,0,1,0,1,0
52622,445,0,0,70,70,0,1,0,1,0
59993,445,0,0,70,70,0,1,0,1,0
60249,445,0,0,66,66,0,1,0,1,0
63758,445,0,0,66,66,0,1,0,1,0
50726,445,0,0,70,70,0,1,0,1,0
64653,445,0,0,70,70,0,1,0,1,0
54289,445,0,0,70,70,0,1,0,1,0
54331,445,0,0,70,70,0,1,0,1,0
61718,445,0,0,70,70,0,1,0,1,0
59339,445,0,0,66,66,0,1,0,1,0
53126,445,0,0,70,70,0,1,0,1,0
55567,445,0,0,66,66,0,1,0,1,0
59353,445,0,0,70,70,0,1,0,1,0
50818,445,0,0,70,70,0,1,0,1,0
62401,445,0,0,70,70,0,1,0,1,0
59982,445,0,0,70,70,0,1,0,1,0
57026,445,0,0,66,66,0,1,0,1,0
55665,445,0,0,70,70,0,1,0,1,0
53212,445,0,0,70,70,0,1,0,1,0
58438,445,0,0,70,70,0,1,0,1,0
55659,445,0,0,70,70,0,1,0,1,0
59396,445,0,0,70,70,0,1,0,1,0
50735,445,0,0,66,66,0,1,0,1,0
50140,445,0,0,70,70,0,1,0,1,0
56511,445,0,0,66,66,0,1,0,1,0
51962,445,0,0,66,66,0,1,0,1,0
63967,445,0,0,66,66,0,1,0,1,0
59301,445,0,0,66,66,0,1,0,1,0
61585,445,0,0,70,70,0,1,0,1,0
52828,445,0,0,70,70,0,1,0,1,0
62977,445,0,0,70,70,0,1,0,1,0
61096,445,0,0,66,66,0,1,0,1,0
50125,445,0,0,66,66,0,1,0,1,0
60446,445,0,0,66,66,0,1,0,1,0
53157,445,0,0,70,70,0,1,0,1,0
56584,445,0,0,70,70,0,1,0,1,0
49578,445,0,0,70,70,0,1,0,1,0
65131,445,0,0,70,70,0,1,0,1,0
59767,445,0,0,70,70,0,1,0,1,0
50741,445,0,0,66,66,0,1,0,1,0
62571,445,0,0,66,66,0,1,0,1,0
58643,445,0,0,70,70,0,1,0,1,0
59887,445,0,0,70,70,0,1,0,1,0
49450,445,0,0,70,70,0,1,0,1,0
49760,445,0,0,70,70,0,1,0,1,0
53425,445,0,0,66,66,0,1,0,1,0
60688,445,0,0,70,70,0,1,0,1,0
63510,445,0,0,70,70,0,1,0,1,0
62442,445,0,0,66,66,0,1,0,1,0
55976,445,0,0,70,70,0,1,0,1,0
63050,445,0,0,66,66,0,1,0,1,0
55614,445,0,0,66,66,0,1,0,1,0
58599,445,0,0,66,66,0,1,0,1,0
60741,445,0,0,70,70,0,1,0,1,0
62664,445,0,0,70,70,0,1,0,1,0
64891,445,0,0,70,70,0,1,0,1,0
52718,445,0,0,70,70,0,1,0,1,0
55642,445,0,0,70,70,0,1,0,1,0
64930,445,0,0,70,70,0,1,0,1,0
56089,445,0,0,70,70,0,1,0,1,0
62273,445,0,0,70,70,0,1,0,1,0
64101,445,0,0,70,70,0,1,0,1,0
59340,445,0,0,70,70,0,1,0,1,0
54526,445,0,0,70,70,0,1,0,1,0
51204,445,0,0,70,70,0,1,0,1,0
61449,445,0,0,66,66,0,1,0,1,0
55467,445,0,0,70,70,0,1,0,1,0
51502,445,0,0,70,70,0,1,0,1,0
61270,445,0,0,70,70,0,1,0,1,0
64429,445,0,0,70,70,0,1,0,1,0
52092,445,0,0,66,66,0,1,0,1,0
63907,445,0,0,66,66,0,1,0,1,0
61414,445,0,0,70,70,0,1,0,1,0
54390,445,0,0,66,66,0,1,0,1,0
54821,445,0,0,70,70,0,1,0,1,0
59044,445,0,0,66,66,0,1,0,1,0
57789,445,0,0,66,66,0,1,0,1,0
55869,445,0,0,70,70,0,1,0,1,0
64004,445,0,0,70,70,0,1,0,1,0
58888,445,0,0,70,70,0,1,0,1,0
50566,445,0,0,70,70,0,1,0,1,0
55805,445,0,0,70,70,0,1,0,1,0
64203,445,0,0,70,70,0,1,0,1,0
65156,445,0,0,70,70,0,1,0,1,0
64957,445,0,0,70,70,0,1,0,1,0
49864,445,0,0,70,70,0,1,0,1,0
57236,445,0,0,70,70,0,1,0,1,0
56447,445,0,0,70,70,0,1,0,1,0
61626,445,0,0,70,70,0,1,0,1,0
60212,445,0,0,70,70,0,1,0,1,0
61637,445,0,0,70,70,0,1,0,1,0
60114,445,0,0,70,70,0,1,0,1,0
53696,445,0,0,66,66,0,1,0,1,0
60119,445,0,0,70,70,0,1,0,1,0
57029,445,0,0,70,70,0,1,0,1,0
63015,445,0,0,70,70,0,1,0,1,0
60204,445,0,0,66,66,0,1,0,1,0
50818,445,0,0,66,66,0,1,0,1,0
63711,445,0,0,70,70,0,1,0,1,0
63906,445,0,0,70,70,0,1,0,1,0
60593,445,0,0,70,70,0,1,0,1,0
62225,445,0,0,70,70,0,1,0,1,0
50530,445,0,0,70,70,0,1,0,1,0
53321,445,0,0,66,66,0,1,0,1,0
53481,445,0,0,66,66,0,1,0,1,0
50731,445,0,0,66,66,0,1,0,1,0
60159,445,0,0,66,66,0,1,0,1,0
62397,445,0,0,66,66,0,1,0,1,0
61402,445,0,0,70,70,0,1,0,1,0
51241,445,0,0,66,66,0,1,0,1,0
56583,445,0,0,70,70,0,1,0,1,0
60423,445,0,0,70,70,0,1,0,1,0
59843,445,0,0,70,70,0,1,0,1,0
54844,445,0,0,70,70,0,1,0,1,0
55473,445,0,0,66,66,0,1,0,1,0
49491,445,0,0,70,70,0,1,0,1,0
56914,445,0,0,66,66,0,1,0,1,0
63072,445,0,0,66,66,0,1,0,1,0
52840,445,0,0,66,66,0,1,0,1,0
58190,445,0,0,66,66,0,1,0,1,0
65247,445,0,0,70,70,0,1,0,1,0
52637,445,0,0,70,70,0,1,0,1,0
49882,445,0,0,70,70,0,1,0,1,0
63802,445,0,0,66,66,0,1,0,1,0
58189,445,0,0,70,70,0,1,0,1,0
64680,445,0,0,66,66,0,1,0,1,0
65161,445,0,0,70,70,0,1,0,1,0
55264,445,0,0,70,70,0,1,0,1,0
63773,445,0,0,66,66,0,1,0,1,0
64743,445,0,0,70,70,0,1,0,1,0
52200,445,0,0,66,66,0,1,0,1,0
64485,445,0,0,70,70,0,1,0,1,0
50848,445,0,0,66,66,0,1,0,1,0
63091,445,0,0,70,70,0,1,0,1,0
50869,445,0,0,66,66,0,1,0,1,0
57196,445,0,0,70,70,0,1,0,1,0
53602,445,0,0,70,70,0,1,0,1,0
55804,445,0,0,70,70,0,1,0,1,0
54463,445,0,0,70,70,0,1,0,1,0
57414,445,0,0,66,66,0,1,0,1,0
53021,445,0,0,70,70,0,1,0,1,0
61246,445,0,0,66,66,0,1,0,1,0
57074,445,0,0,66,66,0,1,0,1,0
54014,445,0,0,70,70,0,1,0,1,0
54783,445,0,0,70,70,0,1,0,1,0
49211,445,0,0,70,70,0,1,0,1,0
50099,445,0,0,66,66,0,1,0,1,0
55895,445,0,0,70,70,0,1,0,1,0
50423,445,0,0,70,70,0,1,0,1,0
53524,445,0,0,70,70,0,1,0,1,0
51410,445,0,0,70,70,0,1,0,1,0
56063,445,0,0,66,66,0,1,0,1,0
51397,445,0,0,66,66,0,1,0,1,0
61760,445,0,0,70,70,0,1,0,1,0
50799,445,0,0,66,66,0,1,0,1,0
59947,445,0,0,66,66,0,1,0,1,0
58244,445,0,0,66,66,0,1,0,1,0
64499,445,0,0,70,70,0,1,0,1,0
50647,445,0,0,66,66,0,1,0,1,0
51118,445,0,0,70,70,0,1,0,1,0
60573,445,0,0,70,70,0,1,0,1,0
51214,445,0,0,70,70,0,1,0,1,0
55516,445,0,0,70,70,0,1,0,1,0
55500,445,0,0,70,70,0,1,0,1,0
65114,445,0,0,70,70,0,1,0,1,0
60311,445,0,0,70,70,0,1,0,1,0
62568,445,0,0,70,70,0,1,0,1,0
57161,445,0,0,70,70,0,1,0,1,0
55162,445,0,0,66,66,0,1,0,1,0
51194,445,0,0,66,66,0,1,0,1,0
64472,445,0,0,66,66,0,1,0,1,0
52303,445,0,0,70,70,0,1,0,1,0
50882,445,0,0,70,70,0,1,0,1,0
56287,445,0,0,70,70,0,1,0,1,0
51560,445,0,0,70,70,0,1,0,1,0
55608,445,0,0,66,66,0,1,0,1,0
50530,445,0,0,70,70,0,1,0,1,0
59644,445,0,0,66,66,0,1,0,1,0
64052,445,0,0,70,70,0,1,0,1,0
58658,445,0,0,70,70,0,1,0,1,0
52869,445,0,0,70,70,0,1,0,1,0
55180,445,0,0,70,70,0,1,0,1,0
58517,445,0,0,70,70,0,1,0,1,0
61929,445,0,0,70,70,0,1,0,1,0
55420,445,0,0,70,70,0,1,0,1,0
57373,445,0,0,70,70,0,1,0,1,0
57569,445,0,0,70,70,0,1,0,1,0
61913,445,0,0,70,70,0,1,0,1,0
49793,445,0,0,70,70,0,1,0,1,0
51590,445,0,0,70,70,0,1,0,1,0
61135,445,0,0,70,70,0,1,0,1,0
58833,445,0,0,70,70,0,1,0,1,0
51493,445,0,0,70,70,0,1,0,1,0
62253,445,0,0,66,66,0,1,0,1,0
59255,445,0,0,66,66,0,1,0,1,0
60206,445,0,0,70,70,0,1,0,1,0
61803,445,0,0,70,70,0,1,0,1,0
50707,445,0,0,70,70,0,1,0,1,0
57301,445,0,0,70,70,0,1,0,1,0
65451,445,0,0,66,66,0,1,0,1,0
54108,445,0,0,70,70,0,1,0,1,0
59574,445,0,0,70,70,0,1,0,1,0
53917,445,0,0,66,66,0,1,0,1,0
62852,445,0,0,70,70,0,1,0,1,0
58986,445,0,0,66,66,0,1,0,1,0
50418,445,0,0,66,66,0,1,0,1,0
64586,445,0,0,66,66,0,1,0,1,0
56146,445,0,0,66,66,0,1,0,1,0
63307,445,0,0,66,66,0,1,0,1,0
54129,445,0,0,70,70,0,1,0,1,0
55114,445,0,0,66,66,0,1,0,1,0
60646,445,0,0,70,70,0,1,0,1,0
51097,445,0,0,70,70,0,1,0,1,0
51762,445,0,0,66,66,0,1,0,1,0
50178,445,0,0,70,70,0,1,0,1,0
49648,445,0,0,66,66,0,1,0,1,0
61757,445,0,0,66,66,0,1,0,1,0
53373,445,0,0,70,70,0,1,0,1,0
55755,445,0,0,66,66,0,1,0,1,0
63462,445,0,0,70,70,0,1,0,1,0
63972,445,0,0,70,70,0,1,0,1,0
51185,445,0,0,66,66,0,1,0,1,0
63200,445,0,0,66,66,0,1,0,1,0
58795,445,0,0,70,70,0,1,0,1,0
59871,445,0,0,70,70,0,1,0,1,0
60932,445,0,0,70,70,0,1,0,1,0
61075,445,0,0,70,70,0,1,0,1,0
60891,445,0,0,66,66,0,1,0,1,0
54956,445,0,0,70,70,0,1,0,1,0
57528,445,0,0,66,66,0,1,0,1,0
58612,445,0,0,70,70,0,1,0,1,0
50905,445,0,0,70,70,0,1,0,1,0
64104,445,0,0,70,70,0,1,0,1,0
56307,445,0,0,66,66,0,1,0,1,0
51373,445,0,0,66,66,0,1,0,1,0
54731,445,0,0,66,66,0,1,0,1,0
50998,445,0,0,66,66,0,1,0,1,0
52971,445,0,0,70,70,0,1,0,1,0
53881,445,0,0,66,66,0,1,0,1,0
49232,445,0,0,70,70,0,1,0,1,0
51946,445,0,0,70,70,0,1,0,1,0
49470,445,0,0,66,66,0,1,0,1,0
64812,445,0,0,70,70,0,1,0,1,0
55677,445,0,0,66,66,0,1,0,1,0
51914,445,0,0,66,66,0,1,0,1,0
52549,445,0,0,66,66,0,1,0,1,0
54871,445,0,0,70,70,0,1,0,1,0
59149,445,0,0,70,70,0,1,0,1,0
63459,445,0,0,66,66,0,1,0,1,0
49872,445,0,0,70,70,0,1,0,1,0
64225,445,0,0,70,70,0,1,0,1,0
51397,445,0,0,70,70,0,1,0,1,0
54343,445,0,0,70,70,0,1,0,1,0
54682,445,0,0,70,70,0,1,0,1,0
49988,445,0,0,70,70,0,1,0,1,0
52852,445,0,0,66,66,0,1,0,1,0
53104,445,0,0,70,70,0,1,0,1,0
60118,445,0,0,66,66,0,1,0,1,0
64775,445,0,0,70,70,0,1,0,1,0
50270,445,0,0,66,66,0,1,0,1,0
59051,445,0,0,70,70,0,1,0,1,0
55736,445,0,0,66,66,0,1,0,1,0
56516,445,0,0,70,70,0,1,0,1,0
58761,445,0,0,70,70,0,1,0,1,0
58213,445,0,0,70,70,0,1,0,1,0
62933,445,0,0,70,70,0,1,0,1,0
64729,445,0,0,70,70,0,1,0,1,0
60098,445,0,0,66,66,0,1,0,1,0
50578,445,0,0,66,66,0,1,0,1,0
52309,445,0,0,70,70,0,1,0,1,0
56395,445,0,0,66,66,0,1,0,1,0
49824,445,0,0,66,66,0,1,0,1,0
50040,445,0,0,70,70,0,1,0,1,0
64712,445,0,0,70,70,0,1,0,1,0
53757,445,0,0,66,66,0,1,0,1,0
52378,445,0,0,70,70,0,1,0,1,0
51621,445,0,0,70,70,0,1,0,1,0
49581,445,0,0,70,70,0,1,0,1,0
59055,445,0,0,70,70,0,1,0,1,0
60959,445,0,0,70,70,0,1,0,1,0
54615,445,0,0,70,70,0,1,0,1,0
54115,445,0,0,70,70,0,1,0,1,0
54365,445,0,0,70,70,0,1,0,1,0
56348,445,0,0,70,70,0,1,0,1,0
56164,445,0,0,70,70,0,1,0,1,0
50653,445,0,0,66,66,0,1,0,1,0
57904,445,0,0,70,70,0,1,0,1,0
55024,445,0,0,70,70,0,1,0,1,0
54157,445,0,0,70,70,0,1,0,1,0
50498,445,0,0,70,70,0,1,0,1,0
61160,445,0,0,70,70,0,1,0,1,0
58154,445,0,0,66,66,0,1,0,1,0
60476,445,0,0,70,70,0,1,0,1,0
51194,445,0,0,70,70,0,1,0,1,0
64490,445,0,0,70,70,0,1,0,1,0
58074,445,0,0,70,70,0,1,0,1,0
63217,445,0,0,70,70,0,1,0,1,0
51057,445,0,0,66,66,0,1,0,1,0
63824,445,0,0,66,66,0,1,0,1,0
58241,445,0,0,66,66,0,1,0,1,0
55143,445,0,0,66,66,0,1,0,1,0
61899,445,0,0,66,66,0,1,0,1,0
63542,445,0,0,70,70,0,1,0,1,0
49741,445,0,0,66,66,0,1,0,1,0
52201,445,0,0,70,70,0,1,0,1,0
50024,445,0,0,70,70,0,1,0,1,0
59067,445,0,0,70,70,0,1,0,1,0
60730,445,0,0,70,70,0,1,0,1,0
50115,445,0,0,70,70,0,1,0,1,0
61642,445,0,0,70,70,0,1,0,1,0
55877,445,0,0,70,70,0,1,0,1,0
54830,445,0,0,70,70,0,1,0,1,0
60413,445,0,0,70,70,0,1,0,1,0
61848,445,0,0,66,66,0,1,0,1,0
65157,445,0,0,70,70,0,1,0,1,0
51021,445,0,0,70,70,0,1,0,1,0
56123,445,0,0,66,66,0,1,0,1,0
49231,445,0,0,70,70,0,1,0,1,0
50047,445,0,0,66,66,0,1,0,1,0
52315,445,0,0,70,70,0,1,0,1,0
50524,445,0,0,70,70,0,1,0,1,0
54262,445,0,0,66,66,0,1,0,1,0
53042,445,0,0,66,66,0,1,0,1,0
64980,445,0,0,70,70,0,1,0,1,0
62172,445,0,0,70,70,0,1,0,1,0
60331,445,0,0,70,70,0,1,0,1,0
59759,445,0,0,70,70,0,1,0,1,0
64565,445,0,0,70,70,0,1,0,1,0
59641,445,0,0,66,66,0,1,0,1,0
51120,445,0,0,66,66,0,1,0,1,0
53956,445,0,0,70,70,0,1,0,1,0
58224,445,0,0,70,70,0,1,0,1,0
65320,445,0,0,66,66,0,1,0,1,0
52533,445,0,0,70,70,0,1,0,1,0
51648,445,0,0,70,70,0,1,0,1,0
63438,445,0,0,66,66,0,1,0,1,0
49994,445,0,0,70,70,0,1,0,1,0
55635,445,0,0,70,70,0,1,0,1,0
62774,445,0,0,70,70,0,1,0,1,0
55529,445,0,0,66,66,0,1,0,1,0
54965,445,0,0,66,66,0,1,0,1,0
49911,445,0,0,66,66,0,1,0,1,0
50064,445,0,0,70,70,0,1,0,1,0
51037,445,0,0,66,66,0,1,0,1,0
61959,445,0,0,66,66,0,1,0,1,0
61605,445,0,0,70,70,0,1,0,1,0
63130,445,0,0,66,66,0,1,0,1,0
64882,445,0,0,66,66,0,1,0,1,0
63441,445,0,0,70,70,0,1,0,1,0
61410,445,0,0,66,66,0,1,0,1,0
49207,445,0,0,70,70,0,1,0,1,0
58715,445,0,0,70,70,0,1,0,1,0
52886,445,0,0,70,70,0,1,0,1,0
56878,445,0,0,70,70,0,1,0,1,0
55280,445,0,0,70,70,0,1,0,1,0
50866,445,0,0,66,66,0,1,0,1,0
59506,445,0,0,70,70,0,1,0,1,0
61603,445,0,0,70,70,0,1,0,1,0
54491,445,0,0,70,70,0,1,0,1,0
63666,445,0,0,66,66,0,1,0,1,0
55876,445,0,0,70,70,0,1,0,1,0
58371,445,0,0,66,66,0,1,0,1,0
52732,445,0,0,70,70,0,1,0,1,0
54076,445,0,0,70,70,0,1,0,1,0
64043,445,0,0,70,70,0,1,0,1,0
60811,445,0,0,70,70,0,1,0,1,0
61689,445,0,0,70,70,0,1,0,1,0
56177,445,0,0,66,66,0,1,0,1,0
54702,445,0,0,70,70,0,1,0,1,0
53806,445,0,0,70,70,0,1,0,1,0
54815,445,0,0,70,70,0,1,0,1,0
63085,445,0,0,66,66,0,1,0,1,0
49236,445,0,0,70,70,0,1,0,1,0
50285,445,0,0,70,70,0,1,0,1,0
64378,445,0,0,70,70,0,1,0,1,0
62155,445,0,0,70,70,0,1,0,1,0
58175,445,0,0,70,70,0,1,0,1,0
54056,445,0,0,70,70,0,1,0,1,0
58580,445,0,0,66,66,0,1,0,1,0
58318,445,0,0,66,66,0,1,0,1,0
64999,445,0,0,66,66,0,1,0,1,0
53751,445,0,0,66,66,0,1,0,1,0
52088,445,0,0,66,66,0,1,0,1,0
51468,445,0,0,70,70,0,1,0,1,0
55132,445,0,0,70,70,0,1,0,1,0
52955,445,0,0,70,70,0,1,0,1,0
61209,445,0,0,66,66,0,1,0,1,0
63885,445,0,0,66,66,0,1,0,1,0
59347,445,0,0,70,70,0,1,0,1,0
56297,445,0,0,70,70,0,1,0,1,0
65433,445,0,0,66,66,0,1,0,1,0
58316,445,0,0,70,70,0,1,0,1,0
62306,445,0,0,70,70,0,1,0,1,0
56486,445,0,0,70,70,0,1,0,1,0
52199,445,0,0,66,66,0,1,0,1,0
51499,445,0,0,70,70,0,1,0,1,0
62412,445,0,0,70,70,0,1,0,1,0
55708,445,0,0,70,70,0,1,0,1,0
62880,445,0,0,70,70,0,1,0,1,0
61007,445,0,0,70,70,0,1,0,1,0
54788,445,0,0,70,70,0,1,0,1,0
55906,445,0,0,70,70,0,1,0,1,0
62261,445,0,0,70,70,0,1,0,1,0
52433,445,0,0,66,66,0,1,0,1,0
51709,445,0,0,70,70,0,1,0,1,0
60174,445,0,0,70,70,0,1,0,1,0
63449,445,0,0,70,70,0,1,0,1,0
51008,445,0,0,70,70,0,1,0,1,0
64797,445,0,0,70,70,0,1,0,1,0
54456,445,0,0,66,66,0,1,0,1,0
59919,445,0,0,66,66,0,1,0,1,0
59072,445,0,0,66,66,0,1,0,1,0
62384,445,0,0,70,70,0,1,0,1,0
55116,445,0,0,70,70,0,1,0,1,0
54688,445,0,0,70,70,0,1,0,1,0
64988,445,0,0,66,66,0,1,0,1,0
62305,445,0,0,70,70,0,1,0,1,0
51584,445,0,0,70,70,0,1,0,1,0
61658,445,0,0,66,66,0,1,0,1,0
49568,445,0,0,70,70,0,1,0,1,0
51827,445,0,0,66,66,0,1,0,1,0
51227,445,0,0,70,70,0,1,0,1,0
58510,445,0,0,70,70,0,1,0,1,0
56804,445,0,0,70,70,0,1,0,1,0
61533,445,0,0,70,70,0,1,0,1,0
51697,445,0,0,66,66,0,1,0,1,0
60795,445,0,0,70,70,0,1,0,1,0
49339,445,0,0,70,70,0,1,0,1,0
60172,445,0,0,70,70,0,1,0,1,0
54808,445,0,0,70,70,0,1,0,1,0
55419,445,0,0,66,66,0,1,0,1,0
58533,445,0,0,70,70,0,1,0,1,0
51688,445,0,0,70,70,0,1,0,1,0
61354,445,0,0,70,70,0,1,0,1,0
52687,445,0,0,70,70,0,1,0,1,0
63141,445,0,0,70,70,0,1,0,1,0
55632,445,0,0,70,70,0,1,0,1,0
56652,445,0,0,70,70,0,1,0,1,0
56450,445,0,0,66,66,0,1,0,1,0
52719,445,0,0,70,70,0,1,0,1,0
62516,445,0,0,66,66,0,1,0,1,0
57706,445,0,0,70,70,0,1,0,1,0
61208,445,0,0,66,66,0,1,0,1,0
51282,445,0,0,70,70,0,1,0,1,0
62919,445,0,0,70,70,0,1,0,1,0
62699,445,0,0,66,66,0,1,0,1,0
53432,445,0,0,66,66,0,1,0,1,0
55321,445,0,0,70,70,0,1,0,1,0
55644,445,0,0,70,70,0,1,0,1,0
60160,445,0,0,66,66,0,1,0,1,0
54403,445,0,0,70,70,0,1,0,1,0
50478,445,0,0,66,66,0,1,0,1,0
64837,445,0,0,70,70,0,1,0,1,0
65103,445,0,0,66,66,0,1,0,1,0
51948,445,0,0,70,70,0,1,0,1,0
50481,445,0,0,70,70,0,1,0,1,0
55734,445,0,0,70,70,0,1,0,1,0
50476,445,0,0,70,70,0,1,0,1,0
60470,445,0,0,70,70,0,1,0,1,0
61430,445,0,0,70,70,0,1,0,1,0
55458,445,0,0,70,70,0,1,0,1,0
57001,445,0,0,70,70,0,1,0,1,0
50928,445,0,0,66,66,0,1,0,1,0
63110,445,0,0,70,70,0,1,0,1,0
62176,445,0,0,66,66,0,1,0,1,0
60464,445,0,0,70,70,0,1,0,1,0
51233,445,0,0,70,70,0,1,0,1,0
58933,445,0,0,66,66,0,1,0,1,0
53034,445,0,0,70,70,0,1,0,1,0
60827,445,0,0,70,70,0,1,0,1,0
57432,445,0,0,70,70,0,1,0,1,0
64780,445,0,0,70,70,0,1,0,1,0
55386,445,0,0,70,70,0,1,0,1,0
53580,445,0,0,66,66,0,1,0,1,0
63618,445,0,0,70,70,0,1,0,1,0
53456,445,0,0,70,70,0,1,0,1,0
64691,445,0,0,70,70,0,1,0,1,0
52420,445,0,0,70,70,0,1,0,1,0
52604,445,0,0,66,66,0,1,0,1,0
63126,445,0,0,70,70,0,1,0,1,0
64430,445,0,0,70,70,0,1,0,1,0
59840,445,0,0,70,70,0,1,0,1,0
57485,445,0,0,70,70,0,1,0,1,0
50606,445,0,0,66,66,0,1,0,1,0
54977,445,0,0,70,70,0,1,0,1,0
50748,445,0,0,70,70,0,1,0,1,0
60491,445,0,0,70,70,0,1,0,1,0
58923,445,0,0,70,70,0,1,0,1,0
62433,445,0,0,70,70,0,1,0,1,0
61444,445,0,0,70,70,0,1,0,1,0
57461,445,0,0,66,66,0,1,0,1,0
51560,445,0,0,70,70,0,1,0,1,0
59891,445,0,0,70,70,0,1,0,1,0
65267,445,0,0,66,66,0,1,0,1,0
60619,445,0,0,66,66,0,1,0,1,0
58153,445,0,0,70,70,0,1,0,1,0
49973,445,0,0,70,70,0,1,0,1,0
56406,445,0,0,66,66,0,1,0,1,0
58915,445,0,0,66,66,0,1,0,1,0
50782,445,0,0,70,70,0,1,0,1,0
61159,445,0,0,66,66,0,1,0,1,0
62554,445,0,0,70,70,0,1,0,1,0
61143,445,0,0,66,66,0,1,0,1,0
49712,445,0,0,70,70,0,1,0,1,0
58440,445,0,0,66,66,0,1,0,1,0
52535,445,0,0,70,70,0,1,0,1,0
62037,445,0,0,70,70,0,1,0,1,0
56438,445,0,0,70,70,0,1,0,1,0
58567,445,0,0,66,66,0,1,0,1,0
55358,445,0,0,70,70,0,1,0,1,0
61402,445,0,0,66,66,0,1,0,1,0
61079,445,0,0,66,66,0,1,0,1,0
58015,445,0,0,70,70,0,1,0,1,0
58127,445,0,0,66,66,0,1,0,1,0
57057,445,0,0,70,70,0,1,0,1,0
56118,445,0,0,66,66,0,1,0,1,0
57400,445,0,0,66,66,0,1,0,1,0
57737,445,0,0,66,66,0,1,0,1,0
55788,445,0,0,70,70,0,1,0,1,0
59714,445,0,0,66,66,0,1,0,1,0
51445,445,0,0,66,66,0,1,0,1,0
50671,445,0,0,66,66,0,1,0,1,0
55215,445,0,0,66,66,0,1,0,1,0
63797,445,0,0,70,70,0,1,0,1,0
64090,445,0,0,70,70,0,1,0,1,0
60936,445,0,0,70,70,0,1,0,1,0
60633,445,0,0,66,66,0,1,0,1,0
56721,445,0,0,70,70,0,1,0,1,0
56072,445,0,0,70,70,0,1,0,1,0
60948,445,0,0,70,70,0,1,0,1,0
50979,445,0,0,70,70,0,1,0,1,0
52974,445,0,0,70,70,0,1,0,1,0
52352,445,0,0,70,70,0,1,0,1,0
49750,445,0,0,66,66,0,1,0,1,0
55094,445,0,0,66,66,0,1,0,1,0
57344,445,0,0,70,70,0,1,0,1,0
58039,445,0,0,66,66,0,1,0,1,0
53741,445,0,0,70,70,0,1,0,1,0
64454,445,0,0,70,70,0,1,0,1,0
51083,445,0,0,70,70,0,1,0,1,0
65478,445,0,0,66,66,0,1,0,1,0
49283,445,0,0,70,70,0,1,0,1,0
63341,445,0,0,66,66,0,1,0,1,0
57114,445,0,0,70,70,0,1,0,1,0
55261,445,0,0,70,70,0,1,0,1,0
55310,445,0,0,70,70,0,1,0,1,0
63695,445,0,0,66,66,0,1,0,1,0
58116,445,0,0,70,70,0,1,0,1,0
57256,445,0,0,70,70,0,1,0,1,0
57284,445,0,0,66,66,0,1,0,1,0
51904,445,0,0,70,70,0,1,0,1,0
54563,445,0,0,70,70,0,1,0,1,0
49474,445,0,0,70,70,0,1,0,1,0
49615,445,0,0,66,66,0,1,0,1,0
57608,445,0,0,70,70,0,1,0,1,0
55935,445,0,0,70,70,0,1,0,1,0
63868,445,0,0,70,70,0,1,0,1,0
65219,445,0,0,70,70,0,1,0,1,0
59486,445,0,0,70,70,0,1,0,1,0
54061,445,0,0,66,66,0,1,0,1,0
52860,445,0,0,70,70,0,1,0,1,0
63984,445,0,0,70,70,0,1,0,1,0
60422,445,0,0,70,70,0,1,0,1,0
59989,445,0,0,70,70,0,1,0,1,0
54973,445,0,0,66,66,0,1,0,1,0
60823,445,0,0,66,66,0,1,0,1,0
52345,445,0,0,66,66,0,1,0,1,0
64116,445,0,0,66,66,0,1,0,1,0
53233,445,0,0,70,70,0,1,0,1,0
51265,445,0,0,70,70,0,1,0,1,0
63895,445,0,0,70,70,0,1,0,1,0
52253,445,0,0,70,70,0,1,0,1,0
55774,445,0,0,70,70,0,1,0,1,0
53532,445,0,0,70,70,0,1,0,1,0
50412,445,0,0,70,70,0,1,0,1,0
62061,445,0,0,70,70,0,1,0,1,0
61031,445,0,0,70,70,0,1,0,1,0
60702,445,0,0,70,70,0,1,0,1,0
60804,445,0,0,70,70,0,1,0,1,0
57716,445,0,0,66,66,0,1,0,1,0
60765,445,0,0,70,70,0,1,0,1,0
61690,445,0,0,66,66,0,1,0,1,0
56209,445,0,0,70,70,0,1,0,1,0
53706,445,0,0,70,70,0,1,0,1,0
61918,445,0,0,70,70,0,1,0,1,0
52052,445,0,0,70,70,0,1,0,1,0
56360,445,0,0,70,70,0,1,0,1,0
50381,445,0,0,66,66,0,1,0,1,0
61122,445,0,0,70,70,0,1,0,1,0
53670,445,0,0,70,70,0,1,0,1,0
50920,445,0,0,66,66,0,1,0,1,0
63436,445,0,0,66,66,0,1,0,1,0
62997,445,0,0,66,66,0,1,0,1,0
61738,445,0,0,70,70,0,1,0,1,0
49934,445,0,0,70,70,0,1,0,1,0
51788,445,0,0,66,66,0,1,0,1,0
49511,445,0,0,66,66,0,1,0,1,0
49326,445,0,0,66,66,0,1,0,1,0
56784,445,0,0,66,66,0,1,0,1,0
56840,445,0,0,66,66,0,1,0,1,0
63873,445,0,0,70,70,0,1,0,1,0
51563,445,0,0,70,70,0,1,0,1,0
64297,445,0,0,70,70,0,1,0,1,0
63358,445,0,0,70,70,0,1,0,1,0
65394,445,0,0,66,66,0,1,0,1,0
56979,445,0,0,70,70,0,1,0,1,0
50291,445,0,0,70,70,0,1,0,1,0
61714,445,0,0,70,70,0,1,0,1,0
52523,445,0,0,70,70,0,1,0,1,0
51186,445,0,0,66,66,0,1,0,1,0
50984,445,0,0,66,66,0,1,0,1,0
55083,445,0,0,70,70,0,1,0,1,0
50355,445,0,0,70,70,0,1,0,1,0
58858,445,0,0,66,66,0,1,0,1,0
52600,445,0,0,66,66,0,1,0,1,0
55182,445,0,0,66,66,0,1,0,1,0
56619,445,0,0,70,70,0,1,0,1,0
50609,445,0,0,66,66,0,1,0,1,0
49359,445,0,0,70,70,0,1,0,1,0
52728,445,0,0,70,70,0,1,0,1,0
55660,445,0,0,70,70,0,1,0,1,0
52910,445,0,0,66,66,0,1,0,1,0
57220,445,0,0,66,66,0,1,0,1,0
58414,445,0,0,70,70,0,1,0,1,0
52405,445,0,0,66,66,0,1,0,1,0
50277,445,0,0,70,70,0,1,0,1,0
64596,445,0,0,70,70,0,1,0,1,0
55938,445,0,0,66,66,0,1,0,1,0
52126,445,0,0,70,70,0,1,0,1,0
56489,445,0,0,66,66,0,1,0,1,0
61784,445,0,0,70,70,0,1,0,1,0
55360,445,0,0,70,70,0,1,0,1,0
62913,445,0,0,70,70,0,1,0,1,0
60812,445,0,0,70,70,0,1,0,1,0
53472,445,0,0,70,70,0,1,0,1,0
61030,445,0,0,66,66,0,1,0,1,0
54922,445,0,0,70,70,0,1,0,1,0
65059,445,0,0,70,70,0,1,0,1,0
60595,445,0,0,66,66,0,1,0,1,0
53760,445,0,0,70,70,0,1,0,1,0
57967,445,0,0,70,70,0,1,0,1,0
59230,445,0,0,66,66,0,1,0,1,0
55350,445,0,0,66,66,0,1,0,1,0
57013,445,0,0,70,70,0,1,0,1,0
57963,445,0,0,70,70,0,1,0,1,0
63770,445,0,0,70,70,0,1,0,1,0
64597,445,0,0,70,70,0,1,0,1,0
53482,445,0,0,70,70,0,1,0,1,0
53757,445,0,0,70,70,0,1,0,1,0
53062,445,0,0,66,66,0,1,0,1,0
60877,445,0,0,70,70,0,1,0,1,0
55235,445,0,0,70,70,0,1,0,1,0
63391,445,0,0,66,66,0,1,0,1,0
57377,445,0,0,70,70,0,1,0,1,0
60743,445,0,0,66,66,0,1,0,1,0
56845,445,0,0,70,70,0,1,0,1,0
60044,445,0,0,70,70,0,1,0,1,0
60066,445,0,0,70,70,0,1,0,1,0
50596,445,0,0,70,70,0,1,0,1,0
51930,445,0,0,70,70,0,1,0,1,0
55716,445,0,0,70,70,0,1,0,1,0
63433,445,0,0,70,70,0,1,0,1,0
59147,445,0,0,66,66,0,1,0,1,0
50562,445,0,0,66,66,0,1,0,1,0
55865,445,0,0,66,66,0,1,0,1,0
55044,445,0,0,70,70,0,1,0,1,0
65328,445,0,0,70,70,0,1,0,1,0
50785,445,0,0,70,70,0,1,0,1,0
55685,445,0,0,70,70,0,1,0,1,0
56330,445,0,0,70,70,0,1,0,1,0
60122,445,0,0,66,66,0,1,0,1,0
61891,445,0,0,70,70,0,1,0,1,0
56012,445,0,0,70,70,0,1,0,1,0
61108,445,0,0,70,70,0,1,0,1,0
55359,445,0,0,70,70,0,1,0,1,0
52122,445,0,0,70,70,0,1,0,1,0
51291,445,0,0,70,70,0,1,0,1,0
50642,445,0,0,70,70,0,1,0,1,0
49411,445,0,0,70,70,0,1,0,1,0
64424,445,0,0,66,66,0,1,0,1,0
50683,445,0,0,70,70,0,1,0,1,0
50767,445,0,0,66,66,0,1,0,1,0
50818,445,0,0,66,66,0,1,0,1,0
55639,445,0,0,70,70,0,1,0,1,0
55199,445,0,0,66,66,0,1,0,1,0
63715,445,0,0,66,66,0,1,0,1,0
53823,445,0,0,66,66,0,1,0,1,0
57731,445,0,0,70,70,0,1,0,1,0
58115,445,0,0,70,70,0,1,0,1,0
65312,445,0,0,70,70,0,1,0,1,0
55075,445,0,0,70,70,0,1,0,1,0
54091,445,0,0,66,66,0,1,0,1,0
49283,445,0,0,66,66,0,1,0,1,0
60195,445,0,0,66,66,0,1,0,1,0
56817,445,0,0,66,66,0,1,0,1,0
64492,445,0,0,66,66,0,1,0,1,0
49511,445,0,0,70,70,0,1,0,1,0
64052,445,0,0,70,70,0,1,0,1,0
55244,445,0,0,70,70,0,1,0,1,0
62105,445,0,0,70,70,0,1,0,1,0
59267,445,0,0,70,70,0,1,0,1,0
54648,445,0,0,66,66,0,1,0,1,0
58634,445,0,0,70,70,0,1,0,1,0
49993,445,0,0,70,70,0,1,0,1,0
54710,445,0,0,66,66,0,1,0,1,0
50944,445,0,0,70,70,0,1,0,1,0
64402,445,0,0,66,66,0,1,0,1,0
60783,445,0,0,70,70,0,1,0,1,0
56291,445,0,0,70,70,0,1,0,1,0
63925,445,0,0,70,70,0,1,0,1,0
55075,445,0,0,70,70,0,1,0,1,0
62786,445,0,0,70,70,0,1,0,1,0
50725,445,0,0,70,70,0,1,0,1,0
54624,445,0,0,70,70,0,1,0,1,0
65263,445,0,0,66,66,0,1,0,1,0
57629,445,0,0,70,70,0,1,0,1,0
50801,445,0,0,66,66,0,1,0,1,0
50322,445,0,0,70,70,0,1,0,1,0
58072,445,0,0,70,70,0,1,0,1,0
62671,445,0,0,70,70,0,1,0,1,0
61370,445,0,0,70,70,0,1,0,1,0
57643,445,0,0,70,70,0,1,0,1,0
49920,445,0,0,70,70,0,1,0,1,0
55212,445,0,0,70,70,0,1,0,1,0
52508,445,0,0,66,66,0,1,0,1,0
58858,445,0,0,70,70,0,1,0,1,0
60059,445,0,0,66,66,0,1,0,1,0
53362,445,0,0,70,70,0,1,0,1,0
51501,445,0,0,70,70,0,1,0,1,0
58457,445,0,0,66,66,0,1,0,1,0
54391,445,0,0,70,70,0,1,0,1,0
61831,445,0,0,66,66,0,1,0,1,0
61276,445,0,0,66,66,0,1,0,1,0
60466,445,0,0,66,66,0,1,0,1,0
58902,445,0,0,70,70,0,1,0,1,0
60999,445,0,0,70,70,0,1,0,1,0
51544,445,0,0,70,70,0,1,0,1,0
50926,445,0,0,66,66,0,1,0,1,0
58274,445,0,0,66,66,0,1,0,1,0
50542,445,0,0,66,66,0,1,0,1,0
64964,445,0,0,70,70,0,1,0,1,0
57606,445,0,0,70,70,0,1,0,1,0
64802,445,0,0,70,70,0,1,0,1,0
63562,445,0,0,70,70,0,1,0,1,0
64969,445,0,0,70,70,0,1,0,1,0
60589,445,0,0,70,70,0,1,0,1,0
55110,445,0,0,66,66,0,1,0,1,0
58576,445,0,0,70,70,0,1,0,1,0
50557,445,0,0,70,70,0,1,0,1,0
52492,445,0,0,66,66,0,1,0,1,0
63926,445,0,0,66,66,0,1,0,1,0
59141,445,0,0,70,70,0,1,0,1,0
60271,445,0,0,70,70,0,1,0,1,0
50937,445,0,0,70,70,0,1,0,1,0
55133,445,0,0,70,70,0,1,0,1,0
49408,445,0,0,70,70,0,1,0,1,0
61141,445,0,0,70,70,0,1,0,1,0
53479,445,0,0,66,66,0,1,0,1,0
60315,445,0,0,70,70,0,1,0,1,0
56962,445,0,0,66,66,0,1,0,1,0
65227,445,0,0,70,70,0,1,0,1,0
51975,445,0,0,66,66,0,1,0,1,0
64898,445,0,0,70,70,0,1,0,1,0
59320,445,0,0,70,70,0,1,0,1,0
58201,445,0,0,66,66,0,1,0,1,0
56485,445,0,0,70,70,0,1,0,1,0
64294,445,0,0,66,66,0,1,0,1,0
52789,445,0,0,70,70,0,1,0,1,0
60629,445,0,0,70,70,0,1,0,1,0
56532,445,0,0,70,70,0,1,0,1,0
61373,445,0,0,66,66,0,1,0,1,0
53841,445,0,0,66,66,0,1,0,1,0
59956,445,0,0,70,70,0,1,0,1,0
51540,445,0,0,70,70,0,1,0,1,0
54797,445,0,0,70,70,0,1,0,1,0
61077,445,0,0,66,66,0,1,0,1,0
49220,445,0,0,66,66,0,1,0,1,0
64688,445,0,0,70,70,0,1,0,1,0
59786,445,0,0,66,66,0,1,0,1,0
53769,445,0,0,70,70,0,1,0,1,0
65271,445,0,0,66,66,0,1,0,1,0
54013,445,0,0,70,70,0,1,0,1,0
50167,445,0,0,70,70,0,1,0,1,0
58887,445,0,0,70,70,0,1,0,1,0
59177,445,0,0,70,70,0,1,0,1,0
55875,445,0,0,70,70,0,1,0,1,0
55323,445,0,0,70,70,0,1,0,1,0
63017,445,0,0,66,66,0,1,0,1,0
55835,445,0,0,70,70,0,1,0,1,0
55939,445,0,0,66,66,0,1,0,1,0
50359,445,0,0,70,70,0,1,0,1,0
52730,445,0,0,66,66,0,1,0,1,0
50465,445,0,0,66,66,0,1,0,1,0
61111,445,0,0,70,70,0,1,0,1,0
55006,445,0,0,70,70,0,1,0,1,0
60452,445,0,0,70,70,0,1,0,1,0
57791,445,0,0,70,70,0,1,0,1,0
59822,445,0,0,70,70,0,1,0,1,0
63958,445,0,0,70,70,0,1,0,1,0
50783,445,0,0,70,70,0,1,0,1,0
60600,445,0,0,70,70,0,1,0,1,0
53685,445,0,0,66,66,0,1,0,1,0
50902,445,0,0,70,70,0,1,0,1,0
65393,445,0,0,66,66,0,1,0,1,0
56645,445,0,0,66,66,0,1,0,1,0
52987,445,0,0,66,66,0,1,0,1,0
49265,445,0,0,70,70,0,1,0,1,0
55210,445,0,0,66,66,0,1,0,1,0
63639,445,0,0,70,70,0,1,0,1,0
58095,445,0,0,70,70,0,1,0,1,0
59718,445,0,0,70,70,0,1,0,1,0
50006,445,0,0,70,70,0,1,0,1,0
49812,445,0,0,70,70,0,1,0,1,0
50106,445,0,0,70,70,0,1,0,1,0
51032,445,0,0,66,66,0,1,0,1,0
49395,445,0,0,70,70,0,1,0,1,0
53376,445,0,0,70,70,0,1,0,1,0
57863,445,0,0,66,66,0,1,0,1,0
50098,445,0,0,66,66,0,1,0,1,0
65327,445,0,0,66,66,0,1,0,1,0
54970,445,0,0,66,66,0,1,0,1,0
54909,445,0,0,70,70,0,1,0,1,0
58054,445,0,0,66,66,0,1,0,1,0
57928,445,0,0,66,66,0,1,0,1,0
52565,445,0,0,70,70,0,1,0,1,0
51308,445,0,0,70,70,0,1,0,1,0
51478,445,0,0,70,70,0,1,0,1,0
55334,445,0,0,70,70,0,1,0,1,0
49705,445,0,0,70,70,0,1,0,1,0
64181,445,0,0,70,70,0,1,0,1,0
51311,445,0,0,70,70,0,1,0,1,0
60635,445,0,0,66,66,0,1,0,1,0
51160,445,0,0,70,70,0,1,0,1,0
56724,445,0,0,70,70,0,1,0,1,0
50453,445,0,0,70,70,0,1,0,1,0
53157,445,0,0,70,70,0,1,0,1,0
50732,445,0,0,70,70,0,1,0,1,0
57675,445,0,0,70,70,0,1,0,1,0
55141,445,0,0,70,70,0,1,0,1,0
52146,445,0,0,70,70,0,1,0,1,0
53782,445,0,0,70,70,0,1,0,1,0
59475,445,0,0,66,66,0,1,0,1,0
50377,445,0,0,70,70,0,1,0,1,0
58678,445,0,0,66,66,0,1,0,1,0
56832,445,0,0,70,70,0,1,0,1,0
56618,445,0,0,70,70,0,1,0,1,0
65128,445,0,0,66,66,0,1,0,1,0
59180,445,0,0,66,66,0,1,0,1,0
57047,445,0,0,70,70,0,1,0,1,0
58268,445,0,0,70,70,0,1,0,1,0
49227,445,0,0,70,70,0,1,0,1,0
60818,445,0,0,70,70,0,1,0,1,0
58132,445,0,0,70,70,0,1,0,1,0
50436,445,0,0,70,70,0,1,0,1,0
53886,445,0,0,70,70,0,1,0,1,0
58202,445,0,0,70,70,0,1,0,1,0
58366,445,0,0,70,70,0,1,0,1,0
59290,445,0,0,66,66,0,1,0,1,0
55152,445,0,0,70,70,0,1,0,1,0
57736,445,0,0,66,66,0,1,0,1,0
63320,445,0,0,66,66,0,1,0,1,0
65065,445,0,0,66,66,0,1,0,1,0
56838,445,0,0,66,66,0,1,0,1,0
64515,445,0,0,70,70,0,1,0,1,0
55694,445,0,0,70,70,0,1,0,1,0
49858,445,0,0,70,70,0,1,0,1,0
50499,445,0,0,66,66,0,1,0,1,0
65371,445,0,0,66,66,0,1,0,1,0
50907,445,0,0,66,66,0,1,0,1,0
50682,445,0,0,70,70,0,1,0,1,0
63129,445,0,0,66,66,0,1,0,1,0
50604,445,0,0,70,70,0,1,0,1,0
58367,445,0,0,70,70,0,1,0,1,0
52883,445,0,0,66,66,0,1,0,1,0
51167,445,0,0,70,70,0,1,0,1,0
57871,445,0,0,70,70,0,1,0,1,0
51886,445,0,0,70,70,0,1,0,1,0
60083,445,0,0,70,70,0,1,0,1,0
65464,445,0,0,70,70,0,1,0,1,0
53520,445,0,0,70,70,0,1,0,1,0
58542,445,0,0,70,70,0,1,0,1,0
52075,445,0,0,70,70,0,1,0,1,0
65146,445,0,0,70,70,0,1,0,1,0
49938,445,0,0,70,70,0,1,0,1,0
49496,445,0,0,70,70,0,1,0,1,0
54249,445,0,0,70,70,0,1,0,1,0
60203,445,0,0,70,70,0,1,0,1,0
49841,445,0,0,70,70,0,1,0,1,0
51458,445,0,0,70,70,0,1,0,1,0
63487,445,0,0,70,70,0,1,0,1,0
49195,445,0,0,70,70,0,1,0,1,0
51811,445,0,0,70,70,0,1,0,1,0
57804,445,0,0,66,66,0,1,0,1,0
51812,445,0,0,70,70,0,1,0,1,0
54204,445,0,0,70,70,0,1,0,1,0
62972,445,0,0,66,66,0,1,0,1,0
51947,445,0,0,70,70,0,1,0,1,0
57492,445,0,0,70,70,0,1,0,1,0
61657,445,0,0,70,70,0,1,0,1,0
52526,445,0,0,70,70,0,1,0,1,0
62748,445,0,0,70,70,0,1,0,1,0
57515,445,0,0,70,70,0,1,0,1,0
49494,445,0,0,70,70,0,1,0,1,0
60194,445,0,0,70,70,0,1,0,1,0
50135,445,0,0,70,70,0,1,0,1,0
58842,445,0,0,70,70,0,1,0,1,0
51200,445,0,0,70,70,0,1,0,1,0
63149,445,0,0,70,70,0,1,0,1,0
51551,445,0,0,70,70,0,1,0,1,0
56328,445,0,0,70,70,0,1,0,1,0
64325,445,0,0,70,70,0,1,0,1,0
55701,445,0,0,70,70,0,1,0,1,0
53714,445,0,0,66,66,0,1,0,1,0
61739,445,0,0,66,66,0,1,0,1,0
59922,445,0,0,66,66,0,1,0,1,0
58217,445,0,0,70,70,0,1,0,1,0
61164,445,0,0,66,66,0,1,0,1,0
51076,445,0,0,70,70,0,1,0,1,0
53889,445,0,0,70,70,0,1,0,1,0
51704,445,0,0,66,66,0,1,0,1,0
52849,445,0,0,70,70,0,1,0,1,0
64792,445,0,0,66,66,0,1,0,1,0
57670,445,0,0,66,66,0,1,0,1,0
61850,445,0,0,66,66,0,1,0,1,0
54397,445,0,0,70,70,0,1,0,1,0
49305,445,0,0,70,70,0,1,0,1,0
54325,445,0,0,66,66,0,1,0,1,0
52552,445,0,0,66,66,0,1,0,1,0
56014,445,0,0,70,70,0,1,0,1,0
50255,445,0,0,70,70,0,1,0,1,0
62175,445,0,0,70,70,0,1,0,1,0
59941,445,0,0,70,70,0,1,0,1,0
55739,445,0,0,66,66,0,1,0,1,0
51142,445,0,0,70,70,0,1,0,1,0
50211,445,0,0,70,70,0,1,0,1,0
56908,445,0,0,70,70,0,1,0,1,0
62060,445,0,0,70,70,0,1,0,1,0
64313,445,0,0,70,70,0,1,0,1,0
57366,445,0,0,70,70,0,1,0,1,0
63564,445,0,0,66,66,0,1,0,1,0
62575,445,0,0,70,70,0,1,0,1,0
51423,445,0,0,66,66,0,1,0,1,0
62156,445,0,0,70,70,0,1,0,1,0
49818,445,0,0,70,70,0,1,0,1,0
59117,445,0,0,70,70,0,1,0,1,0
65316,445,0,0,70,70,0,1,0,1,0
55448,445,0,0,70,70,0,1,0,1,0
64605,445,0,0,66,66,0,1,0,1,0
57058,445,0,0,70,70,0,1,0,1,0
49411,445,0,0,70,70,0,1,0,1,0
61399,445,0,0,66,66,0,1,0,1,0
50265,445,0,0,70,70,0,1,0,1,0
56498,445,0,0,70,70,0,1,0,1,0
57479,445,0,0,66,66,0,1,0,1,0
56775,445,0,0,70,70,0,1,0,1,0
59155,445,0,0,66,66,0,1,0,1,0
51594,445,0,0,70,70,0,1,0,1,0
60728,445,0,0,70,70,0,1,0,1,0
53976,445,0,0,70,70,0,1,0,1,0
62299,445,0,0,70,70,0,1,0,1,0
58757,445,0,0,70,70,0,1,0,1,0
55532,445,0,0,70,70,0,1,0,1,0
53897,445,0,0,66,66,0,1,0,1,0
58017,445,0,0,70,70,0,1,0,1,0
65080,445,0,0,70,70,0,1,0,1,0
62336,445,0,0,70,70,0,1,0,1,0
61892,445,0,0,70,70,0,1,0,1,0
55478,445,0,0,70,70,0,1,0,1,0
57477,445,0,0,70,70,0,1,0,1,0
51630,445,0,0,70,70,0,1,0,1,0
61336,445,0,0,66,66,0,1,0,1,0
58734,445,0,0,70,70,0,1,0,1,0
57604,445,0,0,70,70,0,1,0,1,0
52397,445,0,0,66,66,0,1,0,1,0
55458,445,0,0,70,70,0,1,0,1,0
62089,445,0,0,70,70,0,1,0,1,0
59145,445,0,0,66,66,0,1,0,1,0
57412,445,0,0,70,70,0,1,0,1,0
64260,445,0,0,70,70,0,1,0,1,0
59669,445,0,0,70,70,0,1,0,1,0
49359,445,0,0,66,66,0,1,0,1,0
58269,445,0,0,70,70,0,1,0,1,0
56517,445,0,0,70,70,0,1,0,1,0
62746,445,0,0,70,70,0,1,0,1,0
51843,445,0,0,70,70,0,1,0,1,0
60304,445,0,0,66,66,0,1,0,1,0
49530,445,0,0,66,66,0,1,0,1,0
58318,445,0,0,70,70,0,1,0,1,0
55558,445,0,0,70,70,0,1,0,1,0
62085,445,0,0,70,70,0,1,0,1,0
52454,445,0,0,70,70,0,1,0,1,0
55790,445,0,0,66,66,0,1,0,1,0
62025,445,0,0,70,70,0,1,0,1,0
51026,445,0,0,70,70,0,1,0,1,0
51699,445,0,0,70,70,0,1,0,1,0
61363,445,0,0,70,70,0,1,0,1,0
55032,445,0,0,70,70,0,1,0,1,0
49884,445,0,0,70,70,0,1,0,1,0
53433,445,0,0,70,70,0,1,0,1,0
60180,445,0,0,66,66,0,1,0,1,0
52298,445,0,0,66,66,0,1,0,1,0
55818,445,0,0,70,70,0,1,0,1,0
51140,445,0,0,70,70,0,1,0,1,0
57248,445,0,0,70,70,0,1,0,1,0
60563,445,0,0,66,66,0,1,0,1,0
64080,445,0,0,70,70,0,1,0,1,0
55997,445,0,0,70,70,0,1,0,1,0
54846,445,0,0,70,70,0,1,0,1,0
64684,445,0,0,70,70,0,1,0,1,0
58790,445,0,0,70,70,0,1,0,1,0
55836,445,0,0,70,70,0,1,0,1,0
63109,445,0,0,70,70,0,1,0,1,0
62624,445,0,0,70,70,0,1,0,1,0
51267,445,0,0,70,70,0,1,0,1,0
53890,445,0,0,70,70,0,1,0,1,0
61805,445,0,0,70,70,0,1,0,1,0
53462,445,0,0,70,70,0,1,0,1,0
50786,445,0,0,70,70,0,1,0,1,0
52019,445,0,0,70,70,0,1,0,1,0
53237,445,0,0,66,66,0,1,0,1,0
53497,445,0,0,66,66,0,1,0,1,0
52690,445,0,0,70,70,0,1,0,1,0
57710,445,0,0,70,70,0,1,0,1,0
53188,445,0,0,70,70,0,1,0,1,0
57157,445,0,0,66,66,0,1,0,1,0
58154,445,0,0,70,70,0,1,0,1,0
60210,445,0,0,70,70,0,1,0,1,0
57353,445,0,0,66,66,0,1,0,1,0
64423,445,0,0,66,66,0,1,0,1,0
62704,445,0,0,70,70,0,1,0,1,0
60002,445,0,0,66,66,0,1,0,1,0
51866,445,0,0,70,70,0,1,0,1,0
61130,445,0,0,66,66,0,1,0,1,0
63937,445,0,0,70,70,0,1,0,1,0
56737,445,0,0,70,70,0,1,0,1,0
57406,445,0,0,70,70,0,1,0,1,0
58327,445,0,0,66,66,0,1,0,1,0
64858,445,0,0,66,66,0,1,0,1,0
54499,445,0,0,70,70,0,1,0,1,0
52108,445,0,0,66,66,0,1,0,1,0
57733,445,0,0,66,66,0,1,0,1,0
60455,445,0,0,66,66,0,1,0,1,0
62709,445,0,0,70,70,0,1,0,1,0
57496,445,0,0,70,70,0,1,0,1,0
53794,445,0,0,70,70,0,1,0,1,0
52179,445,0,0,70,70,0,1,0,1,0
49199,445,0,0,66,66,0,1,0,1,0
58701,445,0,0,66,66,0,1,0,1,0
54702,445,0,0,66,66,0,1,0,1,0
57017,445,0,0,66,66,0,1,0,1,0
55509,445,0,0,70,70,0,1,0,1,0
60270,445,0,0,70,70,0,1,0,1,0
57480,445,0,0,66,66,0,1,0,1,0
62229,445,0,0,66,66,0,1,0,1,0
65121,445,0,0,66,66,0,1,0,1,0
61366,445,0,0,66,66,0,1,0,1,0
52846,445,0,0,70,70,0,1,0,1,0
55561,445,0,0,66,66,0,1,0,1,0
64146,445,0,0,66,66,0,1,0,1,0
65336,445,0,0,70,70,0,1,0,1,0
61788,445,0,0,66,66,0,1,0,1,0
55035,445,0,0,66,66,0,1,0,1,0
61207,445,0,0,66,66,0,1,0,1,0
56791,445,0,0,70,70,0,1,0,1,0
61252,445,0,0,70,70,0,1,0,1,0
52676,445,0,0,70,70,0,1,0,1,0
55021,445,0,0,70,70,0,1,0,1,0
62812,445,0,0,70,70,0,1,0,1,0
49523,445,0,0,70,70,0,1,0,1,0
65469,445,0,0,66,66,0,1,0,1,0
62252,445,0,0,70,70,0,1,0,1,0
55163,445,0,0,66,66,0,1,0,1,0
62501,445,0,0,70,70,0,1,0,1,0
55540,445,0,0,70,70,0,1,0,1,0
56341,445,0,0,66,66,0,1,0,1,0
64538,445,0,0,70,70,0,1,0,1,0
61394,445,0,0,66,66,0,1,0,1,0
55397,445,0,0,70,70,0,1,0,1,0
57858,445,0,0,70,70,0,1,0,1,0
59200,445,0,0,66,66,0,1,0,1,0
57557,445,0,0,66,66,0,1,0,1,0
62231,445,0,0,66,66,0,1,0,1,0
55916,445,0,0,70,70,0,1,0,1,0
62871,445,0,0,66,66,0,1,0,1,0
60247,445,0,0,70,70,0,1,0,1,0
57910,445,0,0,66,66,0,1,0,1,0
59218,445,0,0,70,70,0,1,0,1,0
57340,445,0,0,70,70,0,1,0,1,0
54501,445,0,0,70,70,0,1,0,1,0
58830,445,0,0,66,66,0,1,0,1,0
62935,445,0,0,70,70,0,1,0,1,0
50161,445,0,0,66,66,0,1,0,1,0
51058,445,0,0,66,66,0,1,0,1,0
62488,445,0,0,66,66,0,1,0,1,0
53334,445,0,0,70,70,0,1,0,1,0
65060,445,0,0,70,70,0,1,0,1,0
57152,445,0,0,66,66,0,1,0,1,0
51566,445,0,0,70,70,0,1,0,1,0
57836,445,0,0,70,70,0,1,0,1,0
61388,445,0,0,66,66,0,1,0,1,0
56312,445,0,0,70,70,0,1,0,1,0
65171,445,0,0,70,70,0,1,0,1,0
62984,445,0,0,66,66,0,1,0,1,0
61720,445,0,0,70,70,0,1,0,1,0
54610,445,0,0,70,70,0,1,0,1,0
62282,445,0,0,66,66,0,1,0,1,0
62389,445,0,0,70,70,0,1,0,1,0
64082,445,0,0,66,66,0,1,0,1,0
62210,445,0,0,70,70,0,1,0,1,0
54774,445,0,0,66,66,0,1,0,1,0
64394,445,0,0,70,70,0,1,0,1,0
51291,445,0,0,70,70,0,1,0,1,0
59733,445,0,0,70,70,0,1,0,1,0
55340,445,0,0,70,70,0,1,0,1,0
64624,445,0,0,70,70,0,1,0,1,0
50482,445,0,0,66,66,0,1,0,1,0
64624,445,0,0,66,66,0,1,0,1,0
61087,445,0,0,70,70,0,1,0,1,0
50869,445,0,0,70,70,0,1,0,1,0
49423,445,0,0,70,70,0,1,0,1,0
58295,445,0,0,70,70,0,1,0,1,0
53717,445,0,0,70,70,0,1,0,1,0
53717,445,0,0,70,70,0,1,0,1,0
54443,445,0,0,70,70,0,1,0,1,0
64321,445,0,0,70,70,0,1,0,1,0
54292,445,0,0,66,66,0,1,0,1,0
59413,445,0,0,70,70,0,1,0,1,0
61530,445,0,0,70,70,0,1,0,1,0
53363,445,0,0,70,70,0,1,0,1,0
63877,445,0,0,70,70,0,1,0,1,0
62431,445,0,0,66,66,0,1,0,1,0
61044,445,0,0,70,70,0,1,0,1,0
55667,445,0,0,70,70,0,1,0,1,0
58058,445,0,0,70,70,0,1,0,1,0
58398,445,0,0,70,70,0,1,0,1,0
50561,445,0,0,70,70,0,1,0,1,0
62068,445,0,0,70,70,0,1,0,1,0
59915,445,0,0,70,70,0,1,0,1,0
54889,445,0,0,66,66,0,1,0,1,0
58206,445,0,0,66,66,0,1,0,1,0
61747,445,0,0,66,66,0,1,0,1,0
61802,445,0,0,70,70,0,1,0,1,0
60349,445,0,0,70,70,0,1,0,1,0
64938,445,0,0,66,66,0,1,0,1,0
64947,445,0,0,70,70,0,1,0,1,0
63425,445,0,0,70,70,0,1,0,1,0
52167,445,0,0,66,66,0,1,0,1,0
65285,445,0,0,70,70,0,1,0,1,0
64606,445,0,0,70,70,0,1,0,1,0
55060,445,0,0,70,70,0,1,0,1,0
60504,445,0,0,70,70,0,1,0,1,0
61737,445,0,0,70,70,0,1,0,1,0
62251,445,0,0,70,70,0,1,0,1,0
50987,445,0,0,70,70,0,1,0,1,0
51066,445,0,0,66,66,0,1,0,1,0
62448,445,0,0,70,70,0,1,0,1,0
62621,445,0,0,66,66,0,1,0,1,0
54035,445,0,0,66,66,0,1,0,1,0
56196,445,0,0,66,66,0,1,0,1,0
56641,445,0,0,70,70,0,1,0,1,0
50405,445,0,0,70,70,0,1,0,1,0
64361,445,0,0,66,66,0,1,0,1,0
54231,445,0,0,70,70,0,1,0,1,0
53917,445,0,0,70,70,0,1,0,1,0
63626,445,0,0,66,66,0,1,0,1,0
55866,445,0,0,66,66,0,1,0,1,0
57357,445,0,0,70,70,0,1,0,1,0
57634,445,0,0,66,66,0,1,0,1,0
64708,445,0,0,66,66,0,1,0,1,0
55673,445,0,0,66,66,0,1,0,1,0
63760,445,0,0,70,70,0,1,0,1,0
59286,445,0,0,70,70,0,1,0,1,0
58998,445,0,0,66,66,0,1,0,1,0
49912,445,0,0,70,70,0,1,0,1,0
57417,445,0,0,66,66,0,1,0,1,0
64019,445,0,0,66,66,0,1,0,1,0
55608,445,0,0,70,70,0,1,0,1,0
50604,445,0,0,66,66,0,1,0,1,0
57981,445,0,0,70,70,0,1,0,1,0
50322,445,0,0,70,70,0,1,0,1,0
57730,445,0,0,66,66,0,1,0,1,0
64920,445,0,0,66,66,0,1,0,1,0
57473,445,0,0,66,66,0,1,0,1,0
62164,445,0,0,70,70,0,1,0,1,0
52134,445,0,0,70,70,0,1,0,1,0
61828,445,0,0,70,70,0,1,0,1,0
54632,445,0,0,66,66,0,1,0,1,0
50601,445,0,0,66,66,0,1,0,1,0
65188,445,0,0,70,70,0,1,0,1,0
54096,445,0,0,66,66,0,1,0,1,0
62084,445,0,0,70,70,0,1,0,1,0
54059,445,0,0,66,66,0,1,0,1,0
52876,445,0,0,66,66,0,1,0,1,0
58946,445,0,0,70,70,0,1,0,1,0
58907,445,0,0,70,70,0,1,0,1,0
53495,445,0,0,66,66,0,1,0,1,0
64483,445,0,0,70,70,0,1,0,1,0
58135,445,0,0,66,66,0,1,0,1,0
60950,445,0,0,70,70,0,1,0,1,0
65131,445,0,0,66,66,0,1,0,1,0
63234,445,0,0,70,70,0,1,0,1,0
51388,445,0,0,70,70,0,1,0,1,0
61191,445,0,0,66,66,0,1,0,1,0
58500,445,0,0,66,66,0,1,0,1,0
52666,445,0,0,66,66,0,1,0,1,0
59709,445,0,0,66,66,0,1,0,1,0
53626,445,0,0,70,70,0,1,0,1,0
59917,445,0,0,70,70,0,1,0,1,0
63901,445,0,0,70,70,0,1,0,1,0
51625,445,0,0,66,66,0,1,0,1,0
64579,445,0,0,66,66,0,1,0,1,0
62107,445,0,0,70,70,0,1,0,1,0
50708,445,0,0,66,66,0,1,0,1,0
63646,445,0,0,70,70,0,1,0,1,0
55945,445,0,0,70,70,0,1,0,1,0
64477,445,0,0,70,70,0,1,0,1,0
62026,445,0,0,66,66,0,1,0,1,0
52168,445,0,0,66,66,0,1,0,1,0
63029,445,0,0,70,70,0,1,0,1,0
65096,445,0,0,66,66,0,1,0,1,0
55838,445,0,0,70,70,0,1,0,1,0
50100,445,0,0,70,70,0,1,0,1,0
62725,445,0,0,70,70,0,1,0,1,0
55504,445,0,0,70,70,0,1,0,1,0
52711,445,0,0,70,70,0,1,0,1,0
55617,445,0,0,66,66,0,1,0,1,0
57992,445,0,0,66,66,0,1,0,1,0
60529,445,0,0,70,70,0,1,0,1,0
60740,445,0,0,70,70,0,1,0,1,0
50347,445,0,0,70,70,0,1,0,1,0
52348,445,0,0,66,66,0,1,0,1,0
64291,445,0,0,66,66,0,1,0,1,0
62535,445,0,0,70,70,0,1,0,1,0
51300,445,0,0,70,70,0,1,0,1,0
53874,445,0,0,70,70,0,1,0,1,0
52697,445,0,0,70,70,0,1,0,1,0
54748,445,0,0,70,70,0,1,0,1,0
52988,445,0,0,66,66,0,1,0,1,0
61792,445,0,0,70,70,0,1,0,1,0
55093,445,0,0,70,70,0,1,0,1,0
55641,445,0,0,70,70,0,1,0,1,0
60972,445,0,0,70,70,0,1,0,1,0
55233,445,0,0,70,70,0,1,0,1,0
53829,445,0,0,66,66,0,1,0,1,0
60933,445,0,0,66,66,0,1,0,1,0
58521,445,0,0,70,70,0,1,0,1,0
65516,445,0,0,70,70,0,1,0,1,0
63708,445,0,0,66,66,0,1,0,1,0
61351,445,0,0,70,70,0,1,0,1,0
65257,445,0,0,66,66,0,1,0,1,0
57168,445,0,0,70,70,0,1,0,1,0
63322,445,0,0,70,70,0,1,0,1,0
50254,445,0,0,70,70,0,1,0,1,0
54415,445,0,0,70,70,0,1,0,1,0
58660,445,0,0,70,70,0,1,0,1,0
64341,445,0,0,66,66,0,1,0,1,0
57142,445,0,0,66,66,0,1,0,1,0
50418,445,0,0,70,70,0,1,0,1,0
50572,445,0,0,70,70,0,1,0,1,0
54642,445,0,0,70,70,0,1,0,1,0
50510,445,0,0,70,70,0,1,0,1,0
59969,445,0,0,70,70,0,1,0,1,0
54313,445,0,0,66,66,0,1,0,1,0
62458,445,0,0,70,70,0,1,0,1,0
63536,445,0,0,66,66,0,1,0,1,0
59086,445,0,0,66,66,0,1,0,1,0
59535,445,0,0,70,70,0,1,0,1,0
64455,445,0,0,70,70,0,1,0,1,0
54506,445,0,0,70,70,0,1,0,1,0
56562,445,0,0,66,66,0,1,0,1,0
57509,445,0,0,70,70,0,1,0,1,0
63791,445,0,0,70,70,0,1,0,1,0
50376,445,0,0,70,70,0,1,0,1,0
57192,445,0,0,70,70,0,1,0,1,0
50745,445,0,0,70,70,0,1,0,1,0
57583,445,0,0,70,70,0,1,0,1,0
49880,445,0,0,70,70,0,1,0,1,0
62548,445,0,0,70,70,0,1,0,1,0
54721,445,0,0,70,70,0,1,0,1,0
64049,445,0,0,70,70,0,1,0,1,0
53123,445,0,0,66,66,0,1,0,1,0
58372,445,0,0,66,66,0,1,0,1,0
58793,445,0,0,66,66,0,1,0,1,0
64023,445,0,0,70,70,0,1,0,1,0
56212,445,0,0,70,70,0,1,0,1,0
60243,445,0,0,70,70,0,1,0,1,0
51622,445,0,0,70,70,0,1,0,1,0
58862,445,0,0,70,70,0,1,0,1,0
65368,445,0,0,70,70,0,1,0,1,0
51339,445,0,0,70,70,0,1,0,1,0
62707,445,0,0,70,70,0,1,0,1,0
53481,445,0,0,70,70,0,1,0,1,0
52977,445,0,0,70,70,0,1,0,1,0
49352,445,0,0,70,70,0,1,0,1,0
60830,445,0,0,70,70,0,1,0,1,0
63627,445,0,0,66,66,0,1,0,1,0
64730,445,0,0,66,66,0,1,0,1,0
51923,445,0,0,70,70,0,1,0,1,0
52569,445,0,0,70,70,0,1,0,1,0
50402,445,0,0,70,70,0,1,0,1,0
53990,445,0,0,66,66,0,1,0,1,0
61099,445,0,0,70,70,0,1,0,1,0
55452,445,0,0,70,70,0,1,0,1,0
57673,445,0,0,66,66,0,1,0,1,0
50298,445,0,0,70,70,0,1,0,1,0
58369,445,0,0,66,66,0,1,0,1,0
64437,445,0,0,66,66,0,1,0,1,0
55595,445,0,0,70,70,0,1,0,1,0
50761,445,0,0,70,70,0,1,0,1,0
53758,445,0,0,70,70,0,1,0,1,0
59529,445,0,0,66,66,0,1,0,1,0
54251,445,0,0,70,70,0,1,0,1,0
60763,445,0,0,66,66,0,1,0,1,0
50643,445,0,0,70,70,0,1,0,1,0
54713,445,0,0,70,70,0,1,0,1,0
58923,445,0,0,66,66,0,1,0,1,0
49714,445,0,0,66,66,0,1,0,1,0
56519,445,0,0,70,70,0,1,0,1,0
54984,445,0,0,66,66,0,1,0,1,0
63051,445,0,0,66,66,0,1,0,1,0
55302,445,0,0,70,70,0,1,0,1,0
55020,445,0,0,70,70,0,1,0,1,0
50556,445,0,0,70,70,0,1,0,1,0
55288,445,0,0,66,66,0,1,0,1,0
55440,445,0,0,70,70,0,1,0,1,0
61114,445,0,0,70,70,0,1,0,1,0
49884,445,0,0,70,70,0,1,0,1,0
55160,445,0,0,70,70,0,1,0,1,0
64545,445,0,0,70,70,0,1,0,1,0
59166,445,0,0,70,70,0,1,0,1,0
57004,445,0,0,70,70,0,1,0,1,0
54518,445,0,0,66,66,0,1,0,1,0
50610,445,0,0,70,70,0,1,0,1,0
51072,445,0,0,70,70,0,1,0,1,0
55981,445,0,0,70,70,0,1,0,1,0
50620,445,0,0,66,66,0,1,0,1,0
65528,445,0,0,70,70,0,1,0,1,0
53191,445,0,0,70,70,0,1,0,1,0
64709,445,0,0,70,70,0,1,0,1,0
60046,445,0,0,70,70,0,1,0,1,0
52856,445,0,0,66,66,0,1,0,1,0
62876,445,0,0,66,66,0,1,0,1,0
60293,445,0,0,70,70,0,1,0,1,0
61522,445,0,0,66,66,0,1,0,1,0
56454,445,0,0,70,70,0,1,0,1,0
51101,445,0,0,70,70,0,1,0,1,0
59195,445,0,0,66,66,0,1,0,1,0
64774,445,0,0,70,70,0,1,0,1,0
51957,445,0,0,66,66,0,1,0,1,0
52292,445,0,0,70,70,0,1,0,1,0
58476,445,0,0,70,70,0,1,0,1,0
50252,445,0,0,66,66,0,1,0,1,0
62896,445,0,0,70,70,0,1,0,1,0
49779,445,0,0,66,66,0,1,0,1,0
50821,445,0,0,70,70,0,1,0,1,0
53529,445,0,0,70,70,0,1,0,1,0
52373,445,0,0,66,66,0,1,0,1,0
53589,445,0,0,70,70,0,1,0,1,0
60391,445,0,0,70,70,0,1,0,1,0
54570,445,0,0,66,66,0,1,0,1,0
50460,445,0,0,70,70,0,1,0,1,0
63419,445,0,0,70,70,0,1,0,1,0
63214,445,0,0,70,70,0,1,0,1,0
51055,445,0,0,70,70,0,1,0,1,0
65530,445,0,0,66,66,0,1,0,1,0
62571,445,0,0,70,70,0,1,0,1,0
62141,445,0,0,66,66,0,1,0,1,0
49325,445,0,0,70,70,0,1,0,1,0
60644,445,0,0,66,66,0,1,0,1,0
52012,445,0,0,66,66,0,1,0,1,0
52205,445,0,0,70,70,0,1,0,1,0
50101,445,0,0,66,66,0,1,0,1,0
56772,445,0,0,70,70,0,1,0,1,0
52313,445,0,0,70,70,0,1,0,1,0
61264,445,0,0,66,66,0,1,0,1,0
61741,445,0,0,70,70,0,1,0,1,0
61142,445,0,0,70,70,0,1,0,1,0
62519,445,0,0,70,70,0,1,0,1,0
51028,445,0,0,70,70,0,1,0,1,0
57383,445,0,0,70,70,0,1,0,1,0
57839,445,0,0,70,70,0,1,0,1,0
56638,445,0,0,70,70,0,1,0,1,0
62322,445,0,0,70,70,0,1,0,1,0
64645,445,0,0,70,70,0,1,0,1,0
50949,445,0,0,70,70,0,1,0,1,0
53107,445,0,0,70,70,0,1,0,1,0
53813,445,0,0,70,70,0,1,0,1,0
65252,445,0,0,70,70,0,1,0,1,0
59192,445,0,0,66,66,0,1,0,1,0
50482,445,0,0,70,70,0,1,0,1,0
61659,445,0,0,70,70,0,1,0,1,0
62907,445,0,0,70,70,0,1,0,1,0
51027,445,0,0,70,70,0,1,0,1,0
55357,445,0,0,70,70,0,1,0,1,0
53358,445,0,0,70,70,0,1,0,1,0
61088,445,0,0,70,70,0,1,0,1,0
59726,445,0,0,70,70,0,1,0,1,0
62260,445,0,0,66,66,0,1,0,1,0
62864,445,0,0,70,70,0,1,0,1,0
57541,445,0,0,70,70,0,1,0,1,0
50274,445,0,0,66,66,0,1,0,1,0
62277,445,0,0,70,70,0,1,0,1,0
64049,445,0,0,70,70,0,1,0,1,0
63799,445,0,0,70,70,0,1,0,1,0
54464,445,0,0,66,66,0,1,0,1,0
65231,445,0,0,70,70,0,1,0,1,0
55504,445,0,0,70,70,0,1,0,1,0
56326,445,0,0,66,66,0,1,0,1,0
63404,445,0,0,66,66,0,1,0,1,0
54870,445,0,0,70,70,0,1,0,1,0
64659,445,0,0,70,70,0,1,0,1,0
65483,445,0,0,70,70,0,1,0,1,0
50421,445,0,0,70,70,0,1,0,1,0
52461,445,0,0,70,70,0,1,0,1,0
60888,445,0,0,70,70,0,1,0,1,0
51136,445,0,0,70,70,0,1,0,1,0
61594,445,0,0,70,70,0,1,0,1,0
50585,445,0,0,70,70,0,1,0,1,0
60661,445,0,0,70,70,0,1,0,1,0
60142,445,0,0,70,70,0,1,0,1,0
52432,445,0,0,70,70,0,1,0,1,0
50123,445,0,0,70,70,0,1,0,1,0
62613,445,0,0,66,66,0,1,0,1,0
51365,445,0,0,66,66,0,1,0,1,0
49852,445,0,0,70,70,0,1,0,1,0
58058,445,0,0,66,66,0,1,0,1,0
64540,445,0,0,70,70,0,1,0,1,0
63787,445,0,0,70,70,0,1,0,1,0
65367,445,0,0,70,70,0,1,0,1,0
61985,445,0,0,70,70,0,1,0,1,0
64765,445,0,0,66,66,0,1,0,1,0
65091,445,0,0,70,70,0,1,0,1,0
63610,445,0,0,70,70,0,1,0,1,0
58996,445,0,0,70,70,0,1,0,1,0
60246,445,0,0,66,66,0,1,0,1,0
63932,445,0,0,66,66,0,1,0,1,0
55068,445,0,0,70,70,0,1,0,1,0
61479,445,0,0,70,70,0,1,0,1,0
63620,445,0,0,70,70,0,1,0,1,0
57645,445,0,0,70,70,0,1,0,1,0
63448,445,0,0,70,70,0,1,0,1,0
63272,445,0,0,70,70,0,1,0,1,0
58835,445,0,0,66,66,0,1,0,1,0
61816,445,0,0,70,70,0,1,0,1,0
63857,445,0,0,70,70,0,1,0,1,0
60757,445,0,0,66,66,0,1,0,1,0
57998,445,0,0,66,66,0,1,0,1,0
58408,445,0,0,70,70,0,1,0,1,0
59743,445,0,0,70,70,0,1,0,1,0
62164,445,0,0,70,70,0,1,0,1,0
58605,445,0,0,70,70,0,1,0,1,0
52198,445,0,0,70,70,0,1,0,1,0
63644,445,0,0,70,70,0,1,0,1,0
56609,445,0,0,66,66,0,1,0,1,0
51713,445,0,0,66,66,0,1,0,1,0
49938,445,0,0,70,70,0,1,0,1,0
55176,445,0,0,70,70,0,1,0,1,0
55856,445,0,0,66,66,0,1,0,1,0
57324,445,0,0,70,70,0,1,0,1,0
65197,445,0,0,66,66,0,1,0,1,0
49189,445,0,0,70,70,0,1,0,1,0
62649,445,0,0,70,70,0,1,0,1,0
57156,445,0,0,66,66,0,1,0,1,0
54719,445,0,0,70,70,0,1,0,1,0
57545,445,0,0,66,66,0,1,0,1,0
53940,445,0,0,66,66,0,1,0,1,0
63146,445,0,0,66,66,0,1,0,1,0
50503,445,0,0,66,66,0,1,0,1,0
51171,445,0,0,70,70,0,1,0,1,0
49813,445,0,0,70,70,0,1,0,1,0
57911,445,0,0,66,66,0,1,0,1,0
51335,445,0,0,70,70,0,1,0,1,0
58740,445,0,0,70,70,0,1,0,1,0
62893,445,0,0,66,66,0,1,0,1,0
62793,445,0,0,70,70,0,1,0,1,0
49923,445,0,0,70,70,0,1,0,1,0
64462,445,0,0,70,70,0,1,0,1,0
63369,445,0,0,70,70,0,1,0,1,0
61974,445,0,0,70,70,0,1,0,1,0
52207,445,0,0,70,70,0,1,0,1,0
60308,445,0,0,66,66,0,1,0,1,0
64133,445,0,0,70,70,0,1,0,1,0
50517,445,0,0,70,70,0,1,0,1,0
63918,445,0,0,66,66,0,1,0,1,0
58356,445,0,0,66,66,0,1,0,1,0
64890,445,0,0,70,70,0,1,0,1,0
58923,445,0,0,70,70,0,1,0,1,0
58786,445,0,0,70,70,0,1,0,1,0
57333,445,0,0,66,66,0,1,0,1,0
63339,445,0,0,66,66,0,1,0,1,0
49242,445,0,0,70,70,0,1,0,1,0
60686,445,0,0,70,70,0,1,0,1,0
56298,445,0,0,70,70,0,1,0,1,0
57094,445,0,0,70,70,0,1,0,1,0
62557,445,0,0,66,66,0,1,0,1,0
58955,445,0,0,66,66,0,1,0,1,0
50637,445,0,0,66,66,0,1,0,1,0
57043,445,0,0,70,70,0,1,0,1,0
55443,445,0,0,70,70,0,1,0,1,0
61609,445,0,0,70,70,0,1,0,1,0
64737,445,0,0,66,66,0,1,0,1,0
62533,445,0,0,70,70,0,1,0,1,0
57965,445,0,0,70,70,0,1,0,1,0
49821,445,0,0,70,70,0,1,0,1,0
62855,445,0,0,70,70,0,1,0,1,0
53502,445,0,0,70,70,0,1,0,1,0
51826,445,0,0,70,70,0,1,0,1,0
53599,445,0,0,70,70,0,1,0,1,0
58445,445,0,0,70,70,0,1,0,1,0
53105,445,0,0,70,70,0,1,0,1,0
52583,445,0,0,66,66,0,1,0,1,0
55164,445,0,0,66,66,0,1,0,1,0
50198,445,0,0,66,66,0,1,0,1,0
63316,445,0,0,66,66,0,1,0,1,0
55055,445,0,0,70,70,0,1,0,1,0
58127,445,0,0,70,70,0,1,0,1,0
55068,445,0,0,70,70,0,1,0,1,0
65060,445,0,0,70,70,0,1,0,1,0
55140,445,0,0,70,70,0,1,0,1,0
64563,445,0,0,70,70,0,1,0,1,0
57257,445,0,0,70,70,0,1,0,1,0
50304,445,0,0,70,70,0,1,0,1,0
61488,445,0,0,70,70,0,1,0,1,0
60342,445,0,0,66,66,0,1,0,1,0
61806,445,0,0,66,66,0,1,0,1,0
50582,445,0,0,70,70,0,1,0,1,0
59213,445,0,0,66,66,0,1,0,1,0
58701,445,0,0,70,70,0,1,0,1,0
54392,445,0,0,66,66,0,1,0,1,0
51076,445,0,0,66,66,0,1,0,1,0
50878,445,0,0,70,70,0,1,0,1,0
49204,445,0,0,66,66,0,1,0,1,0
62759,445,0,0,70,70,0,1,0,1,0
56435,445,0,0,66,66,0,1,0,1,0
56430,445,0,0,70,70,0,1,0,1,0
50963,445,0,0,66,66,0,1,0,1,0
53328,445,0,0,66,66,0,1,0,1,0
51444,445,0,0,66,66,0,1,0,1,0
62297,445,0,0,70,70,0,1,0,1,0
57817,445,0,0,70,70,0,1,0,1,0
54766,445,0,0,70,70,0,1,0,1,0
50125,445,0,0,70,70,0,1,0,1,0
58117,445,0,0,70,70,0,1,0,1,0
56489,445,0,0,70,70,0,1,0,1,0
62129,445,0,0,70,70,0,1,0,1,0
53816,445,0,0,70,70,0,1,0,1,0
52142,445,0,0,70,70,0,1,0,1,0
62792,445,0,0,66,66,0,1,0,1,0
50806,445,0,0,70,70,0,1,0,1,0
58521,445,0,0,70,70,0,1,0,1,0
60788,445,0,0,70,70,0,1,0,1,0
54434,445,0,0,70,70,0,1,0,1,0
49443,445,0,0,70,70,0,1,0,1,0
55294,445,0,0,66,66,0,1,0,1,0
51247,445,0,0,66,66,0,1,0,1,0
51524,445,0,0,66,66,0,1,0,1,0
58761,445,0,0,66,66,0,1,0,1,0
59534,445,0,0,66,66,0,1,0,1,0
61064,445,0,0,66,66,0,1,0,1,0
53223,445,0,0,66,66,0,1,0,1,0
62638,445,0,0,70,70,0,1,0,1,0
64274,445,0,0,70,70,0,1,0,1,0
50870,445,0,0,70,70,0,1,0,1,0
63702,445,0,0,66,66,0,1,0,1,0
60436,445,0,0,66,66,0,1,0,1,0
61212,445,0,0,66,66,0,1,0,1,0
58741,445,0,0,66,66,0,1,0,1,0
51121,445,0,0,66,66,0,1,0,1,0
51880,445,0,0,70,70,0,1,0,1,0
61197,445,0,0,70,70,0,1,0,1,0
50464,445,0,0,70,70,0,1,0,1,0
54385,445,0,0,70,70,0,1,0,1,0
60710,445,0,0,66,66,0,1,0,1,0
57689,445,0,0,70,70,0,1,0,1,0
59467,445,0,0,66,66,0,1,0,1,0
57411,445,0,0,66,66,0,1,0,1,0
60354,445,0,0,70,70,0,1,0,1,0
52806,445,0,0,70,70,0,1,0,1,0
50287,445,0,0,66,66,0,1,0,1,0
49351,445,0,0,70,70,0,1,0,1,0
65068,445,0,0,70,70,0,1,0,1,0
64289,445,0,0,66,66,0,1,0,1,0
54586,445,0,0,66,66,0,1,0,1,0
62102,445,0,0,66,66,0,1,0,1,0
52791,445,0,0,66,66,0,1,0,1,0
60969,445,0,0,66,66,0,1,0,1,0
63049,445,0,0,70,70,0,1,0,1,0
64600,445,0,0,70,70,0,1,0,1,0
56945,445,0,0,70,70,0,1,0,1,0
49602,445,0,0,70,70,0,1,0,1,0
59653,445,0,0,70,70,0,1,0,1,0
58209,445,0,0,70,70,0,1,0,1,0
62033,445,0,0,66,66,0,1,0,1,0
62538,445,0,0,66,66,0,1,0,1,0
57202,445,0,0,66,66,0,1,0,1,0
59128,445,0,0,66,66,0,1,0,1,0
59315,445,0,0,70,70,0,1,0,1,0
63685,445,0,0,70,70,0,1,0,1,0
58098,445,0,0,66,66,0,1,0,1,0
55355,445,0,0,70,70,0,1,0,1,0
55600,445,0,0,66,66,0,1,0,1,0
54060,445,0,0,66,66,0,1,0,1,0
64210,445,0,0,70,70,0,1,0,1,0
61403,445,0,0,66,66,0,1,0,1,0
60548,445,0,0,70,70,0,1,0,1,0
62608,445,0,0,70,70,0,1,0,1,0
57644,445,0,0,70,70,0,1,0,1,0
52959,445,0,0,70,70,0,1,0,1,0
53233,445,0,0,70,70,0,1,0,1,0
50654,445,0,0,66,66,0,1,0,1,0
64017,445,0,0,66,66,0,1,0,1,0
54054,445,0,0,70,70,0,1,0,1,0
49688,445,0,0,70,70,0,1,0,1,0
55713,445,0,0,70,70,0,1,0,1,0
60310,445,0,0,66,66,0,1,0,1,0
52795,445,0,0,66,66,0,1,0,1,0
61601,445,0,0,70,70,0,1,0,1,0
53290,445,0,0,66,66,0,1,0,1,0
49835,445,0,0,70,70,0,1,0,1,0
50957,445,0,0,70,70,0,1,0,1,0
59570,445,0,0,70,70,0,1,0,1,0
53385,445,0,0,70,70,0,1,0,1,0
63624,445,0,0,70,70,0,1,0,1,0
60406,445,0,0,66,66,0,1,0,1,0
56391,445,0,0,66,66,0,1,0,1,0
63259,445,0,0,70,70,0,1,0,1,0
60134,445,0,0,66,66,0,1,0,1,0
55489,445,0,0,70,70,0,1,0,1,0
50625,445,0,0,70,70,0,1,0,1,0
50562,445,0,0,66,66,0,1,0,1,0
61174,445,0,0,70,70,0,1,0,1,0
50454,445,0,0,70,70,0,1,0,1,0
59732,445,0,0,70,70,0,1,0,1,0
56008,445,0,0,66,66,0,1,0,1,0
50480,445,0,0,66,66,0,1,0,1,0
58068,445,0,0,66,66,0,1,0,1,0
62685,445,0,0,70,70,0,1,0,1,0
53562,445,0,0,70,70,0,1,0,1,0
61933,445,0,0,66,66,0,1,0,1,0
63024,445,0,0,70,70,0,1,0,1,0
60481,445,0,0,70,70,0,1,0,1,0
50141,445,0,0,70,70,0,1,0,1,0
57758,445,0,0,70,70,0,1,0,1,0
64346,445,0,0,70,70,0,1,0,1,0
63860,445,0,0,66,66,0,1,0,1,0
56922,445,0,0,70,70,0,1,0,1,0
62854,445,0,0,70,70,0,1,0,1,0
53141,445,0,0,66,66,0,1,0,1,0
55252,445,0,0,70,70,0,1,0,1,0
55591,445,0,0,70,70,0,1,0,1,0
50196,445,0,0,70,70,0,1,0,1,0
54327,445,0,0,70,70,0,1,0,1,0
49784,445,0,0,70,70,0,1,0,1,0
49710,445,0,0,70,70,0,1,0,1,0
52144,445,0,0,70,70,0,1,0,1,0
62025,445,0,0,66,66,0,1,0,1,0
53274,445,0,0,70,70,0,1,0,1,0
52391,445,0,0,66,66,0,1,0,1,0
53852,445,0,0,70,70,0,1,0,1,0
62512,445,0,0,70,70,0,1,0,1,0
62041,445,0,0,70,70,0,1,0,1,0
55256,445,0,0,70,70,0,1,0,1,0
55450,445,0,0,70,70,0,1,0,1,0
64379,445,0,0,70,70,0,1,0,1,0
65482,445,0,0,70,70,0,1,0,1,0
60762,445,0,0,66,66,0,1,0,1,0
55869,445,0,0,66,66,0,1,0,1,0
60259,445,0,0,70,70,0,1,0,1,0
53038,445,0,0,70,70,0,1,0,1,0
55523,445,0,0,70,70,0,1,0,1,0
60281,445,0,0,70,70,0,1,0,1,0
58484,445,0,0,66,66,0,1,0,1,0
51805,445,0,0,70,70,0,1,0,1,0
65220,445,0,0,70,70,0,1,0,1,0
56098,445,0,0,70,70,0,1,0,1,0
61849,445,0,0,66,66,0,1,0,1,0
58290,445,0,0,70,70,0,1,0,1,0
61902,445,0,0,66,66,0,1,0,1,0
58958,445,0,0,70,70,0,1,0,1,0
53609,445,0,0,66,66,0,1,0,1,0
51266,445,0,0,66,66,0,1,0,1,0
63494,445,0,0,70,70,0,1,0,1,0
59079,445,0,0,66,66,0,1,0,1,0
50629,445,0,0,66,66,0,1,0,1,0
65136,445,0,0,66,66,0,1,0,1,0
57843,445,0,0,66,66,0,1,0,1,0
58352,445,0,0,70,70,0,1,0,1,0
49643,445,0,0,70,70,0,1,0,1,0
59919,445,0,0,70,70,0,1,0,1,0
53026,445,0,0,70,70,0,1,0,1,0
54858,445,0,0,70,70,0,1,0,1,0
58185,445,0,0,66,66,0,1,0,1,0
63545,445,0,0,70,70,0,1,0,1,0
61653,445,0,0,70,70,0,1,0,1,0
62743,445,0,0,66,66,0,1,0,1,0
49518,445,0,0,70,70,0,1,0,1,0
50605,445,0,0,70,70,0,1,0,1,0
50671,445,0,0,66,66,0,1,0,1,0
64567,445,0,0,70,70,0,1,0,1,0
63830,445,0,0,66,66,0,1,0,1,0
57429,445,0,0,70,70,0,1,0,1,0
65404,445,0,0,70,70,0,1,0,1,0
63538,445,0,0,70,70,0,1,0,1,0
63787,445,0,0,66,66,0,1,0,1,0
58806,445,0,0,70,70,0,1,0,1,0
57877,445,0,0,70,70,0,1,0,1,0
56198,445,0,0,70,70,0,1,0,1,0
50859,445,0,0,66,66,0,1,0,1,0
52475,445,0,0,70,70,0,1,0,1,0
57755,445,0,0,70,70,0,1,0,1,0
60143,445,0,0,70,70,0,1,0,1,0
56362,445,0,0,70,70,0,1,0,1,0
53637,445,0,0,70,70,0,1,0,1,0
64507,445,0,0,66,66,0,1,0,1,0
57149,445,0,0,70,70,0,1,0,1,0
53586,445,0,0,70,70,0,1,0,1,0
57501,445,0,0,70,70,0,1,0,1,0
58792,445,0,0,70,70,0,1,0,1,0
52807,445,0,0,66,66,0,1,0,1,0
50035,445,0,0,70,70,0,1,0,1,0
59228,445,0,0,66,66,0,1,0,1,0
57231,445,0,0,70,70,0,1,0,1,0
65029,445,0,0,70,70,0,1,0,1,0
62915,445,0,0,70,70,0,1,0,1,0
52919,445,0,0,70,70,0,1,0,1,0
64057,445,0,0,70,70,0,1,0,1,0
50172,445,0,0,70,70,0,1,0,1,0
56663,445,0,0,70,70,0,1,0,1,0
55462,445,0,0,70,70,0,1,0,1,0
50219,445,0,0,70,70,0,1,0,1,0
56673,445,0,0,70,70,0,1,0,1,0
61561,445,0,0,70,70,0,1,0,1,0
60238,445,0,0,70,70,0,1,0,1,0
49743,445,0,0,66,66,0,1,0,1,0
61404,445,0,0,70,70,0,1,0,1,0
62324,445,0,0,70,70,0,1,0,1,0
57277,445,0,0,66,66,0,1,0,1,0
49420,445,0,0,70,70,0,1,0,1,0
57262,445,0,0,70,70,0,1,0,1,0
50897,445,0,0,70,70,0,1,0,1,0
53093,445,0,0,66,66,0,1,0,1,0
62616,445,0,0,66,66,0,1,0,1,0
64650,445,0,0,70,70,0,1,0,1,0
60740,445,0,0,70,70,0,1,0,1,0
61128,445,0,0,66,66,0,1,0,1,0
56063,445,0,0,70,70,0,1,0,1,0
55966,445,0,0,70,70,0,1,0,1,0
52212,445,0,0,66,66,0,1,0,1,0
57002,445,0,0,70,70,0,1,0,1,0
64612,445,0,0,66,66,0,1,0,1,0
54602,445,0,0,66,66,0,1,0,1,0
56906,445,0,0,70,70,0,1,0,1,0
60316,445,0,0,66,66,0,1,0,1,0
59017,445,0,0,70,70,0,1,0,1,0
52729,445,0,0,66,66,0,1,0,1,0
58713,445,0,0,66,66,0,1,0,1,0
63328,445,0,0,70,70,0,1,0,1,0
56649,445,0,0,66,66,0,1,0,1,0
59287,445,0,0,70,70,0,1,0,1,0
64198,445,0,0,70,70,0,1,0,1,0
58134,445,0,0,70,70,0,1,0,1,0
60677,445,0,0,70,70,0,1,0,1,0
56511,445,0,0,70,70,0,1,0,1,0
56247,445,0,0,66,66,0,1,0,1,0
53048,445,0,0,70,70,0,1,0,1,0
60829,445,0,0,70,70,0,1,0,1,0
61718,445,0,0,66,66,0,1,0,1,0
58002,445,0,0,70,70,0,1,0,1,0
50725,445,0,0,66,66,0,1,0,1,0
61916,445,0,0,66,66,0,1,0,1,0
64476,445,0,0,70,70,0,1,0,1,0
52383,445,0,0,66,66,0,1,0,1,0
55211,445,0,0,66,66,0,1,0,1,0
54951,445,0,0,70,70,0,1,0,1,0
55532,445,0,0,70,70,0,1,0,1,0
59971,445,0,0,70,70,0,1,0,1,0
61425,445,0,0,70,70,0,1,0,1,0
59435,445,0,0,70,70,0,1,0,1,0
53916,445,0,0,70,70,0,1,0,1,0
51045,445,0,0,66,66,0,1,0,1,0
55621,445,0,0,70,70,0,1,0,1,0
64103,445,0,0,66,66,0,1,0,1,0
56364,445,0,0,70,70,0,1,0,1,0
53241,445,0,0,66,66,0,1,0,1,0
65237,445,0,0,70,70,0,1,0,1,0
51453,445,0,0,66,66,0,1,0,1,0
62067,445,0,0,70,70,0,1,0,1,0
55933,445,0,0,66,66,0,1,0,1,0
51619,445,0,0,66,66,0,1,0,1,0
55519,445,0,0,70,70,0,1,0,1,0
49171,445,0,0,70,70,0,1,0,1,0
60356,445,0,0,66,66,0,1,0,1,0
59143,445,0,0,70,70,0,1,0,1,0
53984,445,0,0,70,70,0,1,0,1,0
63143,445,0,0,70,70,0,1,0,1,0
64557,445,0,0,70,70,0,1,0,1,0
52306,445,0,0,70,70,0,1,0,1,0
55807,445,0,0,66,66,0,1,0,1,0
57892,445,0,0,70,70,0,1,0,1,0
59899,445,0,0,66,66,0,1,0,1,0
61202,445,0,0,70,70,0,1,0,1,0
55070,445,0,0,70,70,0,1,0,1,0
65099,445,0,0,70,70,0,1,0,1,0
55231,445,0,0,70,70,0,1,0,1,0
59232,445,0,0,70,70,0,1,0,1,0
63156,445,0,0,66,66,0,1,0,1,0
63847,445,0,0,70,70,0,1,0,1,0
62768,445,0,0,70,70,0,1,0,1,0
60343,445,0,0,70,70,0,1,0,1,0
60695,445,0,0,66,66,0,1,0,1,0
64900,445,0,0,70,70,0,1,0,1,0
59415,445,0,0,70,70,0,1,0,1,0
49463,445,0,0,70,70,0,1,0,1,0
50822,445,0,0,70,70,0,1,0,1,0
57795,445,0,0,66,66,0,1,0,1,0
61827,445,0,0,70,70,0,1,0,1,0
57484,445,0,0,70,70,0,1,0,1,0
60863,445,0,0,70,70,0,1,0,1,0
55548,445,0,0,66,66,0,1,0,1,0
64205,445,0,0,70,70,0,1,0,1,0
58182,445,0,0,66,66,0,1,0,1,0
55267,445,0,0,70,70,0,1,0,1,0
51264,445,0,0,70,70,0,1,0,1,0
55953,445,0,0,70,70,0,1,0,1,0
55088,445,0,0,70,70,0,1,0,1,0
55487,445,0,0,70,70,0,1,0,1,0
65179,445,0,0,70,70,0,1,0,1,0
60085,445,0,0,66,66,0,1,0,1,0
58574,445,0,0,66,66,0,1,0,1,0
50293,445,0,0,70,70,0,1,0,1,0
64516,445,0,0,70,70,0,1,0,1,0
59790,445,0,0,66,66,0,1,0,1,0
64899,445,0,0,70,70,0,1,0,1,0
61773,445,0,0,66,66,0,1,0,1,0
56836,445,0,0,70,70,0,1,0,1,0
61528,445,0,0,66,66,0,1,0,1,0
50511,445,0,0,66,66,0,1,0,1,0
49965,445,0,0,70,70,0,1,0,1,0
56192,445,0,0,70,70,0,1,0,1,0
51599,445,0,0,66,66,0,1,0,1,0
64643,445,0,0,70,70,0,1,0,1,0
55918,445,0,0,70,70,0,1,0,1,0
60574,445,0,0,70,70,0,1,0,1,0
52326,445,0,0,66,66,0,1,0,1,0
50068,445,0,0,70,70,0,1,0,1,0
64100,445,0,0,66,66,0,1,0,1,0
51205,445,0,0,70,70,0,1,0,1,0
53645,445,0,0,66,66,0,1,0,1,0
64886,445,0,0,70,70,0,1,0,1,0
61973,445,0,0,66,66,0,1,0,1,0
64267,445,0,0,70,70,0,1,0,1,0
50162,445,0,0,66,66,0,1,0,1,0
59529,445,0,0,70,70,0,1,0,1,0
52641,445,0,0,70,70,0,1,0,1,0
65291,445,0,0,70,70,0,1,0,1,0
59622,445,0,0,70,70,0,1,0,1,0
55372,445,0,0,70,70,0,1,0,1,0
57949,445,0,0,66,66,0,1,0,1,0
65187,445,0,0,70,70,0,1,0,1,0
65521,445,0,0,66,66,0,1,0,1,0
50343,445,0,0,66,66,0,1,0,1,0
63815,445,0,0,70,70,0,1,0,1,0
51054,445,0,0,70,70,0,1,0,1,0
63520,445,0,0,66,66,0,1,0,1,0
61165,445,0,0,70,70,0,1,0,1,0
51041,445,0,0,70,70,0,1,0,1,0
58392,445,0,0,66,66,0,1,0,1,0
58395,445,0,0,70,70,0,1,0,1,0
63790,445,0,0,70,70,0,1,0,1,0
64231,445,0,0,70,70,0,1,0,1,0
61612,445,0,0,70,70,0,1,0,1,0
50798,445,0,0,70,70,0,1,0,1,0
55976,445,0,0,70,70,0,1,0,1,0
55084,445,0,0,70,70,0,1,0,1,0
62177,445,0,0,66,66,0,1,0,1,0
50978,445,0,0,66,66,0,1,0,1,0
53517,445,0,0,66,66,0,1,0,1,0
61403,445,0,0,70,70,0,1,0,1,0
60714,445,0,0,70,70,0,1,0,1,0
58609,445,0,0,70,70,0,1,0,1,0
61076,445,0,0,70,70,0,1,0,1,0
55594,445,0,0,66,66,0,1,0,1,0
52438,445,0,0,70,70,0,1,0,1,0
62077,445,0,0,66,66,0,1,0,1,0
58278,445,0,0,70,70,0,1,0,1,0
64573,445,0,0,70,70,0,1,0,1,0
57056,445,0,0,70,70,0,1,0,1,0
51389,445,0,0,66,66,0,1,0,1,0
56392,445,0,0,66,66,0,1,0,1,0
53238,445,0,0,66,66,0,1,0,1,0
49657,445,0,0,70,70,0,1,0,1,0
54572,445,0,0,70,70,0,1,0,1,0
54679,445,0,0,66,66,0,1,0,1,0
61589,445,0,0,66,66,0,1,0,1,0
51685,445,0,0,66,66,0,1,0,1,0
60371,445,0,0,66,66,0,1,0,1,0
60521,445,0,0,66,66,0,1,0,1,0
59357,445,0,0,70,70,0,1,0,1,0
58799,445,0,0,70,70,0,1,0,1,0
51882,445,0,0,66,66,0,1,0,1,0
63972,445,0,0,66,66,0,1,0,1,0
55634,445,0,0,70,70,0,1,0,1,0
62446,445,0,0,66,66,0,1,0,1,0
50398,445,0,0,66,66,0,1,0,1,0
58298,445,0,0,70,70,0,1,0,1,0
53508,445,0,0,70,70,0,1,0,1,0
58939,445,0,0,66,66,0,1,0,1,0
58457,445,0,0,70,70,0,1,0,1,0
51372,445,0,0,70,70,0,1,0,1,0
50626,445,0,0,66,66,0,1,0,1,0
55972,445,0,0,70,70,0,1,0,1,0
60822,445,0,0,66,66,0,1,0,1,0
61911,445,0,0,66,66,0,1,0,1,0
51302,445,0,0,70,70,0,1,0,1,0
54990,445,0,0,70,70,0,1,0,1,0
52296,445,0,0,66,66,0,1,0,1,0
55233,445,0,0,70,70,0,1,0,1,0
51510,445,0,0,66,66,0,1,0,1,0
57649,445,0,0,70,70,0,1,0,1,0
61083,445,0,0,66,66,0,1,0,1,0
60923,445,0,0,70,70,0,1,0,1,0
59474,445,0,0,70,70,0,1,0,1,0
56153,445,0,0,66,66,0,1,0,1,0
58839,445,0,0,70,70,0,1,0,1,0
59465,445,0,0,70,70,0,1,0,1,0
54520,445,0,0,70,70,0,1,0,1,0
64841,445,0,0,70,70,0,1,0,1,0
63037,445,0,0,66,66,0,1,0,1,0
51431,445,0,0,70,70,0,1,0,1,0
54962,445,0,0,66,66,0,1,0,1,0
56937,445,0,0,70,70,0,1,0,1,0
51164,445,0,0,66,66,0,1,0,1,0
53132,445,0,0,70,70,0,1,0,1,0
50415,445,0,0,66,66,0,1,0,1,0
51825,445,0,0,70,70,0,1,0,1,0
56256,445,0,0,70,70,0,1,0,1,0
53853,445,0,0,70,70,0,1,0,1,0
54571,445,0,0,70,70,0,1,0,1,0
58243,445,0,0,70,70,0,1,0,1,0
57661,445,0,0,70,70,0,1,0,1,0
61146,445,0,0,70,70,0,1,0,1,0
54497,445,0,0,70,70,0,1,0,1,0
57880,445,0,0,70,70,0,1,0,1,0
58420,445,0,0,70,70,0,1,0,1,0
59722,445,0,0,66,66,0,1,0,1,0
53625,445,0,0,66,66,0,1,0,1,0
60295,445,0,0,70,70,0,1,0,1,0
56183,445,0,0,70,70,0,1,0,1,0
55799,445,0,0,70,70,0,1,0,1,0
53367,445,0,0,70,70,0,1,0,1,0
59296,445,0,0,70,70,0,1,0,1,0
60965,445,0,0,70,70,0,1,0,1,0
56675,445,0,0,70,70,0,1,0,1,0
53646,445,0,0,70,70,0,1,0,1,0
49936,445,0,0,70,70,0,1,0,1,0
54926,445,0,0,70,70,0,1,0,1,0
58444,445,0,0,70,70,0,1,0,1,0
61334,445,0,0,66,66,0,1,0,1,0
50911,445,0,0,70,70,0,1,0,1,0
61927,445,0,0,66,66,0,1,0,1,0
55161,445,0,0,70,70,0,1,0,1,0
62020,445,0,0,70,70,0,1,0,1,0
60732,445,0,0,70,70,0,1,0,1,0
49267,445,0,0,66,66,0,1,0,1,0
55292,445,0,0,66,66,0,1,0,1,0
56343,445,0,0,66,66,0,1,0,1,0
59346,445,0,0,70,70,0,1,0,1,0
54403,445,0,0,70,70,0,1,0,1,0
53879,445,0,0,66,66,0,1,0,1,0
55747,445,0,0,70,70,0,1,0,1,0
51115,445,0,0,70,70,0,1,0,1,0
52553,445,0,0,70,70,0,1,0,1,0
59395,445,0,0,70,70,0,1,0,1,0
58570,445,0,0,70,70,0,1,0,1,0
63488,445,0,0,70,70,0,1,0,1,0
61271,445,0,0,66,66,0,1,0,1,0
53287,445,0,0,70,70,0,1,0,1,0
56371,445,0,0,66,66,0,1,0,1,0
59277,445,0,0,66,66,0,1,0,1,0
61779,445,0,0,70,70,0,1,0,1,0
56168,445,0,0,70,70,0,1,0,1,0
49769,445,0,0,70,70,0,1,0,1,0
50365,445,0,0,66,66,0,1,0,1,0
52370,445,0,0,66,66,0,1,0,1,0
65372,445,0,0,70,70,0,1,0,1,0
51209,445,0,0,66,66,0,1,0,1,0
62484,445,0,0,70,70,0,1,0,1,0
57803,445,0,0,70,70,0,1,0,1,0
60219,445,0,0,70,70,0,1,0,1,0
49910,445,0,0,66,66,0,1,0,1,0
56973,445,0,0,70,70,0,1,0,1,0
50764,445,0,0,70,70,0,1,0,1,0
58060,445,0,0,70,70,0,1,0,1,0
51077,445,0,0,70,70,0,1,0,1,0
64460,445,0,0,70,70,0,1,0,1,0
63022,445,0,0,70,70,0,1,0,1,0
64617,445,0,0,66,66,0,1,0,1,0
55651,445,0,0,70,70,0,1,0,1,0
56813,445,0,0,70,70,0,1,0,1,0
64422,445,0,0,66,66,0,1,0,1,0
55316,445,0,0,66,66,0,1,0,1,0
55265,445,0,0,70,70,0,1,0,1,0
49346,445,0,0,70,70,0,1,0,1,0
52710,445,0,0,70,70,0,1,0,1,0
56417,445,0,0,70,70,0,1,0,1,0
50170,445,0,0,70,70,0,1,0,1,0
55038,445,0,0,70,70,0,1,0,1,0
59552,445,0,0,66,66,0,1,0,1,0
61270,445,0,0,70,70,0,1,0,1,0
59703,445,0,0,70,70,0,1,0,1,0
52662,445,0,0,70,70,0,1,0,1,0
56960,445,0,0,70,70,0,1,0,1,0
56130,445,0,0,70,70,0,1,0,1,0
62629,445,0,0,70,70,0,1,0,1,0
54727,445,0,0,70,70,0,1,0,1,0
50754,445,0,0,70,70,0,1,0,1,0
51117,445,0,0,66,66,0,1,0,1,0
62473,445,0,0,70,70,0,1,0,1,0
53037,445,0,0,66,66,0,1,0,1,0
60838,445,0,0,70,70,0,1,0,1,0
60614,445,0,0,70,70,0,1,0,1,0
63657,445,0,0,70,70,0,1,0,1,0
50126,445,0,0,70,70,0,1,0,1,0
62212,445,0,0,70,70,0,1,0,1,0
52227,445,0,0,70,70,0,1,0,1,0
63472,445,0,0,70,70,0,1,0,1,0
64856,445,0,0,66,66,0,1,0,1,0
51881,445,0,0,66,66,0,1,0,1,0
54711,445,0,0,70,70,0,1,0,1,0
56013,445,0,0,66,66,0,1,0,1,0
54554,445,0,0,70,70,0,1,0,1,0
54135,445,0,0,70,70,0,1,0,1,0
65516,445,0,0,70,70,0,1,0,1,0
53123,445,0,0,70,70,0,1,0,1,0
57986,445,0,0,70,70,0,1,0,1,0
59916,445,0,0,66,66,0,1,0,1,0
61591,445,0,0,66,66,0,1,0,1,0
62316,445,0,0,70,70,0,1,0,1,0
54187,445,0,0,66,66,0,1,0,1,0
54930,445,0,0,70,70,0,1,0,1,0
49734,445,0,0,66,66,0,1,0,1,0
62395,445,0,0,70,70,0,1,0,1,0
64232,445,0,0,66,66,0,1,0,1,0
62488,445,0,0,70,70,0,1,0,1,0
63042,445,0,0,70,70,0,1,0,1,0
56774,445,0,0,66,66,0,1,0,1,0
50446,445,0,0,70,70,0,1,0,1,0
55162,445,0,0,70,70,0,1,0,1,0
62492,445,0,0,70,70,0,1,0,1,0
53814,445,0,0,66,66,0,1,0,1,0
58404,445,0,0,70,70,0,1,0,1,0
55838,445,0,0,70,70,0,1,0,1,0
65063,445,0,0,66,66,0,1,0,1,0
54276,445,0,0,70,70,0,1,0,1,0
51826,445,0,0,66,66,0,1,0,1,0
61846,445,0,0,70,70,0,1,0,1,0
63085,445,0,0,70,70,0,1,0,1,0
55696,445,0,0,70,70,0,1,0,1,0
63596,445,0,0,66,66,0,1,0,1,0
63460,445,0,0,70,70,0,1,0,1,0
63206,445,0,0,70,70,0,1,0,1,0
64220,445,0,0,66,66,0,1,0,1,0
60176,445,0,0,70,70,0,1,0,1,0
55211,445,0,0,70,70,0,1,0,1,0
52671,445,0,0,70,70,0,1,0,1,0
49909,445,0,0,66,66,0,1,0,1,0
54979,445,0,0,70,70,0,1,0,1,0
61594,445,0,0,66,66,0,1,0,1,0
59042,445,0,0,70,70,0,1,0,1,0
54388,445,0,0,70,70,0,1,0,1,0
65027,445,0,0,70,70,0,1,0,1,0
50293,445,0,0,66,66,0,1,0,1,0
50712,445,0,0,70,70,0,1,0,1,0
52148,445,0,0,66,66,0,1,0,1,0
53608,445,0,0,70,70,0,1,0,1,0
50915,445,0,0,66,66,0,1,0,1,0
56471,445,0,0,70,70,0,1,0,1,0
53672,445,0,0,70,70,0,1,0,1,0
50800,445,0,0,66,66,0,1,0,1,0
60612,445,0,0,70,70,0,1,0,1,0
62358,445,0,0,66,66,0,1,0,1,0
55694,445,0,0,70,70,0,1,0,1,0
56755,445,0,0,66,66,0,1,0,1,0
58420,445,0,0,66,66,0,1,0,1,0
59044,445,0,0,70,70,0,1,0,1,0
54761,445,0,0,66,66,0,1,0,1,0
52109,445,0,0,70,70,0,1,0,1,0
57560,445,0,0,70,70,0,1,0,1,0
63386,445,0,0,66,66,0,1,0,1,0
59918,445,0,0,66,66,0,1,0,1,0
56018,445,0,0,70,70,0,1,0,1,0
52706,445,0,0,70,70,0,1,0,1,0
56732,445,0,0,70,70,0,1,0,1,0
50355,445,0,0,66,66,0,1,0,1,0
55045,445,0,0,70,70,0,1,0,1,0
50274,445,0,0,70,70,0,1,0,1,0
51837,445,0,0,70,70,0,1,0,1,0
57669,445,0,0,70,70,0,1,0,1,0
59965,445,0,0,66,66,0,1,0,1,0
59582,445,0,0,66,66,0,1,0,1,0
58612,445,0,0,66,66,0,1,0,1,0
52601,445,0,0,66,66,0,1,0,1,0
63234,445,0,0,70,70,0,1,0,1,0
60097,445,0,0,70,70,0,1,0,1,0
61507,445,0,0,70,70,0,1,0,1,0
60868,445,0,0,70,70,0,1,0,1,0
64164,445,0,0,70,70,0,1,0,1,0
58263,445,0,0,70,70,0,1,0,1,0
55463,445,0,0,70,70,0,1,0,1,0
57466,445,0,0,70,70,0,1,0,1,0
49335,445,0,0,70,70,0,1,0,1,0
52068,445,0,0,70,70,0,1,0,1,0
57460,445,0,0,66,66,0,1,0,1,0
52985,445,0,0,66,66,0,1,0,1,0
52658,445,0,0,66,66,0,1,0,1,0
52056,445,0,0,70,70,0,1,0,1,0
60945,445,0,0,70,70,0,1,0,1,0
57566,445,0,0,70,70,0,1,0,1,0
59125,445,0,0,66,66,0,1,0,1,0
58447,445,0,0,70,70,0,1,0,1,0
57911,445,0,0,70,70,0,1,0,1,0
53203,445,0,0,70,70,0,1,0,1,0
60892,445,0,0,70,70,0,1,0,1,0
52088,445,0,0,70,70,0,1,0,1,0
63131,445,0,0,70,70,0,1,0,1,0
60243,445,0,0,70,70,0,1,0,1,0
49787,445,0,0,70,70,0,1,0,1,0
54519,445,0,0,70,70,0,1,0,1,0
51627,445,0,0,70,70,0,1,0,1,0
61583,445,0,0,70,70,0,1,0,1,0
59315,445,0,0,70,70,0,1,0,1,0
54551,445,0,0,70,70,0,1,0,1,0
61313,445,0,0,70,70,0,1,0,1,0
60501,445,0,0,70,70,0,1,0,1,0
62447,445,0,0,70,70,0,1,0,1,0
63519,445,0,0,66,66,0,1,0,1,0
64525,445,0,0,70,70,0,1,0,1,0
50494,445,0,0,66,66,0,1,0,1,0
52789,445,0,0,66,66,0,1,0,1,0
61671,445,0,0,66,66,0,1,0,1,0
49789,445,0,0,70,70,0,1,0,1,0
60565,445,0,0,66,66,0,1,0,1,0
52953,445,0,0,70,70,0,1,0,1,0
59162,445,0,0,70,70,0,1,0,1,0
52980,445,0,0,66,66,0,1,0,1,0
54531,445,0,0,70,70,0,1,0,1,0
52655,445,0,0,70,70,0,1,0,1,0
60132,445,0,0,66,66,0,1,0,1,0
56713,445,0,0,70,70,0,1,0,1,0
63989,445,0,0,70,70,0,1,0,1,0
54914,445,0,0,70,70,0,1,0,1,0
59820,445,0,0,70,70,0,1,0,1,0
52219,445,0,0,66,66,0,1,0,1,0
52314,445,0,0,70,70,0,1,0,1,0
60820,445,0,0,66,66,0,1,0,1,0
58785,445,0,0,70,70,0,1,0,1,0
53304,445,0,0,66,66,0,1,0,1,0
62600,445,0,0,66,66,0,1,0,1,0
49190,445,0,0,70,70,0,1,0,1,0
56082,445,0,0,66,66,0,1,0,1,0
56595,445,0,0,70,70,0,1,0,1,0
59782,445,0,0,70,70,0,1,0,1,0
57358,445,0,0,70,70,0,1,0,1,0
51341,445,0,0,70,70,0,1,0,1,0
51989,445,0,0,66,66,0,1,0,1,0
53817,445,0,0,70,70,0,1,0,1,0
54947,445,0,0,70,70,0,1,0,1,0
57890,445,0,0,66,66,0,1,0,1,0
49520,445,0,0,66,66,0,1,0,1,0
57514,445,0,0,70,70,0,1,0,1,0
51383,445,0,0,70,70,0,1,0,1,0
50826,445,0,0,70,70,0,1,0,1,0
58112,445,0,0,70,70,0,1,0,1,0
63365,445,0,0,70,70,0,1,0,1,0
54925,445,0,0,70,70,0,1,0,1,0
60106,445,0,0,70,70,0,1,0,1,0
58853,445,0,0,70,70,0,1,0,1,0
51600,445,0,0,70,70,0,1,0,1,0
63811,445,0,0,66,66,0,1,0,1,0
52231,445,0,0,66,66,0,1,0,1,0
49656,445,0,0,66,66,0,1,0,1,0
50910,445,0,0,70,70,0,1,0,1,0
54903,445,0,0,66,66,0,1,0,1,0
56831,445,0,0,70,70,0,1,0,1,0
50427,445,0,0,66,66,0,1,0,1,0
63900,445,0,0,66,66,0,1,0,1,0
55862,445,0,0,70,70,0,1,0,1,0
58632,445,0,0,70,70,0,1,0,1,0
60696,445,0,0,66,66,0,1,0,1,0
54324,445,0,0,66,66,0,1,0,1,0
51872,445,0,0,70,70,0,1,0,1,0
59637,445,0,0,70,70,0,1,0,1,0
50335,445,0,0,66,66,0,1,0,1,0
53160,445,0,0,70,70,0,1,0,1,0
65453,445,0,0,70,70,0,1,0,1,0
51782,445,0,0,70,70,0,1,0,1,0
57268,445,0,0,70,70,0,1,0,1,0
53269,445,0,0,66,66,0,1,0,1,0
53294,445,0,0,66,66,0,1,0,1,0
50350,445,0,0,70,70,0,1,0,1,0
63948,445,0,0,70,70,0,1,0,1,0
55015,445,0,0,66,66,0,1,0,1,0
51834,445,0,0,66,66,0,1,0,1,0
64618,445,0,0,70,70,0,1,0,1,0
54572,445,0,0,66,66,0,1,0,1,0
59088,445,0,0,66,66,0,1,0,1,0
50594,445,0,0,70,70,0,1,0,1,0
60309,445,0,0,66,66,0,1,0,1,0
52582,445,0,0,66,66,0,1,0,1,0
49516,445,0,0,70,70,0,1,0,1,0
50012,445,0,0,70,70,0,1,0,1,0
53118,445,0,0,70,70,0,1,0,1,0
50606,445,0,0,70,70,0,1,0,1,0
57985,445,0,0,66,66,0,1,0,1,0
55417,445,0,0,70,70,0,1,0,1,0
52016,445,0,0,70,70,0,1,0,1,0
59271,445,0,0,70,70,0,1,0,1,0
56737,445,0,0,70,70,0,1,0,1,0
63161,445,0,0,70,70,0,1,0,1,0
64393,445,0,0,66,66,0,1,0,1,0
54658,445,0,0,70,70,0,1,0,1,0
62490,445,0,0,70,70,0,1,0,1,0
59977,445,0,0,70,70,0,1,0,1,0
62469,445,0,0,70,70,0,1,0,1,0
61719,445,0,0,70,70,0,1,0,1,0
59999,445,0,0,70,70,0,1,0,1,0
63771,445,0,0,70,70,0,1,0,1,0
63963,445,0,0,70,70,0,1,0,1,0
63301,445,0,0,70,70,0,1,0,1,0
54050,445,0,0,70,70,0,1,0,1,0
51538,445,0,0,70,70,0,1,0,1,0
49414,445,0,0,66,66,0,1,0,1,0
51569,445,0,0,70,70,0,1,0,1,0
53429,445,0,0,70,70,0,1,0,1,0
59788,445,0,0,70,70,0,1,0,1,0
51054,445,0,0,66,66,0,1,0,1,0
51187,445,0,0,66,66,0,1,0,1,0
63287,445,0,0,66,66,0,1,0,1,0
55038,445,0,0,66,66,0,1,0,1,0
51677,445,0,0,70,70,0,1,0,1,0
65421,445,0,0,66,66,0,1,0,1,0
61240,445,0,0,70,70,0,1,0,1,0
54572,445,0,0,70,70,0,1,0,1,0
51416,445,0,0,70,70,0,1,0,1,0
62701,445,0,0,70,70,0,1,0,1,0
56911,445,0,0,70,70,0,1,0,1,0
53278,445,0,0,66,66,0,1,0,1,0
55529,445,0,0,70,70,0,1,0,1,0
49834,445,0,0,70,70,0,1,0,1,0
53017,445,0,0,70,70,0,1,0,1,0
60401,445,0,0,70,70,0,1,0,1,0
50612,445,0,0,70,70,0,1,0,1,0
64156,445,0,0,70,70,0,1,0,1,0
59832,445,0,0,70,70,0,1,0,1,0
56963,445,0,0,66,66,0,1,0,1,0
63392,445,0,0,70,70,0,1,0,1,0
55491,445,0,0,70,70,0,1,0,1,0
53029,445,0,0,70,70,0,1,0,1,0
50781,445,0,0,70,70,0,1,0,1,0
64226,445,0,0,66,66,0,1,0,1,0
54582,445,0,0,66,66,0,1,0,1,0
49661,445,0,0,70,70,0,1,0,1,0
55644,445,0,0,70,70,0,1,0,1,0
64064,445,0,0,66,66,0,1,0,1,0
58850,445,0,0,70,70,0,1,0,1,0
57855,445,0,0,70,70,0,1,0,1,0
63876,445,0,0,70,70,0,1,0,1,0
50976,445,0,0,66,66,0,1,0,1,0
60335,445,0,0,70,70,0,1,0,1,0
50684,445,0,0,70,70,0,1,0,1,0
53106,445,0,0,70,70,0,1,0,1,0
53573,445,0,0,70,70,0,1,0,1,0
59168,445,0,0,70,70,0,1,0,1,0
51248,445,0,0,66,66,0,1,0,1,0
59828,445,0,0,70,70,0,1,0,1,0
56278,445,0,0,70,70,0,1,0,1,0
59317,445,0,0,70,70,0,1,0,1,0
50477,445,0,0,66,66,0,1,0,1,0
62498,445,0,0,70,70,0,1,0,1,0
50040,445,0,0,70,70,0,1,0,1,0
54716,445,0,0,70,70,0,1,0,1,0
65284,445,0,0,70,70,0,1,0,1,0
49375,445,0,0,70,70,0,1,0,1,0
62215,445,0,0,70,70,0,1,0,1,0
54278,445,0,0,70,70,0,1,0,1,0
51320,445,0,0,70,70,0,1,0,1,0
52348,445,0,0,70,70,0,1,0,1,0
64347,445,0,0,66,66,0,1,0,1,0
54269,445,0,0,66,66,0,1,0,1,0
58504,445,0,0,70,70,0,1,0,1,0
63902,445,0,0,70,70,0,1,0,1,0
65195,445,0,0,66,66,0,1,0,1,0
53192,445,0,0,66,66,0,1,0,1,0
63443,445,0,0,70,70,0,1,0,1,0
56717,445,0,0,70,70,0,1,0,1,0
63520,445,0,0,70,70,0,1,0,1,0
56739,445,0,0,70,70,0,1,0,1,0
60675,445,0,0,66,66,0,1,0,1,0
59500,445,0,0,70,70,0,1,0,1,0
51131,445,0,0,70,70,0,1,0,1,0
50118,445,0,0,70,70,0,1,0,1,0
60138,445,0,0,70,70,0,1,0,1,0
52638,445,0,0,66,66,0,1,0,1,0
64309,445,0,0,70,70,0,1,0,1,0
64941,445,0,0,70,70,0,1,0,1,0
56509,445,0,0,66,66,0,1,0,1,0
60886,445,0,0,70,70,0,1,0,1,0
53065,445,0,0,66,66,0,1,0,1,0
50613,445,0,0,70,70,0,1,0,1,0
64483,445,0,0,66,66,0,1,0,1,0
52613,445,0,0,70,70,0,1,0,1,0
53013,445,0,0,66,66,0,1,0,1,0
51918,445,0,0,66,66,0,1,0,1,0
55054,445,0,0,66,66,0,1,0,1,0
59952,445,0,0,70,70,0,1,0,1,0
50096,445,0,0,70,70,0,1,0,1,0
57672,445,0,0,70,70,0,1,0,1,0
60968,445,0,0,70,70,0,1,0,1,0
64112,445,0,0,70,70,0,1,0,1,0
52477,445,0,0,70,70,0,1,0,1,0
60956,445,0,0,66,66,0,1,0,1,0
64375,445,0,0,70,70,0,1,0,1,0
51548,445,0,0,70,70,0,1,0,1,0
51180,445,0,0,70,70,0,1,0,1,0
56505,445,0,0,70,70,0,1,0,1,0
55213,445,0,0,66,66,0,1,0,1,0
51568,445,0,0,66,66,0,1,0,1,0
57882,445,0,0,70,70,0,1,0,1,0
61176,445,0,0,70,70,0,1,0,1,0
49286,445,0,0,66,66,0,1,0,1,0
52560,445,0,0,66,66,0,1,0,1,0
59985,445,0,0,70,70,0,1,0,1,0
50109,445,0,0,70,70,0,1,0,1,0
50624,445,0,0,70,70,0,1,0,1,0
57802,445,0,0,70,70,0,1,0,1,0
52782,445,0,0,66,66,0,1,0,1,0
63843,445,0,0,66,66,0,1,0,1,0
62329,445,0,0,70,70,0,1,0,1,0
63576,445,0,0,70,70,0,1,0,1,0
49890,445,0,0,70,70,0,1,0,1,0
51075,445,0,0,70,70,0,1,0,1,0
49664,445,0,0,66,66,0,1,0,1,0
64745,445,0,0,66,66,0,1,0,1,0
50632,445,0,0,70,70,0,1,0,1,0
63390,445,0,0,70,70,0,1,0,1,0
65484,445,0,0,70,70,0,1,0,1,0
64629,445,0,0,70,70,0,1,0,1,0
59891,445,0,0,70,70,0,1,0,1,0
57861,445,0,0,66,66,0,1,0,1,0
65253,445,0,0,70,70,0,1,0,1,0
65181,445,0,0,70,70,0,1,0,1,0
56005,445,0,0,66,66,0,1,0,1,0
51678,445,0,0,70,70,0,1,0,1,0
59148,445,0,0,66,66,0,1,0,1,0
53507,445,0,0,70,70,0,1,0,1,0
62895,445,0,0,70,70,0,1,0,1,0
65188,445,0,0,70,70,0,1,0,1,0
49861,445,0,0,70,70,0,1,0,1,0
50737,445,0,0,66,66,0,1,0,1,0
63007,445,0,0,70,70,0,1,0,1,0
52932,445,0,0,70,70,0,1,0,1,0
58087,445,0,0,70,70,0,1,0,1,0
56168,445,0,0,70,70,0,1,0,1,0
54007,445,0,0,70,70,0,1,0,1,0
53110,445,0,0,66,66,0,1,0,1,0
55328,445,0,0,70,70,0,1,0,1,0
65422,445,0,0,70,70,0,1,0,1,0
55290,445,0,0,66,66,0,1,0,1,0
57914,445,0,0,66,66,0,1,0,1,0
50742,445,0,0,66,66,0,1,0,1,0
56773,445,0,0,70,70,0,1,0,1,0
61180,445,0,0,66,66,0,1,0,1,0
60244,445,0,0,70,70,0,1,0,1,0
59688,445,0,0,66,66,0,1,0,1,0
64314,445,0,0,70,70,0,1,0,1,0
51727,445,0,0,70,70,0,1,0,1,0
50780,445,0,0,70,70,0,1,0,1,0
51073,445,0,0,66,66,0,1,0,1,0
50274,445,0,0,70,70,0,1,0,1,0
52532,445,0,0,70,70,0,1,0,1,0
57720,445,0,0,70,70,0,1,0,1,0
51351,445,0,0,70,70,0,1,0,1,0
64740,445,0,0,70,70,0,1,0,1,0
65255,445,0,0,70,70,0,1,0,1,0
55632,445,0,0,70,70,0,1,0,1,0
54955,445,0,0,70,70,0,1,0,1,0
55718,445,0,0,70,70,0,1,0,1,0
63943,445,0,0,66,66,0,1,0,1,0
49719,445,0,0,70,70,0,1,0,1,0
61841,445,0,0,70,70,0,1,0,1,0
58027,445,0,0,70,70,0,1,0,1,0
55886,445,0,0,70,70,0,1,0,1,0
64918,445,0,0,66,66,0,1,0,1,0
54278,445,0,0,66,66,0,1,0,1,0
64404,445,0,0,70,70,0,1,0,1,0
50013,445,0,0,70,70,0,1,0,1,0
51527,445,0,0,70,70,0,1,0,1,0
49520,445,0,0,70,70,0,1,0,1,0
56834,445,0,0,66,66,0,1,0,1,0
52364,445,0,0,66,66,0,1,0,1,0
61915,445,0,0,70,70,0,1,0,1,0
55201,445,0,0,70,70,0,1,0,1,0
55002,445,0,0,70,70,0,1,0,1,0
61261,445,0,0,66,66,0,1,0,1,0
59818,445,0,0,66,66,0,1,0,1,0
63513,445,0,0,66,66,0,1,0,1,0
52266,445,0,0,70,70,0,1,0,1,0
50386,445,0,0,70,70,0,1,0,1,0
51633,445,0,0,66,66,0,1,0,1,0
62119,445,0,0,70,70,0,1,0,1,0
51824,445,0,0,70,70,0,1,0,1,0
53894,445,0,0,70,70,0,1,0,1,0
62149,445,0,0,70,70,0,1,0,1,0
52849,445,0,0,70,70,0,1,0,1,0
56954,445,0,0,70,70,0,1,0,1,0
53244,445,0,0,66,66,0,1,0,1,0
49300,445,0,0,66,66,0,1,0,1,0
50593,445,0,0,66,66,0,1,0,1,0
61865,445,0,0,66,66,0,1,0,1,0
58422,445,0,0,66,66,0,1,0,1,0
56806,445,0,0,70,70,0,1,0,1,0
51425,445,0,0,66,66,0,1,0,1,0
59698,445,0,0,70,70,0,1,0,1,0
52721,445,0,0,70,70,0,1,0,1,0
49401,445,0,0,70,70,0,1,0,1,0
52240,445,0,0,70,70,0,1,0,1,0
51260,445,0,0,70,70,0,1,0,1,0
53804,445,0,0,70,70,0,1,0,1,0
62876,445,0,0,70,70,0,1,0,1,0
56900,445,0,0,66,66,0,1,0,1,0
56835,445,0,0,66,66,0,1,0,1,0
58928,445,0,0,70,70,0,1,0,1,0
63514,445,0,0,66,66,0,1,0,1,0
51927,445,0,0,70,70,0,1,0,1,0
50455,445,0,0,70,70,0,1,0,1,0
60455,445,0,0,70,70,0,1,0,1,0
53818,445,0,0,66,66,0,1,0,1,0
55932,445,0,0,66,66,0,1,0,1,0
64416,445,0,0,70,70,0,1,0,1,0
55827,445,0,0,70,70,0,1,0,1,0
54547,445,0,0,70,70,0,1,0,1,0
52079,445,0,0,70,70,0,1,0,1,0
60748,445,0,0,70,70,0,1,0,1,0
64161,445,0,0,66,66,0,1,0,1,0
52094,445,0,0,70,70,0,1,0,1,0
49988,445,0,0,70,70,0,1,0,1,0
50400,445,0,0,70,70,0,1,0,1,0
64286,445,0,0,70,70,0,1,0,1,0
54144,445,0,0,70,70,0,1,0,1,0
59657,445,0,0,70,70,0,1,0,1,0
49458,445,0,0,66,66,0,1,0,1,0
58181,445,0,0,66,66,0,1,0,1,0
53773,445,0,0,66,66,0,1,0,1,0
59896,445,0,0,70,70,0,1,0,1,0
53971,445,0,0,70,70,0,1,0,1,0
50767,445,0,0,70,70,0,1,0,1,0
52072,445,0,0,70,70,0,1,0,1,0
54254,445,0,0,70,70,0,1,0,1,0
61852,445,0,0,66,66,0,1,0,1,0
50017,445,0,0,70,70,0,1,0,1,0
51050,445,0,0,66,66,0,1,0,1,0
59862,445,0,0,66,66,0,1,0,1,0
63013,445,0,0,70,70,0,1,0,1,0
54730,445,0,0,70,70,0,1,0,1,0
63684,445,0,0,70,70,0,1,0,1,0
62806,445,0,0,70,70,0,1,0,1,0
56865,445,0,0,70,70,0,1,0,1,0
50798,445,0,0,66,66,0,1,0,1,0
49971,445,0,0,70,70,0,1,0,1,0
50226,445,0,0,70,70,0,1,0,1,0
52091,445,0,0,66,66,0,1,0,1,0
53113,445,0,0,66,66,0,1,0,1,0
65003,445,0,0,70,70,0,1,0,1,0
53377,445,0,0,66,66,0,1,0,1,0
64097,445,0,0,70,70,0,1,0,1,0
65327,445,0,0,70,70,0,1,0,1,0
49452,445,0,0,70,70,0,1,0,1,0
59770,445,0,0,70,70,0,1,0,1,0
49337,445,0,0,70,70,0,1,0,1,0
60634,445,0,0,66,66,0,1,0,1,0
49620,445,0,0,70,70,0,1,0,1,0
56897,445,0,0,66,66,0,1,0,1,0
65477,445,0,0,70,70,0,1,0,1,0
57279,445,0,0,66,66,0,1,0,1,0
55582,445,0,0,70,70,0,1,0,1,0
64117,445,0,0,70,70,0,1,0,1,0
49161,445,0,0,70,70,0,1,0,1,0
50929,445,0,0,66,66,0,1,0,1,0
61398,445,0,0,70,70,0,1,0,1,0
59297,445,0,0,70,70,0,1,0,1,0
56263,445,0,0,70,70,0,1,0,1,0
64474,445,0,0,66,66,0,1,0,1,0
59830,445,0,0,70,70,0,1,0,1,0
52010,445,0,0,66,66,0,1,0,1,0
50138,445,0,0,70,70,0,1,0,1,0
60347,445,0,0,70,70,0,1,0,1,0
63857,445,0,0,70,70,0,1,0,1,0
50483,445,0,0,70,70,0,1,0,1,0
60288,445,0,0,66,66,0,1,0,1,0
53526,445,0,0,66,66,0,1,0,1,0
50463,445,0,0,70,70,0,1,0,1,0
49561,445,0,0,70,70,0,1,0,1,0
62812,445,0,0,70,70,0,1,0,1,0
57579,445,0,0,70,70,0,1,0,1,0
54972,445,0,0,70,70,0,1,0,1,0
61484,445,0,0,70,70,0,1,0,1,0
62999,445,0,0,66,66,0,1,0,1,0
58630,445,0,0,66,66,0,1,0,1,0
64683,445,0,0,70,70,0,1,0,1,0
60824,445,0,0,66,66,0,1,0,1,0
60444,445,0,0,70,70,0,1,0,1,0
52093,445,0,0,70,70,0,1,0,1,0
53224,445,0,0,66,66,0,1,0,1,0
55991,445,0,0,66,66,0,1,0,1,0
57049,445,0,0,66,66,0,1,0,1,0
50426,445,0,0,70,70,0,1,0,1,0
52287,445,0,0,66,66,0,1,0,1,0
55779,445,0,0,70,70,0,1,0,1,0
64122,445,0,0,70,70,0,1,0,1,0
50968,445,0,0,70,70,0,1,0,1,0
59269,445,0,0,66,66,0,1,0,1,0
61949,445,0,0,70,70,0,1,0,1,0
59456,445,0,0,66,66,0,1,0,1,0
62679,445,0,0,70,70,0,1,0,1,0
56776,445,0,0,66,66,0,1,0,1,0
62006,445,0,0,66,66,0,1,0,1,0
64077,445,0,0,70,70,0,1,0,1,0
62983,445,0,0,66,66,0,1,0,1,0
61210,445,0,0,66,66,0,1,0,1,0
52838,445,0,0,66,66,0,1,0,1,0
63772,445,0,0,70,70,0,1,0,1,0
49183,445,0,0,66,66,0,1,0,1,0
57392,445,0,0,70,70,0,1,0,1,0
57385,445,0,0,66,66,0,1,0,1,0
56373,445,0,0,66,66,0,1,0,1,0
57221,445,0,0,66,66,0,1,0,1,0
58747,445,0,0,70,70,0,1,0,1,0
62716,445,0,0,70,70,0,1,0,1,0
63792,445,0,0,70,70,0,1,0,1,0
50310,445,0,0,66,66,0,1,0,1,0
62818,445,0,0,66,66,0,1,0,1,0
62167,445,0,0,66,66,0,1,0,1,0
55341,445,0,0,70,70,0,1,0,1,0
55019,445,0,0,70,70,0,1,0,1,0
49678,445,0,0,70,70,0,1,0,1,0
54655,445,0,0,70,70,0,1,0,1,0
50551,445,0,0,70,70,0,1,0,1,0
55370,445,0,0,66,66,0,1,0,1,0
60313,445,0,0,70,70,0,1,0,1,0
57353,445,0,0,70,70,0,1,0,1,0
50347,445,0,0,66,66,0,1,0,1,0
54816,445,0,0,70,70,0,1,0,1,0
53327,445,0,0,70,70,0,1,0,1,0
52340,445,0,0,66,66,0,1,0,1,0
54174,445,0,0,70,70,0,1,0,1,0
55344,445,0,0,70,70,0,1,0,1,0
64651,445,0,0,66,66,0,1,0,1,0
55580,445,0,0,70,70,0,1,0,1,0
53100,445,0,0,70,70,0,1,0,1,0
65511,445,0,0,70,70,0,1,0,1,0
64613,445,0,0,70,70,0,1,0,1,0
62331,445,0,0,70,70,0,1,0,1,0
55507,445,0,0,70,70,0,1,0,1,0
61437,445,0,0,70,70,0,1,0,1,0
50255,445,0,0,66,66,0,1,0,1,0
62044,445,0,0,70,70,0,1,0,1,0
58706,445,0,0,70,70,0,1,0,1,0
56269,445,0,0,70,70,0,1,0,1,0
56513,445,0,0,66,66,0,1,0,1,0
62257,445,0,0,70,70,0,1,0,1,0
59594,445,0,0,66,66,0,1,0,1,0
63311,445,0,0,66,66,0,1,0,1,0
53016,445,0,0,70,70,0,1,0,1,0
58991,445,0,0,70,70,0,1,0,1,0
49889,445,0,0,70,70,0,1,0,1,0
49702,445,0,0,70,70,0,1,0,1,0
64172,445,0,0,70,70,0,1,0,1,0
62203,445,0,0,66,66,0,1,0,1,0
55404,445,0,0,70,70,0,1,0,1,0
58934,445,0,0,70,70,0,1,0,1,0
63844,445,0,0,66,66,0,1,0,1,0
49677,445,0,0,70,70,0,1,0,1,0
51355,445,0,0,70,70,0,1,0,1,0
64007,445,0,0,70,70,0,1,0,1,0
56488,445,0,0,70,70,0,1,0,1,0
57347,445,0,0,66,66,0,1,0,1,0
61448,445,0,0,66,66,0,1,0,1,0
50865,445,0,0,66,66,0,1,0,1,0
60754,445,0,0,70,70,0,1,0,1,0
64261,445,0,0,70,70,0,1,0,1,0
63416,445,0,0,66,66,0,1,0,1,0
61908,445,0,0,70,70,0,1,0,1,0
62178,445,0,0,70,70,0,1,0,1,0
59423,445,0,0,70,70,0,1,0,1,0
55802,445,0,0,70,70,0,1,0,1,0
57944,445,0,0,70,70,0,1,0,1,0
57083,445,0,0,70,70,0,1,0,1,0
57458,445,0,0,66,66,0,1,0,1,0
63196,445,0,0,70,70,0,1,0,1,0
56640,445,0,0,70,70,0,1,0,1,0
55984,445,0,0,70,70,0,1,0,1,0
53538,445,0,0,70,70,0,1,0,1,0
52275,445,0,0,70,70,0,1,0,1,0
59864,445,0,0,70,70,0,1,0,1,0
63988,445,0,0,66,66,0,1,0,1,0
49903,445,0,0,70,70,0,1,0,1,0
64835,445,0,0,70,70,0,1,0,1,0
54776,445,0,0,66,66,0,1,0,1,0
57614,445,0,0,70,70,0,1,0,1,0
52278,445,0,0,70,70,0,1,0,1,0
51065,445,0,0,66,66,0,1,0,1,0
62854,445,0,0,66,66,0,1,0,1,0
60959,445,0,0,70,70,0,1,0,1,0
62038,445,0,0,66,66,0,1,0,1,0
57384,445,0,0,70,70,0,1,0,1,0
51601,445,0,0,66,66,0,1,0,1,0
63069,445,0,0,66,66,0,1,0,1,0
57673,445,0,0,70,70,0,1,0,1,0
56386,445,0,0,66,66,0,1,0,1,0
50987,445,0,0,66,66,0,1,0,1,0
51781,445,0,0,66,66,0,1,0,1,0
55133,445,0,0,70,70,0,1,0,1,0
56687,445,0,0,70,70,0,1,0,1,0
62086,445,0,0,66,66,0,1,0,1,0
60604,445,0,0,70,70,0,1,0,1,0
50680,445,0,0,70,70,0,1,0,1,0
55454,445,0,0,66,66,0,1,0,1,0
57153,445,0,0,66,66,0,1,0,1,0
57533,445,0,0,66,66,0,1,0,1,0
57475,445,0,0,66,66,0,1,0,1,0
61990,445,0,0,70,70,0,1,0,1,0
64517,445,0,0,70,70,0,1,0,1,0
55232,445,0,0,70,70,0,1,0,1,0
61033,445,0,0,70,70,0,1,0,1,0
49271,445,0,0,66,66,0,1,0,1,0
53683,445,0,0,66,66,0,1,0,1,0
50417,445,0,0,66,66,0,1,0,1,0
55817,445,0,0,70,70,0,1,0,1,0
62356,445,0,0,70,70,0,1,0,1,0
51678,445,0,0,70,70,0,1,0,1,0
59144,445,0,0,70,70,0,1,0,1,0
49264,445,0,0,66,66,0,1,0,1,0
60273,445,0,0,70,70,0,1,0,1,0
54647,445,0,0,66,66,0,1,0,1,0
59736,445,0,0,70,70,0,1,0,1,0
60584,445,0,0,66,66,0,1,0,1,0
64036,445,0,0,66,66,0,1,0,1,0
49214,445,0,0,70,70,0,1,0,1,0
63133,445,0,0,66,66,0,1,0,1,0
57813,445,0,0,70,70,0,1,0,1,0
60883,445,0,0,70,70,0,1,0,1,0
63963,445,0,0,70,70,0,1,0,1,0
63212,445,0,0,66,66,0,1,0,1,0
53835,445,0,0,66,66,0,1,0,1,0
65337,445,0,0,70,70,0,1,0,1,0
63262,445,0,0,70,70,0,1,0,1,0
64327,445,0,0,70,70,0,1,0,1,0
51176,445,0,0,70,70,0,1,0,1,0
62745,445,0,0,66,66,0,1,0,1,0
50748,445,0,0,66,66,0,1,0,1,0
56613,445,0,0,70,70,0,1,0,1,0
54432,445,0,0,70,70,0,1,0,1,0
54016,445,0,0,70,70,0,1,0,1,0
58613,445,0,0,70,70,0,1,0,1,0
53431,445,0,0,66,66,0,1,0,1,0
63847,445,0,0,66,66,0,1,0,1,0
50945,445,0,0,66,66,0,1,0,1,0
59585,445,0,0,66,66,0,1,0,1,0
54593,445,0,0,66,66,0,1,0,1,0
49707,445,0,0,70,70,0,1,0,1,0
60681,445,0,0,70,70,0,1,0,1,0
58273,445,0,0,70,70,0,1,0,1,0
52990,445,0,0,70,70,0,1,0,1,0
54660,445,0,0,70,70,0,1,0,1,0
52502,445,0,0,70,70,0,1,0,1,0
61975,445,0,0,70,70,0,1,0,1,0
49967,445,0,0,70,70,0,1,0,1,0
53471,445,0,0,70,70,0,1,0,1,0
53044,445,0,0,70,70,0,1,0,1,0
57020,445,0,0,70,70,0,1,0,1,0
53654,445,0,0,66,66,0,1,0,1,0
61589,445,0,0,70,70,0,1,0,1,0
58818,445,0,0,66,66,0,1,0,1,0
56785,445,0,0,70,70,0,1,0,1,0
54196,445,0,0,66,66,0,1,0,1,0
51363,445,0,0,70,70,0,1,0,1,0
59448,445,0,0,70,70,0,1,0,1,0
51759,445,0,0,70,70,0,1,0,1,0
54332,445,0,0,70,70,0,1,0,1,0
60114,445,0,0,66,66,0,1,0,1,0
57044,445,0,0,66,66,0,1,0,1,0
59342,445,0,0,70,70,0,1,0,1,0
53886,445,0,0,70,70,0,1,0,1,0
51522,445,0,0,66,66,0,1,0,1,0
65412,445,0,0,70,70,0,1,0,1,0
63766,445,0,0,70,70,0,1,0,1,0
52853,445,0,0,66,66,0,1,0,1,0
56885,445,0,0,70,70,0,1,0,1,0
51123,445,0,0,66,66,0,1,0,1,0
53442,445,0,0,70,70,0,1,0,1,0
64361,445,0,0,70,70,0,1,0,1,0
60045,445,0,0,70,70,0,1,0,1,0
57988,445,0,0,70,70,0,1,0,1,0
60374,445,0,0,70,70,0,1,0,1,0
50010,445,0,0,70,70,0,1,0,1,0
54410,445,0,0,66,66,0,1,0,1,0
49765,445,0,0,66,66,0,1,0,1,0
51756,445,0,0,70,70,0,1,0,1,0
59986,445,0,0,66,66,0,1,0,1,0
56587,445,0,0,70,70,0,1,0,1,0
49386,445,0,0,70,70,0,1,0,1,0
50650,445,0,0,70,70,0,1,0,1,0
63579,445,0,0,66,66,0,1,0,1,0
58822,445,0,0,70,70,0,1,0,1,0
56973,445,0,0,70,70,0,1,0,1,0
55457,445,0,0,70,70,0,1,0,1,0
64817,445,0,0,70,70,0,1,0,1,0
59785,445,0,0,70,70,0,1,0,1,0
49310,445,0,0,70,70,0,1,0,1,0
53189,445,0,0,66,66,0,1,0,1,0
62217,445,0,0,66,66,0,1,0,1,0
53403,445,0,0,70,70,0,1,0,1,0
50169,445,0,0,66,66,0,1,0,1,0
60641,445,0,0,70,70,0,1,0,1,0
57103,445,0,0,70,70,0,1,0,1,0
51489,445,0,0,70,70,0,1,0,1,0
49969,445,0,0,70,70,0,1,0,1,0
54478,445,0,0,70,70,0,1,0,1,0
57885,445,0,0,70,70,0,1,0,1,0
58016,445,0,0,66,66,0,1,0,1,0
50556,445,0,0,70,70,0,1,0,1,0
56058,445,0,0,70,70,0,1,0,1,0
55998,445,0,0,66,66,0,1,0,1,0
65390,445,0,0,70,70,0,1,0,1,0
64266,445,0,0,70,70,0,1,0,1,0
56467,445,0,0,70,70,0,1,0,1,0
65339,445,0,0,70,70,0,1,0,1,0
57794,445,0,0,70,70,0,1,0,1,0
59292,445,0,0,70,70,0,1,0,1,0
50252,445,0,0,70,70,0,1,0,1,0
61211,445,0,0,66,66,0,1,0,1,0
50572,445,0,0,70,70,0,1,0,1,0
54186,445,0,0,70,70,0,1,0,1,0
57694,445,0,0,70,70,0,1,0,1,0
62797,445,0,0,70,70,0,1,0,1,0
62887,445,0,0,70,70,0,1,0,1,0
57075,445,0,0,66,66,0,1,0,1,0
55137,445,0,0,70,70,0,1,0,1,0
51686,445,0,0,70,70,0,1,0,1,0
54369,445,0,0,70,70,0,1,0,1,0
53659,445,0,0,70,70,0,1,0,1,0
58559,445,0,0,70,70,0,1,0,1,0
50191,445,0,0,70,70,0,1,0,1,0
58830,445,0,0,70,70,0,1,0,1,0
61793,445,0,0,66,66,0,1,0,1,0
63083,445,0,0,66,66,0,1,0,1,0
62101,445,0,0,66,66,0,1,0,1,0
54058,445,0,0,70,70,0,1,0,1,0
51622,445,0,0,70,70,0,1,0,1,0
60276,445,0,0,70,70,0,1,0,1,0
63719,445,0,0,66,66,0,1,0,1,0
50138,445,0,0,70,70,0,1,0,1,0
51315,445,0,0,70,70,0,1,0,1,0
62973,445,0,0,70,70,0,1,0,1,0
59759,445,0,0,70,70,0,1,0,1,0
56531,445,0,0,70,70,0,1,0,1,0
62254,445,0,0,70,70,0,1,0,1,0
51039,445,0,0,70,70,0,1,0,1,0
59531,445,0,0,66,66,0,1,0,1,0
49783,445,0,0,70,70,0,1,0,1,0
63660,445,0,0,70,70,0,1,0,1,0
49843,445,0,0,66,66,0,1,0,1,0
60851,445,0,0,70,70,0,1,0,1,0
49556,445,0,0,70,70,0,1,0,1,0
57364,445,0,0,70,70,0,1,0,1,0
58626,445,0,0,70,70,0,1,0,1,0
56716,445,0,0,70,70,0,1,0,1,0
62122,445,0,0,66,66,0,1,0,1,0
50290,445,0,0,66,66,0,1,0,1,0
64815,445,0,0,70,70,0,1,0,1,0
65307,445,0,0,70,70,0,1,0,1,0
63898,445,0,0,70,70,0,1,0,1,0
54164,445,0,0,66,66,0,1,0,1,0
59021,445,0,0,70,70,0,1,0,1,0
50164,445,0,0,66,66,0,1,0,1,0
57007,445,0,0,70,70,0,1,0,1,0
49764,445,0,0,66,66,0,1,0,1,0
60117,445,0,0,70,70,0,1,0,1,0
58701,445,0,0,70,70,0,1,0,1,0
57097,445,0,0,70,70,0,1,0,1,0
56767,445,0,0,70,70,0,1,0,1,0
59049,445,0,0,70,70,0,1,0,1,0
55609,445,0,0,66,66,0,1,0,1,0
51000,445,0,0,70,70,0,1,0,1,0
50837,445,0,0,66,66,0,1,0,1,0
65529,445,0,0,70,70,0,1,0,1,0
61181,445,0,0,70,70,0,1,0,1,0
51518,445,0,0,70,70,0,1,0,1,0
51960,445,0,0,66,66,0,1,0,1,0
53379,445,0,0,70,70,0,1,0,1,0
57361,445,0,0,66,66,0,1,0,1,0
53803,445,0,0,66,66,0,1,0,1,0
53027,445,0,0,70,70,0,1,0,1,0
63390,445,0,0,66,66,0,1,0,1,0
59215,445,0,0,66,66,0,1,0,1,0
60614,445,0,0,66,66,0,1,0,1,0
61857,445,0,0,70,70,0,1,0,1,0
63414,445,0,0,66,66,0,1,0,1,0
50256,445,0,0,70,70,0,1,0,1,0
58295,445,0,0,70,70,0,1,0,1,0
55282,445,0,0,70,70,0,1,0,1,0
65132,445,0,0,66,66,0,1,0,1,0
54892,445,0,0,70,70,0,1,0,1,0
51562,445,0,0,70,70,0,1,0,1,0
56001,445,0,0,70,70,0,1,0,1,0
58678,445,0,0,70,70,0,1,0,1,0
63471,445,0,0,70,70,0,1,0,1,0
63452,445,0,0,66,66,0,1,0,1,0
50546,445,0,0,66,66,0,1,0,1,0
52850,445,0,0,70,70,0,1,0,1,0
62653,445,0,0,66,66,0,1,0,1,0
60375,445,0,0,66,66,0,1,0,1,0
50578,445,0,0,70,70,0,1,0,1,0
52463,445,0,0,70,70,0,1,0,1,0
54005,445,0,0,66,66,0,1,0,1,0
65260,445,0,0,70,70,0,1,0,1,0
65130,445,0,0,70,70,0,1,0,1,0
64105,445,0,0,66,66,0,1,0,1,0
60104,445,0,0,66,66,0,1,0,1,0
51114,445,0,0,66,66,0,1,0,1,0
49701,445,0,0,70,70,0,1,0,1,0
55550,445,0,0,66,66,0,1,0,1,0
56077,445,0,0,70,70,0,1,0,1,0
65460,445,0,0,70,70,0,1,0,1,0
60971,445,0,0,70,70,0,1,0,1,0
61494,445,0,0,70,70,0,1,0,1,0
53722,445,0,0,70,70,0,1,0,1,0
54343,445,0,0,70,70,0,1,0,1,0
50875,445,0,0,70,70,0,1,0,1,0
64279,445,0,0,70,70,0,1,0,1,0
50339,445,0,0,66,66,0,1,0,1,0
62303,445,0,0,70,70,0,1,0,1,0
57845,445,0,0,66,66,0,1,0,1,0
52395,445,0,0,70,70,0,1,0,1,0
49356,445,0,0,66,66,0,1,0,1,0
49878,445,0,0,66,66,0,1,0,1,0
50658,445,0,0,70,70,0,1,0,1,0
64249,445,0,0,70,70,0,1,0,1,0
50394,445,0,0,70,70,0,1,0,1,0
65373,445,0,0,66,66,0,1,0,1,0
57194,445,0,0,70,70,0,1,0,1,0
50760,445,0,0,70,70,0,1,0,1,0
59850,445,0,0,66,66,0,1,0,1,0
52085,445,0,0,66,66,0,1,0,1,0
56423,445,0,0,70,70,0,1,0,1,0
55745,445,0,0,70,70,0,1,0,1,0
60385,445,0,0,70,70,0,1,0,1,0
56508,445,0,0,70,70,0,1,0,1,0
55576,445,0,0,66,66,0,1,0,1,0
55193,445,0,0,70,70,0,1,0,1,0
60872,445,0,0,66,66,0,1,0,1,0
60630,445,0,0,66,66,0,1,0,1,0
52588,445,0,0,70,70,0,1,0,1,0
49826,445,0,0,66,66,0,1,0,1,0
56383,445,0,0,70,70,0,1,0,1,0
50505,445,0,0,70,70,0,1,0,1,0
58472,445,0,0,70,70,0,1,0,1,0
54649,445,0,0,66,66,0,1,0,1,0
59758,445,0,0,70,70,0,1,0,1,0
55840,445,0,0,70,70,0,1,0,1,0
54781,445,0,0,66,66,0,1,0,1,0
53830,445,0,0,70,70,0,1,0,1,0
50603,445,0,0,70,70,0,1,0,1,0
57133,445,0,0,70,70,0,1,0,1,0
62668,445,0,0,66,66,0,1,0,1,0
60547,445,0,0,70,70,0,1,0,1,0
50780,445,0,0,70,70,0,1,0,1,0
49531,445,0,0,66,66,0,1,0,1,0
56375,445,0,0,66,66,0,1,0,1,0
49716,445,0,0,66,66,0,1,0,1,0
49834,445,0,0,70,70,0,1,0,1,0
55079,445,0,0,70,70,0,1,0,1,0
60687,445,0,0,70,70,0,1,0,1,0
62748,445,0,0,70,70,0,1,0,1,0
54348,445,0,0,66,66,0,1,0,1,0
56812,445,0,0,70,70,0,1,0,1,0
62115,445,0,0,70,70,0,1,0,1,0
53948,445,0,0,66,66,0,1,0,1,0
53571,445,0,0,70,70,0,1,0,1,0
61723,445,0,0,70,70,0,1,0,1,0
60745,445,0,0,70,70,0,1,0,1,0
51491,445,0,0,66,66,0,1,0,1,0
61508,445,0,0,70,70,0,1,0,1,0
56704,445,0,0,70,70,0,1,0,1,0
49576,445,0,0,70,70,0,1,0,1,0
60105,445,0,0,70,70,0,1,0,1,0
64795,445,0,0,70,70,0,1,0,1,0
55447,445,0,0,66,66,0,1,0,1,0
64557,445,0,0,70,70,0,1,0,1,0
50364,445,0,0,70,70,0,1,0,1,0
49252,445,0,0,70,70,0,1,0,1,0
50224,445,0,0,66,66,0,1,0,1,0
52598,445,0,0,66,66,0,1,0,1,0
64809,445,0,0,66,66,0,1,0,1,0
56656,445,0,0,66,66,0,1,0,1,0
63742,445,0,0,70,70,0,1,0,1,0
49392,445,0,0,66,66,0,1,0,1,0
58248,445,0,0,70,70,0,1,0,1,0
64974,445,0,0,70,70,0,1,0,1,0
50461,445,0,0,66,66,0,1,0,1,0
55714,445,0,0,70,70,0,1,0,1,0
57162,445,0,0,70,70,0,1,0,1,0
50871,445,0,0,70,70,0,1,0,1,0
53499,445,0,0,66,66,0,1,0,1,0
64869,445,0,0,70,70,0,1,0,1,0
52501,445,0,0,66,66,0,1,0,1,0
56065,445,0,0,66,66,0,1,0,1,0
49550,445,0,0,70,70,0,1,0,1,0
64356,445,0,0,70,70,0,1,0,1,0
60110,445,0,0,70,70,0,1,0,1,0
57212,445,0,0,70,70,0,1,0,1,0
61483,445,0,0,70,70,0,1,0,1,0
60437,445,0,0,66,66,0,1,0,1,0
52762,445,0,0,70,70,0,1,0,1,0
53179,445,0,0,66,66,0,1,0,1,0
60842,445,0,0,66,66,0,1,0,1,0
56406,445,0,0,70,70,0,1,0,1,0
49444,445,0,0,70,70,0,1,0,1,0
49218,445,0,0,70,70,0,1,0,1,0
58445,445,0,0,66,66,0,1,0,1,0
50092,445,0,0,70,70,0,1,0,1,0
60030,445,0,0,66,66,0,1,0,1,0
55388,445,0,0,70,70,0,1,0,1,0
56190,445,0,0,66,66,0,1,0,1,0
50684,445,0,0,70,70,0,1,0,1,0
61858,445,0,0,70,70,0,1,0,1,0
58610,445,0,0,66,66,0,1,0,1,0
59012,445,0,0,70,70,0,1,0,1,0
59208,445,0,0,70,70,0,1,0,1,0
50849,445,0,0,66,66,0,1,0,1,0
64024,445,0,0,70,70,0,1,0,1,0
51166,445,0,0,66,66,0,1,0,1,0
50490,445,0,0,70,70,0,1,0,1,0
52178,445,0,0,70,70,0,1,0,1,0
60617,445,0,0,70,70,0,1,0,1,0
61881,445,0,0,70,70,0,1,0,1,0
61995,445,0,0,70,70,0,1,0,1,0
55825,445,0,0,70,70,0,1,0,1,0
55363,445,0,0,70,70,0,1,0,1,0
63515,445,0,0,70,70,0,1,0,1,0
54981,445,0,0,70,70,0,1,0,1,0
55978,445,0,0,70,70,0,1,0,1,0
54926,445,0,0,66,66,0,1,0,1,0
56654,445,0,0,70,70,0,1,0,1,0
65150,445,0,0,66,66,0,1,0,1,0
54073,445,0,0,66,66,0,1,0,1,0
60678,445,0,0,70,70,0,1,0,1,0
61062,445,0,0,70,70,0,1,0,1,0
62570,445,0,0,70,70,0,1,0,1,0
58938,445,0,0,70,70,0,1,0,1,0
54745,445,0,0,70,70,0,1,0,1,0
62388,445,0,0,66,66,0,1,0,1,0
50219,445,0,0,70,70,0,1,0,1,0
51720,445,0,0,66,66,0,1,0,1,0
49791,445,0,0,70,70,0,1,0,1,0
62635,445,0,0,70,70,0,1,0,1,0
59501,445,0,0,70,70,0,1,0,1,0
51761,445,0,0,66,66,0,1,0,1,0
63204,445,0,0,70,70,0,1,0,1,0
50469,445,0,0,66,66,0,1,0,1,0
64554,445,0,0,66,66,0,1,0,1,0
61875,445,0,0,66,66,0,1,0,1,0
59458,445,0,0,66,66,0,1,0,1,0
57101,445,0,0,70,70,0,1,0,1,0
53591,445,0,0,70,70,0,1,0,1,0
63407,445,0,0,66,66,0,1,0,1,0
51870,445,0,0,66,66,0,1,0,1,0
60430,445,0,0,70,70,0,1,0,1,0
64634,445,0,0,70,70,0,1,0,1,0
49981,445,0,0,70,70,0,1,0,1,0
53398,445,0,0,70,70,0,1,0,1,0
55311,445,0,0,70,70,0,1,0,1,0
50543,445,0,0,66,66,0,1,0,1,0
53287,445,0,0,66,66,0,1,0,1,0
53302,445,0,0,70,70,0,1,0,1,0
53418,445,0,0,66,66,0,1,0,1,0
58549,445,0,0,70,70,0,1,0,1,0
50055,445,0,0,70,70,0,1,0,1,0
55965,445,0,0,66,66,0,1,0,1,0
52371,445,0,0,70,70,0,1,0,1,0
49401,445,0,0,66,66,0,1,0,1,0
49795,445,0,0,66,66,0,1,0,1,0
61225,445,0,0,70,70,0,1,0,1,0
63183,445,0,0,70,70,0,1,0,1,0
64872,445,0,0,70,70,0,1,0,1,0
49776,445,0,0,66,66,0,1,0,1,0
49964,445,0,0,70,70,0,1,0,1,0
53171,445,0,0,70,70,0,1,0,1,0
49853,445,0,0,70,70,0,1,0,1,0
57927,445,0,0,66,66,0,1,0,1,0
54549,445,0,0,66,66,0,1,0,1,0
53874,445,0,0,70,70,0,1,0,1,0
57366,445,0,0,70,70,0,1,0,1,0
57478,445,0,0,66,66,0,1,0,1,0
50199,445,0,0,70,70,0,1,0,1,0
57760,445,0,0,66,66,0,1,0,1,0
55892,445,0,0,70,70,0,1,0,1,0
62170,445,0,0,70,70,0,1,0,1,0
64169,445,0,0,70,70,0,1,0,1,0
60463,445,0,0,66,66,0,1,0,1,0
54521,445,0,0,70,70,0,1,0,1,0
60655,445,0,0,70,70,0,1,0,1,0
54320,445,0,0,66,66,0,1,0,1,0
57088,445,0,0,70,70,0,1,0,1,0
56061,445,0,0,70,70,0,1,0,1,0
65177,445,0,0,66,66,0,1,0,1,0
60059,445,0,0,70,70,0,1,0,1,0
59378,445,0,0,70,70,0,1,0,1,0
62905,445,0,0,70,70,0,1,0,1,0
49810,445,0,0,70,70,0,1,0,1,0
55619,445,0,0,70,70,0,1,0,1,0
62680,445,0,0,70,70,0,1,0,1,0
58342,445,0,0,70,70,0,1,0,1,0
63633,445,0,0,70,70,0,1,0,1,0
62192,445,0,0,70,70,0,1,0,1,0
49809,445,0,0,70,70,0,1,0,1,0
50610,445,0,0,66,66,0,1,0,1,0
57780,445,0,0,66,66,0,1,0,1,0
50739,445,0,0,70,70,0,1,0,1,0
50845,445,0,0,66,66,0,1,0,1,0
55421,445,0,0,66,66,0,1,0,1,0
58498,445,0,0,66,66,0,1,0,1,0
57887,445,0,0,66,66,0,1,0,1,0
55183,445,0,0,70,70,0,1,0,1,0
55891,445,0,0,66,66,0,1,0,1,0
52273,445,0,0,66,66,0,1,0,1,0
62510,445,0,0,70,70,0,1,0,1,0
62278,445,0,0,70,70,0,1,0,1,0
56085,445,0,0,66,66,0,1,0,1,0
56263,445,0,0,66,66,0,1,0,1,0
56846,445,0,0,70,70,0,1,0,1,0
51973,445,0,0,70,70,0,1,0,1,0
55191,445,0,0,70,70,0,1,0,1,0
54274,445,0,0,70,70,0,1,0,1,0
55776,445,0,0,70,70,0,1,0,1,0
52851,445,0,0,70,70,0,1,0,1,0
55580,445,0,0,70,70,0,1,0,1,0
54970,445,0,0,70,70,0,1,0,1,0
56788,445,0,0,66,66,0,1,0,1,0
59605,445,0,0,66,66,0,1,0,1,0
52012,445,0,0,70,70,0,1,0,1,0
63694,445,0,0,66,66,0,1,0,1,0
50412,445,0,0,66,66,0,1,0,1,0
65396,445,0,0,66,66,0,1,0,1,0
49365,445,0,0,70,70,0,1,0,1,0
50333,445,0,0,70,70,0,1,0,1,0
63765,445,0,0,70,70,0,1,0,1,0
52823,445,0,0,70,70,0,1,0,1,0
50484,445,0,0,66,66,0,1,0,1,0
51887,445,0,0,70,70,0,1,0,1,0
56094,445,0,0,66,66,0,1,0,1,0
50979,445,0,0,70,70,0,1,0,1,0
58981,445,0,0,70,70,0,1,0,1,0
55483,445,0,0,70,70,0,1,0,1,0
59310,445,0,0,66,66,0,1,0,1,0
54488,445,0,0,70,70,0,1,0,1,0
53705,445,0,0,66,66,0,1,0,1,0
58771,445,0,0,70,70,0,1,0,1,0
64299,445,0,0,70,70,0,1,0,1,0
58683,445,0,0,70,70,0,1,0,1,0
50990,445,0,0,66,66,0,1,0,1,0
50907,445,0,0,70,70,0,1,0,1,0
60771,445,0,0,70,70,0,1,0,1,0
58263,445,0,0,70,70,0,1,0,1,0
51314,445,0,0,70,70,0,1,0,1,0
52572,445,0,0,70,70,0,1,0,1,0
59985,445,0,0,66,66,0,1,0,1,0
64840,445,0,0,70,70,0,1,0,1,0
52698,445,0,0,70,70,0,1,0,1,0
51121,445,0,0,66,66,0,1,0,1,0
63166,445,0,0,66,66,0,1,0,1,0
65444,445,0,0,70,70,0,1,0,1,0
55585,445,0,0,70,70,0,1,0,1,0
54829,445,0,0,66,66,0,1,0,1,0
58682,445,0,0,66,66,0,1,0,1,0
53495,445,0,0,70,70,0,1,0,1,0
63003,445,0,0,70,70,0,1,0,1,0
59785,445,0,0,66,66,0,1,0,1,0
53072,445,0,0,66,66,0,1,0,1,0
60099,445,0,0,70,70,0,1,0,1,0
51255,445,0,0,70,70,0,1,0,1,0
65017,445,0,0,70,70,0,1,0,1,0
63126,445,0,0,66,66,0,1,0,1,0
62528,445,0,0,70,70,0,1,0,1,0
61784,445,0,0,66,66,0,1,0,1,0
51125,445,0,0,66,66,0,1,0,1,0
63723,445,0,0,70,70,0,1,0,1,0
63826,445,0,0,66,66,0,1,0,1,0
63069,445,0,0,70,70,0,1,0,1,0
57119,445,0,0,70,70,0,1,0,1,0
62145,445,0,0,70,70,0,1,0,1,0
61560,445,0,0,70,70,0,1,0,1,0
58558,445,0,0,70,70,0,1,0,1,0
49388,445,0,0,70,70,0,1,0,1,0
54206,445,0,0,70,70,0,1,0,1,0
58432,445,0,0,70,70,0,1,0,1,0
51441,445,0,0,66,66,0,1,0,1,0
65112,445,0,0,70,70,0,1,0,1,0
51420,445,0,0,70,70,0,1,0,1,0
52431,445,0,0,70,70,0,1,0,1,0
58944,445,0,0,70,70,0,1,0,1,0
65441,445,0,0,70,70,0,1,0,1,0
64846,445,0,0,66,66,0,1,0,1,0
53308,445,0,0,66,66,0,1,0,1,0
64121,445,0,0,70,70,0,1,0,1,0
62153,445,0,0,66,66,0,1,0,1,0
61968,445,0,0,70,70,0,1,0,1,0
58882,445,0,0,66,66,0,1,0,1,0
55330,445,0,0,70,70,0,1,0,1,0
50207,445,0,0,66,66,0,1,0,1,0
56843,445,0,0,70,70,0,1,0,1,0
55531,445,0,0,70,70,0,1,0,1,0
55498,445,0,0,70,70,0,1,0,1,0
55676,445,0,0,70,70,0,1,0,1,0
50387,445,0,0,70,70,0,1,0,1,0
58430,445,0,0,66,66,0,1,0,1,0
59960,445,0,0,70,70,0,1,0,1,0
63286,445,0,0,70,70,0,1,0,1,0
62615,445,0,0,70,70,0,1,0,1,0
62286,445,0,0,66,66,0,1,0,1,0
61544,445,0,0,66,66,0,1,0,1,0
60957,445,0,0,70,70,0,1,0,1,0
53979,445,0,0,70,70,0,1,0,1,0
56158,445,0,0,70,70,0,1,0,1,0
55543,445,0,0,66,66,0,1,0,1,0
53902,445,0,0,70,70,0,1,0,1,0
51234,445,0,0,66,66,0,1,0,1,0
51350,445,0,0,70,70,0,1,0,1,0
55515,445,0,0,70,70,0,1,0,1,0
59783,445,0,0,70,70,0,1,0,1,0
63453,445,0,0,70,70,0,1,0,1,0
50543,445,0,0,66,66,0,1,0,1,0
59146,445,0,0,70,70,0,1,0,1,0
58116,445,0,0,66,66,0,1,0,1,0
64452,445,0,0,70,70,0,1,0,1,0
55228,445,0,0,70,70,0,1,0,1,0
57156,445,0,0,70,70,0,1,0,1,0
57020,445,0,0,66,66,0,1,0,1,0
63561,445,0,0,70,70,0,1,0,1,0
50797,445,0,0,66,66,0,1,0,1,0
63179,445,0,0,70,70,0,1,0,1,0
49664,445,0,0,70,70,0,1,0,1,0
55950,445,0,0,70,70,0,1,0,1,0
52317,445,0,0,70,70,0,1,0,1,0
51616,445,0,0,70,70,0,1,0,1,0
53175,445,0,0,66,66,0,1,0,1,0
58587,445,0,0,70,70,0,1,0,1,0
53801,445,0,0,70,70,0,1,0,1,0
62272,445,0,0,70,70,0,1,0,1,0
62310,445,0,0,70,70,0,1,0,1,0
49736,445,0,0,70,70,0,1,0,1,0
64772,445,0,0,70,70,0,1,0,1,0
58506,445,0,0,70,70,0,1,0,1,0
57543,445,0,0,70,70,0,1,0,1,0
50648,445,0,0,70,70,0,1,0,1,0
56407,445,0,0,70,70,0,1,0,1,0
55749,445,0,0,66,66,0,1,0,1,0
49780,445,0,0,70,70,0,1,0,1,0
63909,445,0,0,70,70,0,1,0,1,0
55230,445,0,0,70,70,0,1,0,1,0
64358,445,0,0,70,70,0,1,0,1,0
63718,445,0,0,70,70,0,1,0,1,0
59734,445,0,0,66,66,0,1,0,1,0
63000,445,0,0,66,66,0,1,0,1,0
52958,445,0,0,70,70,0,1,0,1,0
54588,445,0,0,70,70,0,1,0,1,0
64415,445,0,0,70,70,0,1,0,1,0
51945,445,0,0,70,70,0,1,0,1,0
52086,445,0,0,70,70,0,1,0,1,0
62636,445,0,0,70,70,0,1,0,1,0
59604,445,0,0,70,70,0,1,0,1,0
64331,445,0,0,70,70,0,1,0,1,0
49267,445,0,0,70,70,0,1,0,1,0
55203,445,0,0,70,70,0,1,0,1,0
49667,445,0,0,70,70,0,1,0,1,0
63861,445,0,0,70,70,0,1,0,1,0
52915,445,0,0,66,66,0,1,0,1,0
49524,445,0,0,70,70,0,1,0,1,0
56400,445,0,0,66,66,0,1,0,1,0
63413,445,0,0,70,70,0,1,0,1,0
54077,445,0,0,70,70,0,1,0,1,0
49644,445,0,0,70,70,0,1,0,1,0
49844,445,0,0,66,66,0,1,0,1,0
53866,445,0,0,70,70,0,1,0,1,0
50299,445,0,0,70,70,0,1,0,1,0
61054,445,0,0,70,70,0,1,0,1,0
56660,445,0,0,66,66,0,1,0,1,0
54296,445,0,0,70,70,0,1,0,1,0
62235,445,0,0,70,70,0,1,0,1,0
64248,445,0,0,66,66,0,1,0,1,0
49905,445,0,0,66,66,0,1,0,1,0
54285,445,0,0,66,66,0,1,0,1,0
62433,445,0,0,66,66,0,1,0,1,0
62923,445,0,0,66,66,0,1,0,1,0
61993,445,0,0,70,70,0,1,0,1,0
61441,445,0,0,70,70,0,1,0,1,0
56971,445,0,0,70,70,0,1,0,1,0
57678,445,0,0,70,70,0,1,0,1,0
53608,445,0,0,66,66,0,1,0,1,0
53879,445,0,0,70,70,0,1,0,1,0
65070,445,0,0,66,66,0,1,0,1,0
52703,445,0,0,70,70,0,1,0,1,0
52394,445,0,0,70,70,0,1,0,1,0
54640,445,0,0,70,70,0,1,0,1,0
61912,445,0,0,66,66,0,1,0,1,0
50345,445,0,0,66,66,0,1,0,1,0
54839,445,0,0,66,66,0,1,0,1,0
63289,445,0,0,70,70,0,1,0,1,0
55275,445,0,0,70,70,0,1,0,1,0
64563,445,0,0,70,70,0,1,0,1,0
52966,445,0,0,66,66,0,1,0,1,0
54827,445,0,0,70,70,0,1,0,1,0
54720,445,0,0,70,70,0,1,0,1,0
54910,445,0,0,70,70,0,1,0,1,0
61945,445,0,0,70,70,0,1,0,1,0
52086,445,0,0,66,66,0,1,0,1,0
60048,445,0,0,70,70,0,1,0,1,0
53973,445,0,0,70,70,0,1,0,1,0
56564,445,0,0,66,66,0,1,0,1,0
50889,445,0,0,70,70,0,1,0,1,0
55678,445,0,0,70,70,0,1,0,1,0
61954,445,0,0,70,70,0,1,0,1,0
59743,445,0,0,66,66,0,1,0,1,0
60063,445,0,0,70,70,0,1,0,1,0
64033,445,0,0,66,66,0,1,0,1,0
51783,445,0,0,66,66,0,1,0,1,0
58516,445,0,0,70,70,0,1,0,1,0
51965,445,0,0,70,70,0,1,0,1,0
59155,445,0,0,70,70,0,1,0,1,0
51468,445,0,0,66,66,0,1,0,1,0
61144,445,0,0,70,70,0,1,0,1,0
60820,445,0,0,70,70,0,1,0,1,0
55984,445,0,0,70,70,0,1,0,1,0
50807,445,0,0,66,66,0,1,0,1,0
50246,445,0,0,66,66,0,1,0,1,0
52934,445,0,0,70,70,0,1,0,1,0
50544,445,0,0,70,70,0,1,0,1,0
53499,445,0,0,70,70,0,1,0,1,0
49427,445,0,0,70,70,0,1,0,1,0
62214,445,0,0,66,66,0,1,0,1,0
56648,445,0,0,66,66,0,1,0,1,0
54602,445,0,0,70,70,0,1,0,1,0
57927,445,0,0,70,70,0,1,0,1,0
64469,445,0,0,66,66,0,1,0,1,0
58152,445,0,0,70,70,0,1,0,1,0
51755,445,0,0,70,70,0,1,0,1,0
50939,445,0,0,66,66,0,1,0,1,0
51833,445,0,0,66,66,0,1,0,1,0
59761,445,0,0,70,70,0,1,0,1,0
63122,445,0,0,70,70,0,1,0,1,0
53960,445,0,0,70,70,0,1,0,1,0
61566,445,0,0,70,70,0,1,0,1,0
51240,445,0,0,66,66,0,1,0,1,0
56996,445,0,0,70,70,0,1,0,1,0
61163,445,0,0,66,66,0,1,0,1,0
56403,445,0,0,70,70,0,1,0,1,0
63433,445,0,0,70,70,0,1,0,1,0
61574,445,0,0,66,66,0,1,0,1,0
53341,445,0,0,70,70,0,1,0,1,0
51083,445,0,0,66,66,0,1,0,1,0
60688,445,0,0,70,70,0,1,0,1,0
55277,445,0,0,70,70,0,1,0,1,0
65156,445,0,0,70,70,0,1,0,1,0
54396,445,0,0,66,66,0,1,0,1,0
50707,445,0,0,70,70,0,1,0,1,0
60405,445,0,0,70,70,0,1,0,1,0
62562,445,0,0,66,66,0,1,0,1,0
56112,445,0,0,70,70,0,1,0,1,0
55174,445,0,0,70,70,0,1,0,1,0
62393,445,0,0,70,70,0,1,0,1,0
55031,445,0,0,70,70,0,1,0,1,0
59500,445,0,0,70,70,0,1,0,1,0
64552,445,0,0,66,66,0,1,0,1,0
64256,445,0,0,70,70,0,1,0,1,0
58289,445,0,0,70,70,0,1,0,1,0
62157,445,0,0,70,70,0,1,0,1,0
53405,445,0,0,66,66,0,1,0,1,0
50641,445,0,0,70,70,0,1,0,1,0
51066,445,0,0,66,66,0,1,0,1,0
63476,445,0,0,70,70,0,1,0,1,0
57129,445,0,0,66,66,0,1,0,1,0
49662,445,0,0,70,70,0,1,0,1,0
61791,445,0,0,70,70,0,1,0,1,0
58327,445,0,0,70,70,0,1,0,1,0
53010,445,0,0,66,66,0,1,0,1,0
52906,445,0,0,70,70,0,1,0,1,0
64342,445,0,0,70,70,0,1,0,1,0
55491,445,0,0,70,70,0,1,0,1,0
57816,445,0,0,66,66,0,1,0,1,0
55491,445,0,0,70,70,0,1,0,1,0
59770,445,0,0,66,66,0,1,0,1,0
55962,445,0,0,70,70,0,1,0,1,0
51717,445,0,0,70,70,0,1,0,1,0
56321,445,0,0,70,70,0,1,0,1,0
54348,445,0,0,70,70,0,1,0,1,0
49842,445,0,0,66,66,0,1,0,1,0
59254,445,0,0,70,70,0,1,0,1,0
60193,445,0,0,66,66,0,1,0,1,0
57427,445,0,0,70,70,0,1,0,1,0
57238,445,0,0,70,70,0,1,0,1,0
50149,445,0,0,70,70,0,1,0,1,0
50886,445,0,0,66,66,0,1,0,1,0
49974,445,0,0,70,70,0,1,0,1,0
62126,445,0,0,70,70,0,1,0,1,0
57557,445,0,0,70,70,0,1,0,1,0
56449,445,0,0,70,70,0,1,0,1,0
50402,445,0,0,66,66,0,1,0,1,0
65502,445,0,0,66,66,0,1,0,1,0
52731,445,0,0,66,66,0,1,0,1,0
55575,445,0,0,70,70,0,1,0,1,0
53007,445,0,0,70,70,0,1,0,1,0
63111,445,0,0,66,66,0,1,0,1,0
57608,445,0,0,66,66,0,1,0,1,0
50910,445,0,0,66,66,0,1,0,1,0
55291,445,0,0,70,70,0,1,0,1,0
64432,445,0,0,70,70,0,1,0,1,0
55063,445,0,0,70,70,0,1,0,1,0
53045,445,0,0,70,70,0,1,0,1,0
49946,445,0,0,70,70,0,1,0,1,0
59452,445,0,0,66,66,0,1,0,1,0
55804,445,0,0,66,66,0,1,0,1,0
63388,445,0,0,66,66,0,1,0,1,0
61813,445,0,0,70,70,0,1,0,1,0
63492,445,0,0,70,70,0,1,0,1,0
51586,445,0,0,66,66,0,1,0,1,0
56748,445,0,0,70,70,0,1,0,1,0
50043,445,0,0,66,66,0,1,0,1,0
58312,445,0,0,70,70,0,1,0,1,0
64236,445,0,0,66,66,0,1,0,1,0
49903,445,0,0,66,66,0,1,0,1,0
63330,445,0,0,66,66,0,1,0,1,0
52944,445,0,0,66,66,0,1,0,1,0
53930,445,0,0,70,70,0,1,0,1,0
59549,445,0,0,70,70,0,1,0,1,0
54323,445,0,0,66,66,0,1,0,1,0
56854,445,0,0,70,70,0,1,0,1,0
55132,445,0,0,70,70,0,1,0,1,0
56104,445,0,0,70,70,0,1,0,1,0
60354,445,0,0,70,70,0,1,0,1,0
53747,445,0,0,70,70,0,1,0,1,0
62691,445,0,0,70,70,0,1,0,1,0
50696,445,0,0,66,66,0,1,0,1,0
65041,445,0,0,70,70,0,1,0,1,0
50019,445,0,0,66,66,0,1,0,1,0
56043,445,0,0,70,70,0,1,0,1,0
60559,445,0,0,70,70,0,1,0,1,0
49792,445,0,0,70,70,0,1,0,1,0
65493,445,0,0,70,70,0,1,0,1,0
56768,445,0,0,70,70,0,1,0,1,0
55789,445,0,0,66,66,0,1,0,1,0
53320,445,0,0,66,66,0,1,0,1,0
54567,445,0,0,70,70,0,1,0,1,0
50794,445,0,0,66,66,0,1,0,1,0
50951,445,0,0,70,70,0,1,0,1,0
63274,445,0,0,70,70,0,1,0,1,0
55672,445,0,0,70,70,0,1,0,1,0
60362,445,0,0,70,70,0,1,0,1,0
49527,445,0,0,66,66,0,1,0,1,0
56380,445,0,0,70,70,0,1,0,1,0
56874,445,0,0,70,70,0,1,0,1,0
59771,445,0,0,66,66,0,1,0,1,0
52688,445,0,0,70,70,0,1,0,1,0
54955,445,0,0,70,70,0,1,0,1,0
51439,445,0,0,66,66,0,1,0,1,0
55105,445,0,0,66,66,0,1,0,1,0
53344,445,0,0,70,70,0,1,0,1,0
50208,445,0,0,66,66,0,1,0,1,0
53330,445,0,0,70,70,0,1,0,1,0
59710,445,0,0,70,70,0,1,0,1,0
62625,445,0,0,70,70,0,1,0,1,0
51362,445,0,0,66,66,0,1,0,1,0
56705,445,0,0,66,66,0,1,0,1,0
63566,445,0,0,66,66,0,1,0,1,0
60438,445,0,0,66,66,0,1,0,1,0
53564,445,0,0,70,70,0,1,0,1,0
52039,445,0,0,70,70,0,1,0,1,0
61222,445,0,0,70,70,0,1,0,1,0
57045,445,0,0,66,66,0,1,0,1,0
56255,445,0,0,66,66,0,1,0,1,0
55572,445,0,0,70,70,0,1,0,1,0
62923,445,0,0,70,70,0,1,0,1,0
62155,445,0,0,66,66,0,1,0,1,0
55086,445,0,0,70,70,0,1,0,1,0
58779,445,0,0,70,70,0,1,0,1,0
59080,445,0,0,70,70,0,1,0,1,0
50298,445,0,0,70,70,0,1,0,1,0
50487,445,0,0,70,70,0,1,0,1,0
52220,445,0,0,66,66,0,1,0,1,0
56683,445,0,0,70,70,0,1,0,1,0
65477,445,0,0,70,70,0,1,0,1,0
58331,445,0,0,70,70,0,1,0,1,0
64498,445,0,0,66,66,0,1,0,1,0
53924,445,0,0,70,70,0,1,0,1,0
59526,445,0,0,70,70,0,1,0,1,0
54206,445,0,0,66,66,0,1,0,1,0
57729,445,0,0,70,70,0,1,0,1,0
53283,445,0,0,70,70,0,1,0,1,0
50346,445,0,0,66,66,0,1,0,1,0
53094,445,0,0,66,66,0,1,0,1,0
58502,445,0,0,66,66,0,1,0,1,0
60923,445,0,0,70,70,0,1,0,1,0
50518,445,0,0,66,66,0,1,0,1,0
59792,445,0,0,70,70,0,1,0,1,0
56715,445,0,0,70,70,0,1,0,1,0
56892,445,0,0,70,70,0,1,0,1,0
54997,445,0,0,70,70,0,1,0,1,0
61055,445,0,0,70,70,0,1,0,1,0
50755,445,0,0,70,70,0,1,0,1,0
54721,445,0,0,66,66,0,1,0,1,0
58099,445,0,0,66,66,0,1,0,1,0
52657,445,0,0,66,66,0,1,0,1,0
64644,445,0,0,70,70,0,1,0,1,0
52976,445,0,0,70,70,0,1,0,1,0
57317,445,0,0,70,70,0,1,0,1,0
54975,445,0,0,70,70,0,1,0,1,0
55330,445,0,0,70,70,0,1,0,1,0
60544,445,0,0,70,70,0,1,0,1,0
64901,445,0,0,70,70,0,1,0,1,0
56872,445,0,0,70,70,0,1,0,1,0
49788,445,0,0,70,70,0,1,0,1,0
56967,445,0,0,66,66,0,1,0,1,0
50615,445,0,0,70,70,0,1,0,1,0
53491,445,0,0,70,70,0,1,0,1,0
61610,445,0,0,70,70,0,1,0,1,0
54956,445,0,0,70,70,0,1,0,1,0
55182,445,0,0,70,70,0,1,0,1,0
52156,445,0,0,66,66,0,1,0,1,0
52143,445,0,0,66,66,0,1,0,1,0
55469,445,0,0,70,70,0,1,0,1,0
49257,445,0,0,70,70,0,1,0,1,0
65111,445,0,0,70,70,0,1,0,1,0
54246,445,0,0,66,66,0,1,0,1,0
59203,445,0,0,70,70,0,1,0,1,0
61082,445,0,0,66,66,0,1,0,1,0
54551,445,0,0,66,66,0,1,0,1,0
62434,445,0,0,66,66,0,1,0,1,0
56381,445,0,0,66,66,0,1,0,1,0
58168,445,0,0,70,70,0,1,0,1,0
64062,445,0,0,66,66,0,1,0,1,0
51806,445,0,0,70,70,0,1,0,1,0
64566,445,0,0,70,70,0,1,0,1,0
63100,445,0,0,70,70,0,1,0,1,0
51985,445,0,0,70,70,0,1,0,1,0
50395,445,0,0,70,70,0,1,0,1,0
57566,445,0,0,66,66,0,1,0,1,0
49922,445,0,0,70,70,0,1,0,1,0
59422,445,0,0,66,66,0,1,0,1,0
49712,445,0,0,66,66,0,1,0,1,0
55917,445,0,0,66,66,0,1,0,1,0
62957,445,0,0,70,70,0,1,0,1,0
61078,445,0,0,70,70,0,1,0,1,0
51789,445,0,0,70,70,0,1,0,1,0
60612,445,0,0,70,70,0,1,0,1,0
56969,445,0,0,66,66,0,1,0,1,0
58440,445,0,0,70,70,0,1,0,1,0
58143,445,0,0,70,70,0,1,0,1,0
51783,445,0,0,70,70,0,1,0,1,0
50837,445,0,0,70,70,0,1,0,1,0
53335,445,0,0,70,70,0,1,0,1,0
61016,445,0,0,70,70,0,1,0,1,0
50482,445,0,0,66,66,0,1,0,1,0
60546,445,0,0,66,66,0,1,0,1,0
65360,445,0,0,66,66,0,1,0,1,0
64349,445,0,0,70,70,0,1,0,1,0
64192,445,0,0,66,66,0,1,0,1,0
56056,445,0,0,70,70,0,1,0,1,0
59597,445,0,0,70,70,0,1,0,1,0
57329,445,0,0,70,70,0,1,0,1,0
57157,445,0,0,70,70,0,1,0,1,0
56066,445,0,0,66,66,0,1,0,1,0
58528,445,0,0,70,70,0,1,0,1,0
55341,445,0,0,70,70,0,1,0,1,0
59910,445,0,0,70,70,0,1,0,1,0
49555,445,0,0,70,70,0,1,0,1,0
55549,445,0,0,70,70,0,1,0,1,0
50672,445,0,0,70,70,0,1,0,1,0
57028,445,0,0,70,70,0,1,0,1,0
55502,445,0,0,66,66,0,1,0,1,0
58449,445,0,0,70,70,0,1,0,1,0
59373,445,0,0,70,70,0,1,0,1,0
54266,445,0,0,66,66,0,1,0,1,0
65034,445,0,0,70,70,0,1,0,1,0
55242,445,0,0,66,66,0,1,0,1,0
53845,445,0,0,70,70,0,1,0,1,0
59345,445,0,0,70,70,0,1,0,1,0
54465,445,0,0,70,70,0,1,0,1,0
52962,445,0,0,70,70,0,1,0,1,0
62407,445,0,0,70,70,0,1,0,1,0
51038,445,0,0,70,70,0,1,0,1,0
65201,445,0,0,70,70,0,1,0,1,0
62856,445,0,0,66,66,0,1,0,1,0
60897,445,0,0,66,66,0,1,0,1,0
64973,445,0,0,70,70,0,1,0,1,0
52027,445,0,0,66,66,0,1,0,1,0
53454,445,0,0,66,66,0,1,0,1,0
51286,445,0,0,70,70,0,1,0,1,0
57094,445,0,0,66,66,0,1,0,1,0
63539,445,0,0,70,70,0,1,0,1,0
54860,445,0,0,66,66,0,1,0,1,0
50330,445,0,0,70,70,0,1,0,1,0
59449,445,0,0,70,70,0,1,0,1,0
51286,445,0,0,70,70,0,1,0,1,0
59690,445,0,0,66,66,0,1,0,1,0
55773,445,0,0,70,70,0,1,0,1,0
53949,445,0,0,66,66,0,1,0,1,0
50813,445,0,0,70,70,0,1,0,1,0
52276,445,0,0,66,66,0,1,0,1,0
54393,445,0,0,66,66,0,1,0,1,0
49954,445,0,0,70,70,0,1,0,1,0
50526,445,0,0,66,66,0,1,0,1,0
54951,445,0,0,70,70,0,1,0,1,0
53878,445,0,0,66,66,0,1,0,1,0
56073,445,0,0,70,70,0,1,0,1,0
63239,445,0,0,66,66,0,1,0,1,0
63367,445,0,0,70,70,0,1,0,1,0
56930,445,0,0,70,70,0,1,0,1,0
53638,445,0,0,70,70,0,1,0,1,0
63463,445,0,0,70,70,0,1,0,1,0
64698,445,0,0,66,66,0,1,0,1,0
51859,445,0,0,66,66,0,1,0,1,0
50472,445,0,0,66,66,0,1,0,1,0
52858,445,0,0,70,70,0,1,0,1,0
53623,445,0,0,70,70,0,1,0,1,0
54880,445,0,0,70,70,0,1,0,1,0
53882,445,0,0,66,66,0,1,0,1,0
51499,445,0,0,66,66,0,1,0,1,0
64828,445,0,0,66,66,0,1,0,1,0
51071,445,0,0,70,70,0,1,0,1,0
57961,445,0,0,70,70,0,1,0,1,0
57753,445,0,0,70,70,0,1,0,1,0
61677,445,0,0,66,66,0,1,0,1,0
61499,445,0,0,70,70,0,1,0,1,0
56191,445,0,0,70,70,0,1,0,1,0
50344,445,0,0,70,70,0,1,0,1,0
54006,445,0,0,70,70,0,1,0,1,0
62401,445,0,0,70,70,0,1,0,1,0
54172,445,0,0,70,70,0,1,0,1,0
55690,445,0,0,70,70,0,1,0,1,0
51946,445,0,0,70,70,0,1,0,1,0
51881,445,0,0,70,70,0,1,0,1,0
56837,445,0,0,70,70,0,1,0,1,0
63732,445,0,0,70,70,0,1,0,1,0
58450,445,0,0,66,66,0,1,0,1,0
50525,445,0,0,70,70,0,1,0,1,0
64874,445,0,0,66,66,0,1,0,1,0
49843,445,0,0,70,70,0,1,0,1,0
53531,445,0,0,70,70,0,1,0,1,0
53630,445,0,0,70,70,0,1,0,1,0
49757,445,0,0,70,70,0,1,0,1,0
51295,445,0,0,70,70,0,1,0,1,0
51727,445,0,0,66,66,0,1,0,1,0
54485,445,0,0,70,70,0,1,0,1,0
65518,445,0,0,66,66,0,1,0,1,0
50927,445,0,0,66,66,0,1,0,1,0
51734,445,0,0,70,70,0,1,0,1,0
54367,445,0,0,70,70,0,1,0,1,0
55367,445,0,0,66,66,0,1,0,1,0
51584,445,0,0,70,70,0,1,0,1,0
57433,445,0,0,70,70,0,1,0,1,0
50239,445,0,0,66,66,0,1,0,1,0
60441,445,0,0,70,70,0,1,0,1,0
58247,445,0,0,66,66,0,1,0,1,0
50285,445,0,0,70,70,0,1,0,1,0
62651,445,0,0,70,70,0,1,0,1,0
61853,445,0,0,66,66,0,1,0,1,0
55319,445,0,0,66,66,0,1,0,1,0
54916,445,0,0,70,70,0,1,0,1,0
50133,445,0,0,70,70,0,1,0,1,0
59969,445,0,0,66,66,0,1,0,1,0
51028,445,0,0,70,70,0,1,0,1,0
50136,445,0,0,70,70,0,1,0,1,0
57268,445,0,0,66,66,0,1,0,1,0
57771,445,0,0,70,70,0,1,0,1,0
54817,445,0,0,66,66,0,1,0,1,0
57305,445,0,0,66,66,0,1,0,1,0
62344,445,0,0,66,66,0,1,0,1,0
51922,445,0,0,70,70,0,1,0,1,0
54166,445,0,0,70,70,0,1,0,1,0
61516,445,0,0,66,66,0,1,0,1,0
58176,445,0,0,70,70,0,1,0,1,0
49585,445,0,0,66,66,0,1,0,1,0
54057,445,0,0,66,66,0,1,0,1,0
52691,445,0,0,70,70,0,1,0,1,0
60297,445,0,0,70,70,0,1,0,1,0
61415,445,0,0,66,66,0,1,0,1,0
49927,445,0,0,66,66,0,1,0,1,0
50357,445,0,0,70,70,0,1,0,1,0
54210,445,0,0,70,70,0,1,0,1,0
50039,445,0,0,70,70,0,1,0,1,0
61398,445,0,0,66,66,0,1,0,1,0
58395,445,0,0,70,70,0,1,0,1,0
58108,445,0,0,70,70,0,1,0,1,0
51690,445,0,0,70,70,0,1,0,1,0
59887,445,0,0,70,70,0,1,0,1,0
53752,445,0,0,66,66,0,1,0,1,0
58671,445,0,0,70,70,0,1,0,1,0
61569,445,0,0,70,70,0,1,0,1,0
58996,445,0,0,66,66,0,1,0,1,0
55798,445,0,0,70,70,0,1,0,1,0
64844,445,0,0,70,70,0,1,0,1,0
51755,445,0,0,70,70,0,1,0,1,0
62927,445,0,0,70,70,0,1,0,1,0
63343,445,0,0,70,70,0,1,0,1,0
55349,445,0,0,66,66,0,1,0,1,0
50055,445,0,0,66,66,0,1,0,1,0
55145,445,0,0,66,66,0,1,0,1,0
55707,445,0,0,70,70,0,1,0,1,0
50327,445,0,0,70,70,0,1,0,1,0
63921,445,0,0,70,70,0,1,0,1,0
62315,445,0,0,66,66,0,1,0,1,0
64697,445,0,0,70,70,0,1,0,1,0
65415,445,0,0,70,70,0,1,0,1,0
56699,445,0,0,70,70,0,1,0,1,0
50263,445,0,0,66,66,0,1,0,1,0
54780,445,0,0,66,66,0,1,0,1,0
56965,445,0,0,70,70,0,1,0,1,0
55039,445,0,0,70,70,0,1,0,1,0
58060,445,0,0,66,66,0,1,0,1,0
61948,445,0,0,66,66,0,1,0,1,0
63389,445,0,0,70,70,0,1,0,1,0
51110,445,0,0,66,66,0,1,0,1,0
62916,445,0,0,70,70,0,1,0,1,0
58063,445,0,0,70,70,0,1,0,1,0
64247,445,0,0,70,70,0,1,0,1,0
61335,445,0,0,66,66,0,1,0,1,0
53768,445,0,0,66,66,0,1,0,1,0
49534,445,0,0,70,70,0,1,0,1,0
64162,445,0,0,70,70,0,1,0,1,0
62692,445,0,0,70,70,0,1,0,1,0
58971,445,0,0,70,70,0,1,0,1,0
62655,445,0,0,70,70,0,1,0,1,0
59740,445,0,0,70,70,0,1,0,1,0
58170,445,0,0,66,66,0,1,0,1,0
50866,445,0,0,70,70,0,1,0,1,0
50979,445,0,0,66,66,0,1,0,1,0
58631,445,0,0,66,66,0,1,0,1,0
63662,445,0,0,70,70,0,1,0,1,0
62663,445,0,0,70,70,0,1,0,1,0
58478,445,0,0,70,70,0,1,0,1,0
55834,445,0,0,66,66,0,1,0,1,0
63775,445,0,0,66,66,0,1,0,1,0
63689,445,0,0,70,70,0,1,0,1,0
61281,445,0,0,66,66,0,1,0,1,0
56899,445,0,0,66,66,0,1,0,1,0
53243,445,0,0,66,66,0,1,0,1,0
51270,445,0,0,70,70,0,1,0,1,0
60373,445,0,0,66,66,0,1,0,1,0
58547,445,0,0,70,70,0,1,0,1,0
50683,445,0,0,70,70,0,1,0,1,0
50149,445,0,0,66,66,0,1,0,1,0
50443,445,0,0,66,66,0,1,0,1,0
52379,445,0,0,70,70,0,1,0,1,0
63106,445,0,0,70,70,0,1,0,1,0
59634,445,0,0,70,70,0,1,0,1,0
49523,445,0,0,70,70,0,1,0,1,0
52989,445,0,0,70,70,0,1,0,1,0
52895,445,0,0,66,66,0,1,0,1,0
51643,445,0,0,66,66,0,1,0,1,0
51160,445,0,0,70,70,0,1,0,1,0
59531,445,0,0,70,70,0,1,0,1,0
59090,445,0,0,70,70,0,1,0,1,0
51132,445,0,0,70,70,0,1,0,1,0
59557,445,0,0,70,70,0,1,0,1,0
63475,445,0,0,70,70,0,1,0,1,0
63554,445,0,0,70,70,0,1,0,1,0
49604,445,0,0,70,70,0,1,0,1,0
61786,445,0,0,66,66,0,1,0,1,0
63615,445,0,0,70,70,0,1,0,1,0
53594,445,0,0,70,70,0,1,0,1,0
51423,445,0,0,70,70,0,1,0,1,0
56222,445,0,0,70,70,0,1,0,1,0
60408,445,0,0,70,70,0,1,0,1,0
54455,445,0,0,70,70,0,1,0,1,0
52076,445,0,0,70,70,0,1,0,1,0
64242,445,0,0,70,70,0,1,0,1,0
51163,445,0,0,70,70,0,1,0,1,0
54500,445,0,0,70,70,0,1,0,1,0
58377,445,0,0,66,66,0,1,0,1,0
55844,445,0,0,66,66,0,1,0,1,0
50639,445,0,0,70,70,0,1,0,1,0
64016,445,0,0,66,66,0,1,0,1,0
50069,445,0,0,70,70,0,1,0,1,0
56825,445,0,0,70,70,0,1,0,1,0
56640,445,0,0,66,66,0,1,0,1,0
56472,445,0,0,66,66,0,1,0,1,0
50177,445,0,0,70,70,0,1,0,1,0
55551,445,0,0,66,66,0,1,0,1,0
61597,445,0,0,66,66,0,1,0,1,0
62844,445,0,0,70,70,0,1,0,1,0
60191,445,0,0,70,70,0,1,0,1,0
51367,445,0,0,70,70,0,1,0,1,0
51815,445,0,0,70,70,0,1,0,1,0
61503,445,0,0,70,70,0,1,0,1,0
56783,445,0,0,70,70,0,1,0,1,0
51672,445,0,0,70,70,0,1,0,1,0
55388,445,0,0,70,70,0,1,0,1,0
54334,445,0,0,70,70,0,1,0,1,0
62386,445,0,0,70,70,0,1,0,1,0
59576,445,0,0,70,70,0,1,0,1,0
50863,445,0,0,66,66,0,1,0,1,0
52956,445,0,0,70,70,0,1,0,1,0
50143,445,0,0,70,70,0,1,0,1,0
61404,445,0,0,70,70,0,1,0,1,0
56229,445,0,0,70,70,0,1,0,1,0
61759,445,0,0,70,70,0,1,0,1,0
61287,445,0,0,66,66,0,1,0,1,0
52006,445,0,0,70,70,0,1,0,1,0
53196,445,0,0,66,66,0,1,0,1,0
50308,445,0,0,70,70,0,1,0,1,0
55721,445,0,0,70,70,0,1,0,1,0
62820,445,0,0,70,70,0,1,0,1,0
58477,445,0,0,70,70,0,1,0,1,0
60303,445,0,0,70,70,0,1,0,1,0
62980,445,0,0,70,70,0,1,0,1,0
63955,445,0,0,70,70,0,1,0,1,0
60469,445,0,0,70,70,0,1,0,1,0
56608,445,0,0,70,70,0,1,0,1,0
53119,445,0,0,70,70,0,1,0,1,0
55955,445,0,0,66,66,0,1,0,1,0
57967,445,0,0,70,70,0,1,0,1,0
50223,445,0,0,70,70,0,1,0,1,0
55427,445,0,0,70,70,0,1,0,1,0
61867,445,0,0,70,70,0,1,0,1,0
49995,445,0,0,70,70,0,1,0,1,0
54375,445,0,0,66,66,0,1,0,1,0
63313,445,0,0,70,70,0,1,0,1,0
62390,445,0,0,66,66,0,1,0,1,0
57111,445,0,0,66,66,0,1,0,1,0
59245,445,0,0,66,66,0,1,0,1,0
50429,445,0,0,70,70,0,1,0,1,0
61635,445,0,0,70,70,0,1,0,1,0
64088,445,0,0,66,66,0,1,0,1,0
64944,445,0,0,70,70,0,1,0,1,0
56357,445,0,0,70,70,0,1,0,1,0
49663,445,0,0,70,70,0,1,0,1,0
52785,445,0,0,70,70,0,1,0,1,0
61303,445,0,0,70,70,0,1,0,1,0
52172,445,0,0,66,66,0,1,0,1,0
60652,445,0,0,70,70,0,1,0,1,0
57542,445,0,0,66,66,0,1,0,1,0
64407,445,0,0,70,70,0,1,0,1,0
59171,445,0,0,66,66,0,1,0,1,0
61279,445,0,0,66,66,0,1,0,1,0
54275,445,0,0,70,70,0,1,0,1,0
49853,445,0,0,66,66,0,1,0,1,0
61428,445,0,0,70,70,0,1,0,1,0
65374,445,0,0,70,70,0,1,0,1,0
58738,445,0,0,66,66,0,1,0,1,0
56655,445,0,0,70,70,0,1,0,1,0
52319,445,0,0,70,70,0,1,0,1,0
57525,445,0,0,66,66,0,1,0,1,0
64190,445,0,0,70,70,0,1,0,1,0
54633,445,0,0,70,70,0,1,0,1,0
58869,445,0,0,70,70,0,1,0,1,0
55335,445,0,0,70,70,0,1,0,1,0
55874,445,0,0,70,70,0,1,0,1,0
52305,445,0,0,70,70,0,1,0,1,0
53403,445,0,0,70,70,0,1,0,1,0
52712,445,0,0,66,66,0,1,0,1,0
58229,445,0,0,66,66,0,1,0,1,0
57662,445,0,0,70,70,0,1,0,1,0
57164,445,0,0,70,70,0,1,0,1,0
55452,445,0,0,70,70,0,1,0,1,0
60335,445,0,0,66,66,0,1,0,1,0
63697,445,0,0,70,70,0,1,0,1,0
57123,445,0,0,70,70,0,1,0,1,0
61012,445,0,0,70,70,0,1,0,1,0
49684,445,0,0,66,66,0,1,0,1,0
58572,445,0,0,66,66,0,1,0,1,0
59440,445,0,0,70,70,0,1,0,1,0
51014,445,0,0,66,66,0,1,0,1,0
58117,445,0,0,66,66,0,1,0,1,0
64152,445,0,0,70,70,0,1,0,1,0
62903,445,0,0,70,70,0,1,0,1,0
51095,445,0,0,70,70,0,1,0,1,0
49348,445,0,0,70,70,0,1,0,1,0
56912,445,0,0,70,70,0,1,0,1,0
52881,445,0,0,70,70,0,1,0,1,0
51503,445,0,0,66,66,0,1,0,1,0
52578,445,0,0,70,70,0,1,0,1,0
59763,445,0,0,70,70,0,1,0,1,0
55099,445,0,0,70,70,0,1,0,1,0
55300,445,0,0,70,70,0,1,0,1,0
51431,445,0,0,70,70,0,1,0,1,0
52139,445,0,0,70,70,0,1,0,1,0
58151,445,0,0,70,70,0,1,0,1,0
57419,445,0,0,70,70,0,1,0,1,0
61037,445,0,0,66,66,0,1,0,1,0
59847,445,0,0,70,70,0,1,0,1,0
60946,445,0,0,70,70,0,1,0,1,0
49868,445,0,0,70,70,0,1,0,1,0
50888,445,0,0,70,70,0,1,0,1,0
51440,445,0,0,66,66,0,1,0,1,0
63326,445,0,0,70,70,0,1,0,1,0
53229,445,0,0,70,70,0,1,0,1,0
51103,445,0,0,70,70,0,1,0,1,0
50340,445,0,0,70,70,0,1,0,1,0
60982,445,0,0,70,70,0,1,0,1,0
58048,445,0,0,70,70,0,1,0,1,0
53685,445,0,0,70,70,0,1,0,1,0
53677,445,0,0,66,66,0,1,0,1,0
50337,445,0,0,66,66,0,1,0,1,0
57878,445,0,0,70,70,0,1,0,1,0
63457,445,0,0,66,66,0,1,0,1,0
52164,445,0,0,70,70,0,1,0,1,0
60578,445,0,0,70,70,0,1,0,1,0
60232,445,0,0,70,70,0,1,0,1,0
63777,445,0,0,66,66,0,1,0,1,0
62423,445,0,0,66,66,0,1,0,1,0
50810,445,0,0,70,70,0,1,0,1,0
50271,445,0,0,70,70,0,1,0,1,0
60891,445,0,0,70,70,0,1,0,1,0
62132,445,0,0,66,66,0,1,0,1,0
52634,445,0,0,70,70,0,1,0,1,0
64034,445,0,0,66,66,0,1,0,1,0
62877,445,0,0,66,66,0,1,0,1,0
59780,445,0,0,70,70,0,1,0,1,0
49976,445,0,0,70,70,0,1,0,1,0
50146,445,0,0,70,70,0,1,0,1,0
60164,445,0,0,70,70,0,1,0,1,0
49747,445,0,0,70,70,0,1,0,1,0
52754,445,0,0,70,70,0,1,0,1,0
60815,445,0,0,70,70,0,1,0,1,0
57050,445,0,0,70,70,0,1,0,1,0
62150,445,0,0,70,70,0,1,0,1,0
63488,445,0,0,66,66,0,1,0,1,0
50270,445,0,0,70,70,0,1,0,1,0
50633,445,0,0,70,70,0,1,0,1,0
50782,445,0,0,66,66,0,1,0,1,0
55099,445,0,0,70,70,0,1,0,1,0
50800,445,0,0,70,70,0,1,0,1,0
64883,445,0,0,70,70,0,1,0,1,0
64965,445,0,0,66,66,0,1,0,1,0
52176,445,0,0,70,70,0,1,0,1,0
50768,445,0,0,70,70,0,1,0,1,0
50406,445,0,0,70,70,0,1,0,1,0
56640,445,0,0,70,70,0,1,0,1,0
56747,445,0,0,70,70,0,1,0,1,0
56686,445,0,0,70,70,0,1,0,1,0
63535,445,0,0,70,70,0,1,0,1,0
63590,445,0,0,66,66,0,1,0,1,0
55024,445,0,0,70,70,0,1,0,1,0
51576,445,0,0,66,66,0,1,0,1,0
61210,445,0,0,70,70,0,1,0,1,0
59907,445,0,0,70,70,0,1,0,1,0
49446,445,0,0,70,70,0,1,0,1,0
64323,445,0,0,70,70,0,1,0,1,0
57039,445,0,0,70,70,0,1,0,1,0
54916,445,0,0,70,70,0,1,0,1,0
64005,445,0,0,66,66,0,1,0,1,0
63186,445,0,0,66,66,0,1,0,1,0
59487,445,0,0,66,66,0,1,0,1,0
56029,445,0,0,70,70,0,1,0,1,0
53856,445,0,0,70,70,0,1,0,1,0
56013,445,0,0,70,70,0,1,0,1,0
50769,445,0,0,70,70,0,1,0,1,0
65330,445,0,0,70,70,0,1,0,1,0
54941,445,0,0,70,70,0,1,0,1,0
64862,445,0,0,70,70,0,1,0,1,0
63903,445,0,0,66,66,0,1,0,1,0
55940,445,0,0,66,66,0,1,0,1,0
53749,445,0,0,66,66,0,1,0,1,0
64032,445,0,0,70,70,0,1,0,1,0
63182,445,0,0,70,70,0,1,0,1,0
61702,445,0,0,70,70,0,1,0,1,0
58315,445,0,0,66,66,0,1,0,1,0
59018,445,0,0,66,66,0,1,0,1,0
57731,445,0,0,66,66,0,1,0,1,0
52650,445,0,0,70,70,0,1,0,1,0
62075,445,0,0,70,70,0,1,0,1,0
49777,445,0,0,66,66,0,1,0,1,0
59014,445,0,0,66,66,0,1,0,1,0
62194,445,0,0,70,70,0,1,0,1,0
52131,445,0,0,70,70,0,1,0,1,0
53543,445,0,0,70,70,0,1,0,1,0
50538,445,0,0,66,66,0,1,0,1,0
59061,445,0,0,70,70,0,1,0,1,0
55741,445,0,0,70,70,0,1,0,1,0
61126,445,0,0,70,70,0,1,0,1,0
53600,445,0,0,70,70,0,1,0,1,0
55571,445,0,0,70,70,0,1,0,1,0
65066,445,0,0,66,66,0,1,0,1,0
49568,445,0,0,66,66,0,1,0,1,0
58436,445,0,0,66,66,0,1,0,1,0
58795,445,0,0,70,70,0,1,0,1,0
50094,445,0,0,70,70,0,1,0,1,0
58087,445,0,0,70,70,0,1,0,1,0
64312,445,0,0,66,66,0,1,0,1,0
58691,445,0,0,70,70,0,1,0,1,0
55130,445,0,0,70,70,0,1,0,1,0
53178,445,0,0,70,70,0,1,0,1,0
56416,445,0,0,70,70,0,1,0,1,0
57082,445,0,0,70,70,0,1,0,1,0
58314,445,0,0,70,70,0,1,0,1,0
65336,445,0,0,70,70,0,1,0,1,0
50159,445,0,0,70,70,0,1,0,1,0
63551,445,0,0,70,70,0,1,0,1,0
55101,445,0,0,70,70,0,1,0,1,0
64312,445,0,0,70,70,0,1,0,1,0
56450,445,0,0,70,70,0,1,0,1,0
58779,445,0,0,70,70,0,1,0,1,0
63006,445,0,0,70,70,0,1,0,1,0
62639,445,0,0,70,70,0,1,0,1,0
50759,445,0,0,66,66,0,1,0,1,0
53682,445,0,0,66,66,0,1,0,1,0
53901,445,0,0,70,70,0,1,0,1,0
58815,445,0,0,70,70,0,1,0,1,0
60909,445,0,0,70,70,0,1,0,1,0
57092,445,0,0,70,70,0,1,0,1,0
65058,445,0,0,70,70,0,1,0,1,0
51327,445,0,0,70,70,0,1,0,1,0
59724,445,0,0,70,70,0,1,0,1,0
57090,445,0,0,66,66,0,1,0,1,0
49749,445,0,0,70,70,0,1,0,1,0
55114,445,0,0,70,70,0,1,0,1,0
60746,445,0,0,66,66,0,1,0,1,0
60954,445,0,0,66,66,0,1,0,1,0
60821,445,0,0,66,66,0,1,0,1,0
52534,445,0,0,66,66,0,1,0,1,0
54155,445,0,0,66,66,0,1,0,1,0
61319,445,0,0,66,66,0,1,0,1,0
54201,445,0,0,70,70,0,1,0,1,0
62059,445,0,0,70,70,0,1,0,1,0
55258,445,0,0,70,70,0,1,0,1,0
51283,445,0,0,70,70,0,1,0,1,0
61717,445,0,0,66,66,0,1,0,1,0
50436,445,0,0,66,66,0,1,0,1,0
52559,445,0,0,70,70,0,1,0,1,0
53722,445,0,0,70,70,0,1,0,1,0
63940,445,0,0,70,70,0,1,0,1,0
51588,445,0,0,70,70,0,1,0,1,0
60787,445,0,0,70,70,0,1,0,1,0
63068,445,0,0,70,70,0,1,0,1,0
52346,445,0,0,66,66,0,1,0,1,0
50784,445,0,0,70,70,0,1,0,1,0
50700,445,0,0,70,70,0,1,0,1,0
55308,445,0,0,70,70,0,1,0,1,0
54355,445,0,0,66,66,0,1,0,1,0
54232,445,0,0,70,70,0,1,0,1,0
63943,445,0,0,70,70,0,1,0,1,0
64488,445,0,0,66,66,0,1,0,1,0
53557,445,0,0,70,70,0,1,0,1,0
62922,445,0,0,66,66,0,1,0,1,0
53245,445,0,0,70,70,0,1,0,1,0
61238,445,0,0,70,70,0,1,0,1,0
52605,445,0,0,70,70,0,1,0,1,0
64292,445,0,0,66,66,0,1,0,1,0
61346,445,0,0,70,70,0,1,0,1,0
57776,445,0,0,70,70,0,1,0,1,0
50288,445,0,0,70,70,0,1,0,1,0
57271,445,0,0,66,66,0,1,0,1,0
55403,445,0,0,70,70,0,1,0,1,0
50607,445,0,0,66,66,0,1,0,1,0
59288,445,0,0,70,70,0,1,0,1,0
64929,445,0,0,70,70,0,1,0,1,0
54490,445,0,0,70,70,0,1,0,1,0
61518,445,0,0,66,66,0,1,0,1,0
62451,445,0,0,70,70,0,1,0,1,0
50007,445,0,0,66,66,0,1,0,1,0
55430,445,0,0,70,70,0,1,0,1,0
59140,445,0,0,66,66,0,1,0,1,0
56285,445,0,0,70,70,0,1,0,1,0
64264,445,0,0,70,70,0,1,0,1,0
53654,445,0,0,70,70,0,1,0,1,0
54948,445,0,0,70,70,0,1,0,1,0
50050,445,0,0,70,70,0,1,0,1,0
61671,445,0,0,70,70,0,1,0,1,0
57606,445,0,0,66,66,0,1,0,1,0
51416,445,0,0,70,70,0,1,0,1,0
62796,445,0,0,70,70,0,1,0,1,0
58568,445,0,0,66,66,0,1,0,1,0
57235,445,0,0,70,70,0,1,0,1,0
50321,445,0,0,70,70,0,1,0,1,0
49726,445,0,0,70,70,0,1,0,1,0
51034,445,0,0,70,70,0,1,0,1,0
57700,445,0,0,70,70,0,1,0,1,0
62741,445,0,0,66,66,0,1,0,1,0
49579,445,0,0,70,70,0,1,0,1,0
51543,445,0,0,70,70,0,1,0,1,0
50319,445,0,0,70,70,0,1,0,1,0
63928,445,0,0,70,70,0,1,0,1,0
49940,445,0,0,66,66,0,1,0,1,0
60715,445,0,0,70,70,0,1,0,1,0
62297,445,0,0,66,66,0,1,0,1,0
62870,445,0,0,70,70,0,1,0,1,0
64288,445,0,0,66,66,0,1,0,1,0
50923,445,0,0,66,66,0,1,0,1,0
53962,445,0,0,70,70,0,1,0,1,0
54128,445,0,0,70,70,0,1,0,1,0
59788,445,0,0,66,66,0,1,0,1,0
54136,445,0,0,66,66,0,1,0,1,0
55502,445,0,0,70,70,0,1,0,1,0
64674,445,0,0,70,70,0,1,0,1,0
50639,445,0,0,66,66,0,1,0,1,0
52946,445,0,0,70,70,0,1,0,1,0
61247,445,0,0,70,70,0,1,0,1,0
61574,445,0,0,70,70,0,1,0,1,0
54146,445,0,0,70,70,0,1,0,1,0
52740,445,0,0,70,70,0,1,0,1,0
52818,445,0,0,70,70,0,1,0,1,0
56383,445,0,0,66,66,0,1,0,1,0
53912,445,0,0,70,70,0,1,0,1,0
64519,445,0,0,66,66,0,1,0,1,0
62173,445,0,0,70,70,0,1,0,1,0
62212,445,0,0,70,70,0,1,0,1,0
61866,445,0,0,67,67,0,1,0,1,0
54570,445,0,0,70,70,0,1,0,1,0
50422,445,0,0,70,70,0,1,0,1,0
58869,445,0,0,68,68,0,1,0,1,0
61126,445,0,0,70,70,0,1,0,1,0
62995,445,0,0,70,70,0,1,0,1,0
63524,445,0,0,68,68,0,1,0,1,0
62133,445,0,0,66,66,0,1,0,1,0
60822,445,0,0,66,66,0,1,0,1,0
51960,445,0,0,67,67,0,1,0,1,0
56704,445,0,0,66,66,0,1,0,1,0
52660,445,0,0,66,66,0,1,0,1,0
59405,445,0,0,70,70,0,1,0,1,0
64189,445,0,0,70,70,0,1,0,1,0
52651,445,0,0,70,70,0,1,0,1,0
57673,445,0,0,70,70,0,1,0,1,0
61979,445,0,0,70,70,0,1,0,1,0
55967,445,0,0,70,70,0,1,0,1,0
57510,445,0,0,70,70,0,1,0,1,0
50956,445,0,0,69,69,0,1,0,1,0
49211,445,0,0,70,70,0,1,0,1,0
58651,445,0,0,70,70,0,1,0,1,0
49884,445,0,0,70,70,0,1,0,1,0
51616,445,0,0,70,70,0,1,0,1,0
49858,445,0,0,70,70,0,1,0,1,0
57928,445,0,0,68,68,0,1,0,1,0
50609,445,0,0,70,70,0,1,0,1,0
63957,445,0,0,70,70,0,1,0,1,0
61842,445,0,0,70,70,0,1,0,1,0
53293,445,0,0,66,66,0,1,0,1,0
59759,445,0,0,68,68,0,1,0,1,0
61974,445,0,0,66,66,0,1,0,1,0
53106,445,0,0,70,70,0,1,0,1,0
60280,445,0,0,69,69,0,1,0,1,0
53910,445,0,0,67,67,0,1,0,1,0
63030,445,0,0,66,66,0,1,0,1,0
56819,445,0,0,66,66,0,1,0,1,0
60158,445,0,0,67,67,0,1,0,1,0
61766,445,0,0,70,70,0,1,0,1,0
61333,445,0,0,67,67,0,1,0,1,0
54797,445,0,0,70,70,0,1,0,1,0
58093,445,0,0,70,70,0,1,0,1,0
57230,445,0,0,70,70,0,1,0,1,0
55109,445,0,0,66,66,0,1,0,1,0
51642,445,0,0,66,66,0,1,0,1,0
63798,445,0,0,68,68,0,1,0,1,0
50501,445,0,0,70,70,0,1,0,1,0
60631,445,0,0,70,70,0,1,0,1,0
51122,445,0,0,66,66,0,1,0,1,0
62670,445,0,0,70,70,0,1,0,1,0
50928,445,0,0,66,66,0,1,0,1,0
50652,445,0,0,69,69,0,1,0,1,0
64436,445,0,0,70,70,0,1,0,1,0
61898,445,0,0,68,68,0,1,0,1,0
63955,445,0,0,68,68,0,1,0,1,0
53427,445,0,0,70,70,0,1,0,1,0
50734,445,0,0,66,66,0,1,0,1,0
54518,445,0,0,70,70,0,1,0,1,0
50673,445,0,0,66,66,0,1,0,1,0
53833,445,0,0,70,70,0,1,0,1,0
50778,445,0,0,70,70,0,1,0,1,0
56773,445,0,0,70,70,0,1,0,1,0
63471,445,0,0,70,70,0,1,0,1,0
55885,445,0,0,68,68,0,1,0,1,0
52053,445,0,0,70,70,0,1,0,1,0
60596,445,0,0,70,70,0,1,0,1,0
53095,445,0,0,67,67,0,1,0,1,0
57930,445,0,0,70,70,0,1,0,1,0
49773,445,0,0,69,69,0,1,0,1,0
65194,445,0,0,66,66,0,1,0,1,0
60954,445,0,0,66,66,0,1,0,1,0
60691,445,0,0,66,66,0,1,0,1,0
52309,445,0,0,70,70,0,1,0,1,0
61573,445,0,0,70,70,0,1,0,1,0
60680,445,0,0,70,70,0,1,0,1,0
55694,445,0,0,70,70,0,1,0,1,0
64045,445,0,0,70,70,0,1,0,1,0
65505,445,0,0,70,70,0,1,0,1,0
63561,445,0,0,70,70,0,1,0,1,0
62105,445,0,0,70,70,0,1,0,1,0
61783,445,0,0,70,70,0,1,0,1,0
59986,445,0,0,66,66,0,1,0,1,0
62993,445,0,0,70,70,0,1,0,1,0
55703,445,0,0,70,70,0,1,0,1,0
64612,445,0,0,66,66,0,1,0,1,0
50671,445,0,0,66,66,0,1,0,1,0
61598,445,0,0,70,70,0,1,0,1,0
60670,445,0,0,70,70,0,1,0,1,0
49364,445,0,0,70,70,0,1,0,1,0
53865,445,0,0,69,69,0,1,0,1,0
63359,445,0,0,70,70,0,1,0,1,0
65130,445,0,0,69,69,0,1,0,1,0
55419,445,0,0,66,66,0,1,0,1,0
51420,445,0,0,67,67,0,1,0,1,0
65359,445,0,0,66,66,0,1,0,1,0
55172,445,0,0,70,70,0,1,0,1,0
62920,445,0,0,70,70,0,1,0,1,0
60822,445,0,0,66,66,0,1,0,1,0
51439,445,0,0,66,66,0,1,0,1,0
63405,445,0,0,66,66,0,1,0,1,0
56745,445,0,0,66,66,0,1,0,1,0
52497,445,0,0,70,70,0,1,0,1,0
62619,445,0,0,67,67,0,1,0,1,0
61689,445,0,0,70,70,0,1,0,1,0
56836,445,0,0,66,66,0,1,0,1,0
52732,445,0,0,69,69,0,1,0,1,0
49753,445,0,0,70,70,0,1,0,1,0
63447,445,0,0,70,70,0,1,0,1,0
55540,445,0,0,70,70,0,1,0,1,0
63813,445,0,0,70,70,0,1,0,1,0
62869,445,0,0,69,69,0,1,0,1,0
60400,445,0,0,70,70,0,1,0,1,0
57730,445,0,0,66,66,0,1,0,1,0
52420,445,0,0,70,70,0,1,0,1,0
62412,445,0,0,67,67,0,1,0,1,0
55291,445,0,0,68,68,0,1,0,1,0
50266,445,0,0,70,70,0,1,0,1,0
54651,445,0,0,70,70,0,1,0,1,0
62273,445,0,0,70,70,0,1,0,1,0
65070,445,0,0,70,70,0,1,0,1,0
52328,445,0,0,67,67,0,1,0,1,0
64311,445,0,0,70,70,0,1,0,1,0
53304,445,0,0,68,68,0,1,0,1,0
55478,445,0,0,68,68,0,1,0,1,0
54538,445,0,0,70,70,0,1,0,1,0
49577,445,0,0,70,70,0,1,0,1,0
64585,445,0,0,70,70,0,1,0,1,0
58243,445,0,0,66,66,0,1,0,1,0
63298,445,0,0,70,70,0,1,0,1,0
54632,445,0,0,66,66,0,1,0,1,0
57002,445,0,0,70,70,0,1,0,1,0
56393,445,0,0,70,70,0,1,0,1,0
56831,445,0,0,70,70,0,1,0,1,0
51978,445,0,0,70,70,0,1,0,1,0
59225,445,0,0,69,69,0,1,0,1,0
52406,445,0,0,66,66,0,1,0,1,0
50622,445,0,0,66,66,0,1,0,1,0
60118,445,0,0,70,70,0,1,0,1,0
62725,445,0,0,67,67,0,1,0,1,0
52326,445,0,0,66,66,0,1,0,1,0
51651,445,0,0,67,67,0,1,0,1,0
54363,445,0,0,70,70,0,1,0,1,0
49926,445,0,0,70,70,0,1,0,1,0
49971,445,0,0,66,66,0,1,0,1,0
52339,445,0,0,67,67,0,1,0,1,0
54364,445,0,0,70,70,0,1,0,1,0
49926,445,0,0,66,66,0,1,0,1,0
60563,445,0,0,66,66,0,1,0,1,0
54797,445,0,0,70,70,0,1,0,1,0
59018,445,0,0,70,70,0,1,0,1,0
49466,445,0,0,70,70,0,1,0,1,0
62075,445,0,0,70,70,0,1,0,1,0
60743,445,0,0,66,66,0,1,0,1,0
62298,445,0,0,70,70,0,1,0,1,0
49812,445,0,0,70,70,0,1,0,1,0
55316,445,0,0,66,66,0,1,0,1,0
49373,445,0,0,70,70,0,1,0,1,0
56586,445,0,0,70,70,0,1,0,1,0
64321,445,0,0,66,66,0,1,0,1,0
63919,445,0,0,70,70,0,1,0,1,0
56542,445,0,0,70,70,0,1,0,1,0
64052,445,0,0,70,70,0,1,0,1,0
59228,445,0,0,70,70,0,1,0,1,0
65219,445,0,0,70,70,0,1,0,1,0
57904,445,0,0,70,70,0,1,0,1,0
49380,445,0,0,66,66,0,1,0,1,0
50052,445,0,0,70,70,0,1,0,1,0
50558,445,0,0,70,70,0,1,0,1,0
65228,445,0,0,70,70,0,1,0,1,0
58706,445,0,0,68,68,0,1,0,1,0
61930,445,0,0,66,66,0,1,0,1,0
55463,445,0,0,70,70,0,1,0,1,0
50200,445,0,0,70,70,0,1,0,1,0
65503,445,0,0,68,68,0,1,0,1,0
50415,445,0,0,66,66,0,1,0,1,0
57090,445,0,0,66,66,0,1,0,1,0
60517,445,0,0,70,70,0,1,0,1,0
49684,445,0,0,67,67,0,1,0,1,0
61607,445,0,0,70,70,0,1,0,1,0
52742,445,0,0,68,68,0,1,0,1,0
58959,445,0,0,66,66,0,1,0,1,0
61200,445,0,0,70,70,0,1,0,1,0
63309,445,0,0,66,66,0,1,0,1,0
50126,445,0,0,70,70,0,1,0,1,0
62214,445,0,0,66,66,0,1,0,1,0
61584,445,0,0,70,70,0,1,0,1,0
50623,445,0,0,70,70,0,1,0,1,0
64120,445,0,0,70,70,0,1,0,1,0
65182,445,0,0,70,70,0,1,0,1,0
51290,445,0,0,70,70,0,1,0,1,0
58048,445,0,0,70,70,0,1,0,1,0
58729,445,0,0,70,70,0,1,0,1,0
61235,445,0,0,66,66,0,1,0,1,0
61476,445,0,0,67,67,0,1,0,1,0
62391,445,0,0,70,70,0,1,0,1,0
55999,445,0,0,70,70,0,1,0,1,0
56518,445,0,0,70,70,0,1,0,1,0
54013,445,0,0,69,69,0,1,0,1,0
52381,445,0,0,67,67,0,1,0,1,0
53947,445,0,0,66,66,0,1,0,1,0
52790,445,0,0,70,70,0,1,0,1,0
59982,445,0,0,70,70,0,1,0,1,0
65498,445,0,0,69,69,0,1,0,1,0
58629,445,0,0,66,66,0,1,0,1,0
64795,445,0,0,70,70,0,1,0,1,0
58330,445,0,0,70,70,0,1,0,1,0
52521,445,0,0,70,70,0,1,0,1,0
54404,445,0,0,70,70,0,1,0,1,0
57924,445,0,0,66,66,0,1,0,1,0
58190,445,0,0,70,70,0,1,0,1,0
58712,445,0,0,66,66,0,1,0,1,0
49751,445,0,0,67,67,0,1,0,1,0
54092,445,0,0,66,66,0,1,0,1,0
58970,445,0,0,69,69,0,1,0,1,0
64210,445,0,0,70,70,0,1,0,1,0
53874,445,0,0,70,70,0,1,0,1,0
53540,445,0,0,70,70,0,1,0,1,0
54962,445,0,0,69,69,0,1,0,1,0
55549,445,0,0,66,66,0,1,0,1,0
60838,445,0,0,70,70,0,1,0,1,0
55590,445,0,0,70,70,0,1,0,1,0
52067,445,0,0,70,70,0,1,0,1,0
50560,445,0,0,70,70,0,1,0,1,0
61867,445,0,0,70,70,0,1,0,1,0
58217,445,0,0,70,70,0,1,0,1,0
55349,445,0,0,66,66,0,1,0,1,0
50944,445,0,0,70,70,0,1,0,1,0
62459,445,0,0,70,70,0,1,0,1,0
58704,445,0,0,70,70,0,1,0,1,0
59579,445,0,0,67,67,0,1,0,1,0
62026,445,0,0,66,66,0,1,0,1,0
53685,445,0,0,66,66,0,1,0,1,0
61210,445,0,0,66,66,0,1,0,1,0
51234,445,0,0,70,70,0,1,0,1,0
59392,445,0,0,70,70,0,1,0,1,0
51055,445,0,0,66,66,0,1,0,1,0
64730,445,0,0,69,69,0,1,0,1,0
49907,445,0,0,70,70,0,1,0,1,0
58041,445,0,0,66,66,0,1,0,1,0
49342,445,0,0,70,70,0,1,0,1,0
59947,445,0,0,70,70,0,1,0,1,0
53123,445,0,0,70,70,0,1,0,1,0
61063,445,0,0,66,66,0,1,0,1,0
62372,445,0,0,70,70,0,1,0,1,0
55131,445,0,0,70,70,0,1,0,1,0
53292,445,0,0,68,68,0,1,0,1,0
56065,445,0,0,66,66,0,1,0,1,0
49964,445,0,0,70,70,0,1,0,1,0
62895,445,0,0,70,70,0,1,0,1,0
52118,445,0,0,69,69,0,1,0,1,0
51721,445,0,0,66,66,0,1,0,1,0
49643,445,0,0,70,70,0,1,0,1,0
63002,445,0,0,70,70,0,1,0,1,0
50159,445,0,0,70,70,0,1,0,1,0
65292,445,0,0,70,70,0,1,0,1,0
50326,445,0,0,69,69,0,1,0,1,0
61551,445,0,0,70,70,0,1,0,1,0
51909,445,0,0,66,66,0,1,0,1,0
61400,445,0,0,70,70,0,1,0,1,0
60630,445,0,0,66,66,0,1,0,1,0
53044,445,0,0,70,70,0,1,0,1,0
63014,445,0,0,70,70,0,1,0,1,0
60968,445,0,0,67,67,0,1,0,1,0
53025,445,0,0,70,70,0,1,0,1,0
62783,445,0,0,70,70,0,1,0,1,0
53594,445,0,0,70,70,0,1,0,1,0
58252,445,0,0,70,70,0,1,0,1,0
59257,445,0,0,67,67,0,1,0,1,0
52142,445,0,0,70,70,0,1,0,1,0
62048,445,0,0,69,69,0,1,0,1,0
58118,445,0,0,66,66,0,1,0,1,0
65068,445,0,0,70,70,0,1,0,1,0
55469,445,0,0,67,67,0,1,0,1,0
57413,445,0,0,70,70,0,1,0,1,0
64876,445,0,0,66,66,0,1,0,1,0
64299,445,0,0,69,69,0,1,0,1,0
65183,445,0,0,70,70,0,1,0,1,0
50049,445,0,0,70,70,0,1,0,1,0
50433,445,0,0,68,68,0,1,0,1,0
57016,445,0,0,66,66,0,1,0,1,0
60915,445,0,0,70,70,0,1,0,1,0
51084,445,0,0,70,70,0,1,0,1,0
56979,445,0,0,69,69,0,1,0,1,0
64475,445,0,0,66,66,0,1,0,1,0
65002,445,0,0,69,69,0,1,0,1,0
49887,445,0,0,70,70,0,1,0,1,0
50285,445,0,0,66,66,0,1,0,1,0
55839,445,0,0,70,70,0,1,0,1,0
50248,445,0,0,70,70,0,1,0,1,0
62709,445,0,0,70,70,0,1,0,1,0
63984,445,0,0,66,66,0,1,0,1,0
51621,445,0,0,70,70,0,1,0,1,0
64165,445,0,0,70,70,0,1,0,1,0
59206,445,0,0,68,68,0,1,0,1,0
60710,445,0,0,70,70,0,1,0,1,0
53210,445,0,0,70,70,0,1,0,1,0
51001,445,0,0,70,70,0,1,0,1,0
64836,445,0,0,70,70,0,1,0,1,0
64459,445,0,0,70,70,0,1,0,1,0
59250,445,0,0,68,68,0,1,0,1,0
62315,445,0,0,70,70,0,1,0,1,0
50979,445,0,0,70,70,0,1,0,1,0
51205,445,0,0,70,70,0,1,0,1,0
61089,445,0,0,70,70,0,1,0,1,0
53368,445,0,0,66,66,0,1,0,1,0
60912,445,0,0,70,70,0,1,0,1,0
63581,445,0,0,67,67,0,1,0,1,0
52371,445,0,0,69,69,0,1,0,1,0
63358,445,0,0,70,70,0,1,0,1,0
49266,445,0,0,70,70,0,1,0,1,0
50292,445,0,0,70,70,0,1,0,1,0
54490,445,0,0,70,70,0,1,0,1,0
61772,445,0,0,66,66,0,1,0,1,0
49893,445,0,0,70,70,0,1,0,1,0
55302,445,0,0,70,70,0,1,0,1,0
55290,445,0,0,70,70,0,1,0,1,0
59914,445,0,0,66,66,0,1,0,1,0
55212,445,0,0,70,70,0,1,0,1,0
58540,445,0,0,70,70,0,1,0,1,0
58754,445,0,0,66,66,0,1,0,1,0
63333,445,0,0,70,70,0,1,0,1,0
59467,445,0,0,68,68,0,1,0,1,0
50956,445,0,0,70,70,0,1,0,1,0
57604,445,0,0,66,66,0,1,0,1,0
51736,445,0,0,70,70,0,1,0,1,0
58704,445,0,0,70,70,0,1,0,1,0
56014,445,0,0,70,70,0,1,0,1,0
59986,445,0,0,66,66,0,1,0,1,0
50976,445,0,0,66,66,0,1,0,1,0
59077,445,0,0,70,70,0,1,0,1,0
50123,445,0,0,70,70,0,1,0,1,0
56765,445,0,0,70,70,0,1,0,1,0
52115,445,0,0,70,70,0,1,0,1,0
61053,445,0,0,70,70,0,1,0,1,0
55991,445,0,0,66,66,0,1,0,1,0
50497,445,0,0,70,70,0,1,0,1,0
52602,445,0,0,69,69,0,1,0,1,0
50417,445,0,0,66,66,0,1,0,1,0
62060,445,0,0,70,70,0,1,0,1,0
58318,445,0,0,70,70,0,1,0,1,0
49776,445,0,0,66,66,0,1,0,1,0
53669,445,0,0,70,70,0,1,0,1,0
53819,445,0,0,70,70,0,1,0,1,0
56652,445,0,0,68,68,0,1,0,1,0
51083,445,0,0,70,70,0,1,0,1,0
57131,445,0,0,69,69,0,1,0,1,0
49265,445,0,0,70,70,0,1,0,1,0
55370,445,0,0,67,67,0,1,0,1,0
53992,445,0,0,69,69,0,1,0,1,0
63518,445,0,0,67,67,0,1,0,1,0
64798,445,0,0,70,70,0,1,0,1,0
56838,445,0,0,66,66,0,1,0,1,0
50867,445,0,0,70,70,0,1,0,1,0
58986,445,0,0,66,66,0,1,0,1,0
58066,445,0,0,67,67,0,1,0,1,0
52138,445,0,0,70,70,0,1,0,1,0
61399,445,0,0,70,70,0,1,0,1,0
62980,445,0,0,70,70,0,1,0,1,0
50142,445,0,0,70,70,0,1,0,1,0
56698,445,0,0,70,70,0,1,0,1,0
53211,445,0,0,70,70,0,1,0,1,0
63774,445,0,0,66,66,0,1,0,1,0
62466,445,0,0,70,70,0,1,0,1,0
55083,445,0,0,68,68,0,1,0,1,0
62015,445,0,0,70,70,0,1,0,1,0
53673,445,0,0,70,70,0,1,0,1,0
56533,445,0,0,70,70,0,1,0,1,0
64644,445,0,0,70,70,0,1,0,1,0
56617,445,0,0,70,70,0,1,0,1,0
50274,445,0,0,70,70,0,1,0,1,0
51023,445,0,0,70,70,0,1,0,1,0
55290,445,0,0,66,66,0,1,0,1,0
64364,445,0,0,66,66,0,1,0,1,0
63886,445,0,0,68,68,0,1,0,1,0
58973,445,0,0,70,70,0,1,0,1,0
64838,445,0,0,70,70,0,1,0,1,0
55319,445,0,0,70,70,0,1,0,1,0
62105,445,0,0,70,70,0,1,0,1,0
51398,445,0,0,70,70,0,1,0,1,0
57091,445,0,0,70,70,0,1,0,1,0
52450,445,0,0,70,70,0,1,0,1,0
50750,445,0,0,70,70,0,1,0,1,0
59122,445,0,0,70,70,0,1,0,1,0
53011,445,0,0,67,67,0,1,0,1,0
54392,445,0,0,66,66,0,1,0,1,0
64124,445,0,0,70,70,0,1,0,1,0
50797,445,0,0,66,66,0,1,0,1,0
56990,445,0,0,66,66,0,1,0,1,0
62251,445,0,0,70,70,0,1,0,1,0
55592,445,0,0,70,70,0,1,0,1,0
58565,445,0,0,70,70,0,1,0,1,0
52501,445,0,0,70,70,0,1,0,1,0
51499,445,0,0,70,70,0,1,0,1,0
64900,445,0,0,70,70,0,1,0,1,0
53222,445,0,0,67,67,0,1,0,1,0
49645,445,0,0,67,67,0,1,0,1,0
49969,445,0,0,70,70,0,1,0,1,0
56137,445,0,0,66,66,0,1,0,1,0
49663,445,0,0,67,67,0,1,0,1,0
63427,445,0,0,70,70,0,1,0,1,0
52084,445,0,0,66,66,0,1,0,1,0
53929,445,0,0,70,70,0,1,0,1,0
51601,445,0,0,66,66,0,1,0,1,0
62651,445,0,0,68,68,0,1,0,1,0
49212,445,0,0,70,70,0,1,0,1,0
58058,445,0,0,70,70,0,1,0,1,0
55395,445,0,0,70,70,0,1,0,1,0
53725,445,0,0,70,70,0,1,0,1,0
52534,445,0,0,66,66,0,1,0,1,0
50100,445,0,0,68,68,0,1,0,1,0
56149,445,0,0,66,66,0,1,0,1,0
64324,445,0,0,70,70,0,1,0,1,0
53814,445,0,0,70,70,0,1,0,1,0
57910,445,0,0,67,67,0,1,0,1,0
59861,445,0,0,66,66,0,1,0,1,0
64457,445,0,0,70,70,0,1,0,1,0
57731,445,0,0,66,66,0,1,0,1,0
56723,445,0,0,70,70,0,1,0,1,0
55415,445,0,0,66,66,0,1,0,1,0
54253,445,0,0,70,70,0,1,0,1,0
64487,445,0,0,66,66,0,1,0,1,0
52520,445,0,0,70,70,0,1,0,1,0
59359,445,0,0,70,70,0,1,0,1,0
64279,445,0,0,70,70,0,1,0,1,0
63073,445,0,0,70,70,0,1,0,1,0
64044,445,0,0,70,70,0,1,0,1,0
62692,445,0,0,68,68,0,1,0,1,0
53505,445,0,0,70,70,0,1,0,1,0
56872,445,0,0,70,70,0,1,0,1,0
52582,445,0,0,66,66,0,1,0,1,0
57523,445,0,0,70,70,0,1,0,1,0
55613,445,0,0,67,67,0,1,0,1,0
50542,445,0,0,66,66,0,1,0,1,0
60804,445,0,0,70,70,0,1,0,1,0
65529,445,0,0,67,67,0,1,0,1,0
55357,445,0,0,70,70,0,1,0,1,0
54587,445,0,0,69,69,0,1,0,1,0
57160,445,0,0,70,70,0,1,0,1,0
53941,445,0,0,66,66,0,1,0,1,0
59335,445,0,0,66,66,0,1,0,1,0
65230,445,0,0,70,70,0,1,0,1,0
51187,445,0,0,66,66,0,1,0,1,0
55020,445,0,0,70,70,0,1,0,1,0
57857,445,0,0,69,69,0,1,0,1,0
51241,445,0,0,66,66,0,1,0,1,0
55302,445,0,0,70,70,0,1,0,1,0
49335,445,0,0,68,68,0,1,0,1,0
62296,445,0,0,70,70,0,1,0,1,0
50870,445,0,0,70,70,0,1,0,1,0
49524,445,0,0,70,70,0,1,0,1,0
65201,445,0,0,70,70,0,1,0,1,0
51104,445,0,0,66,66,0,1,0,1,0
51936,445,0,0,70,70,0,1,0,1,0
49390,445,0,0,70,70,0,1,0,1,0
51173,445,0,0,70,70,0,1,0,1,0
62636,445,0,0,70,70,0,1,0,1,0
61182,445,0,0,70,70,0,1,0,1,0
51038,445,0,0,70,70,0,1,0,1,0
54273,445,0,0,70,70,0,1,0,1,0
56765,445,0,0,70,70,0,1,0,1,0
64404,445,0,0,69,69,0,1,0,1,0
62371,445,0,0,68,68,0,1,0,1,0
56640,445,0,0,70,70,0,1,0,1,0
53459,445,0,0,70,70,0,1,0,1,0
54331,445,0,0,70,70,0,1,0,1,0
57855,445,0,0,70,70,0,1,0,1,0
56639,445,0,0,70,70,0,1,0,1,0
58912,445,0,0,70,70,0,1,0,1,0
57885,445,0,0,68,68,0,1,0,1,0
54909,445,0,0,68,68,0,1,0,1,0
64502,445,0,0,70,70,0,1,0,1,0
56124,445,0,0,66,66,0,1,0,1,0
53123,445,0,0,66,66,0,1,0,1,0
57015,445,0,0,66,66,0,1,0,1,0
60095,445,0,0,70,70,0,1,0,1,0
65478,445,0,0,66,66,0,1,0,1,0
55247,445,0,0,70,70,0,1,0,1,0
61698,445,0,0,69,69,0,1,0,1,0
53665,445,0,0,70,70,0,1,0,1,0
53526,445,0,0,69,69,0,1,0,1,0
64824,445,0,0,68,68,0,1,0,1,0
52206,445,0,0,70,70,0,1,0,1,0
65326,445,0,0,66,66,0,1,0,1,0
53176,445,0,0,68,68,0,1,0,1,0
55549,445,0,0,66,66,0,1,0,1,0
62251,445,0,0,69,69,0,1,0,1,0
55386,445,0,0,70,70,0,1,0,1,0
62358,445,0,0,68,68,0,1,0,1,0
63110,445,0,0,68,68,0,1,0,1,0
64294,445,0,0,66,66,0,1,0,1,0
59607,445,0,0,70,70,0,1,0,1,0
50925,445,0,0,66,66,0,1,0,1,0
62085,445,0,0,70,70,0,1,0,1,0
62929,445,0,0,70,70,0,1,0,1,0
51946,445,0,0,70,70,0,1,0,1,0
61333,445,0,0,66,66,0,1,0,1,0
60944,445,0,0,70,70,0,1,0,1,0
54006,445,0,0,66,66,0,1,0,1,0
53422,445,0,0,68,68,0,1,0,1,0
59044,445,0,0,70,70,0,1,0,1,0
61513,445,0,0,70,70,0,1,0,1,0
63558,445,0,0,70,70,0,1,0,1,0
56062,445,0,0,70,70,0,1,0,1,0
53959,445,0,0,70,70,0,1,0,1,0
52930,445,0,0,70,70,0,1,0,1,0
50311,445,0,0,66,66,0,1,0,1,0
56882,445,0,0,70,70,0,1,0,1,0
57353,445,0,0,66,66,0,1,0,1,0
50621,445,0,0,70,70,0,1,0,1,0
55852,445,0,0,70,70,0,1,0,1,0
50521,445,0,0,70,70,0,1,0,1,0
54872,445,0,0,70,70,0,1,0,1,0
52086,445,0,0,70,70,0,1,0,1,0
54430,445,0,0,69,69,0,1,0,1,0
55742,445,0,0,70,70,0,1,0,1,0
62559,445,0,0,70,70,0,1,0,1,0
53801,445,0,0,70,70,0,1,0,1,0
61849,445,0,0,66,66,0,1,0,1,0
49834,445,0,0,70,70,0,1,0,1,0
54464,445,0,0,67,67,0,1,0,1,0
54440,445,0,0,69,69,0,1,0,1,0
50525,445,0,0,68,68,0,1,0,1,0
58713,445,0,0,70,70,0,1,0,1,0
53688,445,0,0,66,66,0,1,0,1,0
61083,445,0,0,66,66,0,1,0,1,0
61280,445,0,0,66,66,0,1,0,1,0
49813,445,0,0,70,70,0,1,0,1,0
55355,445,0,0,70,70,0,1,0,1,0
63556,445,0,0,70,70,0,1,0,1,0
59502,445,0,0,70,70,0,1,0,1,0
61377,445,0,0,70,70,0,1,0,1,0
49200,445,0,0,66,66,0,1,0,1,0
50289,445,0,0,66,66,0,1,0,1,0
50354,445,0,0,70,70,0,1,0,1,0
57748,445,0,0,70,70,0,1,0,1,0
64263,445,0,0,70,70,0,1,0,1,0
63172,445,0,0,68,68,0,1,0,1,0
50735,445,0,0,66,66,0,1,0,1,0
61016,445,0,0,70,70,0,1,0,1,0
53367,445,0,0,66,66,0,1,0,1,0
61514,445,0,0,69,69,0,1,0,1,0
59040,445,0,0,70,70,0,1,0,1,0
59091,445,0,0,67,67,0,1,0,1,0
58884,445,0,0,66,66,0,1,0,1,0
55114,445,0,0,70,70,0,1,0,1,0
65028,445,0,0,70,70,0,1,0,1,0
57669,445,0,0,70,70,0,1,0,1,0
51755,445,0,0,70,70,0,1,0,1,0
56618,445,0,0,70,70,0,1,0,1,0
59395,445,0,0,70,70,0,1,0,1,0
57355,445,0,0,68,68,0,1,0,1,0
53994,445,0,0,70,70,0,1,0,1,0
57861,445,0,0,66,66,0,1,0,1,0
57932,445,0,0,66,66,0,1,0,1,0
50622,445,0,0,70,70,0,1,0,1,0
57415,445,0,0,70,70,0,1,0,1,0
50268,445,0,0,66,66,0,1,0,1,0
58445,445,0,0,70,70,0,1,0,1,0
55253,445,0,0,70,70,0,1,0,1,0
55568,445,0,0,70,70,0,1,0,1,0
50659,445,0,0,66,66,0,1,0,1,0
64412,445,0,0,70,70,0,1,0,1,0
57427,445,0,0,70,70,0,1,0,1,0
61604,445,0,0,70,70,0,1,0,1,0
54559,445,0,0,66,66,0,1,0,1,0
58271,445,0,0,67,67,0,1,0,1,0
62187,445,0,0,70,70,0,1,0,1,0
53818,445,0,0,66,66,0,1,0,1,0
54911,445,0,0,70,70,0,1,0,1,0
61512,445,0,0,69,69,0,1,0,1,0
52789,445,0,0,70,70,0,1,0,1,0
65483,445,0,0,70,70,0,1,0,1,0
51507,445,0,0,68,68,0,1,0,1,0
64480,445,0,0,70,70,0,1,0,1,0
58629,445,0,0,70,70,0,1,0,1,0
64739,445,0,0,70,70,0,1,0,1,0
54127,445,0,0,70,70,0,1,0,1,0
61465,445,0,0,66,66,0,1,0,1,0
54294,445,0,0,70,70,0,1,0,1,0
55674,445,0,0,67,67,0,1,0,1,0
63814,445,0,0,70,70,0,1,0,1,0
51622,445,0,0,68,68,0,1,0,1,0
63963,445,0,0,69,69,0,1,0,1,0
52499,445,0,0,68,68,0,1,0,1,0
60994,445,0,0,70,70,0,1,0,1,0
52730,445,0,0,66,66,0,1,0,1,0
53723,445,0,0,70,70,0,1,0,1,0
62177,445,0,0,70,70,0,1,0,1,0
57005,445,0,0,70,70,0,1,0,1,0
56114,445,0,0,66,66,0,1,0,1,0
58248,445,0,0,69,69,0,1,0,1,0
59155,445,0,0,66,66,0,1,0,1,0
55707,445,0,0,70,70,0,1,0,1,0
55599,445,0,0,66,66,0,1,0,1,0
62649,445,0,0,66,66,0,1,0,1,0
62160,445,0,0,70,70,0,1,0,1,0
55414,445,0,0,70,70,0,1,0,1,0
58533,445,0,0,70,70,0,1,0,1,0
57413,445,0,0,70,70,0,1,0,1,0
63546,445,0,0,70,70,0,1,0,1,0
61465,445,0,0,69,69,0,1,0,1,0
54817,445,0,0,66,66,0,1,0,1,0
50691,445,0,0,68,68,0,1,0,1,0
53779,445,0,0,67,67,0,1,0,1,0
53985,445,0,0,70,70,0,1,0,1,0
56839,445,0,0,66,66,0,1,0,1,0
57650,445,0,0,70,70,0,1,0,1,0
54041,445,0,0,70,70,0,1,0,1,0
53864,445,0,0,67,67,0,1,0,1,0
61388,445,0,0,66,66,0,1,0,1,0
52340,445,0,0,66,66,0,1,0,1,0
59452,445,0,0,66,66,0,1,0,1,0
61467,445,0,0,66,66,0,1,0,1,0
55210,445,0,0,66,66,0,1,0,1,0
58901,445,0,0,70,70,0,1,0,1,0
50195,445,0,0,70,70,0,1,0,1,0
55816,445,0,0,68,68,0,1,0,1,0
59089,445,0,0,69,69,0,1,0,1,0
56835,445,0,0,66,66,0,1,0,1,0
59894,445,0,0,70,70,0,1,0,1,0
51120,445,0,0,66,66,0,1,0,1,0
51675,445,0,0,70,70,0,1,0,1,0
58646,445,0,0,70,70,0,1,0,1,0
59770,445,0,0,66,66,0,1,0,1,0
52293,445,0,0,67,67,0,1,0,1,0
56754,445,0,0,68,68,0,1,0,1,0
58671,445,0,0,70,70,0,1,0,1,0
58629,445,0,0,66,66,0,1,0,1,0
49642,445,0,0,70,70,0,1,0,1,0
58229,445,0,0,66,66,0,1,0,1,0
53792,445,0,0,70,70,0,1,0,1,0
57236,445,0,0,70,70,0,1,0,1,0
52483,445,0,0,70,70,0,1,0,1,0
60805,445,0,0,67,67,0,1,0,1,0
55290,445,0,0,70,70,0,1,0,1,0
49867,445,0,0,70,70,0,1,0,1,0
57828,445,0,0,70,70,0,1,0,1,0
51000,445,0,0,70,70,0,1,0,1,0
51355,445,0,0,70,70,0,1,0,1,0
56421,445,0,0,70,70,0,1,0,1,0
64018,445,0,0,66,66,0,1,0,1,0
51124,445,0,0,67,67,0,1,0,1,0
51923,445,0,0,70,70,0,1,0,1,0
51834,445,0,0,66,66,0,1,0,1,0
53234,445,0,0,70,70,0,1,0,1,0
58992,445,0,0,70,70,0,1,0,1,0
49744,445,0,0,67,67,0,1,0,1,0
50682,445,0,0,70,70,0,1,0,1,0
52397,445,0,0,70,70,0,1,0,1,0
51102,445,0,0,66,66,0,1,0,1,0
61190,445,0,0,66,66,0,1,0,1,0
59086,445,0,0,66,66,0,1,0,1,0
59197,445,0,0,66,66,0,1,0,1,0
61591,445,0,0,70,70,0,1,0,1,0
52014,445,0,0,70,70,0,1,0,1,0
53191,445,0,0,69,69,0,1,0,1,0
63526,445,0,0,70,70,0,1,0,1,0
51420,445,0,0,69,69,0,1,0,1,0
64734,445,0,0,70,70,0,1,0,1,0
49427,445,0,0,70,70,0,1,0,1,0
55888,445,0,0,68,68,0,1,0,1,0
59378,445,0,0,70,70,0,1,0,1,0
57396,445,0,0,66,66,0,1,0,1,0
57090,445,0,0,66,66,0,1,0,1,0
57943,445,0,0,70,70,0,1,0,1,0
51309,445,0,0,66,66,0,1,0,1,0
55069,445,0,0,70,70,0,1,0,1,0
49581,445,0,0,70,70,0,1,0,1,0
54931,445,0,0,70,70,0,1,0,1,0
52583,445,0,0,66,66,0,1,0,1,0
52715,445,0,0,70,70,0,1,0,1,0
58549,445,0,0,68,68,0,1,0,1,0
59142,445,0,0,70,70,0,1,0,1,0
62681,445,0,0,70,70,0,1,0,1,0
61724,445,0,0,66,66,0,1,0,1,0
59013,445,0,0,66,66,0,1,0,1,0
59968,445,0,0,66,66,0,1,0,1,0
55497,445,0,0,66,66,0,1,0,1,0
62420,445,0,0,70,70,0,1,0,1,0
64596,445,0,0,70,70,0,1,0,1,0
62376,445,0,0,70,70,0,1,0,1,0
60692,445,0,0,66,66,0,1,0,1,0
49301,445,0,0,70,70,0,1,0,1,0
54976,445,0,0,70,70,0,1,0,1,0
63917,445,0,0,70,70,0,1,0,1,0
55143,445,0,0,70,70,0,1,0,1,0
64405,445,0,0,67,67,0,1,0,1,0
59126,445,0,0,66,66,0,1,0,1,0
55967,445,0,0,70,70,0,1,0,1,0
63387,445,0,0,66,66,0,1,0,1,0
56669,445,0,0,70,70,0,1,0,1,0
58182,445,0,0,67,67,0,1,0,1,0
50723,445,0,0,66,66,0,1,0,1,0
64157,445,0,0,70,70,0,1,0,1,0
54970,445,0,0,70,70,0,1,0,1,0
50466,445,0,0,66,66,0,1,0,1,0
55931,445,0,0,66,66,0,1,0,1,0
61929,445,0,0,70,70,0,1,0,1,0
61591,445,0,0,68,68,0,1,0,1,0
59500,445,0,0,70,70,0,1,0,1,0
59077,445,0,0,66,66,0,1,0,1,0
53320,445,0,0,66,66,0,1,0,1,0
50556,445,0,0,70,70,0,1,0,1,0
64276,445,0,0,66,66,0,1,0,1,0
53401,445,0,0,66,66,0,1,0,1,0
52629,445,0,0,70,70,0,1,0,1,0
61986,445,0,0,70,70,0,1,0,1,0
54731,445,0,0,66,66,0,1,0,1,0
51071,445,0,0,70,70,0,1,0,1,0
50794,445,0,0,66,66,0,1,0,1,0
50122,445,0,0,70,70,0,1,0,1,0
50482,445,0,0,66,66,0,1,0,1,0
60948,445,0,0,70,70,0,1,0,1,0
51811,445,0,0,70,70,0,1,0,1,0
63100,445,0,0,70,70,0,1,0,1,0
52220,445,0,0,70,70,0,1,0,1,0
56939,445,0,0,70,70,0,1,0,1,0
57930,445,0,0,70,70,0,1,0,1,0
51158,445,0,0,70,70,0,1,0,1,0
53691,445,0,0,70,70,0,1,0,1,0
61590,445,0,0,70,70,0,1,0,1,0
65416,445,0,0,70,70,0,1,0,1,0
52072,445,0,0,67,67,0,1,0,1,0
57465,445,0,0,69,69,0,1,0,1,0
57927,445,0,0,70,70,0,1,0,1,0
54713,445,0,0,66,66,0,1,0,1,0
57156,445,0,0,68,68,0,1,0,1,0
51706,445,0,0,67,67,0,1,0,1,0
56552,445,0,0,70,70,0,1,0,1,0
49878,445,0,0,66,66,0,1,0,1,0
55515,445,0,0,70,70,0,1,0,1,0
54406,445,0,0,70,70,0,1,0,1,0
61271,445,0,0,67,67,0,1,0,1,0
64887,445,0,0,70,70,0,1,0,1,0
55769,445,0,0,66,66,0,1,0,1,0
49244,445,0,0,68,68,0,1,0,1,0
51037,445,0,0,70,70,0,1,0,1,0
50398,445,0,0,69,69,0,1,0,1,0
58714,445,0,0,69,69,0,1,0,1,0
57075,445,0,0,66,66,0,1,0,1,0
54369,445,0,0,70,70,0,1,0,1,0
60805,445,0,0,67,67,0,1,0,1,0
49782,445,0,0,70,70,0,1,0,1,0
54902,445,0,0,69,69,0,1,0,1,0
52416,445,0,0,67,67,0,1,0,1,0
53987,445,0,0,70,70,0,1,0,1,0
54260,445,0,0,67,67,0,1,0,1,0
50797,445,0,0,66,66,0,1,0,1,0
52981,445,0,0,66,66,0,1,0,1,0
63040,445,0,0,70,70,0,1,0,1,0
51349,445,0,0,70,70,0,1,0,1,0
63147,445,0,0,66,66,0,1,0,1,0
63774,445,0,0,66,66,0,1,0,1,0
53122,445,0,0,70,70,0,1,0,1,0
55856,445,0,0,66,66,0,1,0,1,0
53741,445,0,0,70,70,0,1,0,1,0
62552,445,0,0,66,66,0,1,0,1,0
65448,445,0,0,66,66,0,1,0,1,0
63200,445,0,0,66,66,0,1,0,1,0
57161,445,0,0,70,70,0,1,0,1,0
52129,445,0,0,70,70,0,1,0,1,0
50008,445,0,0,70,70,0,1,0,1,0
51370,445,0,0,69,69,0,1,0,1,0
53247,445,0,0,70,70,0,1,0,1,0
49967,445,0,0,70,70,0,1,0,1,0
63731,445,0,0,70,70,0,1,0,1,0
63322,445,0,0,68,68,0,1,0,1,0
63207,445,0,0,66,66,0,1,0,1,0
62298,445,0,0,68,68,0,1,0,1,0
58568,445,0,0,67,67,0,1,0,1,0
57414,445,0,0,70,70,0,1,0,1,0
51946,445,0,0,70,70,0,1,0,1,0
50796,445,0,0,70,70,0,1,0,1,0
63407,445,0,0,67,67,0,1,0,1,0
60405,445,0,0,69,69,0,1,0,1,0
63416,445,0,0,66,66,0,1,0,1,0
57412,445,0,0,70,70,0,1,0,1,0
56047,445,0,0,69,69,0,1,0,1,0
61063,445,0,0,66,66,0,1,0,1,0
60340,445,0,0,68,68,0,1,0,1,0
51232,445,0,0,66,66,0,1,0,1,0
56128,445,0,0,66,66,0,1,0,1,0
52088,445,0,0,66,66,0,1,0,1,0
63110,445,0,0,66,66,0,1,0,1,0
64392,445,0,0,66,66,0,1,0,1,0
54033,445,0,0,67,67,0,1,0,1,0
61235,445,0,0,70,70,0,1,0,1,0
54493,445,0,0,70,70,0,1,0,1,0
54207,445,0,0,67,67,0,1,0,1,0
63072,445,0,0,67,67,0,1,0,1,0
57926,445,0,0,67,67,0,1,0,1,0
52729,445,0,0,66,66,0,1,0,1,0
56897,445,0,0,66,66,0,1,0,1,0
65524,445,0,0,70,70,0,1,0,1,0
64540,445,0,0,70,70,0,1,0,1,0
50272,445,0,0,70,70,0,1,0,1,0
50182,445,0,0,69,69,0,1,0,1,0
54011,445,0,0,66,66,0,1,0,1,0
62383,445,0,0,70,70,0,1,0,1,0
50274,445,0,0,67,67,0,1,0,1,0
59604,445,0,0,70,70,0,1,0,1,0
59819,445,0,0,68,68,0,1,0,1,0
54090,445,0,0,68,68,0,1,0,1,0
53037,445,0,0,66,66,0,1,0,1,0
59673,445,0,0,67,67,0,1,0,1,0
55936,445,0,0,66,66,0,1,0,1,0
51884,445,0,0,70,70,0,1,0,1,0
49353,445,0,0,67,67,0,1,0,1,0
54774,445,0,0,66,66,0,1,0,1,0
51858,445,0,0,66,66,0,1,0,1,0
59733,445,0,0,70,70,0,1,0,1,0
64794,445,0,0,70,70,0,1,0,1,0
57156,445,0,0,66,66,0,1,0,1,0
52347,445,0,0,66,66,0,1,0,1,0
64273,445,0,0,67,67,0,1,0,1,0
49624,445,0,0,70,70,0,1,0,1,0
57383,445,0,0,68,68,0,1,0,1,0
62128,445,0,0,70,70,0,1,0,1,0
62401,445,0,0,70,70,0,1,0,1,0
56608,445,0,0,70,70,0,1,0,1,0
50864,445,0,0,66,66,0,1,0,1,0
56617,445,0,0,70,70,0,1,0,1,0
55571,445,0,0,70,70,0,1,0,1,0
50132,445,0,0,70,70,0,1,0,1,0
54679,445,0,0,70,70,0,1,0,1,0
53911,445,0,0,66,66,0,1,0,1,0
50163,445,0,0,70,70,0,1,0,1,0
65440,445,0,0,69,69,0,1,0,1,0
59400,445,0,0,66,66,0,1,0,1,0
49996,445,0,0,70,70,0,1,0,1,0
54755,445,0,0,70,70,0,1,0,1,0
55135,445,0,0,70,70,0,1,0,1,0
58691,445,0,0,69,69,0,1,0,1,0
63900,445,0,0,70,70,0,1,0,1,0
55558,445,0,0,70,70,0,1,0,1,0
59703,445,0,0,70,70,0,1,0,1,0
50765,445,0,0,70,70,0,1,0,1,0
54013,445,0,0,69,69,0,1,0,1,0
61902,445,0,0,70,70,0,1,0,1,0
57677,445,0,0,70,70,0,1,0,1,0
49447,445,0,0,70,70,0,1,0,1,0
52436,445,0,0,70,70,0,1,0,1,0
63774,445,0,0,70,70,0,1,0,1,0
63100,445,0,0,70,70,0,1,0,1,0
55357,445,0,0,66,66,0,1,0,1,0
55504,445,0,0,66,66,0,1,0,1,0
53317,445,0,0,66,66,0,1,0,1,0
50595,445,0,0,66,66,0,1,0,1,0
50478,445,0,0,66,66,0,1,0,1,0
57015,445,0,0,66,66,0,1,0,1,0
63450,445,0,0,66,66,0,1,0,1,0
58477,445,0,0,70,70,0,1,0,1,0
52275,445,0,0,66,66,0,1,0,1,0
49290,445,0,0,70,70,0,1,0,1,0
50837,445,0,0,67,67,0,1,0,1,0
57398,445,0,0,68,68,0,1,0,1,0
51678,445,0,0,70,70,0,1,0,1,0
59146,445,0,0,66,66,0,1,0,1,0
61886,445,0,0,70,70,0,1,0,1,0
62391,445,0,0,68,68,0,1,0,1,0
60979,445,0,0,66,66,0,1,0,1,0
49853,445,0,0,70,70,0,1,0,1,0
50290,445,0,0,66,66,0,1,0,1,0
61409,445,0,0,66,66,0,1,0,1,0
53293,445,0,0,70,70,0,1,0,1,0
57217,445,0,0,68,68,0,1,0,1,0
55709,445,0,0,70,70,0,1,0,1,0
52711,445,0,0,67,67,0,1,0,1,0
54197,445,0,0,70,70,0,1,0,1,0
49250,445,0,0,67,67,0,1,0,1,0
57958,445,0,0,70,70,0,1,0,1,0
53027,445,0,0,70,70,0,1,0,1,0
52115,445,0,0,67,67,0,1,0,1,0
62669,445,0,0,70,70,0,1,0,1,0
49324,445,0,0,70,70,0,1,0,1,0
60614,445,0,0,70,70,0,1,0,1,0
63887,445,0,0,70,70,0,1,0,1,0
56468,445,0,0,70,70,0,1,0,1,0
54391,445,0,0,66,66,0,1,0,1,0
50273,445,0,0,66,66,0,1,0,1,0
54373,445,0,0,67,67,0,1,0,1,0
62232,445,0,0,70,70,0,1,0,1,0
60083,445,0,0,69,69,0,1,0,1,0
65015,445,0,0,68,68,0,1,0,1,0
61960,445,0,0,66,66,0,1,0,1,0
63478,445,0,0,70,70,0,1,0,1,0
52049,445,0,0,70,70,0,1,0,1,0
51566,445,0,0,70,70,0,1,0,1,0
53508,445,0,0,70,70,0,1,0,1,0
53428,445,0,0,67,67,0,1,0,1,0
60044,445,0,0,70,70,0,1,0,1,0
59016,445,0,0,70,70,0,1,0,1,0
62121,445,0,0,70,70,0,1,0,1,0
63465,445,0,0,70,70,0,1,0,1,0
51082,445,0,0,69,69,0,1,0,1,0
62787,445,0,0,70,70,0,1,0,1,0
51340,445,0,0,70,70,0,1,0,1,0
54375,445,0,0,66,66,0,1,0,1,0
56164,445,0,0,70,70,0,1,0,1,0
52882,445,0,0,70,70,0,1,0,1,0
63084,445,0,0,68,68,0,1,0,1,0
64282,445,0,0,70,70,0,1,0,1,0
50740,445,0,0,66,66,0,1,0,1,0
57646,445,0,0,70,70,0,1,0,1,0
57839,445,0,0,69,69,0,1,0,1,0
57943,445,0,0,70,70,0,1,0,1,0
54997,445,0,0,70,70,0,1,0,1,0
54714,445,0,0,66,66,0,1,0,1,0
56583,445,0,0,70,70,0,1,0,1,0
61403,445,0,0,70,70,0,1,0,1,0
64538,445,0,0,70,70,0,1,0,1,0
57000,445,0,0,70,70,0,1,0,1,0
63340,445,0,0,67,67,0,1,0,1,0
62245,445,0,0,70,70,0,1,0,1,0
52240,445,0,0,70,70,0,1,0,1,0
55546,445,0,0,70,70,0,1,0,1,0
63333,445,0,0,70,70,0,1,0,1,0
53598,445,0,0,70,70,0,1,0,1,0
60506,445,0,0,66,66,0,1,0,1,0
49702,445,0,0,70,70,0,1,0,1,0
59506,445,0,0,70,70,0,1,0,1,0
62430,445,0,0,70,70,0,1,0,1,0
56481,445,0,0,66,66,0,1,0,1,0
57709,445,0,0,70,70,0,1,0,1,0
51549,445,0,0,70,70,0,1,0,1,0
54563,445,0,0,70,70,0,1,0,1,0
54174,445,0,0,68,68,0,1,0,1,0
61751,445,0,0,70,70,0,1,0,1,0
58115,445,0,0,70,70,0,1,0,1,0
56718,445,0,0,70,70,0,1,0,1,0
63193,445,0,0,70,70,0,1,0,1,0
65516,445,0,0,70,70,0,1,0,1,0
54948,445,0,0,70,70,0,1,0,1,0
57096,445,0,0,66,66,0,1,0,1,0
60376,445,0,0,70,70,0,1,0,1,0
52633,445,0,0,70,70,0,1,0,1,0
53246,445,0,0,70,70,0,1,0,1,0
49555,445,0,0,70,70,0,1,0,1,0
58554,445,0,0,70,70,0,1,0,1,0
55875,445,0,0,70,70,0,1,0,1,0
56773,445,0,0,70,70,0,1,0,1,0
58792,445,0,0,67,67,0,1,0,1,0
63759,445,0,0,70,70,0,1,0,1,0
64448,445,0,0,66,66,0,1,0,1,0
53799,445,0,0,70,70,0,1,0,1,0
58549,445,0,0,70,70,0,1,0,1,0
64669,445,0,0,70,70,0,1,0,1,0
54526,445,0,0,69,69,0,1,0,1,0
64392,445,0,0,70,70,0,1,0,1,0
62215,445,0,0,66,66,0,1,0,1,0
52199,445,0,0,66,66,0,1,0,1,0
63801,445,0,0,66,66,0,1,0,1,0
60287,445,0,0,70,70,0,1,0,1,0
60631,445,0,0,66,66,0,1,0,1,0
52789,445,0,0,66,66,0,1,0,1,0
51387,445,0,0,70,70,0,1,0,1,0
58153,445,0,0,70,70,0,1,0,1,0
59761,445,0,0,70,70,0,1,0,1,0
63499,445,0,0,66,66,0,1,0,1,0
63902,445,0,0,70,70,0,1,0,1,0
50140,445,0,0,70,70,0,1,0,1,0
60787,445,0,0,70,70,0,1,0,1,0
60631,445,0,0,68,68,0,1,0,1,0
63683,445,0,0,70,70,0,1,0,1,0
51120,445,0,0,66,66,0,1,0,1,0
64765,445,0,0,70,70,0,1,0,1,0
55734,445,0,0,68,68,0,1,0,1,0
52532,445,0,0,66,66,0,1,0,1,0
63156,445,0,0,66,66,0,1,0,1,0
57160,445,0,0,70,70,0,1,0,1,0
57527,445,0,0,67,67,0,1,0,1,0
61982,445,0,0,70,70,0,1,0,1,0
53688,445,0,0,69,69,0,1,0,1,0
52919,445,0,0,66,66,0,1,0,1,0
63488,445,0,0,68,68,0,1,0,1,0
53886,445,0,0,70,70,0,1,0,1,0
53990,445,0,0,70,70,0,1,0,1,0
53442,445,0,0,70,70,0,1,0,1,0
51588,445,0,0,70,70,0,1,0,1,0
63466,445,0,0,70,70,0,1,0,1,0
56066,445,0,0,66,66,0,1,0,1,0
52007,445,0,0,66,66,0,1,0,1,0
53930,445,0,0,67,67,0,1,0,1,0
61887,445,0,0,70,70,0,1,0,1,0
51324,445,0,0,70,70,0,1,0,1,0
52265,445,0,0,70,70,0,1,0,1,0
58505,445,0,0,70,70,0,1,0,1,0
55939,445,0,0,66,66,0,1,0,1,0
61031,445,0,0,70,70,0,1,0,1,0
58232,445,0,0,69,69,0,1,0,1,0
63196,445,0,0,70,70,0,1,0,1,0
49378,445,0,0,66,66,0,1,0,1,0
61981,445,0,0,68,68,0,1,0,1,0
51597,445,0,0,70,70,0,1,0,1,0
53558,445,0,0,68,68,0,1,0,1,0
53642,445,0,0,70,70,0,1,0,1,0
62037,445,0,0,66,66,0,1,0,1,0
59791,445,0,0,70,70,0,1,0,1,0
61400,445,0,0,66,66,0,1,0,1,0
51568,445,0,0,70,70,0,1,0,1,0
50307,445,0,0,66,66,0,1,0,1,0
64567,445,0,0,70,70,0,1,0,1,0
62933,445,0,0,70,70,0,1,0,1,0
50913,445,0,0,66,66,0,1,0,1,0
55203,445,0,0,70,70,0,1,0,1,0
51912,445,0,0,68,68,0,1,0,1,0
59597,445,0,0,70,70,0,1,0,1,0
55338,445,0,0,67,67,0,1,0,1,0
50336,445,0,0,66,66,0,1,0,1,0
59019,445,0,0,66,66,0,1,0,1,0
54649,445,0,0,66,66,0,1,0,1,0
55597,445,0,0,70,70,0,1,0,1,0
54720,445,0,0,70,70,0,1,0,1,0
59987,445,0,0,70,70,0,1,0,1,0
50293,445,0,0,70,70,0,1,0,1,0
61494,445,0,0,70,70,0,1,0,1,0
52069,445,0,0,66,66,0,1,0,1,0
50149,445,0,0,67,67,0,1,0,1,0
57798,445,0,0,68,68,0,1,0,1,0
63984,445,0,0,70,70,0,1,0,1,0
57503,445,0,0,66,66,0,1,0,1,0
53597,445,0,0,70,70,0,1,0,1,0
53818,445,0,0,70,70,0,1,0,1,0
63498,445,0,0,67,67,0,1,0,1,0
58970,445,0,0,68,68,0,1,0,1,0
64103,445,0,0,70,70,0,1,0,1,0
65111,445,0,0,70,70,0,1,0,1,0
60097,445,0,0,70,70,0,1,0,1,0
49426,445,0,0,70,70,0,1,0,1,0
56905,445,0,0,67,67,0,1,0,1,0
56745,445,0,0,67,67,0,1,0,1,0
58474,445,0,0,68,68,0,1,0,1,0
53035,445,0,0,66,66,0,1,0,1,0
50779,445,0,0,70,70,0,1,0,1,0
57929,445,0,0,70,70,0,1,0,1,0
60506,445,0,0,66,66,0,1,0,1,0
57293,445,0,0,70,70,0,1,0,1,0
58842,445,0,0,68,68,0,1,0,1,0
56197,445,0,0,69,69,0,1,0,1,0
50538,445,0,0,66,66,0,1,0,1,0
60238,445,0,0,66,66,0,1,0,1,0
49659,445,0,0,70,70,0,1,0,1,0
53550,445,0,0,66,66,0,1,0,1,0
61800,445,0,0,67,67,0,1,0,1,0
60355,445,0,0,67,67,0,1,0,1,0
59474,445,0,0,66,66,0,1,0,1,0
51698,445,0,0,66,66,0,1,0,1,0
50149,445,0,0,69,69,0,1,0,1,0
61804,445,0,0,70,70,0,1,0,1,0
64289,445,0,0,66,66,0,1,0,1,0
53531,445,0,0,70,70,0,1,0,1,0
62829,445,0,0,66,66,0,1,0,1,0
59576,445,0,0,70,70,0,1,0,1,0
53385,445,0,0,68,68,0,1,0,1,0
63873,445,0,0,70,70,0,1,0,1,0
57732,445,0,0,66,66,0,1,0,1,0
55883,445,0,0,69,69,0,1,0,1,0
63856,445,0,0,70,70,0,1,0,1,0
61170,445,0,0,70,70,0,1,0,1,0
55596,445,0,0,70,70,0,1,0,1,0
52015,445,0,0,70,70,0,1,0,1,0
63924,445,0,0,69,69,0,1,0,1,0
57793,445,0,0,70,70,0,1,0,1,0
57327,445,0,0,70,70,0,1,0,1,0
54631,445,0,0,66,66,0,1,0,1,0
61592,445,0,0,70,70,0,1,0,1,0
55910,445,0,0,70,70,0,1,0,1,0
61949,445,0,0,67,67,0,1,0,1,0
53931,445,0,0,70,70,0,1,0,1,0
57106,445,0,0,70,70,0,1,0,1,0
51203,445,0,0,70,70,0,1,0,1,0
58259,445,0,0,66,66,0,1,0,1,0
64631,445,0,0,67,67,0,1,0,1,0
64017,445,0,0,68,68,0,1,0,1,0
59041,445,0,0,70,70,0,1,0,1,0
51064,445,0,0,66,66,0,1,0,1,0
65071,445,0,0,70,70,0,1,0,1,0
55782,445,0,0,70,70,0,1,0,1,0
62784,445,0,0,70,70,0,1,0,1,0
64226,445,0,0,66,66,0,1,0,1,0
54640,445,0,0,70,70,0,1,0,1,0
53290,445,0,0,68,68,0,1,0,1,0
55659,445,0,0,70,70,0,1,0,1,0
59737,445,0,0,69,69,0,1,0,1,0
60977,445,0,0,70,70,0,1,0,1,0
57097,445,0,0,68,68,0,1,0,1,0
57218,445,0,0,66,66,0,1,0,1,0
59210,445,0,0,66,66,0,1,0,1,0
59465,445,0,0,69,69,0,1,0,1,0
64011,445,0,0,68,68,0,1,0,1,0
56218,445,0,0,70,70,0,1,0,1,0
51829,445,0,0,66,66,0,1,0,1,0
54028,445,0,0,70,70,0,1,0,1,0
62811,445,0,0,70,70,0,1,0,1,0
50606,445,0,0,66,66,0,1,0,1,0
50977,445,0,0,66,66,0,1,0,1,0
53480,445,0,0,68,68,0,1,0,1,0
65077,445,0,0,70,70,0,1,0,1,0
63876,445,0,0,70,70,0,1,0,1,0
61740,445,0,0,67,67,0,1,0,1,0
50525,445,0,0,70,70,0,1,0,1,0
50878,445,0,0,70,70,0,1,0,1,0
51635,445,0,0,66,66,0,1,0,1,0
56908,445,0,0,70,70,0,1,0,1,0
60361,445,0,0,70,70,0,1,0,1,0
55053,445,0,0,69,69,0,1,0,1,0
57330,445,0,0,66,66,0,1,0,1,0
54433,445,0,0,69,69,0,1,0,1,0
57415,445,0,0,69,69,0,1,0,1,0
59398,445,0,0,70,70,0,1,0,1,0
63825,445,0,0,66,66,0,1,0,1,0
59823,445,0,0,70,70,0,1,0,1,0
65463,445,0,0,70,70,0,1,0,1,0
61196,445,0,0,69,69,0,1,0,1,0
61030,445,0,0,66,66,0,1,0,1,0
63971,445,0,0,66,66,0,1,0,1,0
61350,445,0,0,67,67,0,1,0,1,0
55180,445,0,0,70,70,0,1,0,1,0
53716,445,0,0,70,70,0,1,0,1,0
55455,445,0,0,67,67,0,1,0,1,0
61016,445,0,0,70,70,0,1,0,1,0
57357,445,0,0,69,69,0,1,0,1,0
59570,445,0,0,70,70,0,1,0,1,0
59635,445,0,0,70,70,0,1,0,1,0
59714,445,0,0,66,66,0,1,0,1,0
62548,445,0,0,70,70,0,1,0,1,0
55340,445,0,0,70,70,0,1,0,1,0
56235,445,0,0,70,70,0,1,0,1,0
52022,445,0,0,68,68,0,1,0,1,0
56810,445,0,0,70,70,0,1,0,1,0
54782,445,0,0,69,69,0,1,0,1,0
55207,445,0,0,70,70,0,1,0,1,0
58076,445,0,0,67,67,0,1,0,1,0
52849,445,0,0,70,70,0,1,0,1,0
64991,445,0,0,66,66,0,1,0,1,0
50351,445,0,0,66,66,0,1,0,1,0
49781,445,0,0,70,70,0,1,0,1,0
55615,445,0,0,66,66,0,1,0,1,0
53624,445,0,0,66,66,0,1,0,1,0
62703,445,0,0,70,70,0,1,0,1,0
58815,445,0,0,68,68,0,1,0,1,0
56536,445,0,0,70,70,0,1,0,1,0
59012,445,0,0,70,70,0,1,0,1,0
61186,445,0,0,70,70,0,1,0,1,0
49998,445,0,0,70,70,0,1,0,1,0
65479,445,0,0,67,67,0,1,0,1,0
49807,445,0,0,70,70,0,1,0,1,0
64035,445,0,0,66,66,0,1,0,1,0
54432,445,0,0,68,68,0,1,0,1,0
60305,445,0,0,67,67,0,1,0,1,0
50683,445,0,0,70,70,0,1,0,1,0
56654,445,0,0,70,70,0,1,0,1,0
65002,445,0,0,69,69,0,1,0,1,0
51305,445,0,0,70,70,0,1,0,1,0
60928,445,0,0,68,68,0,1,0,1,0
50821,445,0,0,69,69,0,1,0,1,0
60631,445,0,0,69,69,0,1,0,1,0
57360,445,0,0,66,66,0,1,0,1,0
63490,445,0,0,68,68,0,1,0,1,0
51540,445,0,0,70,70,0,1,0,1,0
51584,445,0,0,70,70,0,1,0,1,0
57398,445,0,0,69,69,0,1,0,1,0
64540,445,0,0,70,70,0,1,0,1,0
57357,445,0,0,70,70,0,1,0,1,0
65327,445,0,0,70,70,0,1,0,1,0
55806,445,0,0,66,66,0,1,0,1,0
58913,445,0,0,67,67,0,1,0,1,0
60604,445,0,0,70,70,0,1,0,1,0
63033,445,0,0,70,70,0,1,0,1,0
55567,445,0,0,70,70,0,1,0,1,0
55212,445,0,0,70,70,0,1,0,1,0
54568,445,0,0,70,70,0,1,0,1,0
59987,445,0,0,66,66,0,1,0,1,0
62126,445,0,0,70,70,0,1,0,1,0
63390,445,0,0,66,66,0,1,0,1,0
49193,445,0,0,70,70,0,1,0,1,0
52534,445,0,0,70,70,0,1,0,1,0
65168,445,0,0,68,68,0,1,0,1,0
64584,445,0,0,67,67,0,1,0,1,0
63678,445,0,0,70,70,0,1,0,1,0
53686,445,0,0,66,66,0,1,0,1,0
55360,445,0,0,70,70,0,1,0,1,0
64005,445,0,0,70,70,0,1,0,1,0
53324,445,0,0,66,66,0,1,0,1,0
55627,445,0,0,66,66,0,1,0,1,0
50159,445,0,0,67,67,0,1,0,1,0
53963,445,0,0,66,66,0,1,0,1,0
63873,445,0,0,70,70,0,1,0,1,0
56656,445,0,0,70,70,0,1,0,1,0
64964,445,0,0,70,70,0,1,0,1,0
62214,445,0,0,66,66,0,1,0,1,0
50274,445,0,0,70,70,0,1,0,1,0
57346,445,0,0,66,66,0,1,0,1,0
62553,445,0,0,70,70,0,1,0,1,0
64273,445,0,0,66,66,0,1,0,1,0
52795,445,0,0,66,66,0,1,0,1,0
53381,445,0,0,70,70,0,1,0,1,0
57733,445,0,0,66,66,0,1,0,1,0
50624,445,0,0,70,70,0,1,0,1,0
55181,445,0,0,70,70,0,1,0,1,0
50307,445,0,0,70,70,0,1,0,1,0
59831,445,0,0,70,70,0,1,0,1,0
49617,445,0,0,66,66,0,1,0,1,0
61425,445,0,0,70,70,0,1,0,1,0
55681,445,0,0,70,70,0,1,0,1,0
62708,445,0,0,70,70,0,1,0,1,0
50046,445,0,0,66,66,0,1,0,1,0
53946,445,0,0,66,66,0,1,0,1,0
62230,445,0,0,70,70,0,1,0,1,0
51459,445,0,0,70,70,0,1,0,1,0
62272,445,0,0,70,70,0,1,0,1,0
54113,445,0,0,70,70,0,1,0,1,0
57908,445,0,0,66,66,0,1,0,1,0
50229,445,0,0,66,66,0,1,0,1,0
57870,445,0,0,70,70,0,1,0,1,0
49236,445,0,0,70,70,0,1,0,1,0
60716,445,0,0,68,68,0,1,0,1,0
53754,445,0,0,66,66,0,1,0,1,0
61658,445,0,0,67,67,0,1,0,1,0
61146,445,0,0,70,70,0,1,0,1,0
63796,445,0,0,70,70,0,1,0,1,0
61335,445,0,0,66,66,0,1,0,1,0
55788,445,0,0,66,66,0,1,0,1,0
62654,445,0,0,66,66,0,1,0,1,0
60244,445,0,0,68,68,0,1,0,1,0
50033,445,0,0,69,69,0,1,0,1,0
63662,445,0,0,70,70,0,1,0,1,0
65518,445,0,0,70,70,0,1,0,1,0
62879,445,0,0,70,70,0,1,0,1,0
58889,445,0,0,70,70,0,1,0,1,0
53563,445,0,0,70,70,0,1,0,1,0
57046,445,0,0,69,69,0,1,0,1,0
56817,445,0,0,67,67,0,1,0,1,0
64282,445,0,0,70,70,0,1,0,1,0
50950,445,0,0,66,66,0,1,0,1,0
52671,445,0,0,69,69,0,1,0,1,0
57730,445,0,0,67,67,0,1,0,1,0
60214,445,0,0,70,70,0,1,0,1,0
50673,445,0,0,66,66,0,1,0,1,0
59355,445,0,0,67,67,0,1,0,1,0
52462,445,0,0,70,70,0,1,0,1,0
53143,445,0,0,69,69,0,1,0,1,0
56237,445,0,0,70,70,0,1,0,1,0
57511,445,0,0,70,70,0,1,0,1,0
51308,445,0,0,69,69,0,1,0,1,0
51638,445,0,0,66,66,0,1,0,1,0
57247,445,0,0,70,70,0,1,0,1,0
57495,445,0,0,70,70,0,1,0,1,0
63759,445,0,0,70,70,0,1,0,1,0
60667,445,0,0,70,70,0,1,0,1,0
62327,445,0,0,70,70,0,1,0,1,0
51372,445,0,0,70,70,0,1,0,1,0
52622,445,0,0,70,70,0,1,0,1,0
58190,445,0,0,70,70,0,1,0,1,0
62669,445,0,0,70,70,0,1,0,1,0
56784,445,0,0,70,70,0,1,0,1,0
50465,445,0,0,66,66,0,1,0,1,0
51558,445,0,0,70,70,0,1,0,1,0
64504,445,0,0,69,69,0,1,0,1,0
50867,445,0,0,66,66,0,1,0,1,0
62330,445,0,0,70,70,0,1,0,1,0
57719,445,0,0,70,70,0,1,0,1,0
61086,445,0,0,69,69,0,1,0,1,0
65395,445,0,0,69,69,0,1,0,1,0
53685,445,0,0,66,66,0,1,0,1,0
49753,445,0,0,70,70,0,1,0,1,0
56371,445,0,0,66,66,0,1,0,1,0
53178,445,0,0,69,69,0,1,0,1,0
56554,445,0,0,70,70,0,1,0,1,0
57332,445,0,0,66,66,0,1,0,1,0
50376,445,0,0,70,70,0,1,0,1,0
61528,445,0,0,66,66,0,1,0,1,0
60787,445,0,0,70,70,0,1,0,1,0
62446,445,0,0,68,68,0,1,0,1,0
60630,445,0,0,66,66,0,1,0,1,0
51435,445,0,0,70,70,0,1,0,1,0
61717,445,0,0,69,69,0,1,0,1,0
64819,445,0,0,70,70,0,1,0,1,0
61827,445,0,0,70,70,0,1,0,1,0
61899,445,0,0,68,68,0,1,0,1,0
64932,445,0,0,67,67,0,1,0,1,0
55040,445,0,0,66,66,0,1,0,1,0
53289,445,0,0,70,70,0,1,0,1,0
60803,445,0,0,69,69,0,1,0,1,0
60151,445,0,0,70,70,0,1,0,1,0
62105,445,0,0,66,66,0,1,0,1,0
61701,445,0,0,66,66,0,1,0,1,0
62518,445,0,0,70,70,0,1,0,1,0
60256,445,0,0,66,66,0,1,0,1,0
59018,445,0,0,66,66,0,1,0,1,0
64629,445,0,0,66,66,0,1,0,1,0
49476,445,0,0,70,70,0,1,0,1,0
56404,445,0,0,68,68,0,1,0,1,0
58777,445,0,0,70,70,0,1,0,1,0
56816,445,0,0,66,66,0,1,0,1,0
61063,445,0,0,66,66,0,1,0,1,0
63512,445,0,0,66,66,0,1,0,1,0
54702,445,0,0,67,67,0,1,0,1,0
51289,445,0,0,70,70,0,1,0,1,0
64990,445,0,0,66,66,0,1,0,1,0
60312,445,0,0,69,69,0,1,0,1,0
57473,445,0,0,66,66,0,1,0,1,0
56517,445,0,0,70,70,0,1,0,1,0
49701,445,0,0,70,70,0,1,0,1,0
55534,445,0,0,70,70,0,1,0,1,0
55211,445,0,0,66,66,0,1,0,1,0
58558,445,0,0,70,70,0,1,0,1,0
51105,445,0,0,66,66,0,1,0,1,0
58960,445,0,0,70,70,0,1,0,1,0
53505,445,0,0,66,66,0,1,0,1,0
60351,445,0,0,70,70,0,1,0,1,0
60160,445,0,0,69,69,0,1,0,1,0
59140,445,0,0,66,66,0,1,0,1,0
62554,445,0,0,68,68,0,1,0,1,0
53489,445,0,0,70,70,0,1,0,1,0
50633,445,0,0,70,70,0,1,0,1,0
50585,445,0,0,70,70,0,1,0,1,0
61091,445,0,0,70,70,0,1,0,1,0
63201,445,0,0,66,66,0,1,0,1,0
59124,445,0,0,70,70,0,1,0,1,0
55933,445,0,0,67,67,0,1,0,1,0
58997,445,0,0,66,66,0,1,0,1,0
56254,445,0,0,66,66,0,1,0,1,0
63984,445,0,0,70,70,0,1,0,1,0
54113,445,0,0,70,70,0,1,0,1,0
54780,445,0,0,70,70,0,1,0,1,0
52904,445,0,0,70,70,0,1,0,1,0
62775,445,0,0,70,70,0,1,0,1,0
56684,445,0,0,70,70,0,1,0,1,0
50467,445,0,0,66,66,0,1,0,1,0
63160,445,0,0,66,66,0,1,0,1,0
56846,445,0,0,70,70,0,1,0,1,0
57328,445,0,0,70,70,0,1,0,1,0
62488,445,0,0,66,66,0,1,0,1,0
54294,445,0,0,70,70,0,1,0,1,0
56226,445,0,0,70,70,0,1,0,1,0
51599,445,0,0,70,70,0,1,0,1,0
56904,445,0,0,66,66,0,1,0,1,0
56414,445,0,0,70,70,0,1,0,1,0
52642,445,0,0,70,70,0,1,0,1,0
59387,445,0,0,70,70,0,1,0,1,0
59785,445,0,0,66,66,0,1,0,1,0
65328,445,0,0,70,70,0,1,0,1,0
58057,445,0,0,66,66,0,1,0,1,0
53468,445,0,0,70,70,0,1,0,1,0
62296,445,0,0,69,69,0,1,0,1,0
57566,445,0,0,70,70,0,1,0,1,0
64226,445,0,0,66,66,0,1,0,1,0
63640,445,0,0,70,70,0,1,0,1,0
52404,445,0,0,66,66,0,1,0,1,0
52166,445,0,0,66,66,0,1,0,1,0
51305,445,0,0,70,70,0,1,0,1,0
53369,445,0,0,66,66,0,1,0,1,0
65200,445,0,0,69,69,0,1,0,1,0
64884,445,0,0,70,70,0,1,0,1,0
50763,445,0,0,70,70,0,1,0,1,0
59176,445,0,0,70,70,0,1,0,1,0
55076,445,0,0,70,70,0,1,0,1,0
55034,445,0,0,66,66,0,1,0,1,0
54844,445,0,0,69,69,0,1,0,1,0
57404,445,0,0,70,70,0,1,0,1,0
53489,445,0,0,70,70,0,1,0,1,0
58225,445,0,0,68,68,0,1,0,1,0
54432,445,0,0,70,70,0,1,0,1,0
56112,445,0,0,68,68,0,1,0,1,0
55942,445,0,0,70,70,0,1,0,1,0
55965,445,0,0,66,66,0,1,0,1,0
54739,445,0,0,70,70,0,1,0,1,0
65058,445,0,0,70,70,0,1,0,1,0
50620,445,0,0,66,66,0,1,0,1,0
63921,445,0,0,70,70,0,1,0,1,0
50937,445,0,0,69,69,0,1,0,1,0
59918,445,0,0,66,66,0,1,0,1,0
53165,445,0,0,70,70,0,1,0,1,0
50590,445,0,0,66,66,0,1,0,1,0
52255,445,0,0,67,67,0,1,0,1,0
49662,445,0,0,70,70,0,1,0,1,0
56896,445,0,0,66,66,0,1,0,1,0
51713,445,0,0,70,70,0,1,0,1,0
57647,445,0,0,70,70,0,1,0,1,0
55341,445,0,0,70,70,0,1,0,1,0
51054,445,0,0,69,69,0,1,0,1,0
50427,445,0,0,70,70,0,1,0,1,0
52497,445,0,0,70,70,0,1,0,1,0
54263,445,0,0,66,66,0,1,0,1,0
65268,445,0,0,70,70,0,1,0,1,0
60791,445,0,0,70,70,0,1,0,1,0
63905,445,0,0,66,66,0,1,0,1,0
53303,445,0,0,70,70,0,1,0,1,0
62489,445,0,0,66,66,0,1,0,1,0
51596,445,0,0,70,70,0,1,0,1,0
52638,445,0,0,70,70,0,1,0,1,0
50858,445,0,0,66,66,0,1,0,1,0
51599,445,0,0,69,69,0,1,0,1,0
52711,445,0,0,69,69,0,1,0,1,0
52025,445,0,0,68,68,0,1,0,1,0
59595,445,0,0,66,66,0,1,0,1,0
63126,445,0,0,66,66,0,1,0,1,0
57674,445,0,0,66,66,0,1,0,1,0
52206,445,0,0,70,70,0,1,0,1,0
54955,445,0,0,70,70,0,1,0,1,0
50735,445,0,0,70,70,0,1,0,1,0
64375,445,0,0,66,66,0,1,0,1,0
52350,445,0,0,70,70,0,1,0,1,0
52984,445,0,0,66,66,0,1,0,1,0
65521,445,0,0,69,69,0,1,0,1,0
58366,445,0,0,68,68,0,1,0,1,0
49788,445,0,0,70,70,0,1,0,1,0
53523,445,0,0,68,68,0,1,0,1,0
49524,445,0,0,68,68,0,1,0,1,0
56964,445,0,0,70,70,0,1,0,1,0
49350,445,0,0,70,70,0,1,0,1,0
53045,445,0,0,70,70,0,1,0,1,0
53714,445,0,0,67,67,0,1,0,1,0
49479,445,0,0,70,70,0,1,0,1,0
57325,445,0,0,70,70,0,1,0,1,0
52416,445,0,0,66,66,0,1,0,1,0
53979,445,0,0,70,70,0,1,0,1,0
57373,445,0,0,70,70,0,1,0,1,0
62176,445,0,0,67,67,0,1,0,1,0
56671,445,0,0,67,67,0,1,0,1,0
58889,445,0,0,66,66,0,1,0,1,0
59713,445,0,0,66,66,0,1,0,1,0
50567,445,0,0,70,70,0,1,0,1,0
54591,445,0,0,70,70,0,1,0,1,0
56055,445,0,0,70,70,0,1,0,1,0
58901,445,0,0,70,70,0,1,0,1,0
57910,445,0,0,66,66,0,1,0,1,0
52355,445,0,0,70,70,0,1,0,1,0
52802,445,0,0,69,69,0,1,0,1,0
58134,445,0,0,67,67,0,1,0,1,0
63050,445,0,0,66,66,0,1,0,1,0
57784,445,0,0,66,66,0,1,0,1,0
59718,445,0,0,70,70,0,1,0,1,0
50297,445,0,0,70,70,0,1,0,1,0
56357,445,0,0,70,70,0,1,0,1,0
52654,445,0,0,66,66,0,1,0,1,0
56486,445,0,0,70,70,0,1,0,1,0
64197,445,0,0,70,70,0,1,0,1,0
63130,445,0,0,70,70,0,1,0,1,0
58885,445,0,0,66,66,0,1,0,1,0
60144,445,0,0,70,70,0,1,0,1,0
64101,445,0,0,68,68,0,1,0,1,0
55595,445,0,0,70,70,0,1,0,1,0
55514,445,0,0,70,70,0,1,0,1,0
57260,445,0,0,67,67,0,1,0,1,0
57088,445,0,0,70,70,0,1,0,1,0
63514,445,0,0,66,66,0,1,0,1,0
60142,445,0,0,70,70,0,1,0,1,0
59500,445,0,0,70,70,0,1,0,1,0
50403,445,0,0,70,70,0,1,0,1,0
56012,445,0,0,69,69,0,1,0,1,0
55093,445,0,0,67,67,0,1,0,1,0
62777,445,0,0,70,70,0,1,0,1,0
51452,445,0,0,66,66,0,1,0,1,0
63847,445,0,0,70,70,0,1,0,1,0
58888,445,0,0,70,70,0,1,0,1,0
51184,445,0,0,66,66,0,1,0,1,0
58525,445,0,0,70,70,0,1,0,1,0
51027,445,0,0,70,70,0,1,0,1,0
64925,445,0,0,70,70,0,1,0,1,0
50525,445,0,0,70,70,0,1,0,1,0
52528,445,0,0,70,70,0,1,0,1,0
65156,445,0,0,70,70,0,1,0,1,0
58190,445,0,0,70,70,0,1,0,1,0
53854,445,0,0,70,70,0,1,0,1,0
55515,445,0,0,70,70,0,1,0,1,0
64450,445,0,0,66,66,0,1,0,1,0
52658,445,0,0,66,66,0,1,0,1,0
58859,445,0,0,70,70,0,1,0,1,0
55678,445,0,0,66,66,0,1,0,1,0
56102,445,0,0,66,66,0,1,0,1,0
51324,445,0,0,70,70,0,1,0,1,0
52089,445,0,0,66,66,0,1,0,1,0
59715,445,0,0,67,67,0,1,0,1,0
59089,445,0,0,69,69,0,1,0,1,0
52370,445,0,0,69,69,0,1,0,1,0
52942,445,0,0,68,68,0,1,0,1,0
53204,445,0,0,70,70,0,1,0,1,0
56895,445,0,0,70,70,0,1,0,1,0
53747,445,0,0,70,70,0,1,0,1,0
58315,445,0,0,70,70,0,1,0,1,0
61072,445,0,0,70,70,0,1,0,1,0
55053,445,0,0,67,67,0,1,0,1,0
53790,445,0,0,66,66,0,1,0,1,0
54902,445,0,0,68,68,0,1,0,1,0
51014,445,0,0,66,66,0,1,0,1,0
54285,445,0,0,66,66,0,1,0,1,0
55321,445,0,0,70,70,0,1,0,1,0
57902,445,0,0,69,69,0,1,0,1,0
61387,445,0,0,66,66,0,1,0,1,0
53169,445,0,0,70,70,0,1,0,1,0
56905,445,0,0,69,69,0,1,0,1,0
50260,445,0,0,70,70,0,1,0,1,0
49951,445,0,0,68,68,0,1,0,1,0
56584,445,0,0,70,70,0,1,0,1,0
55315,445,0,0,67,67,0,1,0,1,0
64414,445,0,0,70,70,0,1,0,1,0
53072,445,0,0,66,66,0,1,0,1,0
55703,445,0,0,70,70,0,1,0,1,0
58088,445,0,0,70,70,0,1,0,1,0
63294,445,0,0,66,66,0,1,0,1,0
60832,445,0,0,70,70,0,1,0,1,0
63982,445,0,0,70,70,0,1,0,1,0
61125,445,0,0,70,70,0,1,0,1,0
57801,445,0,0,68,68,0,1,0,1,0
49897,445,0,0,66,66,0,1,0,1,0
64890,445,0,0,70,70,0,1,0,1,0
58527,445,0,0,70,70,0,1,0,1,0
53625,445,0,0,66,66,0,1,0,1,0
65065,445,0,0,66,66,0,1,0,1,0
53364,445,0,0,70,70,0,1,0,1,0
50016,445,0,0,70,70,0,1,0,1,0
57927,445,0,0,66,66,0,1,0,1,0
50988,445,0,0,66,66,0,1,0,1,0
57280,445,0,0,70,70,0,1,0,1,0
53594,445,0,0,70,70,0,1,0,1,0
60202,445,0,0,70,70,0,1,0,1,0
63884,445,0,0,66,66,0,1,0,1,0
60999,445,0,0,70,70,0,1,0,1,0
60857,445,0,0,69,69,0,1,0,1,0
62638,445,0,0,70,70,0,1,0,1,0
62913,445,0,0,70,70,0,1,0,1,0
64304,445,0,0,70,70,0,1,0,1,0
49862,445,0,0,70,70,0,1,0,1,0
61385,445,0,0,67,67,0,1,0,1,0
63040,445,0,0,70,70,0,1,0,1,0
54776,445,0,0,70,70,0,1,0,1,0
50578,445,0,0,68,68,0,1,0,1,0
62164,445,0,0,70,70,0,1,0,1,0
58327,445,0,0,70,70,0,1,0,1,0
53726,445,0,0,70,70,0,1,0,1,0
50286,445,0,0,66,66,0,1,0,1,0
59611,445,0,0,70,70,0,1,0,1,0
56516,445,0,0,68,68,0,1,0,1,0
56420,445,0,0,70,70,0,1,0,1,0
65477,445,0,0,66,66,0,1,0,1,0
61338,445,0,0,66,66,0,1,0,1,0
60597,445,0,0,70,70,0,1,0,1,0
52394,445,0,0,70,70,0,1,0,1,0
51346,445,0,0,70,70,0,1,0,1,0
50682,445,0,0,70,70,0,1,0,1,0
55359,445,0,0,70,70,0,1,0,1,0
60303,445,0,0,66,66,0,1,0,1,0
49934,445,0,0,70,70,0,1,0,1,0
59443,445,0,0,70,70,0,1,0,1,0
51290,445,0,0,70,70,0,1,0,1,0
51907,445,0,0,66,66,0,1,0,1,0
50507,445,0,0,66,66,0,1,0,1,0
64579,445,0,0,68,68,0,1,0,1,0
59438,445,0,0,70,70,0,1,0,1,0
62627,445,0,0,70,70,0,1,0,1,0
55937,445,0,0,66,66,0,1,0,1,0
58114,445,0,0,68,68,0,1,0,1,0
52214,445,0,0,66,66,0,1,0,1,0
60234,445,0,0,70,70,0,1,0,1,0
51260,445,0,0,70,70,0,1,0,1,0
64844,445,0,0,70,70,0,1,0,1,0
50116,445,0,0,70,70,0,1,0,1,0
56738,445,0,0,70,70,0,1,0,1,0
50162,445,0,0,66,66,0,1,0,1,0
57661,445,0,0,69,69,0,1,0,1,0
53171,445,0,0,66,66,0,1,0,1,0
60313,445,0,0,70,70,0,1,0,1,0
53700,445,0,0,66,66,0,1,0,1,0
61569,445,0,0,70,70,0,1,0,1,0
54385,445,0,0,70,70,0,1,0,1,0
59155,445,0,0,67,67,0,1,0,1,0
63073,445,0,0,70,70,0,1,0,1,0
49213,445,0,0,70,70,0,1,0,1,0
51044,445,0,0,66,66,0,1,0,1,0
58224,445,0,0,69,69,0,1,0,1,0
61605,445,0,0,70,70,0,1,0,1,0
50289,445,0,0,66,66,0,1,0,1,0
50427,445,0,0,70,70,0,1,0,1,0
54832,445,0,0,70,70,0,1,0,1,0
59486,445,0,0,68,68,0,1,0,1,0
64748,445,0,0,66,66,0,1,0,1,0
50092,445,0,0,70,70,0,1,0,1,0
56851,445,0,0,70,70,0,1,0,1,0
60242,445,0,0,70,70,0,1,0,1,0
58268,445,0,0,70,70,0,1,0,1,0
61908,445,0,0,69,69,0,1,0,1,0
62287,445,0,0,67,67,0,1,0,1,0
50477,445,0,0,66,66,0,1,0,1,0
50625,445,0,0,67,67,0,1,0,1,0
61398,445,0,0,69,69,0,1,0,1,0
52299,445,0,0,66,66,0,1,0,1,0
61405,445,0,0,70,70,0,1,0,1,0
59469,445,0,0,66,66,0,1,0,1,0
51669,445,0,0,70,70,0,1,0,1,0
50289,445,0,0,66,66,0,1,0,1,0
52915,445,0,0,66,66,0,1,0,1,0
50604,445,0,0,66,66,0,1,0,1,0
55713,445,0,0,70,70,0,1,0,1,0
52660,445,0,0,67,67,0,1,0,1,0
59436,445,0,0,70,70,0,1,0,1,0
64973,445,0,0,70,70,0,1,0,1,0
50528,445,0,0,70,70,0,1,0,1,0
53062,445,0,0,66,66,0,1,0,1,0
53482,445,0,0,70,70,0,1,0,1,0
59485,445,0,0,70,70,0,1,0,1,0
57109,445,0,0,70,70,0,1,0,1,0
52315,445,0,0,70,70,0,1,0,1,0
53539,445,0,0,70,70,0,1,0,1,0
55203,445,0,0,70,70,0,1,0,1,0
50389,445,0,0,69,69,0,1,0,1,0
63150,445,0,0,69,69,0,1,0,1,0
62402,445,0,0,70,70,0,1,0,1,0
52731,445,0,0,70,70,0,1,0,1,0
62023,445,0,0,67,67,0,1,0,1,0
49631,445,0,0,70,70,0,1,0,1,0
54562,445,0,0,70,70,0,1,0,1,0
55230,445,0,0,70,70,0,1,0,1,0
63966,445,0,0,66,66,0,1,0,1,0
61981,445,0,0,70,70,0,1,0,1,0
49710,445,0,0,70,70,0,1,0,1,0
63520,445,0,0,66,66,0,1,0,1,0
60656,445,0,0,70,70,0,1,0,1,0
50528,445,0,0,70,70,0,1,0,1,0
62284,445,0,0,70,70,0,1,0,1,0
49953,445,0,0,70,70,0,1,0,1,0
50291,445,0,0,66,66,0,1,0,1,0
61903,445,0,0,70,70,0,1,0,1,0
52253,445,0,0,68,68,0,1,0,1,0
54505,445,0,0,67,67,0,1,0,1,0
58342,445,0,0,70,70,0,1,0,1,0
58153,445,0,0,70,70,0,1,0,1,0
54135,445,0,0,66,66,0,1,0,1,0
50298,445,0,0,70,70,0,1,0,1,0
55058,445,0,0,70,70,0,1,0,1,0
57926,445,0,0,66,66,0,1,0,1,0
55418,445,0,0,66,66,0,1,0,1,0
60440,445,0,0,66,66,0,1,0,1,0
54251,445,0,0,69,69,0,1,0,1,0
54013,445,0,0,68,68,0,1,0,1,0
51968,445,0,0,70,70,0,1,0,1,0
49749,445,0,0,67,67,0,1,0,1,0
52569,445,0,0,70,70,0,1,0,1,0
57477,445,0,0,66,66,0,1,0,1,0
54535,445,0,0,70,70,0,1,0,1,0
64611,445,0,0,70,70,0,1,0,1,0
61143,445,0,0,70,70,0,1,0,1,0
64586,445,0,0,70,70,0,1,0,1,0
50894,445,0,0,70,70,0,1,0,1,0
64007,445,0,0,70,70,0,1,0,1,0
58187,445,0,0,66,66,0,1,0,1,0
61598,445,0,0,69,69,0,1,0,1,0
50254,445,0,0,67,67,0,1,0,1,0
55638,445,0,0,70,70,0,1,0,1,0
62392,445,0,0,70,70,0,1,0,1,0
55580,445,0,0,69,69,0,1,0,1,0
55658,445,0,0,70,70,0,1,0,1,0
56210,445,0,0,68,68,0,1,0,1,0
50694,445,0,0,67,67,0,1,0,1,0
52346,445,0,0,66,66,0,1,0,1,0
53626,445,0,0,66,66,0,1,0,1,0
54226,445,0,0,70,70,0,1,0,1,0
54905,445,0,0,70,70,0,1,0,1,0
62409,445,0,0,67,67,0,1,0,1,0
64104,445,0,0,66,66,0,1,0,1,0
60787,445,0,0,70,70,0,1,0,1,0
61292,445,0,0,68,68,0,1,0,1,0
49509,445,0,0,66,66,0,1,0,1,0
60724,445,0,0,70,70,0,1,0,1,0
60432,445,0,0,67,67,0,1,0,1,0
61107,445,0,0,67,67,0,1,0,1,0
65219,445,0,0,70,70,0,1,0,1,0
54262,445,0,0,66,66,0,1,0,1,0
49302,445,0,0,70,70,0,1,0,1,0
50163,445,0,0,70,70,0,1,0,1,0
56519,445,0,0,66,66,0,1,0,1,0
52474,445,0,0,70,70,0,1,0,1,0
55889,445,0,0,66,66,0,1,0,1,0
52985,445,0,0,66,66,0,1,0,1,0
62796,445,0,0,70,70,0,1,0,1,0
50169,445,0,0,70,70,0,1,0,1,0
63957,445,0,0,70,70,0,1,0,1,0
55211,445,0,0,70,70,0,1,0,1,0
62174,445,0,0,70,70,0,1,0,1,0
63848,445,0,0,68,68,0,1,0,1,0
54164,445,0,0,67,67,0,1,0,1,0
54903,445,0,0,70,70,0,1,0,1,0
56371,445,0,0,66,66,0,1,0,1,0
52931,445,0,0,70,70,0,1,0,1,0
53713,445,0,0,66,66,0,1,0,1,0
52521,445,0,0,66,66,0,1,0,1,0
58495,445,0,0,68,68,0,1,0,1,0
64166,445,0,0,70,70,0,1,0,1,0
60119,445,0,0,70,70,0,1,0,1,0
56206,445,0,0,70,70,0,1,0,1,0
50283,445,0,0,66,66,0,1,0,1,0
56844,445,0,0,70,70,0,1,0,1,0
50017,445,0,0,70,70,0,1,0,1,0
55229,445,0,0,70,70,0,1,0,1,0
56092,445,0,0,67,67,0,1,0,1,0
63358,445,0,0,70,70,0,1,0,1,0
61238,445,0,0,69,69,0,1,0,1,0
51677,445,0,0,70,70,0,1,0,1,0
63340,445,0,0,70,70,0,1,0,1,0
57735,445,0,0,66,66,0,1,0,1,0
52698,445,0,0,70,70,0,1,0,1,0
51000,445,0,0,70,70,0,1,0,1,0
51833,445,0,0,66,66,0,1,0,1,0
56851,445,0,0,69,69,0,1,0,1,0
57533,445,0,0,70,70,0,1,0,1,0
56449,445,0,0,70,70,0,1,0,1,0
50823,445,0,0,70,70,0,1,0,1,0
55115,445,0,0,70,70,0,1,0,1,0
56101,445,0,0,66,66,0,1,0,1,0
64488,445,0,0,66,66,0,1,0,1,0
59226,445,0,0,70,70,0,1,0,1,0
60841,445,0,0,70,70,0,1,0,1,0
55083,445,0,0,70,70,0,1,0,1,0
56812,445,0,0,70,70,0,1,0,1,0
53725,445,0,0,70,70,0,1,0,1,0
52013,445,0,0,70,70,0,1,0,1,0
57306,445,0,0,70,70,0,1,0,1,0
53639,445,0,0,70,70,0,1,0,1,0
50007,445,0,0,70,70,0,1,0,1,0
64812,445,0,0,70,70,0,1,0,1,0
50394,445,0,0,70,70,0,1,0,1,0
62568,445,0,0,68,68,0,1,0,1,0
50737,445,0,0,70,70,0,1,0,1,0
55723,445,0,0,70,70,0,1,0,1,0
54571,445,0,0,70,70,0,1,0,1,0
58221,445,0,0,69,69,0,1,0,1,0
64232,445,0,0,66,66,0,1,0,1,0
58043,445,0,0,67,67,0,1,0,1,0
62169,445,0,0,66,66,0,1,0,1,0
58812,445,0,0,70,70,0,1,0,1,0
58519,445,0,0,70,70,0,1,0,1,0
64729,445,0,0,66,66,0,1,0,1,0
49520,445,0,0,70,70,0,1,0,1,0
62703,445,0,0,70,70,0,1,0,1,0
49783,445,0,0,70,70,0,1,0,1,0
50870,445,0,0,70,70,0,1,0,1,0
60959,445,0,0,70,70,0,1,0,1,0
54517,445,0,0,70,70,0,1,0,1,0
55744,445,0,0,66,66,0,1,0,1,0
58571,445,0,0,66,66,0,1,0,1,0
50591,445,0,0,70,70,0,1,0,1,0
57250,445,0,0,70,70,0,1,0,1,0
58968,445,0,0,66,66,0,1,0,1,0
63286,445,0,0,70,70,0,1,0,1,0
53916,445,0,0,69,69,0,1,0,1,0
58434,445,0,0,66,66,0,1,0,1,0
50800,445,0,0,66,66,0,1,0,1,0
52072,445,0,0,70,70,0,1,0,1,0
55541,445,0,0,70,70,0,1,0,1,0
58936,445,0,0,70,70,0,1,0,1,0
49769,445,0,0,70,70,0,1,0,1,0
53027,445,0,0,70,70,0,1,0,1,0
61229,445,0,0,70,70,0,1,0,1,0
54077,445,0,0,69,69,0,1,0,1,0
56045,445,0,0,68,68,0,1,0,1,0
61752,445,0,0,70,70,0,1,0,1,0
64248,445,0,0,67,67,0,1,0,1,0
59075,445,0,0,69,69,0,1,0,1,0
55143,445,0,0,66,66,0,1,0,1,0
50415,445,0,0,66,66,0,1,0,1,0
50298,445,0,0,70,70,0,1,0,1,0
53438,445,0,0,70,70,0,1,0,1,0
62429,445,0,0,70,70,0,1,0,1,0
55438,445,0,0,67,67,0,1,0,1,0
59759,445,0,0,70,70,0,1,0,1,0
55452,445,0,0,70,70,0,1,0,1,0
57869,445,0,0,70,70,0,1,0,1,0
59781,445,0,0,70,70,0,1,0,1,0
52349,445,0,0,70,70,0,1,0,1,0
49797,445,0,0,70,70,0,1,0,1,0
61877,445,0,0,70,70,0,1,0,1,0
53826,445,0,0,66,66,0,1,0,1,0
51344,445,0,0,70,70,0,1,0,1,0
63642,445,0,0,70,70,0,1,0,1,0
58496,445,0,0,70,70,0,1,0,1,0
63586,445,0,0,70,70,0,1,0,1,0
50284,445,0,0,67,67,0,1,0,1,0
64067,445,0,0,68,68,0,1,0,1,0
61145,445,0,0,70,70,0,1,0,1,0
63275,445,0,0,67,67,0,1,0,1,0
59781,445,0,0,70,70,0,1,0,1,0
63306,445,0,0,67,67,0,1,0,1,0
50881,445,0,0,66,66,0,1,0,1,0
63448,445,0,0,69,69,0,1,0,1,0
50492,445,0,0,70,70,0,1,0,1,0
59769,445,0,0,69,69,0,1,0,1,0
63922,445,0,0,69,69,0,1,0,1,0
63616,445,0,0,70,70,0,1,0,1,0
58939,445,0,0,66,66,0,1,0,1,0
60980,445,0,0,70,70,0,1,0,1,0
63484,445,0,0,70,70,0,1,0,1,0
55372,445,0,0,70,70,0,1,0,1,0
53482,445,0,0,70,70,0,1,0,1,0
62156,445,0,0,68,68,0,1,0,1,0
57398,445,0,0,67,67,0,1,0,1,0
49266,445,0,0,69,69,0,1,0,1,0
59445,445,0,0,70,70,0,1,0,1,0
51269,445,0,0,70,70,0,1,0,1,0
61280,445,0,0,66,66,0,1,0,1,0
59215,445,0,0,70,70,0,1,0,1,0
57095,445,0,0,68,68,0,1,0,1,0
54400,445,0,0,67,67,0,1,0,1,0
58947,445,0,0,70,70,0,1,0,1,0
59147,445,0,0,66,66,0,1,0,1,0
60632,445,0,0,67,67,0,1,0,1,0
64809,445,0,0,66,66,0,1,0,1,0
59168,445,0,0,69,69,0,1,0,1,0
63691,445,0,0,70,70,0,1,0,1,0
53356,445,0,0,69,69,0,1,0,1,0
63717,445,0,0,70,70,0,1,0,1,0
59679,445,0,0,67,67,0,1,0,1,0
54553,445,0,0,69,69,0,1,0,1,0
59501,445,0,0,70,70,0,1,0,1,0
53719,445,0,0,70,70,0,1,0,1,0
59530,445,0,0,70,70,0,1,0,1,0
56275,445,0,0,69,69,0,1,0,1,0
59165,445,0,0,70,70,0,1,0,1,0
58969,445,0,0,70,70,0,1,0,1,0
58424,445,0,0,66,66,0,1,0,1,0
56749,445,0,0,70,70,0,1,0,1,0
50304,445,0,0,70,70,0,1,0,1,0
49753,445,0,0,70,70,0,1,0,1,0
53191,445,0,0,67,67,0,1,0,1,0
50320,445,0,0,70,70,0,1,0,1,0
64676,445,0,0,68,68,0,1,0,1,0
54583,445,0,0,66,66,0,1,0,1,0
54724,445,0,0,70,70,0,1,0,1,0
52763,445,0,0,68,68,0,1,0,1,0
55317,445,0,0,70,70,0,1,0,1,0
62776,445,0,0,70,70,0,1,0,1,0
61121,445,0,0,69,69,0,1,0,1,0
62128,445,0,0,70,70,0,1,0,1,0
60096,445,0,0,70,70,0,1,0,1,0
52821,445,0,0,70,70,0,1,0,1,0
64342,445,0,0,68,68,0,1,0,1,0
53672,445,0,0,70,70,0,1,0,1,0
64541,445,0,0,70,70,0,1,0,1,0
54935,445,0,0,70,70,0,1,0,1,0
62170,445,0,0,70,70,0,1,0,1,0
58839,445,0,0,68,68,0,1,0,1,0
58353,445,0,0,66,66,0,1,0,1,0
55505,445,0,0,70,70,0,1,0,1,0
64587,445,0,0,68,68,0,1,0,1,0
63257,445,0,0,66,66,0,1,0,1,0
54129,445,0,0,70,70,0,1,0,1,0
50043,445,0,0,70,70,0,1,0,1,0
52892,445,0,0,70,70,0,1,0,1,0
55976,445,0,0,70,70,0,1,0,1,0
57544,445,0,0,66,66,0,1,0,1,0
59320,445,0,0,70,70,0,1,0,1,0
60302,445,0,0,70,70,0,1,0,1,0
64672,445,0,0,70,70,0,1,0,1,0
59733,445,0,0,70,70,0,1,0,1,0
62900,445,0,0,67,67,0,1,0,1,0
60342,445,0,0,66,66,0,1,0,1,0
63315,445,0,0,70,70,0,1,0,1,0
57927,445,0,0,66,66,0,1,0,1,0
61546,445,0,0,66,66,0,1,0,1,0
62261,445,0,0,70,70,0,1,0,1,0
51392,445,0,0,70,70,0,1,0,1,0
58778,445,0,0,70,70,0,1,0,1,0
61656,445,0,0,66,66,0,1,0,1,0
51583,445,0,0,70,70,0,1,0,1,0
58971,445,0,0,70,70,0,1,0,1,0
54565,445,0,0,70,70,0,1,0,1,0
63791,445,0,0,70,70,0,1,0,1,0
54045,445,0,0,69,69,0,1,0,1,0
59042,445,0,0,68,68,0,1,0,1,0
50477,445,0,0,66,66,0,1,0,1,0
57987,445,0,0,70,70,0,1,0,1,0
50605,445,0,0,70,70,0,1,0,1,0
61738,445,0,0,68,68,0,1,0,1,0
60980,445,0,0,70,70,0,1,0,1,0
52816,445,0,0,68,68,0,1,0,1,0
54369,445,0,0,70,70,0,1,0,1,0
50612,445,0,0,70,70,0,1,0,1,0
62061,445,0,0,70,70,0,1,0,1,0
60216,445,0,0,70,70,0,1,0,1,0
50989,445,0,0,66,66,0,1,0,1,0
52804,445,0,0,70,70,0,1,0,1,0
55659,445,0,0,70,70,0,1,0,1,0
54890,445,0,0,70,70,0,1,0,1,0
54844,445,0,0,70,70,0,1,0,1,0
52808,445,0,0,68,68,0,1,0,1,0
63545,445,0,0,66,66,0,1,0,1,0
54732,445,0,0,66,66,0,1,0,1,0
61675,445,0,0,67,67,0,1,0,1,0
50766,445,0,0,70,70,0,1,0,1,0
56065,445,0,0,66,66,0,1,0,1,0
49804,445,0,0,70,70,0,1,0,1,0
52963,445,0,0,67,67,0,1,0,1,0
63202,445,0,0,70,70,0,1,0,1,0
62175,445,0,0,70,70,0,1,0,1,0
64103,445,0,0,70,70,0,1,0,1,0
65435,445,0,0,67,67,0,1,0,1,0
58853,445,0,0,70,70,0,1,0,1,0
49568,445,0,0,68,68,0,1,0,1,0
50298,445,0,0,70,70,0,1,0,1,0
61516,445,0,0,70,70,0,1,0,1,0
56191,445,0,0,70,70,0,1,0,1,0
57732,445,0,0,66,66,0,1,0,1,0
59271,445,0,0,69,69,0,1,0,1,0
52779,445,0,0,66,66,0,1,0,1,0
64930,445,0,0,70,70,0,1,0,1,0
52253,445,0,0,70,70,0,1,0,1,0
51384,445,0,0,70,70,0,1,0,1,0
55690,445,0,0,70,70,0,1,0,1,0
51566,445,0,0,70,70,0,1,0,1,0
56200,445,0,0,70,70,0,1,0,1,0
58034,445,0,0,67,67,0,1,0,1,0
55901,445,0,0,70,70,0,1,0,1,0
60985,445,0,0,70,70,0,1,0,1,0
50018,445,0,0,70,70,0,1,0,1,0
64357,445,0,0,69,69,0,1,0,1,0
60337,445,0,0,70,70,0,1,0,1,0
61774,445,0,0,66,66,0,1,0,1,0
62318,445,0,0,70,70,0,1,0,1,0
56123,445,0,0,66,66,0,1,0,1,0
58259,445,0,0,70,70,0,1,0,1,0
52779,445,0,0,70,70,0,1,0,1,0
49213,445,0,0,70,70,0,1,0,1,0
50191,445,0,0,70,70,0,1,0,1,0
64429,445,0,0,70,70,0,1,0,1,0
56027,445,0,0,70,70,0,1,0,1,0
64332,445,0,0,70,70,0,1,0,1,0
59390,445,0,0,70,70,0,1,0,1,0
61502,445,0,0,70,70,0,1,0,1,0
62795,445,0,0,70,70,0,1,0,1,0
59076,445,0,0,68,68,0,1,0,1,0
59725,445,0,0,69,69,0,1,0,1,0
55557,445,0,0,70,70,0,1,0,1,0
49530,445,0,0,66,66,0,1,0,1,0
63426,445,0,0,70,70,0,1,0,1,0
56834,445,0,0,70,70,0,1,0,1,0
65456,445,0,0,70,70,0,1,0,1,0
63929,445,0,0,68,68,0,1,0,1,0
52437,445,0,0,70,70,0,1,0,1,0
54498,445,0,0,70,70,0,1,0,1,0
57747,445,0,0,70,70,0,1,0,1,0
51597,445,0,0,70,70,0,1,0,1,0
49581,445,0,0,70,70,0,1,0,1,0
56893,445,0,0,70,70,0,1,0,1,0
49816,445,0,0,70,70,0,1,0,1,0
57221,445,0,0,66,66,0,1,0,1,0
61589,445,0,0,70,70,0,1,0,1,0
56127,445,0,0,66,66,0,1,0,1,0
61509,445,0,0,70,70,0,1,0,1,0
62128,445,0,0,69,69,0,1,0,1,0
63001,445,0,0,70,70,0,1,0,1,0
57320,445,0,0,70,70,0,1,0,1,0
60614,445,0,0,66,66,0,1,0,1,0
63084,445,0,0,70,70,0,1,0,1,0
60823,445,0,0,66,66,0,1,0,1,0
50065,445,0,0,70,70,0,1,0,1,0
50865,445,0,0,66,66,0,1,0,1,0
57406,445,0,0,70,70,0,1,0,1,0
59731,445,0,0,70,70,0,1,0,1,0
51603,445,0,0,70,70,0,1,0,1,0
59550,445,0,0,70,70,0,1,0,1,0
60806,445,0,0,67,67,0,1,0,1,0
51634,445,0,0,68,68,0,1,0,1,0
62704,445,0,0,70,70,0,1,0,1,0
53438,445,0,0,70,70,0,1,0,1,0
60980,445,0,0,68,68,0,1,0,1,0
52976,445,0,0,70,70,0,1,0,1,0
63493,445,0,0,70,70,0,1,0,1,0
56981,445,0,0,69,69,0,1,0,1,0
64374,445,0,0,66,66,0,1,0,1,0
60014,445,0,0,70,70,0,1,0,1,0
51004,445,0,0,70,70,0,1,0,1,0
65459,445,0,0,70,70,0,1,0,1,0
57656,445,0,0,70,70,0,1,0,1,0
54972,445,0,0,70,70,0,1,0,1,0
55319,445,0,0,66,66,0,1,0,1,0
63488,445,0,0,70,70,0,1,0,1,0
56149,445,0,0,70,70,0,1,0,1,0
56337,445,0,0,68,68,0,1,0,1,0
57228,445,0,0,70,70,0,1,0,1,0
58133,445,0,0,70,70,0,1,0,1,0
61403,445,0,0,70,70,0,1,0,1,0
51136,445,0,0,70,70,0,1,0,1,0
60307,445,0,0,66,66,0,1,0,1,0
62488,445,0,0,66,66,0,1,0,1,0
59486,445,0,0,69,69,0,1,0,1,0
50888,445,0,0,70,70,0,1,0,1,0
63554,445,0,0,70,70,0,1,0,1,0
63665,445,0,0,70,70,0,1,0,1,0
51315,445,0,0,68,68,0,1,0,1,0
52088,445,0,0,70,70,0,1,0,1,0
52911,445,0,0,66,66,0,1,0,1,0
57543,445,0,0,70,70,0,1,0,1,0
56153,445,0,0,66,66,0,1,0,1,0
61951,445,0,0,70,70,0,1,0,1,0
50769,445,0,0,70,70,0,1,0,1,0
58933,445,0,0,68,68,0,1,0,1,0
53923,445,0,0,70,70,0,1,0,1,0
55896,445,0,0,70,70,0,1,0,1,0
61107,445,0,0,70,70,0,1,0,1,0
61662,445,0,0,70,70,0,1,0,1,0
62739,445,0,0,69,69,0,1,0,1,0
61222,445,0,0,70,70,0,1,0,1,0
63517,445,0,0,66,66,0,1,0,1,0
58447,445,0,0,70,70,0,1,0,1,0
58445,445,0,0,66,66,0,1,0,1,0
52473,445,0,0,66,66,0,1,0,1,0
64500,445,0,0,70,70,0,1,0,1,0
65394,445,0,0,66,66,0,1,0,1,0
51886,445,0,0,68,68,0,1,0,1,0
64556,445,0,0,70,70,0,1,0,1,0
49744,445,0,0,66,66,0,1,0,1,0
55289,445,0,0,66,66,0,1,0,1,0
54910,445,0,0,70,70,0,1,0,1,0
49523,445,0,0,70,70,0,1,0,1,0
64888,445,0,0,70,70,0,1,0,1,0
59106,445,0,0,70,70,0,1,0,1,0
59384,445,0,0,70,70,0,1,0,1,0
60114,445,0,0,70,70,0,1,0,1,0
59140,445,0,0,70,70,0,1,0,1,0
63752,445,0,0,70,70,0,1,0,1,0
49660,445,0,0,70,70,0,1,0,1,0
57616,445,0,0,68,68,0,1,0,1,0
54072,445,0,0,66,66,0,1,0,1,0
53901,445,0,0,66,66,0,1,0,1,0
53013,445,0,0,66,66,0,1,0,1,0
65294,445,0,0,70,70,0,1,0,1,0
50698,445,0,0,70,70,0,1,0,1,0
51502,445,0,0,66,66,0,1,0,1,0
62832,445,0,0,70,70,0,1,0,1,0
55014,445,0,0,67,67,0,1,0,1,0
53287,445,0,0,69,69,0,1,0,1,0
61246,445,0,0,67,67,0,1,0,1,0
64363,445,0,0,66,66,0,1,0,1,0
64350,445,0,0,70,70,0,1,0,1,0
63546,445,0,0,66,66,0,1,0,1,0
60887,445,0,0,70,70,0,1,0,1,0
52348,445,0,0,68,68,0,1,0,1,0
58707,445,0,0,67,67,0,1,0,1,0
62818,445,0,0,68,68,0,1,0,1,0
50264,445,0,0,70,70,0,1,0,1,0
57523,445,0,0,70,70,0,1,0,1,0
49490,445,0,0,70,70,0,1,0,1,0
56647,445,0,0,66,66,0,1,0,1,0
61691,445,0,0,68,68,0,1,0,1,0
55840,445,0,0,70,70,0,1,0,1,0
61005,445,0,0,66,66,0,1,0,1,0
59516,445,0,0,70,70,0,1,0,1,0
60818,445,0,0,70,70,0,1,0,1,0
60770,445,0,0,70,70,0,1,0,1,0
57357,445,0,0,70,70,0,1,0,1,0
49284,445,0,0,67,67,0,1,0,1,0
55855,445,0,0,70,70,0,1,0,1,0
63756,445,0,0,70,70,0,1,0,1,0
62747,445,0,0,66,66,0,1,0,1,0
50507,445,0,0,70,70,0,1,0,1,0
54662,445,0,0,67,67,0,1,0,1,0
50927,445,0,0,66,66,0,1,0,1,0
49969,445,0,0,70,70,0,1,0,1,0
58930,445,0,0,70,70,0,1,0,1,0
58412,445,0,0,70,70,0,1,0,1,0
65434,445,0,0,66,66,0,1,0,1,0
55428,445,0,0,70,70,0,1,0,1,0
50065,445,0,0,70,70,0,1,0,1,0
59083,445,0,0,66,66,0,1,0,1,0
56467,445,0,0,70,70,0,1,0,1,0
55235,445,0,0,70,70,0,1,0,1,0
49841,445,0,0,69,69,0,1,0,1,0
58447,445,0,0,70,70,0,1,0,1,0
61702,445,0,0,67,67,0,1,0,1,0
54519,445,0,0,70,70,0,1,0,1,0
56452,445,0,0,66,66,0,1,0,1,0
53544,445,0,0,70,70,0,1,0,1,0
50162,445,0,0,66,66,0,1,0,1,0
54981,445,0,0,70,70,0,1,0,1,0
49524,445,0,0,67,67,0,1,0,1,0
56937,445,0,0,70,70,0,1,0,1,0
65231,445,0,0,70,70,0,1,0,1,0
65256,445,0,0,67,67,0,1,0,1,0
49551,445,0,0,70,70,0,1,0,1,0
62921,445,0,0,66,66,0,1,0,1,0
57641,445,0,0,70,70,0,1,0,1,0
64321,445,0,0,66,66,0,1,0,1,0
59828,445,0,0,70,70,0,1,0,1,0
61125,445,0,0,70,70,0,1,0,1,0
64923,445,0,0,68,68,0,1,0,1,0
63388,445,0,0,70,70,0,1,0,1,0
52052,445,0,0,70,70,0,1,0,1,0
54459,445,0,0,67,67,0,1,0,1,0
58457,445,0,0,68,68,0,1,0,1,0
52952,445,0,0,70,70,0,1,0,1,0
50580,445,0,0,70,70,0,1,0,1,0
55917,445,0,0,66,66,0,1,0,1,0
58303,445,0,0,66,66,0,1,0,1,0
64837,445,0,0,70,70,0,1,0,1,0
63918,445,0,0,68,68,0,1,0,1,0
50076,445,0,0,69,69,0,1,0,1,0
51725,445,0,0,70,70,0,1,0,1,0
59937,445,0,0,69,69,0,1,0,1,0
57752,445,0,0,70,70,0,1,0,1,0
52110,445,0,0,70,70,0,1,0,1,0
59692,445,0,0,69,69,0,1,0,1,0
60911,445,0,0,70,70,0,1,0,1,0
50545,445,0,0,66,66,0,1,0,1,0
61865,445,0,0,69,69,0,1,0,1,0
59703,445,0,0,70,70,0,1,0,1,0
49677,445,0,0,70,70,0,1,0,1,0
61762,445,0,0,70,70,0,1,0,1,0
60516,445,0,0,70,70,0,1,0,1,0
50254,445,0,0,70,70,0,1,0,1,0
64628,445,0,0,70,70,0,1,0,1,0
60856,445,0,0,70,70,0,1,0,1,0
54460,445,0,0,66,66,0,1,0,1,0
60136,445,0,0,67,67,0,1,0,1,0
54957,445,0,0,70,70,0,1,0,1,0
50502,445,0,0,66,66,0,1,0,1,0
62202,445,0,0,70,70,0,1,0,1,0
55093,445,0,0,70,70,0,1,0,1,0
49585,445,0,0,66,66,0,1,0,1,0
53652,445,0,0,67,67,0,1,0,1,0
52188,445,0,0,70,70,0,1,0,1,0
57710,445,0,0,70,70,0,1,0,1,0
51672,445,0,0,70,70,0,1,0,1,0
52483,445,0,0,70,70,0,1,0,1,0
58996,445,0,0,66,66,0,1,0,1,0
52087,445,0,0,66,66,0,1,0,1,0
55851,445,0,0,69,69,0,1,0,1,0
64807,445,0,0,66,66,0,1,0,1,0
61063,445,0,0,66,66,0,1,0,1,0
56985,445,0,0,70,70,0,1,0,1,0
62364,445,0,0,66,66,0,1,0,1,0
55273,445,0,0,67,67,0,1,0,1,0
55228,445,0,0,70,70,0,1,0,1,0
62620,445,0,0,70,70,0,1,0,1,0
50195,445,0,0,70,70,0,1,0,1,0
63020,445,0,0,70,70,0,1,0,1,0
52771,445,0,0,70,70,0,1,0,1,0
65445,445,0,0,68,68,0,1,0,1,0
50288,445,0,0,70,70,0,1,0,1,0
62390,445,0,0,70,70,0,1,0,1,0
49678,445,0,0,70,70,0,1,0,1,0
52920,445,0,0,69,69,0,1,0,1,0
59451,445,0,0,66,66,0,1,0,1,0
60402,445,0,0,70,70,0,1,0,1,0
62232,445,0,0,67,67,0,1,0,1,0
65006,445,0,0,66,66,0,1,0,1,0
64346,445,0,0,70,70,0,1,0,1,0
60464,445,0,0,70,70,0,1,0,1,0
55863,445,0,0,68,68,0,1,0,1,0
58691,445,0,0,66,66,0,1,0,1,0
53608,445,0,0,67,67,0,1,0,1,0
62227,445,0,0,67,67,0,1,0,1,0
56581,445,0,0,68,68,0,1,0,1,0
65502,445,0,0,69,69,0,1,0,1,0
53864,445,0,0,66,66,0,1,0,1,0
50837,445,0,0,70,70,0,1,0,1,0
54348,445,0,0,70,70,0,1,0,1,0
50228,445,0,0,66,66,0,1,0,1,0
50977,445,0,0,66,66,0,1,0,1,0
55641,445,0,0,70,70,0,1,0,1,0
52534,445,0,0,70,70,0,1,0,1,0
61867,445,0,0,66,66,0,1,0,1,0
52949,445,0,0,70,70,0,1,0,1,0
61904,445,0,0,70,70,0,1,0,1,0
64235,445,0,0,66,66,0,1,0,1,0
55996,445,0,0,70,70,0,1,0,1,0
61173,445,0,0,70,70,0,1,0,1,0
55102,445,0,0,66,66,0,1,0,1,0
55159,445,0,0,68,68,0,1,0,1,0
65528,445,0,0,70,70,0,1,0,1,0
57196,445,0,0,70,70,0,1,0,1,0
59198,445,0,0,70,70,0,1,0,1,0
58818,445,0,0,66,66,0,1,0,1,0
63967,445,0,0,66,66,0,1,0,1,0
55105,445,0,0,70,70,0,1,0,1,0
54052,445,0,0,70,70,0,1,0,1,0
64321,445,0,0,70,70,0,1,0,1,0
64436,445,0,0,70,70,0,1,0,1,0
51439,445,0,0,70,70,0,1,0,1,0
51935,445,0,0,70,70,0,1,0,1,0
49401,445,0,0,66,66,0,1,0,1,0
51694,445,0,0,70,70,0,1,0,1,0
57519,445,0,0,70,70,0,1,0,1,0
59586,445,0,0,70,70,0,1,0,1,0
55567,445,0,0,70,70,0,1,0,1,0
63646,445,0,0,66,66,0,1,0,1,0
61249,445,0,0,70,70,0,1,0,1,0
62665,445,0,0,66,66,0,1,0,1,0
61162,445,0,0,69,69,0,1,0,1,0
64605,445,0,0,70,70,0,1,0,1,0
63231,445,0,0,70,70,0,1,0,1,0
58352,445,0,0,70,70,0,1,0,1,0
53930,445,0,0,70,70,0,1,0,1,0
57929,445,0,0,70,70,0,1,0,1,0
57653,445,0,0,70,70,0,1,0,1,0
52760,445,0,0,70,70,0,1,0,1,0
50780,445,0,0,70,70,0,1,0,1,0
63240,445,0,0,66,66,0,1,0,1,0
49561,445,0,0,70,70,0,1,0,1,0
61017,445,0,0,70,70,0,1,0,1,0
49937,445,0,0,70,70,0,1,0,1,0
58501,445,0,0,66,66,0,1,0,1,0
55132,445,0,0,70,70,0,1,0,1,0
50735,445,0,0,66,66,0,1,0,1,0
62179,445,0,0,70,70,0,1,0,1,0
63070,445,0,0,66,66,0,1,0,1,0
53526,445,0,0,69,69,0,1,0,1,0
62565,445,0,0,66,66,0,1,0,1,0
51295,445,0,0,66,66,0,1,0,1,0
55319,445,0,0,67,67,0,1,0,1,0
53243,445,0,0,67,67,0,1,0,1,0
50856,445,0,0,66,66,0,1,0,1,0
57101,445,0,0,70,70,0,1,0,1,0
51825,445,0,0,67,67,0,1,0,1,0
55490,445,0,0,70,70,0,1,0,1,0
58555,445,0,0,70,70,0,1,0,1,0
54247,445,0,0,66,66,0,1,0,1,0
61930,445,0,0,66,66,0,1,0,1,0
52849,445,0,0,70,70,0,1,0,1,0
56005,445,0,0,70,70,0,1,0,1,0
60872,445,0,0,66,66,0,1,0,1,0
52454,445,0,0,70,70,0,1,0,1,0
49412,445,0,0,68,68,0,1,0,1,0
55131,445,0,0,70,70,0,1,0,1,0
54538,445,0,0,70,70,0,1,0,1,0
51243,445,0,0,66,66,0,1,0,1,0
54972,445,0,0,66,66,0,1,0,1,0
55538,445,0,0,70,70,0,1,0,1,0
54551,445,0,0,66,66,0,1,0,1,0
50951,445,0,0,70,70,0,1,0,1,0
59918,445,0,0,66,66,0,1,0,1,0
49478,445,0,0,70,70,0,1,0,1,0
51502,445,0,0,66,66,0,1,0,1,0
55657,445,0,0,70,70,0,1,0,1,0
57352,445,0,0,67,67,0,1,0,1,0
59155,445,0,0,67,67,0,1,0,1,0
55406,445,0,0,70,70,0,1,0,1,0
63466,445,0,0,70,70,0,1,0,1,0
53012,445,0,0,67,67,0,1,0,1,0
54329,445,0,0,70,70,0,1,0,1,0
63556,445,0,0,70,70,0,1,0,1,0
55851,445,0,0,69,69,0,1,0,1,0
52173,445,0,0,67,67,0,1,0,1,0
52700,445,0,0,70,70,0,1,0,1,0
64192,445,0,0,67,67,0,1,0,1,0
63330,445,0,0,66,66,0,1,0,1,0
50270,445,0,0,70,70,0,1,0,1,0
57039,445,0,0,70,70,0,1,0,1,0
50075,445,0,0,70,70,0,1,0,1,0
54931,445,0,0,66,66,0,1,0,1,0
61284,445,0,0,66,66,0,1,0,1,0
49713,445,0,0,66,66,0,1,0,1,0
50609,445,0,0,66,66,0,1,0,1,0
63052,445,0,0,68,68,0,1,0,1,0
63195,445,0,0,70,70,0,1,0,1,0
62488,445,0,0,66,66,0,1,0,1,0
52883,445,0,0,66,66,0,1,0,1,0
50907,445,0,0,66,66,0,1,0,1,0
50845,445,0,0,66,66,0,1,0,1,0
55358,445,0,0,70,70,0,1,0,1,0
54090,445,0,0,66,66,0,1,0,1,0
59638,445,0,0,67,67,0,1,0,1,0
57536,445,0,0,70,70,0,1,0,1,0
63073,445,0,0,68,68,0,1,0,1,0
49460,445,0,0,70,70,0,1,0,1,0
63160,445,0,0,66,66,0,1,0,1,0
57230,445,0,0,70,70,0,1,0,1,0
57531,445,0,0,66,66,0,1,0,1,0
50251,445,0,0,70,70,0,1,0,1,0
62807,445,0,0,70,70,0,1,0,1,0
64391,445,0,0,68,68,0,1,0,1,0
50218,445,0,0,70,70,0,1,0,1,0
60616,445,0,0,66,66,0,1,0,1,0
54869,445,0,0,70,70,0,1,0,1,0
63551,445,0,0,68,68,0,1,0,1,0
62889,445,0,0,66,66,0,1,0,1,0
63972,445,0,0,69,69,0,1,0,1,0
56342,445,0,0,66,66,0,1,0,1,0
64404,445,0,0,70,70,0,1,0,1,0
60096,445,0,0,66,66,0,1,0,1,0
53685,445,0,0,66,66,0,1,0,1,0
50721,445,0,0,68,68,0,1,0,1,0
56489,445,0,0,70,70,0,1,0,1,0
53438,445,0,0,70,70,0,1,0,1,0
63684,445,0,0,70,70,0,1,0,1,0
52748,445,0,0,70,70,0,1,0,1,0
55666,445,0,0,70,70,0,1,0,1,0
60173,445,0,0,70,70,0,1,0,1,0
60811,445,0,0,70,70,0,1,0,1,0
55912,445,0,0,68,68,0,1,0,1,0
49597,445,0,0,70,70,0,1,0,1,0
53773,445,0,0,66,66,0,1,0,1,0
64313,445,0,0,70,70,0,1,0,1,0
64937,445,0,0,67,67,0,1,0,1,0
60963,445,0,0,70,70,0,1,0,1,0
65466,445,0,0,67,67,0,1,0,1,0
65410,445,0,0,70,70,0,1,0,1,0
53577,445,0,0,66,66,0,1,0,1,0
65111,445,0,0,70,70,0,1,0,1,0
59077,445,0,0,66,66,0,1,0,1,0
59088,445,0,0,69,69,0,1,0,1,0
62371,445,0,0,70,70,0,1,0,1,0
63212,445,0,0,67,67,0,1,0,1,0
63050,445,0,0,68,68,0,1,0,1,0
57531,445,0,0,70,70,0,1,0,1,0
64151,445,0,0,70,70,0,1,0,1,0
63213,445,0,0,69,69,0,1,0,1,0
52585,445,0,0,68,68,0,1,0,1,0
63940,445,0,0,70,70,0,1,0,1,0
50336,445,0,0,66,66,0,1,0,1,0
52047,445,0,0,70,70,0,1,0,1,0
63436,445,0,0,67,67,0,1,0,1,0
65486,445,0,0,70,70,0,1,0,1,0
49402,445,0,0,66,66,0,1,0,1,0
59080,445,0,0,66,66,0,1,0,1,0
64035,445,0,0,66,66,0,1,0,1,0
58864,445,0,0,70,70,0,1,0,1,0
64729,445,0,0,68,68,0,1,0,1,0
55556,445,0,0,70,70,0,1,0,1,0
61199,445,0,0,70,70,0,1,0,1,0
53076,445,0,0,69,69,0,1,0,1,0
56914,445,0,0,67,67,0,1,0,1,0
49542,445,0,0,66,66,0,1,0,1,0
63202,445,0,0,70,70,0,1,0,1,0
63619,445,0,0,70,70,0,1,0,1,0
58370,445,0,0,66,66,0,1,0,1,0
62210,445,0,0,70,70,0,1,0,1,0
59050,445,0,0,70,70,0,1,0,1,0
61815,445,0,0,70,70,0,1,0,1,0
64555,445,0,0,70,70,0,1,0,1,0
52984,445,0,0,66,66,0,1,0,1,0
60786,445,0,0,70,70,0,1,0,1,0
51945,445,0,0,70,70,0,1,0,1,0
59294,445,0,0,69,69,0,1,0,1,0
50593,445,0,0,66,66,0,1,0,1,0
51106,445,0,0,66,66,0,1,0,1,0
50837,445,0,0,70,70,0,1,0,1,0
56278,445,0,0,70,70,0,1,0,1,0
54353,445,0,0,67,67,0,1,0,1,0
62166,445,0,0,70,70,0,1,0,1,0
51676,445,0,0,70,70,0,1,0,1,0
51441,445,0,0,69,69,0,1,0,1,0
54508,445,0,0,70,70,0,1,0,1,0
49873,445,0,0,70,70,0,1,0,1,0
60747,445,0,0,69,69,0,1,0,1,0
51027,445,0,0,70,70,0,1,0,1,0
63289,445,0,0,70,70,0,1,0,1,0
51568,445,0,0,66,66,0,1,0,1,0
61996,445,0,0,69,69,0,1,0,1,0
54987,445,0,0,67,67,0,1,0,1,0
55955,445,0,0,70,70,0,1,0,1,0
50507,445,0,0,70,70,0,1,0,1,0
49833,445,0,0,70,70,0,1,0,1,0
50848,445,0,0,70,70,0,1,0,1,0
51862,445,0,0,70,70,0,1,0,1,0
65476,445,0,0,69,69,0,1,0,1,0
54150,445,0,0,70,70,0,1,0,1,0
52379,445,0,0,68,68,0,1,0,1,0
60126,445,0,0,70,70,0,1,0,1,0
56806,445,0,0,70,70,0,1,0,1,0
62379,445,0,0,70,70,0,1,0,1,0
53950,445,0,0,66,66,0,1,0,1,0
58244,445,0,0,66,66,0,1,0,1,0
49472,445,0,0,70,70,0,1,0,1,0
56893,445,0,0,66,66,0,1,0,1,0
54709,445,0,0,66,66,0,1,0,1,0
51631,445,0,0,70,70,0,1,0,1,0
50265,445,0,0,70,70,0,1,0,1,0
64803,445,0,0,70,70,0,1,0,1,0
61622,445,0,0,66,66,0,1,0,1,0
54358,445,0,0,70,70,0,1,0,1,0
64845,445,0,0,70,70,0,1,0,1,0
55229,445,0,0,70,70,0,1,0,1,0
65188,445,0,0,70,70,0,1,0,1,0
57616,445,0,0,70,70,0,1,0,1,0
57477,445,0,0,68,68,0,1,0,1,0
56023,445,0,0,68,68,0,1,0,1,0
50524,445,0,0,68,68,0,1,0,1,0
52883,445,0,0,70,70,0,1,0,1,0
60689,445,0,0,68,68,0,1,0,1,0
51434,445,0,0,70,70,0,1,0,1,0
57291,445,0,0,70,70,0,1,0,1,0
65335,445,0,0,70,70,0,1,0,1,0
60375,445,0,0,70,70,0,1,0,1,0
56832,445,0,0,70,70,0,1,0,1,0
50546,445,0,0,66,66,0,1,0,1,0
55447,445,0,0,70,70,0,1,0,1,0
52599,445,0,0,66,66,0,1,0,1,0
56615,445,0,0,70,70,0,1,0,1,0
53496,445,0,0,66,66,0,1,0,1,0
51782,445,0,0,70,70,0,1,0,1,0
51162,445,0,0,70,70,0,1,0,1,0
62913,445,0,0,70,70,0,1,0,1,0
50684,445,0,0,70,70,0,1,0,1,0
63793,445,0,0,70,70,0,1,0,1,0
57453,445,0,0,70,70,0,1,0,1,0
62936,445,0,0,67,67,0,1,0,1,0
52378,445,0,0,70,70,0,1,0,1,0
64162,445,0,0,70,70,0,1,0,1,0
61447,445,0,0,66,66,0,1,0,1,0
64211,445,0,0,70,70,0,1,0,1,0
50816,445,0,0,70,70,0,1,0,1,0
54967,445,0,0,69,69,0,1,0,1,0
53726,445,0,0,70,70,0,1,0,1,0
50866,445,0,0,66,66,0,1,0,1,0
55724,445,0,0,70,70,0,1,0,1,0
49411,445,0,0,69,69,0,1,0,1,0
52299,445,0,0,66,66,0,1,0,1,0
60529,445,0,0,70,70,0,1,0,1,0
64882,445,0,0,67,67,0,1,0,1,0
60353,445,0,0,70,70,0,1,0,1,0
59320,445,0,0,70,70,0,1,0,1,0
61252,445,0,0,70,70,0,1,0,1,0
49884,445,0,0,70,70,0,1,0,1,0
58958,445,0,0,70,70,0,1,0,1,0
61731,445,0,0,70,70,0,1,0,1,0
54990,445,0,0,70,70,0,1,0,1,0
59475,445,0,0,66,66,0,1,0,1,0
63902,445,0,0,66,66,0,1,0,1,0
54962,445,0,0,68,68,0,1,0,1,0
56990,445,0,0,70,70,0,1,0,1,0
64565,445,0,0,70,70,0,1,0,1,0
56053,445,0,0,70,70,0,1,0,1,0
56792,445,0,0,70,70,0,1,0,1,0
65137,445,0,0,66,66,0,1,0,1,0
53189,445,0,0,66,66,0,1,0,1,0
57443,445,0,0,69,69,0,1,0,1,0
54872,445,0,0,70,70,0,1,0,1,0
62586,445,0,0,70,70,0,1,0,1,0
57930,445,0,0,70,70,0,1,0,1,0
54890,445,0,0,70,70,0,1,0,1,0
55998,445,0,0,66,66,0,1,0,1,0
63439,445,0,0,66,66,0,1,0,1,0
56303,445,0,0,66,66,0,1,0,1,0
50828,445,0,0,70,70,0,1,0,1,0
59940,445,0,0,70,70,0,1,0,1,0
62724,445,0,0,70,70,0,1,0,1,0
49369,445,0,0,70,70,0,1,0,1,0
50887,445,0,0,70,70,0,1,0,1,0
60302,445,0,0,67,67,0,1,0,1,0
54192,445,0,0,70,70,0,1,0,1,0
59015,445,0,0,66,66,0,1,0,1,0
64423,445,0,0,66,66,0,1,0,1,0
60405,445,0,0,70,70,0,1,0,1,0
54331,445,0,0,70,70,0,1,0,1,0
51593,445,0,0,70,70,0,1,0,1,0
50524,445,0,0,70,70,0,1,0,1,0
60148,445,0,0,66,66,0,1,0,1,0
55514,445,0,0,70,70,0,1,0,1,0
53047,445,0,0,70,70,0,1,0,1,0
50364,445,0,0,69,69,0,1,0,1,0
55980,445,0,0,70,70,0,1,0,1,0
59357,445,0,0,70,70,0,1,0,1,0
54233,445,0,0,70,70,0,1,0,1,0
53765,445,0,0,70,70,0,1,0,1,0
52067,445,0,0,70,70,0,1,0,1,0
56745,445,0,0,66,66,0,1,0,1,0
53417,445,0,0,68,68,0,1,0,1,0
65196,445,0,0,68,68,0,1,0,1,0
57347,445,0,0,66,66,0,1,0,1,0
57943,445,0,0,70,70,0,1,0,1,0
51675,445,0,0,70,70,0,1,0,1,0
51160,445,0,0,70,70,0,1,0,1,0
61179,445,0,0,70,70,0,1,0,1,0
52632,445,0,0,70,70,0,1,0,1,0
53753,445,0,0,66,66,0,1,0,1,0
58677,445,0,0,69,69,0,1,0,1,0
52064,445,0,0,70,70,0,1,0,1,0
56896,445,0,0,66,66,0,1,0,1,0
56337,445,0,0,70,70,0,1,0,1,0
53805,445,0,0,70,70,0,1,0,1,0
55647,445,0,0,70,70,0,1,0,1,0
51728,445,0,0,67,67,0,1,0,1,0
49970,445,0,0,66,66,0,1,0,1,0
59314,445,0,0,70,70,0,1,0,1,0
50290,445,0,0,70,70,0,1,0,1,0
52671,445,0,0,67,67,0,1,0,1,0
59972,445,0,0,66,66,0,1,0,1,0
50273,445,0,0,70,70,0,1,0,1,0
53715,445,0,0,70,70,0,1,0,1,0
49762,445,0,0,66,66,0,1,0,1,0
54677,445,0,0,67,67,0,1,0,1,0
62296,445,0,0,68,68,0,1,0,1,0
56583,445,0,0,70,70,0,1,0,1,0
62011,445,0,0,66,66,0,1,0,1,0
52300,445,0,0,68,68,0,1,0,1,0
65531,445,0,0,66,66,0,1,0,1,0
55833,445,0,0,67,67,0,1,0,1,0
50735,445,0,0,66,66,0,1,0,1,0
50685,445,0,0,70,70,0,1,0,1,0
59967,445,0,0,70,70,0,1,0,1,0
58683,445,0,0,66,66,0,1,0,1,0
50069,445,0,0,70,70,0,1,0,1,0
49970,445,0,0,70,70,0,1,0,1,0
56938,445,0,0,70,70,0,1,0,1,0
64585,445,0,0,67,67,0,1,0,1,0
49685,445,0,0,67,67,0,1,0,1,0
61389,445,0,0,66,66,0,1,0,1,0
62775,445,0,0,68,68,0,1,0,1,0
53243,445,0,0,68,68,0,1,0,1,0
53932,445,0,0,66,66,0,1,0,1,0
54275,445,0,0,70,70,0,1,0,1,0
51069,445,0,0,66,66,0,1,0,1,0
57186,445,0,0,70,70,0,1,0,1,0
58889,445,0,0,66,66,0,1,0,1,0
60994,445,0,0,70,70,0,1,0,1,0
51657,445,0,0,70,70,0,1,0,1,0
57789,445,0,0,66,66,0,1,0,1,0
62225,445,0,0,70,70,0,1,0,1,0
60773,445,0,0,66,66,0,1,0,1,0
51288,445,0,0,70,70,0,1,0,1,0
59050,445,0,0,70,70,0,1,0,1,0
62910,445,0,0,70,70,0,1,0,1,0
62725,445,0,0,70,70,0,1,0,1,0
51042,445,0,0,70,70,0,1,0,1,0
54955,445,0,0,70,70,0,1,0,1,0
58198,445,0,0,70,70,0,1,0,1,0
62815,445,0,0,66,66,0,1,0,1,0
50819,445,0,0,66,66,0,1,0,1,0
51871,445,0,0,68,68,0,1,0,1,0
57353,445,0,0,70,70,0,1,0,1,0
53598,445,0,0,70,70,0,1,0,1,0
49662,445,0,0,70,70,0,1,0,1,0
62202,445,0,0,66,66,0,1,0,1,0
64949,445,0,0,70,70,0,1,0,1,0
54276,445,0,0,70,70,0,1,0,1,0
64540,445,0,0,70,70,0,1,0,1,0
62488,445,0,0,66,66,0,1,0,1,0
55814,445,0,0,70,70,0,1,0,1,0
54959,445,0,0,70,70,0,1,0,1,0
65071,445,0,0,70,70,0,1,0,1,0
63937,445,0,0,70,70,0,1,0,1,0
50837,445,0,0,69,69,0,1,0,1,0
51806,445,0,0,70,70,0,1,0,1,0
53269,445,0,0,70,70,0,1,0,1,0
61337,445,0,0,66,66,0,1,0,1,0
64556,445,0,0,70,70,0,1,0,1,0
58894,445,0,0,66,66,0,1,0,1,0
60084,445,0,0,70,70,0,1,0,1,0
56499,445,0,0,66,66,0,1,0,1,0
51825,445,0,0,68,68,0,1,0,1,0
51123,445,0,0,66,66,0,1,0,1,0
52199,445,0,0,66,66,0,1,0,1,0
54593,445,0,0,68,68,0,1,0,1,0
61800,445,0,0,69,69,0,1,0,1,0
52207,445,0,0,70,70,0,1,0,1,0
54396,445,0,0,66,66,0,1,0,1,0
53292,445,0,0,66,66,0,1,0,1,0
53946,445,0,0,66,66,0,1,0,1,0
54526,445,0,0,69,69,0,1,0,1,0
58054,445,0,0,66,66,0,1,0,1,0
62528,445,0,0,70,70,0,1,0,1,0
62999,445,0,0,66,66,0,1,0,1,0
52312,445,0,0,70,70,0,1,0,1,0
60783,445,0,0,70,70,0,1,0,1,0
50497,445,0,0,70,70,0,1,0,1,0
52983,445,0,0,66,66,0,1,0,1,0
59016,445,0,0,70,70,0,1,0,1,0
52178,445,0,0,70,70,0,1,0,1,0
64032,445,0,0,67,67,0,1,0,1,0
65515,445,0,0,66,66,0,1,0,1,0
62913,445,0,0,70,70,0,1,0,1,0
56914,445,0,0,66,66,0,1,0,1,0
52069,445,0,0,70,70,0,1,0,1,0
60166,445,0,0,70,70,0,1,0,1,0
52826,445,0,0,70,70,0,1,0,1,0
51116,445,0,0,67,67,0,1,0,1,0
62485,445,0,0,66,66,0,1,0,1,0
51597,445,0,0,70,70,0,1,0,1,0
55084,445,0,0,70,70,0,1,0,1,0
55131,445,0,0,70,70,0,1,0,1,0
61553,445,0,0,70,70,0,1,0,1,0
51560,445,0,0,70,70,0,1,0,1,0
59177,445,0,0,68,68,0,1,0,1,0
64604,445,0,0,66,66,0,1,0,1,0
55799,445,0,0,70,70,0,1,0,1,0
64587,445,0,0,67,67,0,1,0,1,0
60601,445,0,0,70,70,0,1,0,1,0
55745,445,0,0,70,70,0,1,0,1,0
59276,445,0,0,66,66,0,1,0,1,0
55608,445,0,0,70,70,0,1,0,1,0
57884,445,0,0,70,70,0,1,0,1,0
50672,445,0,0,66,66,0,1,0,1,0
62834,445,0,0,70,70,0,1,0,1,0
59738,445,0,0,70,70,0,1,0,1,0
51205,445,0,0,70,70,0,1,0,1,0
54397,445,0,0,66,66,0,1,0,1,0
61463,445,0,0,67,67,0,1,0,1,0
60506,445,0,0,66,66,0,1,0,1,0
53684,445,0,0,66,66,0,1,0,1,0
62569,445,0,0,69,69,0,1,0,1,0
59068,445,0,0,70,70,0,1,0,1,0
51172,445,0,0,70,70,0,1,0,1,0
59590,445,0,0,70,70,0,1,0,1,0
59018,445,0,0,66,66,0,1,0,1,0
64082,445,0,0,67,67,0,1,0,1,0
51678,445,0,0,70,70,0,1,0,1,0
52224,445,0,0,70,70,0,1,0,1,0
55557,445,0,0,70,70,0,1,0,1,0
60191,445,0,0,69,69,0,1,0,1,0
55573,445,0,0,66,66,0,1,0,1,0
54059,445,0,0,66,66,0,1,0,1,0
59141,445,0,0,70,70,0,1,0,1,0
53705,445,0,0,67,67,0,1,0,1,0
59169,445,0,0,68,68,0,1,0,1,0
50272,445,0,0,70,70,0,1,0,1,0
51343,445,0,0,70,70,0,1,0,1,0
54130,445,0,0,70,70,0,1,0,1,0
63527,445,0,0,66,66,0,1,0,1,0
52333,445,0,0,70,70,0,1,0,1,0
56537,445,0,0,70,70,0,1,0,1,0
54776,445,0,0,66,66,0,1,0,1,0
57701,445,0,0,70,70,0,1,0,1,0
55403,445,0,0,68,68,0,1,0,1,0
54489,445,0,0,70,70,0,1,0,1,0
50019,445,0,0,70,70,0,1,0,1,0
60593,445,0,0,69,69,0,1,0,1,0
56005,445,0,0,66,66,0,1,0,1,0
58397,445,0,0,70,70,0,1,0,1,0
59839,445,0,0,66,66,0,1,0,1,0
65227,445,0,0,70,70,0,1,0,1,0
55558,445,0,0,70,70,0,1,0,1,0
57078,445,0,0,68,68,0,1,0,1,0
65197,445,0,0,70,70,0,1,0,1,0
62586,445,0,0,69,69,0,1,0,1,0
50463,445,0,0,70,70,0,1,0,1,0
53267,445,0,0,66,66,0,1,0,1,0
57428,445,0,0,66,66,0,1,0,1,0
59701,445,0,0,70,70,0,1,0,1,0
52976,445,0,0,70,70,0,1,0,1,0
64986,445,0,0,66,66,0,1,0,1,0
54566,445,0,0,70,70,0,1,0,1,0
51380,445,0,0,66,66,0,1,0,1,0
63273,445,0,0,70,70,0,1,0,1,0
51501,445,0,0,70,70,0,1,0,1,0
50413,445,0,0,66,66,0,1,0,1,0
59550,445,0,0,66,66,0,1,0,1,0
53753,445,0,0,66,66,0,1,0,1,0
60177,445,0,0,66,66,0,1,0,1,0
56509,445,0,0,66,66,0,1,0,1,0
56277,445,0,0,66,66,0,1,0,1,0
60548,445,0,0,70,70,0,1,0,1,0
54812,445,0,0,68,68,0,1,0,1,0
64657,445,0,0,70,70,0,1,0,1,0
63209,445,0,0,70,70,0,1,0,1,0
60015,445,0,0,70,70,0,1,0,1,0
50711,445,0,0,70,70,0,1,0,1,0
63670,445,0,0,67,67,0,1,0,1,0
63070,445,0,0,70,70,0,1,0,1,0
64462,445,0,0,70,70,0,1,0,1,0
52059,445,0,0,70,70,0,1,0,1,0
50364,445,0,0,68,68,0,1,0,1,0
55644,445,0,0,70,70,0,1,0,1,0
61879,445,0,0,70,70,0,1,0,1,0
50885,445,0,0,67,67,0,1,0,1,0
55192,445,0,0,69,69,0,1,0,1,0
50978,445,0,0,66,66,0,1,0,1,0
62085,445,0,0,70,70,0,1,0,1,0
64543,445,0,0,70,70,0,1,0,1,0
55814,445,0,0,70,70,0,1,0,1,0
64179,445,0,0,68,68,0,1,0,1,0
50942,445,0,0,70,70,0,1,0,1,0
64810,445,0,0,66,66,0,1,0,1,0
51946,445,0,0,70,70,0,1,0,1,0
62489,445,0,0,66,66,0,1,0,1,0
59997,445,0,0,70,70,0,1,0,1,0
58768,445,0,0,70,70,0,1,0,1,0
52633,445,0,0,70,70,0,1,0,1,0
59335,445,0,0,66,66,0,1,0,1,0
59143,445,0,0,70,70,0,1,0,1,0
64884,445,0,0,70,70,0,1,0,1,0
62538,445,0,0,66,66,0,1,0,1,0
52858,445,0,0,70,70,0,1,0,1,0
53459,445,0,0,70,70,0,1,0,1,0
51979,445,0,0,69,69,0,1,0,1,0
59339,445,0,0,67,67,0,1,0,1,0
58419,445,0,0,70,70,0,1,0,1,0
56617,445,0,0,70,70,0,1,0,1,0
55515,445,0,0,70,70,0,1,0,1,0
58262,445,0,0,69,69,0,1,0,1,0
55515,445,0,0,70,70,0,1,0,1,0
52522,445,0,0,70,70,0,1,0,1,0
60310,445,0,0,66,66,0,1,0,1,0
58793,445,0,0,67,67,0,1,0,1,0
56942,445,0,0,70,70,0,1,0,1,0
59348,445,0,0,70,70,0,1,0,1,0
64460,445,0,0,70,70,0,1,0,1,0
54680,445,0,0,70,70,0,1,0,1,0
57263,445,0,0,68,68,0,1,0,1,0
59474,445,0,0,66,66,0,1,0,1,0
54543,445,0,0,70,70,0,1,0,1,0
56262,445,0,0,70,70,0,1,0,1,0
49466,445,0,0,68,68,0,1,0,1,0
59343,445,0,0,70,70,0,1,0,1,0
54507,445,0,0,70,70,0,1,0,1,0
62681,445,0,0,68,68,0,1,0,1,0
63456,445,0,0,66,66,0,1,0,1,0
60936,445,0,0,68,68,0,1,0,1,0
50711,445,0,0,70,70,0,1,0,1,0
64472,445,0,0,66,66,0,1,0,1,0
65376,445,0,0,66,66,0,1,0,1,0
50867,445,0,0,70,70,0,1,0,1,0
61295,445,0,0,66,66,0,1,0,1,0
64245,445,0,0,69,69,0,1,0,1,0
63565,445,0,0,67,67,0,1,0,1,0
63557,445,0,0,70,70,0,1,0,1,0
52755,445,0,0,70,70,0,1,0,1,0
61220,445,0,0,70,70,0,1,0,1,0
57925,445,0,0,70,70,0,1,0,1,0
50289,445,0,0,70,70,0,1,0,1,0
57268,445,0,0,69,69,0,1,0,1,0
54403,445,0,0,70,70,0,1,0,1,0
64734,445,0,0,70,70,0,1,0,1,0
50572,445,0,0,70,70,0,1,0,1,0
51620,445,0,0,66,66,0,1,0,1,0
64562,445,0,0,70,70,0,1,0,1,0
57120,445,0,0,66,66,0,1,0,1,0
52313,445,0,0,70,70,0,1,0,1,0
60487,445,0,0,66,66,0,1,0,1,0
61331,445,0,0,70,70,0,1,0,1,0
55520,445,0,0,70,70,0,1,0,1,0
54956,445,0,0,70,70,0,1,0,1,0
52882,445,0,0,68,68,0,1,0,1,0
53123,445,0,0,67,67,0,1,0,1,0
50784,445,0,0,70,70,0,1,0,1,0
55713,445,0,0,66,66,0,1,0,1,0
59516,445,0,0,70,70,0,1,0,1,0
52636,445,0,0,70,70,0,1,0,1,0
59327,445,0,0,69,69,0,1,0,1,0
53702,445,0,0,68,68,0,1,0,1,0
57704,445,0,0,70,70,0,1,0,1,0
60044,445,0,0,67,67,0,1,0,1,0
59686,445,0,0,66,66,0,1,0,1,0
53114,445,0,0,66,66,0,1,0,1,0
65335,445,0,0,69,69,0,1,0,1,0
65233,445,0,0,70,70,0,1,0,1,0
50489,445,0,0,70,70,0,1,0,1,0
54571,445,0,0,70,70,0,1,0,1,0
53425,445,0,0,66,66,0,1,0,1,0
53147,445,0,0,69,69,0,1,0,1,0
49498,445,0,0,70,70,0,1,0,1,0
50609,445,0,0,66,66,0,1,0,1,0
62232,445,0,0,66,66,0,1,0,1,0
64936,445,0,0,66,66,0,1,0,1,0
53431,445,0,0,68,68,0,1,0,1,0
51015,445,0,0,66,66,0,1,0,1,0
65324,445,0,0,66,66,0,1,0,1,0
62643,445,0,0,70,70,0,1,0,1,0
55607,445,0,0,70,70,0,1,0,1,0
58807,445,0,0,70,70,0,1,0,1,0
50292,445,0,0,66,66,0,1,0,1,0
62384,445,0,0,70,70,0,1,0,1,0
64512,445,0,0,70,70,0,1,0,1,0
55721,445,0,0,70,70,0,1,0,1,0
54786,445,0,0,70,70,0,1,0,1,0
64597,445,0,0,70,70,0,1,0,1,0
59357,445,0,0,68,68,0,1,0,1,0
58317,445,0,0,68,68,0,1,0,1,0
55571,445,0,0,70,70,0,1,0,1,0
59571,445,0,0,70,70,0,1,0,1,0
63212,445,0,0,68,68,0,1,0,1,0
58632,445,0,0,70,70,0,1,0,1,0
64193,445,0,0,69,69,0,1,0,1,0
65193,445,0,0,66,66,0,1,0,1,0
61144,445,0,0,70,70,0,1,0,1,0
59664,445,0,0,66,66,0,1,0,1,0
55491,445,0,0,70,70,0,1,0,1,0
52591,445,0,0,70,70,0,1,0,1,0
59296,445,0,0,70,70,0,1,0,1,0
55250,445,0,0,70,70,0,1,0,1,0
49493,445,0,0,70,70,0,1,0,1,0
60530,445,0,0,70,70,0,1,0,1,0
61113,445,0,0,70,70,0,1,0,1,0
58504,445,0,0,70,70,0,1,0,1,0
65269,445,0,0,70,70,0,1,0,1,0
50946,445,0,0,70,70,0,1,0,1,0
61865,445,0,0,67,67,0,1,0,1,0
64976,445,0,0,70,70,0,1,0,1,0
64006,445,0,0,70,70,0,1,0,1,0
60050,445,0,0,66,66,0,1,0,1,0
52508,445,0,0,66,66,0,1,0,1,0
51806,445,0,0,70,70,0,1,0,1,0
59286,445,0,0,70,70,0,1,0,1,0
53654,445,0,0,70,70,0,1,0,1,0
64632,445,0,0,66,66,0,1,0,1,0
49320,445,0,0,70,70,0,1,0,1,0
52404,445,0,0,66,66,0,1,0,1,0
53763,445,0,0,70,70,0,1,0,1,0
60303,445,0,0,67,67,0,1,0,1,0
55631,445,0,0,66,66,0,1,0,1,0
64289,445,0,0,66,66,0,1,0,1,0
56556,445,0,0,69,69,0,1,0,1,0
63130,445,0,0,66,66,0,1,0,1,0
64362,445,0,0,67,67,0,1,0,1,0
55288,445,0,0,70,70,0,1,0,1,0
64811,445,0,0,67,67,0,1,0,1,0
63474,445,0,0,70,70,0,1,0,1,0
49773,445,0,0,68,68,0,1,0,1,0
62301,445,0,0,70,70,0,1,0,1,0
59344,445,0,0,70,70,0,1,0,1,0
55726,445,0,0,68,68,0,1,0,1,0
64999,445,0,0,66,66,0,1,0,1,0
58441,445,0,0,66,66,0,1,0,1,0
63700,445,0,0,70,70,0,1,0,1,0
56968,445,0,0,66,66,0,1,0,1,0
55602,445,0,0,66,66,0,1,0,1,0
58966,445,0,0,70,70,0,1,0,1,0
63843,445,0,0,66,66,0,1,0,1,0
62060,445,0,0,70,70,0,1,0,1,0
57831,445,0,0,70,70,0,1,0,1,0
57072,445,0,0,68,68,0,1,0,1,0
50338,445,0,0,70,70,0,1,0,1,0
52021,445,0,0,66,66,0,1,0,1,0
55779,445,0,0,70,70,0,1,0,1,0
59997,445,0,0,70,70,0,1,0,1,0
55723,445,0,0,70,70,0,1,0,1,0
58933,445,0,0,70,70,0,1,0,1,0
60515,445,0,0,70,70,0,1,0,1,0
56716,445,0,0,70,70,0,1,0,1,0
53751,445,0,0,66,66,0,1,0,1,0
60359,445,0,0,66,66,0,1,0,1,0
55683,445,0,0,70,70,0,1,0,1,0
53077,445,0,0,70,70,0,1,0,1,0
53880,445,0,0,66,66,0,1,0,1,0
56877,445,0,0,70,70,0,1,0,1,0
50419,445,0,0,66,66,0,1,0,1,0
55244,445,0,0,70,70,0,1,0,1,0
57944,445,0,0,70,70,0,1,0,1,0
55591,445,0,0,70,70,0,1,0,1,0
49903,445,0,0,70,70,0,1,0,1,0
60613,445,0,0,66,66,0,1,0,1,0
53279,445,0,0,69,69,0,1,0,1,0
57003,445,0,0,70,70,0,1,0,1,0
55084,445,0,0,70,70,0,1,0,1,0
59485,445,0,0,69,69,0,1,0,1,0
50019,445,0,0,70,70,0,1,0,1,0
64288,445,0,0,66,66,0,1,0,1,0
50783,445,0,0,70,70,0,1,0,1,0
54191,445,0,0,70,70,0,1,0,1,0
58409,445,0,0,70,70,0,1,0,1,0
49279,445,0,0,70,70,0,1,0,1,0
52400,445,0,0,66,66,0,1,0,1,0
57479,445,0,0,66,66,0,1,0,1,0
51115,445,0,0,66,66,0,1,0,1,0
53812,445,0,0,66,66,0,1,0,1,0
59837,445,0,0,66,66,0,1,0,1,0
52432,445,0,0,68,68,0,1,0,1,0
54775,445,0,0,70,70,0,1,0,1,0
55976,445,0,0,70,70,0,1,0,1,0
57646,445,0,0,70,70,0,1,0,1,0
64072,445,0,0,70,70,0,1,0,1,0
58009,445,0,0,68,68,0,1,0,1,0
50425,445,0,0,70,70,0,1,0,1,0
50252,445,0,0,67,67,0,1,0,1,0
53898,445,0,0,69,69,0,1,0,1,0
63041,445,0,0,70,70,0,1,0,1,0
57348,445,0,0,66,66,0,1,0,1,0
63070,445,0,0,70,70,0,1,0,1,0
56235,445,0,0,69,69,0,1,0,1,0
53494,445,0,0,67,67,0,1,0,1,0
51065,445,0,0,66,66,0,1,0,1,0
54463,445,0,0,68,68,0,1,0,1,0
52303,445,0,0,70,70,0,1,0,1,0
55774,445,0,0,70,70,0,1,0,1,0
54320,445,0,0,66,66,0,1,0,1,0
54162,445,0,0,69,69,0,1,0,1,0
58007,445,0,0,67,67,0,1,0,1,0
53771,445,0,0,67,67,0,1,0,1,0
57001,445,0,0,70,70,0,1,0,1,0
55542,445,0,0,66,66,0,1,0,1,0
49883,445,0,0,70,70,0,1,0,1,0
63688,445,0,0,70,70,0,1,0,1,0
54113,445,0,0,70,70,0,1,0,1,0
58312,445,0,0,70,70,0,1,0,1,0
52417,445,0,0,66,66,0,1,0,1,0
63763,445,0,0,70,70,0,1,0,1,0
63084,445,0,0,70,70,0,1,0,1,0
56834,445,0,0,70,70,0,1,0,1,0
56753,445,0,0,66,66,0,1,0,1,0
62358,445,0,0,70,70,0,1,0,1,0
55673,445,0,0,66,66,0,1,0,1,0
61591,445,0,0,70,70,0,1,0,1,0
54047,445,0,0,67,67,0,1,0,1,0
61466,445,0,0,70,70,0,1,0,1,0
61387,445,0,0,66,66,0,1,0,1,0
53654,445,0,0,66,66,0,1,0,1,0
61497,445,0,0,70,70,0,1,0,1,0
62358,445,0,0,69,69,0,1,0,1,0
60152,445,0,0,69,69,0,1,0,1,0
57493,445,0,0,70,70,0,1,0,1,0
57672,445,0,0,70,70,0,1,0,1,0
55743,445,0,0,70,70,0,1,0,1,0
54585,445,0,0,66,66,0,1,0,1,0
60090,445,0,0,70,70,0,1,0,1,0
56016,445,0,0,68,68,0,1,0,1,0
60140,445,0,0,70,70,0,1,0,1,0
58542,445,0,0,70,70,0,1,0,1,0
52135,445,0,0,70,70,0,1,0,1,0
60714,445,0,0,68,68,0,1,0,1,0
59088,445,0,0,69,69,0,1,0,1,0
60756,445,0,0,66,66,0,1,0,1,0
61927,445,0,0,67,67,0,1,0,1,0
63730,445,0,0,67,67,0,1,0,1,0
63668,445,0,0,70,70,0,1,0,1,0
50848,445,0,0,66,66,0,1,0,1,0
53942,445,0,0,66,66,0,1,0,1,0
60569,445,0,0,70,70,0,1,0,1,0
65071,445,0,0,70,70,0,1,0,1,0
61703,445,0,0,66,66,0,1,0,1,0
50652,445,0,0,70,70,0,1,0,1,0
64973,445,0,0,70,70,0,1,0,1,0
55673,445,0,0,66,66,0,1,0,1,0
49265,445,0,0,67,67,0,1,0,1,0
63904,445,0,0,66,66,0,1,0,1,0
62071,445,0,0,70,70,0,1,0,1,0
64729,445,0,0,68,68,0,1,0,1,0
57922,445,0,0,70,70,0,1,0,1,0
55572,445,0,0,66,66,0,1,0,1,0
52394,445,0,0,70,70,0,1,0,1,0
63597,445,0,0,70,70,0,1,0,1,0
56304,445,0,0,66,66,0,1,0,1,0
53484,445,0,0,68,68,0,1,0,1,0
58458,445,0,0,70,70,0,1,0,1,0
56837,445,0,0,66,66,0,1,0,1,0
65340,445,0,0,70,70,0,1,0,1,0
59691,445,0,0,67,67,0,1,0,1,0
60270,445,0,0,70,70,0,1,0,1,0
64305,445,0,0,70,70,0,1,0,1,0
50484,445,0,0,66,66,0,1,0,1,0
51526,445,0,0,67,67,0,1,0,1,0
60097,445,0,0,70,70,0,1,0,1,0
52702,445,0,0,70,70,0,1,0,1,0
50722,445,0,0,66,66,0,1,0,1,0
59100,445,0,0,70,70,0,1,0,1,0
64679,445,0,0,66,66,0,1,0,1,0
57376,445,0,0,68,68,0,1,0,1,0
57944,445,0,0,70,70,0,1,0,1,0
49510,445,0,0,66,66,0,1,0,1,0
64076,445,0,0,70,70,0,1,0,1,0
55085,445,0,0,70,70,0,1,0,1,0
53031,445,0,0,66,66,0,1,0,1,0
50613,445,0,0,70,70,0,1,0,1,0
56060,445,0,0,70,70,0,1,0,1,0
55008,445,0,0,70,70,0,1,0,1,0
54177,445,0,0,70,70,0,1,0,1,0
64312,445,0,0,66,66,0,1,0,1,0
54347,445,0,0,66,66,0,1,0,1,0
64165,445,0,0,70,70,0,1,0,1,0
54570,445,0,0,66,66,0,1,0,1,0
50867,445,0,0,70,70,0,1,0,1,0
56487,445,0,0,70,70,0,1,0,1,0
64632,445,0,0,66,66,0,1,0,1,0
65481,445,0,0,69,69,0,1,0,1,0
60503,445,0,0,68,68,0,1,0,1,0
63498,445,0,0,66,66,0,1,0,1,0
56962,445,0,0,66,66,0,1,0,1,0
62775,445,0,0,70,70,0,1,0,1,0
58090,445,0,0,70,70,0,1,0,1,0
51584,445,0,0,70,70,0,1,0,1,0
50298,445,0,0,70,70,0,1,0,1,0
51283,445,0,0,70,70,0,1,0,1,0
58989,445,0,0,68,68,0,1,0,1,0
51635,445,0,0,66,66,0,1,0,1,0
59403,445,0,0,66,66,0,1,0,1,0
53614,445,0,0,70,70,0,1,0,1,0
59622,445,0,0,70,70,0,1,0,1,0
50079,445,0,0,68,68,0,1,0,1,0
61107,445,0,0,69,69,0,1,0,1,0
60629,445,0,0,66,66,0,1,0,1,0
61015,445,0,0,67,67,0,1,0,1,0
50738,445,0,0,66,66,0,1,0,1,0
53875,445,0,0,70,70,0,1,0,1,0
54926,445,0,0,69,69,0,1,0,1,0
64026,445,0,0,70,70,0,1,0,1,0
50475,445,0,0,68,68,0,1,0,1,0
58677,445,0,0,70,70,0,1,0,1,0
56255,445,0,0,70,70,0,1,0,1,0
64618,445,0,0,66,66,0,1,0,1,0
50865,445,0,0,66,66,0,1,0,1,0
63437,445,0,0,69,69,0,1,0,1,0
62169,445,0,0,70,70,0,1,0,1,0
51293,445,0,0,70,70,0,1,0,1,0
57908,445,0,0,67,67,0,1,0,1,0
55567,445,0,0,70,70,0,1,0,1,0
62980,445,0,0,70,70,0,1,0,1,0
60752,445,0,0,70,70,0,1,0,1,0
50283,445,0,0,66,66,0,1,0,1,0
61158,445,0,0,70,70,0,1,0,1,0
54264,445,0,0,70,70,0,1,0,1,0
62945,445,0,0,69,69,0,1,0,1,0
56471,445,0,0,66,66,0,1,0,1,0
52894,445,0,0,66,66,0,1,0,1,0
55739,445,0,0,66,66,0,1,0,1,0
55216,445,0,0,68,68,0,1,0,1,0
52307,445,0,0,70,70,0,1,0,1,0
64394,445,0,0,70,70,0,1,0,1,0
64583,445,0,0,69,69,0,1,0,1,0
50547,445,0,0,66,66,0,1,0,1,0
62876,445,0,0,69,69,0,1,0,1,0
50665,445,0,0,67,67,0,1,0,1,0
56169,445,0,0,70,70,0,1,0,1,0
51957,445,0,0,66,66,0,1,0,1,0
62171,445,0,0,70,70,0,1,0,1,0
54005,445,0,0,70,70,0,1,0,1,0
53372,445,0,0,66,66,0,1,0,1,0
49401,445,0,0,66,66,0,1,0,1,0
58479,445,0,0,70,70,0,1,0,1,0
60695,445,0,0,66,66,0,1,0,1,0
59017,445,0,0,66,66,0,1,0,1,0
49538,445,0,0,70,70,0,1,0,1,0
50265,445,0,0,70,70,0,1,0,1,0
62993,445,0,0,70,70,0,1,0,1,0
61097,445,0,0,66,66,0,1,0,1,0
61754,445,0,0,70,70,0,1,0,1,0
56474,445,0,0,69,69,0,1,0,1,0
57607,445,0,0,66,66,0,1,0,1,0
53653,445,0,0,68,68,0,1,0,1,0
63538,445,0,0,70,70,0,1,0,1,0
53652,445,0,0,67,67,0,1,0,1,0
64658,445,0,0,66,66,0,1,0,1,0
64373,445,0,0,70,70,0,1,0,1,0
61511,445,0,0,70,70,0,1,0,1,0
56619,445,0,0,70,70,0,1,0,1,0
64556,445,0,0,70,70,0,1,0,1,0
52076,445,0,0,70,70,0,1,0,1,0
63825,445,0,0,66,66,0,1,0,1,0
51502,445,0,0,66,66,0,1,0,1,0
56074,445,0,0,70,70,0,1,0,1,0
65420,445,0,0,66,66,0,1,0,1,0
63983,445,0,0,70,70,0,1,0,1,0
58933,445,0,0,66,66,0,1,0,1,0
59054,445,0,0,70,70,0,1,0,1,0
57750,445,0,0,70,70,0,1,0,1,0
65309,445,0,0,70,70,0,1,0,1,0
62153,445,0,0,66,66,0,1,0,1,0
63302,445,0,0,70,70,0,1,0,1,0
57186,445,0,0,70,70,0,1,0,1,0
65325,445,0,0,68,68,0,1,0,1,0
56468,445,0,0,70,70,0,1,0,1,0
51157,445,0,0,70,70,0,1,0,1,0
60013,445,0,0,70,70,0,1,0,1,0
62147,445,0,0,70,70,0,1,0,1,0
58410,445,0,0,70,70,0,1,0,1,0
57631,445,0,0,66,66,0,1,0,1,0
57427,445,0,0,68,68,0,1,0,1,0
62906,445,0,0,70,70,0,1,0,1,0
65157,445,0,0,70,70,0,1,0,1,0
59099,445,0,0,68,68,0,1,0,1,0
63858,445,0,0,66,66,0,1,0,1,0
54329,445,0,0,67,67,0,1,0,1,0
65265,445,0,0,70,70,0,1,0,1,0
51525,445,0,0,69,69,0,1,0,1,0
64793,445,0,0,68,68,0,1,0,1,0
55727,445,0,0,68,68,0,1,0,1,0
61753,445,0,0,70,70,0,1,0,1,0
56522,445,0,0,66,66,0,1,0,1,0
49885,445,0,0,70,70,0,1,0,1,0
57964,445,0,0,70,70,0,1,0,1,0
54005,445,0,0,69,69,0,1,0,1,0
61206,445,0,0,70,70,0,1,0,1,0
56656,445,0,0,66,66,0,1,0,1,0
53103,445,0,0,70,70,0,1,0,1,0
59771,445,0,0,67,67,0,1,0,1,0
63005,445,0,0,70,70,0,1,0,1,0
62083,445,0,0,70,70,0,1,0,1,0
60967,445,0,0,70,70,0,1,0,1,0
49925,445,0,0,70,70,0,1,0,1,0
54855,445,0,0,66,66,0,1,0,1,0
56426,445,0,0,70,70,0,1,0,1,0
52600,445,0,0,66,66,0,1,0,1,0
50637,445,0,0,66,66,0,1,0,1,0
60105,445,0,0,70,70,0,1,0,1,0
62664,445,0,0,67,67,0,1,0,1,0
60174,445,0,0,66,66,0,1,0,1,0
54206,445,0,0,67,67,0,1,0,1,0
52135,445,0,0,69,69,0,1,0,1,0
55941,445,0,0,67,67,0,1,0,1,0
58035,445,0,0,70,70,0,1,0,1,0
59403,445,0,0,66,66,0,1,0,1,0
58169,445,0,0,66,66,0,1,0,1,0
63238,445,0,0,70,70,0,1,0,1,0
55290,445,0,0,66,66,0,1,0,1,0
57412,445,0,0,68,68,0,1,0,1,0
51825,445,0,0,69,69,0,1,0,1,0
59315,445,0,0,70,70,0,1,0,1,0
56972,445,0,0,70,70,0,1,0,1,0
60785,445,0,0,70,70,0,1,0,1,0
60617,445,0,0,66,66,0,1,0,1,0
64795,445,0,0,70,70,0,1,0,1,0
64414,445,0,0,70,70,0,1,0,1,0
55166,445,0,0,67,67,0,1,0,1,0
52198,445,0,0,67,67,0,1,0,1,0
65176,445,0,0,70,70,0,1,0,1,0
60618,445,0,0,67,67,0,1,0,1,0
52338,445,0,0,70,70,0,1,0,1,0
49536,445,0,0,70,70,0,1,0,1,0
57402,445,0,0,70,70,0,1,0,1,0
60205,445,0,0,66,66,0,1,0,1,0
51500,445,0,0,66,66,0,1,0,1,0
61672,445,0,0,69,69,0,1,0,1,0
51832,445,0,0,69,69,0,1,0,1,0
60858,445,0,0,68,68,0,1,0,1,0
55154,445,0,0,70,70,0,1,0,1,0
64562,445,0,0,70,70,0,1,0,1,0
64489,445,0,0,70,70,0,1,0,1,0
63644,445,0,0,70,70,0,1,0,1,0
55310,445,0,0,67,67,0,1,0,1,0
57015,445,0,0,66,66,0,1,0,1,0
52520,445,0,0,70,70,0,1,0,1,0
51797,445,0,0,70,70,0,1,0,1,0
49964,445,0,0,70,70,0,1,0,1,0
49534,445,0,0,69,69,0,1,0,1,0
54520,445,0,0,66,66,0,1,0,1,0
57216,445,0,0,70,70,0,1,0,1,0
55942,445,0,0,70,70,0,1,0,1,0
54497,445,0,0,70,70,0,1,0,1,0
59254,445,0,0,68,68,0,1,0,1,0
62215,445,0,0,67,67,0,1,0,1,0
57473,445,0,0,70,70,0,1,0,1,0
56255,445,0,0,68,68,0,1,0,1,0
50652,445,0,0,70,70,0,1,0,1,0
55938,445,0,0,66,66,0,1,0,1,0
57322,445,0,0,70,70,0,1,0,1,0
61502,445,0,0,67,67,0,1,0,1,0
59216,445,0,0,70,70,0,1,0,1,0
61959,445,0,0,66,66,0,1,0,1,0
54760,445,0,0,66,66,0,1,0,1,0
64193,445,0,0,66,66,0,1,0,1,0
49298,445,0,0,70,70,0,1,0,1,0
49300,445,0,0,70,70,0,1,0,1,0
50167,445,0,0,70,70,0,1,0,1,0
63561,445,0,0,70,70,0,1,0,1,0
65404,445,0,0,67,67,0,1,0,1,0
63132,445,0,0,70,70,0,1,0,1,0
65454,445,0,0,70,70,0,1,0,1,0
50564,445,0,0,66,66,0,1,0,1,0
63601,445,0,0,69,69,0,1,0,1,0
56453,445,0,0,66,66,0,1,0,1,0
52284,445,0,0,66,66,0,1,0,1,0
49753,445,0,0,70,70,0,1,0,1,0
53932,445,0,0,66,66,0,1,0,1,0
50352,445,0,0,66,66,0,1,0,1,0
65316,445,0,0,69,69,0,1,0,1,0
50632,445,0,0,68,68,0,1,0,1,0
60213,445,0,0,66,66,0,1,0,1,0
51489,445,0,0,70,70,0,1,0,1,0
59077,445,0,0,66,66,0,1,0,1,0
60789,445,0,0,70,70,0,1,0,1,0
50015,445,0,0,70,70,0,1,0,1,0
50073,445,0,0,70,70,0,1,0,1,0
50814,445,0,0,70,70,0,1,0,1,0
53031,445,0,0,66,66,0,1,0,1,0
63938,445,0,0,70,70,0,1,0,1,0
53491,445,0,0,70,70,0,1,0,1,0
60826,445,0,0,70,70,0,1,0,1,0
63538,445,0,0,66,66,0,1,0,1,0
61789,445,0,0,67,67,0,1,0,1,0
56327,445,0,0,70,70,0,1,0,1,0
53158,445,0,0,70,70,0,1,0,1,0
56062,445,0,0,66,66,0,1,0,1,0
58193,445,0,0,70,70,0,1,0,1,0
49391,445,0,0,68,68,0,1,0,1,0
55543,445,0,0,66,66,0,1,0,1,0
58662,445,0,0,68,68,0,1,0,1,0
56901,445,0,0,68,68,0,1,0,1,0
50727,445,0,0,67,67,0,1,0,1,0
54252,445,0,0,70,70,0,1,0,1,0
55081,445,0,0,70,70,0,1,0,1,0
52637,445,0,0,66,66,0,1,0,1,0
53378,445,0,0,70,70,0,1,0,1,0
57557,445,0,0,66,66,0,1,0,1,0
50256,445,0,0,70,70,0,1,0,1,0
50931,445,0,0,66,66,0,1,0,1,0
51057,445,0,0,66,66,0,1,0,1,0
50229,445,0,0,66,66,0,1,0,1,0
62171,445,0,0,70,70,0,1,0,1,0
56229,445,0,0,69,69,0,1,0,1,0
58232,445,0,0,69,69,0,1,0,1,0
55083,445,0,0,70,70,0,1,0,1,0
54980,445,0,0,70,70,0,1,0,1,0
49534,445,0,0,68,68,0,1,0,1,0
57031,445,0,0,70,70,0,1,0,1,0
55155,445,0,0,70,70,0,1,0,1,0
62225,445,0,0,70,70,0,1,0,1,0
61973,445,0,0,70,70,0,1,0,1,0
60215,445,0,0,70,70,0,1,0,1,0
57525,445,0,0,68,68,0,1,0,1,0
51964,445,0,0,70,70,0,1,0,1,0
63847,445,0,0,70,70,0,1,0,1,0
63014,445,0,0,70,70,0,1,0,1,0
59738,445,0,0,66,66,0,1,0,1,0
60097,445,0,0,66,66,0,1,0,1,0
57609,445,0,0,70,70,0,1,0,1,0
59959,445,0,0,70,70,0,1,0,1,0
59160,445,0,0,70,70,0,1,0,1,0
58926,445,0,0,70,70,0,1,0,1,0
64361,445,0,0,67,67,0,1,0,1,0
57886,445,0,0,70,70,0,1,0,1,0
50927,445,0,0,67,67,0,1,0,1,0
54702,445,0,0,69,69,0,1,0,1,0
53460,445,0,0,70,70,0,1,0,1,0
58270,445,0,0,67,67,0,1,0,1,0
53725,445,0,0,70,70,0,1,0,1,0
62276,445,0,0,70,70,0,1,0,1,0
60968,445,0,0,69,69,0,1,0,1,0
60970,445,0,0,70,70,0,1,0,1,0
63233,445,0,0,70,70,0,1,0,1,0
54993,445,0,0,70,70,0,1,0,1,0
55876,445,0,0,70,70,0,1,0,1,0
51524,445,0,0,69,69,0,1,0,1,0
57488,445,0,0,70,70,0,1,0,1,0
56595,445,0,0,70,70,0,1,0,1,0
54719,445,0,0,70,70,0,1,0,1,0
57448,445,0,0,70,70,0,1,0,1,0
49578,445,0,0,70,70,0,1,0,1,0
50352,445,0,0,66,66,0,1,0,1,0
51551,445,0,0,70,70,0,1,0,1,0
62620,445,0,0,66,66,0,1,0,1,0
54059,445,0,0,66,66,0,1,0,1,0
59141,445,0,0,66,66,0,1,0,1,0
49620,445,0,0,68,68,0,1,0,1,0
49302,445,0,0,67,67,0,1,0,1,0
60694,445,0,0,66,66,0,1,0,1,0
54909,445,0,0,70,70,0,1,0,1,0
63751,445,0,0,70,70,0,1,0,1,0
50435,445,0,0,66,66,0,1,0,1,0
63255,445,0,0,66,66,0,1,0,1,0
64262,445,0,0,70,70,0,1,0,1,0
53461,445,0,0,70,70,0,1,0,1,0
50990,445,0,0,66,66,0,1,0,1,0
56835,445,0,0,66,66,0,1,0,1,0
53289,445,0,0,66,66,0,1,0,1,0
58541,445,0,0,70,70,0,1,0,1,0
58218,445,0,0,70,70,0,1,0,1,0
61403,445,0,0,70,70,0,1,0,1,0
61895,445,0,0,70,70,0,1,0,1,0
61741,445,0,0,70,70,0,1,0,1,0
54972,445,0,0,67,67,0,1,0,1,0
59762,445,0,0,70,70,0,1,0,1,0
51883,445,0,0,70,70,0,1,0,1,0
58566,445,0,0,70,70,0,1,0,1,0
62978,445,0,0,70,70,0,1,0,1,0
56746,445,0,0,68,68,0,1,0,1,0
58213,445,0,0,70,70,0,1,0,1,0
49939,445,0,0,67,67,0,1,0,1,0
65392,445,0,0,66,66,0,1,0,1,0
65452,445,0,0,66,66,0,1,0,1,0
59107,445,0,0,70,70,0,1,0,1,0
61275,445,0,0,70,70,0,1,0,1,0
53818,445,0,0,68,68,0,1,0,1,0
59327,445,0,0,70,70,0,1,0,1,0
60746,445,0,0,70,70,0,1,0,1,0
53380,445,0,0,70,70,0,1,0,1,0
57045,445,0,0,66,66,0,1,0,1,0
51194,445,0,0,70,70,0,1,0,1,0
58246,445,0,0,66,66,0,1,0,1,0
49409,445,0,0,70,70,0,1,0,1,0
49506,445,0,0,70,70,0,1,0,1,0
49934,445,0,0,70,70,0,1,0,1,0
53869,445,0,0,70,70,0,1,0,1,0
62210,445,0,0,70,70,0,1,0,1,0
55549,445,0,0,66,66,0,1,0,1,0
62972,445,0,0,66,66,0,1,0,1,0
51015,445,0,0,70,70,0,1,0,1,0
50306,445,0,0,70,70,0,1,0,1,0
55433,445,0,0,68,68,0,1,0,1,0
62102,445,0,0,70,70,0,1,0,1,0
60997,445,0,0,70,70,0,1,0,1,0
58091,445,0,0,70,70,0,1,0,1,0
50096,445,0,0,66,66,0,1,0,1,0
52226,445,0,0,70,70,0,1,0,1,0
62587,445,0,0,70,70,0,1,0,1,0
54569,445,0,0,70,70,0,1,0,1,0
57040,445,0,0,70,70,0,1,0,1,0
53026,445,0,0,70,70,0,1,0,1,0
58313,445,0,0,70,70,0,1,0,1,0
64260,445,0,0,70,70,0,1,0,1,0
50785,445,0,0,70,70,0,1,0,1,0
50829,445,0,0,70,70,0,1,0,1,0
52006,445,0,0,70,70,0,1,0,1,0
53085,445,0,0,70,70,0,1,0,1,0
51087,445,0,0,70,70,0,1,0,1,0
54788,445,0,0,70,70,0,1,0,1,0
61987,445,0,0,70,70,0,1,0,1,0
65359,445,0,0,67,67,0,1,0,1,0
62788,445,0,0,70,70,0,1,0,1,0
61875,445,0,0,70,70,0,1,0,1,0
65190,445,0,0,68,68,0,1,0,1,0
58885,445,0,0,70,70,0,1,0,1,0
50516,445,0,0,70,70,0,1,0,1,0
55204,445,0,0,70,70,0,1,0,1,0
63796,445,0,0,70,70,0,1,0,1,0
62570,445,0,0,67,67,0,1,0,1,0
54556,445,0,0,66,66,0,1,0,1,0
62085,445,0,0,70,70,0,1,0,1,0
58096,445,0,0,67,67,0,1,0,1,0
62176,445,0,0,67,67,0,1,0,1,0
49677,445,0,0,70,70,0,1,0,1,0
49966,445,0,0,67,67,0,1,0,1,0
58134,445,0,0,70,70,0,1,0,1,0
53383,445,0,0,70,70,0,1,0,1,0
56964,445,0,0,70,70,0,1,0,1,0
60302,445,0,0,70,70,0,1,0,1,0
60445,445,0,0,66,66,0,1,0,1,0
52811,445,0,0,66,66,0,1,0,1,0
57822,445,0,0,66,66,0,1,0,1,0
56357,445,0,0,70,70,0,1,0,1,0
57839,445,0,0,70,70,0,1,0,1,0
60751,445,0,0,66,66,0,1,0,1,0
50825,445,0,0,70,70,0,1,0,1,0
52763,445,0,0,70,70,0,1,0,1,0
55287,445,0,0,66,66,0,1,0,1,0
60258,445,0,0,70,70,0,1,0,1,0
54967,445,0,0,66,66,0,1,0,1,0
50415,445,0,0,70,70,0,1,0,1,0
51177,445,0,0,70,70,0,1,0,1,0
57099,445,0,0,70,70,0,1,0,1,0
61588,445,0,0,66,66,0,1,0,1,0
50394,445,0,0,70,70,0,1,0,1,0
59643,445,0,0,66,66,0,1,0,1,0
54980,445,0,0,70,70,0,1,0,1,0
61572,445,0,0,67,67,0,1,0,1,0
57266,445,0,0,70,70,0,1,0,1,0
63844,445,0,0,67,67,0,1,0,1,0
53292,445,0,0,66,66,0,1,0,1,0
64584,445,0,0,68,68,0,1,0,1,0
51093,445,0,0,67,67,0,1,0,1,0
56583,445,0,0,70,70,0,1,0,1,0
51102,445,0,0,70,70,0,1,0,1,0
59788,445,0,0,66,66,0,1,0,1,0
62919,445,0,0,69,69,0,1,0,1,0
63773,445,0,0,69,69,0,1,0,1,0
50176,445,0,0,70,70,0,1,0,1,0
61875,445,0,0,68,68,0,1,0,1,0
55557,445,0,0,70,70,0,1,0,1,0
51682,445,0,0,70,70,0,1,0,1,0
50799,445,0,0,66,66,0,1,0,1,0
62387,445,0,0,66,66,0,1,0,1,0
64798,445,0,0,70,70,0,1,0,1,0
60272,445,0,0,70,70,0,1,0,1,0
61950,445,0,0,67,67,0,1,0,1,0
61661,445,0,0,70,70,0,1,0,1,0
57455,445,0,0,69,69,0,1,0,1,0
56835,445,0,0,70,70,0,1,0,1,0
56391,445,0,0,66,66,0,1,0,1,0
50495,445,0,0,68,68,0,1,0,1,0
58263,445,0,0,70,70,0,1,0,1,0
54059,445,0,0,70,70,0,1,0,1,0
64712,445,0,0,70,70,0,1,0,1,0
62258,445,0,0,70,70,0,1,0,1,0
61738,445,0,0,68,68,0,1,0,1,0
56366,445,0,0,70,70,0,1,0,1,0
53149,445,0,0,70,70,0,1,0,1,0
57674,445,0,0,70,70,0,1,0,1,0
52274,445,0,0,66,66,0,1,0,1,0
56697,445,0,0,70,70,0,1,0,1,0
65530,445,0,0,66,66,0,1,0,1,0
62723,445,0,0,70,70,0,1,0,1,0
56175,445,0,0,66,66,0,1,0,1,0
57448,445,0,0,70,70,0,1,0,1,0
50298,445,0,0,70,70,0,1,0,1,0
50592,445,0,0,70,70,0,1,0,1,0
60306,445,0,0,66,66,0,1,0,1,0
61800,445,0,0,66,66,0,1,0,1,0
53076,445,0,0,70,70,0,1,0,1,0
50477,445,0,0,66,66,0,1,0,1,0
63452,445,0,0,70,70,0,1,0,1,0
52905,445,0,0,67,67,0,1,0,1,0
61070,445,0,0,70,70,0,1,0,1,0
53820,445,0,0,68,68,0,1,0,1,0
50139,445,0,0,70,70,0,1,0,1,0
60815,445,0,0,70,70,0,1,0,1,0
62688,445,0,0,66,66,0,1,0,1,0
55019,445,0,0,70,70,0,1,0,1,0
51834,445,0,0,67,67,0,1,0,1,0
58729,445,0,0,70,70,0,1,0,1,0
49894,445,0,0,67,67,0,1,0,1,0
49368,445,0,0,70,70,0,1,0,1,0
56375,445,0,0,66,66,0,1,0,1,0
59053,445,0,0,70,70,0,1,0,1,0
65487,445,0,0,70,70,0,1,0,1,0
56749,445,0,0,70,70,0,1,0,1,0
60947,445,0,0,70,70,0,1,0,1,0
52344,445,0,0,66,66,0,1,0,1,0
55919,445,0,0,66,66,0,1,0,1,0
57800,445,0,0,67,67,0,1,0,1,0
55072,445,0,0,70,70,0,1,0,1,0
50167,445,0,0,70,70,0,1,0,1,0
63708,445,0,0,66,66,0,1,0,1,0
60177,445,0,0,66,66,0,1,0,1,0
60173,445,0,0,70,70,0,1,0,1,0
56195,445,0,0,66,66,0,1,0,1,0
57528,445,0,0,70,70,0,1,0,1,0
58241,445,0,0,67,67,0,1,0,1,0
55558,445,0,0,70,70,0,1,0,1,0
58243,445,0,0,66,66,0,1,0,1,0
51548,445,0,0,70,70,0,1,0,1,0
54973,445,0,0,70,70,0,1,0,1,0
61448,445,0,0,66,66,0,1,0,1,0
56872,445,0,0,70,70,0,1,0,1,0
59465,445,0,0,69,69,0,1,0,1,0
65337,445,0,0,70,70,0,1,0,1,0
57044,445,0,0,66,66,0,1,0,1,0
50917,445,0,0,68,68,0,1,0,1,0
62778,445,0,0,70,70,0,1,0,1,0
54911,445,0,0,70,70,0,1,0,1,0
61915,445,0,0,70,70,0,1,0,1,0
57579,445,0,0,69,69,0,1,0,1,0
49493,445,0,0,70,70,0,1,0,1,0
50711,445,0,0,70,70,0,1,0,1,0
56063,445,0,0,66,66,0,1,0,1,0
55108,445,0,0,70,70,0,1,0,1,0
52717,445,0,0,70,70,0,1,0,1,0
63436,445,0,0,70,70,0,1,0,1,0
57989,445,0,0,70,70,0,1,0,1,0
53540,445,0,0,70,70,0,1,0,1,0
57535,445,0,0,66,66,0,1,0,1,0
50483,445,0,0,66,66,0,1,0,1,0
58938,445,0,0,68,68,0,1,0,1,0
56960,445,0,0,70,70,0,1,0,1,0
53989,445,0,0,66,66,0,1,0,1,0
52885,445,0,0,66,66,0,1,0,1,0
51808,445,0,0,70,70,0,1,0,1,0
53367,445,0,0,66,66,0,1,0,1,0
59039,445,0,0,70,70,0,1,0,1,0
57719,445,0,0,69,69,0,1,0,1,0
51830,445,0,0,66,66,0,1,0,1,0
50049,445,0,0,67,67,0,1,0,1,0
60648,445,0,0,66,66,0,1,0,1,0
64743,445,0,0,66,66,0,1,0,1,0
63988,445,0,0,66,66,0,1,0,1,0
51539,445,0,0,70,70,0,1,0,1,0
61077,445,0,0,66,66,0,1,0,1,0
50075,445,0,0,70,70,0,1,0,1,0
64579,445,0,0,69,69,0,1,0,1,0
58823,445,0,0,67,67,0,1,0,1,0
58926,445,0,0,70,70,0,1,0,1,0
59055,445,0,0,70,70,0,1,0,1,0
61181,445,0,0,70,70,0,1,0,1,0
56893,445,0,0,70,70,0,1,0,1,0
63426,445,0,0,70,70,0,1,0,1,0
54425,445,0,0,70,70,0,1,0,1,0
55489,445,0,0,70,70,0,1,0,1,0
65067,445,0,0,66,66,0,1,0,1,0
65156,445,0,0,70,70,0,1,0,1,0
64504,445,0,0,68,68,0,1,0,1,0
60336,445,0,0,70,70,0,1,0,1,0
59789,445,0,0,70,70,0,1,0,1,0
61019,445,0,0,67,67,0,1,0,1,0
52263,445,0,0,67,67,0,1,0,1,0
57376,445,0,0,66,66,0,1,0,1,0
64677,445,0,0,66,66,0,1,0,1,0
64563,445,0,0,70,70,0,1,0,1,0
63024,445,0,0,70,70,0,1,0,1,0
50731,445,0,0,66,66,0,1,0,1,0
63886,445,0,0,70,70,0,1,0,1,0
60827,445,0,0,70,70,0,1,0,1,0
53114,445,0,0,68,68,0,1,0,1,0
54135,445,0,0,66,66,0,1,0,1,0
54354,445,0,0,70,70,0,1,0,1,0
65130,445,0,0,68,68,0,1,0,1,0
59379,445,0,0,70,70,0,1,0,1,0
56363,445,0,0,70,70,0,1,0,1,0
59937,445,0,0,69,69,0,1,0,1,0
50612,445,0,0,70,70,0,1,0,1,0
50967,445,0,0,70,70,0,1,0,1,0
65009,445,0,0,66,66,0,1,0,1,0
61777,445,0,0,66,66,0,1,0,1,0
63856,445,0,0,69,69,0,1,0,1,0
61116,445,0,0,66,66,0,1,0,1,0
50622,445,0,0,70,70,0,1,0,1,0
58060,445,0,0,70,70,0,1,0,1,0
62597,445,0,0,69,69,0,1,0,1,0
49978,445,0,0,70,70,0,1,0,1,0
57030,445,0,0,70,70,0,1,0,1,0
49516,445,0,0,70,70,0,1,0,1,0
61466,445,0,0,70,70,0,1,0,1,0
61848,445,0,0,70,70,0,1,0,1,0
63126,445,0,0,66,66,0,1,0,1,0
62804,445,0,0,70,70,0,1,0,1,0
61276,445,0,0,68,68,0,1,0,1,0
56277,445,0,0,70,70,0,1,0,1,0
57090,445,0,0,70,70,0,1,0,1,0
55976,445,0,0,70,70,0,1,0,1,0
50734,445,0,0,66,66,0,1,0,1,0
49949,445,0,0,70,70,0,1,0,1,0
56618,445,0,0,70,70,0,1,0,1,0
58320,445,0,0,66,66,0,1,0,1,0
52074,445,0,0,70,70,0,1,0,1,0
50877,445,0,0,70,70,0,1,0,1,0
64810,445,0,0,66,66,0,1,0,1,0
62425,445,0,0,68,68,0,1,0,1,0
65336,445,0,0,70,70,0,1,0,1,0
57961,445,0,0,70,70,0,1,0,1,0
54720,445,0,0,70,70,0,1,0,1,0
50748,445,0,0,69,69,0,1,0,1,0
52075,445,0,0,70,70,0,1,0,1,0
49257,445,0,0,69,69,0,1,0,1,0
61992,445,0,0,70,70,0,1,0,1,0
52314,445,0,0,70,70,0,1,0,1,0
63788,445,0,0,68,68,0,1,0,1,0
50637,445,0,0,66,66,0,1,0,1,0
56765,445,0,0,67,67,0,1,0,1,0
51069,445,0,0,70,70,0,1,0,1,0
55788,445,0,0,69,69,0,1,0,1,0
54392,445,0,0,66,66,0,1,0,1,0
61720,445,0,0,70,70,0,1,0,1,0
53397,445,0,0,69,69,0,1,0,1,0
60598,445,0,0,70,70,0,1,0,1,0
61276,445,0,0,66,66,0,1,0,1,0
55173,445,0,0,70,70,0,1,0,1,0
49165,445,0,0,70,70,0,1,0,1,0
51243,445,0,0,66,66,0,1,0,1,0
59500,445,0,0,70,70,0,1,0,1,0
62893,445,0,0,66,66,0,1,0,1,0
65248,445,0,0,70,70,0,1,0,1,0
56327,445,0,0,68,68,0,1,0,1,0
51510,445,0,0,66,66,0,1,0,1,0
55707,445,0,0,70,70,0,1,0,1,0
65162,445,0,0,68,68,0,1,0,1,0
65441,445,0,0,70,70,0,1,0,1,0
58734,445,0,0,66,66,0,1,0,1,0
52232,445,0,0,67,67,0,1,0,1,0
55403,445,0,0,70,70,0,1,0,1,0
63320,445,0,0,67,67,0,1,0,1,0
52504,445,0,0,68,68,0,1,0,1,0
60374,445,0,0,66,66,0,1,0,1,0
61106,445,0,0,70,70,0,1,0,1,0
60721,445,0,0,70,70,0,1,0,1,0
62195,445,0,0,69,69,0,1,0,1,0
53104,445,0,0,70,70,0,1,0,1,0
60564,445,0,0,66,66,0,1,0,1,0
57708,445,0,0,70,70,0,1,0,1,0
54057,445,0,0,70,70,0,1,0,1,0
50462,445,0,0,70,70,0,1,0,1,0
63984,445,0,0,67,67,0,1,0,1,0
60712,445,0,0,68,68,0,1,0,1,0
49557,445,0,0,70,70,0,1,0,1,0
58327,445,0,0,70,70,0,1,0,1,0
52474,445,0,0,66,66,0,1,0,1,0
61005,445,0,0,66,66,0,1,0,1,0
50623,445,0,0,67,67,0,1,0,1,0
51184,445,0,0,66,66,0,1,0,1,0
50385,445,0,0,70,70,0,1,0,1,0
53660,445,0,0,70,70,0,1,0,1,0
59212,445,0,0,66,66,0,1,0,1,0
64948,445,0,0,70,70,0,1,0,1,0
56189,445,0,0,67,67,0,1,0,1,0
52156,445,0,0,66,66,0,1,0,1,0
49532,445,0,0,68,68,0,1,0,1,0
55884,445,0,0,70,70,0,1,0,1,0
59320,445,0,0,70,70,0,1,0,1,0
55301,445,0,0,70,70,0,1,0,1,0
55438,445,0,0,67,67,0,1,0,1,0
56642,445,0,0,70,70,0,1,0,1,0
53685,445,0,0,66,66,0,1,0,1,0
58445,445,0,0,70,70,0,1,0,1,0
59528,445,0,0,66,66,0,1,0,1,0
56478,445,0,0,69,69,0,1,0,1,0
58309,445,0,0,66,66,0,1,0,1,0
55034,445,0,0,70,70,0,1,0,1,0
57156,445,0,0,69,69,0,1,0,1,0
55143,445,0,0,66,66,0,1,0,1,0
63125,445,0,0,66,66,0,1,0,1,0
63255,445,0,0,66,66,0,1,0,1,0
53223,445,0,0,66,66,0,1,0,1,0
54342,445,0,0,67,67,0,1,0,1,0
63453,445,0,0,69,69,0,1,0,1,0
59848,445,0,0,69,69,0,1,0,1,0
62617,445,0,0,70,70,0,1,0,1,0
63601,445,0,0,69,69,0,1,0,1,0
61272,445,0,0,70,70,0,1,0,1,0
53728,445,0,0,70,70,0,1,0,1,0
55632,445,0,0,70,70,0,1,0,1,0
49535,445,0,0,70,70,0,1,0,1,0
54547,445,0,0,69,69,0,1,0,1,0
52345,445,0,0,66,66,0,1,0,1,0
50803,445,0,0,66,66,0,1,0,1,0
63208,445,0,0,70,70,0,1,0,1,0
50335,445,0,0,66,66,0,1,0,1,0
49555,445,0,0,70,70,0,1,0,1,0
53206,445,0,0,70,70,0,1,0,1,0
54053,445,0,0,70,70,0,1,0,1,0
54246,445,0,0,66,66,0,1,0,1,0
51476,445,0,0,70,70,0,1,0,1,0
51137,445,0,0,70,70,0,1,0,1,0
58793,445,0,0,67,67,0,1,0,1,0
56516,445,0,0,70,70,0,1,0,1,0
56342,445,0,0,66,66,0,1,0,1,0
62745,445,0,0,66,66,0,1,0,1,0
52292,445,0,0,69,69,0,1,0,1,0
60675,445,0,0,66,66,0,1,0,1,0
63687,445,0,0,70,70,0,1,0,1,0
49893,445,0,0,66,66,0,1,0,1,0
52308,445,0,0,70,70,0,1,0,1,0
49193,445,0,0,70,70,0,1,0,1,0
55471,445,0,0,68,68,0,1,0,1,0
62807,445,0,0,70,70,0,1,0,1,0
51463,445,0,0,70,70,0,1,0,1,0
58114,445,0,0,69,69,0,1,0,1,0
49774,445,0,0,67,67,0,1,0,1,0
58568,445,0,0,70,70,0,1,0,1,0
62229,445,0,0,70,70,0,1,0,1,0
56643,445,0,0,69,69,0,1,0,1,0
56897,445,0,0,66,66,0,1,0,1,0
65001,445,0,0,67,67,0,1,0,1,0
57571,445,0,0,69,69,0,1,0,1,0
56841,445,0,0,67,67,0,1,0,1,0
58914,445,0,0,66,66,0,1,0,1,0
61465,445,0,0,70,70,0,1,0,1,0
61810,445,0,0,70,70,0,1,0,1,0
61617,445,0,0,70,70,0,1,0,1,0
55541,445,0,0,70,70,0,1,0,1,0
62665,445,0,0,66,66,0,1,0,1,0
55240,445,0,0,69,69,0,1,0,1,0
57943,445,0,0,70,70,0,1,0,1,0
50609,445,0,0,70,70,0,1,0,1,0
57637,445,0,0,70,70,0,1,0,1,0
53609,445,0,0,70,70,0,1,0,1,0
52558,445,0,0,70,70,0,1,0,1,0
53365,445,0,0,68,68,0,1,0,1,0
57426,445,0,0,68,68,0,1,0,1,0
61510,445,0,0,70,70,0,1,0,1,0
56900,445,0,0,66,66,0,1,0,1,0
64600,445,0,0,67,67,0,1,0,1,0
53634,445,0,0,70,70,0,1,0,1,0
52346,445,0,0,66,66,0,1,0,1,0
60245,445,0,0,70,70,0,1,0,1,0
60171,445,0,0,70,70,0,1,0,1,0
58687,445,0,0,66,66,0,1,0,1,0
53686,445,0,0,70,70,0,1,0,1,0
53803,445,0,0,70,70,0,1,0,1,0
64566,445,0,0,70,70,0,1,0,1,0
64373,445,0,0,66,66,0,1,0,1,0
50080,445,0,0,69,69,0,1,0,1,0
56963,445,0,0,66,66,0,1,0,1,0
53834,445,0,0,70,70,0,1,0,1,0
53308,445,0,0,69,69,0,1,0,1,0
51063,445,0,0,66,66,0,1,0,1,0
55556,445,0,0,70,70,0,1,0,1,0
64225,445,0,0,70,70,0,1,0,1,0
49887,445,0,0,70,70,0,1,0,1,0
52294,445,0,0,67,67,0,1,0,1,0
53075,445,0,0,70,70,0,1,0,1,0
57155,445,0,0,66,66,0,1,0,1,0
52733,445,0,0,66,66,0,1,0,1,0
60479,445,0,0,70,70,0,1,0,1,0
50367,445,0,0,66,66,0,1,0,1,0
55036,445,0,0,66,66,0,1,0,1,0
57672,445,0,0,70,70,0,1,0,1,0
58736,445,0,0,67,67,0,1,0,1,0
49774,445,0,0,68,68,0,1,0,1,0
51157,445,0,0,70,70,0,1,0,1,0
59969,445,0,0,70,70,0,1,0,1,0
63773,445,0,0,66,66,0,1,0,1,0
51289,445,0,0,70,70,0,1,0,1,0
52791,445,0,0,70,70,0,1,0,1,0
59888,445,0,0,70,70,0,1,0,1,0
56380,445,0,0,69,69,0,1,0,1,0
60995,445,0,0,70,70,0,1,0,1,0
51050,445,0,0,70,70,0,1,0,1,0
54827,445,0,0,69,69,0,1,0,1,0
54090,445,0,0,66,66,0,1,0,1,0
49868,445,0,0,70,70,0,1,0,1,0
59442,445,0,0,70,70,0,1,0,1,0
53559,445,0,0,70,70,0,1,0,1,0
55083,445,0,0,70,70,0,1,0,1,0
61916,445,0,0,70,70,0,1,0,1,0
57730,445,0,0,67,67,0,1,0,1,0
55514,445,0,0,70,70,0,1,0,1,0
59688,445,0,0,66,66,0,1,0,1,0
60438,445,0,0,66,66,0,1,0,1,0
64295,445,0,0,70,70,0,1,0,1,0
56516,445,0,0,70,70,0,1,0,1,0
50142,445,0,0,70,70,0,1,0,1,0
53068,445,0,0,70,70,0,1,0,1,0
51751,445,0,0,70,70,0,1,0,1,0
58439,445,0,0,66,66,0,1,0,1,0
62492,445,0,0,66,66,0,1,0,1,0
59089,445,0,0,70,70,0,1,0,1,0
60342,445,0,0,70,70,0,1,0,1,0
59226,445,0,0,67,67,0,1,0,1,0
63269,445,0,0,70,70,0,1,0,1,0
50797,445,0,0,66,66,0,1,0,1,0
58500,445,0,0,66,66,0,1,0,1,0
51043,445,0,0,70,70,0,1,0,1,0
60978,445,0,0,70,70,0,1,0,1,0
60959,445,0,0,70,70,0,1,0,1,0
49233,445,0,0,70,70,0,1,0,1,0
62256,445,0,0,70,70,0,1,0,1,0
64047,445,0,0,70,70,0,1,0,1,0
57214,445,0,0,70,70,0,1,0,1,0
54506,445,0,0,70,70,0,1,0,1,0
64038,445,0,0,66,66,0,1,0,1,0
62489,445,0,0,70,70,0,1,0,1,0
52052,445,0,0,70,70,0,1,0,1,0
49938,445,0,0,70,70,0,1,0,1,0
62704,445,0,0,70,70,0,1,0,1,0
51939,445,0,0,68,68,0,1,0,1,0
64422,445,0,0,66,66,0,1,0,1,0
62767,445,0,0,70,70,0,1,0,1,0
61229,445,0,0,66,66,0,1,0,1,0
56964,445,0,0,70,70,0,1,0,1,0
50767,445,0,0,66,66,0,1,0,1,0
56480,445,0,0,70,70,0,1,0,1,0
49842,445,0,0,66,66,0,1,0,1,0
63731,445,0,0,67,67,0,1,0,1,0
54061,445,0,0,66,66,0,1,0,1,0
52688,445,0,0,70,70,0,1,0,1,0
62853,445,0,0,70,70,0,1,0,1,0
52354,445,0,0,70,70,0,1,0,1,0
55984,445,0,0,70,70,0,1,0,1,0
63263,445,0,0,68,68,0,1,0,1,0
50097,445,0,0,66,66,0,1,0,1,0
52142,445,0,0,68,68,0,1,0,1,0
65416,445,0,0,70,70,0,1,0,1,0
64440,445,0,0,70,70,0,1,0,1,0
53266,445,0,0,67,67,0,1,0,1,0
56991,445,0,0,66,66,0,1,0,1,0
56771,445,0,0,70,70,0,1,0,1,0
50167,445,0,0,68,68,0,1,0,1,0
64729,445,0,0,70,70,0,1,0,1,0
62190,445,0,0,70,70,0,1,0,1,0
56391,445,0,0,66,66,0,1,0,1,0
51699,445,0,0,67,67,0,1,0,1,0
52918,445,0,0,66,66,0,1,0,1,0
55659,445,0,0,70,70,0,1,0,1,0
54226,445,0,0,70,70,0,1,0,1,0
61436,445,0,0,70,70,0,1,0,1,0
65501,445,0,0,70,70,0,1,0,1,0
61004,445,0,0,66,66,0,1,0,1,0
54602,445,0,0,69,69,0,1,0,1,0
63860,445,0,0,70,70,0,1,0,1,0
63872,445,0,0,70,70,0,1,0,1,0
65446,445,0,0,67,67,0,1,0,1,0
63073,445,0,0,69,69,0,1,0,1,0
65393,445,0,0,66,66,0,1,0,1,0
55840,445,0,0,70,70,0,1,0,1,0
63711,445,0,0,70,70,0,1,0,1,0
55591,445,0,0,70,70,0,1,0,1,0
54048,445,0,0,70,70,0,1,0,1,0
56112,445,0,0,68,68,0,1,0,1,0
50125,445,0,0,66,66,0,1,0,1,0
52178,445,0,0,70,70,0,1,0,1,0
55620,445,0,0,70,70,0,1,0,1,0
51309,445,0,0,70,70,0,1,0,1,0
52903,445,0,0,66,66,0,1,0,1,0
49895,445,0,0,70,70,0,1,0,1,0
62523,445,0,0,70,70,0,1,0,1,0
54931,445,0,0,70,70,0,1,0,1,0
61277,445,0,0,66,66,0,1,0,1,0
50530,445,0,0,70,70,0,1,0,1,0
49974,445,0,0,70,70,0,1,0,1,0
53293,445,0,0,66,66,0,1,0,1,0
51825,445,0,0,66,66,0,1,0,1,0
53316,445,0,0,69,69,0,1,0,1,0
58284,445,0,0,70,70,0,1,0,1,0
51163,445,0,0,68,68,0,1,0,1,0
64043,445,0,0,70,70,0,1,0,1,0
59088,445,0,0,67,67,0,1,0,1,0
61917,445,0,0,70,70,0,1,0,1,0
62959,445,0,0,70,70,0,1,0,1,0
65244,445,0,0,67,67,0,1,0,1,0
50987,445,0,0,69,69,0,1,0,1,0
62287,445,0,0,66,66,0,1,0,1,0
64193,445,0,0,68,68,0,1,0,1,0
65414,445,0,0,70,70,0,1,0,1,0
62045,445,0,0,66,66,0,1,0,1,0
55458,445,0,0,70,70,0,1,0,1,0
64229,445,0,0,69,69,0,1,0,1,0
60548,445,0,0,70,70,0,1,0,1,0
60648,445,0,0,67,67,0,1,0,1,0
50659,445,0,0,66,66,0,1,0,1,0
62551,445,0,0,70,70,0,1,0,1,0
49769,445,0,0,70,70,0,1,0,1,0
52996,445,0,0,70,70,0,1,0,1,0
53060,445,0,0,66,66,0,1,0,1,0
64650,445,0,0,70,70,0,1,0,1,0
54868,445,0,0,70,70,0,1,0,1,0
54060,445,0,0,70,70,0,1,0,1,0
49812,445,0,0,70,70,0,1,0,1,0
61095,445,0,0,70,70,0,1,0,1,0
54615,445,0,0,70,70,0,1,0,1,0
49810,445,0,0,70,70,0,1,0,1,0
64963,445,0,0,69,69,0,1,0,1,0
52559,445,0,0,70,70,0,1,0,1,0
56317,445,0,0,70,70,0,1,0,1,0
59377,445,0,0,70,70,0,1,0,1,0
51489,445,0,0,70,70,0,1,0,1,0
60169,445,0,0,70,70,0,1,0,1,0
60347,445,0,0,70,70,0,1,0,1,0
61864,445,0,0,70,70,0,1,0,1,0
58040,445,0,0,68,68,0,1,0,1,0
53233,445,0,0,70,70,0,1,0,1,0
51027,445,0,0,70,70,0,1,0,1,0
53747,445,0,0,70,70,0,1,0,1,0
65115,445,0,0,70,70,0,1,0,1,0
63536,445,0,0,66,66,0,1,0,1,0
51014,445,0,0,66,66,0,1,0,1,0
60385,445,0,0,69,69,0,1,0,1,0
55834,445,0,0,66,66,0,1,0,1,0
61493,445,0,0,70,70,0,1,0,1,0
51726,445,0,0,70,70,0,1,0,1,0
53375,445,0,0,70,70,0,1,0,1,0
57652,445,0,0,66,66,0,1,0,1,0
53571,445,0,0,68,68,0,1,0,1,0
54795,445,0,0,66,66,0,1,0,1,0
52593,445,0,0,69,69,0,1,0,1,0
53077,445,0,0,70,70,0,1,0,1,0
64739,445,0,0,69,69,0,1,0,1,0
61513,445,0,0,70,70,0,1,0,1,0
58941,445,0,0,70,70,0,1,0,1,0
56305,445,0,0,66,66,0,1,0,1,0
52958,445,0,0,70,70,0,1,0,1,0
53420,445,0,0,66,66,0,1,0,1,0
49903,445,0,0,66,66,0,1,0,1,0
57196,445,0,0,70,70,0,1,0,1,0
60644,445,0,0,67,67,0,1,0,1,0
53282,445,0,0,70,70,0,1,0,1,0
51554,445,0,0,67,67,0,1,0,1,0
55836,445,0,0,70,70,0,1,0,1,0
51179,445,0,0,66,66,0,1,0,1,0
49473,445,0,0,69,69,0,1,0,1,0
62529,445,0,0,70,70,0,1,0,1,0
65374,445,0,0,70,70,0,1,0,1,0
58007,445,0,0,70,70,0,1,0,1,0
61915,445,0,0,70,70,0,1,0,1,0
62564,445,0,0,70,70,0,1,0,1,0
54343,445,0,0,70,70,0,1,0,1,0
50513,445,0,0,70,70,0,1,0,1,0
58960,445,0,0,69,69,0,1,0,1,0
52141,445,0,0,70,70,0,1,0,1,0
52532,445,0,0,70,70,0,1,0,1,0
54266,445,0,0,66,66,0,1,0,1,0
49916,445,0,0,70,70,0,1,0,1,0
57484,445,0,0,70,70,0,1,0,1,0
51068,445,0,0,70,70,0,1,0,1,0
53985,445,0,0,70,70,0,1,0,1,0
51146,445,0,0,68,68,0,1,0,1,0
55722,445,0,0,70,70,0,1,0,1,0
63872,445,0,0,70,70,0,1,0,1,0
55272,445,0,0,67,67,0,1,0,1,0
62446,445,0,0,70,70,0,1,0,1,0
52475,445,0,0,70,70,0,1,0,1,0
57499,445,0,0,70,70,0,1,0,1,0
60559,445,0,0,70,70,0,1,0,1,0
56058,445,0,0,70,70,0,1,0,1,0
65275,445,0,0,67,67,0,1,0,1,0
54396,445,0,0,66,66,0,1,0,1,0
62875,445,0,0,68,68,0,1,0,1,0
58222,445,0,0,70,70,0,1,0,1,0
55839,445,0,0,70,70,0,1,0,1,0
62854,445,0,0,68,68,0,1,0,1,0
56556,445,0,0,69,69,0,1,0,1,0
64678,445,0,0,66,66,0,1,0,1,0
57371,445,0,0,70,70,0,1,0,1,0
49993,445,0,0,70,70,0,1,0,1,0
55175,445,0,0,70,70,0,1,0,1,0
62486,445,0,0,66,66,0,1,0,1,0
52430,445,0,0,70,70,0,1,0,1,0
52932,445,0,0,68,68,0,1,0,1,0
55267,445,0,0,70,70,0,1,0,1,0
51057,445,0,0,66,66,0,1,0,1,0
59957,445,0,0,70,70,0,1,0,1,0
49348,445,0,0,68,68,0,1,0,1,0
58243,445,0,0,70,70,0,1,0,1,0
52522,445,0,0,67,67,0,1,0,1,0
49510,445,0,0,66,66,0,1,0,1,0
54086,445,0,0,70,70,0,1,0,1,0
60118,445,0,0,70,70,0,1,0,1,0
59018,445,0,0,66,66,0,1,0,1,0
58010,445,0,0,70,70,0,1,0,1,0
49491,445,0,0,70,70,0,1,0,1,0
49530,445,0,0,66,66,0,1,0,1,0
62556,445,0,0,66,66,0,1,0,1,0
60305,445,0,0,66,66,0,1,0,1,0
50722,445,0,0,66,66,0,1,0,1,0
58412,445,0,0,70,70,0,1,0,1,0
49519,445,0,0,67,67,0,1,0,1,0
63181,445,0,0,68,68,0,1,0,1,0
52962,445,0,0,68,68,0,1,0,1,0
59699,445,0,0,70,70,0,1,0,1,0
51708,445,0,0,70,70,0,1,0,1,0
49285,445,0,0,66,66,0,1,0,1,0
59381,445,0,0,70,70,0,1,0,1,0
59379,445,0,0,70,70,0,1,0,1,0
52947,445,0,0,70,70,0,1,0,1,0
62155,445,0,0,68,68,0,1,0,1,0
50589,445,0,0,70,70,0,1,0,1,0
58631,445,0,0,70,70,0,1,0,1,0
59019,445,0,0,70,70,0,1,0,1,0
50780,445,0,0,69,69,0,1,0,1,0
55324,445,0,0,68,68,0,1,0,1,0
62573,445,0,0,70,70,0,1,0,1,0
53032,445,0,0,70,70,0,1,0,1,0
52789,445,0,0,66,66,0,1,0,1,0
52087,445,0,0,66,66,0,1,0,1,0
59313,445,0,0,68,68,0,1,0,1,0
61210,445,0,0,69,69,0,1,0,1,0
55616,445,0,0,66,66,0,1,0,1,0
62166,445,0,0,67,67,0,1,0,1,0
64002,445,0,0,70,70,0,1,0,1,0
60205,445,0,0,69,69,0,1,0,1,0
65308,445,0,0,70,70,0,1,0,1,0
52395,445,0,0,70,70,0,1,0,1,0
60347,445,0,0,70,70,0,1,0,1,0
56774,445,0,0,66,66,0,1,0,1,0
61617,445,0,0,68,68,0,1,0,1,0
57804,445,0,0,69,69,0,1,0,1,0
56533,445,0,0,70,70,0,1,0,1,0
53040,445,0,0,70,70,0,1,0,1,0
52038,445,0,0,69,69,0,1,0,1,0
53695,445,0,0,66,66,0,1,0,1,0
52988,445,0,0,69,69,0,1,0,1,0
50819,445,0,0,66,66,0,1,0,1,0
54748,445,0,0,70,70,0,1,0,1,0
57858,445,0,0,70,70,0,1,0,1,0
58607,445,0,0,70,70,0,1,0,1,0
49654,445,0,0,66,66,0,1,0,1,0
57800,445,0,0,66,66,0,1,0,1,0
49809,445,0,0,70,70,0,1,0,1,0
60858,445,0,0,70,70,0,1,0,1,0
56763,445,0,0,69,69,0,1,0,1,0
54456,445,0,0,67,67,0,1,0,1,0
57426,445,0,0,70,70,0,1,0,1,0
61462,445,0,0,69,69,0,1,0,1,0
49665,445,0,0,68,68,0,1,0,1,0
64877,445,0,0,70,70,0,1,0,1,0
55186,445,0,0,67,67,0,1,0,1,0
55550,445,0,0,70,70,0,1,0,1,0
58814,445,0,0,69,69,0,1,0,1,0
59235,445,0,0,70,70,0,1,0,1,0
59335,445,0,0,66,66,0,1,0,1,0
58342,445,0,0,70,70,0,1,0,1,0
55610,445,0,0,66,66,0,1,0,1,0
60903,445,0,0,70,70,0,1,0,1,0
54699,445,0,0,68,68,0,1,0,1,0
53013,445,0,0,70,70,0,1,0,1,0
62083,445,0,0,70,70,0,1,0,1,0
50828,445,0,0,70,70,0,1,0,1,0
51925,445,0,0,70,70,0,1,0,1,0
62244,445,0,0,70,70,0,1,0,1,0
49906,445,0,0,70,70,0,1,0,1,0
61276,445,0,0,69,69,0,1,0,1,0
55455,445,0,0,70,70,0,1,0,1,0
59441,445,0,0,70,70,0,1,0,1,0
52345,445,0,0,66,66,0,1,0,1,0
50667,445,0,0,66,66,0,1,0,1,0
60884,445,0,0,70,70,0,1,0,1,0
58419,445,0,0,67,67,0,1,0,1,0
55452,445,0,0,70,70,0,1,0,1,0
60212,445,0,0,70,70,0,1,0,1,0
63665,445,0,0,70,70,0,1,0,1,0
61590,445,0,0,66,66,0,1,0,1,0
53154,445,0,0,70,70,0,1,0,1,0
63217,445,0,0,70,70,0,1,0,1,0
56555,445,0,0,70,70,0,1,0,1,0
59563,445,0,0,68,68,0,1,0,1,0
61688,445,0,0,70,70,0,1,0,1,0
49533,445,0,0,69,69,0,1,0,1,0
50195,445,0,0,70,70,0,1,0,1,0
64689,445,0,0,70,70,0,1,0,1,0
57540,445,0,0,66,66,0,1,0,1,0
50382,445,0,0,70,70,0,1,0,1,0
59403,445,0,0,70,70,0,1,0,1,0
49933,445,0,0,70,70,0,1,0,1,0
51142,445,0,0,70,70,0,1,0,1,0
59605,445,0,0,70,70,0,1,0,1,0
50006,445,0,0,70,70,0,1,0,1,0
50193,445,0,0,70,70,0,1,0,1,0
50783,445,0,0,70,70,0,1,0,1,0
53308,445,0,0,70,70,0,1,0,1,0
58409,445,0,0,69,69,0,1,0,1,0
61515,445,0,0,66,66,0,1,0,1,0
64791,445,0,0,67,67,0,1,0,1,0
62669,445,0,0,70,70,0,1,0,1,0
53085,445,0,0,70,70,0,1,0,1,0
51186,445,0,0,66,66,0,1,0,1,0
54187,445,0,0,67,67,0,1,0,1,0
50041,445,0,0,70,70,0,1,0,1,0
55419,445,0,0,66,66,0,1,0,1,0
50720,445,0,0,70,70,0,1,0,1,0
57494,445,0,0,70,70,0,1,0,1,0
54817,445,0,0,70,70,0,1,0,1,0
54276,445,0,0,67,67,0,1,0,1,0
53505,445,0,0,70,70,0,1,0,1,0
59587,445,0,0,68,68,0,1,0,1,0
65194,445,0,0,66,66,0,1,0,1,0
51228,445,0,0,67,67,0,1,0,1,0
52228,445,0,0,68,68,0,1,0,1,0
64329,445,0,0,67,67,0,1,0,1,0
59165,445,0,0,70,70,0,1,0,1,0
63597,445,0,0,66,66,0,1,0,1,0
58215,445,0,0,70,70,0,1,0,1,0
52638,445,0,0,66,66,0,1,0,1,0
62447,445,0,0,70,70,0,1,0,1,0
53155,445,0,0,70,70,0,1,0,1,0
63519,445,0,0,66,66,0,1,0,1,0
57563,445,0,0,70,70,0,1,0,1,0
53461,445,0,0,70,70,0,1,0,1,0
50858,445,0,0,66,66,0,1,0,1,0
62567,445,0,0,67,67,0,1,0,1,0
65230,445,0,0,70,70,0,1,0,1,0
59770,445,0,0,66,66,0,1,0,1,0
61105,445,0,0,70,70,0,1,0,1,0
58188,445,0,0,70,70,0,1,0,1,0
56580,445,0,0,70,70,0,1,0,1,0
57119,445,0,0,70,70,0,1,0,1,0
61465,445,0,0,70,70,0,1,0,1,0
58582,445,0,0,66,66,0,1,0,1,0
54873,445,0,0,70,70,0,1,0,1,0
56815,445,0,0,69,69,0,1,0,1,0
52789,445,0,0,66,66,0,1,0,1,0
51454,445,0,0,70,70,0,1,0,1,0
55173,445,0,0,70,70,0,1,0,1,0
51621,445,0,0,70,70,0,1,0,1,0
60018,445,0,0,70,70,0,1,0,1,0
59219,445,0,0,70,70,0,1,0,1,0
50986,445,0,0,69,69,0,1,0,1,0
62505,445,0,0,70,70,0,1,0,1,0
65531,445,0,0,66,66,0,1,0,1,0
56876,445,0,0,70,70,0,1,0,1,0
50866,445,0,0,66,66,0,1,0,1,0
49367,445,0,0,70,70,0,1,0,1,0
56716,445,0,0,70,70,0,1,0,1,0
64947,445,0,0,70,70,0,1,0,1,0
64875,445,0,0,70,70,0,1,0,1,0
49780,445,0,0,70,70,0,1,0,1,0
55725,445,0,0,70,70,0,1,0,1,0
63542,445,0,0,70,70,0,1,0,1,0
49783,445,0,0,70,70,0,1,0,1,0
61159,445,0,0,67,67,0,1,0,1,0
57092,445,0,0,66,66,0,1,0,1,0
63858,445,0,0,70,70,0,1,0,1,0
57349,445,0,0,66,66,0,1,0,1,0
50338,445,0,0,66,66,0,1,0,1,0
55733,445,0,0,67,67,0,1,0,1,0
63238,445,0,0,66,66,0,1,0,1,0
59028,445,0,0,68,68,0,1,0,1,0
55023,445,0,0,70,70,0,1,0,1,0
51461,445,0,0,70,70,0,1,0,1,0
62170,445,0,0,70,70,0,1,0,1,0
55876,445,0,0,68,68,0,1,0,1,0
60423,445,0,0,70,70,0,1,0,1,0
51882,445,0,0,70,70,0,1,0,1,0
56639,445,0,0,70,70,0,1,0,1,0
55035,445,0,0,66,66,0,1,0,1,0
60823,445,0,0,66,66,0,1,0,1,0
62212,445,0,0,70,70,0,1,0,1,0
61872,445,0,0,69,69,0,1,0,1,0
52236,445,0,0,70,70,0,1,0,1,0
51862,445,0,0,70,70,0,1,0,1,0
51309,445,0,0,66,66,0,1,0,1,0
57384,445,0,0,68,68,0,1,0,1,0
49868,445,0,0,70,70,0,1,0,1,0
50460,445,0,0,67,67,0,1,0,1,0
52453,445,0,0,70,70,0,1,0,1,0
51792,445,0,0,70,70,0,1,0,1,0
60270,445,0,0,70,70,0,1,0,1,0
53278,445,0,0,66,66,0,1,0,1,0
49183,445,0,0,66,66,0,1,0,1,0
61934,445,0,0,70,70,0,1,0,1,0
64196,445,0,0,70,70,0,1,0,1,0
57956,445,0,0,70,70,0,1,0,1,0
57861,445,0,0,66,66,0,1,0,1,0
51674,445,0,0,70,70,0,1,0,1,0
63537,445,0,0,69,69,0,1,0,1,0
54658,445,0,0,69,69,0,1,0,1,0
61762,445,0,0,70,70,0,1,0,1,0
56986,445,0,0,70,70,0,1,0,1,0
51438,445,0,0,66,66,0,1,0,1,0
58326,445,0,0,66,66,0,1,0,1,0
52710,445,0,0,70,70,0,1,0,1,0
50811,445,0,0,70,70,0,1,0,1,0
63640,445,0,0,70,70,0,1,0,1,0
56979,445,0,0,67,67,0,1,0,1,0
65059,445,0,0,70,70,0,1,0,1,0
53652,445,0,0,66,66,0,1,0,1,0
63553,445,0,0,69,69,0,1,0,1,0
56618,445,0,0,69,69,0,1,0,1,0
52185,445,0,0,70,70,0,1,0,1,0
63517,445,0,0,66,66,0,1,0,1,0
55400,445,0,0,70,70,0,1,0,1,0
53227,445,0,0,70,70,0,1,0,1,0
61898,445,0,0,66,66,0,1,0,1,0
65188,445,0,0,70,70,0,1,0,1,0
52166,445,0,0,67,67,0,1,0,1,0
60472,445,0,0,67,67,0,1,0,1,0
52919,445,0,0,66,66,0,1,0,1,0
54654,445,0,0,67,67,0,1,0,1,0
51806,445,0,0,70,70,0,1,0,1,0
60288,445,0,0,66,66,0,1,0,1,0
61591,445,0,0,68,68,0,1,0,1,0
52983,445,0,0,66,66,0,1,0,1,0
62874,445,0,0,66,66,0,1,0,1,0
56452,445,0,0,66,66,0,1,0,1,0
58890,445,0,0,69,69,0,1,0,1,0
58126,445,0,0,66,66,0,1,0,1,0
50594,445,0,0,70,70,0,1,0,1,0
60997,445,0,0,70,70,0,1,0,1,0
50777,445,0,0,70,70,0,1,0,1,0
60634,445,0,0,66,66,0,1,0,1,0
54712,445,0,0,68,68,0,1,0,1,0
56775,445,0,0,70,70,0,1,0,1,0
64033,445,0,0,66,66,0,1,0,1,0
52220,445,0,0,70,70,0,1,0,1,0
50231,445,0,0,68,68,0,1,0,1,0
65326,445,0,0,68,68,0,1,0,1,0
56441,445,0,0,70,70,0,1,0,1,0
50228,445,0,0,69,69,0,1,0,1,0
50080,445,0,0,66,66,0,1,0,1,0
51574,445,0,0,66,66,0,1,0,1,0
50523,445,0,0,70,70,0,1,0,1,0
57303,445,0,0,70,70,0,1,0,1,0
65197,445,0,0,68,68,0,1,0,1,0
54833,445,0,0,66,66,0,1,0,1,0
60074,445,0,0,69,69,0,1,0,1,0
50017,445,0,0,70,70,0,1,0,1,0
54610,445,0,0,70,70,0,1,0,1,0
57403,445,0,0,68,68,0,1,0,1,0
63240,445,0,0,67,67,0,1,0,1,0
62444,445,0,0,68,68,0,1,0,1,0
58438,445,0,0,68,68,0,1,0,1,0
60806,445,0,0,66,66,0,1,0,1,0
64740,445,0,0,66,66,0,1,0,1,0
58860,445,0,0,70,70,0,1,0,1,0
60561,445,0,0,70,70,0,1,0,1,0
62228,445,0,0,70,70,0,1,0,1,0
55548,445,0,0,68,68,0,1,0,1,0
62552,445,0,0,70,70,0,1,0,1,0
60848,445,0,0,70,70,0,1,0,1,0
56328,445,0,0,70,70,0,1,0,1,0
53761,445,0,0,70,70,0,1,0,1,0
56468,445,0,0,70,70,0,1,0,1,0
63203,445,0,0,70,70,0,1,0,1,0
53623,445,0,0,66,66,0,1,0,1,0
50886,445,0,0,66,66,0,1,0,1,0
60142,445,0,0,70,70,0,1,0,1,0
61998,445,0,0,68,68,0,1,0,1,0
60578,445,0,0,70,70,0,1,0,1,0
56696,445,0,0,70,70,0,1,0,1,0
57768,445,0,0,70,70,0,1,0,1,0
50413,445,0,0,66,66,0,1,0,1,0
60230,445,0,0,70,70,0,1,0,1,0
50734,445,0,0,66,66,0,1,0,1,0
60409,445,0,0,68,68,0,1,0,1,0
55165,445,0,0,70,70,0,1,0,1,0
64920,445,0,0,66,66,0,1,0,1,0
51929,445,0,0,70,70,0,1,0,1,0
63558,445,0,0,70,70,0,1,0,1,0
51994,445,0,0,68,68,0,1,0,1,0
58759,445,0,0,66,66,0,1,0,1,0
54505,445,0,0,66,66,0,1,0,1,0
52013,445,0,0,70,70,0,1,0,1,0
50270,445,0,0,70,70,0,1,0,1,0
54443,445,0,0,69,69,0,1,0,1,0
57541,445,0,0,69,69,0,1,0,1,0
60864,445,0,0,70,70,0,1,0,1,0
63210,445,0,0,70,70,0,1,0,1,0
53467,445,0,0,70,70,0,1,0,1,0
56276,445,0,0,68,68,0,1,0,1,0
50939,445,0,0,70,70,0,1,0,1,0
58920,445,0,0,66,66,0,1,0,1,0
59722,445,0,0,66,66,0,1,0,1,0
58012,445,0,0,70,70,0,1,0,1,0
62902,445,0,0,70,70,0,1,0,1,0
61792,445,0,0,67,67,0,1,0,1,0
51888,445,0,0,66,66,0,1,0,1,0
63967,445,0,0,66,66,0,1,0,1,0
64004,445,0,0,70,70,0,1,0,1,0
57240,445,0,0,70,70,0,1,0,1,0
58784,445,0,0,70,70,0,1,0,1,0
53932,445,0,0,70,70,0,1,0,1,0
61879,445,0,0,70,70,0,1,0,1,0
54548,445,0,0,66,66,0,1,0,1,0
56732,445,0,0,70,70,0,1,0,1,0
52700,445,0,0,70,70,0,1,0,1,0
58227,445,0,0,66,66,0,1,0,1,0
53630,445,0,0,70,70,0,1,0,1,0
49377,445,0,0,69,69,0,1,0,1,0
53000,445,0,0,70,70,0,1,0,1,0
63660,445,0,0,70,70,0,1,0,1,0
60419,445,0,0,69,69,0,1,0,1,0
56363,445,0,0,70,70,0,1,0,1,0
61917,445,0,0,70,70,0,1,0,1,0
59718,445,0,0,67,67,0,1,0,1,0
64890,445,0,0,67,67,0,1,0,1,0
49813,445,0,0,70,70,0,1,0,1,0
50045,445,0,0,67,67,0,1,0,1,0
57347,445,0,0,67,67,0,1,0,1,0
65000,445,0,0,70,70,0,1,0,1,0
57926,445,0,0,66,66,0,1,0,1,0
61430,445,0,0,70,70,0,1,0,1,0
55484,445,0,0,70,70,0,1,0,1,0
62276,445,0,0,70,70,0,1,0,1,0
58270,445,0,0,69,69,0,1,0,1,0
52044,445,0,0,70,70,0,1,0,1,0
54294,445,0,0,70,70,0,1,0,1,0
60899,445,0,0,66,66,0,1,0,1,0
55706,445,0,0,70,70,0,1,0,1,0
63951,445,0,0,70,70,0,1,0,1,0
53075,445,0,0,70,70,0,1,0,1,0
57417,445,0,0,66,66,0,1,0,1,0
61570,445,0,0,70,70,0,1,0,1,0
52220,445,0,0,70,70,0,1,0,1,0
50928,445,0,0,66,66,0,1,0,1,0
58840,445,0,0,70,70,0,1,0,1,0
49908,445,0,0,70,70,0,1,0,1,0
51655,445,0,0,70,70,0,1,0,1,0
62445,445,0,0,70,70,0,1,0,1,0
57753,445,0,0,70,70,0,1,0,1,0
50563,445,0,0,66,66,0,1,0,1,0
53499,445,0,0,66,66,0,1,0,1,0
63262,445,0,0,70,70,0,1,0,1,0
57293,445,0,0,68,68,0,1,0,1,0
50293,445,0,0,70,70,0,1,0,1,0
63307,445,0,0,66,66,0,1,0,1,0
59168,445,0,0,69,69,0,1,0,1,0
53984,445,0,0,70,70,0,1,0,1,0
49781,445,0,0,70,70,0,1,0,1,0
49199,445,0,0,66,66,0,1,0,1,0
52902,445,0,0,70,70,0,1,0,1,0
60469,445,0,0,70,70,0,1,0,1,0
60337,445,0,0,70,70,0,1,0,1,0
50399,445,0,0,70,70,0,1,0,1,0
63390,445,0,0,69,69,0,1,0,1,0
51970,445,0,0,68,68,0,1,0,1,0
58308,445,0,0,66,66,0,1,0,1,0
52606,445,0,0,70,70,0,1,0,1,0
52138,445,0,0,70,70,0,1,0,1,0
64226,445,0,0,66,66,0,1,0,1,0
64088,445,0,0,67,67,0,1,0,1,0
51752,445,0,0,70,70,0,1,0,1,0
52820,445,0,0,70,70,0,1,0,1,0
50566,445,0,0,69,69,0,1,0,1,0
55995,445,0,0,69,69,0,1,0,1,0
64930,445,0,0,70,70,0,1,0,1,0
50484,445,0,0,66,66,0,1,0,1,0
62669,445,0,0,67,67,0,1,0,1,0
51284,445,0,0,70,70,0,1,0,1,0
55193,445,0,0,70,70,0,1,0,1,0
54902,445,0,0,66,66,0,1,0,1,0
53047,445,0,0,66,66,0,1,0,1,0
58289,445,0,0,70,70,0,1,0,1,0
51182,445,0,0,66,66,0,1,0,1,0
60821,445,0,0,66,66,0,1,0,1,0
55469,445,0,0,66,66,0,1,0,1,0
61475,445,0,0,66,66,0,1,0,1,0
62935,445,0,0,68,68,0,1,0,1,0
63541,445,0,0,70,70,0,1,0,1,0
55524,445,0,0,70,70,0,1,0,1,0
59215,445,0,0,70,70,0,1,0,1,0
55892,445,0,0,70,70,0,1,0,1,0
50927,445,0,0,70,70,0,1,0,1,0
53304,445,0,0,67,67,0,1,0,1,0
62905,445,0,0,66,66,0,1,0,1,0
55201,445,0,0,70,70,0,1,0,1,0
51966,445,0,0,70,70,0,1,0,1,0
64776,445,0,0,70,70,0,1,0,1,0
60311,445,0,0,70,70,0,1,0,1,0
63626,445,0,0,66,66,0,1,0,1,0
59444,445,0,0,70,70,0,1,0,1,0
62445,445,0,0,70,70,0,1,0,1,0
62946,445,0,0,66,66,0,1,0,1,0
62874,445,0,0,66,66,0,1,0,1,0
51419,445,0,0,69,69,0,1,0,1,0
53591,445,0,0,70,70,0,1,0,1,0
53335,445,0,0,70,70,0,1,0,1,0
62128,445,0,0,70,70,0,1,0,1,0
61006,445,0,0,69,69,0,1,0,1,0
60876,445,0,0,69,69,0,1,0,1,0
57994,445,0,0,66,66,0,1,0,1,0
57174,445,0,0,70,70,0,1,0,1,0
53238,445,0,0,66,66,0,1,0,1,0
58583,445,0,0,66,66,0,1,0,1,0
51603,445,0,0,70,70,0,1,0,1,0
63871,445,0,0,70,70,0,1,0,1,0
58952,445,0,0,66,66,0,1,0,1,0
60497,445,0,0,70,70,0,1,0,1,0
64052,445,0,0,70,70,0,1,0,1,0
49778,445,0,0,66,66,0,1,0,1,0
53637,445,0,0,70,70,0,1,0,1,0
50907,445,0,0,70,70,0,1,0,1,0
58048,445,0,0,70,70,0,1,0,1,0
55735,445,0,0,66,66,0,1,0,1,0
59862,445,0,0,66,66,0,1,0,1,0
61015,445,0,0,67,67,0,1,0,1,0
61251,445,0,0,70,70,0,1,0,1,0
52403,445,0,0,70,70,0,1,0,1,0
59890,445,0,0,70,70,0,1,0,1,0
61665,445,0,0,66,66,0,1,0,1,0
55179,445,0,0,70,70,0,1,0,1,0
50221,445,0,0,70,70,0,1,0,1,0
55556,445,0,0,70,70,0,1,0,1,0
63305,445,0,0,70,70,0,1,0,1,0
50399,445,0,0,66,66,0,1,0,1,0
57072,445,0,0,67,67,0,1,0,1,0
52372,445,0,0,67,67,0,1,0,1,0
50338,445,0,0,70,70,0,1,0,1,0
57678,445,0,0,70,70,0,1,0,1,0
52021,445,0,0,67,67,0,1,0,1,0
64405,445,0,0,68,68,0,1,0,1,0
55363,445,0,0,70,70,0,1,0,1,0
59373,445,0,0,68,68,0,1,0,1,0
64835,445,0,0,70,70,0,1,0,1,0
57089,445,0,0,70,70,0,1,0,1,0
61126,445,0,0,70,70,0,1,0,1,0
63278,445,0,0,70,70,0,1,0,1,0
54870,445,0,0,70,70,0,1,0,1,0
58482,445,0,0,68,68,0,1,0,1,0
55746,445,0,0,70,70,0,1,0,1,0
58741,445,0,0,67,67,0,1,0,1,0
64856,445,0,0,66,66,0,1,0,1,0
53916,445,0,0,70,70,0,1,0,1,0
63472,445,0,0,70,70,0,1,0,1,0
60726,445,0,0,68,68,0,1,0,1,0
65130,445,0,0,67,67,0,1,0,1,0
64807,445,0,0,66,66,0,1,0,1,0
51562,445,0,0,70,70,0,1,0,1,0
57429,445,0,0,66,66,0,1,0,1,0
50191,445,0,0,70,70,0,1,0,1,0
55804,445,0,0,70,70,0,1,0,1,0
50966,445,0,0,67,67,0,1,0,1,0
63984,445,0,0,70,70,0,1,0,1,0
55944,445,0,0,70,70,0,1,0,1,0
53931,445,0,0,66,66,0,1,0,1,0
63511,445,0,0,70,70,0,1,0,1,0
50875,445,0,0,70,70,0,1,0,1,0
63645,445,0,0,70,70,0,1,0,1,0
62668,445,0,0,66,66,0,1,0,1,0
60946,445,0,0,70,70,0,1,0,1,0
64856,445,0,0,66,66,0,1,0,1,0
50878,445,0,0,66,66,0,1,0,1,0
50857,445,0,0,70,70,0,1,0,1,0
62355,445,0,0,67,67,0,1,0,1,0
59474,445,0,0,70,70,0,1,0,1,0
63714,445,0,0,67,67,0,1,0,1,0
54567,445,0,0,70,70,0,1,0,1,0
53119,445,0,0,70,70,0,1,0,1,0
53168,445,0,0,66,66,0,1,0,1,0
56305,445,0,0,66,66,0,1,0,1,0
58412,445,0,0,70,70,0,1,0,1,0
52690,445,0,0,70,70,0,1,0,1,0
49792,445,0,0,70,70,0,1,0,1,0
52624,445,0,0,70,70,0,1,0,1,0
63827,445,0,0,67,67,0,1,0,1,0
52790,445,0,0,66,66,0,1,0,1,0
50770,445,0,0,70,70,0,1,0,1,0
50440,445,0,0,66,66,0,1,0,1,0
59020,445,0,0,70,70,0,1,0,1,0
54659,445,0,0,70,70,0,1,0,1,0
63147,445,0,0,70,70,0,1,0,1,0
53725,445,0,0,70,70,0,1,0,1,0
59155,445,0,0,66,66,0,1,0,1,0
57348,445,0,0,66,66,0,1,0,1,0
52348,445,0,0,68,68,0,1,0,1,0
63523,445,0,0,70,70,0,1,0,1,0
50673,445,0,0,66,66,0,1,0,1,0
50798,445,0,0,66,66,0,1,0,1,0
63599,445,0,0,68,68,0,1,0,1,0
50654,445,0,0,68,68,0,1,0,1,0
62941,445,0,0,66,66,0,1,0,1,0
61875,445,0,0,70,70,0,1,0,1,0
50782,445,0,0,70,70,0,1,0,1,0
62943,445,0,0,67,67,0,1,0,1,0
60883,445,0,0,70,70,0,1,0,1,0
55242,445,0,0,67,67,0,1,0,1,0
49305,445,0,0,70,70,0,1,0,1,0
58398,445,0,0,66,66,0,1,0,1,0
61145,445,0,0,70,70,0,1,0,1,0
62284,445,0,0,66,66,0,1,0,1,0
59288,445,0,0,67,67,0,1,0,1,0
50947,445,0,0,66,66,0,1,0,1,0
56573,445,0,0,70,70,0,1,0,1,0
50217,445,0,0,70,70,0,1,0,1,0
62975,445,0,0,70,70,0,1,0,1,0
61605,445,0,0,70,70,0,1,0,1,0
65010,445,0,0,68,68,0,1,0,1,0
63925,445,0,0,68,68,0,1,0,1,0
53868,445,0,0,70,70,0,1,0,1,0
50886,445,0,0,70,70,0,1,0,1,0
50522,445,0,0,70,70,0,1,0,1,0
63651,445,0,0,70,70,0,1,0,1,0
50269,445,0,0,70,70,0,1,0,1,0
61249,445,0,0,70,70,0,1,0,1,0
60117,445,0,0,69,69,0,1,0,1,0
51038,445,0,0,70,70,0,1,0,1,0
58594,445,0,0,70,70,0,1,0,1,0
49235,445,0,0,70,70,0,1,0,1,0
56631,445,0,0,66,66,0,1,0,1,0
58737,445,0,0,70,70,0,1,0,1,0
55312,445,0,0,66,66,0,1,0,1,0
61199,445,0,0,70,70,0,1,0,1,0
62253,445,0,0,70,70,0,1,0,1,0
61829,445,0,0,67,67,0,1,0,1,0
55842,445,0,0,70,70,0,1,0,1,0
61750,445,0,0,70,70,0,1,0,1,0
63123,445,0,0,68,68,0,1,0,1,0
60356,445,0,0,66,66,0,1,0,1,0
63536,445,0,0,66,66,0,1,0,1,0
53149,445,0,0,70,70,0,1,0,1,0
52526,445,0,0,70,70,0,1,0,1,0
59345,445,0,0,70,70,0,1,0,1,0
64838,445,0,0,70,70,0,1,0,1,0
64808,445,0,0,66,66,0,1,0,1,0
50622,445,0,0,68,68,0,1,0,1,0
50327,445,0,0,70,70,0,1,0,1,0
61818,445,0,0,70,70,0,1,0,1,0
62956,445,0,0,70,70,0,1,0,1,0
50509,445,0,0,70,70,0,1,0,1,0
51066,445,0,0,66,66,0,1,0,1,0
63254,445,0,0,69,69,0,1,0,1,0
58764,445,0,0,70,70,0,1,0,1,0
54739,445,0,0,68,68,0,1,0,1,0
56860,445,0,0,66,66,0,1,0,1,0
52068,445,0,0,68,68,0,1,0,1,0
51032,445,0,0,70,70,0,1,0,1,0
50100,445,0,0,66,66,0,1,0,1,0
58734,445,0,0,67,67,0,1,0,1,0
50148,445,0,0,70,70,0,1,0,1,0
54956,445,0,0,70,70,0,1,0,1,0
64513,445,0,0,70,70,0,1,0,1,0
51142,445,0,0,70,70,0,1,0,1,0
50912,445,0,0,70,70,0,1,0,1,0
55529,445,0,0,66,66,0,1,0,1,0
49456,445,0,0,69,69,0,1,0,1,0
49644,445,0,0,70,70,0,1,0,1,0
61522,445,0,0,67,67,0,1,0,1,0
50019,445,0,0,70,70,0,1,0,1,0
52402,445,0,0,68,68,0,1,0,1,0
58914,445,0,0,68,68,0,1,0,1,0
59597,445,0,0,70,70,0,1,0,1,0
55723,445,0,0,68,68,0,1,0,1,0
52355,445,0,0,70,70,0,1,0,1,0
54259,445,0,0,69,69,0,1,0,1,0
61392,445,0,0,70,70,0,1,0,1,0
57542,445,0,0,66,66,0,1,0,1,0
57012,445,0,0,67,67,0,1,0,1,0
57542,445,0,0,68,68,0,1,0,1,0
58246,445,0,0,66,66,0,1,0,1,0
61479,445,0,0,70,70,0,1,0,1,0
55114,445,0,0,66,66,0,1,0,1,0
53497,445,0,0,66,66,0,1,0,1,0
56358,445,0,0,70,70,0,1,0,1,0
50799,445,0,0,66,66,0,1,0,1,0
58555,445,0,0,70,70,0,1,0,1,0
56851,445,0,0,70,70,0,1,0,1,0
54829,445,0,0,66,66,0,1,0,1,0
53518,445,0,0,68,68,0,1,0,1,0
64330,445,0,0,70,70,0,1,0,1,0
60701,445,0,0,70,70,0,1,0,1,0
52228,445,0,0,69,69,0,1,0,1,0
50759,445,0,0,70,70,0,1,0,1,0
50928,445,0,0,68,68,0,1,0,1,0
57101,445,0,0,70,70,0,1,0,1,0
58059,445,0,0,70,70,0,1,0,1,0
60160,445,0,0,66,66,0,1,0,1,0
58112,445,0,0,66,66,0,1,0,1,0
54086,445,0,0,66,66,0,1,0,1,0
50817,445,0,0,66,66,0,1,0,1,0
58882,445,0,0,66,66,0,1,0,1,0
53577,445,0,0,70,70,0,1,0,1,0
52988,445,0,0,66,66,0,1,0,1,0
51996,445,0,0,66,66,0,1,0,1,0
53386,445,0,0,67,67,0,1,0,1,0
51942,445,0,0,70,70,0,1,0,1,0
64476,445,0,0,70,70,0,1,0,1,0
59731,445,0,0,70,70,0,1,0,1,0
60047,445,0,0,66,66,0,1,0,1,0
54269,445,0,0,68,68,0,1,0,1,0
58181,445,0,0,68,68,0,1,0,1,0
51506,445,0,0,66,66,0,1,0,1,0
54504,445,0,0,67,67,0,1,0,1,0
58397,445,0,0,70,70,0,1,0,1,0
64120,445,0,0,70,70,0,1,0,1,0
62894,445,0,0,70,70,0,1,0,1,0
65067,445,0,0,68,68,0,1,0,1,0
49994,445,0,0,70,70,0,1,0,1,0
52432,445,0,0,70,70,0,1,0,1,0
59043,445,0,0,66,66,0,1,0,1,0
58813,445,0,0,70,70,0,1,0,1,0
61938,445,0,0,70,70,0,1,0,1,0
50462,445,0,0,70,70,0,1,0,1,0
53263,445,0,0,70,70,0,1,0,1,0
49374,445,0,0,70,70,0,1,0,1,0
64046,445,0,0,70,70,0,1,0,1,0
52440,445,0,0,70,70,0,1,0,1,0
51945,445,0,0,70,70,0,1,0,1,0
60740,445,0,0,70,70,0,1,0,1,0
49566,445,0,0,70,70,0,1,0,1,0
61995,445,0,0,68,68,0,1,0,1,0
51788,445,0,0,68,68,0,1,0,1,0
50317,445,0,0,70,70,0,1,0,1,0
56063,445,0,0,66,66,0,1,0,1,0
63152,445,0,0,68,68,0,1,0,1,0
61830,445,0,0,66,66,0,1,0,1,0
63597,445,0,0,66,66,0,1,0,1,0
52690,445,0,0,70,70,0,1,0,1,0
60376,445,0,0,70,70,0,1,0,1,0
50632,445,0,0,70,70,0,1,0,1,0
55044,445,0,0,70,70,0,1,0,1,0
57571,445,0,0,70,70,0,1,0,1,0
60243,445,0,0,70,70,0,1,0,1,0
51329,445,0,0,70,70,0,1,0,1,0
50713,445,0,0,70,70,0,1,0,1,0
65478,445,0,0,67,67,0,1,0,1,0
57123,445,0,0,66,66,0,1,0,1,0
51072,445,0,0,69,69,0,1,0,1,0
55011,445,0,0,70,70,0,1,0,1,0
57388,445,0,0,69,69,0,1,0,1,0
56484,445,0,0,70,70,0,1,0,1,0
64660,445,0,0,66,66,0,1,0,1,0
63019,445,0,0,69,69,0,1,0,1,0
51065,445,0,0,66,66,0,1,0,1,0
59662,445,0,0,66,66,0,1,0,1,0
61619,445,0,0,70,70,0,1,0,1,0
55262,445,0,0,70,70,0,1,0,1,0
50033,445,0,0,67,67,0,1,0,1,0
58914,445,0,0,69,69,0,1,0,1,0
54323,445,0,0,66,66,0,1,0,1,0
52982,445,0,0,66,66,0,1,0,1,0
50225,445,0,0,70,70,0,1,0,1,0
62336,445,0,0,70,70,0,1,0,1,0
52048,445,0,0,70,70,0,1,0,1,0
51076,445,0,0,70,70,0,1,0,1,0
62392,445,0,0,70,70,0,1,0,1,0
50799,445,0,0,66,66,0,1,0,1,0
62037,445,0,0,66,66,0,1,0,1,0
64234,445,0,0,67,67,0,1,0,1,0
55241,445,0,0,67,67,0,1,0,1,0
63517,445,0,0,66,66,0,1,0,1,0
58645,445,0,0,70,70,0,1,0,1,0
53403,445,0,0,69,69,0,1,0,1,0
58695,445,0,0,70,70,0,1,0,1,0
51334,445,0,0,70,70,0,1,0,1,0
51596,445,0,0,70,70,0,1,0,1,0
60890,445,0,0,70,70,0,1,0,1,0
61760,445,0,0,69,69,0,1,0,1,0
59529,445,0,0,70,70,0,1,0,1,0
49842,445,0,0,66,66,0,1,0,1,0
53286,445,0,0,66,66,0,1,0,1,0
65460,445,0,0,70,70,0,1,0,1,0
60864,445,0,0,70,70,0,1,0,1,0
57514,445,0,0,70,70,0,1,0,1,0
63576,445,0,0,66,66,0,1,0,1,0
55138,445,0,0,70,70,0,1,0,1,0
57476,445,0,0,66,66,0,1,0,1,0
49767,445,0,0,68,68,0,1,0,1,0
58663,445,0,0,70,70,0,1,0,1,0
59912,445,0,0,70,70,0,1,0,1,0
58296,445,0,0,66,66,0,1,0,1,0
64684,445,0,0,70,70,0,1,0,1,0
62725,445,0,0,70,70,0,1,0,1,0
56002,445,0,0,70,70,0,1,0,1,0
57289,445,0,0,70,70,0,1,0,1,0
60907,445,0,0,70,70,0,1,0,1,0
50865,445,0,0,66,66,0,1,0,1,0
59143,445,0,0,70,70,0,1,0,1,0
50416,445,0,0,70,70,0,1,0,1,0
54807,445,0,0,68,68,0,1,0,1,0
60411,445,0,0,70,70,0,1,0,1,0
53042,445,0,0,66,66,0,1,0,1,0
63941,445,0,0,70,70,0,1,0,1,0
57651,445,0,0,70,70,0,1,0,1,0
59316,445,0,0,70,70,0,1,0,1,0
57062,445,0,0,70,70,0,1,0,1,0
59270,445,0,0,70,70,0,1,0,1,0
54956,445,0,0,70,70,0,1,0,1,0
49996,445,0,0,70,70,0,1,0,1,0
59127,445,0,0,66,66,0,1,0,1,0
64212,445,0,0,66,66,0,1,0,1,0
60047,445,0,0,70,70,0,1,0,1,0
60174,445,0,0,66,66,0,1,0,1,0
62229,445,0,0,67,67,0,1,0,1,0
65038,445,0,0,69,69,0,1,0,1,0
61467,445,0,0,66,66,0,1,0,1,0
51583,445,0,0,70,70,0,1,0,1,0
50797,445,0,0,66,66,0,1,0,1,0
53028,445,0,0,70,70,0,1,0,1,0
52474,445,0,0,70,70,0,1,0,1,0
61016,445,0,0,69,69,0,1,0,1,0
58162,445,0,0,70,70,0,1,0,1,0
52881,445,0,0,69,69,0,1,0,1,0
63940,445,0,0,70,70,0,1,0,1,0
64287,445,0,0,66,66,0,1,0,1,0
50784,445,0,0,70,70,0,1,0,1,0
57231,445,0,0,70,70,0,1,0,1,0
53456,445,0,0,70,70,0,1,0,1,0
56524,445,0,0,66,66,0,1,0,1,0
65398,445,0,0,70,70,0,1,0,1,0
50673,445,0,0,66,66,0,1,0,1,0
56639,445,0,0,70,70,0,1,0,1,0
49283,445,0,0,69,69,0,1,0,1,0
59042,445,0,0,69,69,0,1,0,1,0
50506,445,0,0,70,70,0,1,0,1,0
62797,445,0,0,69,69,0,1,0,1,0
55229,445,0,0,70,70,0,1,0,1,0
57364,445,0,0,70,70,0,1,0,1,0
50351,445,0,0,66,66,0,1,0,1,0
57527,445,0,0,66,66,0,1,0,1,0
61257,445,0,0,66,66,0,1,0,1,0
61275,445,0,0,66,66,0,1,0,1,0
50413,445,0,0,66,66,0,1,0,1,0
62304,445,0,0,70,70,0,1,0,1,0
50599,445,0,0,66,66,0,1,0,1,0
60354,445,0,0,70,70,0,1,0,1,0
52608,445,0,0,70,70,0,1,0,1,0
54532,445,0,0,70,70,0,1,0,1,0
50226,445,0,0,69,69,0,1,0,1,0
60339,445,0,0,70,70,0,1,0,1,0
65318,445,0,0,68,68,0,1,0,1,0
55957,445,0,0,70,70,0,1,0,1,0
62874,445,0,0,66,66,0,1,0,1,0
63872,445,0,0,70,70,0,1,0,1,0
50613,445,0,0,66,66,0,1,0,1,0
51397,445,0,0,68,68,0,1,0,1,0
65029,445,0,0,70,70,0,1,0,1,0
63000,445,0,0,70,70,0,1,0,1,0
62392,445,0,0,70,70,0,1,0,1,0
62156,445,0,0,66,66,0,1,0,1,0
53755,445,0,0,66,66,0,1,0,1,0
55896,445,0,0,70,70,0,1,0,1,0
57074,445,0,0,66,66,0,1,0,1,0
51651,445,0,0,66,66,0,1,0,1,0
64490,445,0,0,69,69,0,1,0,1,0
55591,445,0,0,70,70,0,1,0,1,0
51021,445,0,0,66,66,0,1,0,1,0
55339,445,0,0,67,67,0,1,0,1,0
64816,445,0,0,70,70,0,1,0,1,0
50355,445,0,0,66,66,0,1,0,1,0
55932,445,0,0,68,68,0,1,0,1,0
63297,445,0,0,70,70,0,1,0,1,0
57884,445,0,0,70,70,0,1,0,1,0
64804,445,0,0,66,66,0,1,0,1,0
51308,445,0,0,70,70,0,1,0,1,0
61867,445,0,0,70,70,0,1,0,1,0
49300,445,0,0,67,67,0,1,0,1,0
62854,445,0,0,70,70,0,1,0,1,0
58554,445,0,0,70,70,0,1,0,1,0
51714,445,0,0,70,70,0,1,0,1,0
53493,445,0,0,66,66,0,1,0,1,0
50818,445,0,0,70,70,0,1,0,1,0
58164,445,0,0,67,67,0,1,0,1,0
58504,445,0,0,70,70,0,1,0,1,0
60804,445,0,0,66,66,0,1,0,1,0
56061,445,0,0,66,66,0,1,0,1,0
53415,445,0,0,70,70,0,1,0,1,0
58022,445,0,0,70,70,0,1,0,1,0
53725,445,0,0,70,70,0,1,0,1,0
61378,445,0,0,70,70,0,1,0,1,0
60335,445,0,0,70,70,0,1,0,1,0
54504,445,0,0,66,66,0,1,0,1,0
50626,445,0,0,66,66,0,1,0,1,0
61755,445,0,0,70,70,0,1,0,1,0
59101,445,0,0,70,70,0,1,0,1,0
56317,445,0,0,70,70,0,1,0,1,0
63943,445,0,0,66,66,0,1,0,1,0
61296,445,0,0,70,70,0,1,0,1,0
58199,445,0,0,67,67,0,1,0,1,0
54628,445,0,0,70,70,0,1,0,1,0
56324,445,0,0,70,70,0,1,0,1,0
62929,445,0,0,70,70,0,1,0,1,0
62214,445,0,0,68,68,0,1,0,1,0
51310,445,0,0,66,66,0,1,0,1,0
50608,445,0,0,66,66,0,1,0,1,0
61931,445,0,0,66,66,0,1,0,1,0
54908,445,0,0,66,66,0,1,0,1,0
60509,445,0,0,69,69,0,1,0,1,0
63303,445,0,0,70,70,0,1,0,1,0
60429,445,0,0,70,70,0,1,0,1,0
50272,445,0,0,70,70,0,1,0,1,0
52888,445,0,0,70,70,0,1,0,1,0
52989,445,0,0,70,70,0,1,0,1,0
58331,445,0,0,70,70,0,1,0,1,0
50044,445,0,0,66,66,0,1,0,1,0
55917,445,0,0,67,67,0,1,0,1,0
50270,445,0,0,70,70,0,1,0,1,0
58890,445,0,0,67,67,0,1,0,1,0
50049,445,0,0,68,68,0,1,0,1,0
57271,445,0,0,66,66,0,1,0,1,0
55635,445,0,0,67,67,0,1,0,1,0
56711,445,0,0,66,66,0,1,0,1,0
59788,445,0,0,70,70,0,1,0,1,0
59395,445,0,0,70,70,0,1,0,1,0
57223,445,0,0,66,66,0,1,0,1,0
53343,445,0,0,70,70,0,1,0,1,0
50726,445,0,0,70,70,0,1,0,1,0
50068,445,0,0,70,70,0,1,0,1,0
62837,445,0,0,70,70,0,1,0,1,0
58981,445,0,0,70,70,0,1,0,1,0
54797,445,0,0,68,68,0,1,0,1,0
61852,445,0,0,66,66,0,1,0,1,0
57486,445,0,0,70,70,0,1,0,1,0
63511,445,0,0,68,68,0,1,0,1,0
64562,445,0,0,70,70,0,1,0,1,0
49938,445,0,0,70,70,0,1,0,1,0
49330,445,0,0,66,66,0,1,0,1,0
63923,445,0,0,70,70,0,1,0,1,0
56454,445,0,0,66,66,0,1,0,1,0
52940,445,0,0,67,67,0,1,0,1,0
50767,445,0,0,70,70,0,1,0,1,0
64344,445,0,0,70,70,0,1,0,1,0
55631,445,0,0,69,69,0,1,0,1,0
64232,445,0,0,66,66,0,1,0,1,0
64871,445,0,0,70,70,0,1,0,1,0
49813,445,0,0,70,70,0,1,0,1,0
50877,445,0,0,70,70,0,1,0,1,0
54052,445,0,0,70,70,0,1,0,1,0
54186,445,0,0,70,70,0,1,0,1,0
50425,445,0,0,70,70,0,1,0,1,0
55855,445,0,0,70,70,0,1,0,1,0
61993,445,0,0,70,70,0,1,0,1,0
64745,445,0,0,66,66,0,1,0,1,0
65183,445,0,0,70,70,0,1,0,1,0
63621,445,0,0,70,70,0,1,0,1,0
64265,445,0,0,70,70,0,1,0,1,0
58166,445,0,0,66,66,0,1,0,1,0
56897,445,0,0,66,66,0,1,0,1,0
58934,445,0,0,66,66,0,1,0,1,0
49505,445,0,0,69,69,0,1,0,1,0
53507,445,0,0,70,70,0,1,0,1,0
56234,445,0,0,69,69,0,1,0,1,0
52224,445,0,0,70,70,0,1,0,1,0
50927,445,0,0,66,66,0,1,0,1,0
65095,445,0,0,70,70,0,1,0,1,0
62328,445,0,0,70,70,0,1,0,1,0
62252,445,0,0,70,70,0,1,0,1,0
63482,445,0,0,69,69,0,1,0,1,0
53685,445,0,0,66,66,0,1,0,1,0
50181,445,0,0,67,67,0,1,0,1,0
59479,445,0,0,70,70,0,1,0,1,0
52501,445,0,0,69,69,0,1,0,1,0
51362,445,0,0,66,66,0,1,0,1,0
64510,445,0,0,69,69,0,1,0,1,0
60911,445,0,0,70,70,0,1,0,1,0
64275,445,0,0,67,67,0,1,0,1,0
54988,445,0,0,70,70,0,1,0,1,0
61550,445,0,0,70,70,0,1,0,1,0
54313,445,0,0,70,70,0,1,0,1,0
50273,445,0,0,70,70,0,1,0,1,0
56642,445,0,0,70,70,0,1,0,1,0
60050,445,0,0,66,66,0,1,0,1,0
64469,445,0,0,66,66,0,1,0,1,0
50595,445,0,0,66,66,0,1,0,1,0
57162,445,0,0,70,70,0,1,0,1,0
57327,445,0,0,70,70,0,1,0,1,0
64274,445,0,0,68,68,0,1,0,1,0
62830,445,0,0,66,66,0,1,0,1,0
54497,445,0,0,70,70,0,1,0,1,0
51263,445,0,0,66,66,0,1,0,1,0
57149,445,0,0,66,66,0,1,0,1,0
55260,445,0,0,70,70,0,1,0,1,0
57941,445,0,0,70,70,0,1,0,1,0
49871,445,0,0,70,70,0,1,0,1,0
59920,445,0,0,66,66,0,1,0,1,0
56886,445,0,0,70,70,0,1,0,1,0
55116,445,0,0,66,66,0,1,0,1,0
57451,445,0,0,70,70,0,1,0,1,0
50386,445,0,0,70,70,0,1,0,1,0
50729,445,0,0,66,66,0,1,0,1,0
53154,445,0,0,70,70,0,1,0,1,0
50289,445,0,0,66,66,0,1,0,1,0
65177,445,0,0,66,66,0,1,0,1,0
50365,445,0,0,67,67,0,1,0,1,0
50676,445,0,0,70,70,0,1,0,1,0
63258,445,0,0,68,68,0,1,0,1,0
49966,445,0,0,66,66,0,1,0,1,0
56573,445,0,0,70,70,0,1,0,1,0
55952,445,0,0,68,68,0,1,0,1,0
52739,445,0,0,70,70,0,1,0,1,0
50820,445,0,0,70,70,0,1,0,1,0
52089,445,0,0,66,66,0,1,0,1,0
54730,445,0,0,69,69,0,1,0,1,0
65286,445,0,0,70,70,0,1,0,1,0
60015,445,0,0,70,70,0,1,0,1,0
55703,445,0,0,70,70,0,1,0,1,0
60953,445,0,0,66,66,0,1,0,1,0
50614,445,0,0,70,70,0,1,0,1,0
59162,445,0,0,70,70,0,1,0,1,0
49510,445,0,0,70,70,0,1,0,1,0
53876,445,0,0,70,70,0,1,0,1,0
65327,445,0,0,69,69,0,1,0,1,0
49796,445,0,0,70,70,0,1,0,1,0
51038,445,0,0,70,70,0,1,0,1,0
55565,445,0,0,70,70,0,1,0,1,0
61400,445,0,0,66,66,0,1,0,1,0
57107,445,0,0,70,70,0,1,0,1,0
63711,445,0,0,66,66,0,1,0,1,0
55967,445,0,0,70,70,0,1,0,1,0
61663,445,0,0,70,70,0,1,0,1,0
60657,445,0,0,70,70,0,1,0,1,0
50544,445,0,0,66,66,0,1,0,1,0
62048,445,0,0,68,68,0,1,0,1,0
60824,445,0,0,66,66,0,1,0,1,0
63021,445,0,0,70,70,0,1,0,1,0
53941,445,0,0,66,66,0,1,0,1,0
62724,445,0,0,70,70,0,1,0,1,0
64300,445,0,0,70,70,0,1,0,1,0
50944,445,0,0,70,70,0,1,0,1,0
52859,445,0,0,70,70,0,1,0,1,0
59293,445,0,0,67,67,0,1,0,1,0
61929,445,0,0,70,70,0,1,0,1,0
49351,445,0,0,70,70,0,1,0,1,0
63666,445,0,0,70,70,0,1,0,1,0
54499,445,0,0,70,70,0,1,0,1,0
60986,445,0,0,70,70,0,1,0,1,0
56578,445,0,0,66,66,0,1,0,1,0
52199,445,0,0,67,67,0,1,0,1,0
57165,445,0,0,70,70,0,1,0,1,0
59596,445,0,0,66,66,0,1,0,1,0
63451,445,0,0,68,68,0,1,0,1,0
60812,445,0,0,70,70,0,1,0,1,0
50321,445,0,0,70,70,0,1,0,1,0
51165,445,0,0,66,66,0,1,0,1,0
60756,445,0,0,70,70,0,1,0,1,0
56066,445,0,0,66,66,0,1,0,1,0
55258,445,0,0,70,70,0,1,0,1,0
59841,445,0,0,70,70,0,1,0,1,0
50737,445,0,0,66,66,0,1,0,1,0
65365,445,0,0,70,70,0,1,0,1,0
49494,445,0,0,70,70,0,1,0,1,0
65156,445,0,0,70,70,0,1,0,1,0
53816,445,0,0,67,67,0,1,0,1,0
52902,445,0,0,66,66,0,1,0,1,0
64044,445,0,0,70,70,0,1,0,1,0
55730,445,0,0,70,70,0,1,0,1,0
55834,445,0,0,70,70,0,1,0,1,0
59638,445,0,0,68,68,0,1,0,1,0
54012,445,0,0,66,66,0,1,0,1,0
62592,445,0,0,70,70,0,1,0,1,0
61619,445,0,0,67,67,0,1,0,1,0
60302,445,0,0,67,67,0,1,0,1,0
62386,445,0,0,70,70,0,1,0,1,0
52401,445,0,0,70,70,0,1,0,1,0
59529,445,0,0,70,70,0,1,0,1,0
51544,445,0,0,70,70,0,1,0,1,0
57708,445,0,0,70,70,0,1,0,1,0
59999,445,0,0,69,69,0,1,0,1,0
61405,445,0,0,66,66,0,1,0,1,0
63125,445,0,0,66,66,0,1,0,1,0
53015,445,0,0,70,70,0,1,0,1,0
65316,445,0,0,70,70,0,1,0,1,0
54388,445,0,0,70,70,0,1,0,1,0
49254,445,0,0,66,66,0,1,0,1,0
64453,445,0,0,68,68,0,1,0,1,0
54908,445,0,0,67,67,0,1,0,1,0
51038,445,0,0,70,70,0,1,0,1,0
50445,445,0,0,70,70,0,1,0,1,0
50285,445,0,0,66,66,0,1,0,1,0
57320,445,0,0,70,70,0,1,0,1,0
54626,445,0,0,70,70,0,1,0,1,0
59126,445,0,0,70,70,0,1,0,1,0
62142,445,0,0,67,67,0,1,0,1,0
51142,445,0,0,68,68,0,1,0,1,0
58180,445,0,0,66,66,0,1,0,1,0
59570,445,0,0,70,70,0,1,0,1,0
56278,445,0,0,69,69,0,1,0,1,0
61238,445,0,0,70,70,0,1,0,1,0
51233,445,0,0,67,67,0,1,0,1,0
64079,445,0,0,68,68,0,1,0,1,0
54871,445,0,0,70,70,0,1,0,1,0
64482,445,0,0,70,70,0,1,0,1,0
51076,445,0,0,70,70,0,1,0,1,0
63424,445,0,0,68,68,0,1,0,1,0
60637,445,0,0,67,67,0,1,0,1,0
58949,445,0,0,66,66,0,1,0,1,0
49364,445,0,0,70,70,0,1,0,1,0
53599,445,0,0,70,70,0,1,0,1,0
56776,445,0,0,69,69,0,1,0,1,0
50779,445,0,0,70,70,0,1,0,1,0
53286,445,0,0,70,70,0,1,0,1,0
64293,445,0,0,66,66,0,1,0,1,0
55037,445,0,0,66,66,0,1,0,1,0
50780,445,0,0,70,70,0,1,0,1,0
55523,445,0,0,70,70,0,1,0,1,0
59454,445,0,0,66,66,0,1,0,1,0
53855,445,0,0,70,70,0,1,0,1,0
59770,445,0,0,68,68,0,1,0,1,0
50482,445,0,0,66,66,0,1,0,1,0
54893,445,0,0,70,70,0,1,0,1,0
56705,445,0,0,66,66,0,1,0,1,0
55488,445,0,0,70,70,0,1,0,1,0
56452,445,0,0,66,66,0,1,0,1,0
63667,445,0,0,68,68,0,1,0,1,0
50464,445,0,0,66,66,0,1,0,1,0
54263,445,0,0,66,66,0,1,0,1,0
65071,445,0,0,70,70,0,1,0,1,0
50005,445,0,0,70,70,0,1,0,1,0
52853,445,0,0,67,67,0,1,0,1,0
58914,445,0,0,68,68,0,1,0,1,0
50164,445,0,0,70,70,0,1,0,1,0
57282,445,0,0,70,70,0,1,0,1,0
64034,445,0,0,70,70,0,1,0,1,0
50592,445,0,0,66,66,0,1,0,1,0
60456,445,0,0,70,70,0,1,0,1,0
65079,445,0,0,70,70,0,1,0,1,0
54988,445,0,0,70,70,0,1,0,1,0
60743,445,0,0,70,70,0,1,0,1,0
49372,445,0,0,70,70,0,1,0,1,0
61464,445,0,0,66,66,0,1,0,1,0
58403,445,0,0,69,69,0,1,0,1,0
61275,445,0,0,66,66,0,1,0,1,0
49885,445,0,0,70,70,0,1,0,1,0
62650,445,0,0,68,68,0,1,0,1,0
63776,445,0,0,66,66,0,1,0,1,0
57557,445,0,0,70,70,0,1,0,1,0
64717,445,0,0,67,67,0,1,0,1,0
52531,445,0,0,67,67,0,1,0,1,0
62665,445,0,0,66,66,0,1,0,1,0
50017,445,0,0,70,70,0,1,0,1,0
61231,445,0,0,67,67,0,1,0,1,0
53879,445,0,0,66,66,0,1,0,1,0
55796,445,0,0,69,69,0,1,0,1,0
63204,445,0,0,66,66,0,1,0,1,0
49256,445,0,0,68,68,0,1,0,1,0
50253,445,0,0,70,70,0,1,0,1,0
61571,445,0,0,70,70,0,1,0,1,0
50427,445,0,0,69,69,0,1,0,1,0
50069,445,0,0,70,70,0,1,0,1,0
55419,445,0,0,70,70,0,1,0,1,0
56577,445,0,0,66,66,0,1,0,1,0
61122,445,0,0,70,70,0,1,0,1,0
60406,445,0,0,66,66,0,1,0,1,0
49301,445,0,0,68,68,0,1,0,1,0
50638,445,0,0,66,66,0,1,0,1,0
55436,445,0,0,70,70,0,1,0,1,0
58760,445,0,0,66,66,0,1,0,1,0
53665,445,0,0,70,70,0,1,0,1,0
62585,445,0,0,70,70,0,1,0,1,0
64969,445,0,0,70,70,0,1,0,1,0
53103,445,0,0,70,70,0,1,0,1,0
58418,445,0,0,70,70,0,1,0,1,0
60467,445,0,0,67,67,0,1,0,1,0
62404,445,0,0,70,70,0,1,0,1,0
60956,445,0,0,66,66,0,1,0,1,0
50734,445,0,0,66,66,0,1,0,1,0
59373,445,0,0,68,68,0,1,0,1,0
64853,445,0,0,69,69,0,1,0,1,0
63970,445,0,0,66,66,0,1,0,1,0
54127,445,0,0,70,70,0,1,0,1,0
50601,445,0,0,66,66,0,1,0,1,0
53864,445,0,0,69,69,0,1,0,1,0
62213,445,0,0,70,70,0,1,0,1,0
50907,445,0,0,67,67,0,1,0,1,0
55469,445,0,0,69,69,0,1,0,1,0
54422,445,0,0,70,70,0,1,0,1,0
65071,445,0,0,70,70,0,1,0,1,0
53550,445,0,0,66,66,0,1,0,1,0
54018,445,0,0,70,70,0,1,0,1,0
63875,445,0,0,70,70,0,1,0,1,0
60074,445,0,0,69,69,0,1,0,1,0
54946,445,0,0,70,70,0,1,0,1,0
53957,445,0,0,70,70,0,1,0,1,0
60655,445,0,0,70,70,0,1,0,1,0
59230,445,0,0,70,70,0,1,0,1,0
61334,445,0,0,66,66,0,1,0,1,0
61494,445,0,0,66,66,0,1,0,1,0
49850,445,0,0,68,68,0,1,0,1,0
51655,445,0,0,70,70,0,1,0,1,0
56647,445,0,0,66,66,0,1,0,1,0
54781,445,0,0,67,67,0,1,0,1,0
50001,445,0,0,70,70,0,1,0,1,0
50062,445,0,0,70,70,0,1,0,1,0
50638,445,0,0,66,66,0,1,0,1,0
49807,445,0,0,70,70,0,1,0,1,0
53794,445,0,0,70,70,0,1,0,1,0
55593,445,0,0,70,70,0,1,0,1,0
52987,445,0,0,66,66,0,1,0,1,0
65239,445,0,0,69,69,0,1,0,1,0
55500,445,0,0,70,70,0,1,0,1,0
49779,445,0,0,70,70,0,1,0,1,0
60687,445,0,0,70,70,0,1,0,1,0
57878,445,0,0,70,70,0,1,0,1,0
55363,445,0,0,70,70,0,1,0,1,0
63237,445,0,0,70,70,0,1,0,1,0
52694,445,0,0,70,70,0,1,0,1,0
52085,445,0,0,66,66,0,1,0,1,0
62299,445,0,0,70,70,0,1,0,1,0
61397,445,0,0,70,70,0,1,0,1,0
65253,445,0,0,70,70,0,1,0,1,0
51677,445,0,0,70,70,0,1,0,1,0
60373,445,0,0,70,70,0,1,0,1,0
51311,445,0,0,66,66,0,1,0,1,0
64430,445,0,0,70,70,0,1,0,1,0
52891,445,0,0,70,70,0,1,0,1,0
57988,445,0,0,70,70,0,1,0,1,0
49736,445,0,0,69,69,0,1,0,1,0
50863,445,0,0,66,66,0,1,0,1,0
60868,445,0,0,70,70,0,1,0,1,0
60092,445,0,0,70,70,0,1,0,1,0
50384,445,0,0,70,70,0,1,0,1,0
49494,445,0,0,70,70,0,1,0,1,0
50264,445,0,0,70,70,0,1,0,1,0
58575,445,0,0,70,70,0,1,0,1,0
64377,445,0,0,68,68,0,1,0,1,0
55058,445,0,0,70,70,0,1,0,1,0
64053,445,0,0,70,70,0,1,0,1,0
51912,445,0,0,70,70,0,1,0,1,0
55806,445,0,0,66,66,0,1,0,1,0
63468,445,0,0,66,66,0,1,0,1,0
49185,445,0,0,67,67,0,1,0,1,0
50826,445,0,0,70,70,0,1,0,1,0
50609,445,0,0,66,66,0,1,0,1,0
59140,445,0,0,66,66,0,1,0,1,0
63596,445,0,0,66,66,0,1,0,1,0
62362,445,0,0,66,66,0,1,0,1,0
57925,445,0,0,70,70,0,1,0,1,0
53086,445,0,0,69,69,0,1,0,1,0
61186,445,0,0,70,70,0,1,0,1,0
62283,445,0,0,66,66,0,1,0,1,0
57981,445,0,0,70,70,0,1,0,1,0
56451,445,0,0,66,66,0,1,0,1,0
55086,445,0,0,70,70,0,1,0,1,0
57371,445,0,0,70,70,0,1,0,1,0
57954,445,0,0,69,69,0,1,0,1,0
54158,445,0,0,70,70,0,1,0,1,0
59891,445,0,0,70,70,0,1,0,1,0
50907,445,0,0,70,70,0,1,0,1,0
61691,445,0,0,70,70,0,1,0,1,0
64802,445,0,0,70,70,0,1,0,1,0
54005,445,0,0,70,70,0,1,0,1,0
56018,445,0,0,69,69,0,1,0,1,0
58238,445,0,0,69,69,0,1,0,1,0
51073,445,0,0,70,70,0,1,0,1,0
64650,445,0,0,67,67,0,1,0,1,0
57217,445,0,0,70,70,0,1,0,1,0
54345,445,0,0,70,70,0,1,0,1,0
60160,445,0,0,66,66,0,1,0,1,0
55313,445,0,0,70,70,0,1,0,1,0
62748,445,0,0,67,67,0,1,0,1,0
62135,445,0,0,68,68,0,1,0,1,0
51044,445,0,0,70,70,0,1,0,1,0
51014,445,0,0,68,68,0,1,0,1,0
51320,445,0,0,70,70,0,1,0,1,0
49281,445,0,0,70,70,0,1,0,1,0
60159,445,0,0,66,66,0,1,0,1,0
55129,445,0,0,70,70,0,1,0,1,0
49303,445,0,0,70,70,0,1,0,1,0
62821,445,0,0,70,70,0,1,0,1,0
64455,445,0,0,70,70,0,1,0,1,0
54239,445,0,0,70,70,0,1,0,1,0
53546,445,0,0,70,70,0,1,0,1,0
49413,445,0,0,67,67,0,1,0,1,0
49233,445,0,0,70,70,0,1,0,1,0
60748,445,0,0,69,69,0,1,0,1,0
53880,445,0,0,66,66,0,1,0,1,0
54347,445,0,0,70,70,0,1,0,1,0
56576,445,0,0,68,68,0,1,0,1,0
56581,445,0,0,66,66,0,1,0,1,0
55387,445,0,0,70,70,0,1,0,1,0
62213,445,0,0,70,70,0,1,0,1,0
52404,445,0,0,66,66,0,1,0,1,0
56483,445,0,0,70,70,0,1,0,1,0
52522,445,0,0,69,69,0,1,0,1,0
56964,445,0,0,69,69,0,1,0,1,0
61740,445,0,0,68,68,0,1,0,1,0
51597,445,0,0,70,70,0,1,0,1,0
55198,445,0,0,70,70,0,1,0,1,0
60328,445,0,0,70,70,0,1,0,1,0
57158,445,0,0,70,70,0,1,0,1,0
59509,445,0,0,70,70,0,1,0,1,0
49578,445,0,0,70,70,0,1,0,1,0
62573,445,0,0,68,68,0,1,0,1,0
58519,445,0,0,70,70,0,1,0,1,0
51047,445,0,0,66,66,0,1,0,1,0
61820,445,0,0,70,70,0,1,0,1,0
55002,445,0,0,70,70,0,1,0,1,0
52876,445,0,0,66,66,0,1,0,1,0
49218,445,0,0,66,66,0,1,0,1,0
53582,445,0,0,67,67,0,1,0,1,0
53173,445,0,0,70,70,0,1,0,1,0
54173,445,0,0,70,70,0,1,0,1,0
58188,445,0,0,70,70,0,1,0,1,0
52183,445,0,0,70,70,0,1,0,1,0
54319,445,0,0,66,66,0,1,0,1,0
56686,445,0,0,70,70,0,1,0,1,0
60309,445,0,0,66,66,0,1,0,1,0
49618,445,0,0,66,66,0,1,0,1,0
61389,445,0,0,67,67,0,1,0,1,0
61532,445,0,0,66,66,0,1,0,1,0
58133,445,0,0,70,70,0,1,0,1,0
62153,445,0,0,70,70,0,1,0,1,0
51788,445,0,0,68,68,0,1,0,1,0
50535,445,0,0,66,66,0,1,0,1,0
50023,445,0,0,70,70,0,1,0,1,0
49971,445,0,0,70,70,0,1,0,1,0
61573,445,0,0,70,70,0,1,0,1,0
56470,445,0,0,70,70,0,1,0,1,0
52114,445,0,0,70,70,0,1,0,1,0
59781,445,0,0,70,70,0,1,0,1,0
62812,445,0,0,67,67,0,1,0,1,0
59123,445,0,0,70,70,0,1,0,1,0
59346,445,0,0,70,70,0,1,0,1,0
51340,445,0,0,70,70,0,1,0,1,0
51164,445,0,0,69,69,0,1,0,1,0
65184,445,0,0,70,70,0,1,0,1,0
54517,445,0,0,67,67,0,1,0,1,0
65066,445,0,0,66,66,0,1,0,1,0
53723,445,0,0,70,70,0,1,0,1,0
61760,445,0,0,70,70,0,1,0,1,0
53496,445,0,0,66,66,0,1,0,1,0
58575,445,0,0,67,67,0,1,0,1,0
61204,445,0,0,70,70,0,1,0,1,0
65058,445,0,0,70,70,0,1,0,1,0
52353,445,0,0,70,70,0,1,0,1,0
53875,445,0,0,70,70,0,1,0,1,0
59141,445,0,0,67,67,0,1,0,1,0
50307,445,0,0,70,70,0,1,0,1,0
55708,445,0,0,70,70,0,1,0,1,0
63768,445,0,0,70,70,0,1,0,1,0
51110,445,0,0,66,66,0,1,0,1,0
56834,445,0,0,70,70,0,1,0,1,0
55976,445,0,0,70,70,0,1,0,1,0
59139,445,0,0,68,68,0,1,0,1,0
52461,445,0,0,70,70,0,1,0,1,0
51711,445,0,0,70,70,0,1,0,1,0
54268,445,0,0,66,66,0,1,0,1,0
53657,445,0,0,70,70,0,1,0,1,0
57196,445,0,0,70,70,0,1,0,1,0
57357,445,0,0,70,70,0,1,0,1,0
52637,445,0,0,70,70,0,1,0,1,0
53960,445,0,0,68,68,0,1,0,1,0
60307,445,0,0,66,66,0,1,0,1,0
62155,445,0,0,66,66,0,1,0,1,0
55619,445,0,0,70,70,0,1,0,1,0
54775,445,0,0,70,70,0,1,0,1,0
62869,445,0,0,70,70,0,1,0,1,0
64605,445,0,0,68,68,0,1,0,1,0
55357,445,0,0,70,70,0,1,0,1,0
58075,445,0,0,66,66,0,1,0,1,0
51788,445,0,0,70,70,0,1,0,1,0
59115,445,0,0,66,66,0,1,0,1,0
62775,445,0,0,68,68,0,1,0,1,0
51789,445,0,0,70,70,0,1,0,1,0
51655,445,0,0,70,70,0,1,0,1,0
51902,445,0,0,70,70,0,1,0,1,0
59914,445,0,0,66,66,0,1,0,1,0
65325,445,0,0,69,69,0,1,0,1,0
50594,445,0,0,66,66,0,1,0,1,0
49252,445,0,0,70,70,0,1,0,1,0
61623,445,0,0,68,68,0,1,0,1,0
51529,445,0,0,70,70,0,1,0,1,0
62304,445,0,0,70,70,0,1,0,1,0
63984,445,0,0,66,66,0,1,0,1,0
59694,445,0,0,70,70,0,1,0,1,0
61073,445,0,0,70,70,0,1,0,1,0
60712,445,0,0,66,66,0,1,0,1,0
52406,445,0,0,66,66,0,1,0,1,0
52698,445,0,0,70,70,0,1,0,1,0
58628,445,0,0,66,66,0,1,0,1,0
55464,445,0,0,70,70,0,1,0,1,0
60418,445,0,0,67,67,0,1,0,1,0
52565,445,0,0,70,70,0,1,0,1,0
64023,445,0,0,70,70,0,1,0,1,0
52647,445,0,0,69,69,0,1,0,1,0
49937,445,0,0,70,70,0,1,0,1,0
59148,445,0,0,70,70,0,1,0,1,0
54056,445,0,0,70,70,0,1,0,1,0
56963,445,0,0,66,66,0,1,0,1,0
63387,445,0,0,70,70,0,1,0,1,0
52371,445,0,0,70,70,0,1,0,1,0
53117,445,0,0,70,70,0,1,0,1,0
52453,445,0,0,70,70,0,1,0,1,0
62583,445,0,0,67,67,0,1,0,1,0
65227,445,0,0,70,70,0,1,0,1,0
56661,445,0,0,66,66,0,1,0,1,0
65014,445,0,0,67,67,0,1,0,1,0
49577,445,0,0,70,70,0,1,0,1,0
61201,445,0,0,70,70,0,1,0,1,0
59089,445,0,0,70,70,0,1,0,1,0
57621,445,0,0,70,70,0,1,0,1,0
58214,445,0,0,70,70,0,1,0,1,0
57708,445,0,0,70,70,0,1,0,1,0
53104,445,0,0,70,70,0,1,0,1,0
53165,445,0,0,70,70,0,1,0,1,0
62944,445,0,0,70,70,0,1,0,1,0
50021,445,0,0,70,70,0,1,0,1,0
57465,445,0,0,69,69,0,1,0,1,0
51795,445,0,0,70,70,0,1,0,1,0
63237,445,0,0,69,69,0,1,0,1,0
59945,445,0,0,66,66,0,1,0,1,0
55330,445,0,0,70,70,0,1,0,1,0
52858,445,0,0,70,70,0,1,0,1,0
63930,445,0,0,70,70,0,1,0,1,0
64034,445,0,0,66,66,0,1,0,1,0
50154,445,0,0,70,70,0,1,0,1,0
63006,445,0,0,70,70,0,1,0,1,0
49494,445,0,0,67,67,0,1,0,1,0
59294,445,0,0,69,69,0,1,0,1,0
50838,445,0,0,70,70,0,1,0,1,0
59245,445,0,0,70,70,0,1,0,1,0
53794,445,0,0,70,70,0,1,0,1,0
55107,445,0,0,70,70,0,1,0,1,0
58945,445,0,0,66,66,0,1,0,1,0
58003,445,0,0,69,69,0,1,0,1,0
64739,445,0,0,70,70,0,1,0,1,0
55723,445,0,0,70,70,0,1,0,1,0
51690,445,0,0,70,70,0,1,0,1,0
53574,445,0,0,67,67,0,1,0,1,0
63359,445,0,0,70,70,0,1,0,1,0
65259,445,0,0,70,70,0,1,0,1,0
50396,445,0,0,70,70,0,1,0,1,0
51811,445,0,0,70,70,0,1,0,1,0
51434,445,0,0,69,69,0,1,0,1,0
61878,445,0,0,67,67,0,1,0,1,0
50827,445,0,0,68,68,0,1,0,1,0
60997,445,0,0,70,70,0,1,0,1,0
60439,445,0,0,67,67,0,1,0,1,0
54245,445,0,0,67,67,0,1,0,1,0
52787,445,0,0,66,66,0,1,0,1,0
49946,445,0,0,70,70,0,1,0,1,0
58151,445,0,0,70,70,0,1,0,1,0
65268,445,0,0,69,69,0,1,0,1,0
62638,445,0,0,70,70,0,1,0,1,0
63957,445,0,0,70,70,0,1,0,1,0
64599,445,0,0,70,70,0,1,0,1,0
57677,445,0,0,70,70,0,1,0,1,0
64325,445,0,0,69,69,0,1,0,1,0
60311,445,0,0,68,68,0,1,0,1,0
56448,445,0,0,66,66,0,1,0,1,0
52347,445,0,0,67,67,0,1,0,1,0
51656,445,0,0,70,70,0,1,0,1,0
60044,445,0,0,66,66,0,1,0,1,0
55045,445,0,0,70,70,0,1,0,1,0
61442,445,0,0,68,68,0,1,0,1,0
52173,445,0,0,66,66,0,1,0,1,0
58887,445,0,0,66,66,0,1,0,1,0
60149,445,0,0,70,70,0,1,0,1,0
62616,445,0,0,70,70,0,1,0,1,0
61774,445,0,0,66,66,0,1,0,1,0
51543,445,0,0,70,70,0,1,0,1,0
53626,445,0,0,70,70,0,1,0,1,0
61241,445,0,0,70,70,0,1,0,1,0
64884,445,0,0,66,66,0,1,0,1,0
58152,445,0,0,70,70,0,1,0,1,0
64837,445,0,0,70,70,0,1,0,1,0
51382,445,0,0,69,69,0,1,0,1,0
63435,445,0,0,70,70,0,1,0,1,0
49474,445,0,0,70,70,0,1,0,1,0
50333,445,0,0,66,66,0,1,0,1,0
59079,445,0,0,66,66,0,1,0,1,0
63624,445,0,0,70,70,0,1,0,1,0
50910,445,0,0,70,70,0,1,0,1,0
58373,445,0,0,70,70,0,1,0,1,0
50807,445,0,0,66,66,0,1,0,1,0
57732,445,0,0,66,66,0,1,0,1,0
58851,445,0,0,70,70,0,1,0,1,0
49264,445,0,0,67,67,0,1,0,1,0
51360,445,0,0,68,68,0,1,0,1,0
55056,445,0,0,70,70,0,1,0,1,0
60230,445,0,0,70,70,0,1,0,1,0
59312,445,0,0,69,69,0,1,0,1,0
58189,445,0,0,70,70,0,1,0,1,0
59270,445,0,0,66,66,0,1,0,1,0
62210,445,0,0,70,70,0,1,0,1,0
65185,445,0,0,70,70,0,1,0,1,0
62087,445,0,0,67,67,0,1,0,1,0
49712,445,0,0,66,66,0,1,0,1,0
61772,445,0,0,66,66,0,1,0,1,0
49785,445,0,0,70,70,0,1,0,1,0
49509,445,0,0,68,68,0,1,0,1,0
49324,445,0,0,70,70,0,1,0,1,0
59271,445,0,0,68,68,0,1,0,1,0
55173,445,0,0,70,70,0,1,0,1,0
62042,445,0,0,70,70,0,1,0,1,0
57068,445,0,0,70,70,0,1,0,1,0
65013,445,0,0,68,68,0,1,0,1,0
55842,445,0,0,70,70,0,1,0,1,0
60091,445,0,0,70,70,0,1,0,1,0
62484,445,0,0,69,69,0,1,0,1,0
63669,445,0,0,68,68,0,1,0,1,0
50782,445,0,0,66,66,0,1,0,1,0
50549,445,0,0,70,70,0,1,0,1,0
61878,445,0,0,70,70,0,1,0,1,0
59056,445,0,0,70,70,0,1,0,1,0
59641,445,0,0,66,66,0,1,0,1,0
58524,445,0,0,70,70,0,1,0,1,0
60377,445,0,0,66,66,0,1,0,1,0
64423,445,0,0,66,66,0,1,0,1,0
50273,445,0,0,66,66,0,1,0,1,0
57361,445,0,0,70,70,0,1,0,1,0
54574,445,0,0,66,66,0,1,0,1,0
62062,445,0,0,70,70,0,1,0,1,0
63730,445,0,0,70,70,0,1,0,1,0
50895,445,0,0,66,66,0,1,0,1,0
60099,445,0,0,67,67,0,1,0,1,0
64652,445,0,0,70,70,0,1,0,1,0
62541,445,0,0,68,68,0,1,0,1,0
57947,445,0,0,67,67,0,1,0,1,0
55844,445,0,0,66,66,0,1,0,1,0
57325,445,0,0,70,70,0,1,0,1,0
62301,445,0,0,70,70,0,1,0,1,0
60724,445,0,0,67,67,0,1,0,1,0
59630,445,0,0,70,70,0,1,0,1,0
49256,445,0,0,70,70,0,1,0,1,0
50482,445,0,0,66,66,0,1,0,1,0
49441,445,0,0,66,66,0,1,0,1,0
61833,445,0,0,67,67,0,1,0,1,0
62274,445,0,0,70,70,0,1,0,1,0
57964,445,0,0,70,70,0,1,0,1,0
50456,445,0,0,70,70,0,1,0,1,0
52821,445,0,0,70,70,0,1,0,1,0
63261,445,0,0,70,70,0,1,0,1,0
56736,445,0,0,70,70,0,1,0,1,0
56103,445,0,0,70,70,0,1,0,1,0
51074,445,0,0,70,70,0,1,0,1,0
50998,445,0,0,70,70,0,1,0,1,0
62272,445,0,0,70,70,0,1,0,1,0
58220,445,0,0,70,70,0,1,0,1,0
54303,445,0,0,70,70,0,1,0,1,0
50609,445,0,0,70,70,0,1,0,1,0
52339,445,0,0,69,69,0,1,0,1,0
60730,445,0,0,70,70,0,1,0,1,0
54674,445,0,0,70,70,0,1,0,1,0
59200,445,0,0,70,70,0,1,0,1,0
61439,445,0,0,70,70,0,1,0,1,0
58952,445,0,0,66,66,0,1,0,1,0
57621,445,0,0,70,70,0,1,0,1,0
59346,445,0,0,70,70,0,1,0,1,0
50642,445,0,0,70,70,0,1,0,1,0
63811,445,0,0,70,70,0,1,0,1,0
61876,445,0,0,70,70,0,1,0,1,0
50909,445,0,0,70,70,0,1,0,1,0
52341,445,0,0,66,66,0,1,0,1,0
64163,445,0,0,70,70,0,1,0,1,0
65312,445,0,0,70,70,0,1,0,1,0
49401,445,0,0,66,66,0,1,0,1,0
62258,445,0,0,70,70,0,1,0,1,0
61656,445,0,0,68,68,0,1,0,1,0
55333,445,0,0,70,70,0,1,0,1,0
52997,445,0,0,67,67,0,1,0,1,0
51014,445,0,0,67,67,0,1,0,1,0
62689,445,0,0,68,68,0,1,0,1,0
61734,445,0,0,70,70,0,1,0,1,0
50410,445,0,0,66,66,0,1,0,1,0
63429,445,0,0,70,70,0,1,0,1,0
59012,445,0,0,70,70,0,1,0,1,0
55696,445,0,0,70,70,0,1,0,1,0
52908,445,0,0,66,66,0,1,0,1,0
55030,445,0,0,67,67,0,1,0,1,0
60347,445,0,0,70,70,0,1,0,1,0
60168,445,0,0,70,70,0,1,0,1,0
56233,445,0,0,70,70,0,1,0,1,0
54006,445,0,0,66,66,0,1,0,1,0
59762,445,0,0,70,70,0,1,0,1,0
64625,445,0,0,70,70,0,1,0,1,0
49604,445,0,0,70,70,0,1,0,1,0
52876,445,0,0,69,69,0,1,0,1,0
60440,445,0,0,69,69,0,1,0,1,0
57986,445,0,0,70,70,0,1,0,1,0
55773,445,0,0,70,70,0,1,0,1,0
60818,445,0,0,70,70,0,1,0,1,0
49954,445,0,0,67,67,0,1,0,1,0
51132,445,0,0,70,70,0,1,0,1,0
64155,445,0,0,69,69,0,1,0,1,0
52757,445,0,0,66,66,0,1,0,1,0
50684,445,0,0,70,70,0,1,0,1,0
58501,445,0,0,66,66,0,1,0,1,0
58041,445,0,0,67,67,0,1,0,1,0
60595,445,0,0,70,70,0,1,0,1,0
59781,445,0,0,70,70,0,1,0,1,0
51842,445,0,0,70,70,0,1,0,1,0
56059,445,0,0,70,70,0,1,0,1,0
50801,445,0,0,70,70,0,1,0,1,0
54652,445,0,0,66,66,0,1,0,1,0
60354,445,0,0,70,70,0,1,0,1,0
55466,445,0,0,70,70,0,1,0,1,0
63944,445,0,0,70,70,0,1,0,1,0
55746,445,0,0,70,70,0,1,0,1,0
55253,445,0,0,70,70,0,1,0,1,0
55460,445,0,0,70,70,0,1,0,1,0
62076,445,0,0,66,66,0,1,0,1,0
62891,445,0,0,70,70,0,1,0,1,0
53176,445,0,0,66,66,0,1,0,1,0
57958,445,0,0,70,70,0,1,0,1,0
64028,445,0,0,70,70,0,1,0,1,0
56516,445,0,0,70,70,0,1,0,1,0
51656,445,0,0,70,70,0,1,0,1,0
53252,445,0,0,70,70,0,1,0,1,0
62392,445,0,0,70,70,0,1,0,1,0
53733,445,0,0,66,66,0,1,0,1,0
52844,445,0,0,70,70,0,1,0,1,0
56510,445,0,0,68,68,0,1,0,1,0
62048,445,0,0,66,66,0,1,0,1,0
55458,445,0,0,70,70,0,1,0,1,0
62652,445,0,0,66,66,0,1,0,1,0
50080,445,0,0,69,69,0,1,0,1,0
61484,445,0,0,68,68,0,1,0,1,0
49870,445,0,0,70,70,0,1,0,1,0
62898,445,0,0,70,70,0,1,0,1,0
53192,445,0,0,70,70,0,1,0,1,0
51075,445,0,0,70,70,0,1,0,1,0
55339,445,0,0,67,67,0,1,0,1,0
56018,445,0,0,70,70,0,1,0,1,0
55300,445,0,0,70,70,0,1,0,1,0
63264,445,0,0,70,70,0,1,0,1,0
50771,445,0,0,70,70,0,1,0,1,0
63872,445,0,0,70,70,0,1,0,1,0
51327,445,0,0,70,70,0,1,0,1,0
65094,445,0,0,70,70,0,1,0,1,0
50499,445,0,0,66,66,0,1,0,1,0
57943,445,0,0,69,69,0,1,0,1,0
65495,445,0,0,70,70,0,1,0,1,0
52794,445,0,0,66,66,0,1,0,1,0
64924,445,0,0,70,70,0,1,0,1,0
63786,445,0,0,66,66,0,1,0,1,0
52430,445,0,0,70,70,0,1,0,1,0
60617,445,0,0,69,69,0,1,0,1,0
57554,445,0,0,66,66,0,1,0,1,0
59229,445,0,0,66,66,0,1,0,1,0
62724,445,0,0,68,68,0,1,0,1,0
62373,445,0,0,70,70,0,1,0,1,0
50079,445,0,0,66,66,0,1,0,1,0
58648,445,0,0,67,67,0,1,0,1,0
55760,445,0,0,66,66,0,1,0,1,0
61485,445,0,0,70,70,0,1,0,1,0
50102,445,0,0,70,70,0,1,0,1,0
56380,445,0,0,70,70,0,1,0,1,0
49999,445,0,0,70,70,0,1,0,1,0
61747,445,0,0,66,66,0,1,0,1,0
53214,445,0,0,70,70,0,1,0,1,0
52366,445,0,0,66,66,0,1,0,1,0
62088,445,0,0,70,70,0,1,0,1,0
62690,445,0,0,70,70,0,1,0,1,0
60657,445,0,0,70,70,0,1,0,1,0
63771,445,0,0,66,66,0,1,0,1,0
53949,445,0,0,67,67,0,1,0,1,0
56388,445,0,0,70,70,0,1,0,1,0
57346,445,0,0,66,66,0,1,0,1,0
50126,445,0,0,70,70,0,1,0,1,0
64117,445,0,0,67,67,0,1,0,1,0
49714,445,0,0,66,66,0,1,0,1,0
60377,445,0,0,66,66,0,1,0,1,0
60336,445,0,0,69,69,0,1,0,1,0
64804,445,0,0,68,68,0,1,0,1,0
52309,445,0,0,70,70,0,1,0,1,0
50859,445,0,0,66,66,0,1,0,1,0
50252,445,0,0,70,70,0,1,0,1,0
49507,445,0,0,66,66,0,1,0,1,0
65248,445,0,0,70,70,0,1,0,1,0
49997,445,0,0,70,70,0,1,0,1,0
63868,445,0,0,70,70,0,1,0,1,0
56703,445,0,0,70,70,0,1,0,1,0
51203,445,0,0,70,70,0,1,0,1,0
52405,445,0,0,70,70,0,1,0,1,0
54127,445,0,0,70,70,0,1,0,1,0
50104,445,0,0,70,70,0,1,0,1,0
50196,445,0,0,68,68,0,1,0,1,0
63002,445,0,0,66,66,0,1,0,1,0
55175,445,0,0,70,70,0,1,0,1,0
64020,445,0,0,70,70,0,1,0,1,0
51372,445,0,0,66,66,0,1,0,1,0
57340,445,0,0,70,70,0,1,0,1,0
55499,445,0,0,68,68,0,1,0,1,0
51211,445,0,0,68,68,0,1,0,1,0
55696,445,0,0,69,69,0,1,0,1,0
63191,445,0,0,68,68,0,1,0,1,0
50193,445,0,0,70,70,0,1,0,1,0
64574,445,0,0,67,67,0,1,0,1,0
54735,445,0,0,70,70,0,1,0,1,0
55575,445,0,0,70,70,0,1,0,1,0
65131,445,0,0,66,66,0,1,0,1,0
59198,445,0,0,70,70,0,1,0,1,0
56697,445,0,0,70,70,0,1,0,1,0
49449,445,0,0,70,70,0,1,0,1,0
57929,445,0,0,70,70,0,1,0,1,0
50807,445,0,0,67,67,0,1,0,1,0
59787,445,0,0,66,66,0,1,0,1,0
57127,445,0,0,70,70,0,1,0,1,0
59161,445,0,0,70,70,0,1,0,1,0
50725,445,0,0,70,70,0,1,0,1,0
49420,445,0,0,70,70,0,1,0,1,0
49409,445,0,0,70,70,0,1,0,1,0
59291,445,0,0,66,66,0,1,0,1,0
64335,445,0,0,70,70,0,1,0,1,0
60353,445,0,0,70,70,0,1,0,1,0
61826,445,0,0,70,70,0,1,0,1,0
55108,445,0,0,68,68,0,1,0,1,0
61569,445,0,0,70,70,0,1,0,1,0
49923,445,0,0,70,70,0,1,0,1,0
57967,445,0,0,70,70,0,1,0,1,0
55933,445,0,0,66,66,0,1,0,1,0
54529,445,0,0,70,70,0,1,0,1,0
51503,445,0,0,70,70,0,1,0,1,0
63304,445,0,0,70,70,0,1,0,1,0
51003,445,0,0,66,66,0,1,0,1,0
64247,445,0,0,67,67,0,1,0,1,0
63619,445,0,0,70,70,0,1,0,1,0
53165,445,0,0,70,70,0,1,0,1,0
57321,445,0,0,70,70,0,1,0,1,0
54353,445,0,0,66,66,0,1,0,1,0
63272,445,0,0,70,70,0,1,0,1,0
49743,445,0,0,66,66,0,1,0,1,0
61562,445,0,0,67,67,0,1,0,1,0
64472,445,0,0,66,66,0,1,0,1,0
53247,445,0,0,70,70,0,1,0,1,0
54791,445,0,0,70,70,0,1,0,1,0
58498,445,0,0,66,66,0,1,0,1,0
57804,445,0,0,66,66,0,1,0,1,0
61691,445,0,0,68,68,0,1,0,1,0
56912,445,0,0,68,68,0,1,0,1,0
64882,445,0,0,70,70,0,1,0,1,0
57928,445,0,0,68,68,0,1,0,1,0
58033,445,0,0,69,69,0,1,0,1,0
61849,445,0,0,66,66,0,1,0,1,0
57340,445,0,0,70,70,0,1,0,1,0
51359,445,0,0,69,69,0,1,0,1,0
64568,445,0,0,70,70,0,1,0,1,0
62109,445,0,0,67,67,0,1,0,1,0
56893,445,0,0,66,66,0,1,0,1,0
53269,445,0,0,68,68,0,1,0,1,0
57218,445,0,0,67,67,0,1,0,1,0
60506,445,0,0,66,66,0,1,0,1,0
62287,445,0,0,66,66,0,1,0,1,0
50653,445,0,0,70,70,0,1,0,1,0
65098,445,0,0,70,70,0,1,0,1,0
49627,445,0,0,70,70,0,1,0,1,0
53159,445,0,0,70,70,0,1,0,1,0
55567,445,0,0,70,70,0,1,0,1,0
61109,445,0,0,70,70,0,1,0,1,0
51070,445,0,0,70,70,0,1,0,1,0
49364,445,0,0,70,70,0,1,0,1,0
49631,445,0,0,70,70,0,1,0,1,0
50209,445,0,0,66,66,0,1,0,1,0
62701,445,0,0,70,70,0,1,0,1,0
52168,445,0,0,66,66,0,1,0,1,0
60715,445,0,0,70,70,0,1,0,1,0
53879,445,0,0,67,67,0,1,0,1,0
58005,445,0,0,70,70,0,1,0,1,0
58024,445,0,0,70,70,0,1,0,1,0
58611,445,0,0,68,68,0,1,0,1,0
64972,445,0,0,70,70,0,1,0,1,0
56868,445,0,0,70,70,0,1,0,1,0
51587,445,0,0,70,70,0,1,0,1,0
54476,445,0,0,68,68,0,1,0,1,0
58055,445,0,0,66,66,0,1,0,1,0
64468,445,0,0,70,70,0,1,0,1,0
53036,445,0,0,67,67,0,1,0,1,0
52850,445,0,0,70,70,0,1,0,1,0
55932,445,0,0,69,69,0,1,0,1,0
63436,445,0,0,70,70,0,1,0,1,0
50794,445,0,0,66,66,0,1,0,1,0
58023,445,0,0,70,70,0,1,0,1,0
51862,445,0,0,70,70,0,1,0,1,0
59308,445,0,0,66,66,0,1,0,1,0
49348,445,0,0,67,67,0,1,0,1,0
64927,445,0,0,70,70,0,1,0,1,0
63172,445,0,0,68,68,0,1,0,1,0
56555,445,0,0,70,70,0,1,0,1,0
62538,445,0,0,67,67,0,1,0,1,0
60633,445,0,0,66,66,0,1,0,1,0
54606,445,0,0,70,70,0,1,0,1,0
65118,445,0,0,70,70,0,1,0,1,0
63010,445,0,0,70,70,0,1,0,1,0
54735,445,0,0,70,70,0,1,0,1,0
62549,445,0,0,70,70,0,1,0,1,0
49187,445,0,0,67,67,0,1,0,1,0
51685,445,0,0,69,69,0,1,0,1,0
65065,445,0,0,66,66,0,1,0,1,0
64052,445,0,0,70,70,0,1,0,1,0
50495,445,0,0,66,66,0,1,0,1,0
61888,445,0,0,70,70,0,1,0,1,0
56013,445,0,0,68,68,0,1,0,1,0
52658,445,0,0,66,66,0,1,0,1,0
59919,445,0,0,66,66,0,1,0,1,0
63560,445,0,0,70,70,0,1,0,1,0
54776,445,0,0,66,66,0,1,0,1,0
54047,445,0,0,66,66,0,1,0,1,0
65452,445,0,0,66,66,0,1,0,1,0
64057,445,0,0,69,69,0,1,0,1,0
55424,445,0,0,70,70,0,1,0,1,0
61030,445,0,0,67,67,0,1,0,1,0
56973,445,0,0,70,70,0,1,0,1,0
52182,445,0,0,70,70,0,1,0,1,0
51798,445,0,0,70,70,0,1,0,1,0
64153,445,0,0,70,70,0,1,0,1,0
60667,445,0,0,69,69,0,1,0,1,0
55314,445,0,0,67,67,0,1,0,1,0
63322,445,0,0,70,70,0,1,0,1,0
64277,445,0,0,70,70,0,1,0,1,0
58825,445,0,0,66,66,0,1,0,1,0
63178,445,0,0,70,70,0,1,0,1,0
63459,445,0,0,67,67,0,1,0,1,0
61145,445,0,0,70,70,0,1,0,1,0
59724,445,0,0,66,66,0,1,0,1,0
56584,445,0,0,67,67,0,1,0,1,0
56196,445,0,0,66,66,0,1,0,1,0
49999,445,0,0,70,70,0,1,0,1,0
63326,445,0,0,66,66,0,1,0,1,0
63264,445,0,0,70,70,0,1,0,1,0
62373,445,0,0,67,67,0,1,0,1,0
59887,445,0,0,70,70,0,1,0,1,0
51054,445,0,0,66,66,0,1,0,1,0
52439,445,0,0,70,70,0,1,0,1,0
54076,445,0,0,70,70,0,1,0,1,0
52975,445,0,0,70,70,0,1,0,1,0
62915,445,0,0,70,70,0,1,0,1,0
61212,445,0,0,66,66,0,1,0,1,0
62625,445,0,0,70,70,0,1,0,1,0
61639,445,0,0,66,66,0,1,0,1,0
64613,445,0,0,66,66,0,1,0,1,0
55713,445,0,0,69,69,0,1,0,1,0
61368,445,0,0,68,68,0,1,0,1,0
57153,445,0,0,66,66,0,1,0,1,0
61244,445,0,0,70,70,0,1,0,1,0
65251,445,0,0,68,68,0,1,0,1,0
58040,445,0,0,68,68,0,1,0,1,0
63452,445,0,0,70,70,0,1,0,1,0
51550,445,0,0,70,70,0,1,0,1,0
60955,445,0,0,66,66,0,1,0,1,0
50411,445,0,0,70,70,0,1,0,1,0
64373,445,0,0,70,70,0,1,0,1,0
64080,445,0,0,67,67,0,1,0,1,0
55098,445,0,0,70,70,0,1,0,1,0
56445,445,0,0,70,70,0,1,0,1,0
59818,445,0,0,67,67,0,1,0,1,0
51629,445,0,0,70,70,0,1,0,1,0
61167,445,0,0,70,70,0,1,0,1,0
54262,445,0,0,66,66,0,1,0,1,0
50270,445,0,0,70,70,0,1,0,1,0
53807,445,0,0,66,66,0,1,0,1,0
59440,445,0,0,69,69,0,1,0,1,0
51621,445,0,0,70,70,0,1,0,1,0
55416,445,0,0,70,70,0,1,0,1,0
60303,445,0,0,67,67,0,1,0,1,0
49960,445,0,0,70,70,0,1,0,1,0
64360,445,0,0,66,66,0,1,0,1,0
57075,445,0,0,66,66,0,1,0,1,0
64049,445,0,0,70,70,0,1,0,1,0
62906,445,0,0,70,70,0,1,0,1,0
53365,445,0,0,66,66,0,1,0,1,0
62618,445,0,0,70,70,0,1,0,1,0
56255,445,0,0,67,67,0,1,0,1,0
52917,445,0,0,67,67,0,1,0,1,0
62891,445,0,0,70,70,0,1,0,1,0
58386,445,0,0,70,70,0,1,0,1,0
64256,445,0,0,70,70,0,1,0,1,0
58399,445,0,0,70,70,0,1,0,1,0
59400,445,0,0,66,66,0,1,0,1,0
59346,445,0,0,70,70,0,1,0,1,0
50426,445,0,0,70,70,0,1,0,1,0
50357,445,0,0,66,66,0,1,0,1,0
50917,445,0,0,70,70,0,1,0,1,0
51104,445,0,0,66,66,0,1,0,1,0
62875,445,0,0,66,66,0,1,0,1,0
54201,445,0,0,70,70,0,1,0,1,0
56063,445,0,0,66,66,0,1,0,1,0
62716,445,0,0,70,70,0,1,0,1,0
63582,445,0,0,70,70,0,1,0,1,0
56087,445,0,0,67,67,0,1,0,1,0
54873,445,0,0,70,70,0,1,0,1,0
64935,445,0,0,66,66,0,1,0,1,0
63515,445,0,0,66,66,0,1,0,1,0
61399,445,0,0,70,70,0,1,0,1,0
64763,445,0,0,70,70,0,1,0,1,0
51451,445,0,0,70,70,0,1,0,1,0
61950,445,0,0,70,70,0,1,0,1,0
57302,445,0,0,70,70,0,1,0,1,0
52249,445,0,0,70,70,0,1,0,1,0
53918,445,0,0,70,70,0,1,0,1,0
65325,445,0,0,68,68,0,1,0,1,0
50143,445,0,0,70,70,0,1,0,1,0
49351,445,0,0,70,70,0,1,0,1,0
61546,445,0,0,66,66,0,1,0,1,0
49489,445,0,0,70,70,0,1,0,1,0
51753,445,0,0,66,66,0,1,0,1,0
58199,445,0,0,70,70,0,1,0,1,0
59947,445,0,0,69,69,0,1,0,1,0
63051,445,0,0,66,66,0,1,0,1,0
58513,445,0,0,70,70,0,1,0,1,0
52658,445,0,0,66,66,0,1,0,1,0
64927,445,0,0,70,70,0,1,0,1,0
61333,445,0,0,66,66,0,1,0,1,0
59287,445,0,0,70,70,0,1,0,1,0
64681,445,0,0,66,66,0,1,0,1,0
54007,445,0,0,66,66,0,1,0,1,0
55214,445,0,0,68,68,0,1,0,1,0
63026,445,0,0,70,70,0,1,0,1,0
58515,445,0,0,70,70,0,1,0,1,0
65253,445,0,0,70,70,0,1,0,1,0
62372,445,0,0,70,70,0,1,0,1,0
50651,445,0,0,70,70,0,1,0,1,0
57090,445,0,0,70,70,0,1,0,1,0
53258,445,0,0,67,67,0,1,0,1,0
49510,445,0,0,70,70,0,1,0,1,0
57570,445,0,0,70,70,0,1,0,1,0
55499,445,0,0,70,70,0,1,0,1,0
51072,445,0,0,66,66,0,1,0,1,0
58314,445,0,0,68,68,0,1,0,1,0
54393,445,0,0,66,66,0,1,0,1,0
50336,445,0,0,66,66,0,1,0,1,0
59256,445,0,0,66,66,0,1,0,1,0
60501,445,0,0,68,68,0,1,0,1,0
61436,445,0,0,70,70,0,1,0,1,0
55585,445,0,0,70,70,0,1,0,1,0
51694,445,0,0,70,70,0,1,0,1,0
63192,445,0,0,66,66,0,1,0,1,0
64538,445,0,0,70,70,0,1,0,1,0
61848,445,0,0,66,66,0,1,0,1,0
50810,445,0,0,70,70,0,1,0,1,0
63539,445,0,0,70,70,0,1,0,1,0
54553,445,0,0,69,69,0,1,0,1,0
57543,445,0,0,66,66,0,1,0,1,0
49712,445,0,0,66,66,0,1,0,1,0
55885,445,0,0,68,68,0,1,0,1,0
56878,445,0,0,70,70,0,1,0,1,0
63551,445,0,0,69,69,0,1,0,1,0
63844,445,0,0,66,66,0,1,0,1,0
61973,445,0,0,68,68,0,1,0,1,0
57736,445,0,0,66,66,0,1,0,1,0
51213,445,0,0,70,70,0,1,0,1,0
63212,445,0,0,69,69,0,1,0,1,0
51575,445,0,0,66,66,0,1,0,1,0
49375,445,0,0,70,70,0,1,0,1,0
61488,445,0,0,70,70,0,1,0,1,0
60767,445,0,0,68,68,0,1,0,1,0
52532,445,0,0,70,70,0,1,0,1,0
63853,445,0,0,66,66,0,1,0,1,0
51752,445,0,0,70,70,0,1,0,1,0
58709,445,0,0,66,66,0,1,0,1,0
61083,445,0,0,67,67,0,1,0,1,0
54489,445,0,0,70,70,0,1,0,1,0
51040,445,0,0,70,70,0,1,0,1,0
60141,445,0,0,70,70,0,1,0,1,0
55515,445,0,0,70,70,0,1,0,1,0
64602,445,0,0,66,66,0,1,0,1,0
58287,445,0,0,70,70,0,1,0,1,0
55446,445,0,0,70,70,0,1,0,1,0
51422,445,0,0,70,70,0,1,0,1,0
49767,445,0,0,68,68,0,1,0,1,0
55230,445,0,0,70,70,0,1,0,1,0
56454,445,0,0,68,68,0,1,0,1,0
51120,445,0,0,66,66,0,1,0,1,0
53308,445,0,0,69,69,0,1,0,1,0
55352,445,0,0,66,66,0,1,0,1,0
54134,445,0,0,70,70,0,1,0,1,0
61512,445,0,0,69,69,0,1,0,1,0
63468,445,0,0,66,66,0,1,0,1,0
55758,445,0,0,68,68,0,1,0,1,0
59525,445,0,0,70,70,0,1,0,1,0
52710,445,0,0,66,66,0,1,0,1,0
60675,445,0,0,66,66,0,1,0,1,0
51878,445,0,0,70,70,0,1,0,1,0
54392,445,0,0,66,66,0,1,0,1,0
52346,445,0,0,66,66,0,1,0,1,0
62690,445,0,0,67,67,0,1,0,1,0
64566,445,0,0,70,70,0,1,0,1,0
59533,445,0,0,66,66,0,1,0,1,0
58554,445,0,0,70,70,0,1,0,1,0
55210,445,0,0,66,66,0,1,0,1,0
51575,445,0,0,66,66,0,1,0,1,0
56184,445,0,0,70,70,0,1,0,1,0
49379,445,0,0,66,66,0,1,0,1,0
63876,445,0,0,70,70,0,1,0,1,0
50747,445,0,0,70,70,0,1,0,1,0
59736,445,0,0,69,69,0,1,0,1,0
50228,445,0,0,70,70,0,1,0,1,0
64575,445,0,0,66,66,0,1,0,1,0
62155,445,0,0,69,69,0,1,0,1,0
58923,445,0,0,69,69,0,1,0,1,0
55738,445,0,0,66,66,0,1,0,1,0
50545,445,0,0,66,66,0,1,0,1,0
53665,445,0,0,70,70,0,1,0,1,0
64211,445,0,0,67,67,0,1,0,1,0
55412,445,0,0,70,70,0,1,0,1,0
59126,445,0,0,66,66,0,1,0,1,0
64760,445,0,0,67,67,0,1,0,1,0
50664,445,0,0,66,66,0,1,0,1,0
56263,445,0,0,69,69,0,1,0,1,0
58794,445,0,0,70,70,0,1,0,1,0
50642,445,0,0,70,70,0,1,0,1,0
52647,445,0,0,70,70,0,1,0,1,0
62051,445,0,0,66,66,0,1,0,1,0
50397,445,0,0,70,70,0,1,0,1,0
61030,445,0,0,68,68,0,1,0,1,0
55933,445,0,0,66,66,0,1,0,1,0
50377,445,0,0,70,70,0,1,0,1,0
56606,445,0,0,66,66,0,1,0,1,0
65342,445,0,0,70,70,0,1,0,1,0
59838,445,0,0,66,66,0,1,0,1,0
62214,445,0,0,70,70,0,1,0,1,0
55242,445,0,0,66,66,0,1,0,1,0
49903,445,0,0,70,70,0,1,0,1,0
55350,445,0,0,69,69,0,1,0,1,0
54650,445,0,0,66,66,0,1,0,1,0
55290,445,0,0,69,69,0,1,0,1,0
65309,445,0,0,70,70,0,1,0,1,0
50521,445,0,0,70,70,0,1,0,1,0
62509,445,0,0,66,66,0,1,0,1,0
54054,445,0,0,70,70,0,1,0,1,0
55746,445,0,0,70,70,0,1,0,1,0
51291,445,0,0,70,70,0,1,0,1,0
54849,445,0,0,69,69,0,1,0,1,0
49267,445,0,0,70,70,0,1,0,1,0
51568,445,0,0,70,70,0,1,0,1,0
51491,445,0,0,70,70,0,1,0,1,0
61916,445,0,0,70,70,0,1,0,1,0
58819,445,0,0,70,70,0,1,0,1,0
61229,445,0,0,66,66,0,1,0,1,0
51021,445,0,0,70,70,0,1,0,1,0
60276,445,0,0,66,66,0,1,0,1,0
65074,445,0,0,70,70,0,1,0,1,0
50464,445,0,0,70,70,0,1,0,1,0
61465,445,0,0,66,66,0,1,0,1,0
63972,445,0,0,67,67,0,1,0,1,0
64948,445,0,0,70,70,0,1,0,1,0
63110,445,0,0,70,70,0,1,0,1,0
60714,445,0,0,68,68,0,1,0,1,0
64243,445,0,0,70,70,0,1,0,1,0
50382,445,0,0,70,70,0,1,0,1,0
51221,445,0,0,67,67,0,1,0,1,0
62697,445,0,0,66,66,0,1,0,1,0
54062,445,0,0,70,70,0,1,0,1,0
50326,445,0,0,70,70,0,1,0,1,0
62889,445,0,0,70,70,0,1,0,1,0
65450,445,0,0,66,66,0,1,0,1,0
64051,445,0,0,70,70,0,1,0,1,0
61587,445,0,0,70,70,0,1,0,1,0
65069,445,0,0,67,67,0,1,0,1,0
62950,445,0,0,70,70,0,1,0,1,0
62691,445,0,0,70,70,0,1,0,1,0
63110,445,0,0,70,70,0,1,0,1,0
63020,445,0,0,70,70,0,1,0,1,0
55203,445,0,0,70,70,0,1,0,1,0
63844,445,0,0,66,66,0,1,0,1,0
55874,445,0,0,68,68,0,1,0,1,0
51626,445,0,0,68,68,0,1,0,1,0
57996,445,0,0,68,68,0,1,0,1,0
59997,445,0,0,70,70,0,1,0,1,0
60441,445,0,0,70,70,0,1,0,1,0
55213,445,0,0,70,70,0,1,0,1,0
62104,445,0,0,66,66,0,1,0,1,0
54231,445,0,0,70,70,0,1,0,1,0
63388,445,0,0,70,70,0,1,0,1,0
62852,445,0,0,70,70,0,1,0,1,0
58521,445,0,0,70,70,0,1,0,1,0
57121,445,0,0,70,70,0,1,0,1,0
61385,445,0,0,66,66,0,1,0,1,0
56054,445,0,0,70,70,0,1,0,1,0
59112,445,0,0,70,70,0,1,0,1,0
61811,445,0,0,70,70,0,1,0,1,0
53774,445,0,0,70,70,0,1,0,1,0
62557,445,0,0,66,66,0,1,0,1,0
49479,445,0,0,70,70,0,1,0,1,0
52992,445,0,0,70,70,0,1,0,1,0
56152,445,0,0,66,66,0,1,0,1,0
50735,445,0,0,66,66,0,1,0,1,0
51600,445,0,0,66,66,0,1,0,1,0
56270,445,0,0,70,70,0,1,0,1,0
64874,445,0,0,66,66,0,1,0,1,0
52497,445,0,0,70,70,0,1,0,1,0
53625,445,0,0,68,68,0,1,0,1,0
52958,445,0,0,70,70,0,1,0,1,0
59923,445,0,0,66,66,0,1,0,1,0
57048,445,0,0,66,66,0,1,0,1,0
63882,445,0,0,70,70,0,1,0,1,0
51831,445,0,0,66,66,0,1,0,1,0
54741,445,0,0,70,70,0,1,0,1,0
54966,445,0,0,66,66,0,1,0,1,0
52853,445,0,0,66,66,0,1,0,1,0
53766,445,0,0,66,66,0,1,0,1,0
50648,445,0,0,66,66,0,1,0,1,0
63643,445,0,0,70,70,0,1,0,1,0
59253,445,0,0,70,70,0,1,0,1,0
59570,445,0,0,70,70,0,1,0,1,0
59686,445,0,0,67,67,0,1,0,1,0
53846,445,0,0,70,70,0,1,0,1,0
60217,445,0,0,69,69,0,1,0,1,0
62108,445,0,0,70,70,0,1,0,1,0
62105,445,0,0,70,70,0,1,0,1,0
57964,445,0,0,70,70,0,1,0,1,0
49359,445,0,0,66,66,0,1,0,1,0
63124,445,0,0,69,69,0,1,0,1,0
52254,445,0,0,68,68,0,1,0,1,0
50542,445,0,0,66,66,0,1,0,1,0
62516,445,0,0,68,68,0,1,0,1,0
50906,445,0,0,70,70,0,1,0,1,0
60446,445,0,0,66,66,0,1,0,1,0
51568,445,0,0,66,66,0,1,0,1,0
55545,445,0,0,66,66,0,1,0,1,0
51499,445,0,0,66,66,0,1,0,1,0
58712,445,0,0,66,66,0,1,0,1,0
61877,445,0,0,70,70,0,1,0,1,0
58066,445,0,0,67,67,0,1,0,1,0
58985,445,0,0,70,70,0,1,0,1,0
52981,445,0,0,66,66,0,1,0,1,0
53165,445,0,0,70,70,0,1,0,1,0
62073,445,0,0,70,70,0,1,0,1,0
52699,445,0,0,70,70,0,1,0,1,0
62468,445,0,0,70,70,0,1,0,1,0
57929,445,0,0,70,70,0,1,0,1,0
54154,445,0,0,66,66,0,1,0,1,0
61396,445,0,0,70,70,0,1,0,1,0
50416,445,0,0,70,70,0,1,0,1,0
56513,445,0,0,69,69,0,1,0,1,0
59735,445,0,0,70,70,0,1,0,1,0
61702,445,0,0,67,67,0,1,0,1,0
56468,445,0,0,70,70,0,1,0,1,0
52497,445,0,0,70,70,0,1,0,1,0
54702,445,0,0,67,67,0,1,0,1,0
60668,445,0,0,70,70,0,1,0,1,0
64598,445,0,0,70,70,0,1,0,1,0
61473,445,0,0,70,70,0,1,0,1,0
51522,445,0,0,66,66,0,1,0,1,0
49409,445,0,0,70,70,0,1,0,1,0
55976,445,0,0,70,70,0,1,0,1,0
64200,445,0,0,70,70,0,1,0,1,0
53641,445,0,0,70,70,0,1,0,1,0
58777,445,0,0,70,70,0,1,0,1,0
60728,445,0,0,69,69,0,1,0,1,0
56239,445,0,0,69,69,0,1,0,1,0
62156,445,0,0,70,70,0,1,0,1,0
58645,445,0,0,67,67,0,1,0,1,0
53768,445,0,0,66,66,0,1,0,1,0
63561,445,0,0,70,70,0,1,0,1,0
49974,445,0,0,70,70,0,1,0,1,0
56961,445,0,0,70,70,0,1,0,1,0
54857,445,0,0,68,68,0,1,0,1,0
65242,445,0,0,67,67,0,1,0,1,0
58700,445,0,0,70,70,0,1,0,1,0
57217,445,0,0,66,66,0,1,0,1,0
61653,445,0,0,69,69,0,1,0,1,0
50949,445,0,0,70,70,0,1,0,1,0
64313,445,0,0,70,70,0,1,0,1,0
52556,445,0,0,70,70,0,1,0,1,0
65305,445,0,0,67,67,0,1,0,1,0
51941,445,0,0,66,66,0,1,0,1,0
65268,445,0,0,67,67,0,1,0,1,0
52883,445,0,0,67,67,0,1,0,1,0
58348,445,0,0,70,70,0,1,0,1,0
49687,445,0,0,70,70,0,1,0,1,0
64198,445,0,0,68,68,0,1,0,1,0
61668,445,0,0,67,67,0,1,0,1,0
54972,445,0,0,68,68,0,1,0,1,0
62853,445,0,0,67,67,0,1,0,1,0
64871,445,0,0,67,67,0,1,0,1,0
62922,445,0,0,69,69,0,1,0,1,0
53676,445,0,0,66,66,0,1,0,1,0
49728,445,0,0,68,68,0,1,0,1,0
55850,445,0,0,70,70,0,1,0,1,0
62914,445,0,0,70,70,0,1,0,1,0
50285,445,0,0,70,70,0,1,0,1,0
54785,445,0,0,70,70,0,1,0,1,0
61340,445,0,0,70,70,0,1,0,1,0
57560,445,0,0,70,70,0,1,0,1,0
54076,445,0,0,70,70,0,1,0,1,0
57927,445,0,0,70,70,0,1,0,1,0
55201,445,0,0,70,70,0,1,0,1,0
50508,445,0,0,66,66,0,1,0,1,0
58763,445,0,0,70,70,0,1,0,1,0
59480,445,0,0,70,70,0,1,0,1,0
64792,445,0,0,69,69,0,1,0,1,0
61180,445,0,0,70,70,0,1,0,1,0
51123,445,0,0,66,66,0,1,0,1,0
50624,445,0,0,69,69,0,1,0,1,0
64430,445,0,0,70,70,0,1,0,1,0
55875,445,0,0,66,66,0,1,0,1,0
53916,445,0,0,68,68,0,1,0,1,0
49189,445,0,0,70,70,0,1,0,1,0
51543,445,0,0,70,70,0,1,0,1,0
49323,445,0,0,70,70,0,1,0,1,0
60175,445,0,0,66,66,0,1,0,1,0
60342,445,0,0,70,70,0,1,0,1,0
49644,445,0,0,70,70,0,1,0,1,0
50150,445,0,0,68,68,0,1,0,1,0
62331,445,0,0,70,70,0,1,0,1,0
53436,445,0,0,70,70,0,1,0,1,0
61507,445,0,0,70,70,0,1,0,1,0
51858,445,0,0,68,68,0,1,0,1,0
52434,445,0,0,70,70,0,1,0,1,0
55591,445,0,0,70,70,0,1,0,1,0
57593,445,0,0,69,69,0,1,0,1,0
64928,445,0,0,70,70,0,1,0,1,0
61530,445,0,0,70,70,0,1,0,1,0
55607,445,0,0,66,66,0,1,0,1,0
50736,445,0,0,70,70,0,1,0,1,0
62903,445,0,0,70,70,0,1,0,1,0
52088,445,0,0,70,70,0,1,0,1,0
50618,445,0,0,70,70,0,1,0,1,0
54875,445,0,0,70,70,0,1,0,1,0
55657,445,0,0,70,70,0,1,0,1,0
58888,445,0,0,70,70,0,1,0,1,0
59267,445,0,0,70,70,0,1,0,1,0
60302,445,0,0,66,66,0,1,0,1,0
55783,445,0,0,70,70,0,1,0,1,0
60208,445,0,0,69,69,0,1,0,1,0
61040,445,0,0,67,67,0,1,0,1,0
49935,445,0,0,70,70,0,1,0,1,0
64422,445,0,0,66,66,0,1,0,1,0
64817,445,0,0,70,70,0,1,0,1,0
59700,445,0,0,70,70,0,1,0,1,0
65390,445,0,0,70,70,0,1,0,1,0
65130,445,0,0,66,66,0,1,0,1,0
63772,445,0,0,69,69,0,1,0,1,0
52124,445,0,0,70,70,0,1,0,1,0
54748,445,0,0,70,70,0,1,0,1,0
57161,445,0,0,70,70,0,1,0,1,0
63800,445,0,0,68,68,0,1,0,1,0
55132,445,0,0,70,70,0,1,0,1,0
52886,445,0,0,70,70,0,1,0,1,0
58280,445,0,0,67,67,0,1,0,1,0
58759,445,0,0,66,66,0,1,0,1,0
52915,445,0,0,66,66,0,1,0,1,0
58534,445,0,0,70,70,0,1,0,1,0
60660,445,0,0,70,70,0,1,0,1,0
55864,445,0,0,66,66,0,1,0,1,0
54859,445,0,0,70,70,0,1,0,1,0
53771,445,0,0,66,66,0,1,0,1,0
59295,445,0,0,70,70,0,1,0,1,0
53914,445,0,0,70,70,0,1,0,1,0
61335,445,0,0,66,66,0,1,0,1,0
62775,445,0,0,70,70,0,1,0,1,0
56715,445,0,0,70,70,0,1,0,1,0
55607,445,0,0,67,67,0,1,0,1,0
50934,445,0,0,66,66,0,1,0,1,0
57928,445,0,0,70,70,0,1,0,1,0
56320,445,0,0,70,70,0,1,0,1,0
50272,445,0,0,66,66,0,1,0,1,0
65404,445,0,0,68,68,0,1,0,1,0
55267,445,0,0,70,70,0,1,0,1,0
64725,445,0,0,70,70,0,1,0,1,0
56472,445,0,0,70,70,0,1,0,1,0
65195,445,0,0,66,66,0,1,0,1,0
62285,445,0,0,67,67,0,1,0,1,0
61841,445,0,0,70,70,0,1,0,1,0
61716,445,0,0,70,70,0,1,0,1,0
55777,445,0,0,70,70,0,1,0,1,0
49395,445,0,0,66,66,0,1,0,1,0
50377,445,0,0,70,70,0,1,0,1,0
51117,445,0,0,69,69,0,1,0,1,0
52586,445,0,0,68,68,0,1,0,1,0
56661,445,0,0,70,70,0,1,0,1,0
61993,445,0,0,67,67,0,1,0,1,0
49780,445,0,0,70,70,0,1,0,1,0
63955,445,0,0,68,68,0,1,0,1,0
62514,445,0,0,70,70,0,1,0,1,0
53952,445,0,0,70,70,0,1,0,1,0
56312,445,0,0,70,70,0,1,0,1,0
57352,445,0,0,66,66,0,1,0,1,0
56196,445,0,0,66,66,0,1,0,1,0
52504,445,0,0,70,70,0,1,0,1,0
62853,445,0,0,66,66,0,1,0,1,0
60934,445,0,0,67,67,0,1,0,1,0
65421,445,0,0,67,67,0,1,0,1,0
53599,445,0,0,70,70,0,1,0,1,0
59529,445,0,0,69,69,0,1,0,1,0
56601,445,0,0,70,70,0,1,0,1,0
62549,445,0,0,70,70,0,1,0,1,0
62190,445,0,0,70,70,0,1,0,1,0
58518,445,0,0,70,70,0,1,0,1,0
49766,445,0,0,70,70,0,1,0,1,0
50546,445,0,0,70,70,0,1,0,1,0
64873,445,0,0,66,66,0,1,0,1,0
64433,445,0,0,70,70,0,1,0,1,0
53423,445,0,0,70,70,0,1,0,1,0
55944,445,0,0,70,70,0,1,0,1,0
57077,445,0,0,67,67,0,1,0,1,0
57943,445,0,0,70,70,0,1,0,1,0
56451,445,0,0,66,66,0,1,0,1,0
57263,445,0,0,70,70,0,1,0,1,0
63711,445,0,0,66,66,0,1,0,1,0
61591,445,0,0,68,68,0,1,0,1,0
60695,445,0,0,66,66,0,1,0,1,0
54458,445,0,0,66,66,0,1,0,1,0
57643,445,0,0,70,70,0,1,0,1,0
59115,445,0,0,67,67,0,1,0,1,0
58007,445,0,0,68,68,0,1,0,1,0
55634,445,0,0,70,70,0,1,0,1,0
49973,445,0,0,70,70,0,1,0,1,0
64312,445,0,0,66,66,0,1,0,1,0
61414,445,0,0,66,66,0,1,0,1,0
60116,445,0,0,70,70,0,1,0,1,0
52649,445,0,0,67,67,0,1,0,1,0
50254,445,0,0,70,70,0,1,0,1,0
50659,445,0,0,66,66,0,1,0,1,0
59148,445,0,0,69,69,0,1,0,1,0
49333,445,0,0,70,70,0,1,0,1,0
52733,445,0,0,70,70,0,1,0,1,0
63458,445,0,0,66,66,0,1,0,1,0
63482,445,0,0,69,69,0,1,0,1,0
56650,445,0,0,68,68,0,1,0,1,0
50067,445,0,0,66,66,0,1,0,1,0
58501,445,0,0,66,66,0,1,0,1,0
62318,445,0,0,67,67,0,1,0,1,0
59862,445,0,0,68,68,0,1,0,1,0
56190,445,0,0,69,69,0,1,0,1,0
60994,445,0,0,70,70,0,1,0,1,0
58374,445,0,0,70,70,0,1,0,1,0
62720,445,0,0,66,66,0,1,0,1,0
60438,445,0,0,66,66,0,1,0,1,0
50781,445,0,0,66,66,0,1,0,1,0
60958,445,0,0,70,70,0,1,0,1,0
53625,445,0,0,66,66,0,1,0,1,0
59971,445,0,0,66,66,0,1,0,1,0
55776,445,0,0,70,70,0,1,0,1,0
58964,445,0,0,70,70,0,1,0,1,0
61779,445,0,0,66,66,0,1,0,1,0
64468,445,0,0,70,70,0,1,0,1,0
58934,445,0,0,70,70,0,1,0,1,0
60165,445,0,0,70,70,0,1,0,1,0
52599,445,0,0,66,66,0,1,0,1,0
49166,445,0,0,70,70,0,1,0,1,0
52698,445,0,0,70,70,0,1,0,1,0
62420,445,0,0,70,70,0,1,0,1,0
54007,445,0,0,66,66,0,1,0,1,0
64572,445,0,0,70,70,0,1,0,1,0
54445,445,0,0,66,66,0,1,0,1,0
61592,445,0,0,66,66,0,1,0,1,0
57163,445,0,0,68,68,0,1,0,1,0
51805,445,0,0,70,70,0,1,0,1,0
56064,445,0,0,66,66,0,1,0,1,0
59346,445,0,0,70,70,0,1,0,1,0
54150,445,0,0,70,70,0,1,0,1,0
63068,445,0,0,66,66,0,1,0,1,0
64180,445,0,0,70,70,0,1,0,1,0
62893,445,0,0,69,69,0,1,0,1,0
51586,445,0,0,67,67,0,1,0,1,0
52882,445,0,0,66,66,0,1,0,1,0
65386,445,0,0,70,70,0,1,0,1,0
50400,445,0,0,70,70,0,1,0,1,0
50307,445,0,0,70,70,0,1,0,1,0
49361,445,0,0,70,70,0,1,0,1,0
50336,445,0,0,66,66,0,1,0,1,0
49984,445,0,0,70,70,0,1,0,1,0
60863,445,0,0,70,70,0,1,0,1,0
56264,445,0,0,70,70,0,1,0,1,0
52350,445,0,0,70,70,0,1,0,1,0
50658,445,0,0,66,66,0,1,0,1,0
59768,445,0,0,70,70,0,1,0,1,0
50372,445,0,0,66,66,0,1,0,1,0
65477,445,0,0,66,66,0,1,0,1,0
62132,445,0,0,66,66,0,1,0,1,0
53506,445,0,0,67,67,0,1,0,1,0
64019,445,0,0,66,66,0,1,0,1,0
55633,445,0,0,70,70,0,1,0,1,0
51550,445,0,0,70,70,0,1,0,1,0
54961,445,0,0,70,70,0,1,0,1,0
58890,445,0,0,70,70,0,1,0,1,0
49756,445,0,0,70,70,0,1,0,1,0
63021,445,0,0,70,70,0,1,0,1,0
51018,445,0,0,70,70,0,1,0,1,0
59848,445,0,0,67,67,0,1,0,1,0
62105,445,0,0,66,66,0,1,0,1,0
56493,445,0,0,70,70,0,1,0,1,0
61536,445,0,0,69,69,0,1,0,1,0
65130,445,0,0,66,66,0,1,0,1,0
60697,445,0,0,66,66,0,1,0,1,0
57276,445,0,0,66,66,0,1,0,1,0
65387,445,0,0,70,70,0,1,0,1,0
58399,445,0,0,70,70,0,1,0,1,0
63149,445,0,0,70,70,0,1,0,1,0
54111,445,0,0,70,70,0,1,0,1,0
55567,445,0,0,70,70,0,1,0,1,0
56486,445,0,0,70,70,0,1,0,1,0
64453,445,0,0,70,70,0,1,0,1,0
62662,445,0,0,70,70,0,1,0,1,0
63852,445,0,0,66,66,0,1,0,1,0
64392,445,0,0,70,70,0,1,0,1,0
52289,445,0,0,67,67,0,1,0,1,0
63459,445,0,0,66,66,0,1,0,1,0
57996,445,0,0,69,69,0,1,0,1,0
56220,445,0,0,70,70,0,1,0,1,0
54849,445,0,0,67,67,0,1,0,1,0
64655,445,0,0,66,66,0,1,0,1,0
50811,445,0,0,70,70,0,1,0,1,0
53272,445,0,0,70,70,0,1,0,1,0
60154,445,0,0,70,70,0,1,0,1,0
49645,445,0,0,70,70,0,1,0,1,0
54187,445,0,0,70,70,0,1,0,1,0
50748,445,0,0,66,66,0,1,0,1,0
50582,445,0,0,70,70,0,1,0,1,0
53949,445,0,0,66,66,0,1,0,1,0
52740,445,0,0,69,69,0,1,0,1,0
50528,445,0,0,70,70,0,1,0,1,0
64394,445,0,0,68,68,0,1,0,1,0
61968,445,0,0,70,70,0,1,0,1,0
49851,445,0,0,70,70,0,1,0,1,0
61532,445,0,0,67,67,0,1,0,1,0
56700,445,0,0,70,70,0,1,0,1,0
61665,445,0,0,66,66,0,1,0,1,0
55141,445,0,0,70,70,0,1,0,1,0
62400,445,0,0,70,70,0,1,0,1,0
55675,445,0,0,70,70,0,1,0,1,0
61113,445,0,0,70,70,0,1,0,1,0
64675,445,0,0,70,70,0,1,0,1,0
57310,445,0,0,70,70,0,1,0,1,0
63749,445,0,0,70,70,0,1,0,1,0
56790,445,0,0,70,70,0,1,0,1,0
60953,445,0,0,66,66,0,1,0,1,0
54064,445,0,0,70,70,0,1,0,1,0
59694,445,0,0,70,70,0,1,0,1,0
63543,445,0,0,66,66,0,1,0,1,0
49935,445,0,0,70,70,0,1,0,1,0
50907,445,0,0,70,70,0,1,0,1,0
62061,445,0,0,69,69,0,1,0,1,0
55644,445,0,0,70,70,0,1,0,1,0
51085,445,0,0,68,68,0,1,0,1,0
49501,445,0,0,70,70,0,1,0,1,0
53106,445,0,0,69,69,0,1,0,1,0
56640,445,0,0,66,66,0,1,0,1,0
57038,445,0,0,70,70,0,1,0,1,0
55083,445,0,0,70,70,0,1,0,1,0
60752,445,0,0,67,67,0,1,0,1,0
62981,445,0,0,69,69,0,1,0,1,0
51432,445,0,0,70,70,0,1,0,1,0
56258,445,0,0,66,66,0,1,0,1,0
63444,445,0,0,70,70,0,1,0,1,0
64625,445,0,0,70,70,0,1,0,1,0
55634,445,0,0,69,69,0,1,0,1,0
53975,445,0,0,70,70,0,1,0,1,0
56104,445,0,0,70,70,0,1,0,1,0
52522,445,0,0,66,66,0,1,0,1,0
58592,445,0,0,70,70,0,1,0,1,0
59827,445,0,0,70,70,0,1,0,1,0
56769,445,0,0,70,70,0,1,0,1,0
62700,445,0,0,68,68,0,1,0,1,0
52604,445,0,0,70,70,0,1,0,1,0
64227,445,0,0,70,70,0,1,0,1,0
50096,445,0,0,66,66,0,1,0,1,0
54482,445,0,0,70,70,0,1,0,1,0
61436,445,0,0,70,70,0,1,0,1,0
58887,445,0,0,70,70,0,1,0,1,0
51040,445,0,0,70,70,0,1,0,1,0
50967,445,0,0,70,70,0,1,0,1,0
54068,445,0,0,66,66,0,1,0,1,0
58855,445,0,0,70,70,0,1,0,1,0
61256,445,0,0,70,70,0,1,0,1,0
59312,445,0,0,68,68,0,1,0,1,0
52281,445,0,0,66,66,0,1,0,1,0
60210,445,0,0,70,70,0,1,0,1,0
63192,445,0,0,67,67,0,1,0,1,0
62612,445,0,0,66,66,0,1,0,1,0
51686,445,0,0,70,70,0,1,0,1,0
53722,445,0,0,70,70,0,1,0,1,0
63947,445,0,0,70,70,0,1,0,1,0
50652,445,0,0,67,67,0,1,0,1,0
51489,445,0,0,70,70,0,1,0,1,0
50194,445,0,0,70,70,0,1,0,1,0
61665,445,0,0,66,66,0,1,0,1,0
60579,445,0,0,69,69,0,1,0,1,0
54615,445,0,0,68,68,0,1,0,1,0
56669,445,0,0,66,66,0,1,0,1,0
59109,445,0,0,70,70,0,1,0,1,0
56417,445,0,0,70,70,0,1,0,1,0
56047,445,0,0,67,67,0,1,0,1,0
56202,445,0,0,70,70,0,1,0,1,0
51882,445,0,0,67,67,0,1,0,1,0
55083,445,0,0,70,70,0,1,0,1,0
49939,445,0,0,70,70,0,1,0,1,0
53289,445,0,0,66,66,0,1,0,1,0
53943,445,0,0,69,69,0,1,0,1,0
54930,445,0,0,68,68,0,1,0,1,0
49193,445,0,0,70,70,0,1,0,1,0
65227,445,0,0,70,70,0,1,0,1,0
50049,445,0,0,70,70,0,1,0,1,0
59934,445,0,0,66,66,0,1,0,1,0
54113,445,0,0,70,70,0,1,0,1,0
56096,445,0,0,70,70,0,1,0,1,0
64456,445,0,0,70,70,0,1,0,1,0
61815,445,0,0,70,70,0,1,0,1,0
63237,445,0,0,70,70,0,1,0,1,0
60064,445,0,0,70,70,0,1,0,1,0
62284,445,0,0,70,70,0,1,0,1,0
54444,445,0,0,69,69,0,1,0,1,0
59088,445,0,0,69,69,0,1,0,1,0
58059,445,0,0,66,66,0,1,0,1,0
64986,445,0,0,68,68,0,1,0,1,0
50418,445,0,0,66,66,0,1,0,1,0
50035,445,0,0,70,70,0,1,0,1,0
51551,445,0,0,70,70,0,1,0,1,0
59862,445,0,0,70,70,0,1,0,1,0
49877,445,0,0,70,70,0,1,0,1,0
64515,445,0,0,70,70,0,1,0,1,0
64034,445,0,0,66,66,0,1,0,1,0
52052,445,0,0,70,70,0,1,0,1,0
56939,445,0,0,70,70,0,1,0,1,0
62505,445,0,0,70,70,0,1,0,1,0
63886,445,0,0,70,70,0,1,0,1,0
55973,445,0,0,70,70,0,1,0,1,0
51721,445,0,0,68,68,0,1,0,1,0
58068,445,0,0,66,66,0,1,0,1,0
50837,445,0,0,66,66,0,1,0,1,0
62548,445,0,0,70,70,0,1,0,1,0
64838,445,0,0,70,70,0,1,0,1,0
51104,445,0,0,69,69,0,1,0,1,0
57730,445,0,0,68,68,0,1,0,1,0
64266,445,0,0,70,70,0,1,0,1,0
58845,445,0,0,70,70,0,1,0,1,0
64452,445,0,0,70,70,0,1,0,1,0
50847,445,0,0,66,66,0,1,0,1,0
49218,445,0,0,66,66,0,1,0,1,0
60812,445,0,0,70,70,0,1,0,1,0
59932,445,0,0,70,70,0,1,0,1,0
60313,445,0,0,70,70,0,1,0,1,0
51812,445,0,0,70,70,0,1,0,1,0
61846,445,0,0,68,68,0,1,0,1,0
59991,445,0,0,66,66,0,1,0,1,0
52313,445,0,0,70,70,0,1,0,1,0
49544,445,0,0,66,66,0,1,0,1,0
55289,445,0,0,66,66,0,1,0,1,0
50814,445,0,0,70,70,0,1,0,1,0
49879,445,0,0,70,70,0,1,0,1,0
59988,445,0,0,70,70,0,1,0,1,0
50033,445,0,0,66,66,0,1,0,1,0
58603,445,0,0,70,70,0,1,0,1,0
53499,445,0,0,66,66,0,1,0,1,0
54303,445,0,0,70,70,0,1,0,1,0
52838,445,0,0,66,66,0,1,0,1,0
57302,445,0,0,66,66,0,1,0,1,0
58420,445,0,0,66,66,0,1,0,1,0
54730,445,0,0,67,67,0,1,0,1,0
50128,445,0,0,70,70,0,1,0,1,0
57151,445,0,0,67,67,0,1,0,1,0
62812,445,0,0,67,67,0,1,0,1,0
56860,445,0,0,69,69,0,1,0,1,0
50351,445,0,0,66,66,0,1,0,1,0
57496,445,0,0,68,68,0,1,0,1,0
49663,445,0,0,66,66,0,1,0,1,0
65396,445,0,0,69,69,0,1,0,1,0
61601,445,0,0,70,70,0,1,0,1,0
50169,445,0,0,70,70,0,1,0,1,0
52991,445,0,0,70,70,0,1,0,1,0
58691,445,0,0,69,69,0,1,0,1,0
50930,445,0,0,66,66,0,1,0,1,0
50475,445,0,0,68,68,0,1,0,1,0
54666,445,0,0,68,68,0,1,0,1,0
61784,445,0,0,66,66,0,1,0,1,0
58012,445,0,0,70,70,0,1,0,1,0
65326,445,0,0,67,67,0,1,0,1,0
51324,445,0,0,66,66,0,1,0,1,0
59197,445,0,0,66,66,0,1,0,1,0
63616,445,0,0,70,70,0,1,0,1,0
63955,445,0,0,66,66,0,1,0,1,0
62172,445,0,0,70,70,0,1,0,1,0
52440,445,0,0,70,70,0,1,0,1,0
60371,445,0,0,66,66,0,1,0,1,0
52584,445,0,0,70,70,0,1,0,1,0
55402,445,0,0,68,68,0,1,0,1,0
49346,445,0,0,69,69,0,1,0,1,0
58224,445,0,0,69,69,0,1,0,1,0
64164,445,0,0,66,66,0,1,0,1,0
51104,445,0,0,66,66,0,1,0,1,0
52250,445,0,0,70,70,0,1,0,1,0
50950,445,0,0,66,66,0,1,0,1,0
51630,445,0,0,68,68,0,1,0,1,0
57795,445,0,0,66,66,0,1,0,1,0
50574,445,0,0,70,70,0,1,0,1,0
55034,445,0,0,66,66,0,1,0,1,0
51032,445,0,0,70,70,0,1,0,1,0
49518,445,0,0,67,67,0,1,0,1,0
63423,445,0,0,67,67,0,1,0,1,0
60629,445,0,0,70,70,0,1,0,1,0
54979,445,0,0,70,70,0,1,0,1,0
56191,445,0,0,66,66,0,1,0,1,0
57088,445,0,0,70,70,0,1,0,1,0
54533,445,0,0,70,70,0,1,0,1,0
61336,445,0,0,66,66,0,1,0,1,0
62134,445,0,0,66,66,0,1,0,1,0
49397,445,0,0,66,66,0,1,0,1,0
50075,445,0,0,70,70,0,1,0,1,0
51036,445,0,0,70,70,0,1,0,1,0
63851,445,0,0,68,68,0,1,0,1,0
50343,445,0,0,68,68,0,1,0,1,0
59219,445,0,0,70,70,0,1,0,1,0
62558,445,0,0,68,68,0,1,0,1,0
50707,445,0,0,70,70,0,1,0,1,0
53975,445,0,0,70,70,0,1,0,1,0
61159,445,0,0,70,70,0,1,0,1,0
54947,445,0,0,70,70,0,1,0,1,0
52007,445,0,0,70,70,0,1,0,1,0
53040,445,0,0,70,70,0,1,0,1,0
59141,445,0,0,70,70,0,1,0,1,0
53012,445,0,0,66,66,0,1,0,1,0
64861,445,0,0,70,70,0,1,0,1,0
50750,445,0,0,66,66,0,1,0,1,0
53190,445,0,0,68,68,0,1,0,1,0
59093,445,0,0,66,66,0,1,0,1,0
50253,445,0,0,70,70,0,1,0,1,0
65531,445,0,0,66,66,0,1,0,1,0
63358,445,0,0,70,70,0,1,0,1,0
65269,445,0,0,66,66,0,1,0,1,0
50524,445,0,0,70,70,0,1,0,1,0
53775,445,0,0,66,66,0,1,0,1,0
60981,445,0,0,70,70,0,1,0,1,0
57123,445,0,0,70,70,0,1,0,1,0
49593,445,0,0,69,69,0,1,0,1,0
56255,445,0,0,67,67,0,1,0,1,0
55508,445,0,0,70,70,0,1,0,1,0
58272,445,0,0,66,66,0,1,0,1,0
58446,445,0,0,69,69,0,1,0,1,0
50149,445,0,0,67,67,0,1,0,1,0
58017,445,0,0,67,67,0,1,0,1,0
58833,445,0,0,66,66,0,1,0,1,0
63563,445,0,0,66,66,0,1,0,1,0
56391,445,0,0,66,66,0,1,0,1,0
50792,445,0,0,66,66,0,1,0,1,0
60474,445,0,0,70,70,0,1,0,1,0
56639,445,0,0,66,66,0,1,0,1,0
64248,445,0,0,70,70,0,1,0,1,0
50708,445,0,0,69,69,0,1,0,1,0
55569,445,0,0,70,70,0,1,0,1,0
61379,445,0,0,70,70,0,1,0,1,0
59206,445,0,0,70,70,0,1,0,1,0
55333,445,0,0,70,70,0,1,0,1,0
59832,445,0,0,70,70,0,1,0,1,0
50780,445,0,0,66,66,0,1,0,1,0
60058,445,0,0,66,66,0,1,0,1,0
59162,445,0,0,70,70,0,1,0,1,0
58701,445,0,0,70,70,0,1,0,1,0
64973,445,0,0,70,70,0,1,0,1,0
63344,445,0,0,70,70,0,1,0,1,0
64557,445,0,0,70,70,0,1,0,1,0
57043,445,0,0,68,68,0,1,0,1,0
62544,445,0,0,66,66,0,1,0,1,0
59733,445,0,0,70,70,0,1,0,1,0
58012,445,0,0,70,70,0,1,0,1,0
53609,445,0,0,70,70,0,1,0,1,0
53597,445,0,0,70,70,0,1,0,1,0
50674,445,0,0,66,66,0,1,0,1,0
55785,445,0,0,70,70,0,1,0,1,0
58498,445,0,0,66,66,0,1,0,1,0
62082,445,0,0,70,70,0,1,0,1,0
57369,445,0,0,66,66,0,1,0,1,0
61159,445,0,0,69,69,0,1,0,1,0
56197,445,0,0,69,69,0,1,0,1,0
62037,445,0,0,68,68,0,1,0,1,0
60968,445,0,0,69,69,0,1,0,1,0
60949,445,0,0,68,68,0,1,0,1,0
56531,445,0,0,66,66,0,1,0,1,0
64312,445,0,0,70,70,0,1,0,1,0
63516,445,0,0,66,66,0,1,0,1,0
50632,445,0,0,70,70,0,1,0,1,0
54628,445,0,0,70,70,0,1,0,1,0
55412,445,0,0,70,70,0,1,0,1,0
49706,445,0,0,70,70,0,1,0,1,0
63641,445,0,0,70,70,0,1,0,1,0
59293,445,0,0,66,66,0,1,0,1,0
49587,445,0,0,66,66,0,1,0,1,0
60788,445,0,0,70,70,0,1,0,1,0
58583,445,0,0,66,66,0,1,0,1,0
53123,445,0,0,70,70,0,1,0,1,0
57928,445,0,0,70,70,0,1,0,1,0
58564,445,0,0,70,70,0,1,0,1,0
54827,445,0,0,68,68,0,1,0,1,0
62830,445,0,0,67,67,0,1,0,1,0
64965,445,0,0,70,70,0,1,0,1,0
50402,445,0,0,70,70,0,1,0,1,0
58207,445,0,0,67,67,0,1,0,1,0
61461,445,0,0,70,70,0,1,0,1,0
56656,445,0,0,70,70,0,1,0,1,0
53672,445,0,0,70,70,0,1,0,1,0
60459,445,0,0,70,70,0,1,0,1,0
50653,445,0,0,69,69,0,1,0,1,0
64499,445,0,0,70,70,0,1,0,1,0
65116,445,0,0,66,66,0,1,0,1,0
54313,445,0,0,67,67,0,1,0,1,0
62303,445,0,0,70,70,0,1,0,1,0
59064,445,0,0,68,68,0,1,0,1,0
55334,445,0,0,70,70,0,1,0,1,0
59527,445,0,0,70,70,0,1,0,1,0
62296,445,0,0,66,66,0,1,0,1,0
60955,445,0,0,67,67,0,1,0,1,0
59228,445,0,0,70,70,0,1,0,1,0
54388,445,0,0,70,70,0,1,0,1,0
65031,445,0,0,70,70,0,1,0,1,0
62972,445,0,0,70,70,0,1,0,1,0
64488,445,0,0,70,70,0,1,0,1,0
49448,445,0,0,70,70,0,1,0,1,0
62854,445,0,0,70,70,0,1,0,1,0
57095,445,0,0,67,67,0,1,0,1,0
62703,445,0,0,70,70,0,1,0,1,0
57304,445,0,0,67,67,0,1,0,1,0
53751,445,0,0,66,66,0,1,0,1,0
54306,445,0,0,70,70,0,1,0,1,0
63518,445,0,0,67,67,0,1,0,1,0
52498,445,0,0,70,70,0,1,0,1,0
63110,445,0,0,70,70,0,1,0,1,0
59113,445,0,0,70,70,0,1,0,1,0
59115,445,0,0,66,66,0,1,0,1,0
62976,445,0,0,70,70,0,1,0,1,0
54156,445,0,0,70,70,0,1,0,1,0
60173,445,0,0,70,70,0,1,0,1,0
52891,445,0,0,70,70,0,1,0,1,0
65140,445,0,0,67,67,0,1,0,1,0
49707,445,0,0,70,70,0,1,0,1,0
62193,445,0,0,70,70,0,1,0,1,0
52405,445,0,0,67,67,0,1,0,1,0
60742,445,0,0,66,66,0,1,0,1,0
50748,445,0,0,66,66,0,1,0,1,0
51077,445,0,0,70,70,0,1,0,1,0
64239,445,0,0,70,70,0,1,0,1,0
53506,445,0,0,66,66,0,1,0,1,0
63775,445,0,0,66,66,0,1,0,1,0
62919,445,0,0,70,70,0,1,0,1,0
65143,445,0,0,70,70,0,1,0,1,0
55807,445,0,0,66,66,0,1,0,1,0
52792,445,0,0,66,66,0,1,0,1,0
57501,445,0,0,70,70,0,1,0,1,0
64266,445,0,0,70,70,0,1,0,1,0
49184,445,0,0,67,67,0,1,0,1,0
64349,445,0,0,68,68,0,1,0,1,0
55618,445,0,0,70,70,0,1,0,1,0
56097,445,0,0,70,70,0,1,0,1,0
62122,445,0,0,68,68,0,1,0,1,0
59823,445,0,0,70,70,0,1,0,1,0
61352,445,0,0,70,70,0,1,0,1,0
60568,445,0,0,70,70,0,1,0,1,0
56433,445,0,0,70,70,0,1,0,1,0
53816,445,0,0,70,70,0,1,0,1,0
57232,445,0,0,70,70,0,1,0,1,0
50827,445,0,0,70,70,0,1,0,1,0
50826,445,0,0,70,70,0,1,0,1,0
58427,445,0,0,67,67,0,1,0,1,0
52415,445,0,0,69,69,0,1,0,1,0
54155,445,0,0,66,66,0,1,0,1,0
62384,445,0,0,70,70,0,1,0,1,0
54348,445,0,0,66,66,0,1,0,1,0
50731,445,0,0,67,67,0,1,0,1,0
63193,445,0,0,70,70,0,1,0,1,0
51346,445,0,0,70,70,0,1,0,1,0
61992,445,0,0,70,70,0,1,0,1,0
62994,445,0,0,70,70,0,1,0,1,0
59633,445,0,0,70,70,0,1,0,1,0
51601,445,0,0,67,67,0,1,0,1,0
60938,445,0,0,69,69,0,1,0,1,0
58198,445,0,0,69,69,0,1,0,1,0
56063,445,0,0,66,66,0,1,0,1,0
58708,445,0,0,66,66,0,1,0,1,0
55872,445,0,0,66,66,0,1,0,1,0
60058,445,0,0,66,66,0,1,0,1,0
58447,445,0,0,70,70,0,1,0,1,0
60451,445,0,0,70,70,0,1,0,1,0
54390,445,0,0,70,70,0,1,0,1,0
64217,445,0,0,70,70,0,1,0,1,0
54423,445,0,0,70,70,0,1,0,1,0
64845,445,0,0,70,70,0,1,0,1,0
53224,445,0,0,67,67,0,1,0,1,0
58151,445,0,0,70,70,0,1,0,1,0
57197,445,0,0,70,70,0,1,0,1,0
50194,445,0,0,70,70,0,1,0,1,0
57964,445,0,0,70,70,0,1,0,1,0
55741,445,0,0,66,66,0,1,0,1,0
52925,445,0,0,66,66,0,1,0,1,0
63021,445,0,0,70,70,0,1,0,1,0
51063,445,0,0,66,66,0,1,0,1,0
50505,445,0,0,70,70,0,1,0,1,0
65482,445,0,0,70,70,0,1,0,1,0
54735,445,0,0,70,70,0,1,0,1,0
60112,445,0,0,67,67,0,1,0,1,0
56939,445,0,0,70,70,0,1,0,1,0
59862,445,0,0,70,70,0,1,0,1,0
59380,445,0,0,70,70,0,1,0,1,0
56005,445,0,0,70,70,0,1,0,1,0
56404,445,0,0,70,70,0,1,0,1,0
49565,445,0,0,68,68,0,1,0,1,0
53500,445,0,0,66,66,0,1,0,1,0
62134,445,0,0,70,70,0,1,0,1,0
52402,445,0,0,70,70,0,1,0,1,0
53614,445,0,0,70,70,0,1,0,1,0
57096,445,0,0,68,68,0,1,0,1,0
53083,445,0,0,70,70,0,1,0,1,0
64765,445,0,0,66,66,0,1,0,1,0
56403,445,0,0,68,68,0,1,0,1,0
55667,445,0,0,70,70,0,1,0,1,0
63143,445,0,0,70,70,0,1,0,1,0
58065,445,0,0,66,66,0,1,0,1,0
49880,445,0,0,70,70,0,1,0,1,0
60310,445,0,0,66,66,0,1,0,1,0
50604,445,0,0,70,70,0,1,0,1,0
54203,445,0,0,66,66,0,1,0,1,0
59012,445,0,0,70,70,0,1,0,1,0
60038,445,0,0,70,70,0,1,0,1,0
51363,445,0,0,68,68,0,1,0,1,0
64181,445,0,0,68,68,0,1,0,1,0
55620,445,0,0,70,70,0,1,0,1,0
62136,445,0,0,70,70,0,1,0,1,0
53189,445,0,0,66,66,0,1,0,1,0
50286,445,0,0,66,66,0,1,0,1,0
58055,445,0,0,66,66,0,1,0,1,0
49809,445,0,0,70,70,0,1,0,1,0
59114,445,0,0,67,67,0,1,0,1,0
58893,445,0,0,67,67,0,1,0,1,0
55455,445,0,0,70,70,0,1,0,1,0
59533,445,0,0,66,66,0,1,0,1,0
54429,445,0,0,70,70,0,1,0,1,0
63278,445,0,0,70,70,0,1,0,1,0
51438,445,0,0,70,70,0,1,0,1,0
57129,445,0,0,66,66,0,1,0,1,0
62315,445,0,0,70,70,0,1,0,1,0
51439,445,0,0,66,66,0,1,0,1,0
60822,445,0,0,66,66,0,1,0,1,0
63941,445,0,0,70,70,0,1,0,1,0
52484,445,0,0,67,67,0,1,0,1,0
58580,445,0,0,66,66,0,1,0,1,0
58574,445,0,0,70,70,0,1,0,1,0
60488,445,0,0,66,66,0,1,0,1,0
50764,445,0,0,70,70,0,1,0,1,0
60293,445,0,0,70,70,0,1,0,1,0
60516,445,0,0,69,69,0,1,0,1,0
61617,445,0,0,70,70,0,1,0,1,0
53960,445,0,0,70,70,0,1,0,1,0
54516,445,0,0,69,69,0,1,0,1,0
58785,445,0,0,70,70,0,1,0,1,0
53111,445,0,0,66,66,0,1,0,1,0
51882,445,0,0,70,70,0,1,0,1,0
52075,445,0,0,70,70,0,1,0,1,0
51297,445,0,0,70,70,0,1,0,1,0
52894,445,0,0,67,67,0,1,0,1,0
62463,445,0,0,70,70,0,1,0,1,0
51798,445,0,0,70,70,0,1,0,1,0
55256,445,0,0,70,70,0,1,0,1,0
51291,445,0,0,70,70,0,1,0,1,0
60354,445,0,0,70,70,0,1,0,1,0
60957,445,0,0,70,70,0,1,0,1,0
52995,445,0,0,70,70,0,1,0,1,0
50043,445,0,0,70,70,0,1,0,1,0
50799,445,0,0,66,66,0,1,0,1,0
57235,445,0,0,70,70,0,1,0,1,0
54649,445,0,0,66,66,0,1,0,1,0
49264,445,0,0,66,66,0,1,0,1,0
60783,445,0,0,70,70,0,1,0,1,0
55363,445,0,0,70,70,0,1,0,1,0
65453,445,0,0,67,67,0,1,0,1,0
58232,445,0,0,69,69,0,1,0,1,0
52976,445,0,0,70,70,0,1,0,1,0
62232,445,0,0,70,70,0,1,0,1,0
51037,445,0,0,70,70,0,1,0,1,0
53703,445,0,0,68,68,0,1,0,1,0
56092,445,0,0,69,69,0,1,0,1,0
50011,445,0,0,70,70,0,1,0,1,0
55457,445,0,0,70,70,0,1,0,1,0
55340,445,0,0,70,70,0,1,0,1,0
58791,445,0,0,70,70,0,1,0,1,0
50967,445,0,0,68,68,0,1,0,1,0
63493,445,0,0,70,70,0,1,0,1,0
52335,445,0,0,68,68,0,1,0,1,0
64257,445,0,0,70,70,0,1,0,1,0
62746,445,0,0,70,70,0,1,0,1,0
58125,445,0,0,70,70,0,1,0,1,0
53379,445,0,0,70,70,0,1,0,1,0
59448,445,0,0,70,70,0,1,0,1,0
49716,445,0,0,66,66,0,1,0,1,0
65216,445,0,0,69,69,0,1,0,1,0
63390,445,0,0,66,66,0,1,0,1,0
61508,445,0,0,70,70,0,1,0,1,0
51026,445,0,0,70,70,0,1,0,1,0
52906,445,0,0,69,69,0,1,0,1,0
62996,445,0,0,67,67,0,1,0,1,0
52164,445,0,0,69,69,0,1,0,1,0
51792,445,0,0,70,70,0,1,0,1,0
64275,445,0,0,66,66,0,1,0,1,0
56531,445,0,0,70,70,0,1,0,1,0
64722,445,0,0,70,70,0,1,0,1,0
49521,445,0,0,70,70,0,1,0,1,0
55505,445,0,0,70,70,0,1,0,1,0
54926,445,0,0,70,70,0,1,0,1,0
50253,445,0,0,70,70,0,1,0,1,0
56653,445,0,0,70,70,0,1,0,1,0
51826,445,0,0,68,68,0,1,0,1,0
60374,445,0,0,70,70,0,1,0,1,0
55773,445,0,0,70,70,0,1,0,1,0
62213,445,0,0,68,68,0,1,0,1,0
61142,445,0,0,68,68,0,1,0,1,0
52312,445,0,0,70,70,0,1,0,1,0
60193,445,0,0,70,70,0,1,0,1,0
53964,445,0,0,70,70,0,1,0,1,0
53948,445,0,0,66,66,0,1,0,1,0
52017,445,0,0,66,66,0,1,0,1,0
50754,445,0,0,70,70,0,1,0,1,0
65245,445,0,0,69,69,0,1,0,1,0
63838,445,0,0,70,70,0,1,0,1,0
63938,445,0,0,70,70,0,1,0,1,0
52944,445,0,0,67,67,0,1,0,1,0
60571,445,0,0,70,70,0,1,0,1,0
59614,445,0,0,67,67,0,1,0,1,0
50619,445,0,0,66,66,0,1,0,1,0
64190,445,0,0,69,69,0,1,0,1,0
53119,445,0,0,70,70,0,1,0,1,0
59013,445,0,0,66,66,0,1,0,1,0
62466,445,0,0,70,70,0,1,0,1,0
60378,445,0,0,66,66,0,1,0,1,0
60508,445,0,0,66,66,0,1,0,1,0
56406,445,0,0,70,70,0,1,0,1,0
53223,445,0,0,68,68,0,1,0,1,0
60714,445,0,0,70,70,0,1,0,1,0
51810,445,0,0,70,70,0,1,0,1,0
51084,445,0,0,70,70,0,1,0,1,0
56357,445,0,0,70,70,0,1,0,1,0
61671,445,0,0,66,66,0,1,0,1,0
62175,445,0,0,69,69,0,1,0,1,0
62809,445,0,0,70,70,0,1,0,1,0
62875,445,0,0,66,66,0,1,0,1,0
58713,445,0,0,66,66,0,1,0,1,0
65013,445,0,0,66,66,0,1,0,1,0
61082,445,0,0,66,66,0,1,0,1,0
57311,445,0,0,70,70,0,1,0,1,0
58606,445,0,0,70,70,0,1,0,1,0
50441,445,0,0,67,67,0,1,0,1,0
49489,445,0,0,70,70,0,1,0,1,0
65420,445,0,0,70,70,0,1,0,1,0
55975,445,0,0,70,70,0,1,0,1,0
56891,445,0,0,69,69,0,1,0,1,0
62785,445,0,0,70,70,0,1,0,1,0
51380,445,0,0,66,66,0,1,0,1,0
64098,445,0,0,70,70,0,1,0,1,0
61461,445,0,0,70,70,0,1,0,1,0
58438,445,0,0,66,66,0,1,0,1,0
62301,445,0,0,70,70,0,1,0,1,0
61159,445,0,0,70,70,0,1,0,1,0
60679,445,0,0,70,70,0,1,0,1,0
55451,445,0,0,70,70,0,1,0,1,0
49778,445,0,0,66,66,0,1,0,1,0
52629,445,0,0,70,70,0,1,0,1,0
51525,445,0,0,69,69,0,1,0,1,0
62125,445,0,0,70,70,0,1,0,1,0
55429,445,0,0,70,70,0,1,0,1,0
54788,445,0,0,70,70,0,1,0,1,0
49880,445,0,0,70,70,0,1,0,1,0
57033,445,0,0,66,66,0,1,0,1,0
51221,445,0,0,70,70,0,1,0,1,0
54572,445,0,0,66,66,0,1,0,1,0
58395,445,0,0,70,70,0,1,0,1,0
54248,445,0,0,68,68,0,1,0,1,0
50907,445,0,0,66,66,0,1,0,1,0
61903,445,0,0,70,70,0,1,0,1,0
64961,445,0,0,70,70,0,1,0,1,0
62409,445,0,0,68,68,0,1,0,1,0
56513,445,0,0,70,70,0,1,0,1,0
64313,445,0,0,70,70,0,1,0,1,0
60293,445,0,0,70,70,0,1,0,1,0
53048,445,0,0,69,69,0,1,0,1,0
54428,445,0,0,70,70,0,1,0,1,0
56206,445,0,0,70,70,0,1,0,1,0
50170,445,0,0,70,70,0,1,0,1,0
62108,445,0,0,69,69,0,1,0,1,0
50837,445,0,0,70,70,0,1,0,1,0
51543,445,0,0,70,70,0,1,0,1,0
56798,445,0,0,66,66,0,1,0,1,0
59440,445,0,0,70,70,0,1,0,1,0
54831,445,0,0,66,66,0,1,0,1,0
56775,445,0,0,66,66,0,1,0,1,0
53337,445,0,0,70,70,0,1,0,1,0
56964,445,0,0,70,70,0,1,0,1,0
62471,445,0,0,67,67,0,1,0,1,0
57669,445,0,0,66,66,0,1,0,1,0
61826,445,0,0,70,70,0,1,0,1,0
60143,445,0,0,70,70,0,1,0,1,0
49510,445,0,0,66,66,0,1,0,1,0
55618,445,0,0,70,70,0,1,0,1,0
55159,445,0,0,66,66,0,1,0,1,0
52474,445,0,0,67,67,0,1,0,1,0
59319,445,0,0,70,70,0,1,0,1,0
55031,445,0,0,68,68,0,1,0,1,0
53459,445,0,0,70,70,0,1,0,1,0
50255,445,0,0,69,69,0,1,0,1,0
54564,445,0,0,70,70,0,1,0,1,0
50593,445,0,0,66,66,0,1,0,1,0
56899,445,0,0,66,66,0,1,0,1,0
60502,445,0,0,66,66,0,1,0,1,0
50650,445,0,0,70,70,0,1,0,1,0
53358,445,0,0,70,70,0,1,0,1,0
61910,445,0,0,66,66,0,1,0,1,0
62625,445,0,0,70,70,0,1,0,1,0
53234,445,0,0,70,70,0,1,0,1,0
60118,445,0,0,68,68,0,1,0,1,0
55918,445,0,0,69,69,0,1,0,1,0
52568,445,0,0,70,70,0,1,0,1,0
53497,445,0,0,66,66,0,1,0,1,0
58274,445,0,0,70,70,0,1,0,1,0
61073,445,0,0,70,70,0,1,0,1,0
65072,445,0,0,70,70,0,1,0,1,0
53725,445,0,0,70,70,0,1,0,1,0
57606,445,0,0,70,70,0,1,0,1,0
51309,445,0,0,66,66,0,1,0,1,0
59613,445,0,0,69,69,0,1,0,1,0
58911,445,0,0,70,70,0,1,0,1,0
53799,445,0,0,70,70,0,1,0,1,0
49454,445,0,0,70,70,0,1,0,1,0
63188,445,0,0,66,66,0,1,0,1,0
59863,445,0,0,70,70,0,1,0,1,0
55696,445,0,0,70,70,0,1,0,1,0
59028,445,0,0,67,67,0,1,0,1,0
64771,445,0,0,70,70,0,1,0,1,0
52904,445,0,0,67,67,0,1,0,1,0
59556,445,0,0,68,68,0,1,0,1,0
51491,445,0,0,68,68,0,1,0,1,0
60688,445,0,0,70,70,0,1,0,1,0
54063,445,0,0,66,66,0,1,0,1,0
53674,445,0,0,70,70,0,1,0,1,0
63386,445,0,0,66,66,0,1,0,1,0
58968,445,0,0,69,69,0,1,0,1,0
55641,445,0,0,70,70,0,1,0,1,0
61238,445,0,0,67,67,0,1,0,1,0
63695,445,0,0,66,66,0,1,0,1,0
62212,445,0,0,70,70,0,1,0,1,0
60313,445,0,0,70,70,0,1,0,1,0
57198,445,0,0,68,68,0,1,0,1,0
54717,445,0,0,67,67,0,1,0,1,0
61530,445,0,0,70,70,0,1,0,1,0
63708,445,0,0,66,66,0,1,0,1,0
60977,445,0,0,69,69,0,1,0,1,0
61826,445,0,0,70,70,0,1,0,1,0
50763,445,0,0,70,70,0,1,0,1,0
64603,445,0,0,67,67,0,1,0,1,0
50782,445,0,0,70,70,0,1,0,1,0
57354,445,0,0,70,70,0,1,0,1,0
53753,445,0,0,66,66,0,1,0,1,0
63515,445,0,0,70,70,0,1,0,1,0
57355,445,0,0,70,70,0,1,0,1,0
57911,445,0,0,67,67,0,1,0,1,0
56963,445,0,0,66,66,0,1,0,1,0
58197,445,0,0,70,70,0,1,0,1,0
64273,445,0,0,66,66,0,1,0,1,0
52243,445,0,0,70,70,0,1,0,1,0
60140,445,0,0,70,70,0,1,0,1,0
58483,445,0,0,69,69,0,1,0,1,0
51766,445,0,0,69,69,0,1,0,1,0
51985,445,0,0,70,70,0,1,0,1,0
51630,445,0,0,69,69,0,1,0,1,0
51054,445,0,0,66,66,0,1,0,1,0
63366,445,0,0,70,70,0,1,0,1,0
56190,445,0,0,67,67,0,1,0,1,0
57929,445,0,0,70,70,0,1,0,1,0
60873,445,0,0,66,66,0,1,0,1,0
55060,445,0,0,69,69,0,1,0,1,0
56123,445,0,0,69,69,0,1,0,1,0
61247,445,0,0,70,70,0,1,0,1,0
50849,445,0,0,69,69,0,1,0,1,0
54522,445,0,0,70,70,0,1,0,1,0
58296,445,0,0,66,66,0,1,0,1,0
63859,445,0,0,66,66,0,1,0,1,0
63785,445,0,0,70,70,0,1,0,1,0
53149,445,0,0,70,70,0,1,0,1,0
60385,445,0,0,69,69,0,1,0,1,0
63920,445,0,0,70,70,0,1,0,1,0
55866,445,0,0,66,66,0,1,0,1,0
59124,445,0,0,67,67,0,1,0,1,0
57804,445,0,0,66,66,0,1,0,1,0
50123,445,0,0,70,70,0,1,0,1,0
63413,445,0,0,69,69,0,1,0,1,0
53498,445,0,0,70,70,0,1,0,1,0
63026,445,0,0,70,70,0,1,0,1,0
64601,445,0,0,66,66,0,1,0,1,0
58409,445,0,0,66,66,0,1,0,1,0
55596,445,0,0,70,70,0,1,0,1,0
58998,445,0,0,67,67,0,1,0,1,0
56314,445,0,0,70,70,0,1,0,1,0
61398,445,0,0,66,66,0,1,0,1,0
50052,445,0,0,66,66,0,1,0,1,0
54982,445,0,0,70,70,0,1,0,1,0
63664,445,0,0,70,70,0,1,0,1,0
50135,445,0,0,70,70,0,1,0,1,0
62892,445,0,0,69,69,0,1,0,1,0
51753,445,0,0,70,70,0,1,0,1,0
59439,445,0,0,70,70,0,1,0,1,0
56784,445,0,0,70,70,0,1,0,1,0
57157,445,0,0,70,70,0,1,0,1,0
50707,445,0,0,70,70,0,1,0,1,0
59988,445,0,0,70,70,0,1,0,1,0
49553,445,0,0,70,70,0,1,0,1,0
64963,445,0,0,70,70,0,1,0,1,0
62470,445,0,0,67,67,0,1,0,1,0
60601,445,0,0,70,70,0,1,0,1,0
61860,445,0,0,70,70,0,1,0,1,0
53505,445,0,0,66,66,0,1,0,1,0
51165,445,0,0,68,68,0,1,0,1,0
59789,445,0,0,66,66,0,1,0,1,0
61145,445,0,0,70,70,0,1,0,1,0
61229,445,0,0,68,68,0,1,0,1,0
54201,445,0,0,68,68,0,1,0,1,0
61591,445,0,0,68,68,0,1,0,1,0
54727,445,0,0,70,70,0,1,0,1,0
49425,445,0,0,70,70,0,1,0,1,0
61385,445,0,0,67,67,0,1,0,1,0
50653,445,0,0,69,69,0,1,0,1,0
51550,445,0,0,70,70,0,1,0,1,0
50325,445,0,0,66,66,0,1,0,1,0
56764,445,0,0,70,70,0,1,0,1,0
53878,445,0,0,66,66,0,1,0,1,0
50338,445,0,0,66,66,0,1,0,1,0
53031,445,0,0,70,70,0,1,0,1,0
65125,445,0,0,66,66,0,1,0,1,0
65323,445,0,0,66,66,0,1,0,1,0
59041,445,0,0,70,70,0,1,0,1,0
50595,445,0,0,70,70,0,1,0,1,0
54321,445,0,0,66,66,0,1,0,1,0
56510,445,0,0,70,70,0,1,0,1,0
57870,445,0,0,70,70,0,1,0,1,0
56872,445,0,0,70,70,0,1,0,1,0
53363,445,0,0,70,70,0,1,0,1,0
53426,445,0,0,66,66,0,1,0,1,0
62156,445,0,0,69,69,0,1,0,1,0
53223,445,0,0,66,66,0,1,0,1,0
53289,445,0,0,66,66,0,1,0,1,0
53932,445,0,0,70,70,0,1,0,1,0
55600,445,0,0,66,66,0,1,0,1,0
62774,445,0,0,69,69,0,1,0,1,0
61569,445,0,0,70,70,0,1,0,1,0
64974,445,0,0,70,70,0,1,0,1,0
54718,445,0,0,69,69,0,1,0,1,0
62716,445,0,0,68,68,0,1,0,1,0
55984,445,0,0,68,68,0,1,0,1,0
53146,445,0,0,70,70,0,1,0,1,0
55713,445,0,0,68,68,0,1,0,1,0
57314,445,0,0,70,70,0,1,0,1,0
58687,445,0,0,66,66,0,1,0,1,0
51082,445,0,0,66,66,0,1,0,1,0
55251,445,0,0,70,70,0,1,0,1,0
49510,445,0,0,70,70,0,1,0,1,0
51167,445,0,0,70,70,0,1,0,1,0
62915,445,0,0,70,70,0,1,0,1,0
58312,445,0,0,66,66,0,1,0,1,0
51068,445,0,0,70,70,0,1,0,1,0
62807,445,0,0,70,70,0,1,0,1,0
61903,445,0,0,68,68,0,1,0,1,0
51211,445,0,0,68,68,0,1,0,1,0
61140,445,0,0,70,70,0,1,0,1,0
53705,445,0,0,70,70,0,1,0,1,0
51071,445,0,0,70,70,0,1,0,1,0
55253,445,0,0,70,70,0,1,0,1,0
55609,445,0,0,66,66,0,1,0,1,0
59581,445,0,0,70,70,0,1,0,1,0
59156,445,0,0,70,70,0,1,0,1,0
50977,445,0,0,66,66,0,1,0,1,0
53645,445,0,0,68,68,0,1,0,1,0
50047,445,0,0,67,67,0,1,0,1,0
51882,445,0,0,66,66,0,1,0,1,0
59866,445,0,0,70,70,0,1,0,1,0
57450,445,0,0,70,70,0,1,0,1,0
56651,445,0,0,68,68,0,1,0,1,0
57377,445,0,0,69,69,0,1,0,1,0
54429,445,0,0,67,67,0,1,0,1,0
53267,445,0,0,67,67,0,1,0,1,0
56773,445,0,0,70,70,0,1,0,1,0
59956,445,0,0,70,70,0,1,0,1,0
57928,445,0,0,70,70,0,1,0,1,0
50370,445,0,0,66,66,0,1,0,1,0
56660,445,0,0,70,70,0,1,0,1,0
59916,445,0,0,66,66,0,1,0,1,0
50987,445,0,0,70,70,0,1,0,1,0
51736,445,0,0,70,70,0,1,0,1,0
53507,445,0,0,69,69,0,1,0,1,0
54783,445,0,0,70,70,0,1,0,1,0
53229,445,0,0,70,70,0,1,0,1,0
64605,445,0,0,67,67,0,1,0,1,0
62443,445,0,0,70,70,0,1,0,1,0
63405,445,0,0,70,70,0,1,0,1,0
55954,445,0,0,66,66,0,1,0,1,0
62855,445,0,0,66,66,0,1,0,1,0
58495,445,0,0,69,69,0,1,0,1,0
56316,445,0,0,70,70,0,1,0,1,0
51454,445,0,0,70,70,0,1,0,1,0
60084,445,0,0,67,67,0,1,0,1,0
63386,445,0,0,70,70,0,1,0,1,0
55233,445,0,0,70,70,0,1,0,1,0
59403,445,0,0,66,66,0,1,0,1,0
57683,445,0,0,69,69,0,1,0,1,0
50254,445,0,0,70,70,0,1,0,1,0
55915,445,0,0,70,70,0,1,0,1,0
54388,445,0,0,70,70,0,1,0,1,0
53104,445,0,0,70,70,0,1,0,1,0
60526,445,0,0,69,69,0,1,0,1,0
53461,445,0,0,70,70,0,1,0,1,0
57494,445,0,0,70,70,0,1,0,1,0
63321,445,0,0,70,70,0,1,0,1,0
59722,445,0,0,66,66,0,1,0,1,0
61235,445,0,0,67,67,0,1,0,1,0
60868,445,0,0,70,70,0,1,0,1,0
56172,445,0,0,67,67,0,1,0,1,0
60085,445,0,0,70,70,0,1,0,1,0
57197,445,0,0,70,70,0,1,0,1,0
56130,445,0,0,66,66,0,1,0,1,0
63173,445,0,0,70,70,0,1,0,1,0
59735,445,0,0,70,70,0,1,0,1,0
61235,445,0,0,66,66,0,1,0,1,0
60700,445,0,0,68,68,0,1,0,1,0
61791,445,0,0,69,69,0,1,0,1,0
62154,445,0,0,66,66,0,1,0,1,0
63112,445,0,0,70,70,0,1,0,1,0
62876,445,0,0,66,66,0,1,0,1,0
62035,445,0,0,70,70,0,1,0,1,0
59937,445,0,0,68,68,0,1,0,1,0
53876,445,0,0,70,70,0,1,0,1,0
55211,445,0,0,66,66,0,1,0,1,0
50791,445,0,0,66,66,0,1,0,1,0
61583,445,0,0,70,70,0,1,0,1,0
55954,445,0,0,66,66,0,1,0,1,0
60241,445,0,0,70,70,0,1,0,1,0
55707,445,0,0,70,70,0,1,0,1,0
52108,445,0,0,66,66,0,1,0,1,0
60091,445,0,0,70,70,0,1,0,1,0
55462,445,0,0,70,70,0,1,0,1,0
52976,445,0,0,70,70,0,1,0,1,0
60174,445,0,0,66,66,0,1,0,1,0
58134,445,0,0,66,66,0,1,0,1,0
61912,445,0,0,66,66,0,1,0,1,0
50909,445,0,0,70,70,0,1,0,1,0
62033,445,0,0,67,67,0,1,0,1,0
50080,445,0,0,67,67,0,1,0,1,0
58517,445,0,0,68,68,0,1,0,1,0
50998,445,0,0,70,70,0,1,0,1,0
50272,445,0,0,70,70,0,1,0,1,0
51357,445,0,0,70,70,0,1,0,1,0
53645,445,0,0,68,68,0,1,0,1,0
49782,445,0,0,70,70,0,1,0,1,0
56167,445,0,0,70,70,0,1,0,1,0
55100,445,0,0,70,70,0,1,0,1,0
63465,445,0,0,70,70,0,1,0,1,0
64366,445,0,0,66,66,0,1,0,1,0
61318,445,0,0,68,68,0,1,0,1,0
55388,445,0,0,70,70,0,1,0,1,0
57070,445,0,0,69,69,0,1,0,1,0
61554,445,0,0,70,70,0,1,0,1,0
62526,445,0,0,67,67,0,1,0,1,0
59019,445,0,0,70,70,0,1,0,1,0
62724,445,0,0,70,70,0,1,0,1,0
51624,445,0,0,66,66,0,1,0,1,0
52291,445,0,0,70,70,0,1,0,1,0
50369,445,0,0,66,66,0,1,0,1,0
55109,445,0,0,70,70,0,1,0,1,0
49269,445,0,0,68,68,0,1,0,1,0
60213,445,0,0,70,70,0,1,0,1,0
60740,445,0,0,70,70,0,1,0,1,0
61758,445,0,0,70,70,0,1,0,1,0
50379,445,0,0,70,70,0,1,0,1,0
52083,445,0,0,66,66,0,1,0,1,0
62082,445,0,0,70,70,0,1,0,1,0
52013,445,0,0,70,70,0,1,0,1,0
63178,445,0,0,68,68,0,1,0,1,0
50512,445,0,0,70,70,0,1,0,1,0
59769,445,0,0,70,70,0,1,0,1,0
57858,445,0,0,70,70,0,1,0,1,0
61857,445,0,0,70,70,0,1,0,1,0
49566,445,0,0,66,66,0,1,0,1,0
63339,445,0,0,68,68,0,1,0,1,0
59120,445,0,0,70,70,0,1,0,1,0
59396,445,0,0,70,70,0,1,0,1,0
61117,445,0,0,66,66,0,1,0,1,0
50405,445,0,0,70,70,0,1,0,1,0
58152,445,0,0,68,68,0,1,0,1,0
56586,445,0,0,70,70,0,1,0,1,0
62127,445,0,0,70,70,0,1,0,1,0
53587,445,0,0,70,70,0,1,0,1,0
50859,445,0,0,69,69,0,1,0,1,0
55039,445,0,0,70,70,0,1,0,1,0
62472,445,0,0,68,68,0,1,0,1,0
49936,445,0,0,70,70,0,1,0,1,0
51560,445,0,0,70,70,0,1,0,1,0
61141,445,0,0,70,70,0,1,0,1,0
62634,445,0,0,70,70,0,1,0,1,0
64669,445,0,0,70,70,0,1,0,1,0
52923,445,0,0,66,66,0,1,0,1,0
52474,445,0,0,70,70,0,1,0,1,0
60374,445,0,0,70,70,0,1,0,1,0
52346,445,0,0,66,66,0,1,0,1,0
55001,445,0,0,70,70,0,1,0,1,0
63545,445,0,0,66,66,0,1,0,1,0
59275,445,0,0,67,67,0,1,0,1,0
55694,445,0,0,70,70,0,1,0,1,0
51337,445,0,0,70,70,0,1,0,1,0
57925,445,0,0,66,66,0,1,0,1,0
62107,445,0,0,70,70,0,1,0,1,0
55733,445,0,0,66,66,0,1,0,1,0
54774,445,0,0,70,70,0,1,0,1,0
62339,445,0,0,70,70,0,1,0,1,0
55567,445,0,0,70,70,0,1,0,1,0
57944,445,0,0,69,69,0,1,0,1,0
63423,445,0,0,70,70,0,1,0,1,0
62245,445,0,0,70,70,0,1,0,1,0
62044,445,0,0,66,66,0,1,0,1,0
59146,445,0,0,69,69,0,1,0,1,0
58021,445,0,0,70,70,0,1,0,1,0
62125,445,0,0,66,66,0,1,0,1,0
59715,445,0,0,67,67,0,1,0,1,0
64792,445,0,0,66,66,0,1,0,1,0
55427,445,0,0,70,70,0,1,0,1,0
63345,445,0,0,69,69,0,1,0,1,0
61228,445,0,0,68,68,0,1,0,1,0
51782,445,0,0,70,70,0,1,0,1,0
64681,445,0,0,66,66,0,1,0,1,0
51179,445,0,0,70,70,0,1,0,1,0
52596,445,0,0,66,66,0,1,0,1,0
53704,445,0,0,66,66,0,1,0,1,0
65463,445,0,0,69,69,0,1,0,1,0
55460,445,0,0,70,70,0,1,0,1,0
49770,445,0,0,70,70,0,1,0,1,0
55012,445,0,0,69,69,0,1,0,1,0
55310,445,0,0,67,67,0,1,0,1,0
49868,445,0,0,70,70,0,1,0,1,0
50798,445,0,0,66,66,0,1,0,1,0
50612,445,0,0,70,70,0,1,0,1,0
50648,445,0,0,70,70,0,1,0,1,0
62171,445,0,0,70,70,0,1,0,1,0
52445,445,0,0,70,70,0,1,0,1,0
65514,445,0,0,70,70,0,1,0,1,0
61388,445,0,0,66,66,0,1,0,1,0
58447,445,0,0,70,70,0,1,0,1,0
58447,445,0,0,70,70,0,1,0,1,0
64208,445,0,0,70,70,0,1,0,1,0
52794,445,0,0,66,66,0,1,0,1,0
50467,445,0,0,66,66,0,1,0,1,0
65058,445,0,0,70,70,0,1,0,1,0
60097,445,0,0,66,66,0,1,0,1,0
52019,445,0,0,69,69,0,1,0,1,0
53268,445,0,0,68,68,0,1,0,1,0
50764,445,0,0,70,70,0,1,0,1,0
57240,445,0,0,70,70,0,1,0,1,0
64841,445,0,0,70,70,0,1,0,1,0
64898,445,0,0,70,70,0,1,0,1,0
55531,445,0,0,70,70,0,1,0,1,0
54654,445,0,0,68,68,0,1,0,1,0
52087,445,0,0,66,66,0,1,0,1,0
52762,445,0,0,70,70,0,1,0,1,0
56406,445,0,0,70,70,0,1,0,1,0
52819,445,0,0,70,70,0,1,0,1,0
63846,445,0,0,66,66,0,1,0,1,0
53481,445,0,0,70,70,0,1,0,1,0
59114,445,0,0,70,70,0,1,0,1,0
52019,445,0,0,70,70,0,1,0,1,0
62037,445,0,0,66,66,0,1,0,1,0
51619,445,0,0,70,70,0,1,0,1,0
49524,445,0,0,69,69,0,1,0,1,0
65440,445,0,0,69,69,0,1,0,1,0
56831,445,0,0,70,70,0,1,0,1,0
63076,445,0,0,68,68,0,1,0,1,0
64339,445,0,0,69,69,0,1,0,1,0
61981,445,0,0,66,66,0,1,0,1,0
63510,445,0,0,69,69,0,1,0,1,0
60632,445,0,0,70,70,0,1,0,1,0
65369,445,0,0,67,67,0,1,0,1,0
62535,445,0,0,70,70,0,1,0,1,0
52273,445,0,0,66,66,0,1,0,1,0
56123,445,0,0,70,70,0,1,0,1,0
53494,445,0,0,66,66,0,1,0,1,0
53625,445,0,0,66,66,0,1,0,1,0
56186,445,0,0,70,70,0,1,0,1,0
58884,445,0,0,66,66,0,1,0,1,0
50834,445,0,0,70,70,0,1,0,1,0
57884,445,0,0,70,70,0,1,0,1,0
57144,445,0,0,66,66,0,1,0,1,0
54795,445,0,0,68,68,0,1,0,1,0
54855,445,0,0,66,66,0,1,0,1,0
55162,445,0,0,70,70,0,1,0,1,0
55269,445,0,0,70,70,0,1,0,1,0
65265,445,0,0,68,68,0,1,0,1,0
64708,445,0,0,70,70,0,1,0,1,0
61481,445,0,0,70,70,0,1,0,1,0
62895,445,0,0,70,70,0,1,0,1,0
54012,445,0,0,66,66,0,1,0,1,0
49887,445,0,0,70,70,0,1,0,1,0
59084,445,0,0,66,66,0,1,0,1,0
54701,445,0,0,66,66,0,1,0,1,0
63688,445,0,0,70,70,0,1,0,1,0
50878,445,0,0,70,70,0,1,0,1,0
63771,445,0,0,70,70,0,1,0,1,0
54364,445,0,0,70,70,0,1,0,1,0
63840,445,0,0,70,70,0,1,0,1,0
63305,445,0,0,69,69,0,1,0,1,0
51431,445,0,0,70,70,0,1,0,1,0
62276,445,0,0,70,70,0,1,0,1,0
51158,445,0,0,70,70,0,1,0,1,0
53978,445,0,0,70,70,0,1,0,1,0
61786,445,0,0,66,66,0,1,0,1,0
57038,445,0,0,70,70,0,1,0,1,0
53714,445,0,0,66,66,0,1,0,1,0
56834,445,0,0,70,70,0,1,0,1,0
51959,445,0,0,66,66,0,1,0,1,0
52436,445,0,0,70,70,0,1,0,1,0
51933,445,0,0,70,70,0,1,0,1,0
65188,445,0,0,70,70,0,1,0,1,0
59482,445,0,0,70,70,0,1,0,1,0
57870,445,0,0,66,66,0,1,0,1,0
65453,445,0,0,67,67,0,1,0,1,0
56440,445,0,0,70,70,0,1,0,1,0
53431,445,0,0,66,66,0,1,0,1,0
52149,445,0,0,69,69,0,1,0,1,0
51637,445,0,0,66,66,0,1,0,1,0
59827,445,0,0,70,70,0,1,0,1,0
61897,445,0,0,66,66,0,1,0,1,0
54790,445,0,0,70,70,0,1,0,1,0
57709,445,0,0,70,70,0,1,0,1,0
50223,445,0,0,70,70,0,1,0,1,0
51770,445,0,0,68,68,0,1,0,1,0
61141,445,0,0,66,66,0,1,0,1,0
58970,445,0,0,67,67,0,1,0,1,0
59144,445,0,0,66,66,0,1,0,1,0
64659,445,0,0,68,68,0,1,0,1,0
62067,445,0,0,70,70,0,1,0,1,0
51028,445,0,0,70,70,0,1,0,1,0
49776,445,0,0,66,66,0,1,0,1,0
63298,445,0,0,70,70,0,1,0,1,0
54005,445,0,0,70,70,0,1,0,1,0
63366,445,0,0,70,70,0,1,0,1,0
51104,445,0,0,68,68,0,1,0,1,0
55160,445,0,0,70,70,0,1,0,1,0
64193,445,0,0,69,69,0,1,0,1,0
59509,445,0,0,70,70,0,1,0,1,0
49371,445,0,0,70,70,0,1,0,1,0
53085,445,0,0,70,70,0,1,0,1,0
50646,445,0,0,70,70,0,1,0,1,0
54819,445,0,0,69,69,0,1,0,1,0
58923,445,0,0,68,68,0,1,0,1,0
61974,445,0,0,69,69,0,1,0,1,0
59285,445,0,0,70,70,0,1,0,1,0
49549,445,0,0,69,69,0,1,0,1,0
61270,445,0,0,70,70,0,1,0,1,0
49950,445,0,0,68,68,0,1,0,1,0
55355,445,0,0,66,66,0,1,0,1,0
58890,445,0,0,70,70,0,1,0,1,0
50618,445,0,0,70,70,0,1,0,1,0
57667,445,0,0,70,70,0,1,0,1,0
62133,445,0,0,67,67,0,1,0,1,0
55074,445,0,0,70,70,0,1,0,1,0
49718,445,0,0,66,66,0,1,0,1,0
55575,445,0,0,68,68,0,1,0,1,0
54249,445,0,0,70,70,0,1,0,1,0
60984,445,0,0,70,70,0,1,0,1,0
53962,445,0,0,70,70,0,1,0,1,0
64458,445,0,0,70,70,0,1,0,1,0
50866,445,0,0,70,70,0,1,0,1,0
62944,445,0,0,66,66,0,1,0,1,0
61471,445,0,0,70,70,0,1,0,1,0
51501,445,0,0,70,70,0,1,0,1,0
54151,445,0,0,70,70,0,1,0,1,0
57160,445,0,0,70,70,0,1,0,1,0
62101,445,0,0,66,66,0,1,0,1,0
56662,445,0,0,68,68,0,1,0,1,0
58929,445,0,0,70,70,0,1,0,1,0
64780,445,0,0,70,70,0,1,0,1,0
52220,445,0,0,68,68,0,1,0,1,0
61044,445,0,0,70,70,0,1,0,1,0
63004,445,0,0,66,66,0,1,0,1,0
62778,445,0,0,69,69,0,1,0,1,0
56639,445,0,0,70,70,0,1,0,1,0
59143,445,0,0,70,70,0,1,0,1,0
61863,445,0,0,70,70,0,1,0,1,0
53566,445,0,0,66,66,0,1,0,1,0
50179,445,0,0,70,70,0,1,0,1,0
56835,445,0,0,70,70,0,1,0,1,0
51302,445,0,0,70,70,0,1,0,1,0
60746,445,0,0,66,66,0,1,0,1,0
51230,445,0,0,66,66,0,1,0,1,0
51622,445,0,0,66,66,0,1,0,1,0
51967,445,0,0,70,70,0,1,0,1,0
62465,445,0,0,70,70,0,1,0,1,0
60658,445,0,0,70,70,0,1,0,1,0
52501,445,0,0,66,66,0,1,0,1,0
58626,445,0,0,70,70,0,1,0,1,0
62630,445,0,0,68,68,0,1,0,1,0
49442,445,0,0,66,66,0,1,0,1,0
52026,445,0,0,66,66,0,1,0,1,0
63070,445,0,0,66,66,0,1,0,1,0
51624,445,0,0,67,67,0,1,0,1,0
58842,445,0,0,66,66,0,1,0,1,0
54898,445,0,0,70,70,0,1,0,1,0
53334,445,0,0,70,70,0,1,0,1,0
56086,445,0,0,66,66,0,1,0,1,0
53682,445,0,0,66,66,0,1,0,1,0
49298,445,0,0,70,70,0,1,0,1,0
55440,445,0,0,70,70,0,1,0,1,0
55036,445,0,0,66,66,0,1,0,1,0
64297,445,0,0,70,70,0,1,0,1,0
59049,445,0,0,70,70,0,1,0,1,0
51082,445,0,0,70,70,0,1,0,1,0
50645,445,0,0,70,70,0,1,0,1,0
50321,445,0,0,70,70,0,1,0,1,0
55003,445,0,0,70,70,0,1,0,1,0
55734,445,0,0,69,69,0,1,0,1,0
54255,445,0,0,70,70,0,1,0,1,0
61067,445,0,0,70,70,0,1,0,1,0
50067,445,0,0,67,67,0,1,0,1,0
53963,445,0,0,68,68,0,1,0,1,0
53304,445,0,0,70,70,0,1,0,1,0
50007,445,0,0,68,68,0,1,0,1,0
57492,445,0,0,70,70,0,1,0,1,0
50997,445,0,0,69,69,0,1,0,1,0
62026,445,0,0,66,66,0,1,0,1,0
50562,445,0,0,66,66,0,1,0,1,0
56047,445,0,0,66,66,0,1,0,1,0
56454,445,0,0,68,68,0,1,0,1,0
63192,445,0,0,66,66,0,1,0,1,0
51363,445,0,0,69,69,0,1,0,1,0
59930,445,0,0,69,69,0,1,0,1,0
52019,445,0,0,70,70,0,1,0,1,0
55068,445,0,0,70,70,0,1,0,1,0
58240,445,0,0,70,70,0,1,0,1,0
50041,445,0,0,66,66,0,1,0,1,0
61402,445,0,0,66,66,0,1,0,1,0
51101,445,0,0,66,66,0,1,0,1,0
55833,445,0,0,70,70,0,1,0,1,0
60405,445,0,0,66,66,0,1,0,1,0
65450,445,0,0,66,66,0,1,0,1,0
64539,445,0,0,69,69,0,1,0,1,0
50141,445,0,0,70,70,0,1,0,1,0
61246,445,0,0,67,67,0,1,0,1,0
58060,445,0,0,70,70,0,1,0,1,0
57318,445,0,0,70,70,0,1,0,1,0
59228,445,0,0,70,70,0,1,0,1,0
54009,445,0,0,66,66,0,1,0,1,0
65211,445,0,0,70,70,0,1,0,1,0
63178,445,0,0,66,66,0,1,0,1,0
51184,445,0,0,66,66,0,1,0,1,0
59970,445,0,0,70,70,0,1,0,1,0
56428,445,0,0,70,70,0,1,0,1,0
56388,445,0,0,70,70,0,1,0,1,0
54836,445,0,0,69,69,0,1,0,1,0
49913,445,0,0,70,70,0,1,0,1,0
65326,445,0,0,66,66,0,1,0,1,0
58612,445,0,0,66,66,0,1,0,1,0
52011,445,0,0,68,68,0,1,0,1,0
55567,445,0,0,70,70,0,1,0,1,0
59664,445,0,0,66,66,0,1,0,1,0
63318,445,0,0,66,66,0,1,0,1,0
54990,445,0,0,70,70,0,1,0,1,0
52011,445,0,0,66,66,0,1,0,1,0
61332,445,0,0,70,70,0,1,0,1,0
52641,445,0,0,70,70,0,1,0,1,0
57772,445,0,0,70,70,0,1,0,1,0
57508,445,0,0,70,70,0,1,0,1,0
54956,445,0,0,66,66,0,1,0,1,0
57093,445,0,0,70,70,0,1,0,1,0
61569,445,0,0,70,70,0,1,0,1,0
49805,445,0,0,70,70,0,1,0,1,0
62176,445,0,0,68,68,0,1,0,1,0
62581,445,0,0,70,70,0,1,0,1,0
63791,445,0,0,70,70,0,1,0,1,0
58135,445,0,0,66,66,0,1,0,1,0
55003,445,0,0,70,70,0,1,0,1,0
63035,445,0,0,70,70,0,1,0,1,0
54385,445,0,0,70,70,0,1,0,1,0
49443,445,0,0,70,70,0,1,0,1,0
50227,445,0,0,70,70,0,1,0,1,0
50830,445,0,0,70,70,0,1,0,1,0
50346,445,0,0,66,66,0,1,0,1,0
61589,445,0,0,70,70,0,1,0,1,0
64282,445,0,0,70,70,0,1,0,1,0
62076,445,0,0,66,66,0,1,0,1,0
50969,445,0,0,70,70,0,1,0,1,0
62299,445,0,0,70,70,0,1,0,1,0
57479,445,0,0,66,66,0,1,0,1,0
51359,445,0,0,69,69,0,1,0,1,0
59244,445,0,0,68,68,0,1,0,1,0
57124,445,0,0,70,70,0,1,0,1,0
60662,445,0,0,70,70,0,1,0,1,0
53221,445,0,0,67,67,0,1,0,1,0
49832,445,0,0,70,70,0,1,0,1,0
60047,445,0,0,70,70,0,1,0,1,0
52878,445,0,0,66,66,0,1,0,1,0
57250,445,0,0,70,70,0,1,0,1,0
50642,445,0,0,70,70,0,1,0,1,0
54063,445,0,0,70,70,0,1,0,1,0
55409,445,0,0,70,70,0,1,0,1,0
61403,445,0,0,70,70,0,1,0,1,0
65058,445,0,0,70,70,0,1,0,1,0
54716,445,0,0,70,70,0,1,0,1,0
50198,445,0,0,69,69,0,1,0,1,0
56784,445,0,0,67,67,0,1,0,1,0
54271,445,0,0,70,70,0,1,0,1,0
57925,445,0,0,66,66,0,1,0,1,0
52639,445,0,0,68,68,0,1,0,1,0
51451,445,0,0,70,70,0,1,0,1,0
59769,445,0,0,70,70,0,1,0,1,0
61545,445,0,0,67,67,0,1,0,1,0
49365,445,0,0,70,70,0,1,0,1,0
55160,445,0,0,70,70,0,1,0,1,0
60337,445,0,0,70,70,0,1,0,1,0
53921,445,0,0,70,70,0,1,0,1,0
61623,445,0,0,70,70,0,1,0,1,0
52345,445,0,0,66,66,0,1,0,1,0
54306,445,0,0,70,70,0,1,0,1,0
49230,445,0,0,70,70,0,1,0,1,0
58084,445,0,0,68,68,0,1,0,1,0
50785,445,0,0,70,70,0,1,0,1,0
61624,445,0,0,70,70,0,1,0,1,0
56646,445,0,0,66,66,0,1,0,1,0
50449,445,0,0,70,70,0,1,0,1,0
64919,445,0,0,66,66,0,1,0,1,0
61850,445,0,0,66,66,0,1,0,1,0
58737,445,0,0,66,66,0,1,0,1,0
65232,445,0,0,67,67,0,1,0,1,0
49726,445,0,0,66,66,0,1,0,1,0
64392,445,0,0,70,70,0,1,0,1,0
53716,445,0,0,70,70,0,1,0,1,0
61874,445,0,0,70,70,0,1,0,1,0
65077,445,0,0,70,70,0,1,0,1,0
63039,445,0,0,70,70,0,1,0,1,0
62010,445,0,0,70,70,0,1,0,1,0
52918,445,0,0,68,68,0,1,0,1,0
51068,445,0,0,70,70,0,1,0,1,0
55037,445,0,0,70,70,0,1,0,1,0
56131,445,0,0,70,70,0,1,0,1,0
63349,445,0,0,70,70,0,1,0,1,0
53803,445,0,0,66,66,0,1,0,1,0
63329,445,0,0,66,66,0,1,0,1,0
51742,445,0,0,70,70,0,1,0,1,0
53684,445,0,0,66,66,0,1,0,1,0
52406,445,0,0,70,70,0,1,0,1,0
52711,445,0,0,67,67,0,1,0,1,0
54633,445,0,0,69,69,0,1,0,1,0
63328,445,0,0,67,67,0,1,0,1,0
63022,445,0,0,70,70,0,1,0,1,0
54700,445,0,0,70,70,0,1,0,1,0
54050,445,0,0,70,70,0,1,0,1,0
61016,445,0,0,70,70,0,1,0,1,0
61590,445,0,0,66,66,0,1,0,1,0
53843,445,0,0,68,68,0,1,0,1,0
50879,445,0,0,66,66,0,1,0,1,0
51884,445,0,0,70,70,0,1,0,1,0
54627,445,0,0,70,70,0,1,0,1,0
56046,445,0,0,66,66,0,1,0,1,0
51783,445,0,0,66,66,0,1,0,1,0
64454,445,0,0,70,70,0,1,0,1,0
54663,445,0,0,70,70,0,1,0,1,0
54175,445,0,0,67,67,0,1,0,1,0
63184,445,0,0,67,67,0,1,0,1,0
62689,445,0,0,69,69,0,1,0,1,0
51041,445,0,0,70,70,0,1,0,1,0
51767,445,0,0,68,68,0,1,0,1,0
50042,445,0,0,70,70,0,1,0,1,0
52248,445,0,0,70,70,0,1,0,1,0
61699,445,0,0,68,68,0,1,0,1,0
52534,445,0,0,69,69,0,1,0,1,0
59969,445,0,0,66,66,0,1,0,1,0
56682,445,0,0,70,70,0,1,0,1,0
64721,445,0,0,70,70,0,1,0,1,0
53675,445,0,0,70,70,0,1,0,1,0
59057,445,0,0,70,70,0,1,0,1,0
52935,445,0,0,70,70,0,1,0,1,0
58368,445,0,0,70,70,0,1,0,1,0
55665,445,0,0,70,70,0,1,0,1,0
51075,445,0,0,70,70,0,1,0,1,0
57274,445,0,0,66,66,0,1,0,1,0
61506,445,0,0,70,70,0,1,0,1,0
56059,445,0,0,70,70,0,1,0,1,0
50139,445,0,0,70,70,0,1,0,1,0
50132,445,0,0,70,70,0,1,0,1,0
60513,445,0,0,70,70,0,1,0,1,0
64553,445,0,0,66,66,0,1,0,1,0
59570,445,0,0,70,70,0,1,0,1,0
56640,445,0,0,70,70,0,1,0,1,0
51858,445,0,0,70,70,0,1,0,1,0
55204,445,0,0,70,70,0,1,0,1,0
61111,445,0,0,70,70,0,1,0,1,0
63336,445,0,0,70,70,0,1,0,1,0
50528,445,0,0,70,70,0,1,0,1,0
64780,445,0,0,70,70,0,1,0,1,0
60742,445,0,0,67,67,0,1,0,1,0
63027,445,0,0,68,68,0,1,0,1,0
60083,445,0,0,70,70,0,1,0,1,0
57986,445,0,0,70,70,0,1,0,1,0
52603,445,0,0,66,66,0,1,0,1,0
58949,445,0,0,66,66,0,1,0,1,0
50356,445,0,0,66,66,0,1,0,1,0
50904,445,0,0,70,70,0,1,0,1,0
64671,445,0,0,70,70,0,1,0,1,0
61718,445,0,0,70,70,0,1,0,1,0
56940,445,0,0,70,70,0,1,0,1,0
63131,445,0,0,67,67,0,1,0,1,0
53726,445,0,0,70,70,0,1,0,1,0
63388,445,0,0,70,70,0,1,0,1,0
60834,445,0,0,70,70,0,1,0,1,0
61791,445,0,0,68,68,0,1,0,1,0
61334,445,0,0,66,66,0,1,0,1,0
52186,445,0,0,70,70,0,1,0,1,0
57686,445,0,0,66,66,0,1,0,1,0
55838,445,0,0,70,70,0,1,0,1,0
60373,445,0,0,70,70,0,1,0,1,0
61059,445,0,0,70,70,0,1,0,1,0
63143,445,0,0,68,68,0,1,0,1,0
49813,445,0,0,70,70,0,1,0,1,0
63340,445,0,0,70,70,0,1,0,1,0
61342,445,0,0,70,70,0,1,0,1,0
49777,445,0,0,66,66,0,1,0,1,0
63880,445,0,0,70,70,0,1,0,1,0
53930,445,0,0,70,70,0,1,0,1,0
51812,445,0,0,69,69,0,1,0,1,0
64332,445,0,0,70,70,0,1,0,1,0
62644,445,0,0,70,70,0,1,0,1,0
61932,445,0,0,69,69,0,1,0,1,0
60963,445,0,0,70,70,0,1,0,1,0
49300,445,0,0,70,70,0,1,0,1,0
58568,445,0,0,68,68,0,1,0,1,0
54718,445,0,0,70,70,0,1,0,1,0
56585,445,0,0,70,70,0,1,0,1,0
60632,445,0,0,70,70,0,1,0,1,0
60886,445,0,0,67,67,0,1,0,1,0
55682,445,0,0,68,68,0,1,0,1,0
59396,445,0,0,70,70,0,1,0,1,0
58420,445,0,0,69,69,0,1,0,1,0
56784,445,0,0,69,69,0,1,0,1,0
63905,445,0,0,66,66,0,1,0,1,0
57444,445,0,0,70,70,0,1,0,1,0
58214,445,0,0,70,70,0,1,0,1,0
56504,445,0,0,69,69,0,1,0,1,0
50656,445,0,0,66,66,0,1,0,1,0
58596,445,0,0,70,70,0,1,0,1,0
55488,445,0,0,70,70,0,1,0,1,0
56077,445,0,0,70,70,0,1,0,1,0
60112,445,0,0,67,67,0,1,0,1,0
57303,445,0,0,70,70,0,1,0,1,0
53634,445,0,0,70,70,0,1,0,1,0
64604,445,0,0,67,67,0,1,0,1,0
52858,445,0,0,70,70,0,1,0,1,0
56763,445,0,0,69,69,0,1,0,1,0
50123,445,0,0,70,70,0,1,0,1,0
50468,445,0,0,66,66,0,1,0,1,0
64610,445,0,0,70,70,0,1,0,1,0
56252,445,0,0,66,66,0,1,0,1,0
50941,445,0,0,70,70,0,1,0,1,0
56800,445,0,0,70,70,0,1,0,1,0
63598,445,0,0,66,66,0,1,0,1,0
50946,445,0,0,70,70,0,1,0,1,0
58504,445,0,0,66,66,0,1,0,1,0
53569,445,0,0,70,70,0,1,0,1,0
55621,445,0,0,70,70,0,1,0,1,0
55997,445,0,0,67,67,0,1,0,1,0
52083,445,0,0,68,68,0,1,0,1,0
63455,445,0,0,67,67,0,1,0,1,0
64986,445,0,0,70,70,0,1,0,1,0
62442,445,0,0,67,67,0,1,0,1,0
60175,445,0,0,70,70,0,1,0,1,0
50484,445,0,0,66,66,0,1,0,1,0
64468,445,0,0,70,70,0,1,0,1,0
64679,445,0,0,66,66,0,1,0,1,0
61589,445,0,0,67,67,0,1,0,1,0
64389,445,0,0,70,70,0,1,0,1,0
63488,445,0,0,70,70,0,1,0,1,0
58692,445,0,0,66,66,0,1,0,1,0
55748,445,0,0,66,66,0,1,0,1,0
56467,445,0,0,70,70,0,1,0,1,0
54419,445,0,0,70,70,0,1,0,1,0
55746,445,0,0,70,70,0,1,0,1,0
62793,445,0,0,66,66,0,1,0,1,0
52790,445,0,0,70,70,0,1,0,1,0
54398,445,0,0,70,70,0,1,0,1,0
62618,445,0,0,66,66,0,1,0,1,0
51289,445,0,0,70,70,0,1,0,1,0
56656,445,0,0,69,69,0,1,0,1,0
51416,445,0,0,70,70,0,1,0,1,0
59218,445,0,0,70,70,0,1,0,1,0
49523,445,0,0,70,70,0,1,0,1,0
54313,445,0,0,66,66,0,1,0,1,0
55192,445,0,0,70,70,0,1,0,1,0
58025,445,0,0,70,70,0,1,0,1,0
51265,445,0,0,70,70,0,1,0,1,0
56812,445,0,0,70,70,0,1,0,1,0
64908,445,0,0,66,66,0,1,0,1,0
65455,445,0,0,70,70,0,1,0,1,0
52329,445,0,0,68,68,0,1,0,1,0
58646,445,0,0,67,67,0,1,0,1,0
56835,445,0,0,66,66,0,1,0,1,0
58202,445,0,0,70,70,0,1,0,1,0
54505,445,0,0,66,66,0,1,0,1,0
55855,445,0,0,70,70,0,1,0,1,0
53912,445,0,0,70,70,0,1,0,1,0
54734,445,0,0,70,70,0,1,0,1,0
51235,445,0,0,69,69,0,1,0,1,0
62105,445,0,0,66,66,0,1,0,1,0
51295,445,0,0,66,66,0,1,0,1,0
57820,445,0,0,66,66,0,1,0,1,0
63742,445,0,0,70,70,0,1,0,1,0
60096,445,0,0,66,66,0,1,0,1,0
54178,445,0,0,70,70,0,1,0,1,0
59784,445,0,0,70,70,0,1,0,1,0
50421,445,0,0,70,70,0,1,0,1,0
56359,445,0,0,70,70,0,1,0,1,0
61810,445,0,0,70,70,0,1,0,1,0
50874,445,0,0,70,70,0,1,0,1,0
49795,445,0,0,70,70,0,1,0,1,0
64411,445,0,0,70,70,0,1,0,1,0
49834,445,0,0,70,70,0,1,0,1,0
52772,445,0,0,69,69,0,1,0,1,0
58997,445,0,0,69,69,0,1,0,1,0
58986,445,0,0,67,67,0,1,0,1,0
62876,445,0,0,66,66,0,1,0,1,0
63328,445,0,0,69,69,0,1,0,1,0
55059,445,0,0,69,69,0,1,0,1,0
50593,445,0,0,70,70,0,1,0,1,0
50150,445,0,0,70,70,0,1,0,1,0
50929,445,0,0,66,66,0,1,0,1,0
55665,445,0,0,70,70,0,1,0,1,0
59465,445,0,0,68,68,0,1,0,1,0
62492,445,0,0,66,66,0,1,0,1,0
52496,445,0,0,70,70,0,1,0,1,0
50656,445,0,0,70,70,0,1,0,1,0
62132,445,0,0,66,66,0,1,0,1,0
53498,445,0,0,66,66,0,1,0,1,0
59874,445,0,0,70,70,0,1,0,1,0
51932,445,0,0,70,70,0,1,0,1,0
49321,445,0,0,70,70,0,1,0,1,0
59916,445,0,0,66,66,0,1,0,1,0
59771,445,0,0,68,68,0,1,0,1,0
50209,445,0,0,67,67,0,1,0,1,0
51397,445,0,0,66,66,0,1,0,1,0
56059,445,0,0,70,70,0,1,0,1,0
60141,445,0,0,70,70,0,1,0,1,0
63839,445,0,0,70,70,0,1,0,1,0
57526,445,0,0,70,70,0,1,0,1,0
54531,445,0,0,70,70,0,1,0,1,0
49991,445,0,0,70,70,0,1,0,1,0
63943,445,0,0,67,67,0,1,0,1,0
62972,445,0,0,68,68,0,1,0,1,0
57074,445,0,0,66,66,0,1,0,1,0
53415,445,0,0,70,70,0,1,0,1,0
61877,445,0,0,66,66,0,1,0,1,0
62294,445,0,0,69,69,0,1,0,1,0
63127,445,0,0,66,66,0,1,0,1,0
52348,445,0,0,70,70,0,1,0,1,0
55031,445,0,0,66,66,0,1,0,1,0
57200,445,0,0,67,67,0,1,0,1,0
60866,445,0,0,70,70,0,1,0,1,0
53804,445,0,0,68,68,0,1,0,1,0
49922,445,0,0,70,70,0,1,0,1,0
60280,445,0,0,69,69,0,1,0,1,0
55442,445,0,0,70,70,0,1,0,1,0
65339,445,0,0,70,70,0,1,0,1,0
56839,445,0,0,66,66,0,1,0,1,0
55645,445,0,0,70,70,0,1,0,1,0
51685,445,0,0,70,70,0,1,0,1,0
58631,445,0,0,70,70,0,1,0,1,0
53614,445,0,0,70,70,0,1,0,1,0
60998,445,0,0,70,70,0,1,0,1,0
52525,445,0,0,70,70,0,1,0,1,0
49488,445,0,0,67,67,0,1,0,1,0
50855,445,0,0,66,66,0,1,0,1,0
54502,445,0,0,66,66,0,1,0,1,0
62156,445,0,0,70,70,0,1,0,1,0
64483,445,0,0,70,70,0,1,0,1,0
50298,445,0,0,70,70,0,1,0,1,0
54593,445,0,0,70,70,0,1,0,1,0
60851,445,0,0,70,70,0,1,0,1,0
65060,445,0,0,70,70,0,1,0,1,0
53940,445,0,0,66,66,0,1,0,1,0
53156,445,0,0,70,70,0,1,0,1,0
50033,445,0,0,66,66,0,1,0,1,0
56357,445,0,0,70,70,0,1,0,1,0
55145,445,0,0,69,69,0,1,0,1,0
62174,445,0,0,70,70,0,1,0,1,0
58993,445,0,0,67,67,0,1,0,1,0
63183,445,0,0,68,68,0,1,0,1,0
54261,445,0,0,66,66,0,1,0,1,0
65002,445,0,0,68,68,0,1,0,1,0
60900,445,0,0,66,66,0,1,0,1,0
55457,445,0,0,70,70,0,1,0,1,0
62173,445,0,0,70,70,0,1,0,1,0
56255,445,0,0,66,66,0,1,0,1,0
51099,445,0,0,67,67,0,1,0,1,0
57428,445,0,0,70,70,0,1,0,1,0
59651,445,0,0,70,70,0,1,0,1,0
52083,445,0,0,66,66,0,1,0,1,0
62102,445,0,0,66,66,0,1,0,1,0
60276,445,0,0,69,69,0,1,0,1,0
57862,445,0,0,66,66,0,1,0,1,0
50644,445,0,0,70,70,0,1,0,1,0
57070,445,0,0,69,69,0,1,0,1,0
60313,445,0,0,70,70,0,1,0,1,0
52461,445,0,0,70,70,0,1,0,1,0
55884,445,0,0,70,70,0,1,0,1,0
50025,445,0,0,70,70,0,1,0,1,0
57932,445,0,0,67,67,0,1,0,1,0
58017,445,0,0,70,70,0,1,0,1,0
54389,445,0,0,70,70,0,1,0,1,0
59018,445,0,0,66,66,0,1,0,1,0
50430,445,0,0,70,70,0,1,0,1,0
51502,445,0,0,66,66,0,1,0,1,0
61572,445,0,0,70,70,0,1,0,1,0
62742,445,0,0,66,66,0,1,0,1,0
52269,445,0,0,70,70,0,1,0,1,0
58531,445,0,0,70,70,0,1,0,1,0
49868,445,0,0,70,70,0,1,0,1,0
57514,445,0,0,70,70,0,1,0,1,0
57088,445,0,0,70,70,0,1,0,1,0
64498,445,0,0,66,66,0,1,0,1,0
62615,445,0,0,66,66,0,1,0,1,0
64286,445,0,0,70,70,0,1,0,1,0
59600,445,0,0,70,70,0,1,0,1,0
58787,445,0,0,70,70,0,1,0,1,0
56019,445,0,0,66,66,0,1,0,1,0
53916,445,0,0,69,69,0,1,0,1,0
62315,445,0,0,70,70,0,1,0,1,0
53618,445,0,0,70,70,0,1,0,1,0
64604,445,0,0,68,68,0,1,0,1,0
62488,445,0,0,66,66,0,1,0,1,0
57476,445,0,0,66,66,0,1,0,1,0
64837,445,0,0,68,68,0,1,0,1,0
64947,445,0,0,70,70,0,1,0,1,0
50502,445,0,0,68,68,0,1,0,1,0
62207,445,0,0,68,68,0,1,0,1,0
54949,445,0,0,70,70,0,1,0,1,0
58961,445,0,0,66,66,0,1,0,1,0
52415,445,0,0,70,70,0,1,0,1,0
61037,445,0,0,66,66,0,1,0,1,0
49325,445,0,0,70,70,0,1,0,1,0
55352,445,0,0,66,66,0,1,0,1,0
57729,445,0,0,70,70,0,1,0,1,0
56168,445,0,0,70,70,0,1,0,1,0
64115,445,0,0,70,70,0,1,0,1,0
51065,445,0,0,69,69,0,1,0,1,0
63520,445,0,0,70,70,0,1,0,1,0
56124,445,0,0,66,66,0,1,0,1,0
58371,445,0,0,66,66,0,1,0,1,0
55648,445,0,0,70,70,0,1,0,1,0
51616,445,0,0,70,70,0,1,0,1,0
55068,445,0,0,70,70,0,1,0,1,0
49560,445,0,0,70,70,0,1,0,1,0
62405,445,0,0,70,70,0,1,0,1,0
53723,445,0,0,70,70,0,1,0,1,0
56009,445,0,0,66,66,0,1,0,1,0
56637,445,0,0,70,70,0,1,0,1,0
64960,445,0,0,70,70,0,1,0,1,0
65372,445,0,0,70,70,0,1,0,1,0
61771,445,0,0,67,67,0,1,0,1,0
62359,445,0,0,70,70,0,1,0,1,0
55855,445,0,0,70,70,0,1,0,1,0
55597,445,0,0,70,70,0,1,0,1,0
58764,445,0,0,70,70,0,1,0,1,0
61073,445,0,0,70,70,0,1,0,1,0
61688,445,0,0,68,68,0,1,0,1,0
60374,445,0,0,70,70,0,1,0,1,0
63876,445,0,0,70,70,0,1,0,1,0
56473,445,0,0,70,70,0,1,0,1,0
53293,445,0,0,66,66,0,1,0,1,0
63789,445,0,0,70,70,0,1,0,1,0
57877,445,0,0,70,70,0,1,0,1,0
53302,445,0,0,70,70,0,1,0,1,0
50290,445,0,0,66,66,0,1,0,1,0
64907,445,0,0,66,66,0,1,0,1,0
60726,445,0,0,68,68,0,1,0,1,0
60373,445,0,0,70,70,0,1,0,1,0
64813,445,0,0,70,70,0,1,0,1,0
52174,445,0,0,68,68,0,1,0,1,0
53016,445,0,0,70,70,0,1,0,1,0
52742,445,0,0,66,66,0,1,0,1,0
61592,445,0,0,70,70,0,1,0,1,0
52091,445,0,0,66,66,0,1,0,1,0
57115,445,0,0,70,70,0,1,0,1,0
54794,445,0,0,68,68,0,1,0,1,0
58296,445,0,0,66,66,0,1,0,1,0
54826,445,0,0,67,67,0,1,0,1,0
54518,445,0,0,70,70,0,1,0,1,0
50749,445,0,0,66,66,0,1,0,1,0
61192,445,0,0,66,66,0,1,0,1,0
56993,445,0,0,70,70,0,1,0,1,0
50682,445,0,0,70,70,0,1,0,1,0
62491,445,0,0,70,70,0,1,0,1,0
60430,445,0,0,69,69,0,1,0,1,0
57754,445,0,0,70,70,0,1,0,1,0
59164,445,0,0,69,69,0,1,0,1,0
58682,445,0,0,66,66,0,1,0,1,0
62742,445,0,0,66,66,0,1,0,1,0
64864,445,0,0,70,70,0,1,0,1,0
52677,445,0,0,68,68,0,1,0,1,0
51587,445,0,0,68,68,0,1,0,1,0
49466,445,0,0,70,70,0,1,0,1,0
64193,445,0,0,70,70,0,1,0,1,0
61878,445,0,0,68,68,0,1,0,1,0
58944,445,0,0,66,66,0,1,0,1,0
55545,445,0,0,66,66,0,1,0,1,0
51656,445,0,0,70,70,0,1,0,1,0
55915,445,0,0,70,70,0,1,0,1,0
51157,445,0,0,70,70,0,1,0,1,0
49563,445,0,0,68,68,0,1,0,1,0
60342,445,0,0,69,69,0,1,0,1,0
63331,445,0,0,70,70,0,1,0,1,0
63667,445,0,0,70,70,0,1,0,1,0
60986,445,0,0,66,66,0,1,0,1,0
57944,445,0,0,70,70,0,1,0,1,0
64836,445,0,0,69,69,0,1,0,1,0
64677,445,0,0,66,66,0,1,0,1,0
54755,445,0,0,69,69,0,1,0,1,0
56017,445,0,0,68,68,0,1,0,1,0
57646,445,0,0,70,70,0,1,0,1,0
50802,445,0,0,66,66,0,1,0,1,0
55202,445,0,0,70,70,0,1,0,1,0
52859,445,0,0,70,70,0,1,0,1,0
55101,445,0,0,66,66,0,1,0,1,0
49590,445,0,0,66,66,0,1,0,1,0
51304,445,0,0,70,70,0,1,0,1,0
50843,445,0,0,70,70,0,1,0,1,0
59871,445,0,0,70,70,0,1,0,1,0
53171,445,0,0,69,69,0,1,0,1,0
64946,445,0,0,70,70,0,1,0,1,0
51516,445,0,0,68,68,0,1,0,1,0
53834,445,0,0,70,70,0,1,0,1,0
51007,445,0,0,70,70,0,1,0,1,0
63758,445,0,0,66,66,0,1,0,1,0
51826,445,0,0,68,68,0,1,0,1,0
62260,445,0,0,69,69,0,1,0,1,0
58448,445,0,0,70,70,0,1,0,1,0
59531,445,0,0,66,66,0,1,0,1,0
51311,445,0,0,66,66,0,1,0,1,0
64680,445,0,0,66,66,0,1,0,1,0
51554,445,0,0,69,69,0,1,0,1,0
54725,445,0,0,66,66,0,1,0,1,0
54186,445,0,0,69,69,0,1,0,1,0
58702,445,0,0,70,70,0,1,0,1,0
60766,445,0,0,70,70,0,1,0,1,0
53304,445,0,0,70,70,0,1,0,1,0
52999,445,0,0,66,66,0,1,0,1,0
49302,445,0,0,70,70,0,1,0,1,0
54049,445,0,0,70,70,0,1,0,1,0
53526,445,0,0,70,70,0,1,0,1,0
60296,445,0,0,70,70,0,1,0,1,0
63987,445,0,0,66,66,0,1,0,1,0
50468,445,0,0,66,66,0,1,0,1,0
55572,445,0,0,68,68,0,1,0,1,0
55317,445,0,0,70,70,0,1,0,1,0
56358,445,0,0,70,70,0,1,0,1,0
57366,445,0,0,69,69,0,1,0,1,0
50111,445,0,0,70,70,0,1,0,1,0
62323,445,0,0,70,70,0,1,0,1,0
52608,445,0,0,70,70,0,1,0,1,0
56123,445,0,0,66,66,0,1,0,1,0
53577,445,0,0,66,66,0,1,0,1,0
53864,445,0,0,70,70,0,1,0,1,0
55275,445,0,0,70,70,0,1,0,1,0
50468,445,0,0,70,70,0,1,0,1,0
50308,445,0,0,66,66,0,1,0,1,0
51698,445,0,0,69,69,0,1,0,1,0
50289,445,0,0,70,70,0,1,0,1,0
56236,445,0,0,70,70,0,1,0,1,0
61655,445,0,0,66,66,0,1,0,1,0
52089,445,0,0,70,70,0,1,0,1,0
60247,445,0,0,67,67,0,1,0,1,0
51047,445,0,0,70,70,0,1,0,1,0
54210,445,0,0,69,69,0,1,0,1,0
51036,445,0,0,66,66,0,1,0,1,0
51633,445,0,0,66,66,0,1,0,1,0
53801,445,0,0,70,70,0,1,0,1,0
61123,445,0,0,70,70,0,1,0,1,0
59228,445,0,0,70,70,0,1,0,1,0
53835,445,0,0,68,68,0,1,0,1,0
58311,445,0,0,66,66,0,1,0,1,0
65253,445,0,0,70,70,0,1,0,1,0
52790,445,0,0,66,66,0,1,0,1,0
61481,445,0,0,70,70,0,1,0,1,0
59631,445,0,0,70,70,0,1,0,1,0
54539,445,0,0,70,70,0,1,0,1,0
53727,445,0,0,70,70,0,1,0,1,0
51037,445,0,0,70,70,0,1,0,1,0
55630,445,0,0,68,68,0,1,0,1,0
50651,445,0,0,70,70,0,1,0,1,0
57075,445,0,0,66,66,0,1,0,1,0
60958,445,0,0,70,70,0,1,0,1,0
54666,445,0,0,70,70,0,1,0,1,0
61122,445,0,0,70,70,0,1,0,1,0
49735,445,0,0,68,68,0,1,0,1,0
58556,445,0,0,70,70,0,1,0,1,0
62174,445,0,0,70,70,0,1,0,1,0
52649,445,0,0,67,67,0,1,0,1,0
60580,445,0,0,70,70,0,1,0,1,0
50990,445,0,0,66,66,0,1,0,1,0
50798,445,0,0,66,66,0,1,0,1,0
56161,445,0,0,70,70,0,1,0,1,0
50094,445,0,0,66,66,0,1,0,1,0
63807,445,0,0,70,70,0,1,0,1,0
56962,445,0,0,70,70,0,1,0,1,0
64809,445,0,0,66,66,0,1,0,1,0
50139,445,0,0,70,70,0,1,0,1,0
50395,445,0,0,70,70,0,1,0,1,0
53196,445,0,0,70,70,0,1,0,1,0
63645,445,0,0,70,70,0,1,0,1,0
62133,445,0,0,66,66,0,1,0,1,0
54797,445,0,0,66,66,0,1,0,1,0
55138,445,0,0,70,70,0,1,0,1,0
55836,445,0,0,68,68,0,1,0,1,0
50014,445,0,0,70,70,0,1,0,1,0
52691,445,0,0,70,70,0,1,0,1,0
59046,445,0,0,70,70,0,1,0,1,0
53815,445,0,0,66,66,0,1,0,1,0
61514,445,0,0,68,68,0,1,0,1,0
55250,445,0,0,70,70,0,1,0,1,0
59356,445,0,0,70,70,0,1,0,1,0
64712,445,0,0,70,70,0,1,0,1,0
63296,445,0,0,70,70,0,1,0,1,0
62696,445,0,0,66,66,0,1,0,1,0
61221,445,0,0,70,70,0,1,0,1,0
52310,445,0,0,70,70,0,1,0,1,0
60688,445,0,0,70,70,0,1,0,1,0
49940,445,0,0,70,70,0,1,0,1,0
64714,445,0,0,70,70,0,1,0,1,0
49525,445,0,0,68,68,0,1,0,1,0
54735,445,0,0,70,70,0,1,0,1,0
50927,445,0,0,70,70,0,1,0,1,0
52786,445,0,0,66,66,0,1,0,1,0
65404,445,0,0,70,70,0,1,0,1,0
62721,445,0,0,66,66,0,1,0,1,0
50444,445,0,0,70,70,0,1,0,1,0
59442,445,0,0,70,70,0,1,0,1,0
58852,445,0,0,70,70,0,1,0,1,0
61313,445,0,0,70,70,0,1,0,1,0
50529,445,0,0,70,70,0,1,0,1,0
53619,445,0,0,70,70,0,1,0,1,0
62668,445,0,0,70,70,0,1,0,1,0
61592,445,0,0,70,70,0,1,0,1,0
61008,445,0,0,66,66,0,1,0,1,0
56794,445,0,0,68,68,0,1,0,1,0
56899,445,0,0,66,66,0,1,0,1,0
50807,445,0,0,67,67,0,1,0,1,0
63773,445,0,0,70,70,0,1,0,1,0
54460,445,0,0,69,69,0,1,0,1,0
51584,445,0,0,70,70,0,1,0,1,0
54984,445,0,0,66,66,0,1,0,1,0
63323,445,0,0,70,70,0,1,0,1,0
56496,445,0,0,68,68,0,1,0,1,0
63517,445,0,0,66,66,0,1,0,1,0
51838,445,0,0,67,67,0,1,0,1,0
56980,445,0,0,66,66,0,1,0,1,0
49661,445,0,0,70,70,0,1,0,1,0
53921,445,0,0,70,70,0,1,0,1,0
53252,445,0,0,70,70,0,1,0,1,0
50194,445,0,0,70,70,0,1,0,1,0
50004,445,0,0,70,70,0,1,0,1,0
62831,445,0,0,67,67,0,1,0,1,0
54139,445,0,0,66,66,0,1,0,1,0
61030,445,0,0,67,67,0,1,0,1,0
59231,445,0,0,68,68,0,1,0,1,0
61402,445,0,0,70,70,0,1,0,1,0
64044,445,0,0,70,70,0,1,0,1,0
53829,445,0,0,70,70,0,1,0,1,0
65289,445,0,0,70,70,0,1,0,1,0
63850,445,0,0,67,67,0,1,0,1,0
50023,445,0,0,68,68,0,1,0,1,0
55558,445,0,0,70,70,0,1,0,1,0
50736,445,0,0,70,70,0,1,0,1,0
51022,445,0,0,69,69,0,1,0,1,0
63301,445,0,0,70,70,0,1,0,1,0
56873,445,0,0,70,70,0,1,0,1,0
62596,445,0,0,68,68,0,1,0,1,0
54699,445,0,0,70,70,0,1,0,1,0
49521,445,0,0,68,68,0,1,0,1,0
63517,445,0,0,69,69,0,1,0,1,0
58573,445,0,0,66,66,0,1,0,1,0
62725,445,0,0,69,69,0,1,0,1,0
52070,445,0,0,70,70,0,1,0,1,0
59382,445,0,0,70,70,0,1,0,1,0
50799,445,0,0,70,70,0,1,0,1,0
63515,445,0,0,66,66,0,1,0,1,0
59570,445,0,0,70,70,0,1,0,1,0
63179,445,0,0,70,70,0,1,0,1,0
58958,445,0,0,68,68,0,1,0,1,0
62400,445,0,0,70,70,0,1,0,1,0
64688,445,0,0,70,70,0,1,0,1,0
62108,445,0,0,66,66,0,1,0,1,0
49950,445,0,0,70,70,0,1,0,1,0
50306,445,0,0,70,70,0,1,0,1,0
54039,445,0,0,69,69,0,1,0,1,0
62954,445,0,0,70,70,0,1,0,1,0
50779,445,0,0,66,66,0,1,0,1,0
49812,445,0,0,67,67,0,1,0,1,0
53677,445,0,0,67,67,0,1,0,1,0
63773,445,0,0,68,68,0,1,0,1,0
52254,445,0,0,67,67,0,1,0,1,0
64027,445,0,0,70,70,0,1,0,1,0
55837,445,0,0,69,69,0,1,0,1,0
63384,445,0,0,70,70,0,1,0,1,0
58790,445,0,0,66,66,0,1,0,1,0
55392,445,0,0,70,70,0,1,0,1,0
61805,445,0,0,69,69,0,1,0,1,0
59373,445,0,0,67,67,0,1,0,1,0
63461,445,0,0,70,70,0,1,0,1,0
49678,445,0,0,70,70,0,1,0,1,0
65305,445,0,0,66,66,0,1,0,1,0
56919,445,0,0,70,70,0,1,0,1,0
58631,445,0,0,70,70,0,1,0,1,0
51754,445,0,0,70,70,0,1,0,1,0
64968,445,0,0,70,70,0,1,0,1,0
62701,445,0,0,70,70,0,1,0,1,0
56307,445,0,0,66,66,0,1,0,1,0
53087,445,0,0,69,69,0,1,0,1,0
64377,445,0,0,68,68,0,1,0,1,0
63066,445,0,0,66,66,0,1,0,1,0
56146,445,0,0,70,70,0,1,0,1,0
53914,445,0,0,70,70,0,1,0,1,0
57564,445,0,0,67,67,0,1,0,1,0
61850,445,0,0,66,66,0,1,0,1,0
57645,445,0,0,70,70,0,1,0,1,0
53723,445,0,0,70,70,0,1,0,1,0
52529,445,0,0,70,70,0,1,0,1,0
60600,445,0,0,70,70,0,1,0,1,0
55707,445,0,0,70,70,0,1,0,1,0
61515,445,0,0,66,66,0,1,0,1,0
60660,445,0,0,70,70,0,1,0,1,0
56442,445,0,0,70,70,0,1,0,1,0
51861,445,0,0,70,70,0,1,0,1,0
60687,445,0,0,70,70,0,1,0,1,0
61879,445,0,0,70,70,0,1,0,1,0
64689,445,0,0,70,70,0,1,0,1,0
51957,445,0,0,66,66,0,1,0,1,0
50646,445,0,0,70,70,0,1,0,1,0
52395,445,0,0,68,68,0,1,0,1,0
59441,445,0,0,70,70,0,1,0,1,0
61846,445,0,0,70,70,0,1,0,1,0
64164,445,0,0,66,66,0,1,0,1,0
60107,445,0,0,70,70,0,1,0,1,0
51536,445,0,0,70,70,0,1,0,1,0
53645,445,0,0,66,66,0,1,0,1,0
55521,445,0,0,70,70,0,1,0,1,0
50035,445,0,0,70,70,0,1,0,1,0
59482,445,0,0,70,70,0,1,0,1,0
50720,445,0,0,67,67,0,1,0,1,0
50684,445,0,0,70,70,0,1,0,1,0
63711,445,0,0,67,67,0,1,0,1,0
54962,445,0,0,67,67,0,1,0,1,0
52501,445,0,0,70,70,0,1,0,1,0
50522,445,0,0,70,70,0,1,0,1,0
61470,445,0,0,70,70,0,1,0,1,0
64772,445,0,0,70,70,0,1,0,1,0
54490,445,0,0,70,70,0,1,0,1,0
57427,445,0,0,68,68,0,1,0,1,0
56486,445,0,0,70,70,0,1,0,1,0
49265,445,0,0,66,66,0,1,0,1,0
62190,445,0,0,70,70,0,1,0,1,0
51451,445,0,0,70,70,0,1,0,1,0
52892,445,0,0,67,67,0,1,0,1,0
49498,445,0,0,70,70,0,1,0,1,0
60359,445,0,0,66,66,0,1,0,1,0
50981,445,0,0,70,70,0,1,0,1,0
59015,445,0,0,66,66,0,1,0,1,0
61278,445,0,0,66,66,0,1,0,1,0
50952,445,0,0,66,66,0,1,0,1,0
64006,445,0,0,70,70,0,1,0,1,0
52919,445,0,0,66,66,0,1,0,1,0
64341,445,0,0,66,66,0,1,0,1,0
51199,445,0,0,70,70,0,1,0,1,0
55444,445,0,0,68,68,0,1,0,1,0
61995,445,0,0,69,69,0,1,0,1,0
65285,445,0,0,70,70,0,1,0,1,0
61122,445,0,0,70,70,0,1,0,1,0
62492,445,0,0,68,68,0,1,0,1,0
55241,445,0,0,70,70,0,1,0,1,0
60179,445,0,0,66,66,0,1,0,1,0
63284,445,0,0,69,69,0,1,0,1,0
50782,445,0,0,70,70,0,1,0,1,0
54661,445,0,0,69,69,0,1,0,1,0
58431,445,0,0,66,66,0,1,0,1,0
52648,445,0,0,70,70,0,1,0,1,0
50897,445,0,0,70,70,0,1,0,1,0
54829,445,0,0,70,70,0,1,0,1,0
59286,445,0,0,70,70,0,1,0,1,0
50336,445,0,0,66,66,0,1,0,1,0
65325,445,0,0,67,67,0,1,0,1,0
61764,445,0,0,70,70,0,1,0,1,0
60845,445,0,0,68,68,0,1,0,1,0
58553,445,0,0,70,70,0,1,0,1,0
61343,445,0,0,70,70,0,1,0,1,0
49922,445,0,0,70,70,0,1,0,1,0
58043,445,0,0,66,66,0,1,0,1,0
64715,445,0,0,70,70,0,1,0,1,0
57930,445,0,0,66,66,0,1,0,1,0
53714,445,0,0,67,67,0,1,0,1,0
56714,445,0,0,70,70,0,1,0,1,0
54234,445,0,0,70,70,0,1,0,1,0
53509,445,0,0,69,69,0,1,0,1,0
60886,445,0,0,70,70,0,1,0,1,0
65373,445,0,0,66,66,0,1,0,1,0
59199,445,0,0,66,66,0,1,0,1,0
58638,445,0,0,70,70,0,1,0,1,0
60104,445,0,0,67,67,0,1,0,1,0
57457,445,0,0,66,66,0,1,0,1,0
61570,445,0,0,70,70,0,1,0,1,0
56222,445,0,0,70,70,0,1,0,1,0
50445,445,0,0,70,70,0,1,0,1,0
61256,445,0,0,70,70,0,1,0,1,0
50464,445,0,0,70,70,0,1,0,1,0
60150,445,0,0,68,68,0,1,0,1,0
54795,445,0,0,68,68,0,1,0,1,0
62276,445,0,0,70,70,0,1,0,1,0
55802,445,0,0,70,70,0,1,0,1,0
56639,445,0,0,70,70,0,1,0,1,0
62665,445,0,0,70,70,0,1,0,1,0
49242,445,0,0,70,70,0,1,0,1,0
64581,445,0,0,70,70,0,1,0,1,0
52753,445,0,0,70,70,0,1,0,1,0
56447,445,0,0,70,70,0,1,0,1,0
63322,445,0,0,66,66,0,1,0,1,0
53747,445,0,0,70,70,0,1,0,1,0
54053,445,0,0,70,70,0,1,0,1,0
58165,445,0,0,66,66,0,1,0,1,0
65196,445,0,0,66,66,0,1,0,1,0
50848,445,0,0,66,66,0,1,0,1,0
65339,445,0,0,70,70,0,1,0,1,0
55582,445,0,0,70,70,0,1,0,1,0
51351,445,0,0,70,70,0,1,0,1,0
59896,445,0,0,69,69,0,1,0,1,0
65092,445,0,0,70,70,0,1,0,1,0
57401,445,0,0,66,66,0,1,0,1,0
49664,445,0,0,70,70,0,1,0,1,0
61204,445,0,0,70,70,0,1,0,1,0
61484,445,0,0,66,66,0,1,0,1,0
62424,445,0,0,66,66,0,1,0,1,0
56321,445,0,0,70,70,0,1,0,1,0
63024,445,0,0,70,70,0,1,0,1,0
60635,445,0,0,70,70,0,1,0,1,0
56449,445,0,0,70,70,0,1,0,1,0
49425,445,0,0,70,70,0,1,0,1,0
61887,445,0,0,70,70,0,1,0,1,0
56666,445,0,0,70,70,0,1,0,1,0
50594,445,0,0,66,66,0,1,0,1,0
52433,445,0,0,66,66,0,1,0,1,0
61328,445,0,0,70,70,0,1,0,1,0
60115,445,0,0,69,69,0,1,0,1,0
60150,445,0,0,68,68,0,1,0,1,0
49218,445,0,0,69,69,0,1,0,1,0
49812,445,0,0,70,70,0,1,0,1,0
53426,445,0,0,66,66,0,1,0,1,0
64168,445,0,0,67,67,0,1,0,1,0
50865,445,0,0,66,66,0,1,0,1,0
56706,445,0,0,66,66,0,1,0,1,0
49427,445,0,0,70,70,0,1,0,1,0
61620,445,0,0,67,67,0,1,0,1,0
49387,445,0,0,70,70,0,1,0,1,0
51958,445,0,0,69,69,0,1,0,1,0
58788,445,0,0,70,70,0,1,0,1,0
61386,445,0,0,66,66,0,1,0,1,0
51628,445,0,0,70,70,0,1,0,1,0
55706,445,0,0,67,67,0,1,0,1,0
53343,445,0,0,70,70,0,1,0,1,0
57757,445,0,0,70,70,0,1,0,1,0
63546,445,0,0,70,70,0,1,0,1,0
50098,445,0,0,66,66,0,1,0,1,0
63869,445,0,0,70,70,0,1,0,1,0
63872,445,0,0,70,70,0,1,0,1,0
56872,445,0,0,70,70,0,1,0,1,0
57799,445,0,0,66,66,0,1,0,1,0
63145,445,0,0,66,66,0,1,0,1,0
60276,445,0,0,69,69,0,1,0,1,0
63330,445,0,0,66,66,0,1,0,1,0
50777,445,0,0,70,70,0,1,0,1,0
64929,445,0,0,70,70,0,1,0,1,0
62343,445,0,0,66,66,0,1,0,1,0
59501,445,0,0,70,70,0,1,0,1,0
59722,445,0,0,66,66,0,1,0,1,0
59783,445,0,0,70,70,0,1,0,1,0
49534,445,0,0,66,66,0,1,0,1,0
50894,445,0,0,70,70,0,1,0,1,0
58972,445,0,0,70,70,0,1,0,1,0
65065,445,0,0,66,66,0,1,0,1,0
64633,445,0,0,68,68,0,1,0,1,0
53607,445,0,0,66,66,0,1,0,1,0
50671,445,0,0,66,66,0,1,0,1,0
54392,445,0,0,70,70,0,1,0,1,0
50594,445,0,0,70,70,0,1,0,1,0
63085,445,0,0,68,68,0,1,0,1,0
56262,445,0,0,70,70,0,1,0,1,0
63771,445,0,0,66,66,0,1,0,1,0
53682,445,0,0,66,66,0,1,0,1,0
61669,445,0,0,66,66,0,1,0,1,0
50125,445,0,0,66,66,0,1,0,1,0
51125,445,0,0,66,66,0,1,0,1,0
64422,445,0,0,66,66,0,1,0,1,0
49962,445,0,0,70,70,0,1,0,1,0
52090,445,0,0,66,66,0,1,0,1,0
52472,445,0,0,66,66,0,1,0,1,0
63716,445,0,0,70,70,0,1,0,1,0
49494,445,0,0,68,68,0,1,0,1,0
58222,445,0,0,70,70,0,1,0,1,0
51229,445,0,0,70,70,0,1,0,1,0
54536,445,0,0,70,70,0,1,0,1,0
52533,445,0,0,70,70,0,1,0,1,0
50868,445,0,0,70,70,0,1,0,1,0
62129,445,0,0,70,70,0,1,0,1,0
57844,445,0,0,66,66,0,1,0,1,0
52522,445,0,0,69,69,0,1,0,1,0
65231,445,0,0,70,70,0,1,0,1,0
58294,445,0,0,66,66,0,1,0,1,0
52892,445,0,0,70,70,0,1,0,1,0
57149,445,0,0,70,70,0,1,0,1,0
55339,445,0,0,70,70,0,1,0,1,0
56655,445,0,0,70,70,0,1,0,1,0
50395,445,0,0,70,70,0,1,0,1,0
61063,445,0,0,66,66,0,1,0,1,0
53916,445,0,0,70,70,0,1,0,1,0
51371,445,0,0,66,66,0,1,0,1,0
60993,445,0,0,70,70,0,1,0,1,0
52255,445,0,0,66,66,0,1,0,1,0
53276,445,0,0,70,70,0,1,0,1,0
59799,445,0,0,70,70,0,1,0,1,0
64006,445,0,0,70,70,0,1,0,1,0
61806,445,0,0,66,66,0,1,0,1,0
51184,445,0,0,66,66,0,1,0,1,0
49321,445,0,0,70,70,0,1,0,1,0
56579,445,0,0,66,66,0,1,0,1,0
53949,445,0,0,69,69,0,1,0,1,0
51946,445,0,0,70,70,0,1,0,1,0
52824,445,0,0,70,70,0,1,0,1,0
53014,445,0,0,67,67,0,1,0,1,0
58712,445,0,0,66,66,0,1,0,1,0
54944,445,0,0,70,70,0,1,0,1,0
55641,445,0,0,70,70,0,1,0,1,0
55678,445,0,0,70,70,0,1,0,1,0
63070,445,0,0,66,66,0,1,0,1,0
58607,445,0,0,68,68,0,1,0,1,0
54772,445,0,0,70,70,0,1,0,1,0
62216,445,0,0,67,67,0,1,0,1,0
64079,445,0,0,70,70,0,1,0,1,0
54516,445,0,0,70,70,0,1,0,1,0
62790,445,0,0,70,70,0,1,0,1,0
58860,445,0,0,70,70,0,1,0,1,0
63049,445,0,0,70,70,0,1,0,1,0
51021,445,0,0,66,66,0,1,0,1,0
54836,445,0,0,70,70,0,1,0,1,0
50382,445,0,0,70,70,0,1,0,1,0
52145,445,0,0,68,68,0,1,0,1,0
50066,445,0,0,70,70,0,1,0,1,0
59297,445,0,0,70,70,0,1,0,1,0
51603,445,0,0,69,69,0,1,0,1,0
55388,445,0,0,70,70,0,1,0,1,0
60932,445,0,0,69,69,0,1,0,1,0
63362,445,0,0,70,70,0,1,0,1,0
62193,445,0,0,70,70,0,1,0,1,0
57398,445,0,0,67,67,0,1,0,1,0
62664,445,0,0,68,68,0,1,0,1,0
62539,445,0,0,68,68,0,1,0,1,0
61531,445,0,0,70,70,0,1,0,1,0
52782,445,0,0,66,66,0,1,0,1,0
51699,445,0,0,69,69,0,1,0,1,0
50697,445,0,0,70,70,0,1,0,1,0
58497,445,0,0,70,70,0,1,0,1,0
54967,445,0,0,66,66,0,1,0,1,0
52691,445,0,0,70,70,0,1,0,1,0
55855,445,0,0,66,66,0,1,0,1,0
49630,445,0,0,70,70,0,1,0,1,0
51913,445,0,0,66,66,0,1,0,1,0
51622,445,0,0,66,66,0,1,0,1,0
51231,445,0,0,66,66,0,1,0,1,0
59341,445,0,0,70,70,0,1,0,1,0
50582,445,0,0,70,70,0,1,0,1,0
59954,445,0,0,67,67,0,1,0,1,0
49659,445,0,0,70,70,0,1,0,1,0
65035,445,0,0,70,70,0,1,0,1,0
61533,445,0,0,70,70,0,1,0,1,0
62630,445,0,0,68,68,0,1,0,1,0
57391,445,0,0,70,70,0,1,0,1,0
50525,445,0,0,67,67,0,1,0,1,0
59955,445,0,0,70,70,0,1,0,1,0
55031,445,0,0,70,70,0,1,0,1,0
55068,445,0,0,70,70,0,1,0,1,0
65251,445,0,0,70,70,0,1,0,1,0
57148,445,0,0,68,68,0,1,0,1,0
64822,445,0,0,70,70,0,1,0,1,0
51580,445,0,0,70,70,0,1,0,1,0
57701,445,0,0,70,70,0,1,0,1,0
50544,445,0,0,70,70,0,1,0,1,0
56509,445,0,0,66,66,0,1,0,1,0
63795,445,0,0,66,66,0,1,0,1,0
57201,445,0,0,66,66,0,1,0,1,0
65458,445,0,0,70,70,0,1,0,1,0
61861,445,0,0,70,70,0,1,0,1,0
64565,445,0,0,70,70,0,1,0,1,0
50149,445,0,0,67,67,0,1,0,1,0
57046,445,0,0,69,69,0,1,0,1,0
59929,445,0,0,70,70,0,1,0,1,0
50821,445,0,0,70,70,0,1,0,1,0
52075,445,0,0,70,70,0,1,0,1,0
62100,445,0,0,70,70,0,1,0,1,0
51745,445,0,0,70,70,0,1,0,1,0
54729,445,0,0,68,68,0,1,0,1,0
60106,445,0,0,70,70,0,1,0,1,0
53099,445,0,0,69,69,0,1,0,1,0
51569,445,0,0,66,66,0,1,0,1,0
54160,445,0,0,69,69,0,1,0,1,0
61038,445,0,0,66,66,0,1,0,1,0
56875,445,0,0,70,70,0,1,0,1,0
51221,445,0,0,67,67,0,1,0,1,0
56834,445,0,0,70,70,0,1,0,1,0
55490,445,0,0,70,70,0,1,0,1,0
52625,445,0,0,70,70,0,1,0,1,0
59733,445,0,0,70,70,0,1,0,1,0
58607,445,0,0,70,70,0,1,0,1,0
58869,445,0,0,69,69,0,1,0,1,0
55839,445,0,0,70,70,0,1,0,1,0
58478,445,0,0,69,69,0,1,0,1,0
54755,445,0,0,70,70,0,1,0,1,0
55565,445,0,0,70,70,0,1,0,1,0
56448,445,0,0,66,66,0,1,0,1,0
57074,445,0,0,66,66,0,1,0,1,0
60390,445,0,0,69,69,0,1,0,1,0
58451,445,0,0,66,66,0,1,0,1,0
62983,445,0,0,66,66,0,1,0,1,0
60303,445,0,0,66,66,0,1,0,1,0
50658,445,0,0,67,67,0,1,0,1,0
58076,445,0,0,68,68,0,1,0,1,0
56396,445,0,0,67,67,0,1,0,1,0
64080,445,0,0,70,70,0,1,0,1,0
56641,445,0,0,66,66,0,1,0,1,0
51690,445,0,0,70,70,0,1,0,1,0
60986,445,0,0,68,68,0,1,0,1,0
56637,445,0,0,70,70,0,1,0,1,0
54624,445,0,0,70,70,0,1,0,1,0
50977,445,0,0,66,66,0,1,0,1,0
60420,445,0,0,70,70,0,1,0,1,0
49625,445,0,0,70,70,0,1,0,1,0
54643,445,0,0,70,70,0,1,0,1,0
57536,445,0,0,69,69,0,1,0,1,0
65290,445,0,0,70,70,0,1,0,1,0
51075,445,0,0,70,70,0,1,0,1,0
51500,445,0,0,66,66,0,1,0,1,0
61976,445,0,0,67,67,0,1,0,1,0
63339,445,0,0,68,68,0,1,0,1,0
49443,445,0,0,70,70,0,1,0,1,0
50099,445,0,0,66,66,0,1,0,1,0
52631,445,0,0,69,69,0,1,0,1,0
58093,445,0,0,70,70,0,1,0,1,0
65258,445,0,0,70,70,0,1,0,1,0
59359,445,0,0,70,70,0,1,0,1,0
63518,445,0,0,66,66,0,1,0,1,0
50781,445,0,0,70,70,0,1,0,1,0
64821,445,0,0,70,70,0,1,0,1,0
50394,445,0,0,70,70,0,1,0,1,0
58041,445,0,0,69,69,0,1,0,1,0
56043,445,0,0,69,69,0,1,0,1,0
53141,445,0,0,67,67,0,1,0,1,0
51655,445,0,0,70,70,0,1,0,1,0
53028,445,0,0,70,70,0,1,0,1,0
55086,445,0,0,66,66,0,1,0,1,0
60058,445,0,0,70,70,0,1,0,1,0
64263,445,0,0,70,70,0,1,0,1,0
57415,445,0,0,70,70,0,1,0,1,0
60507,445,0,0,70,70,0,1,0,1,0
49450,445,0,0,70,70,0,1,0,1,0
50798,445,0,0,66,66,0,1,0,1,0
56894,445,0,0,70,70,0,1,0,1,0
50338,445,0,0,70,70,0,1,0,1,0
65502,445,0,0,67,67,0,1,0,1,0
51471,445,0,0,70,70,0,1,0,1,0
64313,445,0,0,66,66,0,1,0,1,0
59255,445,0,0,66,66,0,1,0,1,0
49256,445,0,0,70,70,0,1,0,1,0
56498,445,0,0,69,69,0,1,0,1,0
50651,445,0,0,70,70,0,1,0,1,0
61382,445,0,0,70,70,0,1,0,1,0
58942,445,0,0,70,70,0,1,0,1,0
64360,445,0,0,66,66,0,1,0,1,0
52303,445,0,0,66,66,0,1,0,1,0
54718,445,0,0,70,70,0,1,0,1,0
57087,445,0,0,70,70,0,1,0,1,0
51069,445,0,0,70,70,0,1,0,1,0
64301,445,0,0,70,70,0,1,0,1,0
57729,445,0,0,70,70,0,1,0,1,0
64556,445,0,0,70,70,0,1,0,1,0
51033,445,0,0,67,67,0,1,0,1,0
61484,445,0,0,66,66,0,1,0,1,0
57800,445,0,0,66,66,0,1,0,1,0
60293,445,0,0,70,70,0,1,0,1,0
56397,445,0,0,70,70,0,1,0,1,0
55677,445,0,0,66,66,0,1,0,1,0
52552,445,0,0,66,66,0,1,0,1,0
55952,445,0,0,70,70,0,1,0,1,0
61875,445,0,0,69,69,0,1,0,1,0
65324,445,0,0,66,66,0,1,0,1,0
51008,445,0,0,70,70,0,1,0,1,0
62264,445,0,0,70,70,0,1,0,1,0
60419,445,0,0,68,68,0,1,0,1,0
52481,445,0,0,70,70,0,1,0,1,0
53531,445,0,0,70,70,0,1,0,1,0
58043,445,0,0,69,69,0,1,0,1,0
63420,445,0,0,70,70,0,1,0,1,0
57158,445,0,0,66,66,0,1,0,1,0
51435,445,0,0,70,70,0,1,0,1,0
53496,445,0,0,66,66,0,1,0,1,0
49444,445,0,0,70,70,0,1,0,1,0
57477,445,0,0,69,69,0,1,0,1,0
54967,445,0,0,66,66,0,1,0,1,0
50915,445,0,0,70,70,0,1,0,1,0
60571,445,0,0,70,70,0,1,0,1,0
63729,445,0,0,66,66,0,1,0,1,0
61038,445,0,0,66,66,0,1,0,1,0
60083,445,0,0,70,70,0,1,0,1,0
54427,445,0,0,70,70,0,1,0,1,0
49981,445,0,0,69,69,0,1,0,1,0
61491,445,0,0,68,68,0,1,0,1,0
56092,445,0,0,67,67,0,1,0,1,0
49904,445,0,0,66,66,0,1,0,1,0
52986,445,0,0,66,66,0,1,0,1,0
53148,445,0,0,70,70,0,1,0,1,0
50697,445,0,0,70,70,0,1,0,1,0
60916,445,0,0,70,70,0,1,0,1,0
52921,445,0,0,66,66,0,1,0,1,0
52399,445,0,0,66,66,0,1,0,1,0
63210,445,0,0,70,70,0,1,0,1,0
63807,445,0,0,69,69,0,1,0,1,0
60178,445,0,0,66,66,0,1,0,1,0
57447,445,0,0,70,70,0,1,0,1,0
49409,445,0,0,69,69,0,1,0,1,0
50880,445,0,0,70,70,0,1,0,1,0
63560,445,0,0,70,70,0,1,0,1,0
58127,445,0,0,68,68,0,1,0,1,0
64644,445,0,0,70,70,0,1,0,1,0
59789,445,0,0,70,70,0,1,0,1,0
65248,445,0,0,70,70,0,1,0,1,0
61003,445,0,0,66,66,0,1,0,1,0
51763,445,0,0,66,66,0,1,0,1,0
61530,445,0,0,66,66,0,1,0,1,0
61059,445,0,0,70,70,0,1,0,1,0
49907,445,0,0,70,70,0,1,0,1,0
51290,445,0,0,70,70,0,1,0,1,0
51492,445,0,0,70,70,0,1,0,1,0
52700,445,0,0,70,70,0,1,0,1,0
53974,445,0,0,70,70,0,1,0,1,0
58371,445,0,0,66,66,0,1,0,1,0
58112,445,0,0,68,68,0,1,0,1,0
63625,445,0,0,69,69,0,1,0,1,0
55784,445,0,0,69,69,0,1,0,1,0
58504,445,0,0,66,66,0,1,0,1,0
62449,445,0,0,70,70,0,1,0,1,0
50513,445,0,0,70,70,0,1,0,1,0
51716,445,0,0,70,70,0,1,0,1,0
49625,445,0,0,70,70,0,1,0,1,0
50290,445,0,0,70,70,0,1,0,1,0
53334,445,0,0,70,70,0,1,0,1,0
49448,445,0,0,70,70,0,1,0,1,0
60437,445,0,0,66,66,0,1,0,1,0
62534,445,0,0,70,70,0,1,0,1,0
55950,445,0,0,69,69,0,1,0,1,0
57371,445,0,0,70,70,0,1,0,1,0
64343,445,0,0,66,66,0,1,0,1,0
64540,445,0,0,70,70,0,1,0,1,0
62084,445,0,0,70,70,0,1,0,1,0
65118,445,0,0,70,70,0,1,0,1,0
62081,445,0,0,70,70,0,1,0,1,0
58278,445,0,0,70,70,0,1,0,1,0
62698,445,0,0,67,67,0,1,0,1,0
58502,445,0,0,66,66,0,1,0,1,0
65463,445,0,0,70,70,0,1,0,1,0
58658,445,0,0,70,70,0,1,0,1,0
49960,445,0,0,70,70,0,1,0,1,0
50632,445,0,0,67,67,0,1,0,1,0
54065,445,0,0,66,66,0,1,0,1,0
58582,445,0,0,70,70,0,1,0,1,0
50355,445,0,0,66,66,0,1,0,1,0
57301,445,0,0,70,70,0,1,0,1,0
57316,445,0,0,70,70,0,1,0,1,0
57386,445,0,0,70,70,0,1,0,1,0
65069,445,0,0,66,66,0,1,0,1,0
59829,445,0,0,70,70,0,1,0,1,0
53577,445,0,0,66,66,0,1,0,1,0
58180,445,0,0,66,66,0,1,0,1,0
54173,445,0,0,70,70,0,1,0,1,0
64214,445,0,0,70,70,0,1,0,1,0
60375,445,0,0,70,70,0,1,0,1,0
58058,445,0,0,66,66,0,1,0,1,0
50711,445,0,0,70,70,0,1,0,1,0
54399,445,0,0,70,70,0,1,0,1,0
53045,445,0,0,70,70,0,1,0,1,0
59164,445,0,0,70,70,0,1,0,1,0
54455,445,0,0,67,67,0,1,0,1,0
57162,445,0,0,70,70,0,1,0,1,0
63752,445,0,0,70,70,0,1,0,1,0
54945,445,0,0,70,70,0,1,0,1,0
63130,445,0,0,66,66,0,1,0,1,0
52108,445,0,0,66,66,0,1,0,1,0
50479,445,0,0,66,66,0,1,0,1,0
54342,445,0,0,67,67,0,1,0,1,0
57656,445,0,0,66,66,0,1,0,1,0
52919,445,0,0,66,66,0,1,0,1,0
56790,445,0,0,67,67,0,1,0,1,0
51639,445,0,0,66,66,0,1,0,1,0
53340,445,0,0,70,70,0,1,0,1,0
62430,445,0,0,70,70,0,1,0,1,0
50017,445,0,0,70,70,0,1,0,1,0
64438,445,0,0,70,70,0,1,0,1,0
58307,445,0,0,70,70,0,1,0,1,0
55131,445,0,0,70,70,0,1,0,1,0
54323,445,0,0,66,66,0,1,0,1,0
54647,445,0,0,66,66,0,1,0,1,0
53362,445,0,0,70,70,0,1,0,1,0
51112,445,0,0,66,66,0,1,0,1,0
64030,445,0,0,69,69,0,1,0,1,0
63718,445,0,0,68,68,0,1,0,1,0
58435,445,0,0,66,66,0,1,0,1,0
63439,445,0,0,70,70,0,1,0,1,0
57985,445,0,0,70,70,0,1,0,1,0
61277,445,0,0,66,66,0,1,0,1,0
55531,445,0,0,70,70,0,1,0,1,0
58212,445,0,0,70,70,0,1,0,1,0
52749,445,0,0,70,70,0,1,0,1,0
65185,445,0,0,70,70,0,1,0,1,0
53220,445,0,0,70,70,0,1,0,1,0
53484,445,0,0,68,68,0,1,0,1,0
64552,445,0,0,66,66,0,1,0,1,0
65224,445,0,0,70,70,0,1,0,1,0
55261,445,0,0,70,70,0,1,0,1,0
50697,445,0,0,68,68,0,1,0,1,0
54720,445,0,0,70,70,0,1,0,1,0
52074,445,0,0,70,70,0,1,0,1,0
62931,445,0,0,70,70,0,1,0,1,0
54858,445,0,0,67,67,0,1,0,1,0
53682,445,0,0,66,66,0,1,0,1,0
51242,445,0,0,66,66,0,1,0,1,0
60244,445,0,0,70,70,0,1,0,1,0
53427,445,0,0,66,66,0,1,0,1,0
54780,445,0,0,66,66,0,1,0,1,0
63052,445,0,0,69,69,0,1,0,1,0
52848,445,0,0,70,70,0,1,0,1,0
51585,445,0,0,70,70,0,1,0,1,0
50692,445,0,0,70,70,0,1,0,1,0
60820,445,0,0,66,66,0,1,0,1,0
63051,445,0,0,66,66,0,1,0,1,0
58953,445,0,0,66,66,0,1,0,1,0
65359,445,0,0,66,66,0,1,0,1,0
59092,445,0,0,67,67,0,1,0,1,0
50812,445,0,0,70,70,0,1,0,1,0
52814,445,0,0,67,67,0,1,0,1,0
64867,445,0,0,70,70,0,1,0,1,0
63559,445,0,0,70,70,0,1,0,1,0
61259,445,0,0,66,66,0,1,0,1,0
53015,445,0,0,70,70,0,1,0,1,0
55165,445,0,0,66,66,0,1,0,1,0
49907,445,0,0,70,70,0,1,0,1,0
59192,445,0,0,66,66,0,1,0,1,0
50946,445,0,0,70,70,0,1,0,1,0
50020,445,0,0,70,70,0,1,0,1,0
52933,445,0,0,70,70,0,1,0,1,0
49867,445,0,0,70,70,0,1,0,1,0
59759,445,0,0,70,70,0,1,0,1,0
58246,445,0,0,66,66,0,1,0,1,0
62665,445,0,0,66,66,0,1,0,1,0
58971,445,0,0,70,70,0,1,0,1,0
56857,445,0,0,70,70,0,1,0,1,0
49497,445,0,0,70,70,0,1,0,1,0
62359,445,0,0,66,66,0,1,0,1,0
58570,445,0,0,66,66,0,1,0,1,0
59050,445,0,0,70,70,0,1,0,1,0
57565,445,0,0,66,66,0,1,0,1,0
57497,445,0,0,69,69,0,1,0,1,0
54812,445,0,0,68,68,0,1,0,1,0
53077,445,0,0,70,70,0,1,0,1,0
52021,445,0,0,66,66,0,1,0,1,0
55288,445,0,0,66,66,0,1,0,1,0
57698,445,0,0,70,70,0,1,0,1,0
56672,445,0,0,69,69,0,1,0,1,0
63321,445,0,0,69,69,0,1,0,1,0
51234,445,0,0,66,66,0,1,0,1,0
55589,445,0,0,70,70,0,1,0,1,0
65078,445,0,0,70,70,0,1,0,1,0
59712,445,0,0,70,70,0,1,0,1,0
55234,445,0,0,70,70,0,1,0,1,0
62075,445,0,0,70,70,0,1,0,1,0
65516,445,0,0,70,70,0,1,0,1,0
54614,445,0,0,70,70,0,1,0,1,0
64309,445,0,0,70,70,0,1,0,1,0
55011,445,0,0,70,70,0,1,0,1,0
56190,445,0,0,68,68,0,1,0,1,0
54284,445,0,0,66,66,0,1,0,1,0
49469,445,0,0,70,70,0,1,0,1,0
60823,445,0,0,66,66,0,1,0,1,0
62851,445,0,0,66,66,0,1,0,1,0
63585,445,0,0,70,70,0,1,0,1,0
59141,445,0,0,68,68,0,1,0,1,0
61808,445,0,0,70,70,0,1,0,1,0
57534,445,0,0,70,70,0,1,0,1,0
56836,445,0,0,68,68,0,1,0,1,0
53963,445,0,0,69,69,0,1,0,1,0
51422,445,0,0,70,70,0,1,0,1,0
55213,445,0,0,70,70,0,1,0,1,0
63306,445,0,0,66,66,0,1,0,1,0
58630,445,0,0,66,66,0,1,0,1,0
65049,445,0,0,66,66,0,1,0,1,0
60075,445,0,0,70,70,0,1,0,1,0
62084,445,0,0,70,70,0,1,0,1,0
58271,445,0,0,68,68,0,1,0,1,0
53851,445,0,0,70,70,0,1,0,1,0
63874,445,0,0,67,67,0,1,0,1,0
56515,445,0,0,70,70,0,1,0,1,0
65275,445,0,0,68,68,0,1,0,1,0
54355,445,0,0,68,68,0,1,0,1,0
55044,445,0,0,70,70,0,1,0,1,0
54528,445,0,0,68,68,0,1,0,1,0
51041,445,0,0,70,70,0,1,0,1,0
55682,445,0,0,70,70,0,1,0,1,0
54505,445,0,0,70,70,0,1,0,1,0
51787,445,0,0,66,66,0,1,0,1,0
61247,445,0,0,70,70,0,1,0,1,0
58372,445,0,0,66,66,0,1,0,1,0
55630,445,0,0,68,68,0,1,0,1,0
63870,445,0,0,70,70,0,1,0,1,0
60289,445,0,0,67,67,0,1,0,1,0
50931,445,0,0,66,66,0,1,0,1,0
63517,445,0,0,67,67,0,1,0,1,0
54904,445,0,0,66,66,0,1,0,1,0
50082,445,0,0,70,70,0,1,0,1,0
59830,445,0,0,70,70,0,1,0,1,0
59099,445,0,0,68,68,0,1,0,1,0
64284,445,0,0,70,70,0,1,0,1,0
54606,445,0,0,70,70,0,1,0,1,0
52609,445,0,0,70,70,0,1,0,1,0
62549,445,0,0,70,70,0,1,0,1,0
50041,445,0,0,70,70,0,1,0,1,0
52479,445,0,0,70,70,0,1,0,1,0
50253,445,0,0,70,70,0,1,0,1,0
62233,445,0,0,70,70,0,1,0,1,0
51166,445,0,0,68,68,0,1,0,1,0
64794,445,0,0,70,70,0,1,0,1,0
62077,445,0,0,70,70,0,1,0,1,0
60192,445,0,0,70,70,0,1,0,1,0
61145,445,0,0,70,70,0,1,0,1,0
52880,445,0,0,66,66,0,1,0,1,0
50634,445,0,0,70,70,0,1,0,1,0
60440,445,0,0,69,69,0,1,0,1,0
49924,445,0,0,70,70,0,1,0,1,0
64659,445,0,0,67,67,0,1,0,1,0
60983,445,0,0,70,70,0,1,0,1,0
59802,445,0,0,68,68,0,1,0,1,0
50718,445,0,0,70,70,0,1,0,1,0
50337,445,0,0,66,66,0,1,0,1,0
62914,445,0,0,70,70,0,1,0,1,0
64343,445,0,0,66,66,0,1,0,1,0
64069,445,0,0,69,69,0,1,0,1,0
61167,445,0,0,70,70,0,1,0,1,0
57179,445,0,0,70,70,0,1,0,1,0
55034,445,0,0,66,66,0,1,0,1,0
62259,445,0,0,67,67,0,1,0,1,0
63775,445,0,0,66,66,0,1,0,1,0
51076,445,0,0,66,66,0,1,0,1,0
63646,445,0,0,70,70,0,1,0,1,0
60177,445,0,0,70,70,0,1,0,1,0
62422,445,0,0,67,67,0,1,0,1,0
53746,445,0,0,70,70,0,1,0,1,0
57907,445,0,0,70,70,0,1,0,1,0
54874,445,0,0,70,70,0,1,0,1,0
53654,445,0,0,69,69,0,1,0,1,0
59637,445,0,0,68,68,0,1,0,1,0
60343,445,0,0,70,70,0,1,0,1,0
53560,445,0,0,67,67,0,1,0,1,0
50651,445,0,0,70,70,0,1,0,1,0
59378,445,0,0,70,70,0,1,0,1,0
59160,445,0,0,70,70,0,1,0,1,0
64016,445,0,0,69,69,0,1,0,1,0
63051,445,0,0,69,69,0,1,0,1,0
64643,445,0,0,70,70,0,1,0,1,0
64605,445,0,0,69,69,0,1,0,1,0
49793,445,0,0,70,70,0,1,0,1,0
63966,445,0,0,67,67,0,1,0,1,0
50604,445,0,0,70,70,0,1,0,1,0
60313,445,0,0,69,69,0,1,0,1,0
54110,445,0,0,70,70,0,1,0,1,0
60508,445,0,0,66,66,0,1,0,1,0
51440,445,0,0,66,66,0,1,0,1,0
59030,445,0,0,70,70,0,1,0,1,0
55256,445,0,0,70,70,0,1,0,1,0
61079,445,0,0,66,66,0,1,0,1,0
62605,445,0,0,68,68,0,1,0,1,0
63943,445,0,0,66,66,0,1,0,1,0
55696,445,0,0,70,70,0,1,0,1,0
58040,445,0,0,69,69,0,1,0,1,0
50896,445,0,0,70,70,0,1,0,1,0
65096,445,0,0,70,70,0,1,0,1,0
59414,445,0,0,70,70,0,1,0,1,0
57185,445,0,0,68,68,0,1,0,1,0
53243,445,0,0,66,66,0,1,0,1,0
50360,445,0,0,70,70,0,1,0,1,0
53365,445,0,0,70,70,0,1,0,1,0
62359,445,0,0,66,66,0,1,0,1,0
65494,445,0,0,70,70,0,1,0,1,0
59017,445,0,0,70,70,0,1,0,1,0
62147,445,0,0,70,70,0,1,0,1,0
65203,445,0,0,70,70,0,1,0,1,0
61249,445,0,0,70,70,0,1,0,1,0
64959,445,0,0,66,66,0,1,0,1,0
55965,445,0,0,70,70,0,1,0,1,0
62388,445,0,0,66,66,0,1,0,1,0
62001,445,0,0,66,66,0,1,0,1,0
65120,445,0,0,66,66,0,1,0,1,0
63436,445,0,0,67,67,0,1,0,1,0
61211,445,0,0,66,66,0,1,0,1,0
61591,445,0,0,66,66,0,1,0,1,0
59254,445,0,0,69,69,0,1,0,1,0
50885,445,0,0,67,67,0,1,0,1,0
49687,445,0,0,70,70,0,1,0,1,0
50807,445,0,0,66,66,0,1,0,1,0
58217,445,0,0,70,70,0,1,0,1,0
60697,445,0,0,66,66,0,1,0,1,0
57197,445,0,0,70,70,0,1,0,1,0
59117,445,0,0,70,70,0,1,0,1,0
63367,445,0,0,70,70,0,1,0,1,0
51715,445,0,0,70,70,0,1,0,1,0
49411,445,0,0,66,66,0,1,0,1,0
64002,445,0,0,70,70,0,1,0,1,0
52276,445,0,0,67,67,0,1,0,1,0
64551,445,0,0,66,66,0,1,0,1,0
60375,445,0,0,70,70,0,1,0,1,0
60787,445,0,0,70,70,0,1,0,1,0
49726,445,0,0,70,70,0,1,0,1,0
52590,445,0,0,70,70,0,1,0,1,0
58116,445,0,0,68,68,0,1,0,1,0
60564,445,0,0,66,66,0,1,0,1,0
61848,445,0,0,66,66,0,1,0,1,0
52996,445,0,0,70,70,0,1,0,1,0
64164,445,0,0,66,66,0,1,0,1,0
55341,445,0,0,70,70,0,1,0,1,0
49578,445,0,0,70,70,0,1,0,1,0
62354,445,0,0,70,70,0,1,0,1,0
54522,445,0,0,70,70,0,1,0,1,0
53593,445,0,0,70,70,0,1,0,1,0
61957,445,0,0,67,67,0,1,0,1,0
56702,445,0,0,70,70,0,1,0,1,0
50985,445,0,0,70,70,0,1,0,1,0
56471,445,0,0,66,66,0,1,0,1,0
64629,445,0,0,66,66,0,1,0,1,0
54173,445,0,0,70,70,0,1,0,1,0
61258,445,0,0,66,66,0,1,0,1,0
65485,445,0,0,70,70,0,1,0,1,0
51380,445,0,0,67,67,0,1,0,1,0
60977,445,0,0,70,70,0,1,0,1,0
53862,445,0,0,67,67,0,1,0,1,0
52089,445,0,0,70,70,0,1,0,1,0
63905,445,0,0,66,66,0,1,0,1,0
55491,445,0,0,70,70,0,1,0,1,0
54155,445,0,0,70,70,0,1,0,1,0
57944,445,0,0,70,70,0,1,0,1,0
51289,445,0,0,70,70,0,1,0,1,0
59848,445,0,0,68,68,0,1,0,1,0
61894,445,0,0,70,70,0,1,0,1,0
57860,445,0,0,66,66,0,1,0,1,0
61626,445,0,0,70,70,0,1,0,1,0
50797,445,0,0,66,66,0,1,0,1,0
51561,445,0,0,70,70,0,1,0,1,0
53149,445,0,0,70,70,0,1,0,1,0
58958,445,0,0,68,68,0,1,0,1,0
54204,445,0,0,68,68,0,1,0,1,0
50652,445,0,0,70,70,0,1,0,1,0
55514,445,0,0,70,70,0,1,0,1,0
51314,445,0,0,68,68,0,1,0,1,0
56773,445,0,0,70,70,0,1,0,1,0
49907,445,0,0,70,70,0,1,0,1,0
51164,445,0,0,67,67,0,1,0,1,0
52790,445,0,0,66,66,0,1,0,1,0
54966,445,0,0,66,66,0,1,0,1,0
53193,445,0,0,70,70,0,1,0,1,0
63321,445,0,0,70,70,0,1,0,1,0
51070,445,0,0,70,70,0,1,0,1,0
52403,445,0,0,66,66,0,1,0,1,0
60211,445,0,0,70,70,0,1,0,1,0
55835,445,0,0,70,70,0,1,0,1,0
57401,445,0,0,67,67,0,1,0,1,0
62945,445,0,0,66,66,0,1,0,1,0
63438,445,0,0,70,70,0,1,0,1,0
63165,445,0,0,68,68,0,1,0,1,0
53886,445,0,0,70,70,0,1,0,1,0
55490,445,0,0,70,70,0,1,0,1,0
61564,445,0,0,70,70,0,1,0,1,0
64153,445,0,0,70,70,0,1,0,1,0
64820,445,0,0,70,70,0,1,0,1,0
62082,445,0,0,70,70,0,1,0,1,0
64943,445,0,0,70,70,0,1,0,1,0
51481,445,0,0,70,70,0,1,0,1,0
64334,445,0,0,70,70,0,1,0,1,0
63811,445,0,0,67,67,0,1,0,1,0
54719,445,0,0,70,70,0,1,0,1,0
51991,445,0,0,69,69,0,1,0,1,0
55418,445,0,0,70,70,0,1,0,1,0
51415,445,0,0,70,70,0,1,0,1,0
53366,445,0,0,66,66,0,1,0,1,0
50910,445,0,0,70,70,0,1,0,1,0
62641,445,0,0,70,70,0,1,0,1,0
59799,445,0,0,70,70,0,1,0,1,0
64898,445,0,0,70,70,0,1,0,1,0
52891,445,0,0,70,70,0,1,0,1,0
58821,445,0,0,70,70,0,1,0,1,0
56128,445,0,0,70,70,0,1,0,1,0
61388,445,0,0,66,66,0,1,0,1,0
59089,445,0,0,70,70,0,1,0,1,0
63852,445,0,0,70,70,0,1,0,1,0
64695,445,0,0,70,70,0,1,0,1,0
58860,445,0,0,70,70,0,1,0,1,0
53624,445,0,0,66,66,0,1,0,1,0
50827,445,0,0,68,68,0,1,0,1,0
53118,445,0,0,70,70,0,1,0,1,0
49924,445,0,0,70,70,0,1,0,1,0
51262,445,0,0,66,66,0,1,0,1,0
51283,445,0,0,70,70,0,1,0,1,0
60509,445,0,0,67,67,0,1,0,1,0
56766,445,0,0,68,68,0,1,0,1,0
61763,445,0,0,70,70,0,1,0,1,0
54996,445,0,0,68,68,0,1,0,1,0
62075,445,0,0,68,68,0,1,0,1,0
59029,445,0,0,69,69,0,1,0,1,0
53769,445,0,0,69,69,0,1,0,1,0
63100,445,0,0,70,70,0,1,0,1,0
53756,445,0,0,66,66,0,1,0,1,0
54351,445,0,0,69,69,0,1,0,1,0
53329,445,0,0,70,70,0,1,0,1,0
55800,445,0,0,70,70,0,1,0,1,0
55721,445,0,0,70,70,0,1,0,1,0
50116,445,0,0,70,70,0,1,0,1,0
65314,445,0,0,70,70,0,1,0,1,0
56489,445,0,0,70,70,0,1,0,1,0
64070,445,0,0,70,70,0,1,0,1,0
50982,445,0,0,66,66,0,1,0,1,0
60438,445,0,0,66,66,0,1,0,1,0
50556,445,0,0,70,70,0,1,0,1,0
62423,445,0,0,66,66,0,1,0,1,0
49591,445,0,0,68,68,0,1,0,1,0
60931,445,0,0,70,70,0,1,0,1,0
52533,445,0,0,70,70,0,1,0,1,0
49305,445,0,0,70,70,0,1,0,1,0
60632,445,0,0,67,67,0,1,0,1,0
62039,445,0,0,70,70,0,1,0,1,0
52656,445,0,0,67,67,0,1,0,1,0
61441,445,0,0,69,69,0,1,0,1,0
50252,445,0,0,68,68,0,1,0,1,0
55644,445,0,0,70,70,0,1,0,1,0
57217,445,0,0,66,66,0,1,0,1,0
63971,445,0,0,69,69,0,1,0,1,0
56376,445,0,0,66,66,0,1,0,1,0
50423,445,0,0,70,70,0,1,0,1,0
55516,445,0,0,70,70,0,1,0,1,0
51080,445,0,0,66,66,0,1,0,1,0
51766,445,0,0,69,69,0,1,0,1,0
64210,445,0,0,70,70,0,1,0,1,0
61604,445,0,0,70,70,0,1,0,1,0
62423,445,0,0,66,66,0,1,0,1,0
56747,445,0,0,70,70,0,1,0,1,0
63310,445,0,0,66,66,0,1,0,1,0
52296,445,0,0,66,66,0,1,0,1,0
54662,445,0,0,70,70,0,1,0,1,0
62627,445,0,0,70,70,0,1,0,1,0
62540,445,0,0,66,66,0,1,0,1,0
49715,445,0,0,66,66,0,1,0,1,0
63271,445,0,0,70,70,0,1,0,1,0
60284,445,0,0,70,70,0,1,0,1,0
56533,445,0,0,67,67,0,1,0,1,0
59722,445,0,0,66,66,0,1,0,1,0
53272,445,0,0,70,70,0,1,0,1,0
65247,445,0,0,70,70,0,1,0,1,0
50077,445,0,0,68,68,0,1,0,1,0
55361,445,0,0,70,70,0,1,0,1,0
62960,445,0,0,70,70,0,1,0,1,0
61416,445,0,0,68,68,0,1,0,1,0
54320,445,0,0,66,66,0,1,0,1,0
52313,445,0,0,70,70,0,1,0,1,0
58792,445,0,0,67,67,0,1,0,1,0
50568,445,0,0,70,70,0,1,0,1,0
60912,445,0,0,70,70,0,1,0,1,0
51113,445,0,0,66,66,0,1,0,1,0
51791,445,0,0,70,70,0,1,0,1,0
51351,445,0,0,69,69,0,1,0,1,0
50397,445,0,0,66,66,0,1,0,1,0
62009,445,0,0,68,68,0,1,0,1,0
50478,445,0,0,70,70,0,1,0,1,0
62315,445,0,0,67,67,0,1,0,1,0
64345,445,0,0,66,66,0,1,0,1,0
56606,445,0,0,69,69,0,1,0,1,0
64515,445,0,0,70,70,0,1,0,1,0
58168,445,0,0,66,66,0,1,0,1,0
50663,445,0,0,68,68,0,1,0,1,0
63052,445,0,0,67,67,0,1,0,1,0
58792,445,0,0,70,70,0,1,0,1,0
53613,445,0,0,70,70,0,1,0,1,0
59394,445,0,0,70,70,0,1,0,1,0
50927,445,0,0,69,69,0,1,0,1,0
49451,445,0,0,70,70,0,1,0,1,0
64565,445,0,0,70,70,0,1,0,1,0
57001,445,0,0,70,70,0,1,0,1,0
64344,445,0,0,66,66,0,1,0,1,0
59481,445,0,0,70,70,0,1,0,1,0
52320,445,0,0,69,69,0,1,0,1,0
52326,445,0,0,67,67,0,1,0,1,0
55915,445,0,0,70,70,0,1,0,1,0
54791,445,0,0,70,70,0,1,0,1,0
55662,445,0,0,70,70,0,1,0,1,0
61590,445,0,0,70,70,0,1,0,1,0
60969,445,0,0,66,66,0,1,0,1,0
65069,445,0,0,70,70,0,1,0,1,0
52548,445,0,0,69,69,0,1,0,1,0
59344,445,0,0,70,70,0,1,0,1,0
57752,445,0,0,70,70,0,1,0,1,0
64166,445,0,0,66,66,0,1,0,1,0
61913,445,0,0,66,66,0,1,0,1,0
52630,445,0,0,70,70,0,1,0,1,0
51622,445,0,0,66,66,0,1,0,1,0
60116,445,0,0,70,70,0,1,0,1,0
63239,445,0,0,69,69,0,1,0,1,0
56275,445,0,0,66,66,0,1,0,1,0
60771,445,0,0,66,66,0,1,0,1,0
50264,445,0,0,70,70,0,1,0,1,0
61758,445,0,0,70,70,0,1,0,1,0
65268,445,0,0,70,70,0,1,0,1,0
63163,445,0,0,66,66,0,1,0,1,0
49957,445,0,0,68,68,0,1,0,1,0
50927,445,0,0,66,66,0,1,0,1,0
51296,445,0,0,70,70,0,1,0,1,0
55653,445,0,0,70,70,0,1,0,1,0
58154,445,0,0,70,70,0,1,0,1,0
54968,445,0,0,66,66,0,1,0,1,0
64696,445,0,0,70,70,0,1,0,1,0
63774,445,0,0,70,70,0,1,0,1,0
50997,445,0,0,69,69,0,1,0,1,0
53531,445,0,0,70,70,0,1,0,1,0
64443,445,0,0,68,68,0,1,0,1,0
50528,445,0,0,70,70,0,1,0,1,0
59141,445,0,0,66,66,0,1,0,1,0
55977,445,0,0,70,70,0,1,0,1,0
65179,445,0,0,68,68,0,1,0,1,0
61116,445,0,0,67,67,0,1,0,1,0
63911,445,0,0,70,70,0,1,0,1,0
61803,445,0,0,70,70,0,1,0,1,0
49863,445,0,0,70,70,0,1,0,1,0
59738,445,0,0,70,70,0,1,0,1,0
54786,445,0,0,70,70,0,1,0,1,0
58574,445,0,0,66,66,0,1,0,1,0
50226,445,0,0,70,70,0,1,0,1,0
58829,445,0,0,66,66,0,1,0,1,0
62124,445,0,0,70,70,0,1,0,1,0
49218,445,0,0,66,66,0,1,0,1,0
60142,445,0,0,70,70,0,1,0,1,0
60674,445,0,0,70,70,0,1,0,1,0
49327,445,0,0,68,68,0,1,0,1,0
55356,445,0,0,66,66,0,1,0,1,0
51616,445,0,0,70,70,0,1,0,1,0
50739,445,0,0,66,66,0,1,0,1,0
60680,445,0,0,70,70,0,1,0,1,0
61973,445,0,0,70,70,0,1,0,1,0
62276,445,0,0,70,70,0,1,0,1,0
56545,445,0,0,70,70,0,1,0,1,0
52418,445,0,0,70,70,0,1,0,1,0
64676,445,0,0,69,69,0,1,0,1,0
60559,445,0,0,70,70,0,1,0,1,0
55548,445,0,0,66,66,0,1,0,1,0
65198,445,0,0,70,70,0,1,0,1,0
54941,445,0,0,70,70,0,1,0,1,0
60436,445,0,0,66,66,0,1,0,1,0
56104,445,0,0,70,70,0,1,0,1,0
60336,445,0,0,70,70,0,1,0,1,0
56885,445,0,0,68,68,0,1,0,1,0
55812,445,0,0,67,67,0,1,0,1,0
64439,445,0,0,70,70,0,1,0,1,0
53010,445,0,0,68,68,0,1,0,1,0
64451,445,0,0,68,68,0,1,0,1,0
51067,445,0,0,70,70,0,1,0,1,0
61533,445,0,0,70,70,0,1,0,1,0
54643,445,0,0,70,70,0,1,0,1,0
64584,445,0,0,70,70,0,1,0,1,0
50499,445,0,0,70,70,0,1,0,1,0
59828,445,0,0,70,70,0,1,0,1,0
61140,445,0,0,70,70,0,1,0,1,0
59207,445,0,0,68,68,0,1,0,1,0
55744,445,0,0,66,66,0,1,0,1,0
54533,445,0,0,70,70,0,1,0,1,0
49567,445,0,0,66,66,0,1,0,1,0
61667,445,0,0,66,66,0,1,0,1,0
51007,445,0,0,70,70,0,1,0,1,0
58772,445,0,0,66,66,0,1,0,1,0
61816,445,0,0,70,70,0,1,0,1,0
57709,445,0,0,70,70,0,1,0,1,0
58273,445,0,0,68,68,0,1,0,1,0
51117,445,0,0,68,68,0,1,0,1,0
55098,445,0,0,70,70,0,1,0,1,0
54909,445,0,0,70,70,0,1,0,1,0
59661,445,0,0,67,67,0,1,0,1,0
64475,445,0,0,66,66,0,1,0,1,0
54858,445,0,0,69,69,0,1,0,1,0
54144,445,0,0,70,70,0,1,0,1,0
61145,445,0,0,70,70,0,1,0,1,0
50202,445,0,0,70,70,0,1,0,1,0
60743,445,0,0,70,70,0,1,0,1,0
60697,445,0,0,66,66,0,1,0,1,0
61602,445,0,0,70,70,0,1,0,1,0
53499,445,0,0,67,67,0,1,0,1,0
65327,445,0,0,70,70,0,1,0,1,0
57013,445,0,0,66,66,0,1,0,1,0
50347,445,0,0,70,70,0,1,0,1,0
57341,445,0,0,68,68,0,1,0,1,0
50557,445,0,0,70,70,0,1,0,1,0
63590,445,0,0,68,68,0,1,0,1,0
50998,445,0,0,70,70,0,1,0,1,0
57805,445,0,0,70,70,0,1,0,1,0
55417,445,0,0,70,70,0,1,0,1,0
59563,445,0,0,67,67,0,1,0,1,0
64686,445,0,0,70,70,0,1,0,1,0
55340,445,0,0,70,70,0,1,0,1,0
60946,445,0,0,70,70,0,1,0,1,0
59434,445,0,0,70,70,0,1,0,1,0
51502,445,0,0,66,66,0,1,0,1,0
64512,445,0,0,70,70,0,1,0,1,0
59399,445,0,0,70,70,0,1,0,1,0
50566,445,0,0,69,69,0,1,0,1,0
60953,445,0,0,66,66,0,1,0,1,0
56357,445,0,0,70,70,0,1,0,1,0
52553,445,0,0,70,70,0,1,0,1,0
51072,445,0,0,66,66,0,1,0,1,0
56066,445,0,0,66,66,0,1,0,1,0
56655,445,0,0,66,66,0,1,0,1,0
61778,445,0,0,66,66,0,1,0,1,0
54426,445,0,0,70,70,0,1,0,1,0
59524,445,0,0,70,70,0,1,0,1,0
63717,445,0,0,70,70,0,1,0,1,0
62361,445,0,0,69,69,0,1,0,1,0
49735,445,0,0,66,66,0,1,0,1,0
57430,445,0,0,67,67,0,1,0,1,0
51197,445,0,0,70,70,0,1,0,1,0
56049,445,0,0,67,67,0,1,0,1,0
58849,445,0,0,70,70,0,1,0,1,0
55506,445,0,0,70,70,0,1,0,1,0
61628,445,0,0,70,70,0,1,0,1,0
61139,445,0,0,70,70,0,1,0,1,0
52924,445,0,0,66,66,0,1,0,1,0
51583,445,0,0,70,70,0,1,0,1,0
57644,445,0,0,70,70,0,1,0,1,0
65418,445,0,0,70,70,0,1,0,1,0
56778,445,0,0,66,66,0,1,0,1,0
57675,445,0,0,70,70,0,1,0,1,0
56372,445,0,0,66,66,0,1,0,1,0
60970,445,0,0,69,69,0,1,0,1,0
58431,445,0,0,70,70,0,1,0,1,0
63180,445,0,0,66,66,0,1,0,1,0
53829,445,0,0,68,68,0,1,0,1,0
60833,445,0,0,70,70,0,1,0,1,0
50871,445,0,0,70,70,0,1,0,1,0
59125,445,0,0,67,67,0,1,0,1,0
61464,445,0,0,70,70,0,1,0,1,0
56341,445,0,0,70,70,0,1,0,1,0
54315,445,0,0,68,68,0,1,0,1,0
53525,445,0,0,70,70,0,1,0,1,0
51116,445,0,0,70,70,0,1,0,1,0
58434,445,0,0,70,70,0,1,0,1,0
58913,445,0,0,70,70,0,1,0,1,0
52689,445,0,0,70,70,0,1,0,1,0
61472,445,0,0,70,70,0,1,0,1,0
56810,445,0,0,70,70,0,1,0,1,0
55139,445,0,0,70,70,0,1,0,1,0
51147,445,0,0,68,68,0,1,0,1,0
50945,445,0,0,70,70,0,1,0,1,0
52714,445,0,0,70,70,0,1,0,1,0
64216,445,0,0,70,70,0,1,0,1,0
49411,445,0,0,67,67,0,1,0,1,0
55593,445,0,0,70,70,0,1,0,1,0
52690,445,0,0,70,70,0,1,0,1,0
64222,445,0,0,70,70,0,1,0,1,0
56977,445,0,0,70,70,0,1,0,1,0
58597,445,0,0,70,70,0,1,0,1,0
63830,445,0,0,69,69,0,1,0,1,0
50838,445,0,0,70,70,0,1,0,1,0
61574,445,0,0,69,69,0,1,0,1,0
53421,445,0,0,67,67,0,1,0,1,0
58307,445,0,0,66,66,0,1,0,1,0
63020,445,0,0,70,70,0,1,0,1,0
56459,445,0,0,67,67,0,1,0,1,0
63047,445,0,0,70,70,0,1,0,1,0
50288,445,0,0,70,70,0,1,0,1,0
56170,445,0,0,70,70,0,1,0,1,0
60545,445,0,0,70,70,0,1,0,1,0
57675,445,0,0,70,70,0,1,0,1,0
59442,445,0,0,70,70,0,1,0,1,0
55203,445,0,0,70,70,0,1,0,1,0
62517,445,0,0,70,70,0,1,0,1,0
56126,445,0,0,66,66,0,1,0,1,0
63871,445,0,0,70,70,0,1,0,1,0
57094,445,0,0,68,68,0,1,0,1,0
54188,445,0,0,66,66,0,1,0,1,0
61332,445,0,0,70,70,0,1,0,1,0
65395,445,0,0,69,69,0,1,0,1,0
50864,445,0,0,66,66,0,1,0,1,0
50604,445,0,0,70,70,0,1,0,1,0
61057,445,0,0,70,70,0,1,0,1,0
58029,445,0,0,70,70,0,1,0,1,0
63639,445,0,0,70,70,0,1,0,1,0
60315,445,0,0,66,66,0,1,0,1,0
51371,445,0,0,70,70,0,1,0,1,0
63883,445,0,0,66,66,0,1,0,1,0
52482,445,0,0,70,70,0,1,0,1,0
60896,445,0,0,66,66,0,1,0,1,0
61911,445,0,0,66,66,0,1,0,1,0
62254,445,0,0,70,70,0,1,0,1,0
58072,445,0,0,69,69,0,1,0,1,0
63624,445,0,0,67,67,0,1,0,1,0
52877,445,0,0,66,66,0,1,0,1,0
58483,445,0,0,66,66,0,1,0,1,0
61791,445,0,0,68,68,0,1,0,1,0
60458,445,0,0,70,70,0,1,0,1,0
64165,445,0,0,66,66,0,1,0,1,0
59199,445,0,0,66,66,0,1,0,1,0
56103,445,0,0,68,68,0,1,0,1,0
53560,445,0,0,66,66,0,1,0,1,0
57173,445,0,0,70,70,0,1,0,1,0
58706,445,0,0,66,66,0,1,0,1,0
58552,445,0,0,69,69,0,1,0,1,0
60191,445,0,0,70,70,0,1,0,1,0
54755,445,0,0,70,70,0,1,0,1,0
51362,445,0,0,67,67,0,1,0,1,0
56891,445,0,0,66,66,0,1,0,1,0
56190,445,0,0,70,70,0,1,0,1,0
50480,445,0,0,70,70,0,1,0,1,0
55930,445,0,0,67,67,0,1,0,1,0
49987,445,0,0,70,70,0,1,0,1,0
60013,445,0,0,70,70,0,1,0,1,0
56991,445,0,0,70,70,0,1,0,1,0
49793,445,0,0,70,70,0,1,0,1,0
56709,445,0,0,66,66,0,1,0,1,0
50617,445,0,0,70,70,0,1,0,1,0
55632,445,0,0,70,70,0,1,0,1,0
50999,445,0,0,70,70,0,1,0,1,0
51879,445,0,0,70,70,0,1,0,1,0
61141,445,0,0,70,70,0,1,0,1,0
56606,445,0,0,67,67,0,1,0,1,0
52885,445,0,0,70,70,0,1,0,1,0
64454,445,0,0,70,70,0,1,0,1,0
61749,445,0,0,68,68,0,1,0,1,0
56511,445,0,0,70,70,0,1,0,1,0
54409,445,0,0,66,66,0,1,0,1,0
55451,445,0,0,70,70,0,1,0,1,0
60931,445,0,0,66,66,0,1,0,1,0
64797,445,0,0,70,70,0,1,0,1,0
59890,445,0,0,70,70,0,1,0,1,0
56537,445,0,0,70,70,0,1,0,1,0
50018,445,0,0,70,70,0,1,0,1,0
58376,445,0,0,66,66,0,1,0,1,0
51691,445,0,0,70,70,0,1,0,1,0
52478,445,0,0,70,70,0,1,0,1,0
61244,445,0,0,70,70,0,1,0,1,0
57277,445,0,0,68,68,0,1,0,1,0
62146,445,0,0,70,70,0,1,0,1,0
64837,445,0,0,70,70,0,1,0,1,0
63985,445,0,0,70,70,0,1,0,1,0
60612,445,0,0,70,70,0,1,0,1,0
60905,445,0,0,70,70,0,1,0,1,0
53469,445,0,0,70,70,0,1,0,1,0
63239,445,0,0,66,66,0,1,0,1,0
62598,445,0,0,66,66,0,1,0,1,0
50257,445,0,0,70,70,0,1,0,1,0
52531,445,0,0,70,70,0,1,0,1,0
50293,445,0,0,70,70,0,1,0,1,0
50351,445,0,0,66,66,0,1,0,1,0
64287,445,0,0,67,67,0,1,0,1,0
52144,445,0,0,70,70,0,1,0,1,0
54285,445,0,0,66,66,0,1,0,1,0
52920,445,0,0,66,66,0,1,0,1,0
49772,445,0,0,70,70,0,1,0,1,0
54679,445,0,0,67,67,0,1,0,1,0
63258,445,0,0,69,69,0,1,0,1,0
63847,445,0,0,70,70,0,1,0,1,0
64119,445,0,0,68,68,0,1,0,1,0
50007,445,0,0,70,70,0,1,0,1,0
49546,445,0,0,68,68,0,1,0,1,0
63290,445,0,0,70,70,0,1,0,1,0
56805,445,0,0,70,70,0,1,0,1,0
54680,445,0,0,67,67,0,1,0,1,0
60632,445,0,0,70,70,0,1,0,1,0
53430,445,0,0,70,70,0,1,0,1,0
57495,445,0,0,70,70,0,1,0,1,0
63709,445,0,0,66,66,0,1,0,1,0
57094,445,0,0,66,66,0,1,0,1,0
52373,445,0,0,70,70,0,1,0,1,0
49399,445,0,0,70,70,0,1,0,1,0
57541,445,0,0,66,66,0,1,0,1,0
54388,445,0,0,70,70,0,1,0,1,0
53047,445,0,0,67,67,0,1,0,1,0
55631,445,0,0,70,70,0,1,0,1,0
55066,445,0,0,70,70,0,1,0,1,0
61015,445,0,0,70,70,0,1,0,1,0
54204,445,0,0,70,70,0,1,0,1,0
61734,445,0,0,66,66,0,1,0,1,0
50119,445,0,0,70,70,0,1,0,1,0
62212,445,0,0,70,70,0,1,0,1,0
55744,445,0,0,70,70,0,1,0,1,0
60903,445,0,0,66,66,0,1,0,1,0
63287,445,0,0,70,70,0,1,0,1,0
50930,445,0,0,66,66,0,1,0,1,0
51967,445,0,0,70,70,0,1,0,1,0
56834,445,0,0,66,66,0,1,0,1,0
51806,445,0,0,70,70,0,1,0,1,0
57386,445,0,0,66,66,0,1,0,1,0
60547,445,0,0,70,70,0,1,0,1,0
65028,445,0,0,70,70,0,1,0,1,0
55549,445,0,0,66,66,0,1,0,1,0
50535,445,0,0,66,66,0,1,0,1,0
63772,445,0,0,66,66,0,1,0,1,0
52845,445,0,0,69,69,0,1,0,1,0
53172,445,0,0,66,66,0,1,0,1,0
61276,445,0,0,69,69,0,1,0,1,0
64631,445,0,0,66,66,0,1,0,1,0
54144,445,0,0,70,70,0,1,0,1,0
63050,445,0,0,66,66,0,1,0,1,0
61554,445,0,0,70,70,0,1,0,1,0
58479,445,0,0,70,70,0,1,0,1,0
57476,445,0,0,66,66,0,1,0,1,0
49896,445,0,0,70,70,0,1,0,1,0
55604,445,0,0,67,67,0,1,0,1,0
56343,445,0,0,70,70,0,1,0,1,0
56665,445,0,0,70,70,0,1,0,1,0
63258,445,0,0,66,66,0,1,0,1,0
56239,445,0,0,70,70,0,1,0,1,0
57372,445,0,0,70,70,0,1,0,1,0
63300,445,0,0,70,70,0,1,0,1,0
53928,445,0,0,70,70,0,1,0,1,0
58740,445,0,0,70,70,0,1,0,1,0
63193,445,0,0,70,70,0,1,0,1,0
51528,445,0,0,70,70,0,1,0,1,0
61826,445,0,0,70,70,0,1,0,1,0
60762,445,0,0,66,66,0,1,0,1,0
52958,445,0,0,70,70,0,1,0,1,0
59017,445,0,0,66,66,0,1,0,1,0
56899,445,0,0,66,66,0,1,0,1,0
50887,445,0,0,68,68,0,1,0,1,0
64407,445,0,0,70,70,0,1,0,1,0
60602,445,0,0,70,70,0,1,0,1,0
54765,445,0,0,70,70,0,1,0,1,0
54050,445,0,0,70,70,0,1,0,1,0
57816,445,0,0,69,69,0,1,0,1,0
58272,445,0,0,66,66,0,1,0,1,0
58402,445,0,0,66,66,0,1,0,1,0
49872,445,0,0,70,70,0,1,0,1,0
55951,445,0,0,70,70,0,1,0,1,0
50731,445,0,0,69,69,0,1,0,1,0
52792,445,0,0,70,70,0,1,0,1,0
65151,445,0,0,67,67,0,1,0,1,0
61404,445,0,0,70,70,0,1,0,1,0
55531,445,0,0,70,70,0,1,0,1,0
55163,445,0,0,66,66,0,1,0,1,0
61809,445,0,0,69,69,0,1,0,1,0
58096,445,0,0,68,68,0,1,0,1,0
53429,445,0,0,66,66,0,1,0,1,0
61062,445,0,0,67,67,0,1,0,1,0
54108,445,0,0,70,70,0,1,0,1,0
64232,445,0,0,66,66,0,1,0,1,0
50779,445,0,0,70,70,0,1,0,1,0
65418,445,0,0,70,70,0,1,0,1,0
63305,445,0,0,69,69,0,1,0,1,0
64438,445,0,0,70,70,0,1,0,1,0
50950,445,0,0,68,68,0,1,0,1,0
51876,445,0,0,69,69,0,1,0,1,0
57870,445,0,0,70,70,0,1,0,1,0
60746,445,0,0,66,66,0,1,0,1,0
51121,445,0,0,66,66,0,1,0,1,0
56643,445,0,0,66,66,0,1,0,1,0
61995,445,0,0,70,70,0,1,0,1,0
62554,445,0,0,68,68,0,1,0,1,0
59251,445,0,0,70,70,0,1,0,1,0
57430,445,0,0,70,70,0,1,0,1,0
54494,445,0,0,70,70,0,1,0,1,0
52017,445,0,0,66,66,0,1,0,1,0
56786,445,0,0,70,70,0,1,0,1,0
52718,445,0,0,70,70,0,1,0,1,0
61848,445,0,0,66,66,0,1,0,1,0
56800,445,0,0,70,70,0,1,0,1,0
65079,445,0,0,70,70,0,1,0,1,0
57981,445,0,0,69,69,0,1,0,1,0
63068,445,0,0,69,69,0,1,0,1,0
58273,445,0,0,66,66,0,1,0,1,0
59091,445,0,0,68,68,0,1,0,1,0
49990,445,0,0,70,70,0,1,0,1,0
64013,445,0,0,70,70,0,1,0,1,0
53754,445,0,0,66,66,0,1,0,1,0
50118,445,0,0,70,70,0,1,0,1,0
53930,445,0,0,70,70,0,1,0,1,0
55645,445,0,0,70,70,0,1,0,1,0
49684,445,0,0,66,66,0,1,0,1,0
63330,445,0,0,66,66,0,1,0,1,0
51793,445,0,0,70,70,0,1,0,1,0
53016,445,0,0,70,70,0,1,0,1,0
62667,445,0,0,70,70,0,1,0,1,0
57427,445,0,0,67,67,0,1,0,1,0
55919,445,0,0,66,66,0,1,0,1,0
49991,445,0,0,70,70,0,1,0,1,0
50885,445,0,0,66,66,0,1,0,1,0
58760,445,0,0,66,66,0,1,0,1,0
55709,445,0,0,70,70,0,1,0,1,0
53382,445,0,0,70,70,0,1,0,1,0
61211,445,0,0,66,66,0,1,0,1,0
53634,445,0,0,70,70,0,1,0,1,0
61248,445,0,0,70,70,0,1,0,1,0
63132,445,0,0,66,66,0,1,0,1,0
62875,445,0,0,66,66,0,1,0,1,0
50096,445,0,0,70,70,0,1,0,1,0
51422,445,0,0,66,66,0,1,0,1,0
55907,445,0,0,70,70,0,1,0,1,0
62641,445,0,0,68,68,0,1,0,1,0
52012,445,0,0,70,70,0,1,0,1,0
56255,445,0,0,68,68,0,1,0,1,0
52626,445,0,0,70,70,0,1,0,1,0
64460,445,0,0,70,70,0,1,0,1,0
54937,445,0,0,70,70,0,1,0,1,0
61875,445,0,0,67,67,0,1,0,1,0
50658,445,0,0,68,68,0,1,0,1,0
57912,445,0,0,66,66,0,1,0,1,0
59851,445,0,0,66,66,0,1,0,1,0
57474,445,0,0,66,66,0,1,0,1,0
63360,445,0,0,70,70,0,1,0,1,0
58933,445,0,0,70,70,0,1,0,1,0
55321,445,0,0,70,70,0,1,0,1,0
58093,445,0,0,70,70,0,1,0,1,0
55866,445,0,0,66,66,0,1,0,1,0
65111,445,0,0,69,69,0,1,0,1,0
51701,445,0,0,66,66,0,1,0,1,0
50676,445,0,0,70,70,0,1,0,1,0
60138,445,0,0,70,70,0,1,0,1,0
51881,445,0,0,66,66,0,1,0,1,0
63385,445,0,0,67,67,0,1,0,1,0
50619,445,0,0,70,70,0,1,0,1,0
65312,445,0,0,70,70,0,1,0,1,0
52918,445,0,0,69,69,0,1,0,1,0
61589,445,0,0,66,66,0,1,0,1,0
62389,445,0,0,66,66,0,1,0,1,0
58015,445,0,0,70,70,0,1,0,1,0
59435,445,0,0,66,66,0,1,0,1,0
59840,445,0,0,66,66,0,1,0,1,0
61301,445,0,0,70,70,0,1,0,1,0
52850,445,0,0,70,70,0,1,0,1,0
56870,445,0,0,70,70,0,1,0,1,0
51331,445,0,0,70,70,0,1,0,1,0
63571,445,0,0,66,66,0,1,0,1,0
54260,445,0,0,66,66,0,1,0,1,0
56264,445,0,0,66,66,0,1,0,1,0
51883,445,0,0,70,70,0,1,0,1,0
50100,445,0,0,70,70,0,1,0,1,0
55083,445,0,0,67,67,0,1,0,1,0
62532,445,0,0,70,70,0,1,0,1,0
56270,445,0,0,70,70,0,1,0,1,0
59441,445,0,0,70,70,0,1,0,1,0
54016,445,0,0,70,70,0,1,0,1,0
65526,445,0,0,70,70,0,1,0,1,0
62282,445,0,0,66,66,0,1,0,1,0
51385,445,0,0,70,70,0,1,0,1,0
50777,445,0,0,70,70,0,1,0,1,0
58056,445,0,0,66,66,0,1,0,1,0
62789,445,0,0,69,69,0,1,0,1,0
64301,445,0,0,67,67,0,1,0,1,0
52859,445,0,0,70,70,0,1,0,1,0
58574,445,0,0,69,69,0,1,0,1,0
52788,445,0,0,66,66,0,1,0,1,0
49331,445,0,0,66,66,0,1,0,1,0
53520,445,0,0,70,70,0,1,0,1,0
59403,445,0,0,70,70,0,1,0,1,0
49401,445,0,0,67,67,0,1,0,1,0
54250,445,0,0,70,70,0,1,0,1,0
57790,445,0,0,68,68,0,1,0,1,0
55741,445,0,0,66,66,0,1,0,1,0
58432,445,0,0,66,66,0,1,0,1,0
63175,445,0,0,67,67,0,1,0,1,0
53280,445,0,0,67,67,0,1,0,1,0
54613,445,0,0,70,70,0,1,0,1,0
63126,445,0,0,69,69,0,1,0,1,0
52859,445,0,0,70,70,0,1,0,1,0
58755,445,0,0,66,66,0,1,0,1,0
54251,445,0,0,70,70,0,1,0,1,0
53819,445,0,0,70,70,0,1,0,1,0
52484,445,0,0,67,67,0,1,0,1,0
57452,445,0,0,70,70,0,1,0,1,0
54390,445,0,0,70,70,0,1,0,1,0
56550,445,0,0,70,70,0,1,0,1,0
50905,445,0,0,70,70,0,1,0,1,0
58116,445,0,0,66,66,0,1,0,1,0
61791,445,0,0,66,66,0,1,0,1,0
60548,445,0,0,66,66,0,1,0,1,0
56450,445,0,0,66,66,0,1,0,1,0
55042,445,0,0,70,70,0,1,0,1,0
63149,445,0,0,70,70,0,1,0,1,0
62392,445,0,0,70,70,0,1,0,1,0
59476,445,0,0,68,68,0,1,0,1,0
56868,445,0,0,70,70,0,1,0,1,0
65013,445,0,0,69,69,0,1,0,1,0
61949,445,0,0,67,67,0,1,0,1,0
52220,445,0,0,70,70,0,1,0,1,0
49215,445,0,0,68,68,0,1,0,1,0
54329,445,0,0,66,66,0,1,0,1,0
64584,445,0,0,68,68,0,1,0,1,0
65002,445,0,0,70,70,0,1,0,1,0
50594,445,0,0,66,66,0,1,0,1,0
52020,445,0,0,68,68,0,1,0,1,0
60984,445,0,0,70,70,0,1,0,1,0
64623,445,0,0,67,67,0,1,0,1,0
55445,445,0,0,70,70,0,1,0,1,0
62564,445,0,0,66,66,0,1,0,1,0
60867,445,0,0,70,70,0,1,0,1,0
64742,445,0,0,70,70,0,1,0,1,0
50225,445,0,0,66,66,0,1,0,1,0
55339,445,0,0,70,70,0,1,0,1,0
64591,445,0,0,70,70,0,1,0,1,0
55341,445,0,0,70,70,0,1,0,1,0
50437,445,0,0,70,70,0,1,0,1,0
55548,445,0,0,66,66,0,1,0,1,0
53376,445,0,0,66,66,0,1,0,1,0
53722,445,0,0,70,70,0,1,0,1,0
53706,445,0,0,66,66,0,1,0,1,0
49878,445,0,0,66,66,0,1,0,1,0
60518,445,0,0,70,70,0,1,0,1,0
62225,445,0,0,69,69,0,1,0,1,0
50735,445,0,0,70,70,0,1,0,1,0
52694,445,0,0,70,70,0,1,0,1,0
49938,445,0,0,70,70,0,1,0,1,0
55479,445,0,0,70,70,0,1,0,1,0
59696,445,0,0,70,70,0,1,0,1,0
54329,445,0,0,67,67,0,1,0,1,0
49713,445,0,0,66,66,0,1,0,1,0
58887,445,0,0,66,66,0,1,0,1,0
55530,445,0,0,70,70,0,1,0,1,0
61404,445,0,0,66,66,0,1,0,1,0
58154,445,0,0,70,70,0,1,0,1,0
50748,445,0,0,66,66,0,1,0,1,0
63750,445,0,0,70,70,0,1,0,1,0
59440,445,0,0,68,68,0,1,0,1,0
57451,445,0,0,70,70,0,1,0,1,0
56872,445,0,0,70,70,0,1,0,1,0
62685,445,0,0,70,70,0,1,0,1,0
50470,445,0,0,66,66,0,1,0,1,0
58481,445,0,0,67,67,0,1,0,1,0
64394,445,0,0,70,70,0,1,0,1,0
60728,445,0,0,70,70,0,1,0,1,0
60555,445,0,0,70,70,0,1,0,1,0
56130,445,0,0,70,70,0,1,0,1,0
53637,445,0,0,70,70,0,1,0,1,0
63702,445,0,0,69,69,0,1,0,1,0
64686,445,0,0,70,70,0,1,0,1,0
63540,445,0,0,70,70,0,1,0,1,0
61277,445,0,0,66,66,0,1,0,1,0
64303,445,0,0,66,66,0,1,0,1,0
55938,445,0,0,68,68,0,1,0,1,0
51941,445,0,0,66,66,0,1,0,1,0
55288,445,0,0,69,69,0,1,0,1,0
55976,445,0,0,70,70,0,1,0,1,0
52009,445,0,0,66,66,0,1,0,1,0
53317,445,0,0,66,66,0,1,0,1,0
50897,445,0,0,70,70,0,1,0,1,0
49881,445,0,0,70,70,0,1,0,1,0
55130,445,0,0,70,70,0,1,0,1,0
60868,445,0,0,70,70,0,1,0,1,0
64063,445,0,0,66,66,0,1,0,1,0
56899,445,0,0,70,70,0,1,0,1,0
57675,445,0,0,70,70,0,1,0,1,0
55837,445,0,0,70,70,0,1,0,1,0
51204,445,0,0,70,70,0,1,0,1,0
53745,445,0,0,70,70,0,1,0,1,0
61549,445,0,0,70,70,0,1,0,1,0
49161,445,0,0,70,70,0,1,0,1,0
57773,445,0,0,70,70,0,1,0,1,0
54586,445,0,0,66,66,0,1,0,1,0
56937,445,0,0,70,70,0,1,0,1,0
60990,445,0,0,70,70,0,1,0,1,0
61318,445,0,0,66,66,0,1,0,1,0
65031,445,0,0,70,70,0,1,0,1,0
55227,445,0,0,69,69,0,1,0,1,0
63237,445,0,0,70,70,0,1,0,1,0
61333,445,0,0,66,66,0,1,0,1,0
52277,445,0,0,69,69,0,1,0,1,0
64593,445,0,0,70,70,0,1,0,1,0
64677,445,0,0,66,66,0,1,0,1,0
64550,445,0,0,66,66,0,1,0,1,0
61375,445,0,0,70,70,0,1,0,1,0
56393,445,0,0,70,70,0,1,0,1,0
53706,445,0,0,67,67,0,1,0,1,0
55159,445,0,0,66,66,0,1,0,1,0
61732,445,0,0,70,70,0,1,0,1,0
51065,445,0,0,66,66,0,1,0,1,0
49908,445,0,0,66,66,0,1,0,1,0
53805,445,0,0,66,66,0,1,0,1,0
56343,445,0,0,70,70,0,1,0,1,0
65517,445,0,0,66,66,0,1,0,1,0
64347,445,0,0,70,70,0,1,0,1,0
51968,445,0,0,70,70,0,1,0,1,0
51175,445,0,0,70,70,0,1,0,1,0
52768,445,0,0,69,69,0,1,0,1,0
63685,445,0,0,70,70,0,1,0,1,0
53880,445,0,0,66,66,0,1,0,1,0
62105,445,0,0,66,66,0,1,0,1,0
50582,445,0,0,69,69,0,1,0,1,0
62104,445,0,0,66,66,0,1,0,1,0
50998,445,0,0,66,66,0,1,0,1,0
54964,445,0,0,67,67,0,1,0,1,0
63017,445,0,0,66,66,0,1,0,1,0
60148,445,0,0,70,70,0,1,0,1,0
57102,445,0,0,70,70,0,1,0,1,0
63872,445,0,0,70,70,0,1,0,1,0
50711,445,0,0,70,70,0,1,0,1,0
55568,445,0,0,70,70,0,1,0,1,0
49447,445,0,0,70,70,0,1,0,1,0
52481,445,0,0,68,68,0,1,0,1,0
63004,445,0,0,70,70,0,1,0,1,0
60504,445,0,0,66,66,0,1,0,1,0
61850,445,0,0,66,66,0,1,0,1,0
53547,445,0,0,67,67,0,1,0,1,0
50161,445,0,0,68,68,0,1,0,1,0
51333,445,0,0,70,70,0,1,0,1,0
58295,445,0,0,70,70,0,1,0,1,0
52502,445,0,0,70,70,0,1,0,1,0
60985,445,0,0,70,70,0,1,0,1,0
55130,445,0,0,70,70,0,1,0,1,0
64414,445,0,0,70,70,0,1,0,1,0
57259,445,0,0,70,70,0,1,0,1,0
55582,445,0,0,70,70,0,1,0,1,0
60910,445,0,0,70,70,0,1,0,1,0
50607,445,0,0,66,66,0,1,0,1,0
54958,445,0,0,68,68,0,1,0,1,0
64937,445,0,0,66,66,0,1,0,1,0
52887,445,0,0,70,70,0,1,0,1,0
61008,445,0,0,66,66,0,1,0,1,0
63338,445,0,0,70,70,0,1,0,1,0
62685,445,0,0,70,70,0,1,0,1,0
56434,445,0,0,66,66,0,1,0,1,0
51202,445,0,0,70,70,0,1,0,1,0
59207,445,0,0,70,70,0,1,0,1,0
62529,445,0,0,70,70,0,1,0,1,0
57115,445,0,0,70,70,0,1,0,1,0
59732,445,0,0,70,70,0,1,0,1,0
59610,445,0,0,70,70,0,1,0,1,0
64121,445,0,0,69,69,0,1,0,1,0
53793,445,0,0,70,70,0,1,0,1,0
49643,445,0,0,70,70,0,1,0,1,0
64837,445,0,0,70,70,0,1,0,1,0
65350,445,0,0,66,66,0,1,0,1,0
53760,445,0,0,70,70,0,1,0,1,0
55724,445,0,0,70,70,0,1,0,1,0
49621,445,0,0,70,70,0,1,0,1,0
55893,445,0,0,68,68,0,1,0,1,0
63004,445,0,0,70,70,0,1,0,1,0
64654,445,0,0,70,70,0,1,0,1,0
62812,445,0,0,66,66,0,1,0,1,0
63447,445,0,0,70,70,0,1,0,1,0
59712,445,0,0,68,68,0,1,0,1,0
59588,445,0,0,70,70,0,1,0,1,0
60559,445,0,0,70,70,0,1,0,1,0
55714,445,0,0,70,70,0,1,0,1,0
54652,445,0,0,66,66,0,1,0,1,0
63910,445,0,0,70,70,0,1,0,1,0
49819,445,0,0,70,70,0,1,0,1,0
60936,445,0,0,66,66,0,1,0,1,0
52922,445,0,0,66,66,0,1,0,1,0
60436,445,0,0,66,66,0,1,0,1,0
51877,445,0,0,70,70,0,1,0,1,0
49953,445,0,0,66,66,0,1,0,1,0
64563,445,0,0,70,70,0,1,0,1,0
53481,445,0,0,70,70,0,1,0,1,0
64432,445,0,0,70,70,0,1,0,1,0
50779,445,0,0,68,68,0,1,0,1,0
57857,445,0,0,70,70,0,1,0,1,0
54397,445,0,0,66,66,0,1,0,1,0
55123,445,0,0,66,66,0,1,0,1,0
49647,445,0,0,67,67,0,1,0,1,0
63001,445,0,0,66,66,0,1,0,1,0
54318,445,0,0,66,66,0,1,0,1,0
58691,445,0,0,70,70,0,1,0,1,0
50501,445,0,0,67,67,0,1,0,1,0
49761,445,0,0,68,68,0,1,0,1,0
56391,445,0,0,66,66,0,1,0,1,0
51974,445,0,0,66,66,0,1,0,1,0
58933,445,0,0,67,67,0,1,0,1,0
51383,445,0,0,70,70,0,1,0,1,0
54950,445,0,0,70,70,0,1,0,1,0
54626,445,0,0,70,70,0,1,0,1,0
58295,445,0,0,68,68,0,1,0,1,0
59787,445,0,0,66,66,0,1,0,1,0
51552,445,0,0,70,70,0,1,0,1,0
55317,445,0,0,67,67,0,1,0,1,0
60761,445,0,0,70,70,0,1,0,1,0
63596,445,0,0,66,66,0,1,0,1,0
57215,445,0,0,70,70,0,1,0,1,0
64512,445,0,0,70,70,0,1,0,1,0
57360,445,0,0,66,66,0,1,0,1,0
56702,445,0,0,70,70,0,1,0,1,0
61163,445,0,0,66,66,0,1,0,1,0
64679,445,0,0,66,66,0,1,0,1,0
49448,445,0,0,70,70,0,1,0,1,0
60856,445,0,0,70,70,0,1,0,1,0
64010,445,0,0,70,70,0,1,0,1,0
58548,445,0,0,66,66,0,1,0,1,0
63561,445,0,0,70,70,0,1,0,1,0
50030,445,0,0,68,68,0,1,0,1,0
50557,445,0,0,70,70,0,1,0,1,0
56639,445,0,0,70,70,0,1,0,1,0
63330,445,0,0,66,66,0,1,0,1,0
59377,445,0,0,70,70,0,1,0,1,0
54848,445,0,0,68,68,0,1,0,1,0
64414,445,0,0,70,70,0,1,0,1,0
63900,445,0,0,66,66,0,1,0,1,0
59073,445,0,0,70,70,0,1,0,1,0
53493,445,0,0,70,70,0,1,0,1,0
60473,445,0,0,70,70,0,1,0,1,0
62294,445,0,0,68,68,0,1,0,1,0
61510,445,0,0,70,70,0,1,0,1,0
53638,445,0,0,66,66,0,1,0,1,0
50066,445,0,0,70,70,0,1,0,1,0
53074,445,0,0,70,70,0,1,0,1,0
54053,445,0,0,70,70,0,1,0,1,0
55324,445,0,0,70,70,0,1,0,1,0
50367,445,0,0,66,66,0,1,0,1,0
64875,445,0,0,66,66,0,1,0,1,0
55274,445,0,0,70,70,0,1,0,1,0
64052,445,0,0,70,70,0,1,0,1,0
51011,445,0,0,70,70,0,1,0,1,0
52397,445,0,0,66,66,0,1,0,1,0
61415,445,0,0,66,66,0,1,0,1,0
58258,445,0,0,66,66,0,1,0,1,0
59470,445,0,0,66,66,0,1,0,1,0
51415,445,0,0,70,70,0,1,0,1,0
49938,445,0,0,69,69,0,1,0,1,0
50167,445,0,0,70,70,0,1,0,1,0
50263,445,0,0,66,66,0,1,0,1,0
58682,445,0,0,66,66,0,1,0,1,0
57156,445,0,0,66,66,0,1,0,1,0
55129,445,0,0,70,70,0,1,0,1,0
55031,445,0,0,70,70,0,1,0,1,0
51083,445,0,0,69,69,0,1,0,1,0
55054,445,0,0,69,69,0,1,0,1,0
52791,445,0,0,70,70,0,1,0,1,0
51802,445,0,0,70,70,0,1,0,1,0
50817,445,0,0,68,68,0,1,0,1,0
52335,445,0,0,69,69,0,1,0,1,0
53727,445,0,0,70,70,0,1,0,1,0
63787,445,0,0,70,70,0,1,0,1,0
56753,445,0,0,70,70,0,1,0,1,0
51056,445,0,0,66,66,0,1,0,1,0
61185,445,0,0,70,70,0,1,0,1,0
51651,445,0,0,66,66,0,1,0,1,0
55330,445,0,0,70,70,0,1,0,1,0
63811,445,0,0,70,70,0,1,0,1,0
58532,445,0,0,70,70,0,1,0,1,0
59066,445,0,0,70,70,0,1,0,1,0
61405,445,0,0,70,70,0,1,0,1,0
54867,445,0,0,69,69,0,1,0,1,0
50780,445,0,0,66,66,0,1,0,1,0
50170,445,0,0,70,70,0,1,0,1,0
52021,445,0,0,68,68,0,1,0,1,0
63687,445,0,0,70,70,0,1,0,1,0
64126,445,0,0,70,70,0,1,0,1,0
50720,445,0,0,66,66,0,1,0,1,0
64981,445,0,0,70,70,0,1,0,1,0
58313,445,0,0,70,70,0,1,0,1,0
51308,445,0,0,66,66,0,1,0,1,0
50781,445,0,0,70,70,0,1,0,1,0
63624,445,0,0,70,70,0,1,0,1,0
51269,445,0,0,70,70,0,1,0,1,0
63211,445,0,0,66,66,0,1,0,1,0
52269,445,0,0,66,66,0,1,0,1,0
61806,445,0,0,70,70,0,1,0,1,0
50466,445,0,0,66,66,0,1,0,1,0
58944,445,0,0,69,69,0,1,0,1,0
64200,445,0,0,70,70,0,1,0,1,0
55035,445,0,0,70,70,0,1,0,1,0
50643,445,0,0,70,70,0,1,0,1,0
51903,445,0,0,69,69,0,1,0,1,0
49499,445,0,0,70,70,0,1,0,1,0
55332,445,0,0,70,70,0,1,0,1,0
62127,445,0,0,70,70,0,1,0,1,0
64632,445,0,0,66,66,0,1,0,1,0
57970,445,0,0,66,66,0,1,0,1,0
51370,445,0,0,70,70,0,1,0,1,0
60245,445,0,0,70,70,0,1,0,1,0
59918,445,0,0,66,66,0,1,0,1,0
64585,445,0,0,66,66,0,1,0,1,0
53594,445,0,0,70,70,0,1,0,1,0
50280,445,0,0,66,66,0,1,0,1,0
50018,445,0,0,70,70,0,1,0,1,0
63004,445,0,0,66,66,0,1,0,1,0
64084,445,0,0,69,69,0,1,0,1,0
62136,445,0,0,70,70,0,1,0,1,0
52484,445,0,0,70,70,0,1,0,1,0
50530,445,0,0,70,70,0,1,0,1,0
55706,445,0,0,70,70,0,1,0,1,0
65269,445,0,0,66,66,0,1,0,1,0
57605,445,0,0,66,66,0,1,0,1,0
51619,445,0,0,70,70,0,1,0,1,0
61875,445,0,0,66,66,0,1,0,1,0
63193,445,0,0,70,70,0,1,0,1,0
50902,445,0,0,70,70,0,1,0,1,0
49784,445,0,0,70,70,0,1,0,1,0
52256,445,0,0,68,68,0,1,0,1,0
52666,445,0,0,67,67,0,1,0,1,0
49971,445,0,0,70,70,0,1,0,1,0
55223,445,0,0,67,67,0,1,0,1,0
62983,445,0,0,68,68,0,1,0,1,0
56765,445,0,0,67,67,0,1,0,1,0
59843,445,0,0,70,70,0,1,0,1,0
64072,445,0,0,70,70,0,1,0,1,0
61721,445,0,0,70,70,0,1,0,1,0
60429,445,0,0,70,70,0,1,0,1,0
57963,445,0,0,70,70,0,1,0,1,0
52149,445,0,0,69,69,0,1,0,1,0
55953,445,0,0,68,68,0,1,0,1,0
51363,445,0,0,68,68,0,1,0,1,0
56845,445,0,0,70,70,0,1,0,1,0
60407,445,0,0,69,69,0,1,0,1,0
63665,445,0,0,70,70,0,1,0,1,0
64102,445,0,0,70,70,0,1,0,1,0
51217,445,0,0,70,70,0,1,0,1,0
49926,445,0,0,70,70,0,1,0,1,0
54647,445,0,0,70,70,0,1,0,1,0
61701,445,0,0,66,66,0,1,0,1,0
51022,445,0,0,70,70,0,1,0,1,0
58244,445,0,0,70,70,0,1,0,1,0
55116,445,0,0,66,66,0,1,0,1,0
55159,445,0,0,70,70,0,1,0,1,0
55875,445,0,0,70,70,0,1,0,1,0
50361,445,0,0,70,70,0,1,0,1,0
59214,445,0,0,70,70,0,1,0,1,0
58327,445,0,0,68,68,0,1,0,1,0
62685,445,0,0,70,70,0,1,0,1,0
59530,445,0,0,66,66,0,1,0,1,0
63510,445,0,0,69,69,0,1,0,1,0
57221,445,0,0,66,66,0,1,0,1,0
59332,445,0,0,66,66,0,1,0,1,0
60218,445,0,0,70,70,0,1,0,1,0
54701,445,0,0,70,70,0,1,0,1,0
50304,445,0,0,70,70,0,1,0,1,0
63965,445,0,0,67,67,0,1,0,1,0
58316,445,0,0,70,70,0,1,0,1,0
54245,445,0,0,66,66,0,1,0,1,0
59216,445,0,0,70,70,0,1,0,1,0
64333,445,0,0,70,70,0,1,0,1,0
62980,445,0,0,70,70,0,1,0,1,0
50352,445,0,0,66,66,0,1,0,1,0
52565,445,0,0,70,70,0,1,0,1,0
49715,445,0,0,66,66,0,1,0,1,0
52226,445,0,0,70,70,0,1,0,1,0
60952,445,0,0,66,66,0,1,0,1,0
56166,445,0,0,70,70,0,1,0,1,0
56709,445,0,0,66,66,0,1,0,1,0
50796,445,0,0,70,70,0,1,0,1,0
51524,445,0,0,69,69,0,1,0,1,0
56581,445,0,0,70,70,0,1,0,1,0
63849,445,0,0,70,70,0,1,0,1,0
60443,445,0,0,70,70,0,1,0,1,0
64720,445,0,0,70,70,0,1,0,1,0
58628,445,0,0,66,66,0,1,0,1,0
59204,445,0,0,70,70,0,1,0,1,0
56470,445,0,0,70,70,0,1,0,1,0
53926,445,0,0,70,70,0,1,0,1,0
60422,445,0,0,69,69,0,1,0,1,0
50422,445,0,0,70,70,0,1,0,1,0
60375,445,0,0,70,70,0,1,0,1,0
51080,445,0,0,69,69,0,1,0,1,0
62597,445,0,0,69,69,0,1,0,1,0
62445,445,0,0,70,70,0,1,0,1,0
64688,445,0,0,69,69,0,1,0,1,0
60610,445,0,0,70,70,0,1,0,1,0
58483,445,0,0,68,68,0,1,0,1,0
52735,445,0,0,70,70,0,1,0,1,0
62925,445,0,0,68,68,0,1,0,1,0
57515,445,0,0,70,70,0,1,0,1,0
55074,445,0,0,70,70,0,1,0,1,0
55273,445,0,0,70,70,0,1,0,1,0
52665,445,0,0,66,66,0,1,0,1,0
50623,445,0,0,68,68,0,1,0,1,0
56673,445,0,0,70,70,0,1,0,1,0
61866,445,0,0,67,67,0,1,0,1,0
62664,445,0,0,66,66,0,1,0,1,0
58731,445,0,0,70,70,0,1,0,1,0
55591,445,0,0,70,70,0,1,0,1,0
61973,445,0,0,68,68,0,1,0,1,0
55233,445,0,0,70,70,0,1,0,1,0
49926,445,0,0,70,70,0,1,0,1,0
61252,445,0,0,70,70,0,1,0,1,0
56581,445,0,0,70,70,0,1,0,1,0
61702,445,0,0,66,66,0,1,0,1,0
65436,445,0,0,66,66,0,1,0,1,0
51209,445,0,0,66,66,0,1,0,1,0
50868,445,0,0,70,70,0,1,0,1,0
63441,445,0,0,70,70,0,1,0,1,0
57634,445,0,0,66,66,0,1,0,1,0
59821,445,0,0,70,70,0,1,0,1,0
50520,445,0,0,70,70,0,1,0,1,0
51551,445,0,0,70,70,0,1,0,1,0
52449,445,0,0,68,68,0,1,0,1,0
63028,445,0,0,70,70,0,1,0,1,0
63543,445,0,0,69,69,0,1,0,1,0
65294,445,0,0,70,70,0,1,0,1,0
64895,445,0,0,70,70,0,1,0,1,0
50650,445,0,0,70,70,0,1,0,1,0
51491,445,0,0,69,69,0,1,0,1,0
63775,445,0,0,66,66,0,1,0,1,0
51452,445,0,0,70,70,0,1,0,1,0
61863,445,0,0,70,70,0,1,0,1,0
64611,445,0,0,69,69,0,1,0,1,0
59573,445,0,0,70,70,0,1,0,1,0
53690,445,0,0,70,70,0,1,0,1,0
58822,445,0,0,70,70,0,1,0,1,0
65487,445,0,0,70,70,0,1,0,1,0
51929,445,0,0,70,70,0,1,0,1,0
61803,445,0,0,70,70,0,1,0,1,0
49199,445,0,0,67,67,0,1,0,1,0
63049,445,0,0,69,69,0,1,0,1,0
53579,445,0,0,67,67,0,1,0,1,0
57044,445,0,0,66,66,0,1,0,1,0
50208,445,0,0,66,66,0,1,0,1,0
52694,445,0,0,70,70,0,1,0,1,0
53489,445,0,0,70,70,0,1,0,1,0
56746,445,0,0,68,68,0,1,0,1,0
59400,445,0,0,66,66,0,1,0,1,0
53174,445,0,0,66,66,0,1,0,1,0
49363,445,0,0,68,68,0,1,0,1,0
60423,445,0,0,70,70,0,1,0,1,0
58867,445,0,0,66,66,0,1,0,1,0
61850,445,0,0,66,66,0,1,0,1,0
58164,445,0,0,68,68,0,1,0,1,0
57344,445,0,0,67,67,0,1,0,1,0
53747,445,0,0,70,70,0,1,0,1,0
56737,445,0,0,70,70,0,1,0,1,0
50299,445,0,0,70,70,0,1,0,1,0
58396,445,0,0,70,70,0,1,0,1,0
60958,445,0,0,70,70,0,1,0,1,0
61553,445,0,0,70,70,0,1,0,1,0
51419,445,0,0,70,70,0,1,0,1,0
52562,445,0,0,67,67,0,1,0,1,0
56014,445,0,0,69,69,0,1,0,1,0
53930,445,0,0,66,66,0,1,0,1,0
50460,445,0,0,70,70,0,1,0,1,0
51638,445,0,0,67,67,0,1,0,1,0
64017,445,0,0,66,66,0,1,0,1,0
52710,445,0,0,68,68,0,1,0,1,0
56784,445,0,0,69,69,0,1,0,1,0
63259,445,0,0,70,70,0,1,0,1,0
58526,445,0,0,70,70,0,1,0,1,0
59611,445,0,0,70,70,0,1,0,1,0
52483,445,0,0,70,70,0,1,0,1,0
65497,445,0,0,70,70,0,1,0,1,0
61880,445,0,0,70,70,0,1,0,1,0
61532,445,0,0,70,70,0,1,0,1,0
56412,445,0,0,70,70,0,1,0,1,0
61831,445,0,0,66,66,0,1,0,1,0
60675,445,0,0,66,66,0,1,0,1,0
63540,445,0,0,70,70,0,1,0,1,0
54064,445,0,0,70,70,0,1,0,1,0
51034,445,0,0,70,70,0,1,0,1,0
58511,445,0,0,70,70,0,1,0,1,0
62134,445,0,0,68,68,0,1,0,1,0
49907,445,0,0,70,70,0,1,0,1,0
49165,445,0,0,70,70,0,1,0,1,0
65282,445,0,0,67,67,0,1,0,1,0
59621,445,0,0,69,69,0,1,0,1,0
50170,445,0,0,70,70,0,1,0,1,0
50927,445,0,0,66,66,0,1,0,1,0
61316,445,0,0,67,67,0,1,0,1,0
60402,445,0,0,70,70,0,1,0,1,0
60594,445,0,0,67,67,0,1,0,1,0
65096,445,0,0,70,70,0,1,0,1,0
56028,445,0,0,70,70,0,1,0,1,0
59724,445,0,0,69,69,0,1,0,1,0
56224,445,0,0,66,66,0,1,0,1,0
61388,445,0,0,66,66,0,1,0,1,0
53423,445,0,0,68,68,0,1,0,1,0
54399,445,0,0,69,69,0,1,0,1,0
57365,445,0,0,69,69,0,1,0,1,0
64515,445,0,0,70,70,0,1,0,1,0
51438,445,0,0,70,70,0,1,0,1,0
64308,445,0,0,70,70,0,1,0,1,0
54649,445,0,0,66,66,0,1,0,1,0
61209,445,0,0,66,66,0,1,0,1,0
51791,445,0,0,70,70,0,1,0,1,0
53879,445,0,0,66,66,0,1,0,1,0
50762,445,0,0,70,70,0,1,0,1,0
62739,445,0,0,69,69,0,1,0,1,0
51621,445,0,0,70,70,0,1,0,1,0
61621,445,0,0,70,70,0,1,0,1,0
56144,445,0,0,66,66,0,1,0,1,0
62157,445,0,0,66,66,0,1,0,1,0
58691,445,0,0,69,69,0,1,0,1,0
50856,445,0,0,70,70,0,1,0,1,0
63902,445,0,0,70,70,0,1,0,1,0
65119,445,0,0,69,69,0,1,0,1,0
65055,445,0,0,69,69,0,1,0,1,0
58953,445,0,0,66,66,0,1,0,1,0
60230,445,0,0,67,67,0,1,0,1,0
63620,445,0,0,70,70,0,1,0,1,0
55384,445,0,0,70,70,0,1,0,1,0
50295,445,0,0,70,70,0,1,0,1,0
64883,445,0,0,70,70,0,1,0,1,0
57942,445,0,0,69,69,0,1,0,1,0
53497,445,0,0,66,66,0,1,0,1,0
53222,445,0,0,70,70,0,1,0,1,0
61886,445,0,0,70,70,0,1,0,1,0
61717,445,0,0,66,66,0,1,0,1,0
58670,445,0,0,70,70,0,1,0,1,0
59502,445,0,0,67,67,0,1,0,1,0
52088,445,0,0,70,70,0,1,0,1,0
53469,445,0,0,70,70,0,1,0,1,0
58612,445,0,0,67,67,0,1,0,1,0
53267,445,0,0,66,66,0,1,0,1,0
50982,445,0,0,70,70,0,1,0,1,0
55789,445,0,0,66,66,0,1,0,1,0
62741,445,0,0,66,66,0,1,0,1,0
51491,445,0,0,70,70,0,1,0,1,0
60824,445,0,0,66,66,0,1,0,1,0
64796,445,0,0,70,70,0,1,0,1,0
61110,445,0,0,70,70,0,1,0,1,0
51574,445,0,0,66,66,0,1,0,1,0
54454,445,0,0,69,69,0,1,0,1,0
64036,445,0,0,66,66,0,1,0,1,0
58629,445,0,0,70,70,0,1,0,1,0
56622,445,0,0,70,70,0,1,0,1,0
54189,445,0,0,70,70,0,1,0,1,0
61146,445,0,0,70,70,0,1,0,1,0
53717,445,0,0,70,70,0,1,0,1,0
60557,445,0,0,70,70,0,1,0,1,0
56990,445,0,0,70,70,0,1,0,1,0
54913,445,0,0,70,70,0,1,0,1,0
53886,445,0,0,70,70,0,1,0,1,0
59804,445,0,0,70,70,0,1,0,1,0
55100,445,0,0,70,70,0,1,0,1,0
51293,445,0,0,70,70,0,1,0,1,0
65335,445,0,0,67,67,0,1,0,1,0
57964,445,0,0,70,70,0,1,0,1,0
64544,445,0,0,70,70,0,1,0,1,0
52887,445,0,0,69,69,0,1,0,1,0
58763,445,0,0,68,68,0,1,0,1,0
50812,445,0,0,70,70,0,1,0,1,0
62624,445,0,0,70,70,0,1,0,1,0
49616,445,0,0,70,70,0,1,0,1,0
57479,445,0,0,66,66,0,1,0,1,0
55371,445,0,0,66,66,0,1,0,1,0
62412,445,0,0,67,67,0,1,0,1,0
58077,445,0,0,67,67,0,1,0,1,0
55583,445,0,0,67,67,0,1,0,1,0
60192,445,0,0,68,68,0,1,0,1,0
62829,445,0,0,66,66,0,1,0,1,0
58367,445,0,0,70,70,0,1,0,1,0
58549,445,0,0,70,70,0,1,0,1,0
54651,445,0,0,66,66,0,1,0,1,0
51589,445,0,0,70,70,0,1,0,1,0
55083,445,0,0,70,70,0,1,0,1,0
50826,445,0,0,70,70,0,1,0,1,0
64164,445,0,0,66,66,0,1,0,1,0
64617,445,0,0,66,66,0,1,0,1,0
57672,445,0,0,70,70,0,1,0,1,0
63872,445,0,0,66,66,0,1,0,1,0
53521,445,0,0,70,70,0,1,0,1,0
59045,445,0,0,70,70,0,1,0,1,0
51517,445,0,0,69,69,0,1,0,1,0
50812,445,0,0,70,70,0,1,0,1,0
52710,445,0,0,70,70,0,1,0,1,0
51231,445,0,0,66,66,0,1,0,1,0
54955,445,0,0,70,70,0,1,0,1,0
62390,445,0,0,70,70,0,1,0,1,0
59401,445,0,0,70,70,0,1,0,1,0
51553,445,0,0,70,70,0,1,0,1,0
64518,445,0,0,66,66,0,1,0,1,0
53803,445,0,0,70,70,0,1,0,1,0
56401,445,0,0,68,68,0,1,0,1,0
59327,445,0,0,66,66,0,1,0,1,0
53416,445,0,0,69,69,0,1,0,1,0
55855,445,0,0,69,69,0,1,0,1,0
50596,445,0,0,69,69,0,1,0,1,0
50353,445,0,0,66,66,0,1,0,1,0
55026,445,0,0,70,70,0,1,0,1,0
64365,445,0,0,66,66,0,1,0,1,0
58883,445,0,0,66,66,0,1,0,1,0
62615,445,0,0,66,66,0,1,0,1,0
57397,445,0,0,66,66,0,1,0,1,0
64361,445,0,0,67,67,0,1,0,1,0
57163,445,0,0,70,70,0,1,0,1,0
52205,445,0,0,70,70,0,1,0,1,0
54365,445,0,0,70,70,0,1,0,1,0
51598,445,0,0,70,70,0,1,0,1,0
62210,445,0,0,70,70,0,1,0,1,0
62635,445,0,0,68,68,0,1,0,1,0
50477,445,0,0,70,70,0,1,0,1,0
59466,445,0,0,66,66,0,1,0,1,0
61506,445,0,0,70,70,0,1,0,1,0
55162,445,0,0,66,66,0,1,0,1,0
58053,445,0,0,66,66,0,1,0,1,0
54996,445,0,0,66,66,0,1,0,1,0
57363,445,0,0,69,69,0,1,0,1,0
56385,445,0,0,70,70,0,1,0,1,0
54155,445,0,0,70,70,0,1,0,1,0
52136,445,0,0,70,70,0,1,0,1,0
55559,445,0,0,70,70,0,1,0,1,0
57376,445,0,0,69,69,0,1,0,1,0
63404,445,0,0,66,66,0,1,0,1,0
51587,445,0,0,70,70,0,1,0,1,0
55731,445,0,0,70,70,0,1,0,1,0
51301,445,0,0,70,70,0,1,0,1,0
55938,445,0,0,67,67,0,1,0,1,0
51918,445,0,0,66,66,0,1,0,1,0
59322,445,0,0,70,70,0,1,0,1,0
55676,445,0,0,70,70,0,1,0,1,0
65314,445,0,0,70,70,0,1,0,1,0
53493,445,0,0,66,66,0,1,0,1,0
52496,445,0,0,70,70,0,1,0,1,0
54185,445,0,0,70,70,0,1,0,1,0
57877,445,0,0,70,70,0,1,0,1,0
59285,445,0,0,70,70,0,1,0,1,0
54852,445,0,0,66,66,0,1,0,1,0
61995,445,0,0,68,68,0,1,0,1,0
64492,445,0,0,66,66,0,1,0,1,0
55462,445,0,0,70,70,0,1,0,1,0
64671,445,0,0,70,70,0,1,0,1,0
57132,445,0,0,70,70,0,1,0,1,0
55590,445,0,0,70,70,0,1,0,1,0
59141,445,0,0,70,70,0,1,0,1,0
61087,445,0,0,70,70,0,1,0,1,0
61716,445,0,0,70,70,0,1,0,1,0
62983,445,0,0,66,66,0,1,0,1,0
58331,445,0,0,70,70,0,1,0,1,0
53365,445,0,0,70,70,0,1,0,1,0
64539,445,0,0,70,70,0,1,0,1,0
57344,445,0,0,70,70,0,1,0,1,0
53624,445,0,0,66,66,0,1,0,1,0
53938,445,0,0,66,66,0,1,0,1,0
51647,445,0,0,70,70,0,1,0,1,0
51107,445,0,0,66,66,0,1,0,1,0
54396,445,0,0,66,66,0,1,0,1,0
56836,445,0,0,69,69,0,1,0,1,0
61245,445,0,0,67,67,0,1,0,1,0
62791,445,0,0,70,70,0,1,0,1,0
56324,445,0,0,67,67,0,1,0,1,0
52044,445,0,0,69,69,0,1,0,1,0
58633,445,0,0,70,70,0,1,0,1,0
58862,445,0,0,70,70,0,1,0,1,0
59833,445,0,0,69,69,0,1,0,1,0
58308,445,0,0,66,66,0,1,0,1,0
61877,445,0,0,66,66,0,1,0,1,0
63449,445,0,0,66,66,0,1,0,1,0
54777,445,0,0,66,66,0,1,0,1,0
55211,445,0,0,70,70,0,1,0,1,0
56373,445,0,0,66,66,0,1,0,1,0
53976,445,0,0,70,70,0,1,0,1,0
62855,445,0,0,66,66,0,1,0,1,0
59652,445,0,0,70,70,0,1,0,1,0
56913,445,0,0,68,68,0,1,0,1,0
54292,445,0,0,66,66,0,1,0,1,0
51489,445,0,0,70,70,0,1,0,1,0
51020,445,0,0,70,70,0,1,0,1,0
53572,445,0,0,70,70,0,1,0,1,0
61467,445,0,0,67,67,0,1,0,1,0
53598,445,0,0,70,70,0,1,0,1,0
50498,445,0,0,68,68,0,1,0,1,0
52981,445,0,0,66,66,0,1,0,1,0
55744,445,0,0,66,66,0,1,0,1,0
57373,445,0,0,70,70,0,1,0,1,0
50413,445,0,0,66,66,0,1,0,1,0
55864,445,0,0,66,66,0,1,0,1,0
52918,445,0,0,69,69,0,1,0,1,0
62919,445,0,0,70,70,0,1,0,1,0
52639,445,0,0,70,70,0,1,0,1,0
64456,445,0,0,70,70,0,1,0,1,0
50866,445,0,0,66,66,0,1,0,1,0
54977,445,0,0,70,70,0,1,0,1,0
53068,445,0,0,70,70,0,1,0,1,0
59947,445,0,0,68,68,0,1,0,1,0
52580,445,0,0,70,70,0,1,0,1,0
57934,445,0,0,69,69,0,1,0,1,0
56449,445,0,0,70,70,0,1,0,1,0
54053,445,0,0,70,70,0,1,0,1,0
56899,445,0,0,66,66,0,1,0,1,0
64356,445,0,0,70,70,0,1,0,1,0
53690,445,0,0,70,70,0,1,0,1,0
52707,445,0,0,68,68,0,1,0,1,0
54060,445,0,0,66,66,0,1,0,1,0
56322,445,0,0,66,66,0,1,0,1,0
57156,445,0,0,67,67,0,1,0,1,0
59198,445,0,0,70,70,0,1,0,1,0
52395,445,0,0,69,69,0,1,0,1,0
54344,445,0,0,66,66,0,1,0,1,0
49203,445,0,0,66,66,0,1,0,1,0
63710,445,0,0,68,68,0,1,0,1,0
56014,445,0,0,68,68,0,1,0,1,0
62947,445,0,0,68,68,0,1,0,1,0
56935,445,0,0,70,70,0,1,0,1,0
52276,445,0,0,67,67,0,1,0,1,0
60851,445,0,0,70,70,0,1,0,1,0
61441,445,0,0,70,70,0,1,0,1,0
50587,445,0,0,70,70,0,1,0,1,0
61936,445,0,0,70,70,0,1,0,1,0
51065,445,0,0,66,66,0,1,0,1,0
51240,445,0,0,66,66,0,1,0,1,0
50298,445,0,0,70,70,0,1,0,1,0
54499,445,0,0,70,70,0,1,0,1,0
59146,445,0,0,67,67,0,1,0,1,0
55697,445,0,0,70,70,0,1,0,1,0
59226,445,0,0,68,68,0,1,0,1,0
54531,445,0,0,70,70,0,1,0,1,0
62788,445,0,0,70,70,0,1,0,1,0
62909,445,0,0,66,66,0,1,0,1,0
61077,445,0,0,69,69,0,1,0,1,0
55660,445,0,0,67,67,0,1,0,1,0
55558,445,0,0,70,70,0,1,0,1,0
61726,445,0,0,70,70,0,1,0,1,0
55462,445,0,0,70,70,0,1,0,1,0
58813,445,0,0,70,70,0,1,0,1,0
49580,445,0,0,70,70,0,1,0,1,0
58629,445,0,0,66,66,0,1,0,1,0
61589,445,0,0,66,66,0,1,0,1,0
55488,445,0,0,66,66,0,1,0,1,0
57350,445,0,0,66,66,0,1,0,1,0
57986,445,0,0,70,70,0,1,0,1,0
55426,445,0,0,70,70,0,1,0,1,0
54187,445,0,0,70,70,0,1,0,1,0
61276,445,0,0,69,69,0,1,0,1,0
63435,445,0,0,69,69,0,1,0,1,0
58049,445,0,0,70,70,0,1,0,1,0
53722,445,0,0,70,70,0,1,0,1,0
53748,445,0,0,70,70,0,1,0,1,0
54005,445,0,0,68,68,0,1,0,1,0
57774,445,0,0,70,70,0,1,0,1,0
57677,445,0,0,70,70,0,1,0,1,0
52595,445,0,0,66,66,0,1,0,1,0
61159,445,0,0,70,70,0,1,0,1,0
61145,445,0,0,70,70,0,1,0,1,0
65443,445,0,0,70,70,0,1,0,1,0
56409,445,0,0,70,70,0,1,0,1,0
50632,445,0,0,69,69,0,1,0,1,0
60296,445,0,0,70,70,0,1,0,1,0
62550,445,0,0,70,70,0,1,0,1,0
57539,445,0,0,70,70,0,1,0,1,0
62466,445,0,0,70,70,0,1,0,1,0
57924,445,0,0,66,66,0,1,0,1,0
63051,445,0,0,69,69,0,1,0,1,0
62102,445,0,0,66,66,0,1,0,1,0
59581,445,0,0,66,66,0,1,0,1,0
58550,445,0,0,70,70,0,1,0,1,0
57377,445,0,0,66,66,0,1,0,1,0
53110,445,0,0,66,66,0,1,0,1,0
49324,445,0,0,70,70,0,1,0,1,0
49620,445,0,0,70,70,0,1,0,1,0
59671,445,0,0,70,70,0,1,0,1,0
54794,445,0,0,70,70,0,1,0,1,0
62497,445,0,0,69,69,0,1,0,1,0
61759,445,0,0,70,70,0,1,0,1,0
58183,445,0,0,70,70,0,1,0,1,0
50352,445,0,0,66,66,0,1,0,1,0
50980,445,0,0,70,70,0,1,0,1,0
63824,445,0,0,66,66,0,1,0,1,0
56714,445,0,0,70,70,0,1,0,1,0
63277,445,0,0,70,70,0,1,0,1,0
60787,445,0,0,70,70,0,1,0,1,0
50079,445,0,0,66,66,0,1,0,1,0
61330,445,0,0,70,70,0,1,0,1,0
50040,445,0,0,70,70,0,1,0,1,0
65135,445,0,0,66,66,0,1,0,1,0
55912,445,0,0,70,70,0,1,0,1,0
49641,445,0,0,70,70,0,1,0,1,0
49335,445,0,0,69,69,0,1,0,1,0
51362,445,0,0,70,70,0,1,0,1,0
58260,445,0,0,67,67,0,1,0,1,0
56486,445,0,0,70,70,0,1,0,1,0
55542,445,0,0,70,70,0,1,0,1,0
62708,445,0,0,70,70,0,1,0,1,0
58739,445,0,0,70,70,0,1,0,1,0
59413,445,0,0,70,70,0,1,0,1,0
53726,445,0,0,70,70,0,1,0,1,0
51544,445,0,0,70,70,0,1,0,1,0
57222,445,0,0,66,66,0,1,0,1,0
59286,445,0,0,70,70,0,1,0,1,0
62340,445,0,0,69,69,0,1,0,1,0
54133,445,0,0,70,70,0,1,0,1,0
52214,445,0,0,66,66,0,1,0,1,0
57500,445,0,0,66,66,0,1,0,1,0
56586,445,0,0,70,70,0,1,0,1,0
56342,445,0,0,70,70,0,1,0,1,0
64650,445,0,0,70,70,0,1,0,1,0
52603,445,0,0,66,66,0,1,0,1,0
59725,445,0,0,67,67,0,1,0,1,0
53803,445,0,0,66,66,0,1,0,1,0
53806,445,0,0,68,68,0,1,0,1,0
65060,445,0,0,70,70,0,1,0,1,0
51261,445,0,0,66,66,0,1,0,1,0
59688,445,0,0,66,66,0,1,0,1,0
59215,445,0,0,70,70,0,1,0,1,0
53834,445,0,0,68,68,0,1,0,1,0
53505,445,0,0,66,66,0,1,0,1,0
58056,445,0,0,66,66,0,1,0,1,0
62640,445,0,0,70,70,0,1,0,1,0
62596,445,0,0,67,67,0,1,0,1,0
51214,445,0,0,70,70,0,1,0,1,0
54817,445,0,0,70,70,0,1,0,1,0
50251,445,0,0,70,70,0,1,0,1,0
62024,445,0,0,66,66,0,1,0,1,0
62685,445,0,0,70,70,0,1,0,1,0
57816,445,0,0,67,67,0,1,0,1,0
49752,445,0,0,70,70,0,1,0,1,0
53637,445,0,0,70,70,0,1,0,1,0
50463,445,0,0,66,66,0,1,0,1,0
61981,445,0,0,66,66,0,1,0,1,0
63513,445,0,0,66,66,0,1,0,1,0
53385,445,0,0,67,67,0,1,0,1,0
60232,445,0,0,69,69,0,1,0,1,0
49968,445,0,0,66,66,0,1,0,1,0
54750,445,0,0,70,70,0,1,0,1,0
55891,445,0,0,70,70,0,1,0,1,0
55805,445,0,0,70,70,0,1,0,1,0
57266,445,0,0,70,70,0,1,0,1,0
64043,445,0,0,70,70,0,1,0,1,0
52021,445,0,0,66,66,0,1,0,1,0
52698,445,0,0,70,70,0,1,0,1,0
55835,445,0,0,66,66,0,1,0,1,0
62629,445,0,0,66,66,0,1,0,1,0
50736,445,0,0,66,66,0,1,0,1,0
49891,445,0,0,67,67,0,1,0,1,0
51943,445,0,0,69,69,0,1,0,1,0
64015,445,0,0,67,67,0,1,0,1,0
51780,445,0,0,66,66,0,1,0,1,0
50709,445,0,0,70,70,0,1,0,1,0
54110,445,0,0,70,70,0,1,0,1,0
61115,445,0,0,70,70,0,1,0,1,0
62458,445,0,0,70,70,0,1,0,1,0
58433,445,0,0,67,67,0,1,0,1,0
52154,445,0,0,66,66,0,1,0,1,0
50350,445,0,0,66,66,0,1,0,1,0
52580,445,0,0,68,68,0,1,0,1,0
52836,445,0,0,66,66,0,1,0,1,0
53666,445,0,0,70,70,0,1,0,1,0
64248,445,0,0,69,69,0,1,0,1,0
51303,445,0,0,70,70,0,1,0,1,0
55440,445,0,0,70,70,0,1,0,1,0
50569,445,0,0,66,66,0,1,0,1,0
53805,445,0,0,69,69,0,1,0,1,0
64683,445,0,0,70,70,0,1,0,1,0
62445,445,0,0,70,70,0,1,0,1,0
51525,445,0,0,70,70,0,1,0,1,0
53079,445,0,0,70,70,0,1,0,1,0
55372,445,0,0,70,70,0,1,0,1,0
64810,445,0,0,66,66,0,1,0,1,0
63668,445,0,0,70,70,0,1,0,1,0
60969,445,0,0,66,66,0,1,0,1,0
50610,445,0,0,70,70,0,1,0,1,0
55678,445,0,0,67,67,0,1,0,1,0
53101,445,0,0,70,70,0,1,0,1,0
61567,445,0,0,70,70,0,1,0,1,0
60085,445,0,0,70,70,0,1,0,1,0
53528,445,0,0,70,70,0,1,0,1,0
55658,445,0,0,68,68,0,1,0,1,0
51230,445,0,0,68,68,0,1,0,1,0
59191,445,0,0,69,69,0,1,0,1,0
63613,445,0,0,70,70,0,1,0,1,0
54260,445,0,0,67,67,0,1,0,1,0
54642,445,0,0,70,70,0,1,0,1,0
61447,445,0,0,66,66,0,1,0,1,0
53116,445,0,0,70,70,0,1,0,1,0
57193,445,0,0,70,70,0,1,0,1,0
63984,445,0,0,70,70,0,1,0,1,0
56339,445,0,0,69,69,0,1,0,1,0
60935,445,0,0,66,66,0,1,0,1,0
58958,445,0,0,66,66,0,1,0,1,0
55609,445,0,0,66,66,0,1,0,1,0
64696,445,0,0,66,66,0,1,0,1,0
55659,445,0,0,67,67,0,1,0,1,0
56073,445,0,0,70,70,0,1,0,1,0
63646,445,0,0,66,66,0,1,0,1,0
52718,445,0,0,70,70,0,1,0,1,0
60827,445,0,0,70,70,0,1,0,1,0
57836,445,0,0,70,70,0,1,0,1,0
65436,445,0,0,68,68,0,1,0,1,0
59016,445,0,0,70,70,0,1,0,1,0
51795,445,0,0,70,70,0,1,0,1,0
51289,445,0,0,70,70,0,1,0,1,0
51244,445,0,0,66,66,0,1,0,1,0
53929,445,0,0,70,70,0,1,0,1,0
59124,445,0,0,66,66,0,1,0,1,0
55205,445,0,0,70,70,0,1,0,1,0
56686,445,0,0,70,70,0,1,0,1,0
50950,445,0,0,68,68,0,1,0,1,0
56164,445,0,0,70,70,0,1,0,1,0
60421,445,0,0,69,69,0,1,0,1,0
61077,445,0,0,70,70,0,1,0,1,0
60546,445,0,0,66,66,0,1,0,1,0
53172,445,0,0,66,66,0,1,0,1,0
57731,445,0,0,66,66,0,1,0,1,0
59802,445,0,0,66,66,0,1,0,1,0
53874,445,0,0,70,70,0,1,0,1,0
58328,445,0,0,70,70,0,1,0,1,0
56227,445,0,0,66,66,0,1,0,1,0
55774,445,0,0,70,70,0,1,0,1,0
56962,445,0,0,70,70,0,1,0,1,0
58504,445,0,0,70,70,0,1,0,1,0
53950,445,0,0,66,66,0,1,0,1,0
55032,445,0,0,70,70,0,1,0,1,0
62553,445,0,0,66,66,0,1,0,1,0
56984,445,0,0,70,70,0,1,0,1,0
62467,445,0,0,70,70,0,1,0,1,0
49191,445,0,0,70,70,0,1,0,1,0
62893,445,0,0,66,66,0,1,0,1,0
52532,445,0,0,66,66,0,1,0,1,0
49205,445,0,0,67,67,0,1,0,1,0
61659,445,0,0,70,70,0,1,0,1,0
62234,445,0,0,70,70,0,1,0,1,0
59769,445,0,0,67,67,0,1,0,1,0
56696,445,0,0,70,70,0,1,0,1,0
53747,445,0,0,70,70,0,1,0,1,0
52676,445,0,0,67,67,0,1,0,1,0
54629,445,0,0,70,70,0,1,0,1,0
51258,445,0,0,70,70,0,1,0,1,0
49714,445,0,0,66,66,0,1,0,1,0
52020,445,0,0,69,69,0,1,0,1,0
50647,445,0,0,66,66,0,1,0,1,0
60949,445,0,0,70,70,0,1,0,1,0
50906,445,0,0,67,67,0,1,0,1,0
49768,445,0,0,69,69,0,1,0,1,0
63065,445,0,0,70,70,0,1,0,1,0
55174,445,0,0,70,70,0,1,0,1,0
63748,445,0,0,70,70,0,1,0,1,0
63203,445,0,0,70,70,0,1,0,1,0
63657,445,0,0,70,70,0,1,0,1,0
62297,445,0,0,66,66,0,1,0,1,0
54018,445,0,0,70,70,0,1,0,1,0
57807,445,0,0,70,70,0,1,0,1,0
57160,445,0,0,70,70,0,1,0,1,0
54011,445,0,0,66,66,0,1,0,1,0
59802,445,0,0,70,70,0,1,0,1,0
50270,445,0,0,70,70,0,1,0,1,0
59139,445,0,0,70,70,0,1,0,1,0
56236,445,0,0,70,70,0,1,0,1,0
49793,445,0,0,70,70,0,1,0,1,0
53599,445,0,0,70,70,0,1,0,1,0
55608,445,0,0,67,67,0,1,0,1,0
64377,445,0,0,70,70,0,1,0,1,0
52185,445,0,0,70,70,0,1,0,1,0
59650,445,0,0,70,70,0,1,0,1,0
52117,445,0,0,66,66,0,1,0,1,0
56736,445,0,0,66,66,0,1,0,1,0
59069,445,0,0,66,66,0,1,0,1,0
50826,445,0,0,70,70,0,1,0,1,0
50040,445,0,0,66,66,0,1,0,1,0
50534,445,0,0,70,70,0,1,0,1,0
60855,445,0,0,70,70,0,1,0,1,0
64750,445,0,0,66,66,0,1,0,1,0
50775,445,0,0,67,67,0,1,0,1,0
52601,445,0,0,66,66,0,1,0,1,0
57304,445,0,0,70,70,0,1,0,1,0
63018,445,0,0,70,70,0,1,0,1,0
59782,445,0,0,70,70,0,1,0,1,0
63016,445,0,0,67,67,0,1,0,1,0
55206,445,0,0,70,70,0,1,0,1,0
61102,445,0,0,70,70,0,1,0,1,0
56488,445,0,0,70,70,0,1,0,1,0
53123,445,0,0,70,70,0,1,0,1,0
52055,445,0,0,70,70,0,1,0,1,0
50441,445,0,0,67,67,0,1,0,1,0
51811,445,0,0,70,70,0,1,0,1,0
60191,445,0,0,70,70,0,1,0,1,0
50659,445,0,0,70,70,0,1,0,1,0
63776,445,0,0,66,66,0,1,0,1,0
53141,445,0,0,67,67,0,1,0,1,0
54344,445,0,0,70,70,0,1,0,1,0
54532,445,0,0,70,70,0,1,0,1,0
65203,445,0,0,70,70,0,1,0,1,0
58636,445,0,0,70,70,0,1,0,1,0
59436,445,0,0,70,70,0,1,0,1,0
55497,445,0,0,66,66,0,1,0,1,0
50532,445,0,0,70,70,0,1,0,1,0
65268,445,0,0,70,70,0,1,0,1,0
50936,445,0,0,66,66,0,1,0,1,0
56129,445,0,0,70,70,0,1,0,1,0
62796,445,0,0,69,69,0,1,0,1,0
56983,445,0,0,70,70,0,1,0,1,0
62166,445,0,0,66,66,0,1,0,1,0
50177,445,0,0,70,70,0,1,0,1,0
63849,445,0,0,68,68,0,1,0,1,0
57757,445,0,0,70,70,0,1,0,1,0
62594,445,0,0,70,70,0,1,0,1,0
58461,445,0,0,70,70,0,1,0,1,0
56876,445,0,0,70,70,0,1,0,1,0
63528,445,0,0,70,70,0,1,0,1,0
52689,445,0,0,70,70,0,1,0,1,0
50567,445,0,0,70,70,0,1,0,1,0
52686,445,0,0,70,70,0,1,0,1,0
59079,445,0,0,67,67,0,1,0,1,0
53676,445,0,0,66,66,0,1,0,1,0
49833,445,0,0,70,70,0,1,0,1,0
57056,445,0,0,70,70,0,1,0,1,0
51879,445,0,0,70,70,0,1,0,1,0
53883,445,0,0,66,66,0,1,0,1,0
52955,445,0,0,70,70,0,1,0,1,0
54323,445,0,0,66,66,0,1,0,1,0
64153,445,0,0,70,70,0,1,0,1,0
62337,445,0,0,70,70,0,1,0,1,0
62254,445,0,0,68,68,0,1,0,1,0
55982,445,0,0,70,70,0,1,0,1,0
54575,445,0,0,66,66,0,1,0,1,0
55581,445,0,0,68,68,0,1,0,1,0
57890,445,0,0,70,70,0,1,0,1,0
52472,445,0,0,66,66,0,1,0,1,0
54323,445,0,0,66,66,0,1,0,1,0
51437,445,0,0,67,67,0,1,0,1,0
61095,445,0,0,70,70,0,1,0,1,0
58814,445,0,0,70,70,0,1,0,1,0
63723,445,0,0,66,66,0,1,0,1,0
61849,445,0,0,66,66,0,1,0,1,0
56125,445,0,0,66,66,0,1,0,1,0
63599,445,0,0,70,70,0,1,0,1,0
50266,445,0,0,70,70,0,1,0,1,0
53106,445,0,0,70,70,0,1,0,1,0
50269,445,0,0,70,70,0,1,0,1,0
51948,445,0,0,70,70,0,1,0,1,0
59946,445,0,0,68,68,0,1,0,1,0
57993,445,0,0,70,70,0,1,0,1,0
54367,445,0,0,70,70,0,1,0,1,0
50346,445,0,0,66,66,0,1,0,1,0
49190,445,0,0,69,69,0,1,0,1,0
56327,445,0,0,69,69,0,1,0,1,0
53901,445,0,0,70,70,0,1,0,1,0
63670,445,0,0,66,66,0,1,0,1,0
51633,445,0,0,67,67,0,1,0,1,0
61233,445,0,0,70,70,0,1,0,1,0
51107,445,0,0,66,66,0,1,0,1,0
54976,445,0,0,70,70,0,1,0,1,0
58352,445,0,0,69,69,0,1,0,1,0
54955,445,0,0,69,69,0,1,0,1,0
53104,445,0,0,70,70,0,1,0,1,0
64512,445,0,0,70,70,0,1,0,1,0
63179,445,0,0,66,66,0,1,0,1,0
60313,445,0,0,70,70,0,1,0,1,0
57148,445,0,0,66,66,0,1,0,1,0
53206,445,0,0,70,70,0,1,0,1,0
61444,445,0,0,70,70,0,1,0,1,0
59228,445,0,0,67,67,0,1,0,1,0
60160,445,0,0,66,66,0,1,0,1,0
55229,445,0,0,70,70,0,1,0,1,0
50273,445,0,0,70,70,0,1,0,1,0
63391,445,0,0,70,70,0,1,0,1,0
61059,445,0,0,70,70,0,1,0,1,0
58933,445,0,0,69,69,0,1,0,1,0
50159,445,0,0,70,70,0,1,0,1,0
52796,445,0,0,66,66,0,1,0,1,0
59071,445,0,0,66,66,0,1,0,1,0
62997,445,0,0,66,66,0,1,0,1,0
61612,445,0,0,70,70,0,1,0,1,0
51624,445,0,0,67,67,0,1,0,1,0
51116,445,0,0,66,66,0,1,0,1,0
59530,445,0,0,70,70,0,1,0,1,0
61079,445,0,0,66,66,0,1,0,1,0
61975,445,0,0,69,69,0,1,0,1,0
64414,445,0,0,70,70,0,1,0,1,0
62434,445,0,0,70,70,0,1,0,1,0
58314,445,0,0,66,66,0,1,0,1,0
50782,445,0,0,70,70,0,1,0,1,0
56098,445,0,0,70,70,0,1,0,1,0
52348,445,0,0,67,67,0,1,0,1,0
64050,445,0,0,70,70,0,1,0,1,0
49818,445,0,0,70,70,0,1,0,1,0
65494,445,0,0,70,70,0,1,0,1,0
51968,445,0,0,70,70,0,1,0,1,0
64044,445,0,0,70,70,0,1,0,1,0
57261,445,0,0,70,70,0,1,0,1,0
52605,445,0,0,70,70,0,1,0,1,0
55070,445,0,0,70,70,0,1,0,1,0
60086,445,0,0,67,67,0,1,0,1,0
62597,445,0,0,68,68,0,1,0,1,0
62148,445,0,0,70,70,0,1,0,1,0
54746,445,0,0,70,70,0,1,0,1,0
58193,445,0,0,70,70,0,1,0,1,0
50346,445,0,0,66,66,0,1,0,1,0
54632,445,0,0,66,66,0,1,0,1,0
55864,445,0,0,66,66,0,1,0,1,0
50982,445,0,0,66,66,0,1,0,1,0
58231,445,0,0,68,68,0,1,0,1,0
53230,445,0,0,70,70,0,1,0,1,0
56669,445,0,0,69,69,0,1,0,1,0
61596,445,0,0,67,67,0,1,0,1,0
54795,445,0,0,68,68,0,1,0,1,0
58894,445,0,0,66,66,0,1,0,1,0
59620,445,0,0,69,69,0,1,0,1,0
60479,445,0,0,70,70,0,1,0,1,0
54087,445,0,0,66,66,0,1,0,1,0
56853,445,0,0,70,70,0,1,0,1,0
54130,445,0,0,70,70,0,1,0,1,0
60174,445,0,0,68,68,0,1,0,1,0
61763,445,0,0,70,70,0,1,0,1,0
54476,445,0,0,68,68,0,1,0,1,0
56914,445,0,0,66,66,0,1,0,1,0
57429,445,0,0,69,69,0,1,0,1,0
54128,445,0,0,70,70,0,1,0,1,0
60724,445,0,0,70,70,0,1,0,1,0
53015,445,0,0,70,70,0,1,0,1,0
53644,445,0,0,66,66,0,1,0,1,0
58321,445,0,0,69,69,0,1,0,1,0
64908,445,0,0,70,70,0,1,0,1,0
65338,445,0,0,70,70,0,1,0,1,0
51654,445,0,0,68,68,0,1,0,1,0
60574,445,0,0,70,70,0,1,0,1,0
57278,445,0,0,69,69,0,1,0,1,0
60192,445,0,0,66,66,0,1,0,1,0
55548,445,0,0,66,66,0,1,0,1,0
60018,445,0,0,70,70,0,1,0,1,0
54138,445,0,0,66,66,0,1,0,1,0
54719,445,0,0,70,70,0,1,0,1,0
56765,445,0,0,70,70,0,1,0,1,0
58690,445,0,0,67,67,0,1,0,1,0
62250,445,0,0,70,70,0,1,0,1,0
56786,445,0,0,67,67,0,1,0,1,0
56940,445,0,0,70,70,0,1,0,1,0
61044,445,0,0,70,70,0,1,0,1,0
63328,445,0,0,66,66,0,1,0,1,0
50354,445,0,0,66,66,0,1,0,1,0
65094,445,0,0,70,70,0,1,0,1,0
52245,445,0,0,70,70,0,1,0,1,0
58955,445,0,0,66,66,0,1,0,1,0
55531,445,0,0,70,70,0,1,0,1,0
58095,445,0,0,70,70,0,1,0,1,0
63778,445,0,0,70,70,0,1,0,1,0
55541,445,0,0,70,70,0,1,0,1,0
52010,445,0,0,67,67,0,1,0,1,0
51491,445,0,0,70,70,0,1,0,1,0
65215,445,0,0,70,70,0,1,0,1,0
59295,445,0,0,70,70,0,1,0,1,0
60117,445,0,0,68,68,0,1,0,1,0
56418,445,0,0,70,70,0,1,0,1,0
52582,445,0,0,69,69,0,1,0,1,0
58814,445,0,0,69,69,0,1,0,1,0
57027,445,0,0,70,70,0,1,0,1,0
52176,445,0,0,70,70,0,1,0,1,0
57033,445,0,0,70,70,0,1,0,1,0
50547,445,0,0,70,70,0,1,0,1,0
62976,445,0,0,70,70,0,1,0,1,0
57752,445,0,0,70,70,0,1,0,1,0
58196,445,0,0,70,70,0,1,0,1,0
62511,445,0,0,70,70,0,1,0,1,0
56518,445,0,0,66,66,0,1,0,1,0
60352,445,0,0,70,70,0,1,0,1,0
55310,445,0,0,70,70,0,1,0,1,0
59724,445,0,0,66,66,0,1,0,1,0
52957,445,0,0,70,70,0,1,0,1,0
62737,445,0,0,70,70,0,1,0,1,0
62447,445,0,0,70,70,0,1,0,1,0
60693,445,0,0,66,66,0,1,0,1,0
52415,445,0,0,70,70,0,1,0,1,0
62492,445,0,0,66,66,0,1,0,1,0
50297,445,0,0,66,66,0,1,0,1,0
52143,445,0,0,70,70,0,1,0,1,0
56520,445,0,0,66,66,0,1,0,1,0
62360,445,0,0,66,66,0,1,0,1,0
51417,445,0,0,70,70,0,1,0,1,0
55596,445,0,0,70,70,0,1,0,1,0
55320,445,0,0,69,69,0,1,0,1,0
59356,445,0,0,67,67,0,1,0,1,0
49884,445,0,0,70,70,0,1,0,1,0
61333,445,0,0,66,66,0,1,0,1,0
56960,445,0,0,70,70,0,1,0,1,0
51063,445,0,0,66,66,0,1,0,1,0
64687,445,0,0,70,70,0,1,0,1,0
63470,445,0,0,70,70,0,1,0,1,0
50163,445,0,0,70,70,0,1,0,1,0
56916,445,0,0,70,70,0,1,0,1,0
50360,445,0,0,70,70,0,1,0,1,0
50731,445,0,0,66,66,0,1,0,1,0
62059,445,0,0,70,70,0,1,0,1,0
63906,445,0,0,66,66,0,1,0,1,0
50306,445,0,0,66,66,0,1,0,1,0
56532,445,0,0,68,68,0,1,0,1,0
52198,445,0,0,68,68,0,1,0,1,0
62490,445,0,0,66,66,0,1,0,1,0
60739,445,0,0,70,70,0,1,0,1,0
59457,445,0,0,66,66,0,1,0,1,0
52303,445,0,0,70,70,0,1,0,1,0
56324,445,0,0,66,66,0,1,0,1,0
50518,445,0,0,67,67,0,1,0,1,0
50935,445,0,0,66,66,0,1,0,1,0
57733,445,0,0,66,66,0,1,0,1,0
55893,445,0,0,70,70,0,1,0,1,0
65012,445,0,0,70,70,0,1,0,1,0
58166,445,0,0,69,69,0,1,0,1,0
49450,445,0,0,70,70,0,1,0,1,0
61210,445,0,0,66,66,0,1,0,1,0
63065,445,0,0,67,67,0,1,0,1,0
50333,445,0,0,70,70,0,1,0,1,0
60763,445,0,0,70,70,0,1,0,1,0
57895,445,0,0,70,70,0,1,0,1,0
56025,445,0,0,70,70,0,1,0,1,0
50941,445,0,0,70,70,0,1,0,1,0
55164,445,0,0,66,66,0,1,0,1,0
64091,445,0,0,70,70,0,1,0,1,0
63444,445,0,0,70,70,0,1,0,1,0
60722,445,0,0,70,70,0,1,0,1,0
55875,445,0,0,67,67,0,1,0,1,0
63332,445,0,0,66,66,0,1,0,1,0
64291,445,0,0,66,66,0,1,0,1,0
63049,445,0,0,70,70,0,1,0,1,0
50979,445,0,0,70,70,0,1,0,1,0
61790,445,0,0,66,66,0,1,0,1,0
62285,445,0,0,69,69,0,1,0,1,0
52430,445,0,0,70,70,0,1,0,1,0
51067,445,0,0,66,66,0,1,0,1,0
56774,445,0,0,70,70,0,1,0,1,0
54629,445,0,0,69,69,0,1,0,1,0
61755,445,0,0,70,70,0,1,0,1,0
55503,445,0,0,70,70,0,1,0,1,0
52221,445,0,0,70,70,0,1,0,1,0
62212,445,0,0,70,70,0,1,0,1,0
53777,445,0,0,68,68,0,1,0,1,0
51103,445,0,0,66,66,0,1,0,1,0
61275,445,0,0,68,68,0,1,0,1,0
63619,445,0,0,70,70,0,1,0,1,0
60809,445,0,0,68,68,0,1,0,1,0
63743,445,0,0,68,68,0,1,0,1,0
58071,445,0,0,68,68,0,1,0,1,0
56167,445,0,0,70,70,0,1,0,1,0
51913,445,0,0,66,66,0,1,0,1,0
56512,445,0,0,66,66,0,1,0,1,0
50095,445,0,0,70,70,0,1,0,1,0
58627,445,0,0,66,66,0,1,0,1,0
61452,445,0,0,70,70,0,1,0,1,0
58861,445,0,0,70,70,0,1,0,1,0
49266,445,0,0,70,70,0,1,0,1,0
61159,445,0,0,70,70,0,1,0,1,0
57436,445,0,0,70,70,0,1,0,1,0
62785,445,0,0,70,70,0,1,0,1,0
50306,445,0,0,70,70,0,1,0,1,0
58517,445,0,0,70,70,0,1,0,1,0
63516,445,0,0,70,70,0,1,0,1,0
50049,445,0,0,70,70,0,1,0,1,0
58957,445,0,0,66,66,0,1,0,1,0
49953,445,0,0,67,67,0,1,0,1,0
65069,445,0,0,66,66,0,1,0,1,0
57344,445,0,0,69,69,0,1,0,1,0
51398,445,0,0,70,70,0,1,0,1,0
53048,445,0,0,70,70,0,1,0,1,0
56451,445,0,0,66,66,0,1,0,1,0
63576,445,0,0,70,70,0,1,0,1,0
62362,445,0,0,66,66,0,1,0,1,0
49567,445,0,0,67,67,0,1,0,1,0
64256,445,0,0,70,70,0,1,0,1,0
62560,445,0,0,70,70,0,1,0,1,0
63080,445,0,0,66,66,0,1,0,1,0
64560,445,0,0,70,70,0,1,0,1,0
53479,445,0,0,66,66,0,1,0,1,0
60047,445,0,0,66,66,0,1,0,1,0
57543,445,0,0,70,70,0,1,0,1,0
55878,445,0,0,70,70,0,1,0,1,0
58220,445,0,0,70,70,0,1,0,1,0
60633,445,0,0,66,66,0,1,0,1,0
62264,445,0,0,70,70,0,1,0,1,0
64196,445,0,0,68,68,0,1,0,1,0
63287,445,0,0,67,67,0,1,0,1,0
63902,445,0,0,70,70,0,1,0,1,0
52763,445,0,0,70,70,0,1,0,1,0
49386,445,0,0,70,70,0,1,0,1,0
55708,445,0,0,70,70,0,1,0,1,0
64918,445,0,0,66,66,0,1,0,1,0
57639,445,0,0,70,70,0,1,0,1,0
55038,445,0,0,70,70,0,1,0,1,0
60303,445,0,0,70,70,0,1,0,1,0
64207,445,0,0,70,70,0,1,0,1,0
60354,445,0,0,70,70,0,1,0,1,0
51165,445,0,0,66,66,0,1,0,1,0
59575,445,0,0,70,70,0,1,0,1,0
50989,445,0,0,70,70,0,1,0,1,0
62254,445,0,0,68,68,0,1,0,1,0
50017,445,0,0,70,70,0,1,0,1,0
55051,445,0,0,70,70,0,1,0,1,0
60142,445,0,0,70,70,0,1,0,1,0
58831,445,0,0,66,66,0,1,0,1,0
50719,445,0,0,70,70,0,1,0,1,0
53507,445,0,0,69,69,0,1,0,1,0
53805,445,0,0,67,67,0,1,0,1,0
62177,445,0,0,66,66,0,1,0,1,0
57927,445,0,0,70,70,0,1,0,1,0
57452,445,0,0,70,70,0,1,0,1,0
50398,445,0,0,70,70,0,1,0,1,0
51541,445,0,0,70,70,0,1,0,1,0
58932,445,0,0,70,70,0,1,0,1,0
49758,445,0,0,70,70,0,1,0,1,0
65229,445,0,0,70,70,0,1,0,1,0
58519,445,0,0,66,66,0,1,0,1,0
50997,445,0,0,66,66,0,1,0,1,0
60679,445,0,0,70,70,0,1,0,1,0
60936,445,0,0,66,66,0,1,0,1,0
54956,445,0,0,70,70,0,1,0,1,0
50412,445,0,0,66,66,0,1,0,1,0
58038,445,0,0,66,66,0,1,0,1,0
62876,445,0,0,70,70,0,1,0,1,0
56392,445,0,0,70,70,0,1,0,1,0
60044,445,0,0,70,70,0,1,0,1,0
50979,445,0,0,70,70,0,1,0,1,0
49408,445,0,0,70,70,0,1,0,1,0
50571,445,0,0,70,70,0,1,0,1,0
63259,445,0,0,70,70,0,1,0,1,0
49579,445,0,0,70,70,0,1,0,1,0
50063,445,0,0,70,70,0,1,0,1,0
50920,445,0,0,66,66,0,1,0,1,0
58444,445,0,0,70,70,0,1,0,1,0
50367,445,0,0,66,66,0,1,0,1,0
62706,445,0,0,70,70,0,1,0,1,0
57218,445,0,0,68,68,0,1,0,1,0
50818,445,0,0,66,66,0,1,0,1,0
53488,445,0,0,70,70,0,1,0,1,0
55570,445,0,0,70,70,0,1,0,1,0
62831,445,0,0,69,69,0,1,0,1,0
54891,445,0,0,69,69,0,1,0,1,0
50491,445,0,0,70,70,0,1,0,1,0
54964,445,0,0,66,66,0,1,0,1,0
60303,445,0,0,68,68,0,1,0,1,0
52519,445,0,0,70,70,0,1,0,1,0
50067,445,0,0,70,70,0,1,0,1,0
62471,445,0,0,66,66,0,1,0,1,0
62888,445,0,0,67,67,0,1,0,1,0
62407,445,0,0,70,70,0,1,0,1,0
54460,445,0,0,68,68,0,1,0,1,0
57033,445,0,0,66,66,0,1,0,1,0
65254,445,0,0,70,70,0,1,0,1,0
49534,445,0,0,70,70,0,1,0,1,0
53691,445,0,0,66,66,0,1,0,1,0
59070,445,0,0,68,68,0,1,0,1,0
53685,445,0,0,67,67,0,1,0,1,0
65337,445,0,0,70,70,0,1,0,1,0
52951,445,0,0,70,70,0,1,0,1,0
55892,445,0,0,67,67,0,1,0,1,0
51461,445,0,0,67,67,0,1,0,1,0
65502,445,0,0,70,70,0,1,0,1,0
55647,445,0,0,70,70,0,1,0,1,0
57525,445,0,0,67,67,0,1,0,1,0
60788,445,0,0,70,70,0,1,0,1,0
63068,445,0,0,70,70,0,1,0,1,0
57031,445,0,0,70,70,0,1,0,1,0
63805,445,0,0,68,68,0,1,0,1,0
53564,445,0,0,69,69,0,1,0,1,0
64291,445,0,0,66,66,0,1,0,1,0
50720,445,0,0,70,70,0,1,0,1,0
64414,445,0,0,70,70,0,1,0,1,0
62487,445,0,0,66,66,0,1,0,1,0
55126,445,0,0,70,70,0,1,0,1,0
56358,445,0,0,70,70,0,1,0,1,0
63468,445,0,0,70,70,0,1,0,1,0
63165,445,0,0,68,68,0,1,0,1,0
59698,445,0,0,70,70,0,1,0,1,0
50684,445,0,0,70,70,0,1,0,1,0
51858,445,0,0,66,66,0,1,0,1,0
60977,445,0,0,69,69,0,1,0,1,0
53641,445,0,0,70,70,0,1,0,1,0
53403,445,0,0,70,70,0,1,0,1,0
53481,445,0,0,70,70,0,1,0,1,0
50656,445,0,0,66,66,0,1,0,1,0
52172,445,0,0,66,66,0,1,0,1,0
50353,445,0,0,66,66,0,1,0,1,0
60091,445,0,0,70,70,0,1,0,1,0
64947,445,0,0,70,70,0,1,0,1,0
59501,445,0,0,70,70,0,1,0,1,0
55355,445,0,0,70,70,0,1,0,1,0
58627,445,0,0,66,66,0,1,0,1,0
61739,445,0,0,66,66,0,1,0,1,0
61389,445,0,0,67,67,0,1,0,1,0
53675,445,0,0,66,66,0,1,0,1,0
50469,445,0,0,66,66,0,1,0,1,0
59198,445,0,0,70,70,0,1,0,1,0
53308,445,0,0,66,66,0,1,0,1,0
54956,445,0,0,70,70,0,1,0,1,0
61121,445,0,0,70,70,0,1,0,1,0
59124,445,0,0,67,67,0,1,0,1,0
53721,445,0,0,70,70,0,1,0,1,0
54561,445,0,0,68,68,0,1,0,1,0
51106,445,0,0,66,66,0,1,0,1,0
57033,445,0,0,70,70,0,1,0,1,0
62596,445,0,0,68,68,0,1,0,1,0
50115,445,0,0,66,66,0,1,0,1,0
59550,445,0,0,68,68,0,1,0,1,0
61063,445,0,0,66,66,0,1,0,1,0
63125,445,0,0,70,70,0,1,0,1,0
62183,445,0,0,69,69,0,1,0,1,0
59641,445,0,0,66,66,0,1,0,1,0
52569,445,0,0,70,70,0,1,0,1,0
63688,445,0,0,70,70,0,1,0,1,0
51468,445,0,0,66,66,0,1,0,1,0
63750,445,0,0,70,70,0,1,0,1,0
50265,445,0,0,70,70,0,1,0,1,0
51529,445,0,0,70,70,0,1,0,1,0
57885,445,0,0,70,70,0,1,0,1,0
63574,445,0,0,66,66,0,1,0,1,0
59995,445,0,0,66,66,0,1,0,1,0
57327,445,0,0,68,68,0,1,0,1,0
64803,445,0,0,70,70,0,1,0,1,0
50799,445,0,0,66,66,0,1,0,1,0
50845,445,0,0,66,66,0,1,0,1,0
50469,445,0,0,66,66,0,1,0,1,0
60955,445,0,0,66,66,0,1,0,1,0
51632,445,0,0,66,66,0,1,0,1,0
61567,445,0,0,70,70,0,1,0,1,0
53359,445,0,0,70,70,0,1,0,1,0
57282,445,0,0,67,67,0,1,0,1,0
55532,445,0,0,70,70,0,1,0,1,0
49665,445,0,0,70,70,0,1,0,1,0
52886,445,0,0,70,70,0,1,0,1,0
53883,445,0,0,66,66,0,1,0,1,0
52478,445,0,0,70,70,0,1,0,1,0
64330,445,0,0,70,70,0,1,0,1,0
55163,445,0,0,70,70,0,1,0,1,0
59873,445,0,0,70,70,0,1,0,1,0
56656,445,0,0,67,67,0,1,0,1,0
58730,445,0,0,70,70,0,1,0,1,0
59677,445,0,0,70,70,0,1,0,1,0
51712,445,0,0,67,67,0,1,0,1,0
52629,445,0,0,70,70,0,1,0,1,0
56812,445,0,0,70,70,0,1,0,1,0
59146,445,0,0,70,70,0,1,0,1,0
53308,445,0,0,66,66,0,1,0,1,0
53087,445,0,0,70,70,0,1,0,1,0
59411,445,0,0,70,70,0,1,0,1,0
50736,445,0,0,66,66,0,1,0,1,0
58756,445,0,0,67,67,0,1,0,1,0
56642,445,0,0,70,70,0,1,0,1,0
52275,445,0,0,66,66,0,1,0,1,0
58890,445,0,0,66,66,0,1,0,1,0
55284,445,0,0,70,70,0,1,0,1,0
56064,445,0,0,66,66,0,1,0,1,0
50880,445,0,0,70,70,0,1,0,1,0
57359,445,0,0,70,70,0,1,0,1,0
49704,445,0,0,70,70,0,1,0,1,0
53192,445,0,0,70,70,0,1,0,1,0
58263,445,0,0,70,70,0,1,0,1,0
58996,445,0,0,70,70,0,1,0,1,0
52977,445,0,0,70,70,0,1,0,1,0
62247,445,0,0,70,70,0,1,0,1,0
56737,445,0,0,66,66,0,1,0,1,0
54710,445,0,0,66,66,0,1,0,1,0
50644,445,0,0,70,70,0,1,0,1,0
52072,445,0,0,68,68,0,1,0,1,0
58279,445,0,0,70,70,0,1,0,1,0
65256,445,0,0,67,67,0,1,0,1,0
53983,445,0,0,70,70,0,1,0,1,0
65265,445,0,0,66,66,0,1,0,1,0
62327,445,0,0,70,70,0,1,0,1,0
56836,445,0,0,70,70,0,1,0,1,0
64969,445,0,0,70,70,0,1,0,1,0
60981,445,0,0,70,70,0,1,0,1,0
65112,445,0,0,70,70,0,1,0,1,0
58579,445,0,0,66,66,0,1,0,1,0
61127,445,0,0,66,66,0,1,0,1,0
51441,445,0,0,66,66,0,1,0,1,0
51551,445,0,0,70,70,0,1,0,1,0
64822,445,0,0,70,70,0,1,0,1,0
59739,445,0,0,69,69,0,1,0,1,0
56205,445,0,0,70,70,0,1,0,1,0
49708,445,0,0,70,70,0,1,0,1,0
65441,445,0,0,70,70,0,1,0,1,0
62557,445,0,0,67,67,0,1,0,1,0
65511,445,0,0,70,70,0,1,0,1,0
63285,445,0,0,70,70,0,1,0,1,0
49666,445,0,0,70,70,0,1,0,1,0
56810,445,0,0,70,70,0,1,0,1,0
55020,445,0,0,70,70,0,1,0,1,0
57199,445,0,0,68,68,0,1,0,1,0
62256,445,0,0,70,70,0,1,0,1,0
57268,445,0,0,66,66,0,1,0,1,0
57198,445,0,0,70,70,0,1,0,1,0
61816,445,0,0,68,68,0,1,0,1,0
49625,445,0,0,70,70,0,1,0,1,0
49576,445,0,0,70,70,0,1,0,1,0
56363,445,0,0,70,70,0,1,0,1,0
51068,445,0,0,70,70,0,1,0,1,0
64261,445,0,0,70,70,0,1,0,1,0
64009,445,0,0,70,70,0,1,0,1,0
59759,445,0,0,70,70,0,1,0,1,0
53726,445,0,0,70,70,0,1,0,1,0
57653,445,0,0,69,69,0,1,0,1,0
53886,445,0,0,70,70,0,1,0,1,0
53660,445,0,0,70,70,0,1,0,1,0
50343,445,0,0,66,66,0,1,0,1,0
55162,445,0,0,66,66,0,1,0,1,0
49351,445,0,0,66,66,0,1,0,1,0
57510,445,0,0,70,70,0,1,0,1,0
51930,445,0,0,70,70,0,1,0,1,0
50976,445,0,0,66,66,0,1,0,1,0
51977,445,0,0,70,70,0,1,0,1,0
50377,445,0,0,70,70,0,1,0,1,0
55221,445,0,0,70,70,0,1,0,1,0
50109,445,0,0,70,70,0,1,0,1,0
64804,445,0,0,66,66,0,1,0,1,0
65511,445,0,0,70,70,0,1,0,1,0
59592,445,0,0,66,66,0,1,0,1,0
56834,445,0,0,66,66,0,1,0,1,0
63872,445,0,0,70,70,0,1,0,1,0
65038,445,0,0,67,67,0,1,0,1,0
52254,445,0,0,67,67,0,1,0,1,0
59612,445,0,0,70,70,0,1,0,1,0
49805,445,0,0,70,70,0,1,0,1,0
63050,445,0,0,66,66,0,1,0,1,0
60949,445,0,0,70,70,0,1,0,1,0
52318,445,0,0,70,70,0,1,0,1,0
51505,445,0,0,68,68,0,1,0,1,0
62586,445,0,0,68,68,0,1,0,1,0
55102,445,0,0,70,70,0,1,0,1,0
55059,445,0,0,69,69,0,1,0,1,0
56896,445,0,0,70,70,0,1,0,1,0
50306,445,0,0,70,70,0,1,0,1,0
58784,445,0,0,67,67,0,1,0,1,0
64691,445,0,0,70,70,0,1,0,1,0
64629,445,0,0,69,69,0,1,0,1,0
63255,445,0,0,70,70,0,1,0,1,0
59631,445,0,0,70,70,0,1,0,1,0
63713,445,0,0,68,68,0,1,0,1,0
61762,445,0,0,70,70,0,1,0,1,0
65360,445,0,0,68,68,0,1,0,1,0
58213,445,0,0,70,70,0,1,0,1,0
52892,445,0,0,70,70,0,1,0,1,0
54816,445,0,0,70,70,0,1,0,1,0
57928,445,0,0,70,70,0,1,0,1,0
65490,445,0,0,70,70,0,1,0,1,0
52987,445,0,0,67,67,0,1,0,1,0
60589,445,0,0,69,69,0,1,0,1,0
52186,445,0,0,70,70,0,1,0,1,0
63315,445,0,0,66,66,0,1,0,1,0
59257,445,0,0,68,68,0,1,0,1,0
56594,445,0,0,70,70,0,1,0,1,0
61465,445,0,0,70,70,0,1,0,1,0
59663,445,0,0,66,66,0,1,0,1,0
63327,445,0,0,70,70,0,1,0,1,0
65292,445,0,0,70,70,0,1,0,1,0
61260,445,0,0,66,66,0,1,0,1,0
52756,445,0,0,66,66,0,1,0,1,0
59609,445,0,0,70,70,0,1,0,1,0
65363,445,0,0,70,70,0,1,0,1,0
61430,445,0,0,70,70,0,1,0,1,0
56938,445,0,0,70,70,0,1,0,1,0
54367,445,0,0,70,70,0,1,0,1,0
58247,445,0,0,69,69,0,1,0,1,0
50288,445,0,0,66,66,0,1,0,1,0
65460,445,0,0,70,70,0,1,0,1,0
52983,445,0,0,66,66,0,1,0,1,0
55696,445,0,0,70,70,0,1,0,1,0
57000,445,0,0,70,70,0,1,0,1,0
49374,445,0,0,70,70,0,1,0,1,0
59179,445,0,0,70,70,0,1,0,1,0
50864,445,0,0,66,66,0,1,0,1,0
49576,445,0,0,70,70,0,1,0,1,0
55998,445,0,0,70,70,0,1,0,1,0
59213,445,0,0,66,66,0,1,0,1,0
51038,445,0,0,70,70,0,1,0,1,0
62058,445,0,0,68,68,0,1,0,1,0
63617,445,0,0,70,70,0,1,0,1,0
59920,445,0,0,67,67,0,1,0,1,0
64375,445,0,0,66,66,0,1,0,1,0
53403,445,0,0,70,70,0,1,0,1,0
58116,445,0,0,67,67,0,1,0,1,0
62982,445,0,0,67,67,0,1,0,1,0
53369,445,0,0,66,66,0,1,0,1,0
62422,445,0,0,66,66,0,1,0,1,0
55598,445,0,0,69,69,0,1,0,1,0
53500,445,0,0,70,70,0,1,0,1,0
50894,445,0,0,70,70,0,1,0,1,0
63068,445,0,0,67,67,0,1,0,1,0
50084,445,0,0,70,70,0,1,0,1,0
58603,445,0,0,70,70,0,1,0,1,0
58476,445,0,0,70,70,0,1,0,1,0
50364,445,0,0,70,70,0,1,0,1,0
57222,445,0,0,66,66,0,1,0,1,0
62210,445,0,0,70,70,0,1,0,1,0
55069,445,0,0,70,70,0,1,0,1,0
55361,445,0,0,70,70,0,1,0,1,0
50723,445,0,0,66,66,0,1,0,1,0
65219,445,0,0,70,70,0,1,0,1,0
59500,445,0,0,70,70,0,1,0,1,0
61088,445,0,0,70,70,0,1,0,1,0
51027,445,0,0,70,70,0,1,0,1,0
49388,445,0,0,70,70,0,1,0,1,0
61690,445,0,0,70,70,0,1,0,1,0
63520,445,0,0,66,66,0,1,0,1,0
57019,445,0,0,66,66,0,1,0,1,0
63581,445,0,0,68,68,0,1,0,1,0
54575,445,0,0,66,66,0,1,0,1,0
62531,445,0,0,70,70,0,1,0,1,0
51697,445,0,0,66,66,0,1,0,1,0
51125,445,0,0,69,69,0,1,0,1,0
63105,445,0,0,70,70,0,1,0,1,0
63133,445,0,0,67,67,0,1,0,1,0
61290,445,0,0,70,70,0,1,0,1,0
65311,445,0,0,70,70,0,1,0,1,0
51048,445,0,0,70,70,0,1,0,1,0
54570,445,0,0,66,66,0,1,0,1,0
60686,445,0,0,70,70,0,1,0,1,0
56958,445,0,0,70,70,0,1,0,1,0
61332,445,0,0,69,69,0,1,0,1,0
54084,445,0,0,66,66,0,1,0,1,0
57798,445,0,0,70,70,0,1,0,1,0
59469,445,0,0,66,66,0,1,0,1,0
64004,445,0,0,70,70,0,1,0,1,0
64305,445,0,0,70,70,0,1,0,1,0
65000,445,0,0,68,68,0,1,0,1,0
58481,445,0,0,70,70,0,1,0,1,0
54248,445,0,0,66,66,0,1,0,1,0
52325,445,0,0,66,66,0,1,0,1,0
56540,445,0,0,70,70,0,1,0,1,0
63337,445,0,0,70,70,0,1,0,1,0
51907,445,0,0,70,70,0,1,0,1,0
52768,445,0,0,70,70,0,1,0,1,0
51462,445,0,0,66,66,0,1,0,1,0
59465,445,0,0,69,69,0,1,0,1,0
55938,445,0,0,70,70,0,1,0,1,0
59146,445,0,0,70,70,0,1,0,1,0
50860,445,0,0,70,70,0,1,0,1,0
60277,445,0,0,70,70,0,1,0,1,0
60093,445,0,0,70,70,0,1,0,1,0
65234,445,0,0,70,70,0,1,0,1,0
55440,445,0,0,70,70,0,1,0,1,0
51308,445,0,0,66,66,0,1,0,1,0
54011,445,0,0,66,66,0,1,0,1,0
51085,445,0,0,70,70,0,1,0,1,0
51121,445,0,0,66,66,0,1,0,1,0
63715,445,0,0,67,67,0,1,0,1,0
53793,445,0,0,69,69,0,1,0,1,0
54502,445,0,0,67,67,0,1,0,1,0
61234,445,0,0,69,69,0,1,0,1,0
55290,445,0,0,70,70,0,1,0,1,0
54969,445,0,0,66,66,0,1,0,1,0
54005,445,0,0,66,66,0,1,0,1,0
59734,445,0,0,69,69,0,1,0,1,0
53659,445,0,0,70,70,0,1,0,1,0
63407,445,0,0,70,70,0,1,0,1,0
52921,445,0,0,69,69,0,1,0,1,0
53752,445,0,0,66,66,0,1,0,1,0
50263,445,0,0,70,70,0,1,0,1,0
52119,445,0,0,70,70,0,1,0,1,0
50785,445,0,0,70,70,0,1,0,1,0
57077,445,0,0,68,68,0,1,0,1,0
63938,445,0,0,70,70,0,1,0,1,0
61180,445,0,0,70,70,0,1,0,1,0
50283,445,0,0,66,66,0,1,0,1,0
64567,445,0,0,70,70,0,1,0,1,0
50285,445,0,0,70,70,0,1,0,1,0
51259,445,0,0,70,70,0,1,0,1,0
54398,445,0,0,67,67,0,1,0,1,0
50296,445,0,0,70,70,0,1,0,1,0
52649,445,0,0,70,70,0,1,0,1,0
62541,445,0,0,68,68,0,1,0,1,0
55806,445,0,0,70,70,0,1,0,1,0
55469,445,0,0,66,66,0,1,0,1,0
59570,445,0,0,70,70,0,1,0,1,0
56363,445,0,0,70,70,0,1,0,1,0
57983,445,0,0,70,70,0,1,0,1,0
49577,445,0,0,70,70,0,1,0,1,0
50298,445,0,0,70,70,0,1,0,1,0
56361,445,0,0,70,70,0,1,0,1,0
52632,445,0,0,70,70,0,1,0,1,0
56451,445,0,0,66,66,0,1,0,1,0
62878,445,0,0,68,68,0,1,0,1,0
55101,445,0,0,70,70,0,1,0,1,0
53751,445,0,0,66,66,0,1,0,1,0
64458,445,0,0,70,70,0,1,0,1,0
50305,445,0,0,70,70,0,1,0,1,0
63006,445,0,0,70,70,0,1,0,1,0
56078,445,0,0,68,68,0,1,0,1,0
49973,445,0,0,70,70,0,1,0,1,0
50821,445,0,0,70,70,0,1,0,1,0
49423,445,0,0,70,70,0,1,0,1,0
65451,445,0,0,66,66,0,1,0,1,0
52908,445,0,0,67,67,0,1,0,1,0
50912,445,0,0,70,70,0,1,0,1,0
50677,445,0,0,66,66,0,1,0,1,0
60524,445,0,0,67,67,0,1,0,1,0
57606,445,0,0,66,66,0,1,0,1,0
52877,445,0,0,70,70,0,1,0,1,0
50625,445,0,0,68,68,0,1,0,1,0
54902,445,0,0,67,67,0,1,0,1,0
56575,445,0,0,66,66,0,1,0,1,0
50366,445,0,0,66,66,0,1,0,1,0
51541,445,0,0,70,70,0,1,0,1,0
49782,445,0,0,70,70,0,1,0,1,0
51136,445,0,0,70,70,0,1,0,1,0
65002,445,0,0,66,66,0,1,0,1,0
60346,445,0,0,70,70,0,1,0,1,0
56143,445,0,0,70,70,0,1,0,1,0
64576,445,0,0,70,70,0,1,0,1,0
62896,445,0,0,70,70,0,1,0,1,0
60345,445,0,0,70,70,0,1,0,1,0
50736,445,0,0,66,66,0,1,0,1,0
50198,445,0,0,70,70,0,1,0,1,0
58996,445,0,0,68,68,0,1,0,1,0
58264,445,0,0,70,70,0,1,0,1,0
60594,445,0,0,66,66,0,1,0,1,0
53460,445,0,0,70,70,0,1,0,1,0
65057,445,0,0,70,70,0,1,0,1,0
60676,445,0,0,67,67,0,1,0,1,0
57541,445,0,0,66,66,0,1,0,1,0
54280,445,0,0,68,68,0,1,0,1,0
64551,445,0,0,66,66,0,1,0,1,0
57289,445,0,0,70,70,0,1,0,1,0
50824,445,0,0,70,70,0,1,0,1,0
54500,445,0,0,69,69,0,1,0,1,0
60613,445,0,0,67,67,0,1,0,1,0
57198,445,0,0,70,70,0,1,0,1,0
54038,445,0,0,67,67,0,1,0,1,0
53976,445,0,0,70,70,0,1,0,1,0
61776,445,0,0,66,66,0,1,0,1,0
49825,445,0,0,67,67,0,1,0,1,0
59300,445,0,0,66,66,0,1,0,1,0
49552,445,0,0,70,70,0,1,0,1,0
62489,445,0,0,66,66,0,1,0,1,0
55918,445,0,0,67,67,0,1,0,1,0
61912,445,0,0,66,66,0,1,0,1,0
64227,445,0,0,66,66,0,1,0,1,0
58916,445,0,0,69,69,0,1,0,1,0
50837,445,0,0,66,66,0,1,0,1,0
50500,445,0,0,66,66,0,1,0,1,0
50760,445,0,0,70,70,0,1,0,1,0
61737,445,0,0,66,66,0,1,0,1,0
61169,445,0,0,70,70,0,1,0,1,0
58135,445,0,0,70,70,0,1,0,1,0
55828,445,0,0,70,70,0,1,0,1,0
63196,445,0,0,70,70,0,1,0,1,0
65130,445,0,0,70,70,0,1,0,1,0
62704,445,0,0,70,70,0,1,0,1,0
58215,445,0,0,70,70,0,1,0,1,0
61791,445,0,0,66,66,0,1,0,1,0
50676,445,0,0,70,70,0,1,0,1,0
51635,445,0,0,66,66,0,1,0,1,0
58519,445,0,0,70,70,0,1,0,1,0
59706,445,0,0,70,70,0,1,0,1,0
52474,445,0,0,66,66,0,1,0,1,0
50483,445,0,0,70,70,0,1,0,1,0
58317,445,0,0,70,70,0,1,0,1,0
54876,445,0,0,70,70,0,1,0,1,0
56317,445,0,0,70,70,0,1,0,1,0
56531,445,0,0,70,70,0,1,0,1,0
63708,445,0,0,66,66,0,1,0,1,0
62442,445,0,0,70,70,0,1,0,1,0
61181,445,0,0,70,70,0,1,0,1,0
56063,445,0,0,66,66,0,1,0,1,0
60957,445,0,0,70,70,0,1,0,1,0
52790,445,0,0,70,70,0,1,0,1,0
58241,445,0,0,66,66,0,1,0,1,0
58483,445,0,0,66,66,0,1,0,1,0
50579,445,0,0,67,67,0,1,0,1,0
49465,445,0,0,70,70,0,1,0,1,0
53385,445,0,0,69,69,0,1,0,1,0
52074,445,0,0,70,70,0,1,0,1,0
54720,445,0,0,68,68,0,1,0,1,0
54988,445,0,0,68,68,0,1,0,1,0
51884,445,0,0,67,67,0,1,0,1,0
62517,445,0,0,70,70,0,1,0,1,0
62302,445,0,0,70,70,0,1,0,1,0
53623,445,0,0,68,68,0,1,0,1,0
64404,445,0,0,67,67,0,1,0,1,0
62868,445,0,0,70,70,0,1,0,1,0
62905,445,0,0,70,70,0,1,0,1,0
58397,445,0,0,70,70,0,1,0,1,0
58013,445,0,0,70,70,0,1,0,1,0
59345,445,0,0,70,70,0,1,0,1,0
52666,445,0,0,66,66,0,1,0,1,0
58515,445,0,0,70,70,0,1,0,1,0
50356,445,0,0,70,70,0,1,0,1,0
50514,445,0,0,70,70,0,1,0,1,0
59887,445,0,0,70,70,0,1,0,1,0
55799,445,0,0,70,70,0,1,0,1,0
59125,445,0,0,66,66,0,1,0,1,0
57381,445,0,0,70,70,0,1,0,1,0
50003,445,0,0,70,70,0,1,0,1,0
63695,445,0,0,66,66,0,1,0,1,0
64793,445,0,0,70,70,0,1,0,1,0
60859,445,0,0,67,67,0,1,0,1,0
50610,445,0,0,70,70,0,1,0,1,0
56903,445,0,0,70,70,0,1,0,1,0
52501,445,0,0,70,70,0,1,0,1,0
51792,445,0,0,70,70,0,1,0,1,0
60047,445,0,0,70,70,0,1,0,1,0
60258,445,0,0,70,70,0,1,0,1,0
55803,445,0,0,66,66,0,1,0,1,0
49508,445,0,0,66,66,0,1,0,1,0
50118,445,0,0,70,70,0,1,0,1,0
62982,445,0,0,66,66,0,1,0,1,0
65325,445,0,0,66,66,0,1,0,1,0
53673,445,0,0,70,70,0,1,0,1,0
51211,445,0,0,69,69,0,1,0,1,0
50912,445,0,0,66,66,0,1,0,1,0
50682,445,0,0,66,66,0,1,0,1,0
59099,445,0,0,69,69,0,1,0,1,0
51258,445,0,0,70,70,0,1,0,1,0
61228,445,0,0,70,70,0,1,0,1,0
56438,445,0,0,70,70,0,1,0,1,0
56450,445,0,0,66,66,0,1,0,1,0
60374,445,0,0,70,70,0,1,0,1,0
57876,445,0,0,70,70,0,1,0,1,0
59198,445,0,0,70,70,0,1,0,1,0
49971,445,0,0,66,66,0,1,0,1,0
61019,445,0,0,66,66,0,1,0,1,0
58447,445,0,0,66,66,0,1,0,1,0
58419,445,0,0,70,70,0,1,0,1,0
53160,445,0,0,70,70,0,1,0,1,0
50464,445,0,0,66,66,0,1,0,1,0
51527,445,0,0,69,69,0,1,0,1,0
49970,445,0,0,66,66,0,1,0,1,0
58114,445,0,0,66,66,0,1,0,1,0
49684,445,0,0,66,66,0,1,0,1,0
52627,445,0,0,70,70,0,1,0,1,0
53559,445,0,0,66,66,0,1,0,1,0
64738,445,0,0,70,70,0,1,0,1,0
50552,445,0,0,70,70,0,1,0,1,0
57406,445,0,0,70,70,0,1,0,1,0
51324,445,0,0,70,70,0,1,0,1,0
56190,445,0,0,66,66,0,1,0,1,0
51002,445,0,0,70,70,0,1,0,1,0
54952,445,0,0,70,70,0,1,0,1,0
62818,445,0,0,70,70,0,1,0,1,0
51928,445,0,0,70,70,0,1,0,1,0
64963,445,0,0,70,70,0,1,0,1,0
63365,445,0,0,70,70,0,1,0,1,0
49844,445,0,0,70,70,0,1,0,1,0
51548,445,0,0,70,70,0,1,0,1,0
59478,445,0,0,70,70,0,1,0,1,0
57653,445,0,0,70,70,0,1,0,1,0
60158,445,0,0,66,66,0,1,0,1,0
56825,445,0,0,70,70,0,1,0,1,0
56264,445,0,0,66,66,0,1,0,1,0
53814,445,0,0,66,66,0,1,0,1,0
50846,445,0,0,66,66,0,1,0,1,0
51372,445,0,0,69,69,0,1,0,1,0
62081,445,0,0,70,70,0,1,0,1,0
59254,445,0,0,70,70,0,1,0,1,0
54777,445,0,0,66,66,0,1,0,1,0
60163,445,0,0,69,69,0,1,0,1,0
54626,445,0,0,70,70,0,1,0,1,0
59585,445,0,0,66,66,0,1,0,1,0
61871,445,0,0,66,66,0,1,0,1,0
51763,445,0,0,66,66,0,1,0,1,0
63789,445,0,0,70,70,0,1,0,1,0
56789,445,0,0,70,70,0,1,0,1,0
59788,445,0,0,66,66,0,1,0,1,0
55045,445,0,0,70,70,0,1,0,1,0
56966,445,0,0,70,70,0,1,0,1,0
56388,445,0,0,70,70,0,1,0,1,0
61748,445,0,0,68,68,0,1,0,1,0
54232,445,0,0,70,70,0,1,0,1,0
60242,445,0,0,70,70,0,1,0,1,0
64414,445,0,0,70,70,0,1,0,1,0
55762,445,0,0,66,66,0,1,0,1,0
59357,445,0,0,68,68,0,1,0,1,0
56442,445,0,0,70,70,0,1,0,1,0
61737,445,0,0,70,70,0,1,0,1,0
52415,445,0,0,66,66,0,1,0,1,0
63110,445,0,0,70,70,0,1,0,1,0
50986,445,0,0,68,68,0,1,0,1,0
53012,445,0,0,66,66,0,1,0,1,0
60404,445,0,0,70,70,0,1,0,1,0
60867,445,0,0,70,70,0,1,0,1,0
57194,445,0,0,70,70,0,1,0,1,0
61610,445,0,0,70,70,0,1,0,1,0
49390,445,0,0,70,70,0,1,0,1,0
62106,445,0,0,66,66,0,1,0,1,0
61157,445,0,0,70,70,0,1,0,1,0
54746,445,0,0,70,70,0,1,0,1,0
63875,445,0,0,70,70,0,1,0,1,0
60203,445,0,0,70,70,0,1,0,1,0
65324,445,0,0,66,66,0,1,0,1,0
50723,445,0,0,70,70,0,1,0,1,0
53480,445,0,0,68,68,0,1,0,1,0
57750,445,0,0,70,70,0,1,0,1,0
63856,445,0,0,70,70,0,1,0,1,0
51800,445,0,0,70,70,0,1,0,1,0
53702,445,0,0,70,70,0,1,0,1,0
62683,445,0,0,70,70,0,1,0,1,0
49716,445,0,0,66,66,0,1,0,1,0
49685,445,0,0,68,68,0,1,0,1,0
61658,445,0,0,67,67,0,1,0,1,0
65306,445,0,0,69,69,0,1,0,1,0
63014,445,0,0,70,70,0,1,0,1,0
52067,445,0,0,70,70,0,1,0,1,0
58960,445,0,0,66,66,0,1,0,1,0
56730,445,0,0,70,70,0,1,0,1,0
64017,445,0,0,69,69,0,1,0,1,0
57006,445,0,0,70,70,0,1,0,1,0
51196,445,0,0,70,70,0,1,0,1,0
53212,445,0,0,70,70,0,1,0,1,0
50767,445,0,0,70,70,0,1,0,1,0
50265,445,0,0,70,70,0,1,0,1,0
64517,445,0,0,70,70,0,1,0,1,0
57497,445,0,0,70,70,0,1,0,1,0
63985,445,0,0,70,70,0,1,0,1,0
65054,445,0,0,70,70,0,1,0,1,0
52532,445,0,0,70,70,0,1,0,1,0
49641,445,0,0,70,70,0,1,0,1,0
51753,445,0,0,70,70,0,1,0,1,0
60807,445,0,0,70,70,0,1,0,1,0
63556,445,0,0,70,70,0,1,0,1,0
50377,445,0,0,70,70,0,1,0,1,0
50190,445,0,0,70,70,0,1,0,1,0
55556,445,0,0,70,70,0,1,0,1,0
56533,445,0,0,68,68,0,1,0,1,0
56238,445,0,0,70,70,0,1,0,1,0
57303,445,0,0,66,66,0,1,0,1,0
56992,445,0,0,68,68,0,1,0,1,0
55111,445,0,0,70,70,0,1,0,1,0
60753,445,0,0,66,66,0,1,0,1,0
63902,445,0,0,70,70,0,1,0,1,0
65394,445,0,0,67,67,0,1,0,1,0
57674,445,0,0,70,70,0,1,0,1,0
58369,445,0,0,66,66,0,1,0,1,0
56519,445,0,0,68,68,0,1,0,1,0
51654,445,0,0,68,68,0,1,0,1,0
61661,445,0,0,70,70,0,1,0,1,0
57429,445,0,0,69,69,0,1,0,1,0
49989,445,0,0,70,70,0,1,0,1,0
52112,445,0,0,66,66,0,1,0,1,0
59705,445,0,0,70,70,0,1,0,1,0
62357,445,0,0,70,70,0,1,0,1,0
51057,445,0,0,70,70,0,1,0,1,0
64088,445,0,0,67,67,0,1,0,1,0
55875,445,0,0,70,70,0,1,0,1,0
64083,445,0,0,66,66,0,1,0,1,0
63782,445,0,0,70,70,0,1,0,1,0
55854,445,0,0,68,68,0,1,0,1,0
50010,445,0,0,70,70,0,1,0,1,0
52503,445,0,0,70,70,0,1,0,1,0
63358,445,0,0,70,70,0,1,0,1,0
50682,445,0,0,67,67,0,1,0,1,0
55050,445,0,0,70,70,0,1,0,1,0
50217,445,0,0,70,70,0,1,0,1,0
49747,445,0,0,69,69,0,1,0,1,0
58117,445,0,0,69,69,0,1,0,1,0
56747,445,0,0,70,70,0,1,0,1,0
51454,445,0,0,67,67,0,1,0,1,0
59548,445,0,0,69,69,0,1,0,1,0
59015,445,0,0,70,70,0,1,0,1,0
54649,445,0,0,66,66,0,1,0,1,0
63758,445,0,0,70,70,0,1,0,1,0
55183,445,0,0,66,66,0,1,0,1,0
56381,445,0,0,70,70,0,1,0,1,0
52053,445,0,0,70,70,0,1,0,1,0
52726,445,0,0,66,66,0,1,0,1,0
60338,445,0,0,70,70,0,1,0,1,0
65038,445,0,0,66,66,0,1,0,1,0
53596,445,0,0,70,70,0,1,0,1,0
54127,445,0,0,70,70,0,1,0,1,0
59377,445,0,0,70,70,0,1,0,1,0
57405,445,0,0,69,69,0,1,0,1,0
52049,445,0,0,70,70,0,1,0,1,0
54518,445,0,0,70,70,0,1,0,1,0
63234,445,0,0,70,70,0,1,0,1,0
57839,445,0,0,70,70,0,1,0,1,0
64929,445,0,0,70,70,0,1,0,1,0
65092,445,0,0,70,70,0,1,0,1,0
54989,445,0,0,70,70,0,1,0,1,0
54888,445,0,0,67,67,0,1,0,1,0
51945,445,0,0,70,70,0,1,0,1,0
49640,445,0,0,67,67,0,1,0,1,0
62625,445,0,0,70,70,0,1,0,1,0
51913,445,0,0,68,68,0,1,0,1,0
51568,445,0,0,69,69,0,1,0,1,0
49768,445,0,0,69,69,0,1,0,1,0
52887,445,0,0,70,70,0,1,0,1,0
53623,445,0,0,66,66,0,1,0,1,0
63017,445,0,0,70,70,0,1,0,1,0
50859,445,0,0,66,66,0,1,0,1,0
52589,445,0,0,70,70,0,1,0,1,0
64420,445,0,0,66,66,0,1,0,1,0
59863,445,0,0,70,70,0,1,0,1,0
59556,445,0,0,70,70,0,1,0,1,0
58227,445,0,0,66,66,0,1,0,1,0
50668,445,0,0,66,66,0,1,0,1,0
50264,445,0,0,70,70,0,1,0,1,0
59613,445,0,0,68,68,0,1,0,1,0
64615,445,0,0,70,70,0,1,0,1,0
60564,445,0,0,66,66,0,1,0,1,0
50983,445,0,0,70,70,0,1,0,1,0
51526,445,0,0,70,70,0,1,0,1,0
57927,445,0,0,66,66,0,1,0,1,0
63193,445,0,0,70,70,0,1,0,1,0
60011,445,0,0,70,70,0,1,0,1,0
57148,445,0,0,66,66,0,1,0,1,0
55575,445,0,0,68,68,0,1,0,1,0
65460,445,0,0,70,70,0,1,0,1,0
51033,445,0,0,66,66,0,1,0,1,0
50053,445,0,0,70,70,0,1,0,1,0
56898,445,0,0,70,70,0,1,0,1,0
50516,445,0,0,70,70,0,1,0,1,0
56487,445,0,0,70,70,0,1,0,1,0
57857,445,0,0,70,70,0,1,0,1,0
51943,445,0,0,70,70,0,1,0,1,0
50309,445,0,0,66,66,0,1,0,1,0
58933,445,0,0,66,66,0,1,0,1,0
55957,445,0,0,70,70,0,1,0,1,0
57804,445,0,0,68,68,0,1,0,1,0
50837,445,0,0,70,70,0,1,0,1,0
64313,445,0,0,70,70,0,1,0,1,0
52084,445,0,0,66,66,0,1,0,1,0
55457,445,0,0,70,70,0,1,0,1,0
57927,445,0,0,70,70,0,1,0,1,0
52115,445,0,0,66,66,0,1,0,1,0
56012,445,0,0,69,69,0,1,0,1,0
50162,445,0,0,70,70,0,1,0,1,0
61977,445,0,0,66,66,0,1,0,1,0
57106,445,0,0,70,70,0,1,0,1,0
50429,445,0,0,70,70,0,1,0,1,0
51527,445,0,0,66,66,0,1,0,1,0
60563,445,0,0,69,69,0,1,0,1,0
63050,445,0,0,66,66,0,1,0,1,0
50023,445,0,0,68,68,0,1,0,1,0
60049,445,0,0,66,66,0,1,0,1,0
60599,445,0,0,70,70,0,1,0,1,0
55386,445,0,0,70,70,0,1,0,1,0
54998,445,0,0,70,70,0,1,0,1,0
49903,445,0,0,70,70,0,1,0,1,0
50099,445,0,0,66,66,0,1,0,1,0
51490,445,0,0,67,67,0,1,0,1,0
52220,445,0,0,70,70,0,1,0,1,0
52154,445,0,0,66,66,0,1,0,1,0
51643,445,0,0,66,66,0,1,0,1,0
64604,445,0,0,70,70,0,1,0,1,0
64154,445,0,0,70,70,0,1,0,1,0
51044,445,0,0,66,66,0,1,0,1,0
65130,445,0,0,68,68,0,1,0,1,0
65249,445,0,0,66,66,0,1,0,1,0
54519,445,0,0,70,70,0,1,0,1,0
49890,445,0,0,70,70,0,1,0,1,0
55420,445,0,0,66,66,0,1,0,1,0
50997,445,0,0,70,70,0,1,0,1,0
50589,445,0,0,70,70,0,1,0,1,0
49620,445,0,0,66,66,0,1,0,1,0
57741,445,0,0,68,68,0,1,0,1,0
61332,445,0,0,66,66,0,1,0,1,0
59176,445,0,0,70,70,0,1,0,1,0
60600,445,0,0,70,70,0,1,0,1,0
65479,445,0,0,70,70,0,1,0,1,0
60082,445,0,0,69,69,0,1,0,1,0
54796,445,0,0,70,70,0,1,0,1,0
55358,445,0,0,70,70,0,1,0,1,0
52956,445,0,0,70,70,0,1,0,1,0
50720,445,0,0,66,66,0,1,0,1,0
51525,445,0,0,70,70,0,1,0,1,0
64191,445,0,0,70,70,0,1,0,1,0
51806,445,0,0,70,70,0,1,0,1,0
50898,445,0,0,70,70,0,1,0,1,0
54392,445,0,0,66,66,0,1,0,1,0
58891,445,0,0,70,70,0,1,0,1,0
50030,445,0,0,70,70,0,1,0,1,0
54984,445,0,0,66,66,0,1,0,1,0
57405,445,0,0,70,70,0,1,0,1,0
54191,445,0,0,70,70,0,1,0,1,0
62540,445,0,0,66,66,0,1,0,1,0
50610,445,0,0,70,70,0,1,0,1,0
64357,445,0,0,67,67,0,1,0,1,0
60577,445,0,0,69,69,0,1,0,1,0
58901,445,0,0,70,70,0,1,0,1,0
53549,445,0,0,66,66,0,1,0,1,0
62174,445,0,0,70,70,0,1,0,1,0
49708,445,0,0,70,70,0,1,0,1,0
50620,445,0,0,66,66,0,1,0,1,0
56616,445,0,0,66,66,0,1,0,1,0
62679,445,0,0,70,70,0,1,0,1,0
57927,445,0,0,70,70,0,1,0,1,0
61385,445,0,0,66,66,0,1,0,1,0
57186,445,0,0,70,70,0,1,0,1,0
55501,445,0,0,70,70,0,1,0,1,0
55031,445,0,0,70,70,0,1,0,1,0
56518,445,0,0,70,70,0,1,0,1,0
60419,445,0,0,69,69,0,1,0,1,0
64710,445,0,0,70,70,0,1,0,1,0
49400,445,0,0,70,70,0,1,0,1,0
56898,445,0,0,70,70,0,1,0,1,0
56254,445,0,0,69,69,0,1,0,1,0
50109,445,0,0,70,70,0,1,0,1,0
57128,445,0,0,66,66,0,1,0,1,0
57250,445,0,0,66,66,0,1,0,1,0
65480,445,0,0,66,66,0,1,0,1,0
54748,445,0,0,70,70,0,1,0,1,0
56638,445,0,0,70,70,0,1,0,1,0
52405,445,0,0,68,68,0,1,0,1,0
63695,445,0,0,66,66,0,1,0,1,0
52626,445,0,0,70,70,0,1,0,1,0
54136,445,0,0,66,66,0,1,0,1,0
57041,445,0,0,68,68,0,1,0,1,0
50658,445,0,0,68,68,0,1,0,1,0
63971,445,0,0,66,66,0,1,0,1,0
55803,445,0,0,70,70,0,1,0,1,0
62044,445,0,0,68,68,0,1,0,1,0
65516,445,0,0,70,70,0,1,0,1,0
52764,445,0,0,69,69,0,1,0,1,0
54988,445,0,0,68,68,0,1,0,1,0
61662,445,0,0,70,70,0,1,0,1,0
61570,445,0,0,70,70,0,1,0,1,0
51370,445,0,0,70,70,0,1,0,1,0
57478,445,0,0,66,66,0,1,0,1,0
49350,445,0,0,68,68,0,1,0,1,0
55696,445,0,0,70,70,0,1,0,1,0
60629,445,0,0,69,69,0,1,0,1,0
59373,445,0,0,70,70,0,1,0,1,0
55950,445,0,0,70,70,0,1,0,1,0
55548,445,0,0,66,66,0,1,0,1,0
61467,445,0,0,67,67,0,1,0,1,0
58993,445,0,0,67,67,0,1,0,1,0
60895,445,0,0,66,66,0,1,0,1,0
52686,445,0,0,70,70,0,1,0,1,0
64684,445,0,0,70,70,0,1,0,1,0
55104,445,0,0,69,69,0,1,0,1,0
52524,445,0,0,70,70,0,1,0,1,0
50236,445,0,0,66,66,0,1,0,1,0
64601,445,0,0,66,66,0,1,0,1,0
55488,445,0,0,66,66,0,1,0,1,0
57012,445,0,0,70,70,0,1,0,1,0
55020,445,0,0,70,70,0,1,0,1,0
55617,445,0,0,70,70,0,1,0,1,0
63701,445,0,0,69,69,0,1,0,1,0
57943,445,0,0,70,70,0,1,0,1,0
49539,445,0,0,69,69,0,1,0,1,0
64950,445,0,0,70,70,0,1,0,1,0
62033,445,0,0,67,67,0,1,0,1,0
53649,445,0,0,70,70,0,1,0,1,0
62913,445,0,0,70,70,0,1,0,1,0
62211,445,0,0,70,70,0,1,0,1,0
60169,445,0,0,70,70,0,1,0,1,0
60904,445,0,0,70,70,0,1,0,1,0
63929,445,0,0,70,70,0,1,0,1,0
64941,445,0,0,70,70,0,1,0,1,0
51550,445,0,0,70,70,0,1,0,1,0
61569,445,0,0,70,70,0,1,0,1,0
50853,445,0,0,66,66,0,1,0,1,0
54977,445,0,0,70,70,0,1,0,1,0
59139,445,0,0,70,70,0,1,0,1,0
63302,445,0,0,70,70,0,1,0,1,0
64345,445,0,0,70,70,0,1,0,1,0
56446,445,0,0,70,70,0,1,0,1,0
53237,445,0,0,66,66,0,1,0,1,0
61592,445,0,0,70,70,0,1,0,1,0
59148,445,0,0,66,66,0,1,0,1,0
49807,445,0,0,70,70,0,1,0,1,0
64266,445,0,0,70,70,0,1,0,1,0
63516,445,0,0,66,66,0,1,0,1,0
63006,445,0,0,70,70,0,1,0,1,0
55260,445,0,0,70,70,0,1,0,1,0
54299,445,0,0,70,70,0,1,0,1,0
52847,445,0,0,70,70,0,1,0,1,0
63013,445,0,0,70,70,0,1,0,1,0
62888,445,0,0,70,70,0,1,0,1,0
62878,445,0,0,70,70,0,1,0,1,0
59861,445,0,0,66,66,0,1,0,1,0
62360,445,0,0,70,70,0,1,0,1,0
53561,445,0,0,66,66,0,1,0,1,0
57805,445,0,0,66,66,0,1,0,1,0
52688,445,0,0,70,70,0,1,0,1,0
55672,445,0,0,66,66,0,1,0,1,0
51074,445,0,0,70,70,0,1,0,1,0
57367,445,0,0,70,70,0,1,0,1,0
62444,445,0,0,70,70,0,1,0,1,0
52345,445,0,0,66,66,0,1,0,1,0
58394,445,0,0,69,69,0,1,0,1,0
52806,445,0,0,68,68,0,1,0,1,0
56052,445,0,0,70,70,0,1,0,1,0
61107,445,0,0,70,70,0,1,0,1,0
52583,445,0,0,66,66,0,1,0,1,0
59145,445,0,0,66,66,0,1,0,1,0
49881,445,0,0,70,70,0,1,0,1,0
63988,445,0,0,70,70,0,1,0,1,0
59577,445,0,0,70,70,0,1,0,1,0
52915,445,0,0,66,66,0,1,0,1,0
63546,445,0,0,67,67,0,1,0,1,0
56517,445,0,0,70,70,0,1,0,1,0
50656,445,0,0,66,66,0,1,0,1,0
57395,445,0,0,66,66,0,1,0,1,0
55183,445,0,0,66,66,0,1,0,1,0
50711,445,0,0,70,70,0,1,0,1,0
60419,445,0,0,70,70,0,1,0,1,0
51489,445,0,0,68,68,0,1,0,1,0
53742,445,0,0,70,70,0,1,0,1,0
59709,445,0,0,69,69,0,1,0,1,0
55456,445,0,0,70,70,0,1,0,1,0
61658,445,0,0,70,70,0,1,0,1,0
60866,445,0,0,70,70,0,1,0,1,0
65038,445,0,0,69,69,0,1,0,1,0
52328,445,0,0,70,70,0,1,0,1,0
49402,445,0,0,66,66,0,1,0,1,0
60117,445,0,0,66,66,0,1,0,1,0
59982,445,0,0,69,69,0,1,0,1,0
52275,445,0,0,67,67,0,1,0,1,0
56629,445,0,0,66,66,0,1,0,1,0
64487,445,0,0,66,66,0,1,0,1,0
58972,445,0,0,70,70,0,1,0,1,0
57384,445,0,0,70,70,0,1,0,1,0
53338,445,0,0,70,70,0,1,0,1,0
49777,445,0,0,70,70,0,1,0,1,0
52015,445,0,0,70,70,0,1,0,1,0
64312,445,0,0,70,70,0,1,0,1,0
64220,445,0,0,68,68,0,1,0,1,0
62235,445,0,0,68,68,0,1,0,1,0
49175,445,0,0,66,66,0,1,0,1,0
59055,445,0,0,70,70,0,1,0,1,0
58628,445,0,0,70,70,0,1,0,1,0
60630,445,0,0,66,66,0,1,0,1,0
52779,445,0,0,67,67,0,1,0,1,0
60273,445,0,0,70,70,0,1,0,1,0
55976,445,0,0,70,70,0,1,0,1,0
50796,445,0,0,66,66,0,1,0,1,0
50856,445,0,0,66,66,0,1,0,1,0
50483,445,0,0,66,66,0,1,0,1,0
49887,445,0,0,70,70,0,1,0,1,0
62616,445,0,0,66,66,0,1,0,1,0
64566,445,0,0,70,70,0,1,0,1,0
54358,445,0,0,70,70,0,1,0,1,0
63796,445,0,0,70,70,0,1,0,1,0
52239,445,0,0,70,70,0,1,0,1,0
53415,445,0,0,69,69,0,1,0,1,0
53192,445,0,0,70,70,0,1,0,1,0
65025,445,0,0,70,70,0,1,0,1,0
60508,445,0,0,68,68,0,1,0,1,0
56451,445,0,0,66,66,0,1,0,1,0
49625,445,0,0,70,70,0,1,0,1,0
64436,445,0,0,70,70,0,1,0,1,0
64041,445,0,0,70,70,0,1,0,1,0
49489,445,0,0,70,70,0,1,0,1,0
64562,445,0,0,70,70,0,1,0,1,0
49357,445,0,0,67,67,0,1,0,1,0
55789,445,0,0,66,66,0,1,0,1,0
55757,445,0,0,66,66,0,1,0,1,0
51038,445,0,0,70,70,0,1,0,1,0
55714,445,0,0,70,70,0,1,0,1,0
53962,445,0,0,70,70,0,1,0,1,0
62619,445,0,0,70,70,0,1,0,1,0
61912,445,0,0,66,66,0,1,0,1,0
57431,445,0,0,70,70,0,1,0,1,0
61869,445,0,0,70,70,0,1,0,1,0
60721,445,0,0,68,68,0,1,0,1,0
62718,445,0,0,70,70,0,1,0,1,0
56674,445,0,0,70,70,0,1,0,1,0
62249,445,0,0,70,70,0,1,0,1,0
54253,445,0,0,70,70,0,1,0,1,0
59733,445,0,0,70,70,0,1,0,1,0
60866,445,0,0,70,70,0,1,0,1,0
58729,445,0,0,69,69,0,1,0,1,0
59297,445,0,0,68,68,0,1,0,1,0
60814,445,0,0,70,70,0,1,0,1,0
53028,445,0,0,70,70,0,1,0,1,0
50745,445,0,0,70,70,0,1,0,1,0
64456,445,0,0,70,70,0,1,0,1,0
49996,445,0,0,70,70,0,1,0,1,0
56682,445,0,0,70,70,0,1,0,1,0
63254,445,0,0,66,66,0,1,0,1,0
56336,445,0,0,70,70,0,1,0,1,0
52458,445,0,0,70,70,0,1,0,1,0
52007,445,0,0,66,66,0,1,0,1,0
54872,445,0,0,70,70,0,1,0,1,0
50523,445,0,0,70,70,0,1,0,1,0
50149,445,0,0,70,70,0,1,0,1,0
53087,445,0,0,70,70,0,1,0,1,0
51522,445,0,0,70,70,0,1,0,1,0
54413,445,0,0,70,70,0,1,0,1,0
55200,445,0,0,70,70,0,1,0,1,0
62872,445,0,0,66,66,0,1,0,1,0
51004,445,0,0,70,70,0,1,0,1,0
54574,445,0,0,66,66,0,1,0,1,0
59571,445,0,0,70,70,0,1,0,1,0
64100,445,0,0,67,67,0,1,0,1,0
53721,445,0,0,70,70,0,1,0,1,0
58316,445,0,0,70,70,0,1,0,1,0
50944,445,0,0,70,70,0,1,0,1,0
54491,445,0,0,70,70,0,1,0,1,0
57960,445,0,0,70,70,0,1,0,1,0
50423,445,0,0,70,70,0,1,0,1,0
64567,445,0,0,67,67,0,1,0,1,0
56811,445,0,0,70,70,0,1,0,1,0
55076,445,0,0,70,70,0,1,0,1,0
51313,445,0,0,70,70,0,1,0,1,0
53832,445,0,0,70,70,0,1,0,1,0
53566,445,0,0,67,67,0,1,0,1,0
53358,445,0,0,70,70,0,1,0,1,0
53362,445,0,0,70,70,0,1,0,1,0
52371,445,0,0,70,70,0,1,0,1,0
65027,445,0,0,70,70,0,1,0,1,0
58766,445,0,0,70,70,0,1,0,1,0
55182,445,0,0,69,69,0,1,0,1,0
51063,445,0,0,66,66,0,1,0,1,0
51468,445,0,0,68,68,0,1,0,1,0
56790,445,0,0,70,70,0,1,0,1,0
61450,445,0,0,66,66,0,1,0,1,0
63016,445,0,0,66,66,0,1,0,1,0
61500,445,0,0,66,66,0,1,0,1,0
54206,445,0,0,70,70,0,1,0,1,0
54774,445,0,0,70,70,0,1,0,1,0
62074,445,0,0,69,69,0,1,0,1,0
64674,445,0,0,70,70,0,1,0,1,0
65186,445,0,0,70,70,0,1,0,1,0
61127,445,0,0,67,67,0,1,0,1,0
64301,445,0,0,67,67,0,1,0,1,0
50194,445,0,0,70,70,0,1,0,1,0
49923,445,0,0,70,70,0,1,0,1,0
63436,445,0,0,66,66,0,1,0,1,0
58196,445,0,0,69,69,0,1,0,1,0
62540,445,0,0,66,66,0,1,0,1,0
50561,445,0,0,70,70,0,1,0,1,0
58520,445,0,0,70,70,0,1,0,1,0
65305,445,0,0,66,66,0,1,0,1,0
63032,445,0,0,70,70,0,1,0,1,0
49849,445,0,0,70,70,0,1,0,1,0
51471,445,0,0,70,70,0,1,0,1,0
55056,445,0,0,70,70,0,1,0,1,0
58820,445,0,0,68,68,0,1,0,1,0
49724,445,0,0,67,67,0,1,0,1,0
51541,445,0,0,70,70,0,1,0,1,0
49446,445,0,0,70,70,0,1,0,1,0
55620,445,0,0,70,70,0,1,0,1,0
55068,445,0,0,70,70,0,1,0,1,0
54873,445,0,0,70,70,0,1,0,1,0
49401,445,0,0,67,67,0,1,0,1,0
51214,445,0,0,70,70,0,1,0,1,0
49741,445,0,0,66,66,0,1,0,1,0
59465,445,0,0,66,66,0,1,0,1,0
50672,445,0,0,66,66,0,1,0,1,0
59930,445,0,0,70,70,0,1,0,1,0
51038,445,0,0,70,70,0,1,0,1,0
64005,445,0,0,70,70,0,1,0,1,0
51637,445,0,0,66,66,0,1,0,1,0
54269,445,0,0,70,70,0,1,0,1,0
50673,445,0,0,66,66,0,1,0,1,0
51158,445,0,0,70,70,0,1,0,1,0
54364,445,0,0,70,70,0,1,0,1,0
62663,445,0,0,70,70,0,1,0,1,0
64467,445,0,0,70,70,0,1,0,1,0
49952,445,0,0,70,70,0,1,0,1,0
50389,445,0,0,70,70,0,1,0,1,0
55083,445,0,0,70,70,0,1,0,1,0
53291,445,0,0,66,66,0,1,0,1,0
59734,445,0,0,70,70,0,1,0,1,0
63815,445,0,0,70,70,0,1,0,1,0
57271,445,0,0,66,66,0,1,0,1,0
58710,445,0,0,66,66,0,1,0,1,0
63261,445,0,0,70,70,0,1,0,1,0
50619,445,0,0,69,69,0,1,0,1,0
65050,445,0,0,69,69,0,1,0,1,0
64237,445,0,0,67,67,0,1,0,1,0
58497,445,0,0,69,69,0,1,0,1,0
54571,445,0,0,70,70,0,1,0,1,0
56076,445,0,0,70,70,0,1,0,1,0
63288,445,0,0,69,69,0,1,0,1,0
58701,445,0,0,70,70,0,1,0,1,0
52660,445,0,0,66,66,0,1,0,1,0
53672,445,0,0,70,70,0,1,0,1,0
49215,445,0,0,70,70,0,1,0,1,0
50865,445,0,0,66,66,0,1,0,1,0
62554,445,0,0,69,69,0,1,0,1,0
60474,445,0,0,70,70,0,1,0,1,0
63971,445,0,0,66,66,0,1,0,1,0
49493,445,0,0,70,70,0,1,0,1,0
58606,445,0,0,68,68,0,1,0,1,0
64967,445,0,0,70,70,0,1,0,1,0
50610,445,0,0,70,70,0,1,0,1,0
53746,445,0,0,70,70,0,1,0,1,0
53986,445,0,0,70,70,0,1,0,1,0
54668,445,0,0,66,66,0,1,0,1,0
53404,445,0,0,66,66,0,1,0,1,0
51908,445,0,0,66,66,0,1,0,1,0
58758,445,0,0,66,66,0,1,0,1,0
57731,445,0,0,66,66,0,1,0,1,0
57774,445,0,0,70,70,0,1,0,1,0
50739,445,0,0,66,66,0,1,0,1,0
57450,445,0,0,70,70,0,1,0,1,0
49812,445,0,0,70,70,0,1,0,1,0
61349,445,0,0,66,66,0,1,0,1,0
62146,445,0,0,70,70,0,1,0,1,0
52696,445,0,0,70,70,0,1,0,1,0
60098,445,0,0,70,70,0,1,0,1,0
58961,445,0,0,67,67,0,1,0,1,0
52522,445,0,0,70,70,0,1,0,1,0
50603,445,0,0,70,70,0,1,0,1,0
64742,445,0,0,66,66,0,1,0,1,0
50129,445,0,0,70,70,0,1,0,1,0
56275,445,0,0,69,69,0,1,0,1,0
64404,445,0,0,66,66,0,1,0,1,0
49665,445,0,0,70,70,0,1,0,1,0
52084,445,0,0,67,67,0,1,0,1,0
50411,445,0,0,70,70,0,1,0,1,0
53290,445,0,0,66,66,0,1,0,1,0
49712,445,0,0,66,66,0,1,0,1,0
58058,445,0,0,70,70,0,1,0,1,0
65061,445,0,0,70,70,0,1,0,1,0
53122,445,0,0,70,70,0,1,0,1,0
54233,445,0,0,70,70,0,1,0,1,0
57892,445,0,0,70,70,0,1,0,1,0
64937,445,0,0,66,66,0,1,0,1,0
56545,445,0,0,70,70,0,1,0,1,0
50778,445,0,0,70,70,0,1,0,1,0
49630,445,0,0,70,70,0,1,0,1,0
62278,445,0,0,70,70,0,1,0,1,0
62872,445,0,0,66,66,0,1,0,1,0
56075,445,0,0,70,70,0,1,0,1,0
59082,445,0,0,67,67,0,1,0,1,0
60089,445,0,0,70,70,0,1,0,1,0
56131,445,0,0,70,70,0,1,0,1,0
50866,445,0,0,70,70,0,1,0,1,0
60560,445,0,0,70,70,0,1,0,1,0
53117,445,0,0,70,70,0,1,0,1,0
50483,445,0,0,66,66,0,1,0,1,0
58286,445,0,0,70,70,0,1,0,1,0
50807,445,0,0,66,66,0,1,0,1,0
57397,445,0,0,66,66,0,1,0,1,0
53871,445,0,0,70,70,0,1,0,1,0
55707,445,0,0,70,70,0,1,0,1,0
59676,445,0,0,69,69,0,1,0,1,0
58818,445,0,0,70,70,0,1,0,1,0
50228,445,0,0,69,69,0,1,0,1,0
55864,445,0,0,66,66,0,1,0,1,0
53426,445,0,0,66,66,0,1,0,1,0
58281,445,0,0,66,66,0,1,0,1,0
55363,445,0,0,70,70,0,1,0,1,0
56885,445,0,0,70,70,0,1,0,1,0
54073,445,0,0,67,67,0,1,0,1,0
61634,445,0,0,66,66,0,1,0,1,0
49519,445,0,0,70,70,0,1,0,1,0
63494,445,0,0,69,69,0,1,0,1,0
51684,445,0,0,66,66,0,1,0,1,0
63714,445,0,0,70,70,0,1,0,1,0
61211,445,0,0,66,66,0,1,0,1,0
50426,445,0,0,70,70,0,1,0,1,0
55450,445,0,0,70,70,0,1,0,1,0
62900,445,0,0,66,66,0,1,0,1,0
58268,445,0,0,70,70,0,1,0,1,0
52401,445,0,0,70,70,0,1,0,1,0
61620,445,0,0,70,70,0,1,0,1,0
64589,445,0,0,70,70,0,1,0,1,0
50591,445,0,0,70,70,0,1,0,1,0
50847,445,0,0,66,66,0,1,0,1,0
57244,445,0,0,70,70,0,1,0,1,0
58209,445,0,0,70,70,0,1,0,1,0
57237,445,0,0,70,70,0,1,0,1,0
59650,445,0,0,70,70,0,1,0,1,0
55412,445,0,0,70,70,0,1,0,1,0
50889,445,0,0,70,70,0,1,0,1,0
56533,445,0,0,68,68,0,1,0,1,0
51226,445,0,0,69,69,0,1,0,1,0
57238,445,0,0,70,70,0,1,0,1,0
64614,445,0,0,70,70,0,1,0,1,0
55172,445,0,0,70,70,0,1,0,1,0
61057,445,0,0,70,70,0,1,0,1,0
64615,445,0,0,69,69,0,1,0,1,0
57158,445,0,0,70,70,0,1,0,1,0
50321,445,0,0,70,70,0,1,0,1,0
63326,445,0,0,68,68,0,1,0,1,0
50404,445,0,0,70,70,0,1,0,1,0
57617,445,0,0,70,70,0,1,0,1,0
61270,445,0,0,70,70,0,1,0,1,0
51107,445,0,0,67,67,0,1,0,1,0
62085,445,0,0,67,67,0,1,0,1,0
58567,445,0,0,70,70,0,1,0,1,0
58901,445,0,0,70,70,0,1,0,1,0
50580,445,0,0,70,70,0,1,0,1,0
55864,445,0,0,66,66,0,1,0,1,0
54490,445,0,0,70,70,0,1,0,1,0
54005,445,0,0,70,70,0,1,0,1,0
53459,445,0,0,69,69,0,1,0,1,0
50349,445,0,0,70,70,0,1,0,1,0
58785,445,0,0,68,68,0,1,0,1,0
58316,445,0,0,70,70,0,1,0,1,0
56258,445,0,0,68,68,0,1,0,1,0
57754,445,0,0,70,70,0,1,0,1,0
60445,445,0,0,66,66,0,1,0,1,0
51947,445,0,0,70,70,0,1,0,1,0
57733,445,0,0,66,66,0,1,0,1,0
60292,445,0,0,70,70,0,1,0,1,0
53043,445,0,0,68,68,0,1,0,1,0
49553,445,0,0,70,70,0,1,0,1,0
52532,445,0,0,70,70,0,1,0,1,0
57497,445,0,0,70,70,0,1,0,1,0
51560,445,0,0,70,70,0,1,0,1,0
57287,445,0,0,70,70,0,1,0,1,0
64835,445,0,0,70,70,0,1,0,1,0
56256,445,0,0,67,67,0,1,0,1,0
50580,445,0,0,70,70,0,1,0,1,0
54037,445,0,0,67,67,0,1,0,1,0
59089,445,0,0,70,70,0,1,0,1,0
50339,445,0,0,70,70,0,1,0,1,0
55773,445,0,0,70,70,0,1,0,1,0
58390,445,0,0,68,68,0,1,0,1,0
53757,445,0,0,70,70,0,1,0,1,0
63890,445,0,0,70,70,0,1,0,1,0
61620,445,0,0,70,70,0,1,0,1,0
55917,445,0,0,68,68,0,1,0,1,0
56814,445,0,0,70,70,0,1,0,1,0
52973,445,0,0,70,70,0,1,0,1,0
58889,445,0,0,66,66,0,1,0,1,0
53749,445,0,0,68,68,0,1,0,1,0
51325,445,0,0,67,67,0,1,0,1,0
52759,445,0,0,67,67,0,1,0,1,0
58116,445,0,0,69,69,0,1,0,1,0
56993,445,0,0,70,70,0,1,0,1,0
53265,445,0,0,70,70,0,1,0,1,0
52533,445,0,0,70,70,0,1,0,1,0
56873,445,0,0,70,70,0,1,0,1,0
61831,445,0,0,66,66,0,1,0,1,0
61461,445,0,0,69,69,0,1,0,1,0
58736,445,0,0,70,70,0,1,0,1,0
59663,445,0,0,69,69,0,1,0,1,0
56488,445,0,0,67,67,0,1,0,1,0
52445,445,0,0,70,70,0,1,0,1,0
54519,445,0,0,70,70,0,1,0,1,0
51119,445,0,0,66,66,0,1,0,1,0
64374,445,0,0,70,70,0,1,0,1,0
50384,445,0,0,70,70,0,1,0,1,0
49651,445,0,0,69,69,0,1,0,1,0
57652,445,0,0,69,69,0,1,0,1,0
53760,445,0,0,70,70,0,1,0,1,0
50425,445,0,0,70,70,0,1,0,1,0
62130,445,0,0,70,70,0,1,0,1,0
53236,445,0,0,66,66,0,1,0,1,0
63465,445,0,0,70,70,0,1,0,1,0
64810,445,0,0,66,66,0,1,0,1,0
63714,445,0,0,70,70,0,1,0,1,0
61806,445,0,0,70,70,0,1,0,1,0
57628,445,0,0,70,70,0,1,0,1,0
63695,445,0,0,66,66,0,1,0,1,0
58546,445,0,0,70,70,0,1,0,1,0
58318,445,0,0,69,69,0,1,0,1,0
64422,445,0,0,66,66,0,1,0,1,0
59473,445,0,0,66,66,0,1,0,1,0
55545,445,0,0,70,70,0,1,0,1,0
54387,445,0,0,70,70,0,1,0,1,0
53547,445,0,0,69,69,0,1,0,1,0
61255,445,0,0,70,70,0,1,0,1,0
61663,445,0,0,70,70,0,1,0,1,0
59231,445,0,0,69,69,0,1,0,1,0
50664,445,0,0,66,66,0,1,0,1,0
51788,445,0,0,66,66,0,1,0,1,0
60740,445,0,0,70,70,0,1,0,1,0
49350,445,0,0,70,70,0,1,0,1,0
60361,445,0,0,68,68,0,1,0,1,0
56834,445,0,0,66,66,0,1,0,1,0
62086,445,0,0,70,70,0,1,0,1,0
50555,445,0,0,70,70,0,1,0,1,0
64339,445,0,0,69,69,0,1,0,1,0
49805,445,0,0,70,70,0,1,0,1,0
50555,445,0,0,70,70,0,1,0,1,0
55036,445,0,0,70,70,0,1,0,1,0
53162,445,0,0,70,70,0,1,0,1,0
55117,445,0,0,70,70,0,1,0,1,0
51000,445,0,0,70,70,0,1,0,1,0
55143,445,0,0,66,66,0,1,0,1,0
51684,445,0,0,66,66,0,1,0,1,0
55223,445,0,0,66,66,0,1,0,1,0
57644,445,0,0,70,70,0,1,0,1,0
55359,445,0,0,70,70,0,1,0,1,0
63940,445,0,0,70,70,0,1,0,1,0
53269,445,0,0,70,70,0,1,0,1,0
64386,445,0,0,70,70,0,1,0,1,0
58545,445,0,0,70,70,0,1,0,1,0
57414,445,0,0,70,70,0,1,0,1,0
60379,445,0,0,70,70,0,1,0,1,0
55916,445,0,0,70,70,0,1,0,1,0
51716,445,0,0,69,69,0,1,0,1,0
59420,445,0,0,66,66,0,1,0,1,0
57284,445,0,0,70,70,0,1,0,1,0
56795,445,0,0,66,66,0,1,0,1,0
60563,445,0,0,66,66,0,1,0,1,0
59653,445,0,0,70,70,0,1,0,1,0
49701,445,0,0,70,70,0,1,0,1,0
51131,445,0,0,70,70,0,1,0,1,0
64685,445,0,0,69,69,0,1,0,1,0
54915,445,0,0,70,70,0,1,0,1,0
56278,445,0,0,70,70,0,1,0,1,0
59770,445,0,0,66,66,0,1,0,1,0
60677,445,0,0,70,70,0,1,0,1,0
54247,445,0,0,66,66,0,1,0,1,0
57622,445,0,0,68,68,0,1,0,1,0
50466,445,0,0,70,70,0,1,0,1,0
60988,445,0,0,66,66,0,1,0,1,0
59690,445,0,0,69,69,0,1,0,1,0
50356,445,0,0,66,66,0,1,0,1,0
60786,445,0,0,70,70,0,1,0,1,0
54246,445,0,0,66,66,0,1,0,1,0
54234,445,0,0,70,70,0,1,0,1,0
52020,445,0,0,66,66,0,1,0,1,0
56638,445,0,0,70,70,0,1,0,1,0
52378,445,0,0,70,70,0,1,0,1,0
60546,445,0,0,66,66,0,1,0,1,0
62172,445,0,0,70,70,0,1,0,1,0
55436,445,0,0,67,67,0,1,0,1,0
59651,445,0,0,70,70,0,1,0,1,0
50749,445,0,0,66,66,0,1,0,1,0
60409,445,0,0,70,70,0,1,0,1,0
64008,445,0,0,70,70,0,1,0,1,0
60203,445,0,0,66,66,0,1,0,1,0
50700,445,0,0,70,70,0,1,0,1,0
61490,445,0,0,70,70,0,1,0,1,0
56385,445,0,0,70,70,0,1,0,1,0
51891,445,0,0,66,66,0,1,0,1,0
60947,445,0,0,70,70,0,1,0,1,0
64812,445,0,0,68,68,0,1,0,1,0
62032,445,0,0,66,66,0,1,0,1,0
52863,445,0,0,70,70,0,1,0,1,0
63716,445,0,0,70,70,0,1,0,1,0
60563,445,0,0,68,68,0,1,0,1,0
63712,445,0,0,66,66,0,1,0,1,0
50480,445,0,0,66,66,0,1,0,1,0
61162,445,0,0,69,69,0,1,0,1,0
54758,445,0,0,66,66,0,1,0,1,0
53247,445,0,0,70,70,0,1,0,1,0
63365,445,0,0,70,70,0,1,0,1,0
51067,445,0,0,70,70,0,1,0,1,0
62363,445,0,0,66,66,0,1,0,1,0
50601,445,0,0,66,66,0,1,0,1,0
63430,445,0,0,70,70,0,1,0,1,0
52628,445,0,0,70,70,0,1,0,1,0
63066,445,0,0,66,66,0,1,0,1,0
62876,445,0,0,69,69,0,1,0,1,0
54647,445,0,0,66,66,0,1,0,1,0
51642,445,0,0,66,66,0,1,0,1,0
49475,445,0,0,70,70,0,1,0,1,0
59631,445,0,0,70,70,0,1,0,1,0
49647,445,0,0,66,66,0,1,0,1,0
55741,445,0,0,66,66,0,1,0,1,0
57818,445,0,0,66,66,0,1,0,1,0
64739,445,0,0,70,70,0,1,0,1,0
50741,445,0,0,66,66,0,1,0,1,0
53740,445,0,0,70,70,0,1,0,1,0
62956,445,0,0,70,70,0,1,0,1,0
56818,445,0,0,66,66,0,1,0,1,0
63367,445,0,0,70,70,0,1,0,1,0
50487,445,0,0,70,70,0,1,0,1,0
53501,445,0,0,70,70,0,1,0,1,0
64894,445,0,0,70,70,0,1,0,1,0
54050,445,0,0,70,70,0,1,0,1,0
50498,445,0,0,67,67,0,1,0,1,0
61332,445,0,0,66,66,0,1,0,1,0
61287,445,0,0,68,68,0,1,0,1,0
63353,445,0,0,70,70,0,1,0,1,0
52198,445,0,0,70,70,0,1,0,1,0
65196,445,0,0,66,66,0,1,0,1,0
49444,445,0,0,70,70,0,1,0,1,0
50838,445,0,0,70,70,0,1,0,1,0
56228,445,0,0,70,70,0,1,0,1,0
58502,445,0,0,66,66,0,1,0,1,0
49810,445,0,0,70,70,0,1,0,1,0
50306,445,0,0,66,66,0,1,0,1,0
51185,445,0,0,66,66,0,1,0,1,0
65024,445,0,0,70,70,0,1,0,1,0
51043,445,0,0,70,70,0,1,0,1,0
58970,445,0,0,70,70,0,1,0,1,0
54956,445,0,0,70,70,0,1,0,1,0
64692,445,0,0,70,70,0,1,0,1,0
56322,445,0,0,66,66,0,1,0,1,0
51758,445,0,0,70,70,0,1,0,1,0
52912,445,0,0,66,66,0,1,0,1,0
56773,445,0,0,70,70,0,1,0,1,0
56155,445,0,0,70,70,0,1,0,1,0
61112,445,0,0,70,70,0,1,0,1,0
53866,445,0,0,70,70,0,1,0,1,0
51372,445,0,0,69,69,0,1,0,1,0
50666,445,0,0,66,66,0,1,0,1,0
52356,445,0,0,70,70,0,1,0,1,0
50998,445,0,0,70,70,0,1,0,1,0
56576,445,0,0,68,68,0,1,0,1,0
55491,445,0,0,70,70,0,1,0,1,0
63516,445,0,0,70,70,0,1,0,1,0
62527,445,0,0,70,70,0,1,0,1,0
50069,445,0,0,70,70,0,1,0,1,0
60455,445,0,0,66,66,0,1,0,1,0
56249,445,0,0,68,68,0,1,0,1,0
49488,445,0,0,70,70,0,1,0,1,0
60603,445,0,0,70,70,0,1,0,1,0
53046,445,0,0,70,70,0,1,0,1,0
58351,445,0,0,70,70,0,1,0,1,0
55289,445,0,0,66,66,0,1,0,1,0
63466,445,0,0,70,70,0,1,0,1,0
49604,445,0,0,70,70,0,1,0,1,0
54552,445,0,0,67,67,0,1,0,1,0
64161,445,0,0,66,66,0,1,0,1,0
58330,445,0,0,70,70,0,1,0,1,0
51063,445,0,0,66,66,0,1,0,1,0
51883,445,0,0,66,66,0,1,0,1,0
53456,445,0,0,70,70,0,1,0,1,0
54328,445,0,0,70,70,0,1,0,1,0
59649,445,0,0,70,70,0,1,0,1,0
57242,445,0,0,70,70,0,1,0,1,0
50040,445,0,0,69,69,0,1,0,1,0
51179,445,0,0,68,68,0,1,0,1,0
63314,445,0,0,67,67,0,1,0,1,0
61933,445,0,0,70,70,0,1,0,1,0
57499,445,0,0,70,70,0,1,0,1,0
55974,445,0,0,70,70,0,1,0,1,0
53777,445,0,0,70,70,0,1,0,1,0
57789,445,0,0,69,69,0,1,0,1,0
50386,445,0,0,70,70,0,1,0,1,0
64947,445,0,0,70,70,0,1,0,1,0
56754,445,0,0,70,70,0,1,0,1,0
56206,445,0,0,70,70,0,1,0,1,0
60884,445,0,0,70,70,0,1,0,1,0
64365,445,0,0,66,66,0,1,0,1,0
62832,445,0,0,69,69,0,1,0,1,0
52820,445,0,0,70,70,0,1,0,1,0
56771,445,0,0,70,70,0,1,0,1,0
60811,445,0,0,70,70,0,1,0,1,0
62248,445,0,0,70,70,0,1,0,1,0
52313,445,0,0,70,70,0,1,0,1,0
63070,445,0,0,70,70,0,1,0,1,0
49996,445,0,0,66,66,0,1,0,1,0
50289,445,0,0,70,70,0,1,0,1,0
51620,445,0,0,70,70,0,1,0,1,0
52294,445,0,0,66,66,0,1,0,1,0
59907,445,0,0,70,70,0,1,0,1,0
51825,445,0,0,67,67,0,1,0,1,0
49192,445,0,0,70,70,0,1,0,1,0
55193,445,0,0,70,70,0,1,0,1,0
51085,445,0,0,70,70,0,1,0,1,0
62184,445,0,0,70,70,0,1,0,1,0
65025,445,0,0,70,70,0,1,0,1,0
60016,445,0,0,70,70,0,1,0,1,0
57116,445,0,0,70,70,0,1,0,1,0
53074,445,0,0,67,67,0,1,0,1,0
58165,445,0,0,66,66,0,1,0,1,0
50149,445,0,0,70,70,0,1,0,1,0
62438,445,0,0,69,69,0,1,0,1,0
52885,445,0,0,67,67,0,1,0,1,0
63903,445,0,0,66,66,0,1,0,1,0
61010,445,0,0,70,70,0,1,0,1,0
62298,445,0,0,69,69,0,1,0,1,0
55819,445,0,0,70,70,0,1,0,1,0
65217,445,0,0,69,69,0,1,0,1,0
61989,445,0,0,70,70,0,1,0,1,0
64345,445,0,0,70,70,0,1,0,1,0
51038,445,0,0,70,70,0,1,0,1,0
49424,445,0,0,70,70,0,1,0,1,0
55620,445,0,0,70,70,0,1,0,1,0
58035,445,0,0,70,70,0,1,0,1,0
63277,445,0,0,66,66,0,1,0,1,0
57273,445,0,0,67,67,0,1,0,1,0
60563,445,0,0,68,68,0,1,0,1,0
62313,445,0,0,70,70,0,1,0,1,0
55407,445,0,0,70,70,0,1,0,1,0
61200,445,0,0,70,70,0,1,0,1,0
52305,445,0,0,70,70,0,1,0,1,0
50522,445,0,0,70,70,0,1,0,1,0
54354,445,0,0,70,70,0,1,0,1,0
64925,445,0,0,70,70,0,1,0,1,0
52071,445,0,0,70,70,0,1,0,1,0
52779,445,0,0,70,70,0,1,0,1,0
53079,445,0,0,70,70,0,1,0,1,0
55266,445,0,0,70,70,0,1,0,1,0
51040,445,0,0,70,70,0,1,0,1,0
49797,445,0,0,70,70,0,1,0,1,0
49563,445,0,0,70,70,0,1,0,1,0
49715,445,0,0,66,66,0,1,0,1,0
52786,445,0,0,66,66,0,1,0,1,0
59096,445,0,0,67,67,0,1,0,1,0
59200,445,0,0,70,70,0,1,0,1,0
57679,445,0,0,70,70,0,1,0,1,0
50523,445,0,0,70,70,0,1,0,1,0
56059,445,0,0,70,70,0,1,0,1,0
54628,445,0,0,70,70,0,1,0,1,0
56917,445,0,0,70,70,0,1,0,1,0
52222,445,0,0,70,70,0,1,0,1,0
54385,445,0,0,70,70,0,1,0,1,0
50148,445,0,0,68,68,0,1,0,1,0
59141,445,0,0,66,66,0,1,0,1,0
62914,445,0,0,70,70,0,1,0,1,0
57228,445,0,0,70,70,0,1,0,1,0
56191,445,0,0,70,70,0,1,0,1,0
57389,445,0,0,70,70,0,1,0,1,0
53031,445,0,0,66,66,0,1,0,1,0
49267,445,0,0,70,70,0,1,0,1,0
61873,445,0,0,70,70,0,1,0,1,0
58245,445,0,0,67,67,0,1,0,1,0
59864,445,0,0,70,70,0,1,0,1,0
65056,445,0,0,70,70,0,1,0,1,0
59016,445,0,0,70,70,0,1,0,1,0
59529,445,0,0,66,66,0,1,0,1,0
52164,445,0,0,70,70,0,1,0,1,0
65058,445,0,0,70,70,0,1,0,1,0
53091,445,0,0,66,66,0,1,0,1,0
62818,445,0,0,70,70,0,1,0,1,0
56130,445,0,0,70,70,0,1,0,1,0
52462,445,0,0,70,70,0,1,0,1,0
51057,445,0,0,66,66,0,1,0,1,0
54942,445,0,0,70,70,0,1,0,1,0
49644,445,0,0,70,70,0,1,0,1,0
62166,445,0,0,66,66,0,1,0,1,0
53043,445,0,0,70,70,0,1,0,1,0
52927,445,0,0,67,67,0,1,0,1,0
50161,445,0,0,66,66,0,1,0,1,0
58285,445,0,0,70,70,0,1,0,1,0
53531,445,0,0,70,70,0,1,0,1,0
59062,445,0,0,70,70,0,1,0,1,0
54331,445,0,0,70,70,0,1,0,1,0
50684,445,0,0,70,70,0,1,0,1,0
59724,445,0,0,68,68,0,1,0,1,0
58235,445,0,0,70,70,0,1,0,1,0
53470,445,0,0,70,70,0,1,0,1,0
63926,445,0,0,70,70,0,1,0,1,0
63425,445,0,0,70,70,0,1,0,1,0
62529,445,0,0,70,70,0,1,0,1,0
53118,445,0,0,70,70,0,1,0,1,0
63790,445,0,0,70,70,0,1,0,1,0
62664,445,0,0,66,66,0,1,0,1,0
59733,445,0,0,70,70,0,1,0,1,0
53899,445,0,0,66,66,0,1,0,1,0
53096,445,0,0,67,67,0,1,0,1,0
53567,445,0,0,66,66,0,1,0,1,0
50025,445,0,0,70,70,0,1,0,1,0
62557,445,0,0,67,67,0,1,0,1,0
65154,445,0,0,70,70,0,1,0,1,0
56793,445,0,0,70,70,0,1,0,1,0
50880,445,0,0,70,70,0,1,0,1,0
64100,445,0,0,66,66,0,1,0,1,0
50582,445,0,0,70,70,0,1,0,1,0
63016,445,0,0,66,66,0,1,0,1,0
50675,445,0,0,66,66,0,1,0,1,0
51461,445,0,0,66,66,0,1,0,1,0
60270,445,0,0,70,70,0,1,0,1,0
61753,445,0,0,70,70,0,1,0,1,0
63496,445,0,0,67,67,0,1,0,1,0
64433,445,0,0,70,70,0,1,0,1,0
54715,445,0,0,70,70,0,1,0,1,0
56716,445,0,0,70,70,0,1,0,1,0
53813,445,0,0,68,68,0,1,0,1,0
55723,445,0,0,70,70,0,1,0,1,0
62777,445,0,0,70,70,0,1,0,1,0
61816,445,0,0,68,68,0,1,0,1,0
50757,445,0,0,66,66,0,1,0,1,0
54179,445,0,0,70,70,0,1,0,1,0
60441,445,0,0,70,70,0,1,0,1,0
54538,445,0,0,70,70,0,1,0,1,0
50307,445,0,0,66,66,0,1,0,1,0
49779,445,0,0,66,66,0,1,0,1,0
55465,445,0,0,70,70,0,1,0,1,0
53289,445,0,0,66,66,0,1,0,1,0
52186,445,0,0,70,70,0,1,0,1,0
53900,445,0,0,66,66,0,1,0,1,0
50658,445,0,0,68,68,0,1,0,1,0
51030,445,0,0,70,70,0,1,0,1,0
50435,445,0,0,70,70,0,1,0,1,0
57617,445,0,0,70,70,0,1,0,1,0
64414,445,0,0,70,70,0,1,0,1,0
61752,445,0,0,70,70,0,1,0,1,0
51636,445,0,0,68,68,0,1,0,1,0
60193,445,0,0,67,67,0,1,0,1,0
64812,445,0,0,70,70,0,1,0,1,0
53686,445,0,0,66,66,0,1,0,1,0
61717,445,0,0,70,70,0,1,0,1,0
55933,445,0,0,66,66,0,1,0,1,0
56607,445,0,0,68,68,0,1,0,1,0
60098,445,0,0,69,69,0,1,0,1,0
58181,445,0,0,66,66,0,1,0,1,0
51167,445,0,0,66,66,0,1,0,1,0
58419,445,0,0,67,67,0,1,0,1,0
53161,445,0,0,70,70,0,1,0,1,0
62447,445,0,0,70,70,0,1,0,1,0
56192,445,0,0,66,66,0,1,0,1,0
49952,445,0,0,66,66,0,1,0,1,0
61879,445,0,0,70,70,0,1,0,1,0
51827,445,0,0,66,66,0,1,0,1,0
64476,445,0,0,70,70,0,1,0,1,0
52351,445,0,0,70,70,0,1,0,1,0
59438,445,0,0,70,70,0,1,0,1,0
62277,445,0,0,70,70,0,1,0,1,0
58480,445,0,0,70,70,0,1,0,1,0
65193,445,0,0,66,66,0,1,0,1,0
61723,445,0,0,69,69,0,1,0,1,0
61319,445,0,0,66,66,0,1,0,1,0
53813,445,0,0,66,66,0,1,0,1,0
57217,445,0,0,70,70,0,1,0,1,0
64230,445,0,0,70,70,0,1,0,1,0
54057,445,0,0,70,70,0,1,0,1,0
50006,445,0,0,70,70,0,1,0,1,0
62260,445,0,0,66,66,0,1,0,1,0
58969,445,0,0,70,70,0,1,0,1,0
58060,445,0,0,66,66,0,1,0,1,0
56515,445,0,0,70,70,0,1,0,1,0
50304,445,0,0,70,70,0,1,0,1,0
53439,445,0,0,70,70,0,1,0,1,0
64197,445,0,0,70,70,0,1,0,1,0
62296,445,0,0,70,70,0,1,0,1,0
50056,445,0,0,67,67,0,1,0,1,0
59299,445,0,0,67,67,0,1,0,1,0
62811,445,0,0,66,66,0,1,0,1,0
60790,445,0,0,70,70,0,1,0,1,0
52332,445,0,0,70,70,0,1,0,1,0
52821,445,0,0,70,70,0,1,0,1,0
53045,445,0,0,68,68,0,1,0,1,0
55593,445,0,0,70,70,0,1,0,1,0
51553,445,0,0,68,68,0,1,0,1,0
64273,445,0,0,67,67,0,1,0,1,0
63646,445,0,0,66,66,0,1,0,1,0
56066,445,0,0,66,66,0,1,0,1,0
58663,445,0,0,70,70,0,1,0,1,0
58420,445,0,0,67,67,0,1,0,1,0
62447,445,0,0,70,70,0,1,0,1,0
50772,445,0,0,70,70,0,1,0,1,0
64404,445,0,0,70,70,0,1,0,1,0
53572,445,0,0,70,70,0,1,0,1,0
51067,445,0,0,70,70,0,1,0,1,0
59027,445,0,0,66,66,0,1,0,1,0
52851,445,0,0,69,69,0,1,0,1,0
50117,445,0,0,70,70,0,1,0,1,0
50866,445,0,0,66,66,0,1,0,1,0
59580,445,0,0,70,70,0,1,0,1,0
55230,445,0,0,70,70,0,1,0,1,0
61166,445,0,0,70,70,0,1,0,1,0
56263,445,0,0,69,69,0,1,0,1,0
56800,445,0,0,70,70,0,1,0,1,0
50720,445,0,0,66,66,0,1,0,1,0
53590,445,0,0,70,70,0,1,0,1,0
55997,445,0,0,66,66,0,1,0,1,0
64772,445,0,0,70,70,0,1,0,1,0
58501,445,0,0,70,70,0,1,0,1,0
62531,445,0,0,70,70,0,1,0,1,0
55163,445,0,0,66,66,0,1,0,1,0
49623,445,0,0,70,70,0,1,0,1,0
58484,445,0,0,66,66,0,1,0,1,0
55160,445,0,0,70,70,0,1,0,1,0
51540,445,0,0,70,70,0,1,0,1,0
61464,445,0,0,70,70,0,1,0,1,0
53687,445,0,0,70,70,0,1,0,1,0
62895,445,0,0,70,70,0,1,0,1,0
62364,445,0,0,66,66,0,1,0,1,0
53758,445,0,0,70,70,0,1,0,1,0
50673,445,0,0,66,66,0,1,0,1,0
58850,445,0,0,70,70,0,1,0,1,0
63598,445,0,0,66,66,0,1,0,1,0
49307,445,0,0,70,70,0,1,0,1,0
63854,445,0,0,70,70,0,1,0,1,0
49623,445,0,0,70,70,0,1,0,1,0
50426,445,0,0,70,70,0,1,0,1,0
53171,445,0,0,66,66,0,1,0,1,0
49919,445,0,0,70,70,0,1,0,1,0
60159,445,0,0,68,68,0,1,0,1,0
56161,445,0,0,70,70,0,1,0,1,0
61532,445,0,0,70,70,0,1,0,1,0
54228,445,0,0,70,70,0,1,0,1,0
56547,445,0,0,70,70,0,1,0,1,0
59128,445,0,0,69,69,0,1,0,1,0
65342,445,0,0,67,67,0,1,0,1,0
50455,445,0,0,70,70,0,1,0,1,0
51808,445,0,0,70,70,0,1,0,1,0
58958,445,0,0,66,66,0,1,0,1,0
54429,445,0,0,70,70,0,1,0,1,0
57237,445,0,0,70,70,0,1,0,1,0
51312,445,0,0,70,70,0,1,0,1,0
64437,445,0,0,70,70,0,1,0,1,0
55966,445,0,0,66,66,0,1,0,1,0
61332,445,0,0,69,69,0,1,0,1,0
55659,445,0,0,70,70,0,1,0,1,0
64601,445,0,0,70,70,0,1,0,1,0
50755,445,0,0,66,66,0,1,0,1,0
60412,445,0,0,70,70,0,1,0,1,0
60634,445,0,0,66,66,0,1,0,1,0
56065,445,0,0,66,66,0,1,0,1,0
60959,445,0,0,70,70,0,1,0,1,0
59167,445,0,0,68,68,0,1,0,1,0
59634,445,0,0,70,70,0,1,0,1,0
56782,445,0,0,66,66,0,1,0,1,0
49243,445,0,0,68,68,0,1,0,1,0
60605,445,0,0,70,70,0,1,0,1,0
59700,445,0,0,70,70,0,1,0,1,0
57180,445,0,0,67,67,0,1,0,1,0
50613,445,0,0,70,70,0,1,0,1,0
63307,445,0,0,66,66,0,1,0,1,0
50090,445,0,0,70,70,0,1,0,1,0
50094,445,0,0,66,66,0,1,0,1,0
63665,445,0,0,70,70,0,1,0,1,0
61338,445,0,0,66,66,0,1,0,1,0
53195,445,0,0,66,66,0,1,0,1,0
59605,445,0,0,66,66,0,1,0,1,0
59919,445,0,0,66,66,0,1,0,1,0
55500,445,0,0,70,70,0,1,0,1,0
57192,445,0,0,70,70,0,1,0,1,0
53947,445,0,0,66,66,0,1,0,1,0
62586,445,0,0,70,70,0,1,0,1,0
58813,445,0,0,70,70,0,1,0,1,0
58859,445,0,0,70,70,0,1,0,1,0
64561,445,0,0,70,70,0,1,0,1,0
56196,445,0,0,66,66,0,1,0,1,0
57159,445,0,0,70,70,0,1,0,1,0
65130,445,0,0,70,70,0,1,0,1,0
61915,445,0,0,70,70,0,1,0,1,0
56920,445,0,0,70,70,0,1,0,1,0
59713,445,0,0,67,67,0,1,0,1,0
52748,445,0,0,68,68,0,1,0,1,0
50141,445,0,0,70,70,0,1,0,1,0
50676,445,0,0,66,66,0,1,0,1,0
63056,445,0,0,66,66,0,1,0,1,0
63215,445,0,0,70,70,0,1,0,1,0
61031,445,0,0,70,70,0,1,0,1,0
63595,445,0,0,69,69,0,1,0,1,0
58570,445,0,0,66,66,0,1,0,1,0
63846,445,0,0,66,66,0,1,0,1,0
53063,445,0,0,67,67,0,1,0,1,0
55724,445,0,0,70,70,0,1,0,1,0
65130,445,0,0,68,68,0,1,0,1,0
59908,445,0,0,70,70,0,1,0,1,0
55955,445,0,0,67,67,0,1,0,1,0
52530,445,0,0,70,70,0,1,0,1,0
55636,445,0,0,70,70,0,1,0,1,0
59041,445,0,0,70,70,0,1,0,1,0
50060,445,0,0,70,70,0,1,0,1,0
61507,445,0,0,70,70,0,1,0,1,0
60090,445,0,0,70,70,0,1,0,1,0
55044,445,0,0,70,70,0,1,0,1,0
54013,445,0,0,66,66,0,1,0,1,0
52624,445,0,0,70,70,0,1,0,1,0
59569,445,0,0,70,70,0,1,0,1,0
49908,445,0,0,70,70,0,1,0,1,0
50585,445,0,0,70,70,0,1,0,1,0
61354,445,0,0,70,70,0,1,0,1,0
61241,445,0,0,70,70,0,1,0,1,0
62446,445,0,0,70,70,0,1,0,1,0
49578,445,0,0,70,70,0,1,0,1,0
54987,445,0,0,67,67,0,1,0,1,0
51181,445,0,0,66,66,0,1,0,1,0
51292,445,0,0,70,70,0,1,0,1,0
61190,445,0,0,67,67,0,1,0,1,0
59957,445,0,0,70,70,0,1,0,1,0
61658,445,0,0,67,67,0,1,0,1,0
55974,445,0,0,67,67,0,1,0,1,0
52580,445,0,0,68,68,0,1,0,1,0
51313,445,0,0,69,69,0,1,0,1,0
62558,445,0,0,69,69,0,1,0,1,0
54506,445,0,0,70,70,0,1,0,1,0
53641,445,0,0,70,70,0,1,0,1,0
57366,445,0,0,68,68,0,1,0,1,0
54868,445,0,0,70,70,0,1,0,1,0
52121,445,0,0,70,70,0,1,0,1,0
61718,445,0,0,70,70,0,1,0,1,0
52599,445,0,0,66,66,0,1,0,1,0
62902,445,0,0,70,70,0,1,0,1,0
53223,445,0,0,68,68,0,1,0,1,0
49712,445,0,0,66,66,0,1,0,1,0
59862,445,0,0,67,67,0,1,0,1,0
56004,445,0,0,70,70,0,1,0,1,0
56454,445,0,0,69,69,0,1,0,1,0
52000,445,0,0,70,70,0,1,0,1,0
58944,445,0,0,66,66,0,1,0,1,0
64766,445,0,0,70,70,0,1,0,1,0
64948,445,0,0,70,70,0,1,0,1,0
50005,445,0,0,70,70,0,1,0,1,0
50298,445,0,0,70,70,0,1,0,1,0
60746,445,0,0,70,70,0,1,0,1,0
65247,445,0,0,70,70,0,1,0,1,0
64047,445,0,0,70,70,0,1,0,1,0
50387,445,0,0,70,70,0,1,0,1,0
63685,445,0,0,70,70,0,1,0,1,0
52353,445,0,0,70,70,0,1,0,1,0
61532,445,0,0,70,70,0,1,0,1,0
51193,445,0,0,66,66,0,1,0,1,0
54375,445,0,0,66,66,0,1,0,1,0
64876,445,0,0,66,66,0,1,0,1,0
57793,445,0,0,66,66,0,1,0,1,0
58759,445,0,0,66,66,0,1,0,1,0
59975,445,0,0,70,70,0,1,0,1,0
52331,445,0,0,70,70,0,1,0,1,0
54974,445,0,0,70,70,0,1,0,1,0
49457,445,0,0,66,66,0,1,0,1,0
63016,445,0,0,69,69,0,1,0,1,0
64966,445,0,0,70,70,0,1,0,1,0
51260,445,0,0,69,69,0,1,0,1,0
54362,445,0,0,70,70,0,1,0,1,0
50983,445,0,0,70,70,0,1,0,1,0
52049,445,0,0,70,70,0,1,0,1,0
58792,445,0,0,68,68,0,1,0,1,0
53677,445,0,0,69,69,0,1,0,1,0
64745,445,0,0,66,66,0,1,0,1,0
54950,445,0,0,70,70,0,1,0,1,0
52199,445,0,0,66,66,0,1,0,1,0
50759,445,0,0,67,67,0,1,0,1,0
56966,445,0,0,70,70,0,1,0,1,0
63272,445,0,0,67,67,0,1,0,1,0
56996,445,0,0,70,70,0,1,0,1,0
54709,445,0,0,70,70,0,1,0,1,0
57408,445,0,0,68,68,0,1,0,1,0
50048,445,0,0,66,66,0,1,0,1,0
56239,445,0,0,70,70,0,1,0,1,0
63493,445,0,0,70,70,0,1,0,1,0
52838,445,0,0,66,66,0,1,0,1,0
65067,445,0,0,66,66,0,1,0,1,0
50799,445,0,0,66,66,0,1,0,1,0
63545,445,0,0,70,70,0,1,0,1,0
53355,445,0,0,68,68,0,1,0,1,0
63295,445,0,0,70,70,0,1,0,1,0
64210,445,0,0,70,70,0,1,0,1,0
62527,445,0,0,70,70,0,1,0,1,0
50988,445,0,0,66,66,0,1,0,1,0
54276,445,0,0,70,70,0,1,0,1,0
49808,445,0,0,70,70,0,1,0,1,0
51753,445,0,0,70,70,0,1,0,1,0
55401,445,0,0,66,66,0,1,0,1,0
58055,445,0,0,66,66,0,1,0,1,0
55669,445,0,0,70,70,0,1,0,1,0
54971,445,0,0,70,70,0,1,0,1,0
62276,445,0,0,70,70,0,1,0,1,0
62128,445,0,0,70,70,0,1,0,1,0
64920,445,0,0,67,67,0,1,0,1,0
54058,445,0,0,70,70,0,1,0,1,0
57919,445,0,0,70,70,0,1,0,1,0
64947,445,0,0,70,70,0,1,0,1,0
53717,445,0,0,70,70,0,1,0,1,0
61223,445,0,0,70,70,0,1,0,1,0
52474,445,0,0,70,70,0,1,0,1,0
53989,445,0,0,66,66,0,1,0,1,0
64132,445,0,0,70,70,0,1,0,1,0
56627,445,0,0,69,69,0,1,0,1,0
54249,445,0,0,70,70,0,1,0,1,0
62232,445,0,0,66,66,0,1,0,1,0
59557,445,0,0,69,69,0,1,0,1,0
58993,445,0,0,70,70,0,1,0,1,0
51307,445,0,0,70,70,0,1,0,1,0
54640,445,0,0,70,70,0,1,0,1,0
65515,445,0,0,66,66,0,1,0,1,0
63361,445,0,0,70,70,0,1,0,1,0
49776,445,0,0,66,66,0,1,0,1,0
56068,445,0,0,69,69,0,1,0,1,0
55464,445,0,0,70,70,0,1,0,1,0
56666,445,0,0,69,69,0,1,0,1,0
57545,445,0,0,66,66,0,1,0,1,0
61916,445,0,0,70,70,0,1,0,1,0
52050,445,0,0,70,70,0,1,0,1,0
60824,445,0,0,66,66,0,1,0,1,0
63453,445,0,0,69,69,0,1,0,1,0
62552,445,0,0,70,70,0,1,0,1,0
64104,445,0,0,66,66,0,1,0,1,0
61759,445,0,0,70,70,0,1,0,1,0
62911,445,0,0,70,70,0,1,0,1,0
49230,445,0,0,68,68,0,1,0,1,0
53865,445,0,0,67,67,0,1,0,1,0
62706,445,0,0,70,70,0,1,0,1,0
52277,445,0,0,69,69,0,1,0,1,0
58315,445,0,0,70,70,0,1,0,1,0
60824,445,0,0,66,66,0,1,0,1,0
52649,445,0,0,66,66,0,1,0,1,0
59963,445,0,0,70,70,0,1,0,1,0
61407,445,0,0,66,66,0,1,0,1,0
51877,445,0,0,70,70,0,1,0,1,0
62107,445,0,0,66,66,0,1,0,1,0
59945,445,0,0,66,66,0,1,0,1,0
53317,445,0,0,67,67,0,1,0,1,0
51786,445,0,0,70,70,0,1,0,1,0
49614,445,0,0,66,66,0,1,0,1,0
53686,445,0,0,66,66,0,1,0,1,0
53281,445,0,0,70,70,0,1,0,1,0
49759,445,0,0,70,70,0,1,0,1,0
53813,445,0,0,66,66,0,1,0,1,0
59437,445,0,0,70,70,0,1,0,1,0
62170,445,0,0,66,66,0,1,0,1,0
52696,445,0,0,70,70,0,1,0,1,0
54944,445,0,0,70,70,0,1,0,1,0
50556,445,0,0,70,70,0,1,0,1,0
62424,445,0,0,66,66,0,1,0,1,0
64681,445,0,0,66,66,0,1,0,1,0
50806,445,0,0,67,67,0,1,0,1,0
61385,445,0,0,66,66,0,1,0,1,0
52670,445,0,0,69,69,0,1,0,1,0
53525,445,0,0,70,70,0,1,0,1,0
50909,445,0,0,70,70,0,1,0,1,0
54500,445,0,0,70,70,0,1,0,1,0
64747,445,0,0,66,66,0,1,0,1,0
49934,445,0,0,70,70,0,1,0,1,0
63826,445,0,0,66,66,0,1,0,1,0
62726,445,0,0,69,69,0,1,0,1,0
50945,445,0,0,70,70,0,1,0,1,0
49298,445,0,0,70,70,0,1,0,1,0
65355,445,0,0,70,70,0,1,0,1,0
51462,445,0,0,69,69,0,1,0,1,0
59787,445,0,0,66,66,0,1,0,1,0
56453,445,0,0,66,66,0,1,0,1,0
51856,445,0,0,67,67,0,1,0,1,0
50905,445,0,0,70,70,0,1,0,1,0
60805,445,0,0,69,69,0,1,0,1,0
55458,445,0,0,70,70,0,1,0,1,0
57022,445,0,0,66,66,0,1,0,1,0
55994,445,0,0,70,70,0,1,0,1,0
59826,445,0,0,70,70,0,1,0,1,0
60933,445,0,0,70,70,0,1,0,1,0
55315,445,0,0,70,70,0,1,0,1,0
54650,445,0,0,66,66,0,1,0,1,0
53077,445,0,0,70,70,0,1,0,1,0
60373,445,0,0,70,70,0,1,0,1,0
50163,445,0,0,70,70,0,1,0,1,0
61285,445,0,0,66,66,0,1,0,1,0
61059,445,0,0,69,69,0,1,0,1,0
51711,445,0,0,70,70,0,1,0,1,0
59416,445,0,0,68,68,0,1,0,1,0
63315,445,0,0,70,70,0,1,0,1,0
54206,445,0,0,66,66,0,1,0,1,0
61642,445,0,0,70,70,0,1,0,1,0
56565,445,0,0,68,68,0,1,0,1,0
53084,445,0,0,70,70,0,1,0,1,0
50428,445,0,0,70,70,0,1,0,1,0
62999,445,0,0,66,66,0,1,0,1,0
56426,445,0,0,70,70,0,1,0,1,0
57119,445,0,0,70,70,0,1,0,1,0
56105,445,0,0,70,70,0,1,0,1,0
53068,445,0,0,70,70,0,1,0,1,0
49410,445,0,0,66,66,0,1,0,1,0
63988,445,0,0,67,67,0,1,0,1,0
54268,445,0,0,70,70,0,1,0,1,0
55876,445,0,0,70,70,0,1,0,1,0
51232,445,0,0,66,66,0,1,0,1,0
56439,445,0,0,70,70,0,1,0,1,0
63023,445,0,0,70,70,0,1,0,1,0
51423,445,0,0,67,67,0,1,0,1,0
59356,445,0,0,66,66,0,1,0,1,0
56455,445,0,0,66,66,0,1,0,1,0
55676,445,0,0,69,69,0,1,0,1,0
52149,445,0,0,70,70,0,1,0,1,0
54275,445,0,0,70,70,0,1,0,1,0
60356,445,0,0,66,66,0,1,0,1,0
51287,445,0,0,70,70,0,1,0,1,0
56091,445,0,0,70,70,0,1,0,1,0
62324,445,0,0,70,70,0,1,0,1,0
50856,445,0,0,70,70,0,1,0,1,0
54091,445,0,0,66,66,0,1,0,1,0
59552,445,0,0,68,68,0,1,0,1,0
63789,445,0,0,70,70,0,1,0,1,0
63871,445,0,0,70,70,0,1,0,1,0
56800,445,0,0,70,70,0,1,0,1,0
51600,445,0,0,66,66,0,1,0,1,0
55073,445,0,0,70,70,0,1,0,1,0
50039,445,0,0,70,70,0,1,0,1,0
50800,445,0,0,66,66,0,1,0,1,0
59844,445,0,0,70,70,0,1,0,1,0
54916,445,0,0,70,70,0,1,0,1,0
59945,445,0,0,66,66,0,1,0,1,0
58140,445,0,0,70,70,0,1,0,1,0
63795,445,0,0,66,66,0,1,0,1,0
50333,445,0,0,68,68,0,1,0,1,0
56653,445,0,0,70,70,0,1,0,1,0
56838,445,0,0,66,66,0,1,0,1,0
50006,445,0,0,70,70,0,1,0,1,0
56715,445,0,0,70,70,0,1,0,1,0
63920,445,0,0,70,70,0,1,0,1,0
56895,445,0,0,70,70,0,1,0,1,0
54624,445,0,0,70,70,0,1,0,1,0
53922,445,0,0,70,70,0,1,0,1,0
53494,445,0,0,66,66,0,1,0,1,0
64406,445,0,0,70,70,0,1,0,1,0
52223,445,0,0,70,70,0,1,0,1,0
49912,445,0,0,70,70,0,1,0,1,0
56003,445,0,0,70,70,0,1,0,1,0
57383,445,0,0,70,70,0,1,0,1,0
55967,445,0,0,70,70,0,1,0,1,0
64519,445,0,0,70,70,0,1,0,1,0
53104,445,0,0,70,70,0,1,0,1,0
65530,445,0,0,66,66,0,1,0,1,0
59760,445,0,0,66,66,0,1,0,1,0
53334,445,0,0,70,70,0,1,0,1,0
59594,445,0,0,66,66,0,1,0,1,0
51164,445,0,0,69,69,0,1,0,1,0
57029,445,0,0,70,70,0,1,0,1,0
65409,445,0,0,70,70,0,1,0,1,0
52798,445,0,0,66,66,0,1,0,1,0
50881,445,0,0,66,66,0,1,0,1,0
64516,445,0,0,70,70,0,1,0,1,0
53461,445,0,0,70,70,0,1,0,1,0
54732,445,0,0,68,68,0,1,0,1,0
57277,445,0,0,66,66,0,1,0,1,0
55733,445,0,0,70,70,0,1,0,1,0
55548,445,0,0,66,66,0,1,0,1,0
52004,445,0,0,70,70,0,1,0,1,0
53389,445,0,0,70,70,0,1,0,1,0
52327,445,0,0,70,70,0,1,0,1,0
51087,445,0,0,70,70,0,1,0,1,0
57508,445,0,0,70,70,0,1,0,1,0
61031,445,0,0,70,70,0,1,0,1,0
56437,445,0,0,69,69,0,1,0,1,0
58299,445,0,0,66,66,0,1,0,1,0
62188,445,0,0,70,70,0,1,0,1,0
49358,445,0,0,66,66,0,1,0,1,0
50977,445,0,0,66,66,0,1,0,1,0
65336,445,0,0,70,70,0,1,0,1,0
53543,445,0,0,70,70,0,1,0,1,0
53897,445,0,0,66,66,0,1,0,1,0
51235,445,0,0,70,70,0,1,0,1,0
52598,445,0,0,66,66,0,1,0,1,0
62608,445,0,0,70,70,0,1,0,1,0
53930,445,0,0,70,70,0,1,0,1,0
51410,445,0,0,70,70,0,1,0,1,0
64790,445,0,0,66,66,0,1,0,1,0
58327,445,0,0,66,66,0,1,0,1,0
56223,445,0,0,66,66,0,1,0,1,0
54952,445,0,0,70,70,0,1,0,1,0
56710,445,0,0,66,66,0,1,0,1,0
60359,445,0,0,66,66,0,1,0,1,0
49701,445,0,0,70,70,0,1,0,1,0
50817,445,0,0,67,67,0,1,0,1,0
63030,445,0,0,66,66,0,1,0,1,0
58553,445,0,0,70,70,0,1,0,1,0
58061,445,0,0,70,70,0,1,0,1,0
50757,445,0,0,66,66,0,1,0,1,0
50441,445,0,0,66,66,0,1,0,1,0
60178,445,0,0,66,66,0,1,0,1,0
58757,445,0,0,66,66,0,1,0,1,0
62651,445,0,0,70,70,0,1,0,1,0
64808,445,0,0,66,66,0,1,0,1,0
50589,445,0,0,66,66,0,1,0,1,0
51265,445,0,0,66,66,0,1,0,1,0
61235,445,0,0,69,69,0,1,0,1,0
49408,445,0,0,66,66,0,1,0,1,0
54306,445,0,0,70,70,0,1,0,1,0
64597,445,0,0,70,70,0,1,0,1,0
56990,445,0,0,68,68,0,1,0,1,0
61995,445,0,0,70,70,0,1,0,1,0
50594,445,0,0,68,68,0,1,0,1,0
64211,445,0,0,67,67,0,1,0,1,0
64860,445,0,0,66,66,0,1,0,1,0
61253,445,0,0,70,70,0,1,0,1,0
51112,445,0,0,66,66,0,1,0,1,0
52309,445,0,0,70,70,0,1,0,1,0
60160,445,0,0,66,66,0,1,0,1,0
61385,445,0,0,66,66,0,1,0,1,0
51948,445,0,0,70,70,0,1,0,1,0
53000,445,0,0,66,66,0,1,0,1,0
61180,445,0,0,66,66,0,1,0,1,0
50036,445,0,0,70,70,0,1,0,1,0
51002,445,0,0,70,70,0,1,0,1,0
59144,445,0,0,66,66,0,1,0,1,0
55641,445,0,0,70,70,0,1,0,1,0
58215,445,0,0,70,70,0,1,0,1,0
52987,445,0,0,66,66,0,1,0,1,0
62952,445,0,0,68,68,0,1,0,1,0
62277,445,0,0,70,70,0,1,0,1,0
51104,445,0,0,66,66,0,1,0,1,0
61128,445,0,0,66,66,0,1,0,1,0
64803,445,0,0,70,70,0,1,0,1,0
51416,445,0,0,70,70,0,1,0,1,0
54348,445,0,0,66,66,0,1,0,1,0
55568,445,0,0,70,70,0,1,0,1,0
54647,445,0,0,66,66,0,1,0,1,0
49502,445,0,0,70,70,0,1,0,1,0
64629,445,0,0,67,67,0,1,0,1,0
56696,445,0,0,70,70,0,1,0,1,0
65226,445,0,0,70,70,0,1,0,1,0
55548,445,0,0,66,66,0,1,0,1,0
63008,445,0,0,70,70,0,1,0,1,0
56340,445,0,0,66,66,0,1,0,1,0
54307,445,0,0,70,70,0,1,0,1,0
60665,445,0,0,69,69,0,1,0,1,0
61717,445,0,0,66,66,0,1,0,1,0
53531,445,0,0,70,70,0,1,0,1,0
64632,445,0,0,66,66,0,1,0,1,0
50873,445,0,0,66,66,0,1,0,1,0
60957,445,0,0,70,70,0,1,0,1,0
64225,445,0,0,70,70,0,1,0,1,0
52039,445,0,0,69,69,0,1,0,1,0
55624,445,0,0,66,66,0,1,0,1,0
63663,445,0,0,70,70,0,1,0,1,0
56012,445,0,0,70,70,0,1,0,1,0
52463,445,0,0,70,70,0,1,0,1,0
61233,445,0,0,70,70,0,1,0,1,0
49581,445,0,0,70,70,0,1,0,1,0
57441,445,0,0,67,67,0,1,0,1,0
61239,445,0,0,70,70,0,1,0,1,0
65057,445,0,0,70,70,0,1,0,1,0
62528,445,0,0,70,70,0,1,0,1,0
55458,445,0,0,70,70,0,1,0,1,0
58184,445,0,0,66,66,0,1,0,1,0
56379,445,0,0,66,66,0,1,0,1,0
60831,445,0,0,70,70,0,1,0,1,0
55384,445,0,0,70,70,0,1,0,1,0
58090,445,0,0,70,70,0,1,0,1,0
55132,445,0,0,70,70,0,1,0,1,0
49323,445,0,0,70,70,0,1,0,1,0
55053,445,0,0,69,69,0,1,0,1,0
58438,445,0,0,66,66,0,1,0,1,0
62428,445,0,0,70,70,0,1,0,1,0
65098,445,0,0,70,70,0,1,0,1,0
61826,445,0,0,70,70,0,1,0,1,0
60757,445,0,0,66,66,0,1,0,1,0
55722,445,0,0,70,70,0,1,0,1,0
65199,445,0,0,67,67,0,1,0,1,0
52890,445,0,0,70,70,0,1,0,1,0
64261,445,0,0,70,70,0,1,0,1,0
64432,445,0,0,70,70,0,1,0,1,0
53817,445,0,0,70,70,0,1,0,1,0
49812,445,0,0,67,67,0,1,0,1,0
64728,445,0,0,66,66,0,1,0,1,0
56277,445,0,0,70,70,0,1,0,1,0
53431,445,0,0,66,66,0,1,0,1,0
49304,445,0,0,70,70,0,1,0,1,0
65394,445,0,0,66,66,0,1,0,1,0
49590,445,0,0,69,69,0,1,0,1,0
57730,445,0,0,66,66,0,1,0,1,0
54976,445,0,0,70,70,0,1,0,1,0
51575,445,0,0,66,66,0,1,0,1,0
54592,445,0,0,70,70,0,1,0,1,0
64797,445,0,0,70,70,0,1,0,1,0
50546,445,0,0,66,66,0,1,0,1,0
56278,445,0,0,70,70,0,1,0,1,0
58854,445,0,0,70,70,0,1,0,1,0
64629,445,0,0,69,69,0,1,0,1,0
50304,445,0,0,70,70,0,1,0,1,0
62557,445,0,0,66,66,0,1,0,1,0
63084,445,0,0,67,67,0,1,0,1,0
55944,445,0,0,70,70,0,1,0,1,0
51113,445,0,0,66,66,0,1,0,1,0
60724,445,0,0,70,70,0,1,0,1,0
53864,445,0,0,67,67,0,1,0,1,0
63795,445,0,0,66,66,0,1,0,1,0
50195,445,0,0,70,70,0,1,0,1,0
62294,445,0,0,70,70,0,1,0,1,0
55935,445,0,0,66,66,0,1,0,1,0
59873,445,0,0,70,70,0,1,0,1,0
57221,445,0,0,66,66,0,1,0,1,0
64675,445,0,0,70,70,0,1,0,1,0
54926,445,0,0,70,70,0,1,0,1,0
61444,445,0,0,70,70,0,1,0,1,0
52326,445,0,0,66,66,0,1,0,1,0
54727,445,0,0,69,69,0,1,0,1,0
63721,445,0,0,70,70,0,1,0,1,0
50604,445,0,0,70,70,0,1,0,1,0
58374,445,0,0,66,66,0,1,0,1,0
54148,445,0,0,70,70,0,1,0,1,0
57759,445,0,0,67,67,0,1,0,1,0
61131,445,0,0,67,67,0,1,0,1,0
59846,445,0,0,70,70,0,1,0,1,0
55771,445,0,0,68,68,0,1,0,1,0
64355,445,0,0,66,66,0,1,0,1,0
50482,445,0,0,66,66,0,1,0,1,0
55352,445,0,0,66,66,0,1,0,1,0
54613,445,0,0,67,67,0,1,0,1,0
64292,445,0,0,66,66,0,1,0,1,0
51305,445,0,0,70,70,0,1,0,1,0
65002,445,0,0,67,67,0,1,0,1,0
55201,445,0,0,70,70,0,1,0,1,0
58890,445,0,0,70,70,0,1,0,1,0
56660,445,0,0,66,66,0,1,0,1,0
54163,445,0,0,66,66,0,1,0,1,0
53672,445,0,0,70,70,0,1,0,1,0
62050,445,0,0,66,66,0,1,0,1,0
65268,445,0,0,68,68,0,1,0,1,0
52886,445,0,0,70,70,0,1,0,1,0
53471,445,0,0,70,70,0,1,0,1,0
53165,445,0,0,70,70,0,1,0,1,0
60109,445,0,0,70,70,0,1,0,1,0
56371,445,0,0,66,66,0,1,0,1,0
57167,445,0,0,70,70,0,1,0,1,0
58143,445,0,0,70,70,0,1,0,1,0
64947,445,0,0,70,70,0,1,0,1,0
63366,445,0,0,70,70,0,1,0,1,0
62248,445,0,0,70,70,0,1,0,1,0
56786,445,0,0,67,67,0,1,0,1,0
65246,445,0,0,70,70,0,1,0,1,0
63213,445,0,0,70,70,0,1,0,1,0
62905,445,0,0,70,70,0,1,0,1,0
54934,445,0,0,70,70,0,1,0,1,0
63100,445,0,0,70,70,0,1,0,1,0
60677,445,0,0,70,70,0,1,0,1,0
52989,445,0,0,70,70,0,1,0,1,0
54520,445,0,0,70,70,0,1,0,1,0
57069,445,0,0,70,70,0,1,0,1,0
57531,445,0,0,70,70,0,1,0,1,0
58568,445,0,0,70,70,0,1,0,1,0
54685,445,0,0,70,70,0,1,0,1,0
64211,445,0,0,70,70,0,1,0,1,0
54987,445,0,0,66,66,0,1,0,1,0
56021,445,0,0,70,70,0,1,0,1,0
62333,445,0,0,70,70,0,1,0,1,0
50623,445,0,0,68,68,0,1,0,1,0
62869,445,0,0,66,66,0,1,0,1,0
50196,445,0,0,70,70,0,1,0,1,0
51946,445,0,0,70,70,0,1,0,1,0
62430,445,0,0,70,70,0,1,0,1,0
60731,445,0,0,70,70,0,1,0,1,0
60290,445,0,0,66,66,0,1,0,1,0
63939,445,0,0,70,70,0,1,0,1,0
56872,445,0,0,70,70,0,1,0,1,0
58556,445,0,0,66,66,0,1,0,1,0
50266,445,0,0,70,70,0,1,0,1,0
52483,445,0,0,70,70,0,1,0,1,0
51105,445,0,0,66,66,0,1,0,1,0
55101,445,0,0,70,70,0,1,0,1,0
52827,445,0,0,70,70,0,1,0,1,0
62108,445,0,0,69,69,0,1,0,1,0
63111,445,0,0,70,70,0,1,0,1,0
50968,445,0,0,70,70,0,1,0,1,0
57856,445,0,0,70,70,0,1,0,1,0
61352,445,0,0,68,68,0,1,0,1,0
60517,445,0,0,67,67,0,1,0,1,0
60656,445,0,0,70,70,0,1,0,1,0
57913,445,0,0,66,66,0,1,0,1,0
56426,445,0,0,70,70,0,1,0,1,0
58517,445,0,0,70,70,0,1,0,1,0
49372,445,0,0,70,70,0,1,0,1,0
57631,445,0,0,66,66,0,1,0,1,0
49996,445,0,0,67,67,0,1,0,1,0
55487,445,0,0,66,66,0,1,0,1,0
51058,445,0,0,66,66,0,1,0,1,0
58210,445,0,0,70,70,0,1,0,1,0
49716,445,0,0,66,66,0,1,0,1,0
53550,445,0,0,66,66,0,1,0,1,0
53654,445,0,0,70,70,0,1,0,1,0
52524,445,0,0,70,70,0,1,0,1,0
59598,445,0,0,70,70,0,1,0,1,0
64918,445,0,0,66,66,0,1,0,1,0
61624,445,0,0,70,70,0,1,0,1,0
65029,445,0,0,70,70,0,1,0,1,0
64492,445,0,0,66,66,0,1,0,1,0
54057,445,0,0,70,70,0,1,0,1,0
63515,445,0,0,66,66,0,1,0,1,0
55031,445,0,0,70,70,0,1,0,1,0
50812,445,0,0,70,70,0,1,0,1,0
59634,445,0,0,70,70,0,1,0,1,0
59956,445,0,0,70,70,0,1,0,1,0
50207,445,0,0,67,67,0,1,0,1,0
61592,445,0,0,70,70,0,1,0,1,0
60471,445,0,0,70,70,0,1,0,1,0
62698,445,0,0,66,66,0,1,0,1,0
62787,445,0,0,70,70,0,1,0,1,0
51720,445,0,0,66,66,0,1,0,1,0
62560,445,0,0,70,70,0,1,0,1,0
52533,445,0,0,70,70,0,1,0,1,0
64697,445,0,0,69,69,0,1,0,1,0
55339,445,0,0,70,70,0,1,0,1,0
55799,445,0,0,69,69,0,1,0,1,0
55550,445,0,0,70,70,0,1,0,1,0
59651,445,0,0,70,70,0,1,0,1,0
50418,445,0,0,66,66,0,1,0,1,0
59145,445,0,0,70,70,0,1,0,1,0
59908,445,0,0,70,70,0,1,0,1,0
57474,445,0,0,69,69,0,1,0,1,0
52349,445,0,0,70,70,0,1,0,1,0
59724,445,0,0,66,66,0,1,0,1,0
52673,445,0,0,68,68,0,1,0,1,0
51687,445,0,0,68,68,0,1,0,1,0
63562,445,0,0,70,70,0,1,0,1,0
54518,445,0,0,69,69,0,1,0,1,0
55333,445,0,0,70,70,0,1,0,1,0
49560,445,0,0,70,70,0,1,0,1,0
55040,445,0,0,70,70,0,1,0,1,0
61084,445,0,0,67,67,0,1,0,1,0
64856,445,0,0,66,66,0,1,0,1,0
63624,445,0,0,70,70,0,1,0,1,0
50847,445,0,0,66,66,0,1,0,1,0
51805,445,0,0,70,70,0,1,0,1,0
55993,445,0,0,66,66,0,1,0,1,0
60247,445,0,0,66,66,0,1,0,1,0
49708,445,0,0,70,70,0,1,0,1,0
59383,445,0,0,66,66,0,1,0,1,0
54829,445,0,0,66,66,0,1,0,1,0
63301,445,0,0,70,70,0,1,0,1,0
57056,445,0,0,70,70,0,1,0,1,0
62529,445,0,0,70,70,0,1,0,1,0
52016,445,0,0,68,68,0,1,0,1,0
55125,445,0,0,70,70,0,1,0,1,0
53392,445,0,0,70,70,0,1,0,1,0
61201,445,0,0,70,70,0,1,0,1,0
61111,445,0,0,70,70,0,1,0,1,0
53645,445,0,0,70,70,0,1,0,1,0
52394,445,0,0,70,70,0,1,0,1,0
64332,445,0,0,70,70,0,1,0,1,0
56464,445,0,0,70,70,0,1,0,1,0
63031,445,0,0,68,68,0,1,0,1,0
55595,445,0,0,70,70,0,1,0,1,0
52564,445,0,0,70,70,0,1,0,1,0
55932,445,0,0,66,66,0,1,0,1,0
58280,445,0,0,68,68,0,1,0,1,0
64729,445,0,0,70,70,0,1,0,1,0
51749,445,0,0,70,70,0,1,0,1,0
50453,445,0,0,70,70,0,1,0,1,0
57237,445,0,0,68,68,0,1,0,1,0
64289,445,0,0,70,70,0,1,0,1,0
61473,445,0,0,68,68,0,1,0,1,0
51443,445,0,0,66,66,0,1,0,1,0
53874,445,0,0,70,70,0,1,0,1,0
59783,445,0,0,70,70,0,1,0,1,0
52175,445,0,0,68,68,0,1,0,1,0
50595,445,0,0,70,70,0,1,0,1,0
60141,445,0,0,70,70,0,1,0,1,0
65371,445,0,0,66,66,0,1,0,1,0
52273,445,0,0,66,66,0,1,0,1,0
63964,445,0,0,68,68,0,1,0,1,0
54786,445,0,0,70,70,0,1,0,1,0
55085,445,0,0,70,70,0,1,0,1,0
54787,445,0,0,70,70,0,1,0,1,0
53653,445,0,0,66,66,0,1,0,1,0
54955,445,0,0,66,66,0,1,0,1,0
53377,445,0,0,67,67,0,1,0,1,0
54605,445,0,0,70,70,0,1,0,1,0
51506,445,0,0,69,69,0,1,0,1,0
50647,445,0,0,70,70,0,1,0,1,0
63828,445,0,0,66,66,0,1,0,1,0
62260,445,0,0,69,69,0,1,0,1,0
59758,445,0,0,70,70,0,1,0,1,0
50739,445,0,0,66,66,0,1,0,1,0
55489,445,0,0,70,70,0,1,0,1,0
64202,445,0,0,69,69,0,1,0,1,0
51486,445,0,0,70,70,0,1,0,1,0
52170,445,0,0,66,66,0,1,0,1,0
50272,445,0,0,70,70,0,1,0,1,0
64886,445,0,0,70,70,0,1,0,1,0
57558,445,0,0,70,70,0,1,0,1,0
51902,445,0,0,70,70,0,1,0,1,0
64741,445,0,0,70,70,0,1,0,1,0
50999,445,0,0,70,70,0,1,0,1,0
50779,445,0,0,67,67,0,1,0,1,0
62817,445,0,0,68,68,0,1,0,1,0
62114,445,0,0,70,70,0,1,0,1,0
54344,445,0,0,70,70,0,1,0,1,0
57643,445,0,0,70,70,0,1,0,1,0
64802,445,0,0,70,70,0,1,0,1,0
60577,445,0,0,70,70,0,1,0,1,0
53994,445,0,0,70,70,0,1,0,1,0
49328,445,0,0,66,66,0,1,0,1,0
61354,445,0,0,70,70,0,1,0,1,0
63407,445,0,0,66,66,0,1,0,1,0
52739,445,0,0,68,68,0,1,0,1,0
60193,445,0,0,70,70,0,1,0,1,0
53462,445,0,0,70,70,0,1,0,1,0
62913,445,0,0,70,70,0,1,0,1,0
50650,445,0,0,70,70,0,1,0,1,0
57129,445,0,0,68,68,0,1,0,1,0
58867,445,0,0,66,66,0,1,0,1,0
50228,445,0,0,66,66,0,1,0,1,0
61901,445,0,0,70,70,0,1,0,1,0
60120,445,0,0,66,66,0,1,0,1,0
53493,445,0,0,68,68,0,1,0,1,0
51917,445,0,0,66,66,0,1,0,1,0
63617,445,0,0,70,70,0,1,0,1,0
55634,445,0,0,67,67,0,1,0,1,0
64966,445,0,0,70,70,0,1,0,1,0
64796,445,0,0,70,70,0,1,0,1,0
64940,445,0,0,70,70,0,1,0,1,0
59477,445,0,0,70,70,0,1,0,1,0
50357,445,0,0,70,70,0,1,0,1,0
56313,445,0,0,70,70,0,1,0,1,0
55758,445,0,0,69,69,0,1,0,1,0
50546,445,0,0,70,70,0,1,0,1,0
51804,445,0,0,70,70,0,1,0,1,0
52214,445,0,0,66,66,0,1,0,1,0
54070,445,0,0,69,69,0,1,0,1,0
61831,445,0,0,66,66,0,1,0,1,0
49420,445,0,0,70,70,0,1,0,1,0
61353,445,0,0,70,70,0,1,0,1,0
50736,445,0,0,66,66,0,1,0,1,0
64540,445,0,0,70,70,0,1,0,1,0
50868,445,0,0,70,70,0,1,0,1,0
49934,445,0,0,70,70,0,1,0,1,0
54717,445,0,0,70,70,0,1,0,1,0
58983,445,0,0,67,67,0,1,0,1,0
61006,445,0,0,69,69,0,1,0,1,0
62937,445,0,0,70,70,0,1,0,1,0
54782,445,0,0,70,70,0,1,0,1,0
50353,445,0,0,66,66,0,1,0,1,0
50479,445,0,0,66,66,0,1,0,1,0
64608,445,0,0,70,70,0,1,0,1,0
50937,445,0,0,70,70,0,1,0,1,0
61397,445,0,0,66,66,0,1,0,1,0
59147,445,0,0,70,70,0,1,0,1,0
49892,445,0,0,66,66,0,1,0,1,0
54471,445,0,0,67,67,0,1,0,1,0
59076,445,0,0,70,70,0,1,0,1,0
63005,445,0,0,70,70,0,1,0,1,0
61427,445,0,0,70,70,0,1,0,1,0
61508,445,0,0,70,70,0,1,0,1,0
58390,445,0,0,67,67,0,1,0,1,0
54593,445,0,0,66,66,0,1,0,1,0
63384,445,0,0,70,70,0,1,0,1,0
53028,445,0,0,70,70,0,1,0,1,0
59100,445,0,0,67,67,0,1,0,1,0
53357,445,0,0,70,70,0,1,0,1,0
60598,445,0,0,70,70,0,1,0,1,0
56519,445,0,0,67,67,0,1,0,1,0
59708,445,0,0,70,70,0,1,0,1,0
60740,445,0,0,70,70,0,1,0,1,0
57618,445,0,0,70,70,0,1,0,1,0
64725,445,0,0,67,67,0,1,0,1,0
50464,445,0,0,66,66,0,1,0,1,0
60117,445,0,0,70,70,0,1,0,1,0
59013,445,0,0,66,66,0,1,0,1,0
50817,445,0,0,68,68,0,1,0,1,0
62518,445,0,0,69,69,0,1,0,1,0
65389,445,0,0,68,68,0,1,0,1,0
64458,445,0,0,70,70,0,1,0,1,0
55544,445,0,0,70,70,0,1,0,1,0
63775,445,0,0,66,66,0,1,0,1,0
59443,445,0,0,70,70,0,1,0,1,0
62816,445,0,0,66,66,0,1,0,1,0
64540,445,0,0,70,70,0,1,0,1,0
65156,445,0,0,70,70,0,1,0,1,0
51166,445,0,0,66,66,0,1,0,1,0
58316,445,0,0,70,70,0,1,0,1,0
60872,445,0,0,69,69,0,1,0,1,0
64931,445,0,0,70,70,0,1,0,1,0
58060,445,0,0,70,70,0,1,0,1,0
55640,445,0,0,70,70,0,1,0,1,0
49566,445,0,0,68,68,0,1,0,1,0
52482,445,0,0,70,70,0,1,0,1,0
54761,445,0,0,66,66,0,1,0,1,0
58739,445,0,0,69,69,0,1,0,1,0
51965,445,0,0,70,70,0,1,0,1,0
51392,445,0,0,66,66,0,1,0,1,0
51040,445,0,0,70,70,0,1,0,1,0
50097,445,0,0,66,66,0,1,0,1,0
60738,445,0,0,70,70,0,1,0,1,0
59924,445,0,0,67,67,0,1,0,1,0
50517,445,0,0,70,70,0,1,0,1,0
63847,445,0,0,66,66,0,1,0,1,0
54955,445,0,0,70,70,0,1,0,1,0
60311,445,0,0,70,70,0,1,0,1,0
57901,445,0,0,68,68,0,1,0,1,0
64300,445,0,0,70,70,0,1,0,1,0
57231,445,0,0,70,70,0,1,0,1,0
62433,445,0,0,67,67,0,1,0,1,0
53799,445,0,0,70,70,0,1,0,1,0
65262,445,0,0,70,70,0,1,0,1,0
60543,445,0,0,70,70,0,1,0,1,0
63537,445,0,0,70,70,0,1,0,1,0
61084,445,0,0,66,66,0,1,0,1,0
49279,445,0,0,70,70,0,1,0,1,0
62044,445,0,0,70,70,0,1,0,1,0
56835,445,0,0,66,66,0,1,0,1,0
62017,445,0,0,70,70,0,1,0,1,0
55759,445,0,0,67,67,0,1,0,1,0
56691,445,0,0,66,66,0,1,0,1,0
51782,445,0,0,66,66,0,1,0,1,0
54035,445,0,0,66,66,0,1,0,1,0
64105,445,0,0,70,70,0,1,0,1,0
54737,445,0,0,70,70,0,1,0,1,0
54267,445,0,0,69,69,0,1,0,1,0
55961,445,0,0,70,70,0,1,0,1,0
64384,445,0,0,70,70,0,1,0,1,0
58409,445,0,0,70,70,0,1,0,1,0
56962,445,0,0,69,69,0,1,0,1,0
58264,445,0,0,70,70,0,1,0,1,0
63235,445,0,0,70,70,0,1,0,1,0
50944,445,0,0,70,70,0,1,0,1,0
63068,445,0,0,67,67,0,1,0,1,0
59475,445,0,0,67,67,0,1,0,1,0
50864,445,0,0,66,66,0,1,0,1,0
51026,445,0,0,70,70,0,1,0,1,0
57487,445,0,0,70,70,0,1,0,1,0
50412,445,0,0,66,66,0,1,0,1,0
62637,445,0,0,70,70,0,1,0,1,0
50929,445,0,0,66,66,0,1,0,1,0
54396,445,0,0,68,68,0,1,0,1,0
60203,445,0,0,69,69,0,1,0,1,0
58517,445,0,0,70,70,0,1,0,1,0
58986,445,0,0,67,67,0,1,0,1,0
65116,445,0,0,70,70,0,1,0,1,0
54967,445,0,0,70,70,0,1,0,1,0
55548,445,0,0,66,66,0,1,0,1,0
58042,445,0,0,66,66,0,1,0,1,0
58862,445,0,0,70,70,0,1,0,1,0
50423,445,0,0,70,70,0,1,0,1,0
62679,445,0,0,70,70,0,1,0,1,0
57603,445,0,0,70,70,0,1,0,1,0
55712,445,0,0,70,70,0,1,0,1,0
57240,445,0,0,70,70,0,1,0,1,0
57248,445,0,0,66,66,0,1,0,1,0
62072,445,0,0,70,70,0,1,0,1,0
58739,445,0,0,66,66,0,1,0,1,0
52957,445,0,0,70,70,0,1,0,1,0
56204,445,0,0,70,70,0,1,0,1,0
57857,445,0,0,70,70,0,1,0,1,0
58948,445,0,0,67,67,0,1,0,1,0
53459,445,0,0,70,70,0,1,0,1,0
65130,445,0,0,66,66,0,1,0,1,0
49992,445,0,0,68,68,0,1,0,1,0
58923,445,0,0,70,70,0,1,0,1,0
50565,445,0,0,66,66,0,1,0,1,0
57701,445,0,0,70,70,0,1,0,1,0
59062,445,0,0,70,70,0,1,0,1,0
57164,445,0,0,70,70,0,1,0,1,0
55698,445,0,0,70,70,0,1,0,1,0
55251,445,0,0,70,70,0,1,0,1,0
56323,445,0,0,66,66,0,1,0,1,0
57378,445,0,0,70,70,0,1,0,1,0
51295,445,0,0,70,70,0,1,0,1,0
50399,445,0,0,70,70,0,1,0,1,0
59550,445,0,0,66,66,0,1,0,1,0
63217,445,0,0,70,70,0,1,0,1,0
53458,445,0,0,70,70,0,1,0,1,0
53123,445,0,0,70,70,0,1,0,1,0
62620,445,0,0,70,70,0,1,0,1,0
60665,445,0,0,70,70,0,1,0,1,0
60294,445,0,0,70,70,0,1,0,1,0
61535,445,0,0,68,68,0,1,0,1,0
59787,445,0,0,70,70,0,1,0,1,0
60998,445,0,0,70,70,0,1,0,1,0
63390,445,0,0,66,66,0,1,0,1,0
56449,445,0,0,70,70,0,1,0,1,0
58156,445,0,0,70,70,0,1,0,1,0
55745,445,0,0,70,70,0,1,0,1,0
63856,445,0,0,68,68,0,1,0,1,0
61996,445,0,0,67,67,0,1,0,1,0
50983,445,0,0,70,70,0,1,0,1,0
55576,445,0,0,70,70,0,1,0,1,0
61559,445,0,0,70,70,0,1,0,1,0
56069,445,0,0,70,70,0,1,0,1,0
52475,445,0,0,70,70,0,1,0,1,0
64364,445,0,0,66,66,0,1,0,1,0
54010,445,0,0,66,66,0,1,0,1,0
49726,445,0,0,67,67,0,1,0,1,0
56153,445,0,0,68,68,0,1,0,1,0
54781,445,0,0,70,70,0,1,0,1,0
64454,445,0,0,70,70,0,1,0,1,0
64485,445,0,0,66,66,0,1,0,1,0
59030,445,0,0,70,70,0,1,0,1,0
49677,445,0,0,70,70,0,1,0,1,0
55416,445,0,0,66,66,0,1,0,1,0
60114,445,0,0,69,69,0,1,0,1,0
54926,445,0,0,68,68,0,1,0,1,0
49179,445,0,0,66,66,0,1,0,1,0
60204,445,0,0,66,66,0,1,0,1,0
63461,445,0,0,70,70,0,1,0,1,0
54270,445,0,0,70,70,0,1,0,1,0
49706,445,0,0,70,70,0,1,0,1,0
55428,445,0,0,70,70,0,1,0,1,0
58701,445,0,0,70,70,0,1,0,1,0
50736,445,0,0,70,70,0,1,0,1,0
64780,445,0,0,70,70,0,1,0,1,0
52805,445,0,0,67,67,0,1,0,1,0
57586,445,0,0,66,66,0,1,0,1,0
65063,445,0,0,67,67,0,1,0,1,0
50567,445,0,0,66,66,0,1,0,1,0
56948,445,0,0,70,70,0,1,0,1,0
55487,445,0,0,70,70,0,1,0,1,0
49252,445,0,0,70,70,0,1,0,1,0
51229,445,0,0,66,66,0,1,0,1,0
59326,445,0,0,66,66,0,1,0,1,0
58385,445,0,0,70,70,0,1,0,1,0
49921,445,0,0,70,70,0,1,0,1,0
62902,445,0,0,66,66,0,1,0,1,0
58826,445,0,0,66,66,0,1,0,1,0
50876,445,0,0,70,70,0,1,0,1,0
57871,445,0,0,70,70,0,1,0,1,0
62977,445,0,0,70,70,0,1,0,1,0
64862,445,0,0,70,70,0,1,0,1,0
56747,445,0,0,70,70,0,1,0,1,0
53687,445,0,0,70,70,0,1,0,1,0
64520,445,0,0,70,70,0,1,0,1,0
55463,445,0,0,69,69,0,1,0,1,0
53170,445,0,0,66,66,0,1,0,1,0
65232,445,0,0,70,70,0,1,0,1,0
61996,445,0,0,66,66,0,1,0,1,0
65131,445,0,0,66,66,0,1,0,1,0
62954,445,0,0,70,70,0,1,0,1,0
52470,445,0,0,66,66,0,1,0,1,0
51826,445,0,0,69,69,0,1,0,1,0
49964,445,0,0,70,70,0,1,0,1,0
60685,445,0,0,70,70,0,1,0,1,0
59956,445,0,0,70,70,0,1,0,1,0
54294,445,0,0,68,68,0,1,0,1,0
53847,445,0,0,70,70,0,1,0,1,0
57112,445,0,0,68,68,0,1,0,1,0
54178,445,0,0,70,70,0,1,0,1,0
55107,445,0,0,70,70,0,1,0,1,0
54367,445,0,0,70,70,0,1,0,1,0
61877,445,0,0,70,70,0,1,0,1,0
50095,445,0,0,70,70,0,1,0,1,0
59738,445,0,0,66,66,0,1,0,1,0
56190,445,0,0,67,67,0,1,0,1,0
54782,445,0,0,67,67,0,1,0,1,0
55233,445,0,0,70,70,0,1,0,1,0
62044,445,0,0,66,66,0,1,0,1,0
56253,445,0,0,70,70,0,1,0,1,0
53589,445,0,0,70,70,0,1,0,1,0
50050,445,0,0,70,70,0,1,0,1,0
55215,445,0,0,70,70,0,1,0,1,0
63296,445,0,0,70,70,0,1,0,1,0
60374,445,0,0,70,70,0,1,0,1,0
58474,445,0,0,67,67,0,1,0,1,0
52889,445,0,0,70,70,0,1,0,1,0
53861,445,0,0,70,70,0,1,0,1,0
58043,445,0,0,70,70,0,1,0,1,0
56642,445,0,0,70,70,0,1,0,1,0
59456,445,0,0,68,68,0,1,0,1,0
63903,445,0,0,66,66,0,1,0,1,0
63445,445,0,0,70,70,0,1,0,1,0
62037,445,0,0,70,70,0,1,0,1,0
60686,445,0,0,70,70,0,1,0,1,0
49212,445,0,0,70,70,0,1,0,1,0
59441,445,0,0,70,70,0,1,0,1,0
57167,445,0,0,70,70,0,1,0,1,0
59732,445,0,0,70,70,0,1,0,1,0
59089,445,0,0,70,70,0,1,0,1,0
55339,445,0,0,70,70,0,1,0,1,0
51454,445,0,0,70,70,0,1,0,1,0
62622,445,0,0,70,70,0,1,0,1,0
55782,445,0,0,70,70,0,1,0,1,0
64689,445,0,0,67,67,0,1,0,1,0
54006,445,0,0,70,70,0,1,0,1,0
59582,445,0,0,66,66,0,1,0,1,0
64650,445,0,0,68,68,0,1,0,1,0
63445,445,0,0,70,70,0,1,0,1,0
55318,445,0,0,68,68,0,1,0,1,0
50333,445,0,0,68,68,0,1,0,1,0
61446,445,0,0,66,66,0,1,0,1,0
59403,445,0,0,68,68,0,1,0,1,0
55402,445,0,0,70,70,0,1,0,1,0
60174,445,0,0,66,66,0,1,0,1,0
52373,445,0,0,69,69,0,1,0,1,0
64885,445,0,0,70,70,0,1,0,1,0
59501,445,0,0,70,70,0,1,0,1,0
60563,445,0,0,66,66,0,1,0,1,0
59533,445,0,0,66,66,0,1,0,1,0
54563,445,0,0,70,70,0,1,0,1,0
61762,445,0,0,70,70,0,1,0,1,0
64074,445,0,0,70,70,0,1,0,1,0
56128,445,0,0,66,66,0,1,0,1,0
58794,445,0,0,70,70,0,1,0,1,0
53635,445,0,0,70,70,0,1,0,1,0
56502,445,0,0,66,66,0,1,0,1,0
58684,445,0,0,69,69,0,1,0,1,0
55211,445,0,0,68,68,0,1,0,1,0
63684,445,0,0,70,70,0,1,0,1,0
50578,445,0,0,70,70,0,1,0,1,0
64393,445,0,0,70,70,0,1,0,1,0
55400,445,0,0,66,66,0,1,0,1,0
52885,445,0,0,67,67,0,1,0,1,0
62061,445,0,0,69,69,0,1,0,1,0
62255,445,0,0,70,70,0,1,0,1,0
60691,445,0,0,67,67,0,1,0,1,0
55251,445,0,0,70,70,0,1,0,1,0
64873,445,0,0,66,66,0,1,0,1,0
60516,445,0,0,69,69,0,1,0,1,0
61328,445,0,0,70,70,0,1,0,1,0
57986,445,0,0,66,66,0,1,0,1,0
61596,445,0,0,66,66,0,1,0,1,0
56340,445,0,0,66,66,0,1,0,1,0
62306,445,0,0,68,68,0,1,0,1,0
50999,445,0,0,70,70,0,1,0,1,0
58565,445,0,0,70,70,0,1,0,1,0
49286,445,0,0,68,68,0,1,0,1,0
51860,445,0,0,68,68,0,1,0,1,0
61981,445,0,0,66,66,0,1,0,1,0
61995,445,0,0,69,69,0,1,0,1,0
61501,445,0,0,66,66,0,1,0,1,0
49423,445,0,0,70,70,0,1,0,1,0
50784,445,0,0,66,66,0,1,0,1,0
50502,445,0,0,70,70,0,1,0,1,0
56836,445,0,0,66,66,0,1,0,1,0
54909,445,0,0,70,70,0,1,0,1,0
63328,445,0,0,67,67,0,1,0,1,0
63170,445,0,0,69,69,0,1,0,1,0
56081,445,0,0,69,69,0,1,0,1,0
60506,445,0,0,66,66,0,1,0,1,0
49622,445,0,0,70,70,0,1,0,1,0
58912,445,0,0,68,68,0,1,0,1,0
58220,445,0,0,70,70,0,1,0,1,0
49841,445,0,0,66,66,0,1,0,1,0
50463,445,0,0,70,70,0,1,0,1,0
51812,445,0,0,66,66,0,1,0,1,0
56516,445,0,0,68,68,0,1,0,1,0
61087,445,0,0,70,70,0,1,0,1,0
59724,445,0,0,66,66,0,1,0,1,0
64681,445,0,0,66,66,0,1,0,1,0
50069,445,0,0,70,70,0,1,0,1,0
54772,445,0,0,70,70,0,1,0,1,0
65398,445,0,0,70,70,0,1,0,1,0
55084,445,0,0,70,70,0,1,0,1,0
49769,445,0,0,70,70,0,1,0,1,0
54863,445,0,0,70,70,0,1,0,1,0
52921,445,0,0,66,66,0,1,0,1,0
53803,445,0,0,70,70,0,1,0,1,0
58515,445,0,0,70,70,0,1,0,1,0
55338,445,0,0,69,69,0,1,0,1,0
51472,445,0,0,70,70,0,1,0,1,0
53117,445,0,0,70,70,0,1,0,1,0
51421,445,0,0,68,68,0,1,0,1,0
56281,445,0,0,70,70,0,1,0,1,0
49533,445,0,0,70,70,0,1,0,1,0
62702,445,0,0,70,70,0,1,0,1,0
65183,445,0,0,70,70,0,1,0,1,0
53719,445,0,0,70,70,0,1,0,1,0
56792,445,0,0,66,66,0,1,0,1,0
53303,445,0,0,70,70,0,1,0,1,0
58164,445,0,0,66,66,0,1,0,1,0
50161,445,0,0,66,66,0,1,0,1,0
63202,445,0,0,69,69,0,1,0,1,0
56774,445,0,0,70,70,0,1,0,1,0
65511,445,0,0,70,70,0,1,0,1,0
62880,445,0,0,70,70,0,1,0,1,0
55316,445,0,0,66,66,0,1,0,1,0
50667,445,0,0,66,66,0,1,0,1,0
58697,445,0,0,70,70,0,1,0,1,0
54013,445,0,0,66,66,0,1,0,1,0
50095,445,0,0,66,66,0,1,0,1,0
50927,445,0,0,66,66,0,1,0,1,0
56192,445,0,0,68,68,0,1,0,1,0
64929,445,0,0,70,70,0,1,0,1,0
61017,445,0,0,70,70,0,1,0,1,0
62721,445,0,0,69,69,0,1,0,1,0
63064,445,0,0,70,70,0,1,0,1,0
61658,445,0,0,69,69,0,1,0,1,0
60791,445,0,0,70,70,0,1,0,1,0
65515,445,0,0,66,66,0,1,0,1,0
54680,445,0,0,70,70,0,1,0,1,0
56966,445,0,0,66,66,0,1,0,1,0
64072,445,0,0,70,70,0,1,0,1,0
62624,445,0,0,70,70,0,1,0,1,0
59804,445,0,0,70,70,0,1,0,1,0
64805,445,0,0,66,66,0,1,0,1,0
50671,445,0,0,66,66,0,1,0,1,0
58419,445,0,0,70,70,0,1,0,1,0
62284,445,0,0,69,69,0,1,0,1,0
53121,445,0,0,70,70,0,1,0,1,0
50138,445,0,0,70,70,0,1,0,1,0
60340,445,0,0,70,70,0,1,0,1,0
51500,445,0,0,70,70,0,1,0,1,0
59155,445,0,0,67,67,0,1,0,1,0
56833,445,0,0,70,70,0,1,0,1,0
56366,445,0,0,70,70,0,1,0,1,0
61983,445,0,0,70,70,0,1,0,1,0
60436,445,0,0,66,66,0,1,0,1,0
52310,445,0,0,70,70,0,1,0,1,0
63874,445,0,0,70,70,0,1,0,1,0
56662,445,0,0,69,69,0,1,0,1,0
52549,445,0,0,70,70,0,1,0,1,0
63870,445,0,0,70,70,0,1,0,1,0
60885,445,0,0,66,66,0,1,0,1,0
61328,445,0,0,70,70,0,1,0,1,0
50767,445,0,0,70,70,0,1,0,1,0
53526,445,0,0,70,70,0,1,0,1,0
52087,445,0,0,70,70,0,1,0,1,0
58328,445,0,0,70,70,0,1,0,1,0
51439,445,0,0,67,67,0,1,0,1,0
49969,445,0,0,66,66,0,1,0,1,0
62323,445,0,0,70,70,0,1,0,1,0
59175,445,0,0,68,68,0,1,0,1,0
63000,445,0,0,68,68,0,1,0,1,0
59826,445,0,0,70,70,0,1,0,1,0
61721,445,0,0,70,70,0,1,0,1,0
49934,445,0,0,70,70,0,1,0,1,0
56406,445,0,0,70,70,0,1,0,1,0
52333,445,0,0,70,70,0,1,0,1,0
50691,445,0,0,66,66,0,1,0,1,0
53497,445,0,0,66,66,0,1,0,1,0
52305,445,0,0,70,70,0,1,0,1,0
53985,445,0,0,70,70,0,1,0,1,0
57926,445,0,0,66,66,0,1,0,1,0
63020,445,0,0,70,70,0,1,0,1,0
55965,445,0,0,68,68,0,1,0,1,0
59338,445,0,0,66,66,0,1,0,1,0
56378,445,0,0,66,66,0,1,0,1,0
56063,445,0,0,66,66,0,1,0,1,0
50485,445,0,0,66,66,0,1,0,1,0
51310,445,0,0,70,70,0,1,0,1,0
49426,445,0,0,70,70,0,1,0,1,0
55128,445,0,0,70,70,0,1,0,1,0
50949,445,0,0,70,70,0,1,0,1,0
59593,445,0,0,66,66,0,1,0,1,0
49889,445,0,0,70,70,0,1,0,1,0
51708,445,0,0,70,70,0,1,0,1,0
59579,445,0,0,70,70,0,1,0,1,0
50377,445,0,0,70,70,0,1,0,1,0
55272,445,0,0,68,68,0,1,0,1,0
51336,445,0,0,70,70,0,1,0,1,0
50723,445,0,0,70,70,0,1,0,1,0
55580,445,0,0,70,70,0,1,0,1,0
53960,445,0,0,69,69,0,1,0,1,0
55031,445,0,0,66,66,0,1,0,1,0
59862,445,0,0,70,70,0,1,0,1,0
63744,445,0,0,66,66,0,1,0,1,0
61057,445,0,0,70,70,0,1,0,1,0
57428,445,0,0,66,66,0,1,0,1,0
49905,445,0,0,70,70,0,1,0,1,0
55456,445,0,0,70,70,0,1,0,1,0
58813,445,0,0,70,70,0,1,0,1,0
50691,445,0,0,66,66,0,1,0,1,0
54370,445,0,0,68,68,0,1,0,1,0
53043,445,0,0,70,70,0,1,0,1,0
58053,445,0,0,66,66,0,1,0,1,0
53749,445,0,0,66,66,0,1,0,1,0
58220,445,0,0,70,70,0,1,0,1,0
51286,445,0,0,70,70,0,1,0,1,0
53634,445,0,0,70,70,0,1,0,1,0
64163,445,0,0,66,66,0,1,0,1,0
52020,445,0,0,67,67,0,1,0,1,0
54269,445,0,0,70,70,0,1,0,1,0
62081,445,0,0,70,70,0,1,0,1,0
62902,445,0,0,67,67,0,1,0,1,0
52534,445,0,0,70,70,0,1,0,1,0
52850,445,0,0,70,70,0,1,0,1,0
60753,445,0,0,70,70,0,1,0,1,0
63389,445,0,0,70,70,0,1,0,1,0
57430,445,0,0,66,66,0,1,0,1,0
56384,445,0,0,70,70,0,1,0,1,0
64082,445,0,0,70,70,0,1,0,1,0
65355,445,0,0,69,69,0,1,0,1,0
64420,445,0,0,66,66,0,1,0,1,0
49794,445,0,0,70,70,0,1,0,1,0
61879,445,0,0,70,70,0,1,0,1,0
62586,445,0,0,67,67,0,1,0,1,0
63287,445,0,0,68,68,0,1,0,1,0
53406,445,0,0,68,68,0,1,0,1,0
50537,445,0,0,66,66,0,1,0,1,0
51971,445,0,0,70,70,0,1,0,1,0
54386,445,0,0,70,70,0,1,0,1,0
50107,445,0,0,70,70,0,1,0,1,0
52918,445,0,0,66,66,0,1,0,1,0
56696,445,0,0,70,70,0,1,0,1,0
52522,445,0,0,69,69,0,1,0,1,0
60980,445,0,0,69,69,0,1,0,1,0
58352,445,0,0,70,70,0,1,0,1,0
52461,445,0,0,70,70,0,1,0,1,0
65198,445,0,0,70,70,0,1,0,1,0
55564,445,0,0,70,70,0,1,0,1,0
62082,445,0,0,70,70,0,1,0,1,0
63407,445,0,0,68,68,0,1,0,1,0
53110,445,0,0,66,66,0,1,0,1,0
59099,445,0,0,66,66,0,1,0,1,0
62902,445,0,0,70,70,0,1,0,1,0
55807,445,0,0,66,66,0,1,0,1,0
59162,445,0,0,66,66,0,1,0,1,0
63571,445,0,0,66,66,0,1,0,1,0
55519,445,0,0,70,70,0,1,0,1,0
57482,445,0,0,70,70,0,1,0,1,0
56275,445,0,0,66,66,0,1,0,1,0
52089,445,0,0,70,70,0,1,0,1,0
62391,445,0,0,68,68,0,1,0,1,0
63830,445,0,0,69,69,0,1,0,1,0
58221,445,0,0,70,70,0,1,0,1,0
64818,445,0,0,70,70,0,1,0,1,0
53487,445,0,0,70,70,0,1,0,1,0
49248,445,0,0,66,66,0,1,0,1,0
65002,445,0,0,68,68,0,1,0,1,0
50194,445,0,0,70,70,0,1,0,1,0
56834,445,0,0,66,66,0,1,0,1,0
61403,445,0,0,70,70,0,1,0,1,0
57383,445,0,0,70,70,0,1,0,1,0
61266,445,0,0,67,67,0,1,0,1,0
65070,445,0,0,67,67,0,1,0,1,0
53359,445,0,0,70,70,0,1,0,1,0
53879,445,0,0,66,66,0,1,0,1,0
50012,445,0,0,70,70,0,1,0,1,0
56786,445,0,0,66,66,0,1,0,1,0
59771,445,0,0,67,67,0,1,0,1,0
65072,445,0,0,70,70,0,1,0,1,0
54987,445,0,0,70,70,0,1,0,1,0
55306,445,0,0,70,70,0,1,0,1,0
49640,445,0,0,66,66,0,1,0,1,0
61124,445,0,0,70,70,0,1,0,1,0
52292,445,0,0,68,68,0,1,0,1,0
60856,445,0,0,70,70,0,1,0,1,0
59506,445,0,0,70,70,0,1,0,1,0
53331,445,0,0,70,70,0,1,0,1,0
52788,445,0,0,66,66,0,1,0,1,0
65232,445,0,0,70,70,0,1,0,1,0
62705,445,0,0,70,70,0,1,0,1,0
59162,445,0,0,70,70,0,1,0,1,0
56220,445,0,0,70,70,0,1,0,1,0
63943,445,0,0,69,69,0,1,0,1,0
65030,445,0,0,70,70,0,1,0,1,0
64413,445,0,0,70,70,0,1,0,1,0
53526,445,0,0,66,66,0,1,0,1,0
54154,445,0,0,70,70,0,1,0,1,0
53036,445,0,0,70,70,0,1,0,1,0
59638,445,0,0,68,68,0,1,0,1,0
63143,445,0,0,68,68,0,1,0,1,0
54897,445,0,0,70,70,0,1,0,1,0
57491,445,0,0,69,69,0,1,0,1,0
62668,445,0,0,69,69,0,1,0,1,0
51297,445,0,0,67,67,0,1,0,1,0
57122,445,0,0,70,70,0,1,0,1,0
50734,445,0,0,70,70,0,1,0,1,0
49810,445,0,0,68,68,0,1,0,1,0
60118,445,0,0,70,70,0,1,0,1,0
49444,445,0,0,70,70,0,1,0,1,0
53013,445,0,0,70,70,0,1,0,1,0
61209,445,0,0,70,70,0,1,0,1,0
64483,445,0,0,69,69,0,1,0,1,0
50498,445,0,0,66,66,0,1,0,1,0
60163,445,0,0,70,70,0,1,0,1,0
62875,445,0,0,66,66,0,1,0,1,0
56135,445,0,0,67,67,0,1,0,1,0
62062,445,0,0,70,70,0,1,0,1,0
63563,445,0,0,67,67,0,1,0,1,0
62872,445,0,0,66,66,0,1,0,1,0
54777,445,0,0,66,66,0,1,0,1,0
64795,445,0,0,70,70,0,1,0,1,0
51697,445,0,0,66,66,0,1,0,1,0
51469,445,0,0,68,68,0,1,0,1,0
54998,445,0,0,68,68,0,1,0,1,0
64808,445,0,0,66,66,0,1,0,1,0
52119,445,0,0,70,70,0,1,0,1,0
58180,445,0,0,66,66,0,1,0,1,0
63342,445,0,0,66,66,0,1,0,1,0
56145,445,0,0,66,66,0,1,0,1,0
63498,445,0,0,66,66,0,1,0,1,0
64322,445,0,0,70,70,0,1,0,1,0
59504,445,0,0,70,70,0,1,0,1,0
63288,445,0,0,70,70,0,1,0,1,0
55761,445,0,0,70,70,0,1,0,1,0
63029,445,0,0,70,70,0,1,0,1,0
54631,445,0,0,66,66,0,1,0,1,0
50337,445,0,0,66,66,0,1,0,1,0
52078,445,0,0,70,70,0,1,0,1,0
56881,445,0,0,70,70,0,1,0,1,0
64010,445,0,0,70,70,0,1,0,1,0
50524,445,0,0,66,66,0,1,0,1,0
50683,445,0,0,70,70,0,1,0,1,0
54239,445,0,0,70,70,0,1,0,1,0
55304,445,0,0,70,70,0,1,0,1,0
50403,445,0,0,70,70,0,1,0,1,0
56833,445,0,0,70,70,0,1,0,1,0
55804,445,0,0,67,67,0,1,0,1,0
51126,445,0,0,66,66,0,1,0,1,0
52326,445,0,0,68,68,0,1,0,1,0
62793,445,0,0,70,70,0,1,0,1,0
62649,445,0,0,70,70,0,1,0,1,0
54441,445,0,0,66,66,0,1,0,1,0
61530,445,0,0,70,70,0,1,0,1,0
57399,445,0,0,66,66,0,1,0,1,0
61791,445,0,0,70,70,0,1,0,1,0
50034,445,0,0,70,70,0,1,0,1,0
49620,445,0,0,66,66,0,1,0,1,0
60076,445,0,0,66,66,0,1,0,1,0
55040,445,0,0,66,66,0,1,0,1,0
60553,445,0,0,70,70,0,1,0,1,0
56510,445,0,0,68,68,0,1,0,1,0
57643,445,0,0,70,70,0,1,0,1,0
55660,445,0,0,69,69,0,1,0,1,0
51243,445,0,0,66,66,0,1,0,1,0
59969,445,0,0,66,66,0,1,0,1,0
56340,445,0,0,66,66,0,1,0,1,0
49911,445,0,0,70,70,0,1,0,1,0
56168,445,0,0,70,70,0,1,0,1,0
57217,445,0,0,66,66,0,1,0,1,0
64600,445,0,0,69,69,0,1,0,1,0
54976,445,0,0,70,70,0,1,0,1,0
49748,445,0,0,70,70,0,1,0,1,0
53607,445,0,0,66,66,0,1,0,1,0
57217,445,0,0,66,66,0,1,0,1,0
52788,445,0,0,66,66,0,1,0,1,0
49187,445,0,0,69,69,0,1,0,1,0
65188,445,0,0,70,70,0,1,0,1,0
52418,445,0,0,68,68,0,1,0,1,0
49745,445,0,0,67,67,0,1,0,1,0
52157,445,0,0,66,66,0,1,0,1,0
54494,445,0,0,70,70,0,1,0,1,0
54505,445,0,0,69,69,0,1,0,1,0
59591,445,0,0,70,70,0,1,0,1,0
61177,445,0,0,68,68,0,1,0,1,0
52790,445,0,0,66,66,0,1,0,1,0
55555,445,0,0,70,70,0,1,0,1,0
59946,445,0,0,66,66,0,1,0,1,0
59292,445,0,0,69,69,0,1,0,1,0
54774,445,0,0,66,66,0,1,0,1,0
56966,445,0,0,66,66,0,1,0,1,0
63210,445,0,0,68,68,0,1,0,1,0
65478,445,0,0,66,66,0,1,0,1,0
54333,445,0,0,70,70,0,1,0,1,0
50998,445,0,0,70,70,0,1,0,1,0
58537,445,0,0,70,70,0,1,0,1,0
58445,445,0,0,70,70,0,1,0,1,0
56773,445,0,0,66,66,0,1,0,1,0
56944,445,0,0,66,66,0,1,0,1,0
55246,445,0,0,70,70,0,1,0,1,0
57200,445,0,0,66,66,0,1,0,1,0
51351,445,0,0,67,67,0,1,0,1,0
61068,445,0,0,70,70,0,1,0,1,0
61122,445,0,0,70,70,0,1,0,1,0
55710,445,0,0,70,70,0,1,0,1,0
50209,445,0,0,70,70,0,1,0,1,0
62797,445,0,0,69,69,0,1,0,1,0
64987,445,0,0,68,68,0,1,0,1,0
54155,445,0,0,67,67,0,1,0,1,0
56416,445,0,0,70,70,0,1,0,1,0
53250,445,0,0,70,70,0,1,0,1,0
52190,445,0,0,70,70,0,1,0,1,0
56326,445,0,0,70,70,0,1,0,1,0
52394,445,0,0,66,66,0,1,0,1,0
54827,445,0,0,68,68,0,1,0,1,0
54500,445,0,0,70,70,0,1,0,1,0
53294,445,0,0,66,66,0,1,0,1,0
50558,445,0,0,70,70,0,1,0,1,0
60619,445,0,0,66,66,0,1,0,1,0
55463,445,0,0,70,70,0,1,0,1,0
54386,445,0,0,70,70,0,1,0,1,0
59325,445,0,0,68,68,0,1,0,1,0
65040,445,0,0,70,70,0,1,0,1,0
55918,445,0,0,67,67,0,1,0,1,0
58666,445,0,0,70,70,0,1,0,1,0
52369,445,0,0,68,68,0,1,0,1,0
53214,445,0,0,70,70,0,1,0,1,0
52858,445,0,0,70,70,0,1,0,1,0
52560,445,0,0,70,70,0,1,0,1,0
62357,445,0,0,67,67,0,1,0,1,0
56063,445,0,0,66,66,0,1,0,1,0
64883,445,0,0,70,70,0,1,0,1,0
58573,445,0,0,66,66,0,1,0,1,0
54016,445,0,0,70,70,0,1,0,1,0
58690,445,0,0,66,66,0,1,0,1,0
55975,445,0,0,70,70,0,1,0,1,0
49626,445,0,0,70,70,0,1,0,1,0
50095,445,0,0,70,70,0,1,0,1,0
57141,445,0,0,66,66,0,1,0,1,0
51831,445,0,0,66,66,0,1,0,1,0
62155,445,0,0,67,67,0,1,0,1,0
61004,445,0,0,66,66,0,1,0,1,0
62913,445,0,0,70,70,0,1,0,1,0
61081,445,0,0,66,66,0,1,0,1,0
49809,445,0,0,70,70,0,1,0,1,0
56843,445,0,0,69,69,0,1,0,1,0
50385,445,0,0,70,70,0,1,0,1,0
49942,445,0,0,70,70,0,1,0,1,0
55011,445,0,0,70,70,0,1,0,1,0
63210,445,0,0,67,67,0,1,0,1,0
54486,445,0,0,70,70,0,1,0,1,0
56007,445,0,0,66,66,0,1,0,1,0
50466,445,0,0,66,66,0,1,0,1,0
55801,445,0,0,70,70,0,1,0,1,0
63030,445,0,0,66,66,0,1,0,1,0
54089,445,0,0,66,66,0,1,0,1,0
65157,445,0,0,70,70,0,1,0,1,0
65514,445,0,0,70,70,0,1,0,1,0
55360,445,0,0,70,70,0,1,0,1,0
64877,445,0,0,70,70,0,1,0,1,0
54677,445,0,0,66,66,0,1,0,1,0
54158,445,0,0,70,70,0,1,0,1,0
57146,445,0,0,66,66,0,1,0,1,0
62980,445,0,0,70,70,0,1,0,1,0
50941,445,0,0,70,70,0,1,0,1,0
51046,445,0,0,66,66,0,1,0,1,0
61849,445,0,0,66,66,0,1,0,1,0
52804,445,0,0,70,70,0,1,0,1,0
54505,445,0,0,66,66,0,1,0,1,0
49755,445,0,0,70,70,0,1,0,1,0
49351,445,0,0,70,70,0,1,0,1,0
54718,445,0,0,70,70,0,1,0,1,0
52760,445,0,0,70,70,0,1,0,1,0
61513,445,0,0,68,68,0,1,0,1,0
60873,445,0,0,66,66,0,1,0,1,0
50259,445,0,0,70,70,0,1,0,1,0
53568,445,0,0,66,66,0,1,0,1,0
54163,445,0,0,68,68,0,1,0,1,0
51466,445,0,0,70,70,0,1,0,1,0
60951,445,0,0,66,66,0,1,0,1,0
59604,445,0,0,68,68,0,1,0,1,0
63311,445,0,0,67,67,0,1,0,1,0
49192,445,0,0,70,70,0,1,0,1,0
54659,445,0,0,70,70,0,1,0,1,0
61209,445,0,0,66,66,0,1,0,1,0
58884,445,0,0,66,66,0,1,0,1,0
57803,445,0,0,66,66,0,1,0,1,0
52952,445,0,0,70,70,0,1,0,1,0
55415,445,0,0,70,70,0,1,0,1,0
49164,445,0,0,68,68,0,1,0,1,0
53165,445,0,0,70,70,0,1,0,1,0
59789,445,0,0,66,66,0,1,0,1,0
60058,445,0,0,66,66,0,1,0,1,0
63085,445,0,0,68,68,0,1,0,1,0
61647,445,0,0,68,68,0,1,0,1,0
60329,445,0,0,70,70,0,1,0,1,0
59502,445,0,0,68,68,0,1,0,1,0
61884,445,0,0,66,66,0,1,0,1,0
62018,445,0,0,70,70,0,1,0,1,0
50948,445,0,0,70,70,0,1,0,1,0
54390,445,0,0,70,70,0,1,0,1,0
52165,445,0,0,69,69,0,1,0,1,0
64414,445,0,0,70,70,0,1,0,1,0
63390,445,0,0,66,66,0,1,0,1,0
51926,445,0,0,70,70,0,1,0,1,0
55935,445,0,0,66,66,0,1,0,1,0
57217,445,0,0,69,69,0,1,0,1,0
63052,445,0,0,70,70,0,1,0,1,0
63872,445,0,0,66,66,0,1,0,1,0
51114,445,0,0,66,66,0,1,0,1,0
64028,445,0,0,70,70,0,1,0,1,0
58844,445,0,0,67,67,0,1,0,1,0
57191,445,0,0,70,70,0,1,0,1,0
59919,445,0,0,69,69,0,1,0,1,0
60111,445,0,0,66,66,0,1,0,1,0
60868,445,0,0,70,70,0,1,0,1,0
64521,445,0,0,70,70,0,1,0,1,0
56534,445,0,0,70,70,0,1,0,1,0
52956,445,0,0,70,70,0,1,0,1,0
51858,445,0,0,70,70,0,1,0,1,0
56532,445,0,0,70,70,0,1,0,1,0
60134,445,0,0,66,66,0,1,0,1,0
50986,445,0,0,66,66,0,1,0,1,0
50006,445,0,0,70,70,0,1,0,1,0
61404,445,0,0,66,66,0,1,0,1,0
52017,445,0,0,70,70,0,1,0,1,0
58841,445,0,0,66,66,0,1,0,1,0
53559,445,0,0,67,67,0,1,0,1,0
57731,445,0,0,66,66,0,1,0,1,0
65337,445,0,0,70,70,0,1,0,1,0
49533,445,0,0,70,70,0,1,0,1,0
59915,445,0,0,70,70,0,1,0,1,0
62980,445,0,0,70,70,0,1,0,1,0
49966,445,0,0,70,70,0,1,0,1,0
62723,445,0,0,70,70,0,1,0,1,0
58765,445,0,0,70,70,0,1,0,1,0
50949,445,0,0,70,70,0,1,0,1,0
54971,445,0,0,70,70,0,1,0,1,0
63197,445,0,0,70,70,0,1,0,1,0
50779,445,0,0,70,70,0,1,0,1,0
52933,445,0,0,66,66,0,1,0,1,0
49357,445,0,0,68,68,0,1,0,1,0
57984,445,0,0,70,70,0,1,0,1,0
53366,445,0,0,66,66,0,1,0,1,0
63068,445,0,0,70,70,0,1,0,1,0
57218,445,0,0,66,66,0,1,0,1,0
50689,445,0,0,66,66,0,1,0,1,0
63470,445,0,0,70,70,0,1,0,1,0
63360,445,0,0,70,70,0,1,0,1,0
64732,445,0,0,69,69,0,1,0,1,0
50398,445,0,0,70,70,0,1,0,1,0
51046,445,0,0,66,66,0,1,0,1,0
53012,445,0,0,66,66,0,1,0,1,0
56375,445,0,0,66,66,0,1,0,1,0
53408,445,0,0,70,70,0,1,0,1,0
58661,445,0,0,70,70,0,1,0,1,0
60478,445,0,0,70,70,0,1,0,1,0
50500,445,0,0,66,66,0,1,0,1,0
55489,445,0,0,66,66,0,1,0,1,0
62852,445,0,0,70,70,0,1,0,1,0
51043,445,0,0,70,70,0,1,0,1,0
52534,445,0,0,70,70,0,1,0,1,0
51291,445,0,0,70,70,0,1,0,1,0
52250,445,0,0,70,70,0,1,0,1,0
50753,445,0,0,68,68,0,1,0,1,0
57776,445,0,0,70,70,0,1,0,1,0
64677,445,0,0,66,66,0,1,0,1,0
64120,445,0,0,68,68,0,1,0,1,0
61176,445,0,0,70,70,0,1,0,1,0
58319,445,0,0,70,70,0,1,0,1,0
60133,445,0,0,66,66,0,1,0,1,0
49956,445,0,0,67,67,0,1,0,1,0
57965,445,0,0,70,70,0,1,0,1,0
51361,445,0,0,68,68,0,1,0,1,0
60295,445,0,0,70,70,0,1,0,1,0
57157,445,0,0,70,70,0,1,0,1,0
51094,445,0,0,68,68,0,1,0,1,0
51034,445,0,0,70,70,0,1,0,1,0
60620,445,0,0,66,66,0,1,0,1,0
53567,445,0,0,66,66,0,1,0,1,0
60788,445,0,0,70,70,0,1,0,1,0
55934,445,0,0,68,68,0,1,0,1,0
52227,445,0,0,70,70,0,1,0,1,0
52958,445,0,0,70,70,0,1,0,1,0
57859,445,0,0,66,66,0,1,0,1,0
61772,445,0,0,66,66,0,1,0,1,0
57933,445,0,0,70,70,0,1,0,1,0
62407,445,0,0,70,70,0,1,0,1,0
61000,445,0,0,68,68,0,1,0,1,0
49604,445,0,0,70,70,0,1,0,1,0
63748,445,0,0,69,69,0,1,0,1,0
50039,445,0,0,70,70,0,1,0,1,0
64596,445,0,0,70,70,0,1,0,1,0
59338,445,0,0,67,67,0,1,0,1,0
62626,445,0,0,70,70,0,1,0,1,0
53984,445,0,0,70,70,0,1,0,1,0
55695,445,0,0,70,70,0,1,0,1,0
63277,445,0,0,70,70,0,1,0,1,0
59143,445,0,0,66,66,0,1,0,1,0
55199,445,0,0,70,70,0,1,0,1,0
57830,445,0,0,70,70,0,1,0,1,0
52041,445,0,0,67,67,0,1,0,1,0
55651,445,0,0,70,70,0,1,0,1,0
57963,445,0,0,70,70,0,1,0,1,0
56979,445,0,0,69,69,0,1,0,1,0
59377,445,0,0,68,68,0,1,0,1,0
53147,445,0,0,70,70,0,1,0,1,0
57419,445,0,0,67,67,0,1,0,1,0
50290,445,0,0,66,66,0,1,0,1,0
50749,445,0,0,66,66,0,1,0,1,0
63842,445,0,0,68,68,0,1,0,1,0
53439,445,0,0,70,70,0,1,0,1,0
59218,445,0,0,70,70,0,1,0,1,0
59549,445,0,0,68,68,0,1,0,1,0
64225,445,0,0,67,67,0,1,0,1,0
57346,445,0,0,66,66,0,1,0,1,0
51065,445,0,0,66,66,0,1,0,1,0
60095,445,0,0,70,70,0,1,0,1,0
59543,445,0,0,66,66,0,1,0,1,0
49462,445,0,0,66,66,0,1,0,1,0
56318,445,0,0,69,69,0,1,0,1,0
54830,445,0,0,67,67,0,1,0,1,0
63294,445,0,0,67,67,0,1,0,1,0
56976,445,0,0,70,70,0,1,0,1,0
49327,445,0,0,66,66,0,1,0,1,0
55402,445,0,0,69,69,0,1,0,1,0
49843,445,0,0,66,66,0,1,0,1,0
54166,445,0,0,68,68,0,1,0,1,0
61948,445,0,0,70,70,0,1,0,1,0
50783,445,0,0,70,70,0,1,0,1,0
51127,445,0,0,70,70,0,1,0,1,0
60518,445,0,0,68,68,0,1,0,1,0
65515,445,0,0,68,68,0,1,0,1,0
58912,445,0,0,67,67,0,1,0,1,0
61445,445,0,0,68,68,0,1,0,1,0
56075,445,0,0,70,70,0,1,0,1,0
56661,445,0,0,66,66,0,1,0,1,0
58040,445,0,0,66,66,0,1,0,1,0
52015,445,0,0,70,70,0,1,0,1,0
61994,445,0,0,70,70,0,1,0,1,0
63294,445,0,0,66,66,0,1,0,1,0
50270,445,0,0,70,70,0,1,0,1,0
52483,445,0,0,70,70,0,1,0,1,0
62174,445,0,0,70,70,0,1,0,1,0
61124,445,0,0,69,69,0,1,0,1,0
50688,445,0,0,70,70,0,1,0,1,0
61396,445,0,0,70,70,0,1,0,1,0
54203,445,0,0,70,70,0,1,0,1,0
51623,445,0,0,66,66,0,1,0,1,0
64745,445,0,0,67,67,0,1,0,1,0
59988,445,0,0,70,70,0,1,0,1,0
62488,445,0,0,66,66,0,1,0,1,0
52041,445,0,0,66,66,0,1,0,1,0
52295,445,0,0,66,66,0,1,0,1,0
62255,445,0,0,70,70,0,1,0,1,0
53722,445,0,0,70,70,0,1,0,1,0
49890,445,0,0,66,66,0,1,0,1,0
53503,445,0,0,70,70,0,1,0,1,0
51917,445,0,0,66,66,0,1,0,1,0
56864,445,0,0,70,70,0,1,0,1,0
56130,445,0,0,69,69,0,1,0,1,0
52860,445,0,0,70,70,0,1,0,1,0
51080,445,0,0,68,68,0,1,0,1,0
61402,445,0,0,66,66,0,1,0,1,0
60722,445,0,0,67,67,0,1,0,1,0
56141,445,0,0,66,66,0,1,0,1,0
63644,445,0,0,70,70,0,1,0,1,0
54300,445,0,0,70,70,0,1,0,1,0
57476,445,0,0,66,66,0,1,0,1,0
51228,445,0,0,67,67,0,1,0,1,0
55664,445,0,0,70,70,0,1,0,1,0
50477,445,0,0,66,66,0,1,0,1,0
63593,445,0,0,70,70,0,1,0,1,0
55643,445,0,0,70,70,0,1,0,1,0
50649,445,0,0,66,66,0,1,0,1,0
50041,445,0,0,70,70,0,1,0,1,0
50775,445,0,0,70,70,0,1,0,1,0
52984,445,0,0,66,66,0,1,0,1,0
63257,445,0,0,68,68,0,1,0,1,0
51499,445,0,0,66,66,0,1,0,1,0
62212,445,0,0,70,70,0,1,0,1,0
57986,445,0,0,70,70,0,1,0,1,0
52509,445,0,0,70,70,0,1,0,1,0
54063,445,0,0,67,67,0,1,0,1,0
58797,445,0,0,70,70,0,1,0,1,0
61466,445,0,0,66,66,0,1,0,1,0
56809,445,0,0,70,70,0,1,0,1,0
52998,445,0,0,67,67,0,1,0,1,0
50927,445,0,0,66,66,0,1,0,1,0
55093,445,0,0,69,69,0,1,0,1,0
57775,445,0,0,70,70,0,1,0,1,0
62838,445,0,0,70,70,0,1,0,1,0
56940,445,0,0,70,70,0,1,0,1,0
59673,445,0,0,66,66,0,1,0,1,0
50035,445,0,0,70,70,0,1,0,1,0
58201,445,0,0,69,69,0,1,0,1,0
56939,445,0,0,70,70,0,1,0,1,0
52340,445,0,0,66,66,0,1,0,1,0
60939,445,0,0,70,70,0,1,0,1,0
62340,445,0,0,70,70,0,1,0,1,0
59209,445,0,0,66,66,0,1,0,1,0
61182,445,0,0,70,70,0,1,0,1,0
60914,445,0,0,70,70,0,1,0,1,0
58578,445,0,0,68,68,0,1,0,1,0
52072,445,0,0,70,70,0,1,0,1,0
60159,445,0,0,66,66,0,1,0,1,0
50571,445,0,0,68,68,0,1,0,1,0
50720,445,0,0,67,67,0,1,0,1,0
59734,445,0,0,67,67,0,1,0,1,0
57158,445,0,0,70,70,0,1,0,1,0
60724,445,0,0,66,66,0,1,0,1,0
51069,445,0,0,66,66,0,1,0,1,0
54780,445,0,0,66,66,0,1,0,1,0
64390,445,0,0,70,70,0,1,0,1,0
60629,445,0,0,66,66,0,1,0,1,0
61643,445,0,0,66,66,0,1,0,1,0
60813,445,0,0,70,70,0,1,0,1,0
50928,445,0,0,66,66,0,1,0,1,0
59030,445,0,0,68,68,0,1,0,1,0
51716,445,0,0,70,70,0,1,0,1,0
62216,445,0,0,66,66,0,1,0,1,0
63644,445,0,0,70,70,0,1,0,1,0
49789,445,0,0,70,70,0,1,0,1,0
59935,445,0,0,66,66,0,1,0,1,0
55290,445,0,0,69,69,0,1,0,1,0
59868,445,0,0,70,70,0,1,0,1,0
53981,445,0,0,70,70,0,1,0,1,0
62389,445,0,0,70,70,0,1,0,1,0
58997,445,0,0,69,69,0,1,0,1,0
53943,445,0,0,66,66,0,1,0,1,0
60433,445,0,0,66,66,0,1,0,1,0
57861,445,0,0,70,70,0,1,0,1,0
57730,445,0,0,68,68,0,1,0,1,0
51183,445,0,0,66,66,0,1,0,1,0
49841,445,0,0,70,70,0,1,0,1,0
58595,445,0,0,70,70,0,1,0,1,0
53336,445,0,0,70,70,0,1,0,1,0
59612,445,0,0,70,70,0,1,0,1,0
54129,445,0,0,70,70,0,1,0,1,0
64938,445,0,0,67,67,0,1,0,1,0
50478,445,0,0,70,70,0,1,0,1,0
57966,445,0,0,70,70,0,1,0,1,0
60803,445,0,0,70,70,0,1,0,1,0
50338,445,0,0,66,66,0,1,0,1,0
64890,445,0,0,70,70,0,1,0,1,0
59661,445,0,0,66,66,0,1,0,1,0
56872,445,0,0,70,70,0,1,0,1,0
54129,445,0,0,70,70,0,1,0,1,0
63956,445,0,0,66,66,0,1,0,1,0
49904,445,0,0,69,69,0,1,0,1,0
64186,445,0,0,70,70,0,1,0,1,0
53835,445,0,0,68,68,0,1,0,1,0
58154,445,0,0,66,66,0,1,0,1,0
53758,445,0,0,70,70,0,1,0,1,0
51751,445,0,0,70,70,0,1,0,1,0
63146,445,0,0,67,67,0,1,0,1,0
61534,445,0,0,70,70,0,1,0,1,0
59530,445,0,0,66,66,0,1,0,1,0
50910,445,0,0,66,66,0,1,0,1,0
54528,445,0,0,70,70,0,1,0,1,0
60841,445,0,0,66,66,0,1,0,1,0
60083,445,0,0,70,70,0,1,0,1,0
50686,445,0,0,70,70,0,1,0,1,0
58774,445,0,0,70,70,0,1,0,1,0
56785,445,0,0,70,70,0,1,0,1,0
54397,445,0,0,66,66,0,1,0,1,0
64557,445,0,0,70,70,0,1,0,1,0
52406,445,0,0,66,66,0,1,0,1,0
56469,445,0,0,70,70,0,1,0,1,0
58296,445,0,0,66,66,0,1,0,1,0
55054,445,0,0,70,70,0,1,0,1,0
56836,445,0,0,66,66,0,1,0,1,0
56073,445,0,0,70,70,0,1,0,1,0
60340,445,0,0,70,70,0,1,0,1,0
60729,445,0,0,70,70,0,1,0,1,0
50098,445,0,0,66,66,0,1,0,1,0
54472,445,0,0,66,66,0,1,0,1,0
54855,445,0,0,66,66,0,1,0,1,0
50025,445,0,0,69,69,0,1,0,1,0
62357,445,0,0,70,70,0,1,0,1,0
62885,445,0,0,70,70,0,1,0,1,0
50753,445,0,0,70,70,0,1,0,1,0
56640,445,0,0,70,70,0,1,0,1,0
55607,445,0,0,70,70,0,1,0,1,0
58228,445,0,0,66,66,0,1,0,1,0
57752,445,0,0,70,70,0,1,0,1,0
55490,445,0,0,70,70,0,1,0,1,0
53176,445,0,0,68,68,0,1,0,1,0
55276,445,0,0,70,70,0,1,0,1,0
55173,445,0,0,70,70,0,1,0,1,0
60171,445,0,0,70,70,0,1,0,1,0
64463,445,0,0,70,70,0,1,0,1,0
63646,445,0,0,69,69,0,1,0,1,0
59781,445,0,0,70,70,0,1,0,1,0
49909,445,0,0,70,70,0,1,0,1,0
61430,445,0,0,70,70,0,1,0,1,0
50354,445,0,0,70,70,0,1,0,1,0
50317,445,0,0,70,70,0,1,0,1,0
52460,445,0,0,70,70,0,1,0,1,0
59591,445,0,0,70,70,0,1,0,1,0
55361,445,0,0,70,70,0,1,0,1,0
50118,445,0,0,70,70,0,1,0,1,0
61735,445,0,0,67,67,0,1,0,1,0
57455,445,0,0,70,70,0,1,0,1,0
52532,445,0,0,66,66,0,1,0,1,0
59161,445,0,0,70,70,0,1,0,1,0
63941,445,0,0,67,67,0,1,0,1,0
56732,445,0,0,70,70,0,1,0,1,0
64175,445,0,0,70,70,0,1,0,1,0
61482,445,0,0,70,70,0,1,0,1,0
52747,445,0,0,68,68,0,1,0,1,0
63671,445,0,0,66,66,0,1,0,1,0
52531,445,0,0,67,67,0,1,0,1,0
52763,445,0,0,70,70,0,1,0,1,0
49617,445,0,0,70,70,0,1,0,1,0
60471,445,0,0,70,70,0,1,0,1,0
56736,445,0,0,70,70,0,1,0,1,0
52762,445,0,0,70,70,0,1,0,1,0
61826,445,0,0,70,70,0,1,0,1,0
58354,445,0,0,66,66,0,1,0,1,0
55406,445,0,0,70,70,0,1,0,1,0
54868,445,0,0,70,70,0,1,0,1,0
65227,445,0,0,70,70,0,1,0,1,0
58852,445,0,0,70,70,0,1,0,1,0
53063,445,0,0,66,66,0,1,0,1,0
52778,445,0,0,69,69,0,1,0,1,0
58962,445,0,0,66,66,0,1,0,1,0
61399,445,0,0,66,66,0,1,0,1,0
50462,445,0,0,70,70,0,1,0,1,0
54586,445,0,0,66,66,0,1,0,1,0
62745,445,0,0,66,66,0,1,0,1,0
65416,445,0,0,70,70,0,1,0,1,0
61891,445,0,0,70,70,0,1,0,1,0
55607,445,0,0,66,66,0,1,0,1,0
60339,445,0,0,70,70,0,1,0,1,0
64436,445,0,0,70,70,0,1,0,1,0
54816,445,0,0,70,70,0,1,0,1,0
55836,445,0,0,70,70,0,1,0,1,0
61332,445,0,0,69,69,0,1,0,1,0
50957,445,0,0,70,70,0,1,0,1,0
55234,445,0,0,70,70,0,1,0,1,0
50481,445,0,0,66,66,0,1,0,1,0
53801,445,0,0,70,70,0,1,0,1,0
59433,445,0,0,66,66,0,1,0,1,0
56459,445,0,0,67,67,0,1,0,1,0
60722,445,0,0,69,69,0,1,0,1,0
60701,445,0,0,70,70,0,1,0,1,0
63728,445,0,0,70,70,0,1,0,1,0
56427,445,0,0,70,70,0,1,0,1,0
52676,445,0,0,68,68,0,1,0,1,0
54147,445,0,0,70,70,0,1,0,1,0
55215,445,0,0,70,70,0,1,0,1,0
50969,445,0,0,70,70,0,1,0,1,0
58247,445,0,0,66,66,0,1,0,1,0
52859,445,0,0,70,70,0,1,0,1,0
57730,445,0,0,66,66,0,1,0,1,0
59171,445,0,0,66,66,0,1,0,1,0
65157,445,0,0,70,70,0,1,0,1,0
56053,445,0,0,70,70,0,1,0,1,0
65304,445,0,0,66,66,0,1,0,1,0
49717,445,0,0,68,68,0,1,0,1,0
51119,445,0,0,66,66,0,1,0,1,0
55970,445,0,0,70,70,0,1,0,1,0
52601,445,0,0,66,66,0,1,0,1,0
55866,445,0,0,66,66,0,1,0,1,0
52671,445,0,0,69,69,0,1,0,1,0
50956,445,0,0,70,70,0,1,0,1,0
51687,445,0,0,70,70,0,1,0,1,0
61766,445,0,0,70,70,0,1,0,1,0
56118,445,0,0,70,70,0,1,0,1,0
59718,445,0,0,67,67,0,1,0,1,0
59271,445,0,0,68,68,0,1,0,1,0
62263,445,0,0,70,70,0,1,0,1,0
61476,445,0,0,70,70,0,1,0,1,0
59018,445,0,0,66,66,0,1,0,1,0
61416,445,0,0,70,70,0,1,0,1,0
56005,445,0,0,66,66,0,1,0,1,0
51380,445,0,0,67,67,0,1,0,1,0
50265,445,0,0,70,70,0,1,0,1,0
61121,445,0,0,70,70,0,1,0,1,0
50007,445,0,0,70,70,0,1,0,1,0
50363,445,0,0,70,70,0,1,0,1,0
59918,445,0,0,69,69,0,1,0,1,0
54267,445,0,0,69,69,0,1,0,1,0
56715,445,0,0,70,70,0,1,0,1,0
64364,445,0,0,66,66,0,1,0,1,0
62854,445,0,0,66,66,0,1,0,1,0
59051,445,0,0,70,70,0,1,0,1,0
64633,445,0,0,70,70,0,1,0,1,0
55044,445,0,0,70,70,0,1,0,1,0
61673,445,0,0,66,66,0,1,0,1,0
51066,445,0,0,70,70,0,1,0,1,0
56328,445,0,0,70,70,0,1,0,1,0
61117,445,0,0,70,70,0,1,0,1,0
50594,445,0,0,70,70,0,1,0,1,0
62538,445,0,0,70,70,0,1,0,1,0
50999,445,0,0,70,70,0,1,0,1,0
63775,445,0,0,66,66,0,1,0,1,0
55583,445,0,0,70,70,0,1,0,1,0
53899,445,0,0,69,69,0,1,0,1,0
63811,445,0,0,70,70,0,1,0,1,0
60569,445,0,0,70,70,0,1,0,1,0
60601,445,0,0,70,70,0,1,0,1,0
58438,445,0,0,70,70,0,1,0,1,0
63784,445,0,0,70,70,0,1,0,1,0
54865,445,0,0,70,70,0,1,0,1,0
62102,445,0,0,66,66,0,1,0,1,0
51721,445,0,0,66,66,0,1,0,1,0
64524,445,0,0,70,70,0,1,0,1,0
59148,445,0,0,70,70,0,1,0,1,0
50180,445,0,0,70,70,0,1,0,1,0
49335,445,0,0,70,70,0,1,0,1,0
52785,445,0,0,70,70,0,1,0,1,0
64904,445,0,0,70,70,0,1,0,1,0
53266,445,0,0,67,67,0,1,0,1,0
50198,445,0,0,69,69,0,1,0,1,0
51554,445,0,0,66,66,0,1,0,1,0
58185,445,0,0,70,70,0,1,0,1,0
54576,445,0,0,66,66,0,1,0,1,0
63364,445,0,0,70,70,0,1,0,1,0
50838,445,0,0,70,70,0,1,0,1,0
50968,445,0,0,69,69,0,1,0,1,0
62681,445,0,0,67,67,0,1,0,1,0
55560,445,0,0,67,67,0,1,0,1,0
64813,445,0,0,70,70,0,1,0,1,0
55726,445,0,0,66,66,0,1,0,1,0
53719,445,0,0,70,70,0,1,0,1,0
51048,445,0,0,66,66,0,1,0,1,0
55547,445,0,0,66,66,0,1,0,1,0
50069,445,0,0,70,70,0,1,0,1,0
61166,445,0,0,69,69,0,1,0,1,0
50397,445,0,0,66,66,0,1,0,1,0
65258,445,0,0,66,66,0,1,0,1,0
54062,445,0,0,70,70,0,1,0,1,0
55733,445,0,0,66,66,0,1,0,1,0
50110,445,0,0,70,70,0,1,0,1,0
50417,445,0,0,66,66,0,1,0,1,0
62185,445,0,0,70,70,0,1,0,1,0
62777,445,0,0,68,68,0,1,0,1,0
53654,445,0,0,70,70,0,1,0,1,0
59611,445,0,0,70,70,0,1,0,1,0
60206,445,0,0,70,70,0,1,0,1,0
56470,445,0,0,70,70,0,1,0,1,0
63967,445,0,0,66,66,0,1,0,1,0
54614,445,0,0,67,67,0,1,0,1,0
51049,445,0,0,70,70,0,1,0,1,0
51431,445,0,0,70,70,0,1,0,1,0
61621,445,0,0,70,70,0,1,0,1,0
60516,445,0,0,66,66,0,1,0,1,0
60539,445,0,0,70,70,0,1,0,1,0
56627,445,0,0,69,69,0,1,0,1,0
54192,445,0,0,69,69,0,1,0,1,0
51754,445,0,0,70,70,0,1,0,1,0
60685,445,0,0,70,70,0,1,0,1,0
54492,445,0,0,70,70,0,1,0,1,0
50987,445,0,0,70,70,0,1,0,1,0
50673,445,0,0,70,70,0,1,0,1,0
52169,445,0,0,66,66,0,1,0,1,0
57876,445,0,0,70,70,0,1,0,1,0
50603,445,0,0,66,66,0,1,0,1,0
54273,445,0,0,70,70,0,1,0,1,0
58317,445,0,0,70,70,0,1,0,1,0
61075,445,0,0,70,70,0,1,0,1,0
58314,445,0,0,70,70,0,1,0,1,0
59320,445,0,0,70,70,0,1,0,1,0
59502,445,0,0,70,70,0,1,0,1,0
55980,445,0,0,70,70,0,1,0,1,0
49812,445,0,0,70,70,0,1,0,1,0
59018,445,0,0,70,70,0,1,0,1,0
52608,445,0,0,70,70,0,1,0,1,0
59401,445,0,0,66,66,0,1,0,1,0
62854,445,0,0,68,68,0,1,0,1,0
52521,445,0,0,70,70,0,1,0,1,0
52269,445,0,0,70,70,0,1,0,1,0
65178,445,0,0,66,66,0,1,0,1,0
50076,445,0,0,70,70,0,1,0,1,0
53543,445,0,0,70,70,0,1,0,1,0
62679,445,0,0,70,70,0,1,0,1,0
56580,445,0,0,69,69,0,1,0,1,0
52303,445,0,0,70,70,0,1,0,1,0
62516,445,0,0,66,66,0,1,0,1,0
55191,445,0,0,70,70,0,1,0,1,0
52306,445,0,0,70,70,0,1,0,1,0
53684,445,0,0,66,66,0,1,0,1,0
54914,445,0,0,70,70,0,1,0,1,0
56639,445,0,0,70,70,0,1,0,1,0
51655,445,0,0,70,70,0,1,0,1,0
59636,445,0,0,70,70,0,1,0,1,0
63752,445,0,0,70,70,0,1,0,1,0
60857,445,0,0,70,70,0,1,0,1,0
62176,445,0,0,70,70,0,1,0,1,0
57606,445,0,0,70,70,0,1,0,1,0
59171,445,0,0,66,66,0,1,0,1,0
54489,445,0,0,70,70,0,1,0,1,0
61547,445,0,0,66,66,0,1,0,1,0
52784,445,0,0,66,66,0,1,0,1,0
56013,445,0,0,70,70,0,1,0,1,0
58175,445,0,0,70,70,0,1,0,1,0
61579,445,0,0,70,70,0,1,0,1,0
52521,445,0,0,66,66,0,1,0,1,0
64313,445,0,0,70,70,0,1,0,1,0
64151,445,0,0,70,70,0,1,0,1,0
59197,445,0,0,69,69,0,1,0,1,0
52811,445,0,0,66,66,0,1,0,1,0
63336,445,0,0,70,70,0,1,0,1,0
55592,445,0,0,70,70,0,1,0,1,0
63211,445,0,0,66,66,0,1,0,1,0
49905,445,0,0,70,70,0,1,0,1,0
60673,445,0,0,70,70,0,1,0,1,0
55707,445,0,0,70,70,0,1,0,1,0
53888,445,0,0,70,70,0,1,0,1,0
51137,445,0,0,70,70,0,1,0,1,0
60990,445,0,0,67,67,0,1,0,1,0
62083,445,0,0,70,70,0,1,0,1,0
49325,445,0,0,70,70,0,1,0,1,0
52078,445,0,0,70,70,0,1,0,1,0
57917,445,0,0,70,70,0,1,0,1,0
56737,445,0,0,67,67,0,1,0,1,0
49255,445,0,0,69,69,0,1,0,1,0
65391,445,0,0,66,66,0,1,0,1,0
61363,445,0,0,69,69,0,1,0,1,0
61447,445,0,0,69,69,0,1,0,1,0
54815,445,0,0,70,70,0,1,0,1,0
50563,445,0,0,66,66,0,1,0,1,0
60603,445,0,0,70,70,0,1,0,1,0
60805,445,0,0,66,66,0,1,0,1,0
64758,445,0,0,66,66,0,1,0,1,0
59956,445,0,0,70,70,0,1,0,1,0
58658,445,0,0,67,67,0,1,0,1,0
61082,445,0,0,66,66,0,1,0,1,0
51385,445,0,0,68,68,0,1,0,1,0
50135,445,0,0,70,70,0,1,0,1,0
55402,445,0,0,67,67,0,1,0,1,0
59044,445,0,0,69,69,0,1,0,1,0
51723,445,0,0,70,70,0,1,0,1,0
50274,445,0,0,70,70,0,1,0,1,0
58321,445,0,0,68,68,0,1,0,1,0
50517,445,0,0,70,70,0,1,0,1,0
49970,445,0,0,70,70,0,1,0,1,0
58320,445,0,0,66,66,0,1,0,1,0
50159,445,0,0,70,70,0,1,0,1,0
57222,445,0,0,66,66,0,1,0,1,0
52306,445,0,0,70,70,0,1,0,1,0
51753,445,0,0,70,70,0,1,0,1,0
57157,445,0,0,66,66,0,1,0,1,0
50849,445,0,0,66,66,0,1,0,1,0
49919,445,0,0,70,70,0,1,0,1,0
64332,445,0,0,70,70,0,1,0,1,0
56708,445,0,0,66,66,0,1,0,1,0
58767,445,0,0,70,70,0,1,0,1,0
61033,445,0,0,70,70,0,1,0,1,0
64687,445,0,0,70,70,0,1,0,1,0
53558,445,0,0,68,68,0,1,0,1,0
58439,445,0,0,66,66,0,1,0,1,0
54777,445,0,0,70,70,0,1,0,1,0
63316,445,0,0,69,69,0,1,0,1,0
58777,445,0,0,69,69,0,1,0,1,0
55805,445,0,0,66,66,0,1,0,1,0
49860,445,0,0,70,70,0,1,0,1,0
54130,445,0,0,70,70,0,1,0,1,0
61630,445,0,0,70,70,0,1,0,1,0
63197,445,0,0,69,69,0,1,0,1,0
50308,445,0,0,66,66,0,1,0,1,0
53922,445,0,0,70,70,0,1,0,1,0
53268,445,0,0,70,70,0,1,0,1,0
53022,445,0,0,70,70,0,1,0,1,0
58058,445,0,0,70,70,0,1,0,1,0
52629,445,0,0,70,70,0,1,0,1,0
51824,445,0,0,70,70,0,1,0,1,0
55741,445,0,0,70,70,0,1,0,1,0
49426,445,0,0,70,70,0,1,0,1,0
62173,445,0,0,70,70,0,1,0,1,0
60358,445,0,0,66,66,0,1,0,1,0
49452,445,0,0,70,70,0,1,0,1,0
59112,445,0,0,70,70,0,1,0,1,0
61055,445,0,0,70,70,0,1,0,1,0
49370,445,0,0,70,70,0,1,0,1,0
64964,445,0,0,70,70,0,1,0,1,0
53916,445,0,0,66,66,0,1,0,1,0
57566,445,0,0,69,69,0,1,0,1,0
51314,445,0,0,70,70,0,1,0,1,0
54278,445,0,0,66,66,0,1,0,1,0
56981,445,0,0,67,67,0,1,0,1,0
61331,445,0,0,70,70,0,1,0,1,0
61599,445,0,0,70,70,0,1,0,1,0
60243,445,0,0,70,70,0,1,0,1,0
53540,445,0,0,70,70,0,1,0,1,0
60834,445,0,0,70,70,0,1,0,1,0
53027,445,0,0,70,70,0,1,0,1,0
54310,445,0,0,68,68,0,1,0,1,0
55543,445,0,0,70,70,0,1,0,1,0
57877,445,0,0,70,70,0,1,0,1,0
63414,445,0,0,66,66,0,1,0,1,0
60629,445,0,0,67,67,0,1,0,1,0
59093,445,0,0,66,66,0,1,0,1,0
62640,445,0,0,70,70,0,1,0,1,0
51470,445,0,0,68,68,0,1,0,1,0
61225,445,0,0,66,66,0,1,0,1,0
62315,445,0,0,70,70,0,1,0,1,0
65218,445,0,0,70,70,0,1,0,1,0
59867,445,0,0,70,70,0,1,0,1,0
52012,445,0,0,70,70,0,1,0,1,0
56324,445,0,0,69,69,0,1,0,1,0
58308,445,0,0,66,66,0,1,0,1,0
52998,445,0,0,69,69,0,1,0,1,0
59381,445,0,0,68,68,0,1,0,1,0
64389,445,0,0,70,70,0,1,0,1,0
52087,445,0,0,66,66,0,1,0,1,0
65515,445,0,0,70,70,0,1,0,1,0
56885,445,0,0,68,68,0,1,0,1,0
65250,445,0,0,70,70,0,1,0,1,0
62315,445,0,0,66,66,0,1,0,1,0
50969,445,0,0,70,70,0,1,0,1,0
62900,445,0,0,69,69,0,1,0,1,0
52705,445,0,0,70,70,0,1,0,1,0
50943,445,0,0,70,70,0,1,0,1,0
61243,445,0,0,70,70,0,1,0,1,0
56875,445,0,0,70,70,0,1,0,1,0
58414,445,0,0,70,70,0,1,0,1,0
58443,445,0,0,66,66,0,1,0,1,0
61533,445,0,0,70,70,0,1,0,1,0
52085,445,0,0,66,66,0,1,0,1,0
60018,445,0,0,70,70,0,1,0,1,0
64419,445,0,0,66,66,0,1,0,1,0
64049,445,0,0,70,70,0,1,0,1,0
61338,445,0,0,66,66,0,1,0,1,0
63456,445,0,0,66,66,0,1,0,1,0
65515,445,0,0,70,70,0,1,0,1,0
65033,445,0,0,68,68,0,1,0,1,0
53948,445,0,0,68,68,0,1,0,1,0
54525,445,0,0,70,70,0,1,0,1,0
54867,445,0,0,70,70,0,1,0,1,0
55723,445,0,0,70,70,0,1,0,1,0
65463,445,0,0,70,70,0,1,0,1,0
64492,445,0,0,66,66,0,1,0,1,0
49425,445,0,0,70,70,0,1,0,1,0
50949,445,0,0,66,66,0,1,0,1,0
50345,445,0,0,66,66,0,1,0,1,0
51040,445,0,0,70,70,0,1,0,1,0
52224,445,0,0,70,70,0,1,0,1,0
52430,445,0,0,70,70,0,1,0,1,0
54611,445,0,0,70,70,0,1,0,1,0
50886,445,0,0,70,70,0,1,0,1,0
58703,445,0,0,70,70,0,1,0,1,0
55846,445,0,0,70,70,0,1,0,1,0
59054,445,0,0,70,70,0,1,0,1,0
62894,445,0,0,70,70,0,1,0,1,0
52600,445,0,0,66,66,0,1,0,1,0
56941,445,0,0,70,70,0,1,0,1,0
52510,445,0,0,69,69,0,1,0,1,0
58905,445,0,0,70,70,0,1,0,1,0
57476,445,0,0,66,66,0,1,0,1,0
54174,445,0,0,70,70,0,1,0,1,0
52703,445,0,0,70,70,0,1,0,1,0
63903,445,0,0,66,66,0,1,0,1,0
64330,445,0,0,67,67,0,1,0,1,0
61360,445,0,0,70,70,0,1,0,1,0
58888,445,0,0,70,70,0,1,0,1,0
63955,445,0,0,66,66,0,1,0,1,0
58516,445,0,0,70,70,0,1,0,1,0
57496,445,0,0,70,70,0,1,0,1,0
56062,445,0,0,66,66,0,1,0,1,0
52304,445,0,0,70,70,0,1,0,1,0
52976,445,0,0,70,70,0,1,0,1,0
49969,445,0,0,66,66,0,1,0,1,0
59256,445,0,0,66,66,0,1,0,1,0
54774,445,0,0,70,70,0,1,0,1,0
60681,445,0,0,70,70,0,1,0,1,0
59213,445,0,0,66,66,0,1,0,1,0
65228,445,0,0,70,70,0,1,0,1,0
60884,445,0,0,70,70,0,1,0,1,0
50648,445,0,0,70,70,0,1,0,1,0
63436,445,0,0,66,66,0,1,0,1,0
55373,445,0,0,67,67,0,1,0,1,0
58130,445,0,0,70,70,0,1,0,1,0
64230,445,0,0,70,70,0,1,0,1,0
60947,445,0,0,70,70,0,1,0,1,0
57027,445,0,0,67,67,0,1,0,1,0
59226,445,0,0,70,70,0,1,0,1,0
51101,445,0,0,66,66,0,1,0,1,0
53290,445,0,0,70,70,0,1,0,1,0
59503,445,0,0,70,70,0,1,0,1,0
54053,445,0,0,70,70,0,1,0,1,0
58952,445,0,0,66,66,0,1,0,1,0
59649,445,0,0,70,70,0,1,0,1,0
63851,445,0,0,70,70,0,1,0,1,0
56114,445,0,0,66,66,0,1,0,1,0
54830,445,0,0,67,67,0,1,0,1,0
64715,445,0,0,66,66,0,1,0,1,0
49493,445,0,0,70,70,0,1,0,1,0
60557,445,0,0,70,70,0,1,0,1,0
64551,445,0,0,67,67,0,1,0,1,0
50572,445,0,0,70,70,0,1,0,1,0
49615,445,0,0,66,66,0,1,0,1,0
56005,445,0,0,66,66,0,1,0,1,0
59570,445,0,0,70,70,0,1,0,1,0
52325,445,0,0,70,70,0,1,0,1,0
63203,445,0,0,70,70,0,1,0,1,0
53500,445,0,0,66,66,0,1,0,1,0
62140,445,0,0,66,66,0,1,0,1,0
58701,445,0,0,66,66,0,1,0,1,0
49407,445,0,0,70,70,0,1,0,1,0
59191,445,0,0,67,67,0,1,0,1,0
50265,445,0,0,70,70,0,1,0,1,0
50067,445,0,0,70,70,0,1,0,1,0
49493,445,0,0,70,70,0,1,0,1,0
53949,445,0,0,69,69,0,1,0,1,0
57987,445,0,0,70,70,0,1,0,1,0
62938,445,0,0,66,66,0,1,0,1,0
61464,445,0,0,66,66,0,1,0,1,0
53094,445,0,0,67,67,0,1,0,1,0
51946,445,0,0,70,70,0,1,0,1,0
56581,445,0,0,66,66,0,1,0,1,0
59139,445,0,0,70,70,0,1,0,1,0
56765,445,0,0,68,68,0,1,0,1,0
49493,445,0,0,69,69,0,1,0,1,0
50346,445,0,0,66,66,0,1,0,1,0
64038,445,0,0,67,67,0,1,0,1,0
59213,445,0,0,70,70,0,1,0,1,0
64156,445,0,0,70,70,0,1,0,1,0
52665,445,0,0,66,66,0,1,0,1,0
56750,445,0,0,70,70,0,1,0,1,0
63049,445,0,0,68,68,0,1,0,1,0
56448,445,0,0,66,66,0,1,0,1,0
51542,445,0,0,70,70,0,1,0,1,0
52509,445,0,0,68,68,0,1,0,1,0
52251,445,0,0,70,70,0,1,0,1,0
55636,445,0,0,70,70,0,1,0,1,0
63109,445,0,0,70,70,0,1,0,1,0
60888,445,0,0,70,70,0,1,0,1,0
56534,445,0,0,70,70,0,1,0,1,0
56383,445,0,0,67,67,0,1,0,1,0
55835,445,0,0,69,69,0,1,0,1,0
63290,445,0,0,70,70,0,1,0,1,0
63658,445,0,0,67,67,0,1,0,1,0
64155,445,0,0,70,70,0,1,0,1,0
56192,445,0,0,66,66,0,1,0,1,0
55883,445,0,0,70,70,0,1,0,1,0
62918,445,0,0,70,70,0,1,0,1,0
56322,445,0,0,66,66,0,1,0,1,0
64289,445,0,0,70,70,0,1,0,1,0
52870,445,0,0,70,70,0,1,0,1,0
54051,445,0,0,70,70,0,1,0,1,0
59591,445,0,0,70,70,0,1,0,1,0
50806,445,0,0,67,67,0,1,0,1,0
55542,445,0,0,66,66,0,1,0,1,0
52894,445,0,0,66,66,0,1,0,1,0
52678,445,0,0,66,66,0,1,0,1,0
54797,445,0,0,66,66,0,1,0,1,0
52965,445,0,0,66,66,0,1,0,1,0
63100,445,0,0,70,70,0,1,0,1,0
61407,445,0,0,66,66,0,1,0,1,0
60461,445,0,0,66,66,0,1,0,1,0
54073,445,0,0,70,70,0,1,0,1,0
59575,445,0,0,70,70,0,1,0,1,0
59709,445,0,0,70,70,0,1,0,1,0
57418,445,0,0,70,70,0,1,0,1,0
54205,445,0,0,70,70,0,1,0,1,0
57718,445,0,0,68,68,0,1,0,1,0
57627,445,0,0,70,70,0,1,0,1,0
54036,445,0,0,66,66,0,1,0,1,0
51905,445,0,0,68,68,0,1,0,1,0
60865,445,0,0,70,70,0,1,0,1,0
58859,445,0,0,70,70,0,1,0,1,0
56293,445,0,0,70,70,0,1,0,1,0
57547,445,0,0,67,67,0,1,0,1,0
49407,445,0,0,68,68,0,1,0,1,0
57415,445,0,0,70,70,0,1,0,1,0
54386,445,0,0,70,70,0,1,0,1,0
53367,445,0,0,66,66,0,1,0,1,0
50895,445,0,0,70,70,0,1,0,1,0
64360,445,0,0,70,70,0,1,0,1,0
55838,445,0,0,70,70,0,1,0,1,0
61277,445,0,0,66,66,0,1,0,1,0
54785,445,0,0,70,70,0,1,0,1,0
62364,445,0,0,66,66,0,1,0,1,0
50839,445,0,0,70,70,0,1,0,1,0
63796,445,0,0,70,70,0,1,0,1,0
50683,445,0,0,70,70,0,1,0,1,0
61621,445,0,0,70,70,0,1,0,1,0
57027,445,0,0,68,68,0,1,0,1,0
63811,445,0,0,70,70,0,1,0,1,0
57497,445,0,0,69,69,0,1,0,1,0
60529,445,0,0,70,70,0,1,0,1,0
54227,445,0,0,70,70,0,1,0,1,0
63749,445,0,0,70,70,0,1,0,1,0
49323,445,0,0,70,70,0,1,0,1,0
50888,445,0,0,70,70,0,1,0,1,0
49946,445,0,0,70,70,0,1,0,1,0
50206,445,0,0,67,67,0,1,0,1,0
54616,445,0,0,70,70,0,1,0,1,0
62044,445,0,0,70,70,0,1,0,1,0
50997,445,0,0,67,67,0,1,0,1,0
59228,445,0,0,70,70,0,1,0,1,0
50672,445,0,0,66,66,0,1,0,1,0
61698,445,0,0,70,70,0,1,0,1,0
50837,445,0,0,69,69,0,1,0,1,0
49356,445,0,0,66,66,0,1,0,1,0
59862,445,0,0,70,70,0,1,0,1,0
58181,445,0,0,66,66,0,1,0,1,0
61733,445,0,0,68,68,0,1,0,1,0
65038,445,0,0,70,70,0,1,0,1,0
58819,445,0,0,68,68,0,1,0,1,0
56391,445,0,0,67,67,0,1,0,1,0
51009,445,0,0,70,70,0,1,0,1,0
63794,445,0,0,70,70,0,1,0,1,0
60374,445,0,0,70,70,0,1,0,1,0
56583,445,0,0,70,70,0,1,0,1,0
58862,445,0,0,70,70,0,1,0,1,0
55267,445,0,0,70,70,0,1,0,1,0
54274,445,0,0,70,70,0,1,0,1,0
58395,445,0,0,70,70,0,1,0,1,0
56341,445,0,0,70,70,0,1,0,1,0
64564,445,0,0,70,70,0,1,0,1,0
57133,445,0,0,70,70,0,1,0,1,0
62492,445,0,0,66,66,0,1,0,1,0
61850,445,0,0,66,66,0,1,0,1,0
50497,445,0,0,66,66,0,1,0,1,0
58862,445,0,0,70,70,0,1,0,1,0
54781,445,0,0,66,66,0,1,0,1,0
59605,445,0,0,66,66,0,1,0,1,0
50791,445,0,0,66,66,0,1,0,1,0
55123,445,0,0,70,70,0,1,0,1,0
50337,445,0,0,66,66,0,1,0,1,0
53742,445,0,0,70,70,0,1,0,1,0
58567,445,0,0,68,68,0,1,0,1,0
59758,445,0,0,70,70,0,1,0,1,0
57474,445,0,0,69,69,0,1,0,1,0
60289,445,0,0,70,70,0,1,0,1,0
50980,445,0,0,66,66,0,1,0,1,0
63512,445,0,0,66,66,0,1,0,1,0
50339,445,0,0,70,70,0,1,0,1,0
60507,445,0,0,66,66,0,1,0,1,0
63235,445,0,0,68,68,0,1,0,1,0
64273,445,0,0,66,66,0,1,0,1,0
59969,445,0,0,68,68,0,1,0,1,0
61550,445,0,0,70,70,0,1,0,1,0
55457,445,0,0,70,70,0,1,0,1,0
59206,445,0,0,69,69,0,1,0,1,0
55488,445,0,0,70,70,0,1,0,1,0
64604,445,0,0,69,69,0,1,0,1,0
50096,445,0,0,70,70,0,1,0,1,0
59515,445,0,0,67,67,0,1,0,1,0
50636,445,0,0,66,66,0,1,0,1,0
53431,445,0,0,70,70,0,1,0,1,0
60683,445,0,0,70,70,0,1,0,1,0
59909,445,0,0,70,70,0,1,0,1,0
53358,445,0,0,70,70,0,1,0,1,0
52090,445,0,0,70,70,0,1,0,1,0
53022,445,0,0,70,70,0,1,0,1,0
57547,445,0,0,66,66,0,1,0,1,0
62100,445,0,0,66,66,0,1,0,1,0
64296,445,0,0,66,66,0,1,0,1,0
60293,445,0,0,70,70,0,1,0,1,0
54646,445,0,0,70,70,0,1,0,1,0
55059,445,0,0,68,68,0,1,0,1,0
59500,445,0,0,70,70,0,1,0,1,0
59448,445,0,0,70,70,0,1,0,1,0
50679,445,0,0,70,70,0,1,0,1,0
61721,445,0,0,70,70,0,1,0,1,0
58915,445,0,0,66,66,0,1,0,1,0
62360,445,0,0,66,66,0,1,0,1,0
55229,445,0,0,70,70,0,1,0,1,0
51314,445,0,0,66,66,0,1,0,1,0
53191,445,0,0,68,68,0,1,0,1,0
55531,445,0,0,68,68,0,1,0,1,0
57357,445,0,0,70,70,0,1,0,1,0
64964,445,0,0,69,69,0,1,0,1,0
58374,445,0,0,70,70,0,1,0,1,0
58676,445,0,0,67,67,0,1,0,1,0
55580,445,0,0,70,70,0,1,0,1,0
61973,445,0,0,68,68,0,1,0,1,0
53916,445,0,0,70,70,0,1,0,1,0
50930,445,0,0,66,66,0,1,0,1,0
57069,445,0,0,70,70,0,1,0,1,0
57493,445,0,0,70,70,0,1,0,1,0
62203,445,0,0,68,68,0,1,0,1,0
60702,445,0,0,70,70,0,1,0,1,0
52717,445,0,0,70,70,0,1,0,1,0
64321,445,0,0,70,70,0,1,0,1,0
52316,445,0,0,70,70,0,1,0,1,0
51919,445,0,0,70,70,0,1,0,1,0
53268,445,0,0,68,68,0,1,0,1,0
56635,445,0,0,68,68,0,1,0,1,0
55212,445,0,0,70,70,0,1,0,1,0
62742,445,0,0,66,66,0,1,0,1,0
51184,445,0,0,66,66,0,1,0,1,0
58241,445,0,0,66,66,0,1,0,1,0
59211,445,0,0,66,66,0,1,0,1,0
50229,445,0,0,66,66,0,1,0,1,0
56450,445,0,0,66,66,0,1,0,1,0
65196,445,0,0,66,66,0,1,0,1,0
54194,445,0,0,69,69,0,1,0,1,0
52434,445,0,0,68,68,0,1,0,1,0
65396,445,0,0,69,69,0,1,0,1,0
50637,445,0,0,66,66,0,1,0,1,0
50032,445,0,0,70,70,0,1,0,1,0
59631,445,0,0,70,70,0,1,0,1,0
59535,445,0,0,67,67,0,1,0,1,0
58793,445,0,0,70,70,0,1,0,1,0
60175,445,0,0,66,66,0,1,0,1,0
53930,445,0,0,66,66,0,1,0,1,0
54153,445,0,0,67,67,0,1,0,1,0
49182,445,0,0,66,66,0,1,0,1,0
50609,445,0,0,66,66,0,1,0,1,0
50097,445,0,0,66,66,0,1,0,1,0
64912,445,0,0,70,70,0,1,0,1,0
50149,445,0,0,67,67,0,1,0,1,0
49681,445,0,0,67,67,0,1,0,1,0
58520,445,0,0,68,68,0,1,0,1,0
63412,445,0,0,70,70,0,1,0,1,0
63898,445,0,0,70,70,0,1,0,1,0
57707,445,0,0,70,70,0,1,0,1,0
58883,445,0,0,66,66,0,1,0,1,0
55350,445,0,0,66,66,0,1,0,1,0
51183,445,0,0,66,66,0,1,0,1,0
65058,445,0,0,70,70,0,1,0,1,0
61656,445,0,0,66,66,0,1,0,1,0
63902,445,0,0,66,66,0,1,0,1,0
65507,445,0,0,68,68,0,1,0,1,0
60232,445,0,0,68,68,0,1,0,1,0
60058,445,0,0,70,70,0,1,0,1,0
63467,445,0,0,70,70,0,1,0,1,0
52007,445,0,0,66,66,0,1,0,1,0
63515,445,0,0,66,66,0,1,0,1,0
54925,445,0,0,66,66,0,1,0,1,0
57905,445,0,0,70,70,0,1,0,1,0
63025,445,0,0,70,70,0,1,0,1,0
63427,445,0,0,70,70,0,1,0,1,0
58405,445,0,0,70,70,0,1,0,1,0
56452,445,0,0,66,66,0,1,0,1,0
57546,445,0,0,66,66,0,1,0,1,0
63154,445,0,0,66,66,0,1,0,1,0
57047,445,0,0,69,69,0,1,0,1,0
60436,445,0,0,66,66,0,1,0,1,0
55987,445,0,0,70,70,0,1,0,1,0
59531,445,0,0,68,68,0,1,0,1,0
51639,445,0,0,66,66,0,1,0,1,0
59270,445,0,0,68,68,0,1,0,1,0
53797,445,0,0,70,70,0,1,0,1,0
58764,445,0,0,70,70,0,1,0,1,0
55616,445,0,0,66,66,0,1,0,1,0
61213,445,0,0,69,69,0,1,0,1,0
55211,445,0,0,66,66,0,1,0,1,0
65093,445,0,0,70,70,0,1,0,1,0
50671,445,0,0,66,66,0,1,0,1,0
61367,445,0,0,67,67,0,1,0,1,0
63776,445,0,0,70,70,0,1,0,1,0
49705,445,0,0,70,70,0,1,0,1,0
51037,445,0,0,67,67,0,1,0,1,0
60214,445,0,0,70,70,0,1,0,1,0
59482,445,0,0,70,70,0,1,0,1,0
52868,445,0,0,70,70,0,1,0,1,0
65421,445,0,0,70,70,0,1,0,1,0
57677,445,0,0,70,70,0,1,0,1,0
49643,445,0,0,70,70,0,1,0,1,0
60591,445,0,0,70,70,0,1,0,1,0
58821,445,0,0,70,70,0,1,0,1,0
60191,445,0,0,69,69,0,1,0,1,0
55835,445,0,0,70,70,0,1,0,1,0
53985,445,0,0,70,70,0,1,0,1,0
54032,445,0,0,67,67,0,1,0,1,0
59356,445,0,0,70,70,0,1,0,1,0
50352,445,0,0,66,66,0,1,0,1,0
64707,445,0,0,70,70,0,1,0,1,0
49231,445,0,0,70,70,0,1,0,1,0
61864,445,0,0,70,70,0,1,0,1,0
55705,445,0,0,70,70,0,1,0,1,0
52659,445,0,0,66,66,0,1,0,1,0
63200,445,0,0,66,66,0,1,0,1,0
58353,445,0,0,67,67,0,1,0,1,0
51022,445,0,0,70,70,0,1,0,1,0
65039,445,0,0,68,68,0,1,0,1,0
55290,445,0,0,70,70,0,1,0,1,0
60820,445,0,0,66,66,0,1,0,1,0
59633,445,0,0,70,70,0,1,0,1,0
63004,445,0,0,70,70,0,1,0,1,0
58890,445,0,0,70,70,0,1,0,1,0
50338,445,0,0,66,66,0,1,0,1,0
59322,445,0,0,66,66,0,1,0,1,0
54700,445,0,0,68,68,0,1,0,1,0
54625,445,0,0,70,70,0,1,0,1,0
58091,445,0,0,70,70,0,1,0,1,0
65252,445,0,0,70,70,0,1,0,1,0
62816,445,0,0,70,70,0,1,0,1,0
59142,445,0,0,70,70,0,1,0,1,0
55895,445,0,0,70,70,0,1,0,1,0
64874,445,0,0,68,68,0,1,0,1,0
51647,445,0,0,70,70,0,1,0,1,0
59029,445,0,0,70,70,0,1,0,1,0
50035,445,0,0,70,70,0,1,0,1,0
60437,445,0,0,66,66,0,1,0,1,0
65353,445,0,0,68,68,0,1,0,1,0
62486,445,0,0,66,66,0,1,0,1,0
50749,445,0,0,66,66,0,1,0,1,0
54246,445,0,0,66,66,0,1,0,1,0
64016,445,0,0,66,66,0,1,0,1,0
52305,445,0,0,70,70,0,1,0,1,0
50946,445,0,0,70,70,0,1,0,1,0
63620,445,0,0,70,70,0,1,0,1,0
57031,445,0,0,70,70,0,1,0,1,0
53640,445,0,0,70,70,0,1,0,1,0
57690,445,0,0,70,70,0,1,0,1,0
52791,445,0,0,70,70,0,1,0,1,0
55804,445,0,0,69,69,0,1,0,1,0
63200,445,0,0,66,66,0,1,0,1,0
60275,445,0,0,67,67,0,1,0,1,0
56447,445,0,0,70,70,0,1,0,1,0
60441,445,0,0,70,70,0,1,0,1,0
52923,445,0,0,66,66,0,1,0,1,0
53881,445,0,0,66,66,0,1,0,1,0
61013,445,0,0,70,70,0,1,0,1,0
51076,445,0,0,66,66,0,1,0,1,0
57007,445,0,0,70,70,0,1,0,1,0
65460,445,0,0,70,70,0,1,0,1,0
63757,445,0,0,66,66,0,1,0,1,0
53759,445,0,0,70,70,0,1,0,1,0
63171,445,0,0,70,70,0,1,0,1,0
54071,445,0,0,70,70,0,1,0,1,0
54005,445,0,0,70,70,0,1,0,1,0
64796,445,0,0,70,70,0,1,0,1,0
51019,445,0,0,68,68,0,1,0,1,0
63940,445,0,0,70,70,0,1,0,1,0
62832,445,0,0,70,70,0,1,0,1,0
58952,445,0,0,66,66,0,1,0,1,0
50476,445,0,0,70,70,0,1,0,1,0
54060,445,0,0,66,66,0,1,0,1,0
64114,445,0,0,67,67,0,1,0,1,0
55845,445,0,0,67,67,0,1,0,1,0
50465,445,0,0,66,66,0,1,0,1,0
54072,445,0,0,66,66,0,1,0,1,0
59326,445,0,0,66,66,0,1,0,1,0
54089,445,0,0,66,66,0,1,0,1,0
56371,445,0,0,66,66,0,1,0,1,0
61750,445,0,0,70,70,0,1,0,1,0
60166,445,0,0,70,70,0,1,0,1,0
63585,445,0,0,70,70,0,1,0,1,0
51524,445,0,0,68,68,0,1,0,1,0
64485,445,0,0,70,70,0,1,0,1,0
61569,445,0,0,70,70,0,1,0,1,0
55213,445,0,0,70,70,0,1,0,1,0
58541,445,0,0,70,70,0,1,0,1,0
55388,445,0,0,70,70,0,1,0,1,0
51858,445,0,0,70,70,0,1,0,1,0
55436,445,0,0,66,66,0,1,0,1,0
62920,445,0,0,66,66,0,1,0,1,0
53608,445,0,0,66,66,0,1,0,1,0
49969,445,0,0,66,66,0,1,0,1,0
57410,445,0,0,70,70,0,1,0,1,0
50516,445,0,0,69,69,0,1,0,1,0
58152,445,0,0,67,67,0,1,0,1,0
55096,445,0,0,70,70,0,1,0,1,0
64869,445,0,0,70,70,0,1,0,1,0
50564,445,0,0,67,67,0,1,0,1,0
62133,445,0,0,66,66,0,1,0,1,0
64979,445,0,0,70,70,0,1,0,1,0
62155,445,0,0,66,66,0,1,0,1,0
54455,445,0,0,69,69,0,1,0,1,0
50920,445,0,0,66,66,0,1,0,1,0
64247,445,0,0,70,70,0,1,0,1,0
59597,445,0,0,70,70,0,1,0,1,0
59695,445,0,0,70,70,0,1,0,1,0
60423,445,0,0,70,70,0,1,0,1,0
55835,445,0,0,70,70,0,1,0,1,0
53797,445,0,0,70,70,0,1,0,1,0
49933,445,0,0,70,70,0,1,0,1,0
57934,445,0,0,67,67,0,1,0,1,0
63741,445,0,0,70,70,0,1,0,1,0
54948,445,0,0,70,70,0,1,0,1,0
64870,445,0,0,70,70,0,1,0,1,0
65305,445,0,0,66,66,0,1,0,1,0
50998,445,0,0,70,70,0,1,0,1,0
53929,445,0,0,66,66,0,1,0,1,0
61129,445,0,0,68,68,0,1,0,1,0
64179,445,0,0,70,70,0,1,0,1,0
57330,445,0,0,66,66,0,1,0,1,0
62854,445,0,0,68,68,0,1,0,1,0
53929,445,0,0,70,70,0,1,0,1,0
58521,445,0,0,70,70,0,1,0,1,0
58028,445,0,0,70,70,0,1,0,1,0
60090,445,0,0,70,70,0,1,0,1,0
59336,445,0,0,66,66,0,1,0,1,0
65342,445,0,0,70,70,0,1,0,1,0
50547,445,0,0,66,66,0,1,0,1,0
52775,445,0,0,66,66,0,1,0,1,0
56754,445,0,0,70,70,0,1,0,1,0
51598,445,0,0,70,70,0,1,0,1,0
53349,445,0,0,66,66,0,1,0,1,0
51351,445,0,0,66,66,0,1,0,1,0
50679,445,0,0,70,70,0,1,0,1,0
49346,445,0,0,70,70,0,1,0,1,0
63826,445,0,0,66,66,0,1,0,1,0
63611,445,0,0,70,70,0,1,0,1,0
54059,445,0,0,66,66,0,1,0,1,0
58113,445,0,0,66,66,0,1,0,1,0
63684,445,0,0,70,70,0,1,0,1,0
59885,445,0,0,70,70,0,1,0,1,0
51022,445,0,0,66,66,0,1,0,1,0
50818,445,0,0,67,67,0,1,0,1,0
50895,445,0,0,70,70,0,1,0,1,0
53457,445,0,0,70,70,0,1,0,1,0
51880,445,0,0,70,70,0,1,0,1,0
62586,445,0,0,67,67,0,1,0,1,0
57803,445,0,0,69,69,0,1,0,1,0
65494,445,0,0,70,70,0,1,0,1,0
64212,445,0,0,69,69,0,1,0,1,0
64585,445,0,0,66,66,0,1,0,1,0
50523,445,0,0,70,70,0,1,0,1,0
54551,445,0,0,70,70,0,1,0,1,0
64873,445,0,0,70,70,0,1,0,1,0
51240,445,0,0,66,66,0,1,0,1,0
50894,445,0,0,70,70,0,1,0,1,0
49782,445,0,0,70,70,0,1,0,1,0
54988,445,0,0,68,68,0,1,0,1,0
61088,445,0,0,70,70,0,1,0,1,0
58933,445,0,0,70,70,0,1,0,1,0
63847,445,0,0,70,70,0,1,0,1,0
54632,445,0,0,70,70,0,1,0,1,0
59099,445,0,0,70,70,0,1,0,1,0
59889,445,0,0,70,70,0,1,0,1,0
55429,445,0,0,70,70,0,1,0,1,0
56398,445,0,0,70,70,0,1,0,1,0
64679,445,0,0,66,66,0,1,0,1,0
64734,445,0,0,70,70,0,1,0,1,0
63312,445,0,0,66,66,0,1,0,1,0
55416,445,0,0,70,70,0,1,0,1,0
56616,445,0,0,70,70,0,1,0,1,0
64005,445,0,0,68,68,0,1,0,1,0
53153,445,0,0,70,70,0,1,0,1,0
53703,445,0,0,70,70,0,1,0,1,0
49941,445,0,0,70,70,0,1,0,1,0
61973,445,0,0,66,66,0,1,0,1,0
59014,445,0,0,66,66,0,1,0,1,0
63335,445,0,0,70,70,0,1,0,1,0
61048,445,0,0,70,70,0,1,0,1,0
59546,445,0,0,66,66,0,1,0,1,0
62058,445,0,0,70,70,0,1,0,1,0
61943,445,0,0,67,67,0,1,0,1,0
61788,445,0,0,66,66,0,1,0,1,0
50307,445,0,0,70,70,0,1,0,1,0
58643,445,0,0,70,70,0,1,0,1,0
57487,445,0,0,70,70,0,1,0,1,0
53684,445,0,0,68,68,0,1,0,1,0
65414,445,0,0,70,70,0,1,0,1,0
62571,445,0,0,66,66,0,1,0,1,0
65130,445,0,0,68,68,0,1,0,1,0
58734,445,0,0,69,69,0,1,0,1,0
63688,445,0,0,70,70,0,1,0,1,0
65503,445,0,0,66,66,0,1,0,1,0
54988,445,0,0,66,66,0,1,0,1,0
50352,445,0,0,66,66,0,1,0,1,0
52632,445,0,0,70,70,0,1,0,1,0
49462,445,0,0,67,67,0,1,0,1,0
65205,445,0,0,69,69,0,1,0,1,0
58636,445,0,0,70,70,0,1,0,1,0
64801,445,0,0,70,70,0,1,0,1,0
61550,445,0,0,68,68,0,1,0,1,0
51971,445,0,0,70,70,0,1,0,1,0
65356,445,0,0,70,70,0,1,0,1,0
65451,445,0,0,66,66,0,1,0,1,0
64900,445,0,0,70,70,0,1,0,1,0
50699,445,0,0,70,70,0,1,0,1,0
54908,445,0,0,69,69,0,1,0,1,0
52591,445,0,0,70,70,0,1,0,1,0
53541,445,0,0,70,70,0,1,0,1,0
55746,445,0,0,70,70,0,1,0,1,0
55630,445,0,0,70,70,0,1,0,1,0
58958,445,0,0,68,68,0,1,0,1,0
50169,445,0,0,70,70,0,1,0,1,0
61418,445,0,0,70,70,0,1,0,1,0
56908,445,0,0,70,70,0,1,0,1,0
50298,445,0,0,70,70,0,1,0,1,0
50455,445,0,0,70,70,0,1,0,1,0
61488,445,0,0,70,70,0,1,0,1,0
53366,445,0,0,70,70,0,1,0,1,0
49267,445,0,0,70,70,0,1,0,1,0
62488,445,0,0,66,66,0,1,0,1,0
54475,445,0,0,67,67,0,1,0,1,0
56506,445,0,0,66,66,0,1,0,1,0
61867,445,0,0,69,69,0,1,0,1,0
55338,445,0,0,66,66,0,1,0,1,0
64792,445,0,0,69,69,0,1,0,1,0
64791,445,0,0,66,66,0,1,0,1,0
55301,445,0,0,70,70,0,1,0,1,0
54464,445,0,0,70,70,0,1,0,1,0
51417,445,0,0,70,70,0,1,0,1,0
50725,445,0,0,70,70,0,1,0,1,0
54828,445,0,0,66,66,0,1,0,1,0
60547,445,0,0,70,70,0,1,0,1,0
54342,445,0,0,68,68,0,1,0,1,0
58671,445,0,0,69,69,0,1,0,1,0
65145,445,0,0,70,70,0,1,0,1,0
56892,445,0,0,70,70,0,1,0,1,0
65486,445,0,0,70,70,0,1,0,1,0
62312,445,0,0,70,70,0,1,0,1,0
50633,445,0,0,70,70,0,1,0,1,0
52431,445,0,0,70,70,0,1,0,1,0
53332,445,0,0,70,70,0,1,0,1,0
59914,445,0,0,67,67,0,1,0,1,0
54948,445,0,0,70,70,0,1,0,1,0
53042,445,0,0,66,66,0,1,0,1,0
53428,445,0,0,70,70,0,1,0,1,0
54274,445,0,0,70,70,0,1,0,1,0
50500,445,0,0,70,70,0,1,0,1,0
62213,445,0,0,70,70,0,1,0,1,0
57276,445,0,0,70,70,0,1,0,1,0
50683,445,0,0,70,70,0,1,0,1,0
53928,445,0,0,67,67,0,1,0,1,0
59661,445,0,0,66,66,0,1,0,1,0
62468,445,0,0,70,70,0,1,0,1,0
55645,445,0,0,70,70,0,1,0,1,0
54434,445,0,0,70,70,0,1,0,1,0
57292,445,0,0,66,66,0,1,0,1,0
57036,445,0,0,70,70,0,1,0,1,0
56608,445,0,0,67,67,0,1,0,1,0
56509,445,0,0,70,70,0,1,0,1,0
56581,445,0,0,70,70,0,1,0,1,0
64882,445,0,0,70,70,0,1,0,1,0
64219,445,0,0,67,67,0,1,0,1,0
64632,445,0,0,70,70,0,1,0,1,0
55070,445,0,0,70,70,0,1,0,1,0
64088,445,0,0,67,67,0,1,0,1,0
55031,445,0,0,66,66,0,1,0,1,0
56386,445,0,0,70,70,0,1,0,1,0
50921,445,0,0,66,66,0,1,0,1,0
58610,445,0,0,70,70,0,1,0,1,0
63487,445,0,0,67,67,0,1,0,1,0
61723,445,0,0,68,68,0,1,0,1,0
51870,445,0,0,66,66,0,1,0,1,0
60654,445,0,0,70,70,0,1,0,1,0
55032,445,0,0,66,66,0,1,0,1,0
50193,445,0,0,70,70,0,1,0,1,0
59890,445,0,0,70,70,0,1,0,1,0
58442,445,0,0,66,66,0,1,0,1,0
58182,445,0,0,68,68,0,1,0,1,0
60537,445,0,0,69,69,0,1,0,1,0
55567,445,0,0,70,70,0,1,0,1,0
63302,445,0,0,70,70,0,1,0,1,0
58181,445,0,0,66,66,0,1,0,1,0
57487,445,0,0,70,70,0,1,0,1,0
64426,445,0,0,69,69,0,1,0,1,0
50381,445,0,0,70,70,0,1,0,1,0
49890,445,0,0,68,68,0,1,0,1,0
55131,445,0,0,70,70,0,1,0,1,0
62488,445,0,0,66,66,0,1,0,1,0
55718,445,0,0,70,70,0,1,0,1,0
55936,445,0,0,66,66,0,1,0,1,0
64164,445,0,0,69,69,0,1,0,1,0
53430,445,0,0,70,70,0,1,0,1,0
59413,445,0,0,70,70,0,1,0,1,0
49591,445,0,0,70,70,0,1,0,1,0
53121,445,0,0,70,70,0,1,0,1,0
64633,445,0,0,67,67,0,1,0,1,0
49493,445,0,0,70,70,0,1,0,1,0
65070,445,0,0,66,66,0,1,0,1,0
51057,445,0,0,66,66,0,1,0,1,0
56320,445,0,0,66,66,0,1,0,1,0
54489,445,0,0,70,70,0,1,0,1,0
53801,445,0,0,70,70,0,1,0,1,0
60204,445,0,0,67,67,0,1,0,1,0
58243,445,0,0,66,66,0,1,0,1,0
57986,445,0,0,66,66,0,1,0,1,0
55745,445,0,0,70,70,0,1,0,1,0
53252,445,0,0,70,70,0,1,0,1,0
55390,445,0,0,70,70,0,1,0,1,0
62577,445,0,0,69,69,0,1,0,1,0
64004,445,0,0,70,70,0,1,0,1,0
53577,445,0,0,67,67,0,1,0,1,0
54955,445,0,0,70,70,0,1,0,1,0
58944,445,0,0,70,70,0,1,0,1,0
62254,445,0,0,70,70,0,1,0,1,0
58859,445,0,0,70,70,0,1,0,1,0
60418,445,0,0,66,66,0,1,0,1,0
53426,445,0,0,70,70,0,1,0,1,0
54642,445,0,0,70,70,0,1,0,1,0
53192,445,0,0,70,70,0,1,0,1,0
61019,445,0,0,67,67,0,1,0,1,0
50361,445,0,0,70,70,0,1,0,1,0
53288,445,0,0,70,70,0,1,0,1,0
54613,445,0,0,70,70,0,1,0,1,0
63685,445,0,0,70,70,0,1,0,1,0
56721,445,0,0,70,70,0,1,0,1,0
49495,445,0,0,70,70,0,1,0,1,0
49411,445,0,0,68,68,0,1,0,1,0
49266,445,0,0,69,69,0,1,0,1,0
50251,445,0,0,70,70,0,1,0,1,0
57497,445,0,0,66,66,0,1,0,1,0
49554,445,0,0,70,70,0,1,0,1,0
55499,445,0,0,70,70,0,1,0,1,0
65453,445,0,0,66,66,0,1,0,1,0
59089,445,0,0,70,70,0,1,0,1,0
62720,445,0,0,70,70,0,1,0,1,0
52482,445,0,0,70,70,0,1,0,1,0
59208,445,0,0,69,69,0,1,0,1,0
52612,445,0,0,70,70,0,1,0,1,0
63304,445,0,0,70,70,0,1,0,1,0
62387,445,0,0,70,70,0,1,0,1,0
51440,445,0,0,70,70,0,1,0,1,0
52884,445,0,0,66,66,0,1,0,1,0
51502,445,0,0,70,70,0,1,0,1,0
56451,445,0,0,66,66,0,1,0,1,0
61349,445,0,0,66,66,0,1,0,1,0
62539,445,0,0,68,68,0,1,0,1,0
59609,445,0,0,70,70,0,1,0,1,0
56191,445,0,0,68,68,0,1,0,1,0
63208,445,0,0,70,70,0,1,0,1,0
57802,445,0,0,70,70,0,1,0,1,0
63262,445,0,0,66,66,0,1,0,1,0
53238,445,0,0,66,66,0,1,0,1,0
55722,445,0,0,70,70,0,1,0,1,0
52090,445,0,0,66,66,0,1,0,1,0
58627,445,0,0,70,70,0,1,0,1,0
54656,445,0,0,68,68,0,1,0,1,0
65444,445,0,0,68,68,0,1,0,1,0
54008,445,0,0,66,66,0,1,0,1,0
54816,445,0,0,70,70,0,1,0,1,0
55359,445,0,0,70,70,0,1,0,1,0
50467,445,0,0,66,66,0,1,0,1,0
65027,445,0,0,70,70,0,1,0,1,0
51682,445,0,0,70,70,0,1,0,1,0
56715,445,0,0,70,70,0,1,0,1,0
55938,445,0,0,68,68,0,1,0,1,0
51169,445,0,0,70,70,0,1,0,1,0
58059,445,0,0,70,70,0,1,0,1,0
51966,445,0,0,70,70,0,1,0,1,0
56722,445,0,0,70,70,0,1,0,1,0
52250,445,0,0,70,70,0,1,0,1,0
64482,445,0,0,70,70,0,1,0,1,0
62360,445,0,0,66,66,0,1,0,1,0
50035,445,0,0,70,70,0,1,0,1,0
65111,445,0,0,70,70,0,1,0,1,0
52139,445,0,0,66,66,0,1,0,1,0
64947,445,0,0,70,70,0,1,0,1,0
59203,445,0,0,70,70,0,1,0,1,0
55544,445,0,0,66,66,0,1,0,1,0
49524,445,0,0,70,70,0,1,0,1,0
63579,445,0,0,67,67,0,1,0,1,0
50869,445,0,0,70,70,0,1,0,1,0
61210,445,0,0,67,67,0,1,0,1,0
60063,445,0,0,70,70,0,1,0,1,0
57838,445,0,0,70,70,0,1,0,1,0
62279,445,0,0,70,70,0,1,0,1,0
60697,445,0,0,66,66,0,1,0,1,0
62746,445,0,0,66,66,0,1,0,1,0
49885,445,0,0,70,70,0,1,0,1,0
61161,445,0,0,68,68,0,1,0,1,0
63598,445,0,0,66,66,0,1,0,1,0
53408,445,0,0,70,70,0,1,0,1,0
57988,445,0,0,70,70,0,1,0,1,0
52736,445,0,0,66,66,0,1,0,1,0
51723,445,0,0,70,70,0,1,0,1,0
54247,445,0,0,66,66,0,1,0,1,0
57028,445,0,0,70,70,0,1,0,1,0
55627,445,0,0,66,66,0,1,0,1,0
54614,445,0,0,68,68,0,1,0,1,0
50827,445,0,0,70,70,0,1,0,1,0
53374,445,0,0,70,70,0,1,0,1,0
59338,445,0,0,66,66,0,1,0,1,0
57538,445,0,0,70,70,0,1,0,1,0
59167,445,0,0,70,70,0,1,0,1,0
55359,445,0,0,70,70,0,1,0,1,0
57242,445,0,0,70,70,0,1,0,1,0
50976,445,0,0,66,66,0,1,0,1,0
59141,445,0,0,67,67,0,1,0,1,0
51040,445,0,0,70,70,0,1,0,1,0
64524,445,0,0,70,70,0,1,0,1,0
52420,445,0,0,69,69,0,1,0,1,0
63132,445,0,0,70,70,0,1,0,1,0
65524,445,0,0,70,70,0,1,0,1,0
50693,445,0,0,66,66,0,1,0,1,0
49407,445,0,0,67,67,0,1,0,1,0
53964,445,0,0,70,70,0,1,0,1,0
49966,445,0,0,70,70,0,1,0,1,0
52690,445,0,0,70,70,0,1,0,1,0
59475,445,0,0,69,69,0,1,0,1,0
49410,445,0,0,66,66,0,1,0,1,0
62277,445,0,0,70,70,0,1,0,1,0
54872,445,0,0,70,70,0,1,0,1,0
52908,445,0,0,66,66,0,1,0,1,0
54750,445,0,0,70,70,0,1,0,1,0
50341,445,0,0,70,70,0,1,0,1,0
60194,445,0,0,68,68,0,1,0,1,0
54458,445,0,0,68,68,0,1,0,1,0
64619,445,0,0,66,66,0,1,0,1,0
58482,445,0,0,69,69,0,1,0,1,0
64633,445,0,0,68,68,0,1,0,1,0
50230,445,0,0,69,69,0,1,0,1,0
58951,445,0,0,70,70,0,1,0,1,0
57910,445,0,0,68,68,0,1,0,1,0
59718,445,0,0,68,68,0,1,0,1,0
51118,445,0,0,69,69,0,1,0,1,0
58197,445,0,0,70,70,0,1,0,1,0
61379,445,0,0,70,70,0,1,0,1,0
58787,445,0,0,70,70,0,1,0,1,0
50748,445,0,0,69,69,0,1,0,1,0
64401,445,0,0,66,66,0,1,0,1,0
63745,445,0,0,70,70,0,1,0,1,0
51441,445,0,0,69,69,0,1,0,1,0
61977,445,0,0,66,66,0,1,0,1,0
64100,445,0,0,66,66,0,1,0,1,0
55417,445,0,0,66,66,0,1,0,1,0
58281,445,0,0,70,70,0,1,0,1,0
64211,445,0,0,66,66,0,1,0,1,0
49184,445,0,0,67,67,0,1,0,1,0
51540,445,0,0,70,70,0,1,0,1,0
54516,445,0,0,70,70,0,1,0,1,0
54436,445,0,0,70,70,0,1,0,1,0
63364,445,0,0,70,70,0,1,0,1,0
52883,445,0,0,66,66,0,1,0,1,0
55042,445,0,0,66,66,0,1,0,1,0
53587,445,0,0,70,70,0,1,0,1,0
61512,445,0,0,70,70,0,1,0,1,0
51755,445,0,0,70,70,0,1,0,1,0
52224,445,0,0,70,70,0,1,0,1,0
64518,445,0,0,70,70,0,1,0,1,0
63988,445,0,0,67,67,0,1,0,1,0
54057,445,0,0,70,70,0,1,0,1,0
49784,445,0,0,70,70,0,1,0,1,0
55568,445,0,0,70,70,0,1,0,1,0
56748,445,0,0,70,70,0,1,0,1,0
61937,445,0,0,70,70,0,1,0,1,0
56755,445,0,0,67,67,0,1,0,1,0
54460,445,0,0,66,66,0,1,0,1,0
60104,445,0,0,67,67,0,1,0,1,0
61169,445,0,0,70,70,0,1,0,1,0
50848,445,0,0,66,66,0,1,0,1,0
59766,445,0,0,70,70,0,1,0,1,0
63083,445,0,0,66,66,0,1,0,1,0
60337,445,0,0,70,70,0,1,0,1,0
58330,445,0,0,70,70,0,1,0,1,0
58612,445,0,0,66,66,0,1,0,1,0
55569,445,0,0,70,70,0,1,0,1,0
50788,445,0,0,70,70,0,1,0,1,0
59914,445,0,0,66,66,0,1,0,1,0
61737,445,0,0,70,70,0,1,0,1,0
52139,445,0,0,67,67,0,1,0,1,0
65322,445,0,0,66,66,0,1,0,1,0
55919,445,0,0,67,67,0,1,0,1,0
61659,445,0,0,70,70,0,1,0,1,0
63931,445,0,0,66,66,0,1,0,1,0
52305,445,0,0,70,70,0,1,0,1,0
64410,445,0,0,70,70,0,1,0,1,0
57432,445,0,0,68,68,0,1,0,1,0
49734,445,0,0,66,66,0,1,0,1,0
60643,445,0,0,70,70,0,1,0,1,0
59782,445,0,0,70,70,0,1,0,1,0
62875,445,0,0,66,66,0,1,0,1,0
53160,445,0,0,70,70,0,1,0,1,0
61142,445,0,0,70,70,0,1,0,1,0
50051,445,0,0,70,70,0,1,0,1,0
61780,445,0,0,66,66,0,1,0,1,0
51418,445,0,0,70,70,0,1,0,1,0
65394,445,0,0,66,66,0,1,0,1,0
55845,445,0,0,67,67,0,1,0,1,0
60440,445,0,0,69,69,0,1,0,1,0
64248,445,0,0,68,68,0,1,0,1,0
55905,445,0,0,70,70,0,1,0,1,0
51569,445,0,0,68,68,0,1,0,1,0
53481,445,0,0,70,70,0,1,0,1,0
50545,445,0,0,66,66,0,1,0,1,0
61932,445,0,0,69,69,0,1,0,1,0
49447,445,0,0,70,70,0,1,0,1,0
62907,445,0,0,67,67,0,1,0,1,0
65255,445,0,0,69,69,0,1,0,1,0
50347,445,0,0,70,70,0,1,0,1,0
64082,445,0,0,68,68,0,1,0,1,0
49755,445,0,0,70,70,0,1,0,1,0
62500,445,0,0,70,70,0,1,0,1,0
58409,445,0,0,70,70,0,1,0,1,0
55204,445,0,0,70,70,0,1,0,1,0
60243,445,0,0,70,70,0,1,0,1,0
59373,445,0,0,70,70,0,1,0,1,0
62743,445,0,0,66,66,0,1,0,1,0
58242,445,0,0,68,68,0,1,0,1,0
51541,445,0,0,70,70,0,1,0,1,0
60064,445,0,0,70,70,0,1,0,1,0
59680,445,0,0,70,70,0,1,0,1,0
50594,445,0,0,70,70,0,1,0,1,0
64713,445,0,0,70,70,0,1,0,1,0
62025,445,0,0,66,66,0,1,0,1,0
55200,445,0,0,69,69,0,1,0,1,0
60312,445,0,0,70,70,0,1,0,1,0
50001,445,0,0,70,70,0,1,0,1,0
56061,445,0,0,66,66,0,1,0,1,0
53797,445,0,0,70,70,0,1,0,1,0
61780,445,0,0,70,70,0,1,0,1,0
59341,445,0,0,69,69,0,1,0,1,0
54505,445,0,0,70,70,0,1,0,1,0
49284,445,0,0,68,68,0,1,0,1,0
58068,445,0,0,66,66,0,1,0,1,0
51184,445,0,0,66,66,0,1,0,1,0
55363,445,0,0,70,70,0,1,0,1,0
58813,445,0,0,67,67,0,1,0,1,0
56618,445,0,0,70,70,0,1,0,1,0
64375,445,0,0,70,70,0,1,0,1,0
62187,445,0,0,70,70,0,1,0,1,0
56708,445,0,0,66,66,0,1,0,1,0
50535,445,0,0,68,68,0,1,0,1,0
63956,445,0,0,67,67,0,1,0,1,0
58330,445,0,0,70,70,0,1,0,1,0
59197,445,0,0,66,66,0,1,0,1,0
51840,445,0,0,70,70,0,1,0,1,0
55673,445,0,0,70,70,0,1,0,1,0
54691,445,0,0,70,70,0,1,0,1,0
54552,445,0,0,68,68,0,1,0,1,0
53032,445,0,0,68,68,0,1,0,1,0
49318,445,0,0,70,70,0,1,0,1,0
51704,445,0,0,66,66,0,1,0,1,0
58167,445,0,0,69,69,0,1,0,1,0
50205,445,0,0,70,70,0,1,0,1,0
54903,445,0,0,66,66,0,1,0,1,0
50379,445,0,0,67,67,0,1,0,1,0
65198,445,0,0,66,66,0,1,0,1,0
63200,445,0,0,66,66,0,1,0,1,0
58677,445,0,0,70,70,0,1,0,1,0
54641,445,0,0,70,70,0,1,0,1,0
53051,445,0,0,68,68,0,1,0,1,0
55937,445,0,0,66,66,0,1,0,1,0
59529,445,0,0,66,66,0,1,0,1,0
62372,445,0,0,66,66,0,1,0,1,0
53813,445,0,0,70,70,0,1,0,1,0
50591,445,0,0,70,70,0,1,0,1,0
54990,445,0,0,70,70,0,1,0,1,0
51985,445,0,0,70,70,0,1,0,1,0
52217,445,0,0,66,66,0,1,0,1,0
63884,445,0,0,66,66,0,1,0,1,0
62492,445,0,0,66,66,0,1,0,1,0
56480,445,0,0,70,70,0,1,0,1,0
64813,445,0,0,70,70,0,1,0,1,0
65463,445,0,0,70,70,0,1,0,1,0
57153,445,0,0,66,66,0,1,0,1,0
50864,445,0,0,66,66,0,1,0,1,0
60873,445,0,0,66,66,0,1,0,1,0
56391,445,0,0,66,66,0,1,0,1,0
52849,445,0,0,70,70,0,1,0,1,0
63556,445,0,0,70,70,0,1,0,1,0
56072,445,0,0,70,70,0,1,0,1,0
55850,445,0,0,70,70,0,1,0,1,0
57234,445,0,0,70,70,0,1,0,1,0
59844,445,0,0,70,70,0,1,0,1,0
53654,445,0,0,66,66,0,1,0,1,0
58270,445,0,0,70,70,0,1,0,1,0
56811,445,0,0,70,70,0,1,0,1,0
59139,445,0,0,70,70,0,1,0,1,0
60110,445,0,0,66,66,0,1,0,1,0
50613,445,0,0,70,70,0,1,0,1,0
50321,445,0,0,70,70,0,1,0,1,0
62024,445,0,0,66,66,0,1,0,1,0
62211,445,0,0,70,70,0,1,0,1,0
55076,445,0,0,70,70,0,1,0,1,0
54392,445,0,0,70,70,0,1,0,1,0
64573,445,0,0,69,69,0,1,0,1,0
51997,445,0,0,69,69,0,1,0,1,0
62679,445,0,0,70,70,0,1,0,1,0
52860,445,0,0,70,70,0,1,0,1,0
50339,445,0,0,67,67,0,1,0,1,0
62925,445,0,0,68,68,0,1,0,1,0
56435,445,0,0,66,66,0,1,0,1,0
64598,445,0,0,70,70,0,1,0,1,0
57031,445,0,0,70,70,0,1,0,1,0
62392,445,0,0,70,70,0,1,0,1,0
52090,445,0,0,70,70,0,1,0,1,0
51722,445,0,0,70,70,0,1,0,1,0
64452,445,0,0,67,67,0,1,0,1,0
51515,445,0,0,67,67,0,1,0,1,0
61600,445,0,0,70,70,0,1,0,1,0
63580,445,0,0,70,70,0,1,0,1,0
60806,445,0,0,66,66,0,1,0,1,0
52725,445,0,0,66,66,0,1,0,1,0
51695,445,0,0,68,68,0,1,0,1,0
57862,445,0,0,69,69,0,1,0,1,0
56819,445,0,0,66,66,0,1,0,1,0
62684,445,0,0,70,70,0,1,0,1,0
59125,445,0,0,67,67,0,1,0,1,0
60177,445,0,0,66,66,0,1,0,1,0
54632,445,0,0,66,66,0,1,0,1,0
64290,445,0,0,66,66,0,1,0,1,0
60934,445,0,0,70,70,0,1,0,1,0
65287,445,0,0,70,70,0,1,0,1,0
54690,445,0,0,70,70,0,1,0,1,0
55723,445,0,0,70,70,0,1,0,1,0
58542,445,0,0,70,70,0,1,0,1,0
64632,445,0,0,66,66,0,1,0,1,0
54371,445,0,0,69,69,0,1,0,1,0
50485,445,0,0,66,66,0,1,0,1,0
60819,445,0,0,70,70,0,1,0,1,0
63872,445,0,0,70,70,0,1,0,1,0
50349,445,0,0,70,70,0,1,0,1,0
57357,445,0,0,70,70,0,1,0,1,0
54816,445,0,0,70,70,0,1,0,1,0
53221,445,0,0,70,70,0,1,0,1,0
55557,445,0,0,70,70,0,1,0,1,0
58155,445,0,0,70,70,0,1,0,1,0
55416,445,0,0,70,70,0,1,0,1,0
64161,445,0,0,70,70,0,1,0,1,0
56485,445,0,0,70,70,0,1,0,1,0
52088,445,0,0,70,70,0,1,0,1,0
52975,445,0,0,70,70,0,1,0,1,0
64056,445,0,0,70,70,0,1,0,1,0
50801,445,0,0,70,70,0,1,0,1,0
52888,445,0,0,70,70,0,1,0,1,0
53106,445,0,0,70,70,0,1,0,1,0
50793,445,0,0,66,66,0,1,0,1,0
64293,445,0,0,66,66,0,1,0,1,0
58417,445,0,0,70,70,0,1,0,1,0
63542,445,0,0,70,70,0,1,0,1,0
59919,445,0,0,68,68,0,1,0,1,0
49794,445,0,0,66,66,0,1,0,1,0
55021,445,0,0,70,70,0,1,0,1,0
60822,445,0,0,66,66,0,1,0,1,0
50463,445,0,0,70,70,0,1,0,1,0
49641,445,0,0,70,70,0,1,0,1,0
50031,445,0,0,67,67,0,1,0,1,0
52807,445,0,0,69,69,0,1,0,1,0
63544,445,0,0,70,70,0,1,0,1,0
56014,445,0,0,70,70,0,1,0,1,0
63777,445,0,0,66,66,0,1,0,1,0
60947,445,0,0,70,70,0,1,0,1,0
65093,445,0,0,70,70,0,1,0,1,0
55306,445,0,0,70,70,0,1,0,1,0
58541,445,0,0,70,70,0,1,0,1,0
56450,445,0,0,68,68,0,1,0,1,0
49879,445,0,0,70,70,0,1,0,1,0
52548,445,0,0,66,66,0,1,0,1,0
53855,445,0,0,70,70,0,1,0,1,0
57220,445,0,0,66,66,0,1,0,1,0
61593,445,0,0,70,70,0,1,0,1,0
58272,445,0,0,70,70,0,1,0,1,0
56361,445,0,0,70,70,0,1,0,1,0
59792,445,0,0,70,70,0,1,0,1,0
55782,445,0,0,70,70,0,1,0,1,0
56589,445,0,0,70,70,0,1,0,1,0
52988,445,0,0,68,68,0,1,0,1,0
59084,445,0,0,66,66,0,1,0,1,0
53799,445,0,0,70,70,0,1,0,1,0
50464,445,0,0,69,69,0,1,0,1,0
52338,445,0,0,70,70,0,1,0,1,0
58416,445,0,0,70,70,0,1,0,1,0
61792,445,0,0,66,66,0,1,0,1,0
50031,445,0,0,70,70,0,1,0,1,0
56637,445,0,0,70,70,0,1,0,1,0
62670,445,0,0,67,67,0,1,0,1,0
61126,445,0,0,70,70,0,1,0,1,0
50246,445,0,0,70,70,0,1,0,1,0
50805,445,0,0,66,66,0,1,0,1,0
57399,445,0,0,67,67,0,1,0,1,0
51624,445,0,0,66,66,0,1,0,1,0
63416,445,0,0,70,70,0,1,0,1,0
52219,445,0,0,68,68,0,1,0,1,0
57669,445,0,0,70,70,0,1,0,1,0
55660,445,0,0,67,67,0,1,0,1,0
54614,445,0,0,68,68,0,1,0,1,0
56790,445,0,0,67,67,0,1,0,1,0
59162,445,0,0,69,69,0,1,0,1,0
63873,445,0,0,66,66,0,1,0,1,0
58559,445,0,0,70,70,0,1,0,1,0
52603,445,0,0,68,68,0,1,0,1,0
60600,445,0,0,70,70,0,1,0,1,0
58499,445,0,0,66,66,0,1,0,1,0
52210,445,0,0,69,69,0,1,0,1,0
51518,445,0,0,70,70,0,1,0,1,0
64899,445,0,0,70,70,0,1,0,1,0
59759,445,0,0,70,70,0,1,0,1,0
58974,445,0,0,70,70,0,1,0,1,0
52714,445,0,0,70,70,0,1,0,1,0
61784,445,0,0,70,70,0,1,0,1,0
52145,445,0,0,70,70,0,1,0,1,0
51990,445,0,0,70,70,0,1,0,1,0
58568,445,0,0,66,66,0,1,0,1,0
56790,445,0,0,66,66,0,1,0,1,0
55043,445,0,0,67,67,0,1,0,1,0
53428,445,0,0,66,66,0,1,0,1,0
63563,445,0,0,67,67,0,1,0,1,0
63956,445,0,0,66,66,0,1,0,1,0
61449,445,0,0,66,66,0,1,0,1,0
62109,445,0,0,70,70,0,1,0,1,0
55056,445,0,0,70,70,0,1,0,1,0
56182,445,0,0,70,70,0,1,0,1,0
57213,445,0,0,70,70,0,1,0,1,0
65449,445,0,0,66,66,0,1,0,1,0
55890,445,0,0,67,67,0,1,0,1,0
57233,445,0,0,70,70,0,1,0,1,0
59502,445,0,0,70,70,0,1,0,1,0
57021,445,0,0,66,66,0,1,0,1,0
52710,445,0,0,70,70,0,1,0,1,0
63971,445,0,0,66,66,0,1,0,1,0
53828,445,0,0,70,70,0,1,0,1,0
49374,445,0,0,70,70,0,1,0,1,0
51035,445,0,0,70,70,0,1,0,1,0
56729,445,0,0,70,70,0,1,0,1,0
50878,445,0,0,66,66,0,1,0,1,0
60095,445,0,0,66,66,0,1,0,1,0
65501,445,0,0,70,70,0,1,0,1,0
64867,445,0,0,70,70,0,1,0,1,0
56773,445,0,0,70,70,0,1,0,1,0
56711,445,0,0,66,66,0,1,0,1,0
57237,445,0,0,70,70,0,1,0,1,0
62276,445,0,0,70,70,0,1,0,1,0
55339,445,0,0,70,70,0,1,0,1,0
58409,445,0,0,70,70,0,1,0,1,0
50694,445,0,0,70,70,0,1,0,1,0
50141,445,0,0,70,70,0,1,0,1,0
57927,445,0,0,70,70,0,1,0,1,0
50298,445,0,0,70,70,0,1,0,1,0
49303,445,0,0,70,70,0,1,0,1,0
55357,445,0,0,66,66,0,1,0,1,0
50267,445,0,0,66,66,0,1,0,1,0
63728,445,0,0,70,70,0,1,0,1,0
53320,445,0,0,66,66,0,1,0,1,0
50612,445,0,0,70,70,0,1,0,1,0
59160,445,0,0,70,70,0,1,0,1,0
58498,445,0,0,70,70,0,1,0,1,0
63388,445,0,0,66,66,0,1,0,1,0
61802,445,0,0,70,70,0,1,0,1,0
51302,445,0,0,70,70,0,1,0,1,0
65322,445,0,0,67,67,0,1,0,1,0
57347,445,0,0,66,66,0,1,0,1,0
57035,445,0,0,67,67,0,1,0,1,0
60945,445,0,0,70,70,0,1,0,1,0
62812,445,0,0,67,67,0,1,0,1,0
50163,445,0,0,66,66,0,1,0,1,0
60695,445,0,0,66,66,0,1,0,1,0
60174,445,0,0,66,66,0,1,0,1,0
49977,445,0,0,70,70,0,1,0,1,0
52767,445,0,0,70,70,0,1,0,1,0
59967,445,0,0,67,67,0,1,0,1,0
63667,445,0,0,70,70,0,1,0,1,0
56188,445,0,0,70,70,0,1,0,1,0
51076,445,0,0,66,66,0,1,0,1,0
53548,445,0,0,69,69,0,1,0,1,0
56254,445,0,0,66,66,0,1,0,1,0
60044,445,0,0,70,70,0,1,0,1,0
59441,445,0,0,70,70,0,1,0,1,0
54862,445,0,0,70,70,0,1,0,1,0
61156,445,0,0,69,69,0,1,0,1,0
60792,445,0,0,70,70,0,1,0,1,0
59826,445,0,0,67,67,0,1,0,1,0
64450,445,0,0,66,66,0,1,0,1,0
64862,445,0,0,70,70,0,1,0,1,0
55371,445,0,0,66,66,0,1,0,1,0
63778,445,0,0,70,70,0,1,0,1,0
52677,445,0,0,68,68,0,1,0,1,0
55263,445,0,0,70,70,0,1,0,1,0
53005,445,0,0,69,69,0,1,0,1,0
52476,445,0,0,70,70,0,1,0,1,0
60573,445,0,0,70,70,0,1,0,1,0
50596,445,0,0,68,68,0,1,0,1,0
53341,445,0,0,70,70,0,1,0,1,0
60088,445,0,0,70,70,0,1,0,1,0
52405,445,0,0,66,66,0,1,0,1,0
53239,445,0,0,66,66,0,1,0,1,0
58176,445,0,0,69,69,0,1,0,1,0
61651,445,0,0,70,70,0,1,0,1,0
55567,445,0,0,70,70,0,1,0,1,0
50825,445,0,0,70,70,0,1,0,1,0
54517,445,0,0,66,66,0,1,0,1,0
49519,445,0,0,70,70,0,1,0,1,0
49391,445,0,0,68,68,0,1,0,1,0
61721,445,0,0,70,70,0,1,0,1,0
57851,445,0,0,70,70,0,1,0,1,0
53962,445,0,0,67,67,0,1,0,1,0
51960,445,0,0,66,66,0,1,0,1,0
56131,445,0,0,70,70,0,1,0,1,0
50556,445,0,0,70,70,0,1,0,1,0
51069,445,0,0,70,70,0,1,0,1,0
65305,445,0,0,66,66,0,1,0,1,0
53537,445,0,0,70,70,0,1,0,1,0
50009,445,0,0,70,70,0,1,0,1,0
64708,445,0,0,70,70,0,1,0,1,0
58691,445,0,0,69,69,0,1,0,1,0
60193,445,0,0,70,70,0,1,0,1,0
54721,445,0,0,69,69,0,1,0,1,0
53705,445,0,0,68,68,0,1,0,1,0
52901,445,0,0,70,70,0,1,0,1,0
59565,445,0,0,68,68,0,1,0,1,0
57404,445,0,0,70,70,0,1,0,1,0
52528,445,0,0,70,70,0,1,0,1,0
52051,445,0,0,70,70,0,1,0,1,0
60308,445,0,0,66,66,0,1,0,1,0
51643,445,0,0,66,66,0,1,0,1,0
64792,445,0,0,69,69,0,1,0,1,0
62659,445,0,0,70,70,0,1,0,1,0
52405,445,0,0,70,70,0,1,0,1,0
63731,445,0,0,70,70,0,1,0,1,0
52988,445,0,0,67,67,0,1,0,1,0
49892,445,0,0,67,67,0,1,0,1,0
60615,445,0,0,70,70,0,1,0,1,0
49678,445,0,0,70,70,0,1,0,1,0
58404,445,0,0,66,66,0,1,0,1,0
62629,445,0,0,70,70,0,1,0,1,0
55721,445,0,0,70,70,0,1,0,1,0
50244,445,0,0,67,67,0,1,0,1,0
59915,445,0,0,70,70,0,1,0,1,0
59986,445,0,0,70,70,0,1,0,1,0
50162,445,0,0,67,67,0,1,0,1,0
59198,445,0,0,66,66,0,1,0,1,0
54418,445,0,0,70,70,0,1,0,1,0
56153,445,0,0,66,66,0,1,0,1,0
49796,445,0,0,70,70,0,1,0,1,0
50643,445,0,0,70,70,0,1,0,1,0
57257,445,0,0,67,67,0,1,0,1,0
59269,445,0,0,67,67,0,1,0,1,0
54819,445,0,0,70,70,0,1,0,1,0
63731,445,0,0,70,70,0,1,0,1,0
50298,445,0,0,70,70,0,1,0,1,0
64751,445,0,0,67,67,0,1,0,1,0
62629,445,0,0,70,70,0,1,0,1,0
53033,445,0,0,66,66,0,1,0,1,0
60770,445,0,0,69,69,0,1,0,1,0
51041,445,0,0,70,70,0,1,0,1,0
51672,445,0,0,70,70,0,1,0,1,0
49808,445,0,0,70,70,0,1,0,1,0
54838,445,0,0,66,66,0,1,0,1,0
51732,445,0,0,69,69,0,1,0,1,0
55140,445,0,0,69,69,0,1,0,1,0
52608,445,0,0,68,68,0,1,0,1,0
55036,445,0,0,66,66,0,1,0,1,0
64037,445,0,0,66,66,0,1,0,1,0
53521,445,0,0,70,70,0,1,0,1,0
52217,445,0,0,66,66,0,1,0,1,0
64633,445,0,0,70,70,0,1,0,1,0
59199,445,0,0,70,70,0,1,0,1,0
49566,445,0,0,66,66,0,1,0,1,0
54731,445,0,0,70,70,0,1,0,1,0
52415,445,0,0,69,69,0,1,0,1,0
65058,445,0,0,70,70,0,1,0,1,0
57303,445,0,0,70,70,0,1,0,1,0
60590,445,0,0,70,70,0,1,0,1,0
61992,445,0,0,70,70,0,1,0,1,0
57066,445,0,0,70,70,0,1,0,1,0
54784,445,0,0,70,70,0,1,0,1,0
53214,445,0,0,70,70,0,1,0,1,0
54342,445,0,0,69,69,0,1,0,1,0
60085,445,0,0,69,69,0,1,0,1,0
64808,445,0,0,66,66,0,1,0,1,0
65014,445,0,0,66,66,0,1,0,1,0
50260,445,0,0,70,70,0,1,0,1,0
63687,445,0,0,70,70,0,1,0,1,0
63442,445,0,0,70,70,0,1,0,1,0
60760,445,0,0,70,70,0,1,0,1,0
57102,445,0,0,70,70,0,1,0,1,0
63513,445,0,0,66,66,0,1,0,1,0
53865,445,0,0,66,66,0,1,0,1,0
51326,445,0,0,68,68,0,1,0,1,0
52095,445,0,0,69,69,0,1,0,1,0
55018,445,0,0,68,68,0,1,0,1,0
61790,445,0,0,69,69,0,1,0,1,0
64413,445,0,0,70,70,0,1,0,1,0
50387,445,0,0,70,70,0,1,0,1,0
61532,445,0,0,70,70,0,1,0,1,0
53365,445,0,0,66,66,0,1,0,1,0
62227,445,0,0,68,68,0,1,0,1,0
51440,445,0,0,70,70,0,1,0,1,0
57543,445,0,0,70,70,0,1,0,1,0
55214,445,0,0,70,70,0,1,0,1,0
63330,445,0,0,70,70,0,1,0,1,0
58658,445,0,0,68,68,0,1,0,1,0
63385,445,0,0,70,70,0,1,0,1,0
52049,445,0,0,70,70,0,1,0,1,0
57668,445,0,0,66,66,0,1,0,1,0
62229,445,0,0,69,69,0,1,0,1,0
56330,445,0,0,70,70,0,1,0,1,0
54573,445,0,0,66,66,0,1,0,1,0
63671,445,0,0,67,67,0,1,0,1,0
61159,445,0,0,66,66,0,1,0,1,0
51692,445,0,0,70,70,0,1,0,1,0
53547,445,0,0,68,68,0,1,0,1,0
51809,445,0,0,70,70,0,1,0,1,0
65077,445,0,0,70,70,0,1,0,1,0
60246,445,0,0,70,70,0,1,0,1,0
59801,445,0,0,70,70,0,1,0,1,0
58996,445,0,0,69,69,0,1,0,1,0
57485,445,0,0,70,70,0,1,0,1,0
53377,445,0,0,70,70,0,1,0,1,0
58445,445,0,0,66,66,0,1,0,1,0
54457,445,0,0,70,70,0,1,0,1,0
60614,445,0,0,68,68,0,1,0,1,0
60755,445,0,0,70,70,0,1,0,1,0
58539,445,0,0,70,70,0,1,0,1,0
55194,445,0,0,70,70,0,1,0,1,0
55211,445,0,0,70,70,0,1,0,1,0
60547,445,0,0,69,69,0,1,0,1,0
63758,445,0,0,66,66,0,1,0,1,0
58033,445,0,0,69,69,0,1,0,1,0
62637,445,0,0,70,70,0,1,0,1,0
57156,445,0,0,70,70,0,1,0,1,0
58681,445,0,0,70,70,0,1,0,1,0
58284,445,0,0,70,70,0,1,0,1,0
56588,445,0,0,70,70,0,1,0,1,0
61512,445,0,0,70,70,0,1,0,1,0
55672,445,0,0,70,70,0,1,0,1,0
52629,445,0,0,70,70,0,1,0,1,0
53653,445,0,0,69,69,0,1,0,1,0
60804,445,0,0,67,67,0,1,0,1,0
55077,445,0,0,70,70,0,1,0,1,0
55939,445,0,0,66,66,0,1,0,1,0
53188,445,0,0,68,68,0,1,0,1,0
58293,445,0,0,70,70,0,1,0,1,0
55866,445,0,0,66,66,0,1,0,1,0
51552,445,0,0,68,68,0,1,0,1,0
61345,445,0,0,70,70,0,1,0,1,0
64942,445,0,0,70,70,0,1,0,1,0
54955,445,0,0,70,70,0,1,0,1,0
52915,445,0,0,66,66,0,1,0,1,0
64199,445,0,0,67,67,0,1,0,1,0
57541,445,0,0,70,70,0,1,0,1,0
65337,445,0,0,70,70,0,1,0,1,0
57375,445,0,0,70,70,0,1,0,1,0
61885,445,0,0,69,69,0,1,0,1,0
55610,445,0,0,70,70,0,1,0,1,0
53944,445,0,0,66,66,0,1,0,1,0
59535,445,0,0,66,66,0,1,0,1,0
63298,445,0,0,70,70,0,1,0,1,0
59861,445,0,0,66,66,0,1,0,1,0
65486,445,0,0,70,70,0,1,0,1,0
63321,445,0,0,70,70,0,1,0,1,0
49620,445,0,0,70,70,0,1,0,1,0
63717,445,0,0,70,70,0,1,0,1,0
50950,445,0,0,70,70,0,1,0,1,0
54396,445,0,0,66,66,0,1,0,1,0
53366,445,0,0,70,70,0,1,0,1,0
49338,445,0,0,70,70,0,1,0,1,0
65237,445,0,0,70,70,0,1,0,1,0
52858,445,0,0,70,70,0,1,0,1,0
65403,445,0,0,69,69,0,1,0,1,0
63007,445,0,0,70,70,0,1,0,1,0
62357,445,0,0,66,66,0,1,0,1,0
59395,445,0,0,70,70,0,1,0,1,0
58183,445,0,0,70,70,0,1,0,1,0
49938,445,0,0,70,70,0,1,0,1,0
61335,445,0,0,66,66,0,1,0,1,0
55339,445,0,0,67,67,0,1,0,1,0
61254,445,0,0,70,70,0,1,0,1,0
52479,445,0,0,70,70,0,1,0,1,0
65459,445,0,0,70,70,0,1,0,1,0
50436,445,0,0,67,67,0,1,0,1,0
55059,445,0,0,70,70,0,1,0,1,0
50711,445,0,0,70,70,0,1,0,1,0
57070,445,0,0,70,70,0,1,0,1,0
55836,445,0,0,69,69,0,1,0,1,0
63598,445,0,0,66,66,0,1,0,1,0
61995,445,0,0,70,70,0,1,0,1,0
50362,445,0,0,70,70,0,1,0,1,0
52052,445,0,0,70,70,0,1,0,1,0
57119,445,0,0,70,70,0,1,0,1,0
55210,445,0,0,67,67,0,1,0,1,0
63065,445,0,0,66,66,0,1,0,1,0
59737,445,0,0,66,66,0,1,0,1,0
60212,445,0,0,70,70,0,1,0,1,0
55913,445,0,0,70,70,0,1,0,1,0
63890,445,0,0,70,70,0,1,0,1,0
60083,445,0,0,70,70,0,1,0,1,0
50778,445,0,0,70,70,0,1,0,1,0
65325,445,0,0,66,66,0,1,0,1,0
59721,445,0,0,70,70,0,1,0,1,0
57567,445,0,0,68,68,0,1,0,1,0
52700,445,0,0,70,70,0,1,0,1,0
54890,445,0,0,70,70,0,1,0,1,0
58516,445,0,0,70,70,0,1,0,1,0
56845,445,0,0,70,70,0,1,0,1,0
57929,445,0,0,70,70,0,1,0,1,0
53365,445,0,0,70,70,0,1,0,1,0
49263,445,0,0,66,66,0,1,0,1,0
53012,445,0,0,70,70,0,1,0,1,0
61750,445,0,0,69,69,0,1,0,1,0
61570,445,0,0,70,70,0,1,0,1,0
62077,445,0,0,66,66,0,1,0,1,0
56613,445,0,0,70,70,0,1,0,1,0
52266,445,0,0,69,69,0,1,0,1,0
58971,445,0,0,70,70,0,1,0,1,0
51186,445,0,0,66,66,0,1,0,1,0
54003,445,0,0,70,70,0,1,0,1,0
63883,445,0,0,70,70,0,1,0,1,0
60354,445,0,0,69,69,0,1,0,1,0
63228,445,0,0,70,70,0,1,0,1,0
50866,445,0,0,66,66,0,1,0,1,0
51922,445,0,0,70,70,0,1,0,1,0
52790,445,0,0,70,70,0,1,0,1,0
61142,445,0,0,70,70,0,1,0,1,0
49905,445,0,0,70,70,0,1,0,1,0
61671,445,0,0,66,66,0,1,0,1,0
51922,445,0,0,70,70,0,1,0,1,0
53242,445,0,0,67,67,0,1,0,1,0
54459,445,0,0,70,70,0,1,0,1,0
52020,445,0,0,66,66,0,1,0,1,0
53076,445,0,0,70,70,0,1,0,1,0
58168,445,0,0,66,66,0,1,0,1,0
55727,445,0,0,66,66,0,1,0,1,0
60822,445,0,0,66,66,0,1,0,1,0
55984,445,0,0,66,66,0,1,0,1,0
51164,445,0,0,66,66,0,1,0,1,0
60978,445,0,0,66,66,0,1,0,1,0
54205,445,0,0,70,70,0,1,0,1,0
60815,445,0,0,70,70,0,1,0,1,0
51959,445,0,0,68,68,0,1,0,1,0
59915,445,0,0,68,68,0,1,0,1,0
53628,445,0,0,66,66,0,1,0,1,0
62266,445,0,0,70,70,0,1,0,1,0
65238,445,0,0,70,70,0,1,0,1,0
60722,445,0,0,70,70,0,1,0,1,0
50513,445,0,0,70,70,0,1,0,1,0
53080,445,0,0,70,70,0,1,0,1,0
49323,445,0,0,70,70,0,1,0,1,0
54250,445,0,0,69,69,0,1,0,1,0
59206,445,0,0,70,70,0,1,0,1,0
55560,445,0,0,70,70,0,1,0,1,0
61728,445,0,0,69,69,0,1,0,1,0
62489,445,0,0,70,70,0,1,0,1,0
60347,445,0,0,70,70,0,1,0,1,0
59965,445,0,0,66,66,0,1,0,1,0
62035,445,0,0,70,70,0,1,0,1,0
62215,445,0,0,66,66,0,1,0,1,0
61544,445,0,0,66,66,0,1,0,1,0
56409,445,0,0,70,70,0,1,0,1,0
57602,445,0,0,66,66,0,1,0,1,0
64339,445,0,0,68,68,0,1,0,1,0
50463,445,0,0,66,66,0,1,0,1,0
62830,445,0,0,66,66,0,1,0,1,0
60308,445,0,0,66,66,0,1,0,1,0
55978,445,0,0,70,70,0,1,0,1,0
50094,445,0,0,70,70,0,1,0,1,0
60816,445,0,0,70,70,0,1,0,1,0
64727,445,0,0,66,66,0,1,0,1,0
55515,445,0,0,70,70,0,1,0,1,0
58449,445,0,0,68,68,0,1,0,1,0
56741,445,0,0,66,66,0,1,0,1,0
61173,445,0,0,70,70,0,1,0,1,0
61620,445,0,0,66,66,0,1,0,1,0
56537,445,0,0,70,70,0,1,0,1,0
65187,445,0,0,70,70,0,1,0,1,0
51379,445,0,0,66,66,0,1,0,1,0
62895,445,0,0,70,70,0,1,0,1,0
51186,445,0,0,66,66,0,1,0,1,0
54197,445,0,0,66,66,0,1,0,1,0
51309,445,0,0,70,70,0,1,0,1,0
49938,445,0,0,70,70,0,1,0,1,0
50916,445,0,0,70,70,0,1,0,1,0
52662,445,0,0,66,66,0,1,0,1,0
54486,445,0,0,70,70,0,1,0,1,0
55181,445,0,0,70,70,0,1,0,1,0
57754,445,0,0,70,70,0,1,0,1,0
58188,445,0,0,70,70,0,1,0,1,0
63037,445,0,0,70,70,0,1,0,1,0
55723,445,0,0,70,70,0,1,0,1,0
49589,445,0,0,66,66,0,1,0,1,0
50602,445,0,0,66,66,0,1,0,1,0
63326,445,0,0,66,66,0,1,0,1,0
58244,445,0,0,66,66,0,1,0,1,0
49663,445,0,0,70,70,0,1,0,1,0
61888,445,0,0,70,70,0,1,0,1,0
53727,445,0,0,70,70,0,1,0,1,0
58738,445,0,0,70,70,0,1,0,1,0
57561,445,0,0,70,70,0,1,0,1,0
55665,445,0,0,70,70,0,1,0,1,0
55084,445,0,0,66,66,0,1,0,1,0
55545,445,0,0,70,70,0,1,0,1,0
59501,445,0,0,67,67,0,1,0,1,0
50497,445,0,0,70,70,0,1,0,1,0
52976,445,0,0,70,70,0,1,0,1,0
50868,445,0,0,70,70,0,1,0,1,0
50570,445,0,0,70,70,0,1,0,1,0
50578,445,0,0,70,70,0,1,0,1,0
62852,445,0,0,70,70,0,1,0,1,0
49218,445,0,0,68,68,0,1,0,1,0
49864,445,0,0,70,70,0,1,0,1,0
50544,445,0,0,68,68,0,1,0,1,0
63579,445,0,0,67,67,0,1,0,1,0
62586,445,0,0,67,67,0,1,0,1,0
55773,445,0,0,70,70,0,1,0,1,0
52460,445,0,0,70,70,0,1,0,1,0
50711,445,0,0,70,70,0,1,0,1,0
50529,445,0,0,70,70,0,1,0,1,0
50928,445,0,0,66,66,0,1,0,1,0
54583,445,0,0,66,66,0,1,0,1,0
54366,445,0,0,70,70,0,1,0,1,0
51159,445,0,0,70,70,0,1,0,1,0
50352,445,0,0,66,66,0,1,0,1,0
50641,445,0,0,70,70,0,1,0,1,0
49993,445,0,0,70,70,0,1,0,1,0
63001,445,0,0,70,70,0,1,0,1,0
55598,445,0,0,69,69,0,1,0,1,0
62690,445,0,0,67,67,0,1,0,1,0
52564,445,0,0,70,70,0,1,0,1,0
55334,445,0,0,70,70,0,1,0,1,0
55978,445,0,0,70,70,0,1,0,1,0
65145,445,0,0,70,70,0,1,0,1,0
58794,445,0,0,69,69,0,1,0,1,0
61467,445,0,0,70,70,0,1,0,1,0
57326,445,0,0,70,70,0,1,0,1,0
56715,445,0,0,70,70,0,1,0,1,0
56187,445,0,0,70,70,0,1,0,1,0
65091,445,0,0,70,70,0,1,0,1,0
64687,445,0,0,70,70,0,1,0,1,0
50926,445,0,0,70,70,0,1,0,1,0
56793,445,0,0,69,69,0,1,0,1,0
54821,445,0,0,70,70,0,1,0,1,0
50429,445,0,0,70,70,0,1,0,1,0
50879,445,0,0,66,66,0,1,0,1,0
55561,445,0,0,70,70,0,1,0,1,0
51803,445,0,0,70,70,0,1,0,1,0
49337,445,0,0,70,70,0,1,0,1,0
57717,445,0,0,67,67,0,1,0,1,0
49795,445,0,0,67,67,0,1,0,1,0
49745,445,0,0,67,67,0,1,0,1,0
50760,445,0,0,70,70,0,1,0,1,0
59199,445,0,0,66,66,0,1,0,1,0
56774,445,0,0,67,67,0,1,0,1,0
56870,445,0,0,69,69,0,1,0,1,0
61412,445,0,0,66,66,0,1,0,1,0
49753,445,0,0,70,70,0,1,0,1,0
58060,445,0,0,67,67,0,1,0,1,0
64380,445,0,0,70,70,0,1,0,1,0
51143,445,0,0,69,69,0,1,0,1,0
64811,445,0,0,66,66,0,1,0,1,0
56555,445,0,0,70,70,0,1,0,1,0
57167,445,0,0,70,70,0,1,0,1,0
61906,445,0,0,69,69,0,1,0,1,0
55453,445,0,0,70,70,0,1,0,1,0
61463,445,0,0,70,70,0,1,0,1,0
61435,445,0,0,70,70,0,1,0,1,0
59789,445,0,0,70,70,0,1,0,1,0
55228,445,0,0,70,70,0,1,0,1,0
49267,445,0,0,70,70,0,1,0,1,0
50071,445,0,0,70,70,0,1,0,1,0
55214,445,0,0,66,66,0,1,0,1,0
57859,445,0,0,70,70,0,1,0,1,0
52725,445,0,0,66,66,0,1,0,1,0
51205,445,0,0,70,70,0,1,0,1,0
60566,445,0,0,67,67,0,1,0,1,0
64517,445,0,0,70,70,0,1,0,1,0
54857,445,0,0,66,66,0,1,0,1,0
59441,445,0,0,70,70,0,1,0,1,0
49854,445,0,0,67,67,0,1,0,1,0
64100,445,0,0,67,67,0,1,0,1,0
60243,445,0,0,70,70,0,1,0,1,0
54774,445,0,0,68,68,0,1,0,1,0
50946,445,0,0,70,70,0,1,0,1,0
58169,445,0,0,67,67,0,1,0,1,0
64900,445,0,0,70,70,0,1,0,1,0
58477,445,0,0,70,70,0,1,0,1,0
56804,445,0,0,70,70,0,1,0,1,0
58286,445,0,0,70,70,0,1,0,1,0
55097,445,0,0,70,70,0,1,0,1,0
50633,445,0,0,70,70,0,1,0,1,0
53930,445,0,0,66,66,0,1,0,1,0
51184,445,0,0,66,66,0,1,0,1,0
52497,445,0,0,70,70,0,1,0,1,0
50781,445,0,0,70,70,0,1,0,1,0
62324,445,0,0,70,70,0,1,0,1,0
64044,445,0,0,70,70,0,1,0,1,0
59760,445,0,0,70,70,0,1,0,1,0
62384,445,0,0,69,69,0,1,0,1,0
56729,445,0,0,70,70,0,1,0,1,0
50708,445,0,0,70,70,0,1,0,1,0
54847,445,0,0,70,70,0,1,0,1,0
61847,445,0,0,69,69,0,1,0,1,0
65198,445,0,0,66,66,0,1,0,1,0
64408,445,0,0,70,70,0,1,0,1,0
51038,445,0,0,70,70,0,1,0,1,0
52341,445,0,0,66,66,0,1,0,1,0
59935,445,0,0,66,66,0,1,0,1,0
54812,445,0,0,70,70,0,1,0,1,0
61724,445,0,0,66,66,0,1,0,1,0
61062,445,0,0,67,67,0,1,0,1,0
60726,445,0,0,70,70,0,1,0,1,0
64329,445,0,0,70,70,0,1,0,1,0
65233,445,0,0,70,70,0,1,0,1,0
55123,445,0,0,70,70,0,1,0,1,0
65306,445,0,0,68,68,0,1,0,1,0
50641,445,0,0,70,70,0,1,0,1,0
64708,445,0,0,67,67,0,1,0,1,0
60935,445,0,0,66,66,0,1,0,1,0
55891,445,0,0,66,66,0,1,0,1,0
53423,445,0,0,70,70,0,1,0,1,0
51790,445,0,0,70,70,0,1,0,1,0
58683,445,0,0,67,67,0,1,0,1,0
57346,445,0,0,66,66,0,1,0,1,0
56904,445,0,0,70,70,0,1,0,1,0
50049,445,0,0,70,70,0,1,0,1,0
56844,445,0,0,70,70,0,1,0,1,0
58821,445,0,0,70,70,0,1,0,1,0
63017,445,0,0,70,70,0,1,0,1,0
56073,445,0,0,70,70,0,1,0,1,0
54586,445,0,0,66,66,0,1,0,1,0
63770,445,0,0,70,70,0,1,0,1,0
57034,445,0,0,70,70,0,1,0,1,0
57655,445,0,0,68,68,0,1,0,1,0
55677,445,0,0,70,70,0,1,0,1,0
55133,445,0,0,70,70,0,1,0,1,0
55983,445,0,0,70,70,0,1,0,1,0
65199,445,0,0,70,70,0,1,0,1,0
55261,445,0,0,70,70,0,1,0,1,0
57356,445,0,0,70,70,0,1,0,1,0
55093,445,0,0,68,68,0,1,0,1,0
55121,445,0,0,70,70,0,1,0,1,0
54499,445,0,0,70,70,0,1,0,1,0
57930,445,0,0,70,70,0,1,0,1,0
50356,445,0,0,66,66,0,1,0,1,0
55850,445,0,0,70,70,0,1,0,1,0
52393,445,0,0,66,66,0,1,0,1,0
60970,445,0,0,68,68,0,1,0,1,0
58219,445,0,0,70,70,0,1,0,1,0
53718,445,0,0,70,70,0,1,0,1,0
50818,445,0,0,70,70,0,1,0,1,0
60953,445,0,0,66,66,0,1,0,1,0
55627,445,0,0,66,66,0,1,0,1,0
59534,445,0,0,70,70,0,1,0,1,0
53848,445,0,0,70,70,0,1,0,1,0
52137,445,0,0,66,66,0,1,0,1,0
58682,445,0,0,66,66,0,1,0,1,0
61077,445,0,0,70,70,0,1,0,1,0
60917,445,0,0,70,70,0,1,0,1,0
62583,445,0,0,70,70,0,1,0,1,0
57055,445,0,0,69,69,0,1,0,1,0
49921,445,0,0,70,70,0,1,0,1,0
64804,445,0,0,69,69,0,1,0,1,0
62872,445,0,0,69,69,0,1,0,1,0
53036,445,0,0,70,70,0,1,0,1,0
57268,445,0,0,68,68,0,1,0,1,0
62156,445,0,0,66,66,0,1,0,1,0
51549,445,0,0,70,70,0,1,0,1,0
57541,445,0,0,66,66,0,1,0,1,0
53496,445,0,0,66,66,0,1,0,1,0
51204,445,0,0,70,70,0,1,0,1,0
53030,445,0,0,70,70,0,1,0,1,0
55641,445,0,0,70,70,0,1,0,1,0
52579,445,0,0,68,68,0,1,0,1,0
64967,445,0,0,70,70,0,1,0,1,0
51047,445,0,0,67,67,0,1,0,1,0
54985,445,0,0,66,66,0,1,0,1,0
53936,445,0,0,66,66,0,1,0,1,0
53105,445,0,0,70,70,0,1,0,1,0
64356,445,0,0,67,67,0,1,0,1,0
63540,445,0,0,70,70,0,1,0,1,0
59501,445,0,0,70,70,0,1,0,1,0
64231,445,0,0,66,66,0,1,0,1,0
58090,445,0,0,70,70,0,1,0,1,0
62172,445,0,0,70,70,0,1,0,1,0
50225,445,0,0,70,70,0,1,0,1,0
53652,445,0,0,66,66,0,1,0,1,0
60174,445,0,0,69,69,0,1,0,1,0
63684,445,0,0,70,70,0,1,0,1,0
53643,445,0,0,68,68,0,1,0,1,0
59515,445,0,0,67,67,0,1,0,1,0
58835,445,0,0,66,66,0,1,0,1,0
63141,445,0,0,70,70,0,1,0,1,0
49604,445,0,0,70,70,0,1,0,1,0
61911,445,0,0,66,66,0,1,0,1,0
63717,445,0,0,68,68,0,1,0,1,0
55502,445,0,0,70,70,0,1,0,1,0
55044,445,0,0,70,70,0,1,0,1,0
51761,445,0,0,66,66,0,1,0,1,0
56839,445,0,0,70,70,0,1,0,1,0
55417,445,0,0,66,66,0,1,0,1,0
49253,445,0,0,68,68,0,1,0,1,0
52786,445,0,0,70,70,0,1,0,1,0
50475,445,0,0,66,66,0,1,0,1,0
64358,445,0,0,70,70,0,1,0,1,0
55639,445,0,0,70,70,0,1,0,1,0
58342,445,0,0,70,70,0,1,0,1,0
64806,445,0,0,66,66,0,1,0,1,0
54694,445,0,0,70,70,0,1,0,1,0
49350,445,0,0,67,67,0,1,0,1,0
61439,445,0,0,70,70,0,1,0,1,0
55235,445,0,0,70,70,0,1,0,1,0
54049,445,0,0,67,67,0,1,0,1,0
64658,445,0,0,70,70,0,1,0,1,0
50847,445,0,0,66,66,0,1,0,1,0
50802,445,0,0,66,66,0,1,0,1,0
53369,445,0,0,66,66,0,1,0,1,0
62386,445,0,0,68,68,0,1,0,1,0
51413,445,0,0,70,70,0,1,0,1,0
58153,445,0,0,70,70,0,1,0,1,0
53773,445,0,0,66,66,0,1,0,1,0
58754,445,0,0,66,66,0,1,0,1,0
61332,445,0,0,66,66,0,1,0,1,0
51587,445,0,0,70,70,0,1,0,1,0
54060,445,0,0,66,66,0,1,0,1,0
56772,445,0,0,70,70,0,1,0,1,0
65443,445,0,0,70,70,0,1,0,1,0
62973,445,0,0,70,70,0,1,0,1,0
54720,445,0,0,66,66,0,1,0,1,0
50505,445,0,0,70,70,0,1,0,1,0
57480,445,0,0,66,66,0,1,0,1,0
59887,445,0,0,70,70,0,1,0,1,0
54386,445,0,0,70,70,0,1,0,1,0
51825,445,0,0,68,68,0,1,0,1,0
64330,445,0,0,67,67,0,1,0,1,0
60050,445,0,0,66,66,0,1,0,1,0
53347,445,0,0,66,66,0,1,0,1,0
53590,445,0,0,70,70,0,1,0,1,0
58638,445,0,0,70,70,0,1,0,1,0
60245,445,0,0,66,66,0,1,0,1,0
62430,445,0,0,70,70,0,1,0,1,0
57986,445,0,0,70,70,0,1,0,1,0
59013,445,0,0,70,70,0,1,0,1,0
54087,445,0,0,69,69,0,1,0,1,0
49643,445,0,0,70,70,0,1,0,1,0
60854,445,0,0,70,70,0,1,0,1,0
51912,445,0,0,70,70,0,1,0,1,0
56893,445,0,0,69,69,0,1,0,1,0
49737,445,0,0,69,69,0,1,0,1,0
53268,445,0,0,68,68,0,1,0,1,0
57906,445,0,0,70,70,0,1,0,1,0
49891,445,0,0,66,66,0,1,0,1,0
51439,445,0,0,67,67,0,1,0,1,0
56464,445,0,0,70,70,0,1,0,1,0
58282,445,0,0,66,66,0,1,0,1,0
59761,445,0,0,70,70,0,1,0,1,0
62819,445,0,0,69,69,0,1,0,1,0
64716,445,0,0,70,70,0,1,0,1,0
64814,445,0,0,70,70,0,1,0,1,0
60346,445,0,0,70,70,0,1,0,1,0
49863,445,0,0,70,70,0,1,0,1,0
53167,445,0,0,67,67,0,1,0,1,0
54173,445,0,0,70,70,0,1,0,1,0
51312,445,0,0,70,70,0,1,0,1,0
59012,445,0,0,70,70,0,1,0,1,0
64264,445,0,0,70,70,0,1,0,1,0
65183,445,0,0,70,70,0,1,0,1,0
50311,445,0,0,67,67,0,1,0,1,0
50783,445,0,0,70,70,0,1,0,1,0
64291,445,0,0,66,66,0,1,0,1,0
57394,445,0,0,70,70,0,1,0,1,0
54392,445,0,0,66,66,0,1,0,1,0
56772,445,0,0,70,70,0,1,0,1,0
61182,445,0,0,70,70,0,1,0,1,0
60664,445,0,0,70,70,0,1,0,1,0
56240,445,0,0,70,70,0,1,0,1,0
55060,445,0,0,66,66,0,1,0,1,0
59146,445,0,0,66,66,0,1,0,1,0
58540,445,0,0,70,70,0,1,0,1,0
54400,445,0,0,70,70,0,1,0,1,0
60405,445,0,0,66,66,0,1,0,1,0
49327,445,0,0,66,66,0,1,0,1,0
56545,445,0,0,70,70,0,1,0,1,0
58794,445,0,0,70,70,0,1,0,1,0
53824,445,0,0,66,66,0,1,0,1,0
63929,445,0,0,70,70,0,1,0,1,0
57963,445,0,0,70,70,0,1,0,1,0
62074,445,0,0,68,68,0,1,0,1,0
53742,445,0,0,70,70,0,1,0,1,0
50511,445,0,0,70,70,0,1,0,1,0
54331,445,0,0,70,70,0,1,0,1,0
64419,445,0,0,66,66,0,1,0,1,0
54793,445,0,0,70,70,0,1,0,1,0
60922,445,0,0,70,70,0,1,0,1,0
55263,445,0,0,70,70,0,1,0,1,0
49382,445,0,0,66,66,0,1,0,1,0
57946,445,0,0,68,68,0,1,0,1,0
51067,445,0,0,66,66,0,1,0,1,0
56871,445,0,0,70,70,0,1,0,1,0
62742,445,0,0,66,66,0,1,0,1,0
61086,445,0,0,70,70,0,1,0,1,0
55440,445,0,0,70,70,0,1,0,1,0
55300,445,0,0,70,70,0,1,0,1,0
65331,445,0,0,70,70,0,1,0,1,0
62717,445,0,0,69,69,0,1,0,1,0
60050,445,0,0,66,66,0,1,0,1,0
53523,445,0,0,69,69,0,1,0,1,0
55340,445,0,0,70,70,0,1,0,1,0
53074,445,0,0,70,70,0,1,0,1,0
53747,445,0,0,70,70,0,1,0,1,0
57541,445,0,0,68,68,0,1,0,1,0
55259,445,0,0,70,70,0,1,0,1,0
56051,445,0,0,70,70,0,1,0,1,0
50812,445,0,0,70,70,0,1,0,1,0
49504,445,0,0,70,70,0,1,0,1,0
57708,445,0,0,68,68,0,1,0,1,0
64928,445,0,0,70,70,0,1,0,1,0
62227,445,0,0,70,70,0,1,0,1,0
52915,445,0,0,66,66,0,1,0,1,0
57527,445,0,0,66,66,0,1,0,1,0
62034,445,0,0,66,66,0,1,0,1,0
61949,445,0,0,70,70,0,1,0,1,0
54858,445,0,0,66,66,0,1,0,1,0
51103,445,0,0,66,66,0,1,0,1,0
50319,445,0,0,70,70,0,1,0,1,0
63177,445,0,0,67,67,0,1,0,1,0
50106,445,0,0,70,70,0,1,0,1,0
50603,445,0,0,67,67,0,1,0,1,0
56593,445,0,0,70,70,0,1,0,1,0
64101,445,0,0,66,66,0,1,0,1,0
63003,445,0,0,70,70,0,1,0,1,0
64095,445,0,0,70,70,0,1,0,1,0
60040,445,0,0,70,70,0,1,0,1,0
52985,445,0,0,66,66,0,1,0,1,0
64826,445,0,0,67,67,0,1,0,1,0
50820,445,0,0,70,70,0,1,0,1,0
49304,445,0,0,70,70,0,1,0,1,0
61817,445,0,0,68,68,0,1,0,1,0
58518,445,0,0,66,66,0,1,0,1,0
51961,445,0,0,68,68,0,1,0,1,0
64629,445,0,0,67,67,0,1,0,1,0
58401,445,0,0,70,70,0,1,0,1,0
56987,445,0,0,70,70,0,1,0,1,0
63984,445,0,0,70,70,0,1,0,1,0
62122,445,0,0,70,70,0,1,0,1,0
52562,445,0,0,70,70,0,1,0,1,0
51524,445,0,0,68,68,0,1,0,1,0
52138,445,0,0,66,66,0,1,0,1,0
50163,445,0,0,70,70,0,1,0,1,0
62431,445,0,0,67,67,0,1,0,1,0
62981,445,0,0,70,70,0,1,0,1,0
59061,445,0,0,70,70,0,1,0,1,0
49661,445,0,0,70,70,0,1,0,1,0
56102,445,0,0,70,70,0,1,0,1,0
57258,445,0,0,70,70,0,1,0,1,0
50265,445,0,0,70,70,0,1,0,1,0
50000,445,0,0,70,70,0,1,0,1,0
50756,445,0,0,66,66,0,1,0,1,0
60191,445,0,0,70,70,0,1,0,1,0
64899,445,0,0,70,70,0,1,0,1,0
56900,445,0,0,66,66,0,1,0,1,0
59147,445,0,0,70,70,0,1,0,1,0
60997,445,0,0,70,70,0,1,0,1,0
55240,445,0,0,68,68,0,1,0,1,0
52790,445,0,0,70,70,0,1,0,1,0
63132,445,0,0,66,66,0,1,0,1,0
55607,445,0,0,66,66,0,1,0,1,0
63020,445,0,0,70,70,0,1,0,1,0
62596,445,0,0,68,68,0,1,0,1,0
65405,445,0,0,70,70,0,1,0,1,0
63272,445,0,0,70,70,0,1,0,1,0
54441,445,0,0,70,70,0,1,0,1,0
60347,445,0,0,70,70,0,1,0,1,0
54048,445,0,0,70,70,0,1,0,1,0
57602,445,0,0,69,69,0,1,0,1,0
54972,445,0,0,66,66,0,1,0,1,0
53609,445,0,0,70,70,0,1,0,1,0
51933,445,0,0,70,70,0,1,0,1,0
64030,445,0,0,70,70,0,1,0,1,0
62500,445,0,0,70,70,0,1,0,1,0
65001,445,0,0,70,70,0,1,0,1,0
61228,445,0,0,70,70,0,1,0,1,0
52522,445,0,0,70,70,0,1,0,1,0
63542,445,0,0,68,68,0,1,0,1,0
59327,445,0,0,69,69,0,1,0,1,0
57221,445,0,0,66,66,0,1,0,1,0
62429,445,0,0,70,70,0,1,0,1,0
58115,445,0,0,70,70,0,1,0,1,0
51084,445,0,0,70,70,0,1,0,1,0
59937,445,0,0,69,69,0,1,0,1,0
62389,445,0,0,66,66,0,1,0,1,0
51621,445,0,0,70,70,0,1,0,1,0
52604,445,0,0,70,70,0,1,0,1,0
51399,445,0,0,70,70,0,1,0,1,0
61115,445,0,0,70,70,0,1,0,1,0
54873,445,0,0,70,70,0,1,0,1,0
54660,445,0,0,70,70,0,1,0,1,0
64048,445,0,0,70,70,0,1,0,1,0
51221,445,0,0,66,66,0,1,0,1,0
59500,445,0,0,70,70,0,1,0,1,0
52326,445,0,0,66,66,0,1,0,1,0
63212,445,0,0,70,70,0,1,0,1,0
63416,445,0,0,66,66,0,1,0,1,0
64100,445,0,0,67,67,0,1,0,1,0
53415,445,0,0,70,70,0,1,0,1,0
54573,445,0,0,66,66,0,1,0,1,0
62699,445,0,0,69,69,0,1,0,1,0
50040,445,0,0,70,70,0,1,0,1,0
49739,445,0,0,67,67,0,1,0,1,0
64486,445,0,0,67,67,0,1,0,1,0
61827,445,0,0,70,70,0,1,0,1,0
65197,445,0,0,70,70,0,1,0,1,0
56661,445,0,0,69,69,0,1,0,1,0
52094,445,0,0,70,70,0,1,0,1,0
54919,445,0,0,70,70,0,1,0,1,0
60410,445,0,0,70,70,0,1,0,1,0
57159,445,0,0,70,70,0,1,0,1,0
54590,445,0,0,70,70,0,1,0,1,0
55108,445,0,0,70,70,0,1,0,1,0
61911,445,0,0,66,66,0,1,0,1,0
55337,445,0,0,70,70,0,1,0,1,0
58860,445,0,0,70,70,0,1,0,1,0
55041,445,0,0,70,70,0,1,0,1,0
61434,445,0,0,70,70,0,1,0,1,0
57160,445,0,0,70,70,0,1,0,1,0
50138,445,0,0,70,70,0,1,0,1,0
55497,445,0,0,66,66,0,1,0,1,0
55431,445,0,0,70,70,0,1,0,1,0
60593,445,0,0,68,68,0,1,0,1,0
59475,445,0,0,66,66,0,1,0,1,0
59759,445,0,0,70,70,0,1,0,1,0
51655,445,0,0,70,70,0,1,0,1,0
50204,445,0,0,70,70,0,1,0,1,0
53282,445,0,0,69,69,0,1,0,1,0
57929,445,0,0,70,70,0,1,0,1,0
59500,445,0,0,70,70,0,1,0,1,0
53493,445,0,0,70,70,0,1,0,1,0
60397,445,0,0,70,70,0,1,0,1,0
61626,445,0,0,70,70,0,1,0,1,0
52474,445,0,0,70,70,0,1,0,1,0
51540,445,0,0,70,70,0,1,0,1,0
58796,445,0,0,70,70,0,1,0,1,0
63873,445,0,0,66,66,0,1,0,1,0
56046,445,0,0,68,68,0,1,0,1,0
50228,445,0,0,68,68,0,1,0,1,0
58216,445,0,0,70,70,0,1,0,1,0
58691,445,0,0,66,66,0,1,0,1,0
49466,445,0,0,68,68,0,1,0,1,0
50400,445,0,0,70,70,0,1,0,1,0
51452,445,0,0,70,70,0,1,0,1,0
57970,445,0,0,66,66,0,1,0,1,0
63179,445,0,0,70,70,0,1,0,1,0
51856,445,0,0,66,66,0,1,0,1,0
52401,445,0,0,70,70,0,1,0,1,0
62543,445,0,0,66,66,0,1,0,1,0
50288,445,0,0,66,66,0,1,0,1,0
53524,445,0,0,66,66,0,1,0,1,0
50255,445,0,0,70,70,0,1,0,1,0
51560,445,0,0,70,70,0,1,0,1,0
57867,445,0,0,66,66,0,1,0,1,0
51339,445,0,0,70,70,0,1,0,1,0
60443,445,0,0,70,70,0,1,0,1,0
62913,445,0,0,70,70,0,1,0,1,0
55532,445,0,0,70,70,0,1,0,1,0
58933,445,0,0,67,67,0,1,0,1,0
61098,445,0,0,67,67,0,1,0,1,0
64882,445,0,0,66,66,0,1,0,1,0
54458,445,0,0,70,70,0,1,0,1,0
65058,445,0,0,70,70,0,1,0,1,0
56910,445,0,0,70,70,0,1,0,1,0
55164,445,0,0,66,66,0,1,0,1,0
63440,445,0,0,70,70,0,1,0,1,0
51723,445,0,0,70,70,0,1,0,1,0
61888,445,0,0,70,70,0,1,0,1,0
54278,445,0,0,68,68,0,1,0,1,0
62563,445,0,0,68,68,0,1,0,1,0
58938,445,0,0,69,69,0,1,0,1,0
59531,445,0,0,66,66,0,1,0,1,0
62149,445,0,0,70,70,0,1,0,1,0
55568,445,0,0,70,70,0,1,0,1,0
62301,445,0,0,70,70,0,1,0,1,0
54183,445,0,0,70,70,0,1,0,1,0
53963,445,0,0,70,70,0,1,0,1,0
61744,445,0,0,68,68,0,1,0,1,0
56750,445,0,0,68,68,0,1,0,1,0
49287,445,0,0,68,68,0,1,0,1,0
60437,445,0,0,66,66,0,1,0,1,0
51766,445,0,0,69,69,0,1,0,1,0
56486,445,0,0,68,68,0,1,0,1,0
59967,445,0,0,68,68,0,1,0,1,0
65481,445,0,0,68,68,0,1,0,1,0
56955,445,0,0,70,70,0,1,0,1,0
55011,445,0,0,70,70,0,1,0,1,0
65322,445,0,0,66,66,0,1,0,1,0
62866,445,0,0,70,70,0,1,0,1,0
65327,445,0,0,70,70,0,1,0,1,0
54666,445,0,0,66,66,0,1,0,1,0
56683,445,0,0,70,70,0,1,0,1,0
64192,445,0,0,69,69,0,1,0,1,0
55514,445,0,0,70,70,0,1,0,1,0
54531,445,0,0,70,70,0,1,0,1,0
59904,445,0,0,67,67,0,1,0,1,0
55287,445,0,0,66,66,0,1,0,1,0
60851,445,0,0,70,70,0,1,0,1,0
64949,445,0,0,70,70,0,1,0,1,0
62663,445,0,0,69,69,0,1,0,1,0
62428,445,0,0,70,70,0,1,0,1,0
56259,445,0,0,66,66,0,1,0,1,0
62125,445,0,0,66,66,0,1,0,1,0
56374,445,0,0,66,66,0,1,0,1,0
54536,445,0,0,70,70,0,1,0,1,0
55856,445,0,0,68,68,0,1,0,1,0
50491,445,0,0,70,70,0,1,0,1,0
63234,445,0,0,70,70,0,1,0,1,0
52078,445,0,0,70,70,0,1,0,1,0
64501,445,0,0,70,70,0,1,0,1,0
57732,445,0,0,66,66,0,1,0,1,0
56968,445,0,0,66,66,0,1,0,1,0
59602,445,0,0,70,70,0,1,0,1,0
58995,445,0,0,70,70,0,1,0,1,0
60938,445,0,0,69,69,0,1,0,1,0
54189,445,0,0,70,70,0,1,0,1,0
56406,445,0,0,69,69,0,1,0,1,0
60017,445,0,0,70,70,0,1,0,1,0
63828,445,0,0,66,66,0,1,0,1,0
50339,445,0,0,67,67,0,1,0,1,0
56432,445,0,0,70,70,0,1,0,1,0
56024,445,0,0,70,70,0,1,0,1,0
50298,445,0,0,70,70,0,1,0,1,0
50610,445,0,0,70,70,0,1,0,1,0
55913,445,0,0,70,70,0,1,0,1,0
56021,445,0,0,67,67,0,1,0,1,0
50432,445,0,0,70,70,0,1,0,1,0
50528,445,0,0,70,70,0,1,0,1,0
55635,445,0,0,69,69,0,1,0,1,0
54659,445,0,0,70,70,0,1,0,1,0
65457,445,0,0,70,70,0,1,0,1,0
53980,445,0,0,70,70,0,1,0,1,0
57277,445,0,0,70,70,0,1,0,1,0
63107,445,0,0,70,70,0,1,0,1,0
51457,445,0,0,70,70,0,1,0,1,0
59725,445,0,0,67,67,0,1,0,1,0
50603,445,0,0,66,66,0,1,0,1,0
49790,445,0,0,70,70,0,1,0,1,0
61386,445,0,0,66,66,0,1,0,1,0
62781,445,0,0,70,70,0,1,0,1,0
60356,445,0,0,66,66,0,1,0,1,0
65501,445,0,0,69,69,0,1,0,1,0
60948,445,0,0,70,70,0,1,0,1,0
59844,445,0,0,69,69,0,1,0,1,0
60915,445,0,0,70,70,0,1,0,1,0
60038,445,0,0,70,70,0,1,0,1,0
50886,445,0,0,66,66,0,1,0,1,0
64855,445,0,0,68,68,0,1,0,1,0
49285,445,0,0,66,66,0,1,0,1,0
53436,445,0,0,70,70,0,1,0,1,0
55311,445,0,0,70,70,0,1,0,1,0
53168,445,0,0,66,66,0,1,0,1,0
62868,445,0,0,70,70,0,1,0,1,0
60243,445,0,0,70,70,0,1,0,1,0
60818,445,0,0,70,70,0,1,0,1,0
61878,445,0,0,67,67,0,1,0,1,0
49809,445,0,0,70,70,0,1,0,1,0
54053,445,0,0,70,70,0,1,0,1,0
52690,445,0,0,70,70,0,1,0,1,0
50466,445,0,0,66,66,0,1,0,1,0
54846,445,0,0,66,66,0,1,0,1,0
51879,445,0,0,70,70,0,1,0,1,0
50110,445,0,0,70,70,0,1,0,1,0
55992,445,0,0,70,70,0,1,0,1,0
53939,445,0,0,66,66,0,1,0,1,0
50480,445,0,0,66,66,0,1,0,1,0
53177,445,0,0,70,70,0,1,0,1,0
56426,445,0,0,70,70,0,1,0,1,0
64729,445,0,0,66,66,0,1,0,1,0
65466,445,0,0,68,68,0,1,0,1,0
60130,445,0,0,68,68,0,1,0,1,0
54455,445,0,0,70,70,0,1,0,1,0
65531,445,0,0,67,67,0,1,0,1,0
58710,445,0,0,67,67,0,1,0,1,0
55640,445,0,0,70,70,0,1,0,1,0
50054,445,0,0,70,70,0,1,0,1,0
54668,445,0,0,70,70,0,1,0,1,0
57395,445,0,0,66,66,0,1,0,1,0
51374,445,0,0,66,66,0,1,0,1,0
53912,445,0,0,70,70,0,1,0,1,0
65482,445,0,0,70,70,0,1,0,1,0
59738,445,0,0,70,70,0,1,0,1,0
61888,445,0,0,70,70,0,1,0,1,0
57230,445,0,0,70,70,0,1,0,1,0
54056,445,0,0,70,70,0,1,0,1,0
56898,445,0,0,70,70,0,1,0,1,0
53900,445,0,0,70,70,0,1,0,1,0
53686,445,0,0,66,66,0,1,0,1,0
60417,445,0,0,66,66,0,1,0,1,0
56357,445,0,0,70,70,0,1,0,1,0
58483,445,0,0,66,66,0,1,0,1,0
54017,445,0,0,70,70,0,1,0,1,0
50069,445,0,0,70,70,0,1,0,1,0
56382,445,0,0,66,66,0,1,0,1,0
57373,445,0,0,66,66,0,1,0,1,0
64707,445,0,0,66,66,0,1,0,1,0
59987,445,0,0,70,70,0,1,0,1,0
59591,445,0,0,66,66,0,1,0,1,0
57045,445,0,0,68,68,0,1,0,1,0
52533,445,0,0,70,70,0,1,0,1,0
61056,445,0,0,70,70,0,1,0,1,0
50379,445,0,0,70,70,0,1,0,1,0
61857,445,0,0,69,69,0,1,0,1,0
61739,445,0,0,67,67,0,1,0,1,0
55268,445,0,0,70,70,0,1,0,1,0
52679,445,0,0,70,70,0,1,0,1,0
50609,445,0,0,70,70,0,1,0,1,0
50371,445,0,0,66,66,0,1,0,1,0
53579,445,0,0,67,67,0,1,0,1,0
55229,445,0,0,70,70,0,1,0,1,0
57431,445,0,0,70,70,0,1,0,1,0
58547,445,0,0,70,70,0,1,0,1,0
63728,445,0,0,70,70,0,1,0,1,0
60955,445,0,0,66,66,0,1,0,1,0
60816,445,0,0,70,70,0,1,0,1,0
52789,445,0,0,70,70,0,1,0,1,0
53416,445,0,0,69,69,0,1,0,1,0
50428,445,0,0,70,70,0,1,0,1,0
52210,445,0,0,69,69,0,1,0,1,0
54306,445,0,0,70,70,0,1,0,1,0
53390,445,0,0,70,70,0,1,0,1,0
50417,445,0,0,70,70,0,1,0,1,0
54518,445,0,0,70,70,0,1,0,1,0
63518,445,0,0,66,66,0,1,0,1,0
64393,445,0,0,68,68,0,1,0,1,0
63588,445,0,0,68,68,0,1,0,1,0
62422,445,0,0,67,67,0,1,0,1,0
53291,445,0,0,66,66,0,1,0,1,0
56893,445,0,0,70,70,0,1,0,1,0
53308,445,0,0,66,66,0,1,0,1,0
57648,445,0,0,70,70,0,1,0,1,0
60149,445,0,0,70,70,0,1,0,1,0
55546,445,0,0,68,68,0,1,0,1,0
61750,445,0,0,70,70,0,1,0,1,0
50162,445,0,0,70,70,0,1,0,1,0
62468,445,0,0,70,70,0,1,0,1,0
60245,445,0,0,66,66,0,1,0,1,0
51523,445,0,0,66,66,0,1,0,1,0
63362,445,0,0,70,70,0,1,0,1,0
54412,445,0,0,70,70,0,1,0,1,0
60423,445,0,0,70,70,0,1,0,1,0
58906,445,0,0,70,70,0,1,0,1,0
58062,445,0,0,70,70,0,1,0,1,0
59662,445,0,0,69,69,0,1,0,1,0
49852,445,0,0,70,70,0,1,0,1,0
50864,445,0,0,66,66,0,1,0,1,0
60174,445,0,0,66,66,0,1,0,1,0
50612,445,0,0,70,70,0,1,0,1,0
54504,445,0,0,66,66,0,1,0,1,0
62358,445,0,0,69,69,0,1,0,1,0
50755,445,0,0,70,70,0,1,0,1,0
49505,445,0,0,69,69,0,1,0,1,0
58446,445,0,0,70,70,0,1,0,1,0
54526,445,0,0,69,69,0,1,0,1,0
57797,445,0,0,66,66,0,1,0,1,0
56979,445,0,0,70,70,0,1,0,1,0
57229,445,0,0,70,70,0,1,0,1,0
65057,445,0,0,70,70,0,1,0,1,0
50483,445,0,0,66,66,0,1,0,1,0
63266,445,0,0,70,70,0,1,0,1,0
52053,445,0,0,70,70,0,1,0,1,0
54206,445,0,0,68,68,0,1,0,1,0
62743,445,0,0,66,66,0,1,0,1,0
59378,445,0,0,70,70,0,1,0,1,0
53176,445,0,0,68,68,0,1,0,1,0
52624,445,0,0,70,70,0,1,0,1,0
54289,445,0,0,66,66,0,1,0,1,0
58147,445,0,0,70,70,0,1,0,1,0
49214,445,0,0,70,70,0,1,0,1,0
55290,445,0,0,70,70,0,1,0,1,0
50591,445,0,0,70,70,0,1,0,1,0
60249,445,0,0,66,66,0,1,0,1,0
56688,445,0,0,68,68,0,1,0,1,0
53595,445,0,0,70,70,0,1,0,1,0
59732,445,0,0,70,70,0,1,0,1,0
58447,445,0,0,70,70,0,1,0,1,0
55841,445,0,0,70,70,0,1,0,1,0
56708,445,0,0,66,66,0,1,0,1,0
60969,445,0,0,66,66,0,1,0,1,0
55876,445,0,0,66,66,0,1,0,1,0
59374,445,0,0,70,70,0,1,0,1,0
52401,445,0,0,70,70,0,1,0,1,0
50848,445,0,0,66,66,0,1,0,1,0
63811,445,0,0,67,67,0,1,0,1,0
64070,445,0,0,70,70,0,1,0,1,0
51699,445,0,0,66,66,0,1,0,1,0
53254,445,0,0,68,68,0,1,0,1,0
49401,445,0,0,69,69,0,1,0,1,0
59970,445,0,0,70,70,0,1,0,1,0
50123,445,0,0,70,70,0,1,0,1,0
53649,445,0,0,67,67,0,1,0,1,0
63497,445,0,0,66,66,0,1,0,1,0
55743,445,0,0,70,70,0,1,0,1,0
61446,445,0,0,67,67,0,1,0,1,0
52267,445,0,0,70,70,0,1,0,1,0
52200,445,0,0,66,66,0,1,0,1,0
54489,445,0,0,70,70,0,1,0,1,0
53588,445,0,0,70,70,0,1,0,1,0
63325,445,0,0,70,70,0,1,0,1,0
60119,445,0,0,66,66,0,1,0,1,0
55268,445,0,0,70,70,0,1,0,1,0
56814,445,0,0,68,68,0,1,0,1,0
57718,445,0,0,70,70,0,1,0,1,0
53223,445,0,0,69,69,0,1,0,1,0
50699,445,0,0,70,70,0,1,0,1,0
58279,445,0,0,68,68,0,1,0,1,0
63843,445,0,0,66,66,0,1,0,1,0
50544,445,0,0,66,66,0,1,0,1,0
63240,445,0,0,66,66,0,1,0,1,0
50308,445,0,0,70,70,0,1,0,1,0
62231,445,0,0,70,70,0,1,0,1,0
64488,445,0,0,70,70,0,1,0,1,0
56960,445,0,0,70,70,0,1,0,1,0
58866,445,0,0,67,67,0,1,0,1,0
61221,445,0,0,70,70,0,1,0,1,0
64659,445,0,0,66,66,0,1,0,1,0
52593,445,0,0,69,69,0,1,0,1,0
50305,445,0,0,70,70,0,1,0,1,0
62393,445,0,0,69,69,0,1,0,1,0
51102,445,0,0,70,70,0,1,0,1,0
61590,445,0,0,66,66,0,1,0,1,0
59917,445,0,0,70,70,0,1,0,1,0
64294,445,0,0,70,70,0,1,0,1,0
53844,445,0,0,69,69,0,1,0,1,0
61141,445,0,0,70,70,0,1,0,1,0
55085,445,0,0,70,70,0,1,0,1,0
61993,445,0,0,67,67,0,1,0,1,0
55641,445,0,0,70,70,0,1,0,1,0
61884,445,0,0,66,66,0,1,0,1,0
49907,445,0,0,66,66,0,1,0,1,0
53527,445,0,0,70,70,0,1,0,1,0
65238,445,0,0,70,70,0,1,0,1,0
57089,445,0,0,67,67,0,1,0,1,0
61016,445,0,0,70,70,0,1,0,1,0
56311,445,0,0,70,70,0,1,0,1,0
61015,445,0,0,66,66,0,1,0,1,0
53208,445,0,0,70,70,0,1,0,1,0
56480,445,0,0,67,67,0,1,0,1,0
51747,445,0,0,70,70,0,1,0,1,0
61933,445,0,0,70,70,0,1,0,1,0
63512,445,0,0,66,66,0,1,0,1,0
63540,445,0,0,70,70,0,1,0,1,0
56805,445,0,0,70,70,0,1,0,1,0
50351,445,0,0,66,66,0,1,0,1,0
53930,445,0,0,66,66,0,1,0,1,0
49805,445,0,0,70,70,0,1,0,1,0
59760,445,0,0,70,70,0,1,0,1,0
63454,445,0,0,66,66,0,1,0,1,0
65145,445,0,0,70,70,0,1,0,1,0
63777,445,0,0,66,66,0,1,0,1,0
62340,445,0,0,70,70,0,1,0,1,0
53980,445,0,0,70,70,0,1,0,1,0
59984,445,0,0,70,70,0,1,0,1,0
62498,445,0,0,70,70,0,1,0,1,0
63767,445,0,0,70,70,0,1,0,1,0
55031,445,0,0,70,70,0,1,0,1,0
56899,445,0,0,67,67,0,1,0,1,0
50466,445,0,0,66,66,0,1,0,1,0
57861,445,0,0,66,66,0,1,0,1,0
63108,445,0,0,70,70,0,1,0,1,0
64641,445,0,0,70,70,0,1,0,1,0
60064,445,0,0,70,70,0,1,0,1,0
64459,445,0,0,70,70,0,1,0,1,0
52497,445,0,0,70,70,0,1,0,1,0
63972,445,0,0,66,66,0,1,0,1,0
64243,445,0,0,70,70,0,1,0,1,0
59466,445,0,0,67,67,0,1,0,1,0
58015,445,0,0,68,68,0,1,0,1,0
60863,445,0,0,70,70,0,1,0,1,0
61790,445,0,0,66,66,0,1,0,1,0
62574,445,0,0,68,68,0,1,0,1,0
62995,445,0,0,70,70,0,1,0,1,0
62491,445,0,0,66,66,0,1,0,1,0
61737,445,0,0,69,69,0,1,0,1,0
62685,445,0,0,70,70,0,1,0,1,0
63904,445,0,0,66,66,0,1,0,1,0
60057,445,0,0,70,70,0,1,0,1,0
51860,445,0,0,69,69,0,1,0,1,0
55883,445,0,0,70,70,0,1,0,1,0
50424,445,0,0,66,66,0,1,0,1,0
65179,445,0,0,67,67,0,1,0,1,0
57557,445,0,0,66,66,0,1,0,1,0
52851,445,0,0,68,68,0,1,0,1,0
64071,445,0,0,70,70,0,1,0,1,0
49581,445,0,0,70,70,0,1,0,1,0
62166,445,0,0,66,66,0,1,0,1,0
64211,445,0,0,66,66,0,1,0,1,0
65077,445,0,0,70,70,0,1,0,1,0
64247,445,0,0,70,70,0,1,0,1,0
63306,445,0,0,66,66,0,1,0,1,0
55471,445,0,0,67,67,0,1,0,1,0
53431,445,0,0,69,69,0,1,0,1,0
65268,445,0,0,66,66,0,1,0,1,0
58670,445,0,0,70,70,0,1,0,1,0
57906,445,0,0,68,68,0,1,0,1,0
61469,445,0,0,70,70,0,1,0,1,0
57377,445,0,0,66,66,0,1,0,1,0
63775,445,0,0,66,66,0,1,0,1,0
54840,445,0,0,69,69,0,1,0,1,0
54748,445,0,0,70,70,0,1,0,1,0
59227,445,0,0,70,70,0,1,0,1,0
58005,445,0,0,70,70,0,1,0,1,0
53045,445,0,0,66,66,0,1,0,1,0
51883,445,0,0,66,66,0,1,0,1,0
55198,445,0,0,70,70,0,1,0,1,0
65306,445,0,0,66,66,0,1,0,1,0
50312,445,0,0,66,66,0,1,0,1,0
58372,445,0,0,68,68,0,1,0,1,0
51038,445,0,0,70,70,0,1,0,1,0
49353,445,0,0,68,68,0,1,0,1,0
65502,445,0,0,67,67,0,1,0,1,0
55072,445,0,0,70,70,0,1,0,1,0
63879,445,0,0,70,70,0,1,0,1,0
63004,445,0,0,66,66,0,1,0,1,0
62401,445,0,0,70,70,0,1,0,1,0
57607,445,0,0,66,66,0,1,0,1,0
55776,445,0,0,70,70,0,1,0,1,0
52853,445,0,0,66,66,0,1,0,1,0
54047,445,0,0,70,70,0,1,0,1,0
55806,445,0,0,66,66,0,1,0,1,0
54970,445,0,0,66,66,0,1,0,1,0
56872,445,0,0,70,70,0,1,0,1,0
49265,445,0,0,70,70,0,1,0,1,0
63229,445,0,0,66,66,0,1,0,1,0
57985,445,0,0,66,66,0,1,0,1,0
64454,445,0,0,70,70,0,1,0,1,0
55359,445,0,0,70,70,0,1,0,1,0
49303,445,0,0,70,70,0,1,0,1,0
63748,445,0,0,70,70,0,1,0,1,0
49778,445,0,0,66,66,0,1,0,1,0
56969,445,0,0,66,66,0,1,0,1,0
62885,445,0,0,69,69,0,1,0,1,0
55141,445,0,0,69,69,0,1,0,1,0
54108,445,0,0,70,70,0,1,0,1,0
55469,445,0,0,69,69,0,1,0,1,0
56480,445,0,0,66,66,0,1,0,1,0
51729,445,0,0,66,66,0,1,0,1,0
50484,445,0,0,66,66,0,1,0,1,0
62303,445,0,0,70,70,0,1,0,1,0
49912,445,0,0,70,70,0,1,0,1,0
63874,445,0,0,70,70,0,1,0,1,0
62433,445,0,0,69,69,0,1,0,1,0
53805,445,0,0,66,66,0,1,0,1,0
51202,445,0,0,70,70,0,1,0,1,0
54444,445,0,0,67,67,0,1,0,1,0
63787,445,0,0,66,66,0,1,0,1,0
59147,445,0,0,66,66,0,1,0,1,0
58684,445,0,0,70,70,0,1,0,1,0
51946,445,0,0,70,70,0,1,0,1,0
54996,445,0,0,69,69,0,1,0,1,0
50929,445,0,0,66,66,0,1,0,1,0
58398,445,0,0,66,66,0,1,0,1,0
61090,445,0,0,70,70,0,1,0,1,0
56654,445,0,0,68,68,0,1,0,1,0
54349,445,0,0,70,70,0,1,0,1,0
57012,445,0,0,66,66,0,1,0,1,0
53292,445,0,0,70,70,0,1,0,1,0
59713,445,0,0,70,70,0,1,0,1,0
49998,445,0,0,70,70,0,1,0,1,0
59532,445,0,0,68,68,0,1,0,1,0
62997,445,0,0,66,66,0,1,0,1,0
58501,445,0,0,70,70,0,1,0,1,0
56339,445,0,0,70,70,0,1,0,1,0
65501,445,0,0,67,67,0,1,0,1,0
49252,445,0,0,69,69,0,1,0,1,0
64499,445,0,0,70,70,0,1,0,1,0
55290,445,0,0,66,66,0,1,0,1,0
52451,445,0,0,68,68,0,1,0,1,0
59294,445,0,0,69,69,0,1,0,1,0
59862,445,0,0,70,70,0,1,0,1,0
63843,445,0,0,66,66,0,1,0,1,0
54067,445,0,0,67,67,0,1,0,1,0
64350,445,0,0,70,70,0,1,0,1,0
64589,445,0,0,70,70,0,1,0,1,0
62134,445,0,0,66,66,0,1,0,1,0
50423,445,0,0,70,70,0,1,0,1,0
49381,445,0,0,66,66,0,1,0,1,0
52854,445,0,0,66,66,0,1,0,1,0
64321,445,0,0,70,70,0,1,0,1,0
55559,445,0,0,70,70,0,1,0,1,0
55576,445,0,0,70,70,0,1,0,1,0
65391,445,0,0,66,66,0,1,0,1,0
55727,445,0,0,70,70,0,1,0,1,0
55132,445,0,0,70,70,0,1,0,1,0
59848,445,0,0,68,68,0,1,0,1,0
65068,445,0,0,66,66,0,1,0,1,0
53869,445,0,0,70,70,0,1,0,1,0
61784,445,0,0,67,67,0,1,0,1,0
53258,445,0,0,70,70,0,1,0,1,0
57322,445,0,0,70,70,0,1,0,1,0
56963,445,0,0,66,66,0,1,0,1,0
54711,445,0,0,67,67,0,1,0,1,0
54203,445,0,0,66,66,0,1,0,1,0
56297,445,0,0,70,70,0,1,0,1,0
61865,445,0,0,69,69,0,1,0,1,0
50643,445,0,0,70,70,0,1,0,1,0
65220,445,0,0,69,69,0,1,0,1,0
57794,445,0,0,66,66,0,1,0,1,0
56281,445,0,0,70,70,0,1,0,1,0
63849,445,0,0,70,70,0,1,0,1,0
59476,445,0,0,66,66,0,1,0,1,0
54579,445,0,0,66,66,0,1,0,1,0
60914,445,0,0,70,70,0,1,0,1,0
50968,445,0,0,70,70,0,1,0,1,0
49338,445,0,0,70,70,0,1,0,1,0
55784,445,0,0,69,69,0,1,0,1,0
49246,445,0,0,66,66,0,1,0,1,0
55783,445,0,0,70,70,0,1,0,1,0
57730,445,0,0,68,68,0,1,0,1,0
54409,445,0,0,67,67,0,1,0,1,0
64273,445,0,0,68,68,0,1,0,1,0
60528,445,0,0,70,70,0,1,0,1,0
52762,445,0,0,69,69,0,1,0,1,0
50619,445,0,0,70,70,0,1,0,1,0
58705,445,0,0,70,70,0,1,0,1,0
62319,445,0,0,70,70,0,1,0,1,0
50848,445,0,0,66,66,0,1,0,1,0
65027,445,0,0,70,70,0,1,0,1,0
55222,445,0,0,68,68,0,1,0,1,0
52623,445,0,0,70,70,0,1,0,1,0
58958,445,0,0,69,69,0,1,0,1,0
51361,445,0,0,70,70,0,1,0,1,0
59476,445,0,0,70,70,0,1,0,1,0
49716,445,0,0,66,66,0,1,0,1,0
56197,445,0,0,69,69,0,1,0,1,0
52076,445,0,0,70,70,0,1,0,1,0
55545,445,0,0,70,70,0,1,0,1,0
61517,445,0,0,66,66,0,1,0,1,0
58394,445,0,0,68,68,0,1,0,1,0
55739,445,0,0,66,66,0,1,0,1,0
59634,445,0,0,70,70,0,1,0,1,0
62282,445,0,0,66,66,0,1,0,1,0
53118,445,0,0,70,70,0,1,0,1,0
62949,445,0,0,67,67,0,1,0,1,0
61334,445,0,0,66,66,0,1,0,1,0
62317,445,0,0,70,70,0,1,0,1,0
55105,445,0,0,66,66,0,1,0,1,0
54114,445,0,0,70,70,0,1,0,1,0
52896,445,0,0,70,70,0,1,0,1,0
53031,445,0,0,70,70,0,1,0,1,0
50710,445,0,0,70,70,0,1,0,1,0
53101,445,0,0,70,70,0,1,0,1,0
57673,445,0,0,70,70,0,1,0,1,0
58268,445,0,0,70,70,0,1,0,1,0
60142,445,0,0,70,70,0,1,0,1,0
61954,445,0,0,70,70,0,1,0,1,0
59959,445,0,0,70,70,0,1,0,1,0
60855,445,0,0,70,70,0,1,0,1,0
56772,445,0,0,70,70,0,1,0,1,0
49730,445,0,0,68,68,0,1,0,1,0
61591,445,0,0,66,66,0,1,0,1,0
55489,445,0,0,70,70,0,1,0,1,0
64691,445,0,0,70,70,0,1,0,1,0
55211,445,0,0,70,70,0,1,0,1,0
58632,445,0,0,70,70,0,1,0,1,0
61933,445,0,0,67,67,0,1,0,1,0
65457,445,0,0,70,70,0,1,0,1,0
58245,445,0,0,66,66,0,1,0,1,0
51856,445,0,0,67,67,0,1,0,1,0
59373,445,0,0,70,70,0,1,0,1,0
54610,445,0,0,70,70,0,1,0,1,0
60687,445,0,0,70,70,0,1,0,1,0
53360,445,0,0,70,70,0,1,0,1,0
64728,445,0,0,67,67,0,1,0,1,0
64348,445,0,0,68,68,0,1,0,1,0
61494,445,0,0,66,66,0,1,0,1,0
55130,445,0,0,70,70,0,1,0,1,0
55601,445,0,0,66,66,0,1,0,1,0
63026,445,0,0,70,70,0,1,0,1,0
49947,445,0,0,70,70,0,1,0,1,0
58044,445,0,0,70,70,0,1,0,1,0
64177,445,0,0,70,70,0,1,0,1,0
49652,445,0,0,70,70,0,1,0,1,0
56999,445,0,0,70,70,0,1,0,1,0
57809,445,0,0,70,70,0,1,0,1,0
55290,445,0,0,70,70,0,1,0,1,0
61875,445,0,0,66,66,0,1,0,1,0
55251,445,0,0,70,70,0,1,0,1,0
64341,445,0,0,69,69,0,1,0,1,0
57463,445,0,0,68,68,0,1,0,1,0
61164,445,0,0,69,69,0,1,0,1,0
57148,445,0,0,70,70,0,1,0,1,0
63413,445,0,0,70,70,0,1,0,1,0
61959,445,0,0,69,69,0,1,0,1,0
54810,445,0,0,67,67,0,1,0,1,0
64754,445,0,0,66,66,0,1,0,1,0
52020,445,0,0,66,66,0,1,0,1,0
54056,445,0,0,69,69,0,1,0,1,0
52654,445,0,0,69,69,0,1,0,1,0
49713,445,0,0,66,66,0,1,0,1,0
55608,445,0,0,70,70,0,1,0,1,0
59197,445,0,0,66,66,0,1,0,1,0
50798,445,0,0,66,66,0,1,0,1,0
49521,445,0,0,70,70,0,1,0,1,0
49470,445,0,0,66,66,0,1,0,1,0
50556,445,0,0,70,70,0,1,0,1,0
60175,445,0,0,66,66,0,1,0,1,0
52020,445,0,0,68,68,0,1,0,1,0
57342,445,0,0,70,70,0,1,0,1,0
49522,445,0,0,66,66,0,1,0,1,0
61616,445,0,0,70,70,0,1,0,1,0
57125,445,0,0,70,70,0,1,0,1,0
61861,445,0,0,70,70,0,1,0,1,0
65158,445,0,0,70,70,0,1,0,1,0
56788,445,0,0,70,70,0,1,0,1,0
54797,445,0,0,67,67,0,1,0,1,0
56831,445,0,0,70,70,0,1,0,1,0
59270,445,0,0,66,66,0,1,0,1,0
51525,445,0,0,70,70,0,1,0,1,0
64286,445,0,0,70,70,0,1,0,1,0
49323,445,0,0,70,70,0,1,0,1,0
56575,445,0,0,66,66,0,1,0,1,0
64124,445,0,0,70,70,0,1,0,1,0
62795,445,0,0,70,70,0,1,0,1,0
62045,445,0,0,70,70,0,1,0,1,0
52861,445,0,0,70,70,0,1,0,1,0
62266,445,0,0,70,70,0,1,0,1,0
58060,445,0,0,67,67,0,1,0,1,0
61545,445,0,0,66,66,0,1,0,1,0
61333,445,0,0,66,66,0,1,0,1,0
62793,445,0,0,66,66,0,1,0,1,0
60017,445,0,0,70,70,0,1,0,1,0
49524,445,0,0,70,70,0,1,0,1,0
55429,445,0,0,70,70,0,1,0,1,0
62389,445,0,0,66,66,0,1,0,1,0
52721,445,0,0,69,69,0,1,0,1,0
57803,445,0,0,70,70,0,1,0,1,0
58741,445,0,0,66,66,0,1,0,1,0
54676,445,0,0,66,66,0,1,0,1,0
64947,445,0,0,70,70,0,1,0,1,0
49618,445,0,0,70,70,0,1,0,1,0
63577,445,0,0,66,66,0,1,0,1,0
56969,445,0,0,66,66,0,1,0,1,0
57071,445,0,0,69,69,0,1,0,1,0
64936,445,0,0,66,66,0,1,0,1,0
57678,445,0,0,68,68,0,1,0,1,0
57101,445,0,0,70,70,0,1,0,1,0
55591,445,0,0,70,70,0,1,0,1,0
60635,445,0,0,70,70,0,1,0,1,0
51289,445,0,0,70,70,0,1,0,1,0
64373,445,0,0,70,70,0,1,0,1,0
51676,445,0,0,70,70,0,1,0,1,0
55591,445,0,0,70,70,0,1,0,1,0
49565,445,0,0,69,69,0,1,0,1,0
64988,445,0,0,66,66,0,1,0,1,0
54134,445,0,0,70,70,0,1,0,1,0
57268,445,0,0,66,66,0,1,0,1,0
64468,445,0,0,70,70,0,1,0,1,0
59013,445,0,0,70,70,0,1,0,1,0
65040,445,0,0,69,69,0,1,0,1,0
63775,445,0,0,66,66,0,1,0,1,0
63714,445,0,0,70,70,0,1,0,1,0
61133,445,0,0,67,67,0,1,0,1,0
53214,445,0,0,70,70,0,1,0,1,0
53928,445,0,0,66,66,0,1,0,1,0
61994,445,0,0,68,68,0,1,0,1,0
54564,445,0,0,70,70,0,1,0,1,0
51672,445,0,0,70,70,0,1,0,1,0
51066,445,0,0,66,66,0,1,0,1,0
50488,445,0,0,70,70,0,1,0,1,0
58971,445,0,0,67,67,0,1,0,1,0
60096,445,0,0,66,66,0,1,0,1,0
51101,445,0,0,66,66,0,1,0,1,0
50422,445,0,0,66,66,0,1,0,1,0
56055,445,0,0,70,70,0,1,0,1,0
54994,445,0,0,70,70,0,1,0,1,0
50886,445,0,0,66,66,0,1,0,1,0
61016,445,0,0,70,70,0,1,0,1,0
57390,445,0,0,70,70,0,1,0,1,0
50663,445,0,0,66,66,0,1,0,1,0
52183,445,0,0,70,70,0,1,0,1,0
61191,445,0,0,67,67,0,1,0,1,0
59401,445,0,0,66,66,0,1,0,1,0
63940,445,0,0,70,70,0,1,0,1,0
49524,445,0,0,67,67,0,1,0,1,0
60664,445,0,0,70,70,0,1,0,1,0
52916,445,0,0,66,66,0,1,0,1,0
63384,445,0,0,69,69,0,1,0,1,0
51811,445,0,0,69,69,0,1,0,1,0
64354,445,0,0,66,66,0,1,0,1,0
64076,445,0,0,70,70,0,1,0,1,0
55359,445,0,0,70,70,0,1,0,1,0
57094,445,0,0,66,66,0,1,0,1,0
62867,445,0,0,69,69,0,1,0,1,0
58214,445,0,0,70,70,0,1,0,1,0
56130,445,0,0,68,68,0,1,0,1,0
49309,445,0,0,70,70,0,1,0,1,0
58840,445,0,0,66,66,0,1,0,1,0
53302,445,0,0,69,69,0,1,0,1,0
51246,445,0,0,66,66,0,1,0,1,0
56175,445,0,0,66,66,0,1,0,1,0
57363,445,0,0,69,69,0,1,0,1,0
62906,445,0,0,68,68,0,1,0,1,0
49965,445,0,0,70,70,0,1,0,1,0
49614,445,0,0,68,68,0,1,0,1,0
52933,445,0,0,67,67,0,1,0,1,0
54349,445,0,0,67,67,0,1,0,1,0
60875,445,0,0,70,70,0,1,0,1,0
60239,445,0,0,70,70,0,1,0,1,0
51071,445,0,0,70,70,0,1,0,1,0
49242,445,0,0,70,70,0,1,0,1,0
59089,445,0,0,69,69,0,1,0,1,0
50642,445,0,0,70,70,0,1,0,1,0
64264,445,0,0,70,70,0,1,0,1,0
50136,445,0,0,70,70,0,1,0,1,0
61039,445,0,0,67,67,0,1,0,1,0
64554,445,0,0,66,66,0,1,0,1,0
53674,445,0,0,70,70,0,1,0,1,0
62652,445,0,0,70,70,0,1,0,1,0
65077,445,0,0,70,70,0,1,0,1,0
60923,445,0,0,70,70,0,1,0,1,0
60338,445,0,0,70,70,0,1,0,1,0
56006,445,0,0,66,66,0,1,0,1,0
58933,445,0,0,70,70,0,1,0,1,0
50837,445,0,0,70,70,0,1,0,1,0
59406,445,0,0,70,70,0,1,0,1,0
62211,445,0,0,70,70,0,1,0,1,0
61273,445,0,0,70,70,0,1,0,1,0
52912,445,0,0,66,66,0,1,0,1,0
52855,445,0,0,66,66,0,1,0,1,0
49165,445,0,0,70,70,0,1,0,1,0
49550,445,0,0,70,70,0,1,0,1,0
55498,445,0,0,67,67,0,1,0,1,0
58267,445,0,0,69,69,0,1,0,1,0
54322,445,0,0,66,66,0,1,0,1,0
51683,445,0,0,70,70,0,1,0,1,0
58562,445,0,0,70,70,0,1,0,1,0
52006,445,0,0,70,70,0,1,0,1,0
64631,445,0,0,69,69,0,1,0,1,0
50254,445,0,0,70,70,0,1,0,1,0
51636,445,0,0,69,69,0,1,0,1,0
60174,445,0,0,66,66,0,1,0,1,0
64388,445,0,0,70,70,0,1,0,1,0
58378,445,0,0,66,66,0,1,0,1,0
49852,445,0,0,70,70,0,1,0,1,0
51691,445,0,0,70,70,0,1,0,1,0
58784,445,0,0,67,67,0,1,0,1,0
62422,445,0,0,68,68,0,1,0,1,0
56252,445,0,0,68,68,0,1,0,1,0
65460,445,0,0,70,70,0,1,0,1,0
54187,445,0,0,66,66,0,1,0,1,0
59013,445,0,0,66,66,0,1,0,1,0
56090,445,0,0,70,70,0,1,0,1,0
59455,445,0,0,66,66,0,1,0,1,0
54108,445,0,0,70,70,0,1,0,1,0
50795,445,0,0,66,66,0,1,0,1,0
59825,445,0,0,66,66,0,1,0,1,0
51825,445,0,0,69,69,0,1,0,1,0
61232,445,0,0,70,70,0,1,0,1,0
55715,445,0,0,70,70,0,1,0,1,0
58154,445,0,0,68,68,0,1,0,1,0
62037,445,0,0,70,70,0,1,0,1,0
61084,445,0,0,68,68,0,1,0,1,0
59728,445,0,0,70,70,0,1,0,1,0
55514,445,0,0,70,70,0,1,0,1,0
50712,445,0,0,70,70,0,1,0,1,0
52430,445,0,0,70,70,0,1,0,1,0
54967,445,0,0,66,66,0,1,0,1,0
60901,445,0,0,66,66,0,1,0,1,0
65038,445,0,0,66,66,0,1,0,1,0
64284,445,0,0,70,70,0,1,0,1,0
58233,445,0,0,69,69,0,1,0,1,0
49215,445,0,0,70,70,0,1,0,1,0
55913,445,0,0,70,70,0,1,0,1,0
65395,445,0,0,69,69,0,1,0,1,0
61441,445,0,0,70,70,0,1,0,1,0
51619,445,0,0,70,70,0,1,0,1,0
54431,445,0,0,70,70,0,1,0,1,0
55260,445,0,0,70,70,0,1,0,1,0
50479,445,0,0,66,66,0,1,0,1,0
57249,445,0,0,66,66,0,1,0,1,0
49834,445,0,0,70,70,0,1,0,1,0
55056,445,0,0,70,70,0,1,0,1,0
61075,445,0,0,70,70,0,1,0,1,0
62635,445,0,0,70,70,0,1,0,1,0
62664,445,0,0,69,69,0,1,0,1,0
58002,445,0,0,70,70,0,1,0,1,0
56754,445,0,0,70,70,0,1,0,1,0
52044,445,0,0,70,70,0,1,0,1,0
51012,445,0,0,70,70,0,1,0,1,0
64166,445,0,0,66,66,0,1,0,1,0
61329,445,0,0,70,70,0,1,0,1,0
56873,445,0,0,70,70,0,1,0,1,0
58565,445,0,0,70,70,0,1,0,1,0
56263,445,0,0,69,69,0,1,0,1,0
60399,445,0,0,70,70,0,1,0,1,0
63637,445,0,0,70,70,0,1,0,1,0
59124,445,0,0,68,68,0,1,0,1,0
54718,445,0,0,69,69,0,1,0,1,0
60745,445,0,0,69,69,0,1,0,1,0
64261,445,0,0,70,70,0,1,0,1,0
53258,445,0,0,66,66,0,1,0,1,0
50290,445,0,0,66,66,0,1,0,1,0
58796,445,0,0,68,68,0,1,0,1,0
58948,445,0,0,66,66,0,1,0,1,0
60532,445,0,0,68,68,0,1,0,1,0
59787,445,0,0,70,70,0,1,0,1,0
52510,445,0,0,68,68,0,1,0,1,0
65389,445,0,0,70,70,0,1,0,1,0
57776,445,0,0,70,70,0,1,0,1,0
57918,445,0,0,67,67,0,1,0,1,0
53016,445,0,0,70,70,0,1,0,1,0
49473,445,0,0,69,69,0,1,0,1,0
62184,445,0,0,70,70,0,1,0,1,0
62254,445,0,0,70,70,0,1,0,1,0
49554,445,0,0,70,70,0,1,0,1,0
51859,445,0,0,70,70,0,1,0,1,0
51309,445,0,0,66,66,0,1,0,1,0
55742,445,0,0,70,70,0,1,0,1,0
62810,445,0,0,70,70,0,1,0,1,0
49518,445,0,0,70,70,0,1,0,1,0
58118,445,0,0,67,67,0,1,0,1,0
51230,445,0,0,66,66,0,1,0,1,0
57523,445,0,0,70,70,0,1,0,1,0
51711,445,0,0,70,70,0,1,0,1,0
64026,445,0,0,70,70,0,1,0,1,0
52394,445,0,0,70,70,0,1,0,1,0
51065,445,0,0,66,66,0,1,0,1,0
65419,445,0,0,68,68,0,1,0,1,0
64875,445,0,0,70,70,0,1,0,1,0
54651,445,0,0,70,70,0,1,0,1,0
50224,445,0,0,70,70,0,1,0,1,0
64708,445,0,0,66,66,0,1,0,1,0
52919,445,0,0,66,66,0,1,0,1,0
52068,445,0,0,68,68,0,1,0,1,0
55001,445,0,0,70,70,0,1,0,1,0
58568,445,0,0,68,68,0,1,0,1,0
64411,445,0,0,70,70,0,1,0,1,0
55962,445,0,0,70,70,0,1,0,1,0
50136,445,0,0,70,70,0,1,0,1,0
59824,445,0,0,67,67,0,1,0,1,0
52582,445,0,0,66,66,0,1,0,1,0
63005,445,0,0,70,70,0,1,0,1,0
62793,445,0,0,70,70,0,1,0,1,0
49542,445,0,0,66,66,0,1,0,1,0
52660,445,0,0,68,68,0,1,0,1,0
64740,445,0,0,70,70,0,1,0,1,0
58312,445,0,0,70,70,0,1,0,1,0
50735,445,0,0,66,66,0,1,0,1,0
57089,445,0,0,70,70,0,1,0,1,0
57277,445,0,0,66,66,0,1,0,1,0
52592,445,0,0,70,70,0,1,0,1,0
55543,445,0,0,70,70,0,1,0,1,0
60762,445,0,0,67,67,0,1,0,1,0
58822,445,0,0,70,70,0,1,0,1,0
53020,445,0,0,70,70,0,1,0,1,0
52371,445,0,0,70,70,0,1,0,1,0
62871,445,0,0,66,66,0,1,0,1,0
60824,445,0,0,66,66,0,1,0,1,0
56914,445,0,0,66,66,0,1,0,1,0
63643,445,0,0,70,70,0,1,0,1,0
57292,445,0,0,70,70,0,1,0,1,0
52568,445,0,0,70,70,0,1,0,1,0
56531,445,0,0,70,70,0,1,0,1,0
64162,445,0,0,66,66,0,1,0,1,0
51243,445,0,0,66,66,0,1,0,1,0
57745,445,0,0,70,70,0,1,0,1,0
51916,445,0,0,67,67,0,1,0,1,0
51583,445,0,0,70,70,0,1,0,1,0
54262,445,0,0,66,66,0,1,0,1,0
62213,445,0,0,70,70,0,1,0,1,0
52977,445,0,0,70,70,0,1,0,1,0
57986,445,0,0,70,70,0,1,0,1,0
55289,445,0,0,68,68,0,1,0,1,0
51072,445,0,0,70,70,0,1,0,1,0
56735,445,0,0,70,70,0,1,0,1,0
61277,445,0,0,66,66,0,1,0,1,0
53338,445,0,0,70,70,0,1,0,1,0
55288,445,0,0,66,66,0,1,0,1,0
50191,445,0,0,70,70,0,1,0,1,0
64263,445,0,0,70,70,0,1,0,1,0
57089,445,0,0,69,69,0,1,0,1,0
51674,445,0,0,70,70,0,1,0,1,0
59013,445,0,0,70,70,0,1,0,1,0
57671,445,0,0,70,70,0,1,0,1,0
58416,445,0,0,70,70,0,1,0,1,0
49647,445,0,0,66,66,0,1,0,1,0
63326,445,0,0,69,69,0,1,0,1,0
55540,445,0,0,70,70,0,1,0,1,0
65219,445,0,0,70,70,0,1,0,1,0
65415,445,0,0,69,69,0,1,0,1,0
52531,445,0,0,70,70,0,1,0,1,0
51589,445,0,0,70,70,0,1,0,1,0
55721,445,0,0,70,70,0,1,0,1,0
62725,445,0,0,66,66,0,1,0,1,0
52921,445,0,0,66,66,0,1,0,1,0
59707,445,0,0,70,70,0,1,0,1,0
61464,445,0,0,66,66,0,1,0,1,0
64523,445,0,0,70,70,0,1,0,1,0
55733,445,0,0,70,70,0,1,0,1,0
50872,445,0,0,70,70,0,1,0,1,0
60000,445,0,0,68,68,0,1,0,1,0
61235,445,0,0,68,68,0,1,0,1,0
51490,445,0,0,70,70,0,1,0,1,0
61690,445,0,0,70,70,0,1,0,1,0
64192,445,0,0,66,66,0,1,0,1,0
53728,445,0,0,70,70,0,1,0,1,0
61372,445,0,0,70,70,0,1,0,1,0
59476,445,0,0,68,68,0,1,0,1,0
60980,445,0,0,70,70,0,1,0,1,0
62586,445,0,0,67,67,0,1,0,1,0
59580,445,0,0,70,70,0,1,0,1,0
53994,445,0,0,70,70,0,1,0,1,0
53421,445,0,0,66,66,0,1,0,1,0
52371,445,0,0,69,69,0,1,0,1,0
64332,445,0,0,70,70,0,1,0,1,0
55584,445,0,0,70,70,0,1,0,1,0
57602,445,0,0,70,70,0,1,0,1,0
62646,445,0,0,66,66,0,1,0,1,0
59480,445,0,0,70,70,0,1,0,1,0
57046,445,0,0,66,66,0,1,0,1,0
50383,445,0,0,70,70,0,1,0,1,0
56835,445,0,0,66,66,0,1,0,1,0
63236,445,0,0,70,70,0,1,0,1,0
50521,445,0,0,70,70,0,1,0,1,0
54868,445,0,0,70,70,0,1,0,1,0
51184,445,0,0,66,66,0,1,0,1,0
57005,445,0,0,70,70,0,1,0,1,0
55840,445,0,0,70,70,0,1,0,1,0
63069,445,0,0,70,70,0,1,0,1,0
64492,445,0,0,66,66,0,1,0,1,0
54986,445,0,0,66,66,0,1,0,1,0
59800,445,0,0,70,70,0,1,0,1,0
62621,445,0,0,66,66,0,1,0,1,0
59162,445,0,0,70,70,0,1,0,1,0
52583,445,0,0,67,67,0,1,0,1,0
60970,445,0,0,66,66,0,1,0,1,0
60651,445,0,0,70,70,0,1,0,1,0
61162,445,0,0,66,66,0,1,0,1,0
58741,445,0,0,70,70,0,1,0,1,0
57305,445,0,0,70,70,0,1,0,1,0
64712,445,0,0,70,70,0,1,0,1,0
50641,445,0,0,70,70,0,1,0,1,0
52649,445,0,0,67,67,0,1,0,1,0
55134,445,0,0,70,70,0,1,0,1,0
62316,445,0,0,70,70,0,1,0,1,0
58430,445,0,0,70,70,0,1,0,1,0
61076,445,0,0,69,69,0,1,0,1,0
53048,445,0,0,70,70,0,1,0,1,0
55475,445,0,0,66,66,0,1,0,1,0
61538,445,0,0,66,66,0,1,0,1,0
65198,445,0,0,66,66,0,1,0,1,0
64938,445,0,0,67,67,0,1,0,1,0
64921,445,0,0,69,69,0,1,0,1,0
64283,445,0,0,70,70,0,1,0,1,0
55874,445,0,0,69,69,0,1,0,1,0
64066,445,0,0,67,67,0,1,0,1,0
51067,445,0,0,70,70,0,1,0,1,0
59696,445,0,0,70,70,0,1,0,1,0
61018,445,0,0,68,68,0,1,0,1,0
65061,445,0,0,70,70,0,1,0,1,0
55746,445,0,0,70,70,0,1,0,1,0
62553,445,0,0,70,70,0,1,0,1,0
52567,445,0,0,70,70,0,1,0,1,0
63496,445,0,0,68,68,0,1,0,1,0
61483,445,0,0,70,70,0,1,0,1,0
49593,445,0,0,69,69,0,1,0,1,0
65311,445,0,0,70,70,0,1,0,1,0
60996,445,0,0,70,70,0,1,0,1,0
63948,445,0,0,70,70,0,1,0,1,0
51010,445,0,0,70,70,0,1,0,1,0
63559,445,0,0,70,70,0,1,0,1,0
61751,445,0,0,67,67,0,1,0,1,0
59892,445,0,0,69,69,0,1,0,1,0
55084,445,0,0,70,70,0,1,0,1,0
58473,445,0,0,66,66,0,1,0,1,0
59889,445,0,0,70,70,0,1,0,1,0
54274,445,0,0,70,70,0,1,0,1,0
58852,445,0,0,70,70,0,1,0,1,0
53030,445,0,0,70,70,0,1,0,1,0
60451,445,0,0,70,70,0,1,0,1,0
50298,445,0,0,70,70,0,1,0,1,0
60192,445,0,0,68,68,0,1,0,1,0
64455,445,0,0,70,70,0,1,0,1,0
57408,445,0,0,70,70,0,1,0,1,0
65441,445,0,0,70,70,0,1,0,1,0
50944,445,0,0,67,67,0,1,0,1,0
60241,445,0,0,70,70,0,1,0,1,0
51372,445,0,0,67,67,0,1,0,1,0
55332,445,0,0,70,70,0,1,0,1,0
55234,445,0,0,70,70,0,1,0,1,0
60117,445,0,0,70,70,0,1,0,1,0
54059,445,0,0,70,70,0,1,0,1,0
50397,445,0,0,70,70,0,1,0,1,0
63436,445,0,0,70,70,0,1,0,1,0
52050,445,0,0,70,70,0,1,0,1,0
59664,445,0,0,70,70,0,1,0,1,0
60924,445,0,0,70,70,0,1,0,1,0
64486,445,0,0,69,69,0,1,0,1,0
55717,445,0,0,70,70,0,1,0,1,0
50304,445,0,0,70,70,0,1,0,1,0
63085,445,0,0,70,70,0,1,0,1,0
53882,445,0,0,66,66,0,1,0,1,0
59435,445,0,0,70,70,0,1,0,1,0
54308,445,0,0,69,69,0,1,0,1,0
55886,445,0,0,70,70,0,1,0,1,0
64871,445,0,0,68,68,0,1,0,1,0
64298,445,0,0,69,69,0,1,0,1,0
54719,445,0,0,70,70,0,1,0,1,0
51362,445,0,0,66,66,0,1,0,1,0
57557,445,0,0,66,66,0,1,0,1,0
53242,445,0,0,66,66,0,1,0,1,0
58154,445,0,0,69,69,0,1,0,1,0
62685,445,0,0,70,70,0,1,0,1,0
60506,445,0,0,67,67,0,1,0,1,0
58968,445,0,0,70,70,0,1,0,1,0
61595,445,0,0,70,70,0,1,0,1,0
61898,445,0,0,69,69,0,1,0,1,0
64541,445,0,0,70,70,0,1,0,1,0
64053,445,0,0,70,70,0,1,0,1,0
60347,445,0,0,70,70,0,1,0,1,0
57272,445,0,0,66,66,0,1,0,1,0
61887,445,0,0,70,70,0,1,0,1,0
53613,445,0,0,70,70,0,1,0,1,0
62298,445,0,0,70,70,0,1,0,1,0
55967,445,0,0,70,70,0,1,0,1,0
58813,445,0,0,70,70,0,1,0,1,0
52076,445,0,0,70,70,0,1,0,1,0
51262,445,0,0,66,66,0,1,0,1,0
55233,445,0,0,70,70,0,1,0,1,0
55139,445,0,0,70,70,0,1,0,1,0
59516,445,0,0,68,68,0,1,0,1,0
58850,445,0,0,70,70,0,1,0,1,0
50284,445,0,0,66,66,0,1,0,1,0
59400,445,0,0,66,66,0,1,0,1,0
57816,445,0,0,69,69,0,1,0,1,0
58386,445,0,0,70,70,0,1,0,1,0
55196,445,0,0,70,70,0,1,0,1,0
50944,445,0,0,70,70,0,1,0,1,0
59733,445,0,0,70,70,0,1,0,1,0
60037,445,0,0,70,70,0,1,0,1,0
50267,445,0,0,70,70,0,1,0,1,0
61447,445,0,0,68,68,0,1,0,1,0
52891,445,0,0,70,70,0,1,0,1,0
64697,445,0,0,68,68,0,1,0,1,0
49554,445,0,0,70,70,0,1,0,1,0
56894,445,0,0,70,70,0,1,0,1,0
64695,445,0,0,66,66,0,1,0,1,0
55458,445,0,0,70,70,0,1,0,1,0
52607,445,0,0,67,67,0,1,0,1,0
52200,445,0,0,69,69,0,1,0,1,0
50941,445,0,0,70,70,0,1,0,1,0
52282,445,0,0,66,66,0,1,0,1,0
51623,445,0,0,66,66,0,1,0,1,0
64837,445,0,0,70,70,0,1,0,1,0
58129,445,0,0,70,70,0,1,0,1,0
55557,445,0,0,70,70,0,1,0,1,0
64689,445,0,0,67,67,0,1,0,1,0
65061,445,0,0,70,70,0,1,0,1,0
63192,445,0,0,69,69,0,1,0,1,0
53493,445,0,0,66,66,0,1,0,1,0
60763,445,0,0,68,68,0,1,0,1,0
62426,445,0,0,68,68,0,1,0,1,0
61804,445,0,0,68,68,0,1,0,1,0
57342,445,0,0,70,70,0,1,0,1,0
51205,445,0,0,70,70,0,1,0,1,0
57607,445,0,0,66,66,0,1,0,1,0
60830,445,0,0,70,70,0,1,0,1,0
58005,445,0,0,67,67,0,1,0,1,0
49567,445,0,0,68,68,0,1,0,1,0
56708,445,0,0,66,66,0,1,0,1,0
52375,445,0,0,70,70,0,1,0,1,0
64944,445,0,0,70,70,0,1,0,1,0
64914,445,0,0,69,69,0,1,0,1,0
51638,445,0,0,66,66,0,1,0,1,0
52236,445,0,0,70,70,0,1,0,1,0
61276,445,0,0,66,66,0,1,0,1,0
55083,445,0,0,70,70,0,1,0,1,0
56400,445,0,0,70,70,0,1,0,1,0
54004,445,0,0,70,70,0,1,0,1,0
60804,445,0,0,70,70,0,1,0,1,0
51860,445,0,0,70,70,0,1,0,1,0
60737,445,0,0,70,70,0,1,0,1,0
58415,445,0,0,70,70,0,1,0,1,0
61403,445,0,0,66,66,0,1,0,1,0
56755,445,0,0,69,69,0,1,0,1,0
59374,445,0,0,67,67,0,1,0,1,0
63158,445,0,0,66,66,0,1,0,1,0
59790,445,0,0,70,70,0,1,0,1,0
59783,445,0,0,70,70,0,1,0,1,0
50683,445,0,0,70,70,0,1,0,1,0
62425,445,0,0,66,66,0,1,0,1,0
58594,445,0,0,69,69,0,1,0,1,0
52168,445,0,0,66,66,0,1,0,1,0
64749,445,0,0,68,68,0,1,0,1,0
54929,445,0,0,67,67,0,1,0,1,0
64437,445,0,0,70,70,0,1,0,1,0
55608,445,0,0,67,67,0,1,0,1,0
60304,445,0,0,67,67,0,1,0,1,0
55979,445,0,0,70,70,0,1,0,1,0
55850,445,0,0,70,70,0,1,0,1,0
62439,445,0,0,70,70,0,1,0,1,0
52587,445,0,0,69,69,0,1,0,1,0
57019,445,0,0,66,66,0,1,0,1,0
62336,445,0,0,70,70,0,1,0,1,0
58185,445,0,0,70,70,0,1,0,1,0
54875,445,0,0,70,70,0,1,0,1,0
60756,445,0,0,66,66,0,1,0,1,0
56439,445,0,0,70,70,0,1,0,1,0
56469,445,0,0,70,70,0,1,0,1,0
50229,445,0,0,67,67,0,1,0,1,0
61273,445,0,0,70,70,0,1,0,1,0
59786,445,0,0,66,66,0,1,0,1,0
60935,445,0,0,70,70,0,1,0,1,0
64793,445,0,0,70,70,0,1,0,1,0
51724,445,0,0,70,70,0,1,0,1,0
52566,445,0,0,70,70,0,1,0,1,0
57429,445,0,0,66,66,0,1,0,1,0
55031,445,0,0,70,70,0,1,0,1,0
57622,445,0,0,68,68,0,1,0,1,0
56330,445,0,0,70,70,0,1,0,1,0
56322,445,0,0,66,66,0,1,0,1,0
52925,445,0,0,66,66,0,1,0,1,0
57666,445,0,0,70,70,0,1,0,1,0
50499,445,0,0,66,66,0,1,0,1,0
54649,445,0,0,66,66,0,1,0,1,0
54593,445,0,0,68,68,0,1,0,1,0
60632,445,0,0,70,70,0,1,0,1,0
60988,445,0,0,66,66,0,1,0,1,0
52522,445,0,0,70,70,0,1,0,1,0
50037,445,0,0,70,70,0,1,0,1,0
64519,445,0,0,70,70,0,1,0,1,0
64004,445,0,0,70,70,0,1,0,1,0
64388,445,0,0,70,70,0,1,0,1,0
62806,445,0,0,70,70,0,1,0,1,0
64363,445,0,0,66,66,0,1,0,1,0
51034,445,0,0,70,70,0,1,0,1,0
9144,3389,9144,3389,293,223,70,4,1,3,1
12604,3389,12604,3389,293,223,70,4,1,3,1
10967,3389,10967,3389,293,223,70,4,1,3,1
18252,18242,0,0,62,62,0,1,0,1,0
22461,34021,0,0,62,62,0,1,0,1,0
2077,45850,0,0,145,145,0,1,0,1,0
28135,34021,0,0,62,62,0,1,0,1,0
51265,31652,0,0,72,72,0,1,0,1,0
35828,8970,0,0,146,146,0,1,0,1,0
14459,11848,0,0,148,148,0,1,0,1,0
37075,3389,37075,3389,293,223,70,4,1,3,1
29951,34021,0,0,62,62,0,1,0,1,0
49160,31652,0,0,146,146,0,1,0,1,0
40500,5618,0,0,146,146,0,1,0,1,0
49160,34021,0,0,146,146,0,1,0,1,0
45690,60038,0,0,62,62,0,1,0,1,0
28305,25773,0,0,148,148,0,1,0,1,0
38554,3389,38554,3389,293,223,70,4,1,3,1
1024,21854,0,0,157,157,0,1,0,1,0
51779,31652,0,0,62,62,0,1,0,1,0
48903,25773,0,0,157,157,0,1,0,1,0
17800,3389,17800,3389,293,223,70,4,0,3,1
22285,3389,22285,3389,293,223,70,4,0,3,1
12283,25773,0,0,139,139,0,1,0,1,0
64461,31652,0,0,62,62,0,1,0,1,0
11317,61248,0,0,143,143,0,1,0,1,0
3529,25773,0,0,143,143,0,1,0,1,0
8116,25773,0,0,157,157,0,1,0,1,0
52578,34021,0,0,62,62,0,1,0,1,0
22130,61248,0,0,159,159,0,1,0,1,0
64014,3389,64014,3389,293,223,70,4,0,3,1
12285,61248,0,0,139,139,0,1,0,1,0
60419,61248,0,0,145,145,0,1,0,1,0
55678,5618,0,0,145,145,0,1,0,1,0
7372,61248,0,0,139,139,0,1,0,1,0
19626,3389,19626,3389,293,223,70,4,0,3,1
18017,25773,0,0,143,143,0,1,0,1,0
25672,162,0,0,64,64,0,1,0,1,0
11747,23075,0,0,122,122,0,1,0,1,0
11754,61248,0,0,141,141,0,1,0,1,0
26450,24383,0,0,132,132,0,1,0,1,0
50877,31652,0,0,90,90,0,1,0,1,0
20497,27795,0,0,123,123,0,1,0,1,0
34051,3389,34051,3389,293,223,70,4,0,3,1
55588,33420,0,0,62,62,0,1,0,1,0
57435,31652,0,0,67,67,0,1,0,1,0
30119,4137,0,0,100,100,0,1,0,1,0
11438,61248,0,0,142,142,0,1,0,1,0
15349,61248,0,0,148,148,0,1,0,1,0
53945,39072,0,0,82,82,0,1,0,1,0
50205,29014,0,0,110,110,0,1,0,1,0
20637,61248,0,0,155,155,0,1,0,1,0
23890,32003,0,0,83,83,0,1,0,1,0
8052,25773,0,0,156,156,0,1,0,1,0
1709,22232,0,0,157,157,0,1,0,1,0
15327,61248,0,0,148,148,0,1,0,1,0
49160,33663,0,0,146,146,0,1,0,1,0
6657,53483,0,0,144,144,0,1,0,1,0
10979,3389,10979,3389,293,223,70,4,1,3,1
49808,32101,0,0,130,130,0,1,0,1,0
52411,33720,0,0,63,63,0,1,0,1,0
57475,3389,57475,3389,293,223,70,4,0,3,1
57876,31652,0,0,66,66,0,1,0,1,0
13411,9311,3288,1016,191,170,20,1,0,1,0
15416,25773,0,0,141,141,0,1,0,1,0
52065,33096,0,0,65,65,0,1,0,1,0
16930,25773,0,0,142,142,0,1,0,1,0
49062,29425,0,0,150,150,0,1,0,1,0
16970,3389,16970,3389,293,223,70,4,0,3,1
60746,58846,0,0,138,138,0,1,0,1,0
19127,3389,19127,3389,293,223,70,4,0,3,1
17810,17497,0,0,72,72,0,1,0,1,0
52297,33391,0,0,69,69,0,1,0,1,0
31848,3389,31848,3389,293,223,70,4,0,3,1
22593,33833,0,0,63,63,0,1,0,1,0
51693,40146,0,0,145,145,0,1,0,1,0
10420,5421,6947,2574,258,204,53,3,0,2,0
16836,25773,0,0,144,144,0,1,0,1,0
19860,3389,19860,3389,293,223,70,4,0,3,1
43549,5618,0,0,145,145,0,1,0,1,0
12602,25773,0,0,139,139,0,1,0,1,0
10431,24052,0,0,135,135,0,1,0,1,0
16164,61248,0,0,146,146,0,1,0,1,0
17331,3389,17331,3389,293,223,70,4,0,3,1
16648,15538,0,0,98,98,0,1,0,1,0
6481,53189,0,0,144,144,0,1,0,1,0
20283,3389,20283,3389,293,223,70,4,0,3,1
29947,60846,0,0,126,126,0,1,0,1,0
54743,11860,0,0,125,125,0,1,0,1,0
49566,3389,49566,3389,293,223,70,4,0,3,1
11911,5676,8000,2472,253,202,51,3,0,2,0
28108,25625,0,0,146,146,0,1,0,1,0
52201,32903,0,0,62,62,0,1,0,1,0
49416,31652,0,0,136,136,0,1,0,1,0
17838,3389,17838,3389,293,223,70,4,0,3,1
4311,52347,0,0,142,142,0,1,0,1,0
50292,32746,0,0,106,106,0,1,0,1,0
12220,3091,10003,3091,272,208,63,3,0,2,0
13813,49625,0,0,106,106,0,1,0,1,0
22241,3290,0,0,85,85,0,1,0,1,0
8062,61248,0,0,139,139,0,1,0,1,0
49041,26117,0,0,152,152,0,1,0,1,0
49929,31652,0,0,118,118,0,1,0,1,0
5955,57128,0,0,140,140,0,1,0,1,0
18882,61248,0,0,154,154,0,1,0,1,0
28424,2702,0,0,87,87,0,1,0,1,0
55611,5815,0,0,145,145,0,1,0,1,0
49516,31899,0,0,137,137,0,1,0,1,0
51705,31718,0,0,64,64,0,1,0,1,0
9802,61248,0,0,142,142,0,1,0,1,0
12090,25705,0,0,139,139,0,1,0,1,0
16375,3389,16375,3389,293,223,70,4,0,3,1
16829,15843,0,0,94,94,0,1,0,1,0
33094,6656,0,0,124,124,0,1,0,1,0
21937,3389,21937,3389,293,223,70,4,0,3,1
11103,3389,11103,3389,293,223,70,4,1,3,1
17251,3389,17251,3389,293,223,70,4,0,3,1
4907,18961,0,0,154,154,0,1,0,1,0
49160,33016,0,0,146,146,0,1,0,1,0
17927,18650,0,0,66,66,0,1,0,1,0
48916,26086,0,0,156,156,0,1,0,1,0
32829,60698,0,0,114,114,0,1,0,1,0
50546,29864,0,0,97,97,0,1,0,1,0
15201,3389,15201,3389,293,223,70,4,0,3,1
9188,61248,0,0,140,140,0,1,0,1,0
50254,34021,0,0,119,119,0,1,0,1,0
15821,10350,0,0,137,137,0,1,0,1,0
19822,25773,0,0,143,143,0,1,0,1,0
17724,3389,17724,3389,293,223,70,4,0,3,1
15866,14220,0,0,116,116,0,1,0,1,0
52564,6143,0,0,145,145,0,1,0,1,0
25317,25773,0,0,146,146,0,1,0,1,0
49815,60376,0,0,85,85,0,1,0,1,0
26912,3389,26912,3389,293,223,70,4,0,3,1
47849,60215,0,0,74,74,0,1,0,1,0
12991,8293,4608,1423,208,179,29,2,0,1,0
2656,43924,0,0,146,146,0,1,0,1,0
25899,34021,0,0,62,62,0,1,0,1,0
19882,29727,0,0,102,102,0,1,0,1,0
13523,25773,0,0,139,139,0,1,0,1,0
34347,3389,34347,3389,293,223,70,4,0,3,1
46834,55715,0,0,62,62,0,1,0,1,0
55868,33364,0,0,62,62,0,1,0,1,0
22689,2798,0,0,82,82,0,1,0,1,0
25130,3389,25130,3389,293,223,70,4,0,3,1
10406,25773,0,0,147,147,0,1,0,1,0
51866,32425,0,0,80,80,0,1,0,1,0
39772,6140,0,0,146,146,0,1,0,1,0
50878,32087,0,0,85,85,0,1,0,1,0
49160,33596,0,0,146,146,0,1,0,1,0
11379,3389,11379,3389,293,223,70,4,1,3,1
42643,5618,0,0,145,145,0,1,0,1,0
9108,61248,0,0,139,139,0,1,0,1,0
54926,42176,0,0,86,86,0,1,0,1,0
16949,16046,0,0,91,91,0,1,0,1,0
29457,1555,0,0,85,85,0,1,0,1,0
8041,25773,0,0,156,156,0,1,0,1,0
36380,8573,0,0,146,146,0,1,0,1,0
56563,60931,0,0,123,123,0,1,0,1,0
49064,30949,0,0,150,150,0,1,0,1,0
46100,56682,0,0,71,71,0,1,0,1,0
21690,3389,21690,3389,293,223,70,4,0,3,1
16616,3389,16616,3389,293,223,70,4,0,3,1
56818,3389,56818,3389,293,223,70,4,0,3,1
1261,21936,0,0,156,156,0,1,0,1,0
4203,22960,0,0,151,151,0,1,0,1,0
15047,25773,0,0,140,140,0,1,0,1,0
12706,3389,12706,3389,293,223,70,4,0,3,1
44446,7514,0,0,145,145,0,1,0,1,0
47732,5618,0,0,145,145,0,1,0,1,0
52309,33225,0,0,62,62,0,1,0,1,0
32298,16852,0,0,146,146,0,1,0,1,0
3712,48316,0,0,144,144,0,1,0,1,0
49160,31936,0,0,146,146,0,1,0,1,0
64094,31652,0,0,64,64,0,1,0,1,0
49995,32231,0,0,125,125,0,1,0,1,0
50390,29112,0,0,118,118,0,1,0,1,0
12124,3389,12124,3389,293,223,70,4,1,3,1
11779,61248,0,0,141,141,0,1,0,1,0
39182,3389,39182,3389,293,223,70,4,0,3,1
54549,12273,0,0,126,126,0,1,0,1,0
26491,28332,0,0,121,121,0,1,0,1,0
50438,28912,0,0,106,106,0,1,0,1,0
52410,33644,0,0,66,66,0,1,0,1,0
25259,32524,0,0,75,75,0,1,0,1,0
14553,48290,0,0,102,102,0,1,0,1,0
52675,23330,0,0,95,95,0,1,0,1,0
60192,61229,0,0,143,143,0,1,0,1,0
27291,34021,0,0,62,62,0,1,0,1,0
35325,8544,0,0,142,142,0,1,0,1,0
18174,20728,0,0,88,88,0,1,0,1,0
27103,13572,0,0,104,104,0,1,0,1,0
14354,3389,14354,3389,293,223,70,4,0,3,1
55112,5618,0,0,145,145,0,1,0,1,0
28719,34021,0,0,62,62,0,1,0,1,0
22107,3389,22107,3389,293,223,70,4,0,3,1
17949,25773,0,0,142,142,0,1,0,1,0
24096,31712,0,0,86,86,0,1,0,1,0
52226,5618,0,0,145,145,0,1,0,1,0
15984,25773,0,0,145,145,0,1,0,1,0
54933,5743,0,0,145,145,0,1,0,1,0
2510,46571,0,0,144,144,0,1,0,1,0
54641,31652,0,0,115,115,0,1,0,1,0
51075,60480,0,0,92,92,0,1,0,1,0
51164,31652,0,0,75,75,0,1,0,1,0
5903,25773,0,0,150,150,0,1,0,1,0
36333,3389,36333,3389,293,223,70,4,0,3,1
26606,61018,0,0,140,140,0,1,0,1,0
50167,34021,0,0,121,121,0,1,0,1,0
51309,31173,0,0,94,94,0,1,0,1,0
26178,34021,0,0,62,62,0,1,0,1,0
11199,3951,10237,3163,283,218,65,3,0,2,0
9476,25773,0,0,140,140,0,1,0,1,0
30030,21918,0,0,147,147,0,1,0,1,0
22098,33347,0,0,68,68,0,1,0,1,0
10663,25773,0,0,145,145,0,1,0,1,0
18738,3389,18738,3389,293,223,70,4,0,3,1
49085,31616,0,0,149,149,0,1,0,1,0
10097,3389,10097,3389,293,223,70,4,1,3,1
11884,13765,0,0,149,149,0,1,0,1,0
12186,61248,0,0,139,139,0,1,0,1,0
51363,31830,0,0,71,71,0,1,0,1,0
16249,25773,0,0,141,141,0,1,0,1,0
27429,3389,27429,3389,293,223,70,4,0,3,1
20005,27147,0,0,129,129,0,1,0,1,0
17928,18482,0,0,65,65,0,1,0,1,0
17534,17032,0,0,78,78,0,1,0,1,0
29148,34021,0,0,62,62,0,1,0,1,0
19098,3389,19098,3389,293,223,70,4,0,3,1
51132,31322,0,0,76,76,0,1,0,1,0
25436,3389,25436,3389,293,223,70,4,0,3,1
14880,61248,0,0,148,148,0,1,0,1,0
19828,61248,0,0,154,154,0,1,0,1,0
51932,32105,0,0,62,62,0,1,0,1,0
18127,22228,0,0,104,104,0,1,0,1,0
30241,3389,30241,3389,293,223,70,4,0,3,1
17162,25773,0,0,144,144,0,1,0,1,0
49075,29714,0,0,149,149,0,1,0,1,0
13633,17127,0,0,144,144,0,1,0,1,0
3401,22681,0,0,153,153,0,1,0,1,0
16475,48644,0,0,105,105,0,1,0,1,0
58157,61062,0,0,132,132,0,1,0,1,0
16837,28142,0,0,116,116,0,1,0,1,0
61420,3389,61420,3389,293,223,70,4,0,3,1
29131,34021,0,0,62,62,0,1,0,1,0
40222,5515,0,0,144,144,0,1,0,1,0
18262,3389,18262,3389,293,223,70,4,0,3,1
50523,31652,0,0,102,102,0,1,0,1,0
51552,33310,0,0,87,87,0,1,0,1,0
51734,33436,0,0,82,82,0,1,0,1,0
21669,3389,21669,3389,293,223,70,4,0,3,1
51549,31652,0,0,66,66,0,1,0,1,0
28302,25897,0,0,146,146,0,1,0,1,0
10237,3389,10237,3389,293,223,70,4,1,3,1
28291,26434,0,0,141,141,0,1,0,1,0
21350,61248,0,0,157,157,0,1,0,1,0
49160,32568,0,0,146,146,0,1,0,1,0
12048,24396,0,0,147,147,0,1,0,1,0
7290,49853,0,0,148,148,0,1,0,1,0
21818,20913,0,0,92,92,0,1,0,1,0
8783,61248,0,0,139,139,0,1,0,1,0
49278,31734,0,0,143,143,0,1,0,1,0
13884,61248,0,0,147,147,0,1,0,1,0
2826,24674,0,0,146,146,0,1,0,1,0
33323,2977,0,0,106,106,0,1,0,1,0
23965,34021,0,0,62,62,0,1,0,1,0
51263,31653,0,0,72,72,0,1,0,1,0
58005,32938,0,0,62,62,0,1,0,1,0
12327,61248,0,0,139,139,0,1,0,1,0
60705,32400,0,0,62,62,0,1,0,1,0
6497,25773,0,0,141,141,0,1,0,1,0
31590,2339,0,0,96,96,0,1,0,1,0
51389,31652,0,0,69,69,0,1,0,1,0
32319,2608,0,0,100,100,0,1,0,1,0
45848,18445,0,0,153,153,0,1,0,1,0
49240,33948,0,0,143,143,0,1,0,1,0
49125,26327,0,0,148,148,0,1,0,1,0
41663,3389,41663,3389,293,223,70,4,0,3,1
16307,25773,0,0,141,141,0,1,0,1,0
53991,16882,0,0,109,109,0,1,0,1,0
24716,32242,0,0,78,78,0,1,0,1,0
51723,31652,0,0,63,63,0,1,0,1,0
16351,25388,0,0,144,144,0,1,0,1,0
29005,29282,0,0,111,111,0,1,0,1,0
9228,61248,0,0,141,141,0,1,0,1,0
50250,31652,0,0,111,111,0,1,0,1,0
50198,34021,0,0,120,120,0,1,0,1,0
11093,3389,11093,3389,293,223,70,4,0,3,1
9995,3389,9995,3389,293,223,70,4,1,3,1
22709,33669,0,0,65,65,0,1,0,1,0
28210,30335,0,0,100,100,0,1,0,1,0
9469,3389,9469,3389,293,223,70,4,0,3,1
18666,3389,18666,3389,293,223,70,4,0,3,1
3548,23248,0,0,157,157,0,1,0,1,0
57345,32753,0,0,101,101,0,1,0,1,0
17216,16496,0,0,85,85,0,1,0,1,0
56705,5343,7888,417,163,154,8,1,0,1,0
27018,34021,0,0,62,62,0,1,0,1,0
19301,3389,19301,3389,293,223,70,4,0,3,1
13634,3389,13634,3389,293,223,70,4,0,3,1
49830,34021,0,0,129,129,0,1,0,1,0
8927,25773,0,0,153,153,0,1,0,1,0
18213,19475,0,0,75,75,0,1,0,1,0
17307,3389,17307,3389,293,223,70,4,0,3,1
10872,3389,10872,3389,293,223,70,4,0,3,1
7441,25773,0,0,141,141,0,1,0,1,0
28961,34021,0,0,62,62,0,1,0,1,0
8177,25773,0,0,156,156,0,1,0,1,0
20534,61248,0,0,156,156,0,1,0,1,0
52031,32401,0,0,62,62,0,1,0,1,0
29819,33362,0,0,68,68,0,1,0,1,0
28268,27536,0,0,129,129,0,1,0,1,0
17816,3389,17816,3389,293,223,70,4,0,3,1
49397,33806,0,0,138,138,0,1,0,1,0
18210,3389,18210,3389,293,223,70,4,0,3,1
48934,26483,0,0,155,155,0,1,0,1,0
48973,28048,0,0,153,153,0,1,0,1,0
38429,8530,0,0,145,145,0,1,0,1,0
51139,33024,0,0,97,97,0,1,0,1,0
49160,33712,0,0,146,146,0,1,0,1,0
25040,3389,25040,3389,293,223,70,4,0,3,1
8375,25773,0,0,155,155,0,1,0,1,0
48044,5618,0,0,145,145,0,1,0,1,0
42432,3389,42432,3389,293,223,70,4,0,3,1
49820,28056,0,0,123,123,0,1,0,1,0
11411,3389,11411,3389,293,223,70,4,1,3,1
63264,31652,0,0,62,62,0,1,0,1,0
14462,48454,0,0,102,102,0,1,0,1,0
50870,32096,0,0,85,85,0,1,0,1,0
13962,3389,13962,3389,293,223,70,4,0,3,1
12221,3389,12221,3389,293,223,70,4,1,3,1
14479,3389,14479,3389,293,223,70,4,0,3,1
21178,61248,0,0,157,157,0,1,0,1,0
3601,25773,0,0,142,142,0,1,0,1,0
2582,38867,0,0,144,144,0,1,0,1,0
16266,3389,16266,3389,293,223,70,4,0,3,1
64110,31652,0,0,62,62,0,1,0,1,0
30245,4243,0,0,101,101,0,1,0,1,0
3491,49962,0,0,143,143,0,1,0,1,0
5678,51283,0,0,142,142,0,1,0,1,0
14001,3389,14001,3389,293,223,70,4,0,3,1
4277,25773,0,0,145,145,0,1,0,1,0
27468,60973,0,0,137,137,0,1,0,1,0
19729,3389,19729,3389,293,223,70,4,0,3,1
54888,60793,0,0,113,113,0,1,0,1,0
42612,34021,0,0,117,117,0,1,0,1,0
16555,19109,0,0,71,71,0,1,0,1,0
23833,34021,0,0,62,62,0,1,0,1,0
6387,25773,0,0,151,151,0,1,0,1,0
36664,3389,36664,3389,293,223,70,4,0,3,1
13111,3389,13111,3389,293,223,70,4,0,3,1
10328,59600,0,0,143,143,0,1,0,1,0
52081,32549,0,0,62,62,0,1,0,1,0
34670,34021,0,0,82,82,0,1,0,1,0
10447,3389,10447,3389,293,223,70,4,1,3,1
49824,33272,0,0,122,122,0,1,0,1,0
13050,3269,12157,3269,284,217,67,3,0,2,0
29290,34021,0,0,62,62,0,1,0,1,0
27937,34021,0,0,62,62,0,1,0,1,0
19724,3389,19724,3389,293,223,70,4,0,3,1
17130,19657,0,0,76,76,0,1,0,1,0
9512,61248,0,0,139,139,0,1,0,1,0
14136,23434,0,0,115,115,0,1,0,1,0
51553,31652,0,0,66,66,0,1,0,1,0
26658,28097,0,0,123,123,0,1,0,1,0
16601,3389,16601,3389,293,223,70,4,0,3,1
21987,3570,0,0,87,87,0,1,0,1,0
49497,27253,0,0,135,135,0,1,0,1,0
27252,3389,27252,3389,293,223,70,4,0,3,1
45747,59568,0,0,63,63,0,1,0,1,0
27013,1507,0,0,76,76,0,1,0,1,0
28551,12808,0,0,111,111,0,1,0,1,0
50789,30006,0,0,108,108,0,1,0,1,0
37112,3389,37112,3389,293,223,70,4,1,3,1
48682,37603,0,0,134,134,0,1,0,1,0
9328,3389,9328,3389,293,223,70,4,1,3,1
26441,1023,0,0,71,71,0,1,0,1,0
61988,31652,0,0,75,75,0,1,0,1,0
60999,31652,0,0,62,62,0,1,0,1,0
21330,61248,0,0,157,157,0,1,0,1,0
14607,12099,0,0,144,144,0,1,0,1,0
19539,28598,0,0,115,115,0,1,0,1,0
51746,31585,0,0,63,63,0,1,0,1,0
34309,3389,34309,3389,293,223,70,4,1,3,1
4487,23768,0,0,157,157,0,1,0,1,0
25043,3389,25043,3389,293,223,70,4,0,3,1
49654,27642,0,0,129,129,0,1,0,1,0
55495,6834,0,0,141,141,0,1,0,1,0
52765,35031,0,0,71,71,0,1,0,1,0
17177,3389,17177,3389,293,223,70,4,0,3,1
13621,3389,13621,3389,293,223,70,4,0,3,1
28880,3389,28880,3389,293,223,70,4,0,3,1
16050,21019,0,0,90,90,0,1,0,1,0
16769,20112,0,0,81,81,0,1,0,1,0
19710,26943,0,0,131,131,0,1,0,1,0
37087,8066,0,0,146,146,0,1,0,1,0
51467,32017,0,0,70,70,0,1,0,1,0
33406,14378,0,0,146,146,0,1,0,1,0
8068,25773,0,0,140,140,0,1,0,1,0
53575,33337,0,0,121,121,0,1,0,1,0
12975,21338,0,0,141,141,0,1,0,1,0
14602,55467,0,0,153,153,0,1,0,1,0
63238,31841,0,0,68,68,0,1,0,1,0
51697,33628,0,0,132,132,0,1,0,1,0
7515,25773,0,0,155,155,0,1,0,1,0
15053,3389,15053,3389,293,223,70,4,0,3,1
3214,23064,0,0,157,157,0,1,0,1,0
49003,28083,0,0,152,152,0,1,0,1,0
38143,3389,38143,3389,293,223,70,4,1,3,1
30860,4764,0,0,106,106,0,1,0,1,0
21296,25773,0,0,144,144,0,1,0,1,0
49086,29975,0,0,149,149,0,1,0,1,0
47950,60223,0,0,74,74,0,1,0,1,0
49354,26896,0,0,140,140,0,1,0,1,0
27215,34021,0,0,62,62,0,1,0,1,0
48966,27229,0,0,154,154,0,1,0,1,0
14480,3389,14480,3389,293,223,70,4,0,3,1
15709,3389,15709,3389,293,223,70,4,0,3,1
59360,3389,59360,3389,293,223,70,4,0,3,1
12463,7014,6266,1936,230,190,39,2,0,2,0
10642,3389,10642,3389,293,223,70,4,1,3,1
48044,6907,0,0,145,145,0,1,0,1,0
15123,12968,0,0,132,132,0,1,0,1,0
16329,3389,16329,3389,293,223,70,4,0,3,1
18392,18347,0,0,63,63,0,1,0,1,0
35021,10770,0,0,146,146,0,1,0,1,0
48367,6852,0,0,145,145,0,1,0,1,0
39436,60359,0,0,87,87,0,1,0,1,0
5716,51339,0,0,142,142,0,1,0,1,0
17380,3389,17380,3389,293,223,70,4,0,3,1
20140,61248,0,0,154,154,0,1,0,1,0
9356,3389,9356,3389,293,223,70,4,1,3,1
54018,45769,0,0,145,145,0,1,0,1,0
52574,34015,0,0,62,62,0,1,0,1,0
24065,29953,0,0,101,101,0,1,0,1,0
50748,29545,0,0,96,96,0,1,0,1,0
50988,30036,0,0,88,88,0,1,0,1,0
22389,33888,0,0,63,63,0,1,0,1,0
13905,54924,0,0,124,124,0,1,0,1,0
29246,34021,0,0,62,62,0,1,0,1,0
22189,3389,22189,3389,293,223,70,4,0,3,1
59525,61174,0,0,139,139,0,1,0,1,0
50478,29694,0,0,100,100,0,1,0,1,0
50268,29172,0,0,107,107,0,1,0,1,0
11716,3389,11716,3389,293,223,70,4,1,3,1
43290,3389,43290,3389,293,223,70,4,0,3,1
8705,61248,0,0,140,140,0,1,0,1,0
14717,52940,0,0,118,118,0,1,0,1,0
28677,1267,0,0,80,80,0,1,0,1,0
29629,33798,0,0,64,64,0,1,0,1,0
29483,31677,0,0,86,86,0,1,0,1,0
7040,60284,0,0,139,139,0,1,0,1,0
4198,25773,0,0,142,142,0,1,0,1,0
8720,61248,0,0,139,139,0,1,0,1,0
14688,3389,14688,3389,293,223,70,4,0,3,1
14283,3389,14283,3389,293,223,70,4,0,3,1
10810,3389,10810,3389,293,223,70,4,1,3,1
17524,3389,17524,3389,293,223,70,4,0,3,1
10724,3389,10724,3389,293,223,70,4,1,3,1
51865,28109,0,0,81,81,0,1,0,1,0
13984,3389,13984,3389,293,223,70,4,0,3,1
6942,23218,0,0,152,152,0,1,0,1,0
51000,32356,0,0,86,86,0,1,0,1,0
50365,32487,0,0,116,116,0,1,0,1,0
20514,30408,0,0,97,97,0,1,0,1,0
18071,24024,0,0,124,124,0,1,0,1,0
10063,61248,0,0,139,139,0,1,0,1,0
21870,20953,0,0,92,92,0,1,0,1,0
17201,3389,17201,3389,293,223,70,4,0,3,1
50852,31652,0,0,86,86,0,1,0,1,0
21166,27949,0,0,121,121,0,1,0,1,0
52511,33823,0,0,62,62,0,1,0,1,0
17240,61248,0,0,151,151,0,1,0,1,0
11502,3261,10555,3261,284,216,67,3,0,2,0
27151,706,0,0,72,72,0,1,0,1,0
11406,6989,5252,1946,231,191,40,2,0,2,0
28130,1066,0,0,77,77,0,1,0,1,0
11840,3389,11840,3389,293,223,70,4,1,3,1
14417,11781,71,26,149,148,0,1,0,1,0
21111,3389,21111,3389,293,223,70,4,1,3,1
51276,31673,0,0,71,71,0,1,0,1,0
50440,29600,0,0,101,101,0,1,0,1,0
19174,61248,0,0,152,152,0,1,0,1,0
36123,8757,0,0,146,146,0,1,0,1,0
2825,22849,0,0,157,157,0,1,0,1,0
2279,22291,0,0,154,154,0,1,0,1,0
55328,7681,0,0,139,139,0,1,0,1,0
18450,1820,6769,1820,186,148,37,2,0,2,0
16186,3389,16186,3389,293,223,70,4,0,3,1
16776,3389,16776,3389,293,223,70,4,1,3,1
15878,14241,0,0,115,115,0,1,0,1,0
18022,3389,18022,3389,293,223,70,4,0,3,1
21208,3389,21208,3389,293,223,70,4,0,3,1
50519,29796,0,0,98,98,0,1,0,1,0
16671,15578,0,0,97,97,0,1,0,1,0
20991,31293,0,0,88,88,0,1,0,1,0
51473,31652,0,0,67,67,0,1,0,1,0
42646,5618,0,0,145,145,0,1,0,1,0
18517,3389,18517,3389,293,223,70,4,0,3,1
34899,60592,0,0,106,106,0,1,0,1,0
32818,3389,32818,3389,293,223,70,4,0,3,1
51706,31652,0,0,64,64,0,1,0,1,0
18038,25090,0,0,135,135,0,1,0,1,0
38984,8436,0,0,145,145,0,1,0,1,0
2836,35341,0,0,143,143,0,1,0,1,0
41907,7943,0,0,145,145,0,1,0,1,0
51701,31722,0,0,64,64,0,1,0,1,0
18658,3389,18658,3389,293,223,70,4,0,3,1
6557,53316,0,0,144,144,0,1,0,1,0
8372,61248,0,0,140,140,0,1,0,1,0
18951,61248,0,0,154,154,0,1,0,1,0
11137,61248,0,0,142,142,0,1,0,1,0
13517,54634,0,0,152,152,0,1,0,1,0
29900,33986,0,0,62,62,0,1,0,1,0
12045,53504,0,0,151,151,0,1,0,1,0
57892,31652,0,0,62,62,0,1,0,1,0
6556,25773,0,0,141,141,0,1,0,1,0
49431,27088,0,0,137,137,0,1,0,1,0
39521,6320,0,0,146,146,0,1,0,1,0
31510,5314,0,0,111,111,0,1,0,1,0
48947,26781,0,0,155,155,0,1,0,1,0
9480,57017,0,0,140,140,0,1,0,1,0
24762,30773,0,0,95,95,0,1,0,1,0
43662,60142,0,0,70,70,0,1,0,1,0
4164,25773,0,0,144,144,0,1,0,1,0
14215,23335,0,0,114,114,0,1,0,1,0
23644,22281,0,0,108,108,0,1,0,1,0
7361,53821,0,0,141,141,0,1,0,1,0
21549,32328,0,0,78,78,0,1,0,1,0
51473,3389,51473,3389,293,223,70,4,0,3,1
21802,3389,21802,3389,293,223,70,4,0,3,1
9185,3389,9185,3389,293,223,70,4,1,3,1
49350,60338,0,0,82,82,0,1,0,1,0
12052,6019,7556,2335,247,199,48,3,0,2,0
26471,34021,0,0,62,62,0,1,0,1,0
15495,3389,15495,3389,293,223,70,4,0,3,1
18024,25787,0,0,142,142,0,1,0,1,0
48932,26453,0,0,155,155,0,1,0,1,0
12095,3389,12095,3389,293,223,70,4,1,3,1
50075,33193,0,0,116,116,0,1,0,1,0
38148,3389,38148,3389,293,223,70,4,1,3,1
21165,3389,21165,3389,293,223,70,4,0,3,1
2009,23395,0,0,151,151,0,1,0,1,0
48929,26616,0,0,155,155,0,1,0,1,0
21561,25773,0,0,144,144,0,1,0,1,0
9703,24593,0,0,142,142,0,1,0,1,0
8751,61248,0,0,140,140,0,1,0,1,0
53667,19041,0,0,102,102,0,1,0,1,0
1808,23081,0,0,152,152,0,1,0,1,0
35423,3389,35423,3389,293,223,70,4,0,3,1
50474,31652,0,0,99,99,0,1,0,1,0
49800,28007,0,0,124,124,0,1,0,1,0
9482,61248,0,0,139,139,0,1,0,1,0
3614,19925,0,0,155,155,0,1,0,1,0
13616,24091,0,0,121,121,0,1,0,1,0
48772,3389,48772,3389,293,223,70,4,0,3,1
10722,3389,10722,3389,293,223,70,4,1,3,1
23667,34021,0,0,62,62,0,1,0,1,0
30274,1855,0,0,89,89,0,1,0,1,0
18164,21049,0,0,92,92,0,1,0,1,0
13183,20011,0,0,142,142,0,1,0,1,0
41520,5618,0,0,145,145,0,1,0,1,0
38846,6804,0,0,146,146,0,1,0,1,0
7414,53901,0,0,141,141,0,1,0,1,0
49160,31987,0,0,146,146,0,1,0,1,0
33691,3389,33691,3389,293,223,70,4,1,3,1
19716,3389,19716,3389,293,223,70,4,0,3,1
10670,25773,0,0,145,145,0,1,0,1,0
50862,32481,0,0,91,91,0,1,0,1,0
28905,28781,0,0,116,116,0,1,0,1,0
30933,21428,0,0,147,147,0,1,0,1,0
21254,4376,0,0,93,93,0,1,0,1,0
28176,32028,0,0,82,82,0,1,0,1,0
41747,7970,0,0,145,145,0,1,0,1,0
30419,3389,30419,3389,293,223,70,4,0,3,1
13397,58270,0,0,130,130,0,1,0,1,0
54746,8390,0,0,146,146,0,1,0,1,0
17478,16937,0,0,79,79,0,1,0,1,0
19488,41282,0,0,83,83,0,1,0,1,0
20878,3389,20878,3389,293,223,70,4,0,3,1
49160,33146,0,0,146,146,0,1,0,1,0
11423,25773,0,0,142,142,0,1,0,1,0
38024,7393,0,0,146,146,0,1,0,1,0
18486,61248,0,0,151,151,0,1,0,1,0
51346,31652,0,0,70,70,0,1,0,1,0
16700,3389,16700,3389,293,223,70,4,0,3,1
17414,16829,0,0,80,80,0,1,0,1,0
58925,31652,0,0,92,92,0,1,0,1,0
9832,61248,0,0,139,139,0,1,0,1,0
25938,34021,0,0,62,62,0,1,0,1,0
11113,61248,0,0,144,144,0,1,0,1,0
13034,9580,2451,908,186,168,18,1,0,1,0
15364,13374,0,0,127,127,0,1,0,1,0
51409,31652,0,0,69,69,0,1,0,1,0
34978,60588,0,0,106,106,0,1,0,1,0
2818,22478,0,0,154,154,0,1,0,1,0
21831,3389,21831,3389,293,223,70,4,0,3,1
10975,3389,10975,3389,293,223,70,4,1,3,1
51410,60507,0,0,94,94,0,1,0,1,0
21557,3389,21557,3389,293,223,70,4,0,3,1
10107,25773,0,0,148,148,0,1,0,1,0
17183,3389,17183,3389,293,223,70,4,0,3,1
35117,60580,0,0,105,105,0,1,0,1,0
26406,32612,0,0,75,75,0,1,0,1,0
51948,60552,0,0,97,97,0,1,0,1,0
53704,17260,0,0,112,112,0,1,0,1,0
59969,59708,0,0,140,140,0,1,0,1,0
14211,3389,14211,3389,293,223,70,4,0,3,1
12507,8742,3356,1244,201,175,25,2,0,1,0
38036,7385,0,0,146,146,0,1,0,1,0
48930,26405,0,0,155,155,0,1,0,1,0
13543,24182,0,0,122,122,0,1,0,1,0
46896,3389,46896,3389,293,223,70,4,0,3,1
17898,3389,17898,3389,293,223,70,4,1,3,1
21739,61248,0,0,158,158,0,1,0,1,0
48188,41307,0,0,122,122,0,1,0,1,0
13730,3389,13730,3389,293,223,70,4,0,3,1
49160,33387,0,0,146,146,0,1,0,1,0
16605,25773,0,0,142,142,0,1,0,1,0
49509,27011,0,0,136,136,0,1,0,1,0
27032,3389,27032,3389,293,223,70,4,0,3,1
9151,57638,0,0,143,143,0,1,0,1,0
58444,61085,0,0,133,133,0,1,0,1,0
51440,31652,0,0,68,68,0,1,0,1,0
23322,2102,0,0,77,77,0,1,0,1,0
56513,31652,0,0,62,62,0,1,0,1,0
50140,28301,0,0,116,116,0,1,0,1,0
14898,3389,14898,3389,293,223,70,4,0,3,1
22617,34021,0,0,62,62,0,1,0,1,0
63211,3389,63211,3389,293,223,70,4,0,3,1
8548,56634,0,0,143,143,0,1,0,1,0
26812,34021,0,0,62,62,0,1,0,1,0
28120,34009,0,0,62,62,0,1,0,1,0
49160,33884,0,0,146,146,0,1,0,1,0
13958,11051,861,319,161,155,6,1,0,1,0
19872,3389,19872,3389,293,223,70,4,0,3,1
37377,7858,0,0,146,146,0,1,0,1,0
49065,29490,0,0,150,150,0,1,0,1,0
7814,25773,0,0,141,141,0,1,0,1,0
17965,3389,17965,3389,293,223,70,4,0,3,1
7976,25773,0,0,140,140,0,1,0,1,0
10600,3389,10600,3389,293,223,70,4,1,3,1
16095,25773,0,0,145,145,0,1,0,1,0
64264,33089,0,0,66,66,0,1,0,1,0
58618,55081,0,0,127,127,0,1,0,1,0
49235,5618,0,0,145,145,0,1,0,1,0
14716,3389,14716,3389,293,223,70,4,0,3,1
62676,3746,53740,2845,269,210,58,3,0,2,0
11555,3389,11555,3389,293,223,70,4,1,3,1
22700,34021,0,0,62,62,0,1,0,1,0
58670,4817,22979,1216,198,173,25,2,0,1,0
18904,3389,18904,3389,293,223,70,4,0,3,1
9843,56788,0,0,126,126,0,1,0,1,0
35026,10759,0,0,146,146,0,1,0,1,0
10081,25773,0,0,140,140,0,1,0,1,0
49974,5618,0,0,145,145,0,1,0,1,0
7133,29038,0,0,155,155,0,1,0,1,0
14985,3389,14985,3389,293,223,70,4,0,3,1
51331,6352,0,0,145,145,0,1,0,1,0
15705,10477,0,0,138,138,0,1,0,1,0
6815,17540,0,0,153,153,0,1,0,1,0
52593,26211,0,0,79,79,0,1,0,1,0
16822,15831,0,0,94,94,0,1,0,1,0
2556,46649,0,0,144,144,0,1,0,1,0
50680,32309,0,0,92,92,0,1,0,1,0
37494,3389,37494,3389,293,223,70,4,1,3,1
15471,3389,15471,3389,293,223,70,4,0,3,1
17513,25773,0,0,142,142,0,1,0,1,0
15449,3389,15449,3389,293,223,70,4,0,3,1
5892,56946,0,0,140,140,0,1,0,1,0
8017,61248,0,0,139,139,0,1,0,1,0
18301,3389,18301,3389,293,223,70,4,0,3,1
10091,3389,10091,3389,293,223,70,4,1,3,1
28568,3389,28568,3389,293,223,70,4,0,3,1
9140,57621,0,0,143,143,0,1,0,1,0
10396,61248,0,0,143,143,0,1,0,1,0
14123,25773,0,0,148,148,0,1,0,1,0
8706,25773,0,0,140,140,0,1,0,1,0
57465,61005,0,0,128,128,0,1,0,1,0
19850,29175,0,0,109,109,0,1,0,1,0
35228,3389,35228,3389,293,223,70,4,0,3,1
27557,34021,0,0,62,62,0,1,0,1,0
58002,31652,0,0,66,66,0,1,0,1,0
10981,61248,0,0,139,139,0,1,0,1,0
17971,3389,17971,3389,293,223,70,4,0,3,1
19638,3389,19638,3389,293,223,70,4,0,3,1
12730,3389,12730,3389,293,223,70,4,0,3,1
24125,34021,0,0,62,62,0,1,0,1,0
31952,5688,0,0,115,115,0,1,0,1,0
49384,26756,0,0,141,141,0,1,0,1,0
12256,61248,0,0,139,139,0,1,0,1,0
53830,33771,0,0,62,62,0,1,0,1,0
16294,25773,0,0,143,143,0,1,0,1,0
28556,33056,0,0,71,71,0,1,0,1,0
28153,33125,0,0,71,71,0,1,0,1,0
54640,11736,0,0,127,127,0,1,0,1,0
22143,3389,22143,3389,293,223,70,4,0,3,1
18245,18452,0,0,64,64,0,1,0,1,0
2313,22302,0,0,154,154,0,1,0,1,0
54659,60774,0,0,112,112,0,1,0,1,0
12907,22213,0,0,112,112,0,1,0,1,0
15352,3389,15352,3389,293,223,70,4,0,3,1
51034,60477,0,0,92,92,0,1,0,1,0
34784,3389,34784,3389,293,223,70,4,0,3,1
7243,24018,0,0,147,147,0,1,0,1,0
51136,33022,0,0,97,97,0,1,0,1,0
7382,61248,0,0,139,139,0,1,0,1,0
14403,21101,0,0,98,98,0,1,0,1,0
26440,25773,0,0,147,147,0,1,0,1,0
24004,22551,0,0,111,111,0,1,0,1,0
17034,61248,0,0,152,152,0,1,0,1,0
9315,3389,9315,3389,293,223,70,4,1,3,1
11401,61248,0,0,144,144,0,1,0,1,0
48960,27092,0,0,154,154,0,1,0,1,0
13420,54560,0,0,152,152,0,1,0,1,0
54240,15218,0,0,114,114,0,1,0,1,0
20130,1212,3923,1212,144,119,25,2,0,1,0
3694,50552,0,0,143,143,0,1,0,1,0
15541,3389,15541,3389,293,223,70,4,0,3,1
18340,3389,18340,3389,293,223,70,4,0,3,1
58116,32634,0,0,96,96,0,1,0,1,0
51136,32232,0,0,82,82,0,1,0,1,0
16760,3389,16760,3389,293,223,70,4,0,3,1
14055,3389,14055,3389,293,223,70,4,0,3,1
16402,20575,0,0,85,85,0,1,0,1,0
18873,3389,18873,3389,293,223,70,4,0,3,1
14089,3389,14089,3389,293,223,70,4,0,3,1
11617,25773,0,0,152,152,0,1,0,1,0
8472,61248,0,0,140,140,0,1,0,1,0
60400,61204,0,0,145,145,0,1,0,1,0
16552,25773,0,0,143,143,0,1,0,1,0
46187,56311,0,0,74,74,0,1,0,1,0
14012,25773,0,0,148,148,0,1,0,1,0
42121,3389,42121,3389,293,223,70,4,0,3,1
18121,44622,0,0,93,93,0,1,0,1,0
11654,61248,0,0,143,143,0,1,0,1,0
49160,32494,0,0,146,146,0,1,0,1,0
29057,34021,0,0,62,62,0,1,0,1,0
10683,60191,0,0,143,143,0,1,0,1,0
31546,2323,0,0,96,96,0,1,0,1,0
16262,3389,16262,3389,293,223,70,4,0,3,1
19878,25773,0,0,143,143,0,1,0,1,0
49948,22663,0,0,155,155,0,1,0,1,0
53008,5618,0,0,145,145,0,1,0,1,0
16746,15704,0,0,96,96,0,1,0,1,0
11996,3389,11996,3389,293,223,70,4,0,3,1
51463,32009,0,0,70,70,0,1,0,1,0
28531,26908,0,0,136,136,0,1,0,1,0
15711,3389,15711,3389,293,223,70,4,0,3,1
24715,3389,24715,3389,293,223,70,4,0,3,1
51049,31116,0,0,79,79,0,1,0,1,0
4278,25773,0,0,145,145,0,1,0,1,0
43300,3389,43300,3389,293,223,70,4,0,3,1
49110,32443,0,0,148,148,0,1,0,1,0
22169,3389,22169,3389,293,223,70,4,0,3,1
5160,22807,0,0,153,153,0,1,0,1,0
37712,3389,37712,3389,293,223,70,4,1,3,1
3696,19863,0,0,155,155,0,1,0,1,0
50458,34021,0,0,114,114,0,1,0,1,0
39650,7022,0,0,146,146,0,1,0,1,0
60124,60240,0,0,142,142,0,1,0,1,0
15499,3389,15499,3389,293,223,70,4,0,3,1
36358,3389,36358,3389,293,223,70,4,0,3,1
24706,25773,0,0,146,146,0,1,0,1,0
36477,3389,36477,3389,293,223,70,4,0,3,1
16043,3389,16043,3389,293,223,70,4,0,3,1
14582,25773,0,0,147,147,0,1,0,1,0
20105,1218,3941,1218,145,119,25,2,0,1,0
17101,61248,0,0,151,151,0,1,0,1,0
9440,25773,0,0,151,151,0,1,0,1,0
51467,31015,0,0,72,72,0,1,0,1,0
45973,60061,0,0,63,63,0,1,0,1,0
16226,25773,0,0,143,143,0,1,0,1,0
2046,23453,0,0,151,151,0,1,0,1,0
11580,61248,0,0,139,139,0,1,0,1,0
38215,3389,38215,3389,293,223,70,4,1,3,1
63132,3389,63132,3389,293,223,70,4,0,3,1
17363,3389,17363,3389,293,223,70,4,0,3,1
43855,13665,0,0,150,150,0,1,0,1,0
11490,61248,0,0,142,142,0,1,0,1,0
19790,3389,19790,3389,293,223,70,4,0,3,1
18128,22194,0,0,104,104,0,1,0,1,0
29647,32500,0,0,77,77,0,1,0,1,0
11916,61248,0,0,139,139,0,1,0,1,0
13616,24091,0,0,121,121,0,1,0,1,0
28208,30475,0,0,98,98,0,1,0,1,0
35962,60537,0,0,102,102,0,1,0,1,0
49861,3389,49861,3389,293,223,70,4,0,3,1
28148,33365,0,0,68,68,0,1,0,1,0
40358,5851,0,0,146,146,0,1,0,1,0
47843,5618,0,0,145,145,0,1,0,1,0
49834,31652,0,0,124,124,0,1,0,1,0
12187,25773,0,0,139,139,0,1,0,1,0
15852,25773,0,0,141,141,0,1,0,1,0
18281,3389,18281,3389,293,223,70,4,0,3,1
1641,21996,0,0,156,156,0,1,0,1,0
53755,33786,0,0,62,62,0,1,0,1,0
53254,12828,0,0,149,149,0,1,0,1,0
49160,33594,0,0,146,146,0,1,0,1,0
46223,3389,46223,3389,293,223,70,4,0,3,1
24464,183,591,182,74,70,3,1,0,1,0
19668,25773,0,0,143,143,0,1,0,1,0
50590,32411,0,0,95,95,0,1,0,1,0
52076,32533,0,0,62,62,0,1,0,1,0
35410,3745,0,0,117,117,0,1,0,1,0
20046,19586,0,0,77,77,0,1,0,1,0
12159,3389,12159,3389,293,223,70,4,1,3,1
23519,32526,0,0,77,77,0,1,0,1,0
48982,28324,0,0,153,153,0,1,0,1,0
14449,11832,16,6,148,148,0,1,0,1,0
5272,24201,0,0,157,157,0,1,0,1,0
15186,25773,0,0,141,141,0,1,0,1,0
7246,25292,0,0,157,157,0,1,0,1,0
9580,3389,9580,3389,293,223,70,4,1,3,1
50626,32694,0,0,98,98,0,1,0,1,0
27178,34021,0,0,62,62,0,1,0,1,0
10991,3389,10991,3389,293,223,70,4,1,3,1
34049,34021,0,0,79,79,0,1,0,1,0
28166,32513,0,0,77,77,0,1,0,1,0
27422,27018,0,0,135,135,0,1,0,1,0
9697,3389,9697,3389,293,223,70,4,1,3,1
13575,10441,1520,563,172,160,11,1,0,1,0
29852,34021,0,0,62,62,0,1,0,1,0
22219,3389,22219,3389,293,223,70,4,0,3,1
18203,19787,0,0,78,78,0,1,0,1,0
51635,33368,0,0,85,85,0,1,0,1,0
50912,32866,0,0,102,102,0,1,0,1,0
19130,58944,0,0,156,156,0,1,0,1,0
16770,3389,16770,3389,293,223,70,4,0,3,1
14499,12006,0,0,147,147,0,1,0,1,0
54470,3389,54470,3389,293,223,70,4,0,3,1
50089,31652,0,0,113,113,0,1,0,1,0
15897,17479,0,0,145,145,0,1,0,1,0
16449,19637,0,0,145,145,0,1,0,1,0
15083,20596,0,0,91,91,0,1,0,1,0
49709,34021,0,0,132,132,0,1,0,1,0
12076,6076,7482,2312,246,199,47,3,0,2,0
15818,19486,0,0,75,75,0,1,0,1,0
6876,23203,0,0,152,152,0,1,0,1,0
21337,61248,0,0,157,157,0,1,0,1,0
55443,7185,0,0,140,140,0,1,0,1,0
25270,3389,25270,3389,293,223,70,4,0,3,1
39699,5323,0,0,141,141,0,1,0,1,0
8370,16382,0,0,152,152,0,1,0,1,0
40665,3389,40665,3389,293,223,70,4,0,3,1
53568,33823,0,0,62,62,0,1,0,1,0
11657,3389,11657,3389,293,223,70,4,0,3,1
16290,19699,0,0,80,80,0,1,0,1,0
11163,3389,11163,3389,293,223,70,4,1,3,1
50175,31652,0,0,110,110,0,1,0,1,0
27596,34021,0,0,62,62,0,1,0,1,0
55182,5701,0,0,145,145,0,1,0,1,0
46251,3389,46251,3389,293,223,70,4,0,3,1
3674,23318,0,0,157,157,0,1,0,1,0
47617,45585,0,0,108,108,0,1,0,1,0
9516,3389,9516,3389,293,223,70,4,1,3,1
19874,3389,19874,3389,293,223,70,4,0,3,1
43668,3389,43668,3389,293,223,70,4,0,3,1
29653,34021,0,0,62,62,0,1,0,1,0
12379,3389,12379,3389,293,223,70,4,0,3,1
12232,61248,0,0,139,139,0,1,0,1,0
49160,31690,0,0,146,146,0,1,0,1,0
17830,45334,0,0,95,95,0,1,0,1,0
27947,34021,0,0,62,62,0,1,0,1,0
19658,3389,19658,3389,293,223,70,4,0,3,1
11232,3389,11232,3389,293,223,70,4,1,3,1
49746,34021,0,0,131,131,0,1,0,1,0
58659,32808,0,0,62,62,0,1,0,1,0
48938,25862,0,0,155,155,0,1,0,1,0
11551,3389,11551,3389,293,223,70,4,0,3,1
54160,31652,0,0,69,69,0,1,0,1,0
61854,31652,0,0,76,76,0,1,0,1,0
2335,42268,0,0,144,144,0,1,0,1,0
50515,31652,0,0,98,98,0,1,0,1,0
40547,5731,0,0,146,146,0,1,0,1,0
11033,3389,11033,3389,293,223,70,4,0,3,1
21611,3389,21611,3389,293,223,70,4,0,3,1
14961,3389,14961,3389,293,223,70,4,0,3,1
10390,25773,0,0,147,147,0,1,0,1,0
54301,5618,0,0,145,145,0,1,0,1,0
50711,33780,0,0,137,137,0,1,0,1,0
52673,3389,52673,3389,293,223,70,4,0,3,1
15224,3389,15224,3389,293,223,70,4,0,3,1
61209,31652,0,0,64,64,0,1,0,1,0
25387,3389,25387,3389,293,223,70,4,0,3,1
4551,25773,0,0,142,142,0,1,0,1,0
36676,60500,0,0,99,99,0,1,0,1,0
31822,19959,0,0,147,147,0,1,0,1,0
31145,2176,0,0,94,94,0,1,0,1,0
37791,3389,37791,3389,293,223,70,4,1,3,1
13663,9921,2497,771,181,165,15,1,0,1,0
17937,3389,17937,3389,293,223,70,4,0,3,1
26342,3389,26342,3389,293,223,70,4,0,3,1
20496,3389,20496,3389,293,223,70,4,0,3,1
1472,22009,0,0,156,156,0,1,0,1,0
11488,3389,11488,3389,293,223,70,4,1,3,1
11528,3389,11528,3389,293,223,70,4,1,3,1
48964,27741,0,0,154,154,0,1,0,1,0
49160,32386,0,0,146,146,0,1,0,1,0
16153,3389,16153,3389,293,223,70,4,0,3,1
49233,26513,0,0,148,148,0,1,0,1,0
17957,25773,0,0,142,142,0,1,0,1,0
51013,31025,0,0,81,81,0,1,0,1,0
52276,34021,0,0,69,69,0,1,0,1,0
12431,25773,0,0,139,139,0,1,0,1,0
25697,61064,0,0,144,144,0,1,0,1,0
51420,60508,0,0,94,94,0,1,0,1,0
4609,22680,0,0,154,154,0,1,0,1,0
50966,31987,0,0,82,82,0,1,0,1,0
16651,25773,0,0,142,142,0,1,0,1,0
14378,11651,254,78,151,149,1,1,0,1,0
12519,3389,12519,3389,293,223,70,4,1,3,1
29292,34021,0,0,62,62,0,1,0,1,0
56996,31652,0,0,67,67,0,1,0,1,0
51561,32186,0,0,69,69,0,1,0,1,0
58490,61089,0,0,134,134,0,1,0,1,0
17456,19245,0,0,72,72,0,1,0,1,0
15775,20081,0,0,85,85,0,1,0,1,0
20301,3389,20301,3389,293,223,70,4,0,3,1
12130,25773,0,0,139,139,0,1,0,1,0
35628,13669,0,0,146,146,0,1,0,1,0
51663,32371,0,0,68,68,0,1,0,1,0
38082,3389,38082,3389,293,223,70,4,1,3,1
15239,13163,0,0,130,130,0,1,0,1,0
11151,3389,11151,3389,293,223,70,4,1,3,1
53411,12359,0,0,149,149,0,1,0,1,0
17023,61248,0,0,152,152,0,1,0,1,0
63957,3389,63957,3389,293,223,70,4,0,3,1
51613,34021,0,0,85,85,0,1,0,1,0
50630,31652,0,0,94,94,0,1,0,1,0
50357,60421,0,0,88,88,0,1,0,1,0
13883,3389,13883,3389,293,223,70,4,0,3,1
60045,3389,60045,3389,293,223,70,4,0,3,1
38150,3389,38150,3389,293,223,70,4,1,3,1
23487,22164,0,0,106,106,0,1,0,1,0
29455,34021,0,0,62,62,0,1,0,1,0
12368,25773,0,0,150,150,0,1,0,1,0
50323,34021,0,0,117,117,0,1,0,1,0
13555,17632,0,0,144,144,0,1,0,1,0
24446,31219,0,0,91,91,0,1,0,1,0
51373,31652,0,0,75,75,0,1,0,1,0
23192,29349,0,0,107,107,0,1,0,1,0
55511,31652,0,0,62,62,0,1,0,1,0
14581,61248,0,0,147,147,0,1,0,1,0
20145,3389,20145,3389,293,223,70,4,0,3,1
24490,25773,0,0,146,146,0,1,0,1,0
14715,12281,0,0,142,142,0,1,0,1,0
46222,7214,0,0,145,145,0,1,0,1,0
18115,3389,18115,3389,293,223,70,4,0,3,1
48933,26475,0,0,155,155,0,1,0,1,0
3339,28389,0,0,143,143,0,1,0,1,0
29970,4010,0,0,99,99,0,1,0,1,0
27256,34021,0,0,62,62,0,1,0,1,0
51320,31652,0,0,70,70,0,1,0,1,0
23879,32019,0,0,82,82,0,1,0,1,0
64377,32261,0,0,63,63,0,1,0,1,0
28141,33709,0,0,65,65,0,1,0,1,0
6792,25041,0,0,157,157,0,1,0,1,0
10441,61248,0,0,139,139,0,1,0,1,0
21890,61248,0,0,158,158,0,1,0,1,0
11324,3389,11324,3389,293,223,70,4,1,3,1
34342,3352,0,0,112,112,0,1,0,1,0
4221,22966,0,0,151,151,0,1,0,1,0
2723,43700,0,0,146,146,0,1,0,1,0
3890,48586,0,0,143,143,0,1,0,1,0
13063,3389,13063,3389,293,223,70,4,0,3,1
6036,25773,0,0,150,150,0,1,0,1,0
28227,29529,0,0,108,108,0,1,0,1,0
62810,3710,54769,2899,271,211,59,3,0,2,0
5266,51164,0,0,144,144,0,1,0,1,0
12909,26098,0,0,135,135,0,1,0,1,0
15307,61248,0,0,145,145,0,1,0,1,0
9103,25039,0,0,147,147,0,1,0,1,0
35348,8563,0,0,142,142,0,1,0,1,0
28305,60930,0,0,133,133,0,1,0,1,0
18930,3389,18930,3389,293,223,70,4,0,3,1
9793,61248,0,0,139,139,0,1,0,1,0
21724,32654,0,0,75,75,0,1,0,1,0
10491,3389,10491,3389,293,223,70,4,1,3,1
49099,30272,0,0,148,148,0,1,0,1,0
23672,3389,23672,3389,293,223,70,4,1,3,1
7181,25256,0,0,157,157,0,1,0,1,0
6175,25773,0,0,151,151,0,1,0,1,0
2290,42897,0,0,144,144,0,1,0,1,0
14674,3389,14674,3389,293,223,70,4,0,3,1
29067,3246,0,0,92,92,0,1,0,1,0
18539,3389,18539,3389,293,223,70,4,0,3,1
17860,3389,17860,3389,293,223,70,4,0,3,1
11982,3147,10186,3147,276,211,65,3,0,2,0
33881,60644,0,0,110,110,0,1,0,1,0
13734,24785,0,0,146,146,0,1,0,1,0
17647,3389,17647,3389,293,223,70,4,0,3,1
53788,18236,0,0,104,104,0,1,0,1,0
19269,28097,0,0,120,120,0,1,0,1,0
11914,3389,11914,3389,293,223,70,4,0,3,1
20348,17135,0,0,72,72,0,1,0,1,0
46019,7249,0,0,145,145,0,1,0,1,0
14813,12446,0,0,139,139,0,1,0,1,0
12719,26126,0,0,135,135,0,1,0,1,0
43621,3389,43621,3389,293,223,70,4,0,3,1
53373,3389,53373,3389,293,223,70,4,0,3,1
14728,2495,8075,2495,232,180,51,3,0,2,0
50125,28516,0,0,125,125,0,1,0,1,0
22644,615,1990,615,103,91,12,1,0,1,0
3234,42000,0,0,147,147,0,1,0,1,0
11556,25773,0,0,142,142,0,1,0,1,0
9707,25773,0,0,143,143,0,1,0,1,0
13046,61248,0,0,140,140,0,1,0,1,0
25922,29135,0,0,112,112,0,1,0,1,0
48999,28880,0,0,152,152,0,1,0,1,0
16539,3389,16539,3389,293,223,70,4,0,3,1
6924,25114,0,0,157,157,0,1,0,1,0
52425,24803,0,0,91,91,0,1,0,1,0
20654,60114,0,0,157,157,0,1,0,1,0
51871,31927,0,0,62,62,0,1,0,1,0
15268,25773,0,0,146,146,0,1,0,1,0
19152,27879,0,0,122,122,0,1,0,1,0
53089,20889,0,0,102,102,0,1,0,1,0
51070,31652,0,0,84,84,0,1,0,1,0
16416,3389,16416,3389,293,223,70,4,0,3,1
50585,29960,0,0,96,96,0,1,0,1,0
16664,20244,0,0,82,82,0,1,0,1,0
18132,22066,0,0,103,103,0,1,0,1,0
7553,24126,0,0,146,146,0,1,0,1,0
10055,25773,0,0,140,140,0,1,0,1,0
14179,25773,0,0,140,140,0,1,0,1,0
25824,3389,25824,3389,293,223,70,4,0,3,1
21971,25773,0,0,144,144,0,1,0,1,0
50788,60456,0,0,90,90,0,1,0,1,0
50429,29572,0,0,102,102,0,1,0,1,0
17568,2057,7649,2056,202,159,42,2,0,2,0
15554,21645,0,0,96,96,0,1,0,1,0
51849,32385,0,0,80,80,0,1,0,1,0
8945,25773,0,0,140,140,0,1,0,1,0
51931,34021,0,0,77,77,0,1,0,1,0
4610,25773,0,0,146,146,0,1,0,1,0
40728,3389,40728,3389,293,223,70,4,0,3,1
15320,13299,0,0,128,128,0,1,0,1,0
50129,28279,0,0,116,116,0,1,0,1,0
51524,31132,0,0,70,70,0,1,0,1,0
26352,33093,0,0,70,70,0,1,0,1,0
38544,3389,38544,3389,293,223,70,4,1,3,1
37656,3389,37656,3389,293,223,70,4,1,3,1
8200,61248,0,0,139,139,0,1,0,1,0
20944,16821,0,0,74,74,0,1,0,1,0
56863,60955,0,0,124,124,0,1,0,1,0
36978,3389,36978,3389,293,223,70,4,0,3,1
28686,34021,0,0,62,62,0,1,0,1,0
22160,61246,0,0,158,158,0,1,0,1,0
25955,3389,25955,3389,293,223,70,4,1,3,1
50246,3389,50246,3389,293,223,70,4,0,3,1
24070,34021,0,0,62,62,0,1,0,1,0
39586,5282,0,0,140,140,0,1,0,1,0
11166,60997,0,0,143,143,0,1,0,1,0
18091,23375,0,0,117,117,0,1,0,1,0
52434,33594,0,0,62,62,0,1,0,1,0
22638,29540,0,0,106,106,0,1,0,1,0
22506,21428,0,0,98,98,0,1,0,1,0
12335,25707,0,0,138,138,0,1,0,1,0
43765,13451,0,0,150,150,0,1,0,1,0
18247,18235,0,0,62,62,0,1,0,1,0
14127,54380,0,0,122,122,0,1,0,1,0
52558,33964,0,0,62,62,0,1,0,1,0
37832,60441,0,0,94,94,0,1,0,1,0
9515,3389,9515,3389,293,223,70,4,1,3,1
14199,3389,14199,3389,293,223,70,4,0,3,1
14583,3389,14583,3389,293,223,70,4,0,3,1
20376,59901,0,0,157,157,0,1,0,1,0
14870,61248,0,0,144,144,0,1,0,1,0
17380,19341,0,0,73,73,0,1,0,1,0
11028,61248,0,0,139,139,0,1,0,1,0
50462,32554,0,0,100,100,0,1,0,1,0
49065,29495,0,0,150,150,0,1,0,1,0
5915,33087,0,0,152,152,0,1,0,1,0
40846,5618,0,0,145,145,0,1,0,1,0
15210,25773,0,0,141,141,0,1,0,1,0
14969,3389,14969,3389,293,223,70,4,0,3,1
46742,5618,0,0,145,145,0,1,0,1,0
52175,32828,0,0,62,62,0,1,0,1,0
8489,61248,0,0,139,139,0,1,0,1,0
12892,54155,0,0,152,152,0,1,0,1,0
44591,5618,0,0,145,145,0,1,0,1,0
61567,4043,45227,2394,249,200,49,3,0,2,0
56594,31652,0,0,62,62,0,1,0,1,0
54317,33674,0,0,62,62,0,1,0,1,0
49902,33349,0,0,122,122,0,1,0,1,0
13202,3389,13202,3389,293,223,70,4,0,3,1
9671,3389,9671,3389,293,223,70,4,1,3,1
28266,27629,0,0,128,128,0,1,0,1,0
20657,27925,0,0,121,121,0,1,0,1,0
50771,31652,0,0,94,94,0,1,0,1,0
49160,33242,0,0,146,146,0,1,0,1,0
49334,34441,0,0,145,145,0,1,0,1,0
52524,33863,0,0,62,62,0,1,0,1,0
1595,22169,0,0,157,157,0,1,0,1,0
18715,26342,0,0,137,137,0,1,0,1,0
51677,33397,0,0,84,84,0,1,0,1,0
21461,61248,0,0,158,158,0,1,0,1,0
11208,61248,0,0,139,139,0,1,0,1,0
10258,5162,7227,2678,262,207,55,3,0,2,0
18060,24393,0,0,128,128,0,1,0,1,0
19114,26667,0,0,134,134,0,1,0,1,0
20847,61248,0,0,157,157,0,1,0,1,0
3242,25324,0,0,144,144,0,1,0,1,0
8576,61248,0,0,140,140,0,1,0,1,0
2986,24924,0,0,146,146,0,1,0,1,0
16552,25773,0,0,141,141,0,1,0,1,0
16836,3389,16836,3389,293,223,70,4,0,3,1
9571,3389,9571,3389,293,223,70,4,1,3,1
61827,32177,0,0,62,62,0,1,0,1,0
22056,33693,0,0,65,65,0,1,0,1,0
17685,8300,0,0,122,122,0,1,0,1,0
5524,25773,0,0,142,142,0,1,0,1,0
5403,25773,0,0,142,142,0,1,0,1,0
49731,31652,0,0,125,125,0,1,0,1,0
23019,3389,23019,3389,293,223,70,4,0,3,1
23784,32153,0,0,81,81,0,1,0,1,0
54257,14001,0,0,121,121,0,1,0,1,0
20125,27491,0,0,126,126,0,1,0,1,0
14379,11656,248,76,151,149,1,1,0,1,0
29843,34021,0,0,62,62,0,1,0,1,0
15553,3389,15553,3389,293,223,70,4,0,3,1
28712,27815,0,0,126,126,0,1,0,1,0
10741,25773,0,0,153,153,0,1,0,1,0
4770,25773,0,0,146,146,0,1,0,1,0
21894,3389,21894,3389,293,223,70,4,0,3,1
52239,33016,0,0,62,62,0,1,0,1,0
50006,60392,0,0,86,86,0,1,0,1,0
22357,21317,0,0,97,97,0,1,0,1,0
47345,46495,0,0,102,102,0,1,0,1,0
44951,60075,0,0,65,65,0,1,0,1,0
15985,21102,0,0,91,91,0,1,0,1,0
13730,23946,0,0,120,120,0,1,0,1,0
25552,34021,0,0,62,62,0,1,0,1,0
9965,25773,0,0,149,149,0,1,0,1,0
30319,3389,30319,3389,293,223,70,4,0,3,1
51315,31743,0,0,71,71,0,1,0,1,0
20768,61248,0,0,156,156,0,1,0,1,0
13435,10218,1761,652,175,162,13,1,0,1,0
7612,61248,0,0,139,139,0,1,0,1,0
10010,59070,0,0,143,143,0,1,0,1,0
11888,25773,0,0,143,143,0,1,0,1,0
48919,26147,0,0,156,156,0,1,0,1,0
14426,61248,0,0,147,147,0,1,0,1,0
8284,56194,0,0,143,143,0,1,0,1,0
27879,26373,0,0,141,141,0,1,0,1,0
11321,3389,11321,3389,293,223,70,4,1,3,1
12371,3389,12371,3389,293,223,70,4,1,3,1
7135,25231,0,0,157,157,0,1,0,1,0
50664,31652,0,0,93,93,0,1,0,1,0
49160,33709,0,0,146,146,0,1,0,1,0
49763,33475,0,0,126,126,0,1,0,1,0
32296,16858,0,0,146,146,0,1,0,1,0
43574,5618,0,0,145,145,0,1,0,1,0
24661,30915,0,0,94,94,0,1,0,1,0
5395,51380,0,0,144,144,0,1,0,1,0
9070,61248,0,0,139,139,0,1,0,1,0
50452,28941,0,0,105,105,0,1,0,1,0
32522,10713,0,0,130,130,0,1,0,1,0
51198,31486,0,0,74,74,0,1,0,1,0
2124,45189,0,0,144,144,0,1,0,1,0
51459,31652,0,0,68,68,0,1,0,1,0
49452,3389,49452,3389,293,223,70,4,0,3,1
21419,3389,21419,3389,293,223,70,4,0,3,1
17478,3389,17478,3389,293,223,70,4,0,3,1
2537,46203,0,0,145,145,0,1,0,1,0
6908,25773,0,0,141,141,0,1,0,1,0
13935,25773,0,0,140,140,0,1,0,1,0
52032,32520,0,0,64,64,0,1,0,1,0
49866,32141,0,0,128,128,0,1,0,1,0
13366,3389,13366,3389,293,223,70,4,0,3,1
60118,32517,0,0,62,62,0,1,0,1,0
13123,3389,13123,3389,293,223,70,4,0,3,1
52227,15882,0,0,151,151,0,1,0,1,0
15132,22177,0,0,102,102,0,1,0,1,0
17733,18895,0,0,68,68,0,1,0,1,0
52541,33912,0,0,62,62,0,1,0,1,0
19624,61248,0,0,155,155,0,1,0,1,0
3168,23038,0,0,157,157,0,1,0,1,0
35942,3389,35942,3389,293,223,70,4,0,3,1
15791,3389,15791,3389,293,223,70,4,0,3,1
6031,32701,0,0,152,152,0,1,0,1,0
10372,58362,0,0,140,140,0,1,0,1,0
8284,23528,0,0,151,151,0,1,0,1,0
13062,59168,0,0,133,133,0,1,0,1,0
60535,60398,0,0,142,142,0,1,0,1,0
25871,3389,25871,3389,293,223,70,4,0,3,1
6653,24174,0,0,125,125,0,1,0,1,0
16605,20319,0,0,83,83,0,1,0,1,0
49047,30407,0,0,150,150,0,1,0,1,0
40314,5751,0,0,146,146,0,1,0,1,0
13215,3389,13215,3389,293,223,70,4,0,3,1
19308,3389,19308,3389,293,223,70,4,0,3,1
46225,34021,0,0,133,133,0,1,0,1,0
10283,3389,10283,3389,293,223,70,4,1,3,1
17518,61248,0,0,152,152,0,1,0,1,0
2326,23891,0,0,149,149,0,1,0,1,0
9582,3389,9582,3389,293,223,70,4,0,3,1
16267,25773,0,0,141,141,0,1,0,1,0
14319,21163,0,0,98,98,0,1,0,1,0
24107,3389,24107,3389,293,223,70,4,0,3,1
49073,26120,0,0,151,151,0,1,0,1,0
15700,20137,0,0,85,85,0,1,0,1,0
18889,43577,0,0,89,89,0,1,0,1,0
17085,25773,0,0,142,142,0,1,0,1,0
11481,3389,11481,3389,293,223,70,4,1,3,1
2040,22415,0,0,157,157,0,1,0,1,0
38476,4873,0,0,134,134,0,1,0,1,0
35009,3389,35009,3389,293,223,70,4,0,3,1
17940,46115,0,0,96,96,0,1,0,1,0
52557,34006,0,0,62,62,0,1,0,1,0
21843,3389,21843,3389,293,223,70,4,0,3,1
33445,3022,0,0,107,107,0,1,0,1,0
14898,3389,14898,3389,293,223,70,4,0,3,1
3218,49169,0,0,143,143,0,1,0,1,0
51251,31617,0,0,72,72,0,1,0,1,0
48961,25892,0,0,155,155,0,1,0,1,0
14560,61248,0,0,147,147,0,1,0,1,0
23276,34021,0,0,62,62,0,1,0,1,0
10331,25773,0,0,139,139,0,1,0,1,0
23802,34021,0,0,62,62,0,1,0,1,0
8221,25773,0,0,143,143,0,1,0,1,0
48952,26903,0,0,154,154,0,1,0,1,0
51747,31652,0,0,62,62,0,1,0,1,0
46376,19713,0,0,153,153,0,1,0,1,0
15172,25773,0,0,143,143,0,1,0,1,0
49753,32063,0,0,131,131,0,1,0,1,0
28166,34021,0,0,62,62,0,1,0,1,0
11874,61248,0,0,140,140,0,1,0,1,0
19099,27782,0,0,123,123,0,1,0,1,0
15217,3389,15217,3389,293,223,70,4,0,3,1
51116,32250,0,0,83,83,0,1,0,1,0
22931,33357,0,0,68,68,0,1,0,1,0
12677,3389,12677,3389,293,223,70,4,0,3,1
52739,6114,0,0,145,145,0,1,0,1,0
54715,33594,0,0,62,62,0,1,0,1,0
26475,457,0,0,68,68,0,1,0,1,0
14504,3389,14504,3389,293,223,70,4,0,3,1
51070,32292,0,0,84,84,0,1,0,1,0
47084,5618,0,0,145,145,0,1,0,1,0
21530,3389,21530,3389,293,223,70,4,0,3,1
34437,7793,0,0,134,134,0,1,0,1,0
28227,29537,0,0,108,108,0,1,0,1,0
51107,31652,0,0,77,77,0,1,0,1,0
24631,30957,0,0,93,93,0,1,0,1,0
10257,3389,10257,3389,293,223,70,4,1,3,1
51437,34021,0,0,90,90,0,1,0,1,0
9843,61248,0,0,141,141,0,1,0,1,0
27005,33433,0,0,67,67,0,1,0,1,0
26168,25773,0,0,146,146,0,1,0,1,0
31202,5054,0,0,109,109,0,1,0,1,0
10985,3389,10985,3389,293,223,70,4,1,3,1
20915,4748,0,0,96,96,0,1,0,1,0
16732,3389,16732,3389,293,223,70,4,0,3,1
25172,3389,25172,3389,293,223,70,4,0,3,1
14893,52510,0,0,117,117,0,1,0,1,0
17114,3389,17114,3389,293,223,70,4,0,3,1
39338,8377,0,0,145,145,0,1,0,1,0
16946,3389,16946,3389,293,223,70,4,0,3,1
49152,31478,0,0,146,146,0,1,0,1,0
27889,2249,0,0,83,83,0,1,0,1,0
11861,25773,0,0,140,140,0,1,0,1,0
24595,703,0,0,67,67,0,1,0,1,0
48985,27649,0,0,153,153,0,1,0,1,0
17471,25773,0,0,143,143,0,1,0,1,0
59099,58057,0,0,145,145,0,1,0,1,0
28223,60935,0,0,133,133,0,1,0,1,0
16662,20247,0,0,82,82,0,1,0,1,0
18150,61248,0,0,150,150,0,1,0,1,0
34831,34021,0,0,83,83,0,1,0,1,0
36266,3389,36266,3389,293,223,70,4,0,3,1
50111,31652,0,0,112,112,0,1,0,1,0
48983,33096,0,0,141,141,0,1,0,1,0
11834,61248,0,0,139,139,0,1,0,1,0
17681,3389,17681,3389,293,223,70,4,0,3,1
10739,23823,0,0,132,132,0,1,0,1,0
4863,53954,0,0,141,141,0,1,0,1,0
11000,3389,11000,3389,293,223,70,4,1,3,1
17552,3389,17552,3389,293,223,70,4,0,3,1
49578,27289,0,0,139,139,0,1,0,1,0
52503,33853,0,0,63,63,0,1,0,1,0
20806,61248,0,0,156,156,0,1,0,1,0
51637,31910,0,0,86,86,0,1,0,1,0
14000,3389,14000,3389,293,223,70,4,0,3,1
28842,28467,0,0,119,119,0,1,0,1,0
9238,3389,9238,3389,293,223,70,4,1,3,1
11008,3389,11008,3389,293,223,70,4,1,3,1
13253,3389,13253,3389,293,223,70,4,0,3,1
30850,20086,0,0,147,147,0,1,0,1,0
49996,31652,0,0,119,119,0,1,0,1,0
51387,31872,0,0,71,71,0,1,0,1,0
3597,47017,0,0,146,146,0,1,0,1,0
58668,31652,0,0,62,62,0,1,0,1,0
48411,39636,0,0,127,127,0,1,0,1,0
49427,6673,0,0,145,145,0,1,0,1,0
12107,24410,0,0,147,147,0,1,0,1,0
27957,26263,0,0,142,142,0,1,0,1,0
2702,37194,0,0,144,144,0,1,0,1,0
11082,3389,11082,3389,293,223,70,4,0,3,1
25491,25773,0,0,146,146,0,1,0,1,0
10774,61248,0,0,143,143,0,1,0,1,0
28212,30273,0,0,101,101,0,1,0,1,0
19495,28516,0,0,116,116,0,1,0,1,0
28655,3389,28655,3389,293,223,70,4,0,3,1
19622,3389,19622,3389,293,223,70,4,0,3,1
8159,61248,0,0,139,139,0,1,0,1,0
29297,12414,0,0,114,114,0,1,0,1,0
49258,26500,0,0,145,145,0,1,0,1,0
28286,26673,0,0,138,138,0,1,0,1,0
20304,61248,0,0,156,156,0,1,0,1,0
20144,61248,0,0,156,156,0,1,0,1,0
50433,31652,0,0,101,101,0,1,0,1,0
20254,3389,20254,3389,293,223,70,4,0,3,1
48989,25987,0,0,153,153,0,1,0,1,0
9726,3389,9726,3389,293,223,70,4,1,3,1
14971,3389,14971,3389,293,223,70,4,0,3,1
13553,3389,13553,3389,293,223,70,4,0,3,1
13842,10355,1934,597,173,161,12,1,0,1,0
13580,12502,0,0,148,148,0,1,0,1,0
30449,20984,0,0,147,147,0,1,0,1,0
18977,1486,4809,1486,163,132,30,2,0,1,0
18455,3389,18455,3389,293,223,70,4,0,3,1
50859,31652,0,0,91,91,0,1,0,1,0
57880,3389,57880,3389,293,223,70,4,0,3,1
50211,31652,0,0,109,109,0,1,0,1,0
16582,25773,0,0,145,145,0,1,0,1,0
19714,61248,0,0,155,155,0,1,0,1,0
18138,21865,0,0,100,100,0,1,0,1,0
30280,60829,0,0,125,125,0,1,0,1,0
24906,32341,0,0,77,77,0,1,0,1,0
35669,3389,35669,3389,293,223,70,4,0,3,1
24842,34021,0,0,62,62,0,1,0,1,0
21710,3389,21710,3389,293,223,70,4,0,3,1
14305,12832,0,0,147,147,0,1,0,1,0
30506,4464,0,0,103,103,0,1,0,1,0
49117,32654,0,0,147,147,0,1,0,1,0
11943,61248,0,0,140,140,0,1,0,1,0
17864,25174,0,0,143,143,0,1,0,1,0
36442,3389,36442,3389,293,223,70,4,0,3,1
48963,27159,0,0,154,154,0,1,0,1,0
36609,8409,0,0,146,146,0,1,0,1,0
34705,60602,0,0,107,107,0,1,0,1,0
60147,60590,0,0,145,145,0,1,0,1,0
55261,31652,0,0,62,62,0,1,0,1,0
37789,3389,37789,3389,293,223,70,4,1,3,1
32015,5742,0,0,115,115,0,1,0,1,0
6761,59473,0,0,139,139,0,1,0,1,0
41400,3389,41400,3389,293,223,70,4,0,3,1
11255,3389,11255,3389,293,223,70,4,1,3,1
36163,8729,0,0,146,146,0,1,0,1,0
51820,32321,0,0,81,81,0,1,0,1,0
26536,25773,0,0,147,147,0,1,0,1,0
14642,53122,0,0,118,118,0,1,0,1,0
27406,3389,27406,3389,293,223,70,4,1,3,1
28212,30247,0,0,101,101,0,1,0,1,0
28243,28756,0,0,116,116,0,1,0,1,0
12236,25773,0,0,139,139,0,1,0,1,0
12777,3389,12777,3389,293,223,70,4,0,3,1
2778,46388,0,0,145,145,0,1,0,1,0
22217,3389,22217,3389,293,223,70,4,0,3,1
50431,3389,50431,3389,293,223,70,4,0,3,1
51256,32125,0,0,78,78,0,1,0,1,0
13163,22022,0,0,109,109,0,1,0,1,0
19373,3389,19373,3389,293,223,70,4,0,3,1
7851,55473,0,0,143,143,0,1,0,1,0
19251,1421,4598,1421,158,129,29,2,0,1,0
22787,3389,22787,3389,293,223,70,4,1,3,1
5639,25773,0,0,149,149,0,1,0,1,0
8082,61248,0,0,139,139,0,1,0,1,0
25562,34021,0,0,62,62,0,1,0,1,0
54590,5618,0,0,145,145,0,1,0,1,0
29581,3389,29581,3389,293,223,70,4,0,3,1
18309,61248,0,0,151,151,0,1,0,1,0
9267,24917,0,0,146,146,0,1,0,1,0
10889,6167,6140,2275,245,198,47,3,0,2,0
12296,3389,12296,3389,293,223,70,4,1,3,1
15120,3389,15120,3389,293,223,70,4,0,3,1
18374,26435,0,0,136,136,0,1,0,1,0
10363,3389,10363,3389,293,223,70,4,1,3,1
37127,3389,37127,3389,293,223,70,4,1,3,1
63092,41668,0,0,90,90,0,1,0,1,0
18101,3389,18101,3389,293,223,70,4,0,3,1
19835,27255,0,0,128,128,0,1,0,1,0
15826,3389,15826,3389,293,223,70,4,0,3,1
28299,26021,0,0,145,145,0,1,0,1,0
17740,2011,7477,2010,199,157,41,2,0,2,0
55076,9167,0,0,135,135,0,1,0,1,0
11974,3389,11974,3389,293,223,70,4,1,3,1
16040,3389,16040,3389,293,223,70,4,0,3,1
59317,31652,0,0,90,90,0,1,0,1,0
50504,29758,0,0,99,99,0,1,0,1,0
16578,56985,0,0,155,155,0,1,0,1,0
60576,4308,37614,1991,231,190,41,2,0,2,0
11064,25773,0,0,152,152,0,1,0,1,0
34861,3389,34861,3389,293,223,70,4,0,3,1
18237,7693,0,0,117,117,0,1,0,1,0
1585,22049,0,0,156,156,0,1,0,1,0
9947,25773,0,0,143,143,0,1,0,1,0
2851,47017,0,0,144,144,0,1,0,1,0
17134,2173,8082,2173,210,165,44,2,0,2,0
57220,50290,0,0,114,114,0,1,0,1,0
51208,31652,0,0,73,73,0,1,0,1,0
23883,34021,0,0,62,62,0,1,0,1,0
12933,61248,0,0,145,145,0,1,0,1,0
12384,3389,12384,3389,293,223,70,4,1,3,1
15720,3389,15720,3389,293,223,70,4,0,3,1
49160,32655,0,0,146,146,0,1,0,1,0
13369,3389,13369,3389,293,223,70,4,0,3,1
3407,27456,0,0,143,143,0,1,0,1,0
12714,13147,0,0,149,149,0,1,0,1,0
49656,31652,0,0,130,130,0,1,0,1,0
34801,3389,34801,3389,293,223,70,4,0,3,1
50193,33085,0,0,112,112,0,1,0,1,0
10744,24095,0,0,148,148,0,1,0,1,0
51293,31137,0,0,95,95,0,1,0,1,0
3170,23040,0,0,157,157,0,1,0,1,0
16792,15781,0,0,95,95,0,1,0,1,0
18075,61248,0,0,153,153,0,1,0,1,0
20751,3389,20751,3389,293,223,70,4,0,3,1
58181,53480,0,0,121,121,0,1,0,1,0
64268,31652,0,0,63,63,0,1,0,1,0
28157,32924,0,0,73,73,0,1,0,1,0
62871,31652,0,0,63,63,0,1,0,1,0
16771,25773,0,0,142,142,0,1,0,1,0
42243,9798,0,0,148,148,0,1,0,1,0
49939,33315,0,0,120,120,0,1,0,1,0
11488,3389,11488,3389,293,223,70,4,0,3,1
11169,3389,11169,3389,293,223,70,4,0,3,1
49570,31652,0,0,132,132,0,1,0,1,0
21398,3389,21398,3389,293,223,70,4,0,3,1
55099,5618,0,0,145,145,0,1,0,1,0
18098,23149,0,0,114,114,0,1,0,1,0
23229,476,1540,476,94,84,9,1,0,1,0
14729,3389,14729,3389,293,223,70,4,0,3,1
20175,29779,0,0,103,103,0,1,0,1,0
12375,25773,0,0,150,150,0,1,0,1,0
52028,32392,0,0,62,62,0,1,0,1,0
11084,3389,11084,3389,293,223,70,4,0,3,1
26175,33001,0,0,71,71,0,1,0,1,0
11300,24223,0,0,148,148,0,1,0,1,0
13348,10081,1909,707,178,163,14,1,0,1,0
15714,3389,15714,3389,293,223,70,4,0,3,1
18024,25787,0,0,142,142,0,1,0,1,0
5221,22822,0,0,153,153,0,1,0,1,0
2788,47036,0,0,144,144,0,1,0,1,0
16884,25773,0,0,143,143,0,1,0,1,0
10540,5611,6741,2498,254,203,51,3,0,2,0
27589,34021,0,0,62,62,0,1,0,1,0
56407,47318,0,0,102,102,0,1,0,1,0
38370,3389,38370,3389,293,223,70,4,0,3,1
12830,25082,0,0,131,131,0,1,0,1,0
22284,33693,0,0,65,65,0,1,0,1,0
22135,3389,22135,3389,293,223,70,4,0,3,1
15297,25773,0,0,141,141,0,1,0,1,0
62347,3389,62347,3389,293,223,70,4,0,3,1
43691,7642,0,0,145,145,0,1,0,1,0
14353,3389,14353,3389,293,223,70,4,0,3,1
52109,32632,0,0,62,62,0,1,0,1,0
10121,3389,10121,3389,293,223,70,4,1,3,1
48738,60288,0,0,79,79,0,1,0,1,0
34491,3389,34491,3389,293,223,70,4,0,3,1
52536,33992,0,0,63,63,0,1,0,1,0
16922,3389,16922,3389,293,223,70,4,1,3,1
19507,61248,0,0,153,153,0,1,0,1,0
48435,5618,0,0,145,145,0,1,0,1,0
4910,25773,0,0,142,142,0,1,0,1,0
50719,6455,0,0,145,145,0,1,0,1,0
26251,25773,0,0,147,147,0,1,0,1,0
50789,31652,0,0,88,88,0,1,0,1,0
18924,61248,0,0,154,154,0,1,0,1,0
16300,3389,16300,3389,293,223,70,4,1,3,1
18920,3389,18920,3389,293,223,70,4,0,3,1
25479,34021,0,0,62,62,0,1,0,1,0
23566,34021,0,0,62,62,0,1,0,1,0
11279,3389,11279,3389,293,223,70,4,0,3,1
35117,3637,0,0,116,116,0,1,0,1,0
18320,25773,0,0,143,143,0,1,0,1,0
28284,26743,0,0,137,137,0,1,0,1,0
8054,25738,0,0,157,157,0,1,0,1,0
32275,10843,0,0,129,129,0,1,0,1,0
47053,49811,0,0,95,95,0,1,0,1,0
50554,29884,0,0,97,97,0,1,0,1,0
20922,25773,0,0,144,144,0,1,0,1,0
10545,3389,10545,3389,293,223,70,4,0,3,1
16270,3389,16270,3389,293,223,70,4,0,3,1
56619,3389,56619,3389,293,223,70,4,0,3,1
28300,25995,0,0,145,145,0,1,0,1,0
28536,26935,0,0,135,135,0,1,0,1,0
32966,6547,0,0,123,123,0,1,0,1,0
8372,25582,0,0,154,154,0,1,0,1,0
49100,26265,0,0,149,149,0,1,0,1,0
10734,5920,6407,2374,249,200,49,3,0,2,0
51293,31703,0,0,71,71,0,1,0,1,0
12850,61248,0,0,145,145,0,1,0,1,0
64206,33514,0,0,67,67,0,1,0,1,0
29901,3952,0,0,99,99,0,1,0,1,0
14292,3389,14292,3389,293,223,70,4,1,3,1
20585,25773,0,0,144,144,0,1,0,1,0
17859,18736,0,0,67,67,0,1,0,1,0
52343,33325,0,0,62,62,0,1,0,1,0
31741,3389,31741,3389,293,223,70,4,0,3,1
9166,25773,0,0,152,152,0,1,0,1,0
19469,61248,0,0,155,155,0,1,0,1,0
7571,25773,0,0,141,141,0,1,0,1,0
51593,31820,0,0,67,67,0,1,0,1,0
47636,5618,0,0,145,145,0,1,0,1,0
11822,61248,0,0,140,140,0,1,0,1,0
19921,3389,19921,3389,293,223,70,4,0,3,1
17915,45126,0,0,95,95,0,1,0,1,0
26327,3389,26327,3389,293,223,70,4,0,3,1
12114,8116,4034,1495,211,181,30,2,0,1,0
59000,31652,0,0,66,66,0,1,0,1,0
51405,31990,0,0,73,73,0,1,0,1,0
37947,3389,37947,3389,293,223,70,4,1,3,1
41603,5618,0,0,145,145,0,1,0,1,0
47213,7047,0,0,145,145,0,1,0,1,0
42014,7925,0,0,145,145,0,1,0,1,0
52414,33535,0,0,62,62,0,1,0,1,0
3446,26915,0,0,143,143,0,1,0,1,0
5646,25773,0,0,142,142,0,1,0,1,0
37149,3389,37149,3389,293,223,70,4,1,3,1
50650,32343,0,0,93,93,0,1,0,1,0
15175,28116,0,0,117,117,0,1,0,1,0
15433,3389,15433,3389,293,223,70,4,0,3,1
50514,32590,0,0,112,112,0,1,0,1,0
16845,3389,16845,3389,293,223,70,4,0,3,1
27658,2053,0,0,81,81,0,1,0,1,0
8059,61248,0,0,139,139,0,1,0,1,0
57358,31652,0,0,67,67,0,1,0,1,0
18556,18469,0,0,64,64,0,1,0,1,0
13347,20750,0,0,88,88,0,1,0,1,0
11381,25773,0,0,142,142,0,1,0,1,0
46450,5618,0,0,145,145,0,1,0,1,0
51231,30999,0,0,96,96,0,1,0,1,0
8459,61248,0,0,140,140,0,1,0,1,0
48649,60281,0,0,78,78,0,1,0,1,0
46246,55488,0,0,75,75,0,1,0,1,0
50395,34021,0,0,115,115,0,1,0,1,0
49160,34001,0,0,146,146,0,1,0,1,0
50124,33148,0,0,115,115,0,1,0,1,0
37334,3389,37334,3389,293,223,70,4,1,3,1
13692,3389,13692,3389,293,223,70,4,1,3,1
16596,20330,0,0,83,83,0,1,0,1,0
25197,34021,0,0,62,62,0,1,0,1,0
28211,30308,0,0,100,100,0,1,0,1,0
25481,34021,0,0,62,62,0,1,0,1,0
55791,45397,0,0,100,100,0,1,0,1,0
45990,18788,0,0,153,153,0,1,0,1,0
6822,25058,0,0,157,157,0,1,0,1,0
35172,8415,0,0,140,140,0,1,0,1,0
7279,25310,0,0,157,157,0,1,0,1,0
5704,25773,0,0,142,142,0,1,0,1,0
11100,23555,0,0,129,129,0,1,0,1,0
21520,61248,0,0,157,157,0,1,0,1,0
20597,19999,0,0,82,82,0,1,0,1,0
29646,34021,0,0,62,62,0,1,0,1,0
36574,3389,36574,3389,293,223,70,4,0,3,1
50577,31652,0,0,138,138,0,1,0,1,0
11218,3389,11218,3389,293,223,70,4,1,3,1
12670,3389,12670,3389,293,223,70,4,0,3,1
4251,49474,0,0,144,144,0,1,0,1,0
31935,3389,31935,3389,293,223,70,4,0,3,1
52261,28432,0,0,72,72,0,1,0,1,0
11473,21709,0,0,99,99,0,1,0,1,0
18043,24928,0,0,133,133,0,1,0,1,0
44830,34021,0,0,127,127,0,1,0,1,0
63535,38430,0,0,81,81,0,1,0,1,0
28272,27348,0,0,131,131,0,1,0,1,0
49090,30053,0,0,148,148,0,1,0,1,0
58290,53858,0,0,122,122,0,1,0,1,0
15162,3389,15162,3389,293,223,70,4,0,3,1
52364,27743,0,0,74,74,0,1,0,1,0
28735,27927,0,0,125,125,0,1,0,1,0
13773,26548,0,0,131,131,0,1,0,1,0
37718,3389,37718,3389,293,223,70,4,0,3,1
50127,28521,0,0,125,125,0,1,0,1,0
1970,23335,0,0,151,151,0,1,0,1,0
13654,16994,0,0,144,144,0,1,0,1,0
1669,22864,0,0,153,153,0,1,0,1,0
8258,61248,0,0,139,139,0,1,0,1,0
8171,25773,0,0,140,140,0,1,0,1,0
12153,3389,12153,3389,293,223,70,4,0,3,1
49177,26389,0,0,149,149,0,1,0,1,0
24711,23080,0,0,117,117,0,1,0,1,0
11627,3389,11627,3389,293,223,70,4,0,3,1
21895,25773,0,0,144,144,0,1,0,1,0
26265,3389,26265,3389,293,223,70,4,0,3,1
11655,61248,0,0,141,141,0,1,0,1,0
49966,5618,0,0,145,145,0,1,0,1,0
50899,31652,0,0,90,90,0,1,0,1,0
2931,24838,0,0,146,146,0,1,0,1,0
1868,23175,0,0,152,152,0,1,0,1,0
22840,21679,0,0,101,101,0,1,0,1,0
49971,34021,0,0,126,126,0,1,0,1,0
21864,35617,0,0,66,66,0,1,0,1,0
50674,32651,0,0,97,97,0,1,0,1,0
41322,60262,0,0,79,79,0,1,0,1,0
52427,33515,0,0,128,128,0,1,0,1,0
14752,3389,14752,3389,293,223,70,4,0,3,1
18040,17885,0,0,66,66,0,1,0,1,0
30737,3389,30737,3389,293,223,70,4,1,3,1
28149,34021,0,0,62,62,0,1,0,1,0
21280,20510,0,0,87,87,0,1,0,1,0
18117,3389,18117,3389,293,223,70,4,0,3,1
10916,3389,10916,3389,293,223,70,4,0,3,1
15535,3389,15535,3389,293,223,70,4,0,3,1
10770,3389,10770,3389,293,223,70,4,1,3,1
47318,60171,0,0,71,71,0,1,0,1,0
18207,18298,0,0,62,62,0,1,0,1,0
47789,60210,0,0,73,73,0,1,0,1,0
29139,29954,0,0,104,104,0,1,0,1,0
18181,20506,0,0,86,86,0,1,0,1,0
3673,40543,0,0,148,148,0,1,0,1,0
34756,60599,0,0,107,107,0,1,0,1,0
17900,18502,0,0,65,65,0,1,0,1,0
54071,15098,0,0,118,118,0,1,0,1,0
17181,46919,0,0,100,100,0,1,0,1,0
27712,2099,0,0,81,81,0,1,0,1,0
49637,27274,0,0,132,132,0,1,0,1,0
56706,5343,7895,418,163,154,8,1,0,1,0
14778,2483,8036,2483,231,179,51,3,0,2,0
51461,32006,0,0,70,70,0,1,0,1,0
51662,32369,0,0,68,68,0,1,0,1,0
35468,3389,35468,3389,293,223,70,4,0,3,1
12098,25773,0,0,139,139,0,1,0,1,0
16543,15362,0,0,100,100,0,1,0,1,0
7426,61248,0,0,139,139,0,1,0,1,0
38102,9580,0,0,146,146,0,1,0,1,0
38158,7298,0,0,146,146,0,1,0,1,0
11900,25773,0,0,139,139,0,1,0,1,0
26381,28487,0,0,119,119,0,1,0,1,0
54446,5825,0,0,145,145,0,1,0,1,0
8454,61248,0,0,140,140,0,1,0,1,0
50109,33162,0,0,115,115,0,1,0,1,0
7200,25773,0,0,154,154,0,1,0,1,0
36605,8412,0,0,146,146,0,1,0,1,0
11510,4705,9260,2861,270,211,59,3,0,2,0
18674,25773,0,0,143,143,0,1,0,1,0
54197,33698,0,0,62,62,0,1,0,1,0
21358,25773,0,0,144,144,0,1,0,1,0
32189,3389,32189,3389,293,223,70,4,0,3,1
37869,34021,0,0,96,96,0,1,0,1,0
20678,3389,20678,3389,293,223,70,4,0,3,1
28032,34021,0,0,62,62,0,1,0,1,0
3709,48312,0,0,144,144,0,1,0,1,0
34642,3389,34642,3389,293,223,70,4,0,3,1
21922,30788,0,0,92,92,0,1,0,1,0
49956,33300,0,0,120,120,0,1,0,1,0
23626,432,1603,431,91,82,8,1,0,1,0
18023,25564,0,0,140,140,0,1,0,1,0
8428,55431,0,0,141,141,0,1,0,1,0
24322,25773,0,0,146,146,0,1,0,1,0
6633,25773,0,0,141,141,0,1,0,1,0
15368,13381,0,0,127,127,0,1,0,1,0
27507,60971,0,0,136,136,0,1,0,1,0
49069,29583,0,0,149,149,0,1,0,1,0
50956,29969,0,0,89,89,0,1,0,1,0
51521,31652,0,0,67,67,0,1,0,1,0
16031,61248,0,0,149,149,0,1,0,1,0
53877,38533,0,0,75,75,0,1,0,1,0
32027,17459,0,0,147,147,0,1,0,1,0
49481,31875,0,0,138,138,0,1,0,1,0
61203,3389,61203,3389,293,223,70,4,0,3,1
49718,34021,0,0,132,132,0,1,0,1,0
12668,3389,12668,3389,293,223,70,4,0,3,1
50559,31652,0,0,101,101,0,1,0,1,0
17126,25773,0,0,142,142,0,1,0,1,0
54310,60746,0,0,110,110,0,1,0,1,0
48996,28777,0,0,152,152,0,1,0,1,0
25033,32407,0,0,77,77,0,1,0,1,0
17360,18904,0,0,70,70,0,1,0,1,0
21901,3389,21901,3389,293,223,70,4,0,3,1
17594,8400,0,0,122,122,0,1,0,1,0
26420,34021,0,0,62,62,0,1,0,1,0
8671,61248,0,0,140,140,0,1,0,1,0
14651,3389,14651,3389,293,223,70,4,0,3,1
29566,32092,0,0,82,82,0,1,0,1,0
11309,4219,9890,3056,278,215,63,3,0,2,0
54835,8124,0,0,146,146,0,1,0,1,0
11674,5102,8745,2702,263,207,55,3,0,2,0
46687,5618,0,0,145,145,0,1,0,1,0
15958,21135,0,0,91,91,0,1,0,1,0
12255,3389,12255,3389,293,223,70,4,1,3,1
8254,25773,0,0,140,140,0,1,0,1,0
19387,3389,19387,3389,293,223,70,4,0,3,1
51387,31652,0,0,69,69,0,1,0,1,0
11580,13991,0,0,149,149,0,1,0,1,0
20942,3389,20942,3389,293,223,70,4,0,3,1
14321,21161,0,0,98,98,0,1,0,1,0
2813,22476,0,0,154,154,0,1,0,1,0
13640,3389,13640,3389,293,223,70,4,0,3,1
50226,32820,0,0,108,108,0,1,0,1,0
49054,29229,0,0,150,150,0,1,0,1,0
28854,28524,0,0,119,119,0,1,0,1,0
49268,26683,0,0,143,143,0,1,0,1,0
5806,18292,0,0,153,153,0,1,0,1,0
13772,3389,13772,3389,293,223,70,4,1,3,1
28181,31772,0,0,85,85,0,1,0,1,0
10819,25263,0,0,141,141,0,1,0,1,0
2689,22433,0,0,154,154,0,1,0,1,0
7329,23829,0,0,122,122,0,1,0,1,0
14648,61248,0,0,143,143,0,1,0,1,0
56685,52220,0,0,145,145,0,1,0,1,0
28237,29043,0,0,113,113,0,1,0,1,0
1436,22500,0,0,154,154,0,1,0,1,0
16266,20746,0,0,87,87,0,1,0,1,0
52402,60589,0,0,99,99,0,1,0,1,0
52329,33572,0,0,63,63,0,1,0,1,0
52203,33180,0,0,71,71,0,1,0,1,0
3879,39856,0,0,148,148,0,1,0,1,0
4909,54086,0,0,141,141,0,1,0,1,0
18372,30707,0,0,92,92,0,1,0,1,0
6303,17921,0,0,153,153,0,1,0,1,0
11933,61248,0,0,140,140,0,1,0,1,0
3793,25773,0,0,142,142,0,1,0,1,0
52269,5618,0,0,145,145,0,1,0,1,0
54423,5829,0,0,145,145,0,1,0,1,0
49884,28216,0,0,121,121,0,1,0,1,0
13196,61248,0,0,146,146,0,1,0,1,0
41024,5618,0,0,145,145,0,1,0,1,0
51760,3389,51760,3389,293,223,70,4,0,3,1
51002,31652,0,0,86,86,0,1,0,1,0
16679,20225,0,0,82,82,0,1,0,1,0
37236,3389,37236,3389,293,223,70,4,1,3,1
10431,25773,0,0,146,146,0,1,0,1,0
52308,33222,0,0,62,62,0,1,0,1,0
8167,25773,0,0,156,156,0,1,0,1,0
49138,31823,0,0,145,145,0,1,0,1,0
39982,5989,0,0,146,146,0,1,0,1,0
5150,23290,0,0,150,150,0,1,0,1,0
54193,31652,0,0,69,69,0,1,0,1,0
3475,25689,0,0,143,143,0,1,0,1,0
50891,29837,0,0,91,91,0,1,0,1,0
50229,3389,50229,3389,293,223,70,4,0,3,1
28141,33692,0,0,65,65,0,1,0,1,0
1728,22955,0,0,153,153,0,1,0,1,0
37024,8767,0,0,145,145,0,1,0,1,0
9146,25773,0,0,155,155,0,1,0,1,0
56987,32809,0,0,103,103,0,1,0,1,0
28287,26604,0,0,139,139,0,1,0,1,0
28288,34021,0,0,62,62,0,1,0,1,0
24065,278,898,277,80,75,5,1,0,1,0
52168,33101,0,0,72,72,0,1,0,1,0
63989,31746,0,0,62,62,0,1,0,1,0
51828,32338,0,0,81,81,0,1,0,1,0
22123,3421,0,0,86,86,0,1,0,1,0
16707,3389,16707,3389,293,223,70,4,0,3,1
23762,30456,0,0,97,97,0,1,0,1,0
47665,34021,0,0,139,139,0,1,0,1,0
12982,61248,0,0,146,146,0,1,0,1,0
51294,31652,0,0,71,71,0,1,0,1,0
11925,61248,0,0,140,140,0,1,0,1,0
43923,7602,0,0,145,145,0,1,0,1,0
27875,33809,0,0,64,64,0,1,0,1,0
53508,18419,0,0,109,109,0,1,0,1,0
11664,3389,11664,3389,293,223,70,4,1,3,1
59562,59176,0,0,145,145,0,1,0,1,0
11595,61248,0,0,141,141,0,1,0,1,0
10068,61248,0,0,141,141,0,1,0,1,0
28146,33455,0,0,67,67,0,1,0,1,0
10375,3389,10375,3389,293,223,70,4,0,3,1
59025,61133,0,0,137,137,0,1,0,1,0
13582,3389,13582,3389,293,223,70,4,0,3,1
23708,3389,23708,3389,293,223,70,4,0,3,1
49160,33466,0,0,146,146,0,1,0,1,0
2515,22373,0,0,154,154,0,1,0,1,0
15911,17531,0,0,145,145,0,1,0,1,0
50050,32269,0,0,124,124,0,1,0,1,0
6995,25153,0,0,157,157,0,1,0,1,0
3408,25585,0,0,143,143,0,1,0,1,0
14872,3389,14872,3389,293,223,70,4,0,3,1
6742,59416,0,0,139,139,0,1,0,1,0
11579,61248,0,0,141,141,0,1,0,1,0
16069,27743,0,0,120,120,0,1,0,1,0
13319,10033,1961,726,179,164,15,1,0,1,0
28671,34021,0,0,62,62,0,1,0,1,0
24976,284,0,0,64,64,0,1,0,1,0
11474,7097,5135,1903,229,190,39,2,0,2,0
17833,17536,0,0,71,71,0,1,0,1,0
11060,61248,0,0,143,143,0,1,0,1,0
11236,3389,11236,3389,293,223,70,4,1,3,1
14826,3389,14826,3389,293,223,70,4,0,3,1
30223,3389,30223,3389,293,223,70,4,0,3,1
28926,28888,0,0,115,115,0,1,0,1,0
6395,25773,0,0,151,151,0,1,0,1,0
8805,61248,0,0,140,140,0,1,0,1,0
18352,3389,18352,3389,293,223,70,4,0,3,1
27840,25424,0,0,144,144,0,1,0,1,0
5615,25773,0,0,149,149,0,1,0,1,0
21949,3389,21949,3389,293,223,70,4,0,3,1
16901,15965,0,0,92,92,0,1,0,1,0
31716,5489,0,0,113,113,0,1,0,1,0
33847,34021,0,0,79,79,0,1,0,1,0
19544,19209,0,0,73,73,0,1,0,1,0
51216,31532,0,0,73,73,0,1,0,1,0
50635,32674,0,0,109,109,0,1,0,1,0
55431,6352,0,0,145,145,0,1,0,1,0
28194,31155,0,0,91,91,0,1,0,1,0
20196,29817,0,0,103,103,0,1,0,1,0
41294,5618,0,0,145,145,0,1,0,1,0
45920,58151,0,0,67,67,0,1,0,1,0
13182,2862,9264,2862,257,198,59,3,0,2,0
37964,3389,37964,3389,293,223,70,4,1,3,1
22535,28896,0,0,112,112,0,1,0,1,0
31098,4965,0,0,108,108,0,1,0,1,0
20634,3389,20634,3389,293,223,70,4,0,3,1
17509,61248,0,0,149,149,0,1,0,1,0
4309,23669,0,0,157,157,0,1,0,1,0
12934,61248,0,0,146,146,0,1,0,1,0
28193,31178,0,0,91,91,0,1,0,1,0
29639,60862,0,0,128,128,0,1,0,1,0
8174,25773,0,0,156,156,0,1,0,1,0
39041,5081,0,0,137,137,0,1,0,1,0
49264,26673,0,0,143,143,0,1,0,1,0
15516,61248,0,0,149,149,0,1,0,1,0
48970,35442,0,0,141,141,0,1,0,1,0
10522,61248,0,0,143,143,0,1,0,1,0
49257,31719,0,0,143,143,0,1,0,1,0
49476,33664,0,0,134,134,0,1,0,1,0
9692,24871,0,0,143,143,0,1,0,1,0
13242,3389,13242,3389,293,223,70,4,0,3,1
19211,3389,19211,3389,293,223,70,4,0,3,1
27260,24990,0,0,139,139,0,1,0,1,0
19322,26675,0,0,134,134,0,1,0,1,0
15284,3389,15284,3389,293,223,70,4,0,3,1
51288,31652,0,0,71,71,0,1,0,1,0
47398,7016,0,0,145,145,0,1,0,1,0
18151,21474,0,0,96,96,0,1,0,1,0
46863,20881,0,0,154,154,0,1,0,1,0
51266,30603,0,0,78,78,0,1,0,1,0
9512,61248,0,0,141,141,0,1,0,1,0
18086,23546,0,0,119,119,0,1,0,1,0
11594,3389,11594,3389,293,223,70,4,0,3,1
51930,32100,0,0,62,62,0,1,0,1,0
13327,24455,0,0,125,125,0,1,0,1,0
48431,24642,0,0,156,156,0,1,0,1,0
25366,34021,0,0,62,62,0,1,0,1,0
23889,3389,23889,3389,293,223,70,4,0,3,1
44517,5618,0,0,145,145,0,1,0,1,0
50265,3389,50265,3389,293,223,70,4,0,3,1
54342,31652,0,0,62,62,0,1,0,1,0
52059,34021,0,0,74,74,0,1,0,1,0
28264,27720,0,0,127,127,0,1,0,1,0
21022,27850,0,0,122,122,0,1,0,1,0
12027,3389,12027,3389,293,223,70,4,1,3,1
17038,3389,17038,3389,293,223,70,4,0,3,1
2646,46799,0,0,144,144,0,1,0,1,0
56412,32898,0,0,106,106,0,1,0,1,0
41242,3389,41242,3389,293,223,70,4,0,3,1
11182,3910,10290,3180,284,218,65,3,0,2,0
21195,61248,0,0,157,157,0,1,0,1,0
17938,3389,17938,3389,293,223,70,4,0,3,1
43086,5618,0,0,145,145,0,1,0,1,0
49381,60341,0,0,82,82,0,1,0,1,0
24350,34021,0,0,62,62,0,1,0,1,0
49246,33923,0,0,142,142,0,1,0,1,0
29384,31183,0,0,91,91,0,1,0,1,0
7725,25773,0,0,141,141,0,1,0,1,0
49360,34021,0,0,141,141,0,1,0,1,0
16288,25773,0,0,141,141,0,1,0,1,0
28755,25028,0,0,147,147,0,1,0,1,0
19440,3389,19440,3389,293,223,70,4,0,3,1
49979,28189,0,0,129,129,0,1,0,1,0
50961,31652,0,0,82,82,0,1,0,1,0
13582,3389,13582,3389,293,223,70,4,0,3,1
52348,33862,0,0,67,67,0,1,0,1,0
18122,25859,0,0,142,142,0,1,0,1,0
11269,3389,11269,3389,293,223,70,4,0,3,1
23571,34021,0,0,62,62,0,1,0,1,0
16570,25773,0,0,141,141,0,1,0,1,0
20488,27480,0,0,126,126,0,1,0,1,0
48300,6863,0,0,145,145,0,1,0,1,0
49886,34021,0,0,128,128,0,1,0,1,0
19400,29476,0,0,104,104,0,1,0,1,0
28282,34021,0,0,62,62,0,1,0,1,0
29680,23500,0,0,147,147,0,1,0,1,0
49936,28092,0,0,130,130,0,1,0,1,0
23203,34021,0,0,62,62,0,1,0,1,0
9788,3389,9788,3389,293,223,70,4,1,3,1
51595,32248,0,0,69,69,0,1,0,1,0
13641,9867,2567,793,181,165,16,1,0,1,0
10819,61248,0,0,139,139,0,1,0,1,0
4863,47989,0,0,146,146,0,1,0,1,0
22007,21055,0,0,94,94,0,1,0,1,0
28808,34021,0,0,62,62,0,1,0,1,0
37444,3389,37444,3389,293,223,70,4,1,3,1
26596,28183,0,0,122,122,0,1,0,1,0
5041,24074,0,0,157,157,0,1,0,1,0
22043,35040,0,0,65,65,0,1,0,1,0
9120,61248,0,0,141,141,0,1,0,1,0
49933,33150,0,0,118,118,0,1,0,1,0
46607,5618,0,0,145,145,0,1,0,1,0
6795,23862,0,0,147,147,0,1,0,1,0
25807,34021,0,0,62,62,0,1,0,1,0
16147,61248,0,0,146,146,0,1,0,1,0
20368,27690,0,0,124,124,0,1,0,1,0
11229,61248,0,0,139,139,0,1,0,1,0
17083,3389,17083,3389,293,223,70,4,0,3,1
11730,3389,11730,3389,293,223,70,4,0,3,1
37758,3389,37758,3389,293,223,70,4,1,3,1
51826,33500,0,0,80,80,0,1,0,1,0
50341,29353,0,0,105,105,0,1,0,1,0
29474,34021,0,0,62,62,0,1,0,1,0
50567,31652,0,0,96,96,0,1,0,1,0
14686,25773,0,0,147,147,0,1,0,1,0
41901,8979,0,0,147,147,0,1,0,1,0
17334,16695,0,0,82,82,0,1,0,1,0
5793,51456,0,0,142,142,0,1,0,1,0
37547,3389,37547,3389,293,223,70,4,1,3,1
21118,61248,0,0,157,157,0,1,0,1,0
5577,56029,0,0,141,141,0,1,0,1,0
28842,3389,28842,3389,293,223,70,4,0,3,1
28234,29194,0,0,112,112,0,1,0,1,0
37446,3389,37446,3389,293,223,70,4,0,3,1
7565,61248,0,0,139,139,0,1,0,1,0
1247,22204,0,0,155,155,0,1,0,1,0
19522,6280,0,0,107,107,0,1,0,1,0
5524,51050,0,0,142,142,0,1,0,1,0
17134,3389,17134,3389,293,223,70,4,0,3,1
23241,29383,0,0,107,107,0,1,0,1,0
10363,3389,10363,3389,293,223,70,4,1,3,1
49004,28086,0,0,152,152,0,1,0,1,0
9607,25773,0,0,150,150,0,1,0,1,0
21099,3389,21099,3389,293,223,70,4,0,3,1
15139,22169,0,0,102,102,0,1,0,1,0
36160,8913,0,0,145,145,0,1,0,1,0
62225,48016,0,0,107,107,0,1,0,1,0
51567,31752,0,0,88,88,0,1,0,1,0
1264,22229,0,0,155,155,0,1,0,1,0
29511,3389,29511,3389,293,223,70,4,0,3,1
59466,61169,0,0,139,139,0,1,0,1,0
12691,7566,5550,1715,221,185,35,2,0,2,0
28189,31384,0,0,89,89,0,1,0,1,0
8757,56983,0,0,143,143,0,1,0,1,0
35374,9982,0,0,146,146,0,1,0,1,0
49242,26534,0,0,148,148,0,1,0,1,0
11448,3389,11448,3389,293,223,70,4,0,3,1
44501,5618,0,0,145,145,0,1,0,1,0
39889,6056,0,0,146,146,0,1,0,1,0
50793,32784,0,0,105,105,0,1,0,1,0
19496,3389,19496,3389,293,223,70,4,0,3,1
49580,27458,0,0,132,132,0,1,0,1,0
11571,61248,0,0,141,141,0,1,0,1,0
15504,3389,15504,3389,293,223,70,4,0,3,1
12067,61248,0,0,139,139,0,1,0,1,0
11348,3389,11348,3389,293,223,70,4,0,3,1
52237,33010,0,0,62,62,0,1,0,1,0
23162,15651,0,0,85,85,0,1,0,1,0
59827,31652,0,0,87,87,0,1,0,1,0
15050,3389,15050,3389,293,223,70,4,0,3,1
55892,45529,0,0,97,97,0,1,0,1,0
25272,32531,0,0,75,75,0,1,0,1,0
6195,25773,0,0,141,141,0,1,0,1,0
17989,1721,5568,1720,179,143,35,2,0,2,0
7984,25773,0,0,156,156,0,1,0,1,0
61096,31652,0,0,62,62,0,1,0,1,0
17049,3389,17049,3389,293,223,70,4,0,3,1
12319,3389,12319,3389,293,223,70,4,0,3,1
28185,31563,0,0,87,87,0,1,0,1,0
50031,31652,0,0,115,115,0,1,0,1,0
28221,29827,0,0,105,105,0,1,0,1,0
23855,3389,23855,3389,293,223,70,4,0,3,1
26243,24228,0,0,130,130,0,1,0,1,0
50236,31652,0,0,108,108,0,1,0,1,0
49017,29458,0,0,152,152,0,1,0,1,0
31126,3389,31126,3389,293,223,70,4,1,3,1
18499,58460,0,0,156,156,0,1,0,1,0
49160,33081,0,0,146,146,0,1,0,1,0
47825,6944,0,0,145,145,0,1,0,1,0
15150,3389,15150,3389,293,223,70,4,0,3,1
14315,61248,0,0,143,143,0,1,0,1,0
50196,28992,0,0,110,110,0,1,0,1,0
50033,33230,0,0,117,117,0,1,0,1,0
4346,25773,0,0,145,145,0,1,0,1,0
19847,3389,19847,3389,293,223,70,4,0,3,1
30056,4084,0,0,100,100,0,1,0,1,0
58873,31652,0,0,62,62,0,1,0,1,0
13189,19968,0,0,142,142,0,1,0,1,0
51354,60503,0,0,93,93,0,1,0,1,0
52337,33306,0,0,62,62,0,1,0,1,0
60132,4426,34204,1810,224,186,37,2,0,2,0
28150,2470,0,0,85,85,0,1,0,1,0
14929,47610,0,0,100,100,0,1,0,1,0
19390,3389,19390,3389,293,223,70,4,0,3,1
51457,30513,0,0,75,75,0,1,0,1,0
15411,61248,0,0,149,149,0,1,0,1,0
59964,59668,0,0,140,140,0,1,0,1,0
11790,61248,0,0,139,139,0,1,0,1,0
39779,8302,0,0,145,145,0,1,0,1,0
16033,3389,16033,3389,293,223,70,4,0,3,1
23816,34021,0,0,62,62,0,1,0,1,0
2149,23615,0,0,150,150,0,1,0,1,0
51534,31652,0,0,66,66,0,1,0,1,0
12963,61248,0,0,140,140,0,1,0,1,0
19785,3389,19785,3389,293,223,70,4,0,3,1
9148,25773,0,0,155,155,0,1,0,1,0
19448,31580,0,0,84,84,0,1,0,1,0
13685,25773,0,0,149,149,0,1,0,1,0
27445,26986,0,0,135,135,0,1,0,1,0
11479,25773,0,0,142,142,0,1,0,1,0
25477,25773,0,0,146,146,0,1,0,1,0
22695,3389,22695,3389,293,223,70,4,0,3,1
5132,25773,0,0,147,147,0,1,0,1,0
48986,28456,0,0,153,153,0,1,0,1,0
39359,60363,0,0,88,88,0,1,0,1,0
14065,11222,676,250,158,153,5,1,0,1,0
12470,53830,0,0,152,152,0,1,0,1,0
15546,27471,0,0,123,123,0,1,0,1,0
46139,34021,0,0,132,132,0,1,0,1,0
9686,3389,9686,3389,293,223,70,4,1,3,1
29689,3389,29689,3389,293,223,70,4,0,3,1
29185,30183,0,0,102,102,0,1,0,1,0
8836,61248,0,0,139,139,0,1,0,1,0
48938,26575,0,0,155,155,0,1,0,1,0
29810,3875,0,0,98,98,0,1,0,1,0
18098,3389,18098,3389,293,223,70,4,0,3,1
37130,3389,37130,3389,293,223,70,4,1,3,1
38989,6701,0,0,146,146,0,1,0,1,0
52371,34021,0,0,67,67,0,1,0,1,0
5236,18716,0,0,154,154,0,1,0,1,0
1356,22374,0,0,155,155,0,1,0,1,0
4810,25773,0,0,142,142,0,1,0,1,0
12804,3389,12804,3389,293,223,70,4,0,3,1
20401,61248,0,0,156,156,0,1,0,1,0
29572,34021,0,0,62,62,0,1,0,1,0
11719,3389,11719,3389,293,223,70,4,1,3,1
33779,7235,0,0,129,129,0,1,0,1,0
11668,25773,0,0,139,139,0,1,0,1,0
42431,3389,42431,3389,293,223,70,4,0,3,1
23308,3389,23308,3389,293,223,70,4,0,3,1
20487,17062,0,0,72,72,0,1,0,1,0
9939,3389,9939,3389,293,223,70,4,1,3,1
12762,22704,0,0,140,140,0,1,0,1,0
2220,46268,0,0,144,144,0,1,0,1,0
19046,3389,19046,3389,293,223,70,4,0,3,1
12571,8843,3247,1203,199,174,24,2,0,1,0
27166,27379,0,0,131,131,0,1,0,1,0
18052,24621,0,0,130,130,0,1,0,1,0
27048,33135,0,0,70,70,0,1,0,1,0
14272,3389,14272,3389,293,223,70,4,0,3,1
60550,60286,0,0,142,142,0,1,0,1,0
47135,48214,0,0,96,96,0,1,0,1,0
14553,22908,0,0,109,109,0,1,0,1,0
2236,23751,0,0,150,150,0,1,0,1,0
22929,3389,22929,3389,293,223,70,4,0,3,1
15089,22232,0,0,102,102,0,1,0,1,0
15121,25773,0,0,140,140,0,1,0,1,0
24343,31364,0,0,89,89,0,1,0,1,0
53892,38893,0,0,82,82,0,1,0,1,0
28618,34021,0,0,62,62,0,1,0,1,0
28142,33636,0,0,66,66,0,1,0,1,0
49445,31652,0,0,144,144,0,1,0,1,0
8876,25207,0,0,149,149,0,1,0,1,0
4067,25773,0,0,144,144,0,1,0,1,0
2203,44104,0,0,144,144,0,1,0,1,0
11810,3389,11810,3389,293,223,70,4,1,3,1
50064,28148,0,0,118,118,0,1,0,1,0
3751,22803,0,0,152,152,0,1,0,1,0
8805,25773,0,0,154,154,0,1,0,1,0
50820,32803,0,0,105,105,0,1,0,1,0
2628,38223,0,0,144,144,0,1,0,1,0
53755,3389,53755,3389,293,223,70,4,0,3,1
49565,31652,0,0,131,131,0,1,0,1,0
18898,17900,0,0,65,65,0,1,0,1,0
10563,5648,6701,2483,254,202,51,3,0,2,0
16295,19695,0,0,80,80,0,1,0,1,0
19105,6739,0,0,110,110,0,1,0,1,0
30008,1757,0,0,88,88,0,1,0,1,0
58398,61082,0,0,133,133,0,1,0,1,0
9799,61248,0,0,142,142,0,1,0,1,0
20783,3389,20783,3389,293,223,70,4,0,3,1
17348,25773,0,0,143,143,0,1,0,1,0
1043,21885,0,0,156,156,0,1,0,1,0
48914,35862,0,0,140,140,0,1,0,1,0
2235,43658,0,0,144,144,0,1,0,1,0
19053,25773,0,0,143,143,0,1,0,1,0
21417,3389,21417,3389,293,223,70,4,0,3,1
6196,23654,0,0,148,148,0,1,0,1,0
25983,34021,0,0,62,62,0,1,0,1,0
11639,25773,0,0,152,152,0,1,0,1,0
20379,3389,20379,3389,293,223,70,4,0,3,1
18151,21457,0,0,96,96,0,1,0,1,0
15589,3389,15589,3389,293,223,70,4,0,3,1
8886,25773,0,0,155,155,0,1,0,1,0
20509,3389,20509,3389,293,223,70,4,0,3,1
48970,27319,0,0,154,154,0,1,0,1,0
14807,22587,0,0,106,106,0,1,0,1,0
21874,3389,21874,3389,293,223,70,4,0,3,1
13814,3389,13814,3389,293,223,70,4,0,3,1
29655,34021,0,0,62,62,0,1,0,1,0
63151,41242,0,0,88,88,0,1,0,1,0
49018,28408,0,0,152,152,0,1,0,1,0
12552,25773,0,0,139,139,0,1,0,1,0
17862,46324,0,0,96,96,0,1,0,1,0
50829,31652,0,0,87,87,0,1,0,1,0
19753,3389,19753,3389,293,223,70,4,0,3,1
1823,23105,0,0,152,152,0,1,0,1,0
23919,25773,0,0,145,145,0,1,0,1,0
20732,3389,20732,3389,293,223,70,4,0,3,1
51783,32587,0,0,68,68,0,1,0,1,0
58378,31652,0,0,62,62,0,1,0,1,0
49148,33637,0,0,146,146,0,1,0,1,0
51000,31652,0,0,86,86,0,1,0,1,0
51235,31652,0,0,79,79,0,1,0,1,0
12524,3389,12524,3389,293,223,70,4,0,3,1
36065,3986,0,0,121,121,0,1,0,1,0
13913,3389,13913,3389,293,223,70,4,0,3,1
11682,25773,0,0,139,139,0,1,0,1,0
3625,25773,0,0,142,142,0,1,0,1,0
30252,4249,0,0,101,101,0,1,0,1,0
17061,3389,17061,3389,293,223,70,4,0,3,1
16605,3389,16605,3389,293,223,70,4,0,3,1
24905,30571,0,0,97,97,0,1,0,1,0
52530,33935,0,0,62,62,0,1,0,1,0
51422,31652,0,0,68,68,0,1,0,1,0
8993,25773,0,0,153,153,0,1,0,1,0
49807,33435,0,0,125,125,0,1,0,1,0
14865,3389,14865,3389,293,223,70,4,0,3,1
55253,31652,0,0,112,112,0,1,0,1,0
7575,23703,0,0,120,120,0,1,0,1,0
49430,31652,0,0,144,144,0,1,0,1,0
27944,26282,0,0,142,142,0,1,0,1,0
56696,31652,0,0,67,67,0,1,0,1,0
50154,33121,0,0,114,114,0,1,0,1,0
56577,48088,0,0,108,108,0,1,0,1,0
49014,26001,0,0,153,153,0,1,0,1,0
28184,31620,0,0,87,87,0,1,0,1,0
58438,4879,21200,1122,194,170,23,1,0,1,0
55297,7860,0,0,138,138,0,1,0,1,0
8414,24426,0,0,145,145,0,1,0,1,0
43329,3389,43329,3389,293,223,70,4,0,3,1
29078,1415,0,0,83,83,0,1,0,1,0
10588,25773,0,0,139,139,0,1,0,1,0
29049,29505,0,0,109,109,0,1,0,1,0
29523,34021,0,0,62,62,0,1,0,1,0
15782,21358,0,0,93,93,0,1,0,1,0
48909,25788,0,0,156,156,0,1,0,1,0
25316,14515,0,0,95,95,0,1,0,1,0
51651,40046,0,0,145,145,0,1,0,1,0
54326,60747,0,0,110,110,0,1,0,1,0
59939,4478,32725,1732,220,184,35,2,0,2,0
13977,3389,13977,3389,293,223,70,4,0,3,1
12499,22515,0,0,115,115,0,1,0,1,0
61824,32060,0,0,76,76,0,1,0,1,0
51573,31652,0,0,65,65,0,1,0,1,0
7404,61248,0,0,139,139,0,1,0,1,0
13761,10738,1199,444,167,157,9,1,0,1,0
55697,31652,0,0,68,68,0,1,0,1,0
36388,3389,36388,3389,293,223,70,4,0,3,1
14967,3389,14967,3389,293,223,70,4,0,3,1
5123,54708,0,0,141,141,0,1,0,1,0
11545,61248,0,0,143,143,0,1,0,1,0
20208,29841,0,0,103,103,0,1,0,1,0
11709,3389,11709,3389,293,223,70,4,1,3,1
10185,58081,0,0,140,140,0,1,0,1,0
11736,5253,8549,2641,261,206,54,3,0,2,0
52275,33474,0,0,64,64,0,1,0,1,0
3556,25773,0,0,142,142,0,1,0,1,0
28253,28278,0,0,121,121,0,1,0,1,0
7785,61248,0,0,139,139,0,1,0,1,0
14384,3389,14384,3389,293,223,70,4,0,3,1
5758,25773,0,0,149,149,0,1,0,1,0
11356,3389,11356,3389,293,223,70,4,1,3,1
21066,3389,21066,3389,293,223,70,4,0,3,1
50210,32380,0,0,120,120,0,1,0,1,0
51768,31652,0,0,62,62,0,1,0,1,0
12292,52369,0,0,113,113,0,1,0,1,0
11226,61248,0,0,142,142,0,1,0,1,0
18136,21934,0,0,101,101,0,1,0,1,0
51183,31743,0,0,74,74,0,1,0,1,0
50645,31652,0,0,93,93,0,1,0,1,0
51675,32393,0,0,68,68,0,1,0,1,0
16423,3389,16423,3389,293,223,70,4,0,3,1
16191,9942,0,0,134,134,0,1,0,1,0
8421,61248,0,0,140,140,0,1,0,1,0
49914,31652,0,0,121,121,0,1,0,1,0
50747,32585,0,0,95,95,0,1,0,1,0
52535,33894,0,0,62,62,0,1,0,1,0
57971,5004,17609,932,185,166,19,1,0,1,0
26698,34021,0,0,62,62,0,1,0,1,0
34220,34021,0,0,80,80,0,1,0,1,0
11898,61248,0,0,140,140,0,1,0,1,0
15716,3389,15716,3389,293,223,70,4,0,3,1
6139,57663,0,0,140,140,0,1,0,1,0
23352,25773,0,0,145,145,0,1,0,1,0
64155,33885,0,0,68,68,0,1,0,1,0
29691,34021,0,0,62,62,0,1,0,1,0
51578,39869,0,0,145,145,0,1,0,1,0
26093,3389,26093,3389,293,223,70,4,0,3,1
23091,21867,0,0,103,103,0,1,0,1,0
51794,33477,0,0,81,81,0,1,0,1,0
19972,3389,19972,3389,293,223,70,4,0,3,1
49325,31652,0,0,145,145,0,1,0,1,0
37907,3389,37907,3389,293,223,70,4,1,3,1
43398,5618,0,0,145,145,0,1,0,1,0
21227,61248,0,0,157,157,0,1,0,1,0
14283,25773,0,0,148,148,0,1,0,1,0
24593,31011,0,0,93,93,0,1,0,1,0
12521,3389,12521,3389,293,223,70,4,0,3,1
49160,32640,0,0,146,146,0,1,0,1,0
19370,28285,0,0,118,118,0,1,0,1,0
50117,32943,0,0,112,112,0,1,0,1,0
8385,61248,0,0,140,140,0,1,0,1,0
7640,25773,0,0,155,155,0,1,0,1,0
9094,24663,0,0,144,144,0,1,0,1,0
27399,33421,0,0,67,67,0,1,0,1,0
49160,32665,0,0,146,146,0,1,0,1,0
13908,61248,0,0,142,142,0,1,0,1,0
50103,28227,0,0,117,117,0,1,0,1,0
21072,3389,21072,3389,293,223,70,4,0,3,1
16622,3389,16622,3389,293,223,70,4,0,3,1
50325,3389,50325,3389,293,223,70,4,0,3,1
23700,34021,0,0,62,62,0,1,0,1,0
11048,61248,0,0,143,143,0,1,0,1,0
29071,34021,0,0,62,62,0,1,0,1,0
12520,8763,3334,1235,200,175,25,2,0,1,0
63382,31866,0,0,62,62,0,1,0,1,0
9659,3389,9659,3389,293,223,70,4,1,3,1
55778,45133,0,0,95,95,0,1,0,1,0
9573,24829,0,0,143,143,0,1,0,1,0
49282,33910,0,0,142,142,0,1,0,1,0
52240,33020,0,0,62,62,0,1,0,1,0
17927,3389,17927,3389,293,223,70,4,0,3,1
20719,32609,0,0,75,75,0,1,0,1,0
49976,32217,0,0,125,125,0,1,0,1,0
56095,3389,56095,3389,293,223,70,4,0,3,1
10918,25773,0,0,144,144,0,1,0,1,0
1798,23065,0,0,152,152,0,1,0,1,0
50726,29500,0,0,96,96,0,1,0,1,0
20739,25773,0,0,144,144,0,1,0,1,0
24178,31596,0,0,87,87,0,1,0,1,0
20958,31232,0,0,89,89,0,1,0,1,0
10382,3389,10382,3389,293,223,70,4,0,3,1
14323,23198,0,0,112,112,0,1,0,1,0
49550,27383,0,0,133,133,0,1,0,1,0
60287,60791,0,0,143,143,0,1,0,1,0
47768,6953,0,0,145,145,0,1,0,1,0
11474,25491,0,0,140,140,0,1,0,1,0
10819,3389,10819,3389,293,223,70,4,1,3,1
19353,19067,0,0,71,71,0,1,0,1,0
49252,26642,0,0,144,144,0,1,0,1,0
1967,23329,0,0,151,151,0,1,0,1,0
29727,32899,0,0,73,73,0,1,0,1,0
8464,59276,0,0,133,133,0,1,0,1,0
11399,25465,0,0,140,140,0,1,0,1,0
49160,33345,0,0,146,146,0,1,0,1,0
62368,3829,51376,2719,263,207,56,3,0,2,0
63712,3469,61700,3266,287,220,67,3,0,2,0
50523,6488,0,0,145,145,0,1,0,1,0
15612,3389,15612,3389,293,223,70,4,0,3,1
13717,3389,13717,3389,293,223,70,4,0,3,1
32390,3389,32390,3389,293,223,70,4,0,3,1
14922,3389,14922,3389,293,223,70,4,0,3,1
15779,61248,0,0,150,150,0,1,0,1,0
2254,23779,0,0,150,150,0,1,0,1,0
26147,28818,0,0,116,116,0,1,0,1,0
13681,24008,0,0,120,120,0,1,0,1,0
25896,3389,25896,3389,293,223,70,4,0,3,1
51878,32450,0,0,80,80,0,1,0,1,0
26764,34021,0,0,62,62,0,1,0,1,0
51164,30396,0,0,82,82,0,1,0,1,0
3075,47356,0,0,144,144,0,1,0,1,0
11011,25773,0,0,152,152,0,1,0,1,0
51735,31652,0,0,62,62,0,1,0,1,0
16576,61248,0,0,151,151,0,1,0,1,0
20633,30628,0,0,95,95,0,1,0,1,0
30433,4403,0,0,103,103,0,1,0,1,0
4640,25773,0,0,146,146,0,1,0,1,0
12080,61248,0,0,139,139,0,1,0,1,0
51693,32036,0,0,84,84,0,1,0,1,0
21356,61248,0,0,157,157,0,1,0,1,0
13832,21525,0,0,103,103,0,1,0,1,0
24426,34021,0,0,62,62,0,1,0,1,0
16397,19433,0,0,145,145,0,1,0,1,0
49032,28732,0,0,151,151,0,1,0,1,0
50933,6419,0,0,145,145,0,1,0,1,0
2707,46800,0,0,144,144,0,1,0,1,0
22809,29084,0,0,110,110,0,1,0,1,0
6599,59001,0,0,139,139,0,1,0,1,0
48824,48197,0,0,62,62,0,1,0,1,0
23484,25773,0,0,145,145,0,1,0,1,0
49498,33640,0,0,134,134,0,1,0,1,0
25163,3389,25163,3389,293,223,70,4,0,3,1
38538,7025,0,0,146,146,0,1,0,1,0
7557,61248,0,0,139,139,0,1,0,1,0
4917,23209,0,0,150,150,0,1,0,1,0
12759,7731,5337,1649,218,184,34,2,0,1,0
19865,3389,19865,3389,293,223,70,4,0,3,1
63705,31652,0,0,66,66,0,1,0,1,0
16947,19211,0,0,74,74,0,1,0,1,0
25280,30041,0,0,103,103,0,1,0,1,0
22947,34021,0,0,62,62,0,1,0,1,0
15828,3389,15828,3389,293,223,70,4,0,3,1
30306,3389,30306,3389,293,223,70,4,0,3,1
51090,31216,0,0,78,78,0,1,0,1,0
52030,32791,0,0,76,76,0,1,0,1,0
14882,19965,0,0,80,80,0,1,0,1,0
25092,30306,0,0,100,100,0,1,0,1,0
17922,3389,17922,3389,293,223,70,4,0,3,1
23928,31832,0,0,82,82,0,1,0,1,0
23795,386,1435,386,88,80,7,1,0,1,0
3448,23193,0,0,157,157,0,1,0,1,0
17562,19111,0,0,70,70,0,1,0,1,0
19011,3389,19011,3389,293,223,70,4,0,3,1
17105,8938,0,0,126,126,0,1,0,1,0
24186,31585,0,0,87,87,0,1,0,1,0
49441,27112,0,0,137,137,0,1,0,1,0
50698,32289,0,0,91,91,0,1,0,1,0
29422,31370,0,0,89,89,0,1,0,1,0
4077,51667,0,0,142,142,0,1,0,1,0
38430,8530,0,0,145,145,0,1,0,1,0
51760,31652,0,0,62,62,0,1,0,1,0
45164,3389,45164,3389,293,223,70,4,0,3,1
29723,3389,29723,3389,293,223,70,4,0,3,1
24610,30987,0,0,93,93,0,1,0,1,0
28260,27937,0,0,125,125,0,1,0,1,0
18228,61248,0,0,151,151,0,1,0,1,0
48942,27054,0,0,155,155,0,1,0,1,0
16657,15553,0,0,98,98,0,1,0,1,0
18048,24770,0,0,132,132,0,1,0,1,0
17331,61248,0,0,152,152,0,1,0,1,0
49470,34021,0,0,138,138,0,1,0,1,0
20697,3389,20697,3389,293,223,70,4,0,3,1
13372,3389,13372,3389,293,223,70,4,0,3,1
12483,3389,12483,3389,293,223,70,4,1,3,1
15120,14436,0,0,147,147,0,1,0,1,0
10293,3389,10293,3389,293,223,70,4,0,3,1
18101,23072,0,0,113,113,0,1,0,1,0
28926,28888,0,0,115,115,0,1,0,1,0
29358,34021,0,0,62,62,0,1,0,1,0
21037,3389,21037,3389,293,223,70,4,0,3,1
11234,3389,11234,3389,293,223,70,4,1,3,1
53743,17031,0,0,112,112,0,1,0,1,0
10455,25773,0,0,139,139,0,1,0,1,0
29598,23635,0,0,147,147,0,1,0,1,0
25784,34021,0,0,62,62,0,1,0,1,0
55472,5618,0,0,145,145,0,1,0,1,0
61859,3965,47468,2513,254,202,51,3,0,2,0
15843,61248,0,0,149,149,0,1,0,1,0
38252,3389,38252,3389,293,223,70,4,1,3,1
12622,58059,0,0,133,133,0,1,0,1,0
12564,3389,12564,3389,293,223,70,4,1,3,1
22968,33305,0,0,69,69,0,1,0,1,0
23237,34021,0,0,62,62,0,1,0,1,0
50153,33122,0,0,114,114,0,1,0,1,0
21224,31726,0,0,84,84,0,1,0,1,0
12133,25773,0,0,139,139,0,1,0,1,0
15179,14668,0,0,146,146,0,1,0,1,0
52285,33154,0,0,62,62,0,1,0,1,0
37861,3389,37861,3389,293,223,70,4,1,3,1
24933,34021,0,0,62,62,0,1,0,1,0
7524,25445,0,0,157,157,0,1,0,1,0
8426,61248,0,0,139,139,0,1,0,1,0
49502,23990,0,0,155,155,0,1,0,1,0
11414,7002,5237,1941,231,190,40,2,0,2,0
61987,31652,0,0,63,63,0,1,0,1,0
2589,38761,0,0,144,144,0,1,0,1,0
52205,32917,0,0,62,62,0,1,0,1,0
49428,31652,0,0,137,137,0,1,0,1,0
14268,3389,14268,3389,293,223,70,4,0,3,1
63740,31795,0,0,62,62,0,1,0,1,0
49845,32127,0,0,129,129,0,1,0,1,0
50978,31652,0,0,87,87,0,1,0,1,0
50973,19614,0,0,153,153,0,1,0,1,0
10561,61248,0,0,139,139,0,1,0,1,0
50695,60449,0,0,90,90,0,1,0,1,0
12243,25773,0,0,139,139,0,1,0,1,0
9889,25773,0,0,149,149,0,1,0,1,0
11211,6679,5587,2070,236,193,42,2,0,2,0
20005,19555,0,0,76,76,0,1,0,1,0
51914,27820,0,0,82,82,0,1,0,1,0
52819,14120,0,0,150,150,0,1,0,1,0
32706,18498,0,0,147,147,0,1,0,1,0
9417,3389,9417,3389,293,223,70,4,0,3,1
5856,56842,0,0,140,140,0,1,0,1,0
13890,23745,0,0,118,118,0,1,0,1,0
18016,25773,0,0,143,143,0,1,0,1,0
10682,3389,10682,3389,293,223,70,4,1,3,1
31616,60760,0,0,119,119,0,1,0,1,0
17617,18566,0,0,65,65,0,1,0,1,0
13505,3389,13505,3389,293,223,70,4,0,3,1
22531,3389,22531,3389,293,223,70,4,0,3,1
48268,40703,0,0,124,124,0,1,0,1,0
8957,61248,0,0,141,141,0,1,0,1,0
16308,19685,0,0,80,80,0,1,0,1,0
10852,61248,0,0,142,142,0,1,0,1,0
7549,61248,0,0,139,139,0,1,0,1,0
37603,8670,0,0,145,145,0,1,0,1,0
12703,7595,5513,1703,220,185,35,2,0,2,0
9093,57542,0,0,143,143,0,1,0,1,0
49160,32474,0,0,146,146,0,1,0,1,0
10369,3389,10369,3389,293,223,70,4,0,3,1
49160,31771,0,0,146,146,0,1,0,1,0
11088,3389,11088,3389,293,223,70,4,1,3,1
26331,25773,0,0,147,147,0,1,0,1,0
27563,34021,0,0,62,62,0,1,0,1,0
28247,28555,0,0,118,118,0,1,0,1,0
51036,31082,0,0,80,80,0,1,0,1,0
6191,25773,0,0,151,151,0,1,0,1,0
52170,33286,0,0,65,65,0,1,0,1,0
38572,60403,0,0,91,91,0,1,0,1,0
49160,31715,0,0,146,146,0,1,0,1,0
10077,3389,10077,3389,293,223,70,4,1,3,1
7167,25773,0,0,154,154,0,1,0,1,0
38070,3389,38070,3389,293,223,70,4,1,3,1
26417,3389,26417,3389,293,223,70,4,0,3,1
47485,53256,0,0,62,62,0,1,0,1,0
52961,3389,52961,3389,293,223,70,4,0,3,1
18827,31076,0,0,89,89,0,1,0,1,0
45772,18263,0,0,152,152,0,1,0,1,0
4186,23601,0,0,157,157,0,1,0,1,0
12070,3389,12070,3389,293,223,70,4,1,3,1
48940,26961,0,0,155,155,0,1,0,1,0
12572,61248,0,0,146,146,0,1,0,1,0
28991,34021,0,0,62,62,0,1,0,1,0
47338,7026,0,0,145,145,0,1,0,1,0
51392,32001,0,0,74,74,0,1,0,1,0
10756,3389,10756,3389,293,223,70,4,0,3,1
18483,28999,0,0,108,108,0,1,0,1,0
22291,33706,0,0,65,65,0,1,0,1,0
49750,31652,0,0,125,125,0,1,0,1,0
11954,3389,11954,3389,293,223,70,4,1,3,1
44615,3389,44615,3389,293,223,70,4,0,3,1
15722,16794,0,0,146,146,0,1,0,1,0
19777,3389,19777,3389,293,223,70,4,0,3,1
19461,3389,19461,3389,293,223,70,4,0,3,1
24649,34021,0,0,62,62,0,1,0,1,0
9876,3389,9876,3389,293,223,70,4,1,3,1
53130,22625,0,0,90,90,0,1,0,1,0
50304,31652,0,0,109,109,0,1,0,1,0
48917,26113,0,0,156,156,0,1,0,1,0
49764,33341,0,0,124,124,0,1,0,1,0
8341,61248,0,0,139,139,0,1,0,1,0
50812,32161,0,0,87,87,0,1,0,1,0
11643,25773,0,0,139,139,0,1,0,1,0
52686,34399,0,0,63,63,0,1,0,1,0
52270,33808,0,0,69,69,0,1,0,1,0
2003,23387,0,0,151,151,0,1,0,1,0
2947,24863,0,0,146,146,0,1,0,1,0
12004,5903,7707,2381,249,200,49,3,0,2,0
49079,26170,0,0,152,152,0,1,0,1,0
37721,10209,0,0,146,146,0,1,0,1,0
2998,20383,0,0,155,155,0,1,0,1,0
37073,8076,0,0,146,146,0,1,0,1,0
53538,18240,0,0,109,109,0,1,0,1,0
56637,52102,0,0,145,145,0,1,0,1,0
49622,34021,0,0,134,134,0,1,0,1,0
20062,3389,20062,3389,293,223,70,4,0,3,1
39304,3389,39304,3389,293,223,70,4,0,3,1
49271,31652,0,0,142,142,0,1,0,1,0
51485,60514,0,0,94,94,0,1,0,1,0
12298,8409,3716,1377,206,178,28,2,0,1,0
18347,61248,0,0,151,151,0,1,0,1,0
17140,16368,0,0,87,87,0,1,0,1,0
2393,23996,0,0,149,149,0,1,0,1,0
12101,22811,0,0,119,119,0,1,0,1,0
10372,61248,0,0,139,139,0,1,0,1,0
27224,34021,0,0,62,62,0,1,0,1,0
49906,28271,0,0,120,120,0,1,0,1,0
50778,5618,0,0,145,145,0,1,0,1,0
22490,3017,0,0,83,83,0,1,0,1,0
49179,34021,0,0,145,145,0,1,0,1,0
16415,3389,16415,3389,293,223,70,4,0,3,1
42312,5618,0,0,145,145,0,1,0,1,0
50145,33129,0,0,114,114,0,1,0,1,0
12969,3290,12238,3290,286,218,67,3,0,2,0
51849,28206,0,0,81,81,0,1,0,1,0
18504,25773,0,0,143,143,0,1,0,1,0
16530,19520,0,0,78,78,0,1,0,1,0
21285,3389,21285,3389,293,223,70,4,0,3,1
20502,3389,20502,3389,293,223,70,4,0,3,1
54784,5768,0,0,145,145,0,1,0,1,0
51640,31777,0,0,66,66,0,1,0,1,0
55926,45858,0,0,101,101,0,1,0,1,0
52184,33310,0,0,64,64,0,1,0,1,0
56477,33243,0,0,62,62,0,1,0,1,0
25518,25773,0,0,146,146,0,1,0,1,0
49658,5618,0,0,145,145,0,1,0,1,0
52338,33589,0,0,63,63,0,1,0,1,0
55154,8707,0,0,136,136,0,1,0,1,0
3788,25773,0,0,142,142,0,1,0,1,0
9480,61248,0,0,141,141,0,1,0,1,0
24894,3389,24894,3389,293,223,70,4,0,3,1
51836,33507,0,0,80,80,0,1,0,1,0
46838,60132,0,0,68,68,0,1,0,1,0
42404,60206,0,0,75,75,0,1,0,1,0
36020,8832,0,0,146,146,0,1,0,1,0
24764,25773,0,0,146,146,0,1,0,1,0
19921,40814,0,0,81,81,0,1,0,1,0
11157,61248,0,0,139,139,0,1,0,1,0
11582,61248,0,0,141,141,0,1,0,1,0
55126,33513,0,0,62,62,0,1,0,1,0
14879,13494,0,0,147,147,0,1,0,1,0
9572,25773,0,0,150,150,0,1,0,1,0
6718,25000,0,0,157,157,0,1,0,1,0
38437,34021,0,0,99,99,0,1,0,1,0
12225,25773,0,0,139,139,0,1,0,1,0
19420,3389,19420,3389,293,223,70,4,0,3,1
28960,24689,0,0,147,147,0,1,0,1,0
7088,60423,0,0,139,139,0,1,0,1,0
14324,3389,14324,3389,293,223,70,4,0,3,1
51464,34021,0,0,89,89,0,1,0,1,0
8917,61248,0,0,140,140,0,1,0,1,0
51589,31652,0,0,65,65,0,1,0,1,0
50556,32449,0,0,96,96,0,1,0,1,0
16203,25773,0,0,145,145,0,1,0,1,0
9178,61248,0,0,139,139,0,1,0,1,0
16890,19959,0,0,79,79,0,1,0,1,0
7417,61248,0,0,139,139,0,1,0,1,0
50498,29353,0,0,115,115,0,1,0,1,0
51699,33412,0,0,83,83,0,1,0,1,0
20552,3389,20552,3389,293,223,70,4,0,3,1
27461,32300,0,0,78,78,0,1,0,1,0
49160,32099,0,0,146,146,0,1,0,1,0
18637,3389,18637,3389,293,223,70,4,0,3,1
19513,3389,19513,3389,293,223,70,4,0,3,1
10161,3389,10161,3389,293,223,70,4,1,3,1
51182,31652,0,0,81,81,0,1,0,1,0
13617,3389,13617,3389,293,223,70,4,0,3,1
18103,22994,0,0,113,113,0,1,0,1,0
11685,3389,11685,3389,293,223,70,4,1,3,1
51897,32792,0,0,67,67,0,1,0,1,0
52678,23311,0,0,95,95,0,1,0,1,0
17123,16340,0,0,87,87,0,1,0,1,0
20872,3389,20872,3389,293,223,70,4,0,3,1
54058,60725,0,0,109,109,0,1,0,1,0
31440,3389,31440,3389,293,223,70,4,0,3,1
10277,3389,10277,3389,293,223,70,4,1,3,1
61636,3389,61636,3389,293,223,70,4,0,3,1
49160,31858,0,0,146,146,0,1,0,1,0
18544,3389,18544,3389,293,223,70,4,0,3,1
51635,31652,0,0,71,71,0,1,0,1,0
21065,3389,21065,3389,293,223,70,4,1,3,1
58787,55659,0,0,129,129,0,1,0,1,0
27439,13395,0,0,105,105,0,1,0,1,0
15727,25773,0,0,146,146,0,1,0,1,0
11227,61248,0,0,142,142,0,1,0,1,0
15305,3389,15305,3389,293,223,70,4,1,3,1
7843,54547,0,0,141,141,0,1,0,1,0
51088,32276,0,0,84,84,0,1,0,1,0
27196,1662,0,0,77,77,0,1,0,1,0
11615,61248,0,0,141,141,0,1,0,1,0
22703,29011,0,0,111,111,0,1,0,1,0
50176,31652,0,0,113,113,0,1,0,1,0
17336,3389,17336,3389,293,223,70,4,0,3,1
6370,25773,0,0,141,141,0,1,0,1,0
13836,23812,0,0,118,118,0,1,0,1,0
55143,9184,0,0,133,133,0,1,0,1,0
25517,3389,25517,3389,293,223,70,4,0,3,1
15210,3389,15210,3389,293,223,70,4,0,3,1
28822,34021,0,0,62,62,0,1,0,1,0
48908,25905,0,0,156,156,0,1,0,1,0
17389,3389,17389,3389,293,223,70,4,0,3,1
20611,32522,0,0,75,75,0,1,0,1,0
19057,3389,19057,3389,293,223,70,4,0,3,1
23965,3389,23965,3389,293,223,70,4,0,3,1
10092,25773,0,0,148,148,0,1,0,1,0
39199,6551,0,0,146,146,0,1,0,1,0
18223,19164,0,0,71,71,0,1,0,1,0
50913,38262,0,0,145,145,0,1,0,1,0
50430,32871,0,0,105,105,0,1,0,1,0
49160,33708,0,0,146,146,0,1,0,1,0
15442,3389,15442,3389,293,223,70,4,0,3,1
50720,32264,0,0,91,91,0,1,0,1,0
37219,3389,37219,3389,293,223,70,4,1,3,1
25837,34021,0,0,62,62,0,1,0,1,0
51408,34021,0,0,90,90,0,1,0,1,0
18169,20877,0,0,90,90,0,1,0,1,0
52196,32889,0,0,62,62,0,1,0,1,0
28138,33854,0,0,63,63,0,1,0,1,0
60630,4293,38032,2013,232,191,41,2,0,2,0
10830,25773,0,0,153,153,0,1,0,1,0
12725,25773,0,0,139,139,0,1,0,1,0
10936,3389,10936,3389,293,223,70,4,1,3,1
1075,21935,0,0,156,156,0,1,0,1,0
18468,26611,0,0,134,134,0,1,0,1,0
14591,25773,0,0,140,140,0,1,0,1,0
20335,3389,20335,3389,293,223,70,4,0,3,1
55813,5581,1042,55,147,146,1,1,0,1,0
13639,3389,13639,3389,293,223,70,4,0,3,1
49160,31756,0,0,146,146,0,1,0,1,0
19024,6827,0,0,111,111,0,1,0,1,0
2438,22346,0,0,154,154,0,1,0,1,0
36339,3389,36339,3389,293,223,70,4,0,3,1
18197,19980,0,0,80,80,0,1,0,1,0
51566,5618,0,0,145,145,0,1,0,1,0
27549,25773,0,0,147,147,0,1,0,1,0
13675,20582,0,0,87,87,0,1,0,1,0
12468,3389,12468,3389,293,223,70,4,1,3,1
54091,3389,54091,3389,293,223,70,4,0,3,1
49416,31829,0,0,139,139,0,1,0,1,0
50170,32352,0,0,121,121,0,1,0,1,0
8159,55985,0,0,143,143,0,1,0,1,0
13755,26966,0,0,127,127,0,1,0,1,0
13175,3389,13175,3389,293,223,70,4,0,3,1
12061,61248,0,0,139,139,0,1,0,1,0
47061,48816,0,0,95,95,0,1,0,1,0
21215,61248,0,0,157,157,0,1,0,1,0
16583,3389,16583,3389,293,223,70,4,0,3,1
38455,3389,38455,3389,293,223,70,4,0,3,1
12413,3389,12413,3389,293,223,70,4,1,3,1
29970,1743,0,0,88,88,0,1,0,1,0
33658,3389,33658,3389,293,223,70,4,0,3,1
11744,3389,11744,3389,293,223,70,4,1,3,1
51256,31055,0,0,96,96,0,1,0,1,0
2922,34164,0,0,143,143,0,1,0,1,0
50318,32455,0,0,117,117,0,1,0,1,0
22415,33984,0,0,62,62,0,1,0,1,0
14222,3389,14222,3389,293,223,70,4,1,3,1
21970,3389,21970,3389,293,223,70,4,0,3,1
19326,39676,0,0,77,77,0,1,0,1,0
54226,31652,0,0,69,69,0,1,0,1,0
3362,28068,0,0,143,143,0,1,0,1,0
28982,3389,28982,3389,293,223,70,4,0,3,1
20431,3389,20431,3389,293,223,70,4,0,3,1
29035,34021,0,0,62,62,0,1,0,1,0
51620,3389,51620,3389,293,223,70,4,0,3,1
49105,30412,0,0,148,148,0,1,0,1,0
50621,32699,0,0,99,99,0,1,0,1,0
18122,22383,0,0,106,106,0,1,0,1,0
49200,33975,0,0,144,144,0,1,0,1,0
14306,11605,262,97,152,150,2,1,0,1,0
28808,24941,0,0,147,147,0,1,0,1,0
34739,3498,0,0,114,114,0,1,0,1,0
48904,33741,0,0,139,139,0,1,0,1,0
50152,31652,0,0,114,114,0,1,0,1,0
9246,3389,9246,3389,293,223,70,4,1,3,1
29331,3389,29331,3389,293,223,70,4,0,3,1
20764,61248,0,0,156,156,0,1,0,1,0
46644,52881,0,0,85,85,0,1,0,1,0
18418,3389,18418,3389,293,223,70,4,0,3,1
54624,31652,0,0,62,62,0,1,0,1,0
18749,25773,0,0,143,143,0,1,0,1,0
52627,33484,0,0,126,126,0,1,0,1,0
62027,31652,0,0,62,62,0,1,0,1,0
9008,25109,0,0,148,148,0,1,0,1,0
11288,61248,0,0,142,142,0,1,0,1,0
51927,32562,0,0,78,78,0,1,0,1,0
50299,28628,0,0,110,110,0,1,0,1,0
41687,5618,0,0,145,145,0,1,0,1,0
14750,27057,0,0,127,127,0,1,0,1,0
51531,31652,0,0,66,66,0,1,0,1,0
19614,3389,19614,3389,293,223,70,4,0,3,1
11290,3389,11290,3389,293,223,70,4,1,3,1
21790,20892,0,0,92,92,0,1,0,1,0
25641,34021,0,0,62,62,0,1,0,1,0
11584,60595,0,0,141,141,0,1,0,1,0
50396,34021,0,0,115,115,0,1,0,1,0
15541,3389,15541,3389,293,223,70,4,0,3,1
46636,60115,0,0,67,67,0,1,0,1,0
49160,33624,0,0,146,146,0,1,0,1,0
25698,32753,0,0,73,73,0,1,0,1,0
24637,25773,0,0,146,146,0,1,0,1,0
22454,34009,0,0,62,62,0,1,0,1,0
18095,7849,0,0,118,118,0,1,0,1,0
28118,25773,0,0,147,147,0,1,0,1,0
51845,17018,0,0,151,151,0,1,0,1,0
56076,31652,0,0,108,108,0,1,0,1,0
16076,25773,0,0,141,141,0,1,0,1,0
13424,9341,3249,1004,190,170,20,1,0,1,0
14388,3389,14388,3389,293,223,70,4,0,3,1
39006,6689,0,0,146,146,0,1,0,1,0
44827,5618,0,0,145,145,0,1,0,1,0
11701,3389,11701,3389,293,223,70,4,1,3,1
12628,3389,12628,3389,293,223,70,4,0,3,1
18505,3389,18505,3389,293,223,70,4,0,3,1
7573,60884,0,0,137,137,0,1,0,1,0
12514,3389,12514,3389,293,223,70,4,0,3,1
50181,32359,0,0,120,120,0,1,0,1,0
34514,15510,0,0,146,146,0,1,0,1,0
27285,3389,27285,3389,293,223,70,4,0,3,1
50549,5618,0,0,145,145,0,1,0,1,0
20504,3389,20504,3389,293,223,70,4,0,3,1
10985,3389,10985,3389,293,223,70,4,0,3,1
21005,3389,21005,3389,293,223,70,4,0,3,1
49755,27894,0,0,126,126,0,1,0,1,0
21326,3389,21326,3389,293,223,70,4,0,3,1
50377,31652,0,0,103,103,0,1,0,1,0
8605,25773,0,0,156,156,0,1,0,1,0
11804,25773,0,0,143,143,0,1,0,1,0
49730,31652,0,0,127,127,0,1,0,1,0
51471,32025,0,0,70,70,0,1,0,1,0
5252,23325,0,0,150,150,0,1,0,1,0
19246,3389,19246,3389,293,223,70,4,0,3,1
8108,61248,0,0,139,139,0,1,0,1,0
34393,7755,0,0,134,134,0,1,0,1,0
25761,34021,0,0,62,62,0,1,0,1,0
55196,43114,0,0,89,89,0,1,0,1,0
48746,6788,0,0,145,145,0,1,0,1,0
51420,31652,0,0,68,68,0,1,0,1,0
19417,61248,0,0,155,155,0,1,0,1,0
59959,61210,0,0,142,142,0,1,0,1,0
53290,36828,0,0,76,76,0,1,0,1,0
60383,61245,0,0,144,144,0,1,0,1,0
10579,3389,10579,3389,293,223,70,4,1,3,1
51332,31652,0,0,134,134,0,1,0,1,0
39128,3389,39128,3389,293,223,70,4,0,3,1
19061,3389,19061,3389,293,223,70,4,0,3,1
18132,3389,18132,3389,293,223,70,4,0,3,1
18198,19970,0,0,80,80,0,1,0,1,0
20286,39333,0,0,77,77,0,1,0,1,0
57275,33084,0,0,62,62,0,1,0,1,0
16081,25773,0,0,141,141,0,1,0,1,0
26419,3389,26419,3389,293,223,70,4,0,3,1
36668,34021,0,0,91,91,0,1,0,1,0
50798,31652,0,0,88,88,0,1,0,1,0
33442,6950,0,0,127,127,0,1,0,1,0
26899,34021,0,0,62,62,0,1,0,1,0
19065,3389,19065,3389,293,223,70,4,0,3,1
18221,19223,0,0,72,72,0,1,0,1,0
5859,25773,0,0,141,141,0,1,0,1,0
51317,31339,0,0,72,72,0,1,0,1,0
5975,25773,0,0,141,141,0,1,0,1,0
50842,31652,0,0,136,136,0,1,0,1,0
23489,1919,0,0,75,75,0,1,0,1,0
21603,3389,21603,3389,293,223,70,4,0,3,1
53858,60709,0,0,108,108,0,1,0,1,0
13907,10970,948,351,163,155,7,1,0,1,0
51157,31652,0,0,75,75,0,1,0,1,0
45295,5618,0,0,145,145,0,1,0,1,0
29186,30190,0,0,101,101,0,1,0,1,0
33347,3389,33347,3389,293,223,70,4,0,3,1
8600,25773,0,0,140,140,0,1,0,1,0
12899,24995,0,0,131,131,0,1,0,1,0
38369,3389,38369,3389,293,223,70,4,0,3,1
30840,60800,0,0,123,123,0,1,0,1,0
14809,3389,14809,3389,293,223,70,4,0,3,1
47861,43754,0,0,114,114,0,1,0,1,0
62409,46676,0,0,104,104,0,1,0,1,0
51863,34021,0,0,79,79,0,1,0,1,0
27734,25773,0,0,147,147,0,1,0,1,0
49882,33207,0,0,120,120,0,1,0,1,0
20012,3389,20012,3389,293,223,70,4,0,3,1
50091,32297,0,0,123,123,0,1,0,1,0
23758,32190,0,0,81,81,0,1,0,1,0
17299,57538,0,0,155,155,0,1,0,1,0
15696,3389,15696,3389,293,223,70,4,0,3,1
64177,31652,0,0,62,62,0,1,0,1,0
25710,32759,0,0,73,73,0,1,0,1,0
56675,31652,0,0,62,62,0,1,0,1,0
7480,54854,0,0,143,143,0,1,0,1,0
35702,8863,0,0,145,145,0,1,0,1,0
4179,49353,0,0,144,144,0,1,0,1,0
48984,27631,0,0,153,153,0,1,0,1,0
10364,3389,10364,3389,293,223,70,4,0,3,1
15321,20419,0,0,89,89,0,1,0,1,0
22264,3389,22264,3389,293,223,70,4,0,3,1
26653,34021,0,0,62,62,0,1,0,1,0
18151,21471,0,0,96,96,0,1,0,1,0
49160,33332,0,0,146,146,0,1,0,1,0
52050,32456,0,0,62,62,0,1,0,1,0
61599,31652,0,0,62,62,0,1,0,1,0
25720,34021,0,0,62,62,0,1,0,1,0
35421,9877,0,0,146,146,0,1,0,1,0
13159,61248,0,0,145,145,0,1,0,1,0
49528,27329,0,0,134,134,0,1,0,1,0
51568,31842,0,0,68,68,0,1,0,1,0
20952,3389,20952,3389,293,223,70,4,0,3,1
16462,3389,16462,3389,293,223,70,4,0,3,1
59455,3389,59455,3389,293,223,70,4,0,3,1
10630,3389,10630,3389,293,223,70,4,0,3,1
49982,31652,0,0,117,117,0,1,0,1,0
37524,7752,0,0,146,146,0,1,0,1,0
49875,33215,0,0,120,120,0,1,0,1,0
2728,36843,0,0,144,144,0,1,0,1,0
23359,3389,23359,3389,293,223,70,4,1,3,1
28202,30756,0,0,96,96,0,1,0,1,0
28245,28655,0,0,117,117,0,1,0,1,0
50699,31652,0,0,91,91,0,1,0,1,0
10621,25773,0,0,146,146,0,1,0,1,0
20720,61248,0,0,156,156,0,1,0,1,0
53845,5618,0,0,145,145,0,1,0,1,0
3490,22712,0,0,153,153,0,1,0,1,0
27169,32098,0,0,80,80,0,1,0,1,0
8920,25175,0,0,149,149,0,1,0,1,0
48905,25829,0,0,156,156,0,1,0,1,0
47775,5618,0,0,145,145,0,1,0,1,0
58684,55305,0,0,128,128,0,1,0,1,0
25238,23476,0,0,121,121,0,1,0,1,0
8894,61248,0,0,141,141,0,1,0,1,0
27957,3389,27957,3389,293,223,70,4,0,3,1
11561,21664,0,0,98,98,0,1,0,1,0
14813,13235,0,0,147,147,0,1,0,1,0
19502,3389,19502,3389,293,223,70,4,0,3,1
58202,3389,58202,3389,293,223,70,4,0,3,1
28313,3389,28313,3389,293,223,70,4,0,3,1
29807,3872,0,0,98,98,0,1,0,1,0
8211,61248,0,0,139,139,0,1,0,1,0
12767,9156,2909,1078,194,171,22,1,0,1,0
10586,24059,0,0,149,149,0,1,0,1,0
37575,3389,37575,3389,293,223,70,4,1,3,1
11494,24268,0,0,148,148,0,1,0,1,0
57656,3389,57656,3389,293,223,70,4,0,3,1
51296,31709,0,0,71,71,0,1,0,1,0
23272,3389,23272,3389,293,223,70,4,0,3,1
48993,28693,0,0,153,153,0,1,0,1,0
12104,3389,12104,3389,293,223,70,4,1,3,1
56606,5369,7133,377,161,153,7,1,0,1,0
2431,22344,0,0,154,154,0,1,0,1,0
17271,61248,0,0,151,151,0,1,0,1,0
50584,29209,0,0,101,101,0,1,0,1,0
15402,61248,0,0,149,149,0,1,0,1,0
37204,3389,37204,3389,293,223,70,4,1,3,1
12494,3389,12494,3389,293,223,70,4,1,3,1
50855,29764,0,0,92,92,0,1,0,1,0
25340,29957,0,0,104,104,0,1,0,1,0
44504,3389,44504,3389,293,223,70,4,0,3,1
14533,12137,0,0,147,147,0,1,0,1,0
49570,27435,0,0,132,132,0,1,0,1,0
11812,25773,0,0,141,141,0,1,0,1,0
54592,8847,0,0,146,146,0,1,0,1,0
48932,26459,0,0,155,155,0,1,0,1,0
50558,29157,0,0,102,102,0,1,0,1,0
24116,34021,0,0,62,62,0,1,0,1,0
11271,3389,11271,3389,293,223,70,4,1,3,1
11254,61248,0,0,139,139,0,1,0,1,0
23129,33077,0,0,71,71,0,1,0,1,0
6601,52675,0,0,142,142,0,1,0,1,0
4622,49689,0,0,143,143,0,1,0,1,0
41129,3389,41129,3389,293,223,70,4,0,3,1
58036,55485,0,0,145,145,0,1,0,1,0
31529,5330,0,0,111,111,0,1,0,1,0
20559,38666,0,0,75,75,0,1,0,1,0
7496,27832,0,0,155,155,0,1,0,1,0
10952,61248,0,0,139,139,0,1,0,1,0
23608,1787,0,0,74,74,0,1,0,1,0
37075,34021,0,0,93,93,0,1,0,1,0
12036,25773,0,0,140,140,0,1,0,1,0
3586,22745,0,0,152,152,0,1,0,1,0
61931,3945,48019,2542,256,203,52,3,0,2,0
26934,13661,0,0,103,103,0,1,0,1,0
10059,61248,0,0,139,139,0,1,0,1,0
18307,18283,0,0,62,62,0,1,0,1,0
49059,34776,0,0,143,143,0,1,0,1,0
27030,3389,27030,3389,293,223,70,4,0,3,1
50766,32212,0,0,89,89,0,1,0,1,0
40325,8210,0,0,145,145,0,1,0,1,0
16194,3389,16194,3389,293,223,70,4,0,3,1
19389,3389,19389,3389,293,223,70,4,0,3,1
48337,34021,0,0,142,142,0,1,0,1,0
9017,61248,0,0,140,140,0,1,0,1,0
17217,3389,17217,3389,293,223,70,4,0,3,1
2442,24072,0,0,149,149,0,1,0,1,0
29510,34021,0,0,62,62,0,1,0,1,0
49955,33301,0,0,120,120,0,1,0,1,0
60203,4407,34751,1839,225,187,38,2,0,2,0
49336,33861,0,0,140,140,0,1,0,1,0
2810,22475,0,0,154,154,0,1,0,1,0
26978,3389,26978,3389,293,223,70,4,0,3,1
5301,25773,0,0,148,148,0,1,0,1,0
53604,33816,0,0,62,62,0,1,0,1,0
49838,31652,0,0,124,124,0,1,0,1,0
20689,3389,20689,3389,293,223,70,4,0,3,1
30435,11814,0,0,120,120,0,1,0,1,0
8991,25773,0,0,153,153,0,1,0,1,0
12706,25773,0,0,150,150,0,1,0,1,0
61747,3389,61747,3389,293,223,70,4,0,3,1
9689,3389,9689,3389,293,223,70,4,1,3,1
28863,34021,0,0,62,62,0,1,0,1,0
4955,54219,0,0,141,141,0,1,0,1,0
49963,31652,0,0,117,117,0,1,0,1,0
25358,34021,0,0,62,62,0,1,0,1,0
1693,22223,0,0,157,157,0,1,0,1,0
51381,31652,0,0,69,69,0,1,0,1,0
18314,3389,18314,3389,293,223,70,4,0,3,1
27772,34021,0,0,62,62,0,1,0,1,0
51190,34021,0,0,96,96,0,1,0,1,0
25756,14282,0,0,97,97,0,1,0,1,0
41702,5618,0,0,145,145,0,1,0,1,0
51492,31652,0,0,67,67,0,1,0,1,0
12329,61248,0,0,144,144,0,1,0,1,0
13423,61248,0,0,141,141,0,1,0,1,0
3497,25723,0,0,143,143,0,1,0,1,0
51243,31599,0,0,72,72,0,1,0,1,0
5681,23475,0,0,149,149,0,1,0,1,0
64266,33076,0,0,65,65,0,1,0,1,0
10884,3389,10884,3389,293,223,70,4,1,3,1
5830,51512,0,0,142,142,0,1,0,1,0
28210,34021,0,0,62,62,0,1,0,1,0
16765,25773,0,0,144,144,0,1,0,1,0
59678,31652,0,0,62,62,0,1,0,1,0
25337,23550,0,0,122,122,0,1,0,1,0
13207,3389,13207,3389,293,223,70,4,0,3,1
19937,31976,0,0,81,81,0,1,0,1,0
15289,3389,15289,3389,293,223,70,4,0,3,1
15336,53083,0,0,115,115,0,1,0,1,0
37641,7668,0,0,146,146,0,1,0,1,0
47748,34021,0,0,139,139,0,1,0,1,0
51997,32717,0,0,77,77,0,1,0,1,0
1761,23008,0,0,152,152,0,1,0,1,0
49997,33078,0,0,116,116,0,1,0,1,0
11930,3389,11930,3389,293,223,70,4,1,3,1
14161,11127,933,288,160,154,5,1,0,1,0
56582,48105,0,0,108,108,0,1,0,1,0
52882,3389,52882,3389,293,223,70,4,0,3,1
9149,25773,0,0,155,155,0,1,0,1,0
26511,28304,0,0,121,121,0,1,0,1,0
30257,3389,30257,3389,293,223,70,4,0,3,1
18284,3389,18284,3389,293,223,70,4,0,3,1
30879,3389,30879,3389,293,223,70,4,0,3,1
50317,32973,0,0,108,108,0,1,0,1,0
20590,30549,0,0,96,96,0,1,0,1,0
39074,3389,39074,3389,293,223,70,4,0,3,1
49160,33193,0,0,146,146,0,1,0,1,0
9906,25773,0,0,149,149,0,1,0,1,0
10319,3389,10319,3389,293,223,70,4,1,3,1
33271,3389,33271,3389,293,223,70,4,0,3,1
47795,44254,0,0,112,112,0,1,0,1,0
17961,3389,17961,3389,293,223,70,4,0,3,1
28145,33488,0,0,67,67,0,1,0,1,0
11970,25773,0,0,140,140,0,1,0,1,0
19111,3389,19111,3389,293,223,70,4,0,3,1
8400,24421,0,0,145,145,0,1,0,1,0
47652,3389,47652,3389,293,223,70,4,0,3,1
38166,3389,38166,3389,293,223,70,4,0,3,1
2153,46071,0,0,144,144,0,1,0,1,0
12337,3389,12337,3389,293,223,70,4,1,3,1
23479,32583,0,0,76,76,0,1,0,1,0
28369,34021,0,0,62,62,0,1,0,1,0
49790,27588,0,0,127,127,0,1,0,1,0
45714,18124,0,0,152,152,0,1,0,1,0
17161,19617,0,0,76,76,0,1,0,1,0
49001,28035,0,0,152,152,0,1,0,1,0
33538,3056,0,0,107,107,0,1,0,1,0
26907,34021,0,0,62,62,0,1,0,1,0
10327,3389,10327,3389,293,223,70,4,1,3,1
28241,28867,0,0,115,115,0,1,0,1,0
42900,60181,0,0,73,73,0,1,0,1,0
5654,24412,0,0,157,157,0,1,0,1,0
38191,4768,0,0,133,133,0,1,0,1,0
17881,28685,0,0,111,111,0,1,0,1,0
18082,61248,0,0,150,150,0,1,0,1,0
5339,24238,0,0,157,157,0,1,0,1,0
26044,32933,0,0,72,72,0,1,0,1,0
43499,3389,43499,3389,293,223,70,4,0,3,1
17554,3389,17554,3389,293,223,70,4,0,3,1
19836,3389,19836,3389,293,223,70,4,0,3,1
9467,24792,0,0,143,143,0,1,0,1,0
19420,3389,19420,3389,293,223,70,4,0,3,1
51097,31235,0,0,78,78,0,1,0,1,0
51901,32800,0,0,67,67,0,1,0,1,0
15819,46004,0,0,95,95,0,1,0,1,0
39639,8326,0,0,145,145,0,1,0,1,0
64267,31652,0,0,62,62,0,1,0,1,0
13380,24387,0,0,124,124,0,1,0,1,0
12715,24550,0,0,147,147,0,1,0,1,0
31405,3389,31405,3389,293,223,70,4,0,3,1
4297,25773,0,0,145,145,0,1,0,1,0
52426,33747,0,0,63,63,0,1,0,1,0
53350,3389,53350,3389,293,223,70,4,0,3,1
29935,34021,0,0,62,62,0,1,0,1,0
50580,32636,0,0,111,111,0,1,0,1,0
22940,29175,0,0,109,109,0,1,0,1,0
52298,33516,0,0,64,64,0,1,0,1,0
50021,28557,0,0,116,116,0,1,0,1,0
20368,30136,0,0,100,100,0,1,0,1,0
50841,30598,0,0,87,87,0,1,0,1,0
51198,38949,0,0,145,145,0,1,0,1,0
15509,21702,0,0,97,97,0,1,0,1,0
9843,3389,9843,3389,293,223,70,4,1,3,1
9475,25773,0,0,151,151,0,1,0,1,0
33366,6885,0,0,126,126,0,1,0,1,0
36324,3389,36324,3389,293,223,70,4,0,3,1
51009,30500,0,0,102,102,0,1,0,1,0
25922,3389,25922,3389,293,223,70,4,0,3,1
11698,25773,0,0,139,139,0,1,0,1,0
16262,25773,0,0,141,141,0,1,0,1,0
17014,1953,6318,1952,195,154,40,2,0,2,0
7143,60582,0,0,139,139,0,1,0,1,0
49160,33291,0,0,146,146,0,1,0,1,0
18295,61248,0,0,153,153,0,1,0,1,0
49789,27980,0,0,125,125,0,1,0,1,0
42655,3389,42655,3389,293,223,70,4,0,3,1
22247,21234,0,0,96,96,0,1,0,1,0
28240,28919,0,0,115,115,0,1,0,1,0
49413,34021,0,0,139,139,0,1,0,1,0
47227,5618,0,0,145,145,0,1,0,1,0
9697,58549,0,0,143,143,0,1,0,1,0
17738,61248,0,0,153,153,0,1,0,1,0
18341,3389,18341,3389,293,223,70,4,0,3,1
14780,25773,0,0,140,140,0,1,0,1,0
4466,23756,0,0,157,157,0,1,0,1,0
28266,27625,0,0,128,128,0,1,0,1,0
21991,3389,21991,3389,293,223,70,4,0,3,1
51876,31940,0,0,62,62,0,1,0,1,0
24506,3389,24506,3389,293,223,70,4,0,3,1
49140,33398,0,0,146,146,0,1,0,1,0
20755,3389,20755,3389,293,223,70,4,0,3,1
27897,25468,0,0,144,144,0,1,0,1,0
22549,25773,0,0,145,145,0,1,0,1,0
5643,25773,0,0,149,149,0,1,0,1,0
37759,3389,37759,3389,293,223,70,4,0,3,1
49746,32058,0,0,131,131,0,1,0,1,0
47738,43276,0,0,111,111,0,1,0,1,0
50995,6408,0,0,145,145,0,1,0,1,0
53090,33412,0,0,124,124,0,1,0,1,0
26990,27627,0,0,128,128,0,1,0,1,0
26478,25773,0,0,147,147,0,1,0,1,0
3674,48512,0,0,144,144,0,1,0,1,0
19079,43067,0,0,87,87,0,1,0,1,0
57102,49732,0,0,109,109,0,1,0,1,0
53509,12070,0,0,148,148,0,1,0,1,0
16286,25773,0,0,143,143,0,1,0,1,0
27906,34021,0,0,62,62,0,1,0,1,0
57814,52203,0,0,117,117,0,1,0,1,0
21125,37283,0,0,71,71,0,1,0,1,0
18754,7125,0,0,113,113,0,1,0,1,0
14677,3389,14677,3389,293,223,70,4,0,3,1
9436,3389,9436,3389,293,223,70,4,1,3,1
60221,3389,60221,3389,293,223,70,4,0,3,1
63939,31652,0,0,62,62,0,1,0,1,0
14922,61248,0,0,149,149,0,1,0,1,0
16202,25773,0,0,141,141,0,1,0,1,0
27622,34021,0,0,62,62,0,1,0,1,0
21848,61248,0,0,158,158,0,1,0,1,0
20696,3389,20696,3389,293,223,70,4,0,3,1
39265,6503,0,0,146,146,0,1,0,1,0
19445,3389,19445,3389,293,223,70,4,0,3,1
10616,61248,0,0,139,139,0,1,0,1,0
17630,25773,0,0,142,142,0,1,0,1,0
38383,3389,38383,3389,293,223,70,4,1,3,1
49717,31652,0,0,128,128,0,1,0,1,0
9341,25773,0,0,151,151,0,1,0,1,0
16719,15659,0,0,96,96,0,1,0,1,0
51290,31652,0,0,71,71,0,1,0,1,0
51218,33078,0,0,95,95,0,1,0,1,0
12345,61248,0,0,144,144,0,1,0,1,0
12832,9259,2798,1037,192,170,21,1,0,1,0
11580,25528,0,0,140,140,0,1,0,1,0
4884,23987,0,0,157,157,0,1,0,1,0
52062,34021,0,0,74,74,0,1,0,1,0
24974,3389,24974,3389,293,223,70,4,0,3,1
51364,32026,0,0,75,75,0,1,0,1,0
29777,33151,0,0,71,71,0,1,0,1,0
54267,5618,0,0,145,145,0,1,0,1,0
9719,25773,0,0,150,150,0,1,0,1,0
3532,48274,0,0,144,144,0,1,0,1,0
4283,49178,0,0,143,143,0,1,0,1,0
10081,3389,10081,3389,293,223,70,4,1,3,1
42893,60181,0,0,73,73,0,1,0,1,0
20074,25773,0,0,143,143,0,1,0,1,0
50523,29806,0,0,98,98,0,1,0,1,0
15924,3389,15924,3389,293,223,70,4,1,3,1
19210,17736,0,0,66,66,0,1,0,1,0
55904,3389,55904,3389,293,223,70,4,0,3,1
38370,3389,38370,3389,293,223,70,4,1,3,1
28165,32549,0,0,77,77,0,1,0,1,0
6280,23683,0,0,148,148,0,1,0,1,0
50442,42088,0,0,62,62,0,1,0,1,0
1463,22541,0,0,154,154,0,1,0,1,0
57214,50120,0,0,111,111,0,1,0,1,0
37412,34021,0,0,94,94,0,1,0,1,0
50092,28734,0,0,114,114,0,1,0,1,0
21437,16561,0,0,77,77,0,1,0,1,0
52481,33734,0,0,62,62,0,1,0,1,0
50603,31652,0,0,99,99,0,1,0,1,0
49160,32934,0,0,146,146,0,1,0,1,0
17016,61248,0,0,151,151,0,1,0,1,0
46697,56231,0,0,62,62,0,1,0,1,0
14521,61248,0,0,147,147,0,1,0,1,0
59995,31652,0,0,62,62,0,1,0,1,0
17976,25773,0,0,143,143,0,1,0,1,0
12489,3389,12489,3389,293,223,70,4,0,3,1
11133,6555,5720,2120,238,194,43,2,0,2,0
29905,33794,0,0,64,64,0,1,0,1,0
59923,31652,0,0,62,62,0,1,0,1,0
8322,56257,0,0,143,143,0,1,0,1,0
9608,3389,9608,3389,293,223,70,4,0,3,1
48806,36669,0,0,137,137,0,1,0,1,0
51542,31697,0,0,88,88,0,1,0,1,0
13393,3389,13393,3389,293,223,70,4,0,3,1
49525,23922,0,0,155,155,0,1,0,1,0
61876,32167,0,0,62,62,0,1,0,1,0
54429,12985,0,0,124,124,0,1,0,1,0
13443,3389,13443,3389,293,223,70,4,0,3,1
5587,24720,0,0,131,131,0,1,0,1,0
51251,30574,0,0,79,79,0,1,0,1,0
12386,25773,0,0,150,150,0,1,0,1,0
14773,3389,14773,3389,293,223,70,4,0,3,1
10994,61248,0,0,139,139,0,1,0,1,0
13024,21027,0,0,142,142,0,1,0,1,0
26471,28360,0,0,121,121,0,1,0,1,0
51391,33198,0,0,91,91,0,1,0,1,0
58733,31652,0,0,66,66,0,1,0,1,0
19101,18878,0,0,69,69,0,1,0,1,0
26499,28321,0,0,121,121,0,1,0,1,0
3183,49068,0,0,143,143,0,1,0,1,0
11114,3389,11114,3389,293,223,70,4,1,3,1
11475,3389,11475,3389,293,223,70,4,0,3,1
17524,3389,17524,3389,293,223,70,4,0,3,1
18210,19560,0,0,76,76,0,1,0,1,0
12686,25263,0,0,133,133,0,1,0,1,0
16610,25773,0,0,142,142,0,1,0,1,0
6304,25773,0,0,151,151,0,1,0,1,0
19480,3389,19480,3389,293,223,70,4,0,3,1
46900,55467,0,0,62,62,0,1,0,1,0
49634,34021,0,0,134,134,0,1,0,1,0
11387,3389,11387,3389,293,223,70,4,0,3,1
58063,53069,0,0,120,120,0,1,0,1,0
39610,7088,0,0,146,146,0,1,0,1,0
2474,47004,0,0,144,144,0,1,0,1,0
52020,32366,0,0,62,62,0,1,0,1,0
5145,54774,0,0,141,141,0,1,0,1,0
62882,3389,62882,3389,293,223,70,4,0,3,1
3282,23101,0,0,157,157,0,1,0,1,0
50252,28801,0,0,122,122,0,1,0,1,0
15201,3389,15201,3389,293,223,70,4,0,3,1
16238,2137,6914,2136,207,163,44,2,0,2,0
49790,31652,0,0,125,125,0,1,0,1,0
12807,22414,0,0,141,141,0,1,0,1,0
29785,23325,0,0,147,147,0,1,0,1,0
1210,22145,0,0,155,155,0,1,0,1,0
51750,31652,0,0,62,62,0,1,0,1,0
51686,3389,51686,3389,293,223,70,4,0,3,1
27187,34021,0,0,62,62,0,1,0,1,0
30196,60833,0,0,125,125,0,1,0,1,0
4075,51662,0,0,142,142,0,1,0,1,0
46099,60071,0,0,64,64,0,1,0,1,0
50019,22450,0,0,155,155,0,1,0,1,0
26941,24751,0,0,136,136,0,1,0,1,0
49839,31652,0,0,122,122,0,1,0,1,0
25087,3389,25087,3389,293,223,70,4,0,3,1
62804,3389,62804,3389,293,223,70,4,0,3,1
12402,25773,0,0,139,139,0,1,0,1,0
15271,10955,0,0,141,141,0,1,0,1,0
50551,60437,0,0,89,89,0,1,0,1,0
49491,27237,0,0,135,135,0,1,0,1,0
60161,32509,0,0,62,62,0,1,0,1,0
52507,42115,0,0,145,145,0,1,0,1,0
16519,3389,16519,3389,293,223,70,4,0,3,1
7052,29307,0,0,154,154,0,1,0,1,0
18170,20866,0,0,90,90,0,1,0,1,0
4008,49067,0,0,144,144,0,1,0,1,0
15207,3389,15207,3389,293,223,70,4,0,3,1
59024,3389,59024,3389,293,223,70,4,0,3,1
51101,31244,0,0,77,77,0,1,0,1,0
37185,3389,37185,3389,293,223,70,4,1,3,1
61326,32137,0,0,79,79,0,1,0,1,0
18487,61248,0,0,153,153,0,1,0,1,0
49119,32714,0,0,147,147,0,1,0,1,0
25994,3389,25994,3389,293,223,70,4,1,3,1
48944,25649,0,0,156,156,0,1,0,1,0
28470,34021,0,0,62,62,0,1,0,1,0
52368,34021,0,0,67,67,0,1,0,1,0
31370,3389,31370,3389,293,223,70,4,0,3,1
13997,3389,13997,3389,293,223,70,4,0,3,1
49094,32185,0,0,144,144,0,1,0,1,0
3711,48314,0,0,144,144,0,1,0,1,0
14935,3389,14935,3389,293,223,70,4,0,3,1
19099,3389,19099,3389,293,223,70,4,0,3,1
27231,1691,0,0,77,77,0,1,0,1,0
18180,25773,0,0,143,143,0,1,0,1,0
39147,6588,0,0,146,146,0,1,0,1,0
48342,60255,0,0,76,76,0,1,0,1,0
17400,3389,17400,3389,293,223,70,4,0,3,1
27447,13390,0,0,105,105,0,1,0,1,0
50259,33026,0,0,110,110,0,1,0,1,0
11391,61248,0,0,139,139,0,1,0,1,0
14373,2914,10838,2914,260,200,60,3,0,2,0
23583,34021,0,0,62,62,0,1,0,1,0
12393,3389,12393,3389,293,223,70,4,0,3,1
10858,25773,0,0,143,143,0,1,0,1,0
17266,2138,7951,2137,207,163,44,2,0,2,0
49990,28480,0,0,117,117,0,1,0,1,0
18181,20515,0,0,86,86,0,1,0,1,0
36643,3389,36643,3389,293,223,70,4,0,3,1
50085,33183,0,0,116,116,0,1,0,1,0
17015,29607,0,0,103,103,0,1,0,1,0
38277,7212,0,0,146,146,0,1,0,1,0
4888,50535,0,0,144,144,0,1,0,1,0
18357,3389,18357,3389,293,223,70,4,0,3,1
49360,33839,0,0,139,139,0,1,0,1,0
16283,3389,16283,3389,293,223,70,4,0,3,1
49456,31857,0,0,138,138,0,1,0,1,0
23151,495,1601,494,95,85,10,1,0,1,0
50993,31652,0,0,81,81,0,1,0,1,0
49485,27222,0,0,136,136,0,1,0,1,0
18034,25224,0,0,137,137,0,1,0,1,0
43285,3389,43285,3389,293,223,70,4,0,3,1
18210,19583,0,0,76,76,0,1,0,1,0
14760,22646,0,0,107,107,0,1,0,1,0
22657,3389,22657,3389,293,223,70,4,0,3,1
24788,490,0,0,65,65,0,1,0,1,0
37829,3389,37829,3389,293,223,70,4,1,3,1
26801,34021,0,0,62,62,0,1,0,1,0
17800,17481,0,0,72,72,0,1,0,1,0
40271,5533,0,0,144,144,0,1,0,1,0
31975,60742,0,0,118,118,0,1,0,1,0
18291,3389,18291,3389,293,223,70,4,0,3,1
22233,30950,0,0,90,90,0,1,0,1,0
22056,3389,22056,3389,293,223,70,4,0,3,1
61729,3999,46472,2460,252,201,50,3,0,2,0
23891,30561,0,0,95,95,0,1,0,1,0
48920,26332,0,0,156,156,0,1,0,1,0
4293,23660,0,0,157,157,0,1,0,1,0
51438,31652,0,0,68,68,0,1,0,1,0
16719,61248,0,0,151,151,0,1,0,1,0
6315,24778,0,0,157,157,0,1,0,1,0
4274,49164,0,0,143,143,0,1,0,1,0
43866,13692,0,0,150,150,0,1,0,1,0
15332,15267,0,0,146,146,0,1,0,1,0
49604,34021,0,0,135,135,0,1,0,1,0
26738,1274,0,0,73,73,0,1,0,1,0
5972,52341,0,0,144,144,0,1,0,1,0
43869,5618,0,0,145,145,0,1,0,1,0
27660,26682,0,0,138,138,0,1,0,1,0
45860,58642,0,0,66,66,0,1,0,1,0
58195,4944,19330,1023,189,168,21,1,0,1,0
18048,3389,18048,3389,293,223,70,4,0,3,1
15550,21650,0,0,96,96,0,1,0,1,0
31516,2312,0,0,96,96,0,1,0,1,0
5959,25773,0,0,150,150,0,1,0,1,0
3035,25000,0,0,145,145,0,1,0,1,0
51365,31652,0,0,70,70,0,1,0,1,0
61632,52363,0,0,120,120,0,1,0,1,0
10709,61248,0,0,142,142,0,1,0,1,0
51200,31725,0,0,74,74,0,1,0,1,0
15283,15072,0,0,146,146,0,1,0,1,0
14628,25773,0,0,140,140,0,1,0,1,0
28157,32923,0,0,73,73,0,1,0,1,0
9874,3389,9874,3389,293,223,70,4,1,3,1
38116,3389,38116,3389,293,223,70,4,1,3,1
5320,25773,0,0,148,148,0,1,0,1,0
50593,29980,0,0,96,96,0,1,0,1,0
5760,33602,0,0,152,152,0,1,0,1,0
13258,25773,0,0,143,143,0,1,0,1,0
12984,22155,0,0,111,111,0,1,0,1,0
59486,58008,0,0,135,135,0,1,0,1,0
30290,4281,0,0,102,102,0,1,0,1,0
16924,16003,0,0,92,92,0,1,0,1,0
29729,3389,29729,3389,293,223,70,4,0,3,1
9656,4204,8262,3062,279,215,63,3,0,2,0
59835,4506,31926,1690,218,183,34,2,0,1,0
15116,22197,0,0,102,102,0,1,0,1,0
38589,6988,0,0,146,146,0,1,0,1,0
16140,14683,0,0,109,109,0,1,0,1,0
9164,24687,0,0,143,143,0,1,0,1,0
17195,61248,0,0,148,148,0,1,0,1,0
11135,23529,0,0,128,128,0,1,0,1,0
25248,34021,0,0,62,62,0,1,0,1,0
49479,33661,0,0,134,134,0,1,0,1,0
29097,29745,0,0,106,106,0,1,0,1,0
20289,25773,0,0,144,144,0,1,0,1,0
14933,3389,14933,3389,293,223,70,4,0,3,1
52997,33937,0,0,62,62,0,1,0,1,0
18204,19761,0,0,78,78,0,1,0,1,0
48935,26801,0,0,155,155,0,1,0,1,0
26035,34021,0,0,62,62,0,1,0,1,0
38367,4833,0,0,134,134,0,1,0,1,0
12404,3389,12404,3389,293,223,70,4,0,3,1
38377,3389,38377,3389,293,223,70,4,1,3,1
18240,3389,18240,3389,293,223,70,4,0,3,1
29901,33773,0,0,64,64,0,1,0,1,0
19215,31390,0,0,86,86,0,1,0,1,0
8262,25773,0,0,156,156,0,1,0,1,0
17568,25773,0,0,143,143,0,1,0,1,0
10622,23910,0,0,133,133,0,1,0,1,0
15844,3389,15844,3389,293,223,70,4,0,3,1
44366,60105,0,0,67,67,0,1,0,1,0
50704,32722,0,0,108,108,0,1,0,1,0
50794,31652,0,0,93,93,0,1,0,1,0
11711,23101,0,0,123,123,0,1,0,1,0
24254,3389,24254,3389,293,223,70,4,0,3,1
34939,10954,0,0,146,146,0,1,0,1,0
51781,32584,0,0,68,68,0,1,0,1,0
18214,3389,18214,3389,293,223,70,4,0,3,1
16020,25773,0,0,145,145,0,1,0,1,0
49160,32873,0,0,146,146,0,1,0,1,0
10162,3389,10162,3389,293,223,70,4,1,3,1
15632,13825,0,0,121,121,0,1,0,1,0
25984,32268,0,0,79,79,0,1,0,1,0
11084,60861,0,0,143,143,0,1,0,1,0
27841,33782,0,0,64,64,0,1,0,1,0
50836,30112,0,0,107,107,0,1,0,1,0
49677,33553,0,0,129,129,0,1,0,1,0
43109,5618,0,0,145,145,0,1,0,1,0
10706,3389,10706,3389,293,223,70,4,1,3,1
16729,20163,0,0,81,81,0,1,0,1,0
18845,25773,0,0,143,143,0,1,0,1,0
46704,51741,0,0,86,86,0,1,0,1,0
58313,54037,0,0,124,124,0,1,0,1,0
21593,3389,21593,3389,293,223,70,4,0,3,1
47726,34021,0,0,139,139,0,1,0,1,0
46468,5618,0,0,145,145,0,1,0,1,0
17588,3389,17588,3389,293,223,70,4,0,3,1
39920,60334,0,0,85,85,0,1,0,1,0
12259,3389,12259,3389,293,223,70,4,1,3,1
8255,61248,0,0,139,139,0,1,0,1,0
47933,41688,0,0,116,116,0,1,0,1,0
8564,61248,0,0,140,140,0,1,0,1,0
14160,25773,0,0,140,140,0,1,0,1,0
14597,3389,14597,3389,293,223,70,4,0,3,1
11088,3389,11088,3389,293,223,70,4,1,3,1
21268,3389,21268,3389,293,223,70,4,0,3,1
49998,31652,0,0,116,116,0,1,0,1,0
4294,38478,0,0,149,149,0,1,0,1,0
49160,32421,0,0,146,146,0,1,0,1,0
49160,33841,0,0,146,146,0,1,0,1,0
15897,28702,0,0,111,111,0,1,0,1,0
8362,61248,0,0,139,139,0,1,0,1,0
49463,24104,0,0,156,156,0,1,0,1,0
35332,8550,0,0,142,142,0,1,0,1,0
54392,31652,0,0,69,69,0,1,0,1,0
53155,43683,0,0,145,145,0,1,0,1,0
37227,3389,37227,3389,293,223,70,4,1,3,1
20769,3389,20769,3389,293,223,70,4,0,3,1
11408,3389,11408,3389,293,223,70,4,0,3,1
14889,12573,0,0,138,138,0,1,0,1,0
14287,25773,0,0,140,140,0,1,0,1,0
52230,33393,0,0,64,64,0,1,0,1,0
30545,60815,0,0,124,124,0,1,0,1,0
20128,3389,20128,3389,293,223,70,4,0,3,1
21044,32873,0,0,72,72,0,1,0,1,0
49021,29570,0,0,151,151,0,1,0,1,0
12715,3389,12715,3389,293,223,70,4,0,3,1
48912,25796,0,0,156,156,0,1,0,1,0
11950,61248,0,0,140,140,0,1,0,1,0
52374,33653,0,0,63,63,0,1,0,1,0
52460,33809,0,0,62,62,0,1,0,1,0
53536,37672,0,0,78,78,0,1,0,1,0
18526,26718,0,0,133,133,0,1,0,1,0
10392,3389,10392,3389,293,223,70,4,0,3,1
50884,31652,0,0,85,85,0,1,0,1,0
12231,61248,0,0,145,145,0,1,0,1,0
9894,3389,9894,3389,293,223,70,4,1,3,1
24643,34021,0,0,62,62,0,1,0,1,0
25218,31643,0,0,85,85,0,1,0,1,0
49088,26190,0,0,152,152,0,1,0,1,0
18238,18668,0,0,66,66,0,1,0,1,0
21094,3389,21094,3389,293,223,70,4,0,3,1
56185,5482,3901,206,154,149,4,1,0,1,0
51743,31579,0,0,63,63,0,1,0,1,0
38344,3389,38344,3389,293,223,70,4,1,3,1
18206,3389,18206,3389,293,223,70,4,0,3,1
57391,60999,0,0,127,127,0,1,0,1,0
23872,3389,23872,3389,293,223,70,4,0,3,1
12696,3389,12696,3389,293,223,70,4,0,3,1
26545,28256,0,0,122,122,0,1,0,1,0
51871,31927,0,0,62,62,0,1,0,1,0
29488,34021,0,0,62,62,0,1,0,1,0
9701,3389,9701,3389,293,223,70,4,0,3,1
26492,25773,0,0,147,147,0,1,0,1,0
33715,3121,0,0,108,108,0,1,0,1,0
28237,29037,0,0,113,113,0,1,0,1,0
17735,3389,17735,3389,293,223,70,4,0,3,1
13219,9874,2133,790,181,165,16,1,0,1,0
12090,25773,0,0,139,139,0,1,0,1,0
19826,25773,0,0,143,143,0,1,0,1,0
28955,3389,28955,3389,293,223,70,4,0,3,1
11898,61248,0,0,140,140,0,1,0,1,0
14591,2528,8180,2527,234,182,52,3,0,2,0
31921,2461,0,0,98,98,0,1,0,1,0
21898,61248,0,0,158,158,0,1,0,1,0
63920,3413,63299,3351,291,222,69,3,0,2,0
49160,33111,0,0,146,146,0,1,0,1,0
48999,28858,0,0,152,152,0,1,0,1,0
29787,34021,0,0,62,62,0,1,0,1,0
18850,61248,0,0,152,152,0,1,0,1,0
14938,3389,14938,3389,293,223,70,4,0,3,1
38375,3389,38375,3389,293,223,70,4,0,3,1
18912,3389,18912,3389,293,223,70,4,0,3,1
49187,26481,0,0,146,146,0,1,0,1,0
1268,21939,0,0,156,156,0,1,0,1,0
14970,19920,0,0,80,80,0,1,0,1,0
61129,3389,61129,3389,293,223,70,4,0,3,1
48745,60289,0,0,79,79,0,1,0,1,0
49903,33183,0,0,119,119,0,1,0,1,0
49160,32000,0,0,146,146,0,1,0,1,0
45726,59742,0,0,62,62,0,1,0,1,0
13265,3389,13265,3389,293,223,70,4,0,3,1
8620,61248,0,0,140,140,0,1,0,1,0
20935,61248,0,0,156,156,0,1,0,1,0
16192,3389,16192,3389,293,223,70,4,0,3,1
20060,29565,0,0,105,105,0,1,0,1,0
10066,4857,7556,2800,267,209,57,3,0,2,0
50303,29257,0,0,106,106,0,1,0,1,0
13393,58282,0,0,130,130,0,1,0,1,0
52349,41734,0,0,145,145,0,1,0,1,0
61165,31652,0,0,64,64,0,1,0,1,0
25595,3389,25595,3389,293,223,70,4,0,3,1
16000,3389,16000,3389,293,223,70,4,0,3,1
29518,23061,0,0,147,147,0,1,0,1,0
27113,692,0,0,72,72,0,1,0,1,0
50110,32310,0,0,122,122,0,1,0,1,0
24635,34021,0,0,62,62,0,1,0,1,0
13233,24669,0,0,146,146,0,1,0,1,0
17662,3389,17662,3389,293,223,70,4,0,3,1
50154,33121,0,0,114,114,0,1,0,1,0
14695,3389,14695,3389,293,223,70,4,0,3,1
15756,3389,15756,3389,293,223,70,4,0,3,1
51853,3389,51853,3389,293,223,70,4,0,3,1
11497,61248,0,0,142,142,0,1,0,1,0
19672,3389,19672,3389,293,223,70,4,0,3,1
10718,25773,0,0,139,139,0,1,0,1,0
27357,3389,27357,3389,293,223,70,4,0,3,1
8322,56257,0,0,143,143,0,1,0,1,0
46083,5618,0,0,145,145,0,1,0,1,0
18892,3389,18892,3389,293,223,70,4,0,3,1
5128,50452,0,0,143,143,0,1,0,1,0
49247,33942,0,0,143,143,0,1,0,1,0
28268,27551,0,0,129,129,0,1,0,1,0
51500,31082,0,0,71,71,0,1,0,1,0
7712,27115,0,0,156,156,0,1,0,1,0
57493,31652,0,0,62,62,0,1,0,1,0
17718,3389,17718,3389,293,223,70,4,1,3,1
18770,61248,0,0,154,154,0,1,0,1,0
34230,3311,0,0,111,111,0,1,0,1,0
5911,57000,0,0,140,140,0,1,0,1,0
12465,24602,0,0,139,139,0,1,0,1,0
10453,61248,0,0,142,142,0,1,0,1,0
9271,61248,0,0,140,140,0,1,0,1,0
41162,5618,0,0,145,145,0,1,0,1,0
5816,25773,0,0,149,149,0,1,0,1,0
25140,34021,0,0,62,62,0,1,0,1,0
16890,61248,0,0,148,148,0,1,0,1,0
12072,6067,7494,2315,247,199,47,3,0,2,0
23517,34021,0,0,62,62,0,1,0,1,0
17172,19604,0,0,75,75,0,1,0,1,0
17838,3389,17838,3389,293,223,70,4,0,3,1
49160,33534,0,0,146,146,0,1,0,1,0
49160,31923,0,0,146,146,0,1,0,1,0
35980,8860,0,0,146,146,0,1,0,1,0
18097,23203,0,0,115,115,0,1,0,1,0
49299,31652,0,0,141,141,0,1,0,1,0
29281,30667,0,0,96,96,0,1,0,1,0
13245,25773,0,0,139,139,0,1,0,1,0
9677,3389,9677,3389,293,223,70,4,1,3,1
5941,18191,0,0,153,153,0,1,0,1,0
60457,31652,0,0,65,65,0,1,0,1,0
12515,3389,12515,3389,293,223,70,4,1,3,1
24757,30431,0,0,97,97,0,1,0,1,0
41800,7961,0,0,145,145,0,1,0,1,0
28257,28099,0,0,123,123,0,1,0,1,0
18184,3389,18184,3389,293,223,70,4,0,3,1
26818,3389,26818,3389,293,223,70,4,0,3,1
8084,25879,0,0,156,156,0,1,0,1,0
5810,25773,0,0,143,143,0,1,0,1,0
25381,34021,0,0,62,62,0,1,0,1,0
25405,34021,0,0,62,62,0,1,0,1,0
62395,31971,0,0,73,73,0,1,0,1,0
20118,61248,0,0,156,156,0,1,0,1,0
18453,3389,18453,3389,293,223,70,4,0,3,1
51641,31652,0,0,132,132,0,1,0,1,0
51351,31652,0,0,70,70,0,1,0,1,0
53681,17395,0,0,111,111,0,1,0,1,0
15876,20006,0,0,84,84,0,1,0,1,0
41002,6823,0,0,146,146,0,1,0,1,0
49782,33457,0,0,126,126,0,1,0,1,0
27573,34021,0,0,62,62,0,1,0,1,0
19693,19321,0,0,74,74,0,1,0,1,0
14022,10790,1371,423,166,157,8,1,0,1,0
50441,31652,0,0,100,100,0,1,0,1,0
18074,23942,0,0,123,123,0,1,0,1,0
52437,34021,0,0,65,65,0,1,0,1,0
40472,34021,0,0,108,108,0,1,0,1,0
14155,25773,0,0,140,140,0,1,0,1,0
51289,34021,0,0,93,93,0,1,0,1,0
37234,3389,37234,3389,293,223,70,4,1,3,1
59407,4620,28640,1516,211,179,31,2,0,1,0
49794,33306,0,0,123,123,0,1,0,1,0
18280,26262,0,0,138,138,0,1,0,1,0
13525,25773,0,0,143,143,0,1,0,1,0
10993,25773,0,0,139,139,0,1,0,1,0
13764,49713,0,0,106,106,0,1,0,1,0
31214,3389,31214,3389,293,223,70,4,0,3,1
50837,30114,0,0,106,106,0,1,0,1,0
17790,17464,0,0,72,72,0,1,0,1,0
28542,34021,0,0,62,62,0,1,0,1,0
55336,31652,0,0,112,112,0,1,0,1,0
50799,30493,0,0,88,88,0,1,0,1,0
10339,25773,0,0,139,139,0,1,0,1,0
49447,31652,0,0,136,136,0,1,0,1,0
51651,31652,0,0,66,66,0,1,0,1,0
28293,26322,0,0,142,142,0,1,0,1,0
14142,3389,14142,3389,293,223,70,4,0,3,1
49230,31701,0,0,144,144,0,1,0,1,0
9348,3389,9348,3389,293,223,70,4,1,3,1
21927,33030,0,0,71,71,0,1,0,1,0
51824,32662,0,0,67,67,0,1,0,1,0
49781,27958,0,0,125,125,0,1,0,1,0
15326,61248,0,0,145,145,0,1,0,1,0
52278,33813,0,0,69,69,0,1,0,1,0
50017,60393,0,0,86,86,0,1,0,1,0
16098,3389,16098,3389,293,223,70,4,0,3,1
4809,53795,0,0,141,141,0,1,0,1,0
47074,48713,0,0,95,95,0,1,0,1,0
52124,32674,0,0,62,62,0,1,0,1,0
16355,61248,0,0,151,151,0,1,0,1,0
32375,34021,0,0,72,72,0,1,0,1,0
52013,32348,0,0,62,62,0,1,0,1,0
48906,25852,0,0,156,156,0,1,0,1,0
16159,3389,16159,3389,293,223,70,4,0,3,1
52240,33412,0,0,64,64,0,1,0,1,0
20228,3389,20228,3389,293,223,70,4,0,3,1
59478,61170,0,0,139,139,0,1,0,1,0
22258,33646,0,0,65,65,0,1,0,1,0
58180,55833,0,0,145,145,0,1,0,1,0
12504,3389,12504,3389,293,223,70,4,0,3,1
13342,24436,0,0,125,125,0,1,0,1,0
54094,14959,0,0,118,118,0,1,0,1,0
23126,34021,0,0,62,62,0,1,0,1,0
51043,31901,0,0,79,79,0,1,0,1,0
57547,31652,0,0,67,67,0,1,0,1,0
27391,25088,0,0,140,140,0,1,0,1,0
45093,5618,0,0,145,145,0,1,0,1,0
53781,18278,0,0,104,104,0,1,0,1,0
49157,31584,0,0,146,146,0,1,0,1,0
28563,27070,0,0,134,134,0,1,0,1,0
51758,32543,0,0,68,68,0,1,0,1,0
52349,33344,0,0,62,62,0,1,0,1,0
8566,25773,0,0,155,155,0,1,0,1,0
9575,61248,0,0,139,139,0,1,0,1,0
19364,61248,0,0,154,154,0,1,0,1,0
61328,32276,0,0,62,62,0,1,0,1,0
17562,3389,17562,3389,293,223,70,4,0,3,1
9204,57727,0,0,143,143,0,1,0,1,0
12668,25773,0,0,150,150,0,1,0,1,0
43072,60172,0,0,72,72,0,1,0,1,0
21525,4078,0,0,91,91,0,1,0,1,0
4703,49811,0,0,143,143,0,1,0,1,0
9984,22470,0,0,107,107,0,1,0,1,0
10896,61248,0,0,142,142,0,1,0,1,0
14571,3389,14571,3389,293,223,70,4,0,3,1
14505,25773,0,0,147,147,0,1,0,1,0
15879,3389,15879,3389,293,223,70,4,0,3,1
51953,32893,0,0,66,66,0,1,0,1,0
11014,3503,10817,3342,291,221,69,3,0,2,0
34437,3389,34437,3389,293,223,70,4,0,3,1
1411,21565,0,0,156,156,0,1,0,1,0
50404,31652,0,0,102,102,0,1,0,1,0
33831,3164,0,0,109,109,0,1,0,1,0
52299,33193,0,0,62,62,0,1,0,1,0
50644,29332,0,0,99,99,0,1,0,1,0
49831,33265,0,0,122,122,0,1,0,1,0
14845,61248,0,0,144,144,0,1,0,1,0
47494,53220,0,0,62,62,0,1,0,1,0
11341,3389,11341,3389,293,223,70,4,0,3,1
28747,34021,0,0,62,62,0,1,0,1,0
26762,3389,26762,3389,293,223,70,4,0,3,1
12799,59870,0,0,135,135,0,1,0,1,0
3643,50406,0,0,143,143,0,1,0,1,0
52492,33766,0,0,62,62,0,1,0,1,0
50628,37571,0,0,145,145,0,1,0,1,0
7668,61248,0,0,139,139,0,1,0,1,0
7723,61248,0,0,139,139,0,1,0,1,0
38845,34021,0,0,100,100,0,1,0,1,0
18153,3389,18153,3389,293,223,70,4,0,3,1
18129,3389,18129,3389,293,223,70,4,0,3,1
22282,33689,0,0,65,65,0,1,0,1,0
5562,55986,0,0,141,141,0,1,0,1,0
7589,61248,0,0,139,139,0,1,0,1,0
40242,34021,0,0,107,107,0,1,0,1,0
26003,29020,0,0,114,114,0,1,0,1,0
19829,27250,0,0,128,128,0,1,0,1,0
15073,25773,0,0,147,147,0,1,0,1,0
56605,48007,0,0,104,104,0,1,0,1,0
17708,61248,0,0,152,152,0,1,0,1,0
50109,32952,0,0,112,112,0,1,0,1,0
14885,61248,0,0,144,144,0,1,0,1,0
13765,61248,0,0,142,142,0,1,0,1,0
5117,25773,0,0,143,143,0,1,0,1,0
19421,6391,0,0,108,108,0,1,0,1,0
16305,20698,0,0,87,87,0,1,0,1,0
6717,59345,0,0,139,139,0,1,0,1,0
39742,6869,0,0,146,146,0,1,0,1,0
20319,1319,4904,1318,151,124,27,2,0,1,0
34393,3389,34393,3389,293,223,70,4,0,3,1
53508,37577,0,0,78,78,0,1,0,1,0
24636,31169,0,0,90,90,0,1,0,1,0
22780,21634,0,0,100,100,0,1,0,1,0
37237,3389,37237,3389,293,223,70,4,1,3,1
4679,23874,0,0,157,157,0,1,0,1,0
11765,25773,0,0,141,141,0,1,0,1,0
28337,34021,0,0,62,62,0,1,0,1,0
49160,32327,0,0,146,146,0,1,0,1,0
39643,8325,0,0,145,145,0,1,0,1,0
5595,25773,0,0,149,149,0,1,0,1,0
11369,3389,11369,3389,293,223,70,4,1,3,1
50244,36642,0,0,145,145,0,1,0,1,0
13746,23925,0,0,120,120,0,1,0,1,0
22132,33410,0,0,67,67,0,1,0,1,0
3466,49890,0,0,143,143,0,1,0,1,0
50801,30033,0,0,107,107,0,1,0,1,0
13966,3023,11243,3023,268,205,62,3,0,2,0
37877,7499,0,0,146,146,0,1,0,1,0
11694,61248,0,0,141,141,0,1,0,1,0
15471,20307,0,0,88,88,0,1,0,1,0
3344,28317,0,0,143,143,0,1,0,1,0
14350,3389,14350,3389,293,223,70,4,0,3,1
20884,3389,20884,3389,293,223,70,4,0,3,1
28084,2414,0,0,84,84,0,1,0,1,0
47801,42761,0,0,113,113,0,1,0,1,0
49739,27650,0,0,135,135,0,1,0,1,0
13634,25773,0,0,149,149,0,1,0,1,0
50074,3389,50074,3389,293,223,70,4,0,3,1
28160,32773,0,0,75,75,0,1,0,1,0
36566,3389,36566,3389,293,223,70,4,1,3,1
15941,10218,0,0,136,136,0,1,0,1,0
10185,25773,0,0,154,154,0,1,0,1,0
18211,19525,0,0,75,75,0,1,0,1,0
11615,4960,8929,2759,266,209,56,3,0,2,0
24568,25773,0,0,146,146,0,1,0,1,0
43651,3389,43651,3389,293,223,70,4,0,3,1
21789,3389,21789,3389,293,223,70,4,0,3,1
12500,3389,12500,3389,293,223,70,4,0,3,1
49275,33890,0,0,141,141,0,1,0,1,0
32578,10684,0,0,130,130,0,1,0,1,0
18409,3389,18409,3389,293,223,70,4,0,3,1
2280,43032,0,0,144,144,0,1,0,1,0
2979,20397,0,0,155,155,0,1,0,1,0
42166,5618,0,0,145,145,0,1,0,1,0
32209,3389,32209,3389,293,223,70,4,0,3,1
18056,24517,0,0,129,129,0,1,0,1,0
8345,25773,0,0,140,140,0,1,0,1,0
35282,3698,0,0,117,117,0,1,0,1,0
24283,3389,24283,3389,293,223,70,4,0,3,1
50740,32747,0,0,107,107,0,1,0,1,0
23559,32470,0,0,78,78,0,1,0,1,0
50984,32916,0,0,101,101,0,1,0,1,0
49184,34021,0,0,145,145,0,1,0,1,0
50658,29361,0,0,99,99,0,1,0,1,0
16737,15688,0,0,96,96,0,1,0,1,0
12253,3389,12253,3389,293,223,70,4,0,3,1
16224,3389,16224,3389,293,223,70,4,0,3,1
50650,32673,0,0,98,98,0,1,0,1,0
11162,25773,0,0,139,139,0,1,0,1,0
14136,3389,14136,3389,293,223,70,4,0,3,1
49160,32793,0,0,146,146,0,1,0,1,0
9855,3389,9855,3389,293,223,70,4,0,3,1
16024,61248,0,0,146,146,0,1,0,1,0
39786,5355,0,0,142,142,0,1,0,1,0
50122,28807,0,0,113,113,0,1,0,1,0
49471,34021,0,0,138,138,0,1,0,1,0
12992,8294,4606,1423,208,179,29,2,0,1,0
50180,33097,0,0,113,113,0,1,0,1,0
18075,3389,18075,3389,293,223,70,4,0,3,1
13485,25773,0,0,149,149,0,1,0,1,0
6954,53206,0,0,142,142,0,1,0,1,0
2910,22289,0,0,155,155,0,1,0,1,0
8605,25773,0,0,156,156,0,1,0,1,0
21603,61248,0,0,158,158,0,1,0,1,0
49151,33734,0,0,146,146,0,1,0,1,0
38313,3389,38313,3389,293,223,70,4,0,3,1
24337,22800,0,0,114,114,0,1,0,1,0
50785,32550,0,0,93,93,0,1,0,1,0
30772,3389,30772,3389,293,223,70,4,0,3,1
16058,25773,0,0,145,145,0,1,0,1,0
10901,61248,0,0,142,142,0,1,0,1,0
6266,17949,0,0,153,153,0,1,0,1,0
17921,61248,0,0,152,152,0,1,0,1,0
49160,32263,0,0,146,146,0,1,0,1,0
21116,3389,21116,3389,293,223,70,4,0,3,1
53035,3389,53035,3389,293,223,70,4,0,3,1
51677,31652,0,0,63,63,0,1,0,1,0
21834,32858,0,0,73,73,0,1,0,1,0
51013,31652,0,0,135,135,0,1,0,1,0
26250,14022,0,0,100,100,0,1,0,1,0
3629,23293,0,0,157,157,0,1,0,1,0
1639,22068,0,0,156,156,0,1,0,1,0
14439,3389,14439,3389,293,223,70,4,0,3,1
49580,34021,0,0,135,135,0,1,0,1,0
54645,33608,0,0,62,62,0,1,0,1,0
27020,25773,0,0,147,147,0,1,0,1,0
28712,27817,0,0,126,126,0,1,0,1,0
10028,3389,10028,3389,293,223,70,4,1,3,1
9283,25773,0,0,151,151,0,1,0,1,0
18046,24826,0,0,132,132,0,1,0,1,0
1578,22721,0,0,153,153,0,1,0,1,0
18652,3389,18652,3389,293,223,70,4,0,3,1
49145,26375,0,0,148,148,0,1,0,1,0
40976,5618,0,0,145,145,0,1,0,1,0
24989,25773,0,0,146,146,0,1,0,1,0
16259,3389,16259,3389,293,223,70,4,0,3,1
50216,29043,0,0,109,109,0,1,0,1,0
17847,3389,17847,3389,293,223,70,4,0,3,1
18703,3389,18703,3389,293,223,70,4,0,3,1
40058,34021,0,0,106,106,0,1,0,1,0
12873,8006,4979,1538,213,182,31,2,0,1,0
5007,48100,0,0,147,147,0,1,0,1,0
28216,25706,0,0,147,147,0,1,0,1,0
53867,31652,0,0,70,70,0,1,0,1,0
28698,34021,0,0,62,62,0,1,0,1,0
18615,3389,18615,3389,293,223,70,4,0,3,1
17255,2141,7962,2140,207,163,44,2,0,2,0
50163,33113,0,0,113,113,0,1,0,1,0
37919,3389,37919,3389,293,223,70,4,1,3,1
7587,61248,0,0,139,139,0,1,0,1,0
17469,16922,0,0,79,79,0,1,0,1,0
49983,31652,0,0,119,119,0,1,0,1,0
10532,3389,10532,3389,293,223,70,4,1,3,1
12811,25773,0,0,139,139,0,1,0,1,0
33042,3389,33042,3389,293,223,70,4,0,3,1
51353,30782,0,0,76,76,0,1,0,1,0
55899,3389,55899,3389,293,223,70,4,0,3,1
5898,25773,0,0,150,150,0,1,0,1,0
36308,8624,0,0,146,146,0,1,0,1,0
20940,3389,20940,3389,293,223,70,4,0,3,1
15619,3389,15619,3389,293,223,70,4,0,3,1
52159,33731,0,0,72,72,0,1,0,1,0
49033,26098,0,0,152,152,0,1,0,1,0
37147,3389,37147,3389,293,223,70,4,0,3,1
23078,31390,0,0,86,86,0,1,0,1,0
20213,27563,0,0,125,125,0,1,0,1,0
49308,33853,0,0,140,140,0,1,0,1,0
18168,20926,0,0,90,90,0,1,0,1,0
11997,25773,0,0,140,140,0,1,0,1,0
62566,32029,0,0,62,62,0,1,0,1,0
10965,25773,0,0,139,139,0,1,0,1,0
11710,61248,0,0,141,141,0,1,0,1,0
51869,60545,0,0,96,96,0,1,0,1,0
23757,34021,0,0,62,62,0,1,0,1,0
11037,25773,0,0,139,139,0,1,0,1,0
48842,5618,0,0,145,145,0,1,0,1,0
51897,5618,0,0,145,145,0,1,0,1,0
19070,3389,19070,3389,293,223,70,4,0,3,1
15197,61248,0,0,144,144,0,1,0,1,0
7652,16917,0,0,152,152,0,1,0,1,0
2134,45056,0,0,144,144,0,1,0,1,0
4259,22980,0,0,151,151,0,1,0,1,0
11208,3389,11208,3389,293,223,70,4,1,3,1
51711,40192,0,0,145,145,0,1,0,1,0
19766,31837,0,0,82,82,0,1,0,1,0
12812,61248,0,0,140,140,0,1,0,1,0
16412,15140,0,0,103,103,0,1,0,1,0
51885,34021,0,0,79,79,0,1,0,1,0
9322,3389,9322,3389,293,223,70,4,0,3,1
18418,3389,18418,3389,293,223,70,4,0,3,1
9777,25773,0,0,149,149,0,1,0,1,0
50994,34021,0,0,100,100,0,1,0,1,0
15922,25773,0,0,141,141,0,1,0,1,0
30364,3389,30364,3389,293,223,70,4,0,3,1
51623,32298,0,0,69,69,0,1,0,1,0
51492,31066,0,0,71,71,0,1,0,1,0
20280,3389,20280,3389,293,223,70,4,0,3,1
4685,49784,0,0,143,143,0,1,0,1,0
9837,3389,9837,3389,293,223,70,4,0,3,1
29136,29939,0,0,104,104,0,1,0,1,0
34706,3486,0,0,114,114,0,1,0,1,0
17360,19366,0,0,73,73,0,1,0,1,0
36824,8255,0,0,146,146,0,1,0,1,0
17302,3389,17302,3389,293,223,70,4,0,3,1
10117,25773,0,0,139,139,0,1,0,1,0
4809,50402,0,0,144,144,0,1,0,1,0
13522,10357,1610,596,173,161,12,1,0,1,0
51027,31652,0,0,80,80,0,1,0,1,0
18845,3389,18845,3389,293,223,70,4,0,3,1
12011,3389,12011,3389,293,223,70,4,0,3,1
27057,1544,0,0,76,76,0,1,0,1,0
21038,3389,21038,3389,293,223,70,4,0,3,1
11030,61248,0,0,139,139,0,1,0,1,0
37806,3389,37806,3389,293,223,70,4,1,3,1
50680,5618,0,0,145,145,0,1,0,1,0
13120,24716,0,0,128,128,0,1,0,1,0
2189,44291,0,0,144,144,0,1,0,1,0
8491,25773,0,0,156,156,0,1,0,1,0
48932,25833,0,0,156,156,0,1,0,1,0
14422,3389,14422,3389,293,223,70,4,0,3,1
16041,61248,0,0,146,146,0,1,0,1,0
6493,52512,0,0,142,142,0,1,0,1,0
30477,20920,0,0,147,147,0,1,0,1,0
50423,32598,0,0,101,101,0,1,0,1,0
18020,25657,0,0,141,141,0,1,0,1,0
2353,42024,0,0,144,144,0,1,0,1,0
10319,24136,0,0,136,136,0,1,0,1,0
27646,3389,27646,3389,293,223,70,4,0,3,1
21269,28020,0,0,120,120,0,1,0,1,0
16225,25773,0,0,145,145,0,1,0,1,0
26021,28996,0,0,114,114,0,1,0,1,0
52062,33663,0,0,74,74,0,1,0,1,0
11273,3389,11273,3389,293,223,70,4,1,3,1
12905,22214,0,0,112,112,0,1,0,1,0
51086,30672,0,0,100,100,0,1,0,1,0
50760,31652,0,0,89,89,0,1,0,1,0
21979,3389,21979,3389,293,223,70,4,0,3,1
60681,3389,60681,3389,293,223,70,4,0,3,1
49557,34021,0,0,136,136,0,1,0,1,0
51806,31734,0,0,62,62,0,1,0,1,0
21360,61248,0,0,157,157,0,1,0,1,0
10407,3389,10407,3389,293,223,70,4,1,3,1
11389,3389,11389,3389,293,223,70,4,1,3,1
17549,3389,17549,3389,293,223,70,4,0,3,1
52246,33423,0,0,64,64,0,1,0,1,0
18854,61248,0,0,152,152,0,1,0,1,0
3595,25773,0,0,142,142,0,1,0,1,0
55721,45155,0,0,99,99,0,1,0,1,0
17164,25773,0,0,142,142,0,1,0,1,0
14992,3389,14992,3389,293,223,70,4,0,3,1
31888,19850,0,0,147,147,0,1,0,1,0
49160,33871,0,0,146,146,0,1,0,1,0
51198,30466,0,0,81,81,0,1,0,1,0
10207,24219,0,0,137,137,0,1,0,1,0
58452,31652,0,0,94,94,0,1,0,1,0
48006,60228,0,0,75,75,0,1,0,1,0
6118,25773,0,0,141,141,0,1,0,1,0
16861,3389,16861,3389,293,223,70,4,0,3,1
10574,3389,10574,3389,293,223,70,4,1,3,1
19529,3389,19529,3389,293,223,70,4,0,3,1
51529,31652,0,0,69,69,0,1,0,1,0
16530,61248,0,0,151,151,0,1,0,1,0
48950,25870,0,0,155,155,0,1,0,1,0
9472,61248,0,0,141,141,0,1,0,1,0
52341,33490,0,0,68,68,0,1,0,1,0
14224,23324,0,0,113,113,0,1,0,1,0
54959,60799,0,0,114,114,0,1,0,1,0
12591,3389,12591,3389,293,223,70,4,1,3,1
16377,19356,0,0,145,145,0,1,0,1,0
11019,6374,5916,2192,241,196,45,2,0,2,0
34403,3389,34403,3389,293,223,70,4,0,3,1
49160,33676,0,0,146,146,0,1,0,1,0
10108,24292,0,0,138,138,0,1,0,1,0
2549,46562,0,0,144,144,0,1,0,1,0
49031,28705,0,0,151,151,0,1,0,1,0
26153,28809,0,0,116,116,0,1,0,1,0
50909,31652,0,0,84,84,0,1,0,1,0
50127,32932,0,0,112,112,0,1,0,1,0
29557,32048,0,0,82,82,0,1,0,1,0
29689,3389,29689,3389,293,223,70,4,0,3,1
22247,3389,22247,3389,293,223,70,4,0,3,1
2684,37444,0,0,144,144,0,1,0,1,0
9197,3389,9197,3389,293,223,70,4,1,3,1
47563,22559,0,0,155,155,0,1,0,1,0
50196,31652,0,0,112,112,0,1,0,1,0
18903,3389,18903,3389,293,223,70,4,0,3,1
14914,61248,0,0,149,149,0,1,0,1,0
37042,3389,37042,3389,293,223,70,4,0,3,1
54360,14415,0,0,116,116,0,1,0,1,0
12453,3389,12453,3389,293,223,70,4,1,3,1
32980,2851,0,0,104,104,0,1,0,1,0
12214,3389,12214,3389,293,223,70,4,0,3,1
28275,27213,0,0,132,132,0,1,0,1,0
18953,18767,0,0,68,68,0,1,0,1,0
10212,3389,10212,3389,293,223,70,4,1,3,1
21112,3389,21112,3389,293,223,70,4,0,3,1
6215,25773,0,0,151,151,0,1,0,1,0
1386,22420,0,0,154,154,0,1,0,1,0
52194,32883,0,0,62,62,0,1,0,1,0
55668,31652,0,0,62,62,0,1,0,1,0
37609,7691,0,0,146,146,0,1,0,1,0
9682,3389,9682,3389,293,223,70,4,1,3,1
26392,34021,0,0,62,62,0,1,0,1,0
14118,3389,14118,3389,293,223,70,4,0,3,1
52337,33307,0,0,62,62,0,1,0,1,0
29187,30193,0,0,101,101,0,1,0,1,0
6600,25773,0,0,152,152,0,1,0,1,0
11499,3389,11499,3389,293,223,70,4,1,3,1
13612,3389,13612,3389,293,223,70,4,0,3,1
51569,31652,0,0,66,66,0,1,0,1,0
56542,32878,0,0,105,105,0,1,0,1,0
4514,49911,0,0,144,144,0,1,0,1,0
29514,23070,0,0,147,147,0,1,0,1,0
19402,19104,0,0,71,71,0,1,0,1,0
51518,5618,0,0,145,145,0,1,0,1,0
41106,8078,0,0,145,145,0,1,0,1,0
41002,6824,0,0,146,146,0,1,0,1,0
19704,3389,19704,3389,293,223,70,4,0,3,1
22631,34021,0,0,62,62,0,1,0,1,0
47001,7083,0,0,145,145,0,1,0,1,0
22803,33537,0,0,67,67,0,1,0,1,0
51596,31279,0,0,68,68,0,1,0,1,0
18977,3389,18977,3389,293,223,70,4,0,3,1
16335,3389,16335,3389,293,223,70,4,1,3,1
10895,60545,0,0,143,143,0,1,0,1,0
42192,60217,0,0,76,76,0,1,0,1,0
34442,3389,34442,3389,293,223,70,4,0,3,1
29528,3389,29528,3389,293,223,70,4,0,3,1
12136,61248,0,0,139,139,0,1,0,1,0
14625,11665,0,0,146,146,0,1,0,1,0
12577,3389,12577,3389,293,223,70,4,1,3,1
51865,31907,0,0,62,62,0,1,0,1,0
11215,25773,0,0,152,152,0,1,0,1,0
26253,34021,0,0,62,62,0,1,0,1,0
62201,31652,0,0,62,62,0,1,0,1,0
12516,3389,12516,3389,293,223,70,4,0,3,1
2803,24637,0,0,147,147,0,1,0,1,0
19480,61248,0,0,153,153,0,1,0,1,0
63717,37098,0,0,77,77,0,1,0,1,0
28144,34021,0,0,62,62,0,1,0,1,0
18482,18120,0,0,63,63,0,1,0,1,0
44643,60091,0,0,66,66,0,1,0,1,0
57651,32706,0,0,99,99,0,1,0,1,0
11143,3389,11143,3389,293,223,70,4,1,3,1
19208,27983,0,0,121,121,0,1,0,1,0
20663,20048,0,0,82,82,0,1,0,1,0
47560,52972,0,0,62,62,0,1,0,1,0
25413,61079,0,0,145,145,0,1,0,1,0
17610,3389,17610,3389,293,223,70,4,0,3,1
23574,30303,0,0,98,98,0,1,0,1,0
10770,25773,0,0,153,153,0,1,0,1,0
59429,4614,28806,1525,211,180,31,2,0,1,0
5995,25773,0,0,141,141,0,1,0,1,0
2642,47493,0,0,144,144,0,1,0,1,0
21135,20402,0,0,86,86,0,1,0,1,0
52024,32379,0,0,62,62,0,1,0,1,0
23631,34021,0,0,62,62,0,1,0,1,0
63515,31652,0,0,67,67,0,1,0,1,0
17665,25773,0,0,142,142,0,1,0,1,0
27071,24848,0,0,137,137,0,1,0,1,0
10586,3389,10586,3389,293,223,70,4,0,3,1
10198,3389,10198,3389,293,223,70,4,1,3,1
28303,25834,0,0,147,147,0,1,0,1,0
49951,31652,0,0,120,120,0,1,0,1,0
49121,30773,0,0,147,147,0,1,0,1,0
11093,3389,11093,3389,293,223,70,4,1,3,1
51734,31652,0,0,62,62,0,1,0,1,0
19487,3389,19487,3389,293,223,70,4,0,3,1
50969,30410,0,0,103,103,0,1,0,1,0
33321,17482,0,0,147,147,0,1,0,1,0
52414,33535,0,0,62,62,0,1,0,1,0
11201,3389,11201,3389,293,223,70,4,1,3,1
13743,3389,13743,3389,293,223,70,4,0,3,1
50881,29817,0,0,91,91,0,1,0,1,0
27720,3389,27720,3389,293,223,70,4,0,3,1
15742,25773,0,0,141,141,0,1,0,1,0
14988,22359,0,0,104,104,0,1,0,1,0
49144,31303,0,0,146,146,0,1,0,1,0
33630,3389,33630,3389,293,223,70,4,0,3,1
17089,3389,17089,3389,293,223,70,4,0,3,1
7547,54101,0,0,141,141,0,1,0,1,0
49283,31652,0,0,141,141,0,1,0,1,0
27567,34021,0,0,62,62,0,1,0,1,0
18829,61248,0,0,152,152,0,1,0,1,0
7868,61248,0,0,139,139,0,1,0,1,0
47491,22387,0,0,155,155,0,1,0,1,0
20545,3389,20545,3389,293,223,70,4,0,3,1
51362,31652,0,0,75,75,0,1,0,1,0
4916,54106,0,0,141,141,0,1,0,1,0
14621,53173,0,0,118,118,0,1,0,1,0
13265,61248,0,0,146,146,0,1,0,1,0
10275,25773,0,0,147,147,0,1,0,1,0
26681,34021,0,0,62,62,0,1,0,1,0
19133,3389,19133,3389,293,223,70,4,0,3,1
60324,60921,0,0,144,144,0,1,0,1,0
18490,3389,18490,3389,293,223,70,4,0,3,1
39448,5230,0,0,140,140,0,1,0,1,0
15061,3389,15061,3389,293,223,70,4,0,3,1
12053,60898,0,0,139,139,0,1,0,1,0
15070,61248,0,0,144,144,0,1,0,1,0
10579,5673,6674,2473,253,202,51,3,0,2,0
28560,34021,0,0,62,62,0,1,0,1,0
42831,11210,0,0,149,149,0,1,0,1,0
26417,3389,26417,3389,293,223,70,4,0,3,1
29751,34021,0,0,62,62,0,1,0,1,0
48954,5618,0,0,145,145,0,1,0,1,0
62005,31652,0,0,75,75,0,1,0,1,0
55601,5618,0,0,145,145,0,1,0,1,0
28269,27495,0,0,130,130,0,1,0,1,0
15889,3389,15889,3389,293,223,70,4,0,3,1
49225,33961,0,0,143,143,0,1,0,1,0
17769,18850,0,0,68,68,0,1,0,1,0
18250,3389,18250,3389,293,223,70,4,0,3,1
51707,32449,0,0,68,68,0,1,0,1,0
5865,51564,0,0,142,142,0,1,0,1,0
52074,33112,0,0,65,65,0,1,0,1,0
51566,31652,0,0,66,66,0,1,0,1,0
18686,3389,18686,3389,293,223,70,4,0,3,1
50532,32603,0,0,112,112,0,1,0,1,0
41560,3389,41560,3389,293,223,70,4,0,3,1
9671,3389,9671,3389,293,223,70,4,0,3,1
53894,33758,0,0,62,62,0,1,0,1,0
50330,31652,0,0,108,108,0,1,0,1,0
20144,3389,20144,3389,293,223,70,4,0,3,1
48969,27292,0,0,154,154,0,1,0,1,0
12028,25773,0,0,140,140,0,1,0,1,0
3569,50189,0,0,143,143,0,1,0,1,0
46297,55479,0,0,76,76,0,1,0,1,0
17441,3389,17441,3389,293,223,70,4,1,3,1
11320,3389,11320,3389,293,223,70,4,1,3,1
51268,34021,0,0,94,94,0,1,0,1,0
51803,31724,0,0,62,62,0,1,0,1,0
25885,240,0,0,65,65,0,1,0,1,0
51315,31652,0,0,76,76,0,1,0,1,0
34886,11072,0,0,146,146,0,1,0,1,0
10724,3389,10724,3389,293,223,70,4,0,3,1
22060,3389,22060,3389,293,223,70,4,0,3,1
15239,3389,15239,3389,293,223,70,4,0,3,1
48631,3389,48631,3389,293,223,70,4,0,3,1
21838,61248,0,0,158,158,0,1,0,1,0
50002,32236,0,0,125,125,0,1,0,1,0
52383,33444,0,0,62,62,0,1,0,1,0
51429,31442,0,0,91,91,0,1,0,1,0
3456,22414,0,0,154,154,0,1,0,1,0
12437,24785,0,0,139,139,0,1,0,1,0
21974,35208,0,0,65,65,0,1,0,1,0
8056,55814,0,0,143,143,0,1,0,1,0
17441,3389,17441,3389,293,223,70,4,0,3,1
15545,3389,15545,3389,293,223,70,4,0,3,1
56968,5272,9908,524,167,157,10,1,0,1,0
28579,3389,28579,3389,293,223,70,4,0,3,1
18166,18349,0,0,63,63,0,1,0,1,0
64286,32929,0,0,65,65,0,1,0,1,0
26399,28462,0,0,119,119,0,1,0,1,0
6361,24803,0,0,157,157,0,1,0,1,0
19054,3389,19054,3389,293,223,70,4,0,3,1
32420,6085,0,0,118,118,0,1,0,1,0
48926,47812,0,0,62,62,0,1,0,1,0
9605,3389,9605,3389,293,223,70,4,1,3,1
45956,57859,0,0,68,68,0,1,0,1,0
4859,25773,0,0,147,147,0,1,0,1,0
13560,3389,13560,3389,293,223,70,4,0,3,1
50666,29377,0,0,98,98,0,1,0,1,0
17201,3389,17201,3389,293,223,70,4,0,3,1
24268,34021,0,0,62,62,0,1,0,1,0
49118,32673,0,0,147,147,0,1,0,1,0
4758,25773,0,0,146,146,0,1,0,1,0
7382,61229,0,0,138,138,0,1,0,1,0
10235,3389,10235,3389,293,223,70,4,1,3,1
11162,61248,0,0,139,139,0,1,0,1,0
30385,1896,0,0,90,90,0,1,0,1,0
42281,5618,0,0,145,145,0,1,0,1,0
61540,4050,45016,2383,249,199,49,3,0,2,0
9422,25773,0,0,151,151,0,1,0,1,0
51633,33366,0,0,85,85,0,1,0,1,0
54937,31652,0,0,62,62,0,1,0,1,0
28222,29780,0,0,106,106,0,1,0,1,0
36416,8547,0,0,146,146,0,1,0,1,0
28985,3389,28985,3389,293,223,70,4,0,3,1
14113,3389,14113,3389,293,223,70,4,0,3,1
12161,61248,0,0,139,139,0,1,0,1,0
14054,61248,0,0,148,148,0,1,0,1,0
18031,25300,0,0,137,137,0,1,0,1,0
14261,3389,14261,3389,293,223,70,4,0,3,1
49537,27351,0,0,134,134,0,1,0,1,0
10518,61248,0,0,142,142,0,1,0,1,0
17154,25773,0,0,144,144,0,1,0,1,0
3228,25302,0,0,144,144,0,1,0,1,0
51285,31652,0,0,71,71,0,1,0,1,0
7822,26750,0,0,156,156,0,1,0,1,0
5571,23436,0,0,149,149,0,1,0,1,0
9067,25773,0,0,152,152,0,1,0,1,0
49041,26084,0,0,153,153,0,1,0,1,0
24351,34021,0,0,62,62,0,1,0,1,0
16128,3389,16128,3389,293,223,70,4,0,3,1
50734,32596,0,0,95,95,0,1,0,1,0
36843,8241,0,0,146,146,0,1,0,1,0
13844,61248,0,0,147,147,0,1,0,1,0
25254,30078,0,0,103,103,0,1,0,1,0
20853,3389,20853,3389,293,223,70,4,0,3,1
50498,41874,0,0,62,62,0,1,0,1,0
8469,61248,0,0,140,140,0,1,0,1,0
14384,12324,0,0,147,147,0,1,0,1,0
21480,4127,0,0,91,91,0,1,0,1,0
15066,12872,0,0,134,134,0,1,0,1,0
14570,3389,14570,3389,293,223,70,4,0,3,1
3331,25463,0,0,144,144,0,1,0,1,0
18031,3389,18031,3389,293,223,70,4,0,3,1
9656,3389,9656,3389,293,223,70,4,1,3,1
59415,57811,0,0,135,135,0,1,0,1,0
15683,46251,0,0,96,96,0,1,0,1,0
18268,3389,18268,3389,293,223,70,4,0,3,1
2339,42216,0,0,144,144,0,1,0,1,0
12957,3389,12957,3389,293,223,70,4,0,3,1
18243,18503,0,0,64,64,0,1,0,1,0
51944,60551,0,0,97,97,0,1,0,1,0
11417,25773,0,0,142,142,0,1,0,1,0
8238,56118,0,0,143,143,0,1,0,1,0
15800,61248,0,0,150,150,0,1,0,1,0
46478,7171,0,0,145,145,0,1,0,1,0
59601,32620,0,0,62,62,0,1,0,1,0
8519,61248,0,0,139,139,0,1,0,1,0
13244,8905,3815,1179,198,174,24,2,0,1,0
22909,34021,0,0,62,62,0,1,0,1,0
44077,7576,0,0,145,145,0,1,0,1,0
45822,7282,0,0,145,145,0,1,0,1,0
49434,33772,0,0,137,137,0,1,0,1,0
13324,3389,13324,3389,293,223,70,4,0,3,1
5697,25773,0,0,149,149,0,1,0,1,0
28158,32892,0,0,73,73,0,1,0,1,0
62672,3747,53714,2843,269,210,58,3,0,2,0
21883,33552,0,0,66,66,0,1,0,1,0
26278,33054,0,0,71,71,0,1,0,1,0
12932,8150,4793,1481,211,180,30,2,0,1,0
10243,61248,0,0,139,139,0,1,0,1,0
6332,25773,0,0,151,151,0,1,0,1,0
28651,1258,0,0,80,80,0,1,0,1,0
29091,3389,29091,3389,293,223,70,4,1,3,1
50708,30267,0,0,92,92,0,1,0,1,0
59381,3389,59381,3389,293,223,70,4,0,3,1
15238,22043,0,0,100,100,0,1,0,1,0
13499,9522,3014,931,187,168,19,1,0,1,0
62006,31652,0,0,75,75,0,1,0,1,0
12265,61248,0,0,139,139,0,1,0,1,0
35228,34021,0,0,85,85,0,1,0,1,0
11797,3389,11797,3389,293,223,70,4,1,3,1
52656,34658,0,0,70,70,0,1,0,1,0
2270,23804,0,0,150,150,0,1,0,1,0
50424,34021,0,0,114,114,0,1,0,1,0
20467,3389,20467,3389,293,223,70,4,0,3,1
11903,25773,0,0,151,151,0,1,0,1,0
12766,3389,12766,3389,293,223,70,4,0,3,1
29655,34021,0,0,62,62,0,1,0,1,0
28548,2806,0,0,88,88,0,1,0,1,0
47656,6972,0,0,145,145,0,1,0,1,0
51316,34021,0,0,92,92,0,1,0,1,0
28249,28489,0,0,119,119,0,1,0,1,0
25282,18,0,0,62,62,0,1,0,1,0
50965,29988,0,0,88,88,0,1,0,1,0
13313,3389,13313,3389,293,223,70,4,0,3,1
18858,27333,0,0,127,127,0,1,0,1,0
16466,3389,16466,3389,293,223,70,4,0,3,1
25501,34021,0,0,62,62,0,1,0,1,0
24755,23113,0,0,117,117,0,1,0,1,0
18667,58589,0,0,156,156,0,1,0,1,0
24769,61112,0,0,148,148,0,1,0,1,0
21130,60480,0,0,158,158,0,1,0,1,0
16385,3389,16385,3389,293,223,70,4,0,3,1
17043,48515,0,0,102,102,0,1,0,1,0
26181,3389,26181,3389,293,223,70,4,1,3,1
36298,8632,0,0,146,146,0,1,0,1,0
37449,3389,37449,3389,293,223,70,4,0,3,1
10307,3389,10307,3389,293,223,70,4,1,3,1
28726,34021,0,0,62,62,0,1,0,1,0
11721,61248,0,0,141,141,0,1,0,1,0
13051,3389,13051,3389,293,223,70,4,0,3,1
18655,3389,18655,3389,293,223,70,4,0,3,1
26899,34021,0,0,62,62,0,1,0,1,0
43157,3389,43157,3389,293,223,70,4,0,3,1
12310,61248,0,0,144,144,0,1,0,1,0
8021,25720,0,0,157,157,0,1,0,1,0
50737,34021,0,0,107,107,0,1,0,1,0
10377,58371,0,0,140,140,0,1,0,1,0
51622,31652,0,0,67,67,0,1,0,1,0
9862,3389,9862,3389,293,223,70,4,1,3,1
22816,25773,0,0,145,145,0,1,0,1,0
14469,23014,0,0,110,110,0,1,0,1,0
23895,3389,23895,3389,293,223,70,4,0,3,1
12537,3389,12537,3389,293,223,70,4,1,3,1
9745,61248,0,0,141,141,0,1,0,1,0
5219,54989,0,0,141,141,0,1,0,1,0
36455,4129,0,0,123,123,0,1,0,1,0
52651,33480,0,0,126,126,0,1,0,1,0
10258,24181,0,0,136,136,0,1,0,1,0
13384,9245,3374,1042,192,171,21,1,0,1,0
18290,3389,18290,3389,293,223,70,4,0,3,1
17232,25773,0,0,142,142,0,1,0,1,0
11373,61248,0,0,142,142,0,1,0,1,0
45141,60066,0,0,64,64,0,1,0,1,0
27980,34021,0,0,62,62,0,1,0,1,0
26463,3389,26463,3389,293,223,70,4,0,3,1
9550,4036,8444,3129,281,217,64,3,0,2,0
8930,25773,0,0,140,140,0,1,0,1,0
5692,25773,0,0,149,149,0,1,0,1,0
16719,61248,0,0,148,148,0,1,0,1,0
50086,31652,0,0,116,116,0,1,0,1,0
51449,3389,51449,3389,293,223,70,4,0,3,1
11577,3389,11577,3389,293,223,70,4,0,3,1
14673,11612,0,0,146,146,0,1,0,1,0
19764,40608,0,0,81,81,0,1,0,1,0
37357,3389,37357,3389,293,223,70,4,0,3,1
11125,52798,0,0,151,151,0,1,0,1,0
51700,31652,0,0,63,63,0,1,0,1,0
44936,3389,44936,3389,293,223,70,4,0,3,1
52367,33397,0,0,62,62,0,1,0,1,0
32367,6040,0,0,118,118,0,1,0,1,0
29472,34021,0,0,62,62,0,1,0,1,0
30634,1987,0,0,91,91,0,1,0,1,0
47109,48427,0,0,96,96,0,1,0,1,0
50834,30109,0,0,107,107,0,1,0,1,0
49675,31652,0,0,129,129,0,1,0,1,0
13799,3389,13799,3389,293,223,70,4,0,3,1
49112,32505,0,0,148,148,0,1,0,1,0
14125,13981,0,0,146,146,0,1,0,1,0
20337,25773,0,0,144,144,0,1,0,1,0
21857,3389,21857,3389,293,223,70,4,0,3,1
14892,3389,14892,3389,293,223,70,4,0,3,1
51797,31708,0,0,62,62,0,1,0,1,0
49844,5618,0,0,145,145,0,1,0,1,0
23851,34021,0,0,62,62,0,1,0,1,0
17226,22678,0,0,144,144,0,1,0,1,0
56299,5451,4774,252,156,150,5,1,0,1,0
25361,34021,0,0,62,62,0,1,0,1,0
24423,3389,24423,3389,293,223,70,4,0,3,1
18499,3389,18499,3389,293,223,70,4,0,3,1
9691,61248,0,0,141,141,0,1,0,1,0
51471,31652,0,0,67,67,0,1,0,1,0
28292,26384,0,0,141,141,0,1,0,1,0
28178,31887,0,0,84,84,0,1,0,1,0
52033,31652,0,0,71,71,0,1,0,1,0
4924,25773,0,0,147,147,0,1,0,1,0
12164,3389,12164,3389,293,223,70,4,1,3,1
12287,25743,0,0,139,139,0,1,0,1,0
15504,3389,15504,3389,293,223,70,4,0,3,1
51447,30973,0,0,72,72,0,1,0,1,0
18409,61248,0,0,151,151,0,1,0,1,0
51722,31652,0,0,63,63,0,1,0,1,0
50913,29883,0,0,90,90,0,1,0,1,0
48989,27749,0,0,153,153,0,1,0,1,0
35968,3389,35968,3389,293,223,70,4,0,3,1
9401,3389,9401,3389,293,223,70,4,1,3,1
48915,26053,0,0,156,156,0,1,0,1,0
17451,25773,0,0,142,142,0,1,0,1,0
13223,3389,13223,3389,293,223,70,4,0,3,1
46375,54433,0,0,78,78,0,1,0,1,0
28170,32321,0,0,79,79,0,1,0,1,0
15847,28661,0,0,112,112,0,1,0,1,0
18156,44538,0,0,93,93,0,1,0,1,0
50527,34021,0,0,112,112,0,1,0,1,0
50431,31652,0,0,101,101,0,1,0,1,0
13035,9582,2448,907,186,168,18,1,0,1,0
55102,9462,0,0,132,132,0,1,0,1,0
16727,3389,16727,3389,293,223,70,4,0,3,1
12832,3389,12832,3389,293,223,70,4,0,3,1
51872,32748,0,0,67,67,0,1,0,1,0
5357,18626,0,0,154,154,0,1,0,1,0
51705,32446,0,0,68,68,0,1,0,1,0
31279,5118,0,0,109,109,0,1,0,1,0
48106,40270,0,0,120,120,0,1,0,1,0
8067,61248,0,0,139,139,0,1,0,1,0
13677,3389,13677,3389,293,223,70,4,0,3,1
14847,61248,0,0,144,144,0,1,0,1,0
49823,31652,0,0,122,122,0,1,0,1,0
3977,25773,0,0,144,144,0,1,0,1,0
29986,60844,0,0,126,126,0,1,0,1,0
58417,31652,0,0,95,95,0,1,0,1,0
53042,43409,0,0,145,145,0,1,0,1,0
36750,4238,0,0,125,125,0,1,0,1,0
19446,3389,19446,3389,293,223,70,4,0,3,1
36597,8418,0,0,146,146,0,1,0,1,0
13263,3389,13263,3389,293,223,70,4,0,3,1
2620,47429,0,0,144,144,0,1,0,1,0
15222,61248,0,0,149,149,0,1,0,1,0
25136,3389,25136,3389,293,223,70,4,0,3,1
8889,25773,0,0,140,140,0,1,0,1,0
8428,25540,0,0,154,154,0,1,0,1,0
10076,25773,0,0,154,154,0,1,0,1,0
37141,8027,0,0,146,146,0,1,0,1,0
12688,24544,0,0,147,147,0,1,0,1,0
25063,34021,0,0,62,62,0,1,0,1,0
51977,32241,0,0,62,62,0,1,0,1,0
53305,3389,53305,3389,293,223,70,4,0,3,1
49463,33679,0,0,135,135,0,1,0,1,0
49397,34021,0,0,140,140,0,1,0,1,0
16365,3389,16365,3389,293,223,70,4,0,3,1
19847,41012,0,0,81,81,0,1,0,1,0
51239,31589,0,0,72,72,0,1,0,1,0
9530,24722,0,0,143,143,0,1,0,1,0
11831,61248,0,0,139,139,0,1,0,1,0
2924,34130,0,0,143,143,0,1,0,1,0
2942,20425,0,0,155,155,0,1,0,1,0
10110,3389,10110,3389,293,223,70,4,0,3,1
19541,3389,19541,3389,293,223,70,4,0,3,1
17089,25773,0,0,143,143,0,1,0,1,0
10240,5134,7257,2689,263,207,55,3,0,2,0
28546,26984,0,0,135,135,0,1,0,1,0
24834,30670,0,0,96,96,0,1,0,1,0
53990,60719,0,0,108,108,0,1,0,1,0
37595,3389,37595,3389,293,223,70,4,1,3,1
28742,34021,0,0,62,62,0,1,0,1,0
28355,34021,0,0,62,62,0,1,0,1,0
52351,33864,0,0,67,67,0,1,0,1,0
27377,3389,27377,3389,293,223,70,4,0,3,1
48748,60289,0,0,79,79,0,1,0,1,0
29054,34021,0,0,62,62,0,1,0,1,0
29223,3389,29223,3389,293,223,70,4,0,3,1
50341,31652,0,0,108,108,0,1,0,1,0
50589,5618,0,0,145,145,0,1,0,1,0
49114,32561,0,0,147,147,0,1,0,1,0
13194,61248,0,0,140,140,0,1,0,1,0
58142,3389,58142,3389,293,223,70,4,0,3,1
54302,13729,0,0,122,122,0,1,0,1,0
49171,34007,0,0,145,145,0,1,0,1,0
48959,25914,0,0,154,154,0,1,0,1,0
49059,30810,0,0,150,150,0,1,0,1,0
1967,23330,0,0,151,151,0,1,0,1,0
22884,631,2345,630,104,91,13,1,0,1,0
38413,8533,0,0,145,145,0,1,0,1,0
49160,31980,0,0,146,146,0,1,0,1,0
6395,23723,0,0,148,148,0,1,0,1,0
16823,18972,0,0,69,69,0,1,0,1,0
20376,25773,0,0,144,144,0,1,0,1,0
28212,25903,0,0,146,146,0,1,0,1,0
11321,25773,0,0,152,152,0,1,0,1,0
5352,55376,0,0,141,141,0,1,0,1,0
48860,60298,0,0,79,79,0,1,0,1,0
2905,46486,0,0,145,145,0,1,0,1,0
15871,25773,0,0,146,146,0,1,0,1,0
20787,30915,0,0,92,92,0,1,0,1,0
13833,3389,13833,3389,293,223,70,4,0,3,1
39381,8369,0,0,145,145,0,1,0,1,0
49449,27132,0,0,137,137,0,1,0,1,0
37379,3389,37379,3389,293,223,70,4,1,3,1
28201,34021,0,0,62,62,0,1,0,1,0
24163,30783,0,0,93,93,0,1,0,1,0
29433,34021,0,0,62,62,0,1,0,1,0
64158,33865,0,0,68,68,0,1,0,1,0
10066,3389,10066,3389,293,223,70,4,1,3,1
50714,29475,0,0,97,97,0,1,0,1,0
20155,3389,20155,3389,293,223,70,4,0,3,1
11291,61205,0,0,143,143,0,1,0,1,0
22352,28769,0,0,113,113,0,1,0,1,0
9194,61248,0,0,140,140,0,1,0,1,0
11648,21619,0,0,98,98,0,1,0,1,0
3884,25591,0,0,141,141,0,1,0,1,0
50056,33012,0,0,114,114,0,1,0,1,0
50572,34021,0,0,111,111,0,1,0,1,0
16879,15928,0,0,93,93,0,1,0,1,0
24062,3389,24062,3389,293,223,70,4,1,3,1
50274,28851,0,0,121,121,0,1,0,1,0
51902,6255,0,0,145,145,0,1,0,1,0
17403,25631,0,0,143,143,0,1,0,1,0
49291,33873,0,0,141,141,0,1,0,1,0
55383,5667,0,0,145,145,0,1,0,1,0
10664,3389,10664,3389,293,223,70,4,0,3,1
29351,31015,0,0,93,93,0,1,0,1,0
50155,32341,0,0,121,121,0,1,0,1,0
28215,30117,0,0,102,102,0,1,0,1,0
19913,3389,19913,3389,293,223,70,4,0,3,1
2127,22463,0,0,157,157,0,1,0,1,0
23228,2206,0,0,78,78,0,1,0,1,0
51875,31936,0,0,62,62,0,1,0,1,0
49110,32422,0,0,148,148,0,1,0,1,0
15348,3389,15348,3389,293,223,70,4,0,3,1
17519,23827,0,0,143,143,0,1,0,1,0
17054,25773,0,0,142,142,0,1,0,1,0
9419,3389,9419,3389,293,223,70,4,1,3,1
21546,61248,0,0,158,158,0,1,0,1,0
46221,55691,0,0,74,74,0,1,0,1,0
36207,34021,0,0,89,89,0,1,0,1,0
25496,34021,0,0,62,62,0,1,0,1,0
2179,22256,0,0,155,155,0,1,0,1,0
11982,24381,0,0,147,147,0,1,0,1,0
19472,3389,19472,3389,293,223,70,4,0,3,1
19601,3389,19601,3389,293,223,70,4,0,3,1
5161,24140,0,0,157,157,0,1,0,1,0
20414,19862,0,0,80,80,0,1,0,1,0
20390,1300,4833,1299,150,123,26,2,0,1,0
28209,30415,0,0,99,99,0,1,0,1,0
14516,3389,14516,3389,293,223,70,4,0,3,1
18507,3389,18507,3389,293,223,70,4,0,3,1
20372,1305,4851,1304,150,123,26,2,0,1,0
49288,34332,0,0,145,145,0,1,0,1,0
7553,54976,0,0,143,143,0,1,0,1,0
16690,20582,0,0,144,144,0,1,0,1,0
29531,34021,0,0,62,62,0,1,0,1,0
55099,33101,0,0,113,113,0,1,0,1,0
21918,16307,0,0,79,79,0,1,0,1,0
54949,10482,0,0,129,129,0,1,0,1,0
49554,27234,0,0,140,140,0,1,0,1,0
16616,3389,16616,3389,293,223,70,4,0,3,1
12171,61248,0,0,139,139,0,1,0,1,0
14819,20792,0,0,94,94,0,1,0,1,0
51444,3389,51444,3389,293,223,70,4,0,3,1
18087,17963,0,0,65,65,0,1,0,1,0
48770,48401,0,0,62,62,0,1,0,1,0
13104,56880,0,0,130,130,0,1,0,1,0
15341,3389,15341,3389,293,223,70,4,0,3,1
46546,53028,0,0,82,82,0,1,0,1,0
28204,30639,0,0,97,97,0,1,0,1,0
9915,24948,0,0,142,142,0,1,0,1,0
14704,3389,14704,3389,293,223,70,4,0,3,1
39978,8269,0,0,145,145,0,1,0,1,0
49821,3389,49821,3389,293,223,70,4,0,3,1
51416,30910,0,0,73,73,0,1,0,1,0
63435,39160,0,0,83,83,0,1,0,1,0
33558,3389,33558,3389,293,223,70,4,0,3,1
19261,61248,0,0,153,153,0,1,0,1,0
14429,61248,0,0,147,147,0,1,0,1,0
15766,19513,0,0,75,75,0,1,0,1,0
11799,61248,0,0,143,143,0,1,0,1,0
51850,33516,0,0,79,79,0,1,0,1,0
43817,3389,43817,3389,293,223,70,4,0,3,1
61241,31652,0,0,62,62,0,1,0,1,0
50592,34021,0,0,110,110,0,1,0,1,0
27965,34021,0,0,62,62,0,1,0,1,0
2317,22568,0,0,157,157,0,1,0,1,0
12846,9281,2774,1028,191,170,21,1,0,1,0
1537,21471,0,0,156,156,0,1,0,1,0
51913,32052,0,0,62,62,0,1,0,1,0
28262,27818,0,0,126,126,0,1,0,1,0
50736,6452,0,0,145,145,0,1,0,1,0
29131,34021,0,0,62,62,0,1,0,1,0
18196,20010,0,0,81,81,0,1,0,1,0
25027,34021,0,0,62,62,0,1,0,1,0
18190,20214,0,0,83,83,0,1,0,1,0
53947,17173,0,0,108,108,0,1,0,1,0
15784,28610,0,0,112,112,0,1,0,1,0
9723,58592,0,0,143,143,0,1,0,1,0
8281,61248,0,0,139,139,0,1,0,1,0
50449,3389,50449,3389,293,223,70,4,0,3,1
50696,29798,0,0,110,110,0,1,0,1,0
22466,21399,0,0,98,98,0,1,0,1,0
52778,6107,0,0,145,145,0,1,0,1,0
13058,3389,13058,3389,293,223,70,4,0,3,1
28236,29109,0,0,113,113,0,1,0,1,0
49160,31988,0,0,146,146,0,1,0,1,0
30891,3389,30891,3389,293,223,70,4,0,3,1
18830,3389,18830,3389,293,223,70,4,0,3,1
60066,4444,33697,1784,222,186,36,2,0,2,0
14943,20700,0,0,93,93,0,1,0,1,0
40824,3389,40824,3389,293,223,70,4,0,3,1
48364,3389,48364,3389,293,223,70,4,0,3,1
49045,30332,0,0,150,150,0,1,0,1,0
5751,24466,0,0,157,157,0,1,0,1,0
30344,3389,30344,3389,293,223,70,4,0,3,1
10652,3389,10652,3389,293,223,70,4,1,3,1
9185,3389,9185,3389,293,223,70,4,1,3,1
62288,3389,62288,3389,293,223,70,4,0,3,1
12017,24389,0,0,147,147,0,1,0,1,0
16964,21652,0,0,144,144,0,1,0,1,0
36203,8700,0,0,146,146,0,1,0,1,0
51231,31652,0,0,79,79,0,1,0,1,0
12726,26132,0,0,135,135,0,1,0,1,0
37982,34021,0,0,97,97,0,1,0,1,0
28343,34021,0,0,62,62,0,1,0,1,0
2790,24617,0,0,147,147,0,1,0,1,0
3139,25163,0,0,145,145,0,1,0,1,0
36885,3389,36885,3389,293,223,70,4,0,3,1
49550,33581,0,0,132,132,0,1,0,1,0
20740,61248,0,0,156,156,0,1,0,1,0
47702,5618,0,0,145,145,0,1,0,1,0
45159,3389,45159,3389,293,223,70,4,0,3,1
28474,26624,0,0,139,139,0,1,0,1,0
49159,31651,0,0,146,146,0,1,0,1,0
21049,3389,21049,3389,293,223,70,4,0,3,1
25426,23616,0,0,123,123,0,1,0,1,0
8493,56542,0,0,143,143,0,1,0,1,0
51675,31652,0,0,64,64,0,1,0,1,0
2204,23700,0,0,150,150,0,1,0,1,0
23607,3389,23607,3389,293,223,70,4,0,3,1
9746,25773,0,0,149,149,0,1,0,1,0
2416,22338,0,0,154,154,0,1,0,1,0
51293,34021,0,0,93,93,0,1,0,1,0
11435,4523,9495,2934,273,212,60,3,0,2,0
14373,3389,14373,3389,293,223,70,4,0,3,1
17767,3389,17767,3389,293,223,70,4,0,3,1
14372,3389,14372,3389,293,223,70,4,0,3,1
9154,61248,0,0,139,139,0,1,0,1,0
19018,3389,19018,3389,293,223,70,4,0,3,1
14448,23040,0,0,111,111,0,1,0,1,0
9259,3389,9259,3389,293,223,70,4,1,3,1
10338,3389,10338,3389,293,223,70,4,0,3,1
49482,31652,0,0,135,135,0,1,0,1,0
48937,26876,0,0,155,155,0,1,0,1,0
15584,3389,15584,3389,293,223,70,4,0,3,1
17639,45801,0,0,97,97,0,1,0,1,0
29666,3389,29666,3389,293,223,70,4,0,3,1
5734,25773,0,0,143,143,0,1,0,1,0
12969,24906,0,0,130,130,0,1,0,1,0
29393,34021,0,0,62,62,0,1,0,1,0
59834,31652,0,0,62,62,0,1,0,1,0
29112,3284,0,0,92,92,0,1,0,1,0
49160,32497,0,0,146,146,0,1,0,1,0
9713,3389,9713,3389,293,223,70,4,1,3,1
59593,31652,0,0,62,62,0,1,0,1,0
13868,3389,13868,3389,293,223,70,4,0,3,1
18422,43887,0,0,91,91,0,1,0,1,0
6181,25773,0,0,151,151,0,1,0,1,0
34578,11760,0,0,146,146,0,1,0,1,0
10224,25773,0,0,139,139,0,1,0,1,0
48939,26607,0,0,155,155,0,1,0,1,0
10539,22187,0,0,104,104,0,1,0,1,0
11556,61248,0,0,142,142,0,1,0,1,0
11506,61248,0,0,142,142,0,1,0,1,0
14033,56570,0,0,125,125,0,1,0,1,0
29438,3560,0,0,95,95,0,1,0,1,0
17187,43537,0,0,88,88,0,1,0,1,0
29570,34021,0,0,62,62,0,1,0,1,0
25261,34021,0,0,62,62,0,1,0,1,0
10228,58145,0,0,140,140,0,1,0,1,0
48973,28032,0,0,153,153,0,1,0,1,0
48930,25840,0,0,156,156,0,1,0,1,0
54256,15108,0,0,114,114,0,1,0,1,0
49135,31097,0,0,147,147,0,1,0,1,0
51519,31652,0,0,67,67,0,1,0,1,0
9782,58691,0,0,143,143,0,1,0,1,0
20003,61248,0,0,154,154,0,1,0,1,0
17998,3389,17998,3389,293,223,70,4,0,3,1
21041,31386,0,0,87,87,0,1,0,1,0
20179,3389,20179,3389,293,223,70,4,0,3,1
2127,45995,0,0,144,144,0,1,0,1,0
17557,3389,17557,3389,293,223,70,4,0,3,1
11315,6844,5408,2004,233,192,41,2,0,2,0
18204,19779,0,0,78,78,0,1,0,1,0
19117,3389,19117,3389,293,223,70,4,0,3,1
20062,32077,0,0,80,80,0,1,0,1,0
12387,25641,0,0,137,137,0,1,0,1,0
10980,3389,10980,3389,293,223,70,4,1,3,1
15337,3389,15337,3389,293,223,70,4,0,3,1
21347,33118,0,0,70,70,0,1,0,1,0
17397,3389,17397,3389,293,223,70,4,0,3,1
13315,3389,13315,3389,293,223,70,4,0,3,1
2367,46693,0,0,144,144,0,1,0,1,0
13470,3389,13470,3389,293,223,70,4,0,3,1
13188,3389,13188,3389,293,223,70,4,0,3,1
47692,43660,0,0,110,110,0,1,0,1,0
49074,31273,0,0,149,149,0,1,0,1,0
48917,26097,0,0,156,156,0,1,0,1,0
21856,32898,0,0,73,73,0,1,0,1,0
12527,3389,12527,3389,293,223,70,4,1,3,1
13852,25773,0,0,143,143,0,1,0,1,0
44536,60097,0,0,66,66,0,1,0,1,0
52313,31652,0,0,62,62,0,1,0,1,0
51708,31652,0,0,63,63,0,1,0,1,0
54086,3389,54086,3389,293,223,70,4,0,3,1
2658,43918,0,0,146,146,0,1,0,1,0
23744,25773,0,0,145,145,0,1,0,1,0
17289,16619,0,0,83,83,0,1,0,1,0
10556,61248,0,0,142,142,0,1,0,1,0
15242,3389,15242,3389,293,223,70,4,0,3,1
19892,40892,0,0,81,81,0,1,0,1,0
12941,26115,0,0,135,135,0,1,0,1,0
15196,3389,15196,3389,293,223,70,4,0,3,1
46658,52779,0,0,85,85,0,1,0,1,0
60426,31652,0,0,84,84,0,1,0,1,0
14812,61248,0,0,148,148,0,1,0,1,0
29784,22468,0,0,147,147,0,1,0,1,0
58529,3389,58529,3389,293,223,70,4,0,3,1
27555,60969,0,0,136,136,0,1,0,1,0
33416,60668,0,0,112,112,0,1,0,1,0
7463,53975,0,0,141,141,0,1,0,1,0
12418,8600,3510,1300,203,176,26,2,0,1,0
23985,297,959,296,82,76,6,1,0,1,0
49293,31652,0,0,141,141,0,1,0,1,0
17179,19038,0,0,72,72,0,1,0,1,0
12450,6982,6308,1949,231,191,40,2,0,2,0
2134,23591,0,0,150,150,0,1,0,1,0
16073,25773,0,0,143,143,0,1,0,1,0
12055,6024,7549,2332,247,199,48,3,0,2,0
49385,31652,0,0,138,138,0,1,0,1,0
20817,30971,0,0,91,91,0,1,0,1,0
50453,29252,0,0,116,116,0,1,0,1,0
17784,17454,0,0,72,72,0,1,0,1,0
28246,25855,0,0,147,147,0,1,0,1,0
28216,34021,0,0,62,62,0,1,0,1,0
21392,4225,0,0,92,92,0,1,0,1,0
28187,31474,0,0,88,88,0,1,0,1,0
48240,39171,0,0,123,123,0,1,0,1,0
29912,34021,0,0,62,62,0,1,0,1,0
49050,26104,0,0,153,153,0,1,0,1,0
11111,6520,5758,2134,239,195,44,2,0,2,0
50554,29149,0,0,102,102,0,1,0,1,0
49679,31652,0,0,129,129,0,1,0,1,0
50266,3389,50266,3389,293,223,70,4,0,3,1
52415,33539,0,0,62,62,0,1,0,1,0
50662,31652,0,0,93,93,0,1,0,1,0
15001,25773,0,0,147,147,0,1,0,1,0
11087,3389,11087,3389,293,223,70,4,1,3,1
10258,59483,0,0,143,143,0,1,0,1,0
4582,23820,0,0,157,157,0,1,0,1,0
14996,22349,0,0,103,103,0,1,0,1,0
16617,15487,0,0,99,99,0,1,0,1,0
13548,9642,2859,883,185,167,18,1,0,1,0
57831,32678,0,0,98,98,0,1,0,1,0
10359,25773,0,0,139,139,0,1,0,1,0
51400,31896,0,0,70,70,0,1,0,1,0
37509,3389,37509,3389,293,223,70,4,1,3,1
48903,25796,0,0,156,156,0,1,0,1,0
18078,23802,0,0,121,121,0,1,0,1,0
11156,61248,0,0,142,142,0,1,0,1,0
2510,22675,0,0,157,157,0,1,0,1,0
18055,24554,0,0,129,129,0,1,0,1,0
11788,3389,11788,3389,293,223,70,4,0,3,1
10933,3389,10933,3389,293,223,70,4,1,3,1
25947,25773,0,0,146,146,0,1,0,1,0
28824,34021,0,0,62,62,0,1,0,1,0
60034,59929,0,0,141,141,0,1,0,1,0
49160,33736,0,0,146,146,0,1,0,1,0
39089,5099,0,0,138,138,0,1,0,1,0
11092,25773,0,0,152,152,0,1,0,1,0
9771,3389,9771,3389,293,223,70,4,1,3,1
51668,31652,0,0,64,64,0,1,0,1,0
41481,8015,0,0,145,145,0,1,0,1,0
51030,34021,0,0,100,100,0,1,0,1,0
49767,32073,0,0,131,131,0,1,0,1,0
13123,3389,13123,3389,293,223,70,4,0,3,1
26509,34021,0,0,62,62,0,1,0,1,0
9583,25773,0,0,140,140,0,1,0,1,0
28855,28533,0,0,119,119,0,1,0,1,0
8820,25773,0,0,153,153,0,1,0,1,0
13658,3389,13658,3389,293,223,70,4,0,3,1
22008,35230,0,0,65,65,0,1,0,1,0
16744,20143,0,0,81,81,0,1,0,1,0
26140,28827,0,0,116,116,0,1,0,1,0
23474,61178,0,0,153,153,0,1,0,1,0
37811,7547,0,0,146,146,0,1,0,1,0
39850,6084,0,0,146,146,0,1,0,1,0
52345,34900,0,0,62,62,0,1,0,1,0
21739,3389,21739,3389,293,223,70,4,0,3,1
12010,3389,12010,3389,293,223,70,4,0,3,1
25023,25773,0,0,146,146,0,1,0,1,0
21225,3389,21225,3389,293,223,70,4,0,3,1
27787,26502,0,0,140,140,0,1,0,1,0
9819,61248,0,0,141,141,0,1,0,1,0
16092,25773,0,0,141,141,0,1,0,1,0
16379,25773,0,0,143,143,0,1,0,1,0
13621,3389,13621,3389,293,223,70,4,0,3,1
36137,3389,36137,3389,293,223,70,4,1,3,1
16710,3389,16710,3389,293,223,70,4,0,3,1
11600,3389,11600,3389,293,223,70,4,1,3,1
13420,24338,0,0,124,124,0,1,0,1,0
49838,27684,0,0,126,126,0,1,0,1,0
12104,3389,12104,3389,293,223,70,4,1,3,1
11892,5631,8059,2490,254,203,51,3,0,2,0
12052,3389,12052,3389,293,223,70,4,0,3,1
4697,37139,0,0,150,150,0,1,0,1,0
49889,27788,0,0,124,124,0,1,0,1,0
17276,18741,0,0,67,67,0,1,0,1,0
10317,3389,10317,3389,293,223,70,4,1,3,1
27315,766,0,0,73,73,0,1,0,1,0
2372,46708,0,0,144,144,0,1,0,1,0
24756,114,366,113,69,67,2,1,0,1,0
22691,34021,0,0,62,62,0,1,0,1,0
26475,32668,0,0,75,75,0,1,0,1,0
29731,3389,29731,3389,293,223,70,4,0,3,1
17839,25773,0,0,142,142,0,1,0,1,0
30370,60824,0,0,125,125,0,1,0,1,0
11751,61248,0,0,141,141,0,1,0,1,0
16489,25773,0,0,143,143,0,1,0,1,0
22093,33723,0,0,64,64,0,1,0,1,0
5269,25773,0,0,148,148,0,1,0,1,0
8761,56989,0,0,143,143,0,1,0,1,0
22665,25773,0,0,145,145,0,1,0,1,0
49213,26546,0,0,145,145,0,1,0,1,0
9663,25773,0,0,150,150,0,1,0,1,0
17314,25773,0,0,143,143,0,1,0,1,0
11577,25527,0,0,140,140,0,1,0,1,0
13445,9391,3184,984,190,169,20,1,0,1,0
47307,34021,0,0,137,137,0,1,0,1,0
43045,3389,43045,3389,293,223,70,4,0,3,1
51328,31216,0,0,94,94,0,1,0,1,0
61720,32198,0,0,62,62,0,1,0,1,0
22185,3389,22185,3389,293,223,70,4,0,3,1
52798,6104,0,0,145,145,0,1,0,1,0
49150,33722,0,0,146,146,0,1,0,1,0
58104,31652,0,0,62,62,0,1,0,1,0
19749,3389,19749,3389,293,223,70,4,0,3,1
28285,26736,0,0,137,137,0,1,0,1,0
24380,939,0,0,68,68,0,1,0,1,0
47655,60199,0,0,73,73,0,1,0,1,0
11817,3389,11817,3389,293,223,70,4,1,3,1
32076,3389,32076,3389,293,223,70,4,1,3,1
15855,3389,15855,3389,293,223,70,4,0,3,1
18133,45599,0,0,94,94,0,1,0,1,0
27194,34021,0,0,62,62,0,1,0,1,0
8050,55804,0,0,143,143,0,1,0,1,0
52900,5618,0,0,145,145,0,1,0,1,0
10656,14679,0,0,150,150,0,1,0,1,0
35564,3802,0,0,118,118,0,1,0,1,0
17628,18705,0,0,67,67,0,1,0,1,0
13160,3389,13160,3389,293,223,70,4,0,3,1
16825,25773,0,0,144,144,0,1,0,1,0
26106,61043,0,0,142,142,0,1,0,1,0
19482,28492,0,0,116,116,0,1,0,1,0
49021,29564,0,0,151,151,0,1,0,1,0
41175,7238,0,0,146,146,0,1,0,1,0
10026,3389,10026,3389,293,223,70,4,1,3,1
49160,33247,0,0,146,146,0,1,0,1,0
6124,24445,0,0,128,128,0,1,0,1,0
19028,3389,19028,3389,293,223,70,4,0,3,1
52747,34968,0,0,71,71,0,1,0,1,0
37296,7916,0,0,146,146,0,1,0,1,0
15779,61248,0,0,149,149,0,1,0,1,0
17630,61248,0,0,152,152,0,1,0,1,0
49149,33680,0,0,146,146,0,1,0,1,0
34244,34021,0,0,80,80,0,1,0,1,0
2259,46154,0,0,144,144,0,1,0,1,0
18847,3389,18847,3389,293,223,70,4,0,3,1
48944,26711,0,0,155,155,0,1,0,1,0
55146,3389,55146,3389,293,223,70,4,0,3,1
14319,3389,14319,3389,293,223,70,4,0,3,1
49267,26680,0,0,143,143,0,1,0,1,0
15594,13761,0,0,122,122,0,1,0,1,0
51149,33031,0,0,97,97,0,1,0,1,0
26691,25773,0,0,147,147,0,1,0,1,0
33385,3389,33385,3389,293,223,70,4,0,3,1
50620,32700,0,0,99,99,0,1,0,1,0
12122,3389,12122,3389,293,223,70,4,0,3,1
51705,32446,0,0,68,68,0,1,0,1,0
28973,1377,0,0,82,82,0,1,0,1,0
9588,24835,0,0,143,143,0,1,0,1,0
19544,61248,0,0,153,153,0,1,0,1,0
18007,25773,0,0,142,142,0,1,0,1,0
5765,25773,0,0,149,149,0,1,0,1,0
24626,34021,0,0,62,62,0,1,0,1,0
46833,50685,0,0,89,89,0,1,0,1,0
28043,25773,0,0,147,147,0,1,0,1,0
17631,25773,0,0,143,143,0,1,0,1,0
33733,3389,33733,3389,293,223,70,4,0,3,1
13976,11080,829,307,161,154,6,1,0,1,0
11607,25773,0,0,143,143,0,1,0,1,0
38628,60400,0,0,91,91,0,1,0,1,0
2244,43532,0,0,144,144,0,1,0,1,0
13652,61248,0,0,141,141,0,1,0,1,0
15909,14293,0,0,115,115,0,1,0,1,0
6304,25773,0,0,141,141,0,1,0,1,0
38194,7272,0,0,146,146,0,1,0,1,0
50469,31652,0,0,99,99,0,1,0,1,0
1768,22265,0,0,157,157,0,1,0,1,0
21440,3389,21440,3389,293,223,70,4,0,3,1
51612,39952,0,0,145,145,0,1,0,1,0
60973,3389,60973,3389,293,223,70,4,0,3,1
54967,7732,0,0,146,146,0,1,0,1,0
10913,25773,0,0,144,144,0,1,0,1,0
25945,603,0,0,67,67,0,1,0,1,0
35375,3732,0,0,117,117,0,1,0,1,0
7966,23503,0,0,118,118,0,1,0,1,0
30702,11673,0,0,121,121,0,1,0,1,0
29342,30970,0,0,93,93,0,1,0,1,0
13487,3152,11722,3151,276,211,65,3,0,2,0
10960,3389,10960,3389,293,223,70,4,1,3,1
10445,25773,0,0,139,139,0,1,0,1,0
6358,25773,0,0,141,141,0,1,0,1,0
50609,29602,0,0,112,112,0,1,0,1,0
30443,34021,0,0,64,64,0,1,0,1,0
49190,33986,0,0,144,144,0,1,0,1,0
18084,3389,18084,3389,293,223,70,4,0,3,1
22028,61248,0,0,158,158,0,1,0,1,0
26510,34021,0,0,62,62,0,1,0,1,0
18887,61248,0,0,154,154,0,1,0,1,0
15374,3389,15374,3389,293,223,70,4,0,3,1
11280,59732,0,0,139,139,0,1,0,1,0
56722,5338,8023,424,163,154,8,1,0,1,0
51879,60546,0,0,96,96,0,1,0,1,0
11219,61248,0,0,142,142,0,1,0,1,0
49046,30383,0,0,150,150,0,1,0,1,0
3403,25577,0,0,143,143,0,1,0,1,0
14318,3389,14318,3389,293,223,70,4,0,3,1
49950,33898,0,0,141,141,0,1,0,1,0
12636,25327,0,0,134,134,0,1,0,1,0
60057,31652,0,0,86,86,0,1,0,1,0
17664,3389,17664,3389,293,223,70,4,0,3,1
51606,39937,0,0,145,145,0,1,0,1,0
34109,7515,0,0,132,132,0,1,0,1,0
49654,31652,0,0,128,128,0,1,0,1,0
12647,23441,0,0,140,140,0,1,0,1,0
21379,61248,0,0,157,157,0,1,0,1,0
18423,26526,0,0,135,135,0,1,0,1,0
14145,3389,14145,3389,293,223,70,4,0,3,1
14423,61248,0,0,148,148,0,1,0,1,0
50810,29673,0,0,93,93,0,1,0,1,0
43514,12849,0,0,149,149,0,1,0,1,0
17162,3389,17162,3389,293,223,70,4,0,3,1
7302,61045,0,0,139,139,0,1,0,1,0
8339,56285,0,0,143,143,0,1,0,1,0
19696,19324,0,0,74,74,0,1,0,1,0
9465,61248,0,0,141,141,0,1,0,1,0
64422,31658,0,0,62,62,0,1,0,1,0
58344,31652,0,0,95,95,0,1,0,1,0
49721,31652,0,0,126,126,0,1,0,1,0
4616,53236,0,0,142,142,0,1,0,1,0
50712,31652,0,0,96,96,0,1,0,1,0
14463,21056,0,0,97,97,0,1,0,1,0
13596,12490,0,0,148,148,0,1,0,1,0
47053,21337,0,0,154,154,0,1,0,1,0
55677,3389,55677,3389,293,223,70,4,0,3,1
14612,3389,14612,3389,293,223,70,4,0,3,1
14328,11531,410,126,153,150,2,1,0,1,0
23895,1472,0,0,72,72,0,1,0,1,0
8773,25773,0,0,140,140,0,1,0,1,0
17852,45280,0,0,95,95,0,1,0,1,0
58004,52975,0,0,121,121,0,1,0,1,0
63398,3553,59289,3138,282,217,64,3,0,2,0
15872,3389,15872,3389,293,223,70,4,0,3,1
15291,3389,15291,3389,293,223,70,4,0,3,1
48194,6881,0,0,145,145,0,1,0,1,0
15202,22089,0,0,101,101,0,1,0,1,0
26208,34021,0,0,62,62,0,1,0,1,0
46350,3389,46350,3389,293,223,70,4,0,3,1
14067,10900,1228,379,164,156,7,1,0,1,0
17093,3389,17093,3389,293,223,70,4,0,3,1
48489,6831,0,0,145,145,0,1,0,1,0
37898,4660,0,0,131,131,0,1,0,1,0
14057,3389,14057,3389,293,223,70,4,0,3,1
51869,31919,0,0,62,62,0,1,0,1,0
51517,31641,0,0,89,89,0,1,0,1,0
17329,3389,17329,3389,293,223,70,4,0,3,1
24050,29942,0,0,102,102,0,1,0,1,0
12475,3389,12475,3389,293,223,70,4,0,3,1
51128,31652,0,0,76,76,0,1,0,1,0
17660,3389,17660,3389,293,223,70,4,0,3,1
48762,34021,0,0,144,144,0,1,0,1,0
58321,61075,0,0,133,133,0,1,0,1,0
56119,60894,0,0,120,120,0,1,0,1,0
34838,9492,0,0,141,141,0,1,0,1,0
48939,25848,0,0,155,155,0,1,0,1,0
15771,3389,15771,3389,293,223,70,4,1,3,1
15682,3389,15682,3389,293,223,70,4,0,3,1
8057,61248,0,0,139,139,0,1,0,1,0
20055,3389,20055,3389,293,223,70,4,0,3,1
12129,61248,0,0,139,139,0,1,0,1,0
16800,19320,0,0,75,75,0,1,0,1,0
8038,61248,0,0,139,139,0,1,0,1,0
11624,61248,0,0,139,139,0,1,0,1,0
52141,32726,0,0,62,62,0,1,0,1,0
16901,44053,0,0,90,90,0,1,0,1,0
12289,6592,6813,2105,238,194,43,2,0,2,0
4149,49302,0,0,144,144,0,1,0,1,0
16219,2141,6929,2141,207,163,44,2,0,2,0
61303,3389,61303,3389,293,223,70,4,0,3,1
37897,3389,37897,3389,293,223,70,4,1,3,1
29391,34021,0,0,62,62,0,1,0,1,0
9953,3389,9953,3389,293,223,70,4,1,3,1
24866,30626,0,0,97,97,0,1,0,1,0
55456,6927,0,0,141,141,0,1,0,1,0
15460,3389,15460,3389,293,223,70,4,0,3,1
10552,3389,10552,3389,293,223,70,4,0,3,1
1244,22199,0,0,155,155,0,1,0,1,0
50260,5618,0,0,145,145,0,1,0,1,0
51212,30955,0,0,97,97,0,1,0,1,0
12283,25773,0,0,143,143,0,1,0,1,0
30272,3389,30272,3389,293,223,70,4,0,3,1
40185,5843,0,0,146,146,0,1,0,1,0
9901,61248,0,0,142,142,0,1,0,1,0
52868,33962,0,0,62,62,0,1,0,1,0
25850,3389,25850,3389,293,223,70,4,0,3,1
17335,3389,17335,3389,293,223,70,4,0,3,1
26830,33342,0,0,68,68,0,1,0,1,0
11524,61248,0,0,142,142,0,1,0,1,0
25101,25773,0,0,146,146,0,1,0,1,0
49131,26286,0,0,151,151,0,1,0,1,0
19699,31783,0,0,82,82,0,1,0,1,0
17761,3389,17761,3389,293,223,70,4,0,3,1
17385,3389,17385,3389,293,223,70,4,0,3,1
17610,46998,0,0,98,98,0,1,0,1,0
11838,3389,11838,3389,293,223,70,4,0,3,1
13451,3389,13451,3389,293,223,70,4,0,3,1
49078,29788,0,0,149,149,0,1,0,1,0
50916,31652,0,0,84,84,0,1,0,1,0
14013,3010,11197,3010,267,205,62,3,0,2,0
14242,25773,0,0,140,140,0,1,0,1,0
1392,22430,0,0,154,154,0,1,0,1,0
2535,24219,0,0,148,148,0,1,0,1,0
34095,3389,34095,3389,293,223,70,4,0,3,1
51305,31652,0,0,71,71,0,1,0,1,0
29230,34021,0,0,62,62,0,1,0,1,0
55171,5618,0,0,145,145,0,1,0,1,0
49384,33817,0,0,138,138,0,1,0,1,0
20996,3389,20996,3389,293,223,70,4,0,3,1
49969,33288,0,0,120,120,0,1,0,1,0
55683,5616,44,2,145,145,0,1,0,1,0
49634,33486,0,0,129,129,0,1,0,1,0
17854,3389,17854,3389,293,223,70,4,0,3,1
8097,25773,0,0,140,140,0,1,0,1,0
38035,3389,38035,3389,293,223,70,4,1,3,1
34627,3389,34627,3389,293,223,70,4,0,3,1
11520,23243,0,0,125,125,0,1,0,1,0
9348,3389,9348,3389,293,223,70,4,1,3,1
17943,3389,17943,3389,293,223,70,4,0,3,1
19390,3389,19390,3389,293,223,70,4,0,3,1
21885,25773,0,0,144,144,0,1,0,1,0
14956,13793,0,0,147,147,0,1,0,1,0
23636,429,1594,428,91,82,8,1,0,1,0
21868,20951,0,0,92,92,0,1,0,1,0
9976,3389,9976,3389,293,223,70,4,1,3,1
20683,3389,20683,3389,293,223,70,4,0,3,1
23808,3389,23808,3389,293,223,70,4,0,3,1
52225,32975,0,0,62,62,0,1,0,1,0
18498,18426,0,0,64,64,0,1,0,1,0
54612,5797,0,0,145,145,0,1,0,1,0
47105,3389,47105,3389,293,223,70,4,0,3,1
18026,25473,0,0,139,139,0,1,0,1,0
38118,3389,38118,3389,293,223,70,4,1,3,1
14886,47688,0,0,100,100,0,1,0,1,0
48906,25844,0,0,156,156,0,1,0,1,0
2968,33525,0,0,143,143,0,1,0,1,0
61444,32253,0,0,62,62,0,1,0,1,0
22615,34021,0,0,62,62,0,1,0,1,0
21196,3389,21196,3389,293,223,70,4,0,3,1
2944,20423,0,0,155,155,0,1,0,1,0
23738,31733,0,0,83,83,0,1,0,1,0
3175,30663,0,0,143,143,0,1,0,1,0
2389,41531,0,0,144,144,0,1,0,1,0
46833,55720,0,0,62,62,0,1,0,1,0
21948,33069,0,0,71,71,0,1,0,1,0
38373,7143,0,0,146,146,0,1,0,1,0
12553,3389,12553,3389,293,223,70,4,0,3,1
54551,13141,0,0,121,121,0,1,0,1,0
35733,3389,35733,3389,293,223,70,4,0,3,1
52001,32980,0,0,66,66,0,1,0,1,0
5563,51660,0,0,144,144,0,1,0,1,0
21871,32927,0,0,72,72,0,1,0,1,0
13083,9658,2366,877,185,167,18,1,0,1,0
51234,32144,0,0,79,79,0,1,0,1,0
49160,33906,0,0,146,146,0,1,0,1,0
10732,25773,0,0,153,153,0,1,0,1,0
46304,55014,0,0,76,76,0,1,0,1,0
3956,39601,0,0,148,148,0,1,0,1,0
12177,3389,12177,3389,293,223,70,4,0,3,1
11136,25773,0,0,139,139,0,1,0,1,0
50327,31652,0,0,104,104,0,1,0,1,0
14807,61248,0,0,148,148,0,1,0,1,0
28665,34021,0,0,62,62,0,1,0,1,0
19565,61248,0,0,153,153,0,1,0,1,0
13038,25773,0,0,150,150,0,1,0,1,0
49552,34021,0,0,136,136,0,1,0,1,0
14078,26707,0,0,130,130,0,1,0,1,0
49209,31686,0,0,144,144,0,1,0,1,0
7593,61248,0,0,139,139,0,1,0,1,0
8028,23469,0,0,151,151,0,1,0,1,0
49024,28546,0,0,151,151,0,1,0,1,0
55770,45107,0,0,95,95,0,1,0,1,0
20542,3389,20542,3389,293,223,70,4,0,3,1
17984,61248,0,0,153,153,0,1,0,1,0
11263,61248,0,0,142,142,0,1,0,1,0
14762,25773,0,0,140,140,0,1,0,1,0
49160,32166,0,0,146,146,0,1,0,1,0
49464,60348,0,0,83,83,0,1,0,1,0
51398,31652,0,0,74,74,0,1,0,1,0
51757,31652,0,0,62,62,0,1,0,1,0
16169,3389,16169,3389,293,223,70,4,0,3,1
2123,45920,0,0,144,144,0,1,0,1,0
7225,60822,0,0,139,139,0,1,0,1,0
22040,21079,0,0,94,94,0,1,0,1,0
44739,5618,0,0,145,145,0,1,0,1,0
29589,32208,0,0,80,80,0,1,0,1,0
23356,32756,0,0,75,75,0,1,0,1,0
51780,32581,0,0,68,68,0,1,0,1,0
51084,19283,0,0,153,153,0,1,0,1,0
12501,24501,0,0,147,147,0,1,0,1,0
13797,23862,0,0,119,119,0,1,0,1,0
25322,31728,0,0,84,84,0,1,0,1,0
56500,31652,0,0,105,105,0,1,0,1,0
11886,53382,0,0,151,151,0,1,0,1,0
19320,29434,0,0,104,104,0,1,0,1,0
39498,34021,0,0,103,103,0,1,0,1,0
9478,24796,0,0,143,143,0,1,0,1,0
39471,5239,0,0,140,140,0,1,0,1,0
10184,3389,10184,3389,293,223,70,4,1,3,1
50412,32888,0,0,105,105,0,1,0,1,0
13619,61248,0,0,146,146,0,1,0,1,0
14297,11590,278,103,152,150,2,1,0,1,0
12724,61248,0,0,146,146,0,1,0,1,0
49160,33220,0,0,146,146,0,1,0,1,0
29196,3389,29196,3389,293,223,70,4,0,3,1
24823,34021,0,0,62,62,0,1,0,1,0
34484,11970,0,0,146,146,0,1,0,1,0
9945,25773,0,0,154,154,0,1,0,1,0
51687,31652,0,0,63,63,0,1,0,1,0
20404,29998,0,0,99,99,0,1,0,1,0
22499,33966,0,0,62,62,0,1,0,1,0
1839,23129,0,0,152,152,0,1,0,1,0
29182,1453,0,0,83,83,0,1,0,1,0
54338,14561,0,0,116,116,0,1,0,1,0
13307,10015,1980,734,179,164,15,1,0,1,0
19266,28091,0,0,120,120,0,1,0,1,0
54889,60793,0,0,113,113,0,1,0,1,0
18174,20710,0,0,88,88,0,1,0,1,0
49137,31141,0,0,146,146,0,1,0,1,0
33355,3389,33355,3389,293,223,70,4,0,3,1
26719,13775,0,0,102,102,0,1,0,1,0
12367,3389,12367,3389,293,223,70,4,1,3,1
18830,1521,4922,1521,165,134,31,2,0,1,0
29674,34021,0,0,62,62,0,1,0,1,0
14466,25773,0,0,143,143,0,1,0,1,0
13466,25773,0,0,149,149,0,1,0,1,0
15092,2409,7795,2408,226,176,49,3,0,2,0
23525,22192,0,0,107,107,0,1,0,1,0
52677,34728,0,0,70,70,0,1,0,1,0
43915,60129,0,0,69,69,0,1,0,1,0
49133,31042,0,0,147,147,0,1,0,1,0
52303,33449,0,0,67,67,0,1,0,1,0
29939,3389,29939,3389,293,223,70,4,0,3,1
18835,61248,0,0,152,152,0,1,0,1,0
10836,3389,10836,3389,293,223,70,4,1,3,1
2275,43103,0,0,144,144,0,1,0,1,0
3476,25691,0,0,143,143,0,1,0,1,0
14224,3389,14224,3389,293,223,70,4,0,3,1
14903,61248,0,0,144,144,0,1,0,1,0
22110,33371,0,0,68,68,0,1,0,1,0
9345,3389,9345,3389,293,223,70,4,1,3,1
15471,61248,0,0,145,145,0,1,0,1,0
19433,3389,19433,3389,293,223,70,4,0,3,1
2302,20901,0,0,156,156,0,1,0,1,0
9152,25773,0,0,140,140,0,1,0,1,0
22605,706,2622,705,110,95,14,1,0,1,0
18203,19790,0,0,78,78,0,1,0,1,0
49810,34021,0,0,130,130,0,1,0,1,0
49063,30923,0,0,150,150,0,1,0,1,0
19126,27832,0,0,122,122,0,1,0,1,0
11937,61248,0,0,140,140,0,1,0,1,0
48872,34021,0,0,144,144,0,1,0,1,0
26238,32475,0,0,77,77,0,1,0,1,0
10008,3389,10008,3389,293,223,70,4,1,3,1
21022,31350,0,0,88,88,0,1,0,1,0
14729,12304,0,0,141,141,0,1,0,1,0
50284,34021,0,0,118,118,0,1,0,1,0
49747,31652,0,0,127,127,0,1,0,1,0
28313,25815,0,0,147,147,0,1,0,1,0
26326,34021,0,0,62,62,0,1,0,1,0
14667,25773,0,0,147,147,0,1,0,1,0
21808,28864,0,0,112,112,0,1,0,1,0
21039,3389,21039,3389,293,223,70,4,0,3,1
49119,30733,0,0,147,147,0,1,0,1,0
20131,3389,20131,3389,293,223,70,4,1,3,1
6162,18027,0,0,153,153,0,1,0,1,0
27407,1840,0,0,79,79,0,1,0,1,0
49068,31082,0,0,149,149,0,1,0,1,0
13136,8645,4152,1283,202,176,26,2,0,1,0
11846,7690,4494,1665,219,184,34,2,0,1,0
50812,32161,0,0,87,87,0,1,0,1,0
17865,45248,0,0,95,95,0,1,0,1,0
28282,26873,0,0,136,136,0,1,0,1,0
28284,26787,0,0,137,137,0,1,0,1,0
12378,3389,12378,3389,293,223,70,4,1,3,1
8765,25773,0,0,154,154,0,1,0,1,0
52240,33021,0,0,62,62,0,1,0,1,0
26604,28173,0,0,122,122,0,1,0,1,0
52426,33571,0,0,62,62,0,1,0,1,0
23805,34021,0,0,62,62,0,1,0,1,0
12076,61248,0,0,139,139,0,1,0,1,0
18078,23793,0,0,121,121,0,1,0,1,0
35036,14647,0,0,146,146,0,1,0,1,0
50552,32761,0,0,101,101,0,1,0,1,0
27054,34021,0,0,62,62,0,1,0,1,0
21687,32585,0,0,76,76,0,1,0,1,0
18633,26199,0,0,138,138,0,1,0,1,0
11929,3389,11929,3389,293,223,70,4,1,3,1
7519,23352,0,0,151,151,0,1,0,1,0
18334,61248,0,0,153,153,0,1,0,1,0
30100,3389,30100,3389,293,223,70,4,0,3,1
12331,58769,0,0,135,135,0,1,0,1,0
9553,58309,0,0,143,143,0,1,0,1,0
13327,3389,13327,3389,293,223,70,4,0,3,1
8085,61248,0,0,139,139,0,1,0,1,0
33798,7251,0,0,129,129,0,1,0,1,0
54488,40932,0,0,88,88,0,1,0,1,0
20797,3389,20797,3389,293,223,70,4,0,3,1
52455,33799,0,0,62,62,0,1,0,1,0
21948,33605,0,0,65,65,0,1,0,1,0
17594,47041,0,0,98,98,0,1,0,1,0
28633,34021,0,0,62,62,0,1,0,1,0
17916,3389,17916,3389,293,223,70,4,0,3,1
1876,23187,0,0,152,152,0,1,0,1,0
9589,61248,0,0,139,139,0,1,0,1,0
20610,1241,4613,1240,146,120,25,2,0,1,0
11913,61248,0,0,139,139,0,1,0,1,0
26948,25773,0,0,147,147,0,1,0,1,0
63971,3400,63688,3371,292,222,69,3,0,2,0
18055,24543,0,0,129,129,0,1,0,1,0
37302,3389,37302,3389,293,223,70,4,1,3,1
27348,27123,0,0,133,133,0,1,0,1,0
14448,3389,14448,3389,293,223,70,4,0,3,1
37492,7775,0,0,146,146,0,1,0,1,0
51322,31652,0,0,76,76,0,1,0,1,0
29920,33868,0,0,63,63,0,1,0,1,0
49160,33745,0,0,146,146,0,1,0,1,0
14835,12482,0,0,139,139,0,1,0,1,0
42057,7917,0,0,145,145,0,1,0,1,0
6912,23903,0,0,147,147,0,1,0,1,0
46830,20801,0,0,154,154,0,1,0,1,0
47643,3389,47643,3389,293,223,70,4,0,3,1
14021,61248,0,0,147,147,0,1,0,1,0
51096,32269,0,0,83,83,0,1,0,1,0
18376,18335,0,0,63,63,0,1,0,1,0
18424,3389,18424,3389,293,223,70,4,0,3,1
13593,21702,0,0,105,105,0,1,0,1,0
29137,34021,0,0,62,62,0,1,0,1,0
11489,61248,0,0,143,143,0,1,0,1,0
53529,19961,0,0,99,99,0,1,0,1,0
14776,25773,0,0,147,147,0,1,0,1,0
14431,61248,0,0,147,147,0,1,0,1,0
16891,61248,0,0,151,151,0,1,0,1,0
17959,3389,17959,3389,293,223,70,4,0,3,1
14767,13056,0,0,147,147,0,1,0,1,0
18177,3389,18177,3389,293,223,70,4,0,3,1
13872,61248,0,0,142,142,0,1,0,1,0
20363,3389,20363,3389,293,223,70,4,0,3,1
29742,34021,0,0,62,62,0,1,0,1,0
13222,58739,0,0,131,131,0,1,0,1,0
14046,3389,14046,3389,293,223,70,4,0,3,1
8034,25773,0,0,156,156,0,1,0,1,0
12583,3389,12583,3389,293,223,70,4,0,3,1
1568,22706,0,0,153,153,0,1,0,1,0
19110,3389,19110,3389,293,223,70,4,0,3,1
52319,41661,0,0,145,145,0,1,0,1,0
12385,25856,0,0,138,138,0,1,0,1,0
52512,34021,0,0,63,63,0,1,0,1,0
23967,3389,23967,3389,293,223,70,4,0,3,1
1692,22900,0,0,153,153,0,1,0,1,0
63218,31652,0,0,68,68,0,1,0,1,0
48977,27474,0,0,153,153,0,1,0,1,0
42519,3389,42519,3389,293,223,70,4,0,3,1
51211,32165,0,0,80,80,0,1,0,1,0
13242,9911,2093,775,181,165,16,1,0,1,0
28169,32337,0,0,79,79,0,1,0,1,0
16390,3389,16390,3389,293,223,70,4,0,3,1
46077,7239,0,0,145,145,0,1,0,1,0
24034,22573,0,0,111,111,0,1,0,1,0
49160,31668,0,0,146,146,0,1,0,1,0
29204,30281,0,0,100,100,0,1,0,1,0
52447,33633,0,0,62,62,0,1,0,1,0
18881,3389,18881,3389,293,223,70,4,0,3,1
19683,61248,0,0,155,155,0,1,0,1,0
49935,31652,0,0,121,121,0,1,0,1,0
10041,25773,0,0,148,148,0,1,0,1,0
61424,53884,0,0,124,124,0,1,0,1,0
17318,3389,17318,3389,293,223,70,4,0,3,1
40547,8173,0,0,145,145,0,1,0,1,0
23660,3389,23660,3389,293,223,70,4,0,3,1
9895,3389,9895,3389,293,223,70,4,0,3,1
4187,47470,0,0,146,146,0,1,0,1,0
50434,29585,0,0,101,101,0,1,0,1,0
19321,61248,0,0,154,154,0,1,0,1,0
13125,12841,0,0,148,148,0,1,0,1,0
11122,6537,5740,2127,239,195,43,2,0,2,0
4328,49602,0,0,144,144,0,1,0,1,0
50318,28948,0,0,120,120,0,1,0,1,0
6384,23719,0,0,148,148,0,1,0,1,0
51827,31795,0,0,62,62,0,1,0,1,0
9982,4722,7702,2854,270,211,58,3,0,2,0
52123,32672,0,0,62,62,0,1,0,1,0
11201,6663,5603,2076,236,193,42,2,0,2,0
9294,3628,8885,3293,288,220,68,3,0,2,0
17917,28704,0,0,111,111,0,1,0,1,0
58480,61088,0,0,134,134,0,1,0,1,0
37562,3389,37562,3389,293,223,70,4,1,3,1
49669,27681,0,0,129,129,0,1,0,1,0
29836,33444,0,0,68,68,0,1,0,1,0
51596,31652,0,0,67,67,0,1,0,1,0
12583,8862,3226,1195,199,174,24,2,0,1,0
17621,25773,0,0,143,143,0,1,0,1,0
21368,3389,21368,3389,293,223,70,4,0,3,1
28222,3389,28222,3389,293,223,70,4,0,3,1
27991,34021,0,0,62,62,0,1,0,1,0
50157,31652,0,0,110,110,0,1,0,1,0
2225,46282,0,0,144,144,0,1,0,1,0
13011,21110,0,0,142,142,0,1,0,1,0
59167,32707,0,0,62,62,0,1,0,1,0
21736,3389,21736,3389,293,223,70,4,0,3,1
25172,34021,0,0,62,62,0,1,0,1,0
10691,25773,0,0,145,145,0,1,0,1,0
14972,12713,0,0,136,136,0,1,0,1,0
24556,182,676,181,74,70,3,1,0,1,0
49546,3389,49546,3389,293,223,70,4,0,3,1
2085,45876,0,0,144,144,0,1,0,1,0
23293,22018,0,0,105,105,0,1,0,1,0
51604,32265,0,0,69,69,0,1,0,1,0
49484,3389,49484,3389,293,223,70,4,0,3,1
11004,3389,11004,3389,293,223,70,4,0,3,1
41440,7874,0,0,147,147,0,1,0,1,0
7172,60668,0,0,139,139,0,1,0,1,0
45602,5618,0,0,145,145,0,1,0,1,0
14073,55061,0,0,153,153,0,1,0,1,0
10000,59053,0,0,143,143,0,1,0,1,0
29306,30793,0,0,95,95,0,1,0,1,0
16252,3389,16252,3389,293,223,70,4,0,3,1
51314,31652,0,0,71,71,0,1,0,1,0
49636,33947,0,0,143,143,0,1,0,1,0
46082,56825,0,0,71,71,0,1,0,1,0
13214,19813,0,0,142,142,0,1,0,1,0
38316,3389,38316,3389,293,223,70,4,1,3,1
16411,3389,16411,3389,293,223,70,4,0,3,1
13799,27002,0,0,127,127,0,1,0,1,0
10155,4999,7403,2743,265,208,56,3,0,2,0
19441,3389,19441,3389,293,223,70,4,0,3,1
13005,61248,0,0,140,140,0,1,0,1,0
50482,29703,0,0,100,100,0,1,0,1,0
11198,3389,11198,3389,293,223,70,4,0,3,1
51933,34021,0,0,77,77,0,1,0,1,0
50750,31652,0,0,90,90,0,1,0,1,0
21177,3389,21177,3389,293,223,70,4,0,3,1
24383,61132,0,0,149,149,0,1,0,1,0
26832,32959,0,0,72,72,0,1,0,1,0
3960,39587,0,0,148,148,0,1,0,1,0
28836,34021,0,0,62,62,0,1,0,1,0
20910,61248,0,0,157,157,0,1,0,1,0
11671,3389,11671,3389,293,223,70,4,1,3,1
50488,31652,0,0,99,99,0,1,0,1,0
22471,25773,0,0,145,145,0,1,0,1,0
6750,59440,0,0,139,139,0,1,0,1,0
24391,3389,24391,3389,293,223,70,4,0,3,1
18882,3389,18882,3389,293,223,70,4,0,3,1
11974,60780,0,0,139,139,0,1,0,1,0
13051,9607,2422,897,186,167,18,1,0,1,0
24842,3389,24842,3389,293,223,70,4,0,3,1
12372,3389,12372,3389,293,223,70,4,1,3,1
35545,3795,0,0,118,118,0,1,0,1,0
51464,31522,0,0,90,90,0,1,0,1,0
20119,59704,0,0,157,157,0,1,0,1,0
9971,61248,0,0,141,141,0,1,0,1,0
60412,61227,0,0,144,144,0,1,0,1,0
25454,34021,0,0,62,62,0,1,0,1,0
56624,60936,0,0,123,123,0,1,0,1,0
56165,5487,3739,197,153,149,4,1,0,1,0
22055,21091,0,0,94,94,0,1,0,1,0
16419,3389,16419,3389,293,223,70,4,0,3,1
59541,61175,0,0,140,140,0,1,0,1,0
20880,32740,0,0,73,73,0,1,0,1,0
37006,8124,0,0,146,146,0,1,0,1,0
13112,3389,13112,3389,293,223,70,4,0,3,1
35893,8922,0,0,146,146,0,1,0,1,0
26863,25773,0,0,147,147,0,1,0,1,0
55315,43527,0,0,90,90,0,1,0,1,0
19500,26798,0,0,132,132,0,1,0,1,0
29548,32004,0,0,83,83,0,1,0,1,0
18477,3389,18477,3389,293,223,70,4,0,3,1
19056,26620,0,0,134,134,0,1,0,1,0
51301,31652,0,0,71,71,0,1,0,1,0
22814,25773,0,0,145,145,0,1,0,1,0
18090,18445,0,0,64,64,0,1,0,1,0
9753,3389,9753,3389,293,223,70,4,1,3,1
15359,3389,15359,3389,293,223,70,4,0,3,1
53471,3389,53471,3389,293,223,70,4,0,3,1
50251,31652,0,0,107,107,0,1,0,1,0
60185,61228,0,0,143,143,0,1,0,1,0
3475,26514,0,0,143,143,0,1,0,1,0
58666,31652,0,0,66,66,0,1,0,1,0
51249,32130,0,0,78,78,0,1,0,1,0
19857,29713,0,0,102,102,0,1,0,1,0
60026,60298,0,0,145,145,0,1,0,1,0
40691,5618,0,0,145,145,0,1,0,1,0
21137,20403,0,0,86,86,0,1,0,1,0
16680,3389,16680,3389,293,223,70,4,0,3,1
17150,16385,0,0,86,86,0,1,0,1,0
2406,46807,0,0,144,144,0,1,0,1,0
51349,38659,0,0,62,62,0,1,0,1,0
52319,33501,0,0,67,67,0,1,0,1,0
36814,8262,0,0,146,146,0,1,0,1,0
15361,3389,15361,3389,293,223,70,4,0,3,1
18081,23692,0,0,120,120,0,1,0,1,0
16967,61248,0,0,148,148,0,1,0,1,0
40103,5902,0,0,146,146,0,1,0,1,0
24442,34021,0,0,62,62,0,1,0,1,0
3842,22834,0,0,152,152,0,1,0,1,0
7523,61248,0,0,139,139,0,1,0,1,0
50769,29588,0,0,95,95,0,1,0,1,0
18156,3389,18156,3389,293,223,70,4,0,3,1
15220,3389,15220,3389,293,223,70,4,0,3,1
4395,25773,0,0,145,145,0,1,0,1,0
49918,60385,0,0,85,85,0,1,0,1,0
37126,8038,0,0,146,146,0,1,0,1,0
26907,13675,0,0,103,103,0,1,0,1,0
50480,5618,0,0,145,145,0,1,0,1,0
51204,38966,0,0,145,145,0,1,0,1,0
58031,31652,0,0,62,62,0,1,0,1,0
15956,3389,15956,3389,293,223,70,4,0,3,1
12418,61248,0,0,145,145,0,1,0,1,0
11708,61248,0,0,141,141,0,1,0,1,0
18300,18216,0,0,62,62,0,1,0,1,0
55562,3389,55562,3389,293,223,70,4,0,3,1
48972,28012,0,0,154,154,0,1,0,1,0
28223,29734,0,0,106,106,0,1,0,1,0
35670,3389,35670,3389,293,223,70,4,0,3,1
28158,3389,28158,3389,293,223,70,4,0,3,1
60264,32301,0,0,85,85,0,1,0,1,0
50462,32842,0,0,104,104,0,1,0,1,0
31262,3389,31262,3389,293,223,70,4,0,3,1
27776,26519,0,0,140,140,0,1,0,1,0
50553,29880,0,0,97,97,0,1,0,1,0
18898,3389,18898,3389,293,223,70,4,0,3,1
37635,3389,37635,3389,293,223,70,4,1,3,1
41123,34021,0,0,110,110,0,1,0,1,0
29708,32807,0,0,74,74,0,1,0,1,0
51694,31652,0,0,63,63,0,1,0,1,0
18101,23064,0,0,113,113,0,1,0,1,0
15722,3389,15722,3389,293,223,70,4,0,3,1
9176,3389,9176,3389,293,223,70,4,0,3,1
4788,53734,0,0,141,141,0,1,0,1,0
11745,61248,0,0,141,141,0,1,0,1,0
11485,4645,9338,2885,271,211,59,3,0,2,0
49560,5618,0,0,145,145,0,1,0,1,0
4883,25079,0,0,135,135,0,1,0,1,0
51466,31012,0,0,72,72,0,1,0,1,0
40871,3389,40871,3389,293,223,70,4,0,3,1
20469,3389,20469,3389,293,223,70,4,0,3,1
17804,3389,17804,3389,293,223,70,4,0,3,1
49581,33546,0,0,131,131,0,1,0,1,0
33988,3389,33988,3389,293,223,70,4,0,3,1
24341,30144,0,0,100,100,0,1,0,1,0
48975,25934,0,0,155,155,0,1,0,1,0
14717,25773,0,0,140,140,0,1,0,1,0
32147,17191,0,0,146,146,0,1,0,1,0
16269,9857,0,0,133,133,0,1,0,1,0
3132,31254,0,0,143,143,0,1,0,1,0
36117,3389,36117,3389,293,223,70,4,0,3,1
49160,33284,0,0,146,146,0,1,0,1,0
29014,1391,0,0,82,82,0,1,0,1,0
49644,31652,0,0,130,130,0,1,0,1,0
17833,25773,0,0,143,143,0,1,0,1,0
9009,25773,0,0,153,153,0,1,0,1,0
50423,31652,0,0,101,101,0,1,0,1,0
28694,27723,0,0,127,127,0,1,0,1,0
26998,24794,0,0,136,136,0,1,0,1,0
19180,61248,0,0,154,154,0,1,0,1,0
52559,33965,0,0,62,62,0,1,0,1,0
50519,31652,0,0,102,102,0,1,0,1,0
5585,25773,0,0,143,143,0,1,0,1,0
60612,32419,0,0,62,62,0,1,0,1,0
51713,31652,0,0,63,63,0,1,0,1,0
57009,3389,57009,3389,293,223,70,4,0,3,1
5151,25773,0,0,142,142,0,1,0,1,0
11004,3480,10847,3352,291,222,69,3,0,2,0
13625,25773,0,0,139,139,0,1,0,1,0
11360,59853,0,0,139,139,0,1,0,1,0
5430,25773,0,0,142,142,0,1,0,1,0
28379,25650,0,0,147,147,0,1,0,1,0
13008,21128,0,0,142,142,0,1,0,1,0
46143,56325,0,0,72,72,0,1,0,1,0
56143,46402,0,0,99,99,0,1,0,1,0
10088,3389,10088,3389,293,223,70,4,1,3,1
36223,3389,36223,3389,293,223,70,4,0,3,1
51807,32629,0,0,67,67,0,1,0,1,0
56411,3389,56411,3389,293,223,70,4,0,3,1
21626,32472,0,0,77,77,0,1,0,1,0
18960,29247,0,0,106,106,0,1,0,1,0
14638,3389,14638,3389,293,223,70,4,0,3,1
14860,3389,14860,3389,293,223,70,4,1,3,1
11381,3389,11381,3389,293,223,70,4,0,3,1
25623,34021,0,0,62,62,0,1,0,1,0
9329,3389,9329,3389,293,223,70,4,1,3,1
47500,45228,0,0,105,105,0,1,0,1,0
27703,34021,0,0,62,62,0,1,0,1,0
49160,31744,0,0,146,146,0,1,0,1,0
26031,28982,0,0,114,114,0,1,0,1,0
53456,20454,0,0,97,97,0,1,0,1,0
56583,31652,0,0,62,62,0,1,0,1,0
22655,25773,0,0,145,145,0,1,0,1,0
9376,3389,9376,3389,293,223,70,4,1,3,1
47558,46029,0,0,107,107,0,1,0,1,0
16309,27868,0,0,119,119,0,1,0,1,0
4629,25210,0,0,136,136,0,1,0,1,0
45555,5618,0,0,145,145,0,1,0,1,0
13227,8865,3867,1194,199,174,24,2,0,1,0
13436,25773,0,0,143,143,0,1,0,1,0
18910,3389,18910,3389,293,223,70,4,0,3,1
17244,16543,0,0,84,84,0,1,0,1,0
30429,21028,0,0,147,147,0,1,0,1,0
52938,31652,0,0,70,70,0,1,0,1,0
19474,3389,19474,3389,293,223,70,4,0,3,1
13760,23909,0,0,119,119,0,1,0,1,0
27366,34021,0,0,62,62,0,1,0,1,0
36652,3389,36652,3389,293,223,70,4,0,3,1
12114,61248,0,0,139,139,0,1,0,1,0
13334,24446,0,0,125,125,0,1,0,1,0
49589,27314,0,0,139,139,0,1,0,1,0
12260,3389,12260,3389,293,223,70,4,1,3,1
13185,2862,9261,2861,257,197,59,3,0,2,0
16446,19583,0,0,78,78,0,1,0,1,0
32698,3389,32698,3389,293,223,70,4,0,3,1
11464,53863,0,0,118,118,0,1,0,1,0
13073,9643,2383,883,185,167,18,1,0,1,0
50659,29716,0,0,111,111,0,1,0,1,0
51677,60529,0,0,95,95,0,1,0,1,0
49060,29378,0,0,150,150,0,1,0,1,0
49921,33332,0,0,121,121,0,1,0,1,0
19944,61248,0,0,154,154,0,1,0,1,0
17813,18795,0,0,67,67,0,1,0,1,0
52482,33849,0,0,62,62,0,1,0,1,0
38556,7012,0,0,146,146,0,1,0,1,0
58286,31652,0,0,95,95,0,1,0,1,0
18479,7427,0,0,115,115,0,1,0,1,0
3962,48693,0,0,143,143,0,1,0,1,0
12247,3389,12247,3389,293,223,70,4,0,3,1
48988,27728,0,0,153,153,0,1,0,1,0
2989,24929,0,0,146,146,0,1,0,1,0
49543,33589,0,0,132,132,0,1,0,1,0
9649,3389,9649,3389,293,223,70,4,0,3,1
49989,28478,0,0,117,117,0,1,0,1,0
15659,61248,0,0,149,149,0,1,0,1,0
24584,14901,0,0,92,92,0,1,0,1,0
52317,33247,0,0,62,62,0,1,0,1,0
16926,19914,0,0,79,79,0,1,0,1,0
46305,55420,0,0,76,76,0,1,0,1,0
11473,61248,0,0,142,142,0,1,0,1,0
28299,26027,0,0,145,145,0,1,0,1,0
17537,25773,0,0,142,142,0,1,0,1,0
25642,34021,0,0,62,62,0,1,0,1,0
12907,21776,0,0,141,141,0,1,0,1,0
49160,32970,0,0,146,146,0,1,0,1,0
16421,20551,0,0,85,85,0,1,0,1,0
27354,3389,27354,3389,293,223,70,4,0,3,1
22239,25773,0,0,145,145,0,1,0,1,0
49530,31652,0,0,134,134,0,1,0,1,0
14321,3389,14321,3389,293,223,70,4,1,3,1
29526,34021,0,0,62,62,0,1,0,1,0
14210,27334,0,0,124,124,0,1,0,1,0
7144,23984,0,0,147,147,0,1,0,1,0
18161,21154,0,0,93,93,0,1,0,1,0
11682,25773,0,0,139,139,0,1,0,1,0
32642,6272,0,0,120,120,0,1,0,1,0
10925,25773,0,0,153,153,0,1,0,1,0
4373,52528,0,0,142,142,0,1,0,1,0
13333,3389,13333,3389,293,223,70,4,0,3,1
50501,31652,0,0,98,98,0,1,0,1,0
29554,3659,0,0,96,96,0,1,0,1,0
57913,32665,0,0,97,97,0,1,0,1,0
24696,30866,0,0,94,94,0,1,0,1,0
49160,32093,0,0,146,146,0,1,0,1,0
18557,3389,18557,3389,293,223,70,4,0,3,1
17926,46152,0,0,96,96,0,1,0,1,0
16675,3389,16675,3389,293,223,70,4,0,3,1
51665,29291,0,0,78,78,0,1,0,1,0
15734,3389,15734,3389,293,223,70,4,0,3,1
15540,3389,15540,3389,293,223,70,4,0,3,1
4308,52339,0,0,142,142,0,1,0,1,0
15170,13047,0,0,131,131,0,1,0,1,0
8553,61248,0,0,139,139,0,1,0,1,0
52203,5618,0,0,145,145,0,1,0,1,0
10187,61248,0,0,141,141,0,1,0,1,0
52547,42213,0,0,145,145,0,1,0,1,0
49592,27182,0,0,134,134,0,1,0,1,0
50013,33060,0,0,116,116,0,1,0,1,0
58026,53054,0,0,122,122,0,1,0,1,0
10187,25773,0,0,139,139,0,1,0,1,0
31029,3389,31029,3389,293,223,70,4,1,3,1
33826,3389,33826,3389,293,223,70,4,0,3,1
38583,3389,38583,3389,293,223,70,4,0,3,1
19458,59196,0,0,157,157,0,1,0,1,0
19034,58871,0,0,156,156,0,1,0,1,0
50961,31994,0,0,82,82,0,1,0,1,0
51564,5618,0,0,145,145,0,1,0,1,0
51326,31652,0,0,70,70,0,1,0,1,0
62780,31652,0,0,63,63,0,1,0,1,0
17085,61248,0,0,148,148,0,1,0,1,0
12069,3389,12069,3389,293,223,70,4,1,3,1
52314,33240,0,0,62,62,0,1,0,1,0
44145,14362,0,0,150,150,0,1,0,1,0
29593,23643,0,0,147,147,0,1,0,1,0
18752,26372,0,0,137,137,0,1,0,1,0
51752,31652,0,0,62,62,0,1,0,1,0
17873,3389,17873,3389,293,223,70,4,0,3,1
52355,33362,0,0,62,62,0,1,0,1,0
50921,30797,0,0,84,84,0,1,0,1,0
15670,3389,15670,3389,293,223,70,4,0,3,1
50147,32909,0,0,111,111,0,1,0,1,0
16845,25773,0,0,142,142,0,1,0,1,0
9266,3584,8932,3310,289,221,68,3,0,2,0
1455,22092,0,0,157,157,0,1,0,1,0
10859,61248,0,0,142,142,0,1,0,1,0
22433,34087,0,0,62,62,0,1,0,1,0
63379,31867,0,0,62,62,0,1,0,1,0
12498,7097,6158,1903,229,190,39,2,0,2,0
37327,3389,37327,3389,293,223,70,4,1,3,1
4502,23064,0,0,151,151,0,1,0,1,0
16263,18909,0,0,145,145,0,1,0,1,0
36526,8468,0,0,146,146,0,1,0,1,0
31771,3389,31771,3389,293,223,70,4,0,3,1
23829,1545,0,0,73,73,0,1,0,1,0
15790,61248,0,0,146,146,0,1,0,1,0
12627,25773,0,0,150,150,0,1,0,1,0
52314,31652,0,0,62,62,0,1,0,1,0
50371,31652,0,0,103,103,0,1,0,1,0
17094,3389,17094,3389,293,223,70,4,0,3,1
16831,44178,0,0,90,90,0,1,0,1,0
31465,3389,31465,3389,293,223,70,4,0,3,1
11078,3389,11078,3389,293,223,70,4,1,3,1
28339,34021,0,0,62,62,0,1,0,1,0
11288,25426,0,0,140,140,0,1,0,1,0
52411,33528,0,0,62,62,0,1,0,1,0
28740,3389,28740,3389,293,223,70,4,0,3,1
13854,3389,13854,3389,293,223,70,4,0,3,1
10229,3389,10229,3389,293,223,70,4,0,3,1
15130,27254,0,0,125,125,0,1,0,1,0
48774,60291,0,0,79,79,0,1,0,1,0
14543,25773,0,0,140,140,0,1,0,1,0
4561,23085,0,0,151,151,0,1,0,1,0
28209,30401,0,0,99,99,0,1,0,1,0
14308,11482,474,146,154,151,3,1,0,1,0
19463,3389,19463,3389,293,223,70,4,0,3,1
15242,22039,0,0,100,100,0,1,0,1,0
16743,15698,0,0,96,96,0,1,0,1,0
30133,1803,0,0,88,88,0,1,0,1,0
3031,32656,0,0,143,143,0,1,0,1,0
10845,3389,10845,3389,293,223,70,4,1,3,1
57710,51842,0,0,116,116,0,1,0,1,0
38549,3389,38549,3389,293,223,70,4,0,3,1
50260,29150,0,0,108,108,0,1,0,1,0
5638,51784,0,0,144,144,0,1,0,1,0
6500,31143,0,0,153,153,0,1,0,1,0
16242,2412,8972,2412,226,176,49,3,0,2,0
53967,5618,0,0,145,145,0,1,0,1,0
18178,61248,0,0,150,150,0,1,0,1,0
25413,34021,0,0,62,62,0,1,0,1,0
49118,30692,0,0,147,147,0,1,0,1,0
50247,28521,0,0,112,112,0,1,0,1,0
9331,61248,0,0,140,140,0,1,0,1,0
51610,31652,0,0,65,65,0,1,0,1,0
49039,28885,0,0,151,151,0,1,0,1,0
12080,25773,0,0,139,139,0,1,0,1,0
6553,58867,0,0,139,139,0,1,0,1,0
54669,11570,0,0,128,128,0,1,0,1,0
26953,34021,0,0,62,62,0,1,0,1,0
48919,26153,0,0,156,156,0,1,0,1,0
23862,34021,0,0,62,62,0,1,0,1,0
49129,33043,0,0,147,147,0,1,0,1,0
58636,3389,58636,3389,293,223,70,4,0,3,1
2292,46208,0,0,144,144,0,1,0,1,0
50910,32865,0,0,102,102,0,1,0,1,0
3405,47854,0,0,144,144,0,1,0,1,0
25503,34021,0,0,62,62,0,1,0,1,0
51437,31652,0,0,68,68,0,1,0,1,0
37451,7805,0,0,146,146,0,1,0,1,0
15250,14943,0,0,146,146,0,1,0,1,0
19180,3389,19180,3389,293,223,70,4,0,3,1
10155,3389,10155,3389,293,223,70,4,1,3,1
18129,22169,0,0,104,104,0,1,0,1,0
3788,25773,0,0,143,143,0,1,0,1,0
21735,32674,0,0,75,75,0,1,0,1,0
14048,3389,14048,3389,293,223,70,4,0,3,1
28564,34021,0,0,62,62,0,1,0,1,0
31528,3389,31528,3389,293,223,70,4,1,3,1
16934,3389,16934,3389,293,223,70,4,0,3,1
51705,34021,0,0,83,83,0,1,0,1,0
28262,60933,0,0,133,133,0,1,0,1,0
20091,61248,0,0,154,154,0,1,0,1,0
40287,5770,0,0,146,146,0,1,0,1,0
53916,38668,0,0,76,76,0,1,0,1,0
17249,18987,0,0,71,71,0,1,0,1,0
13823,27021,0,0,127,127,0,1,0,1,0
12959,3389,12959,3389,293,223,70,4,0,3,1
9546,3389,9546,3389,293,223,70,4,1,3,1
49863,60380,0,0,85,85,0,1,0,1,0
38428,3389,38428,3389,293,223,70,4,1,3,1
16920,3389,16920,3389,293,223,70,4,0,3,1
21116,3389,21116,3389,293,223,70,4,0,3,1
10489,25148,0,0,141,141,0,1,0,1,0
27535,34021,0,0,62,62,0,1,0,1,0
37106,3389,37106,3389,293,223,70,4,1,3,1
12302,3389,12302,3389,293,223,70,4,1,3,1
15585,28449,0,0,114,114,0,1,0,1,0
16613,20281,0,0,144,144,0,1,0,1,0
11694,25568,0,0,139,139,0,1,0,1,0
51816,31763,0,0,62,62,0,1,0,1,0
34528,3389,34528,3389,293,223,70,4,0,3,1
25747,31116,0,0,90,90,0,1,0,1,0
8520,61248,0,0,140,140,0,1,0,1,0
51814,32643,0,0,67,67,0,1,0,1,0
10979,3389,10979,3389,293,223,70,4,0,3,1
29325,30887,0,0,94,94,0,1,0,1,0
49080,31456,0,0,149,149,0,1,0,1,0
16386,9728,0,0,132,132,0,1,0,1,0
48447,37480,0,0,128,128,0,1,0,1,0
28203,25773,0,0,147,147,0,1,0,1,0
12143,25773,0,0,143,143,0,1,0,1,0
11898,53079,0,0,115,115,0,1,0,1,0
14504,3389,14504,3389,293,223,70,4,0,3,1
41601,8260,0,0,147,147,0,1,0,1,0
28240,28910,0,0,115,115,0,1,0,1,0
27466,34021,0,0,62,62,0,1,0,1,0
19378,61248,0,0,153,153,0,1,0,1,0
11891,3389,11891,3389,293,223,70,4,1,3,1
35731,3863,0,0,119,119,0,1,0,1,0
50263,29158,0,0,108,108,0,1,0,1,0
10905,3389,10905,3389,293,223,70,4,1,3,1
11423,25773,0,0,139,139,0,1,0,1,0
56688,3389,56688,3389,293,223,70,4,0,3,1
50027,31652,0,0,118,118,0,1,0,1,0
35563,3389,35563,3389,293,223,70,4,1,3,1
28235,29147,0,0,112,112,0,1,0,1,0
15003,3389,15003,3389,293,223,70,4,0,3,1
5700,56388,0,0,140,140,0,1,0,1,0
9112,57574,0,0,143,143,0,1,0,1,0
26716,28015,0,0,124,124,0,1,0,1,0
11415,61248,0,0,142,142,0,1,0,1,0
51975,32234,0,0,62,62,0,1,0,1,0
32614,6249,0,0,120,120,0,1,0,1,0
15673,61248,0,0,150,150,0,1,0,1,0
18206,19707,0,0,77,77,0,1,0,1,0
15259,3389,15259,3389,293,223,70,4,0,3,1
6191,18005,0,0,153,153,0,1,0,1,0
61030,56772,0,0,132,132,0,1,0,1,0
15968,25773,0,0,141,141,0,1,0,1,0
18236,18735,0,0,67,67,0,1,0,1,0
24491,31155,0,0,91,91,0,1,0,1,0
43242,3389,43242,3389,293,223,70,4,0,3,1
10418,3389,10418,3389,293,223,70,4,1,3,1
17030,25773,0,0,144,144,0,1,0,1,0
47926,34021,0,0,140,140,0,1,0,1,0
52779,60620,0,0,101,101,0,1,0,1,0
9606,3389,9606,3389,293,223,70,4,1,3,1
9656,57282,0,0,140,140,0,1,0,1,0
37950,3389,37950,3389,293,223,70,4,1,3,1
4379,25773,0,0,143,143,0,1,0,1,0
9723,24882,0,0,143,143,0,1,0,1,0
48897,6763,0,0,145,145,0,1,0,1,0
9116,25773,0,0,152,152,0,1,0,1,0
24506,30258,0,0,98,98,0,1,0,1,0
9104,61248,0,0,140,140,0,1,0,1,0
13654,24042,0,0,121,121,0,1,0,1,0
36680,4212,0,0,124,124,0,1,0,1,0
15957,17711,0,0,145,145,0,1,0,1,0
11399,61248,0,0,142,142,0,1,0,1,0
11910,61248,0,0,140,140,0,1,0,1,0
50486,32527,0,0,99,99,0,1,0,1,0
15508,10693,0,0,139,139,0,1,0,1,0
13380,24703,0,0,146,146,0,1,0,1,0
11862,3176,10278,3176,278,212,65,3,0,2,0
2390,46760,0,0,144,144,0,1,0,1,0
9423,61248,0,0,139,139,0,1,0,1,0
7433,61248,0,0,139,139,0,1,0,1,0
13246,8911,3807,1176,198,174,24,2,0,1,0
15129,3389,15129,3389,293,223,70,4,0,3,1
13848,54889,0,0,153,153,0,1,0,1,0
11964,5805,7834,2421,251,201,50,3,0,2,0
1437,22501,0,0,154,154,0,1,0,1,0
50873,32470,0,0,91,91,0,1,0,1,0
48087,23816,0,0,155,155,0,1,0,1,0
55121,5711,0,0,145,145,0,1,0,1,0
2397,24002,0,0,149,149,0,1,0,1,0
14676,3389,14676,3389,293,223,70,4,0,3,1
18217,19362,0,0,74,74,0,1,0,1,0
22209,3389,22209,3389,293,223,70,4,0,3,1
35794,3389,35794,3389,293,223,70,4,1,3,1
7771,25582,0,0,157,157,0,1,0,1,0
25929,3389,25929,3389,293,223,70,4,0,3,1
20634,32540,0,0,75,75,0,1,0,1,0
14876,61248,0,0,149,149,0,1,0,1,0
50808,32166,0,0,88,88,0,1,0,1,0
54058,60725,0,0,109,109,0,1,0,1,0
9582,25773,0,0,150,150,0,1,0,1,0
3679,50508,0,0,143,143,0,1,0,1,0
48925,26496,0,0,156,156,0,1,0,1,0
26046,34021,0,0,62,62,0,1,0,1,0
50435,60427,0,0,88,88,0,1,0,1,0
53064,13392,0,0,149,149,0,1,0,1,0
15353,28261,0,0,115,115,0,1,0,1,0
12450,24698,0,0,139,139,0,1,0,1,0
28661,33129,0,0,70,70,0,1,0,1,0
17562,3389,17562,3389,293,223,70,4,0,3,1
17481,3389,17481,3389,293,223,70,4,0,3,1
59716,32386,0,0,88,88,0,1,0,1,0
14601,48202,0,0,102,102,0,1,0,1,0
21853,3389,21853,3389,293,223,70,4,0,3,1
28559,34021,0,0,62,62,0,1,0,1,0
50814,32524,0,0,92,92,0,1,0,1,0
49962,27938,0,0,122,122,0,1,0,1,0
51135,31652,0,0,76,76,0,1,0,1,0
11774,3389,11774,3389,293,223,70,4,1,3,1
18442,3389,18442,3389,293,223,70,4,0,3,1
36873,8220,0,0,146,146,0,1,0,1,0
3278,25380,0,0,144,144,0,1,0,1,0
50792,32783,0,0,105,105,0,1,0,1,0
24686,31209,0,0,89,89,0,1,0,1,0
20309,39777,0,0,78,78,0,1,0,1,0
48959,27061,0,0,154,154,0,1,0,1,0
16339,25773,0,0,141,141,0,1,0,1,0
51697,31652,0,0,63,63,0,1,0,1,0
49817,31652,0,0,122,122,0,1,0,1,0
15885,3389,15885,3389,293,223,70,4,0,3,1
21251,3389,21251,3389,293,223,70,4,0,3,1
49169,31652,0,0,145,145,0,1,0,1,0
61697,31652,0,0,62,62,0,1,0,1,0
58030,55472,0,0,145,145,0,1,0,1,0
15941,27676,0,0,121,121,0,1,0,1,0
28108,3389,28108,3389,293,223,70,4,0,3,1
50310,31652,0,0,105,105,0,1,0,1,0
1342,22351,0,0,155,155,0,1,0,1,0
50868,29791,0,0,92,92,0,1,0,1,0
10699,61248,0,0,142,142,0,1,0,1,0
2383,41610,0,0,144,144,0,1,0,1,0
14830,3389,14830,3389,293,223,70,4,0,3,1
51319,33148,0,0,92,92,0,1,0,1,0
10799,61248,0,0,142,142,0,1,0,1,0
54414,14055,0,0,118,118,0,1,0,1,0
7184,25258,0,0,157,157,0,1,0,1,0
55284,5684,0,0,145,145,0,1,0,1,0
24541,3389,24541,3389,293,223,70,4,0,3,1
41051,6939,0,0,146,146,0,1,0,1,0
36542,8457,0,0,146,146,0,1,0,1,0
38105,3389,38105,3389,293,223,70,4,1,3,1
14077,11240,657,243,158,153,5,1,0,1,0
48944,27095,0,0,155,155,0,1,0,1,0
50264,28556,0,0,112,112,0,1,0,1,0
33827,34021,0,0,78,78,0,1,0,1,0
14737,3389,14737,3389,293,223,70,4,0,3,1
52133,32704,0,0,62,62,0,1,0,1,0
50366,31652,0,0,103,103,0,1,0,1,0
11122,60924,0,0,143,143,0,1,0,1,0
23624,34021,0,0,62,62,0,1,0,1,0
30781,2042,0,0,92,92,0,1,0,1,0
51122,30310,0,0,83,83,0,1,0,1,0
52631,34010,0,0,62,62,0,1,0,1,0
2720,22444,0,0,154,154,0,1,0,1,0
8949,25773,0,0,140,140,0,1,0,1,0
43927,13837,0,0,150,150,0,1,0,1,0
9038,25773,0,0,155,155,0,1,0,1,0
16734,25477,0,0,144,144,0,1,0,1,0
11322,59796,0,0,139,139,0,1,0,1,0
18628,3389,18628,3389,293,223,70,4,0,3,1
47186,3389,47186,3389,293,223,70,4,0,3,1
16154,3389,16154,3389,293,223,70,4,0,3,1
1751,22992,0,0,152,152,0,1,0,1,0
51027,31061,0,0,80,80,0,1,0,1,0
11925,22942,0,0,121,121,0,1,0,1,0
18747,43094,0,0,88,88,0,1,0,1,0
37161,3389,37161,3389,293,223,70,4,0,3,1
18328,61248,0,0,153,153,0,1,0,1,0
49517,23944,0,0,155,155,0,1,0,1,0
48963,35495,0,0,141,141,0,1,0,1,0
2844,22487,0,0,154,154,0,1,0,1,0
50115,28250,0,0,116,116,0,1,0,1,0
10377,25773,0,0,147,147,0,1,0,1,0
49160,33552,0,0,146,146,0,1,0,1,0
51541,34021,0,0,87,87,0,1,0,1,0
50696,41126,0,0,62,62,0,1,0,1,0
27736,34021,0,0,62,62,0,1,0,1,0
8948,25154,0,0,149,149,0,1,0,1,0
4183,25773,0,0,142,142,0,1,0,1,0
15105,22211,0,0,102,102,0,1,0,1,0
49612,27364,0,0,138,138,0,1,0,1,0
15860,3389,15860,3389,293,223,70,4,0,3,1
20234,3389,20234,3389,293,223,70,4,0,3,1
29497,34021,0,0,62,62,0,1,0,1,0
3671,40547,0,0,148,148,0,1,0,1,0
27681,34021,0,0,62,62,0,1,0,1,0
52577,34019,0,0,62,62,0,1,0,1,0
30632,3389,30632,3389,293,223,70,4,0,3,1
51227,30990,0,0,96,96,0,1,0,1,0
13817,20510,0,0,86,86,0,1,0,1,0
17431,46309,0,0,98,98,0,1,0,1,0
49093,30125,0,0,148,148,0,1,0,1,0
12066,6051,7515,2322,247,199,47,3,0,2,0
51411,31915,0,0,70,70,0,1,0,1,0
50997,30985,0,0,81,81,0,1,0,1,0
10056,57886,0,0,140,140,0,1,0,1,0
11925,61248,0,0,140,140,0,1,0,1,0
60517,60525,0,0,142,142,0,1,0,1,0
27054,670,0,0,72,72,0,1,0,1,0
51874,31933,0,0,62,62,0,1,0,1,0
11380,61248,0,0,142,142,0,1,0,1,0
32975,3389,32975,3389,293,223,70,4,1,3,1
16603,25773,0,0,142,142,0,1,0,1,0
12190,61248,0,0,139,139,0,1,0,1,0
51301,34021,0,0,93,93,0,1,0,1,0
10021,25773,0,0,148,148,0,1,0,1,0
37838,7527,0,0,146,146,0,1,0,1,0
10825,3389,10825,3389,293,223,70,4,1,3,1
51044,31652,0,0,79,79,0,1,0,1,0
6095,52546,0,0,144,144,0,1,0,1,0
38184,3389,38184,3389,293,223,70,4,1,3,1
15199,13097,0,0,131,131,0,1,0,1,0
6105,25773,0,0,150,150,0,1,0,1,0
16093,25773,0,0,145,145,0,1,0,1,0
50609,29602,0,0,112,112,0,1,0,1,0
51071,34021,0,0,99,99,0,1,0,1,0
8467,56500,0,0,143,143,0,1,0,1,0
58836,61117,0,0,136,136,0,1,0,1,0
11973,3389,11973,3389,293,223,70,4,0,3,1
20507,1268,4716,1268,148,122,26,2,0,1,0
29167,30094,0,0,102,102,0,1,0,1,0
46427,60098,0,0,66,66,0,1,0,1,0
1883,23198,0,0,152,152,0,1,0,1,0
48430,24639,0,0,156,156,0,1,0,1,0
7094,25773,0,0,153,153,0,1,0,1,0
54702,41397,0,0,84,84,0,1,0,1,0
63704,37194,0,0,77,77,0,1,0,1,0
10349,3389,10349,3389,293,223,70,4,1,3,1
61467,3389,61467,3389,293,223,70,4,0,3,1
9194,56586,0,0,140,140,0,1,0,1,0
12089,61248,0,0,139,139,0,1,0,1,0
3530,25773,0,0,143,143,0,1,0,1,0
21765,3389,21765,3389,293,223,70,4,0,3,1
51522,31652,0,0,66,66,0,1,0,1,0
14274,3389,14274,3389,293,223,70,4,0,3,1
24599,34021,0,0,62,62,0,1,0,1,0
51938,32585,0,0,78,78,0,1,0,1,0
28191,31270,0,0,90,90,0,1,0,1,0
36125,4008,0,0,121,121,0,1,0,1,0
42624,34021,0,0,117,117,0,1,0,1,0
39344,3389,39344,3389,293,223,70,4,0,3,1
6400,24825,0,0,157,157,0,1,0,1,0
28565,60917,0,0,132,132,0,1,0,1,0
12974,3389,12974,3389,293,223,70,4,0,3,1
50544,32463,0,0,97,97,0,1,0,1,0
52433,3389,52433,3389,293,223,70,4,0,3,1
13353,58387,0,0,130,130,0,1,0,1,0
3424,22689,0,0,153,153,0,1,0,1,0
10149,25773,0,0,139,139,0,1,0,1,0
28778,3389,28778,3389,293,223,70,4,0,3,1
14043,25773,0,0,148,148,0,1,0,1,0
16509,3389,16509,3389,293,223,70,4,0,3,1
54743,31652,0,0,69,69,0,1,0,1,0
18951,18765,0,0,67,67,0,1,0,1,0
52079,32542,0,0,62,62,0,1,0,1,0
13360,25773,0,0,139,139,0,1,0,1,0
28895,28729,0,0,117,117,0,1,0,1,0
5570,25773,0,0,142,142,0,1,0,1,0
2696,24469,0,0,147,147,0,1,0,1,0
11208,61248,0,0,139,139,0,1,0,1,0
20079,3389,20079,3389,293,223,70,4,0,3,1
17472,3389,17472,3389,293,223,70,4,0,3,1
9731,3389,9731,3389,293,223,70,4,1,3,1
14811,61248,0,0,148,148,0,1,0,1,0
18009,18422,0,0,64,64,0,1,0,1,0
51111,31825,0,0,77,77,0,1,0,1,0
6921,23906,0,0,147,147,0,1,0,1,0
51541,31652,0,0,66,66,0,1,0,1,0
12264,61248,0,0,139,139,0,1,0,1,0
50350,32681,0,0,104,104,0,1,0,1,0
21793,30721,0,0,92,92,0,1,0,1,0
18223,61248,0,0,153,153,0,1,0,1,0
25111,34021,0,0,62,62,0,1,0,1,0
18110,22786,0,0,110,110,0,1,0,1,0
18187,20324,0,0,84,84,0,1,0,1,0
52759,6110,0,0,145,145,0,1,0,1,0
5057,25773,0,0,142,142,0,1,0,1,0
47705,6964,0,0,145,145,0,1,0,1,0
4379,49686,0,0,144,144,0,1,0,1,0
49160,33361,0,0,146,146,0,1,0,1,0
49761,5618,0,0,145,145,0,1,0,1,0
2978,22534,0,0,153,153,0,1,0,1,0
51707,3389,51707,3389,293,223,70,4,0,3,1
20169,3389,20169,3389,293,223,70,4,0,3,1
50389,3389,50389,3389,293,223,70,4,0,3,1
18849,1713,6371,1713,178,143,35,2,0,2,0
16024,21052,0,0,90,90,0,1,0,1,0
47849,43844,0,0,114,114,0,1,0,1,0
21809,16365,0,0,79,79,0,1,0,1,0
50925,31652,0,0,89,89,0,1,0,1,0
64006,34976,0,0,71,71,0,1,0,1,0
23481,22159,0,0,106,106,0,1,0,1,0
11135,6558,5718,2119,238,194,43,2,0,2,0
2062,23478,0,0,151,151,0,1,0,1,0
21319,61248,0,0,157,157,0,1,0,1,0
11881,3389,11881,3389,293,223,70,4,0,3,1
12143,61248,0,0,139,139,0,1,0,1,0
49942,33313,0,0,120,120,0,1,0,1,0
60701,59176,0,0,139,139,0,1,0,1,0
11944,5757,7895,2439,252,201,50,3,0,2,0
16682,3389,16682,3389,293,223,70,4,0,3,1
9159,57652,0,0,143,143,0,1,0,1,0
29291,33565,0,0,66,66,0,1,0,1,0
19373,3389,19373,3389,293,223,70,4,0,3,1
49688,27728,0,0,128,128,0,1,0,1,0
13726,25773,0,0,140,140,0,1,0,1,0
12943,12976,0,0,149,149,0,1,0,1,0
28558,3389,28558,3389,293,223,70,4,0,3,1
5062,25773,0,0,142,142,0,1,0,1,0
20767,4911,0,0,97,97,0,1,0,1,0
15966,3389,15966,3389,293,223,70,4,0,3,1
12118,25773,0,0,143,143,0,1,0,1,0
10268,61248,0,0,139,139,0,1,0,1,0
25373,119,0,0,63,63,0,1,0,1,0
15245,14927,0,0,146,146,0,1,0,1,0
54292,14870,0,0,115,115,0,1,0,1,0
10181,58074,0,0,140,140,0,1,0,1,0
26309,28589,0,0,118,118,0,1,0,1,0
57815,31652,0,0,67,67,0,1,0,1,0
4909,24001,0,0,157,157,0,1,0,1,0
10823,25773,0,0,143,143,0,1,0,1,0
9356,3389,9356,3389,293,223,70,4,1,3,1
19773,25773,0,0,143,143,0,1,0,1,0
28921,28861,0,0,115,115,0,1,0,1,0
61256,4126,42840,2268,244,197,46,3,0,2,0
49910,31652,0,0,119,119,0,1,0,1,0
31299,19085,0,0,147,147,0,1,0,1,0
16499,61248,0,0,147,147,0,1,0,1,0
60752,31652,0,0,82,82,0,1,0,1,0
3807,50881,0,0,143,143,0,1,0,1,0
24653,30925,0,0,94,94,0,1,0,1,0
13581,24134,0,0,122,122,0,1,0,1,0
3457,23198,0,0,157,157,0,1,0,1,0
11584,25773,0,0,142,142,0,1,0,1,0
6873,24062,0,0,124,124,0,1,0,1,0
27342,34021,0,0,62,62,0,1,0,1,0
13664,9922,2495,771,181,165,15,1,0,1,0
17841,25732,0,0,143,143,0,1,0,1,0
5844,22965,0,0,153,153,0,1,0,1,0
17801,3389,17801,3389,293,223,70,4,0,3,1
16628,25773,0,0,142,142,0,1,0,1,0
49432,31652,0,0,137,137,0,1,0,1,0
15299,28217,0,0,116,116,0,1,0,1,0
63842,3434,62693,3319,289,221,68,3,0,2,0
52542,26553,0,0,78,78,0,1,0,1,0
25439,34021,0,0,62,62,0,1,0,1,0
26038,3389,26038,3389,293,223,70,4,0,3,1
38746,34021,0,0,100,100,0,1,0,1,0
63081,41754,0,0,90,90,0,1,0,1,0
4785,53726,0,0,141,141,0,1,0,1,0
9485,25773,0,0,140,140,0,1,0,1,0
21108,3389,21108,3389,293,223,70,4,0,3,1
13212,24600,0,0,127,127,0,1,0,1,0
10065,3389,10065,3389,293,223,70,4,1,3,1
3165,25205,0,0,145,145,0,1,0,1,0
19824,3389,19824,3389,293,223,70,4,0,3,1
1444,22512,0,0,154,154,0,1,0,1,0
18373,26063,0,0,140,140,0,1,0,1,0
12443,25570,0,0,136,136,0,1,0,1,0
50421,5618,0,0,145,145,0,1,0,1,0
31089,2155,0,0,94,94,0,1,0,1,0
49128,33015,0,0,147,147,0,1,0,1,0
18667,3389,18667,3389,293,223,70,4,0,3,1
32775,15787,0,0,146,146,0,1,0,1,0
34751,3503,0,0,114,114,0,1,0,1,0
57044,33130,0,0,62,62,0,1,0,1,0
17725,17355,0,0,73,73,0,1,0,1,0
49079,26134,0,0,151,151,0,1,0,1,0
63152,3389,63152,3389,293,223,70,4,0,3,1
11195,3389,11195,3389,293,223,70,4,1,3,1
15316,3389,15316,3389,293,223,70,4,0,3,1
20375,61248,0,0,156,156,0,1,0,1,0
19274,26798,0,0,132,132,0,1,0,1,0
49739,27649,0,0,135,135,0,1,0,1,0
29357,31048,0,0,92,92,0,1,0,1,0
23349,25773,0,0,145,145,0,1,0,1,0
35912,8909,0,0,146,146,0,1,0,1,0
31591,3389,31591,3389,293,223,70,4,0,3,1
11722,3389,11722,3389,293,223,70,4,1,3,1
33809,34021,0,0,78,78,0,1,0,1,0
23447,3389,23447,3389,293,223,70,4,1,3,1
5578,24370,0,0,157,157,0,1,0,1,0
11035,61248,0,0,143,143,0,1,0,1,0
26679,34021,0,0,62,62,0,1,0,1,0
9645,3389,9645,3389,293,223,70,4,1,3,1
13715,3389,13715,3389,293,223,70,4,0,3,1
60814,31652,0,0,62,62,0,1,0,1,0
16157,3389,16157,3389,293,223,70,4,0,3,1
51847,32703,0,0,67,67,0,1,0,1,0
23112,29294,0,0,108,108,0,1,0,1,0
10342,3389,10342,3389,293,223,70,4,0,3,1
10383,5361,7011,2598,259,205,53,3,0,2,0
33492,3389,33492,3389,293,223,70,4,1,3,1
11311,3389,11311,3389,293,223,70,4,0,3,1
9920,61248,0,0,141,141,0,1,0,1,0
18930,3389,18930,3389,293,223,70,4,0,3,1
24682,31206,0,0,89,89,0,1,0,1,0
29423,31376,0,0,89,89,0,1,0,1,0
22003,61248,0,0,158,158,0,1,0,1,0
49052,30576,0,0,150,150,0,1,0,1,0
36652,3389,36652,3389,293,223,70,4,0,3,1
28061,25590,0,0,145,145,0,1,0,1,0
8948,25773,0,0,153,153,0,1,0,1,0
10974,3389,10974,3389,293,223,70,4,0,3,1
6926,25773,0,0,141,141,0,1,0,1,0
34157,3389,34157,3389,293,223,70,4,0,3,1
24513,793,0,0,67,67,0,1,0,1,0
40187,5842,0,0,146,146,0,1,0,1,0
49635,27417,0,0,138,138,0,1,0,1,0
50539,34021,0,0,112,112,0,1,0,1,0
6233,23055,0,0,152,152,0,1,0,1,0
25574,25773,0,0,146,146,0,1,0,1,0
56906,52753,0,0,145,145,0,1,0,1,0
12553,60529,0,0,136,136,0,1,0,1,0
48987,27696,0,0,153,153,0,1,0,1,0
62739,3729,54230,2871,270,211,59,3,0,2,0
2254,23778,0,0,150,150,0,1,0,1,0
50676,32313,0,0,92,92,0,1,0,1,0
50210,32838,0,0,109,109,0,1,0,1,0
5453,24301,0,0,157,157,0,1,0,1,0
10396,59714,0,0,143,143,0,1,0,1,0
51298,31652,0,0,71,71,0,1,0,1,0
50486,32528,0,0,99,99,0,1,0,1,0
18741,27117,0,0,129,129,0,1,0,1,0
51628,17665,0,0,152,152,0,1,0,1,0
49160,33334,0,0,146,146,0,1,0,1,0
13605,9779,2681,828,183,166,17,1,0,1,0
9820,25773,0,0,140,140,0,1,0,1,0
3392,27667,0,0,143,143,0,1,0,1,0
15943,28739,0,0,111,111,0,1,0,1,0
49160,33352,0,0,146,146,0,1,0,1,0
13321,25773,0,0,149,149,0,1,0,1,0
14182,11177,868,268,159,153,5,1,0,1,0
17733,25773,0,0,142,142,0,1,0,1,0
11487,3389,11487,3389,293,223,70,4,0,3,1
21844,32876,0,0,73,73,0,1,0,1,0
55823,31652,0,0,62,62,0,1,0,1,0
32017,2497,0,0,99,99,0,1,0,1,0
55453,31652,0,0,62,62,0,1,0,1,0
41497,60253,0,0,79,79,0,1,0,1,0
59244,61151,0,0,138,138,0,1,0,1,0
51754,31652,0,0,62,62,0,1,0,1,0
28528,3389,28528,3389,293,223,70,4,0,3,1
52058,5618,0,0,145,145,0,1,0,1,0
15528,3389,15528,3389,293,223,70,4,0,3,1
7301,25322,0,0,157,157,0,1,0,1,0
48334,5618,0,0,145,145,0,1,0,1,0
51514,31652,0,0,67,67,0,1,0,1,0
28072,34021,0,0,62,62,0,1,0,1,0
39022,34021,0,0,101,101,0,1,0,1,0
12478,24522,0,0,139,139,0,1,0,1,0
18175,18338,0,0,62,62,0,1,0,1,0
29416,34021,0,0,62,62,0,1,0,1,0
14903,61248,0,0,144,144,0,1,0,1,0
3146,23027,0,0,157,157,0,1,0,1,0
50436,5618,0,0,145,145,0,1,0,1,0
25082,23358,0,0,120,120,0,1,0,1,0
49162,26303,0,0,148,148,0,1,0,1,0
50608,32390,0,0,95,95,0,1,0,1,0
49164,34021,0,0,145,145,0,1,0,1,0
50751,31652,0,0,90,90,0,1,0,1,0
22204,3389,22204,3389,293,223,70,4,0,3,1
11960,60759,0,0,139,139,0,1,0,1,0
50291,31652,0,0,106,106,0,1,0,1,0
22233,805,2994,805,116,100,16,1,0,1,0
11870,5577,8129,2512,255,203,51,3,0,2,0
27197,34021,0,0,62,62,0,1,0,1,0
49737,32051,0,0,131,131,0,1,0,1,0
18785,3389,18785,3389,293,223,70,4,0,3,1
27121,25773,0,0,147,147,0,1,0,1,0
12886,21913,0,0,141,141,0,1,0,1,0
20874,3389,20874,3389,293,223,70,4,0,3,1
51701,31652,0,0,63,63,0,1,0,1,0
20058,40450,0,0,80,80,0,1,0,1,0
23217,3389,23217,3389,293,223,70,4,0,3,1
29941,34021,0,0,62,62,0,1,0,1,0
52092,33145,0,0,65,65,0,1,0,1,0
19862,29198,0,0,109,109,0,1,0,1,0
3694,40473,0,0,148,148,0,1,0,1,0
4110,49239,0,0,144,144,0,1,0,1,0
15019,25773,0,0,147,147,0,1,0,1,0
59672,61186,0,0,140,140,0,1,0,1,0
22862,33453,0,0,67,67,0,1,0,1,0
9354,3389,9354,3389,293,223,70,4,1,3,1
24123,34021,0,0,62,62,0,1,0,1,0
27553,32363,0,0,78,78,0,1,0,1,0
36353,8593,0,0,146,146,0,1,0,1,0
19037,61248,0,0,154,154,0,1,0,1,0
19054,31260,0,0,87,87,0,1,0,1,0
32159,19401,0,0,147,147,0,1,0,1,0
52280,33371,0,0,66,66,0,1,0,1,0
2911,22897,0,0,157,157,0,1,0,1,0
16104,2449,9110,2449,228,178,50,3,0,2,0
60592,3389,60592,3389,293,223,70,4,0,3,1
5712,25773,0,0,142,142,0,1,0,1,0
17822,3389,17822,3389,293,223,70,4,0,3,1
24679,25773,0,0,146,146,0,1,0,1,0
50308,29270,0,0,106,106,0,1,0,1,0
50390,29476,0,0,103,103,0,1,0,1,0
12704,3389,12704,3389,293,223,70,4,0,3,1
21059,3389,21059,3389,293,223,70,4,1,3,1
50107,32954,0,0,112,112,0,1,0,1,0
20308,19782,0,0,79,79,0,1,0,1,0
7026,23984,0,0,123,123,0,1,0,1,0
18727,3389,18727,3389,293,223,70,4,0,3,1
24489,3389,24489,3389,293,223,70,4,0,3,1
25480,34021,0,0,62,62,0,1,0,1,0
11864,61248,0,0,139,139,0,1,0,1,0
20066,61248,0,0,154,154,0,1,0,1,0
14414,23083,0,0,111,111,0,1,0,1,0
20300,3389,20300,3389,293,223,70,4,0,3,1
7811,25604,0,0,157,157,0,1,0,1,0
28663,34021,0,0,62,62,0,1,0,1,0
13317,25773,0,0,139,139,0,1,0,1,0
37313,3389,37313,3389,293,223,70,4,0,3,1
11380,3389,11380,3389,293,223,70,4,1,3,1
29752,34021,0,0,62,62,0,1,0,1,0
18099,25840,0,0,142,142,0,1,0,1,0
21874,35589,0,0,66,66,0,1,0,1,0
49081,29858,0,0,149,149,0,1,0,1,0
17583,3389,17583,3389,293,223,70,4,0,3,1
22725,34021,0,0,62,62,0,1,0,1,0
13762,3389,13762,3389,293,223,70,4,0,3,1
3018,42719,0,0,146,146,0,1,0,1,0
51802,32622,0,0,67,67,0,1,0,1,0
47225,34021,0,0,137,137,0,1,0,1,0
3966,23480,0,0,157,157,0,1,0,1,0
47375,34021,0,0,138,138,0,1,0,1,0
11260,61248,0,0,142,142,0,1,0,1,0
38851,6800,0,0,146,146,0,1,0,1,0
49667,33561,0,0,129,129,0,1,0,1,0
21870,3389,21870,3389,293,223,70,4,0,3,1
29500,31761,0,0,85,85,0,1,0,1,0
10180,3389,10180,3389,293,223,70,4,1,3,1
37252,3389,37252,3389,293,223,70,4,1,3,1
12816,22359,0,0,141,141,0,1,0,1,0
20245,3389,20245,3389,293,223,70,4,0,3,1
28748,3389,28748,3389,293,223,70,4,0,3,1
49418,27056,0,0,138,138,0,1,0,1,0
14829,3389,14829,3389,293,223,70,4,0,3,1
45980,5618,0,0,145,145,0,1,0,1,0
59290,4651,27744,1468,209,178,30,2,0,1,0
33323,34021,0,0,76,76,0,1,0,1,0
13430,9356,3230,998,190,170,20,1,0,1,0
17955,17741,0,0,68,68,0,1,0,1,0
20793,3389,20793,3389,293,223,70,4,0,3,1
24987,3389,24987,3389,293,223,70,4,0,3,1
29667,34021,0,0,62,62,0,1,0,1,0
7436,61248,0,0,139,139,0,1,0,1,0
38005,7407,0,0,146,146,0,1,0,1,0
9348,3713,8792,3258,287,220,67,3,0,2,0
10106,25773,0,0,148,148,0,1,0,1,0
14734,25773,0,0,140,140,0,1,0,1,0
11038,25773,0,0,139,139,0,1,0,1,0
12291,25762,0,0,138,138,0,1,0,1,0
11858,25773,0,0,143,143,0,1,0,1,0
55906,31652,0,0,68,68,0,1,0,1,0
17407,25773,0,0,142,142,0,1,0,1,0
51342,30760,0,0,76,76,0,1,0,1,0
17589,3389,17589,3389,293,223,70,4,0,3,1
19542,61248,0,0,153,153,0,1,0,1,0
2924,20438,0,0,155,155,0,1,0,1,0
11139,3806,10426,3221,285,219,66,3,0,2,0
54286,14907,0,0,115,115,0,1,0,1,0
55840,45565,0,0,101,101,0,1,0,1,0
32985,3389,32985,3389,293,223,70,4,0,3,1
51216,30502,0,0,80,80,0,1,0,1,0
34659,3389,34659,3389,293,223,70,4,0,3,1
24759,30777,0,0,95,95,0,1,0,1,0
51618,31652,0,0,65,65,0,1,0,1,0
10360,5325,7051,2613,259,205,53,3,0,2,0
3463,25670,0,0,143,143,0,1,0,1,0
49764,31652,0,0,124,124,0,1,0,1,0
28283,25757,0,0,147,147,0,1,0,1,0
9990,3389,9990,3389,293,223,70,4,0,3,1
10903,25773,0,0,144,144,0,1,0,1,0
37356,7873,0,0,146,146,0,1,0,1,0
8597,25773,0,0,156,156,0,1,0,1,0
23208,21954,0,0,104,104,0,1,0,1,0
11902,7778,4398,1630,217,184,33,2,0,1,0
37136,3389,37136,3389,293,223,70,4,1,3,1
12454,3389,12454,3389,293,223,70,4,1,3,1
11699,61248,0,0,141,141,0,1,0,1,0
59753,58937,0,0,137,137,0,1,0,1,0
25017,30413,0,0,99,99,0,1,0,1,0
6214,49026,0,0,147,147,0,1,0,1,0
48718,6793,0,0,145,145,0,1,0,1,0
15045,14144,0,0,147,147,0,1,0,1,0
25326,34021,0,0,62,62,0,1,0,1,0
51219,31652,0,0,73,73,0,1,0,1,0
7034,25773,0,0,153,153,0,1,0,1,0
10372,25773,0,0,147,147,0,1,0,1,0
14478,11881,0,0,147,147,0,1,0,1,0
50333,32465,0,0,117,117,0,1,0,1,0
17881,61248,0,0,153,153,0,1,0,1,0
53979,38887,0,0,76,76,0,1,0,1,0
51370,31652,0,0,69,69,0,1,0,1,0
55452,31652,0,0,62,62,0,1,0,1,0
13066,20756,0,0,142,142,0,1,0,1,0
18840,3389,18840,3389,293,223,70,4,0,3,1
17585,61248,0,0,149,149,0,1,0,1,0
18292,3389,18292,3389,293,223,70,4,0,3,1
18500,3389,18500,3389,293,223,70,4,0,3,1
51926,32845,0,0,66,66,0,1,0,1,0
22023,3389,22023,3389,293,223,70,4,0,3,1
36524,8470,0,0,146,146,0,1,0,1,0
8721,61248,0,0,140,140,0,1,0,1,0
57034,49496,0,0,109,109,0,1,0,1,0
5091,25773,0,0,142,142,0,1,0,1,0
28279,3389,28279,3389,293,223,70,4,0,3,1
6423,25773,0,0,141,141,0,1,0,1,0
6746,17592,0,0,153,153,0,1,0,1,0
14267,11383,602,186,155,152,3,1,0,1,0
21713,945,3513,944,126,106,19,1,0,1,0
1568,22706,0,0,153,153,0,1,0,1,0
21145,61248,0,0,157,157,0,1,0,1,0
53138,22571,0,0,90,90,0,1,0,1,0
12283,61248,0,0,139,139,0,1,0,1,0
36366,34021,0,0,90,90,0,1,0,1,0
11866,25773,0,0,140,140,0,1,0,1,0
6095,51912,0,0,142,142,0,1,0,1,0
49899,31652,0,0,120,120,0,1,0,1,0
5954,57125,0,0,140,140,0,1,0,1,0
14550,3389,14550,3389,293,223,70,4,0,3,1
14107,14097,0,0,146,146,0,1,0,1,0
50503,32805,0,0,102,102,0,1,0,1,0
17280,19468,0,0,74,74,0,1,0,1,0
12803,22440,0,0,141,141,0,1,0,1,0
28708,3389,28708,3389,293,223,70,4,1,3,1
57887,31652,0,0,62,62,0,1,0,1,0
16429,61248,0,0,150,150,0,1,0,1,0
20228,1189,3847,1189,143,118,24,2,0,1,0
14945,22413,0,0,104,104,0,1,0,1,0
28167,32428,0,0,78,78,0,1,0,1,0
40886,3389,40886,3389,293,223,70,4,0,3,1
11706,3389,11706,3389,293,223,70,4,0,3,1
1583,22729,0,0,153,153,0,1,0,1,0
11174,3892,10313,3187,284,218,65,3,0,2,0
14734,3389,14734,3389,293,223,70,4,0,3,1
22991,34021,0,0,62,62,0,1,0,1,0
13537,17743,0,0,144,144,0,1,0,1,0
51832,32676,0,0,67,67,0,1,0,1,0
16805,15803,0,0,94,94,0,1,0,1,0
10367,3389,10367,3389,293,223,70,4,1,3,1
50756,32576,0,0,94,94,0,1,0,1,0
55857,45623,0,0,101,101,0,1,0,1,0
50425,60426,0,0,88,88,0,1,0,1,0
24498,22921,0,0,115,115,0,1,0,1,0
51286,31652,0,0,71,71,0,1,0,1,0
50790,32186,0,0,88,88,0,1,0,1,0
50203,29009,0,0,110,110,0,1,0,1,0
4579,53127,0,0,142,142,0,1,0,1,0
21655,33368,0,0,68,68,0,1,0,1,0
11622,3389,11622,3389,293,223,70,4,1,3,1
38983,6706,0,0,146,146,0,1,0,1,0
52454,33797,0,0,62,62,0,1,0,1,0
49547,27218,0,0,140,140,0,1,0,1,0
11797,3389,11797,3389,293,223,70,4,0,3,1
27760,13225,0,0,107,107,0,1,0,1,0
35021,3389,35021,3389,293,223,70,4,0,3,1
11285,4159,9967,3080,279,216,63,3,0,2,0
49439,26870,0,0,139,139,0,1,0,1,0
50435,32867,0,0,105,105,0,1,0,1,0
21151,3389,21151,3389,293,223,70,4,0,3,1
49160,32663,0,0,146,146,0,1,0,1,0
37024,3389,37024,3389,293,223,70,4,0,3,1
22195,29178,0,0,109,109,0,1,0,1,0
8882,61248,0,0,139,139,0,1,0,1,0
10277,24167,0,0,136,136,0,1,0,1,0
22079,33712,0,0,64,64,0,1,0,1,0
48935,26510,0,0,155,155,0,1,0,1,0
11577,25773,0,0,142,142,0,1,0,1,0
11659,3389,11659,3389,293,223,70,4,0,3,1
10525,59928,0,0,143,143,0,1,0,1,0
54723,3389,54723,3389,293,223,70,4,0,3,1
50402,29137,0,0,118,118,0,1,0,1,0
19042,3389,19042,3389,293,223,70,4,0,3,1
42475,7847,0,0,145,145,0,1,0,1,0
12553,3389,12553,3389,293,223,70,4,0,3,1
11428,3389,11428,3389,293,223,70,4,0,3,1
58938,3389,58938,3389,293,223,70,4,0,3,1
52504,33855,0,0,63,63,0,1,0,1,0
10287,61248,0,0,139,139,0,1,0,1,0
10943,3389,10943,3389,293,223,70,4,1,3,1
62051,3389,62051,3389,293,223,70,4,0,3,1
4717,25773,0,0,142,142,0,1,0,1,0
62412,31652,0,0,62,62,0,1,0,1,0
18181,20507,0,0,86,86,0,1,0,1,0
28199,25922,0,0,146,146,0,1,0,1,0
49160,31882,0,0,146,146,0,1,0,1,0
52506,33971,0,0,63,63,0,1,0,1,0
12110,25773,0,0,139,139,0,1,0,1,0
52528,33930,0,0,62,62,0,1,0,1,0
47131,48246,0,0,96,96,0,1,0,1,0
3851,25773,0,0,142,142,0,1,0,1,0
35264,8492,0,0,141,141,0,1,0,1,0
7481,25773,0,0,141,141,0,1,0,1,0
52212,32938,0,0,62,62,0,1,0,1,0
13197,56653,0,0,129,129,0,1,0,1,0
21942,61248,0,0,158,158,0,1,0,1,0
17798,61248,0,0,150,150,0,1,0,1,0
9346,3389,9346,3389,293,223,70,4,1,3,1
18727,3389,18727,3389,293,223,70,4,0,3,1
47774,42987,0,0,112,112,0,1,0,1,0
12222,61248,0,0,139,139,0,1,0,1,0
20044,27426,0,0,126,126,0,1,0,1,0
52219,33772,0,0,70,70,0,1,0,1,0
13040,3389,13040,3389,293,223,70,4,0,3,1
12391,25773,0,0,139,139,0,1,0,1,0
19725,25773,0,0,143,143,0,1,0,1,0
17559,42865,0,0,87,87,0,1,0,1,0
34348,7717,0,0,134,134,0,1,0,1,0
3379,23155,0,0,157,157,0,1,0,1,0
49485,31652,0,0,134,134,0,1,0,1,0
27933,34021,0,0,62,62,0,1,0,1,0
8682,25351,0,0,151,151,0,1,0,1,0
49233,31703,0,0,144,144,0,1,0,1,0
54848,8085,0,0,146,146,0,1,0,1,0
13185,19996,0,0,142,142,0,1,0,1,0
59863,59345,0,0,139,139,0,1,0,1,0
31837,5591,0,0,114,114,0,1,0,1,0
22514,34021,0,0,62,62,0,1,0,1,0
17935,3389,17935,3389,293,223,70,4,0,3,1
52615,33485,0,0,127,127,0,1,0,1,0
7684,25773,0,0,155,155,0,1,0,1,0
26279,25773,0,0,147,147,0,1,0,1,0
24405,34021,0,0,62,62,0,1,0,1,0
50964,29986,0,0,88,88,0,1,0,1,0
49147,33621,0,0,146,146,0,1,0,1,0
18086,23540,0,0,118,118,0,1,0,1,0
9830,24498,0,0,140,140,0,1,0,1,0
9376,58013,0,0,143,143,0,1,0,1,0
30781,11632,0,0,121,121,0,1,0,1,0
32249,3389,32249,3389,293,223,70,4,0,3,1
16895,9168,0,0,128,128,0,1,0,1,0
20681,3389,20681,3389,293,223,70,4,0,3,1
51132,31801,0,0,76,76,0,1,0,1,0
20822,3389,20822,3389,293,223,70,4,0,3,1
18678,3389,18678,3389,293,223,70,4,0,3,1
21011,3389,21011,3389,293,223,70,4,0,3,1
51972,33601,0,0,76,76,0,1,0,1,0
48129,40085,0,0,121,121,0,1,0,1,0
52120,32993,0,0,73,73,0,1,0,1,0
11872,3389,11872,3389,293,223,70,4,0,3,1
11691,25773,0,0,141,141,0,1,0,1,0
51691,32422,0,0,68,68,0,1,0,1,0
8776,61248,0,0,139,139,0,1,0,1,0
29368,3500,0,0,94,94,0,1,0,1,0
11537,61248,0,0,144,144,0,1,0,1,0
13973,3389,13973,3389,293,223,70,4,0,3,1
26088,34021,0,0,62,62,0,1,0,1,0
26121,25773,0,0,146,146,0,1,0,1,0
14575,3389,14575,3389,293,223,70,4,0,3,1
15538,3389,15538,3389,293,223,70,4,0,3,1
53959,5618,0,0,145,145,0,1,0,1,0
1995,23374,0,0,151,151,0,1,0,1,0
14030,3389,14030,3389,293,223,70,4,0,3,1
50369,34021,0,0,116,116,0,1,0,1,0
49076,29741,0,0,149,149,0,1,0,1,0
49160,32149,0,0,146,146,0,1,0,1,0
11143,25376,0,0,140,140,0,1,0,1,0
16087,56608,0,0,154,154,0,1,0,1,0
51753,31652,0,0,62,62,0,1,0,1,0
20090,3389,20090,3389,293,223,70,4,0,3,1
27965,32648,0,0,75,75,0,1,0,1,0
20891,3389,20891,3389,293,223,70,4,0,3,1
45889,59283,0,0,62,62,0,1,0,1,0
13717,16591,0,0,144,144,0,1,0,1,0
49112,30559,0,0,148,148,0,1,0,1,0
20078,3389,20078,3389,293,223,70,4,0,3,1
2813,22476,0,0,154,154,0,1,0,1,0
50620,31652,0,0,99,99,0,1,0,1,0
21198,3389,21198,3389,293,223,70,4,0,3,1
14519,25773,0,0,143,143,0,1,0,1,0
56623,52070,0,0,145,145,0,1,0,1,0
51043,31100,0,0,79,79,0,1,0,1,0
21383,35964,0,0,67,67,0,1,0,1,0
56939,33151,0,0,62,62,0,1,0,1,0
4914,25773,0,0,147,147,0,1,0,1,0
45719,59799,0,0,62,62,0,1,0,1,0
10494,24006,0,0,134,134,0,1,0,1,0
54893,5750,0,0,145,145,0,1,0,1,0
21931,3389,21931,3389,293,223,70,4,0,3,1
50928,31652,0,0,83,83,0,1,0,1,0
52380,3389,52380,3389,293,223,70,4,0,3,1
7169,25250,0,0,157,157,0,1,0,1,0
11018,23616,0,0,129,129,0,1,0,1,0
18565,26790,0,0,133,133,0,1,0,1,0
9387,25773,0,0,151,151,0,1,0,1,0
16769,3389,16769,3389,293,223,70,4,0,3,1
13947,25773,0,0,148,148,0,1,0,1,0
18193,44448,0,0,93,93,0,1,0,1,0
28761,34021,0,0,62,62,0,1,0,1,0
59372,58717,0,0,145,145,0,1,0,1,0
49160,32547,0,0,146,146,0,1,0,1,0
2721,24509,0,0,147,147,0,1,0,1,0
16305,14961,0,0,106,106,0,1,0,1,0
48498,24802,0,0,156,156,0,1,0,1,0
13142,3389,13142,3389,293,223,70,4,0,3,1
62125,3894,49510,2621,259,205,54,3,0,2,0
16005,3389,16005,3389,293,223,70,4,0,3,1
3112,23008,0,0,157,157,0,1,0,1,0
17672,17264,0,0,75,75,0,1,0,1,0
20331,3389,20331,3389,293,223,70,4,0,3,1
36587,60505,0,0,99,99,0,1,0,1,0
10103,3389,10103,3389,293,223,70,4,0,3,1
38018,3389,38018,3389,293,223,70,4,1,3,1
49249,26635,0,0,144,144,0,1,0,1,0
56349,31652,0,0,68,68,0,1,0,1,0
29480,34021,0,0,62,62,0,1,0,1,0
42342,7869,0,0,145,145,0,1,0,1,0
28957,60897,0,0,130,130,0,1,0,1,0
50739,31652,0,0,90,90,0,1,0,1,0
10181,25773,0,0,148,148,0,1,0,1,0
22771,31230,0,0,88,88,0,1,0,1,0
51654,32355,0,0,69,69,0,1,0,1,0
20673,25773,0,0,144,144,0,1,0,1,0
60199,61229,0,0,143,143,0,1,0,1,0
18679,3389,18679,3389,293,223,70,4,0,3,1
10514,61248,0,0,142,142,0,1,0,1,0
20985,3389,20985,3389,293,223,70,4,0,3,1
12840,25070,0,0,131,131,0,1,0,1,0
37308,3389,37308,3389,293,223,70,4,1,3,1
27966,33933,0,0,62,62,0,1,0,1,0
49024,28541,0,0,151,151,0,1,0,1,0
16787,3389,16787,3389,293,223,70,4,0,3,1
14457,21061,0,0,97,97,0,1,0,1,0
8608,55702,0,0,141,141,0,1,0,1,0
3515,25954,0,0,143,143,0,1,0,1,0
7302,17177,0,0,152,152,0,1,0,1,0
50158,3389,50158,3389,293,223,70,4,0,3,1
2482,24136,0,0,148,148,0,1,0,1,0
49149,31423,0,0,146,146,0,1,0,1,0
29437,60872,0,0,128,128,0,1,0,1,0
2153,45977,0,0,144,144,0,1,0,1,0
18410,3389,18410,3389,293,223,70,4,0,3,1
15025,22312,0,0,103,103,0,1,0,1,0
55394,44036,0,0,96,96,0,1,0,1,0
39923,6570,0,0,146,146,0,1,0,1,0
4424,52676,0,0,142,142,0,1,0,1,0
37219,60473,0,0,96,96,0,1,0,1,0
52340,33592,0,0,63,63,0,1,0,1,0
16428,19555,0,0,145,145,0,1,0,1,0
47920,60221,0,0,74,74,0,1,0,1,0
55273,8006,0,0,138,138,0,1,0,1,0
51201,31652,0,0,80,80,0,1,0,1,0
21887,3389,21887,3389,293,223,70,4,0,3,1
48732,5618,0,0,145,145,0,1,0,1,0
11061,60823,0,0,143,143,0,1,0,1,0
32965,3389,32965,3389,293,223,70,4,0,3,1
52280,33137,0,0,62,62,0,1,0,1,0
50700,32287,0,0,91,91,0,1,0,1,0
51118,32249,0,0,83,83,0,1,0,1,0
1058,21872,0,0,157,157,0,1,0,1,0
14191,13560,0,0,146,146,0,1,0,1,0
29843,34021,0,0,62,62,0,1,0,1,0
21116,32931,0,0,72,72,0,1,0,1,0
1938,23284,0,0,151,151,0,1,0,1,0
17216,3389,17216,3389,293,223,70,4,0,3,1
26409,33123,0,0,70,70,0,1,0,1,0
9249,3389,9249,3389,293,223,70,4,0,3,1
49076,29731,0,0,149,149,0,1,0,1,0
49160,31722,0,0,146,146,0,1,0,1,0
50195,31652,0,0,109,109,0,1,0,1,0
12795,25126,0,0,132,132,0,1,0,1,0
25000,34021,0,0,62,62,0,1,0,1,0
51355,31652,0,0,70,70,0,1,0,1,0
64254,33162,0,0,66,66,0,1,0,1,0
52448,33638,0,0,62,62,0,1,0,1,0
12450,3389,12450,3389,293,223,70,4,0,3,1
11449,3389,11449,3389,293,223,70,4,1,3,1
10641,3389,10641,3389,293,223,70,4,0,3,1
53672,38139,0,0,80,80,0,1,0,1,0
49736,33372,0,0,125,125,0,1,0,1,0
48941,26661,0,0,155,155,0,1,0,1,0
50581,34021,0,0,111,111,0,1,0,1,0
11918,3162,10235,3162,277,212,65,3,0,2,0
51527,31652,0,0,66,66,0,1,0,1,0
11044,3389,11044,3389,293,223,70,4,1,3,1
52003,33622,0,0,76,76,0,1,0,1,0
2380,46355,0,0,144,144,0,1,0,1,0
9728,61248,0,0,139,139,0,1,0,1,0
50380,32916,0,0,106,106,0,1,0,1,0
62727,44345,0,0,97,97,0,1,0,1,0
17043,16204,0,0,89,89,0,1,0,1,0
5428,55597,0,0,141,141,0,1,0,1,0
52312,33542,0,0,64,64,0,1,0,1,0
19347,59111,0,0,157,157,0,1,0,1,0
48912,26066,0,0,156,156,0,1,0,1,0
5591,25773,0,0,149,149,0,1,0,1,0
20815,3389,20815,3389,293,223,70,4,0,3,1
11621,3389,11621,3389,293,223,70,4,1,3,1
20734,3389,20734,3389,293,223,70,4,0,3,1
18085,3389,18085,3389,293,223,70,4,0,3,1
14881,25773,0,0,143,143,0,1,0,1,0
29171,30116,0,0,102,102,0,1,0,1,0
17796,3389,17796,3389,293,223,70,4,0,3,1
52297,33515,0,0,64,64,0,1,0,1,0
12565,7260,5947,1837,226,188,37,2,0,2,0
29076,34021,0,0,62,62,0,1,0,1,0
28185,31566,0,0,87,87,0,1,0,1,0
13649,3389,13649,3389,293,223,70,4,0,3,1
3936,25773,0,0,143,143,0,1,0,1,0
8128,55934,0,0,143,143,0,1,0,1,0
28890,28708,0,0,117,117,0,1,0,1,0
17888,25270,0,0,143,143,0,1,0,1,0
1247,21931,0,0,156,156,0,1,0,1,0
47503,6998,0,0,145,145,0,1,0,1,0
15849,3389,15849,3389,293,223,70,4,0,3,1
63894,31652,0,0,62,62,0,1,0,1,0
52513,5618,0,0,145,145,0,1,0,1,0
22557,719,2671,718,110,96,14,1,0,1,0
9525,61248,0,0,139,139,0,1,0,1,0
2734,24530,0,0,147,147,0,1,0,1,0
50535,6486,0,0,145,145,0,1,0,1,0
13342,12679,0,0,148,148,0,1,0,1,0
51989,5618,0,0,145,145,0,1,0,1,0
62952,31652,0,0,70,70,0,1,0,1,0
54321,5618,0,0,145,145,0,1,0,1,0
11901,60669,0,0,139,139,0,1,0,1,0
9183,25773,0,0,140,140,0,1,0,1,0
16515,20432,0,0,84,84,0,1,0,1,0
3448,25646,0,0,143,143,0,1,0,1,0
23832,3389,23832,3389,293,223,70,4,0,3,1
8996,25773,0,0,153,153,0,1,0,1,0
26186,28763,0,0,116,116,0,1,0,1,0
35316,10111,0,0,146,146,0,1,0,1,0
22993,3389,22993,3389,293,223,70,4,0,3,1
16829,15843,0,0,94,94,0,1,0,1,0
31766,5531,0,0,113,113,0,1,0,1,0
2164,23638,0,0,150,150,0,1,0,1,0
2922,24824,0,0,146,146,0,1,0,1,0
48953,27382,0,0,154,154,0,1,0,1,0
3068,32136,0,0,143,143,0,1,0,1,0
18605,3389,18605,3389,293,223,70,4,0,3,1
29862,34021,0,0,62,62,0,1,0,1,0
27599,3389,27599,3389,293,223,70,4,0,3,1
33438,6946,0,0,127,127,0,1,0,1,0
3520,41051,0,0,147,147,0,1,0,1,0
17719,2016,7498,2016,199,157,41,2,0,2,0
51774,31652,0,0,62,62,0,1,0,1,0
35621,3389,35621,3389,293,223,70,4,0,3,1
52963,31652,0,0,125,125,0,1,0,1,0
49005,29057,0,0,152,152,0,1,0,1,0
40526,3389,40526,3389,293,223,70,4,0,3,1
54625,5618,0,0,145,145,0,1,0,1,0
16983,25773,0,0,143,143,0,1,0,1,0
15100,3389,15100,3389,293,223,70,4,0,3,1
19265,3389,19265,3389,293,223,70,4,0,3,1
48407,3389,48407,3389,293,223,70,4,0,3,1
28149,33315,0,0,69,69,0,1,0,1,0
18818,3389,18818,3389,293,223,70,4,0,3,1
8754,25773,0,0,154,154,0,1,0,1,0
58335,54014,0,0,122,122,0,1,0,1,0
11837,3389,11837,3389,293,223,70,4,0,3,1
54686,8568,0,0,146,146,0,1,0,1,0
13187,19982,0,0,142,142,0,1,0,1,0
50511,32500,0,0,98,98,0,1,0,1,0
2152,23619,0,0,150,150,0,1,0,1,0
54462,3389,54462,3389,293,223,70,4,0,3,1
12236,25773,0,0,139,139,0,1,0,1,0
12053,61248,0,0,139,139,0,1,0,1,0
2264,45227,0,0,145,145,0,1,0,1,0
64124,31652,0,0,62,62,0,1,0,1,0
27002,1497,0,0,76,76,0,1,0,1,0
60637,59650,0,0,140,140,0,1,0,1,0
39754,3389,39754,3389,293,223,70,4,0,3,1
19302,28158,0,0,119,119,0,1,0,1,0
50056,33011,0,0,114,114,0,1,0,1,0
19627,3389,19627,3389,293,223,70,4,0,3,1
51098,30260,0,0,84,84,0,1,0,1,0
3974,22880,0,0,152,152,0,1,0,1,0
8422,59352,0,0,133,133,0,1,0,1,0
7153,53507,0,0,142,142,0,1,0,1,0
2008,23394,0,0,151,151,0,1,0,1,0
28277,27104,0,0,134,134,0,1,0,1,0
14653,3389,14653,3389,293,223,70,4,0,3,1
9289,61248,0,0,140,140,0,1,0,1,0
18499,3389,18499,3389,293,223,70,4,0,3,1
3006,24956,0,0,145,145,0,1,0,1,0
5895,24545,0,0,157,157,0,1,0,1,0
50249,28524,0,0,112,112,0,1,0,1,0
14268,61248,0,0,143,143,0,1,0,1,0
39186,3389,39186,3389,293,223,70,4,0,3,1
49706,31652,0,0,128,128,0,1,0,1,0
8156,61248,0,0,139,139,0,1,0,1,0
17326,3389,17326,3389,293,223,70,4,0,3,1
21137,3389,21137,3389,293,223,70,4,0,3,1
36877,3389,36877,3389,293,223,70,4,1,3,1
9808,61248,0,0,141,141,0,1,0,1,0
13013,24619,0,0,147,147,0,1,0,1,0
32310,5992,0,0,118,118,0,1,0,1,0
15795,17076,0,0,146,146,0,1,0,1,0
25801,3389,25801,3389,293,223,70,4,0,3,1
12156,61248,0,0,139,139,0,1,0,1,0
31176,60783,0,0,121,121,0,1,0,1,0
18583,3389,18583,3389,293,223,70,4,0,3,1
8775,61248,0,0,140,140,0,1,0,1,0
9313,61248,0,0,139,139,0,1,0,1,0
50380,31652,0,0,103,103,0,1,0,1,0
38512,7044,0,0,146,146,0,1,0,1,0
11707,60376,0,0,139,139,0,1,0,1,0
18827,3389,18827,3389,293,223,70,4,0,3,1
50954,30879,0,0,83,83,0,1,0,1,0
12741,3389,12741,3389,293,223,70,4,0,3,1
17183,19590,0,0,75,75,0,1,0,1,0
12474,3389,12474,3389,293,223,70,4,1,3,1
28928,34021,0,0,62,62,0,1,0,1,0
35637,9395,0,0,146,146,0,1,0,1,0
45253,34021,0,0,128,128,0,1,0,1,0
49081,31510,0,0,149,149,0,1,0,1,0
36902,34021,0,0,92,92,0,1,0,1,0
18395,26475,0,0,136,136,0,1,0,1,0
20226,61248,0,0,156,156,0,1,0,1,0
18030,25334,0,0,138,138,0,1,0,1,0
10405,61248,0,0,143,143,0,1,0,1,0
48904,25797,0,0,156,156,0,1,0,1,0
49211,26403,0,0,146,146,0,1,0,1,0
26229,367,0,0,67,67,0,1,0,1,0
11736,61248,0,0,141,141,0,1,0,1,0
29886,3389,29886,3389,293,223,70,4,0,3,1
13742,21592,0,0,104,104,0,1,0,1,0
51615,31652,0,0,65,65,0,1,0,1,0
51863,31902,0,0,62,62,0,1,0,1,0
16679,3389,16679,3389,293,223,70,4,0,3,1
49160,32989,0,0,146,146,0,1,0,1,0
8472,56508,0,0,143,143,0,1,0,1,0
16451,25773,0,0,141,141,0,1,0,1,0
13542,9627,2878,889,186,167,18,1,0,1,0
14575,11719,0,0,147,147,0,1,0,1,0
13081,8511,4326,1336,205,177,27,2,0,1,0
5136,25773,0,0,143,143,0,1,0,1,0
9010,15905,0,0,151,151,0,1,0,1,0
17351,16724,0,0,82,82,0,1,0,1,0
14684,48052,0,0,101,101,0,1,0,1,0
49014,29344,0,0,152,152,0,1,0,1,0
27865,969,0,0,76,76,0,1,0,1,0
38226,3389,38226,3389,293,223,70,4,0,3,1
22429,33962,0,0,62,62,0,1,0,1,0
29271,34021,0,0,62,62,0,1,0,1,0
51014,32343,0,0,86,86,0,1,0,1,0
14378,3389,14378,3389,293,223,70,4,0,3,1
1644,22196,0,0,157,157,0,1,0,1,0
14415,3389,14415,3389,293,223,70,4,0,3,1
1852,23150,0,0,152,152,0,1,0,1,0
29599,32257,0,0,80,80,0,1,0,1,0
15626,61248,0,0,145,145,0,1,0,1,0
1276,21941,0,0,156,156,0,1,0,1,0
18737,3389,18737,3389,293,223,70,4,0,3,1
26611,3389,26611,3389,293,223,70,4,0,3,1
54857,42198,0,0,91,91,0,1,0,1,0
57681,31652,0,0,62,62,0,1,0,1,0
21407,3389,21407,3389,293,223,70,4,0,3,1
49020,5618,0,0,145,145,0,1,0,1,0
52728,3389,52728,3389,293,223,70,4,0,3,1
4295,23662,0,0,157,157,0,1,0,1,0
3101,47557,0,0,144,144,0,1,0,1,0
15377,25773,0,0,143,143,0,1,0,1,0
50912,32048,0,0,84,84,0,1,0,1,0
5040,50788,0,0,144,144,0,1,0,1,0
38024,7393,0,0,146,146,0,1,0,1,0
19857,59503,0,0,157,157,0,1,0,1,0
2551,22206,0,0,155,155,0,1,0,1,0
20774,4903,0,0,97,97,0,1,0,1,0
50260,28548,0,0,112,112,0,1,0,1,0
16405,20571,0,0,85,85,0,1,0,1,0
26410,31574,0,0,86,86,0,1,0,1,0
11686,3389,11686,3389,293,223,70,4,1,3,1
24978,3389,24978,3389,293,223,70,4,0,3,1
51709,31652,0,0,63,63,0,1,0,1,0
5427,18574,0,0,154,154,0,1,0,1,0
14242,23300,0,0,113,113,0,1,0,1,0
51678,31652,0,0,63,63,0,1,0,1,0
4122,25773,0,0,142,142,0,1,0,1,0
50982,32915,0,0,101,101,0,1,0,1,0
49766,27923,0,0,125,125,0,1,0,1,0
12570,22463,0,0,115,115,0,1,0,1,0
48910,25939,0,0,156,156,0,1,0,1,0
12552,3389,12552,3389,293,223,70,4,0,3,1
25310,23529,0,0,122,122,0,1,0,1,0
21055,16763,0,0,75,75,0,1,0,1,0
48127,41765,0,0,120,120,0,1,0,1,0
12227,6442,7008,2165,240,195,44,2,0,2,0
18224,19119,0,0,71,71,0,1,0,1,0
47664,6971,0,0,145,145,0,1,0,1,0
28857,28539,0,0,119,119,0,1,0,1,0
38104,3389,38104,3389,293,223,70,4,1,3,1
18953,6905,0,0,112,112,0,1,0,1,0
25684,61065,0,0,144,144,0,1,0,1,0
25442,34021,0,0,62,62,0,1,0,1,0
49039,30164,0,0,151,151,0,1,0,1,0
16066,3389,16066,3389,293,223,70,4,0,3,1
23140,34021,0,0,62,62,0,1,0,1,0
40094,5908,0,0,146,146,0,1,0,1,0
50146,32910,0,0,111,111,0,1,0,1,0
8278,25773,0,0,156,156,0,1,0,1,0
13906,15386,0,0,145,145,0,1,0,1,0
52459,33938,0,0,64,64,0,1,0,1,0
50725,32737,0,0,107,107,0,1,0,1,0
8534,25461,0,0,153,153,0,1,0,1,0
36575,12104,0,0,146,146,0,1,0,1,0
15768,14055,0,0,118,118,0,1,0,1,0
38289,3389,38289,3389,293,223,70,4,1,3,1
48445,37493,0,0,128,128,0,1,0,1,0
12863,3389,12863,3389,293,223,70,4,0,3,1
33609,17005,0,0,147,147,0,1,0,1,0
8689,61248,0,0,139,139,0,1,0,1,0
25359,29929,0,0,104,104,0,1,0,1,0
11358,3389,11358,3389,293,223,70,4,1,3,1
7193,25263,0,0,157,157,0,1,0,1,0
11889,3389,11889,3389,293,223,70,4,1,3,1
10325,3389,10325,3389,293,223,70,4,1,3,1
8215,61248,0,0,139,139,0,1,0,1,0
49574,33554,0,0,131,131,0,1,0,1,0
51638,31652,0,0,66,66,0,1,0,1,0
6401,25773,0,0,151,151,0,1,0,1,0
18109,3389,18109,3389,293,223,70,4,0,3,1
17583,61248,0,0,152,152,0,1,0,1,0
16620,20300,0,0,83,83,0,1,0,1,0
26683,3389,26683,3389,293,223,70,4,0,3,1
56966,49258,0,0,108,108,0,1,0,1,0
17872,3389,17872,3389,293,223,70,4,0,3,1
5007,25773,0,0,147,147,0,1,0,1,0
22676,3389,22676,3389,293,223,70,4,0,3,1
19238,3389,19238,3389,293,223,70,4,0,3,1
8975,24621,0,0,144,144,0,1,0,1,0
15373,15425,0,0,146,146,0,1,0,1,0
17833,61248,0,0,150,150,0,1,0,1,0
18777,18635,0,0,66,66,0,1,0,1,0
8006,25712,0,0,157,157,0,1,0,1,0
22377,33866,0,0,63,63,0,1,0,1,0
17566,3389,17566,3389,293,223,70,4,0,3,1
9258,25773,0,0,140,140,0,1,0,1,0
19517,3389,19517,3389,293,223,70,4,0,3,1
29086,29690,0,0,107,107,0,1,0,1,0
12257,61248,0,0,144,144,0,1,0,1,0
21189,37128,0,0,71,71,0,1,0,1,0
12665,24538,0,0,147,147,0,1,0,1,0
9126,25773,0,0,152,152,0,1,0,1,0
51362,31827,0,0,71,71,0,1,0,1,0
28168,32417,0,0,78,78,0,1,0,1,0
12219,61248,0,0,144,144,0,1,0,1,0
18122,61248,0,0,150,150,0,1,0,1,0
16454,15211,0,0,102,102,0,1,0,1,0
61950,3389,61950,3389,293,223,70,4,0,3,1
8726,61248,0,0,140,140,0,1,0,1,0
62809,3389,62809,3389,293,223,70,4,0,3,1
28247,28563,0,0,118,118,0,1,0,1,0
11958,52971,0,0,115,115,0,1,0,1,0
39344,6447,0,0,146,146,0,1,0,1,0
27471,25773,0,0,147,147,0,1,0,1,0
11782,3389,11782,3389,293,223,70,4,0,3,1
49713,32035,0,0,132,132,0,1,0,1,0
8663,55784,0,0,141,141,0,1,0,1,0
13158,25773,0,0,139,139,0,1,0,1,0
10530,58601,0,0,140,140,0,1,0,1,0
2537,47189,0,0,144,144,0,1,0,1,0
27119,60991,0,0,138,138,0,1,0,1,0
49307,31652,0,0,141,141,0,1,0,1,0
15579,3389,15579,3389,293,223,70,4,0,3,1
51769,32561,0,0,68,68,0,1,0,1,0
15239,3389,15239,3389,293,223,70,4,0,3,1
50062,33204,0,0,117,117,0,1,0,1,0
14523,3389,14523,3389,293,223,70,4,0,3,1
27600,34021,0,0,62,62,0,1,0,1,0
44914,60077,0,0,65,65,0,1,0,1,0
53525,19991,0,0,99,99,0,1,0,1,0
21541,3389,21541,3389,293,223,70,4,0,3,1
49062,29416,0,0,150,150,0,1,0,1,0
28167,32447,0,0,78,78,0,1,0,1,0
20934,31188,0,0,89,89,0,1,0,1,0
21382,3389,21382,3389,293,223,70,4,0,3,1
29160,3389,29160,3389,293,223,70,4,0,3,1
10692,25773,0,0,145,145,0,1,0,1,0
50813,29679,0,0,93,93,0,1,0,1,0
3332,41677,0,0,147,147,0,1,0,1,0
9528,3389,9528,3389,293,223,70,4,1,3,1
10043,24340,0,0,138,138,0,1,0,1,0
51060,30615,0,0,101,101,0,1,0,1,0
45655,3389,45655,3389,293,223,70,4,0,3,1
18806,40616,0,0,80,80,0,1,0,1,0
14595,12078,0,0,144,144,0,1,0,1,0
29390,1530,0,0,84,84,0,1,0,1,0
17345,3389,17345,3389,293,223,70,4,0,3,1
47699,60203,0,0,73,73,0,1,0,1,0
19415,3389,19415,3389,293,223,70,4,0,3,1
12515,3389,12515,3389,293,223,70,4,0,3,1
50364,31652,0,0,103,103,0,1,0,1,0
36470,12277,0,0,146,146,0,1,0,1,0
25640,25773,0,0,146,146,0,1,0,1,0
18076,3389,18076,3389,293,223,70,4,0,3,1
50230,28487,0,0,113,113,0,1,0,1,0
18754,1539,4980,1539,166,135,31,2,0,1,0
51303,32081,0,0,77,77,0,1,0,1,0
3086,25080,0,0,145,145,0,1,0,1,0
41430,60256,0,0,79,79,0,1,0,1,0
54078,16294,0,0,110,110,0,1,0,1,0
14228,21231,0,0,99,99,0,1,0,1,0
24385,34021,0,0,62,62,0,1,0,1,0
52291,25594,0,0,88,88,0,1,0,1,0
3964,25773,0,0,142,142,0,1,0,1,0
9492,61248,0,0,139,139,0,1,0,1,0
31768,5533,0,0,113,113,0,1,0,1,0
1567,22704,0,0,153,153,0,1,0,1,0
35186,10403,0,0,146,146,0,1,0,1,0
62442,31964,0,0,73,73,0,1,0,1,0
28299,26046,0,0,145,145,0,1,0,1,0
27601,34021,0,0,62,62,0,1,0,1,0
10636,14694,0,0,150,150,0,1,0,1,0
11504,61248,0,0,139,139,0,1,0,1,0
29975,60845,0,0,126,126,0,1,0,1,0
12022,61248,0,0,140,140,0,1,0,1,0
13158,3389,13158,3389,293,223,70,4,0,3,1
13141,56791,0,0,129,129,0,1,0,1,0
4010,49071,0,0,144,144,0,1,0,1,0
13775,55241,0,0,125,125,0,1,0,1,0
23175,25773,0,0,145,145,0,1,0,1,0
11562,61248,0,0,141,141,0,1,0,1,0
12511,60641,0,0,137,137,0,1,0,1,0
21363,36956,0,0,70,70,0,1,0,1,0
32359,6033,0,0,118,118,0,1,0,1,0
11816,23023,0,0,122,122,0,1,0,1,0
56759,48540,0,0,106,106,0,1,0,1,0
21231,20474,0,0,87,87,0,1,0,1,0
12158,3389,12158,3389,293,223,70,4,0,3,1
29656,3745,0,0,97,97,0,1,0,1,0
32646,3389,32646,3389,293,223,70,4,0,3,1
52069,16351,0,0,151,151,0,1,0,1,0
10228,61248,0,0,139,139,0,1,0,1,0
52170,32813,0,0,62,62,0,1,0,1,0
38245,3389,38245,3389,293,223,70,4,1,3,1
33126,3389,33126,3389,293,223,70,4,0,3,1
57094,49858,0,0,113,113,0,1,0,1,0
1173,21906,0,0,156,156,0,1,0,1,0
56557,31652,0,0,62,62,0,1,0,1,0
17322,25773,0,0,142,142,0,1,0,1,0
9804,24910,0,0,142,142,0,1,0,1,0
50594,32646,0,0,110,110,0,1,0,1,0
50359,29399,0,0,104,104,0,1,0,1,0
60170,60647,0,0,145,145,0,1,0,1,0
1758,23002,0,0,152,152,0,1,0,1,0
9120,61248,0,0,140,140,0,1,0,1,0
22714,33662,0,0,65,65,0,1,0,1,0
29255,23649,0,0,147,147,0,1,0,1,0
28136,33957,0,0,62,62,0,1,0,1,0
14597,48210,0,0,102,102,0,1,0,1,0
8019,61248,0,0,139,139,0,1,0,1,0
23050,3389,23050,3389,293,223,70,4,0,3,1
52426,27328,0,0,75,75,0,1,0,1,0
10086,3389,10086,3389,293,223,70,4,1,3,1
8419,61248,0,0,139,139,0,1,0,1,0
50566,3389,50566,3389,293,223,70,4,0,3,1
54501,3389,54501,3389,293,223,70,4,0,3,1
56430,47397,0,0,102,102,0,1,0,1,0
17959,3389,17959,3389,293,223,70,4,0,3,1
3196,25252,0,0,144,144,0,1,0,1,0
24732,34021,0,0,62,62,0,1,0,1,0
53530,33831,0,0,62,62,0,1,0,1,0
16883,3389,16883,3389,293,223,70,4,0,3,1
52411,34021,0,0,66,66,0,1,0,1,0
15443,3389,15443,3389,293,223,70,4,0,3,1
27498,834,0,0,74,74,0,1,0,1,0
50498,29745,0,0,99,99,0,1,0,1,0
51047,32960,0,0,99,99,0,1,0,1,0
12155,3389,12155,3389,293,223,70,4,1,3,1
46108,58458,0,0,62,62,0,1,0,1,0
40027,5957,0,0,146,146,0,1,0,1,0
12795,9201,2861,1060,193,171,21,1,0,1,0
5512,51031,0,0,142,142,0,1,0,1,0
3044,32478,0,0,143,143,0,1,0,1,0
50990,31960,0,0,81,81,0,1,0,1,0
12028,61248,0,0,140,140,0,1,0,1,0
49123,26224,0,0,149,149,0,1,0,1,0
47289,5618,0,0,145,145,0,1,0,1,0
17682,3389,17682,3389,293,223,70,4,0,3,1
9523,25773,0,0,155,155,0,1,0,1,0
14958,3389,14958,3389,293,223,70,4,0,3,1
58635,31652,0,0,66,66,0,1,0,1,0
21392,1031,3833,1030,132,110,21,1,0,1,0
51116,30740,0,0,99,99,0,1,0,1,0
3094,47544,0,0,144,144,0,1,0,1,0
30649,4585,0,0,104,104,0,1,0,1,0
9395,3389,9395,3389,293,223,70,4,1,3,1
50597,29576,0,0,113,113,0,1,0,1,0
49160,33124,0,0,146,146,0,1,0,1,0
33442,60667,0,0,112,112,0,1,0,1,0
9181,61248,0,0,140,140,0,1,0,1,0
3612,50314,0,0,143,143,0,1,0,1,0
57216,60984,0,0,126,126,0,1,0,1,0
24698,30862,0,0,94,94,0,1,0,1,0
37168,8007,0,0,146,146,0,1,0,1,0
50398,3389,50398,3389,293,223,70,4,0,3,1
18130,18037,0,0,64,64,0,1,0,1,0
48991,27802,0,0,153,153,0,1,0,1,0
49160,32057,0,0,146,146,0,1,0,1,0
53323,5618,0,0,145,145,0,1,0,1,0
51640,31652,0,0,64,64,0,1,0,1,0
10605,58714,0,0,139,139,0,1,0,1,0
50860,33757,0,0,136,136,0,1,0,1,0
14455,11842,5,2,148,148,0,1,0,1,0
13942,20446,0,0,85,85,0,1,0,1,0
18186,20347,0,0,84,84,0,1,0,1,0
17448,29959,0,0,99,99,0,1,0,1,0
20638,20029,0,0,82,82,0,1,0,1,0
14025,10798,1360,420,165,157,8,1,0,1,0
55597,60851,0,0,117,117,0,1,0,1,0
13555,3389,13555,3389,293,223,70,4,0,3,1
19895,19473,0,0,76,76,0,1,0,1,0
29623,32380,0,0,79,79,0,1,0,1,0
48959,27593,0,0,154,154,0,1,0,1,0
19895,3389,19895,3389,293,223,70,4,0,3,1
56007,31652,0,0,108,108,0,1,0,1,0
34998,3593,0,0,115,115,0,1,0,1,0
3902,25773,0,0,143,143,0,1,0,1,0
31405,3389,31405,3389,293,223,70,4,0,3,1
28186,3389,28186,3389,293,223,70,4,0,3,1
14715,61248,0,0,148,148,0,1,0,1,0
17059,16230,0,0,89,89,0,1,0,1,0
9415,3389,9415,3389,293,223,70,4,1,3,1
4321,52376,0,0,142,142,0,1,0,1,0
51366,31652,0,0,70,70,0,1,0,1,0
13183,25773,0,0,149,149,0,1,0,1,0
31611,5400,0,0,112,112,0,1,0,1,0
15921,61248,0,0,150,150,0,1,0,1,0
32619,3389,32619,3389,293,223,70,4,0,3,1
48993,27854,0,0,153,153,0,1,0,1,0
12781,25773,0,0,139,139,0,1,0,1,0
59905,31652,0,0,62,62,0,1,0,1,0
24107,34021,0,0,62,62,0,1,0,1,0
48910,25954,0,0,156,156,0,1,0,1,0
8448,25773,0,0,156,156,0,1,0,1,0
15816,28636,0,0,112,112,0,1,0,1,0
20915,3389,20915,3389,293,223,70,4,0,3,1
31149,34021,0,0,67,67,0,1,0,1,0
13398,24364,0,0,124,124,0,1,0,1,0
2729,46938,0,0,144,144,0,1,0,1,0
6826,53764,0,0,143,143,0,1,0,1,0
19214,3389,19214,3389,293,223,70,4,0,3,1
15443,2326,7526,2325,220,172,48,3,0,2,0
49160,31878,0,0,146,146,0,1,0,1,0
49061,29409,0,0,150,150,0,1,0,1,0
6155,24689,0,0,157,157,0,1,0,1,0
1272,21940,0,0,156,156,0,1,0,1,0
42188,9668,0,0,148,148,0,1,0,1,0
36513,12207,0,0,146,146,0,1,0,1,0
62531,3389,62531,3389,293,223,70,4,0,3,1
20128,5614,0,0,102,102,0,1,0,1,0
52411,33720,0,0,63,63,0,1,0,1,0
26123,754,0,0,69,69,0,1,0,1,0
17081,3389,17081,3389,293,223,70,4,0,3,1
28553,27018,0,0,135,135,0,1,0,1,0
11697,61248,0,0,139,139,0,1,0,1,0
26251,34021,0,0,62,62,0,1,0,1,0
35037,3389,35037,3389,293,223,70,4,0,3,1
13482,10293,1680,622,174,161,12,1,0,1,0
14965,3389,14965,3389,293,223,70,4,0,3,1
8357,25773,0,0,140,140,0,1,0,1,0
52060,33086,0,0,65,65,0,1,0,1,0
31324,19027,0,0,147,147,0,1,0,1,0
21810,32813,0,0,73,73,0,1,0,1,0
25805,25773,0,0,146,146,0,1,0,1,0
25665,25773,0,0,146,146,0,1,0,1,0
42241,9794,0,0,148,148,0,1,0,1,0
36778,8287,0,0,146,146,0,1,0,1,0
1495,22018,0,0,156,156,0,1,0,1,0
56888,31652,0,0,62,62,0,1,0,1,0
51193,30912,0,0,97,97,0,1,0,1,0
12931,24954,0,0,130,130,0,1,0,1,0
17842,3389,17842,3389,293,223,70,4,0,3,1
24944,23255,0,0,119,119,0,1,0,1,0
16739,3389,16739,3389,293,223,70,4,0,3,1
45382,17329,0,0,152,152,0,1,0,1,0
21782,820,2652,819,117,100,16,1,0,1,0
47370,47436,0,0,102,102,0,1,0,1,0
12122,3389,12122,3389,293,223,70,4,1,3,1
61307,4112,43232,2288,244,197,47,3,0,2,0
53476,12167,0,0,148,148,0,1,0,1,0
18152,3389,18152,3389,293,223,70,4,0,3,1
10369,61248,0,0,142,142,0,1,0,1,0
14991,22355,0,0,104,104,0,1,0,1,0
61398,54077,0,0,124,124,0,1,0,1,0
17644,24315,0,0,143,143,0,1,0,1,0
45389,3389,45389,3389,293,223,70,4,0,3,1
11842,3389,11842,3389,293,223,70,4,1,3,1
22751,34021,0,0,62,62,0,1,0,1,0
46593,53261,0,0,83,83,0,1,0,1,0
11860,59921,0,0,139,139,0,1,0,1,0
18289,3389,18289,3389,293,223,70,4,0,3,1
11378,3389,11378,3389,293,223,70,4,0,3,1
50042,28329,0,0,127,127,0,1,0,1,0
16954,3389,16954,3389,293,223,70,4,0,3,1
14162,3389,14162,3389,293,223,70,4,0,3,1
6728,25773,0,0,152,152,0,1,0,1,0
29715,34021,0,0,62,62,0,1,0,1,0
28272,1118,0,0,78,78,0,1,0,1,0
18209,19611,0,0,76,76,0,1,0,1,0
28590,2842,0,0,88,88,0,1,0,1,0
49947,33308,0,0,120,120,0,1,0,1,0
29662,32575,0,0,77,77,0,1,0,1,0
30076,3389,30076,3389,293,223,70,4,0,3,1
12252,61248,0,0,139,139,0,1,0,1,0
15497,25773,0,0,141,141,0,1,0,1,0
49160,33066,0,0,146,146,0,1,0,1,0
10637,61248,0,0,143,143,0,1,0,1,0
14379,61248,0,0,143,143,0,1,0,1,0
56095,33319,0,0,62,62,0,1,0,1,0
37608,3389,37608,3389,293,223,70,4,1,3,1
13835,25773,0,0,140,140,0,1,0,1,0
1905,23233,0,0,152,152,0,1,0,1,0
9303,3389,9303,3389,293,223,70,4,1,3,1
49160,32703,0,0,146,146,0,1,0,1,0
50814,20086,0,0,153,153,0,1,0,1,0
50268,5618,0,0,145,145,0,1,0,1,0
6219,25773,0,0,143,143,0,1,0,1,0
49160,33117,0,0,146,146,0,1,0,1,0
14086,61248,0,0,142,142,0,1,0,1,0
51760,32546,0,0,68,68,0,1,0,1,0
13620,61248,0,0,141,141,0,1,0,1,0
35164,3389,35164,3389,293,223,70,4,0,3,1
13509,61248,0,0,147,147,0,1,0,1,0
12250,61196,0,0,139,139,0,1,0,1,0
22056,3389,22056,3389,293,223,70,4,0,3,1
49052,30559,0,0,150,150,0,1,0,1,0
17829,18775,0,0,67,67,0,1,0,1,0
53100,13285,0,0,149,149,0,1,0,1,0
52444,33623,0,0,62,62,0,1,0,1,0
3692,25773,0,0,143,143,0,1,0,1,0
24303,15049,0,0,90,90,0,1,0,1,0
26613,3389,26613,3389,293,223,70,4,1,3,1
36192,12737,0,0,146,146,0,1,0,1,0
11928,25773,0,0,151,151,0,1,0,1,0
38816,3389,38816,3389,293,223,70,4,0,3,1
21509,3389,21509,3389,293,223,70,4,0,3,1
23362,31537,0,0,85,85,0,1,0,1,0
23740,34021,0,0,62,62,0,1,0,1,0
55924,32973,0,0,108,108,0,1,0,1,0
18588,18494,0,0,64,64,0,1,0,1,0
26980,25773,0,0,147,147,0,1,0,1,0
20391,3389,20391,3389,293,223,70,4,0,3,1
49812,27632,0,0,126,126,0,1,0,1,0
13417,3389,13417,3389,293,223,70,4,0,3,1
17098,16297,0,0,88,88,0,1,0,1,0
50972,30003,0,0,88,88,0,1,0,1,0
21207,3389,21207,3389,293,223,70,4,0,3,1
21288,36136,0,0,67,67,0,1,0,1,0
12132,6212,7306,2257,244,197,46,2,0,2,0
27932,34021,0,0,62,62,0,1,0,1,0
12544,7211,6011,1857,227,189,38,2,0,2,0
54232,15267,0,0,114,114,0,1,0,1,0
18555,43562,0,0,90,90,0,1,0,1,0
16303,3389,16303,3389,293,223,70,4,0,3,1
20460,3389,20460,3389,293,223,70,4,0,3,1
52411,33528,0,0,62,62,0,1,0,1,0
51768,31652,0,0,62,62,0,1,0,1,0
14916,12618,0,0,137,137,0,1,0,1,0
63861,3389,63861,3389,293,223,70,4,0,3,1
29601,32270,0,0,80,80,0,1,0,1,0
52194,33329,0,0,64,64,0,1,0,1,0
12960,26125,0,0,135,135,0,1,0,1,0
14950,13773,0,0,147,147,0,1,0,1,0
9946,61248,0,0,141,141,0,1,0,1,0
51540,32148,0,0,69,69,0,1,0,1,0
49698,33533,0,0,128,128,0,1,0,1,0
10236,61248,0,0,139,139,0,1,0,1,0
18724,1546,5003,1546,167,135,31,2,0,1,0
14760,25773,0,0,140,140,0,1,0,1,0
5765,56575,0,0,140,140,0,1,0,1,0
28728,34021,0,0,62,62,0,1,0,1,0
16675,25773,0,0,142,142,0,1,0,1,0
49837,32121,0,0,129,129,0,1,0,1,0
54505,33636,0,0,62,62,0,1,0,1,0
20246,3389,20246,3389,293,223,70,4,0,3,1
15942,51461,0,0,111,111,0,1,0,1,0
7188,23999,0,0,147,147,0,1,0,1,0
10691,25773,0,0,153,153,0,1,0,1,0
22329,34373,0,0,62,62,0,1,0,1,0
5727,24453,0,0,157,157,0,1,0,1,0
15126,14460,0,0,147,147,0,1,0,1,0
18159,21205,0,0,93,93,0,1,0,1,0
20219,5514,0,0,102,102,0,1,0,1,0
50896,31652,0,0,84,84,0,1,0,1,0
12957,3389,12957,3389,293,223,70,4,0,3,1
3319,25444,0,0,144,144,0,1,0,1,0
11501,61248,0,0,142,142,0,1,0,1,0
3374,48012,0,0,144,144,0,1,0,1,0
31152,60784,0,0,121,121,0,1,0,1,0
11160,61248,0,0,139,139,0,1,0,1,0
7338,49889,0,0,148,148,0,1,0,1,0
13386,25773,0,0,149,149,0,1,0,1,0
50849,31652,0,0,91,91,0,1,0,1,0
48986,27691,0,0,153,153,0,1,0,1,0
14930,3389,14930,3389,293,223,70,4,0,3,1
26917,24733,0,0,136,136,0,1,0,1,0
35463,8661,0,0,143,143,0,1,0,1,0
33666,7139,0,0,128,128,0,1,0,1,0
18883,18715,0,0,67,67,0,1,0,1,0
12836,25773,0,0,150,150,0,1,0,1,0
61423,4081,44119,2335,247,198,48,3,0,2,0
20486,39304,0,0,76,76,0,1,0,1,0
4223,52091,0,0,142,142,0,1,0,1,0
9657,3389,9657,3389,293,223,70,4,1,3,1
55960,60881,0,0,119,119,0,1,0,1,0
27946,13127,0,0,108,108,0,1,0,1,0
7127,54266,0,0,143,143,0,1,0,1,0
40486,5627,0,0,146,146,0,1,0,1,0
58281,53826,0,0,122,122,0,1,0,1,0
21174,31633,0,0,85,85,0,1,0,1,0
29682,34021,0,0,62,62,0,1,0,1,0
17783,3389,17783,3389,293,223,70,4,0,3,1
37462,7797,0,0,146,146,0,1,0,1,0
53797,3389,53797,3389,293,223,70,4,0,3,1
52508,33815,0,0,62,62,0,1,0,1,0
11563,4833,9094,2810,268,210,58,3,0,2,0
14311,25773,0,0,140,140,0,1,0,1,0
28714,27825,0,0,126,126,0,1,0,1,0
50203,32846,0,0,109,109,0,1,0,1,0
5536,51615,0,0,144,144,0,1,0,1,0
48923,6758,0,0,145,145,0,1,0,1,0
28983,34021,0,0,62,62,0,1,0,1,0
22429,34097,0,0,62,62,0,1,0,1,0
51020,32941,0,0,100,100,0,1,0,1,0
29678,32656,0,0,76,76,0,1,0,1,0
48934,26492,0,0,155,155,0,1,0,1,0
21947,781,2526,780,115,99,16,1,0,1,0
37366,3389,37366,3389,293,223,70,4,1,3,1
26574,1135,0,0,72,72,0,1,0,1,0
29748,22548,0,0,147,147,0,1,0,1,0
24114,25773,0,0,145,145,0,1,0,1,0
19346,28240,0,0,118,118,0,1,0,1,0
19786,3389,19786,3389,293,223,70,4,0,3,1
47684,5618,0,0,145,145,0,1,0,1,0
19288,1412,4570,1412,158,129,29,2,0,1,0
49160,31815,0,0,146,146,0,1,0,1,0
23830,25773,0,0,145,145,0,1,0,1,0
2038,23440,0,0,151,151,0,1,0,1,0
11025,3389,11025,3389,293,223,70,4,1,3,1
15362,61248,0,0,149,149,0,1,0,1,0
11579,3389,11579,3389,293,223,70,4,0,3,1
52145,29204,0,0,69,69,0,1,0,1,0
40474,3389,40474,3389,293,223,70,4,0,3,1
49084,31590,0,0,149,149,0,1,0,1,0
17098,3389,17098,3389,293,223,70,4,0,3,1
30558,3389,30558,3389,293,223,70,4,0,3,1
11078,25773,0,0,152,152,0,1,0,1,0
9563,3389,9563,3389,293,223,70,4,1,3,1
19523,3389,19523,3389,293,223,70,4,0,3,1
13203,8805,3944,1218,200,174,25,2,0,1,0
25704,34021,0,0,62,62,0,1,0,1,0
16619,25773,0,0,144,144,0,1,0,1,0
16680,25773,0,0,142,142,0,1,0,1,0
49005,32911,0,0,142,142,0,1,0,1,0
12644,3378,12563,3378,292,222,69,3,0,2,0
49295,33898,0,0,141,141,0,1,0,1,0
37982,3389,37982,3389,293,223,70,4,1,3,1
62861,31652,0,0,63,63,0,1,0,1,0
12051,3389,12051,3389,293,223,70,4,1,3,1
11349,3389,11349,3389,293,223,70,4,1,3,1
11542,25773,0,0,139,139,0,1,0,1,0
51124,31652,0,0,82,82,0,1,0,1,0
20820,30976,0,0,91,91,0,1,0,1,0
12113,61248,0,0,139,139,0,1,0,1,0
50351,60420,0,0,88,88,0,1,0,1,0
51701,33413,0,0,83,83,0,1,0,1,0
49160,32541,0,0,146,146,0,1,0,1,0
21652,28285,0,0,118,118,0,1,0,1,0
19819,40474,0,0,81,81,0,1,0,1,0
38540,3389,38540,3389,293,223,70,4,1,3,1
21082,3389,21082,3389,293,223,70,4,0,3,1
50624,34021,0,0,110,110,0,1,0,1,0
10389,22263,0,0,105,105,0,1,0,1,0
4389,25773,0,0,145,145,0,1,0,1,0
13484,61248,0,0,141,141,0,1,0,1,0
22193,21195,0,0,95,95,0,1,0,1,0
28158,32881,0,0,73,73,0,1,0,1,0
10434,5442,6924,2566,257,204,53,3,0,2,0
50213,34021,0,0,120,120,0,1,0,1,0
12911,3389,12911,3389,293,223,70,4,0,3,1
13781,3389,13781,3389,293,223,70,4,0,3,1
13536,3389,13536,3389,293,223,70,4,0,3,1
21013,3389,21013,3389,293,223,70,4,0,3,1
14473,25773,0,0,140,140,0,1,0,1,0
9081,58162,0,0,130,130,0,1,0,1,0
18846,3389,18846,3389,293,223,70,4,0,3,1
38320,3389,38320,3389,293,223,70,4,1,3,1
18245,18458,0,0,64,64,0,1,0,1,0
51938,32124,0,0,62,62,0,1,0,1,0
23237,32925,0,0,73,73,0,1,0,1,0
12654,7477,5666,1751,222,186,36,2,0,2,0
21464,60736,0,0,158,158,0,1,0,1,0
37056,8088,0,0,146,146,0,1,0,1,0
20474,3389,20474,3389,293,223,70,4,0,3,1
2270,46141,0,0,144,144,0,1,0,1,0
46549,5618,0,0,145,145,0,1,0,1,0
5468,24781,0,0,132,132,0,1,0,1,0
50619,29625,0,0,112,112,0,1,0,1,0
15521,3389,15521,3389,293,223,70,4,0,3,1
31645,2360,0,0,97,97,0,1,0,1,0
58451,61086,0,0,133,133,0,1,0,1,0
12492,3389,12492,3389,293,223,70,4,1,3,1
19412,61248,0,0,154,154,0,1,0,1,0
25602,31956,0,0,82,82,0,1,0,1,0
25284,34021,0,0,62,62,0,1,0,1,0
20977,3389,20977,3389,293,223,70,4,0,3,1
49044,26125,0,0,151,151,0,1,0,1,0
60024,32536,0,0,62,62,0,1,0,1,0
28278,27070,0,0,134,134,0,1,0,1,0
14439,3389,14439,3389,293,223,70,4,0,3,1
3150,48970,0,0,143,143,0,1,0,1,0
51283,33123,0,0,93,93,0,1,0,1,0
12342,3389,12342,3389,293,223,70,4,1,3,1
17963,25773,0,0,143,143,0,1,0,1,0
12948,8189,4742,1465,210,180,30,2,0,1,0
52399,33698,0,0,63,63,0,1,0,1,0
29495,31736,0,0,85,85,0,1,0,1,0
4723,19098,0,0,154,154,0,1,0,1,0
20005,27147,0,0,129,129,0,1,0,1,0
13092,3389,13092,3389,293,223,70,4,0,3,1
22756,29636,0,0,105,105,0,1,0,1,0
23676,31701,0,0,83,83,0,1,0,1,0
8608,61248,0,0,140,140,0,1,0,1,0
50590,32727,0,0,100,100,0,1,0,1,0
20542,61248,0,0,156,156,0,1,0,1,0
50199,31652,0,0,109,109,0,1,0,1,0
52264,33455,0,0,64,64,0,1,0,1,0
10164,24251,0,0,137,137,0,1,0,1,0
50496,29349,0,0,115,115,0,1,0,1,0
52190,32872,0,0,62,62,0,1,0,1,0
7613,61248,0,0,139,139,0,1,0,1,0
50685,34021,0,0,108,108,0,1,0,1,0
16867,15908,0,0,93,93,0,1,0,1,0
33453,14272,0,0,146,146,0,1,0,1,0
14705,3389,14705,3389,293,223,70,4,0,3,1
20540,3389,20540,3389,293,223,70,4,0,3,1
9460,3389,9460,3389,293,223,70,4,0,3,1
38655,60399,0,0,90,90,0,1,0,1,0
13398,25773,0,0,139,139,0,1,0,1,0
51061,31144,0,0,79,79,0,1,0,1,0
43879,3389,43879,3389,293,223,70,4,0,3,1
49715,27433,0,0,130,130,0,1,0,1,0
61023,31652,0,0,64,64,0,1,0,1,0
14621,25773,0,0,140,140,0,1,0,1,0
1164,22073,0,0,156,156,0,1,0,1,0
21429,61248,0,0,157,157,0,1,0,1,0
49630,31652,0,0,130,130,0,1,0,1,0
45065,5618,0,0,145,145,0,1,0,1,0
7358,24059,0,0,146,146,0,1,0,1,0
4687,47854,0,0,146,146,0,1,0,1,0
28391,34021,0,0,62,62,0,1,0,1,0
59296,32681,0,0,62,62,0,1,0,1,0
38239,3389,38239,3389,293,223,70,4,1,3,1
50846,19990,0,0,153,153,0,1,0,1,0
28957,34021,0,0,62,62,0,1,0,1,0
13105,3389,13105,3389,293,223,70,4,0,3,1
22381,3137,0,0,84,84,0,1,0,1,0
9283,3389,9283,3389,293,223,70,4,1,3,1
37513,8685,0,0,145,145,0,1,0,1,0
52147,34021,0,0,72,72,0,1,0,1,0
19139,27855,0,0,122,122,0,1,0,1,0
49160,32158,0,0,146,146,0,1,0,1,0
25064,31518,0,0,86,86,0,1,0,1,0
33396,6911,0,0,126,126,0,1,0,1,0
11086,60864,0,0,143,143,0,1,0,1,0
10164,58049,0,0,140,140,0,1,0,1,0
15512,20277,0,0,87,87,0,1,0,1,0
9660,3389,9660,3389,293,223,70,4,1,3,1
19318,3389,19318,3389,293,223,70,4,0,3,1
59369,32667,0,0,62,62,0,1,0,1,0
52555,33953,0,0,62,62,0,1,0,1,0
15903,3389,15903,3389,293,223,70,4,0,3,1
49907,28027,0,0,131,131,0,1,0,1,0
45769,60044,0,0,62,62,0,1,0,1,0
7927,55598,0,0,143,143,0,1,0,1,0
11855,3389,11855,3389,293,223,70,4,1,3,1
50074,33193,0,0,116,116,0,1,0,1,0
28300,25988,0,0,145,145,0,1,0,1,0
51893,31990,0,0,62,62,0,1,0,1,0
51011,31936,0,0,80,80,0,1,0,1,0
35138,3389,35138,3389,293,223,70,4,0,3,1
13357,24698,0,0,146,146,0,1,0,1,0
7828,60424,0,0,136,136,0,1,0,1,0
54938,5618,0,0,145,145,0,1,0,1,0
10485,58533,0,0,140,140,0,1,0,1,0
15484,25773,0,0,141,141,0,1,0,1,0
8448,61248,0,0,140,140,0,1,0,1,0
51793,31696,0,0,62,62,0,1,0,1,0
52326,33566,0,0,63,63,0,1,0,1,0
28300,25971,0,0,145,145,0,1,0,1,0
20425,3389,20425,3389,293,223,70,4,0,3,1
38875,6783,0,0,146,146,0,1,0,1,0
49593,33629,0,0,132,132,0,1,0,1,0
3708,48310,0,0,144,144,0,1,0,1,0
40795,5618,0,0,145,145,0,1,0,1,0
21635,60868,0,0,158,158,0,1,0,1,0
57097,33120,0,0,62,62,0,1,0,1,0
8768,25773,0,0,154,154,0,1,0,1,0
48999,27973,0,0,152,152,0,1,0,1,0
51543,31652,0,0,66,66,0,1,0,1,0
47873,43665,0,0,114,114,0,1,0,1,0
11612,61248,0,0,139,139,0,1,0,1,0
5544,51628,0,0,144,144,0,1,0,1,0
13640,3389,13640,3389,293,223,70,4,0,3,1
46960,7090,0,0,145,145,0,1,0,1,0
17980,18584,0,0,65,65,0,1,0,1,0
11227,61248,0,0,144,144,0,1,0,1,0
51447,31652,0,0,72,72,0,1,0,1,0
9368,56848,0,0,140,140,0,1,0,1,0
37744,3389,37744,3389,293,223,70,4,0,3,1
28290,34021,0,0,62,62,0,1,0,1,0
11732,5244,8561,2645,261,206,54,3,0,2,0
2003,23386,0,0,151,151,0,1,0,1,0
37620,7684,0,0,146,146,0,1,0,1,0
25797,34021,0,0,62,62,0,1,0,1,0
56682,52212,0,0,145,145,0,1,0,1,0
12226,3389,12226,3389,293,223,70,4,1,3,1
19181,25773,0,0,143,143,0,1,0,1,0
8212,23377,0,0,117,117,0,1,0,1,0
32319,2608,0,0,100,100,0,1,0,1,0
14113,3389,14113,3389,293,223,70,4,0,3,1
50160,32895,0,0,110,110,0,1,0,1,0
3964,25773,0,0,143,143,0,1,0,1,0
18281,26264,0,0,138,138,0,1,0,1,0
49106,34422,0,0,144,144,0,1,0,1,0
11337,25773,0,0,143,143,0,1,0,1,0
10422,5424,6943,2573,258,204,53,3,0,2,0
40238,5805,0,0,146,146,0,1,0,1,0
2867,47042,0,0,144,144,0,1,0,1,0
18122,22388,0,0,106,106,0,1,0,1,0
3739,47126,0,0,146,146,0,1,0,1,0
45908,18590,0,0,153,153,0,1,0,1,0
18899,3389,18899,3389,293,223,70,4,0,3,1
20639,61248,0,0,156,156,0,1,0,1,0
28827,3389,28827,3389,293,223,70,4,0,3,1
8637,61248,0,0,140,140,0,1,0,1,0
28268,27524,0,0,129,129,0,1,0,1,0
10877,3389,10877,3389,293,223,70,4,1,3,1
18243,18501,0,0,64,64,0,1,0,1,0
13264,3389,13264,3389,293,223,70,4,0,3,1
56391,33260,0,0,62,62,0,1,0,1,0
50343,60420,0,0,88,88,0,1,0,1,0
52294,31652,0,0,62,62,0,1,0,1,0
10519,61248,0,0,142,142,0,1,0,1,0
24910,14729,0,0,93,93,0,1,0,1,0
39396,5211,0,0,139,139,0,1,0,1,0
10576,5669,6678,2475,253,202,51,3,0,2,0
51982,32255,0,0,62,62,0,1,0,1,0
29577,22929,0,0,147,147,0,1,0,1,0
15134,12986,0,0,132,132,0,1,0,1,0
15065,3389,15065,3389,293,223,70,4,0,3,1
50285,28598,0,0,111,111,0,1,0,1,0
49454,27145,0,0,137,137,0,1,0,1,0
8436,59327,0,0,133,133,0,1,0,1,0
16574,9522,0,0,131,131,0,1,0,1,0
8231,25773,0,0,156,156,0,1,0,1,0
19424,42146,0,0,84,84,0,1,0,1,0
13353,24422,0,0,125,125,0,1,0,1,0
50109,31652,0,0,112,112,0,1,0,1,0
7938,61248,0,0,139,139,0,1,0,1,0
10630,25773,0,0,146,146,0,1,0,1,0
8354,61248,0,0,139,139,0,1,0,1,0
11803,3389,11803,3389,293,223,70,4,1,3,1
50709,32725,0,0,107,107,0,1,0,1,0
20110,3389,20110,3389,293,223,70,4,0,3,1
13561,3389,13561,3389,293,223,70,4,0,3,1
14061,61248,0,0,148,148,0,1,0,1,0
60932,31652,0,0,81,81,0,1,0,1,0
12958,3389,12958,3389,293,223,70,4,0,3,1
3489,22422,0,0,154,154,0,1,0,1,0
10025,61248,0,0,139,139,0,1,0,1,0
9124,15821,0,0,151,151,0,1,0,1,0
49757,32066,0,0,131,131,0,1,0,1,0
52386,33452,0,0,62,62,0,1,0,1,0
12461,25773,0,0,139,139,0,1,0,1,0
10967,3389,10967,3389,293,223,70,4,0,3,1
51111,31824,0,0,77,77,0,1,0,1,0
52442,33776,0,0,63,63,0,1,0,1,0
9304,3389,9304,3389,293,223,70,4,1,3,1
13915,61248,0,0,146,146,0,1,0,1,0
16689,61248,0,0,147,147,0,1,0,1,0
10177,59349,0,0,143,143,0,1,0,1,0
49160,33650,0,0,146,146,0,1,0,1,0
51459,31652,0,0,68,68,0,1,0,1,0
37148,3389,37148,3389,293,223,70,4,1,3,1
15362,53014,0,0,115,115,0,1,0,1,0
23818,61161,0,0,152,152,0,1,0,1,0
28147,33394,0,0,68,68,0,1,0,1,0
14558,25773,0,0,140,140,0,1,0,1,0
29486,31693,0,0,86,86,0,1,0,1,0
12104,6145,7393,2284,245,198,47,3,0,2,0
18148,21562,0,0,97,97,0,1,0,1,0
10539,59951,0,0,143,143,0,1,0,1,0
51989,32699,0,0,77,77,0,1,0,1,0
51464,31652,0,0,68,68,0,1,0,1,0
49500,33712,0,0,135,135,0,1,0,1,0
18026,25457,0,0,139,139,0,1,0,1,0
13726,10681,1260,467,167,158,9,1,0,1,0
18085,30475,0,0,95,95,0,1,0,1,0
21869,3389,21869,3389,293,223,70,4,0,3,1
28138,33844,0,0,63,63,0,1,0,1,0
16371,27900,0,0,119,119,0,1,0,1,0
29544,23725,0,0,147,147,0,1,0,1,0
62823,3389,62823,3389,293,223,70,4,0,3,1
45491,34021,0,0,129,129,0,1,0,1,0
13679,10607,1341,497,169,159,10,1,0,1,0
10128,4955,7450,2761,266,209,57,3,0,2,0
13025,25773,0,0,150,150,0,1,0,1,0
30410,4383,0,0,103,103,0,1,0,1,0
17773,3389,17773,3389,293,223,70,4,0,3,1
2101,22449,0,0,157,157,0,1,0,1,0
27568,26812,0,0,137,137,0,1,0,1,0
50484,33815,0,0,138,138,0,1,0,1,0
59396,57695,0,0,134,134,0,1,0,1,0
49465,27172,0,0,136,136,0,1,0,1,0
43116,7739,0,0,145,145,0,1,0,1,0
51249,3389,51249,3389,293,223,70,4,0,3,1
13349,3389,13349,3389,293,223,70,4,0,3,1
6182,52691,0,0,144,144,0,1,0,1,0
52216,28733,0,0,71,71,0,1,0,1,0
8385,24416,0,0,145,145,0,1,0,1,0
13482,3389,13482,3389,293,223,70,4,0,3,1
51860,31104,0,0,63,63,0,1,0,1,0
54787,8265,0,0,146,146,0,1,0,1,0
23778,346,1118,345,85,78,7,1,0,1,0
29292,30720,0,0,96,96,0,1,0,1,0
39176,8404,0,0,145,145,0,1,0,1,0
50986,31652,0,0,81,81,0,1,0,1,0
11912,3389,11912,3389,293,223,70,4,1,3,1
9130,61248,0,0,140,140,0,1,0,1,0
23630,3389,23630,3389,293,223,70,4,0,3,1
18509,3389,18509,3389,293,223,70,4,0,3,1
1579,22161,0,0,157,157,0,1,0,1,0
15636,3389,15636,3389,293,223,70,4,0,3,1
47799,5618,0,0,145,145,0,1,0,1,0
17581,3389,17581,3389,293,223,70,4,0,3,1
52333,33297,0,0,62,62,0,1,0,1,0
24544,31080,0,0,92,92,0,1,0,1,0
21064,3389,21064,3389,293,223,70,4,0,3,1
24705,34021,0,0,62,62,0,1,0,1,0
14068,3389,14068,3389,293,223,70,4,1,3,1
16356,25773,0,0,145,145,0,1,0,1,0
52503,26813,0,0,77,77,0,1,0,1,0
14427,3389,14427,3389,293,223,70,4,0,3,1
24360,34021,0,0,62,62,0,1,0,1,0
12976,3389,12976,3389,293,223,70,4,0,3,1
12666,3389,12666,3389,293,223,70,4,0,3,1
26121,61043,0,0,142,142,0,1,0,1,0
47096,49492,0,0,96,96,0,1,0,1,0
47056,60150,0,0,69,69,0,1,0,1,0
24454,31208,0,0,91,91,0,1,0,1,0
48173,5618,0,0,145,145,0,1,0,1,0
9303,3389,9303,3389,293,223,70,4,1,3,1
20541,3389,20541,3389,293,223,70,4,0,3,1
38440,3389,38440,3389,293,223,70,4,1,3,1
8932,25773,0,0,140,140,0,1,0,1,0
11438,61248,0,0,142,142,0,1,0,1,0
28165,32538,0,0,77,77,0,1,0,1,0
17321,61248,0,0,151,151,0,1,0,1,0
51063,3389,51063,3389,293,223,70,4,0,3,1
23891,31812,0,0,82,82,0,1,0,1,0
6672,24975,0,0,157,157,0,1,0,1,0
19820,25773,0,0,143,143,0,1,0,1,0
28690,34021,0,0,62,62,0,1,0,1,0
3299,47887,0,0,144,144,0,1,0,1,0
28613,34021,0,0,62,62,0,1,0,1,0
50563,29167,0,0,102,102,0,1,0,1,0
7524,61248,0,0,139,139,0,1,0,1,0
17464,25773,0,0,142,142,0,1,0,1,0
49667,33562,0,0,129,129,0,1,0,1,0
50165,33111,0,0,113,113,0,1,0,1,0
9594,3389,9594,3389,293,223,70,4,1,3,1
22990,15742,0,0,84,84,0,1,0,1,0
48856,36299,0,0,138,138,0,1,0,1,0
49851,33242,0,0,121,121,0,1,0,1,0
4800,49957,0,0,143,143,0,1,0,1,0
18025,3389,18025,3389,293,223,70,4,0,3,1
57651,61020,0,0,129,129,0,1,0,1,0
33891,3186,0,0,109,109,0,1,0,1,0
49526,6656,0,0,145,145,0,1,0,1,0
50932,32417,0,0,89,89,0,1,0,1,0
7695,60664,0,0,137,137,0,1,0,1,0
13506,9539,2992,924,187,168,19,1,0,1,0
51230,31652,0,0,134,134,0,1,0,1,0
28238,28977,0,0,114,114,0,1,0,1,0
16321,25773,0,0,141,141,0,1,0,1,0
6313,25773,0,0,151,151,0,1,0,1,0
46291,57766,0,0,62,62,0,1,0,1,0
48953,27395,0,0,154,154,0,1,0,1,0
50595,29231,0,0,101,101,0,1,0,1,0
59683,58727,0,0,137,137,0,1,0,1,0
23629,3389,23629,3389,293,223,70,4,1,3,1
12107,3389,12107,3389,293,223,70,4,1,3,1
17491,61248,0,0,149,149,0,1,0,1,0
50898,32448,0,0,90,90,0,1,0,1,0
51429,31968,0,0,73,73,0,1,0,1,0
17134,61248,0,0,148,148,0,1,0,1,0
20526,19945,0,0,81,81,0,1,0,1,0
5539,25773,0,0,149,149,0,1,0,1,0
7237,25773,0,0,154,154,0,1,0,1,0
18126,22276,0,0,105,105,0,1,0,1,0
48948,27224,0,0,155,155,0,1,0,1,0
49796,31652,0,0,123,123,0,1,0,1,0
50452,29628,0,0,101,101,0,1,0,1,0
52121,29365,0,0,69,69,0,1,0,1,0
52505,33807,0,0,62,62,0,1,0,1,0
19496,31618,0,0,84,84,0,1,0,1,0
45166,16810,0,0,152,152,0,1,0,1,0
14085,11253,642,238,158,153,4,1,0,1,0
16615,61248,0,0,147,147,0,1,0,1,0
18059,24405,0,0,128,128,0,1,0,1,0
20760,25773,0,0,144,144,0,1,0,1,0
51286,31652,0,0,71,71,0,1,0,1,0
8784,55968,0,0,141,141,0,1,0,1,0
12187,61248,0,0,139,139,0,1,0,1,0
51420,39486,0,0,145,145,0,1,0,1,0
15347,13345,0,0,127,127,0,1,0,1,0
13357,2821,9129,2821,254,196,58,3,0,2,0
52003,3389,52003,3389,293,223,70,4,0,3,1
35331,60570,0,0,104,104,0,1,0,1,0
13392,25773,0,0,149,149,0,1,0,1,0
29411,34021,0,0,62,62,0,1,0,1,0
4993,25773,0,0,147,147,0,1,0,1,0
11580,4875,9039,2793,267,209,57,3,0,2,0
14141,11079,996,308,161,154,6,1,0,1,0
25712,29431,0,0,109,109,0,1,0,1,0
21646,32509,0,0,76,76,0,1,0,1,0
18015,3389,18015,3389,293,223,70,4,0,3,1
10281,25773,0,0,143,143,0,1,0,1,0
49160,32480,0,0,146,146,0,1,0,1,0
8515,25773,0,0,155,155,0,1,0,1,0
16774,61248,0,0,151,151,0,1,0,1,0
20353,3389,20353,3389,293,223,70,4,0,3,1
51432,31652,0,0,68,68,0,1,0,1,0
38119,3389,38119,3389,293,223,70,4,1,3,1
18319,3389,18319,3389,293,223,70,4,0,3,1
51507,31652,0,0,67,67,0,1,0,1,0
50520,32489,0,0,98,98,0,1,0,1,0
38448,3389,38448,3389,293,223,70,4,1,3,1
37943,60435,0,0,93,93,0,1,0,1,0
22660,34021,0,0,62,62,0,1,0,1,0
14915,3389,14915,3389,293,223,70,4,0,3,1
7750,24195,0,0,146,146,0,1,0,1,0
28748,27997,0,0,124,124,0,1,0,1,0
16543,3389,16543,3389,293,223,70,4,0,3,1
17145,19638,0,0,76,76,0,1,0,1,0
11216,61248,0,0,139,139,0,1,0,1,0
41133,34021,0,0,110,110,0,1,0,1,0
22007,3389,22007,3389,293,223,70,4,0,3,1
26660,3389,26660,3389,293,223,70,4,0,3,1
50771,31652,0,0,94,94,0,1,0,1,0
22851,33470,0,0,67,67,0,1,0,1,0
8261,25773,0,0,140,140,0,1,0,1,0
25233,30108,0,0,102,102,0,1,0,1,0
39492,5247,0,0,140,140,0,1,0,1,0
54270,13918,0,0,121,121,0,1,0,1,0
38120,3389,38120,3389,293,223,70,4,0,3,1
8802,58665,0,0,131,131,0,1,0,1,0
20908,31139,0,0,90,90,0,1,0,1,0
50139,32918,0,0,111,111,0,1,0,1,0
14838,3389,14838,3389,293,223,70,4,0,3,1
20840,31012,0,0,91,91,0,1,0,1,0
46995,49355,0,0,93,93,0,1,0,1,0
2609,24334,0,0,148,148,0,1,0,1,0
4236,25773,0,0,145,145,0,1,0,1,0
28201,25695,0,0,147,147,0,1,0,1,0
50657,30139,0,0,93,93,0,1,0,1,0
30911,3389,30911,3389,293,223,70,4,0,3,1
17105,3389,17105,3389,293,223,70,4,0,3,1
16692,3389,16692,3389,293,223,70,4,0,3,1
20818,61248,0,0,156,156,0,1,0,1,0
37581,3389,37581,3389,293,223,70,4,1,3,1
18076,23850,0,0,122,122,0,1,0,1,0
11478,61248,0,0,142,142,0,1,0,1,0
20644,1232,4580,1231,145,120,25,2,0,1,0
2144,22473,0,0,157,157,0,1,0,1,0
50319,28951,0,0,120,120,0,1,0,1,0
20761,30865,0,0,92,92,0,1,0,1,0
21484,33229,0,0,69,69,0,1,0,1,0
10955,6271,6028,2234,243,197,46,2,0,2,0
2366,41844,0,0,144,144,0,1,0,1,0
11762,7556,4639,1719,221,186,35,2,0,2,0
18349,30689,0,0,93,93,0,1,0,1,0
52472,27023,0,0,76,76,0,1,0,1,0
25451,23635,0,0,123,123,0,1,0,1,0
20234,61248,0,0,155,155,0,1,0,1,0
11466,3389,11466,3389,293,223,70,4,1,3,1
49160,33920,0,0,146,146,0,1,0,1,0
24268,15067,0,0,90,90,0,1,0,1,0
29893,33981,0,0,62,62,0,1,0,1,0
17874,17605,0,0,70,70,0,1,0,1,0
49941,33141,0,0,118,118,0,1,0,1,0
28986,34021,0,0,62,62,0,1,0,1,0
10564,14748,0,0,150,150,0,1,0,1,0
4354,23013,0,0,151,151,0,1,0,1,0
38433,3389,38433,3389,293,223,70,4,1,3,1
54038,33729,0,0,62,62,0,1,0,1,0
28164,34021,0,0,62,62,0,1,0,1,0
7249,28652,0,0,155,155,0,1,0,1,0
28251,3389,28251,3389,293,223,70,4,0,3,1
3165,23037,0,0,157,157,0,1,0,1,0
54452,5618,0,0,145,145,0,1,0,1,0
50277,31652,0,0,110,110,0,1,0,1,0
32611,6247,0,0,120,120,0,1,0,1,0
20810,32683,0,0,74,74,0,1,0,1,0
15876,2223,7193,2222,213,167,45,2,0,2,0
21831,3389,21831,3389,293,223,70,4,0,3,1
53901,31652,0,0,119,119,0,1,0,1,0
46355,19662,0,0,153,153,0,1,0,1,0
32256,2584,0,0,100,100,0,1,0,1,0
10880,61248,0,0,142,142,0,1,0,1,0
42551,10539,0,0,148,148,0,1,0,1,0
47617,44269,0,0,108,108,0,1,0,1,0
7736,61248,0,0,139,139,0,1,0,1,0
11816,3389,11816,3389,293,223,70,4,0,3,1
15654,2275,7363,2275,217,170,47,3,0,2,0
37218,3389,37218,3389,293,223,70,4,1,3,1
29852,3389,29852,3389,293,223,70,4,0,3,1
9899,3389,9899,3389,293,223,70,4,1,3,1
22417,756,2810,755,113,97,15,1,0,1,0
27829,3389,27829,3389,293,223,70,4,1,3,1
28621,27360,0,0,131,131,0,1,0,1,0
41643,3389,41643,3389,293,223,70,4,0,3,1
7544,61248,0,0,139,139,0,1,0,1,0
11121,3389,11121,3389,293,223,70,4,1,3,1
29520,34021,0,0,62,62,0,1,0,1,0
12041,25773,0,0,140,140,0,1,0,1,0
41886,3389,41886,3389,293,223,70,4,0,3,1
48087,3389,48087,3389,293,223,70,4,0,3,1
15496,2613,9717,2612,240,186,53,3,0,2,0
9633,25773,0,0,150,150,0,1,0,1,0
26286,388,0,0,67,67,0,1,0,1,0
9305,57896,0,0,143,143,0,1,0,1,0
51715,31652,0,0,63,63,0,1,0,1,0
27772,3389,27772,3389,293,223,70,4,0,3,1
28096,3389,28096,3389,293,223,70,4,0,3,1
51518,32109,0,0,70,70,0,1,0,1,0
16859,3389,16859,3389,293,223,70,4,0,3,1
15774,61248,0,0,146,146,0,1,0,1,0
8825,25245,0,0,150,150,0,1,0,1,0
49615,33507,0,0,129,129,0,1,0,1,0
39738,6877,0,0,146,146,0,1,0,1,0
49741,31652,0,0,142,142,0,1,0,1,0
22593,3389,22593,3389,293,223,70,4,1,3,1
19686,25773,0,0,143,143,0,1,0,1,0
48176,3389,48176,3389,293,223,70,4,0,3,1
21559,3389,21559,3389,293,223,70,4,0,3,1
49160,31661,0,0,146,146,0,1,0,1,0
57002,49383,0,0,108,108,0,1,0,1,0
23667,25773,0,0,145,145,0,1,0,1,0
11939,61248,0,0,143,143,0,1,0,1,0
28142,1071,0,0,78,78,0,1,0,1,0
45792,7287,0,0,145,145,0,1,0,1,0
33418,3012,0,0,107,107,0,1,0,1,0
36118,60529,0,0,101,101,0,1,0,1,0
58859,61119,0,0,136,136,0,1,0,1,0
26630,31725,0,0,84,84,0,1,0,1,0
8643,25773,0,0,140,140,0,1,0,1,0
52574,26338,0,0,78,78,0,1,0,1,0
33612,3083,0,0,108,108,0,1,0,1,0
34990,10840,0,0,146,146,0,1,0,1,0
24913,14728,0,0,93,93,0,1,0,1,0
29122,3389,29122,3389,293,223,70,4,1,3,1
62862,43353,0,0,94,94,0,1,0,1,0
12920,3389,12920,3389,293,223,70,4,0,3,1
17749,17394,0,0,73,73,0,1,0,1,0
5272,55142,0,0,141,141,0,1,0,1,0
40086,34021,0,0,106,106,0,1,0,1,0
12179,3389,12179,3389,293,223,70,4,0,3,1
13554,25773,0,0,139,139,0,1,0,1,0
14660,3389,14660,3389,293,223,70,4,0,3,1
7507,61248,0,0,139,139,0,1,0,1,0
23193,21943,0,0,104,104,0,1,0,1,0
8335,25773,0,0,156,156,0,1,0,1,0
15867,25773,0,0,146,146,0,1,0,1,0
18646,1768,6574,1767,182,145,36,2,0,2,0
8945,61248,0,0,140,140,0,1,0,1,0
30734,4657,0,0,105,105,0,1,0,1,0
49160,33439,0,0,146,146,0,1,0,1,0
11079,6468,5814,2155,240,195,44,2,0,2,0
50861,32106,0,0,86,86,0,1,0,1,0
4760,23918,0,0,157,157,0,1,0,1,0
15375,21871,0,0,99,99,0,1,0,1,0
50820,31652,0,0,92,92,0,1,0,1,0
14842,13350,0,0,147,147,0,1,0,1,0
57744,61028,0,0,129,129,0,1,0,1,0
12670,3389,12670,3389,293,223,70,4,0,3,1
9135,56496,0,0,140,140,0,1,0,1,0
8392,61248,0,0,140,140,0,1,0,1,0
13905,10508,1736,536,170,159,11,1,0,1,0
48957,27510,0,0,154,154,0,1,0,1,0
16376,3389,16376,3389,293,223,70,4,0,3,1
20116,3389,20116,3389,293,223,70,4,0,3,1
18644,25773,0,0,143,143,0,1,0,1,0
5743,33660,0,0,152,152,0,1,0,1,0
6021,25773,0,0,141,141,0,1,0,1,0
51376,6344,0,0,145,145,0,1,0,1,0
14291,3389,14291,3389,293,223,70,4,0,3,1
23630,3389,23630,3389,293,223,70,4,0,3,1
21032,3389,21032,3389,293,223,70,4,0,3,1
12662,3389,12662,3389,293,223,70,4,0,3,1
50501,32510,0,0,98,98,0,1,0,1,0
9738,3389,9738,3389,293,223,70,4,0,3,1
36485,8859,0,0,145,145,0,1,0,1,0
39216,60370,0,0,88,88,0,1,0,1,0
27443,3389,27443,3389,293,223,70,4,0,3,1
20421,3389,20421,3389,293,223,70,4,0,3,1
41952,9100,0,0,147,147,0,1,0,1,0
56860,3389,56860,3389,293,223,70,4,0,3,1
23601,32411,0,0,78,78,0,1,0,1,0
34454,3389,34454,3389,293,223,70,4,0,3,1
30882,2079,0,0,93,93,0,1,0,1,0
62847,43468,0,0,95,95,0,1,0,1,0
2816,22477,0,0,154,154,0,1,0,1,0
17750,3389,17750,3389,293,223,70,4,0,3,1
34869,3389,34869,3389,293,223,70,4,1,3,1
51832,5618,0,0,145,145,0,1,0,1,0
50842,29736,0,0,92,92,0,1,0,1,0
20971,3389,20971,3389,293,223,70,4,0,3,1
19012,61248,0,0,152,152,0,1,0,1,0
18527,3389,18527,3389,293,223,70,4,1,3,1
28943,34021,0,0,62,62,0,1,0,1,0
52471,33829,0,0,62,62,0,1,0,1,0
9866,25773,0,0,140,140,0,1,0,1,0
28273,34021,0,0,62,62,0,1,0,1,0
49276,26703,0,0,143,143,0,1,0,1,0
51376,30829,0,0,75,75,0,1,0,1,0
37350,3389,37350,3389,293,223,70,4,1,3,1
13479,61248,0,0,146,146,0,1,0,1,0
16034,21039,0,0,90,90,0,1,0,1,0
15316,25773,0,0,141,141,0,1,0,1,0
11283,25773,0,0,143,143,0,1,0,1,0
27709,25327,0,0,142,142,0,1,0,1,0
15055,61248,0,0,149,149,0,1,0,1,0
46952,49712,0,0,92,92,0,1,0,1,0
57690,31652,0,0,99,99,0,1,0,1,0
2284,23826,0,0,149,149,0,1,0,1,0
14067,11224,674,249,158,153,5,1,0,1,0
19240,3389,19240,3389,293,223,70,4,0,3,1
13065,3389,13065,3389,293,223,70,4,0,3,1
8428,61248,0,0,140,140,0,1,0,1,0
50371,29428,0,0,104,104,0,1,0,1,0
17213,16491,0,0,85,85,0,1,0,1,0
38206,4774,0,0,133,133,0,1,0,1,0
36341,8601,0,0,146,146,0,1,0,1,0
29825,1690,0,0,87,87,0,1,0,1,0
49954,27922,0,0,122,122,0,1,0,1,0
11898,5646,8040,2484,254,202,51,3,0,2,0
19189,3389,19189,3389,293,223,70,4,0,3,1
51292,31701,0,0,71,71,0,1,0,1,0
63630,3389,63630,3389,293,223,70,4,0,3,1
22882,33426,0,0,68,68,0,1,0,1,0
14066,3389,14066,3389,293,223,70,4,0,3,1
17780,18836,0,0,68,68,0,1,0,1,0
17998,18561,0,0,65,65,0,1,0,1,0
24852,34021,0,0,62,62,0,1,0,1,0
12705,61248,0,0,146,146,0,1,0,1,0
24313,30905,0,0,92,92,0,1,0,1,0
14704,3389,14704,3389,293,223,70,4,1,3,1
14659,3389,14659,3389,293,223,70,4,0,3,1
4742,23148,0,0,151,151,0,1,0,1,0
15008,3389,15008,3389,293,223,70,4,0,3,1
34255,7638,0,0,133,133,0,1,0,1,0
36908,8194,0,0,146,146,0,1,0,1,0
49036,30062,0,0,151,151,0,1,0,1,0
46219,58037,0,0,62,62,0,1,0,1,0
28808,3026,0,0,90,90,0,1,0,1,0
12895,3389,12895,3389,293,223,70,4,0,3,1
47000,60145,0,0,69,69,0,1,0,1,0
29502,34021,0,0,62,62,0,1,0,1,0
22722,21591,0,0,100,100,0,1,0,1,0
51649,17601,0,0,152,152,0,1,0,1,0
18640,61248,0,0,153,153,0,1,0,1,0
28912,34021,0,0,62,62,0,1,0,1,0
27906,34021,0,0,62,62,0,1,0,1,0
13325,9102,3559,1099,195,172,22,1,0,1,0
17707,28595,0,0,112,112,0,1,0,1,0
46763,51992,0,0,87,87,0,1,0,1,0
7393,25373,0,0,157,157,0,1,0,1,0
50041,33029,0,0,115,115,0,1,0,1,0
50870,31652,0,0,91,91,0,1,0,1,0
20838,31009,0,0,91,91,0,1,0,1,0
37985,3389,37985,3389,293,223,70,4,1,3,1
12114,3389,12114,3389,293,223,70,4,1,3,1
51099,30702,0,0,100,100,0,1,0,1,0
31052,3389,31052,3389,293,223,70,4,0,3,1
49810,27627,0,0,127,127,0,1,0,1,0
6949,25773,0,0,141,141,0,1,0,1,0
11604,61248,0,0,141,141,0,1,0,1,0
21096,30358,0,0,96,96,0,1,0,1,0
14043,3389,14043,3389,293,223,70,4,0,3,1
13544,3389,13544,3389,293,223,70,4,0,3,1
49567,31652,0,0,131,131,0,1,0,1,0
53748,45117,0,0,145,145,0,1,0,1,0
18239,18641,0,0,66,66,0,1,0,1,0
52191,32876,0,0,62,62,0,1,0,1,0
37433,3389,37433,3389,293,223,70,4,1,3,1
29711,32820,0,0,74,74,0,1,0,1,0
9986,3389,9986,3389,293,223,70,4,1,3,1
18926,3389,18926,3389,293,223,70,4,0,3,1
23553,3389,23553,3389,293,223,70,4,0,3,1
9809,61248,0,0,141,141,0,1,0,1,0
9849,25773,0,0,149,149,0,1,0,1,0
19039,43175,0,0,87,87,0,1,0,1,0
48361,60257,0,0,77,77,0,1,0,1,0
5819,24503,0,0,157,157,0,1,0,1,0
16579,3389,16579,3389,293,223,70,4,0,3,1
25673,3389,25673,3389,293,223,70,4,0,3,1
17205,19019,0,0,71,71,0,1,0,1,0
15464,3389,15464,3389,293,223,70,4,0,3,1
14650,54917,0,0,121,121,0,1,0,1,0
35746,3389,35746,3389,293,223,70,4,0,3,1
19290,61248,0,0,155,155,0,1,0,1,0
11368,61248,0,0,142,142,0,1,0,1,0
55597,31652,0,0,62,62,0,1,0,1,0
59889,3389,59889,3389,293,223,70,4,0,3,1
25455,25773,0,0,146,146,0,1,0,1,0
10826,3389,10826,3389,293,223,70,4,1,3,1
52157,33729,0,0,72,72,0,1,0,1,0
17487,25773,0,0,142,142,0,1,0,1,0
28849,34021,0,0,62,62,0,1,0,1,0
12025,3389,12025,3389,293,223,70,4,0,3,1
62259,3858,50543,2675,261,206,55,3,0,2,0
27783,33838,0,0,63,63,0,1,0,1,0
6937,23912,0,0,147,147,0,1,0,1,0
36441,8529,0,0,146,146,0,1,0,1,0
29414,34021,0,0,62,62,0,1,0,1,0
54399,60753,0,0,111,111,0,1,0,1,0
31307,3389,31307,3389,293,223,70,4,0,3,1
28300,25769,0,0,147,147,0,1,0,1,0
8524,61248,0,0,140,140,0,1,0,1,0
10127,25773,0,0,148,148,0,1,0,1,0
52318,33553,0,0,63,63,0,1,0,1,0
49160,32608,0,0,146,146,0,1,0,1,0
49429,34672,0,0,145,145,0,1,0,1,0
13505,3389,13505,3389,293,223,70,4,1,3,1
49160,33527,0,0,146,146,0,1,0,1,0
28522,34021,0,0,62,62,0,1,0,1,0
24792,61111,0,0,148,148,0,1,0,1,0
51736,32502,0,0,68,68,0,1,0,1,0
48974,28057,0,0,153,153,0,1,0,1,0
50074,33193,0,0,116,116,0,1,0,1,0
53801,16690,0,0,113,113,0,1,0,1,0
42487,60202,0,0,75,75,0,1,0,1,0
11428,61248,0,0,142,142,0,1,0,1,0
8839,57119,0,0,143,143,0,1,0,1,0
40155,60322,0,0,84,84,0,1,0,1,0
50891,32852,0,0,103,103,0,1,0,1,0
16481,25773,0,0,145,145,0,1,0,1,0
16664,61248,0,0,150,150,0,1,0,1,0
16654,15549,0,0,98,98,0,1,0,1,0
49081,29864,0,0,149,149,0,1,0,1,0
33777,60649,0,0,111,111,0,1,0,1,0
50557,32448,0,0,96,96,0,1,0,1,0
31536,3389,31536,3389,293,223,70,4,0,3,1
8426,55428,0,0,141,141,0,1,0,1,0
6434,52422,0,0,142,142,0,1,0,1,0
18127,3389,18127,3389,293,223,70,4,0,3,1
35146,10491,0,0,146,146,0,1,0,1,0
18075,3389,18075,3389,293,223,70,4,0,3,1
29473,34021,0,0,62,62,0,1,0,1,0
4370,23703,0,0,157,157,0,1,0,1,0
50630,31652,0,0,94,94,0,1,0,1,0
48522,3389,48522,3389,293,223,70,4,0,3,1
42590,34021,0,0,117,117,0,1,0,1,0
28226,29586,0,0,108,108,0,1,0,1,0
14302,12851,0,0,147,147,0,1,0,1,0
13887,61248,0,0,146,146,0,1,0,1,0
51370,30816,0,0,75,75,0,1,0,1,0
50949,31652,0,0,83,83,0,1,0,1,0
19017,3389,19017,3389,293,223,70,4,0,3,1
20193,3389,20193,3389,293,223,70,4,0,3,1
11022,3389,11022,3389,293,223,70,4,1,3,1
18148,21550,0,0,97,97,0,1,0,1,0
9136,56498,0,0,140,140,0,1,0,1,0
28236,29072,0,0,113,113,0,1,0,1,0
14901,25773,0,0,140,140,0,1,0,1,0
23149,21910,0,0,103,103,0,1,0,1,0
11795,3389,11795,3389,293,223,70,4,1,3,1
59493,3389,59493,3389,293,223,70,4,0,3,1
48969,27301,0,0,154,154,0,1,0,1,0
49733,33502,0,0,127,127,0,1,0,1,0
14185,27314,0,0,124,124,0,1,0,1,0
49087,29993,0,0,149,149,0,1,0,1,0
48935,25854,0,0,155,155,0,1,0,1,0
8258,61248,0,0,140,140,0,1,0,1,0
28554,27021,0,0,134,134,0,1,0,1,0
37309,3389,37309,3389,293,223,70,4,1,3,1
6079,18089,0,0,153,153,0,1,0,1,0
2384,41594,0,0,144,144,0,1,0,1,0
12030,61248,0,0,139,139,0,1,0,1,0
14209,11243,784,242,158,153,5,1,0,1,0
15619,25773,0,0,146,146,0,1,0,1,0
19293,3389,19293,3389,293,223,70,4,0,3,1
50281,29204,0,0,107,107,0,1,0,1,0
32231,2575,0,0,100,100,0,1,0,1,0
21892,32965,0,0,72,72,0,1,0,1,0
15434,3389,15434,3389,293,223,70,4,0,3,1
19599,59304,0,0,157,157,0,1,0,1,0
11053,3389,11053,3389,293,223,70,4,0,3,1
48571,38434,0,0,131,131,0,1,0,1,0
34914,3389,34914,3389,293,223,70,4,0,3,1
16642,3389,16642,3389,293,223,70,4,0,3,1
13014,57101,0,0,130,130,0,1,0,1,0
34036,3389,34036,3389,293,223,70,4,0,3,1
51264,31649,0,0,72,72,0,1,0,1,0
24434,31004,0,0,91,91,0,1,0,1,0
12658,3389,12658,3389,293,223,70,4,0,3,1
11636,3389,11636,3389,293,223,70,4,1,3,1
52249,25846,0,0,88,88,0,1,0,1,0
14044,3389,14044,3389,293,223,70,4,0,3,1
11103,3389,11103,3389,293,223,70,4,1,3,1
15859,21260,0,0,92,92,0,1,0,1,0
27885,26365,0,0,141,141,0,1,0,1,0
6230,24391,0,0,128,128,0,1,0,1,0
28354,34021,0,0,62,62,0,1,0,1,0
28873,1340,0,0,82,82,0,1,0,1,0
10323,5265,7115,2637,260,206,54,3,0,2,0
10607,25773,0,0,139,139,0,1,0,1,0
33104,2896,0,0,105,105,0,1,0,1,0
26216,34021,0,0,62,62,0,1,0,1,0
18527,3389,18527,3389,293,223,70,4,0,3,1
51745,31652,0,0,62,62,0,1,0,1,0
13127,56824,0,0,129,129,0,1,0,1,0
13425,9344,3245,1003,190,170,20,1,0,1,0
31532,2318,0,0,96,96,0,1,0,1,0
14694,3389,14694,3389,293,223,70,4,0,3,1
23599,34021,0,0,62,62,0,1,0,1,0
23622,34021,0,0,62,62,0,1,0,1,0
10817,61248,0,0,142,142,0,1,0,1,0
11411,3389,11411,3389,293,223,70,4,1,3,1
17038,25773,0,0,142,142,0,1,0,1,0
55557,33427,0,0,62,62,0,1,0,1,0
30096,3389,30096,3389,293,223,70,4,0,3,1
51895,32789,0,0,67,67,0,1,0,1,0
25460,3389,25460,3389,293,223,70,4,0,3,1
61435,53805,0,0,124,124,0,1,0,1,0
49160,33169,0,0,146,146,0,1,0,1,0
48919,26317,0,0,156,156,0,1,0,1,0
28279,27023,0,0,134,134,0,1,0,1,0
56005,33337,0,0,62,62,0,1,0,1,0
51532,32134,0,0,69,69,0,1,0,1,0
28768,34021,0,0,62,62,0,1,0,1,0
16002,21080,0,0,91,91,0,1,0,1,0
31908,5651,0,0,114,114,0,1,0,1,0
9097,25773,0,0,155,155,0,1,0,1,0
49160,33105,0,0,146,146,0,1,0,1,0
7880,54604,0,0,141,141,0,1,0,1,0
15346,61248,0,0,148,148,0,1,0,1,0
5505,24762,0,0,132,132,0,1,0,1,0
3412,47864,0,0,144,144,0,1,0,1,0
57097,5238,10899,577,170,158,11,1,0,1,0
49160,32675,0,0,146,146,0,1,0,1,0
22728,34021,0,0,62,62,0,1,0,1,0
19369,1393,4508,1393,156,128,28,2,0,1,0
21395,36623,0,0,69,69,0,1,0,1,0
50018,34021,0,0,124,124,0,1,0,1,0
12143,3389,12143,3389,293,223,70,4,0,3,1
49160,31765,0,0,146,146,0,1,0,1,0
28251,12966,0,0,109,109,0,1,0,1,0
38500,3389,38500,3389,293,223,70,4,1,3,1
30933,3389,30933,3389,293,223,70,4,0,3,1
17952,3389,17952,3389,293,223,70,4,0,3,1
47134,60156,0,0,70,70,0,1,0,1,0
52043,33057,0,0,66,66,0,1,0,1,0
7844,61248,0,0,139,139,0,1,0,1,0
34334,34021,0,0,81,81,0,1,0,1,0
36444,3389,36444,3389,293,223,70,4,1,3,1
50373,29433,0,0,104,104,0,1,0,1,0
50684,32642,0,0,97,97,0,1,0,1,0
26572,1133,0,0,72,72,0,1,0,1,0
29118,3389,29118,3389,293,223,70,4,0,3,1
22846,641,2382,640,105,92,13,1,0,1,0
3052,22974,0,0,157,157,0,1,0,1,0
10146,3389,10146,3389,293,223,70,4,1,3,1
5906,52231,0,0,144,144,0,1,0,1,0
11068,14372,0,0,150,150,0,1,0,1,0
59573,31652,0,0,62,62,0,1,0,1,0
21959,28497,0,0,116,116,0,1,0,1,0
9697,58549,0,0,143,143,0,1,0,1,0
11439,3389,11439,3389,293,223,70,4,0,3,1
14875,61248,0,0,148,148,0,1,0,1,0
51428,31441,0,0,91,91,0,1,0,1,0
59720,31652,0,0,62,62,0,1,0,1,0
64146,33952,0,0,68,68,0,1,0,1,0
9966,25773,0,0,140,140,0,1,0,1,0
50338,32954,0,0,108,108,0,1,0,1,0
52998,33426,0,0,124,124,0,1,0,1,0
51948,6247,0,0,145,145,0,1,0,1,0
27821,26455,0,0,140,140,0,1,0,1,0
17457,47407,0,0,99,99,0,1,0,1,0
18404,3389,18404,3389,293,223,70,4,1,3,1
49247,31652,0,0,142,142,0,1,0,1,0
59523,32416,0,0,89,89,0,1,0,1,0
3713,25773,0,0,143,143,0,1,0,1,0
24257,31485,0,0,88,88,0,1,0,1,0
49076,29741,0,0,149,149,0,1,0,1,0
38441,3389,38441,3389,293,223,70,4,1,3,1
46672,3389,46672,3389,293,223,70,4,0,3,1
10122,3389,10122,3389,293,223,70,4,1,3,1
8053,25738,0,0,157,157,0,1,0,1,0
27785,2161,0,0,82,82,0,1,0,1,0
8384,61248,0,0,140,140,0,1,0,1,0
55614,31652,0,0,62,62,0,1,0,1,0
20571,38637,0,0,75,75,0,1,0,1,0
56247,51159,0,0,145,145,0,1,0,1,0
19299,6526,0,0,109,109,0,1,0,1,0
10875,3389,10875,3389,293,223,70,4,0,3,1
56701,3389,56701,3389,293,223,70,4,0,3,1
13393,3389,13393,3389,293,223,70,4,0,3,1
19314,3389,19314,3389,293,223,70,4,0,3,1
19158,61248,0,0,154,154,0,1,0,1,0
11524,23240,0,0,125,125,0,1,0,1,0
17137,25773,0,0,142,142,0,1,0,1,0
14264,11375,612,189,156,152,3,1,0,1,0
60667,32239,0,0,82,82,0,1,0,1,0
15379,3389,15379,3389,293,223,70,4,0,3,1
8012,23465,0,0,151,151,0,1,0,1,0
49663,27667,0,0,129,129,0,1,0,1,0
28777,28142,0,0,123,123,0,1,0,1,0
9911,3389,9911,3389,293,223,70,4,1,3,1
13878,25773,0,0,140,140,0,1,0,1,0
50418,32604,0,0,101,101,0,1,0,1,0
21614,3389,21614,3389,293,223,70,4,0,3,1
1764,23011,0,0,152,152,0,1,0,1,0
6682,25773,0,0,141,141,0,1,0,1,0
50575,31652,0,0,96,96,0,1,0,1,0
26568,34021,0,0,62,62,0,1,0,1,0
12507,8742,3357,1244,201,175,25,2,0,1,0
17256,3389,17256,3389,293,223,70,4,0,3,1
49291,33873,0,0,141,141,0,1,0,1,0
50823,30082,0,0,107,107,0,1,0,1,0
4604,23100,0,0,151,151,0,1,0,1,0
53495,18493,0,0,108,108,0,1,0,1,0
17539,42900,0,0,87,87,0,1,0,1,0
18026,3389,18026,3389,293,223,70,4,0,3,1
19219,61248,0,0,153,153,0,1,0,1,0
54346,14509,0,0,116,116,0,1,0,1,0
4747,25773,0,0,146,146,0,1,0,1,0
50779,29608,0,0,95,95,0,1,0,1,0
51990,32960,0,0,66,66,0,1,0,1,0
10437,25773,0,0,139,139,0,1,0,1,0
35489,3774,0,0,118,118,0,1,0,1,0
39747,3389,39747,3389,293,223,70,4,0,3,1
42817,11176,0,0,149,149,0,1,0,1,0
19104,26659,0,0,134,134,0,1,0,1,0
28128,3389,28128,3389,293,223,70,4,0,3,1
15507,61248,0,0,150,150,0,1,0,1,0
49757,27520,0,0,128,128,0,1,0,1,0
11233,4034,10129,3130,281,217,64,3,0,2,0
58042,53107,0,0,122,122,0,1,0,1,0
50162,32892,0,0,110,110,0,1,0,1,0
63029,3389,63029,3389,293,223,70,4,0,3,1
14244,25773,0,0,140,140,0,1,0,1,0
3134,25156,0,0,145,145,0,1,0,1,0
56749,31652,0,0,67,67,0,1,0,1,0
19374,3389,19374,3389,293,223,70,4,0,3,1
18103,22989,0,0,113,113,0,1,0,1,0
45064,60070,0,0,64,64,0,1,0,1,0
4476,52828,0,0,142,142,0,1,0,1,0
49130,26238,0,0,149,149,0,1,0,1,0
50838,34021,0,0,104,104,0,1,0,1,0
13124,8615,4190,1294,203,176,26,2,0,1,0
17137,19647,0,0,76,76,0,1,0,1,0
8023,61248,0,0,139,139,0,1,0,1,0
10824,25265,0,0,141,141,0,1,0,1,0
47009,3389,47009,3389,293,223,70,4,0,3,1
54179,31652,0,0,62,62,0,1,0,1,0
14609,22838,0,0,108,108,0,1,0,1,0
49096,30204,0,0,148,148,0,1,0,1,0
49160,33647,0,0,146,146,0,1,0,1,0
28647,3389,28647,3389,293,223,70,4,0,3,1
16603,3389,16603,3389,293,223,70,4,0,3,1
51677,34021,0,0,84,84,0,1,0,1,0
37627,10365,0,0,146,146,0,1,0,1,0
28355,25661,0,0,147,147,0,1,0,1,0
4072,25773,0,0,142,142,0,1,0,1,0
50441,31652,0,0,100,100,0,1,0,1,0
20999,31308,0,0,88,88,0,1,0,1,0
48934,26769,0,0,155,155,0,1,0,1,0
1355,21969,0,0,156,156,0,1,0,1,0
44552,60096,0,0,66,66,0,1,0,1,0
15139,3389,15139,3389,293,223,70,4,0,3,1
28138,33875,0,0,63,63,0,1,0,1,0
10497,25773,0,0,139,139,0,1,0,1,0
25505,14415,0,0,96,96,0,1,0,1,0
10369,25773,0,0,147,147,0,1,0,1,0
44714,7469,0,0,145,145,0,1,0,1,0
8785,55969,0,0,141,141,0,1,0,1,0
49146,33595,0,0,146,146,0,1,0,1,0
31787,5548,0,0,113,113,0,1,0,1,0
51384,31652,0,0,74,74,0,1,0,1,0
50879,34021,0,0,103,103,0,1,0,1,0
49953,3389,49953,3389,293,223,70,4,0,3,1
20546,30467,0,0,96,96,0,1,0,1,0
5094,23270,0,0,150,150,0,1,0,1,0
27075,33469,0,0,67,67,0,1,0,1,0
7608,25773,0,0,155,155,0,1,0,1,0
12471,22537,0,0,116,116,0,1,0,1,0
37823,3389,37823,3389,293,223,70,4,1,3,1
50291,28612,0,0,111,111,0,1,0,1,0
20327,3389,20327,3389,293,223,70,4,0,3,1
46845,55673,0,0,62,62,0,1,0,1,0
39662,3389,39662,3389,293,223,70,4,0,3,1
49137,31136,0,0,146,146,0,1,0,1,0
28868,28598,0,0,118,118,0,1,0,1,0
12564,3389,12564,3389,293,223,70,4,0,3,1
11492,23264,0,0,125,125,0,1,0,1,0
49955,3389,49955,3389,293,223,70,4,0,3,1
61989,3389,61989,3389,293,223,70,4,0,3,1
18119,22484,0,0,107,107,0,1,0,1,0
26216,24208,0,0,130,130,0,1,0,1,0
51531,31652,0,0,66,66,0,1,0,1,0
52554,33950,0,0,62,62,0,1,0,1,0
26804,27891,0,0,125,125,0,1,0,1,0
13525,25773,0,0,139,139,0,1,0,1,0
49093,31890,0,0,148,148,0,1,0,1,0
50448,31652,0,0,138,138,0,1,0,1,0
58965,56200,0,0,129,129,0,1,0,1,0
24414,34021,0,0,62,62,0,1,0,1,0
51789,31688,0,0,62,62,0,1,0,1,0
50668,20520,0,0,153,153,0,1,0,1,0
52547,31652,0,0,71,71,0,1,0,1,0
11090,3389,11090,3389,293,223,70,4,1,3,1
52284,33149,0,0,62,62,0,1,0,1,0
11905,25773,0,0,140,140,0,1,0,1,0
3038,25005,0,0,145,145,0,1,0,1,0
28970,34021,0,0,62,62,0,1,0,1,0
48985,27668,0,0,153,153,0,1,0,1,0
29870,3389,29870,3389,293,223,70,4,0,3,1
10605,25773,0,0,146,146,0,1,0,1,0
50193,32367,0,0,120,120,0,1,0,1,0
25020,3389,25020,3389,293,223,70,4,0,3,1
49933,31652,0,0,118,118,0,1,0,1,0
49132,26344,0,0,148,148,0,1,0,1,0
20533,27512,0,0,125,125,0,1,0,1,0
24906,14731,0,0,93,93,0,1,0,1,0
11903,25640,0,0,139,139,0,1,0,1,0
41619,3389,41619,3389,293,223,70,4,0,3,1
3957,25773,0,0,144,144,0,1,0,1,0
19286,28129,0,0,119,119,0,1,0,1,0
51564,60520,0,0,95,95,0,1,0,1,0
10802,59011,0,0,139,139,0,1,0,1,0
30996,19761,0,0,147,147,0,1,0,1,0
40278,5776,0,0,146,146,0,1,0,1,0
19542,41830,0,0,84,84,0,1,0,1,0
12709,25234,0,0,133,133,0,1,0,1,0
47462,22317,0,0,155,155,0,1,0,1,0
3179,47686,0,0,144,144,0,1,0,1,0
51794,31699,0,0,62,62,0,1,0,1,0
19395,39552,0,0,77,77,0,1,0,1,0
52067,32507,0,0,62,62,0,1,0,1,0
18845,18686,0,0,67,67,0,1,0,1,0
31061,2145,0,0,94,94,0,1,0,1,0
14113,3389,14113,3389,293,223,70,4,0,3,1
26275,28637,0,0,118,118,0,1,0,1,0
7404,61248,0,0,139,139,0,1,0,1,0
58197,31652,0,0,66,66,0,1,0,1,0
8709,55854,0,0,141,141,0,1,0,1,0
58872,31652,0,0,62,62,0,1,0,1,0
7703,25545,0,0,157,157,0,1,0,1,0
3934,48944,0,0,144,144,0,1,0,1,0
24326,3389,24326,3389,293,223,70,4,0,3,1
32013,3389,32013,3389,293,223,70,4,0,3,1
8349,56301,0,0,143,143,0,1,0,1,0
18267,44267,0,0,92,92,0,1,0,1,0
10808,25773,0,0,145,145,0,1,0,1,0
26819,27869,0,0,126,126,0,1,0,1,0
44776,15874,0,0,151,151,0,1,0,1,0
22698,15896,0,0,83,83,0,1,0,1,0
8976,61248,0,0,140,140,0,1,0,1,0
33715,16831,0,0,147,147,0,1,0,1,0
16906,3389,16906,3389,293,223,70,4,0,3,1
19363,3389,19363,3389,293,223,70,4,0,3,1
18176,61248,0,0,153,153,0,1,0,1,0
11973,3389,11973,3389,293,223,70,4,0,3,1
60710,59112,0,0,139,139,0,1,0,1,0
52260,31652,0,0,71,71,0,1,0,1,0
21516,16519,0,0,77,77,0,1,0,1,0
6581,30875,0,0,153,153,0,1,0,1,0
28602,27265,0,0,132,132,0,1,0,1,0
9890,25773,0,0,149,149,0,1,0,1,0
18651,26211,0,0,138,138,0,1,0,1,0
34992,3389,34992,3389,293,223,70,4,0,3,1
11653,3389,11653,3389,293,223,70,4,1,3,1
50050,28629,0,0,115,115,0,1,0,1,0
18810,3389,18810,3389,293,223,70,4,0,3,1
2836,35350,0,0,143,143,0,1,0,1,0
48903,35946,0,0,139,139,0,1,0,1,0
40612,34021,0,0,108,108,0,1,0,1,0
9442,61248,0,0,141,141,0,1,0,1,0
25887,29184,0,0,112,112,0,1,0,1,0
51222,60492,0,0,93,93,0,1,0,1,0
37496,3389,37496,3389,293,223,70,4,1,3,1
51689,31652,0,0,63,63,0,1,0,1,0
49156,31577,0,0,146,146,0,1,0,1,0
49723,27613,0,0,135,135,0,1,0,1,0
49741,33366,0,0,125,125,0,1,0,1,0
50832,32508,0,0,92,92,0,1,0,1,0
24852,32313,0,0,77,77,0,1,0,1,0
44734,15774,0,0,151,151,0,1,0,1,0
51386,31652,0,0,69,69,0,1,0,1,0
28573,34021,0,0,62,62,0,1,0,1,0
35558,3389,35558,3389,293,223,70,4,0,3,1
9258,15720,0,0,151,151,0,1,0,1,0
12298,25674,0,0,139,139,0,1,0,1,0
52116,33700,0,0,73,73,0,1,0,1,0
22578,34021,0,0,62,62,0,1,0,1,0
49827,33270,0,0,122,122,0,1,0,1,0
47208,21708,0,0,154,154,0,1,0,1,0
59310,61156,0,0,138,138,0,1,0,1,0
31831,2428,0,0,98,98,0,1,0,1,0
3364,28054,0,0,143,143,0,1,0,1,0
48966,27796,0,0,154,154,0,1,0,1,0
10216,3389,10216,3389,293,223,70,4,0,3,1
18377,3389,18377,3389,293,223,70,4,0,3,1
7564,25773,0,0,155,155,0,1,0,1,0
51293,31137,0,0,95,95,0,1,0,1,0
24869,30622,0,0,97,97,0,1,0,1,0
3749,25660,0,0,141,141,0,1,0,1,0
50281,32429,0,0,118,118,0,1,0,1,0
4537,25773,0,0,142,142,0,1,0,1,0
14755,20839,0,0,94,94,0,1,0,1,0
7586,61248,0,0,139,139,0,1,0,1,0
36487,8497,0,0,146,146,0,1,0,1,0
29155,3389,29155,3389,293,223,70,4,0,3,1
57012,3389,57012,3389,293,223,70,4,0,3,1
26946,33052,0,0,71,71,0,1,0,1,0
20927,31174,0,0,89,89,0,1,0,1,0
10936,25304,0,0,141,141,0,1,0,1,0
13786,3389,13786,3389,293,223,70,4,0,3,1
13386,3389,13386,3389,293,223,70,4,0,3,1
29640,32464,0,0,78,78,0,1,0,1,0
48262,5618,0,0,145,145,0,1,0,1,0
51001,30063,0,0,87,87,0,1,0,1,0
41997,7928,0,0,145,145,0,1,0,1,0
11856,61248,0,0,140,140,0,1,0,1,0
26387,3389,26387,3389,293,223,70,4,0,3,1
58988,4732,25424,1346,203,175,27,2,0,1,0
29853,34021,0,0,62,62,0,1,0,1,0
49160,32001,0,0,146,146,0,1,0,1,0
5089,54609,0,0,141,141,0,1,0,1,0
49002,28043,0,0,152,152,0,1,0,1,0
22757,2723,0,0,81,81,0,1,0,1,0
8767,61248,0,0,140,140,0,1,0,1,0
37526,7751,0,0,146,146,0,1,0,1,0
27505,26901,0,0,136,136,0,1,0,1,0
6271,49070,0,0,147,147,0,1,0,1,0
35514,8704,0,0,143,143,0,1,0,1,0
37145,8747,0,0,145,145,0,1,0,1,0
1528,22643,0,0,154,154,0,1,0,1,0
10071,61248,0,0,141,141,0,1,0,1,0
14311,21169,0,0,98,98,0,1,0,1,0
49458,3389,49458,3389,293,223,70,4,0,3,1
24182,22684,0,0,112,112,0,1,0,1,0
21938,3389,21938,3389,293,223,70,4,0,3,1
52104,33693,0,0,73,73,0,1,0,1,0
31732,5502,0,0,113,113,0,1,0,1,0
51132,31652,0,0,82,82,0,1,0,1,0
30521,1946,0,0,91,91,0,1,0,1,0
6602,52677,0,0,142,142,0,1,0,1,0
19657,31749,0,0,83,83,0,1,0,1,0
34868,3389,34868,3389,293,223,70,4,0,3,1
51505,31899,0,0,70,70,0,1,0,1,0
51769,33460,0,0,81,81,0,1,0,1,0
51636,31652,0,0,64,64,0,1,0,1,0
26966,34021,0,0,62,62,0,1,0,1,0
51366,31652,0,0,70,70,0,1,0,1,0
20593,3389,20593,3389,293,223,70,4,0,3,1
20278,32252,0,0,78,78,0,1,0,1,0
50261,32780,0,0,107,107,0,1,0,1,0
11130,6549,5727,2122,238,194,43,2,0,2,0
3949,25773,0,0,142,142,0,1,0,1,0
50571,20810,0,0,154,154,0,1,0,1,0
12404,25619,0,0,137,137,0,1,0,1,0
26041,28967,0,0,114,114,0,1,0,1,0
17819,25000,0,0,143,143,0,1,0,1,0
14137,25773,0,0,140,140,0,1,0,1,0
15978,25773,0,0,145,145,0,1,0,1,0
17713,46723,0,0,97,97,0,1,0,1,0
17169,3389,17169,3389,293,223,70,4,0,3,1
2909,47105,0,0,144,144,0,1,0,1,0
51307,31729,0,0,71,71,0,1,0,1,0
15576,3389,15576,3389,293,223,70,4,0,3,1
13693,3389,13693,3389,293,223,70,4,0,3,1
25813,34021,0,0,62,62,0,1,0,1,0
51623,31652,0,0,65,65,0,1,0,1,0
14036,23561,0,0,116,116,0,1,0,1,0
50757,30388,0,0,90,90,0,1,0,1,0
52377,33427,0,0,62,62,0,1,0,1,0
52762,22818,0,0,96,96,0,1,0,1,0
50968,31652,0,0,82,82,0,1,0,1,0
10113,3389,10113,3389,293,223,70,4,1,3,1
49605,27520,0,0,131,131,0,1,0,1,0
39102,60376,0,0,89,89,0,1,0,1,0
9933,3389,9933,3389,293,223,70,4,1,3,1
51142,33025,0,0,97,97,0,1,0,1,0
20315,3389,20315,3389,293,223,70,4,0,3,1
8218,55114,0,0,141,141,0,1,0,1,0
15176,28118,0,0,117,117,0,1,0,1,0
25565,31926,0,0,82,82,0,1,0,1,0
12271,61248,0,0,145,145,0,1,0,1,0
22087,25773,0,0,144,144,0,1,0,1,0
53184,60653,0,0,104,104,0,1,0,1,0
38328,3389,38328,3389,293,223,70,4,1,3,1
7418,61248,0,0,139,139,0,1,0,1,0
21325,3389,21325,3389,293,223,70,4,0,3,1
12081,21398,0,0,95,95,0,1,0,1,0
6307,24351,0,0,127,127,0,1,0,1,0
18346,3389,18346,3389,293,223,70,4,0,3,1
50618,34021,0,0,110,110,0,1,0,1,0
11843,3389,11843,3389,293,223,70,4,0,3,1
51392,34021,0,0,91,91,0,1,0,1,0
16624,9466,0,0,130,130,0,1,0,1,0
51298,31652,0,0,71,71,0,1,0,1,0
14382,3389,14382,3389,293,223,70,4,0,3,1
42172,60218,0,0,76,76,0,1,0,1,0
18032,25285,0,0,137,137,0,1,0,1,0
17539,18771,0,0,68,68,0,1,0,1,0
16246,3389,16246,3389,293,223,70,4,0,3,1
51552,32171,0,0,69,69,0,1,0,1,0
56292,60908,0,0,121,121,0,1,0,1,0
51155,31775,0,0,75,75,0,1,0,1,0
48974,25919,0,0,154,154,0,1,0,1,0
17655,3389,17655,3389,293,223,70,4,0,3,1
11831,7665,4520,1675,219,185,34,2,0,1,0
14179,2966,11032,2966,264,202,61,3,0,2,0
1937,22358,0,0,157,157,0,1,0,1,0
14117,61248,0,0,148,148,0,1,0,1,0
49411,33793,0,0,137,137,0,1,0,1,0
16811,15813,0,0,94,94,0,1,0,1,0
23952,305,984,304,82,76,6,1,0,1,0
9992,4739,7684,2847,269,211,58,3,0,2,0
38084,3389,38084,3389,293,223,70,4,1,3,1
51440,60510,0,0,94,94,0,1,0,1,0
49160,33699,0,0,146,146,0,1,0,1,0
13824,15907,0,0,145,145,0,1,0,1,0
24087,31725,0,0,85,85,0,1,0,1,0
15302,3389,15302,3389,293,223,70,4,0,3,1
14675,61248,0,0,148,148,0,1,0,1,0
21246,3389,21246,3389,293,223,70,4,0,3,1
63236,40619,0,0,87,87,0,1,0,1,0
17133,25773,0,0,144,144,0,1,0,1,0
49954,28132,0,0,129,129,0,1,0,1,0
14409,2571,8320,2571,237,184,53,3,0,2,0
12557,3389,12557,3389,293,223,70,4,0,3,1
13981,24842,0,0,146,146,0,1,0,1,0
12989,57162,0,0,130,130,0,1,0,1,0
49898,28006,0,0,131,131,0,1,0,1,0
15839,3389,15839,3389,293,223,70,4,0,3,1
18170,20868,0,0,90,90,0,1,0,1,0
12430,8619,3489,1293,203,176,26,2,0,1,0
51680,34021,0,0,84,84,0,1,0,1,0
13637,17106,0,0,144,144,0,1,0,1,0
52282,34021,0,0,69,69,0,1,0,1,0
15600,3389,15600,3389,293,223,70,4,0,3,1
28224,29660,0,0,107,107,0,1,0,1,0
21471,3389,21471,3389,293,223,70,4,0,3,1
2483,47030,0,0,144,144,0,1,0,1,0
2472,47001,0,0,144,144,0,1,0,1,0
3458,25662,0,0,143,143,0,1,0,1,0
2093,23527,0,0,151,151,0,1,0,1,0
19128,3389,19128,3389,293,223,70,4,0,3,1
33324,3389,33324,3389,293,223,70,4,0,3,1
11576,4865,9053,2797,267,209,57,3,0,2,0
54948,10486,0,0,129,129,0,1,0,1,0
18042,1930,7176,1929,193,153,39,2,0,2,0
49611,27221,0,0,133,133,0,1,0,1,0
9562,4055,8423,3122,281,217,64,3,0,2,0
52044,16427,0,0,151,151,0,1,0,1,0
39227,34021,0,0,102,102,0,1,0,1,0
51443,31475,0,0,91,91,0,1,0,1,0
21705,61248,0,0,158,158,0,1,0,1,0
25730,183,0,0,64,64,0,1,0,1,0
16455,48692,0,0,105,105,0,1,0,1,0
29141,29965,0,0,104,104,0,1,0,1,0
60350,31652,0,0,84,84,0,1,0,1,0
11876,61248,0,0,140,140,0,1,0,1,0
5223,51093,0,0,144,144,0,1,0,1,0
10248,3389,10248,3389,293,223,70,4,1,3,1
11982,24381,0,0,147,147,0,1,0,1,0
23481,31599,0,0,84,84,0,1,0,1,0
18097,23180,0,0,115,115,0,1,0,1,0
19033,18827,0,0,68,68,0,1,0,1,0
56849,49020,0,0,110,110,0,1,0,1,0
53794,3389,53794,3389,293,223,70,4,0,3,1
28264,27760,0,0,127,127,0,1,0,1,0
28805,3389,28805,3389,293,223,70,4,0,3,1
17247,3389,17247,3389,293,223,70,4,0,3,1
14793,2801,10418,2801,252,195,57,3,0,2,0
5866,25773,0,0,150,150,0,1,0,1,0
14595,27647,0,0,121,121,0,1,0,1,0
39184,6561,0,0,146,146,0,1,0,1,0
26670,3389,26670,3389,293,223,70,4,0,3,1
17295,28381,0,0,114,114,0,1,0,1,0
49051,26077,0,0,152,152,0,1,0,1,0
16855,3389,16855,3389,293,223,70,4,0,3,1
20214,3389,20214,3389,293,223,70,4,0,3,1
17659,2032,7558,2032,200,158,41,2,0,2,0
40222,5816,0,0,146,146,0,1,0,1,0
7422,61248,0,0,139,139,0,1,0,1,0
56999,60967,0,0,125,125,0,1,0,1,0
25486,61075,0,0,145,145,0,1,0,1,0
31367,5193,0,0,110,110,0,1,0,1,0
50037,28318,0,0,127,127,0,1,0,1,0
14261,3389,14261,3389,293,223,70,4,0,3,1
13239,3389,13239,3389,293,223,70,4,0,3,1
38071,3389,38071,3389,293,223,70,4,1,3,1
51907,32031,0,0,62,62,0,1,0,1,0
20437,27445,0,0,126,126,0,1,0,1,0
16801,3389,16801,3389,293,223,70,4,0,3,1
19170,61248,0,0,154,154,0,1,0,1,0
14433,23060,0,0,111,111,0,1,0,1,0
2627,38237,0,0,144,144,0,1,0,1,0
13215,25773,0,0,139,139,0,1,0,1,0
24998,23296,0,0,119,119,0,1,0,1,0
9861,25773,0,0,154,154,0,1,0,1,0
8611,61248,0,0,140,140,0,1,0,1,0
48957,27016,0,0,154,154,0,1,0,1,0
23086,34021,0,0,62,62,0,1,0,1,0
38057,3389,38057,3389,293,223,70,4,1,3,1
18172,20797,0,0,89,89,0,1,0,1,0
44339,60107,0,0,67,67,0,1,0,1,0
50856,31652,0,0,91,91,0,1,0,1,0
51860,31893,0,0,62,62,0,1,0,1,0
54759,33154,0,0,115,115,0,1,0,1,0
49670,27682,0,0,129,129,0,1,0,1,0
20934,1154,4290,1153,140,116,23,2,0,1,0
1287,21657,0,0,156,156,0,1,0,1,0
61726,31652,0,0,77,77,0,1,0,1,0
61479,53484,0,0,123,123,0,1,0,1,0
52523,31652,0,0,71,71,0,1,0,1,0
12426,24853,0,0,139,139,0,1,0,1,0
50568,29178,0,0,101,101,0,1,0,1,0
51796,31704,0,0,62,62,0,1,0,1,0
17577,61248,0,0,149,149,0,1,0,1,0
9256,61248,0,0,141,141,0,1,0,1,0
18188,20267,0,0,83,83,0,1,0,1,0
17197,16464,0,0,85,85,0,1,0,1,0
13882,10452,1809,559,171,160,11,1,0,1,0
51197,31484,0,0,74,74,0,1,0,1,0
23221,3389,23221,3389,293,223,70,4,0,3,1
33639,16956,0,0,147,147,0,1,0,1,0
13107,2880,9321,2880,258,198,59,3,0,2,0
12879,3389,12879,3389,293,223,70,4,0,3,1
49660,34021,0,0,133,133,0,1,0,1,0
11139,3389,11139,3389,293,223,70,4,1,3,1
21953,61248,0,0,158,158,0,1,0,1,0
12894,13013,0,0,149,149,0,1,0,1,0
28182,25946,0,0,146,146,0,1,0,1,0
52106,32621,0,0,62,62,0,1,0,1,0
4355,52475,0,0,142,142,0,1,0,1,0
14807,61248,0,0,149,149,0,1,0,1,0
1198,21914,0,0,156,156,0,1,0,1,0
5694,56370,0,0,140,140,0,1,0,1,0
36599,3389,36599,3389,293,223,70,4,0,3,1
12526,3389,12526,3389,293,223,70,4,1,3,1
48993,27852,0,0,153,153,0,1,0,1,0
30735,3389,30735,3389,293,223,70,4,0,3,1
50196,28993,0,0,110,110,0,1,0,1,0
48690,6797,0,0,145,145,0,1,0,1,0
31112,11457,0,0,123,123,0,1,0,1,0
46560,5618,0,0,145,145,0,1,0,1,0
50074,28166,0,0,118,118,0,1,0,1,0
7707,61248,0,0,139,139,0,1,0,1,0
50930,32878,0,0,102,102,0,1,0,1,0
13910,3389,13910,3389,293,223,70,4,0,3,1
15229,20487,0,0,90,90,0,1,0,1,0
3240,41982,0,0,147,147,0,1,0,1,0
50943,30851,0,0,83,83,0,1,0,1,0
27507,25773,0,0,147,147,0,1,0,1,0
29050,34021,0,0,62,62,0,1,0,1,0
20362,3389,20362,3389,293,223,70,4,0,3,1
27457,32297,0,0,78,78,0,1,0,1,0
36642,8385,0,0,146,146,0,1,0,1,0
12344,53734,0,0,152,152,0,1,0,1,0
9973,59009,0,0,143,143,0,1,0,1,0
25724,3389,25724,3389,293,223,70,4,0,3,1
43610,3389,43610,3389,293,223,70,4,0,3,1
2860,35020,0,0,143,143,0,1,0,1,0
1579,22161,0,0,157,157,0,1,0,1,0
51475,31926,0,0,71,71,0,1,0,1,0
18078,3389,18078,3389,293,223,70,4,0,3,1
15748,3389,15748,3389,293,223,70,4,0,3,1
49646,33581,0,0,130,130,0,1,0,1,0
33897,3389,33897,3389,293,223,70,4,0,3,1
28510,34021,0,0,62,62,0,1,0,1,0
12266,3389,12266,3389,293,223,70,4,0,3,1
31673,5453,0,0,113,113,0,1,0,1,0
11631,25773,0,0,139,139,0,1,0,1,0
49350,26887,0,0,140,140,0,1,0,1,0
56561,48032,0,0,107,107,0,1,0,1,0
18182,20463,0,0,85,85,0,1,0,1,0
46221,7214,0,0,145,145,0,1,0,1,0
10291,25773,0,0,147,147,0,1,0,1,0
24303,34021,0,0,62,62,0,1,0,1,0
3280,29206,0,0,143,143,0,1,0,1,0
10229,25773,0,0,139,139,0,1,0,1,0
2117,45287,0,0,144,144,0,1,0,1,0
17355,3389,17355,3389,293,223,70,4,0,3,1
52002,32313,0,0,62,62,0,1,0,1,0
43513,7672,0,0,145,145,0,1,0,1,0
27966,13117,0,0,108,108,0,1,0,1,0
16481,3389,16481,3389,293,223,70,4,0,3,1
20864,20199,0,0,84,84,0,1,0,1,0
9909,25773,0,0,154,154,0,1,0,1,0
55269,3389,55269,3389,293,223,70,4,0,3,1
14597,3389,14597,3389,293,223,70,4,0,3,1
50743,32239,0,0,90,90,0,1,0,1,0
50505,32803,0,0,102,102,0,1,0,1,0
24994,31461,0,0,87,87,0,1,0,1,0
22618,3389,22618,3389,293,223,70,4,0,3,1
50526,34021,0,0,112,112,0,1,0,1,0
2287,23830,0,0,149,149,0,1,0,1,0
30792,3389,30792,3389,293,223,70,4,0,3,1
3869,51063,0,0,142,142,0,1,0,1,0
26476,32669,0,0,75,75,0,1,0,1,0
13925,3389,13925,3389,293,223,70,4,0,3,1
51101,31836,0,0,77,77,0,1,0,1,0
42098,5618,0,0,145,145,0,1,0,1,0
19820,3389,19820,3389,293,223,70,4,0,3,1
18153,21412,0,0,96,96,0,1,0,1,0
10134,25773,0,0,148,148,0,1,0,1,0
10321,25773,0,0,153,153,0,1,0,1,0
59087,56624,0,0,130,130,0,1,0,1,0
10648,3389,10648,3389,293,223,70,4,1,3,1
18259,25773,0,0,143,143,0,1,0,1,0
13705,61248,0,0,141,141,0,1,0,1,0
40348,5726,0,0,146,146,0,1,0,1,0
16215,3389,16215,3389,293,223,70,4,0,3,1
16089,20970,0,0,89,89,0,1,0,1,0
46423,54034,0,0,79,79,0,1,0,1,0
11637,3389,11637,3389,293,223,70,4,1,3,1
36946,3389,36946,3389,293,223,70,4,0,3,1
16214,14808,0,0,108,108,0,1,0,1,0
40482,5630,0,0,146,146,0,1,0,1,0
18497,3389,18497,3389,293,223,70,4,0,3,1
18290,45178,0,0,93,93,0,1,0,1,0
16275,3389,16275,3389,293,223,70,4,0,3,1
8482,25773,0,0,143,143,0,1,0,1,0
23414,3389,23414,3389,293,223,70,4,0,3,1
49075,31324,0,0,149,149,0,1,0,1,0
28766,34021,0,0,62,62,0,1,0,1,0
18875,3389,18875,3389,293,223,70,4,0,3,1
9889,3389,9889,3389,293,223,70,4,0,3,1
26437,25773,0,0,147,147,0,1,0,1,0
43114,60170,0,0,72,72,0,1,0,1,0
21971,61248,0,0,158,158,0,1,0,1,0
46696,7134,0,0,145,145,0,1,0,1,0
53271,3389,53271,3389,293,223,70,4,0,3,1
38265,3389,38265,3389,293,223,70,4,1,3,1
19146,3389,19146,3389,293,223,70,4,0,3,1
14452,3389,14452,3389,293,223,70,4,0,3,1
26849,1368,0,0,74,74,0,1,0,1,0
51169,34021,0,0,96,96,0,1,0,1,0
49664,33453,0,0,128,128,0,1,0,1,0
7825,24221,0,0,146,146,0,1,0,1,0
58635,31652,0,0,66,66,0,1,0,1,0
1218,21709,0,0,156,156,0,1,0,1,0
52208,32925,0,0,62,62,0,1,0,1,0
49148,33644,0,0,146,146,0,1,0,1,0
59142,61143,0,0,137,137,0,1,0,1,0
28422,26361,0,0,141,141,0,1,0,1,0
17167,16414,0,0,86,86,0,1,0,1,0
57410,50800,0,0,113,113,0,1,0,1,0
16668,3389,16668,3389,293,223,70,4,0,3,1
12236,8310,3824,1417,208,179,29,2,0,1,0
64400,31664,0,0,62,62,0,1,0,1,0
2929,34059,0,0,143,143,0,1,0,1,0
51972,32661,0,0,77,77,0,1,0,1,0
24870,23199,0,0,118,118,0,1,0,1,0
18119,3389,18119,3389,293,223,70,4,0,3,1
7402,53882,0,0,141,141,0,1,0,1,0
11587,7277,4940,1830,226,188,37,2,0,2,0
10740,14617,0,0,150,150,0,1,0,1,0
20343,3389,20343,3389,293,223,70,4,0,3,1
50805,31652,0,0,93,93,0,1,0,1,0
51900,5618,0,0,145,145,0,1,0,1,0
14802,3389,14802,3389,293,223,70,4,0,3,1
3601,40783,0,0,148,148,0,1,0,1,0
26915,34021,0,0,62,62,0,1,0,1,0
41834,5618,0,0,145,145,0,1,0,1,0
24834,3389,24834,3389,293,223,70,4,0,3,1
28136,33948,0,0,62,62,0,1,0,1,0
56843,5306,8947,473,165,155,9,1,0,1,0
19688,25773,0,0,143,143,0,1,0,1,0
17751,3389,17751,3389,293,223,70,4,0,3,1
52165,32796,0,0,62,62,0,1,0,1,0
51636,31908,0,0,86,86,0,1,0,1,0
15633,25773,0,0,146,146,0,1,0,1,0
63143,41296,0,0,89,89,0,1,0,1,0
3914,48622,0,0,143,143,0,1,0,1,0
23970,34021,0,0,62,62,0,1,0,1,0
16480,25773,0,0,141,141,0,1,0,1,0
29090,1419,0,0,83,83,0,1,0,1,0
26746,25773,0,0,147,147,0,1,0,1,0
16126,56638,0,0,154,154,0,1,0,1,0
48468,37311,0,0,129,129,0,1,0,1,0
12246,3389,12246,3389,293,223,70,4,1,3,1
44349,3389,44349,3389,293,223,70,4,0,3,1
17514,3389,17514,3389,293,223,70,4,0,3,1
13808,3389,13808,3389,293,223,70,4,0,3,1
53564,19727,0,0,100,100,0,1,0,1,0
21824,20918,0,0,92,92,0,1,0,1,0
52451,60593,0,0,100,100,0,1,0,1,0
19446,3389,19446,3389,293,223,70,4,0,3,1
25156,3389,25156,3389,293,223,70,4,0,3,1
18660,3389,18660,3389,293,223,70,4,0,3,1
26876,3389,26876,3389,293,223,70,4,0,3,1
27558,3389,27558,3389,293,223,70,4,0,3,1
16711,9370,0,0,130,130,0,1,0,1,0
11712,7477,4724,1751,222,186,36,2,0,2,0
50890,29835,0,0,91,91,0,1,0,1,0
1292,22274,0,0,155,155,0,1,0,1,0
12064,3389,12064,3389,293,223,70,4,1,3,1
24190,31968,0,0,81,81,0,1,0,1,0
24280,32015,0,0,80,80,0,1,0,1,0
49160,32514,0,0,146,146,0,1,0,1,0
51624,32301,0,0,69,69,0,1,0,1,0
29860,3918,0,0,98,98,0,1,0,1,0
2837,35335,0,0,143,143,0,1,0,1,0
48032,3389,48032,3389,293,223,70,4,0,3,1
2393,41478,0,0,144,144,0,1,0,1,0
51570,32203,0,0,69,69,0,1,0,1,0
8172,25773,0,0,156,156,0,1,0,1,0
28651,33122,0,0,70,70,0,1,0,1,0
9022,61248,0,0,140,140,0,1,0,1,0
14954,3389,14954,3389,293,223,70,4,0,3,1
28156,32954,0,0,73,73,0,1,0,1,0
17472,18640,0,0,66,66,0,1,0,1,0
12734,54033,0,0,152,152,0,1,0,1,0
28244,28712,0,0,117,117,0,1,0,1,0
63502,3525,60088,3181,283,218,65,3,0,2,0
12523,3389,12523,3389,293,223,70,4,1,3,1
49057,29316,0,0,150,150,0,1,0,1,0
13814,26570,0,0,131,131,0,1,0,1,0
28239,28966,0,0,114,114,0,1,0,1,0
12663,2986,9662,2985,265,203,61,3,0,2,0
12475,3389,12475,3389,293,223,70,4,1,3,1
10378,3389,10378,3389,293,223,70,4,1,3,1
13209,3389,13209,3389,293,223,70,4,0,3,1
18016,25770,0,0,143,143,0,1,0,1,0
31926,5666,0,0,115,115,0,1,0,1,0
11001,3389,11001,3389,293,223,70,4,1,3,1
51900,33551,0,0,78,78,0,1,0,1,0
17254,3389,17254,3389,293,223,70,4,0,3,1
38398,3389,38398,3389,293,223,70,4,1,3,1
58555,3389,58555,3389,293,223,70,4,0,3,1
27671,13272,0,0,107,107,0,1,0,1,0
8977,23688,0,0,150,150,0,1,0,1,0
25460,34021,0,0,62,62,0,1,0,1,0
13731,3389,13731,3389,293,223,70,4,0,3,1
49922,32180,0,0,127,127,0,1,0,1,0
8797,24559,0,0,144,144,0,1,0,1,0
18032,25289,0,0,137,137,0,1,0,1,0
60534,3389,60534,3389,293,223,70,4,0,3,1
28785,28181,0,0,122,122,0,1,0,1,0
14980,3389,14980,3389,293,223,70,4,0,3,1
49950,32200,0,0,126,126,0,1,0,1,0
22217,34616,0,0,63,63,0,1,0,1,0
13642,3389,13642,3389,293,223,70,4,0,3,1
49341,31777,0,0,141,141,0,1,0,1,0
49483,31652,0,0,134,134,0,1,0,1,0
49699,33533,0,0,128,128,0,1,0,1,0
23683,32296,0,0,79,79,0,1,0,1,0
56941,5280,9701,513,167,156,10,1,0,1,0
19069,3389,19069,3389,293,223,70,4,0,3,1
49137,31137,0,0,146,146,0,1,0,1,0
3308,22380,0,0,155,155,0,1,0,1,0
17889,3389,17889,3389,293,223,70,4,0,3,1
11910,3389,11910,3389,293,223,70,4,1,3,1
7764,61248,0,0,139,139,0,1,0,1,0
53689,17346,0,0,112,112,0,1,0,1,0
37976,3389,37976,3389,293,223,70,4,1,3,1
2907,47233,0,0,144,144,0,1,0,1,0
11326,54112,0,0,118,118,0,1,0,1,0
24313,32032,0,0,80,80,0,1,0,1,0
27947,60949,0,0,135,135,0,1,0,1,0
39656,6223,0,0,146,146,0,1,0,1,0
8558,61248,0,0,140,140,0,1,0,1,0
14326,3389,14326,3389,293,223,70,4,0,3,1
37737,3389,37737,3389,293,223,70,4,1,3,1
29879,60850,0,0,127,127,0,1,0,1,0
26517,25773,0,0,147,147,0,1,0,1,0
27536,26857,0,0,136,136,0,1,0,1,0
12557,7243,5970,1844,226,188,38,2,0,2,0
16120,19825,0,0,81,81,0,1,0,1,0
28432,3389,28432,3389,293,223,70,4,0,3,1
56922,31652,0,0,103,103,0,1,0,1,0
10904,3389,10904,3389,293,223,70,4,0,3,1
35609,3389,35609,3389,293,223,70,4,0,3,1
5725,23490,0,0,149,149,0,1,0,1,0
49112,32502,0,0,148,148,0,1,0,1,0
17848,3389,17848,3389,293,223,70,4,0,3,1
19527,29542,0,0,103,103,0,1,0,1,0
21728,3389,21728,3389,293,223,70,4,0,3,1
16163,61248,0,0,150,150,0,1,0,1,0
16295,25376,0,0,144,144,0,1,0,1,0
14203,13480,0,0,146,146,0,1,0,1,0
49989,33087,0,0,116,116,0,1,0,1,0
18132,3389,18132,3389,293,223,70,4,0,3,1
16919,3389,16919,3389,293,223,70,4,0,3,1
12521,3389,12521,3389,293,223,70,4,0,3,1
16989,3389,16989,3389,293,223,70,4,0,3,1
51016,31931,0,0,80,80,0,1,0,1,0
11372,61248,0,0,142,142,0,1,0,1,0
50308,33843,0,0,139,139,0,1,0,1,0
29776,34021,0,0,62,62,0,1,0,1,0
13709,3389,13709,3389,293,223,70,4,0,3,1
19995,3389,19995,3389,293,223,70,4,0,3,1
9639,3389,9639,3389,293,223,70,4,1,3,1
18110,45660,0,0,94,94,0,1,0,1,0
20118,3389,20118,3389,293,223,70,4,0,3,1
61818,3976,47150,2496,254,202,51,3,0,2,0
12238,3389,12238,3389,293,223,70,4,0,3,1
11674,5103,8744,2702,263,207,55,3,0,2,0
49346,24453,0,0,156,156,0,1,0,1,0
11069,3389,11069,3389,293,223,70,4,1,3,1
37426,3389,37426,3389,293,223,70,4,1,3,1
15740,20108,0,0,85,85,0,1,0,1,0
12740,9113,2955,1095,194,172,22,1,0,1,0
18477,1813,6742,1813,185,148,37,2,0,2,0
12619,61248,0,0,139,139,0,1,0,1,0
21404,3389,21404,3389,293,223,70,4,0,3,1
38679,60398,0,0,90,90,0,1,0,1,0
10978,59277,0,0,139,139,0,1,0,1,0
11063,3389,11063,3389,293,223,70,4,0,3,1
11526,60736,0,0,141,141,0,1,0,1,0
50244,28783,0,0,122,122,0,1,0,1,0
19606,59310,0,0,157,157,0,1,0,1,0
49054,30623,0,0,150,150,0,1,0,1,0
7694,24175,0,0,146,146,0,1,0,1,0
15441,3389,15441,3389,293,223,70,4,0,3,1
52139,33717,0,0,72,72,0,1,0,1,0
26304,28595,0,0,118,118,0,1,0,1,0
18195,18146,0,0,63,63,0,1,0,1,0
6511,53240,0,0,144,144,0,1,0,1,0
32893,2819,0,0,104,104,0,1,0,1,0
18161,21127,0,0,93,93,0,1,0,1,0
19632,3389,19632,3389,293,223,70,4,0,3,1
51763,31652,0,0,62,62,0,1,0,1,0
13891,10944,976,361,163,156,7,1,0,1,0
29715,34021,0,0,62,62,0,1,0,1,0
9666,3389,9666,3389,293,223,70,4,1,3,1
33401,3389,33401,3389,293,223,70,4,0,3,1
53061,60643,0,0,103,103,0,1,0,1,0
16204,3389,16204,3389,293,223,70,4,0,3,1
50358,29040,0,0,119,119,0,1,0,1,0
28695,34021,0,0,62,62,0,1,0,1,0
12278,61248,0,0,139,139,0,1,0,1,0
26735,34021,0,0,62,62,0,1,0,1,0
32467,2662,0,0,101,101,0,1,0,1,0
21338,4284,0,0,93,93,0,1,0,1,0
15844,25773,0,0,143,143,0,1,0,1,0
38095,7343,0,0,146,146,0,1,0,1,0
10641,3389,10641,3389,293,223,70,4,1,3,1
50837,32133,0,0,87,87,0,1,0,1,0
9112,24669,0,0,144,144,0,1,0,1,0
50800,34021,0,0,105,105,0,1,0,1,0
11934,61248,0,0,145,145,0,1,0,1,0
7160,54320,0,0,143,143,0,1,0,1,0
56964,49413,0,0,111,111,0,1,0,1,0
15786,14085,0,0,117,117,0,1,0,1,0
50789,3389,50789,3389,293,223,70,4,0,3,1
28259,27976,0,0,125,125,0,1,0,1,0
28205,34021,0,0,62,62,0,1,0,1,0
56942,5279,9709,514,167,156,10,1,0,1,0
50292,31652,0,0,109,109,0,1,0,1,0
51578,31652,0,0,65,65,0,1,0,1,0
28761,24752,0,0,147,147,0,1,0,1,0
60594,59964,0,0,141,141,0,1,0,1,0
54319,31652,0,0,117,117,0,1,0,1,0
45290,17107,0,0,152,152,0,1,0,1,0
37409,3389,37409,3389,293,223,70,4,1,3,1
11181,25389,0,0,140,140,0,1,0,1,0
24422,30995,0,0,91,91,0,1,0,1,0
19581,3389,19581,3389,293,223,70,4,0,3,1
13027,25773,0,0,150,150,0,1,0,1,0
28586,27184,0,0,133,133,0,1,0,1,0
4384,49695,0,0,144,144,0,1,0,1,0
50121,33150,0,0,115,115,0,1,0,1,0
7767,25773,0,0,141,141,0,1,0,1,0
2501,46489,0,0,144,144,0,1,0,1,0
2254,23778,0,0,150,150,0,1,0,1,0
18091,23372,0,0,117,117,0,1,0,1,0
12855,3389,12855,3389,293,223,70,4,0,3,1
9444,3389,9444,3389,293,223,70,4,1,3,1
16708,3389,16708,3389,293,223,70,4,0,3,1
40787,5618,0,0,145,145,0,1,0,1,0
10983,23642,0,0,130,130,0,1,0,1,0
52489,33759,0,0,62,62,0,1,0,1,0
12296,3389,12296,3389,293,223,70,4,0,3,1
13207,3389,13207,3389,293,223,70,4,0,3,1
13811,3389,13811,3389,293,223,70,4,0,3,1
40228,5812,0,0,146,146,0,1,0,1,0
3436,22693,0,0,153,153,0,1,0,1,0
49048,30430,0,0,150,150,0,1,0,1,0
28468,26591,0,0,139,139,0,1,0,1,0
15533,13659,0,0,123,123,0,1,0,1,0
6375,53012,0,0,144,144,0,1,0,1,0
50244,28784,0,0,122,122,0,1,0,1,0
61514,53223,0,0,122,122,0,1,0,1,0
51745,32518,0,0,68,68,0,1,0,1,0
51641,34021,0,0,85,85,0,1,0,1,0
7455,61248,0,0,139,139,0,1,0,1,0
12479,61248,0,0,144,144,0,1,0,1,0
12270,3389,12270,3389,293,223,70,4,1,3,1
13129,61248,0,0,140,140,0,1,0,1,0
51770,32207,0,0,82,82,0,1,0,1,0
9712,3389,9712,3389,293,223,70,4,1,3,1
18101,3389,18101,3389,293,223,70,4,0,3,1
51506,31652,0,0,67,67,0,1,0,1,0
10112,61248,0,0,142,142,0,1,0,1,0
44939,16266,0,0,151,151,0,1,0,1,0
49026,29734,0,0,151,151,0,1,0,1,0
18153,26026,0,0,140,140,0,1,0,1,0
17196,43520,0,0,88,88,0,1,0,1,0
21195,25773,0,0,144,144,0,1,0,1,0
25056,25773,0,0,146,146,0,1,0,1,0
20642,20032,0,0,82,82,0,1,0,1,0
3586,23269,0,0,157,157,0,1,0,1,0
37748,7591,0,0,146,146,0,1,0,1,0
36067,8798,0,0,146,146,0,1,0,1,0
13816,25773,0,0,143,143,0,1,0,1,0
49325,26721,0,0,146,146,0,1,0,1,0
23761,34021,0,0,62,62,0,1,0,1,0
28670,34021,0,0,62,62,0,1,0,1,0
5749,33641,0,0,152,152,0,1,0,1,0
46916,21008,0,0,154,154,0,1,0,1,0
28756,34021,0,0,62,62,0,1,0,1,0
10176,3389,10176,3389,293,223,70,4,1,3,1
11739,3389,11739,3389,293,223,70,4,1,3,1
21681,61248,0,0,158,158,0,1,0,1,0
17895,46237,0,0,96,96,0,1,0,1,0
7207,24006,0,0,147,147,0,1,0,1,0
13778,23886,0,0,119,119,0,1,0,1,0
21326,20545,0,0,88,88,0,1,0,1,0
49462,31652,0,0,135,135,0,1,0,1,0
34644,3463,0,0,113,113,0,1,0,1,0
60431,31652,0,0,65,65,0,1,0,1,0
8667,25773,0,0,140,140,0,1,0,1,0
32475,16457,0,0,146,146,0,1,0,1,0
11756,3389,11756,3389,293,223,70,4,0,3,1
9196,3389,9196,3389,293,223,70,4,1,3,1
23200,25773,0,0,145,145,0,1,0,1,0
27065,3389,27065,3389,293,223,70,4,0,3,1
11465,61248,0,0,142,142,0,1,0,1,0
31997,3389,31997,3389,293,223,70,4,0,3,1
14427,3389,14427,3389,293,223,70,4,0,3,1
51399,31652,0,0,69,69,0,1,0,1,0
3828,50943,0,0,143,143,0,1,0,1,0
6271,52840,0,0,144,144,0,1,0,1,0
7784,23413,0,0,151,151,0,1,0,1,0
7331,24049,0,0,146,146,0,1,0,1,0
18212,26136,0,0,139,139,0,1,0,1,0
60373,61244,0,0,144,144,0,1,0,1,0
49160,32726,0,0,146,146,0,1,0,1,0
26152,34021,0,0,62,62,0,1,0,1,0
18248,3389,18248,3389,293,223,70,4,0,3,1
25261,30068,0,0,103,103,0,1,0,1,0
51985,34021,0,0,76,76,0,1,0,1,0
18464,61248,0,0,153,153,0,1,0,1,0
38507,3389,38507,3389,293,223,70,4,1,3,1
28228,29471,0,0,109,109,0,1,0,1,0
14709,3389,14709,3389,293,223,70,4,0,3,1
17574,61248,0,0,152,152,0,1,0,1,0
51044,34021,0,0,99,99,0,1,0,1,0
27331,34021,0,0,62,62,0,1,0,1,0
55594,31652,0,0,110,110,0,1,0,1,0
6908,25773,0,0,153,153,0,1,0,1,0
18776,3389,18776,3389,293,223,70,4,0,3,1
35409,3744,0,0,117,117,0,1,0,1,0
49000,35213,0,0,142,142,0,1,0,1,0
10030,3389,10030,3389,293,223,70,4,0,3,1
52311,33835,0,0,68,68,0,1,0,1,0
2260,20932,0,0,156,156,0,1,0,1,0
15308,25773,0,0,141,141,0,1,0,1,0
25136,34021,0,0,62,62,0,1,0,1,0
50129,28526,0,0,125,125,0,1,0,1,0
13460,3389,13460,3389,293,223,70,4,0,3,1
48458,37388,0,0,129,129,0,1,0,1,0
35466,13937,0,0,146,146,0,1,0,1,0
19009,3389,19009,3389,293,223,70,4,0,3,1
15135,3389,15135,3389,293,223,70,4,0,3,1
29172,60886,0,0,130,130,0,1,0,1,0
48623,34021,0,0,143,143,0,1,0,1,0
51006,30072,0,0,87,87,0,1,0,1,0
51399,5618,0,0,145,145,0,1,0,1,0
49564,33565,0,0,131,131,0,1,0,1,0
9864,25773,0,0,149,149,0,1,0,1,0
24771,3389,24771,3389,293,223,70,4,1,3,1
8098,23435,0,0,117,117,0,1,0,1,0
13962,61248,0,0,142,142,0,1,0,1,0
13022,8367,4511,1394,207,178,28,2,0,1,0
52481,33734,0,0,62,62,0,1,0,1,0
18176,20645,0,0,87,87,0,1,0,1,0
42283,9896,0,0,148,148,0,1,0,1,0
16046,19880,0,0,82,82,0,1,0,1,0
55398,44052,0,0,96,96,0,1,0,1,0
38164,3389,38164,3389,293,223,70,4,1,3,1
21792,3389,21792,3389,293,223,70,4,0,3,1
20666,3389,20666,3389,293,223,70,4,0,3,1
13696,25773,0,0,149,149,0,1,0,1,0
50256,31652,0,0,107,107,0,1,0,1,0
57233,50336,0,0,114,114,0,1,0,1,0
52287,33160,0,0,62,62,0,1,0,1,0
19278,3389,19278,3389,293,223,70,4,0,3,1
49155,31543,0,0,146,146,0,1,0,1,0
48912,25979,0,0,156,156,0,1,0,1,0
25616,3389,25616,3389,293,223,70,4,0,3,1
31309,60776,0,0,121,121,0,1,0,1,0
11044,3389,11044,3389,293,223,70,4,1,3,1
15899,61248,0,0,150,150,0,1,0,1,0
23635,31679,0,0,83,83,0,1,0,1,0
49218,31652,0,0,143,143,0,1,0,1,0
60995,31652,0,0,64,64,0,1,0,1,0
4872,50067,0,0,143,143,0,1,0,1,0
10856,61248,0,0,142,142,0,1,0,1,0
5001,25773,0,0,147,147,0,1,0,1,0
37347,3389,37347,3389,293,223,70,4,0,3,1
14057,3389,14057,3389,293,223,70,4,0,3,1
29337,30947,0,0,94,94,0,1,0,1,0
1575,22716,0,0,153,153,0,1,0,1,0
11977,3389,11977,3389,293,223,70,4,1,3,1
14942,3389,14942,3389,293,223,70,4,0,3,1
3277,25379,0,0,144,144,0,1,0,1,0
13888,10939,981,363,163,156,7,1,0,1,0
19187,31368,0,0,86,86,0,1,0,1,0
23904,34021,0,0,62,62,0,1,0,1,0
15490,3389,15490,3389,293,223,70,4,0,3,1
49259,33908,0,0,142,142,0,1,0,1,0
30627,3389,30627,3389,293,223,70,4,0,3,1
2068,22431,0,0,157,157,0,1,0,1,0
10210,61248,0,0,141,141,0,1,0,1,0
29531,31920,0,0,83,83,0,1,0,1,0
16456,3389,16456,3389,293,223,70,4,0,3,1
28792,3013,0,0,90,90,0,1,0,1,0
46316,54914,0,0,77,77,0,1,0,1,0
40629,3389,40629,3389,293,223,70,4,0,3,1
27182,717,0,0,72,72,0,1,0,1,0
8105,61248,0,0,139,139,0,1,0,1,0
11785,3389,11785,3389,293,223,70,4,0,3,1
2594,47354,0,0,144,144,0,1,0,1,0
5726,23490,0,0,149,149,0,1,0,1,0
11332,4273,9820,3034,277,215,62,3,0,2,0
19962,3389,19962,3389,293,223,70,4,0,3,1
29213,33510,0,0,67,67,0,1,0,1,0
6060,24637,0,0,157,157,0,1,0,1,0
6272,24369,0,0,127,127,0,1,0,1,0
62829,3705,54915,2907,271,211,60,3,0,2,0
10058,3389,10058,3389,293,223,70,4,1,3,1
47909,60220,0,0,74,74,0,1,0,1,0
34039,7455,0,0,131,131,0,1,0,1,0
9424,3389,9424,3389,293,223,70,4,1,3,1
15031,3389,15031,3389,293,223,70,4,0,3,1
12357,3389,12357,3389,293,223,70,4,1,3,1
6913,53144,0,0,142,142,0,1,0,1,0
50504,29366,0,0,115,115,0,1,0,1,0
4201,19487,0,0,154,154,0,1,0,1,0
35489,3774,0,0,118,118,0,1,0,1,0
55138,9219,0,0,133,133,0,1,0,1,0
27721,34021,0,0,62,62,0,1,0,1,0
9174,25773,0,0,152,152,0,1,0,1,0
33595,3389,33595,3389,293,223,70,4,0,3,1
42405,5618,0,0,145,145,0,1,0,1,0
21058,3389,21058,3389,293,223,70,4,0,3,1
8703,61248,0,0,139,139,0,1,0,1,0
14557,3389,14557,3389,293,223,70,4,0,3,1
14813,3389,14813,3389,293,223,70,4,0,3,1
12099,25709,0,0,139,139,0,1,0,1,0
51594,31652,0,0,67,67,0,1,0,1,0
13141,22038,0,0,109,109,0,1,0,1,0
24399,34021,0,0,62,62,0,1,0,1,0
2838,46998,0,0,144,144,0,1,0,1,0
18057,24470,0,0,128,128,0,1,0,1,0
19040,3389,19040,3389,293,223,70,4,0,3,1
18028,25389,0,0,138,138,0,1,0,1,0
15711,10470,0,0,138,138,0,1,0,1,0
25482,3389,25482,3389,293,223,70,4,1,3,1
10265,23985,0,0,149,149,0,1,0,1,0
48916,26091,0,0,156,156,0,1,0,1,0
49950,31652,0,0,120,120,0,1,0,1,0
49007,29141,0,0,152,152,0,1,0,1,0
50047,31652,0,0,114,114,0,1,0,1,0
7321,17164,0,0,152,152,0,1,0,1,0
17059,3389,17059,3389,293,223,70,4,0,3,1
29550,32015,0,0,82,82,0,1,0,1,0
18060,18384,0,0,63,63,0,1,0,1,0
28663,27571,0,0,129,129,0,1,0,1,0
2993,47232,0,0,144,144,0,1,0,1,0
10483,61248,0,0,142,142,0,1,0,1,0
15411,3389,15411,3389,293,223,70,4,0,3,1
50799,31652,0,0,93,93,0,1,0,1,0
61079,31652,0,0,64,64,0,1,0,1,0
11601,23183,0,0,124,124,0,1,0,1,0
17038,3389,17038,3389,293,223,70,4,0,3,1
26228,25773,0,0,146,146,0,1,0,1,0
16615,15483,0,0,99,99,0,1,0,1,0
26141,3389,26141,3389,293,223,70,4,0,3,1
12964,61248,0,0,145,145,0,1,0,1,0
11799,5405,8352,2580,258,205,53,3,0,2,0
10750,3389,10750,3389,293,223,70,4,1,3,1
41900,3389,41900,3389,293,223,70,4,0,3,1
14940,3389,14940,3389,293,223,70,4,0,3,1
17209,3389,17209,3389,293,223,70,4,0,3,1
10284,5204,7181,2661,261,206,54,3,0,2,0
2475,24125,0,0,148,148,0,1,0,1,0
49065,6734,0,0,145,145,0,1,0,1,0
29425,3549,0,0,95,95,0,1,0,1,0
18200,19894,0,0,79,79,0,1,0,1,0
18111,3389,18111,3389,293,223,70,4,0,3,1
60522,32261,0,0,83,83,0,1,0,1,0
18434,3389,18434,3389,293,223,70,4,0,3,1
49160,32771,0,0,146,146,0,1,0,1,0
62453,31652,0,0,62,62,0,1,0,1,0
50352,29027,0,0,119,119,0,1,0,1,0
52011,32998,0,0,66,66,0,1,0,1,0
29761,34021,0,0,62,62,0,1,0,1,0
15532,19633,0,0,76,76,0,1,0,1,0
51699,31652,0,0,63,63,0,1,0,1,0
19365,3389,19365,3389,293,223,70,4,0,3,1
31271,3389,31271,3389,293,223,70,4,0,3,1
50023,33048,0,0,115,115,0,1,0,1,0
13642,2753,8910,2753,249,192,56,3,0,2,0
16655,25773,0,0,142,142,0,1,0,1,0
11249,3389,11249,3389,293,223,70,4,0,3,1
27026,34021,0,0,62,62,0,1,0,1,0
9779,3389,9779,3389,293,223,70,4,1,3,1
27534,34021,0,0,62,62,0,1,0,1,0
5150,54788,0,0,141,141,0,1,0,1,0
14192,3389,14192,3389,293,223,70,4,0,3,1
48927,26340,0,0,155,155,0,1,0,1,0
43598,60145,0,0,70,70,0,1,0,1,0
51751,31652,0,0,62,62,0,1,0,1,0
52379,33663,0,0,63,63,0,1,0,1,0
13309,3389,13309,3389,293,223,70,4,0,3,1
58595,61098,0,0,134,134,0,1,0,1,0
15882,19453,0,0,75,75,0,1,0,1,0
25328,3389,25328,3389,293,223,70,4,0,3,1
7395,61248,0,0,139,139,0,1,0,1,0
46614,52474,0,0,84,84,0,1,0,1,0
12674,9007,3070,1137,196,173,23,2,0,1,0
49770,27931,0,0,125,125,0,1,0,1,0
50751,29552,0,0,95,95,0,1,0,1,0
25344,29951,0,0,104,104,0,1,0,1,0
25590,34021,0,0,62,62,0,1,0,1,0
14722,61248,0,0,148,148,0,1,0,1,0
18148,21544,0,0,97,97,0,1,0,1,0
8049,24299,0,0,145,145,0,1,0,1,0
10909,23697,0,0,130,130,0,1,0,1,0
48726,37267,0,0,135,135,0,1,0,1,0
19246,6584,0,0,109,109,0,1,0,1,0
35376,3389,35376,3389,293,223,70,4,0,3,1
13057,2892,9359,2892,259,199,59,3,0,2,0
17071,3389,17071,3389,293,223,70,4,0,3,1
31700,3389,31700,3389,293,223,70,4,0,3,1
44775,3389,44775,3389,293,223,70,4,0,3,1
42481,10370,0,0,148,148,0,1,0,1,0
49843,27695,0,0,125,125,0,1,0,1,0
57980,31652,0,0,97,97,0,1,0,1,0
18951,29242,0,0,106,106,0,1,0,1,0
62441,32054,0,0,62,62,0,1,0,1,0
17907,3389,17907,3389,293,223,70,4,0,3,1
18045,24849,0,0,133,133,0,1,0,1,0
35138,10508,0,0,146,146,0,1,0,1,0
2900,34467,0,0,143,143,0,1,0,1,0
10696,3389,10696,3389,293,223,70,4,1,3,1
54194,39926,0,0,85,85,0,1,0,1,0
12357,3389,12357,3389,293,223,70,4,1,3,1
61488,4064,44617,2362,248,199,48,3,0,2,0
11003,3476,10852,3353,291,222,69,3,0,2,0
13463,21800,0,0,106,106,0,1,0,1,0
49920,60385,0,0,85,85,0,1,0,1,0
2246,22529,0,0,157,157,0,1,0,1,0
14581,2530,8188,2530,234,182,52,3,0,2,0
42463,3389,42463,3389,293,223,70,4,0,3,1
36370,8580,0,0,146,146,0,1,0,1,0
48936,26846,0,0,155,155,0,1,0,1,0
37704,60448,0,0,94,94,0,1,0,1,0
29119,29854,0,0,105,105,0,1,0,1,0
52166,32799,0,0,62,62,0,1,0,1,0
17122,16337,0,0,87,87,0,1,0,1,0
11031,3389,11031,3389,293,223,70,4,1,3,1
55798,45202,0,0,96,96,0,1,0,1,0
50722,30302,0,0,91,91,0,1,0,1,0
11527,3389,11527,3389,293,223,70,4,1,3,1
12818,3389,12818,3389,293,223,70,4,0,3,1
33640,7117,0,0,128,128,0,1,0,1,0
49716,32037,0,0,132,132,0,1,0,1,0
28167,32788,0,0,74,74,0,1,0,1,0
16743,3389,16743,3389,293,223,70,4,0,3,1
51187,30899,0,0,97,97,0,1,0,1,0
11851,61248,0,0,140,140,0,1,0,1,0
49774,33465,0,0,126,126,0,1,0,1,0
8570,61248,0,0,140,140,0,1,0,1,0
51659,32364,0,0,68,68,0,1,0,1,0
30964,3389,30964,3389,293,223,70,4,0,3,1
43779,3389,43779,3389,293,223,70,4,0,3,1
13270,9956,2044,757,180,164,15,1,0,1,0
40898,34021,0,0,109,109,0,1,0,1,0
8036,24294,0,0,145,145,0,1,0,1,0
10991,6329,5965,2211,242,196,45,2,0,2,0
13136,3389,13136,3389,293,223,70,4,0,3,1
11504,25773,0,0,143,143,0,1,0,1,0
7722,61248,0,0,139,139,0,1,0,1,0
29816,34021,0,0,62,62,0,1,0,1,0
4375,25773,0,0,142,142,0,1,0,1,0
22099,3389,22099,3389,293,223,70,4,0,3,1
13742,10708,1232,456,167,158,9,1,0,1,0
3091,31828,0,0,143,143,0,1,0,1,0
49936,28092,0,0,130,130,0,1,0,1,0
12175,61248,0,0,139,139,0,1,0,1,0
58619,4831,22587,1195,197,172,24,2,0,1,0
27633,34021,0,0,62,62,0,1,0,1,0
2652,22753,0,0,157,157,0,1,0,1,0
57957,31652,0,0,66,66,0,1,0,1,0
52099,33157,0,0,65,65,0,1,0,1,0
54667,3389,54667,3389,293,223,70,4,0,3,1
19229,31402,0,0,86,86,0,1,0,1,0
9824,4471,7973,2955,274,213,61,3,0,2,0
50493,31652,0,0,99,99,0,1,0,1,0
8011,25773,0,0,140,140,0,1,0,1,0
26792,25773,0,0,147,147,0,1,0,1,0
11454,7066,5168,1915,229,190,39,2,0,2,0
49441,31847,0,0,139,139,0,1,0,1,0
51474,31927,0,0,71,71,0,1,0,1,0
23048,29874,0,0,102,102,0,1,0,1,0
52140,32725,0,0,62,62,0,1,0,1,0
14438,11798,64,19,148,148,0,1,0,1,0
45915,3389,45915,3389,293,223,70,4,0,3,1
51609,32272,0,0,69,69,0,1,0,1,0
53706,5618,0,0,145,145,0,1,0,1,0
12974,8250,4663,1441,209,179,29,2,0,1,0
20611,32521,0,0,75,75,0,1,0,1,0
49202,46772,0,0,62,62,0,1,0,1,0
33525,7020,0,0,127,127,0,1,0,1,0
18814,3389,18814,3389,293,223,70,4,0,3,1
56818,3389,56818,3389,293,223,70,4,0,3,1
52165,33276,0,0,65,65,0,1,0,1,0
53123,5618,0,0,145,145,0,1,0,1,0
45858,3389,45858,3389,293,223,70,4,0,3,1
11070,60837,0,0,143,143,0,1,0,1,0
20711,3389,20711,3389,293,223,70,4,0,3,1
28112,32750,0,0,74,74,0,1,0,1,0
9951,61248,0,0,141,141,0,1,0,1,0
12861,3389,12861,3389,293,223,70,4,0,3,1
15013,61248,0,0,149,149,0,1,0,1,0
4954,50191,0,0,143,143,0,1,0,1,0
48691,48702,0,0,62,62,0,1,0,1,0
22435,3389,22435,3389,293,223,70,4,0,3,1
1885,22329,0,0,157,157,0,1,0,1,0
63104,41581,0,0,89,89,0,1,0,1,0
6512,25773,0,0,152,152,0,1,0,1,0
51004,3389,51004,3389,293,223,70,4,0,3,1
36360,4094,0,0,123,123,0,1,0,1,0
17406,3389,17406,3389,293,223,70,4,0,3,1
11455,61248,0,0,142,142,0,1,0,1,0
55837,45339,0,0,96,96,0,1,0,1,0
18978,27557,0,0,125,125,0,1,0,1,0
25283,25773,0,0,146,146,0,1,0,1,0
13862,10897,1026,380,164,156,7,1,0,1,0
49027,29756,0,0,151,151,0,1,0,1,0
11086,3389,11086,3389,293,223,70,4,1,3,1
49160,33166,0,0,146,146,0,1,0,1,0
26807,27886,0,0,125,125,0,1,0,1,0
50150,31652,0,0,114,114,0,1,0,1,0
8888,61248,0,0,140,140,0,1,0,1,0
18012,3389,18012,3389,293,223,70,4,0,3,1
10339,61248,0,0,139,139,0,1,0,1,0
12837,9267,2789,1033,192,170,21,1,0,1,0
11578,61248,0,0,141,141,0,1,0,1,0
25191,32489,0,0,76,76,0,1,0,1,0
15999,61248,0,0,150,150,0,1,0,1,0
49160,31752,0,0,146,146,0,1,0,1,0
51406,31907,0,0,70,70,0,1,0,1,0
49299,31652,0,0,141,141,0,1,0,1,0
51560,32184,0,0,69,69,0,1,0,1,0
18424,3389,18424,3389,293,223,70,4,0,3,1
19050,61248,0,0,154,154,0,1,0,1,0
18657,3389,18657,3389,293,223,70,4,0,3,1
39006,6689,0,0,146,146,0,1,0,1,0
6934,23217,0,0,152,152,0,1,0,1,0
12005,61248,0,0,140,140,0,1,0,1,0
11628,61248,0,0,141,141,0,1,0,1,0
10163,3389,10163,3389,293,223,70,4,0,3,1
3626,25773,0,0,143,143,0,1,0,1,0
19557,3389,19557,3389,293,223,70,4,0,3,1
40038,34021,0,0,106,106,0,1,0,1,0
55423,5618,0,0,145,145,0,1,0,1,0
28874,34021,0,0,62,62,0,1,0,1,0
13341,24438,0,0,125,125,0,1,0,1,0
37643,3389,37643,3389,293,223,70,4,1,3,1
51117,30300,0,0,83,83,0,1,0,1,0
19346,3389,19346,3389,293,223,70,4,0,3,1
28019,34021,0,0,62,62,0,1,0,1,0
50006,28519,0,0,117,117,0,1,0,1,0
11083,3389,11083,3389,293,223,70,4,1,3,1
52922,43119,0,0,145,145,0,1,0,1,0
17433,25773,0,0,143,143,0,1,0,1,0
13864,3389,13864,3389,293,223,70,4,0,3,1
12414,8593,3517,1303,203,176,26,2,0,1,0
49024,28544,0,0,151,151,0,1,0,1,0
13880,3389,13880,3389,293,223,70,4,0,3,1
12141,61248,0,0,139,139,0,1,0,1,0
51910,32816,0,0,67,67,0,1,0,1,0
11735,61248,0,0,141,141,0,1,0,1,0
13636,3389,13636,3389,293,223,70,4,0,3,1
12143,61248,0,0,139,139,0,1,0,1,0
49255,33934,0,0,142,142,0,1,0,1,0
10720,3389,10720,3389,293,223,70,4,0,3,1
9936,3389,9936,3389,293,223,70,4,1,3,1
49160,32992,0,0,146,146,0,1,0,1,0
50227,32819,0,0,108,108,0,1,0,1,0
62693,44595,0,0,98,98,0,1,0,1,0
29176,30142,0,0,102,102,0,1,0,1,0
10656,25773,0,0,146,146,0,1,0,1,0
21051,20339,0,0,85,85,0,1,0,1,0
19712,3389,19712,3389,293,223,70,4,0,3,1
40133,8242,0,0,145,145,0,1,0,1,0
36963,8155,0,0,146,146,0,1,0,1,0
19185,26580,0,0,135,135,0,1,0,1,0
11849,61248,0,0,140,140,0,1,0,1,0
26742,1277,0,0,73,73,0,1,0,1,0
50692,41142,0,0,62,62,0,1,0,1,0
30486,3389,30486,3389,293,223,70,4,1,3,1
24791,25773,0,0,146,146,0,1,0,1,0
49326,33833,0,0,140,140,0,1,0,1,0
50063,33203,0,0,117,117,0,1,0,1,0
24230,34021,0,0,62,62,0,1,0,1,0
58018,31652,0,0,62,62,0,1,0,1,0
18154,3389,18154,3389,293,223,70,4,0,3,1
29323,34021,0,0,62,62,0,1,0,1,0
28560,2817,0,0,88,88,0,1,0,1,0
54489,13555,0,0,119,119,0,1,0,1,0
22081,33315,0,0,68,68,0,1,0,1,0
49158,33988,0,0,146,146,0,1,0,1,0
12453,24489,0,0,147,147,0,1,0,1,0
26806,27888,0,0,125,125,0,1,0,1,0
20419,61248,0,0,156,156,0,1,0,1,0
11521,61248,0,0,142,142,0,1,0,1,0
28227,29530,0,0,108,108,0,1,0,1,0
15212,27297,0,0,124,124,0,1,0,1,0
26394,33115,0,0,70,70,0,1,0,1,0
49574,27443,0,0,132,132,0,1,0,1,0
28280,26947,0,0,135,135,0,1,0,1,0
11912,60685,0,0,139,139,0,1,0,1,0
49402,31819,0,0,140,140,0,1,0,1,0
31302,60776,0,0,121,121,0,1,0,1,0
58800,31652,0,0,62,62,0,1,0,1,0
8165,55996,0,0,143,143,0,1,0,1,0
21540,3389,21540,3389,293,223,70,4,0,3,1
19767,1299,4202,1298,150,123,26,2,0,1,0
22580,33851,0,0,63,63,0,1,0,1,0
3174,47504,0,0,144,144,0,1,0,1,0
13867,23774,0,0,118,118,0,1,0,1,0
28484,26674,0,0,138,138,0,1,0,1,0
9240,3542,8978,3327,290,221,68,3,0,2,0
54841,33141,0,0,114,114,0,1,0,1,0
57581,31652,0,0,99,99,0,1,0,1,0
8181,55058,0,0,141,141,0,1,0,1,0
23924,25773,0,0,145,145,0,1,0,1,0
50859,3389,50859,3389,293,223,70,4,0,3,1
51553,31652,0,0,66,66,0,1,0,1,0
48979,25963,0,0,154,154,0,1,0,1,0
31766,5531,0,0,113,113,0,1,0,1,0
49042,30259,0,0,151,151,0,1,0,1,0
14049,25773,0,0,143,143,0,1,0,1,0
11502,3389,11502,3389,293,223,70,4,0,3,1
52063,33093,0,0,65,65,0,1,0,1,0
11054,3389,11054,3389,293,223,70,4,0,3,1
8072,25773,0,0,156,156,0,1,0,1,0
35180,60577,0,0,105,105,0,1,0,1,0
18286,26273,0,0,138,138,0,1,0,1,0
8699,25773,0,0,154,154,0,1,0,1,0
26480,3389,26480,3389,293,223,70,4,0,3,1
1059,21910,0,0,156,156,0,1,0,1,0
4949,24023,0,0,157,157,0,1,0,1,0
48922,35801,0,0,140,140,0,1,0,1,0
49397,3389,49397,3389,293,223,70,4,0,3,1
14300,3389,14300,3389,293,223,70,4,0,3,1
51179,32194,0,0,81,81,0,1,0,1,0
5474,50974,0,0,143,143,0,1,0,1,0
1691,22898,0,0,153,153,0,1,0,1,0
4652,25773,0,0,146,146,0,1,0,1,0
51557,34021,0,0,87,87,0,1,0,1,0
52795,34776,0,0,64,64,0,1,0,1,0
51221,30511,0,0,80,80,0,1,0,1,0
9107,61248,0,0,139,139,0,1,0,1,0
24002,30651,0,0,95,95,0,1,0,1,0
8608,56734,0,0,143,143,0,1,0,1,0
51096,31652,0,0,83,83,0,1,0,1,0
56261,31652,0,0,68,68,0,1,0,1,0
21349,3389,21349,3389,293,223,70,4,0,3,1
58345,32598,0,0,95,95,0,1,0,1,0
10088,3389,10088,3389,293,223,70,4,1,3,1
29771,12165,0,0,117,117,0,1,0,1,0
8853,25773,0,0,155,155,0,1,0,1,0
33568,3389,33568,3389,293,223,70,4,0,3,1
11819,23021,0,0,122,122,0,1,0,1,0
50470,31652,0,0,103,103,0,1,0,1,0
21248,3389,21248,3389,293,223,70,4,0,3,1
46737,60124,0,0,67,67,0,1,0,1,0
7611,61248,0,0,139,139,0,1,0,1,0
33834,13422,0,0,146,146,0,1,0,1,0
38533,3389,38533,3389,293,223,70,4,1,3,1
16653,2302,8562,2302,218,171,47,3,0,2,0
27678,25303,0,0,142,142,0,1,0,1,0
23525,3389,23525,3389,293,223,70,4,0,3,1
10547,3389,10547,3389,293,223,70,4,1,3,1
28287,25759,0,0,147,147,0,1,0,1,0
12452,3389,12452,3389,293,223,70,4,0,3,1
10088,3389,10088,3389,293,223,70,4,1,3,1
10487,24036,0,0,149,149,0,1,0,1,0
2824,48023,0,0,144,144,0,1,0,1,0
49160,32517,0,0,146,146,0,1,0,1,0
29711,22632,0,0,147,147,0,1,0,1,0
9974,3389,9974,3389,293,223,70,4,1,3,1
18025,3389,18025,3389,293,223,70,4,0,3,1
11009,3389,11009,3389,293,223,70,4,1,3,1
63294,3581,58486,3096,280,216,63,3,0,2,0
19835,3389,19835,3389,293,223,70,4,0,3,1
16697,2028,6561,2027,200,158,41,2,0,2,0
13745,3389,13745,3389,293,223,70,4,0,3,1
25736,3389,25736,3389,293,223,70,4,0,3,1
13657,24038,0,0,121,121,0,1,0,1,0
18049,61248,0,0,152,152,0,1,0,1,0
7292,24036,0,0,146,146,0,1,0,1,0
11646,25773,0,0,139,139,0,1,0,1,0
8648,25773,0,0,156,156,0,1,0,1,0
15574,25773,0,0,141,141,0,1,0,1,0
52184,32855,0,0,62,62,0,1,0,1,0
23532,34021,0,0,62,62,0,1,0,1,0
49293,3389,49293,3389,293,223,70,4,0,3,1
12695,7575,5539,1711,221,185,35,2,0,2,0
7653,61248,0,0,139,139,0,1,0,1,0
49160,33013,0,0,146,146,0,1,0,1,0
49393,46049,0,0,62,62,0,1,0,1,0
14455,53578,0,0,120,120,0,1,0,1,0
2225,46281,0,0,144,144,0,1,0,1,0
7435,61248,0,0,139,139,0,1,0,1,0
52042,29894,0,0,67,67,0,1,0,1,0
11187,3389,11187,3389,293,223,70,4,1,3,1
49867,60381,0,0,85,85,0,1,0,1,0
51821,32655,0,0,67,67,0,1,0,1,0
18773,18632,0,0,66,66,0,1,0,1,0
50518,32593,0,0,112,112,0,1,0,1,0
17591,30074,0,0,98,98,0,1,0,1,0
52025,32382,0,0,62,62,0,1,0,1,0
37108,3389,37108,3389,293,223,70,4,1,3,1
40232,6059,0,0,146,146,0,1,0,1,0
30481,3389,30481,3389,293,223,70,4,0,3,1
50642,30101,0,0,94,94,0,1,0,1,0
28728,3389,28728,3389,293,223,70,4,0,3,1
59872,31652,0,0,87,87,0,1,0,1,0
9850,25773,0,0,140,140,0,1,0,1,0
2518,22374,0,0,154,154,0,1,0,1,0
51507,3389,51507,3389,293,223,70,4,0,3,1
9450,56971,0,0,140,140,0,1,0,1,0
25109,30,95,29,64,63,0,1,0,1,0
49434,31652,0,0,137,137,0,1,0,1,0
13141,9751,2266,839,183,166,17,1,0,1,0
15996,25773,0,0,141,141,0,1,0,1,0
20064,19599,0,0,77,77,0,1,0,1,0
20173,29776,0,0,103,103,0,1,0,1,0
52475,34021,0,0,64,64,0,1,0,1,0
44296,3389,44296,3389,293,223,70,4,0,3,1
16916,3389,16916,3389,293,223,70,4,0,3,1
35657,13621,0,0,146,146,0,1,0,1,0
24246,25773,0,0,146,146,0,1,0,1,0
8992,61248,0,0,140,140,0,1,0,1,0
21794,3389,21794,3389,293,223,70,4,0,3,1
18081,61248,0,0,153,153,0,1,0,1,0
11600,25773,0,0,141,141,0,1,0,1,0
49037,28853,0,0,151,151,0,1,0,1,0
6593,53375,0,0,144,144,0,1,0,1,0
28148,33385,0,0,68,68,0,1,0,1,0
49021,29576,0,0,151,151,0,1,0,1,0
14778,3389,14778,3389,293,223,70,4,0,3,1
17512,3389,17512,3389,293,223,70,4,0,3,1
12104,3389,12104,3389,293,223,70,4,1,3,1
28692,27713,0,0,127,127,0,1,0,1,0
49497,33716,0,0,135,135,0,1,0,1,0
13817,3389,13817,3389,293,223,70,4,0,3,1
53621,19346,0,0,101,101,0,1,0,1,0
51387,31652,0,0,69,69,0,1,0,1,0
21797,61248,0,0,158,158,0,1,0,1,0
55311,43754,0,0,95,95,0,1,0,1,0
7746,25773,0,0,155,155,0,1,0,1,0
26470,24398,0,0,132,132,0,1,0,1,0
49098,30254,0,0,148,148,0,1,0,1,0
37484,3389,37484,3389,293,223,70,4,1,3,1
5021,25773,0,0,147,147,0,1,0,1,0
18813,3389,18813,3389,293,223,70,4,0,3,1
10780,3389,10780,3389,293,223,70,4,1,3,1
27541,33537,0,0,66,66,0,1,0,1,0
39297,8384,0,0,145,145,0,1,0,1,0
17326,3389,17326,3389,293,223,70,4,0,3,1
55272,8326,0,0,136,136,0,1,0,1,0
50517,32592,0,0,112,112,0,1,0,1,0
19156,3389,19156,3389,293,223,70,4,0,3,1
18053,24609,0,0,130,130,0,1,0,1,0
55234,6936,0,0,145,145,0,1,0,1,0
49809,32102,0,0,130,130,0,1,0,1,0
29928,34021,0,0,62,62,0,1,0,1,0
15444,28334,0,0,115,115,0,1,0,1,0
19081,3389,19081,3389,293,223,70,4,0,3,1
13111,20471,0,0,142,142,0,1,0,1,0
14630,3389,14630,3389,293,223,70,4,0,3,1
26160,32411,0,0,77,77,0,1,0,1,0
11964,5804,7835,2421,251,201,50,3,0,2,0
2285,42969,0,0,144,144,0,1,0,1,0
23353,22063,0,0,105,105,0,1,0,1,0
15231,22052,0,0,100,100,0,1,0,1,0
52242,6198,0,0,145,145,0,1,0,1,0
7110,25217,0,0,157,157,0,1,0,1,0
20379,3389,20379,3389,293,223,70,4,0,3,1
51041,31902,0,0,79,79,0,1,0,1,0
10588,3389,10588,3389,293,223,70,4,1,3,1
58716,3389,58716,3389,293,223,70,4,0,3,1
13646,3389,13646,3389,293,223,70,4,0,3,1
3239,25320,0,0,144,144,0,1,0,1,0
18081,3389,18081,3389,293,223,70,4,0,3,1
15929,61248,0,0,146,146,0,1,0,1,0
22166,21174,0,0,95,95,0,1,0,1,0
22037,3389,22037,3389,293,223,70,4,0,3,1
18232,18867,0,0,68,68,0,1,0,1,0
12688,57898,0,0,133,133,0,1,0,1,0
18057,24465,0,0,128,128,0,1,0,1,0
4679,50186,0,0,144,144,0,1,0,1,0
17273,16592,0,0,84,84,0,1,0,1,0
50871,29796,0,0,91,91,0,1,0,1,0
34923,10990,0,0,146,146,0,1,0,1,0
18016,3389,18016,3389,293,223,70,4,0,3,1
34854,3389,34854,3389,293,223,70,4,0,3,1
49147,31356,0,0,146,146,0,1,0,1,0
13893,61248,0,0,142,142,0,1,0,1,0
1484,22575,0,0,154,154,0,1,0,1,0
14939,3389,14939,3389,293,223,70,4,0,3,1
17752,17399,0,0,73,73,0,1,0,1,0
51726,32484,0,0,68,68,0,1,0,1,0
28170,32320,0,0,79,79,0,1,0,1,0
9768,25773,0,0,149,149,0,1,0,1,0
39760,6148,0,0,146,146,0,1,0,1,0
49627,23618,0,0,155,155,0,1,0,1,0
39619,6250,0,0,146,146,0,1,0,1,0
16884,25773,0,0,142,142,0,1,0,1,0
51515,33284,0,0,88,88,0,1,0,1,0
27236,27281,0,0,132,132,0,1,0,1,0
63230,40658,0,0,87,87,0,1,0,1,0
12108,6155,7380,2280,245,198,47,3,0,2,0
2899,24787,0,0,146,146,0,1,0,1,0
9749,24890,0,0,143,143,0,1,0,1,0
54167,31652,0,0,62,62,0,1,0,1,0
9921,25773,0,0,149,149,0,1,0,1,0
49625,27571,0,0,130,130,0,1,0,1,0
18611,3389,18611,3389,293,223,70,4,0,3,1
38476,3389,38476,3389,293,223,70,4,0,3,1
34678,60603,0,0,107,107,0,1,0,1,0
12477,3030,9806,3030,268,205,62,3,0,2,0
54802,33147,0,0,115,115,0,1,0,1,0
27266,24995,0,0,139,139,0,1,0,1,0
18036,25146,0,0,136,136,0,1,0,1,0
2076,23500,0,0,151,151,0,1,0,1,0
22069,3389,22069,3389,293,223,70,4,0,3,1
16007,25773,0,0,141,141,0,1,0,1,0
49480,31652,0,0,135,135,0,1,0,1,0
14717,3389,14717,3389,293,223,70,4,0,3,1
51359,34021,0,0,91,91,0,1,0,1,0
11463,3389,11463,3389,293,223,70,4,1,3,1
16454,25773,0,0,145,145,0,1,0,1,0
10309,3389,10309,3389,293,223,70,4,1,3,1
32217,3389,32217,3389,293,223,70,4,0,3,1
13278,3389,13278,3389,293,223,70,4,0,3,1
58372,32865,0,0,62,62,0,1,0,1,0
49722,27448,0,0,129,129,0,1,0,1,0
58303,53901,0,0,122,122,0,1,0,1,0
31391,3389,31391,3389,293,223,70,4,0,3,1
6550,52597,0,0,142,142,0,1,0,1,0
31289,60777,0,0,121,121,0,1,0,1,0
11800,61248,0,0,139,139,0,1,0,1,0
14588,3389,14588,3389,293,223,70,4,0,3,1
29602,34021,0,0,62,62,0,1,0,1,0
9264,3389,9264,3389,293,223,70,4,1,3,1
37058,8087,0,0,146,146,0,1,0,1,0
9243,3389,9243,3389,293,223,70,4,1,3,1
52158,32778,0,0,62,62,0,1,0,1,0
10677,23869,0,0,132,132,0,1,0,1,0
50254,32789,0,0,107,107,0,1,0,1,0
19860,25773,0,0,143,143,0,1,0,1,0
13635,3389,13635,3389,293,223,70,4,0,3,1
23985,297,959,296,82,76,6,1,0,1,0
14769,25773,0,0,140,140,0,1,0,1,0
51855,32400,0,0,80,80,0,1,0,1,0
63049,41983,0,0,90,90,0,1,0,1,0
12978,61248,0,0,146,146,0,1,0,1,0
9848,25773,0,0,143,143,0,1,0,1,0
58897,32761,0,0,62,62,0,1,0,1,0
27723,34021,0,0,62,62,0,1,0,1,0
35492,3389,35492,3389,293,223,70,4,0,3,1
49398,31652,0,0,138,138,0,1,0,1,0
15349,61248,0,0,145,145,0,1,0,1,0
18250,18303,0,0,62,62,0,1,0,1,0
9753,24556,0,0,141,141,0,1,0,1,0
49064,30954,0,0,150,150,0,1,0,1,0
13479,10289,1684,624,174,161,12,1,0,1,0
26189,28759,0,0,116,116,0,1,0,1,0
22378,33954,0,0,62,62,0,1,0,1,0
51238,31585,0,0,72,72,0,1,0,1,0
17216,19011,0,0,71,71,0,1,0,1,0
23700,30406,0,0,97,97,0,1,0,1,0
4033,23517,0,0,157,157,0,1,0,1,0
33101,2895,0,0,105,105,0,1,0,1,0
13549,3389,13549,3389,293,223,70,4,0,3,1
13635,3389,13635,3389,293,223,70,4,0,3,1
49160,31923,0,0,146,146,0,1,0,1,0
51123,30312,0,0,83,83,0,1,0,1,0
19836,61248,0,0,154,154,0,1,0,1,0
13792,16110,0,0,145,145,0,1,0,1,0
21584,3389,21584,3389,293,223,70,4,0,3,1
6059,32610,0,0,152,152,0,1,0,1,0
32319,3389,32319,3389,293,223,70,4,0,3,1
29407,12356,0,0,115,115,0,1,0,1,0
8283,61248,0,0,139,139,0,1,0,1,0
25488,34021,0,0,62,62,0,1,0,1,0
12584,58150,0,0,133,133,0,1,0,1,0
23548,25773,0,0,145,145,0,1,0,1,0
10205,3389,10205,3389,293,223,70,4,1,3,1
27546,3389,27546,3389,293,223,70,4,0,3,1
23221,3389,23221,3389,293,223,70,4,0,3,1
17241,3389,17241,3389,293,223,70,4,0,3,1
61111,32319,0,0,62,62,0,1,0,1,0
25465,29779,0,0,106,106,0,1,0,1,0
27293,60982,0,0,137,137,0,1,0,1,0
48911,26059,0,0,156,156,0,1,0,1,0
18237,3389,18237,3389,293,223,70,4,0,3,1
11704,3389,11704,3389,293,223,70,4,0,3,1
40095,5908,0,0,146,146,0,1,0,1,0
13244,61248,0,0,140,140,0,1,0,1,0
60167,60387,0,0,142,142,0,1,0,1,0
33234,3389,33234,3389,293,223,70,4,0,3,1
51325,31209,0,0,94,94,0,1,0,1,0
18047,25773,0,0,143,143,0,1,0,1,0
11732,3389,11732,3389,293,223,70,4,0,3,1
16910,3389,16910,3389,293,223,70,4,0,3,1
11282,3389,11282,3389,293,223,70,4,1,3,1
16940,47508,0,0,102,102,0,1,0,1,0
12134,22787,0,0,119,119,0,1,0,1,0
19032,18826,0,0,68,68,0,1,0,1,0
16484,25773,0,0,145,145,0,1,0,1,0
19920,3389,19920,3389,293,223,70,4,0,3,1
45929,59135,0,0,62,62,0,1,0,1,0
24985,34021,0,0,62,62,0,1,0,1,0
16396,61248,0,0,147,147,0,1,0,1,0
60271,60890,0,0,145,145,0,1,0,1,0
28951,34021,0,0,62,62,0,1,0,1,0
16942,25773,0,0,144,144,0,1,0,1,0
26039,3389,26039,3389,293,223,70,4,0,3,1
9566,3389,9566,3389,293,223,70,4,1,3,1
31227,3389,31227,3389,293,223,70,4,0,3,1
3076,32035,0,0,143,143,0,1,0,1,0
24392,34021,0,0,62,62,0,1,0,1,0
8666,25773,0,0,140,140,0,1,0,1,0
2793,43468,0,0,146,146,0,1,0,1,0
51655,31652,0,0,64,64,0,1,0,1,0
16904,25773,0,0,144,144,0,1,0,1,0
29543,34021,0,0,62,62,0,1,0,1,0
51770,31652,0,0,62,62,0,1,0,1,0
2897,24785,0,0,146,146,0,1,0,1,0
16264,3389,16264,3389,293,223,70,4,0,3,1
38104,7336,0,0,146,146,0,1,0,1,0
22109,3389,22109,3389,293,223,70,4,0,3,1
13172,20082,0,0,142,142,0,1,0,1,0
8417,61248,0,0,140,140,0,1,0,1,0
46771,55953,0,0,62,62,0,1,0,1,0
25050,23334,0,0,120,120,0,1,0,1,0
42411,7858,0,0,145,145,0,1,0,1,0
49218,34021,0,0,144,144,0,1,0,1,0
12508,3389,12508,3389,293,223,70,4,0,3,1
8925,61248,0,0,139,139,0,1,0,1,0
9241,3389,9241,3389,293,223,70,4,1,3,1
60278,60768,0,0,143,143,0,1,0,1,0
19030,3389,19030,3389,293,223,70,4,0,3,1
50457,60429,0,0,88,88,0,1,0,1,0
5989,23582,0,0,149,149,0,1,0,1,0
61484,53449,0,0,123,123,0,1,0,1,0
7798,25773,0,0,156,156,0,1,0,1,0
11578,25773,0,0,142,142,0,1,0,1,0
15021,25773,0,0,143,143,0,1,0,1,0
19270,61248,0,0,154,154,0,1,0,1,0
44386,5618,0,0,145,145,0,1,0,1,0
14955,25773,0,0,140,140,0,1,0,1,0
15049,25773,0,0,140,140,0,1,0,1,0
56244,3389,56244,3389,293,223,70,4,0,3,1
19725,61248,0,0,155,155,0,1,0,1,0
37589,34021,0,0,95,95,0,1,0,1,0
50969,3389,50969,3389,293,223,70,4,0,3,1
49696,31652,0,0,127,127,0,1,0,1,0
49160,32313,0,0,146,146,0,1,0,1,0
36628,3389,36628,3389,293,223,70,4,0,3,1
51756,34021,0,0,82,82,0,1,0,1,0
37216,3389,37216,3389,293,223,70,4,1,3,1
17129,3389,17129,3389,293,223,70,4,0,3,1
20370,3389,20370,3389,293,223,70,4,0,3,1
52234,25930,0,0,88,88,0,1,0,1,0
7709,24181,0,0,146,146,0,1,0,1,0
50372,29071,0,0,119,119,0,1,0,1,0
51769,32207,0,0,82,82,0,1,0,1,0
21167,61248,0,0,157,157,0,1,0,1,0
18020,3389,18020,3389,293,223,70,4,0,3,1
25921,34021,0,0,62,62,0,1,0,1,0
38135,4747,0,0,132,132,0,1,0,1,0
53290,3389,53290,3389,293,223,70,4,0,3,1
12186,3389,12186,3389,293,223,70,4,0,3,1
7264,25773,0,0,154,154,0,1,0,1,0
30992,3389,30992,3389,293,223,70,4,0,3,1
13490,9502,3041,939,188,168,19,1,0,1,0
20901,25773,0,0,144,144,0,1,0,1,0
11491,3389,11491,3389,293,223,70,4,1,3,1
11391,6966,5276,1955,231,191,40,2,0,2,0
10934,61248,0,0,143,143,0,1,0,1,0
50352,5618,0,0,145,145,0,1,0,1,0
8409,25773,0,0,156,156,0,1,0,1,0
10313,58274,0,0,140,140,0,1,0,1,0
9309,61248,0,0,139,139,0,1,0,1,0
17217,28340,0,0,115,115,0,1,0,1,0
49160,32540,0,0,146,146,0,1,0,1,0
51464,31009,0,0,72,72,0,1,0,1,0
6608,53401,0,0,144,144,0,1,0,1,0
16184,25773,0,0,145,145,0,1,0,1,0
19561,3389,19561,3389,293,223,70,4,0,3,1
13312,24474,0,0,125,125,0,1,0,1,0
13651,10562,1389,515,170,159,10,1,0,1,0
19690,19319,0,0,74,74,0,1,0,1,0
52271,33808,0,0,69,69,0,1,0,1,0
51660,31961,0,0,85,85,0,1,0,1,0
5991,23583,0,0,149,149,0,1,0,1,0
26503,3389,26503,3389,293,223,70,4,1,3,1
49834,33261,0,0,122,122,0,1,0,1,0
52205,33549,0,0,129,129,0,1,0,1,0
51439,31652,0,0,68,68,0,1,0,1,0
25132,34021,0,0,62,62,0,1,0,1,0
11407,61248,0,0,142,142,0,1,0,1,0
51549,31652,0,0,69,69,0,1,0,1,0
51672,32386,0,0,68,68,0,1,0,1,0
53245,33388,0,0,123,123,0,1,0,1,0
50696,31652,0,0,96,96,0,1,0,1,0
55765,31652,0,0,68,68,0,1,0,1,0
21401,3389,21401,3389,293,223,70,4,0,3,1
51627,31887,0,0,86,86,0,1,0,1,0
53399,20831,0,0,96,96,0,1,0,1,0
23754,25773,0,0,145,145,0,1,0,1,0
50089,28436,0,0,126,126,0,1,0,1,0
11048,61248,0,0,142,142,0,1,0,1,0
37999,3389,37999,3389,293,223,70,4,1,3,1
38965,8440,0,0,145,145,0,1,0,1,0
21754,25773,0,0,144,144,0,1,0,1,0
48978,28202,0,0,153,153,0,1,0,1,0
49571,34021,0,0,135,135,0,1,0,1,0
50805,31652,0,0,93,93,0,1,0,1,0
8733,25314,0,0,151,151,0,1,0,1,0
25098,34021,0,0,62,62,0,1,0,1,0
12056,3389,12056,3389,293,223,70,4,1,3,1
48938,26910,0,0,155,155,0,1,0,1,0
17092,1934,6258,1934,193,153,39,2,0,2,0
17630,19026,0,0,70,70,0,1,0,1,0
13038,25773,0,0,139,139,0,1,0,1,0
12588,23818,0,0,140,140,0,1,0,1,0
51660,32366,0,0,68,68,0,1,0,1,0
2373,41749,0,0,144,144,0,1,0,1,0
51395,31652,0,0,69,69,0,1,0,1,0
22435,21376,0,0,97,97,0,1,0,1,0
50928,31652,0,0,89,89,0,1,0,1,0
11099,25773,0,0,139,139,0,1,0,1,0
49037,28847,0,0,151,151,0,1,0,1,0
50663,31652,0,0,97,97,0,1,0,1,0
21948,3389,21948,3389,293,223,70,4,0,3,1
13631,9843,2599,803,182,165,16,1,0,1,0
18719,3389,18719,3389,293,223,70,4,0,3,1
8163,25773,0,0,156,156,0,1,0,1,0
14972,25773,0,0,140,140,0,1,0,1,0
16680,2295,8535,2295,218,171,47,3,0,2,0
10321,25773,0,0,147,147,0,1,0,1,0
7506,25773,0,0,143,143,0,1,0,1,0
16328,20668,0,0,86,86,0,1,0,1,0
29253,60882,0,0,129,129,0,1,0,1,0
28676,27633,0,0,128,128,0,1,0,1,0
60604,59890,0,0,141,141,0,1,0,1,0
39754,5343,0,0,141,141,0,1,0,1,0
3244,25327,0,0,144,144,0,1,0,1,0
47180,5618,0,0,145,145,0,1,0,1,0
11837,3389,11837,3389,293,223,70,4,0,3,1
16088,3389,16088,3389,293,223,70,4,0,3,1
27910,26329,0,0,142,142,0,1,0,1,0
27456,3389,27456,3389,293,223,70,4,0,3,1
39190,3389,39190,3389,293,223,70,4,0,3,1
12052,3389,12052,3389,293,223,70,4,1,3,1
12696,9043,3031,1123,196,172,23,1,0,1,0
6515,25773,0,0,141,141,0,1,0,1,0
53593,11819,0,0,148,148,0,1,0,1,0
13820,15935,0,0,145,145,0,1,0,1,0
7294,61022,0,0,139,139,0,1,0,1,0
12185,3389,12185,3389,293,223,70,4,1,3,1
14573,25773,0,0,140,140,0,1,0,1,0
10257,24181,0,0,136,136,0,1,0,1,0
28199,30905,0,0,94,94,0,1,0,1,0
50670,32654,0,0,97,97,0,1,0,1,0
46274,55255,0,0,76,76,0,1,0,1,0
15650,10538,0,0,138,138,0,1,0,1,0
15151,22153,0,0,101,101,0,1,0,1,0
49933,31652,0,0,118,118,0,1,0,1,0
49051,29165,0,0,150,150,0,1,0,1,0
2291,46472,0,0,144,144,0,1,0,1,0
52525,60599,0,0,100,100,0,1,0,1,0
51835,32681,0,0,67,67,0,1,0,1,0
6072,25773,0,0,150,150,0,1,0,1,0
20969,3389,20969,3389,293,223,70,4,0,3,1
57690,51900,0,0,118,118,0,1,0,1,0
52013,32348,0,0,62,62,0,1,0,1,0
6167,24696,0,0,157,157,0,1,0,1,0
11251,3389,11251,3389,293,223,70,4,0,3,1
49053,30617,0,0,150,150,0,1,0,1,0
50610,31652,0,0,99,99,0,1,0,1,0
6185,52695,0,0,144,144,0,1,0,1,0
31274,3389,31274,3389,293,223,70,4,0,3,1
36582,3389,36582,3389,293,223,70,4,0,3,1
16280,25773,0,0,145,145,0,1,0,1,0
43301,3389,43301,3389,293,223,70,4,0,3,1
29160,34021,0,0,62,62,0,1,0,1,0
37736,3389,37736,3389,293,223,70,4,1,3,1
28217,34021,0,0,62,62,0,1,0,1,0
28648,1257,0,0,80,80,0,1,0,1,0
2659,43912,0,0,146,146,0,1,0,1,0
63291,40214,0,0,86,86,0,1,0,1,0
51679,31652,0,0,63,63,0,1,0,1,0
11225,3389,11225,3389,293,223,70,4,1,3,1
49622,31652,0,0,131,131,0,1,0,1,0
3010,47258,0,0,144,144,0,1,0,1,0
35204,3389,35204,3389,293,223,70,4,1,3,1
61198,3389,61198,3389,293,223,70,4,0,3,1
24296,15053,0,0,90,90,0,1,0,1,0
15398,13431,0,0,126,126,0,1,0,1,0
40842,8123,0,0,145,145,0,1,0,1,0
17564,3389,17564,3389,293,223,70,4,0,3,1
14190,27318,0,0,124,124,0,1,0,1,0
20477,61248,0,0,156,156,0,1,0,1,0
3077,25067,0,0,145,145,0,1,0,1,0
11477,25773,0,0,142,142,0,1,0,1,0
15891,19995,0,0,84,84,0,1,0,1,0
17375,25773,0,0,143,143,0,1,0,1,0
17987,25773,0,0,143,143,0,1,0,1,0
29663,34021,0,0,62,62,0,1,0,1,0
48938,26901,0,0,155,155,0,1,0,1,0
4246,52159,0,0,142,142,0,1,0,1,0
45500,7336,0,0,145,145,0,1,0,1,0
4198,38797,0,0,149,149,0,1,0,1,0
4710,49822,0,0,143,143,0,1,0,1,0
11942,3389,11942,3389,293,223,70,4,0,3,1
17227,29779,0,0,101,101,0,1,0,1,0
17880,17615,0,0,70,70,0,1,0,1,0
8350,61248,0,0,139,139,0,1,0,1,0
34261,60624,0,0,109,109,0,1,0,1,0
15214,3389,15214,3389,293,223,70,4,0,3,1
18947,29240,0,0,106,106,0,1,0,1,0
1501,21964,0,0,156,156,0,1,0,1,0
50819,30074,0,0,107,107,0,1,0,1,0
49093,31891,0,0,148,148,0,1,0,1,0
9635,3389,9635,3389,293,223,70,4,0,3,1
5363,55405,0,0,141,141,0,1,0,1,0
20447,3389,20447,3389,293,223,70,4,0,3,1
47009,49246,0,0,93,93,0,1,0,1,0
50812,30525,0,0,88,88,0,1,0,1,0
52225,32975,0,0,62,62,0,1,0,1,0
23090,3389,23090,3389,293,223,70,4,0,3,1
52102,33163,0,0,65,65,0,1,0,1,0
49115,32603,0,0,147,147,0,1,0,1,0
27299,25773,0,0,147,147,0,1,0,1,0
17378,3389,17378,3389,293,223,70,4,0,3,1
2083,23511,0,0,151,151,0,1,0,1,0
7112,25773,0,0,153,153,0,1,0,1,0
17621,3389,17621,3389,293,223,70,4,0,3,1
11147,3389,11147,3389,293,223,70,4,1,3,1
50171,32882,0,0,110,110,0,1,0,1,0
31095,2157,0,0,94,94,0,1,0,1,0
35784,3389,35784,3389,293,223,70,4,0,3,1
9806,4443,8004,2966,274,213,61,3,0,2,0
31487,2301,0,0,96,96,0,1,0,1,0
52290,33502,0,0,64,64,0,1,0,1,0
31792,3389,31792,3389,293,223,70,4,0,3,1
51390,34021,0,0,91,91,0,1,0,1,0
17233,3389,17233,3389,293,223,70,4,1,3,1
13033,22119,0,0,110,110,0,1,0,1,0
50369,29422,0,0,104,104,0,1,0,1,0
33841,13407,0,0,146,146,0,1,0,1,0
22105,3389,22105,3389,293,223,70,4,0,3,1
49051,30553,0,0,150,150,0,1,0,1,0
8259,25773,0,0,156,156,0,1,0,1,0
21717,32641,0,0,75,75,0,1,0,1,0
20190,5545,0,0,102,102,0,1,0,1,0
49996,31652,0,0,119,119,0,1,0,1,0
49597,27502,0,0,131,131,0,1,0,1,0
19241,3389,19241,3389,293,223,70,4,0,3,1
29065,24073,0,0,147,147,0,1,0,1,0
28203,34021,0,0,62,62,0,1,0,1,0
26893,3389,26893,3389,293,223,70,4,0,3,1
22512,25773,0,0,145,145,0,1,0,1,0
23767,34021,0,0,62,62,0,1,0,1,0
12891,3389,12891,3389,293,223,70,4,0,3,1
57525,51201,0,0,114,114,0,1,0,1,0
18092,25912,0,0,141,141,0,1,0,1,0
48419,39573,0,0,128,128,0,1,0,1,0
54629,60772,0,0,112,112,0,1,0,1,0
28520,26851,0,0,136,136,0,1,0,1,0
51061,34021,0,0,99,99,0,1,0,1,0
28651,60913,0,0,132,132,0,1,0,1,0
9429,3389,9429,3389,293,223,70,4,0,3,1
11651,25553,0,0,140,140,0,1,0,1,0
49774,33464,0,0,126,126,0,1,0,1,0
17501,3389,17501,3389,293,223,70,4,0,3,1
13257,25773,0,0,143,143,0,1,0,1,0
43314,3389,43314,3389,293,223,70,4,0,3,1
49065,29497,0,0,150,150,0,1,0,1,0
13390,21854,0,0,107,107,0,1,0,1,0
19503,19179,0,0,72,72,0,1,0,1,0
53772,5618,0,0,145,145,0,1,0,1,0
24139,25773,0,0,145,145,0,1,0,1,0
34583,11749,0,0,146,146,0,1,0,1,0
11919,61248,0,0,140,140,0,1,0,1,0
2261,23790,0,0,150,150,0,1,0,1,0
11069,3637,10644,3289,288,220,67,3,0,2,0
30806,4718,0,0,106,106,0,1,0,1,0
9582,25773,0,0,154,154,0,1,0,1,0
7073,25773,0,0,141,141,0,1,0,1,0
42118,60221,0,0,76,76,0,1,0,1,0
14983,25773,0,0,140,140,0,1,0,1,0
23758,31744,0,0,83,83,0,1,0,1,0
15957,2489,9257,2489,231,180,51,3,0,2,0
13721,61248,0,0,141,141,0,1,0,1,0
7511,54048,0,0,141,141,0,1,0,1,0
57113,49923,0,0,113,113,0,1,0,1,0
60252,3389,60252,3389,293,223,70,4,0,3,1
9930,61248,0,0,141,141,0,1,0,1,0
51464,33249,0,0,89,89,0,1,0,1,0
52986,35788,0,0,73,73,0,1,0,1,0
22244,25773,0,0,145,145,0,1,0,1,0
13278,3389,13278,3389,293,223,70,4,0,3,1
52044,32437,0,0,62,62,0,1,0,1,0
24238,25773,0,0,146,146,0,1,0,1,0
10956,52668,0,0,151,151,0,1,0,1,0
49160,33856,0,0,146,146,0,1,0,1,0
46101,60071,0,0,64,64,0,1,0,1,0
29814,33338,0,0,69,69,0,1,0,1,0
43311,34021,0,0,120,120,0,1,0,1,0
11898,5645,8040,2484,254,202,51,3,0,2,0
7288,61005,0,0,139,139,0,1,0,1,0
51632,31652,0,0,64,64,0,1,0,1,0
53498,37217,0,0,71,71,0,1,0,1,0
51645,31379,0,0,66,66,0,1,0,1,0
51768,31652,0,0,62,62,0,1,0,1,0
49877,31652,0,0,122,122,0,1,0,1,0
13720,26937,0,0,128,128,0,1,0,1,0
50313,28657,0,0,110,110,0,1,0,1,0
49823,27839,0,0,133,133,0,1,0,1,0
51786,33472,0,0,81,81,0,1,0,1,0
17341,25773,0,0,142,142,0,1,0,1,0
49879,32150,0,0,128,128,0,1,0,1,0
19528,3389,19528,3389,293,223,70,4,0,3,1
28557,3389,28557,3389,293,223,70,4,0,3,1
12934,25773,0,0,150,150,0,1,0,1,0
29184,34021,0,0,62,62,0,1,0,1,0
21957,21017,0,0,93,93,0,1,0,1,0
5387,24265,0,0,157,157,0,1,0,1,0
41248,34021,0,0,111,111,0,1,0,1,0
11056,3605,10686,3302,289,221,68,3,0,2,0
50659,32333,0,0,93,93,0,1,0,1,0
1798,23065,0,0,152,152,0,1,0,1,0
9964,4695,7731,2865,270,211,59,3,0,2,0
34329,60621,0,0,108,108,0,1,0,1,0
49371,31798,0,0,140,140,0,1,0,1,0
19892,3389,19892,3389,293,223,70,4,0,3,1
2196,22262,0,0,155,155,0,1,0,1,0
50030,28077,0,0,119,119,0,1,0,1,0
13941,10594,1624,502,169,159,10,1,0,1,0
25443,23629,0,0,123,123,0,1,0,1,0
54298,14828,0,0,115,115,0,1,0,1,0
37523,3389,37523,3389,293,223,70,4,1,3,1
5177,24149,0,0,157,157,0,1,0,1,0
24829,30677,0,0,96,96,0,1,0,1,0
56626,48255,0,0,108,108,0,1,0,1,0
38219,3389,38219,3389,293,223,70,4,1,3,1
30695,20433,0,0,147,147,0,1,0,1,0
45769,59443,0,0,63,63,0,1,0,1,0
1171,22084,0,0,156,156,0,1,0,1,0
58106,53219,0,0,120,120,0,1,0,1,0
45381,7356,0,0,145,145,0,1,0,1,0
17516,3389,17516,3389,293,223,70,4,0,3,1
12087,3389,12087,3389,293,223,70,4,1,3,1
60205,4407,34763,1840,225,187,38,2,0,2,0
21280,3389,21280,3389,293,223,70,4,0,3,1
59411,57797,0,0,135,135,0,1,0,1,0
30365,21171,0,0,147,147,0,1,0,1,0
49069,29579,0,0,149,149,0,1,0,1,0
17818,25773,0,0,142,142,0,1,0,1,0
50147,28870,0,0,112,112,0,1,0,1,0
52469,34021,0,0,64,64,0,1,0,1,0
37849,3389,37849,3389,293,223,70,4,1,3,1
28659,60912,0,0,132,132,0,1,0,1,0
56010,31652,0,0,62,62,0,1,0,1,0
12204,3389,12204,3389,293,223,70,4,1,3,1
52215,32946,0,0,62,62,0,1,0,1,0
33606,3081,0,0,108,108,0,1,0,1,0
27262,24992,0,0,139,139,0,1,0,1,0
19339,28227,0,0,118,118,0,1,0,1,0
28016,25773,0,0,147,147,0,1,0,1,0
49160,32324,0,0,146,146,0,1,0,1,0
49160,33330,0,0,146,146,0,1,0,1,0
54825,5761,0,0,145,145,0,1,0,1,0
26878,34021,0,0,62,62,0,1,0,1,0
17377,3389,17377,3389,293,223,70,4,0,3,1
51442,31972,0,0,70,70,0,1,0,1,0
21038,37496,0,0,72,72,0,1,0,1,0
9963,3389,9963,3389,293,223,70,4,1,3,1
20921,3389,20921,3389,293,223,70,4,0,3,1
28656,27534,0,0,129,129,0,1,0,1,0
11434,3389,11434,3389,293,223,70,4,1,3,1
49345,33853,0,0,140,140,0,1,0,1,0
51663,32370,0,0,68,68,0,1,0,1,0
44754,7462,0,0,145,145,0,1,0,1,0
20313,3389,20313,3389,293,223,70,4,0,3,1
30590,3389,30590,3389,293,223,70,4,0,3,1
10722,3389,10722,3389,293,223,70,4,1,3,1
7693,25773,0,0,155,155,0,1,0,1,0
17318,3389,17318,3389,293,223,70,4,0,3,1
5392,24267,0,0,157,157,0,1,0,1,0
49159,3389,49159,3389,293,223,70,4,0,3,1
39114,6612,0,0,146,146,0,1,0,1,0
8019,61248,0,0,139,139,0,1,0,1,0
10955,61248,0,0,139,139,0,1,0,1,0
12580,3389,12580,3389,293,223,70,4,0,3,1
11468,61248,0,0,142,142,0,1,0,1,0
20365,3389,20365,3389,293,223,70,4,0,3,1
21248,61248,0,0,157,157,0,1,0,1,0
7307,24041,0,0,146,146,0,1,0,1,0
11484,4642,9342,2886,271,211,59,3,0,2,0
28306,12937,0,0,110,110,0,1,0,1,0
31622,18364,0,0,147,147,0,1,0,1,0
50733,29514,0,0,96,96,0,1,0,1,0
5546,23428,0,0,149,149,0,1,0,1,0
1219,22159,0,0,155,155,0,1,0,1,0
2938,48354,0,0,144,144,0,1,0,1,0
49217,5618,0,0,145,145,0,1,0,1,0
22462,28845,0,0,112,112,0,1,0,1,0
16948,3389,16948,3389,293,223,70,4,0,3,1
14704,2501,8093,2501,232,180,51,3,0,2,0
49778,31652,0,0,124,124,0,1,0,1,0
3736,25773,0,0,143,143,0,1,0,1,0
28226,34021,0,0,62,62,0,1,0,1,0
20433,3389,20433,3389,293,223,70,4,0,3,1
12930,21626,0,0,141,141,0,1,0,1,0
4292,25773,0,0,142,142,0,1,0,1,0
14076,3389,14076,3389,293,223,70,4,0,3,1
51284,31652,0,0,71,71,0,1,0,1,0
16738,25773,0,0,142,142,0,1,0,1,0
49160,32861,0,0,146,146,0,1,0,1,0
11492,3389,11492,3389,293,223,70,4,0,3,1
9721,61248,0,0,139,139,0,1,0,1,0
16340,2112,6836,2112,205,162,43,2,0,2,0
20437,32381,0,0,77,77,0,1,0,1,0
17059,3389,17059,3389,293,223,70,4,0,3,1
13684,24004,0,0,120,120,0,1,0,1,0
26526,25773,0,0,147,147,0,1,0,1,0
25066,30343,0,0,100,100,0,1,0,1,0
11385,3389,11385,3389,293,223,70,4,1,3,1
5759,48677,0,0,147,147,0,1,0,1,0
50669,31652,0,0,97,97,0,1,0,1,0
10334,58306,0,0,140,140,0,1,0,1,0
51033,32950,0,0,99,99,0,1,0,1,0
17591,3389,17591,3389,293,223,70,4,0,3,1
58119,53262,0,0,120,120,0,1,0,1,0
49970,34021,0,0,126,126,0,1,0,1,0
12014,7957,4205,1558,214,182,32,2,0,1,0
41862,3389,41862,3389,293,223,70,4,0,3,1
50205,28696,0,0,123,123,0,1,0,1,0
55256,60823,0,0,115,115,0,1,0,1,0
15844,3389,15844,3389,293,223,70,4,0,3,1
13491,26752,0,0,129,129,0,1,0,1,0
15809,3389,15809,3389,293,223,70,4,0,3,1
22162,3377,0,0,86,86,0,1,0,1,0
20559,3389,20559,3389,293,223,70,4,0,3,1
11652,7381,4828,1789,224,187,36,2,0,2,0
20695,61248,0,0,157,157,0,1,0,1,0
58746,32791,0,0,62,62,0,1,0,1,0
49637,6638,0,0,145,145,0,1,0,1,0
20721,3389,20721,3389,293,223,70,4,0,3,1
16549,61248,0,0,147,147,0,1,0,1,0
25619,23761,0,0,125,125,0,1,0,1,0
49743,27491,0,0,129,129,0,1,0,1,0
7533,25773,0,0,155,155,0,1,0,1,0
19073,61248,0,0,152,152,0,1,0,1,0
13630,17148,0,0,144,144,0,1,0,1,0
51480,31652,0,0,67,67,0,1,0,1,0
3603,25734,0,0,142,142,0,1,0,1,0
14175,54265,0,0,122,122,0,1,0,1,0
49909,28277,0,0,120,120,0,1,0,1,0
14090,3389,14090,3389,293,223,70,4,0,3,1
52559,33494,0,0,127,127,0,1,0,1,0
42734,10977,0,0,148,148,0,1,0,1,0
20120,29850,0,0,100,100,0,1,0,1,0
17787,18587,0,0,66,66,0,1,0,1,0
50180,28953,0,0,111,111,0,1,0,1,0
11635,61248,0,0,139,139,0,1,0,1,0
8763,56992,0,0,143,143,0,1,0,1,0
49079,31449,0,0,149,149,0,1,0,1,0
3493,23218,0,0,157,157,0,1,0,1,0
15919,3389,15919,3389,293,223,70,4,0,3,1
24699,34021,0,0,62,62,0,1,0,1,0
50372,31652,0,0,107,107,0,1,0,1,0
52505,31652,0,0,62,62,0,1,0,1,0
20442,3389,20442,3389,293,223,70,4,0,3,1
43777,60136,0,0,69,69,0,1,0,1,0
18663,3389,18663,3389,293,223,70,4,0,3,1
9568,4064,8413,3118,281,217,64,3,0,2,0
18698,3389,18698,3389,293,223,70,4,0,3,1
51636,34021,0,0,85,85,0,1,0,1,0
36734,11841,0,0,146,146,0,1,0,1,0
18231,30593,0,0,93,93,0,1,0,1,0
15541,3389,15541,3389,293,223,70,4,0,3,1
8726,25319,0,0,151,151,0,1,0,1,0
18805,3389,18805,3389,293,223,70,4,0,3,1
22538,34021,0,0,62,62,0,1,0,1,0
12647,3389,12647,3389,293,223,70,4,0,3,1
28163,32631,0,0,76,76,0,1,0,1,0
21023,31352,0,0,88,88,0,1,0,1,0
13709,3389,13709,3389,293,223,70,4,0,3,1
17665,17254,0,0,75,75,0,1,0,1,0
63078,31652,0,0,63,63,0,1,0,1,0
60408,61247,0,0,144,144,0,1,0,1,0
4096,49215,0,0,144,144,0,1,0,1,0
14036,3389,14036,3389,293,223,70,4,0,3,1
11466,4598,9398,2904,272,212,59,3,0,2,0
23955,31911,0,0,83,83,0,1,0,1,0
37151,8020,0,0,146,146,0,1,0,1,0
37095,3389,37095,3389,293,223,70,4,1,3,1
14703,12260,0,0,142,142,0,1,0,1,0
5743,24462,0,0,157,157,0,1,0,1,0
23132,3389,23132,3389,293,223,70,4,0,3,1
12248,3389,12248,3389,293,223,70,4,0,3,1
32135,2540,0,0,99,99,0,1,0,1,0
9687,61248,0,0,139,139,0,1,0,1,0
1882,23196,0,0,152,152,0,1,0,1,0
28185,31566,0,0,87,87,0,1,0,1,0
16019,61248,0,0,149,149,0,1,0,1,0
26260,869,0,0,70,70,0,1,0,1,0
14762,12359,0,0,141,141,0,1,0,1,0
29495,34021,0,0,62,62,0,1,0,1,0
2696,37284,0,0,144,144,0,1,0,1,0
31603,18406,0,0,147,147,0,1,0,1,0
49757,31652,0,0,125,125,0,1,0,1,0
52916,60631,0,0,102,102,0,1,0,1,0
27396,34021,0,0,62,62,0,1,0,1,0
54270,60742,0,0,110,110,0,1,0,1,0
19009,61248,0,0,154,154,0,1,0,1,0
15211,3389,15211,3389,293,223,70,4,0,3,1
60707,3389,60707,3389,293,223,70,4,0,3,1
49966,28421,0,0,118,118,0,1,0,1,0
2948,33795,0,0,143,143,0,1,0,1,0
22166,3389,22166,3389,293,223,70,4,1,3,1
53878,5618,0,0,145,145,0,1,0,1,0
49087,31703,0,0,149,149,0,1,0,1,0
60960,3389,60960,3389,293,223,70,4,0,3,1
37970,3389,37970,3389,293,223,70,4,1,3,1
11601,3389,11601,3389,293,223,70,4,1,3,1
9996,24977,0,0,142,142,0,1,0,1,0
29500,31761,0,0,85,85,0,1,0,1,0
51597,31652,0,0,65,65,0,1,0,1,0
14858,3389,14858,3389,293,223,70,4,0,3,1
28175,32060,0,0,82,82,0,1,0,1,0
29673,32630,0,0,76,76,0,1,0,1,0
10467,25773,0,0,146,146,0,1,0,1,0
56542,47786,0,0,103,103,0,1,0,1,0
58037,4987,18118,959,186,167,19,1,0,1,0
12015,61248,0,0,140,140,0,1,0,1,0
52652,25817,0,0,80,80,0,1,0,1,0
10105,61248,0,0,139,139,0,1,0,1,0
20458,32398,0,0,77,77,0,1,0,1,0
5882,25773,0,0,141,141,0,1,0,1,0
50509,31652,0,0,98,98,0,1,0,1,0
29875,33641,0,0,65,65,0,1,0,1,0
10413,3389,10413,3389,293,223,70,4,1,3,1
22068,33291,0,0,69,69,0,1,0,1,0
51450,6331,0,0,145,145,0,1,0,1,0
55905,33357,0,0,62,62,0,1,0,1,0
14420,61248,0,0,147,147,0,1,0,1,0
22196,21196,0,0,95,95,0,1,0,1,0
17201,3389,17201,3389,293,223,70,4,0,3,1
59239,32460,0,0,90,90,0,1,0,1,0
50900,31652,0,0,84,84,0,1,0,1,0
38260,3389,38260,3389,293,223,70,4,1,3,1
18030,3389,18030,3389,293,223,70,4,0,3,1
51676,31652,0,0,63,63,0,1,0,1,0
22856,25773,0,0,145,145,0,1,0,1,0
20858,3389,20858,3389,293,223,70,4,1,3,1
45517,17651,0,0,152,152,0,1,0,1,0
9372,3752,8751,3243,286,219,66,3,0,2,0
37283,3389,37283,3389,293,223,70,4,1,3,1
22246,33623,0,0,65,65,0,1,0,1,0
34253,7636,0,0,133,133,0,1,0,1,0
48997,28820,0,0,152,152,0,1,0,1,0
19740,3389,19740,3389,293,223,70,4,0,3,1
12986,3389,12986,3389,293,223,70,4,0,3,1
36644,3389,36644,3389,293,223,70,4,0,3,1
21381,61248,0,0,157,157,0,1,0,1,0
6565,17727,0,0,153,153,0,1,0,1,0
11647,60440,0,0,140,140,0,1,0,1,0
55696,5613,143,7,145,145,0,1,0,1,0
11870,3389,11870,3389,293,223,70,4,0,3,1
48911,25973,0,0,156,156,0,1,0,1,0
37584,3389,37584,3389,293,223,70,4,1,3,1
15073,3389,15073,3389,293,223,70,4,0,3,1
27027,33444,0,0,67,67,0,1,0,1,0
13582,25773,0,0,143,143,0,1,0,1,0
49051,30538,0,0,150,150,0,1,0,1,0
11751,61248,0,0,141,141,0,1,0,1,0
15906,17513,0,0,145,145,0,1,0,1,0
50897,32856,0,0,103,103,0,1,0,1,0
10348,25773,0,0,147,147,0,1,0,1,0
15436,25773,0,0,141,141,0,1,0,1,0
28845,34021,0,0,62,62,0,1,0,1,0
47470,60184,0,0,72,72,0,1,0,1,0
10158,25773,0,0,143,143,0,1,0,1,0
55377,43740,0,0,91,91,0,1,0,1,0
14605,25773,0,0,140,140,0,1,0,1,0
13569,25773,0,0,139,139,0,1,0,1,0
13590,9744,2727,842,184,166,17,1,0,1,0
17655,24356,0,0,143,143,0,1,0,1,0
10280,3389,10280,3389,293,223,70,4,1,3,1
29351,34021,0,0,62,62,0,1,0,1,0
53647,19174,0,0,101,101,0,1,0,1,0
1547,22672,0,0,154,154,0,1,0,1,0
19036,61248,0,0,152,152,0,1,0,1,0
35356,9218,0,0,143,143,0,1,0,1,0
10254,61248,0,0,139,139,0,1,0,1,0
40268,34021,0,0,107,107,0,1,0,1,0
11072,3389,11072,3389,293,223,70,4,0,3,1
27031,34021,0,0,62,62,0,1,0,1,0
50967,3389,50967,3389,293,223,70,4,0,3,1
13564,2772,8970,2772,250,193,57,3,0,2,0
27647,3389,27647,3389,293,223,70,4,0,3,1
51204,34021,0,0,95,95,0,1,0,1,0
14619,12118,0,0,144,144,0,1,0,1,0
13529,3389,13529,3389,293,223,70,4,0,3,1
4728,25773,0,0,146,146,0,1,0,1,0
48098,3389,48098,3389,293,223,70,4,0,3,1
14298,12876,0,0,147,147,0,1,0,1,0
51131,5618,0,0,145,145,0,1,0,1,0
13667,2747,8890,2747,249,192,56,3,0,2,0
10457,24029,0,0,149,149,0,1,0,1,0
26949,27685,0,0,128,128,0,1,0,1,0
50323,34021,0,0,117,117,0,1,0,1,0
27683,60962,0,0,136,136,0,1,0,1,0
45409,5618,0,0,145,145,0,1,0,1,0
28431,3389,28431,3389,293,223,70,4,0,3,1
49231,33939,0,0,143,143,0,1,0,1,0
15222,14836,0,0,146,146,0,1,0,1,0
5835,51518,0,0,142,142,0,1,0,1,0
37067,3389,37067,3389,293,223,70,4,1,3,1
18205,3389,18205,3389,293,223,70,4,0,3,1
19809,61248,0,0,155,155,0,1,0,1,0
20232,19725,0,0,78,78,0,1,0,1,0
1426,21994,0,0,156,156,0,1,0,1,0
51986,32953,0,0,66,66,0,1,0,1,0
50273,29184,0,0,107,107,0,1,0,1,0
64255,31692,0,0,62,62,0,1,0,1,0
54647,12495,0,0,123,123,0,1,0,1,0
50303,6525,0,0,145,145,0,1,0,1,0
48952,26907,0,0,154,154,0,1,0,1,0
28477,3389,28477,3389,293,223,70,4,0,3,1
50293,29233,0,0,106,106,0,1,0,1,0
16722,3389,16722,3389,293,223,70,4,0,3,1
12225,3389,12225,3389,293,223,70,4,1,3,1
50835,6435,0,0,145,145,0,1,0,1,0
22706,34021,0,0,62,62,0,1,0,1,0
16854,3389,16854,3389,293,223,70,4,1,3,1
58559,32828,0,0,62,62,0,1,0,1,0
4747,50300,0,0,144,144,0,1,0,1,0
10674,61248,0,0,142,142,0,1,0,1,0
12571,3389,12571,3389,293,223,70,4,0,3,1
11503,61248,0,0,142,142,0,1,0,1,0
48506,3389,48506,3389,293,223,70,4,0,3,1
36331,3389,36331,3389,293,223,70,4,0,3,1
24893,3389,24893,3389,293,223,70,4,0,3,1
13941,10593,1626,502,169,159,10,1,0,1,0
7961,25773,0,0,140,140,0,1,0,1,0
51350,31805,0,0,71,71,0,1,0,1,0
22587,29498,0,0,106,106,0,1,0,1,0
17858,61248,0,0,150,150,0,1,0,1,0
3588,22445,0,0,154,154,0,1,0,1,0
1844,23137,0,0,152,152,0,1,0,1,0
60647,31652,0,0,62,62,0,1,0,1,0
7452,61248,0,0,139,139,0,1,0,1,0
34217,7606,0,0,133,133,0,1,0,1,0
50222,28733,0,0,122,122,0,1,0,1,0
50252,29131,0,0,108,108,0,1,0,1,0
60830,3389,60830,3389,293,223,70,4,0,3,1
52562,33993,0,0,62,62,0,1,0,1,0
28284,26778,0,0,137,137,0,1,0,1,0
23047,3389,23047,3389,293,223,70,4,0,3,1
16176,3389,16176,3389,293,223,70,4,0,3,1
43151,34021,0,0,119,119,0,1,0,1,0
15429,15644,0,0,146,146,0,1,0,1,0
16689,28065,0,0,117,117,0,1,0,1,0
51041,5618,0,0,145,145,0,1,0,1,0
42686,5618,0,0,145,145,0,1,0,1,0
12686,3389,12686,3389,293,223,70,4,0,3,1
13981,26656,0,0,130,130,0,1,0,1,0
21695,61248,0,0,158,158,0,1,0,1,0
13975,61248,0,0,146,146,0,1,0,1,0
37486,3389,37486,3389,293,223,70,4,1,3,1
15486,25773,0,0,141,141,0,1,0,1,0
16899,3389,16899,3389,293,223,70,4,0,3,1
51210,60491,0,0,93,93,0,1,0,1,0
49030,26091,0,0,152,152,0,1,0,1,0
28872,60901,0,0,131,131,0,1,0,1,0
11995,61248,0,0,140,140,0,1,0,1,0
7044,54127,0,0,143,143,0,1,0,1,0
51808,32633,0,0,67,67,0,1,0,1,0
11457,61248,0,0,142,142,0,1,0,1,0
24071,29957,0,0,101,101,0,1,0,1,0
23753,61164,0,0,152,152,0,1,0,1,0
51261,31066,0,0,96,96,0,1,0,1,0
34756,3389,34756,3389,293,223,70,4,0,3,1
16926,3389,16926,3389,293,223,70,4,0,3,1
13168,3389,13168,3389,293,223,70,4,0,3,1
55574,33423,0,0,62,62,0,1,0,1,0
32937,3389,32937,3389,293,223,70,4,0,3,1
21362,30497,0,0,94,94,0,1,0,1,0
49295,33999,0,0,145,145,0,1,0,1,0
49096,32175,0,0,144,144,0,1,0,1,0
48980,27544,0,0,153,153,0,1,0,1,0
19141,3389,19141,3389,293,223,70,4,0,3,1
9645,24855,0,0,143,143,0,1,0,1,0
37575,3389,37575,3389,293,223,70,4,1,3,1
48761,34909,0,0,136,136,0,1,0,1,0
38706,34021,0,0,100,100,0,1,0,1,0
18737,3389,18737,3389,293,223,70,4,0,3,1
50414,32608,0,0,101,101,0,1,0,1,0
11377,3389,11377,3389,293,223,70,4,1,3,1
63686,37321,0,0,77,77,0,1,0,1,0
21211,3389,21211,3389,293,223,70,4,0,3,1
28294,26277,0,0,142,142,0,1,0,1,0
51668,6295,0,0,145,145,0,1,0,1,0
3070,22985,0,0,157,157,0,1,0,1,0
9431,3389,9431,3389,293,223,70,4,1,3,1
28260,27952,0,0,125,125,0,1,0,1,0
48993,25957,0,0,154,154,0,1,0,1,0
11174,3389,11174,3389,293,223,70,4,1,3,1
51742,31652,0,0,62,62,0,1,0,1,0
53672,38138,0,0,80,80,0,1,0,1,0
31812,5570,0,0,114,114,0,1,0,1,0
21333,3389,21333,3389,293,223,70,4,0,3,1
11402,3389,11402,3389,293,223,70,4,1,3,1
25051,30365,0,0,100,100,0,1,0,1,0
17960,3389,17960,3389,293,223,70,4,0,3,1
24946,30513,0,0,98,98,0,1,0,1,0
11813,61248,0,0,140,140,0,1,0,1,0
3275,29281,0,0,143,143,0,1,0,1,0
55672,31652,0,0,110,110,0,1,0,1,0
54126,60731,0,0,109,109,0,1,0,1,0
22708,29597,0,0,105,105,0,1,0,1,0
56644,60937,0,0,123,123,0,1,0,1,0
11210,3389,11210,3389,293,223,70,4,1,3,1
10694,3389,10694,3389,293,223,70,4,0,3,1
28348,25700,0,0,147,147,0,1,0,1,0
49193,31652,0,0,145,145,0,1,0,1,0
52527,33930,0,0,62,62,0,1,0,1,0
29286,30690,0,0,96,96,0,1,0,1,0
8547,61248,0,0,140,140,0,1,0,1,0
11486,21702,0,0,99,99,0,1,0,1,0
15973,3389,15973,3389,293,223,70,4,0,3,1
34766,3389,34766,3389,293,223,70,4,0,3,1
60565,31652,0,0,62,62,0,1,0,1,0
16801,2263,8415,2262,216,169,46,3,0,2,0
4813,25773,0,0,146,146,0,1,0,1,0
16980,61248,0,0,152,152,0,1,0,1,0
16462,3389,16462,3389,293,223,70,4,0,3,1
12622,61248,0,0,139,139,0,1,0,1,0
37418,7829,0,0,146,146,0,1,0,1,0
21689,3389,21689,3389,293,223,70,4,0,3,1
21631,3389,21631,3389,293,223,70,4,0,3,1
56448,47460,0,0,102,102,0,1,0,1,0
48945,25859,0,0,155,155,0,1,0,1,0
51523,31130,0,0,70,70,0,1,0,1,0
11952,13715,0,0,149,149,0,1,0,1,0
34337,3389,34337,3389,293,223,70,4,0,3,1
16713,28078,0,0,117,117,0,1,0,1,0
51805,31729,0,0,62,62,0,1,0,1,0
33171,2921,0,0,105,105,0,1,0,1,0
13871,21496,0,0,103,103,0,1,0,1,0
12449,8649,3458,1281,202,176,26,2,0,1,0
17874,25773,0,0,143,143,0,1,0,1,0
60420,61235,0,0,144,144,0,1,0,1,0
11767,3389,11767,3389,293,223,70,4,0,3,1
51869,31918,0,0,62,62,0,1,0,1,0
11354,25773,0,0,152,152,0,1,0,1,0
12806,7844,5190,1604,216,183,33,2,0,1,0
19330,3389,19330,3389,293,223,70,4,0,3,1
51094,32271,0,0,83,83,0,1,0,1,0
12546,25773,0,0,139,139,0,1,0,1,0
15110,25773,0,0,140,140,0,1,0,1,0
18610,29065,0,0,108,108,0,1,0,1,0
21926,16303,0,0,79,79,0,1,0,1,0
29772,33124,0,0,71,71,0,1,0,1,0
19698,19325,0,0,74,74,0,1,0,1,0
10152,25773,0,0,154,154,0,1,0,1,0
63753,31761,0,0,65,65,0,1,0,1,0
27365,60979,0,0,137,137,0,1,0,1,0
9329,3389,9329,3389,293,223,70,4,1,3,1
29937,33953,0,0,62,62,0,1,0,1,0
61119,31652,0,0,80,80,0,1,0,1,0
46270,57846,0,0,62,62,0,1,0,1,0
15528,25198,0,0,145,145,0,1,0,1,0
27845,26421,0,0,141,141,0,1,0,1,0
42094,9443,0,0,148,148,0,1,0,1,0
26965,34021,0,0,62,62,0,1,0,1,0
51277,39141,0,0,145,145,0,1,0,1,0
21871,20953,0,0,92,92,0,1,0,1,0
26704,34021,0,0,62,62,0,1,0,1,0
27939,3389,27939,3389,293,223,70,4,1,3,1
18172,26061,0,0,140,140,0,1,0,1,0
26127,3389,26127,3389,293,223,70,4,0,3,1
49187,34021,0,0,145,145,0,1,0,1,0
16957,47466,0,0,101,101,0,1,0,1,0
51517,31652,0,0,67,67,0,1,0,1,0
19644,28792,0,0,113,113,0,1,0,1,0
29777,33154,0,0,71,71,0,1,0,1,0
51749,31652,0,0,62,62,0,1,0,1,0
26613,34021,0,0,62,62,0,1,0,1,0
59866,59356,0,0,139,139,0,1,0,1,0
21496,3389,21496,3389,293,223,70,4,0,3,1
38586,60402,0,0,91,91,0,1,0,1,0
2860,43244,0,0,146,146,0,1,0,1,0
63345,31652,0,0,62,62,0,1,0,1,0
43744,3389,43744,3389,293,223,70,4,0,3,1
10347,5304,7072,2621,260,206,54,3,0,2,0
14178,3389,14178,3389,293,223,70,4,0,3,1
49356,24423,0,0,156,156,0,1,0,1,0
8413,25773,0,0,155,155,0,1,0,1,0
12370,3389,12370,3389,293,223,70,4,0,3,1
27114,33189,0,0,70,70,0,1,0,1,0
52017,33008,0,0,66,66,0,1,0,1,0
33731,3389,33731,3389,293,223,70,4,0,3,1
51509,33280,0,0,88,88,0,1,0,1,0
6601,59006,0,0,139,139,0,1,0,1,0
14098,3389,14098,3389,293,223,70,4,0,3,1
26151,3389,26151,3389,293,223,70,4,0,3,1
20686,3389,20686,3389,293,223,70,4,0,3,1
8283,61248,0,0,139,139,0,1,0,1,0
4710,23891,0,0,157,157,0,1,0,1,0
18015,3389,18015,3389,293,223,70,4,0,3,1
21524,61248,0,0,158,158,0,1,0,1,0
50339,28996,0,0,119,119,0,1,0,1,0
14342,20241,0,0,83,83,0,1,0,1,0
51960,32907,0,0,66,66,0,1,0,1,0
11606,3389,11606,3389,293,223,70,4,1,3,1
49176,60324,0,0,81,81,0,1,0,1,0
18760,3389,18760,3389,293,223,70,4,0,3,1
51398,31892,0,0,70,70,0,1,0,1,0
14858,55664,0,0,153,153,0,1,0,1,0
44454,5618,0,0,145,145,0,1,0,1,0
28281,26924,0,0,135,135,0,1,0,1,0
9900,25773,0,0,140,140,0,1,0,1,0
17227,19534,0,0,75,75,0,1,0,1,0
28503,3389,28503,3389,293,223,70,4,1,3,1
40235,5808,0,0,146,146,0,1,0,1,0
17156,16395,0,0,86,86,0,1,0,1,0
51450,6331,0,0,145,145,0,1,0,1,0
15919,25773,0,0,145,145,0,1,0,1,0
4749,53623,0,0,141,141,0,1,0,1,0
41632,5618,0,0,145,145,0,1,0,1,0
17240,19517,0,0,75,75,0,1,0,1,0
49160,33437,0,0,146,146,0,1,0,1,0
19185,29364,0,0,105,105,0,1,0,1,0
7542,25773,0,0,141,141,0,1,0,1,0
18930,3389,18930,3389,293,223,70,4,0,3,1
16163,3389,16163,3389,293,223,70,4,1,3,1
2696,37287,0,0,144,144,0,1,0,1,0
49579,31652,0,0,132,132,0,1,0,1,0
10529,61248,0,0,143,143,0,1,0,1,0
49730,33379,0,0,125,125,0,1,0,1,0
51329,31652,0,0,70,70,0,1,0,1,0
28453,34021,0,0,62,62,0,1,0,1,0
11758,61248,0,0,141,141,0,1,0,1,0
12582,3389,12582,3389,293,223,70,4,0,3,1
19460,3389,19460,3389,293,223,70,4,0,3,1
35898,3389,35898,3389,293,223,70,4,0,3,1
16980,61248,0,0,151,151,0,1,0,1,0
20549,3389,20549,3389,293,223,70,4,0,3,1
37340,8714,0,0,145,145,0,1,0,1,0
8303,61248,0,0,139,139,0,1,0,1,0
48971,27346,0,0,154,154,0,1,0,1,0
11987,3389,11987,3389,293,223,70,4,1,3,1
28242,28817,0,0,116,116,0,1,0,1,0
12133,8146,4000,1482,211,180,30,2,0,1,0
17646,25773,0,0,143,143,0,1,0,1,0
11074,3389,11074,3389,293,223,70,4,0,3,1
54877,33135,0,0,114,114,0,1,0,1,0
28170,2486,0,0,85,85,0,1,0,1,0
49966,33291,0,0,120,120,0,1,0,1,0
1719,22942,0,0,153,153,0,1,0,1,0
59705,3389,59705,3389,293,223,70,4,0,3,1
50833,31652,0,0,87,87,0,1,0,1,0
9901,25773,0,0,149,149,0,1,0,1,0
32767,3389,32767,3389,293,223,70,4,0,3,1
52490,33762,0,0,62,62,0,1,0,1,0
18144,3389,18144,3389,293,223,70,4,0,3,1
36943,11495,0,0,146,146,0,1,0,1,0
52131,33215,0,0,65,65,0,1,0,1,0
22847,34021,0,0,62,62,0,1,0,1,0
51266,31076,0,0,95,95,0,1,0,1,0
26807,34021,0,0,62,62,0,1,0,1,0
9428,15594,0,0,151,151,0,1,0,1,0
3170,25212,0,0,145,145,0,1,0,1,0
50534,31652,0,0,101,101,0,1,0,1,0
13980,3389,13980,3389,293,223,70,4,0,3,1
8334,55288,0,0,141,141,0,1,0,1,0
37674,3389,37674,3389,293,223,70,4,1,3,1
36020,8831,0,0,146,146,0,1,0,1,0
10827,61248,0,0,139,139,0,1,0,1,0
22468,34021,0,0,62,62,0,1,0,1,0
52139,3389,52139,3389,293,223,70,4,0,3,1
26903,24722,0,0,136,136,0,1,0,1,0
21419,3389,21419,3389,293,223,70,4,0,3,1
2959,24882,0,0,146,146,0,1,0,1,0
50949,32892,0,0,102,102,0,1,0,1,0
11289,25773,0,0,139,139,0,1,0,1,0
18108,22835,0,0,111,111,0,1,0,1,0
13554,61248,0,0,141,141,0,1,0,1,0
55583,49554,0,0,145,145,0,1,0,1,0
49927,31652,0,0,119,119,0,1,0,1,0
49160,32560,0,0,146,146,0,1,0,1,0
30707,3389,30707,3389,293,223,70,4,0,3,1
18026,25455,0,0,139,139,0,1,0,1,0
38055,7371,0,0,146,146,0,1,0,1,0
20573,3389,20573,3389,293,223,70,4,0,3,1
51326,31652,0,0,70,70,0,1,0,1,0
9605,3389,9605,3389,293,223,70,4,0,3,1
16644,25773,0,0,142,142,0,1,0,1,0
21340,25773,0,0,144,144,0,1,0,1,0
11992,3389,11992,3389,293,223,70,4,0,3,1
11717,5207,8608,2660,261,206,54,3,0,2,0
18839,31086,0,0,89,89,0,1,0,1,0
49160,32376,0,0,146,146,0,1,0,1,0
49046,29050,0,0,150,150,0,1,0,1,0
17627,3389,17627,3389,293,223,70,4,0,3,1
51284,31652,0,0,71,71,0,1,0,1,0
20515,3389,20515,3389,293,223,70,4,0,3,1
16412,3389,16412,3389,293,223,70,4,0,3,1
49111,3389,49111,3389,293,223,70,4,0,3,1
28426,26382,0,0,141,141,0,1,0,1,0
29815,34021,0,0,62,62,0,1,0,1,0
26254,28667,0,0,117,117,0,1,0,1,0
51312,31652,0,0,71,71,0,1,0,1,0
19223,3389,19223,3389,293,223,70,4,0,3,1
5550,25773,0,0,142,142,0,1,0,1,0
49620,31652,0,0,143,143,0,1,0,1,0
3135,48926,0,0,143,143,0,1,0,1,0
25159,3389,25159,3389,293,223,70,4,0,3,1
28812,28318,0,0,121,121,0,1,0,1,0
58404,31652,0,0,62,62,0,1,0,1,0
11499,3389,11499,3389,293,223,70,4,1,3,1
49190,33993,0,0,145,145,0,1,0,1,0
20711,30774,0,0,93,93,0,1,0,1,0
8858,25773,0,0,143,143,0,1,0,1,0
9415,15603,0,0,151,151,0,1,0,1,0
20935,3389,20935,3389,293,223,70,4,0,3,1
58661,31652,0,0,93,93,0,1,0,1,0
5285,25773,0,0,148,148,0,1,0,1,0
36957,8159,0,0,146,146,0,1,0,1,0
50244,28515,0,0,112,112,0,1,0,1,0
28277,27128,0,0,133,133,0,1,0,1,0
42998,34021,0,0,119,119,0,1,0,1,0
21263,3389,21263,3389,293,223,70,4,0,3,1
51526,31652,0,0,66,66,0,1,0,1,0
23760,34021,0,0,62,62,0,1,0,1,0
11961,3389,11961,3389,293,223,70,4,0,3,1
52169,32810,0,0,62,62,0,1,0,1,0
20746,27659,0,0,124,124,0,1,0,1,0
13365,3389,13365,3389,293,223,70,4,0,3,1
49160,32819,0,0,146,146,0,1,0,1,0
25710,29435,0,0,109,109,0,1,0,1,0
20466,38893,0,0,76,76,0,1,0,1,0
15534,19631,0,0,76,76,0,1,0,1,0
48952,27359,0,0,154,154,0,1,0,1,0
32989,60690,0,0,114,114,0,1,0,1,0
27109,690,0,0,72,72,0,1,0,1,0
50639,34021,0,0,109,109,0,1,0,1,0
26982,60998,0,0,139,139,0,1,0,1,0
42407,5618,0,0,145,145,0,1,0,1,0
3039,32536,0,0,143,143,0,1,0,1,0
50613,30030,0,0,95,95,0,1,0,1,0
14315,12765,0,0,147,147,0,1,0,1,0
48924,26261,0,0,156,156,0,1,0,1,0
4784,25773,0,0,146,146,0,1,0,1,0
48967,27845,0,0,154,154,0,1,0,1,0
18190,20219,0,0,83,83,0,1,0,1,0
2538,24223,0,0,148,148,0,1,0,1,0
18586,3389,18586,3389,293,223,70,4,0,3,1
49127,32982,0,0,147,147,0,1,0,1,0
18336,3389,18336,3389,293,223,70,4,0,3,1
63386,3556,59193,3133,281,217,64,3,0,2,0
12827,3389,12827,3389,293,223,70,4,0,3,1
24371,30953,0,0,92,92,0,1,0,1,0
11346,3389,11346,3389,293,223,70,4,0,3,1
50761,29943,0,0,108,108,0,1,0,1,0
32958,3389,32958,3389,293,223,70,4,0,3,1
49157,33932,0,0,146,146,0,1,0,1,0
16278,20731,0,0,87,87,0,1,0,1,0
49117,32668,0,0,147,147,0,1,0,1,0
51528,31652,0,0,70,70,0,1,0,1,0
20748,3389,20748,3389,293,223,70,4,0,3,1
12266,61248,0,0,139,139,0,1,0,1,0
51684,31652,0,0,63,63,0,1,0,1,0
8087,16593,0,0,152,152,0,1,0,1,0
48928,26366,0,0,155,155,0,1,0,1,0
48467,60266,0,0,77,77,0,1,0,1,0
28209,30421,0,0,99,99,0,1,0,1,0
9874,3389,9874,3389,293,223,70,4,1,3,1
51508,31652,0,0,67,67,0,1,0,1,0
16841,3389,16841,3389,293,223,70,4,0,3,1
29706,34021,0,0,62,62,0,1,0,1,0
14864,20758,0,0,93,93,0,1,0,1,0
14877,3389,14877,3389,293,223,70,4,0,3,1
18565,7333,0,0,115,115,0,1,0,1,0
12200,61248,0,0,144,144,0,1,0,1,0
38427,3389,38427,3389,293,223,70,4,1,3,1
49160,31915,0,0,146,146,0,1,0,1,0
19117,3389,19117,3389,293,223,70,4,0,3,1
15098,14350,0,0,147,147,0,1,0,1,0
52109,5618,0,0,145,145,0,1,0,1,0
13437,3389,13437,3389,293,223,70,4,0,3,1
2163,23637,0,0,150,150,0,1,0,1,0
18234,18792,0,0,67,67,0,1,0,1,0
27828,2197,0,0,82,82,0,1,0,1,0
3810,25773,0,0,143,143,0,1,0,1,0
28849,28502,0,0,119,119,0,1,0,1,0
48093,42017,0,0,120,120,0,1,0,1,0
12317,8439,3684,1365,206,178,28,2,0,1,0
49160,32530,0,0,146,146,0,1,0,1,0
52253,33435,0,0,64,64,0,1,0,1,0
11380,61248,0,0,142,142,0,1,0,1,0
20217,29856,0,0,102,102,0,1,0,1,0
51731,31652,0,0,62,62,0,1,0,1,0
28229,29444,0,0,109,109,0,1,0,1,0
13567,3389,13567,3389,293,223,70,4,0,3,1
4306,25773,0,0,145,145,0,1,0,1,0
28865,34021,0,0,62,62,0,1,0,1,0
18236,61248,0,0,153,153,0,1,0,1,0
11688,7439,4765,1766,223,187,36,2,0,2,0
14276,3389,14276,3389,293,223,70,4,0,3,1
3287,41825,0,0,147,147,0,1,0,1,0
48936,5618,0,0,145,145,0,1,0,1,0
49087,34562,0,0,144,144,0,1,0,1,0
28350,26000,0,0,145,145,0,1,0,1,0
9952,4675,7753,2873,270,211,59,3,0,2,0
49773,31652,0,0,124,124,0,1,0,1,0
49875,28193,0,0,121,121,0,1,0,1,0
8175,61248,0,0,139,139,0,1,0,1,0
20204,3389,20204,3389,293,223,70,4,0,3,1
49160,32508,0,0,146,146,0,1,0,1,0
19704,61248,0,0,155,155,0,1,0,1,0
49968,31652,0,0,141,141,0,1,0,1,0
13249,8918,3798,1173,198,173,24,2,0,1,0
50475,29302,0,0,116,116,0,1,0,1,0
52140,32723,0,0,62,62,0,1,0,1,0
11698,60362,0,0,139,139,0,1,0,1,0
20962,3389,20962,3389,293,223,70,4,0,3,1
54495,5618,0,0,145,145,0,1,0,1,0
20131,29698,0,0,104,104,0,1,0,1,0
31344,3389,31344,3389,293,223,70,4,0,3,1
14945,25773,0,0,147,147,0,1,0,1,0
49160,33540,0,0,146,146,0,1,0,1,0
8942,25773,0,0,140,140,0,1,0,1,0
52075,33672,0,0,74,74,0,1,0,1,0
29385,23359,0,0,147,147,0,1,0,1,0
50576,32739,0,0,100,100,0,1,0,1,0
18430,61248,0,0,153,153,0,1,0,1,0
2271,46416,0,0,144,144,0,1,0,1,0
17000,19820,0,0,78,78,0,1,0,1,0
5022,24063,0,0,157,157,0,1,0,1,0
51213,18899,0,0,152,152,0,1,0,1,0
1062,21914,0,0,156,156,0,1,0,1,0
29768,33107,0,0,71,71,0,1,0,1,0
29763,34021,0,0,62,62,0,1,0,1,0
51445,31977,0,0,70,70,0,1,0,1,0
37800,7554,0,0,146,146,0,1,0,1,0
47600,5618,0,0,145,145,0,1,0,1,0
20841,3389,20841,3389,293,223,70,4,0,3,1
10276,61248,0,0,141,141,0,1,0,1,0
13780,3389,13780,3389,293,223,70,4,0,3,1
14304,11472,486,150,154,151,3,1,0,1,0
19158,3389,19158,3389,293,223,70,4,0,3,1
2573,44199,0,0,145,145,0,1,0,1,0
55138,3389,55138,3389,293,223,70,4,0,3,1
17601,61248,0,0,152,152,0,1,0,1,0
17946,3389,17946,3389,293,223,70,4,0,3,1
49258,31652,0,0,142,142,0,1,0,1,0
13334,3389,13334,3389,293,223,70,4,0,3,1
51509,31652,0,0,67,67,0,1,0,1,0
22333,28756,0,0,113,113,0,1,0,1,0
28519,26849,0,0,136,136,0,1,0,1,0
52180,5618,0,0,145,145,0,1,0,1,0
47126,7062,0,0,145,145,0,1,0,1,0
1365,22388,0,0,155,155,0,1,0,1,0
9955,25773,0,0,149,149,0,1,0,1,0
50881,32463,0,0,90,90,0,1,0,1,0
52278,34021,0,0,69,69,0,1,0,1,0
11228,25773,0,0,139,139,0,1,0,1,0
52379,33883,0,0,66,66,0,1,0,1,0
28889,28703,0,0,117,117,0,1,0,1,0
7594,25484,0,0,157,157,0,1,0,1,0
38384,7135,0,0,146,146,0,1,0,1,0
18245,18436,0,0,64,64,0,1,0,1,0
61594,31652,0,0,64,64,0,1,0,1,0
7659,55153,0,0,143,143,0,1,0,1,0
19541,61248,0,0,155,155,0,1,0,1,0
5072,50841,0,0,144,144,0,1,0,1,0
29849,33951,0,0,62,62,0,1,0,1,0
14927,3389,14927,3389,293,223,70,4,0,3,1
25586,25773,0,0,146,146,0,1,0,1,0
53174,60652,0,0,104,104,0,1,0,1,0
30217,11929,0,0,119,119,0,1,0,1,0
50712,32616,0,0,96,96,0,1,0,1,0
1823,21258,0,0,156,156,0,1,0,1,0
17023,19792,0,0,77,77,0,1,0,1,0
42271,3389,42271,3389,293,223,70,4,0,3,1
20257,3389,20257,3389,293,223,70,4,0,3,1
22822,34021,0,0,62,62,0,1,0,1,0
49938,32191,0,0,126,126,0,1,0,1,0
21279,20510,0,0,87,87,0,1,0,1,0
34065,7478,0,0,132,132,0,1,0,1,0
18065,24234,0,0,126,126,0,1,0,1,0
28272,27355,0,0,131,131,0,1,0,1,0
16666,3389,16666,3389,293,223,70,4,0,3,1
19135,61248,0,0,154,154,0,1,0,1,0
18101,23061,0,0,113,113,0,1,0,1,0
37803,7552,0,0,146,146,0,1,0,1,0
49106,30421,0,0,148,148,0,1,0,1,0
48754,60289,0,0,79,79,0,1,0,1,0
27716,25773,0,0,147,147,0,1,0,1,0
28254,28210,0,0,122,122,0,1,0,1,0
51194,33062,0,0,95,95,0,1,0,1,0
21515,3389,21515,3389,293,223,70,4,0,3,1
26972,3389,26972,3389,293,223,70,4,0,3,1
28217,30008,0,0,103,103,0,1,0,1,0
28161,2479,0,0,85,85,0,1,0,1,0
15674,3389,15674,3389,293,223,70,4,0,3,1
36555,8847,0,0,145,145,0,1,0,1,0
63718,37085,0,0,77,77,0,1,0,1,0
26982,33421,0,0,67,67,0,1,0,1,0
18192,20135,0,0,82,82,0,1,0,1,0
4687,23878,0,0,157,157,0,1,0,1,0
49027,26052,0,0,153,153,0,1,0,1,0
48925,26493,0,0,156,156,0,1,0,1,0
4958,50652,0,0,144,144,0,1,0,1,0
19939,40182,0,0,80,80,0,1,0,1,0
9398,25773,0,0,151,151,0,1,0,1,0
39660,34021,0,0,104,104,0,1,0,1,0
16361,25773,0,0,145,145,0,1,0,1,0
9998,25773,0,0,154,154,0,1,0,1,0
49084,26180,0,0,152,152,0,1,0,1,0
55205,43390,0,0,94,94,0,1,0,1,0
43048,60173,0,0,72,72,0,1,0,1,0
33236,17622,0,0,147,147,0,1,0,1,0
29215,34021,0,0,62,62,0,1,0,1,0
19723,3389,19723,3389,293,223,70,4,0,3,1
49092,30107,0,0,148,148,0,1,0,1,0
9319,25773,0,0,155,155,0,1,0,1,0
18779,18637,0,0,66,66,0,1,0,1,0
14056,23534,0,0,116,116,0,1,0,1,0
9138,25773,0,0,152,152,0,1,0,1,0
40887,34021,0,0,109,109,0,1,0,1,0
7649,55136,0,0,143,143,0,1,0,1,0
48980,34021,0,0,145,145,0,1,0,1,0
7686,61248,0,0,139,139,0,1,0,1,0
37707,3389,37707,3389,293,223,70,4,1,3,1
38155,3389,38155,3389,293,223,70,4,1,3,1
47261,54100,0,0,62,62,0,1,0,1,0
12123,3389,12123,3389,293,223,70,4,1,3,1
11265,25773,0,0,139,139,0,1,0,1,0
37467,3389,37467,3389,293,223,70,4,1,3,1
6428,23735,0,0,148,148,0,1,0,1,0
43981,7593,0,0,145,145,0,1,0,1,0
3359,25508,0,0,143,143,0,1,0,1,0
31157,3389,31157,3389,293,223,70,4,1,3,1
38984,6705,0,0,146,146,0,1,0,1,0
52030,60558,0,0,97,97,0,1,0,1,0
49072,29660,0,0,149,149,0,1,0,1,0
13891,15476,0,0,145,145,0,1,0,1,0
2062,23479,0,0,151,151,0,1,0,1,0
4927,50600,0,0,144,144,0,1,0,1,0
28286,25799,0,0,147,147,0,1,0,1,0
14037,23559,0,0,116,116,0,1,0,1,0
45950,18690,0,0,153,153,0,1,0,1,0
10980,3389,10980,3389,293,223,70,4,1,3,1
48918,26120,0,0,156,156,0,1,0,1,0
24099,34021,0,0,62,62,0,1,0,1,0
22260,33648,0,0,65,65,0,1,0,1,0
15071,3389,15071,3389,293,223,70,4,1,3,1
21109,4536,0,0,94,94,0,1,0,1,0
6904,53131,0,0,142,142,0,1,0,1,0
14187,3389,14187,3389,293,223,70,4,0,3,1
49160,31688,0,0,146,146,0,1,0,1,0
24095,31713,0,0,86,86,0,1,0,1,0
15564,27480,0,0,123,123,0,1,0,1,0
63058,3389,63058,3389,293,223,70,4,0,3,1
8939,25161,0,0,149,149,0,1,0,1,0
32051,3389,32051,3389,293,223,70,4,0,3,1
13608,3389,13608,3389,293,223,70,4,0,3,1
28511,34021,0,0,62,62,0,1,0,1,0
10887,3389,10887,3389,293,223,70,4,0,3,1
17557,19118,0,0,70,70,0,1,0,1,0
32069,19552,0,0,147,147,0,1,0,1,0
30084,3389,30084,3389,293,223,70,4,0,3,1
1588,22050,0,0,156,156,0,1,0,1,0
15748,3389,15748,3389,293,223,70,4,0,3,1
11872,61248,0,0,140,140,0,1,0,1,0
7036,54113,0,0,143,143,0,1,0,1,0
10882,3389,10882,3389,293,223,70,4,1,3,1
5540,55921,0,0,141,141,0,1,0,1,0
27969,1007,0,0,77,77,0,1,0,1,0
16201,28948,0,0,109,109,0,1,0,1,0
26444,34021,0,0,62,62,0,1,0,1,0
26847,3389,26847,3389,293,223,70,4,0,3,1
16803,20069,0,0,80,80,0,1,0,1,0
32809,15712,0,0,146,146,0,1,0,1,0
50828,3389,50828,3389,293,223,70,4,0,3,1
27294,1745,0,0,78,78,0,1,0,1,0
48909,25977,0,0,156,156,0,1,0,1,0
21991,21043,0,0,93,93,0,1,0,1,0
51656,31652,0,0,132,132,0,1,0,1,0
52633,34579,0,0,70,70,0,1,0,1,0
33566,3389,33566,3389,293,223,70,4,1,3,1
11254,61248,0,0,139,139,0,1,0,1,0
3026,22960,0,0,157,157,0,1,0,1,0
11670,3389,11670,3389,293,223,70,4,1,3,1
20709,30157,0,0,98,98,0,1,0,1,0
13754,3389,13754,3389,293,223,70,4,0,3,1
13859,12294,0,0,148,148,0,1,0,1,0
12135,61248,0,0,139,139,0,1,0,1,0
13078,3389,13078,3389,293,223,70,4,0,3,1
9382,25773,0,0,151,151,0,1,0,1,0
34926,10983,0,0,146,146,0,1,0,1,0
23226,32940,0,0,73,73,0,1,0,1,0
39803,6118,0,0,146,146,0,1,0,1,0
13916,10534,1703,526,170,159,10,1,0,1,0
12605,8898,3188,1181,198,174,24,2,0,1,0
12173,3389,12173,3389,293,223,70,4,0,3,1
26890,25773,0,0,147,147,0,1,0,1,0
28302,25890,0,0,146,146,0,1,0,1,0
14365,23145,0,0,112,112,0,1,0,1,0
17288,3389,17288,3389,293,223,70,4,0,3,1
2100,23537,0,0,150,150,0,1,0,1,0
18040,18398,0,0,63,63,0,1,0,1,0
10452,25773,0,0,139,139,0,1,0,1,0
51689,31652,0,0,63,63,0,1,0,1,0
46151,19173,0,0,153,153,0,1,0,1,0
12190,61248,0,0,139,139,0,1,0,1,0
48908,25949,0,0,156,156,0,1,0,1,0
3696,40464,0,0,148,148,0,1,0,1,0
30522,3389,30522,3389,293,223,70,4,0,3,1
49020,28471,0,0,151,151,0,1,0,1,0
35758,3389,35758,3389,293,223,70,4,1,3,1
6157,32284,0,0,153,153,0,1,0,1,0
49958,33299,0,0,120,120,0,1,0,1,0
9204,61248,0,0,140,140,0,1,0,1,0
53927,45549,0,0,145,145,0,1,0,1,0
11083,61248,0,0,139,139,0,1,0,1,0
28331,2623,0,0,86,86,0,1,0,1,0
13193,25773,0,0,143,143,0,1,0,1,0
4517,52946,0,0,142,142,0,1,0,1,0
12268,25773,0,0,139,139,0,1,0,1,0
52288,33398,0,0,66,66,0,1,0,1,0
9858,61248,0,0,141,141,0,1,0,1,0
50637,32684,0,0,98,98,0,1,0,1,0
53033,33930,0,0,62,62,0,1,0,1,0
21042,16770,0,0,75,75,0,1,0,1,0
50613,34021,0,0,110,110,0,1,0,1,0
8250,23520,0,0,151,151,0,1,0,1,0
15772,25773,0,0,141,141,0,1,0,1,0
18206,19705,0,0,77,77,0,1,0,1,0
18142,3389,18142,3389,293,223,70,4,0,3,1
42167,60218,0,0,76,76,0,1,0,1,0
17935,58027,0,0,156,156,0,1,0,1,0
17952,17736,0,0,68,68,0,1,0,1,0
54312,60746,0,0,110,110,0,1,0,1,0
51588,31652,0,0,65,65,0,1,0,1,0
13632,3389,13632,3389,293,223,70,4,0,3,1
50117,31652,0,0,115,115,0,1,0,1,0
28915,28831,0,0,116,116,0,1,0,1,0
1854,22312,0,0,157,157,0,1,0,1,0
40099,60325,0,0,85,85,0,1,0,1,0
13395,3389,13395,3389,293,223,70,4,0,3,1
17797,3389,17797,3389,293,223,70,4,0,3,1
12282,22677,0,0,117,117,0,1,0,1,0
43493,34021,0,0,121,121,0,1,0,1,0
7285,53706,0,0,141,141,0,1,0,1,0
20093,3389,20093,3389,293,223,70,4,0,3,1
50308,29272,0,0,106,106,0,1,0,1,0
35479,3389,35479,3389,293,223,70,4,0,3,1
21694,32597,0,0,75,75,0,1,0,1,0
29441,31467,0,0,88,88,0,1,0,1,0
3810,50892,0,0,143,143,0,1,0,1,0
28274,27258,0,0,132,132,0,1,0,1,0
42250,3389,42250,3389,293,223,70,4,0,3,1
7732,23622,0,0,119,119,0,1,0,1,0
54930,5744,0,0,145,145,0,1,0,1,0
15107,3389,15107,3389,293,223,70,4,0,3,1
38550,3389,38550,3389,293,223,70,4,1,3,1
6298,25773,0,0,151,151,0,1,0,1,0
6622,25773,0,0,141,141,0,1,0,1,0
14320,11626,239,88,151,149,1,1,0,1,0
7896,25773,0,0,156,156,0,1,0,1,0
10224,3389,10224,3389,293,223,70,4,1,3,1
49259,31652,0,0,142,142,0,1,0,1,0
27095,34021,0,0,62,62,0,1,0,1,0
27964,3389,27964,3389,293,223,70,4,0,3,1
14592,61248,0,0,148,148,0,1,0,1,0
15202,27291,0,0,124,124,0,1,0,1,0
15251,3389,15251,3389,293,223,70,4,0,3,1
35944,8950,0,0,145,145,0,1,0,1,0
24029,3389,24029,3389,293,223,70,4,0,3,1
9442,3389,9442,3389,293,223,70,4,1,3,1
49044,30306,0,0,150,150,0,1,0,1,0
18068,3389,18068,3389,293,223,70,4,0,3,1
14643,3389,14643,3389,293,223,70,4,0,3,1
48587,34021,0,0,143,143,0,1,0,1,0
18047,24799,0,0,132,132,0,1,0,1,0
37783,3389,37783,3389,293,223,70,4,1,3,1
15854,3389,15854,3389,293,223,70,4,0,3,1
16207,19760,0,0,81,81,0,1,0,1,0
9652,3389,9652,3389,293,223,70,4,1,3,1
23743,25773,0,0,145,145,0,1,0,1,0
41686,34021,0,0,113,113,0,1,0,1,0
9297,3389,9297,3389,293,223,70,4,0,3,1
14048,10853,1289,398,165,156,8,1,0,1,0
59454,57898,0,0,134,134,0,1,0,1,0
9820,3389,9820,3389,293,223,70,4,0,3,1
3836,25773,0,0,143,143,0,1,0,1,0
59089,31652,0,0,62,62,0,1,0,1,0
32584,3389,32584,3389,293,223,70,4,0,3,1
49148,31400,0,0,146,146,0,1,0,1,0
52025,32381,0,0,62,62,0,1,0,1,0
25757,34021,0,0,62,62,0,1,0,1,0
27323,34021,0,0,62,62,0,1,0,1,0
11896,53083,0,0,115,115,0,1,0,1,0
19226,26758,0,0,133,133,0,1,0,1,0
6295,25773,0,0,151,151,0,1,0,1,0
35068,60583,0,0,105,105,0,1,0,1,0
18753,26373,0,0,137,137,0,1,0,1,0
12515,3389,12515,3389,293,223,70,4,1,3,1
18130,22141,0,0,103,103,0,1,0,1,0
10618,3389,10618,3389,293,223,70,4,1,3,1
22816,34021,0,0,62,62,0,1,0,1,0
51737,5618,0,0,145,145,0,1,0,1,0
12973,3389,12973,3389,293,223,70,4,0,3,1
18242,18536,0,0,65,65,0,1,0,1,0
17861,3389,17861,3389,293,223,70,4,0,3,1
49706,27772,0,0,128,128,0,1,0,1,0
15651,21522,0,0,95,95,0,1,0,1,0
10993,3389,10993,3389,293,223,70,4,0,3,1
11343,3389,11343,3389,293,223,70,4,1,3,1
7760,55321,0,0,143,143,0,1,0,1,0
56508,47667,0,0,103,103,0,1,0,1,0
52401,5618,0,0,145,145,0,1,0,1,0
28275,27185,0,0,133,133,0,1,0,1,0
14942,3389,14942,3389,293,223,70,4,0,3,1
13144,25773,0,0,139,139,0,1,0,1,0
12733,22342,0,0,113,113,0,1,0,1,0
35561,3389,35561,3389,293,223,70,4,0,3,1
20008,40013,0,0,79,79,0,1,0,1,0
10822,61248,0,0,139,139,0,1,0,1,0
49232,33955,0,0,143,143,0,1,0,1,0
10560,25773,0,0,153,153,0,1,0,1,0
38840,5007,0,0,136,136,0,1,0,1,0
9251,61248,0,0,140,140,0,1,0,1,0
12087,22822,0,0,119,119,0,1,0,1,0
23148,34021,0,0,62,62,0,1,0,1,0
51851,31867,0,0,62,62,0,1,0,1,0
56271,31652,0,0,106,106,0,1,0,1,0
15620,19587,0,0,76,76,0,1,0,1,0
16037,61248,0,0,146,146,0,1,0,1,0
10509,3389,10509,3389,293,223,70,4,1,3,1
20221,61248,0,0,156,156,0,1,0,1,0
48202,39481,0,0,122,122,0,1,0,1,0
53663,60693,0,0,106,106,0,1,0,1,0
24513,34021,0,0,62,62,0,1,0,1,0
21256,3389,21256,3389,293,223,70,4,0,3,1
18967,3389,18967,3389,293,223,70,4,0,3,1
5408,22865,0,0,153,153,0,1,0,1,0
14735,12314,0,0,141,141,0,1,0,1,0
51720,31652,0,0,63,63,0,1,0,1,0
57978,3389,57978,3389,293,223,70,4,0,3,1
12696,61248,0,0,145,145,0,1,0,1,0
49786,27972,0,0,125,125,0,1,0,1,0
16415,15145,0,0,103,103,0,1,0,1,0
23292,25773,0,0,145,145,0,1,0,1,0
27487,26926,0,0,135,135,0,1,0,1,0
49358,26704,0,0,141,141,0,1,0,1,0
11625,3389,11625,3389,293,223,70,4,0,3,1
16208,3389,16208,3389,293,223,70,4,0,3,1
29702,32776,0,0,74,74,0,1,0,1,0
43461,12720,0,0,149,149,0,1,0,1,0
52458,33938,0,0,64,64,0,1,0,1,0
52088,33138,0,0,65,65,0,1,0,1,0
1415,21990,0,0,156,156,0,1,0,1,0
51844,32697,0,0,67,67,0,1,0,1,0
20209,3389,20209,3389,293,223,70,4,0,3,1
30725,21772,0,0,147,147,0,1,0,1,0
3002,33046,0,0,143,143,0,1,0,1,0
3273,41871,0,0,147,147,0,1,0,1,0
13121,20409,0,0,142,142,0,1,0,1,0
28386,26181,0,0,143,143,0,1,0,1,0
36669,4208,0,0,124,124,0,1,0,1,0
13555,10409,1554,576,172,160,11,1,0,1,0
4159,25450,0,0,139,139,0,1,0,1,0
17847,17559,0,0,71,71,0,1,0,1,0
29327,30895,0,0,94,94,0,1,0,1,0
9820,25773,0,0,149,149,0,1,0,1,0
11321,4248,9852,3044,278,215,62,3,0,2,0
13268,8963,3740,1155,197,173,23,2,0,1,0
16281,3389,16281,3389,293,223,70,4,0,3,1
28895,34021,0,0,62,62,0,1,0,1,0
24800,104,333,103,69,66,2,1,0,1,0
51943,32875,0,0,66,66,0,1,0,1,0
13878,3389,13878,3389,293,223,70,4,0,3,1
50063,31652,0,0,114,114,0,1,0,1,0
5381,51356,0,0,144,144,0,1,0,1,0
18666,3389,18666,3389,293,223,70,4,0,3,1
13931,61248,0,0,142,142,0,1,0,1,0
12729,61248,0,0,139,139,0,1,0,1,0
4478,49472,0,0,143,143,0,1,0,1,0
38732,3389,38732,3389,293,223,70,4,0,3,1
11152,3389,11152,3389,293,223,70,4,0,3,1
5399,51386,0,0,144,144,0,1,0,1,0
50749,60453,0,0,90,90,0,1,0,1,0
3206,47732,0,0,144,144,0,1,0,1,0
41829,3389,41829,3389,293,223,70,4,0,3,1
49534,27064,0,0,136,136,0,1,0,1,0
49419,26931,0,0,143,143,0,1,0,1,0
18112,1911,7106,1910,192,152,39,2,0,2,0
10030,3389,10030,3389,293,223,70,4,1,3,1
37380,10773,0,0,146,146,0,1,0,1,0
26800,24646,0,0,135,135,0,1,0,1,0
8584,61248,0,0,140,140,0,1,0,1,0
42867,3389,42867,3389,293,223,70,4,0,3,1
18696,61248,0,0,153,153,0,1,0,1,0
13280,25773,0,0,149,149,0,1,0,1,0
15707,3389,15707,3389,293,223,70,4,0,3,1
24083,31912,0,0,81,81,0,1,0,1,0
4246,52158,0,0,142,142,0,1,0,1,0
52188,33147,0,0,72,72,0,1,0,1,0
8559,25773,0,0,155,155,0,1,0,1,0
16297,3389,16297,3389,293,223,70,4,0,3,1
21155,3389,21155,3389,293,223,70,4,0,3,1
3817,50910,0,0,143,143,0,1,0,1,0
17543,25773,0,0,142,142,0,1,0,1,0
12702,25991,0,0,136,136,0,1,0,1,0
22748,3389,22748,3389,293,223,70,4,0,3,1
18700,25773,0,0,143,143,0,1,0,1,0
12958,57237,0,0,131,131,0,1,0,1,0
19110,3389,19110,3389,293,223,70,4,0,3,1
17567,25773,0,0,142,142,0,1,0,1,0
28647,27488,0,0,130,130,0,1,0,1,0
16460,3389,16460,3389,293,223,70,4,0,3,1
7431,25773,0,0,154,154,0,1,0,1,0
9782,3389,9782,3389,293,223,70,4,1,3,1
51380,31652,0,0,69,69,0,1,0,1,0
14535,22931,0,0,109,109,0,1,0,1,0
24903,14733,0,0,93,93,0,1,0,1,0
6449,53137,0,0,144,144,0,1,0,1,0
55773,60866,0,0,118,118,0,1,0,1,0
35034,3389,35034,3389,293,223,70,4,0,3,1
27031,27571,0,0,129,129,0,1,0,1,0
56670,48407,0,0,108,108,0,1,0,1,0
2711,37076,0,0,144,144,0,1,0,1,0
41777,3389,41777,3389,293,223,70,4,0,3,1
10849,3389,10849,3389,293,223,70,4,1,3,1
1245,21931,0,0,156,156,0,1,0,1,0
49284,34021,0,0,142,142,0,1,0,1,0
28475,26629,0,0,139,139,0,1,0,1,0
21972,61248,0,0,158,158,0,1,0,1,0
5121,25773,0,0,142,142,0,1,0,1,0
2959,47320,0,0,144,144,0,1,0,1,0
24268,31470,0,0,88,88,0,1,0,1,0
16161,25773,0,0,141,141,0,1,0,1,0
17680,28581,0,0,112,112,0,1,0,1,0
51545,31652,0,0,66,66,0,1,0,1,0
9096,61248,0,0,139,139,0,1,0,1,0
36973,8148,0,0,146,146,0,1,0,1,0
17877,25773,0,0,142,142,0,1,0,1,0
50603,31652,0,0,95,95,0,1,0,1,0
39024,60380,0,0,89,89,0,1,0,1,0
26855,3389,26855,3389,293,223,70,4,0,3,1
31060,2144,0,0,94,94,0,1,0,1,0
17609,3389,17609,3389,293,223,70,4,0,3,1
23540,32497,0,0,77,77,0,1,0,1,0
23232,3389,23232,3389,293,223,70,4,0,3,1
18836,3389,18836,3389,293,223,70,4,0,3,1
11777,61248,0,0,141,141,0,1,0,1,0
48338,3389,48338,3389,293,223,70,4,0,3,1
14732,27758,0,0,120,120,0,1,0,1,0
7397,54716,0,0,143,143,0,1,0,1,0
29152,30021,0,0,103,103,0,1,0,1,0
17014,3389,17014,3389,293,223,70,4,0,3,1
18109,3389,18109,3389,293,223,70,4,0,3,1
50838,31652,0,0,86,86,0,1,0,1,0
61443,32119,0,0,78,78,0,1,0,1,0
11030,23607,0,0,129,129,0,1,0,1,0
17319,3389,17319,3389,293,223,70,4,0,3,1
16701,3389,16701,3389,293,223,70,4,0,3,1
13586,61248,0,0,147,147,0,1,0,1,0
21874,35452,0,0,66,66,0,1,0,1,0
18710,25773,0,0,143,143,0,1,0,1,0
26162,34021,0,0,62,62,0,1,0,1,0
3298,28966,0,0,143,143,0,1,0,1,0
26824,32953,0,0,72,72,0,1,0,1,0
48931,26428,0,0,155,155,0,1,0,1,0
14644,61248,0,0,148,148,0,1,0,1,0
11106,3389,11106,3389,293,223,70,4,1,3,1
58119,53372,0,0,122,122,0,1,0,1,0
16785,3389,16785,3389,293,223,70,4,0,3,1
24630,34021,0,0,62,62,0,1,0,1,0
39835,6094,0,0,146,146,0,1,0,1,0
47169,48948,0,0,97,97,0,1,0,1,0
8044,25773,0,0,156,156,0,1,0,1,0
25470,29773,0,0,106,106,0,1,0,1,0
54429,40450,0,0,81,81,0,1,0,1,0
3649,40620,0,0,148,148,0,1,0,1,0
26597,25773,0,0,147,147,0,1,0,1,0
49001,28020,0,0,152,152,0,1,0,1,0
11986,25773,0,0,140,140,0,1,0,1,0
48969,27923,0,0,154,154,0,1,0,1,0
4433,25773,0,0,142,142,0,1,0,1,0
51644,31925,0,0,86,86,0,1,0,1,0
38782,4985,0,0,136,136,0,1,0,1,0
16479,3389,16479,3389,293,223,70,4,0,3,1
49029,28660,0,0,151,151,0,1,0,1,0
12992,3389,12992,3389,293,223,70,4,0,3,1
16605,3389,16605,3389,293,223,70,4,0,3,1
10741,25773,0,0,153,153,0,1,0,1,0
15470,2620,9743,2619,240,186,54,3,0,2,0
13653,9896,2529,781,181,165,16,1,0,1,0
50467,37183,0,0,145,145,0,1,0,1,0
6606,17696,0,0,153,153,0,1,0,1,0
34858,3542,0,0,114,114,0,1,0,1,0
18228,19007,0,0,70,70,0,1,0,1,0
29237,34021,0,0,62,62,0,1,0,1,0
7652,61248,0,0,139,139,0,1,0,1,0
21179,3389,21179,3389,293,223,70,4,0,3,1
4527,25773,0,0,146,146,0,1,0,1,0
50656,32337,0,0,93,93,0,1,0,1,0
27297,1748,0,0,78,78,0,1,0,1,0
7417,25773,0,0,154,154,0,1,0,1,0
13057,9616,2411,893,186,167,18,1,0,1,0
2701,24479,0,0,147,147,0,1,0,1,0
50400,32899,0,0,106,106,0,1,0,1,0
9869,3389,9869,3389,293,223,70,4,1,3,1
11457,3389,11457,3389,293,223,70,4,0,3,1
47186,3389,47186,3389,293,223,70,4,0,3,1
15046,25773,0,0,147,147,0,1,0,1,0
49160,32963,0,0,146,146,0,1,0,1,0
13738,24786,0,0,146,146,0,1,0,1,0
17231,3389,17231,3389,293,223,70,4,0,3,1
28252,28325,0,0,121,121,0,1,0,1,0
9699,61248,0,0,139,139,0,1,0,1,0
37935,3389,37935,3389,293,223,70,4,1,3,1
10555,61248,0,0,142,142,0,1,0,1,0
16345,3389,16345,3389,293,223,70,4,0,3,1
57385,50857,0,0,115,115,0,1,0,1,0
53906,31652,0,0,69,69,0,1,0,1,0
51406,5618,0,0,145,145,0,1,0,1,0
6106,51927,0,0,142,142,0,1,0,1,0
42055,3389,42055,3389,293,223,70,4,0,3,1
28178,31922,0,0,83,83,0,1,0,1,0
48988,25965,0,0,154,154,0,1,0,1,0
49160,33111,0,0,146,146,0,1,0,1,0
12283,61245,0,0,139,139,0,1,0,1,0
3297,41792,0,0,147,147,0,1,0,1,0
17065,16241,0,0,88,88,0,1,0,1,0
18076,28787,0,0,110,110,0,1,0,1,0
17380,16773,0,0,81,81,0,1,0,1,0
28123,34011,0,0,62,62,0,1,0,1,0
53824,3389,53824,3389,293,223,70,4,0,3,1
2737,47770,0,0,144,144,0,1,0,1,0
1517,22025,0,0,156,156,0,1,0,1,0
19755,3389,19755,3389,293,223,70,4,0,3,1
49875,6597,0,0,145,145,0,1,0,1,0
37618,3389,37618,3389,293,223,70,4,1,3,1
31342,3389,31342,3389,293,223,70,4,0,3,1
57549,5117,14369,760,178,162,15,1,0,1,0
19587,3389,19587,3389,293,223,70,4,0,3,1
12611,25358,0,0,134,134,0,1,0,1,0
7451,25773,0,0,154,154,0,1,0,1,0
23321,29438,0,0,106,106,0,1,0,1,0
11121,61248,0,0,139,139,0,1,0,1,0
20536,30449,0,0,97,97,0,1,0,1,0
13311,3389,13311,3389,293,223,70,4,0,3,1
11882,61248,0,0,143,143,0,1,0,1,0
57231,50180,0,0,111,111,0,1,0,1,0
3791,25773,0,0,143,143,0,1,0,1,0
49275,46493,0,0,62,62,0,1,0,1,0
19381,3389,19381,3389,293,223,70,4,0,3,1
8073,55843,0,0,143,143,0,1,0,1,0
50967,19631,0,0,153,153,0,1,0,1,0
25433,61078,0,0,145,145,0,1,0,1,0
12062,6043,7526,2325,247,199,48,3,0,2,0
51259,34021,0,0,94,94,0,1,0,1,0
7756,25574,0,0,157,157,0,1,0,1,0
18086,23543,0,0,119,119,0,1,0,1,0
18279,3389,18279,3389,293,223,70,4,0,3,1
10567,25773,0,0,146,146,0,1,0,1,0
13239,3389,13239,3389,293,223,70,4,0,3,1
17868,17596,0,0,70,70,0,1,0,1,0
13145,9756,2260,837,183,166,17,1,0,1,0
8861,61248,0,0,140,140,0,1,0,1,0
15775,3389,15775,3389,293,223,70,4,0,3,1
61943,31652,0,0,63,63,0,1,0,1,0
18244,18489,0,0,64,64,0,1,0,1,0
11881,7745,4434,1643,218,184,33,2,0,1,0
17279,25602,0,0,143,143,0,1,0,1,0
50123,31652,0,0,112,112,0,1,0,1,0
50565,31652,0,0,100,100,0,1,0,1,0
49160,33000,0,0,146,146,0,1,0,1,0
15934,3389,15934,3389,293,223,70,4,0,3,1
16470,3389,16470,3389,293,223,70,4,0,3,1
14616,3389,14616,3389,293,223,70,4,0,3,1
21288,3389,21288,3389,293,223,70,4,0,3,1
38996,6696,0,0,146,146,0,1,0,1,0
14803,2477,8017,2477,230,179,51,3,0,2,0
18116,61248,0,0,150,150,0,1,0,1,0
59735,31652,0,0,65,65,0,1,0,1,0
23902,1464,0,0,72,72,0,1,0,1,0
49517,27302,0,0,134,134,0,1,0,1,0
51800,32617,0,0,67,67,0,1,0,1,0
52059,34021,0,0,74,74,0,1,0,1,0
49108,60318,0,0,81,81,0,1,0,1,0
5089,35833,0,0,150,150,0,1,0,1,0
32262,3389,32262,3389,293,223,70,4,0,3,1
49077,31372,0,0,149,149,0,1,0,1,0
50035,28087,0,0,119,119,0,1,0,1,0
23527,34021,0,0,62,62,0,1,0,1,0
15171,3389,15171,3389,293,223,70,4,0,3,1
19370,3389,19370,3389,293,223,70,4,0,3,1
5675,25773,0,0,142,142,0,1,0,1,0
34064,7477,0,0,132,132,0,1,0,1,0
51338,34021,0,0,92,92,0,1,0,1,0
47627,45514,0,0,108,108,0,1,0,1,0
18061,25773,0,0,143,143,0,1,0,1,0
28247,28545,0,0,119,119,0,1,0,1,0
52567,34021,0,0,62,62,0,1,0,1,0
18233,3389,18233,3389,293,223,70,4,0,3,1
23341,32778,0,0,74,74,0,1,0,1,0
13796,24799,0,0,146,146,0,1,0,1,0
28915,28830,0,0,116,116,0,1,0,1,0
2786,47913,0,0,144,144,0,1,0,1,0
18690,29106,0,0,107,107,0,1,0,1,0
8285,55215,0,0,141,141,0,1,0,1,0
7983,54759,0,0,141,141,0,1,0,1,0
15119,3389,15119,3389,293,223,70,4,0,3,1
8887,61248,0,0,140,140,0,1,0,1,0
49118,30708,0,0,147,147,0,1,0,1,0
24739,34021,0,0,62,62,0,1,0,1,0
14790,3389,14790,3389,293,223,70,4,0,3,1
52167,32803,0,0,62,62,0,1,0,1,0
26156,32408,0,0,77,77,0,1,0,1,0
24675,23054,0,0,116,116,0,1,0,1,0
14587,3389,14587,3389,293,223,70,4,0,3,1
3278,29240,0,0,143,143,0,1,0,1,0
2749,36550,0,0,144,144,0,1,0,1,0
20303,3389,20303,3389,293,223,70,4,0,3,1
49303,31652,0,0,140,140,0,1,0,1,0
14338,11656,207,76,151,149,1,1,0,1,0
13647,12452,0,0,148,148,0,1,0,1,0
5551,24738,0,0,131,131,0,1,0,1,0
14839,25773,0,0,147,147,0,1,0,1,0
51932,32108,0,0,62,62,0,1,0,1,0
35441,3756,0,0,118,118,0,1,0,1,0
37770,3389,37770,3389,293,223,70,4,1,3,1
9528,57090,0,0,140,140,0,1,0,1,0
21308,31882,0,0,83,83,0,1,0,1,0
49160,32453,0,0,146,146,0,1,0,1,0
51026,30114,0,0,86,86,0,1,0,1,0
2668,22762,0,0,157,157,0,1,0,1,0
63289,3582,58450,3094,280,216,63,3,0,2,0
13969,11068,842,312,161,154,6,1,0,1,0
49083,29903,0,0,149,149,0,1,0,1,0
29314,3389,29314,3389,293,223,70,4,0,3,1
12687,3389,12687,3389,293,223,70,4,0,3,1
51702,31652,0,0,63,63,0,1,0,1,0
1626,22796,0,0,153,153,0,1,0,1,0
41669,7983,0,0,145,145,0,1,0,1,0
49160,32084,0,0,146,146,0,1,0,1,0
2615,24344,0,0,148,148,0,1,0,1,0
18095,23273,0,0,116,116,0,1,0,1,0
49056,30692,0,0,150,150,0,1,0,1,0
15181,22115,0,0,101,101,0,1,0,1,0
12405,25618,0,0,137,137,0,1,0,1,0
37969,9800,0,0,146,146,0,1,0,1,0
16037,3389,16037,3389,293,223,70,4,0,3,1
10969,61248,0,0,143,143,0,1,0,1,0
2806,24642,0,0,147,147,0,1,0,1,0
15388,3389,15388,3389,293,223,70,4,0,3,1
3106,25111,0,0,145,145,0,1,0,1,0
29331,30917,0,0,94,94,0,1,0,1,0
22603,34021,0,0,62,62,0,1,0,1,0
49971,27957,0,0,121,121,0,1,0,1,0
44010,7588,0,0,145,145,0,1,0,1,0
14553,3389,14553,3389,293,223,70,4,0,3,1
51463,31652,0,0,68,68,0,1,0,1,0
46703,56208,0,0,62,62,0,1,0,1,0
49065,26137,0,0,152,152,0,1,0,1,0
40068,5927,0,0,146,146,0,1,0,1,0
49539,31652,0,0,132,132,0,1,0,1,0
56375,31652,0,0,62,62,0,1,0,1,0
13448,3389,13448,3389,293,223,70,4,0,3,1
51316,31652,0,0,70,70,0,1,0,1,0
7976,25696,0,0,157,157,0,1,0,1,0
55291,8199,0,0,136,136,0,1,0,1,0
54148,31652,0,0,62,62,0,1,0,1,0
49105,32275,0,0,148,148,0,1,0,1,0
15390,27390,0,0,123,123,0,1,0,1,0
18257,26219,0,0,138,138,0,1,0,1,0
30829,4738,0,0,106,106,0,1,0,1,0
13447,20699,0,0,88,88,0,1,0,1,0
49504,31652,0,0,133,133,0,1,0,1,0
25046,30372,0,0,100,100,0,1,0,1,0
12113,61248,0,0,139,139,0,1,0,1,0
49128,33024,0,0,147,147,0,1,0,1,0
21280,3389,21280,3389,293,223,70,4,0,3,1
63763,3389,63763,3389,293,223,70,4,0,3,1
19185,3389,19185,3389,293,223,70,4,0,3,1
18815,3389,18815,3389,293,223,70,4,0,3,1
50240,31652,0,0,111,111,0,1,0,1,0
26236,849,0,0,69,69,0,1,0,1,0
37152,8019,0,0,146,146,0,1,0,1,0
2872,43206,0,0,146,146,0,1,0,1,0
13099,61248,0,0,140,140,0,1,0,1,0
29664,3389,29664,3389,293,223,70,4,0,3,1
54545,12301,0,0,126,126,0,1,0,1,0
51931,3389,51931,3389,293,223,70,4,0,3,1
4638,25773,0,0,142,142,0,1,0,1,0
17426,3389,17426,3389,293,223,70,4,0,3,1
13280,24680,0,0,146,146,0,1,0,1,0
17869,25196,0,0,143,143,0,1,0,1,0
10058,61248,0,0,139,139,0,1,0,1,0
51185,34021,0,0,96,96,0,1,0,1,0
15351,3389,15351,3389,293,223,70,4,0,3,1
2588,38781,0,0,144,144,0,1,0,1,0
18339,3389,18339,3389,293,223,70,4,0,3,1
17567,3389,17567,3389,293,223,70,4,0,3,1
11583,3389,11583,3389,293,223,70,4,0,3,1
13429,25773,0,0,149,149,0,1,0,1,0
21506,61248,0,0,158,158,0,1,0,1,0
10434,3389,10434,3389,293,223,70,4,0,3,1
13453,61248,0,0,146,146,0,1,0,1,0
22494,61229,0,0,157,157,0,1,0,1,0
49432,31652,0,0,137,137,0,1,0,1,0
28265,27712,0,0,127,127,0,1,0,1,0
51367,31303,0,0,93,93,0,1,0,1,0
51468,31018,0,0,72,72,0,1,0,1,0
5513,24758,0,0,132,132,0,1,0,1,0
52271,33468,0,0,64,64,0,1,0,1,0
36916,3389,36916,3389,293,223,70,4,0,3,1
18355,3389,18355,3389,293,223,70,4,0,3,1
40724,3389,40724,3389,293,223,70,4,0,3,1
51898,32005,0,0,62,62,0,1,0,1,0
37310,7906,0,0,146,146,0,1,0,1,0
3974,25773,0,0,144,144,0,1,0,1,0
19267,3389,19267,3389,293,223,70,4,0,3,1
50792,32544,0,0,93,93,0,1,0,1,0
11142,3389,11142,3389,293,223,70,4,1,3,1
15478,25187,0,0,145,145,0,1,0,1,0
11699,25773,0,0,141,141,0,1,0,1,0
18176,20664,0,0,88,88,0,1,0,1,0
8185,61248,0,0,139,139,0,1,0,1,0
56938,49160,0,0,108,108,0,1,0,1,0
13291,9019,3667,1133,196,173,23,2,0,1,0
49230,26507,0,0,148,148,0,1,0,1,0
49031,29885,0,0,151,151,0,1,0,1,0
29513,34021,0,0,62,62,0,1,0,1,0
14840,52640,0,0,117,117,0,1,0,1,0
51725,3389,51725,3389,293,223,70,4,0,3,1
7826,25773,0,0,156,156,0,1,0,1,0
49310,26786,0,0,142,142,0,1,0,1,0
24693,34021,0,0,62,62,0,1,0,1,0
52368,33398,0,0,62,62,0,1,0,1,0
35186,3389,35186,3389,293,223,70,4,0,3,1
4332,23682,0,0,157,157,0,1,0,1,0
11149,3389,11149,3389,293,223,70,4,1,3,1
10717,3389,10717,3389,293,223,70,4,1,3,1
28537,26938,0,0,135,135,0,1,0,1,0
18613,3389,18613,3389,293,223,70,4,0,3,1
18132,25853,0,0,142,142,0,1,0,1,0
1378,22408,0,0,155,155,0,1,0,1,0
12533,51933,0,0,112,112,0,1,0,1,0
51915,3389,51915,3389,293,223,70,4,0,3,1
17863,18732,0,0,67,67,0,1,0,1,0
22194,25773,0,0,145,145,0,1,0,1,0
49951,31652,0,0,118,118,0,1,0,1,0
50500,32808,0,0,103,103,0,1,0,1,0
51188,30902,0,0,97,97,0,1,0,1,0
8599,24490,0,0,144,144,0,1,0,1,0
15000,3389,15000,3389,293,223,70,4,0,3,1
35761,34021,0,0,87,87,0,1,0,1,0
31140,3389,31140,3389,293,223,70,4,0,3,1
11654,61248,0,0,141,141,0,1,0,1,0
18595,25773,0,0,143,143,0,1,0,1,0
43697,3389,43697,3389,293,223,70,4,0,3,1
51268,33113,0,0,94,94,0,1,0,1,0
11320,61248,0,0,142,142,0,1,0,1,0
59437,32653,0,0,62,62,0,1,0,1,0
19610,3389,19610,3389,293,223,70,4,0,3,1
32124,2536,0,0,99,99,0,1,0,1,0
49284,31738,0,0,142,142,0,1,0,1,0
9324,3389,9324,3389,293,223,70,4,1,3,1
57256,50415,0,0,114,114,0,1,0,1,0
49378,26744,0,0,141,141,0,1,0,1,0
7903,25773,0,0,156,156,0,1,0,1,0
38736,6883,0,0,146,146,0,1,0,1,0
12649,3389,12649,3389,293,223,70,4,1,3,1
28627,27388,0,0,131,131,0,1,0,1,0
56308,60910,0,0,121,121,0,1,0,1,0
23683,3389,23683,3389,293,223,70,4,0,3,1
25851,3389,25851,3389,293,223,70,4,0,3,1
54395,5834,0,0,145,145,0,1,0,1,0
48927,26561,0,0,155,155,0,1,0,1,0
43520,12863,0,0,149,149,0,1,0,1,0
37203,3389,37203,3389,293,223,70,4,1,3,1
10814,3389,10814,3389,293,223,70,4,0,3,1
61490,53401,0,0,122,122,0,1,0,1,0
24911,3389,24911,3389,293,223,70,4,0,3,1
35419,3748,0,0,118,118,0,1,0,1,0
19182,18939,0,0,69,69,0,1,0,1,0
20372,3389,20372,3389,293,223,70,4,0,3,1
5989,25773,0,0,150,150,0,1,0,1,0
51973,32931,0,0,66,66,0,1,0,1,0
21113,3389,21113,3389,293,223,70,4,0,3,1
9834,25773,0,0,154,154,0,1,0,1,0
49435,33771,0,0,137,137,0,1,0,1,0
6080,23020,0,0,152,152,0,1,0,1,0
19440,3389,19440,3389,293,223,70,4,0,3,1
48189,41295,0,0,122,122,0,1,0,1,0
4914,23208,0,0,150,150,0,1,0,1,0
18113,3389,18113,3389,293,223,70,4,0,3,1
21561,3389,21561,3389,293,223,70,4,0,3,1
28266,27631,0,0,128,128,0,1,0,1,0
28010,2351,0,0,84,84,0,1,0,1,0
18912,27434,0,0,126,126,0,1,0,1,0
49894,28240,0,0,121,121,0,1,0,1,0
10401,3389,10401,3389,293,223,70,4,0,3,1
15126,14460,0,0,147,147,0,1,0,1,0
20856,38314,0,0,74,74,0,1,0,1,0
25876,23953,0,0,127,127,0,1,0,1,0
35529,3389,35529,3389,293,223,70,4,0,3,1
12489,3389,12489,3389,293,223,70,4,1,3,1
12544,3389,12544,3389,293,223,70,4,1,3,1
9969,61248,0,0,142,142,0,1,0,1,0
2463,46974,0,0,144,144,0,1,0,1,0
51703,31652,0,0,63,63,0,1,0,1,0
14087,25773,0,0,148,148,0,1,0,1,0
21678,61248,0,0,158,158,0,1,0,1,0
49854,27718,0,0,125,125,0,1,0,1,0
19089,3389,19089,3389,293,223,70,4,0,3,1
50201,33078,0,0,112,112,0,1,0,1,0
11137,25773,0,0,143,143,0,1,0,1,0
25695,29455,0,0,109,109,0,1,0,1,0
49318,26706,0,0,146,146,0,1,0,1,0
16199,3389,16199,3389,293,223,70,4,0,3,1
46132,19126,0,0,153,153,0,1,0,1,0
20790,3389,20790,3389,293,223,70,4,0,3,1
28219,29942,0,0,104,104,0,1,0,1,0
16831,15847,0,0,94,94,0,1,0,1,0
13253,25773,0,0,143,143,0,1,0,1,0
6554,25773,0,0,152,152,0,1,0,1,0
20094,3389,20094,3389,293,223,70,4,0,3,1
6754,53644,0,0,143,143,0,1,0,1,0
38155,7299,0,0,146,146,0,1,0,1,0
20491,61248,0,0,156,156,0,1,0,1,0
27079,34021,0,0,62,62,0,1,0,1,0
51656,31652,0,0,64,64,0,1,0,1,0
17370,3389,17370,3389,293,223,70,4,0,3,1
26675,1221,0,0,73,73,0,1,0,1,0
36743,3389,36743,3389,293,223,70,4,0,3,1
12770,3389,12770,3389,293,223,70,4,0,3,1
35132,8381,0,0,140,140,0,1,0,1,0
36667,3389,36667,3389,293,223,70,4,0,3,1
17218,3389,17218,3389,293,223,70,4,0,3,1
22610,34021,0,0,62,62,0,1,0,1,0
48998,28832,0,0,152,152,0,1,0,1,0
27733,34021,0,0,62,62,0,1,0,1,0
3434,25625,0,0,143,143,0,1,0,1,0
61008,4192,40937,2167,239,194,44,2,0,2,0
12668,3389,12668,3389,293,223,70,4,0,3,1
34032,60636,0,0,109,109,0,1,0,1,0
29975,1745,0,0,88,88,0,1,0,1,0
49047,30422,0,0,150,150,0,1,0,1,0
19942,40760,0,0,81,81,0,1,0,1,0
11660,25773,0,0,143,143,0,1,0,1,0
50187,28398,0,0,114,114,0,1,0,1,0
22675,34021,0,0,62,62,0,1,0,1,0
6366,52319,0,0,142,142,0,1,0,1,0
28360,34021,0,0,62,62,0,1,0,1,0
5565,25773,0,0,142,142,0,1,0,1,0
25836,3389,25836,3389,293,223,70,4,0,3,1
27924,26309,0,0,142,142,0,1,0,1,0
8876,61248,0,0,139,139,0,1,0,1,0
10861,25773,0,0,153,153,0,1,0,1,0
19259,3389,19259,3389,293,223,70,4,0,3,1
19260,6569,0,0,109,109,0,1,0,1,0
44933,5618,0,0,145,145,0,1,0,1,0
13944,21442,0,0,102,102,0,1,0,1,0
51235,30540,0,0,79,79,0,1,0,1,0
13762,25773,0,0,149,149,0,1,0,1,0
11441,61248,0,0,142,142,0,1,0,1,0
11242,4056,10102,3121,281,217,64,3,0,2,0
19331,19050,0,0,71,71,0,1,0,1,0
50171,32882,0,0,110,110,0,1,0,1,0
17573,19098,0,0,70,70,0,1,0,1,0
18875,1706,6345,1706,178,143,35,2,0,2,0
37136,3389,37136,3389,293,223,70,4,1,3,1
18075,23905,0,0,122,122,0,1,0,1,0
50940,30844,0,0,83,83,0,1,0,1,0
51437,33230,0,0,90,90,0,1,0,1,0
37396,7844,0,0,146,146,0,1,0,1,0
11034,25773,0,0,139,139,0,1,0,1,0
16165,3389,16165,3389,293,223,70,4,0,3,1
17299,3389,17299,3389,293,223,70,4,0,3,1
31351,3389,31351,3389,293,223,70,4,0,3,1
26428,1012,0,0,71,71,0,1,0,1,0
10671,3389,10671,3389,293,223,70,4,1,3,1
29430,31414,0,0,89,89,0,1,0,1,0
18195,18313,0,0,62,62,0,1,0,1,0
11488,3389,11488,3389,293,223,70,4,1,3,1
53560,37433,0,0,72,72,0,1,0,1,0
5998,25773,0,0,141,141,0,1,0,1,0
10150,61248,0,0,139,139,0,1,0,1,0
29728,22593,0,0,147,147,0,1,0,1,0
21213,31706,0,0,84,84,0,1,0,1,0
12750,3389,12750,3389,293,223,70,4,0,3,1
28270,27437,0,0,130,130,0,1,0,1,0
16809,15810,0,0,94,94,0,1,0,1,0
51716,31652,0,0,63,63,0,1,0,1,0
34914,3389,34914,3389,293,223,70,4,0,3,1
50659,31652,0,0,93,93,0,1,0,1,0
9388,24827,0,0,145,145,0,1,0,1,0
50689,60448,0,0,90,90,0,1,0,1,0
20280,61248,0,0,155,155,0,1,0,1,0
29535,34021,0,0,62,62,0,1,0,1,0
17218,3389,17218,3389,293,223,70,4,0,3,1
16512,20437,0,0,84,84,0,1,0,1,0
40334,5557,0,0,145,145,0,1,0,1,0
31420,3389,31420,3389,293,223,70,4,0,3,1
55442,33449,0,0,62,62,0,1,0,1,0
51609,31652,0,0,65,65,0,1,0,1,0
18175,20705,0,0,88,88,0,1,0,1,0
52074,32665,0,0,64,64,0,1,0,1,0
8557,25773,0,0,155,155,0,1,0,1,0
17444,61248,0,0,152,152,0,1,0,1,0
18049,24717,0,0,131,131,0,1,0,1,0
1792,23055,0,0,152,152,0,1,0,1,0
17689,17294,0,0,74,74,0,1,0,1,0
18118,25961,0,0,141,141,0,1,0,1,0
49025,28573,0,0,151,151,0,1,0,1,0
12617,60358,0,0,136,136,0,1,0,1,0
15534,13660,0,0,123,123,0,1,0,1,0
15688,61248,0,0,145,145,0,1,0,1,0
18671,18556,0,0,65,65,0,1,0,1,0
49001,28941,0,0,152,152,0,1,0,1,0
10977,3389,10977,3389,293,223,70,4,1,3,1
17750,3389,17750,3389,293,223,70,4,0,3,1
51368,31652,0,0,75,75,0,1,0,1,0
49990,6578,0,0,145,145,0,1,0,1,0
49198,31652,0,0,144,144,0,1,0,1,0
42422,5618,0,0,145,145,0,1,0,1,0
23904,31984,0,0,83,83,0,1,0,1,0
16288,25773,0,0,141,141,0,1,0,1,0
4030,51531,0,0,142,142,0,1,0,1,0
37759,3389,37759,3389,293,223,70,4,1,3,1
20140,3389,20140,3389,293,223,70,4,0,3,1
23088,3389,23088,3389,293,223,70,4,0,3,1
9205,24963,0,0,146,146,0,1,0,1,0
10205,3389,10205,3389,293,223,70,4,0,3,1
11558,60658,0,0,141,141,0,1,0,1,0
60253,3389,60253,3389,293,223,70,4,0,3,1
7171,25773,0,0,141,141,0,1,0,1,0
24267,61138,0,0,150,150,0,1,0,1,0
21548,3389,21548,3389,293,223,70,4,1,3,1
20744,3389,20744,3389,293,223,70,4,0,3,1
2172,46008,0,0,144,144,0,1,0,1,0
27389,34021,0,0,62,62,0,1,0,1,0
12345,3389,12345,3389,293,223,70,4,0,3,1
10073,25773,0,0,148,148,0,1,0,1,0
21652,61248,0,0,158,158,0,1,0,1,0
29013,1391,0,0,82,82,0,1,0,1,0
11370,61248,0,0,142,142,0,1,0,1,0
20016,59625,0,0,157,157,0,1,0,1,0
52052,32461,0,0,62,62,0,1,0,1,0
27479,32312,0,0,78,78,0,1,0,1,0
13725,10681,1261,467,168,158,9,1,0,1,0
55751,33000,0,0,109,109,0,1,0,1,0
13955,23663,0,0,117,117,0,1,0,1,0
17698,3389,17698,3389,293,223,70,4,0,3,1
28285,26713,0,0,138,138,0,1,0,1,0
16649,3389,16649,3389,293,223,70,4,0,3,1
37232,7962,0,0,146,146,0,1,0,1,0
19425,26921,0,0,131,131,0,1,0,1,0
11032,14399,0,0,150,150,0,1,0,1,0
52330,33287,0,0,62,62,0,1,0,1,0
61273,32145,0,0,79,79,0,1,0,1,0
13678,3389,13678,3389,293,223,70,4,0,3,1
4238,23630,0,0,157,157,0,1,0,1,0
52019,32363,0,0,62,62,0,1,0,1,0
51136,31652,0,0,82,82,0,1,0,1,0
15899,3389,15899,3389,293,223,70,4,0,3,1
15750,25773,0,0,143,143,0,1,0,1,0
25305,3389,25305,3389,293,223,70,4,1,3,1
29188,30200,0,0,101,101,0,1,0,1,0
23882,34021,0,0,62,62,0,1,0,1,0
37781,10111,0,0,146,146,0,1,0,1,0
63227,40682,0,0,87,87,0,1,0,1,0
49160,33771,0,0,146,146,0,1,0,1,0
9206,3389,9206,3389,293,223,70,4,1,3,1
2462,46145,0,0,145,145,0,1,0,1,0
49001,28017,0,0,152,152,0,1,0,1,0
32771,3389,32771,3389,293,223,70,4,1,3,1
52536,33897,0,0,62,62,0,1,0,1,0
10725,3389,10725,3389,293,223,70,4,0,3,1
23032,3389,23032,3389,293,223,70,4,0,3,1
63090,41684,0,0,90,90,0,1,0,1,0
11145,59528,0,0,139,139,0,1,0,1,0
13078,9650,2375,880,185,167,18,1,0,1,0
5702,24439,0,0,157,157,0,1,0,1,0
22102,3389,22102,3389,293,223,70,4,0,3,1
3133,42336,0,0,147,147,0,1,0,1,0
15492,20292,0,0,87,87,0,1,0,1,0
7357,25773,0,0,154,154,0,1,0,1,0
62994,42392,0,0,92,92,0,1,0,1,0
50557,29485,0,0,114,114,0,1,0,1,0
38038,3389,38038,3389,293,223,70,4,1,3,1
46543,3389,46543,3389,293,223,70,4,0,3,1
9951,24408,0,0,139,139,0,1,0,1,0
51795,31701,0,0,62,62,0,1,0,1,0
15873,3389,15873,3389,293,223,70,4,0,3,1
15865,61248,0,0,149,149,0,1,0,1,0
18158,1898,7060,1898,191,152,39,2,0,2,0
12307,6635,6757,2088,237,194,43,2,0,2,0
21394,3389,21394,3389,293,223,70,4,0,3,1
24694,25773,0,0,146,146,0,1,0,1,0
11948,61248,0,0,143,143,0,1,0,1,0
50183,32361,0,0,120,120,0,1,0,1,0
15246,13176,0,0,130,130,0,1,0,1,0
49116,32632,0,0,147,147,0,1,0,1,0
21076,3389,21076,3389,293,223,70,4,0,3,1
37718,8650,0,0,145,145,0,1,0,1,0
12483,24496,0,0,147,147,0,1,0,1,0
22657,3389,22657,3389,293,223,70,4,0,3,1
34518,3417,0,0,113,113,0,1,0,1,0
39018,3389,39018,3389,293,223,70,4,0,3,1
14099,20366,0,0,84,84,0,1,0,1,0
23107,21879,0,0,103,103,0,1,0,1,0
16016,3389,16016,3389,293,223,70,4,0,3,1
27539,25773,0,0,147,147,0,1,0,1,0
50842,29738,0,0,92,92,0,1,0,1,0
19331,61248,0,0,153,153,0,1,0,1,0
24242,22729,0,0,113,113,0,1,0,1,0
18937,18755,0,0,67,67,0,1,0,1,0
55665,5698,0,0,144,144,0,1,0,1,0
10678,5831,6503,2410,251,201,49,3,0,2,0
12129,3389,12129,3389,293,223,70,4,1,3,1
60986,4198,40762,2158,239,194,44,2,0,2,0
61627,3389,61627,3389,293,223,70,4,0,3,1
15720,61248,0,0,150,150,0,1,0,1,0
49184,33992,0,0,145,145,0,1,0,1,0
2936,22910,0,0,157,157,0,1,0,1,0
63131,31652,0,0,63,63,0,1,0,1,0
28658,34021,0,0,62,62,0,1,0,1,0
51960,32906,0,0,66,66,0,1,0,1,0
29592,22897,0,0,147,147,0,1,0,1,0
50574,34021,0,0,111,111,0,1,0,1,0
45349,34021,0,0,129,129,0,1,0,1,0
26491,463,0,0,68,68,0,1,0,1,0
11752,5292,8498,2626,260,206,54,3,0,2,0
15320,25773,0,0,141,141,0,1,0,1,0
12160,3389,12160,3389,293,223,70,4,0,3,1
29401,3389,29401,3389,293,223,70,4,0,3,1
6925,23215,0,0,152,152,0,1,0,1,0
26026,3389,26026,3389,293,223,70,4,0,3,1
49079,29812,0,0,149,149,0,1,0,1,0
50244,28782,0,0,122,122,0,1,0,1,0
61678,3389,61678,3389,293,223,70,4,0,3,1
38362,3389,38362,3389,293,223,70,4,1,3,1
13927,21454,0,0,102,102,0,1,0,1,0
53185,20319,0,0,103,103,0,1,0,1,0
54365,33215,0,0,117,117,0,1,0,1,0
29695,3389,29695,3389,293,223,70,4,0,3,1
44493,15197,0,0,151,151,0,1,0,1,0
4947,25773,0,0,147,147,0,1,0,1,0
49830,34021,0,0,129,129,0,1,0,1,0
52406,33902,0,0,66,66,0,1,0,1,0
19683,61248,0,0,154,154,0,1,0,1,0
55355,33061,0,0,111,111,0,1,0,1,0
14780,20821,0,0,94,94,0,1,0,1,0
12015,5929,7673,2371,249,200,48,3,0,2,0
30647,60810,0,0,123,123,0,1,0,1,0
50358,31652,0,0,107,107,0,1,0,1,0
53473,3389,53473,3389,293,223,70,4,0,3,1
46360,54553,0,0,78,78,0,1,0,1,0
7813,23581,0,0,119,119,0,1,0,1,0
51990,32279,0,0,62,62,0,1,0,1,0
11189,3389,11189,3389,293,223,70,4,0,3,1
9388,25773,0,0,151,151,0,1,0,1,0
64090,34364,0,0,69,69,0,1,0,1,0
20932,1022,3306,1021,131,110,21,1,0,1,0
49057,29312,0,0,150,150,0,1,0,1,0
18098,23167,0,0,114,114,0,1,0,1,0
13220,9877,2130,789,181,165,16,1,0,1,0
49129,33035,0,0,147,147,0,1,0,1,0
58652,4822,22839,1209,197,172,24,2,0,1,0
29911,33824,0,0,64,64,0,1,0,1,0
4140,51851,0,0,142,142,0,1,0,1,0
49789,34021,0,0,130,130,0,1,0,1,0
37855,3389,37855,3389,293,223,70,4,1,3,1
25710,34021,0,0,62,62,0,1,0,1,0
9718,4303,8155,3022,277,214,62,3,0,2,0
26861,31886,0,0,82,82,0,1,0,1,0
29738,32956,0,0,73,73,0,1,0,1,0
3563,48092,0,0,144,144,0,1,0,1,0
18039,25047,0,0,135,135,0,1,0,1,0
1302,22007,0,0,157,157,0,1,0,1,0
8984,61248,0,0,140,140,0,1,0,1,0
13158,9777,2238,829,183,166,17,1,0,1,0
28550,27000,0,0,135,135,0,1,0,1,0
11546,4791,9148,2826,268,210,58,3,0,2,0
27137,33207,0,0,69,69,0,1,0,1,0
14141,11079,996,307,161,154,6,1,0,1,0
49160,32340,0,0,146,146,0,1,0,1,0
19390,3389,19390,3389,293,223,70,4,0,3,1
30209,1831,0,0,89,89,0,1,0,1,0
21228,20471,0,0,87,87,0,1,0,1,0
34891,9464,0,0,141,141,0,1,0,1,0
24027,25773,0,0,145,145,0,1,0,1,0
25386,129,0,0,63,63,0,1,0,1,0
46570,20178,0,0,153,153,0,1,0,1,0
2424,41042,0,0,144,144,0,1,0,1,0
1363,22385,0,0,155,155,0,1,0,1,0
4884,18978,0,0,154,154,0,1,0,1,0
51858,31887,0,0,62,62,0,1,0,1,0
20938,3389,20938,3389,293,223,70,4,0,3,1
18332,26359,0,0,137,137,0,1,0,1,0
11922,61248,0,0,140,140,0,1,0,1,0
23535,34021,0,0,62,62,0,1,0,1,0
22040,61248,0,0,158,158,0,1,0,1,0
14570,3389,14570,3389,293,223,70,4,0,3,1
43962,3389,43962,3389,293,223,70,4,0,3,1
9095,61248,0,0,139,139,0,1,0,1,0
6877,23203,0,0,152,152,0,1,0,1,0
28050,26131,0,0,144,144,0,1,0,1,0
16043,3389,16043,3389,293,223,70,4,0,3,1
20990,61248,0,0,157,157,0,1,0,1,0
7576,25773,0,0,141,141,0,1,0,1,0
41656,34021,0,0,113,113,0,1,0,1,0
56867,31652,0,0,67,67,0,1,0,1,0
20192,3389,20192,3389,293,223,70,4,0,3,1
15423,21810,0,0,98,98,0,1,0,1,0
21603,3389,21603,3389,293,223,70,4,0,3,1
2318,42513,0,0,144,144,0,1,0,1,0
20834,3389,20834,3389,293,223,70,4,0,3,1
19591,3389,19591,3389,293,223,70,4,0,3,1
21050,20338,0,0,85,85,0,1,0,1,0
17221,3389,17221,3389,293,223,70,4,0,3,1
29637,34021,0,0,62,62,0,1,0,1,0
34614,3389,34614,3389,293,223,70,4,0,3,1
3660,48488,0,0,144,144,0,1,0,1,0
62465,3803,52120,2759,265,208,56,3,0,2,0
11119,3757,10488,3241,286,219,66,3,0,2,0
24461,31026,0,0,91,91,0,1,0,1,0
52287,33160,0,0,62,62,0,1,0,1,0
38970,6715,0,0,146,146,0,1,0,1,0
24287,34021,0,0,62,62,0,1,0,1,0
49080,31470,0,0,149,149,0,1,0,1,0
57228,3389,57228,3389,293,223,70,4,0,3,1
44692,7473,0,0,145,145,0,1,0,1,0
56154,60897,0,0,120,120,0,1,0,1,0
11956,25773,0,0,139,139,0,1,0,1,0
7040,53337,0,0,142,142,0,1,0,1,0
43511,7672,0,0,145,145,0,1,0,1,0
10021,61248,0,0,141,141,0,1,0,1,0
16524,9577,0,0,131,131,0,1,0,1,0
6995,25773,0,0,153,153,0,1,0,1,0
50603,32715,0,0,99,99,0,1,0,1,0
13325,61248,0,0,147,147,0,1,0,1,0
50553,32760,0,0,101,101,0,1,0,1,0
25125,25773,0,0,146,146,0,1,0,1,0
9490,3940,8548,3168,283,218,65,3,0,2,0
3622,25773,0,0,143,143,0,1,0,1,0
50047,3389,50047,3389,293,223,70,4,0,3,1
19298,3389,19298,3389,293,223,70,4,0,3,1
29720,32866,0,0,74,74,0,1,0,1,0
11923,61248,0,0,140,140,0,1,0,1,0
10408,61248,0,0,139,139,0,1,0,1,0
51292,31652,0,0,71,71,0,1,0,1,0
18604,3389,18604,3389,293,223,70,4,0,3,1
51784,33470,0,0,81,81,0,1,0,1,0
49095,5618,0,0,145,145,0,1,0,1,0
15746,51987,0,0,112,112,0,1,0,1,0
14975,25773,0,0,143,143,0,1,0,1,0
50573,32430,0,0,96,96,0,1,0,1,0
62774,3389,62774,3389,293,223,70,4,0,3,1
4964,25773,0,0,147,147,0,1,0,1,0
16003,3389,16003,3389,293,223,70,4,0,3,1
20271,3389,20271,3389,293,223,70,4,0,3,1
52187,33316,0,0,64,64,0,1,0,1,0
19929,3389,19929,3389,293,223,70,4,0,3,1
18224,25916,0,0,141,141,0,1,0,1,0
41801,3389,41801,3389,293,223,70,4,0,3,1
28704,34021,0,0,62,62,0,1,0,1,0
9409,3389,9409,3389,293,223,70,4,0,3,1
51009,32347,0,0,86,86,0,1,0,1,0
16509,15305,0,0,101,101,0,1,0,1,0
50741,32748,0,0,107,107,0,1,0,1,0
15223,3389,15223,3389,293,223,70,4,0,3,1
18452,61248,0,0,151,151,0,1,0,1,0
49794,33306,0,0,123,123,0,1,0,1,0
27782,25381,0,0,143,143,0,1,0,1,0
49048,26135,0,0,151,151,0,1,0,1,0
28132,2454,0,0,84,84,0,1,0,1,0
51980,27432,0,0,83,83,0,1,0,1,0
32913,60694,0,0,114,114,0,1,0,1,0
18431,1616,5228,1615,172,138,33,2,0,1,0
37695,34021,0,0,95,95,0,1,0,1,0
21931,61248,0,0,158,158,0,1,0,1,0
31831,2428,0,0,98,98,0,1,0,1,0
18345,3389,18345,3389,293,223,70,4,0,3,1
36832,11680,0,0,146,146,0,1,0,1,0
12014,25773,0,0,139,139,0,1,0,1,0
32263,5952,0,0,117,117,0,1,0,1,0
37824,7537,0,0,146,146,0,1,0,1,0
8505,25773,0,0,155,155,0,1,0,1,0
7874,24238,0,0,146,146,0,1,0,1,0
8886,24590,0,0,144,144,0,1,0,1,0
3107,25113,0,0,145,145,0,1,0,1,0
51634,31357,0,0,66,66,0,1,0,1,0
49863,3389,49863,3389,293,223,70,4,0,3,1
51738,31652,0,0,62,62,0,1,0,1,0
21090,3389,21090,3389,293,223,70,4,0,3,1
14296,3389,14296,3389,293,223,70,4,0,3,1
11875,3389,11875,3389,293,223,70,4,0,3,1
53962,38827,0,0,76,76,0,1,0,1,0
18156,3389,18156,3389,293,223,70,4,0,3,1
19719,3389,19719,3389,293,223,70,4,0,3,1
51844,31847,0,0,62,62,0,1,0,1,0
64008,31722,0,0,64,64,0,1,0,1,0
49160,32239,0,0,146,146,0,1,0,1,0
57814,32681,0,0,98,98,0,1,0,1,0
12150,3389,12150,3389,293,223,70,4,1,3,1
10025,3389,10025,3389,293,223,70,4,0,3,1
18930,3389,18930,3389,293,223,70,4,0,3,1
24628,3389,24628,3389,293,223,70,4,0,3,1
13714,3389,13714,3389,293,223,70,4,0,3,1
22989,21791,0,0,102,102,0,1,0,1,0
49604,34021,0,0,135,135,0,1,0,1,0
25269,23498,0,0,122,122,0,1,0,1,0
4146,25773,0,0,142,142,0,1,0,1,0
44193,3389,44193,3389,293,223,70,4,0,3,1
56263,51199,0,0,145,145,0,1,0,1,0
10214,3389,10214,3389,293,223,70,4,1,3,1
48928,26365,0,0,155,155,0,1,0,1,0
11723,60254,0,0,140,140,0,1,0,1,0
21194,25773,0,0,144,144,0,1,0,1,0
49563,3389,49563,3389,293,223,70,4,0,3,1
12265,3389,12265,3389,293,223,70,4,1,3,1
2550,47227,0,0,144,144,0,1,0,1,0
40147,5870,0,0,146,146,0,1,0,1,0
17667,25773,0,0,142,142,0,1,0,1,0
22241,25773,0,0,145,145,0,1,0,1,0
32091,60736,0,0,117,117,0,1,0,1,0
15832,14162,0,0,116,116,0,1,0,1,0
52501,33794,0,0,62,62,0,1,0,1,0
39832,6720,0,0,146,146,0,1,0,1,0
49143,31271,0,0,146,146,0,1,0,1,0
4126,25773,0,0,142,142,0,1,0,1,0
13634,10535,1418,525,170,159,10,1,0,1,0
20998,25773,0,0,144,144,0,1,0,1,0
13374,3389,13374,3389,293,223,70,4,0,3,1
50795,5618,0,0,145,145,0,1,0,1,0
16479,3389,16479,3389,293,223,70,4,0,3,1
24211,3389,24211,3389,293,223,70,4,0,3,1
13277,3208,11931,3208,280,214,66,3,0,2,0
31247,5091,0,0,109,109,0,1,0,1,0
1918,22348,0,0,157,157,0,1,0,1,0
14437,11814,36,13,148,148,0,1,0,1,0
18230,26169,0,0,139,139,0,1,0,1,0
31672,3389,31672,3389,293,223,70,4,0,3,1
3484,25702,0,0,143,143,0,1,0,1,0
29828,3389,29828,3389,293,223,70,4,0,3,1
14546,11995,0,0,146,146,0,1,0,1,0
21915,3389,21915,3389,293,223,70,4,0,3,1
49160,32128,0,0,146,146,0,1,0,1,0
12963,59433,0,0,133,133,0,1,0,1,0
3575,50206,0,0,143,143,0,1,0,1,0
46391,54299,0,0,78,78,0,1,0,1,0
19574,61248,0,0,155,155,0,1,0,1,0
24555,31102,0,0,90,90,0,1,0,1,0
49114,32562,0,0,147,147,0,1,0,1,0
21962,61248,0,0,158,158,0,1,0,1,0
42443,7852,0,0,145,145,0,1,0,1,0
48268,60249,0,0,76,76,0,1,0,1,0
52300,3389,52300,3389,293,223,70,4,0,3,1
17275,16595,0,0,84,84,0,1,0,1,0
16022,14483,0,0,112,112,0,1,0,1,0
50257,31652,0,0,107,107,0,1,0,1,0
14439,11816,33,12,148,148,0,1,0,1,0
5923,22983,0,0,152,152,0,1,0,1,0
23893,31998,0,0,83,83,0,1,0,1,0
23529,1875,0,0,75,75,0,1,0,1,0
34867,3389,34867,3389,293,223,70,4,0,3,1
23555,22215,0,0,107,107,0,1,0,1,0
14386,3389,14386,3389,293,223,70,4,0,3,1
26418,34021,0,0,62,62,0,1,0,1,0
12321,3389,12321,3389,293,223,70,4,0,3,1
51303,31722,0,0,71,71,0,1,0,1,0
45254,5618,0,0,145,145,0,1,0,1,0
49291,26740,0,0,143,143,0,1,0,1,0
17754,18496,0,0,64,64,0,1,0,1,0
11351,3389,11351,3389,293,223,70,4,1,3,1
9078,61248,0,0,140,140,0,1,0,1,0
11062,61248,0,0,139,139,0,1,0,1,0
12326,25773,0,0,151,151,0,1,0,1,0
13854,15716,0,0,145,145,0,1,0,1,0
49290,26565,0,0,144,144,0,1,0,1,0
11281,25773,0,0,143,143,0,1,0,1,0
12891,3389,12891,3389,293,223,70,4,1,3,1
21852,20939,0,0,92,92,0,1,0,1,0
45947,58110,0,0,68,68,0,1,0,1,0
20685,3389,20685,3389,293,223,70,4,0,3,1
47833,43967,0,0,113,113,0,1,0,1,0
48960,27095,0,0,154,154,0,1,0,1,0
7572,55008,0,0,143,143,0,1,0,1,0
13357,3389,13357,3389,293,223,70,4,0,3,1
50199,21917,0,0,154,154,0,1,0,1,0
11385,59890,0,0,139,139,0,1,0,1,0
61126,32168,0,0,80,80,0,1,0,1,0
40890,5618,0,0,145,145,0,1,0,1,0
11479,14066,0,0,149,149,0,1,0,1,0
56451,3389,56451,3389,293,223,70,4,0,3,1
12982,8271,4636,1432,209,179,29,2,0,1,0
48991,25992,0,0,153,153,0,1,0,1,0
11177,3389,11177,3389,293,223,70,4,1,3,1
38281,3389,38281,3389,293,223,70,4,1,3,1
62879,3389,62879,3389,293,223,70,4,0,3,1
19017,18815,0,0,68,68,0,1,0,1,0
27391,3389,27391,3389,293,223,70,4,1,3,1
26487,25773,0,0,147,147,0,1,0,1,0
61467,3389,61467,3389,293,223,70,4,0,3,1
10807,6036,6282,2328,247,199,48,3,0,2,0
33324,3389,33324,3389,293,223,70,4,0,3,1
14593,3389,14593,3389,293,223,70,4,0,3,1
9354,3389,9354,3389,293,223,70,4,0,3,1
49477,27062,0,0,142,142,0,1,0,1,0
27036,27563,0,0,129,129,0,1,0,1,0
41595,60248,0,0,78,78,0,1,0,1,0
12506,7119,6130,1894,229,189,39,2,0,2,0
5953,25773,0,0,150,150,0,1,0,1,0
21415,32080,0,0,81,81,0,1,0,1,0
12888,9349,2701,1001,190,170,20,1,0,1,0
17404,18871,0,0,69,69,0,1,0,1,0
50584,34021,0,0,110,110,0,1,0,1,0
29861,3389,29861,3389,293,223,70,4,0,3,1
13722,21607,0,0,104,104,0,1,0,1,0
49160,33552,0,0,146,146,0,1,0,1,0
12482,3389,12482,3389,293,223,70,4,0,3,1
28449,34021,0,0,62,62,0,1,0,1,0
11961,3389,11961,3389,293,223,70,4,1,3,1
21871,3697,0,0,88,88,0,1,0,1,0
49708,34021,0,0,132,132,0,1,0,1,0
7441,25400,0,0,157,157,0,1,0,1,0
52316,31652,0,0,128,128,0,1,0,1,0
50861,29775,0,0,92,92,0,1,0,1,0
19139,3389,19139,3389,293,223,70,4,0,3,1
6932,53174,0,0,142,142,0,1,0,1,0
13764,25773,0,0,140,140,0,1,0,1,0
50359,32671,0,0,103,103,0,1,0,1,0
20866,61248,0,0,156,156,0,1,0,1,0
6202,25773,0,0,151,151,0,1,0,1,0
53358,31652,0,0,62,62,0,1,0,1,0
26410,33123,0,0,70,70,0,1,0,1,0
50064,28663,0,0,115,115,0,1,0,1,0
17373,3389,17373,3389,293,223,70,4,0,3,1
14527,3389,14527,3389,293,223,70,4,0,3,1
48930,6757,0,0,145,145,0,1,0,1,0
23724,32237,0,0,80,80,0,1,0,1,0
40079,8252,0,0,145,145,0,1,0,1,0
15578,3389,15578,3389,293,223,70,4,0,3,1
59455,31652,0,0,62,62,0,1,0,1,0
37996,3389,37996,3389,293,223,70,4,1,3,1
51412,31919,0,0,70,70,0,1,0,1,0
6316,52914,0,0,144,144,0,1,0,1,0
28169,32368,0,0,79,79,0,1,0,1,0
18024,25545,0,0,140,140,0,1,0,1,0
49379,31652,0,0,138,138,0,1,0,1,0
60869,3389,60869,3389,293,223,70,4,0,3,1
17823,3389,17823,3389,293,223,70,4,0,3,1
48997,25984,0,0,154,154,0,1,0,1,0
49683,34021,0,0,133,133,0,1,0,1,0
49794,31652,0,0,123,123,0,1,0,1,0
2751,46974,0,0,144,144,0,1,0,1,0
25008,3389,25008,3389,293,223,70,4,1,3,1
10204,61248,0,0,141,141,0,1,0,1,0
10807,6037,6281,2327,247,199,48,3,0,2,0
20536,1116,3611,1115,138,115,23,1,0,1,0
14007,3389,14007,3389,293,223,70,4,0,3,1
47041,21306,0,0,154,154,0,1,0,1,0
45680,18043,0,0,152,152,0,1,0,1,0
50872,32093,0,0,85,85,0,1,0,1,0
32678,16004,0,0,146,146,0,1,0,1,0
21035,3389,21035,3389,293,223,70,4,0,3,1
9269,3389,9269,3389,293,223,70,4,1,3,1
18501,3389,18501,3389,293,223,70,4,0,3,1
12431,6935,6368,1968,232,191,40,2,0,2,0
10231,25773,0,0,147,147,0,1,0,1,0
49486,31652,0,0,135,135,0,1,0,1,0
10879,61248,0,0,142,142,0,1,0,1,0
4689,37164,0,0,150,150,0,1,0,1,0
28272,34021,0,0,62,62,0,1,0,1,0
50516,32494,0,0,98,98,0,1,0,1,0
50670,32698,0,0,108,108,0,1,0,1,0
2969,47196,0,0,144,144,0,1,0,1,0
11237,25773,0,0,143,143,0,1,0,1,0
18033,3389,18033,3389,293,223,70,4,0,3,1
6143,32330,0,0,153,153,0,1,0,1,0
2650,24399,0,0,147,147,0,1,0,1,0
9728,22602,0,0,108,108,0,1,0,1,0
15268,3389,15268,3389,293,223,70,4,0,3,1
6694,25773,0,0,152,152,0,1,0,1,0
15788,17052,0,0,146,146,0,1,0,1,0
25713,3389,25713,3389,293,223,70,4,0,3,1
19204,3389,19204,3389,293,223,70,4,0,3,1
25930,34021,0,0,62,62,0,1,0,1,0
9402,3389,9402,3389,293,223,70,4,1,3,1
44733,15771,0,0,151,151,0,1,0,1,0
4319,49586,0,0,144,144,0,1,0,1,0
25390,3389,25390,3389,293,223,70,4,0,3,1
11627,53569,0,0,117,117,0,1,0,1,0
52469,33778,0,0,64,64,0,1,0,1,0
9116,25773,0,0,155,155,0,1,0,1,0
30546,4498,0,0,104,104,0,1,0,1,0
49591,6645,0,0,145,145,0,1,0,1,0
17368,3389,17368,3389,293,223,70,4,0,3,1
48498,38978,0,0,129,129,0,1,0,1,0
28164,3389,28164,3389,293,223,70,4,0,3,1
60652,31652,0,0,64,64,0,1,0,1,0
5578,24724,0,0,131,131,0,1,0,1,0
16669,15574,0,0,97,97,0,1,0,1,0
47321,7029,0,0,145,145,0,1,0,1,0
51983,32257,0,0,62,62,0,1,0,1,0
28211,30290,0,0,100,100,0,1,0,1,0
38286,60418,0,0,92,92,0,1,0,1,0
6689,53536,0,0,144,144,0,1,0,1,0
16989,3389,16989,3389,293,223,70,4,0,3,1
26252,862,0,0,70,70,0,1,0,1,0
19095,61248,0,0,154,154,0,1,0,1,0
23034,21825,0,0,102,102,0,1,0,1,0
7401,25773,0,0,154,154,0,1,0,1,0
54506,12530,0,0,125,125,0,1,0,1,0
6077,51884,0,0,142,142,0,1,0,1,0
17354,25773,0,0,143,143,0,1,0,1,0
15449,52781,0,0,115,115,0,1,0,1,0
45751,5618,0,0,145,145,0,1,0,1,0
17479,25773,0,0,142,142,0,1,0,1,0
50456,32550,0,0,114,114,0,1,0,1,0
28541,34021,0,0,62,62,0,1,0,1,0
13549,17670,0,0,144,144,0,1,0,1,0
12570,3389,12570,3389,293,223,70,4,1,3,1
12572,25773,0,0,139,139,0,1,0,1,0
14060,2998,11150,2998,266,204,61,3,0,2,0
18934,29233,0,0,106,106,0,1,0,1,0
34913,11012,0,0,146,146,0,1,0,1,0
53731,11409,0,0,148,148,0,1,0,1,0
1519,22628,0,0,154,154,0,1,0,1,0
58568,3389,58568,3389,293,223,70,4,0,3,1
25720,413,0,0,65,65,0,1,0,1,0
3431,27126,0,0,143,143,0,1,0,1,0
35443,8644,0,0,142,142,0,1,0,1,0
5198,24160,0,0,157,157,0,1,0,1,0
20827,38390,0,0,74,74,0,1,0,1,0
15139,25773,0,0,140,140,0,1,0,1,0
17485,18811,0,0,69,69,0,1,0,1,0
48979,25944,0,0,155,155,0,1,0,1,0
11618,61248,0,0,141,141,0,1,0,1,0
58057,53157,0,0,122,122,0,1,0,1,0
54506,60762,0,0,111,111,0,1,0,1,0
10279,3389,10279,3389,293,223,70,4,1,3,1
21329,3389,21329,3389,293,223,70,4,0,3,1
14404,3389,14404,3389,293,223,70,4,0,3,1
9007,25773,0,0,143,143,0,1,0,1,0
52013,33629,0,0,75,75,0,1,0,1,0
15595,13763,0,0,122,122,0,1,0,1,0
16851,15881,0,0,93,93,0,1,0,1,0
23390,34021,0,0,62,62,0,1,0,1,0
50445,32543,0,0,114,114,0,1,0,1,0
13565,3389,13565,3389,293,223,70,4,0,3,1
45411,3389,45411,3389,293,223,70,4,0,3,1
51869,31920,0,0,62,62,0,1,0,1,0
9024,61248,0,0,140,140,0,1,0,1,0
27005,13624,0,0,103,103,0,1,0,1,0
26553,1117,0,0,72,72,0,1,0,1,0
28665,27579,0,0,129,129,0,1,0,1,0
42452,3389,42452,3389,293,223,70,4,0,3,1
49308,26682,0,0,146,146,0,1,0,1,0
30227,34021,0,0,63,63,0,1,0,1,0
49160,32429,0,0,146,146,0,1,0,1,0
49795,33305,0,0,123,123,0,1,0,1,0
20729,30808,0,0,93,93,0,1,0,1,0
2184,46163,0,0,144,144,0,1,0,1,0
9826,24502,0,0,140,140,0,1,0,1,0
50048,32267,0,0,124,124,0,1,0,1,0
29707,34021,0,0,62,62,0,1,0,1,0
9755,24554,0,0,141,141,0,1,0,1,0
7362,25773,0,0,141,141,0,1,0,1,0
38396,3389,38396,3389,293,223,70,4,1,3,1
31531,3389,31531,3389,293,223,70,4,0,3,1
9623,3389,9623,3389,293,223,70,4,1,3,1
52160,33266,0,0,65,65,0,1,0,1,0
27214,27311,0,0,131,131,0,1,0,1,0
10510,25773,0,0,139,139,0,1,0,1,0
5641,25773,0,0,149,149,0,1,0,1,0
12786,3389,12786,3389,293,223,70,4,0,3,1
13405,61248,0,0,147,147,0,1,0,1,0
4166,25773,0,0,144,144,0,1,0,1,0
39817,8296,0,0,145,145,0,1,0,1,0
49537,31652,0,0,133,133,0,1,0,1,0
46378,54873,0,0,78,78,0,1,0,1,0
28736,3389,28736,3389,293,223,70,4,0,3,1
51748,33446,0,0,82,82,0,1,0,1,0
14410,11731,150,46,149,149,0,1,0,1,0
49160,33561,0,0,146,146,0,1,0,1,0
52037,29924,0,0,67,67,0,1,0,1,0
37143,3389,37143,3389,293,223,70,4,1,3,1
20718,25773,0,0,144,144,0,1,0,1,0
47696,44996,0,0,110,110,0,1,0,1,0
49118,32686,0,0,147,147,0,1,0,1,0
17669,17260,0,0,75,75,0,1,0,1,0
7159,25773,0,0,154,154,0,1,0,1,0
13398,9278,3331,1029,192,170,21,1,0,1,0
18152,25773,0,0,143,143,0,1,0,1,0
49105,32276,0,0,148,148,0,1,0,1,0
38606,6976,0,0,146,146,0,1,0,1,0
20506,60001,0,0,157,157,0,1,0,1,0
47350,47590,0,0,102,102,0,1,0,1,0
51619,39968,0,0,145,145,0,1,0,1,0
48912,25990,0,0,156,156,0,1,0,1,0
17300,3389,17300,3389,293,223,70,4,0,3,1
1493,22588,0,0,154,154,0,1,0,1,0
51605,31809,0,0,67,67,0,1,0,1,0
52903,60630,0,0,102,102,0,1,0,1,0
37717,7614,0,0,146,146,0,1,0,1,0
20191,29808,0,0,103,103,0,1,0,1,0
33501,3389,33501,3389,293,223,70,4,0,3,1
4554,25248,0,0,137,137,0,1,0,1,0
26936,34021,0,0,62,62,0,1,0,1,0
50525,31652,0,0,102,102,0,1,0,1,0
17980,25773,0,0,142,142,0,1,0,1,0
18949,18764,0,0,67,67,0,1,0,1,0
19416,3389,19416,3389,293,223,70,4,0,3,1
50575,29936,0,0,96,96,0,1,0,1,0
18172,44497,0,0,93,93,0,1,0,1,0
19157,25773,0,0,143,143,0,1,0,1,0
28477,26636,0,0,138,138,0,1,0,1,0
53451,20485,0,0,97,97,0,1,0,1,0
20728,3389,20728,3389,293,223,70,4,0,3,1
51140,31652,0,0,76,76,0,1,0,1,0
40576,5618,0,0,145,145,0,1,0,1,0
13904,3040,11305,3039,269,206,62,3,0,2,0
16575,48400,0,0,104,104,0,1,0,1,0
11328,61248,0,0,142,142,0,1,0,1,0
2169,44577,0,0,144,144,0,1,0,1,0
55965,60882,0,0,119,119,0,1,0,1,0
48954,26946,0,0,154,154,0,1,0,1,0
62071,31652,0,0,63,63,0,1,0,1,0
9981,22472,0,0,107,107,0,1,0,1,0
51296,34021,0,0,93,93,0,1,0,1,0
13973,3389,13973,3389,293,223,70,4,0,3,1
22483,16009,0,0,82,82,0,1,0,1,0
28257,3389,28257,3389,293,223,70,4,0,3,1
36386,8569,0,0,146,146,0,1,0,1,0
12401,22588,0,0,116,116,0,1,0,1,0
18138,18051,0,0,64,64,0,1,0,1,0
52488,33959,0,0,64,64,0,1,0,1,0
31167,21042,0,0,147,147,0,1,0,1,0
49000,28889,0,0,152,152,0,1,0,1,0
27195,60987,0,0,138,138,0,1,0,1,0
31269,2221,0,0,95,95,0,1,0,1,0
8385,61248,0,0,140,140,0,1,0,1,0
9793,3389,9793,3389,293,223,70,4,1,3,1
51888,31975,0,0,62,62,0,1,0,1,0
15144,13002,0,0,132,132,0,1,0,1,0
1596,21427,0,0,156,156,0,1,0,1,0
48642,60280,0,0,78,78,0,1,0,1,0
10605,61248,0,0,139,139,0,1,0,1,0
10565,3389,10565,3389,293,223,70,4,1,3,1
12062,3389,12062,3389,293,223,70,4,1,3,1
59894,59452,0,0,139,139,0,1,0,1,0
9796,3389,9796,3389,293,223,70,4,1,3,1
15994,10159,0,0,135,135,0,1,0,1,0
49160,31893,0,0,146,146,0,1,0,1,0
46690,3389,46690,3389,293,223,70,4,0,3,1
14247,21216,0,0,99,99,0,1,0,1,0
21341,61248,0,0,157,157,0,1,0,1,0
49323,26633,0,0,143,143,0,1,0,1,0
50232,32814,0,0,108,108,0,1,0,1,0
32080,3389,32080,3389,293,223,70,4,0,3,1
12928,59526,0,0,134,134,0,1,0,1,0
12689,22374,0,0,114,114,0,1,0,1,0
50433,31652,0,0,101,101,0,1,0,1,0
11479,3389,11479,3389,293,223,70,4,1,3,1
49160,33078,0,0,146,146,0,1,0,1,0
1966,23328,0,0,151,151,0,1,0,1,0
40457,5602,0,0,145,145,0,1,0,1,0
19944,3389,19944,3389,293,223,70,4,0,3,1
24913,25773,0,0,146,146,0,1,0,1,0
18634,61248,0,0,153,153,0,1,0,1,0
49160,32731,0,0,146,146,0,1,0,1,0
4772,25773,0,0,142,142,0,1,0,1,0
50227,32819,0,0,108,108,0,1,0,1,0
19434,61248,0,0,155,155,0,1,0,1,0
14195,13536,0,0,146,146,0,1,0,1,0
48326,38472,0,0,125,125,0,1,0,1,0
49166,31652,0,0,145,145,0,1,0,1,0
37394,8705,0,0,145,145,0,1,0,1,0
56520,31652,0,0,68,68,0,1,0,1,0
42727,10960,0,0,148,148,0,1,0,1,0
18050,3389,18050,3389,293,223,70,4,1,3,1
29620,32366,0,0,79,79,0,1,0,1,0
51679,31652,0,0,63,63,0,1,0,1,0
8938,25773,0,0,155,155,0,1,0,1,0
19456,3389,19456,3389,293,223,70,4,0,3,1
49607,34021,0,0,135,135,0,1,0,1,0
10285,3389,10285,3389,293,223,70,4,0,3,1
49406,33798,0,0,138,138,0,1,0,1,0
18196,20014,0,0,81,81,0,1,0,1,0
50589,32412,0,0,95,95,0,1,0,1,0
14020,61248,0,0,147,147,0,1,0,1,0
22906,34021,0,0,62,62,0,1,0,1,0
14329,11533,407,125,153,150,2,1,0,1,0
15898,3389,15898,3389,293,223,70,4,0,3,1
14573,3389,14573,3389,293,223,70,4,0,3,1
49693,31652,0,0,127,127,0,1,0,1,0
24793,3389,24793,3389,293,223,70,4,1,3,1
21538,3389,21538,3389,293,223,70,4,0,3,1
20070,29583,0,0,105,105,0,1,0,1,0
18590,18495,0,0,64,64,0,1,0,1,0
9323,25773,0,0,155,155,0,1,0,1,0
20479,3389,20479,3389,293,223,70,4,0,3,1
11093,25773,0,0,139,139,0,1,0,1,0
51207,30944,0,0,97,97,0,1,0,1,0
49160,32831,0,0,146,146,0,1,0,1,0
50457,31652,0,0,104,104,0,1,0,1,0
14378,61248,0,0,147,147,0,1,0,1,0
29528,3389,29528,3389,293,223,70,4,0,3,1
15910,14294,0,0,115,115,0,1,0,1,0
38182,3389,38182,3389,293,223,70,4,0,3,1
14916,2451,7930,2450,229,178,50,3,0,2,0
47100,54710,0,0,62,62,0,1,0,1,0
60379,32465,0,0,62,62,0,1,0,1,0
54052,39141,0,0,77,77,0,1,0,1,0
28898,34021,0,0,62,62,0,1,0,1,0
62033,49426,0,0,111,111,0,1,0,1,0
28690,1272,0,0,81,81,0,1,0,1,0
18072,17939,0,0,66,66,0,1,0,1,0
51934,32112,0,0,62,62,0,1,0,1,0
50806,32531,0,0,93,93,0,1,0,1,0
10216,25773,0,0,154,154,0,1,0,1,0
28480,34021,0,0,62,62,0,1,0,1,0
20487,61248,0,0,156,156,0,1,0,1,0
28171,32262,0,0,80,80,0,1,0,1,0
64413,31998,0,0,62,62,0,1,0,1,0
12666,3389,12666,3389,293,223,70,4,0,3,1
51259,33107,0,0,94,94,0,1,0,1,0
15512,3389,15512,3389,293,223,70,4,0,3,1
47034,49960,0,0,94,94,0,1,0,1,0
50894,32452,0,0,90,90,0,1,0,1,0
9823,3389,9823,3389,293,223,70,4,1,3,1
51029,39869,0,0,62,62,0,1,0,1,0
51772,31652,0,0,62,62,0,1,0,1,0
50878,19897,0,0,153,153,0,1,0,1,0
50201,3389,50201,3389,293,223,70,4,0,3,1
56448,5412,5913,313,158,152,6,1,0,1,0
49887,31652,0,0,120,120,0,1,0,1,0
26143,28823,0,0,116,116,0,1,0,1,0
19333,6489,0,0,109,109,0,1,0,1,0
21754,32709,0,0,74,74,0,1,0,1,0
20674,20056,0,0,82,82,0,1,0,1,0
14974,54052,0,0,118,118,0,1,0,1,0
11966,61248,0,0,140,140,0,1,0,1,0
16948,25773,0,0,142,142,0,1,0,1,0
58719,55347,0,0,127,127,0,1,0,1,0
14057,23533,0,0,116,116,0,1,0,1,0
14078,25773,0,0,140,140,0,1,0,1,0
49760,27525,0,0,128,128,0,1,0,1,0
49168,31652,0,0,145,145,0,1,0,1,0
50410,28854,0,0,107,107,0,1,0,1,0
18160,21189,0,0,93,93,0,1,0,1,0
11318,61248,0,0,142,142,0,1,0,1,0
52332,33577,0,0,63,63,0,1,0,1,0
18778,18636,0,0,66,66,0,1,0,1,0
45837,60050,0,0,62,62,0,1,0,1,0
36369,8581,0,0,146,146,0,1,0,1,0
13449,10241,1736,643,175,162,13,1,0,1,0
20337,3389,20337,3389,293,223,70,4,0,3,1
13488,10303,1669,618,174,161,12,1,0,1,0
52520,34021,0,0,63,63,0,1,0,1,0
55667,49758,0,0,145,145,0,1,0,1,0
17939,61248,0,0,152,152,0,1,0,1,0
23125,566,2103,565,100,88,11,1,0,1,0
14995,12752,0,0,135,135,0,1,0,1,0
12900,3389,12900,3389,293,223,70,4,0,3,1
16640,3389,16640,3389,293,223,70,4,0,3,1
46257,57896,0,0,62,62,0,1,0,1,0
3805,19782,0,0,155,155,0,1,0,1,0
17441,61248,0,0,149,149,0,1,0,1,0
2736,36730,0,0,144,144,0,1,0,1,0
22464,21397,0,0,98,98,0,1,0,1,0
29339,30958,0,0,93,93,0,1,0,1,0
38881,8292,0,0,146,146,0,1,0,1,0
28275,27180,0,0,133,133,0,1,0,1,0
49012,29295,0,0,152,152,0,1,0,1,0
7012,25163,0,0,157,157,0,1,0,1,0
51592,31270,0,0,68,68,0,1,0,1,0
49160,31699,0,0,146,146,0,1,0,1,0
18141,21793,0,0,100,100,0,1,0,1,0
14855,3389,14855,3389,293,223,70,4,0,3,1
35855,8950,0,0,146,146,0,1,0,1,0
62530,3389,62530,3389,293,223,70,4,0,3,1
22238,3294,0,0,85,85,0,1,0,1,0
37132,3389,37132,3389,293,223,70,4,1,3,1
24554,14917,0,0,92,92,0,1,0,1,0
2864,34967,0,0,143,143,0,1,0,1,0
11633,25773,0,0,152,152,0,1,0,1,0
60041,31652,0,0,65,65,0,1,0,1,0
48980,35366,0,0,141,141,0,1,0,1,0
3338,25474,0,0,144,144,0,1,0,1,0
50369,32660,0,0,103,103,0,1,0,1,0
20728,32617,0,0,75,75,0,1,0,1,0
50015,34021,0,0,124,124,0,1,0,1,0
27525,25773,0,0,147,147,0,1,0,1,0
9395,24767,0,0,143,143,0,1,0,1,0
40332,5737,0,0,146,146,0,1,0,1,0
51406,31652,0,0,69,69,0,1,0,1,0
14553,53340,0,0,119,119,0,1,0,1,0
49034,28776,0,0,151,151,0,1,0,1,0
24217,25773,0,0,146,146,0,1,0,1,0
48981,27570,0,0,153,153,0,1,0,1,0
9761,3389,9761,3389,293,223,70,4,1,3,1
9418,3389,9418,3389,293,223,70,4,1,3,1
17843,3389,17843,3389,293,223,70,4,0,3,1
23052,586,2177,585,101,89,12,1,0,1,0
50208,28702,0,0,123,123,0,1,0,1,0
50083,34021,0,0,123,123,0,1,0,1,0
12099,61248,0,0,145,145,0,1,0,1,0
16859,3389,16859,3389,293,223,70,4,0,3,1
50306,28641,0,0,110,110,0,1,0,1,0
31017,3389,31017,3389,293,223,70,4,0,3,1
13675,25773,0,0,149,149,0,1,0,1,0
3827,25773,0,0,143,143,0,1,0,1,0
2725,46930,0,0,144,144,0,1,0,1,0
49121,32769,0,0,147,147,0,1,0,1,0
4694,22700,0,0,153,153,0,1,0,1,0
11744,5271,8525,2634,260,206,54,3,0,2,0
13348,25773,0,0,143,143,0,1,0,1,0
49210,33975,0,0,144,144,0,1,0,1,0
21917,3389,21917,3389,293,223,70,4,0,3,1
50041,33028,0,0,115,115,0,1,0,1,0
49160,32667,0,0,146,146,0,1,0,1,0
54776,5618,0,0,145,145,0,1,0,1,0
39008,6688,0,0,146,146,0,1,0,1,0
9130,61248,0,0,139,139,0,1,0,1,0
11369,3389,11369,3389,293,223,70,4,1,3,1
9261,56687,0,0,140,140,0,1,0,1,0
16478,19751,0,0,145,145,0,1,0,1,0
8529,61248,0,0,139,139,0,1,0,1,0
17271,61248,0,0,151,151,0,1,0,1,0
50204,28693,0,0,123,123,0,1,0,1,0
9339,3389,9339,3389,293,223,70,4,1,3,1
24623,34021,0,0,62,62,0,1,0,1,0
18182,20479,0,0,86,86,0,1,0,1,0
12109,52700,0,0,114,114,0,1,0,1,0
54190,3389,54190,3389,293,223,70,4,0,3,1
8680,61248,0,0,140,140,0,1,0,1,0
25439,3389,25439,3389,293,223,70,4,0,3,1
18663,3389,18663,3389,293,223,70,4,0,3,1
51491,31912,0,0,71,71,0,1,0,1,0
9694,3389,9694,3389,293,223,70,4,1,3,1
32504,3389,32504,3389,293,223,70,4,0,3,1
9145,25773,0,0,152,152,0,1,0,1,0
11635,61248,0,0,141,141,0,1,0,1,0
48935,26525,0,0,155,155,0,1,0,1,0
50097,32301,0,0,122,122,0,1,0,1,0
7843,61248,0,0,139,139,0,1,0,1,0
14971,20679,0,0,92,92,0,1,0,1,0
24325,34021,0,0,62,62,0,1,0,1,0
21750,3389,21750,3389,293,223,70,4,0,3,1
20681,30718,0,0,94,94,0,1,0,1,0
19410,3389,19410,3389,293,223,70,4,0,3,1
11554,25773,0,0,142,142,0,1,0,1,0
9278,25773,0,0,140,140,0,1,0,1,0
15208,22081,0,0,101,101,0,1,0,1,0
51196,32178,0,0,80,80,0,1,0,1,0
59146,58169,0,0,145,145,0,1,0,1,0
2414,24029,0,0,149,149,0,1,0,1,0
48167,3389,48167,3389,293,223,70,4,0,3,1
16770,3389,16770,3389,293,223,70,4,0,3,1
17158,61248,0,0,151,151,0,1,0,1,0
10304,24147,0,0,136,136,0,1,0,1,0
28408,26292,0,0,142,142,0,1,0,1,0
6347,25773,0,0,143,143,0,1,0,1,0
5480,24316,0,0,157,157,0,1,0,1,0
37126,3389,37126,3389,293,223,70,4,1,3,1
17473,3389,17473,3389,293,223,70,4,0,3,1
15343,61248,0,0,149,149,0,1,0,1,0
46491,54025,0,0,81,81,0,1,0,1,0
11711,7475,4726,1751,222,186,36,2,0,2,0
47726,22951,0,0,155,155,0,1,0,1,0
4249,49470,0,0,144,144,0,1,0,1,0
49542,31652,0,0,133,133,0,1,0,1,0
50961,5618,0,0,145,145,0,1,0,1,0
52437,33605,0,0,62,62,0,1,0,1,0
13934,54852,0,0,123,123,0,1,0,1,0
50627,32669,0,0,109,109,0,1,0,1,0
51553,31652,0,0,66,66,0,1,0,1,0
29864,34021,0,0,62,62,0,1,0,1,0
20657,3389,20657,3389,293,223,70,4,0,3,1
15540,13671,0,0,123,123,0,1,0,1,0
52405,33710,0,0,63,63,0,1,0,1,0
9611,4133,8339,3090,280,216,63,3,0,2,0
14888,61248,0,0,149,149,0,1,0,1,0
50446,32543,0,0,114,114,0,1,0,1,0
16608,25773,0,0,142,142,0,1,0,1,0
48649,5618,0,0,145,145,0,1,0,1,0
3486,46932,0,0,145,145,0,1,0,1,0
11844,3389,11844,3389,293,223,70,4,1,3,1
27942,3389,27942,3389,293,223,70,4,0,3,1
26820,27868,0,0,126,126,0,1,0,1,0
23683,34021,0,0,62,62,0,1,0,1,0
59989,61212,0,0,142,142,0,1,0,1,0
49484,31652,0,0,134,134,0,1,0,1,0
19280,61248,0,0,153,153,0,1,0,1,0
57912,31652,0,0,66,66,0,1,0,1,0
28150,33266,0,0,69,69,0,1,0,1,0
9458,61248,0,0,141,141,0,1,0,1,0
37199,11072,0,0,146,146,0,1,0,1,0
46405,54670,0,0,79,79,0,1,0,1,0
35584,3389,35584,3389,293,223,70,4,1,3,1
29001,29264,0,0,111,111,0,1,0,1,0
52490,33761,0,0,62,62,0,1,0,1,0
51741,28838,0,0,79,79,0,1,0,1,0
53463,31652,0,0,122,122,0,1,0,1,0
33775,13554,0,0,146,146,0,1,0,1,0
28259,27998,0,0,124,124,0,1,0,1,0
38222,3389,38222,3389,293,223,70,4,1,3,1
52650,31652,0,0,126,126,0,1,0,1,0
16345,3389,16345,3389,293,223,70,4,0,3,1
52554,34021,0,0,62,62,0,1,0,1,0
53883,17601,0,0,106,106,0,1,0,1,0
17977,46017,0,0,95,95,0,1,0,1,0
4492,25773,0,0,142,142,0,1,0,1,0
19191,3389,19191,3389,293,223,70,4,0,3,1
16742,3389,16742,3389,293,223,70,4,0,3,1
42475,7847,0,0,145,145,0,1,0,1,0
29618,32356,0,0,79,79,0,1,0,1,0
50863,30652,0,0,86,86,0,1,0,1,0
49160,33645,0,0,146,146,0,1,0,1,0
18729,26353,0,0,137,137,0,1,0,1,0
37604,3389,37604,3389,293,223,70,4,1,3,1
28895,28733,0,0,117,117,0,1,0,1,0
10072,3389,10072,3389,293,223,70,4,1,3,1
28193,31170,0,0,91,91,0,1,0,1,0
21399,3389,21399,3389,293,223,70,4,0,3,1
60538,3389,60538,3389,293,223,70,4,0,3,1
28317,34021,0,0,62,62,0,1,0,1,0
21209,3389,21209,3389,293,223,70,4,0,3,1
62049,32132,0,0,62,62,0,1,0,1,0
18121,22411,0,0,106,106,0,1,0,1,0
13825,54871,0,0,153,153,0,1,0,1,0
35655,9356,0,0,146,146,0,1,0,1,0
8712,23121,0,0,114,114,0,1,0,1,0
19520,28564,0,0,115,115,0,1,0,1,0
21016,60393,0,0,158,158,0,1,0,1,0
33479,3389,33479,3389,293,223,70,4,0,3,1
14980,12727,0,0,136,136,0,1,0,1,0
21407,25773,0,0,144,144,0,1,0,1,0
62368,46971,0,0,104,104,0,1,0,1,0
26292,34021,0,0,62,62,0,1,0,1,0
49827,3389,49827,3389,293,223,70,4,0,3,1
39096,6625,0,0,146,146,0,1,0,1,0
57958,61045,0,0,131,131,0,1,0,1,0
50472,41973,0,0,62,62,0,1,0,1,0
14625,25773,0,0,143,143,0,1,0,1,0
61193,31652,0,0,62,62,0,1,0,1,0
10299,3389,10299,3389,293,223,70,4,1,3,1
51101,32264,0,0,83,83,0,1,0,1,0
63667,3481,61354,3248,286,219,67,3,0,2,0
2333,22577,0,0,157,157,0,1,0,1,0
8939,25161,0,0,149,149,0,1,0,1,0
12737,22338,0,0,113,113,0,1,0,1,0
10991,3447,10890,3365,291,222,69,3,0,2,0
11396,61248,0,0,142,142,0,1,0,1,0
42114,60221,0,0,76,76,0,1,0,1,0
20197,3389,20197,3389,293,223,70,4,0,3,1
51962,34021,0,0,77,77,0,1,0,1,0
9428,3389,9428,3389,293,223,70,4,1,3,1
29363,34021,0,0,62,62,0,1,0,1,0
49304,46385,0,0,62,62,0,1,0,1,0
53022,13519,0,0,149,149,0,1,0,1,0
30935,19897,0,0,147,147,0,1,0,1,0
48968,27268,0,0,154,154,0,1,0,1,0
3107,48847,0,0,143,143,0,1,0,1,0
59974,4469,32996,1746,221,185,36,2,0,2,0
17959,17749,0,0,68,68,0,1,0,1,0
2104,45891,0,0,144,144,0,1,0,1,0
16853,3389,16853,3389,293,223,70,4,1,3,1
5774,56602,0,0,140,140,0,1,0,1,0
5926,52264,0,0,144,144,0,1,0,1,0
24053,22588,0,0,111,111,0,1,0,1,0
26045,31321,0,0,88,88,0,1,0,1,0
28448,26493,0,0,140,140,0,1,0,1,0
15003,22340,0,0,103,103,0,1,0,1,0
51712,33421,0,0,83,83,0,1,0,1,0
8074,25749,0,0,157,157,0,1,0,1,0
62699,44550,0,0,98,98,0,1,0,1,0
18849,61248,0,0,152,152,0,1,0,1,0
60735,31652,0,0,64,64,0,1,0,1,0
48946,27178,0,0,155,155,0,1,0,1,0
18422,3389,18422,3389,293,223,70,4,0,3,1
12650,3389,12650,3389,293,223,70,4,0,3,1
55839,60871,0,0,119,119,0,1,0,1,0
8493,61248,0,0,140,140,0,1,0,1,0
22879,25773,0,0,145,145,0,1,0,1,0
51051,32962,0,0,99,99,0,1,0,1,0
10973,3389,10973,3389,293,223,70,4,1,3,1
51540,33301,0,0,87,87,0,1,0,1,0
32052,3389,32052,3389,293,223,70,4,0,3,1
18111,22753,0,0,110,110,0,1,0,1,0
52275,33124,0,0,62,62,0,1,0,1,0
12472,25871,0,0,138,138,0,1,0,1,0
28978,34021,0,0,62,62,0,1,0,1,0
21969,3389,21969,3389,293,223,70,4,0,3,1
23857,22441,0,0,109,109,0,1,0,1,0
20327,3389,20327,3389,293,223,70,4,0,3,1
51354,32036,0,0,75,75,0,1,0,1,0
28574,2829,0,0,88,88,0,1,0,1,0
33682,3389,33682,3389,293,223,70,4,0,3,1
9216,3389,9216,3389,293,223,70,4,0,3,1
10056,61248,0,0,139,139,0,1,0,1,0
17489,3389,17489,3389,293,223,70,4,0,3,1
31936,3389,31936,3389,293,223,70,4,0,3,1
52514,33832,0,0,62,62,0,1,0,1,0
13816,21537,0,0,103,103,0,1,0,1,0
29934,34021,0,0,62,62,0,1,0,1,0
13801,25773,0,0,140,140,0,1,0,1,0
11951,25773,0,0,140,140,0,1,0,1,0
49192,31652,0,0,145,145,0,1,0,1,0
19386,25773,0,0,143,143,0,1,0,1,0
33391,3002,0,0,106,106,0,1,0,1,0
23913,1453,0,0,72,72,0,1,0,1,0
21304,3389,21304,3389,293,223,70,4,0,3,1
33073,3389,33073,3389,293,223,70,4,0,3,1
49160,32550,0,0,146,146,0,1,0,1,0
12937,24601,0,0,147,147,0,1,0,1,0
15853,17305,0,0,146,146,0,1,0,1,0
12981,57180,0,0,130,130,0,1,0,1,0
14005,23599,0,0,116,116,0,1,0,1,0
5464,50959,0,0,143,143,0,1,0,1,0
29793,33231,0,0,70,70,0,1,0,1,0
31900,3389,31900,3389,293,223,70,4,0,3,1
37081,4360,0,0,127,127,0,1,0,1,0
29773,33132,0,0,71,71,0,1,0,1,0
27165,13539,0,0,104,104,0,1,0,1,0
12558,25426,0,0,135,135,0,1,0,1,0
50154,32902,0,0,111,111,0,1,0,1,0
51683,32407,0,0,68,68,0,1,0,1,0
16050,25773,0,0,141,141,0,1,0,1,0
24940,30522,0,0,98,98,0,1,0,1,0
22377,3389,22377,3389,293,223,70,4,0,3,1
14475,11875,0,0,147,147,0,1,0,1,0
29617,32348,0,0,79,79,0,1,0,1,0
50871,5618,0,0,145,145,0,1,0,1,0
29821,34021,0,0,62,62,0,1,0,1,0
49555,5618,0,0,145,145,0,1,0,1,0
19440,3389,19440,3389,293,223,70,4,0,3,1
29101,34021,0,0,62,62,0,1,0,1,0
4328,52396,0,0,142,142,0,1,0,1,0
30830,4738,0,0,106,106,0,1,0,1,0
25730,420,0,0,65,65,0,1,0,1,0
10873,3389,10873,3389,293,223,70,4,1,3,1
52156,32771,0,0,62,62,0,1,0,1,0
33472,3389,33472,3389,293,223,70,4,0,3,1
6180,24703,0,0,157,157,0,1,0,1,0
53883,17603,0,0,106,106,0,1,0,1,0
19351,3389,19351,3389,293,223,70,4,0,3,1
7700,25543,0,0,157,157,0,1,0,1,0
51409,31652,0,0,73,73,0,1,0,1,0
11742,3389,11742,3389,293,223,70,4,0,3,1
4791,25773,0,0,146,146,0,1,0,1,0
3378,23155,0,0,157,157,0,1,0,1,0
21098,31493,0,0,86,86,0,1,0,1,0
52283,3389,52283,3389,293,223,70,4,0,3,1
55299,5618,0,0,145,145,0,1,0,1,0
51675,31652,0,0,64,64,0,1,0,1,0
51785,31672,0,0,62,62,0,1,0,1,0
51322,31756,0,0,71,71,0,1,0,1,0
50017,31652,0,0,115,115,0,1,0,1,0
52947,5618,0,0,145,145,0,1,0,1,0
16229,25360,0,0,144,144,0,1,0,1,0
49784,33318,0,0,124,124,0,1,0,1,0
29731,3808,0,0,97,97,0,1,0,1,0
17271,16589,0,0,84,84,0,1,0,1,0
29651,34021,0,0,62,62,0,1,0,1,0
11683,61248,0,0,139,139,0,1,0,1,0
27289,34021,0,0,62,62,0,1,0,1,0
50499,32513,0,0,98,98,0,1,0,1,0
37897,3389,37897,3389,293,223,70,4,1,3,1
53067,21016,0,0,101,101,0,1,0,1,0
50383,34021,0,0,115,115,0,1,0,1,0
12888,3389,12888,3389,293,223,70,4,0,3,1
20770,3389,20770,3389,293,223,70,4,0,3,1
12635,7430,5726,1769,223,187,36,2,0,2,0
8106,54945,0,0,141,141,0,1,0,1,0
10885,3389,10885,3389,293,223,70,4,0,3,1
49906,33346,0,0,122,122,0,1,0,1,0
10452,5472,6892,2554,257,204,52,3,0,2,0
5598,25773,0,0,142,142,0,1,0,1,0
2419,41110,0,0,144,144,0,1,0,1,0
52851,14027,0,0,150,150,0,1,0,1,0
18072,23995,0,0,123,123,0,1,0,1,0
10670,3389,10670,3389,293,223,70,4,0,3,1
18051,24657,0,0,130,130,0,1,0,1,0
21627,3389,21627,3389,293,223,70,4,0,3,1
24797,32284,0,0,78,78,0,1,0,1,0
5723,25773,0,0,141,141,0,1,0,1,0
54456,3389,54456,3389,293,223,70,4,0,3,1
20232,61248,0,0,155,155,0,1,0,1,0
49351,33805,0,0,139,139,0,1,0,1,0
16718,3389,16718,3389,293,223,70,4,0,3,1
17792,24896,0,0,143,143,0,1,0,1,0
51656,31763,0,0,65,65,0,1,0,1,0
48417,24607,0,0,156,156,0,1,0,1,0
9466,61248,0,0,141,141,0,1,0,1,0
54430,12980,0,0,124,124,0,1,0,1,0
13243,61248,0,0,145,145,0,1,0,1,0
10329,3389,10329,3389,293,223,70,4,1,3,1
11711,3389,11711,3389,293,223,70,4,0,3,1
18955,31180,0,0,88,88,0,1,0,1,0
22363,25773,0,0,145,145,0,1,0,1,0
32269,60727,0,0,117,117,0,1,0,1,0
51567,31752,0,0,88,88,0,1,0,1,0
15291,13250,0,0,129,129,0,1,0,1,0
55313,3389,55313,3389,293,223,70,4,0,3,1
14303,23223,0,0,112,112,0,1,0,1,0
61920,32045,0,0,75,75,0,1,0,1,0
19382,26886,0,0,132,132,0,1,0,1,0
26836,27845,0,0,126,126,0,1,0,1,0
49602,31958,0,0,135,135,0,1,0,1,0
52404,33505,0,0,62,62,0,1,0,1,0
5852,33297,0,0,152,152,0,1,0,1,0
17143,3389,17143,3389,293,223,70,4,0,3,1
34553,34021,0,0,82,82,0,1,0,1,0
19668,61248,0,0,155,155,0,1,0,1,0
35716,8875,0,0,145,145,0,1,0,1,0
2781,24602,0,0,147,147,0,1,0,1,0
52985,3389,52985,3389,293,223,70,4,0,3,1
5768,25773,0,0,141,141,0,1,0,1,0
28463,26567,0,0,139,139,0,1,0,1,0
51208,31652,0,0,80,80,0,1,0,1,0
34020,7439,0,0,131,131,0,1,0,1,0
23851,34021,0,0,62,62,0,1,0,1,0
30255,3389,30255,3389,293,223,70,4,0,3,1
17888,3389,17888,3389,293,223,70,4,0,3,1
24556,3389,24556,3389,293,223,70,4,0,3,1
52710,5618,0,0,145,145,0,1,0,1,0
28855,34021,0,0,62,62,0,1,0,1,0
49020,26065,0,0,152,152,0,1,0,1,0
49160,32309,0,0,146,146,0,1,0,1,0
37671,3389,37671,3389,293,223,70,4,1,3,1
4403,23721,0,0,157,157,0,1,0,1,0
2798,43452,0,0,146,146,0,1,0,1,0
53666,33803,0,0,62,62,0,1,0,1,0
15633,25773,0,0,146,146,0,1,0,1,0
36251,4054,0,0,122,122,0,1,0,1,0
5699,23481,0,0,149,149,0,1,0,1,0
34026,3236,0,0,110,110,0,1,0,1,0
3403,25575,0,0,143,143,0,1,0,1,0
3770,50775,0,0,143,143,0,1,0,1,0
18001,3389,18001,3389,293,223,70,4,0,3,1
21415,32079,0,0,81,81,0,1,0,1,0
61714,4003,46356,2454,252,201,50,3,0,2,0
49160,33173,0,0,146,146,0,1,0,1,0
30161,1814,0,0,89,89,0,1,0,1,0
50430,32591,0,0,101,101,0,1,0,1,0
11374,3389,11374,3389,293,223,70,4,1,3,1
11198,61051,0,0,143,143,0,1,0,1,0
50164,28352,0,0,115,115,0,1,0,1,0
16602,3389,16602,3389,293,223,70,4,0,3,1
19762,61248,0,0,154,154,0,1,0,1,0
27633,3389,27633,3389,293,223,70,4,0,3,1
9721,25773,0,0,140,140,0,1,0,1,0
19609,19258,0,0,73,73,0,1,0,1,0
51235,33090,0,0,94,94,0,1,0,1,0
18795,58687,0,0,156,156,0,1,0,1,0
11339,3389,11339,3389,293,223,70,4,1,3,1
50900,30745,0,0,85,85,0,1,0,1,0
19184,3389,19184,3389,293,223,70,4,0,3,1
19697,3389,19697,3389,293,223,70,4,0,3,1
32195,60731,0,0,117,117,0,1,0,1,0
49160,32543,0,0,146,146,0,1,0,1,0
17320,25773,0,0,143,143,0,1,0,1,0
12268,61222,0,0,139,139,0,1,0,1,0
16568,3389,16568,3389,293,223,70,4,0,3,1
18918,1500,4854,1500,164,133,30,2,0,1,0
51809,28441,0,0,81,81,0,1,0,1,0
19703,61248,0,0,155,155,0,1,0,1,0
43151,7733,0,0,145,145,0,1,0,1,0
13013,24619,0,0,147,147,0,1,0,1,0
49160,32886,0,0,146,146,0,1,0,1,0
49160,33357,0,0,146,146,0,1,0,1,0
9381,24832,0,0,145,145,0,1,0,1,0
35130,3389,35130,3389,293,223,70,4,1,3,1
27119,24885,0,0,137,137,0,1,0,1,0
6847,25072,0,0,157,157,0,1,0,1,0
14703,12260,0,0,142,142,0,1,0,1,0
20574,19981,0,0,81,81,0,1,0,1,0
28182,31705,0,0,86,86,0,1,0,1,0
25253,3389,25253,3389,293,223,70,4,0,3,1
51320,32066,0,0,76,76,0,1,0,1,0
14308,61248,0,0,147,147,0,1,0,1,0
25033,23321,0,0,120,120,0,1,0,1,0
11848,25621,0,0,139,139,0,1,0,1,0
47105,48460,0,0,96,96,0,1,0,1,0
13326,3389,13326,3389,293,223,70,4,0,3,1
19224,18970,0,0,70,70,0,1,0,1,0
13333,3389,13333,3389,293,223,70,4,0,3,1
51147,31652,0,0,82,82,0,1,0,1,0
34508,60612,0,0,108,108,0,1,0,1,0
52284,33150,0,0,62,62,0,1,0,1,0
27846,34021,0,0,62,62,0,1,0,1,0
16483,19555,0,0,78,78,0,1,0,1,0
34328,7700,0,0,134,134,0,1,0,1,0
49160,32754,0,0,146,146,0,1,0,1,0
22678,34021,0,0,62,62,0,1,0,1,0
14089,25773,0,0,140,140,0,1,0,1,0
17807,3389,17807,3389,293,223,70,4,0,3,1
12372,53755,0,0,152,152,0,1,0,1,0
42811,34021,0,0,118,118,0,1,0,1,0
21184,25773,0,0,144,144,0,1,0,1,0
12971,61248,0,0,145,145,0,1,0,1,0
13480,9476,3074,950,188,169,19,1,0,1,0
20497,1125,3640,1125,138,115,23,1,0,1,0
14408,3389,14408,3389,293,223,70,4,0,3,1
18168,20928,0,0,90,90,0,1,0,1,0
16973,3389,16973,3389,293,223,70,4,0,3,1
12016,25773,0,0,139,139,0,1,0,1,0
24010,25773,0,0,145,145,0,1,0,1,0
50265,32776,0,0,107,107,0,1,0,1,0
43038,60174,0,0,72,72,0,1,0,1,0
50819,34021,0,0,105,105,0,1,0,1,0
19050,3389,19050,3389,293,223,70,4,0,3,1
7897,24246,0,0,146,146,0,1,0,1,0
53353,12533,0,0,149,149,0,1,0,1,0
12005,61248,0,0,140,140,0,1,0,1,0
11195,3389,11195,3389,293,223,70,4,1,3,1
22462,21395,0,0,98,98,0,1,0,1,0
17136,25773,0,0,144,144,0,1,0,1,0
40676,8151,0,0,145,145,0,1,0,1,0
6891,53112,0,0,142,142,0,1,0,1,0
34495,34021,0,0,81,81,0,1,0,1,0
20799,3389,20799,3389,293,223,70,4,0,3,1
10594,61248,0,0,143,143,0,1,0,1,0
29755,34021,0,0,62,62,0,1,0,1,0
22719,34021,0,0,62,62,0,1,0,1,0
2681,37493,0,0,144,144,0,1,0,1,0
51571,34021,0,0,86,86,0,1,0,1,0
48982,27580,0,0,153,153,0,1,0,1,0
49499,31887,0,0,137,137,0,1,0,1,0
28223,29751,0,0,106,106,0,1,0,1,0
59976,32545,0,0,62,62,0,1,0,1,0
32683,3389,32683,3389,293,223,70,4,0,3,1
29668,32606,0,0,76,76,0,1,0,1,0
37595,3389,37595,3389,293,223,70,4,1,3,1
19370,3389,19370,3389,293,223,70,4,0,3,1
38716,3389,38716,3389,293,223,70,4,0,3,1
15629,3389,15629,3389,293,223,70,4,0,3,1
50041,32262,0,0,124,124,0,1,0,1,0
24189,34021,0,0,62,62,0,1,0,1,0
14705,3389,14705,3389,293,223,70,4,0,3,1
58131,61060,0,0,132,132,0,1,0,1,0
50407,29516,0,0,102,102,0,1,0,1,0
18239,18657,0,0,66,66,0,1,0,1,0
20196,61248,0,0,156,156,0,1,0,1,0
18757,3389,18757,3389,293,223,70,4,0,3,1
53875,17650,0,0,106,106,0,1,0,1,0
6045,57391,0,0,140,140,0,1,0,1,0
29070,29606,0,0,108,108,0,1,0,1,0
17256,1895,6131,1894,191,152,39,2,0,2,0
2941,24854,0,0,146,146,0,1,0,1,0
38431,8530,0,0,145,145,0,1,0,1,0
44254,60111,0,0,67,67,0,1,0,1,0
33196,60679,0,0,113,113,0,1,0,1,0
49621,33501,0,0,129,129,0,1,0,1,0
11430,25773,0,0,142,142,0,1,0,1,0
50402,32622,0,0,102,102,0,1,0,1,0
51680,31450,0,0,65,65,0,1,0,1,0
10156,3389,10156,3389,293,223,70,4,1,3,1
24853,23187,0,0,118,118,0,1,0,1,0
54713,31652,0,0,62,62,0,1,0,1,0
48108,40252,0,0,120,120,0,1,0,1,0
20224,39485,0,0,78,78,0,1,0,1,0
10214,59410,0,0,143,143,0,1,0,1,0
42090,9433,0,0,148,148,0,1,0,1,0
8658,55778,0,0,141,141,0,1,0,1,0
10181,61248,0,0,142,142,0,1,0,1,0
49042,28969,0,0,151,151,0,1,0,1,0
38290,3389,38290,3389,293,223,70,4,1,3,1
48919,25809,0,0,156,156,0,1,0,1,0
31589,5381,0,0,112,112,0,1,0,1,0
11452,3389,11452,3389,293,223,70,4,0,3,1
57270,5192,12230,647,173,159,13,1,0,1,0
11673,3389,11673,3389,293,223,70,4,1,3,1
35385,3389,35385,3389,293,223,70,4,0,3,1
15875,61248,0,0,149,149,0,1,0,1,0
57878,61039,0,0,130,130,0,1,0,1,0
18663,25773,0,0,143,143,0,1,0,1,0
6104,24661,0,0,157,157,0,1,0,1,0
16008,3389,16008,3389,293,223,70,4,0,3,1
49651,33467,0,0,128,128,0,1,0,1,0
60946,4209,40460,2142,238,194,44,2,0,2,0
10939,61248,0,0,142,142,0,1,0,1,0
51378,31652,0,0,69,69,0,1,0,1,0
11676,3389,11676,3389,293,223,70,4,1,3,1
20843,32710,0,0,74,74,0,1,0,1,0
59048,31652,0,0,66,66,0,1,0,1,0
14676,3389,14676,3389,293,223,70,4,0,3,1
3524,25834,0,0,143,143,0,1,0,1,0
28145,33502,0,0,67,67,0,1,0,1,0
52232,32997,0,0,62,62,0,1,0,1,0
8358,61248,0,0,139,139,0,1,0,1,0
35705,3853,0,0,119,119,0,1,0,1,0
50308,32448,0,0,117,117,0,1,0,1,0
6572,30905,0,0,153,153,0,1,0,1,0
29525,3389,29525,3389,293,223,70,4,0,3,1
13125,26456,0,0,132,132,0,1,0,1,0
12000,61248,0,0,140,140,0,1,0,1,0
30565,3389,30565,3389,293,223,70,4,1,3,1
49564,31652,0,0,133,133,0,1,0,1,0
27590,34021,0,0,62,62,0,1,0,1,0
25954,34021,0,0,62,62,0,1,0,1,0
51718,31652,0,0,63,63,0,1,0,1,0
51085,31652,0,0,84,84,0,1,0,1,0
55684,31652,0,0,110,110,0,1,0,1,0
51571,31652,0,0,66,66,0,1,0,1,0
16354,61248,0,0,150,150,0,1,0,1,0
49160,32857,0,0,146,146,0,1,0,1,0
15896,25773,0,0,141,141,0,1,0,1,0
9940,25773,0,0,140,140,0,1,0,1,0
48936,26539,0,0,155,155,0,1,0,1,0
9487,3389,9487,3389,293,223,70,4,1,3,1
11831,3389,11831,3389,293,223,70,4,1,3,1
12589,8871,3217,1192,199,174,24,2,0,1,0
18100,18433,0,0,63,63,0,1,0,1,0
18070,24048,0,0,124,124,0,1,0,1,0
52238,33014,0,0,62,62,0,1,0,1,0
44661,60090,0,0,66,66,0,1,0,1,0
17212,61248,0,0,151,151,0,1,0,1,0
20275,27333,0,0,127,127,0,1,0,1,0
17792,24896,0,0,143,143,0,1,0,1,0
28289,2587,0,0,86,86,0,1,0,1,0
17926,3389,17926,3389,293,223,70,4,0,3,1
26964,3389,26964,3389,293,223,70,4,0,3,1
18659,3389,18659,3389,293,223,70,4,0,3,1
50238,28503,0,0,112,112,0,1,0,1,0
20531,30064,0,0,98,98,0,1,0,1,0
20328,3389,20328,3389,293,223,70,4,0,3,1
16839,3389,16839,3389,293,223,70,4,0,3,1
50390,28812,0,0,107,107,0,1,0,1,0
12538,25773,0,0,139,139,0,1,0,1,0
49160,33568,0,0,146,146,0,1,0,1,0
15803,3389,15803,3389,293,223,70,4,0,3,1
40673,8151,0,0,145,145,0,1,0,1,0
49739,27650,0,0,135,135,0,1,0,1,0
13528,17800,0,0,144,144,0,1,0,1,0
56786,3389,56786,3389,293,223,70,4,0,3,1
3468,49895,0,0,143,143,0,1,0,1,0
11996,7929,4235,1569,215,182,32,2,0,1,0
28278,27051,0,0,134,134,0,1,0,1,0
38452,3389,38452,3389,293,223,70,4,1,3,1
53371,12481,0,0,149,149,0,1,0,1,0
21873,3389,21873,3389,293,223,70,4,0,3,1
28625,34021,0,0,62,62,0,1,0,1,0
10896,25773,0,0,144,144,0,1,0,1,0
14920,3389,14920,3389,293,223,70,4,0,3,1
42424,3389,42424,3389,293,223,70,4,0,3,1
51720,32473,0,0,68,68,0,1,0,1,0
52016,33007,0,0,66,66,0,1,0,1,0
51791,31689,0,0,62,62,0,1,0,1,0
27289,3389,27289,3389,293,223,70,4,0,3,1
8455,25773,0,0,156,156,0,1,0,1,0
55990,31652,0,0,62,62,0,1,0,1,0
21868,35469,0,0,66,66,0,1,0,1,0
49124,30830,0,0,147,147,0,1,0,1,0
28263,27777,0,0,127,127,0,1,0,1,0
12465,3389,12465,3389,293,223,70,4,1,3,1
18823,25773,0,0,143,143,0,1,0,1,0
7354,25773,0,0,141,141,0,1,0,1,0
51495,31908,0,0,71,71,0,1,0,1,0
16995,3389,16995,3389,293,223,70,4,0,3,1
27863,25442,0,0,144,144,0,1,0,1,0
11934,61248,0,0,140,140,0,1,0,1,0
49641,31652,0,0,129,129,0,1,0,1,0
23013,61202,0,0,155,155,0,1,0,1,0
53534,19932,0,0,99,99,0,1,0,1,0
49245,46607,0,0,62,62,0,1,0,1,0
18217,25773,0,0,143,143,0,1,0,1,0
51503,31652,0,0,67,67,0,1,0,1,0
13173,61248,0,0,145,145,0,1,0,1,0
52155,33259,0,0,65,65,0,1,0,1,0
49044,30306,0,0,150,150,0,1,0,1,0
49866,5618,0,0,145,145,0,1,0,1,0
31885,60746,0,0,118,118,0,1,0,1,0
19661,3389,19661,3389,293,223,70,4,0,3,1
21699,3389,21699,3389,293,223,70,4,0,3,1
37098,3389,37098,3389,293,223,70,4,0,3,1
25959,34021,0,0,62,62,0,1,0,1,0
7955,61248,0,0,139,139,0,1,0,1,0
18520,3389,18520,3389,293,223,70,4,0,3,1
12684,7549,5572,1722,221,186,35,2,0,2,0
26792,3389,26792,3389,293,223,70,4,0,3,1
50431,29577,0,0,101,101,0,1,0,1,0
53354,19324,0,0,106,106,0,1,0,1,0
2606,24330,0,0,148,148,0,1,0,1,0
12707,23058,0,0,140,140,0,1,0,1,0
36031,3389,36031,3389,293,223,70,4,0,3,1
50000,3389,50000,3389,293,223,70,4,0,3,1
15119,61248,0,0,148,148,0,1,0,1,0
5133,24952,0,0,134,134,0,1,0,1,0
19801,3389,19801,3389,293,223,70,4,0,3,1
28309,1132,0,0,78,78,0,1,0,1,0
8587,56699,0,0,143,143,0,1,0,1,0
27777,2153,0,0,82,82,0,1,0,1,0
51238,31652,0,0,79,79,0,1,0,1,0
52056,33080,0,0,65,65,0,1,0,1,0
5264,23330,0,0,150,150,0,1,0,1,0
50857,19959,0,0,153,153,0,1,0,1,0
11426,3389,11426,3389,293,223,70,4,1,3,1
16567,15402,0,0,100,100,0,1,0,1,0
38097,34021,0,0,97,97,0,1,0,1,0
15381,3389,15381,3389,293,223,70,4,0,3,1
12049,3389,12049,3389,293,223,70,4,1,3,1
49187,33989,0,0,145,145,0,1,0,1,0
22489,33981,0,0,62,62,0,1,0,1,0
51143,39439,0,0,62,62,0,1,0,1,0
52936,5618,0,0,145,145,0,1,0,1,0
62690,31652,0,0,62,62,0,1,0,1,0
25064,14647,0,0,94,94,0,1,0,1,0
11565,25773,0,0,152,152,0,1,0,1,0
51471,31652,0,0,67,67,0,1,0,1,0
3716,50617,0,0,143,143,0,1,0,1,0
22683,21561,0,0,99,99,0,1,0,1,0
10107,61248,0,0,141,141,0,1,0,1,0
45812,59122,0,0,64,64,0,1,0,1,0
5208,22819,0,0,153,153,0,1,0,1,0
12578,25773,0,0,139,139,0,1,0,1,0
24378,34021,0,0,62,62,0,1,0,1,0
1052,21869,0,0,157,157,0,1,0,1,0
15527,3389,15527,3389,293,223,70,4,0,3,1
28564,3389,28564,3389,293,223,70,4,0,3,1
11554,61248,0,0,142,142,0,1,0,1,0
20618,3389,20618,3389,293,223,70,4,0,3,1
62150,31652,0,0,63,63,0,1,0,1,0
11897,61248,0,0,139,139,0,1,0,1,0
44343,3389,44343,3389,293,223,70,4,0,3,1
13266,8960,3743,1156,197,173,23,2,0,1,0
53919,3389,53919,3389,293,223,70,4,0,3,1
51616,31862,0,0,86,86,0,1,0,1,0
9186,56573,0,0,140,140,0,1,0,1,0
21956,3389,21956,3389,293,223,70,4,0,3,1
11740,3389,11740,3389,293,223,70,4,1,3,1
17734,17369,0,0,73,73,0,1,0,1,0
15979,61248,0,0,149,149,0,1,0,1,0
14996,3389,14996,3389,293,223,70,4,0,3,1
24525,31106,0,0,92,92,0,1,0,1,0
17785,3389,17785,3389,293,223,70,4,0,3,1
23843,34021,0,0,62,62,0,1,0,1,0
12087,61248,0,0,139,139,0,1,0,1,0
50677,3389,50677,3389,293,223,70,4,0,3,1
14933,3389,14933,3389,293,223,70,4,0,3,1
3909,23448,0,0,157,157,0,1,0,1,0
4523,49540,0,0,143,143,0,1,0,1,0
50141,32916,0,0,111,111,0,1,0,1,0
51331,31222,0,0,94,94,0,1,0,1,0
15951,14363,0,0,114,114,0,1,0,1,0
10277,61248,0,0,142,142,0,1,0,1,0
14826,3389,14826,3389,293,223,70,4,0,3,1
11519,61248,0,0,142,142,0,1,0,1,0
7811,25773,0,0,141,141,0,1,0,1,0
5575,51126,0,0,142,142,0,1,0,1,0
21659,3389,21659,3389,293,223,70,4,0,3,1
13738,21595,0,0,104,104,0,1,0,1,0
16338,3389,16338,3389,293,223,70,4,0,3,1
51635,3389,51635,3389,293,223,70,4,0,3,1
23671,30382,0,0,97,97,0,1,0,1,0
20576,3389,20576,3389,293,223,70,4,0,3,1
14318,11623,242,89,151,149,1,1,0,1,0
55606,5618,0,0,145,145,0,1,0,1,0
18587,26832,0,0,132,132,0,1,0,1,0
56210,60902,0,0,121,121,0,1,0,1,0
51335,34021,0,0,92,92,0,1,0,1,0
25625,34021,0,0,62,62,0,1,0,1,0
50073,28166,0,0,118,118,0,1,0,1,0
13843,15787,0,0,145,145,0,1,0,1,0
17832,1986,7385,1985,197,156,41,2,0,2,0
10655,24075,0,0,149,149,0,1,0,1,0
8364,23546,0,0,150,150,0,1,0,1,0
39699,3389,39699,3389,293,223,70,4,0,3,1
51775,32572,0,0,68,68,0,1,0,1,0
12995,3389,12995,3389,293,223,70,4,0,3,1
50961,32900,0,0,101,101,0,1,0,1,0
5802,23517,0,0,149,149,0,1,0,1,0
17233,18998,0,0,71,71,0,1,0,1,0
20123,27490,0,0,126,126,0,1,0,1,0
40160,5861,0,0,146,146,0,1,0,1,0
48833,60296,0,0,79,79,0,1,0,1,0
51325,34021,0,0,92,92,0,1,0,1,0
51665,31652,0,0,65,65,0,1,0,1,0
11876,61248,0,0,140,140,0,1,0,1,0
10848,25773,0,0,145,145,0,1,0,1,0
51306,60499,0,0,93,93,0,1,0,1,0
26619,28151,0,0,123,123,0,1,0,1,0
20071,29586,0,0,105,105,0,1,0,1,0
23092,34021,0,0,62,62,0,1,0,1,0
8524,23583,0,0,150,150,0,1,0,1,0
59577,61178,0,0,140,140,0,1,0,1,0
7662,61248,0,0,139,139,0,1,0,1,0
63737,3389,63737,3389,293,223,70,4,0,3,1
9408,3389,9408,3389,293,223,70,4,1,3,1
16959,25773,0,0,142,142,0,1,0,1,0
4850,25773,0,0,142,142,0,1,0,1,0
9762,25773,0,0,149,149,0,1,0,1,0
20188,61248,0,0,156,156,0,1,0,1,0
33124,10396,0,0,133,133,0,1,0,1,0
17526,2068,7692,2068,202,160,42,2,0,2,0
28284,26778,0,0,137,137,0,1,0,1,0
9685,3389,9685,3389,293,223,70,4,1,3,1
21562,61248,0,0,158,158,0,1,0,1,0
28283,26805,0,0,137,137,0,1,0,1,0
19121,3389,19121,3389,293,223,70,4,0,3,1
52173,16043,0,0,151,151,0,1,0,1,0
7935,24259,0,0,145,145,0,1,0,1,0
21712,3389,21712,3389,293,223,70,4,0,3,1
34872,3547,0,0,115,115,0,1,0,1,0
34148,3389,34148,3389,293,223,70,4,0,3,1
58552,31652,0,0,62,62,0,1,0,1,0
58078,32924,0,0,62,62,0,1,0,1,0
24180,3389,24180,3389,293,223,70,4,0,3,1
20576,3389,20576,3389,293,223,70,4,0,3,1
19102,3389,19102,3389,293,223,70,4,0,3,1
36017,8834,0,0,146,146,0,1,0,1,0
12554,3389,12554,3389,293,223,70,4,1,3,1
3770,19808,0,0,155,155,0,1,0,1,0
7857,61248,0,0,139,139,0,1,0,1,0
49112,26293,0,0,149,149,0,1,0,1,0
51509,32093,0,0,70,70,0,1,0,1,0
11683,13914,0,0,149,149,0,1,0,1,0
54783,11588,0,0,125,125,0,1,0,1,0
45844,58777,0,0,65,65,0,1,0,1,0
19114,3389,19114,3389,293,223,70,4,0,3,1
26413,28442,0,0,120,120,0,1,0,1,0
50641,31652,0,0,93,93,0,1,0,1,0
63716,31767,0,0,66,66,0,1,0,1,0
4019,51499,0,0,142,142,0,1,0,1,0
31241,60780,0,0,121,121,0,1,0,1,0
64055,31652,0,0,64,64,0,1,0,1,0
17924,1736,5618,1736,180,144,35,2,0,2,0
27030,34021,0,0,62,62,0,1,0,1,0
24580,34021,0,0,62,62,0,1,0,1,0
54022,45780,0,0,145,145,0,1,0,1,0
11965,3389,11965,3389,293,223,70,4,1,3,1
62239,47920,0,0,107,107,0,1,0,1,0
51880,31954,0,0,62,62,0,1,0,1,0
16813,44211,0,0,90,90,0,1,0,1,0
27459,34021,0,0,62,62,0,1,0,1,0
51535,33298,0,0,87,87,0,1,0,1,0
50199,32850,0,0,109,109,0,1,0,1,0
50429,29572,0,0,102,102,0,1,0,1,0
16793,3389,16793,3389,293,223,70,4,1,3,1
11584,61248,0,0,141,141,0,1,0,1,0
51332,32055,0,0,76,76,0,1,0,1,0
21612,3389,21612,3389,293,223,70,4,0,3,1
19879,29230,0,0,109,109,0,1,0,1,0
43843,5618,0,0,145,145,0,1,0,1,0
19545,6255,0,0,107,107,0,1,0,1,0
33099,6659,0,0,124,124,0,1,0,1,0
51773,60537,0,0,96,96,0,1,0,1,0
55039,42820,0,0,93,93,0,1,0,1,0
49084,31595,0,0,149,149,0,1,0,1,0
55609,3389,55609,3389,293,223,70,4,0,3,1
22650,614,1985,613,103,91,12,1,0,1,0
11242,3389,11242,3389,293,223,70,4,0,3,1
62341,3389,62341,3389,293,223,70,4,0,3,1
21231,25773,0,0,144,144,0,1,0,1,0
23912,22482,0,0,110,110,0,1,0,1,0
52467,34021,0,0,64,64,0,1,0,1,0
22385,765,2842,764,114,98,15,1,0,1,0
18526,3389,18526,3389,293,223,70,4,0,3,1
24332,34021,0,0,62,62,0,1,0,1,0
13959,21431,0,0,102,102,0,1,0,1,0
25597,3389,25597,3389,293,223,70,4,0,3,1
8868,25773,0,0,153,153,0,1,0,1,0
10125,3389,10125,3389,293,223,70,4,1,3,1
61795,3389,61795,3389,293,223,70,4,0,3,1
5753,24467,0,0,157,157,0,1,0,1,0
20583,3389,20583,3389,293,223,70,4,0,3,1
17625,3389,17625,3389,293,223,70,4,0,3,1
50116,28496,0,0,125,125,0,1,0,1,0
49971,33287,0,0,119,119,0,1,0,1,0
9377,61248,0,0,141,141,0,1,0,1,0
51737,34021,0,0,82,82,0,1,0,1,0
7223,25773,0,0,141,141,0,1,0,1,0
22592,21493,0,0,99,99,0,1,0,1,0
18248,18357,0,0,63,63,0,1,0,1,0
49912,32173,0,0,127,127,0,1,0,1,0
18728,3389,18728,3389,293,223,70,4,0,3,1
19330,3389,19330,3389,293,223,70,4,0,3,1
6964,23921,0,0,147,147,0,1,0,1,0
17831,3389,17831,3389,293,223,70,4,0,3,1
49957,31652,0,0,120,120,0,1,0,1,0
30565,20724,0,0,147,147,0,1,0,1,0
19080,3389,19080,3389,293,223,70,4,0,3,1
52132,32701,0,0,62,62,0,1,0,1,0
3417,23176,0,0,157,157,0,1,0,1,0
17833,17537,0,0,71,71,0,1,0,1,0
49919,28302,0,0,120,120,0,1,0,1,0
36010,3389,36010,3389,293,223,70,4,0,3,1
16553,3389,16553,3389,293,223,70,4,0,3,1
26319,34021,0,0,62,62,0,1,0,1,0
15979,3389,15979,3389,293,223,70,4,1,3,1
12397,6853,6475,2000,233,192,41,2,0,2,0
49160,32303,0,0,146,146,0,1,0,1,0
47589,45795,0,0,107,107,0,1,0,1,0
27424,34021,0,0,62,62,0,1,0,1,0
49160,33935,0,0,146,146,0,1,0,1,0
47464,53337,0,0,62,62,0,1,0,1,0
22809,31250,0,0,87,87,0,1,0,1,0
17499,25773,0,0,142,142,0,1,0,1,0
25799,34021,0,0,62,62,0,1,0,1,0
54462,33200,0,0,116,116,0,1,0,1,0
11534,61248,0,0,142,142,0,1,0,1,0
11359,3389,11359,3389,293,223,70,4,0,3,1
5355,55384,0,0,141,141,0,1,0,1,0
9178,61248,0,0,141,141,0,1,0,1,0
25625,14352,0,0,97,97,0,1,0,1,0
11318,3389,11318,3389,293,223,70,4,1,3,1
34296,15870,0,0,147,147,0,1,0,1,0
9457,61248,0,0,141,141,0,1,0,1,0
28876,28638,0,0,118,118,0,1,0,1,0
10319,61248,0,0,139,139,0,1,0,1,0
11581,3389,11581,3389,293,223,70,4,0,3,1
9983,3389,9983,3389,293,223,70,4,1,3,1
11607,3389,11607,3389,293,223,70,4,1,3,1
13411,10181,1801,667,176,162,13,1,0,1,0
20750,1203,4474,1203,144,119,24,2,0,1,0
36945,34021,0,0,92,92,0,1,0,1,0
34314,3389,34314,3389,293,223,70,4,0,3,1
18197,3389,18197,3389,293,223,70,4,0,3,1
11183,61248,0,0,139,139,0,1,0,1,0
26155,34021,0,0,62,62,0,1,0,1,0
20718,38277,0,0,74,74,0,1,0,1,0
42259,9837,0,0,148,148,0,1,0,1,0
21886,899,3340,898,123,104,18,1,0,1,0
36537,3389,36537,3389,293,223,70,4,0,3,1
38406,3389,38406,3389,293,223,70,4,1,3,1
59071,31652,0,0,62,62,0,1,0,1,0
13058,3389,13058,3389,293,223,70,4,0,3,1
9346,3389,9346,3389,293,223,70,4,1,3,1
14162,11130,930,287,160,154,5,1,0,1,0
28841,3055,0,0,90,90,0,1,0,1,0
33054,6622,0,0,124,124,0,1,0,1,0
35727,3389,35727,3389,293,223,70,4,0,3,1
52760,31652,0,0,126,126,0,1,0,1,0
61065,32177,0,0,80,80,0,1,0,1,0
7610,24146,0,0,146,146,0,1,0,1,0
3530,48271,0,0,144,144,0,1,0,1,0
3355,25501,0,0,143,143,0,1,0,1,0
10317,59581,0,0,143,143,0,1,0,1,0
12248,3389,12248,3389,293,223,70,4,0,3,1
18354,3389,18354,3389,293,223,70,4,0,3,1
17207,3389,17207,3389,293,223,70,4,0,3,1
10888,61248,0,0,142,142,0,1,0,1,0
6180,25773,0,0,143,143,0,1,0,1,0
19920,27325,0,0,127,127,0,1,0,1,0
15911,3389,15911,3389,293,223,70,4,0,3,1
49316,60335,0,0,82,82,0,1,0,1,0
18746,3389,18746,3389,293,223,70,4,0,3,1
51670,31652,0,0,64,64,0,1,0,1,0
18236,18735,0,0,67,67,0,1,0,1,0
40799,5618,0,0,145,145,0,1,0,1,0
22070,3389,22070,3389,293,223,70,4,0,3,1
15629,25773,0,0,141,141,0,1,0,1,0
28301,25920,0,0,146,146,0,1,0,1,0
50591,29224,0,0,101,101,0,1,0,1,0
7724,25773,0,0,141,141,0,1,0,1,0
49160,33658,0,0,146,146,0,1,0,1,0
32840,2799,0,0,103,103,0,1,0,1,0
51590,31267,0,0,68,68,0,1,0,1,0
20112,3389,20112,3389,293,223,70,4,0,3,1
61932,31652,0,0,62,62,0,1,0,1,0
10229,58147,0,0,140,140,0,1,0,1,0
33936,3389,33936,3389,293,223,70,4,1,3,1
48952,25884,0,0,155,155,0,1,0,1,0
17454,29964,0,0,99,99,0,1,0,1,0
28493,26715,0,0,138,138,0,1,0,1,0
19382,41542,0,0,84,84,0,1,0,1,0
40750,6219,0,0,146,146,0,1,0,1,0
51521,31652,0,0,67,67,0,1,0,1,0
62843,3389,62843,3389,293,223,70,4,0,3,1
35777,60547,0,0,102,102,0,1,0,1,0
56055,46300,0,0,103,103,0,1,0,1,0
11184,61248,0,0,142,142,0,1,0,1,0
17008,3389,17008,3389,293,223,70,4,0,3,1
48148,60239,0,0,75,75,0,1,0,1,0
38473,3389,38473,3389,293,223,70,4,1,3,1
46222,3389,46222,3389,293,223,70,4,0,3,1
37846,7521,0,0,146,146,0,1,0,1,0
48936,26852,0,0,155,155,0,1,0,1,0
13685,3389,13685,3389,293,223,70,4,0,3,1
47646,45366,0,0,109,109,0,1,0,1,0
23071,21852,0,0,103,103,0,1,0,1,0
17764,3389,17764,3389,293,223,70,4,0,3,1
17028,19785,0,0,77,77,0,1,0,1,0
50711,29469,0,0,97,97,0,1,0,1,0
21147,27936,0,0,121,121,0,1,0,1,0
28250,28426,0,0,120,120,0,1,0,1,0
25490,25773,0,0,146,146,0,1,0,1,0
21655,28287,0,0,118,118,0,1,0,1,0
58667,55247,0,0,128,128,0,1,0,1,0
17272,3389,17272,3389,293,223,70,4,0,3,1
11023,25773,0,0,144,144,0,1,0,1,0
53944,39069,0,0,82,82,0,1,0,1,0
51377,31855,0,0,71,71,0,1,0,1,0
21161,3389,21161,3389,293,223,70,4,0,3,1
12598,3389,12598,3389,293,223,70,4,1,3,1
31382,3389,31382,3389,293,223,70,4,0,3,1
33332,3389,33332,3389,293,223,70,4,1,3,1
7789,25592,0,0,157,157,0,1,0,1,0
51727,31652,0,0,63,63,0,1,0,1,0
24346,31359,0,0,89,89,0,1,0,1,0
11677,61248,0,0,141,141,0,1,0,1,0
16158,61248,0,0,146,146,0,1,0,1,0
11563,61248,0,0,141,141,0,1,0,1,0
49014,29348,0,0,152,152,0,1,0,1,0
15752,21395,0,0,94,94,0,1,0,1,0
5422,25773,0,0,142,142,0,1,0,1,0
34981,34021,0,0,83,83,0,1,0,1,0
49950,31652,0,0,118,118,0,1,0,1,0
18234,18796,0,0,67,67,0,1,0,1,0
9374,58010,0,0,143,143,0,1,0,1,0
29487,3389,29487,3389,293,223,70,4,0,3,1
2286,42953,0,0,144,144,0,1,0,1,0
15771,3389,15771,3389,293,223,70,4,0,3,1
35537,60559,0,0,103,103,0,1,0,1,0
24595,22993,0,0,116,116,0,1,0,1,0
9216,24705,0,0,143,143,0,1,0,1,0
34495,3389,34495,3389,293,223,70,4,0,3,1
50801,31652,0,0,93,93,0,1,0,1,0
9838,25773,0,0,140,140,0,1,0,1,0
51271,31089,0,0,95,95,0,1,0,1,0
6135,32357,0,0,153,153,0,1,0,1,0
13652,3389,13652,3389,293,223,70,4,0,3,1
11587,53640,0,0,117,117,0,1,0,1,0
28808,28298,0,0,121,121,0,1,0,1,0
34305,3389,34305,3389,293,223,70,4,0,3,1
43757,3389,43757,3389,293,223,70,4,0,3,1
13318,3389,13318,3389,293,223,70,4,0,3,1
49627,34021,0,0,134,134,0,1,0,1,0
27379,25079,0,0,140,140,0,1,0,1,0
52581,34401,0,0,69,69,0,1,0,1,0
50873,32839,0,0,103,103,0,1,0,1,0
10257,3389,10257,3389,293,223,70,4,1,3,1
49115,30627,0,0,147,147,0,1,0,1,0
24197,31972,0,0,81,81,0,1,0,1,0
2208,46231,0,0,144,144,0,1,0,1,0
13905,3389,13905,3389,293,223,70,4,0,3,1
49352,33991,0,0,144,144,0,1,0,1,0
46114,58433,0,0,62,62,0,1,0,1,0
6793,25773,0,0,152,152,0,1,0,1,0
20600,3389,20600,3389,293,223,70,4,0,3,1
18683,26233,0,0,138,138,0,1,0,1,0
20903,4762,0,0,96,96,0,1,0,1,0
21549,61248,0,0,157,157,0,1,0,1,0
27867,25773,0,0,147,147,0,1,0,1,0
18914,31146,0,0,88,88,0,1,0,1,0
5672,24422,0,0,157,157,0,1,0,1,0
14845,22539,0,0,105,105,0,1,0,1,0
38538,3389,38538,3389,293,223,70,4,1,3,1
39243,3389,39243,3389,293,223,70,4,0,3,1
50206,32842,0,0,109,109,0,1,0,1,0
14111,3389,14111,3389,293,223,70,4,0,3,1
11098,6499,5781,2142,239,195,44,2,0,2,0
16518,20429,0,0,84,84,0,1,0,1,0
33944,9963,0,0,136,136,0,1,0,1,0
14406,61248,0,0,143,143,0,1,0,1,0
36992,8134,0,0,146,146,0,1,0,1,0
12439,22560,0,0,116,116,0,1,0,1,0
3963,39579,0,0,148,148,0,1,0,1,0
51287,31693,0,0,71,71,0,1,0,1,0
49112,30564,0,0,148,148,0,1,0,1,0
10072,3389,10072,3389,293,223,70,4,1,3,1
49894,31652,0,0,122,122,0,1,0,1,0
11122,6537,5740,2127,239,195,43,2,0,2,0
31354,3389,31354,3389,293,223,70,4,0,3,1
29665,22733,0,0,147,147,0,1,0,1,0
52415,27398,0,0,75,75,0,1,0,1,0
9989,3389,9989,3389,293,223,70,4,1,3,1
32114,5825,0,0,116,116,0,1,0,1,0
8032,26050,0,0,156,156,0,1,0,1,0
29005,34021,0,0,62,62,0,1,0,1,0
19991,3389,19991,3389,293,223,70,4,0,3,1
41707,5618,0,0,145,145,0,1,0,1,0
3321,25447,0,0,144,144,0,1,0,1,0
20320,3389,20320,3389,293,223,70,4,0,3,1
51540,33301,0,0,87,87,0,1,0,1,0
16607,25773,0,0,142,142,0,1,0,1,0
34870,8159,0,0,138,138,0,1,0,1,0
4826,53846,0,0,141,141,0,1,0,1,0
19893,25773,0,0,143,143,0,1,0,1,0
51435,31652,0,0,133,133,0,1,0,1,0
15757,3389,15757,3389,293,223,70,4,0,3,1
11509,25773,0,0,142,142,0,1,0,1,0
13950,3389,13950,3389,293,223,70,4,0,3,1
52144,41237,0,0,145,145,0,1,0,1,0
18697,3389,18697,3389,293,223,70,4,0,3,1
55101,42782,0,0,88,88,0,1,0,1,0
8462,56490,0,0,143,143,0,1,0,1,0
18391,3389,18391,3389,293,223,70,4,0,3,1
6731,59385,0,0,139,139,0,1,0,1,0
2801,22836,0,0,157,157,0,1,0,1,0
51122,30309,0,0,83,83,0,1,0,1,0
28191,3389,28191,3389,293,223,70,4,0,3,1
28174,25957,0,0,146,146,0,1,0,1,0
49518,33617,0,0,133,133,0,1,0,1,0
19108,3389,19108,3389,293,223,70,4,0,3,1
2447,46134,0,0,145,145,0,1,0,1,0
16494,3389,16494,3389,293,223,70,4,0,3,1
13459,10257,1719,637,175,162,13,1,0,1,0
21026,60400,0,0,158,158,0,1,0,1,0
50951,29960,0,0,89,89,0,1,0,1,0
17077,61248,0,0,152,152,0,1,0,1,0
13937,25773,0,0,148,148,0,1,0,1,0
9159,57653,0,0,143,143,0,1,0,1,0
57534,51232,0,0,114,114,0,1,0,1,0
21529,25773,0,0,144,144,0,1,0,1,0
58834,3389,58834,3389,293,223,70,4,0,3,1
36560,4168,0,0,124,124,0,1,0,1,0
50930,31652,0,0,89,89,0,1,0,1,0
19957,29374,0,0,107,107,0,1,0,1,0
62210,32100,0,0,62,62,0,1,0,1,0
20305,3389,20305,3389,293,223,70,4,0,3,1
15123,3389,15123,3389,293,223,70,4,0,3,1
58151,53375,0,0,121,121,0,1,0,1,0
57832,31652,0,0,98,98,0,1,0,1,0
49160,32810,0,0,146,146,0,1,0,1,0
16395,19621,0,0,79,79,0,1,0,1,0
6183,57790,0,0,140,140,0,1,0,1,0
27171,34021,0,0,62,62,0,1,0,1,0
38639,6953,0,0,146,146,0,1,0,1,0
27472,60973,0,0,137,137,0,1,0,1,0
57430,61002,0,0,128,128,0,1,0,1,0
15888,19998,0,0,84,84,0,1,0,1,0
22030,61248,0,0,158,158,0,1,0,1,0
51462,31652,0,0,68,68,0,1,0,1,0
22586,33844,0,0,63,63,0,1,0,1,0
12057,3389,12057,3389,293,223,70,4,0,3,1
19654,3389,19654,3389,293,223,70,4,0,3,1
10016,25773,0,0,154,154,0,1,0,1,0
18120,22455,0,0,107,107,0,1,0,1,0
5839,56792,0,0,140,140,0,1,0,1,0
50516,29070,0,0,103,103,0,1,0,1,0
5640,25773,0,0,143,143,0,1,0,1,0
10854,3389,10854,3389,293,223,70,4,1,3,1
17398,25773,0,0,143,143,0,1,0,1,0
12250,61248,0,0,139,139,0,1,0,1,0
19105,1644,6115,1644,174,140,33,2,0,1,0
49299,34021,0,0,142,142,0,1,0,1,0
11505,25773,0,0,142,142,0,1,0,1,0
16261,14887,0,0,107,107,0,1,0,1,0
15327,3389,15327,3389,293,223,70,4,0,3,1
59591,3389,59591,3389,293,223,70,4,0,3,1
7242,60871,0,0,139,139,0,1,0,1,0
20859,38304,0,0,74,74,0,1,0,1,0
32047,60738,0,0,118,118,0,1,0,1,0
19501,6303,0,0,107,107,0,1,0,1,0
10687,5845,6488,2404,250,201,49,3,0,2,0
26633,3389,26633,3389,293,223,70,4,1,3,1
19478,17595,0,0,67,67,0,1,0,1,0
37027,3389,37027,3389,293,223,70,4,1,3,1
49160,32523,0,0,146,146,0,1,0,1,0
18340,1850,6879,1849,188,149,38,2,0,2,0
49910,33176,0,0,119,119,0,1,0,1,0
17268,18973,0,0,71,71,0,1,0,1,0
2788,24615,0,0,147,147,0,1,0,1,0
5164,50506,0,0,143,143,0,1,0,1,0
11098,61248,0,0,144,144,0,1,0,1,0
48930,26391,0,0,155,155,0,1,0,1,0
54493,5618,0,0,145,145,0,1,0,1,0
17340,25773,0,0,143,143,0,1,0,1,0
12153,6262,7242,2237,243,197,46,2,0,2,0
49160,32565,0,0,146,146,0,1,0,1,0
2525,46525,0,0,144,144,0,1,0,1,0
50493,33814,0,0,138,138,0,1,0,1,0
20460,3389,20460,3389,293,223,70,4,0,3,1
15174,25773,0,0,141,141,0,1,0,1,0
55534,6464,0,0,142,142,0,1,0,1,0
50080,34021,0,0,123,123,0,1,0,1,0
13314,10026,1969,729,179,164,15,1,0,1,0
49415,26923,0,0,143,143,0,1,0,1,0
49382,31652,0,0,138,138,0,1,0,1,0
22413,3389,22413,3389,293,223,70,4,0,3,1
51241,31022,0,0,96,96,0,1,0,1,0
11713,3389,11713,3389,293,223,70,4,0,3,1
49515,31898,0,0,137,137,0,1,0,1,0
47655,22780,0,0,155,155,0,1,0,1,0
56352,47127,0,0,101,101,0,1,0,1,0
13798,25773,0,0,140,140,0,1,0,1,0
49275,33916,0,0,142,142,0,1,0,1,0
49031,29897,0,0,151,151,0,1,0,1,0
29136,34021,0,0,62,62,0,1,0,1,0
24718,30835,0,0,95,95,0,1,0,1,0
11167,61248,0,0,142,142,0,1,0,1,0
2149,23615,0,0,150,150,0,1,0,1,0
18062,18382,0,0,63,63,0,1,0,1,0
49801,27610,0,0,127,127,0,1,0,1,0
9523,61248,0,0,139,139,0,1,0,1,0
20465,61248,0,0,155,155,0,1,0,1,0
56179,31652,0,0,62,62,0,1,0,1,0
18886,3389,18886,3389,293,223,70,4,0,3,1
34259,12473,0,0,146,146,0,1,0,1,0
49450,31652,0,0,135,135,0,1,0,1,0
6023,25773,0,0,141,141,0,1,0,1,0
57674,61022,0,0,129,129,0,1,0,1,0
48967,27852,0,0,154,154,0,1,0,1,0
28185,31547,0,0,87,87,0,1,0,1,0
51794,28529,0,0,80,80,0,1,0,1,0
11461,61248,0,0,139,139,0,1,0,1,0
53388,20904,0,0,96,96,0,1,0,1,0
36185,4030,0,0,122,122,0,1,0,1,0
19732,6049,0,0,105,105,0,1,0,1,0
33668,7141,0,0,128,128,0,1,0,1,0
40952,3389,40952,3389,293,223,70,4,0,3,1
7173,25773,0,0,154,154,0,1,0,1,0
43238,5618,0,0,145,145,0,1,0,1,0
46082,57097,0,0,71,71,0,1,0,1,0
18628,7263,0,0,114,114,0,1,0,1,0
51229,31691,0,0,73,73,0,1,0,1,0
14274,3389,14274,3389,293,223,70,4,0,3,1
42577,60197,0,0,74,74,0,1,0,1,0
9549,24707,0,0,143,143,0,1,0,1,0
13637,61248,0,0,147,147,0,1,0,1,0
16829,3389,16829,3389,293,223,70,4,0,3,1
29087,34021,0,0,62,62,0,1,0,1,0
48944,27091,0,0,155,155,0,1,0,1,0
13528,21751,0,0,106,106,0,1,0,1,0
21013,3389,21013,3389,293,223,70,4,0,3,1
18191,20184,0,0,82,82,0,1,0,1,0
37202,60473,0,0,96,96,0,1,0,1,0
2207,23705,0,0,150,150,0,1,0,1,0
56087,3389,56087,3389,293,223,70,4,0,3,1
36322,8615,0,0,146,146,0,1,0,1,0
21959,28987,0,0,111,111,0,1,0,1,0
18391,3389,18391,3389,293,223,70,4,0,3,1
30455,60820,0,0,124,124,0,1,0,1,0
20418,3389,20418,3389,293,223,70,4,0,3,1
12063,25773,0,0,139,139,0,1,0,1,0
31282,2226,0,0,95,95,0,1,0,1,0
11937,5738,7920,2447,252,202,50,3,0,2,0
39080,6636,0,0,146,146,0,1,0,1,0
6900,25773,0,0,141,141,0,1,0,1,0
54794,31652,0,0,69,69,0,1,0,1,0
51572,31230,0,0,68,68,0,1,0,1,0
9502,61248,0,0,141,141,0,1,0,1,0
21322,3389,21322,3389,293,223,70,4,0,3,1
10400,61248,0,0,142,142,0,1,0,1,0
24635,23023,0,0,116,116,0,1,0,1,0
12250,61248,0,0,139,139,0,1,0,1,0
24571,3389,24571,3389,293,223,70,4,1,3,1
29007,24204,0,0,147,147,0,1,0,1,0
19290,28137,0,0,119,119,0,1,0,1,0
15187,25773,0,0,147,147,0,1,0,1,0
12932,21618,0,0,141,141,0,1,0,1,0
23663,34021,0,0,62,62,0,1,0,1,0
21281,3389,21281,3389,293,223,70,4,0,3,1
50908,30765,0,0,84,84,0,1,0,1,0
3932,48942,0,0,144,144,0,1,0,1,0
18100,23108,0,0,114,114,0,1,0,1,0
47442,45702,0,0,104,104,0,1,0,1,0
12351,25333,0,0,139,139,0,1,0,1,0
49009,29177,0,0,152,152,0,1,0,1,0
16456,3389,16456,3389,293,223,70,4,0,3,1
29375,34021,0,0,62,62,0,1,0,1,0
11424,4496,9531,2945,274,213,60,3,0,2,0
26781,27922,0,0,125,125,0,1,0,1,0
51696,33409,0,0,83,83,0,1,0,1,0
17635,25773,0,0,142,142,0,1,0,1,0
25175,34021,0,0,62,62,0,1,0,1,0
9777,24900,0,0,143,143,0,1,0,1,0
14632,12140,0,0,144,144,0,1,0,1,0
33503,3389,33503,3389,293,223,70,4,0,3,1
49160,31720,0,0,146,146,0,1,0,1,0
20152,5587,0,0,102,102,0,1,0,1,0
4916,50581,0,0,144,144,0,1,0,1,0
25000,3389,25000,3389,293,223,70,4,0,3,1
49701,34021,0,0,132,132,0,1,0,1,0
15788,61248,0,0,150,150,0,1,0,1,0
49458,33684,0,0,135,135,0,1,0,1,0
51307,33140,0,0,93,93,0,1,0,1,0
51188,30444,0,0,81,81,0,1,0,1,0
51463,31652,0,0,68,68,0,1,0,1,0
16458,9649,0,0,132,132,0,1,0,1,0
49121,30777,0,0,147,147,0,1,0,1,0
37151,8020,0,0,146,146,0,1,0,1,0
12060,6038,7531,2327,247,199,48,3,0,2,0
15808,61248,0,0,149,149,0,1,0,1,0
23415,22110,0,0,106,106,0,1,0,1,0
38295,7199,0,0,146,146,0,1,0,1,0
18175,20709,0,0,88,88,0,1,0,1,0
23141,61196,0,0,154,154,0,1,0,1,0
11812,3389,11812,3389,293,223,70,4,1,3,1
18475,3389,18475,3389,293,223,70,4,0,3,1
49025,29699,0,0,151,151,0,1,0,1,0
50475,41962,0,0,62,62,0,1,0,1,0
14912,52462,0,0,116,116,0,1,0,1,0
7425,25773,0,0,154,154,0,1,0,1,0
24453,3389,24453,3389,293,223,70,4,0,3,1
38884,60387,0,0,90,90,0,1,0,1,0
15361,3389,15361,3389,293,223,70,4,0,3,1
46312,7199,0,0,145,145,0,1,0,1,0
64457,31652,0,0,62,62,0,1,0,1,0
24417,31259,0,0,90,90,0,1,0,1,0
35784,60546,0,0,102,102,0,1,0,1,0
27625,3389,27625,3389,293,223,70,4,0,3,1
9844,25773,0,0,149,149,0,1,0,1,0
21715,35842,0,0,67,67,0,1,0,1,0
54663,12392,0,0,123,123,0,1,0,1,0
10828,59051,0,0,139,139,0,1,0,1,0
14869,19971,0,0,80,80,0,1,0,1,0
36048,3980,0,0,121,121,0,1,0,1,0
34478,3389,34478,3389,293,223,70,4,0,3,1
11006,24156,0,0,148,148,0,1,0,1,0
22266,3389,22266,3389,293,223,70,4,0,3,1
62746,3389,62746,3389,293,223,70,4,0,3,1
13347,3389,13347,3389,293,223,70,4,0,3,1
16127,61248,0,0,150,150,0,1,0,1,0
17259,16568,0,0,84,84,0,1,0,1,0
29275,30636,0,0,97,97,0,1,0,1,0
16911,3389,16911,3389,293,223,70,4,0,3,1
17221,16504,0,0,85,85,0,1,0,1,0
28552,34021,0,0,62,62,0,1,0,1,0
50286,28877,0,0,121,121,0,1,0,1,0
50595,32722,0,0,99,99,0,1,0,1,0
43769,7628,0,0,145,145,0,1,0,1,0
34972,3389,34972,3389,293,223,70,4,0,3,1
48925,26507,0,0,156,156,0,1,0,1,0
36299,3389,36299,3389,293,223,70,4,0,3,1
49670,31652,0,0,129,129,0,1,0,1,0
26595,61018,0,0,140,140,0,1,0,1,0
47329,21999,0,0,154,154,0,1,0,1,0
28649,34021,0,0,62,62,0,1,0,1,0
51696,31652,0,0,63,63,0,1,0,1,0
18356,3389,18356,3389,293,223,70,4,0,3,1
48924,26476,0,0,156,156,0,1,0,1,0
49689,33541,0,0,129,129,0,1,0,1,0
56911,52765,0,0,145,145,0,1,0,1,0
10940,59219,0,0,139,139,0,1,0,1,0
10847,25773,0,0,145,145,0,1,0,1,0
56693,3389,56693,3389,293,223,70,4,0,3,1
50361,34021,0,0,116,116,0,1,0,1,0
51385,31652,0,0,69,69,0,1,0,1,0
52470,33827,0,0,62,62,0,1,0,1,0
18750,3389,18750,3389,293,223,70,4,0,3,1
49828,27665,0,0,126,126,0,1,0,1,0
9538,3389,9538,3389,293,223,70,4,1,3,1
22499,34021,0,0,62,62,0,1,0,1,0
20526,3389,20526,3389,293,223,70,4,0,3,1
18224,19109,0,0,71,71,0,1,0,1,0
49712,32034,0,0,132,132,0,1,0,1,0
4568,25773,0,0,146,146,0,1,0,1,0
29564,32084,0,0,82,82,0,1,0,1,0
32456,6115,0,0,119,119,0,1,0,1,0
49154,26336,0,0,150,150,0,1,0,1,0
15278,13230,0,0,129,129,0,1,0,1,0
24104,31923,0,0,81,81,0,1,0,1,0
51730,31652,0,0,62,62,0,1,0,1,0
50187,60407,0,0,87,87,0,1,0,1,0
12988,24883,0,0,129,129,0,1,0,1,0
18202,3389,18202,3389,293,223,70,4,0,3,1
58088,3389,58088,3389,293,223,70,4,0,3,1
14591,61248,0,0,147,147,0,1,0,1,0
47152,3389,47152,3389,293,223,70,4,0,3,1
19141,3389,19141,3389,293,223,70,4,0,3,1
50542,34021,0,0,112,112,0,1,0,1,0
19892,29253,0,0,108,108,0,1,0,1,0
50870,32473,0,0,91,91,0,1,0,1,0
1185,21943,0,0,157,157,0,1,0,1,0
49943,34021,0,0,126,126,0,1,0,1,0
48502,3389,48502,3389,293,223,70,4,0,3,1
51944,60551,0,0,97,97,0,1,0,1,0
19332,3389,19332,3389,293,223,70,4,0,3,1
15346,61248,0,0,145,145,0,1,0,1,0
48260,40763,0,0,124,124,0,1,0,1,0
48646,34021,0,0,143,143,0,1,0,1,0
41521,8067,0,0,147,147,0,1,0,1,0
28198,30961,0,0,93,93,0,1,0,1,0
55846,32985,0,0,109,109,0,1,0,1,0
24526,34021,0,0,62,62,0,1,0,1,0
48041,60231,0,0,75,75,0,1,0,1,0
29900,33768,0,0,64,64,0,1,0,1,0
19145,3389,19145,3389,293,223,70,4,0,3,1
1900,22338,0,0,157,157,0,1,0,1,0
12692,61248,0,0,145,145,0,1,0,1,0
8029,26061,0,0,156,156,0,1,0,1,0
32954,3389,32954,3389,293,223,70,4,0,3,1
21395,32043,0,0,81,81,0,1,0,1,0
18188,20278,0,0,83,83,0,1,0,1,0
28286,26682,0,0,138,138,0,1,0,1,0
51799,34021,0,0,81,81,0,1,0,1,0
36104,8771,0,0,146,146,0,1,0,1,0
2977,48467,0,0,143,143,0,1,0,1,0
17498,16970,0,0,79,79,0,1,0,1,0
31144,21080,0,0,147,147,0,1,0,1,0
17947,3389,17947,3389,293,223,70,4,0,3,1
51583,32226,0,0,69,69,0,1,0,1,0
18205,25926,0,0,141,141,0,1,0,1,0
12860,61248,0,0,140,140,0,1,0,1,0
55866,31652,0,0,62,62,0,1,0,1,0
51777,32577,0,0,68,68,0,1,0,1,0
51294,31652,0,0,71,71,0,1,0,1,0
11478,61248,0,0,142,142,0,1,0,1,0
4515,25773,0,0,142,142,0,1,0,1,0
9275,25773,0,0,151,151,0,1,0,1,0
14859,3389,14859,3389,293,223,70,4,0,3,1
52080,29637,0,0,68,68,0,1,0,1,0
29687,34021,0,0,62,62,0,1,0,1,0
28707,34021,0,0,62,62,0,1,0,1,0
15793,27599,0,0,121,121,0,1,0,1,0
1622,22789,0,0,153,153,0,1,0,1,0
51662,32369,0,0,68,68,0,1,0,1,0
11691,24314,0,0,148,148,0,1,0,1,0
21938,21003,0,0,93,93,0,1,0,1,0
19377,3389,19377,3389,293,223,70,4,0,3,1
9758,3389,9758,3389,293,223,70,4,1,3,1
15852,3389,15852,3389,293,223,70,4,0,3,1
9511,61248,0,0,141,141,0,1,0,1,0
51757,32540,0,0,68,68,0,1,0,1,0
41022,6871,0,0,146,146,0,1,0,1,0
55276,8302,0,0,136,136,0,1,0,1,0
17603,61248,0,0,149,149,0,1,0,1,0
19440,3389,19440,3389,293,223,70,4,0,3,1
7858,61248,0,0,139,139,0,1,0,1,0
13985,10701,1486,459,167,158,9,1,0,1,0
16298,27862,0,0,119,119,0,1,0,1,0
8640,24505,0,0,144,144,0,1,0,1,0
11736,7515,4683,1735,222,186,35,2,0,2,0
52233,3389,52233,3389,293,223,70,4,0,3,1
29721,3799,0,0,97,97,0,1,0,1,0
35988,8942,0,0,145,145,0,1,0,1,0
28191,31256,0,0,90,90,0,1,0,1,0
13839,20498,0,0,86,86,0,1,0,1,0
20031,5721,0,0,103,103,0,1,0,1,0
8064,25744,0,0,157,157,0,1,0,1,0
10987,6323,5971,2213,242,196,45,2,0,2,0
18683,3389,18683,3389,293,223,70,4,0,3,1
35586,8765,0,0,144,144,0,1,0,1,0
29809,33313,0,0,69,69,0,1,0,1,0
49160,33132,0,0,146,146,0,1,0,1,0
11483,25494,0,0,140,140,0,1,0,1,0
49934,33149,0,0,118,118,0,1,0,1,0
53454,31652,0,0,122,122,0,1,0,1,0
50715,29477,0,0,97,97,0,1,0,1,0
29135,3389,29135,3389,293,223,70,4,0,3,1
11401,4441,9602,2967,274,213,61,3,0,2,0
16053,3389,16053,3389,293,223,70,4,0,3,1
50533,5618,0,0,145,145,0,1,0,1,0
5136,25773,0,0,142,142,0,1,0,1,0
26033,25773,0,0,146,146,0,1,0,1,0
50230,31652,0,0,111,111,0,1,0,1,0
21098,60455,0,0,158,158,0,1,0,1,0
43459,3389,43459,3389,293,223,70,4,0,3,1
12559,7245,5966,1843,226,188,38,2,0,2,0
17634,18700,0,0,67,67,0,1,0,1,0
33301,14613,0,0,146,146,0,1,0,1,0
50095,28210,0,0,117,117,0,1,0,1,0
20057,3389,20057,3389,293,223,70,4,0,3,1
20708,3389,20708,3389,293,223,70,4,0,3,1
18058,24449,0,0,128,128,0,1,0,1,0
49638,27603,0,0,130,130,0,1,0,1,0
14862,25773,0,0,147,147,0,1,0,1,0
7572,55008,0,0,143,143,0,1,0,1,0
11469,61248,0,0,142,142,0,1,0,1,0
50967,30911,0,0,82,82,0,1,0,1,0
14934,19938,0,0,80,80,0,1,0,1,0
16259,14883,0,0,107,107,0,1,0,1,0
51446,31652,0,0,68,68,0,1,0,1,0
23132,33072,0,0,71,71,0,1,0,1,0
22475,34001,0,0,62,62,0,1,0,1,0
19330,28210,0,0,119,119,0,1,0,1,0
36729,8323,0,0,146,146,0,1,0,1,0
8259,61248,0,0,139,139,0,1,0,1,0
19541,19208,0,0,73,73,0,1,0,1,0
55238,5618,0,0,145,145,0,1,0,1,0
29047,34021,0,0,62,62,0,1,0,1,0
46719,60122,0,0,67,67,0,1,0,1,0
10164,58048,0,0,140,140,0,1,0,1,0
19757,3389,19757,3389,293,223,70,4,0,3,1
48983,28368,0,0,153,153,0,1,0,1,0
2615,46661,0,0,144,144,0,1,0,1,0
50056,33210,0,0,117,117,0,1,0,1,0
13828,24806,0,0,146,146,0,1,0,1,0
9096,25773,0,0,152,152,0,1,0,1,0
4768,25773,0,0,146,146,0,1,0,1,0
15574,61248,0,0,150,150,0,1,0,1,0
17495,2076,7722,2076,203,160,42,2,0,2,0
6053,24633,0,0,157,157,0,1,0,1,0
49870,31652,0,0,123,123,0,1,0,1,0
63650,3486,61224,3241,286,219,66,3,0,2,0
57512,31652,0,0,100,100,0,1,0,1,0
24053,61149,0,0,151,151,0,1,0,1,0
2796,46934,0,0,144,144,0,1,0,1,0
14437,11796,67,20,148,148,0,1,0,1,0
50353,29382,0,0,104,104,0,1,0,1,0
14919,3389,14919,3389,293,223,70,4,0,3,1
18184,20402,0,0,85,85,0,1,0,1,0
56416,31652,0,0,62,62,0,1,0,1,0
17415,3389,17415,3389,293,223,70,4,0,3,1
51780,33615,0,0,131,131,0,1,0,1,0
4151,49307,0,0,144,144,0,1,0,1,0
46993,50265,0,0,93,93,0,1,0,1,0
18555,7343,0,0,115,115,0,1,0,1,0
20431,38979,0,0,76,76,0,1,0,1,0
19425,3389,19425,3389,293,223,70,4,0,3,1
14514,3389,14514,3389,293,223,70,4,0,3,1
20235,61248,0,0,155,155,0,1,0,1,0
7172,53536,0,0,142,142,0,1,0,1,0
3891,48587,0,0,143,143,0,1,0,1,0
17393,25773,0,0,142,142,0,1,0,1,0
50999,32926,0,0,100,100,0,1,0,1,0
17904,3389,17904,3389,293,223,70,4,0,3,1
29448,34021,0,0,62,62,0,1,0,1,0
12020,60848,0,0,139,139,0,1,0,1,0
15130,12979,0,0,132,132,0,1,0,1,0
50426,34021,0,0,114,114,0,1,0,1,0
51606,31652,0,0,65,65,0,1,0,1,0
18442,3389,18442,3389,293,223,70,4,0,3,1
49112,30574,0,0,148,148,0,1,0,1,0
25209,34021,0,0,62,62,0,1,0,1,0
10696,5860,6472,2398,250,201,49,3,0,2,0
12783,3389,12783,3389,293,223,70,4,0,3,1
51088,31850,0,0,78,78,0,1,0,1,0
50793,40761,0,0,62,62,0,1,0,1,0
21923,61248,0,0,158,158,0,1,0,1,0
52335,3389,52335,3389,293,223,70,4,0,3,1
28593,34021,0,0,62,62,0,1,0,1,0
21899,792,2562,791,115,99,16,1,0,1,0
49160,32330,0,0,146,146,0,1,0,1,0
10182,3389,10182,3389,293,223,70,4,1,3,1
20788,3389,20788,3389,293,223,70,4,0,3,1
24824,3389,24824,3389,293,223,70,4,0,3,1
55464,7046,0,0,140,140,0,1,0,1,0
48925,26492,0,0,156,156,0,1,0,1,0
50099,28218,0,0,117,117,0,1,0,1,0
12381,25773,0,0,139,139,0,1,0,1,0
51761,34021,0,0,82,82,0,1,0,1,0
21404,36848,0,0,69,69,0,1,0,1,0
13309,25773,0,0,139,139,0,1,0,1,0
50760,31652,0,0,89,89,0,1,0,1,0
21632,3389,21632,3389,293,223,70,4,0,3,1
26293,33062,0,0,70,70,0,1,0,1,0
21196,3389,21196,3389,293,223,70,4,0,3,1
20602,3389,20602,3389,293,223,70,4,0,3,1
10285,25773,0,0,139,139,0,1,0,1,0
11789,5380,8385,2591,258,205,53,3,0,2,0
14865,3389,14865,3389,293,223,70,4,0,3,1
54160,60733,0,0,109,109,0,1,0,1,0
51105,31254,0,0,77,77,0,1,0,1,0
11037,52730,0,0,151,151,0,1,0,1,0
18150,21501,0,0,97,97,0,1,0,1,0
19705,1313,4249,1313,151,124,27,2,0,1,0
49738,6620,0,0,145,145,0,1,0,1,0
11255,3389,11255,3389,293,223,70,4,1,3,1
48493,37101,0,0,129,129,0,1,0,1,0
5127,25773,0,0,147,147,0,1,0,1,0
17526,47222,0,0,99,99,0,1,0,1,0
15481,3389,15481,3389,293,223,70,4,0,3,1
46742,5618,0,0,145,145,0,1,0,1,0
24823,23165,0,0,118,118,0,1,0,1,0
62439,3810,51921,2748,265,208,56,3,0,2,0
11670,21608,0,0,98,98,0,1,0,1,0
10837,6084,6230,2309,246,199,47,3,0,2,0
52535,33894,0,0,62,62,0,1,0,1,0
36670,8365,0,0,146,146,0,1,0,1,0
48457,6837,0,0,145,145,0,1,0,1,0
54466,40857,0,0,87,87,0,1,0,1,0
49157,33927,0,0,146,146,0,1,0,1,0
33726,3389,33726,3389,293,223,70,4,0,3,1
50933,30330,0,0,104,104,0,1,0,1,0
52407,31652,0,0,128,128,0,1,0,1,0
51965,32915,0,0,66,66,0,1,0,1,0
9538,61248,0,0,141,141,0,1,0,1,0
17832,3389,17832,3389,293,223,70,4,0,3,1
49059,29361,0,0,150,150,0,1,0,1,0
46032,18887,0,0,153,153,0,1,0,1,0
20249,29916,0,0,102,102,0,1,0,1,0
12026,61248,0,0,140,140,0,1,0,1,0
59891,3389,59891,3389,293,223,70,4,0,3,1
17787,61248,0,0,152,152,0,1,0,1,0
18314,3389,18314,3389,293,223,70,4,0,3,1
49432,33714,0,0,136,136,0,1,0,1,0
28764,3389,28764,3389,293,223,70,4,0,3,1
51281,31652,0,0,71,71,0,1,0,1,0
37221,3389,37221,3389,293,223,70,4,1,3,1
14524,11958,0,0,146,146,0,1,0,1,0
16248,3389,16248,3389,293,223,70,4,0,3,1
51320,39244,0,0,145,145,0,1,0,1,0
18077,23839,0,0,122,122,0,1,0,1,0
17936,3389,17936,3389,293,223,70,4,0,3,1
41778,7965,0,0,145,145,0,1,0,1,0
5514,51578,0,0,144,144,0,1,0,1,0
57417,31652,0,0,100,100,0,1,0,1,0
50444,6501,0,0,145,145,0,1,0,1,0
50654,30131,0,0,93,93,0,1,0,1,0
15350,3389,15350,3389,293,223,70,4,0,3,1
44636,60092,0,0,66,66,0,1,0,1,0
19931,3389,19931,3389,293,223,70,4,0,3,1
51046,32959,0,0,99,99,0,1,0,1,0
49968,31652,0,0,117,117,0,1,0,1,0
9388,3389,9388,3389,293,223,70,4,1,3,1
49286,26634,0,0,147,147,0,1,0,1,0
8175,61248,0,0,139,139,0,1,0,1,0
17373,2109,7844,2109,205,162,43,2,0,2,0
10030,4800,7618,2823,268,210,58,3,0,2,0
20599,3389,20599,3389,293,223,70,4,0,3,1
3581,25773,0,0,143,143,0,1,0,1,0
52033,34021,0,0,75,75,0,1,0,1,0
23594,30319,0,0,98,98,0,1,0,1,0
56176,31652,0,0,68,68,0,1,0,1,0
29319,3389,29319,3389,293,223,70,4,0,3,1
10130,25773,0,0,154,154,0,1,0,1,0
8531,61248,0,0,140,140,0,1,0,1,0
9215,3389,9215,3389,293,223,70,4,1,3,1
16054,61248,0,0,150,150,0,1,0,1,0
51315,30704,0,0,77,77,0,1,0,1,0
52448,33787,0,0,62,62,0,1,0,1,0
41438,60256,0,0,79,79,0,1,0,1,0
33007,6582,0,0,123,123,0,1,0,1,0
18770,3389,18770,3389,293,223,70,4,0,3,1
17649,17226,0,0,75,75,0,1,0,1,0
60193,60465,0,0,142,142,0,1,0,1,0
21150,20413,0,0,86,86,0,1,0,1,0
18283,3389,18283,3389,293,223,70,4,0,3,1
20221,19717,0,0,78,78,0,1,0,1,0
36009,3389,36009,3389,293,223,70,4,1,3,1
27799,944,0,0,76,76,0,1,0,1,0
48994,27877,0,0,153,153,0,1,0,1,0
21515,33254,0,0,69,69,0,1,0,1,0
25164,34021,0,0,62,62,0,1,0,1,0
27411,60976,0,0,137,137,0,1,0,1,0
13674,9947,2464,761,180,164,15,1,0,1,0
21575,3389,21575,3389,293,223,70,4,0,3,1
1813,23088,0,0,152,152,0,1,0,1,0
22786,15849,0,0,83,83,0,1,0,1,0
38298,3389,38298,3389,293,223,70,4,1,3,1
55262,6854,0,0,145,145,0,1,0,1,0
56943,31652,0,0,62,62,0,1,0,1,0
5561,22900,0,0,153,153,0,1,0,1,0
13695,25773,0,0,143,143,0,1,0,1,0
28249,28458,0,0,119,119,0,1,0,1,0
39325,6460,0,0,146,146,0,1,0,1,0
28026,1028,0,0,77,77,0,1,0,1,0
2727,22795,0,0,157,157,0,1,0,1,0
37687,3389,37687,3389,293,223,70,4,0,3,1
23395,34021,0,0,62,62,0,1,0,1,0
17433,47473,0,0,100,100,0,1,0,1,0
50386,32640,0,0,102,102,0,1,0,1,0
49268,26519,0,0,144,144,0,1,0,1,0
13288,61248,0,0,141,141,0,1,0,1,0
52771,35052,0,0,71,71,0,1,0,1,0
2172,44532,0,0,144,144,0,1,0,1,0
12142,6237,7273,2247,244,197,46,2,0,2,0
29541,3389,29541,3389,293,223,70,4,0,3,1
12313,25735,0,0,138,138,0,1,0,1,0
18157,21260,0,0,94,94,0,1,0,1,0
20264,3389,20264,3389,293,223,70,4,0,3,1
13703,3389,13703,3389,293,223,70,4,0,3,1
15717,61248,0,0,149,149,0,1,0,1,0
50393,29483,0,0,103,103,0,1,0,1,0
19638,61248,0,0,155,155,0,1,0,1,0
43244,12199,0,0,149,149,0,1,0,1,0
48925,26285,0,0,156,156,0,1,0,1,0
8806,61248,0,0,140,140,0,1,0,1,0
48962,25894,0,0,155,155,0,1,0,1,0
11103,6507,5772,2139,239,195,44,2,0,2,0
29260,12434,0,0,114,114,0,1,0,1,0
49251,26639,0,0,144,144,0,1,0,1,0
11736,61248,0,0,144,144,0,1,0,1,0
23005,15734,0,0,84,84,0,1,0,1,0
4737,50283,0,0,144,144,0,1,0,1,0
3101,23001,0,0,157,157,0,1,0,1,0
23662,34021,0,0,62,62,0,1,0,1,0
29131,34021,0,0,62,62,0,1,0,1,0
27282,25006,0,0,139,139,0,1,0,1,0
27144,24903,0,0,138,138,0,1,0,1,0
40305,5757,0,0,146,146,0,1,0,1,0
14655,3389,14655,3389,293,223,70,4,0,3,1
12144,3389,12144,3389,293,223,70,4,0,3,1
12744,3389,12744,3389,293,223,70,4,0,3,1
17107,28283,0,0,115,115,0,1,0,1,0
50159,32896,0,0,110,110,0,1,0,1,0
61821,32178,0,0,62,62,0,1,0,1,0
2848,22862,0,0,157,157,0,1,0,1,0
29082,3389,29082,3389,293,223,70,4,0,3,1
59458,3389,59458,3389,293,223,70,4,0,3,1
13183,24636,0,0,127,127,0,1,0,1,0
13507,3389,13507,3389,293,223,70,4,0,3,1
53905,38630,0,0,76,76,0,1,0,1,0
22020,3389,22020,3389,293,223,70,4,0,3,1
51766,32199,0,0,82,82,0,1,0,1,0
49800,27607,0,0,127,127,0,1,0,1,0
41508,60252,0,0,79,79,0,1,0,1,0
16577,3389,16577,3389,293,223,70,4,0,3,1
16833,3389,16833,3389,293,223,70,4,0,3,1
9339,3389,9339,3389,293,223,70,4,0,3,1
49444,6670,0,0,145,145,0,1,0,1,0
6114,25773,0,0,150,150,0,1,0,1,0
12223,24436,0,0,147,147,0,1,0,1,0
10219,3389,10219,3389,293,223,70,4,1,3,1
24741,133,491,132,71,68,2,1,0,1,0
10113,61248,0,0,141,141,0,1,0,1,0
24913,34021,0,0,62,62,0,1,0,1,0
26125,28848,0,0,115,115,0,1,0,1,0
16516,3389,16516,3389,293,223,70,4,0,3,1
15396,20363,0,0,88,88,0,1,0,1,0
32917,3389,32917,3389,293,223,70,4,0,3,1
57118,60976,0,0,126,126,0,1,0,1,0
25766,3389,25766,3389,293,223,70,4,1,3,1
18583,3389,18583,3389,293,223,70,4,0,3,1
16376,25773,0,0,141,141,0,1,0,1,0
1628,22800,0,0,153,153,0,1,0,1,0
2555,47240,0,0,144,144,0,1,0,1,0
5971,52339,0,0,144,144,0,1,0,1,0
43855,3389,43855,3389,293,223,70,4,0,3,1
13406,3389,13406,3389,293,223,70,4,0,3,1
14539,25773,0,0,143,143,0,1,0,1,0
30815,60801,0,0,123,123,0,1,0,1,0
38094,3389,38094,3389,293,223,70,4,1,3,1
24999,34021,0,0,62,62,0,1,0,1,0
19560,3389,19560,3389,293,223,70,4,0,3,1
37068,4355,0,0,127,127,0,1,0,1,0
38548,60404,0,0,91,91,0,1,0,1,0
49258,34021,0,0,143,143,0,1,0,1,0
22175,3389,22175,3389,293,223,70,4,0,3,1
37703,3389,37703,3389,293,223,70,4,1,3,1
18160,21177,0,0,93,93,0,1,0,1,0
18418,3389,18418,3389,293,223,70,4,0,3,1
51123,6387,0,0,145,145,0,1,0,1,0
17698,3389,17698,3389,293,223,70,4,0,3,1
27094,13577,0,0,104,104,0,1,0,1,0
24850,103,382,102,69,66,2,1,0,1,0
33713,3389,33713,3389,293,223,70,4,0,3,1
12063,6044,7523,2324,247,199,48,3,0,2,0
9399,15616,0,0,151,151,0,1,0,1,0
14333,61248,0,0,143,143,0,1,0,1,0
50015,28047,0,0,120,120,0,1,0,1,0
12090,25773,0,0,139,139,0,1,0,1,0
19411,61248,0,0,153,153,0,1,0,1,0
22602,34021,0,0,62,62,0,1,0,1,0
18028,25417,0,0,139,139,0,1,0,1,0
51769,31652,0,0,62,62,0,1,0,1,0
18153,21405,0,0,96,96,0,1,0,1,0
50147,34021,0,0,121,121,0,1,0,1,0
59055,56578,0,0,131,131,0,1,0,1,0
19114,3389,19114,3389,293,223,70,4,0,3,1
11706,5180,8644,2671,262,207,55,3,0,2,0
16617,61248,0,0,151,151,0,1,0,1,0
12096,3389,12096,3389,293,223,70,4,1,3,1
10807,25773,0,0,139,139,0,1,0,1,0
52128,31652,0,0,62,62,0,1,0,1,0
15645,61248,0,0,149,149,0,1,0,1,0
36497,8856,0,0,145,145,0,1,0,1,0
28151,33242,0,0,70,70,0,1,0,1,0
28240,28909,0,0,115,115,0,1,0,1,0
11457,3389,11457,3389,293,223,70,4,0,3,1
49575,27281,0,0,139,139,0,1,0,1,0
24541,34021,0,0,62,62,0,1,0,1,0
49654,27308,0,0,132,132,0,1,0,1,0
27206,27322,0,0,131,131,0,1,0,1,0
18071,24042,0,0,124,124,0,1,0,1,0
49085,31633,0,0,149,149,0,1,0,1,0
8483,61248,0,0,140,140,0,1,0,1,0
19660,3389,19660,3389,293,223,70,4,0,3,1
20136,27501,0,0,126,126,0,1,0,1,0
23843,25773,0,0,145,145,0,1,0,1,0
49186,34021,0,0,145,145,0,1,0,1,0
52133,33219,0,0,65,65,0,1,0,1,0
51678,32398,0,0,68,68,0,1,0,1,0
17660,18988,0,0,69,69,0,1,0,1,0
37740,7597,0,0,146,146,0,1,0,1,0
38075,3389,38075,3389,293,223,70,4,1,3,1
51427,31970,0,0,73,73,0,1,0,1,0
20744,30834,0,0,93,93,0,1,0,1,0
20651,3389,20651,3389,293,223,70,4,0,3,1
10970,61248,0,0,142,142,0,1,0,1,0
12737,3389,12737,3389,293,223,70,4,0,3,1
10243,3389,10243,3389,293,223,70,4,1,3,1
8627,25773,0,0,154,154,0,1,0,1,0
10809,25773,0,0,139,139,0,1,0,1,0
12430,3389,12430,3389,293,223,70,4,1,3,1
51171,34021,0,0,96,96,0,1,0,1,0
51438,31463,0,0,91,91,0,1,0,1,0
11244,6732,5530,2049,235,193,42,2,0,2,0
16522,19527,0,0,78,78,0,1,0,1,0
41424,3389,41424,3389,293,223,70,4,0,3,1
47056,34021,0,0,136,136,0,1,0,1,0
32871,2811,0,0,104,104,0,1,0,1,0
3784,25773,0,0,142,142,0,1,0,1,0
49117,30688,0,0,147,147,0,1,0,1,0
18195,3389,18195,3389,293,223,70,4,0,3,1
10564,3389,10564,3389,293,223,70,4,1,3,1
50501,5618,0,0,145,145,0,1,0,1,0
20897,1030,3333,1030,132,110,21,1,0,1,0
1174,22089,0,0,156,156,0,1,0,1,0
49160,32333,0,0,146,146,0,1,0,1,0
42073,3389,42073,3389,293,223,70,4,0,3,1
7978,55685,0,0,143,143,0,1,0,1,0
6410,31441,0,0,153,153,0,1,0,1,0
10427,61248,0,0,139,139,0,1,0,1,0
51572,31652,0,0,66,66,0,1,0,1,0
49691,32020,0,0,132,132,0,1,0,1,0
35895,34021,0,0,87,87,0,1,0,1,0
14358,23153,0,0,112,112,0,1,0,1,0
49557,33661,0,0,133,133,0,1,0,1,0
28623,27369,0,0,131,131,0,1,0,1,0
28150,3389,28150,3389,293,223,70,4,0,3,1
25205,34021,0,0,62,62,0,1,0,1,0
7910,26457,0,0,156,156,0,1,0,1,0
15345,61248,0,0,145,145,0,1,0,1,0
31638,5423,0,0,112,112,0,1,0,1,0
18833,25773,0,0,143,143,0,1,0,1,0
12635,3389,12635,3389,293,223,70,4,0,3,1
22353,33821,0,0,63,63,0,1,0,1,0
13578,25773,0,0,149,149,0,1,0,1,0
31922,5663,0,0,115,115,0,1,0,1,0
11154,14309,0,0,150,150,0,1,0,1,0
33486,3389,33486,3389,293,223,70,4,0,3,1
13718,3389,13718,3389,293,223,70,4,0,3,1
26535,479,0,0,69,69,0,1,0,1,0
9739,3389,9739,3389,293,223,70,4,1,3,1
17961,61248,0,0,152,152,0,1,0,1,0
18542,3389,18542,3389,293,223,70,4,0,3,1
10842,25773,0,0,139,139,0,1,0,1,0
52167,33736,0,0,72,72,0,1,0,1,0
20050,61248,0,0,154,154,0,1,0,1,0
50240,31652,0,0,111,111,0,1,0,1,0
9383,25773,0,0,140,140,0,1,0,1,0
18204,3389,18204,3389,293,223,70,4,0,3,1
28148,33352,0,0,68,68,0,1,0,1,0
32212,2568,0,0,100,100,0,1,0,1,0
22121,28610,0,0,115,115,0,1,0,1,0
49062,29426,0,0,150,150,0,1,0,1,0
49940,27893,0,0,122,122,0,1,0,1,0
43874,60131,0,0,69,69,0,1,0,1,0
21476,33222,0,0,69,69,0,1,0,1,0
27219,34021,0,0,62,62,0,1,0,1,0
11740,3389,11740,3389,293,223,70,4,1,3,1
11900,3389,11900,3389,293,223,70,4,0,3,1
28204,30630,0,0,97,97,0,1,0,1,0
49417,33787,0,0,137,137,0,1,0,1,0
11476,60028,0,0,139,139,0,1,0,1,0
16800,3389,16800,3389,293,223,70,4,0,3,1
16521,3389,16521,3389,293,223,70,4,0,3,1
5583,56048,0,0,141,141,0,1,0,1,0
50535,5618,0,0,145,145,0,1,0,1,0
12804,61248,0,0,145,145,0,1,0,1,0
47529,53090,0,0,62,62,0,1,0,1,0
49160,33087,0,0,146,146,0,1,0,1,0
14179,3389,14179,3389,293,223,70,4,0,3,1
46606,3389,46606,3389,293,223,70,4,0,3,1
61632,3389,61632,3389,293,223,70,4,0,3,1
19578,3389,19578,3389,293,223,70,4,0,3,1
24829,23169,0,0,118,118,0,1,0,1,0
8072,25748,0,0,157,157,0,1,0,1,0
1988,23362,0,0,151,151,0,1,0,1,0
22703,15893,0,0,83,83,0,1,0,1,0
41561,8162,0,0,147,147,0,1,0,1,0
11790,3389,11790,3389,293,223,70,4,1,3,1
13034,3389,13034,3389,293,223,70,4,0,3,1
49976,33282,0,0,119,119,0,1,0,1,0
11888,61248,0,0,140,140,0,1,0,1,0
27959,3389,27959,3389,293,223,70,4,0,3,1
8920,61248,0,0,140,140,0,1,0,1,0
21062,3389,21062,3389,293,223,70,4,0,3,1
25686,34021,0,0,62,62,0,1,0,1,0
1598,22171,0,0,157,157,0,1,0,1,0
14250,25773,0,0,143,143,0,1,0,1,0
62333,47228,0,0,105,105,0,1,0,1,0
26284,34021,0,0,62,62,0,1,0,1,0
42525,34021,0,0,116,116,0,1,0,1,0
50394,31652,0,0,102,102,0,1,0,1,0
18777,17964,0,0,64,64,0,1,0,1,0
51805,36937,0,0,62,62,0,1,0,1,0
50090,28200,0,0,117,117,0,1,0,1,0
22193,3389,22193,3389,293,223,70,4,0,3,1
13851,55056,0,0,124,124,0,1,0,1,0
9602,25773,0,0,154,154,0,1,0,1,0
12869,3389,12869,3389,293,223,70,4,0,3,1
42267,9857,0,0,148,148,0,1,0,1,0
52002,5618,0,0,145,145,0,1,0,1,0
57584,3389,57584,3389,293,223,70,4,0,3,1
18019,25681,0,0,142,142,0,1,0,1,0
52404,33707,0,0,63,63,0,1,0,1,0
13450,10242,1735,643,175,162,13,1,0,1,0
26750,558,0,0,70,70,0,1,0,1,0
20093,3389,20093,3389,293,223,70,4,0,3,1
51808,31739,0,0,62,62,0,1,0,1,0
1167,22078,0,0,156,156,0,1,0,1,0
56496,3389,56496,3389,293,223,70,4,0,3,1
63163,3389,63163,3389,293,223,70,4,0,3,1
17551,23951,0,0,143,143,0,1,0,1,0
50425,34021,0,0,114,114,0,1,0,1,0
22123,3389,22123,3389,293,223,70,4,0,3,1
7774,61248,0,0,139,139,0,1,0,1,0
2534,22379,0,0,154,154,0,1,0,1,0
26395,984,0,0,71,71,0,1,0,1,0
15741,28575,0,0,112,112,0,1,0,1,0
3001,24947,0,0,145,145,0,1,0,1,0
19081,3389,19081,3389,293,223,70,4,0,3,1
44772,60085,0,0,65,65,0,1,0,1,0
50997,30985,0,0,81,81,0,1,0,1,0
26876,3389,26876,3389,293,223,70,4,0,3,1
17424,16847,0,0,80,80,0,1,0,1,0
33111,60684,0,0,113,113,0,1,0,1,0
33343,6866,0,0,126,126,0,1,0,1,0
16435,25773,0,0,145,145,0,1,0,1,0
19152,18916,0,0,69,69,0,1,0,1,0
24189,3389,24189,3389,293,223,70,4,1,3,1
21194,37408,0,0,71,71,0,1,0,1,0
10147,3389,10147,3389,293,223,70,4,1,3,1
63757,31652,0,0,62,62,0,1,0,1,0
37179,3389,37179,3389,293,223,70,4,1,3,1
51988,60555,0,0,97,97,0,1,0,1,0
19939,3389,19939,3389,293,223,70,4,0,3,1
5045,35980,0,0,150,150,0,1,0,1,0
11248,6737,5523,2047,235,193,42,2,0,2,0
10501,3389,10501,3389,293,223,70,4,1,3,1
11764,25773,0,0,141,141,0,1,0,1,0
48860,48060,0,0,62,62,0,1,0,1,0
49160,32697,0,0,146,146,0,1,0,1,0
13422,2805,9079,2805,253,195,57,3,0,2,0
20887,3389,20887,3389,293,223,70,4,0,3,1
12695,23134,0,0,140,140,0,1,0,1,0
50742,3389,50742,3389,293,223,70,4,0,3,1
42323,9991,0,0,148,148,0,1,0,1,0
10263,25773,0,0,147,147,0,1,0,1,0
10948,6260,6040,2238,243,197,46,2,0,2,0
11841,24348,0,0,148,148,0,1,0,1,0
12693,2978,9639,2978,265,203,61,3,0,2,0
39545,5266,0,0,140,140,0,1,0,1,0
49160,32824,0,0,146,146,0,1,0,1,0
26224,3389,26224,3389,293,223,70,4,0,3,1
28052,2387,0,0,84,84,0,1,0,1,0
18703,3389,18703,3389,293,223,70,4,0,3,1
11440,3389,11440,3389,293,223,70,4,0,3,1
45761,59455,0,0,63,63,0,1,0,1,0
16703,3389,16703,3389,293,223,70,4,0,3,1
2523,24199,0,0,148,148,0,1,0,1,0
16847,20013,0,0,80,80,0,1,0,1,0
52213,33768,0,0,70,70,0,1,0,1,0
14742,20849,0,0,94,94,0,1,0,1,0
51944,32143,0,0,62,62,0,1,0,1,0
60080,31652,0,0,65,65,0,1,0,1,0
18119,22475,0,0,107,107,0,1,0,1,0
50174,33103,0,0,113,113,0,1,0,1,0
22676,34021,0,0,62,62,0,1,0,1,0
12637,3389,12637,3389,293,223,70,4,0,3,1
16279,61248,0,0,147,147,0,1,0,1,0
51980,32249,0,0,62,62,0,1,0,1,0
53323,60665,0,0,105,105,0,1,0,1,0
12887,3389,12887,3389,293,223,70,4,0,3,1
22894,3389,22894,3389,293,223,70,4,0,3,1
16502,3389,16502,3389,293,223,70,4,0,3,1
2864,22870,0,0,157,157,0,1,0,1,0
56911,3389,56911,3389,293,223,70,4,0,3,1
30040,3389,30040,3389,293,223,70,4,0,3,1
3716,25773,0,0,143,143,0,1,0,1,0
31666,2367,0,0,97,97,0,1,0,1,0
54211,14271,0,0,120,120,0,1,0,1,0
37483,3389,37483,3389,293,223,70,4,1,3,1
12582,8861,3228,1196,199,174,24,2,0,1,0
18115,3389,18115,3389,293,223,70,4,0,3,1
59919,59514,0,0,139,139,0,1,0,1,0
26264,61035,0,0,141,141,0,1,0,1,0
25809,25773,0,0,146,146,0,1,0,1,0
21739,32681,0,0,75,75,0,1,0,1,0
15021,3389,15021,3389,293,223,70,4,0,3,1
42746,5618,0,0,145,145,0,1,0,1,0
53178,60653,0,0,104,104,0,1,0,1,0
2668,43882,0,0,146,146,0,1,0,1,0
5975,57185,0,0,140,140,0,1,0,1,0
14820,3389,14820,3389,293,223,70,4,0,3,1
52312,33232,0,0,62,62,0,1,0,1,0
12714,25773,0,0,139,139,0,1,0,1,0
37911,3389,37911,3389,293,223,70,4,1,3,1
21468,61248,0,0,157,157,0,1,0,1,0
14208,3389,14208,3389,293,223,70,4,0,3,1
11801,3190,10325,3190,279,213,65,3,0,2,0
10866,3389,10866,3389,293,223,70,4,1,3,1
14938,61248,0,0,144,144,0,1,0,1,0
9322,61248,0,0,139,139,0,1,0,1,0
26516,34021,0,0,62,62,0,1,0,1,0
15741,3389,15741,3389,293,223,70,4,0,3,1
48797,3389,48797,3389,293,223,70,4,0,3,1
51933,33574,0,0,77,77,0,1,0,1,0
3384,41502,0,0,147,147,0,1,0,1,0
51766,31652,0,0,62,62,0,1,0,1,0
61131,31652,0,0,80,80,0,1,0,1,0
26446,3389,26446,3389,293,223,70,4,0,3,1
5212,24911,0,0,133,133,0,1,0,1,0
26366,34021,0,0,62,62,0,1,0,1,0
3715,47108,0,0,146,146,0,1,0,1,0
20385,30168,0,0,99,99,0,1,0,1,0
47622,6978,0,0,145,145,0,1,0,1,0
37705,7622,0,0,146,146,0,1,0,1,0
22242,61242,0,0,158,158,0,1,0,1,0
34437,60615,0,0,108,108,0,1,0,1,0
49908,33343,0,0,121,121,0,1,0,1,0
25287,45,0,0,62,62,0,1,0,1,0
2448,24083,0,0,149,149,0,1,0,1,0
49160,33426,0,0,146,146,0,1,0,1,0
60589,4304,37712,1996,232,190,41,2,0,2,0
25367,23572,0,0,122,122,0,1,0,1,0
11283,52919,0,0,151,151,0,1,0,1,0
10160,5006,7395,2740,265,208,56,3,0,2,0
21744,3389,21744,3389,293,223,70,4,0,3,1
29618,32356,0,0,79,79,0,1,0,1,0
11791,3389,11791,3389,293,223,70,4,1,3,1
49097,32004,0,0,148,148,0,1,0,1,0
49351,26689,0,0,142,142,0,1,0,1,0
18731,3389,18731,3389,293,223,70,4,1,3,1
28297,26153,0,0,144,144,0,1,0,1,0
14038,14539,0,0,146,146,0,1,0,1,0
38226,3389,38226,3389,293,223,70,4,1,3,1
10667,25773,0,0,153,153,0,1,0,1,0
14460,11854,0,0,147,147,0,1,0,1,0
13820,3389,13820,3389,293,223,70,4,0,3,1
56350,5438,5165,273,156,151,5,1,0,1,0
52728,5618,0,0,145,145,0,1,0,1,0
12271,61248,0,0,139,139,0,1,0,1,0
49480,3389,49480,3389,293,223,70,4,0,3,1
12094,61248,0,0,139,139,0,1,0,1,0
37476,7787,0,0,146,146,0,1,0,1,0
51619,31795,0,0,67,67,0,1,0,1,0
12307,3389,12307,3389,293,223,70,4,0,3,1
17043,16205,0,0,89,89,0,1,0,1,0
16239,25773,0,0,143,143,0,1,0,1,0
29654,34021,0,0,62,62,0,1,0,1,0
31136,4998,0,0,108,108,0,1,0,1,0
12112,3389,12112,3389,293,223,70,4,1,3,1
6236,52781,0,0,144,144,0,1,0,1,0
18520,3389,18520,3389,293,223,70,4,0,3,1
13469,9450,3108,960,189,169,19,1,0,1,0
25115,34021,0,0,62,62,0,1,0,1,0
10681,25773,0,0,145,145,0,1,0,1,0
29534,3389,29534,3389,293,223,70,4,0,3,1
19637,3389,19637,3389,293,223,70,4,0,3,1
25918,3389,25918,3389,293,223,70,4,0,3,1
14506,3389,14506,3389,293,223,70,4,0,3,1
38282,3389,38282,3389,293,223,70,4,1,3,1
13118,20428,0,0,142,142,0,1,0,1,0
50014,28045,0,0,120,120,0,1,0,1,0
18833,18677,0,0,66,66,0,1,0,1,0
30661,60809,0,0,123,123,0,1,0,1,0
11166,61248,0,0,139,139,0,1,0,1,0
9996,61248,0,0,141,141,0,1,0,1,0
52355,33360,0,0,62,62,0,1,0,1,0
29609,32310,0,0,79,79,0,1,0,1,0
37430,10691,0,0,146,146,0,1,0,1,0
12285,8389,3738,1385,207,178,28,2,0,1,0
2938,47285,0,0,144,144,0,1,0,1,0
38948,8443,0,0,145,145,0,1,0,1,0
28255,28166,0,0,123,123,0,1,0,1,0
5447,23393,0,0,149,149,0,1,0,1,0
34600,3389,34600,3389,293,223,70,4,1,3,1
52290,15694,0,0,150,150,0,1,0,1,0
11577,3389,11577,3389,293,223,70,4,1,3,1
49818,33425,0,0,124,124,0,1,0,1,0
43525,60149,0,0,70,70,0,1,0,1,0
21756,3389,21756,3389,293,223,70,4,0,3,1
9803,25773,0,0,154,154,0,1,0,1,0
2569,24272,0,0,148,148,0,1,0,1,0
48397,39736,0,0,127,127,0,1,0,1,0
11445,3389,11445,3389,293,223,70,4,1,3,1
17757,24758,0,0,143,143,0,1,0,1,0
55342,60830,0,0,116,116,0,1,0,1,0
52507,33812,0,0,62,62,0,1,0,1,0
12110,61248,0,0,139,139,0,1,0,1,0
28172,32215,0,0,80,80,0,1,0,1,0
49067,47280,0,0,62,62,0,1,0,1,0
6305,23692,0,0,148,148,0,1,0,1,0
8321,25773,0,0,156,156,0,1,0,1,0
22504,3001,0,0,83,83,0,1,0,1,0
27117,24883,0,0,137,137,0,1,0,1,0
37797,3389,37797,3389,293,223,70,4,0,3,1
29871,33621,0,0,66,66,0,1,0,1,0
15168,3389,15168,3389,293,223,70,4,0,3,1
5096,50404,0,0,143,143,0,1,0,1,0
11504,61248,0,0,139,139,0,1,0,1,0
2710,22786,0,0,157,157,0,1,0,1,0
31382,5206,0,0,110,110,0,1,0,1,0
12346,6730,6634,2050,235,193,42,2,0,2,0
14941,25773,0,0,147,147,0,1,0,1,0
30675,3389,30675,3389,293,223,70,4,0,3,1
29006,24613,0,0,147,147,0,1,0,1,0
12021,61248,0,0,140,140,0,1,0,1,0
50340,34021,0,0,116,116,0,1,0,1,0
52287,33369,0,0,69,69,0,1,0,1,0
19712,3389,19712,3389,293,223,70,4,0,3,1
2390,46760,0,0,144,144,0,1,0,1,0
22209,21207,0,0,95,95,0,1,0,1,0
64147,31700,0,0,63,63,0,1,0,1,0
12170,25773,0,0,139,139,0,1,0,1,0
28041,25773,0,0,147,147,0,1,0,1,0
1530,22645,0,0,154,154,0,1,0,1,0
11752,7540,4656,1725,221,186,35,2,0,2,0
17694,46774,0,0,98,98,0,1,0,1,0
24672,31198,0,0,89,89,0,1,0,1,0
29306,34021,0,0,62,62,0,1,0,1,0
49167,26432,0,0,147,147,0,1,0,1,0
2337,23908,0,0,149,149,0,1,0,1,0
12778,25147,0,0,132,132,0,1,0,1,0
14644,61248,0,0,143,143,0,1,0,1,0
11604,3389,11604,3389,293,223,70,4,1,3,1
49160,31782,0,0,146,146,0,1,0,1,0
17314,3389,17314,3389,293,223,70,4,0,3,1
53002,21402,0,0,100,100,0,1,0,1,0
20364,19824,0,0,80,80,0,1,0,1,0
49421,31652,0,0,136,136,0,1,0,1,0
47105,49422,0,0,96,96,0,1,0,1,0
51740,32509,0,0,68,68,0,1,0,1,0
18743,7136,0,0,113,113,0,1,0,1,0
26098,3389,26098,3389,293,223,70,4,0,3,1
47696,43624,0,0,110,110,0,1,0,1,0
49956,34021,0,0,126,126,0,1,0,1,0
61243,31652,0,0,64,64,0,1,0,1,0
18242,28873,0,0,110,110,0,1,0,1,0
50226,34021,0,0,119,119,0,1,0,1,0
9167,25773,0,0,140,140,0,1,0,1,0
35671,3389,35671,3389,293,223,70,4,0,3,1
8688,25773,0,0,140,140,0,1,0,1,0
24509,25773,0,0,146,146,0,1,0,1,0
50604,30007,0,0,95,95,0,1,0,1,0
6526,58790,0,0,139,139,0,1,0,1,0
27308,34021,0,0,62,62,0,1,0,1,0
51516,31889,0,0,70,70,0,1,0,1,0
4472,52815,0,0,142,142,0,1,0,1,0
8459,61248,0,0,139,139,0,1,0,1,0
60106,60491,0,0,145,145,0,1,0,1,0
49132,33128,0,0,147,147,0,1,0,1,0
21711,837,2707,836,119,101,17,1,0,1,0
21231,31738,0,0,84,84,0,1,0,1,0
12036,61248,0,0,145,145,0,1,0,1,0
2341,42199,0,0,144,144,0,1,0,1,0
51417,31652,0,0,69,69,0,1,0,1,0
4532,25773,0,0,146,146,0,1,0,1,0
21134,31558,0,0,86,86,0,1,0,1,0
17675,18670,0,0,67,67,0,1,0,1,0
18863,3389,18863,3389,293,223,70,4,0,3,1
3579,40855,0,0,147,147,0,1,0,1,0
27619,3389,27619,3389,293,223,70,4,0,3,1
50706,32622,0,0,96,96,0,1,0,1,0
51673,5618,0,0,145,145,0,1,0,1,0
28270,27460,0,0,130,130,0,1,0,1,0
2391,41505,0,0,144,144,0,1,0,1,0
51173,39326,0,0,62,62,0,1,0,1,0
27506,34021,0,0,62,62,0,1,0,1,0
18055,24527,0,0,129,129,0,1,0,1,0
28173,32146,0,0,81,81,0,1,0,1,0
1755,22998,0,0,152,152,0,1,0,1,0
12462,13334,0,0,149,149,0,1,0,1,0
19588,28690,0,0,114,114,0,1,0,1,0
12310,3389,12310,3389,293,223,70,4,1,3,1
51323,30721,0,0,77,77,0,1,0,1,0
10943,61248,0,0,139,139,0,1,0,1,0
29667,3389,29667,3389,293,223,70,4,0,3,1
48982,28336,0,0,153,153,0,1,0,1,0
61021,56839,0,0,132,132,0,1,0,1,0
11013,3389,11013,3389,293,223,70,4,1,3,1
24888,34021,0,0,62,62,0,1,0,1,0
63920,31652,0,0,62,62,0,1,0,1,0
49038,28874,0,0,151,151,0,1,0,1,0
50254,32789,0,0,107,107,0,1,0,1,0
51721,34021,0,0,83,83,0,1,0,1,0
27896,3389,27896,3389,293,223,70,4,0,3,1
2683,47613,0,0,144,144,0,1,0,1,0
14155,55124,0,0,153,153,0,1,0,1,0
15072,3389,15072,3389,293,223,70,4,0,3,1
13535,3389,13535,3389,293,223,70,4,0,3,1
13258,19527,0,0,143,143,0,1,0,1,0
12148,25773,0,0,139,139,0,1,0,1,0
46810,34021,0,0,135,135,0,1,0,1,0
9317,15676,0,0,151,151,0,1,0,1,0
23060,34021,0,0,62,62,0,1,0,1,0
7017,54082,0,0,143,143,0,1,0,1,0
11704,25773,0,0,141,141,0,1,0,1,0
5992,32833,0,0,152,152,0,1,0,1,0
58435,32584,0,0,95,95,0,1,0,1,0
51486,31053,0,0,71,71,0,1,0,1,0
50547,20879,0,0,154,154,0,1,0,1,0
24861,14755,0,0,93,93,0,1,0,1,0
52309,33536,0,0,64,64,0,1,0,1,0
17991,3389,17991,3389,293,223,70,4,0,3,1
16603,15462,0,0,99,99,0,1,0,1,0
49021,28475,0,0,151,151,0,1,0,1,0
28778,34021,0,0,62,62,0,1,0,1,0
15199,3389,15199,3389,293,223,70,4,0,3,1
13764,61248,0,0,146,146,0,1,0,1,0
52028,32390,0,0,62,62,0,1,0,1,0
49825,33271,0,0,122,122,0,1,0,1,0
21946,61248,0,0,158,158,0,1,0,1,0
60911,31652,0,0,62,62,0,1,0,1,0
9527,3389,9527,3389,293,223,70,4,0,3,1
24489,25773,0,0,146,146,0,1,0,1,0
11576,61248,0,0,143,143,0,1,0,1,0
37151,8746,0,0,145,145,0,1,0,1,0
47233,54208,0,0,62,62,0,1,0,1,0
9753,25773,0,0,149,149,0,1,0,1,0
16496,15282,0,0,101,101,0,1,0,1,0
4535,25257,0,0,137,137,0,1,0,1,0
18024,25546,0,0,140,140,0,1,0,1,0
9855,25773,0,0,149,149,0,1,0,1,0
9315,25773,0,0,140,140,0,1,0,1,0
13840,3389,13840,3389,293,223,70,4,0,3,1
6791,25773,0,0,152,152,0,1,0,1,0
14869,27868,0,0,119,119,0,1,0,1,0
3512,48241,0,0,144,144,0,1,0,1,0
37116,8045,0,0,146,146,0,1,0,1,0
11039,25340,0,0,140,140,0,1,0,1,0
17721,25773,0,0,143,143,0,1,0,1,0
21671,3389,21671,3389,293,223,70,4,0,3,1
13788,3389,13788,3389,293,223,70,4,0,3,1
10414,3389,10414,3389,293,223,70,4,1,3,1
55677,3389,55677,3389,293,223,70,4,0,3,1
50078,28699,0,0,114,114,0,1,0,1,0
14775,61248,0,0,148,148,0,1,0,1,0
54775,8303,0,0,146,146,0,1,0,1,0
28139,34021,0,0,62,62,0,1,0,1,0
9159,3389,9159,3389,293,223,70,4,1,3,1
10492,25773,0,0,139,139,0,1,0,1,0
18871,3389,18871,3389,293,223,70,4,0,3,1
59535,31652,0,0,89,89,0,1,0,1,0
58481,32844,0,0,62,62,0,1,0,1,0
51464,5618,0,0,145,145,0,1,0,1,0
26352,32567,0,0,76,76,0,1,0,1,0
20426,61248,0,0,155,155,0,1,0,1,0
30487,3389,30487,3389,293,223,70,4,1,3,1
9634,61248,0,0,142,142,0,1,0,1,0
37451,60461,0,0,95,95,0,1,0,1,0
51722,31652,0,0,63,63,0,1,0,1,0
54479,12686,0,0,125,125,0,1,0,1,0
6247,57978,0,0,140,140,0,1,0,1,0
44766,5618,0,0,145,145,0,1,0,1,0
9813,3389,9813,3389,293,223,70,4,1,3,1
25025,50,160,49,65,64,1,1,0,1,0
29655,32539,0,0,77,77,0,1,0,1,0
6152,23036,0,0,152,152,0,1,0,1,0
8256,25773,0,0,156,156,0,1,0,1,0
12800,7829,5209,1609,216,183,33,2,0,1,0
50365,32664,0,0,103,103,0,1,0,1,0
22580,34021,0,0,62,62,0,1,0,1,0
40774,6275,0,0,146,146,0,1,0,1,0
49803,27612,0,0,127,127,0,1,0,1,0
29639,34021,0,0,62,62,0,1,0,1,0
11490,3389,11490,3389,293,223,70,4,1,3,1
37181,3389,37181,3389,293,223,70,4,1,3,1
12481,7056,6211,1919,230,190,39,2,0,2,0
26553,28244,0,0,122,122,0,1,0,1,0
24485,31164,0,0,91,91,0,1,0,1,0
18947,6912,0,0,112,112,0,1,0,1,0
11281,59734,0,0,139,139,0,1,0,1,0
9177,24691,0,0,143,143,0,1,0,1,0
21659,61248,0,0,158,158,0,1,0,1,0
29300,30763,0,0,95,95,0,1,0,1,0
13856,3389,13856,3389,293,223,70,4,0,3,1
28207,25699,0,0,147,147,0,1,0,1,0
13208,3389,13208,3389,293,223,70,4,0,3,1
52442,33618,0,0,62,62,0,1,0,1,0
30519,1945,0,0,91,91,0,1,0,1,0
18150,3389,18150,3389,293,223,70,4,0,3,1
50847,32494,0,0,91,91,0,1,0,1,0
63341,3389,63341,3389,293,223,70,4,0,3,1
29836,3389,29836,3389,293,223,70,4,0,3,1
23252,32904,0,0,73,73,0,1,0,1,0
13080,3389,13080,3389,293,223,70,4,0,3,1
20798,3389,20798,3389,293,223,70,4,0,3,1
10960,60654,0,0,143,143,0,1,0,1,0
49160,32307,0,0,146,146,0,1,0,1,0
18638,25773,0,0,143,143,0,1,0,1,0
8680,25353,0,0,151,151,0,1,0,1,0
9387,56877,0,0,140,140,0,1,0,1,0
48972,27367,0,0,154,154,0,1,0,1,0
18510,61248,0,0,151,151,0,1,0,1,0
49752,33929,0,0,142,142,0,1,0,1,0
11245,4062,10093,3119,281,217,64,3,0,2,0
36964,11461,0,0,146,146,0,1,0,1,0
51376,32015,0,0,74,74,0,1,0,1,0
46329,54810,0,0,77,77,0,1,0,1,0
59572,61178,0,0,140,140,0,1,0,1,0
18914,3389,18914,3389,293,223,70,4,0,3,1
43140,5618,0,0,145,145,0,1,0,1,0
51671,31652,0,0,64,64,0,1,0,1,0
58398,54230,0,0,123,123,0,1,0,1,0
11678,61248,0,0,141,141,0,1,0,1,0
52269,33464,0,0,64,64,0,1,0,1,0
19481,3389,19481,3389,293,223,70,4,0,3,1
10634,3389,10634,3389,293,223,70,4,1,3,1
11891,3389,11891,3389,293,223,70,4,0,3,1
13687,3389,13687,3389,293,223,70,4,0,3,1
54919,33554,0,0,62,62,0,1,0,1,0
24104,34021,0,0,62,62,0,1,0,1,0
11664,61248,0,0,141,141,0,1,0,1,0
51429,31652,0,0,68,68,0,1,0,1,0
48444,5618,0,0,145,145,0,1,0,1,0
10147,22387,0,0,106,106,0,1,0,1,0
20169,61248,0,0,156,156,0,1,0,1,0
11603,25773,0,0,141,141,0,1,0,1,0
8068,61248,0,0,139,139,0,1,0,1,0
15297,61248,0,0,149,149,0,1,0,1,0
5583,56045,0,0,141,141,0,1,0,1,0
52820,34862,0,0,64,64,0,1,0,1,0
52865,31652,0,0,62,62,0,1,0,1,0
46186,60078,0,0,64,64,0,1,0,1,0
13164,3389,13164,3389,293,223,70,4,0,3,1
12124,6191,7333,2266,244,198,46,3,0,2,0
15015,2742,10197,2741,248,192,56,3,0,2,0
12990,3389,12990,3389,293,223,70,4,0,3,1
15563,20239,0,0,87,87,0,1,0,1,0
37828,7534,0,0,146,146,0,1,0,1,0
48938,26574,0,0,155,155,0,1,0,1,0
3760,50744,0,0,143,143,0,1,0,1,0
5818,51493,0,0,142,142,0,1,0,1,0
50896,32450,0,0,90,90,0,1,0,1,0
63264,3389,63264,3389,293,223,70,4,0,3,1
15947,27679,0,0,121,121,0,1,0,1,0
53103,60647,0,0,103,103,0,1,0,1,0
15298,21968,0,0,100,100,0,1,0,1,0
51574,31234,0,0,68,68,0,1,0,1,0
51101,31652,0,0,83,83,0,1,0,1,0
29763,34021,0,0,62,62,0,1,0,1,0
49330,26837,0,0,141,141,0,1,0,1,0
16209,3389,16209,3389,293,223,70,4,0,3,1
12386,22599,0,0,116,116,0,1,0,1,0
19183,61248,0,0,153,153,0,1,0,1,0
51582,31652,0,0,65,65,0,1,0,1,0
46071,18980,0,0,153,153,0,1,0,1,0
24140,34021,0,0,62,62,0,1,0,1,0
29663,1630,0,0,86,86,0,1,0,1,0
50522,32596,0,0,112,112,0,1,0,1,0
9987,3389,9987,3389,293,223,70,4,0,3,1
26444,1025,0,0,71,71,0,1,0,1,0
12451,58477,0,0,134,134,0,1,0,1,0
9842,61248,0,0,142,142,0,1,0,1,0
17889,3389,17889,3389,293,223,70,4,0,3,1
37870,7504,0,0,146,146,0,1,0,1,0
24946,34021,0,0,62,62,0,1,0,1,0
14561,12020,0,0,145,145,0,1,0,1,0
2530,22378,0,0,154,154,0,1,0,1,0
27760,26541,0,0,139,139,0,1,0,1,0
20666,37258,0,0,71,71,0,1,0,1,0
51010,31652,0,0,86,86,0,1,0,1,0
49111,30549,0,0,148,148,0,1,0,1,0
8648,61248,0,0,140,140,0,1,0,1,0
52113,32642,0,0,62,62,0,1,0,1,0
52357,60585,0,0,99,99,0,1,0,1,0
50286,29216,0,0,107,107,0,1,0,1,0
28211,32819,0,0,73,73,0,1,0,1,0
10173,3389,10173,3389,293,223,70,4,1,3,1
11603,61248,0,0,139,139,0,1,0,1,0
48247,3389,48247,3389,293,223,70,4,0,3,1
48933,25849,0,0,155,155,0,1,0,1,0
53324,19504,0,0,106,106,0,1,0,1,0
4190,25773,0,0,145,145,0,1,0,1,0
51065,32972,0,0,99,99,0,1,0,1,0
29024,34021,0,0,62,62,0,1,0,1,0
2393,46326,0,0,144,144,0,1,0,1,0
49360,31652,0,0,138,138,0,1,0,1,0
40524,5675,0,0,146,146,0,1,0,1,0
49935,31652,0,0,121,121,0,1,0,1,0
37010,11385,0,0,146,146,0,1,0,1,0
22168,3389,22168,3389,293,223,70,4,0,3,1
59124,4696,26464,1401,206,177,28,2,0,1,0
37995,3389,37995,3389,293,223,70,4,1,3,1
27880,25773,0,0,147,147,0,1,0,1,0
10275,25773,0,0,139,139,0,1,0,1,0
56840,31652,0,0,62,62,0,1,0,1,0
16427,19597,0,0,79,79,0,1,0,1,0
23852,29806,0,0,103,103,0,1,0,1,0
19153,26558,0,0,135,135,0,1,0,1,0
17749,17394,0,0,73,73,0,1,0,1,0
12349,3389,12349,3389,293,223,70,4,1,3,1
11197,6657,5611,2079,236,194,42,2,0,2,0
40006,8264,0,0,145,145,0,1,0,1,0
11531,61248,0,0,142,142,0,1,0,1,0
19732,25773,0,0,143,143,0,1,0,1,0
33093,3389,33093,3389,293,223,70,4,0,3,1
12142,3389,12142,3389,293,223,70,4,1,3,1
21716,25773,0,0,144,144,0,1,0,1,0
29623,32379,0,0,79,79,0,1,0,1,0
7891,24244,0,0,146,146,0,1,0,1,0
16258,61248,0,0,150,150,0,1,0,1,0
29467,31598,0,0,87,87,0,1,0,1,0
11114,3746,10503,3245,286,219,67,3,0,2,0
50954,30378,0,0,103,103,0,1,0,1,0
52498,33784,0,0,62,62,0,1,0,1,0
15307,10914,0,0,141,141,0,1,0,1,0
7144,54294,0,0,143,143,0,1,0,1,0
11978,61248,0,0,140,140,0,1,0,1,0
4445,25773,0,0,145,145,0,1,0,1,0
28928,28898,0,0,115,115,0,1,0,1,0
48335,38397,0,0,126,126,0,1,0,1,0
9150,3389,9150,3389,293,223,70,4,1,3,1
29422,33655,0,0,65,65,0,1,0,1,0
50952,31652,0,0,88,88,0,1,0,1,0
26625,25773,0,0,147,147,0,1,0,1,0
11619,25773,0,0,141,141,0,1,0,1,0
13735,3389,13735,3389,293,223,70,4,1,3,1
2090,45658,0,0,144,144,0,1,0,1,0
55881,3389,55881,3389,293,223,70,4,0,3,1
29746,32995,0,0,72,72,0,1,0,1,0
3245,29689,0,0,143,143,0,1,0,1,0
21303,61248,0,0,157,157,0,1,0,1,0
22863,34021,0,0,62,62,0,1,0,1,0
50645,31652,0,0,98,98,0,1,0,1,0
2516,22678,0,0,157,157,0,1,0,1,0
35978,60536,0,0,101,101,0,1,0,1,0
52217,33370,0,0,64,64,0,1,0,1,0
56185,31652,0,0,68,68,0,1,0,1,0
51836,34021,0,0,80,80,0,1,0,1,0
11600,3389,11600,3389,293,223,70,4,1,3,1
12972,9481,2557,947,188,168,19,1,0,1,0
49700,27759,0,0,128,128,0,1,0,1,0
37290,8722,0,0,145,145,0,1,0,1,0
19430,3389,19430,3389,293,223,70,4,0,3,1
28407,26287,0,0,142,142,0,1,0,1,0
49042,28962,0,0,151,151,0,1,0,1,0
10938,61248,0,0,142,142,0,1,0,1,0
24718,34021,0,0,62,62,0,1,0,1,0
38499,3389,38499,3389,293,223,70,4,1,3,1
33588,60659,0,0,111,111,0,1,0,1,0
34366,3389,34366,3389,293,223,70,4,0,3,1
27187,34021,0,0,62,62,0,1,0,1,0
49696,31652,0,0,127,127,0,1,0,1,0
14189,3389,14189,3389,293,223,70,4,0,3,1
13511,17908,0,0,144,144,0,1,0,1,0
13395,3389,13395,3389,293,223,70,4,1,3,1
14680,54838,0,0,120,120,0,1,0,1,0
25046,3389,25046,3389,293,223,70,4,0,3,1
37236,3389,37236,3389,293,223,70,4,1,3,1
49375,60340,0,0,82,82,0,1,0,1,0
12490,3027,9795,3027,268,205,62,3,0,2,0
22763,2717,0,0,81,81,0,1,0,1,0
15714,3389,15714,3389,293,223,70,4,0,3,1
3926,48932,0,0,144,144,0,1,0,1,0
14656,3389,14656,3389,293,223,70,4,0,3,1
12382,22602,0,0,117,117,0,1,0,1,0
49597,34021,0,0,135,135,0,1,0,1,0
6094,24656,0,0,157,157,0,1,0,1,0
15351,13352,0,0,127,127,0,1,0,1,0
13271,61248,0,0,141,141,0,1,0,1,0
40041,8258,0,0,145,145,0,1,0,1,0
13752,23919,0,0,120,120,0,1,0,1,0
50660,32332,0,0,93,93,0,1,0,1,0
3110,25118,0,0,145,145,0,1,0,1,0
31025,3389,31025,3389,293,223,70,4,0,3,1
18103,3389,18103,3389,293,223,70,4,0,3,1
8298,23333,0,0,116,116,0,1,0,1,0
54124,10240,0,0,147,147,0,1,0,1,0
11616,4962,8926,2758,266,209,56,3,0,2,0
12574,25773,0,0,139,139,0,1,0,1,0
51513,31652,0,0,67,67,0,1,0,1,0
9293,57876,0,0,143,143,0,1,0,1,0
17726,24634,0,0,143,143,0,1,0,1,0
18264,3389,18264,3389,293,223,70,4,0,3,1
6273,31899,0,0,153,153,0,1,0,1,0
14537,3389,14537,3389,293,223,70,4,0,3,1
51918,32065,0,0,62,62,0,1,0,1,0
11983,61248,0,0,140,140,0,1,0,1,0
51648,31652,0,0,64,64,0,1,0,1,0
41044,6925,0,0,146,146,0,1,0,1,0
20932,3389,20932,3389,293,223,70,4,0,3,1
13888,26608,0,0,131,131,0,1,0,1,0
51350,31266,0,0,93,93,0,1,0,1,0
21028,3389,21028,3389,293,223,70,4,0,3,1
59199,32700,0,0,62,62,0,1,0,1,0
52010,60557,0,0,97,97,0,1,0,1,0
19165,3389,19165,3389,293,223,70,4,0,3,1
10530,61248,0,0,139,139,0,1,0,1,0
15066,14224,0,0,147,147,0,1,0,1,0
22610,3389,22610,3389,293,223,70,4,0,3,1
6428,25773,0,0,151,151,0,1,0,1,0
47442,46900,0,0,104,104,0,1,0,1,0
4350,49280,0,0,143,143,0,1,0,1,0
49087,26187,0,0,152,152,0,1,0,1,0
19282,31445,0,0,86,86,0,1,0,1,0
51346,32043,0,0,75,75,0,1,0,1,0
51097,31235,0,0,78,78,0,1,0,1,0
49354,31652,0,0,139,139,0,1,0,1,0
50916,30784,0,0,84,84,0,1,0,1,0
58829,61117,0,0,136,136,0,1,0,1,0
18816,61248,0,0,154,154,0,1,0,1,0
45118,16695,0,0,152,152,0,1,0,1,0
51251,32129,0,0,78,78,0,1,0,1,0
19180,3389,19180,3389,293,223,70,4,0,3,1
38068,3389,38068,3389,293,223,70,4,0,3,1
13540,25773,0,0,139,139,0,1,0,1,0
18037,3389,18037,3389,293,223,70,4,0,3,1
19167,25773,0,0,143,143,0,1,0,1,0
28004,1020,0,0,77,77,0,1,0,1,0
46667,56347,0,0,62,62,0,1,0,1,0
48975,27439,0,0,153,153,0,1,0,1,0
6284,52196,0,0,142,142,0,1,0,1,0
39197,3389,39197,3389,293,223,70,4,0,3,1
5117,50435,0,0,143,143,0,1,0,1,0
49160,31723,0,0,146,146,0,1,0,1,0
15697,28540,0,0,113,113,0,1,0,1,0
49111,30540,0,0,148,148,0,1,0,1,0
10477,61248,0,0,142,142,0,1,0,1,0
49479,31652,0,0,135,135,0,1,0,1,0
49050,29144,0,0,150,150,0,1,0,1,0
51608,31652,0,0,65,65,0,1,0,1,0
63042,31652,0,0,62,62,0,1,0,1,0
59213,32698,0,0,62,62,0,1,0,1,0
19946,3389,19946,3389,293,223,70,4,0,3,1
6453,58576,0,0,140,140,0,1,0,1,0
17390,25773,0,0,142,142,0,1,0,1,0
24194,3389,24194,3389,293,223,70,4,1,3,1
10962,25773,0,0,152,152,0,1,0,1,0
50481,28998,0,0,104,104,0,1,0,1,0
29759,34021,0,0,62,62,0,1,0,1,0
13683,24005,0,0,120,120,0,1,0,1,0
18982,3389,18982,3389,293,223,70,4,0,3,1
8867,25214,0,0,149,149,0,1,0,1,0
1272,22242,0,0,155,155,0,1,0,1,0
31529,60765,0,0,120,120,0,1,0,1,0
3157,30913,0,0,143,143,0,1,0,1,0
16870,3389,16870,3389,293,223,70,4,0,3,1
34218,16000,0,0,147,147,0,1,0,1,0
28204,30665,0,0,96,96,0,1,0,1,0
35466,3389,35466,3389,293,223,70,4,0,3,1
11993,3389,11993,3389,293,223,70,4,1,3,1
4056,23529,0,0,157,157,0,1,0,1,0
13007,26150,0,0,135,135,0,1,0,1,0
49160,32173,0,0,146,146,0,1,0,1,0
33456,17258,0,0,147,147,0,1,0,1,0
5893,25773,0,0,141,141,0,1,0,1,0
49158,31610,0,0,146,146,0,1,0,1,0
18971,3389,18971,3389,293,223,70,4,0,3,1
14597,3389,14597,3389,293,223,70,4,0,3,1
22119,3389,22119,3389,293,223,70,4,0,3,1
10812,24111,0,0,148,148,0,1,0,1,0
13281,25773,0,0,143,143,0,1,0,1,0
12707,23054,0,0,140,140,0,1,0,1,0
2829,24679,0,0,146,146,0,1,0,1,0
18050,3389,18050,3389,293,223,70,4,0,3,1
21006,4648,0,0,95,95,0,1,0,1,0
17718,3389,17718,3389,293,223,70,4,0,3,1
20831,3389,20831,3389,293,223,70,4,0,3,1
12197,3389,12197,3389,293,223,70,4,0,3,1
11889,61248,0,0,140,140,0,1,0,1,0
14795,54531,0,0,120,120,0,1,0,1,0
52016,32356,0,0,62,62,0,1,0,1,0
14482,3389,14482,3389,293,223,70,4,0,3,1
61240,55232,0,0,128,128,0,1,0,1,0
20232,3389,20232,3389,293,223,70,4,0,3,1
14742,2492,8065,2492,231,180,51,3,0,2,0
24474,34021,0,0,62,62,0,1,0,1,0
53128,20656,0,0,102,102,0,1,0,1,0
13583,3389,13583,3389,293,223,70,4,0,3,1
11477,25773,0,0,152,152,0,1,0,1,0
50124,32935,0,0,112,112,0,1,0,1,0
38967,6717,0,0,146,146,0,1,0,1,0
35608,3389,35608,3389,293,223,70,4,0,3,1
11825,3389,11825,3389,293,223,70,4,0,3,1
49075,26202,0,0,150,150,0,1,0,1,0
14325,3389,14325,3389,293,223,70,4,0,3,1
14936,3389,14936,3389,293,223,70,4,0,3,1
5356,24247,0,0,157,157,0,1,0,1,0
24063,31759,0,0,85,85,0,1,0,1,0
1980,22382,0,0,157,157,0,1,0,1,0
49853,28137,0,0,122,122,0,1,0,1,0
11622,3389,11622,3389,293,223,70,4,1,3,1
51252,34021,0,0,94,94,0,1,0,1,0
30349,4331,0,0,102,102,0,1,0,1,0
49934,33149,0,0,118,118,0,1,0,1,0
52217,15911,0,0,151,151,0,1,0,1,0
50652,32341,0,0,93,93,0,1,0,1,0
14669,12203,0,0,143,143,0,1,0,1,0
60966,4203,40608,2149,238,194,44,2,0,2,0
28153,33126,0,0,71,71,0,1,0,1,0
14210,11246,779,240,158,153,4,1,0,1,0
10341,3389,10341,3389,293,223,70,4,1,3,1
51928,32849,0,0,66,66,0,1,0,1,0
48903,25787,0,0,156,156,0,1,0,1,0
3461,41247,0,0,147,147,0,1,0,1,0
50529,32601,0,0,112,112,0,1,0,1,0
10140,61248,0,0,141,141,0,1,0,1,0
52152,32759,0,0,62,62,0,1,0,1,0
22559,2941,0,0,83,83,0,1,0,1,0
11746,3389,11746,3389,293,223,70,4,1,3,1
21117,31527,0,0,86,86,0,1,0,1,0
9217,61248,0,0,139,139,0,1,0,1,0
11791,61248,0,0,141,141,0,1,0,1,0
12659,3389,12659,3389,293,223,70,4,0,3,1
19047,61248,0,0,154,154,0,1,0,1,0
18996,3389,18996,3389,293,223,70,4,0,3,1
54680,41589,0,0,89,89,0,1,0,1,0
17216,3389,17216,3389,293,223,70,4,0,3,1
2967,48440,0,0,143,143,0,1,0,1,0
4667,25773,0,0,142,142,0,1,0,1,0
12284,3389,12284,3389,293,223,70,4,1,3,1
18134,25991,0,0,140,140,0,1,0,1,0
38220,7253,0,0,146,146,0,1,0,1,0
15318,61248,0,0,145,145,0,1,0,1,0
5569,56006,0,0,141,141,0,1,0,1,0
12306,3389,12306,3389,293,223,70,4,0,3,1
8313,61248,0,0,139,139,0,1,0,1,0
17562,23992,0,0,143,143,0,1,0,1,0
21946,3389,21946,3389,293,223,70,4,0,3,1
37839,7526,0,0,146,146,0,1,0,1,0
11245,3389,11245,3389,293,223,70,4,0,3,1
40342,60312,0,0,84,84,0,1,0,1,0
64045,34692,0,0,70,70,0,1,0,1,0
18175,3389,18175,3389,293,223,70,4,0,3,1
17501,18625,0,0,66,66,0,1,0,1,0
24944,78,289,77,67,65,1,1,0,1,0
2669,37658,0,0,144,144,0,1,0,1,0
20686,3389,20686,3389,293,223,70,4,0,3,1
11021,3389,11021,3389,293,223,70,4,0,3,1
56562,31652,0,0,62,62,0,1,0,1,0
47219,48571,0,0,99,99,0,1,0,1,0
49887,27982,0,0,131,131,0,1,0,1,0
15955,61248,0,0,150,150,0,1,0,1,0
15763,3389,15763,3389,293,223,70,4,0,3,1
4136,25773,0,0,142,142,0,1,0,1,0
44104,3389,44104,3389,293,223,70,4,0,3,1
50621,32376,0,0,94,94,0,1,0,1,0
4605,47791,0,0,146,146,0,1,0,1,0
52087,5618,0,0,145,145,0,1,0,1,0
30002,21981,0,0,147,147,0,1,0,1,0
2305,23858,0,0,149,149,0,1,0,1,0
49051,30525,0,0,150,150,0,1,0,1,0
37222,3389,37222,3389,293,223,70,4,1,3,1
21207,3389,21207,3389,293,223,70,4,0,3,1
51786,34021,0,0,81,81,0,1,0,1,0
49845,28120,0,0,123,123,0,1,0,1,0
18972,3389,18972,3389,293,223,70,4,0,3,1
49577,34021,0,0,135,135,0,1,0,1,0
51517,31652,0,0,67,67,0,1,0,1,0
36946,8167,0,0,146,146,0,1,0,1,0
55913,31652,0,0,108,108,0,1,0,1,0
30113,11984,0,0,118,118,0,1,0,1,0
51618,31652,0,0,67,67,0,1,0,1,0
13518,9569,2953,912,187,168,18,1,0,1,0
51871,60545,0,0,96,96,0,1,0,1,0
2673,46749,0,0,144,144,0,1,0,1,0
11202,3389,11202,3389,293,223,70,4,0,3,1
50998,38465,0,0,145,145,0,1,0,1,0
11300,3389,11300,3389,293,223,70,4,1,3,1
10340,61248,0,0,142,142,0,1,0,1,0
19941,29345,0,0,107,107,0,1,0,1,0
48905,25838,0,0,156,156,0,1,0,1,0
18986,3389,18986,3389,293,223,70,4,0,3,1
19201,3389,19201,3389,293,223,70,4,0,3,1
3680,48521,0,0,144,144,0,1,0,1,0
51996,32297,0,0,62,62,0,1,0,1,0
47455,45591,0,0,104,104,0,1,0,1,0
25415,34021,0,0,62,62,0,1,0,1,0
10665,23878,0,0,133,133,0,1,0,1,0
4582,37519,0,0,149,149,0,1,0,1,0
18094,3389,18094,3389,293,223,70,4,0,3,1
9955,4680,7748,2871,270,211,59,3,0,2,0
50028,31652,0,0,118,118,0,1,0,1,0
22650,34021,0,0,62,62,0,1,0,1,0
49522,33613,0,0,133,133,0,1,0,1,0
37092,8062,0,0,146,146,0,1,0,1,0
18142,3389,18142,3389,293,223,70,4,0,3,1
17628,18704,0,0,67,67,0,1,0,1,0
63532,38447,0,0,81,81,0,1,0,1,0
49160,33749,0,0,146,146,0,1,0,1,0
15147,53590,0,0,117,117,0,1,0,1,0
56885,31652,0,0,103,103,0,1,0,1,0
29216,34021,0,0,62,62,0,1,0,1,0
50862,31652,0,0,91,91,0,1,0,1,0
48986,28454,0,0,153,153,0,1,0,1,0
13684,9971,2432,751,180,164,15,1,0,1,0
39412,8364,0,0,145,145,0,1,0,1,0
11016,3389,11016,3389,293,223,70,4,1,3,1
3789,25773,0,0,143,143,0,1,0,1,0
8340,56286,0,0,143,143,0,1,0,1,0
27812,25773,0,0,147,147,0,1,0,1,0
50693,34021,0,0,108,108,0,1,0,1,0
28791,28210,0,0,122,122,0,1,0,1,0
28142,34021,0,0,62,62,0,1,0,1,0
40179,5847,0,0,146,146,0,1,0,1,0
13824,10310,1993,616,174,161,12,1,0,1,0
52979,31652,0,0,125,125,0,1,0,1,0
19564,3389,19564,3389,293,223,70,4,1,3,1
7937,55616,0,0,143,143,0,1,0,1,0
3972,48708,0,0,143,143,0,1,0,1,0
21284,36144,0,0,68,68,0,1,0,1,0
27185,1653,0,0,77,77,0,1,0,1,0
51610,31848,0,0,87,87,0,1,0,1,0
38487,3389,38487,3389,293,223,70,4,1,3,1
58240,31652,0,0,66,66,0,1,0,1,0
56133,5496,3501,185,153,149,3,1,0,1,0
50384,32500,0,0,115,115,0,1,0,1,0
6998,60162,0,0,139,139,0,1,0,1,0
46748,52098,0,0,87,87,0,1,0,1,0
33452,6958,0,0,127,127,0,1,0,1,0
33774,3389,33774,3389,293,223,70,4,0,3,1
10896,25773,0,0,139,139,0,1,0,1,0
23642,32353,0,0,79,79,0,1,0,1,0
21261,61248,0,0,157,157,0,1,0,1,0
14457,25773,0,0,143,143,0,1,0,1,0
6067,24474,0,0,129,129,0,1,0,1,0
49771,33468,0,0,126,126,0,1,0,1,0
50487,31652,0,0,103,103,0,1,0,1,0
2954,48403,0,0,144,144,0,1,0,1,0
34169,3389,34169,3389,293,223,70,4,0,3,1
8500,25487,0,0,153,153,0,1,0,1,0
51704,32444,0,0,68,68,0,1,0,1,0
15406,3389,15406,3389,293,223,70,4,0,3,1
30651,3389,30651,3389,293,223,70,4,0,3,1
1601,22757,0,0,153,153,0,1,0,1,0
5674,33888,0,0,152,152,0,1,0,1,0
19020,61248,0,0,154,154,0,1,0,1,0
2357,46666,0,0,144,144,0,1,0,1,0
9921,4626,7805,2893,271,212,59,3,0,2,0
4782,25773,0,0,146,146,0,1,0,1,0
50900,32446,0,0,90,90,0,1,0,1,0
17814,28651,0,0,112,112,0,1,0,1,0
52706,25459,0,0,81,81,0,1,0,1,0
20993,3389,20993,3389,293,223,70,4,0,3,1
20631,3389,20631,3389,293,223,70,4,0,3,1
37629,7677,0,0,146,146,0,1,0,1,0
14858,61248,0,0,148,148,0,1,0,1,0
36509,8480,0,0,146,146,0,1,0,1,0
21681,3389,21681,3389,293,223,70,4,0,3,1
49075,32343,0,0,143,143,0,1,0,1,0
27144,1618,0,0,77,77,0,1,0,1,0
56597,60934,0,0,123,123,0,1,0,1,0
6097,52550,0,0,144,144,0,1,0,1,0
6475,52485,0,0,142,142,0,1,0,1,0
37876,7500,0,0,146,146,0,1,0,1,0
62298,3389,62298,3389,293,223,70,4,0,3,1
21305,3389,21305,3389,293,223,70,4,0,3,1
52477,24500,0,0,92,92,0,1,0,1,0
34336,7707,0,0,134,134,0,1,0,1,0
51008,31652,0,0,135,135,0,1,0,1,0
49155,31546,0,0,146,146,0,1,0,1,0
3279,29228,0,0,143,143,0,1,0,1,0
49455,33688,0,0,135,135,0,1,0,1,0
49524,31652,0,0,133,133,0,1,0,1,0
8352,25773,0,0,156,156,0,1,0,1,0
19959,19521,0,0,76,76,0,1,0,1,0
26286,3389,26286,3389,293,223,70,4,0,3,1
14689,3389,14689,3389,293,223,70,4,0,3,1
29647,32498,0,0,77,77,0,1,0,1,0
19184,26579,0,0,135,135,0,1,0,1,0
28450,26500,0,0,140,140,0,1,0,1,0
51430,30940,0,0,73,73,0,1,0,1,0
52285,33154,0,0,62,62,0,1,0,1,0
8242,25773,0,0,156,156,0,1,0,1,0
24039,22577,0,0,111,111,0,1,0,1,0
1686,22890,0,0,153,153,0,1,0,1,0
16461,2084,6743,2083,204,160,43,2,0,2,0
6904,25103,0,0,157,157,0,1,0,1,0
62706,44501,0,0,98,98,0,1,0,1,0
25377,29904,0,0,104,104,0,1,0,1,0
37697,3389,37697,3389,293,223,70,4,1,3,1
37180,3389,37180,3389,293,223,70,4,1,3,1
18069,3389,18069,3389,293,223,70,4,0,3,1
61975,3389,61975,3389,293,223,70,4,0,3,1
35185,3389,35185,3389,293,223,70,4,0,3,1
7978,61248,0,0,139,139,0,1,0,1,0
41003,5618,0,0,145,145,0,1,0,1,0
8208,61248,0,0,139,139,0,1,0,1,0
18858,43659,0,0,89,89,0,1,0,1,0
12871,3389,12871,3389,293,223,70,4,0,3,1
4097,25773,0,0,144,144,0,1,0,1,0
49313,31652,0,0,140,140,0,1,0,1,0
35648,60553,0,0,103,103,0,1,0,1,0
17912,18494,0,0,65,65,0,1,0,1,0
21289,30458,0,0,95,95,0,1,0,1,0
11554,3389,11554,3389,293,223,70,4,1,3,1
51660,31652,0,0,64,64,0,1,0,1,0
27688,25773,0,0,147,147,0,1,0,1,0
16256,3389,16256,3389,293,223,70,4,0,3,1
14056,27210,0,0,125,125,0,1,0,1,0
51945,5618,0,0,145,145,0,1,0,1,0
52397,33895,0,0,66,66,0,1,0,1,0
1244,22199,0,0,155,155,0,1,0,1,0
12082,3389,12082,3389,293,223,70,4,1,3,1
53944,38765,0,0,76,76,0,1,0,1,0
16850,61248,0,0,148,148,0,1,0,1,0
43490,12790,0,0,149,149,0,1,0,1,0
28204,30629,0,0,97,97,0,1,0,1,0
52042,32433,0,0,62,62,0,1,0,1,0
12298,3389,12298,3389,293,223,70,4,0,3,1
21158,30391,0,0,95,95,0,1,0,1,0
50874,34021,0,0,103,103,0,1,0,1,0
12459,3389,12459,3389,293,223,70,4,1,3,1
11882,61248,0,0,140,140,0,1,0,1,0
52212,33362,0,0,64,64,0,1,0,1,0
14251,3389,14251,3389,293,223,70,4,0,3,1
48967,27251,0,0,154,154,0,1,0,1,0
10443,3389,10443,3389,293,223,70,4,1,3,1
2974,33438,0,0,143,143,0,1,0,1,0
26537,32718,0,0,74,74,0,1,0,1,0
28017,1025,0,0,77,77,0,1,0,1,0
11789,60500,0,0,139,139,0,1,0,1,0
18394,26474,0,0,136,136,0,1,0,1,0
28248,28506,0,0,119,119,0,1,0,1,0
58662,31652,0,0,93,93,0,1,0,1,0
63607,3389,63607,3389,293,223,70,4,0,3,1
9554,61248,0,0,141,141,0,1,0,1,0
14813,3389,14813,3389,293,223,70,4,0,3,1
10996,14426,0,0,150,150,0,1,0,1,0
10597,61248,0,0,139,139,0,1,0,1,0
27852,25434,0,0,144,144,0,1,0,1,0
9383,3389,9383,3389,293,223,70,4,1,3,1
38212,3389,38212,3389,293,223,70,4,1,3,1
3259,25351,0,0,144,144,0,1,0,1,0
34011,60637,0,0,110,110,0,1,0,1,0
18801,3389,18801,3389,293,223,70,4,0,3,1
41004,5618,0,0,145,145,0,1,0,1,0
52595,14787,0,0,150,150,0,1,0,1,0
35188,3389,35188,3389,293,223,70,4,0,3,1
21029,61248,0,0,157,157,0,1,0,1,0
14844,25773,0,0,140,140,0,1,0,1,0
19638,3389,19638,3389,293,223,70,4,0,3,1
13157,20179,0,0,142,142,0,1,0,1,0
3400,27552,0,0,143,143,0,1,0,1,0
17936,25459,0,0,143,143,0,1,0,1,0
11332,3389,11332,3389,293,223,70,4,1,3,1
15846,3389,15846,3389,293,223,70,4,0,3,1
54087,5618,0,0,145,145,0,1,0,1,0
49168,34012,0,0,145,145,0,1,0,1,0
29209,34021,0,0,62,62,0,1,0,1,0
51594,33339,0,0,86,86,0,1,0,1,0
9295,3389,9295,3389,293,223,70,4,1,3,1
55358,7754,0,0,138,138,0,1,0,1,0
18394,3389,18394,3389,293,223,70,4,0,3,1
50401,32624,0,0,102,102,0,1,0,1,0
3414,23174,0,0,157,157,0,1,0,1,0
4037,49116,0,0,144,144,0,1,0,1,0
49093,30127,0,0,148,148,0,1,0,1,0
19736,28964,0,0,111,111,0,1,0,1,0
8151,24334,0,0,145,145,0,1,0,1,0
37881,8623,0,0,145,145,0,1,0,1,0
12045,8007,4152,1538,213,182,31,2,0,1,0
18430,3389,18430,3389,293,223,70,4,0,3,1
33399,3389,33399,3389,293,223,70,4,0,3,1
45785,59676,0,0,62,62,0,1,0,1,0
57519,3389,57519,3389,293,223,70,4,0,3,1
20907,3389,20907,3389,293,223,70,4,0,3,1
50940,31652,0,0,83,83,0,1,0,1,0
49686,33544,0,0,129,129,0,1,0,1,0
26107,740,0,0,68,68,0,1,0,1,0
34949,3389,34949,3389,293,223,70,4,0,3,1
45228,3389,45228,3389,293,223,70,4,0,3,1
19326,61248,0,0,154,154,0,1,0,1,0
11655,61248,0,0,141,141,0,1,0,1,0
11949,61248,0,0,139,139,0,1,0,1,0
15569,13719,0,0,122,122,0,1,0,1,0
48919,26317,0,0,156,156,0,1,0,1,0
50311,32450,0,0,117,117,0,1,0,1,0
3361,28088,0,0,143,143,0,1,0,1,0
22716,34021,0,0,62,62,0,1,0,1,0
38581,4912,0,0,135,135,0,1,0,1,0
27138,1613,0,0,77,77,0,1,0,1,0
37537,3389,37537,3389,293,223,70,4,1,3,1
38268,3389,38268,3389,293,223,70,4,1,3,1
39761,6148,0,0,146,146,0,1,0,1,0
38101,3389,38101,3389,293,223,70,4,1,3,1
18246,25773,0,0,143,143,0,1,0,1,0
10237,25773,0,0,139,139,0,1,0,1,0
4234,52123,0,0,142,142,0,1,0,1,0
9659,61248,0,0,141,141,0,1,0,1,0
13781,21563,0,0,103,103,0,1,0,1,0
11762,5314,8470,2617,259,205,54,3,0,2,0
5983,51742,0,0,142,142,0,1,0,1,0
28320,3389,28320,3389,293,223,70,4,0,3,1
28157,32934,0,0,73,73,0,1,0,1,0
16352,3389,16352,3389,293,223,70,4,0,3,1
51847,31853,0,0,62,62,0,1,0,1,0
19254,25773,0,0,143,143,0,1,0,1,0
51210,32166,0,0,80,80,0,1,0,1,0
17723,3389,17723,3389,293,223,70,4,0,3,1
51111,31652,0,0,83,83,0,1,0,1,0
53093,20863,0,0,102,102,0,1,0,1,0
51415,30761,0,0,74,74,0,1,0,1,0
12060,61248,0,0,139,139,0,1,0,1,0
49160,32000,0,0,146,146,0,1,0,1,0
25607,14361,0,0,97,97,0,1,0,1,0
46749,60125,0,0,67,67,0,1,0,1,0
52807,60622,0,0,102,102,0,1,0,1,0
2781,22259,0,0,155,155,0,1,0,1,0
49952,33303,0,0,120,120,0,1,0,1,0
49569,33650,0,0,132,132,0,1,0,1,0
25264,25773,0,0,146,146,0,1,0,1,0
28262,25833,0,0,147,147,0,1,0,1,0
16827,3389,16827,3389,293,223,70,4,0,3,1
20329,3389,20329,3389,293,223,70,4,0,3,1
20992,61248,0,0,157,157,0,1,0,1,0
48749,35011,0,0,136,136,0,1,0,1,0
23773,32168,0,0,81,81,0,1,0,1,0
27759,2139,0,0,82,82,0,1,0,1,0
21658,32531,0,0,76,76,0,1,0,1,0
48848,60297,0,0,79,79,0,1,0,1,0
59627,32400,0,0,88,88,0,1,0,1,0
8160,25773,0,0,156,156,0,1,0,1,0
13152,26477,0,0,132,132,0,1,0,1,0
9240,56655,0,0,140,140,0,1,0,1,0
10478,25773,0,0,146,146,0,1,0,1,0
49355,24427,0,0,156,156,0,1,0,1,0
18455,58426,0,0,156,156,0,1,0,1,0
18131,1906,7087,1905,191,152,39,2,0,2,0
6072,24472,0,0,129,129,0,1,0,1,0
33469,6973,0,0,127,127,0,1,0,1,0
49093,30121,0,0,148,148,0,1,0,1,0
32896,3389,32896,3389,293,223,70,4,1,3,1
21073,3389,21073,3389,293,223,70,4,1,3,1
31899,60746,0,0,118,118,0,1,0,1,0
13050,59199,0,0,133,133,0,1,0,1,0
27702,34021,0,0,62,62,0,1,0,1,0
29749,34021,0,0,62,62,0,1,0,1,0
20926,27783,0,0,123,123,0,1,0,1,0
63151,41237,0,0,88,88,0,1,0,1,0
5289,51203,0,0,144,144,0,1,0,1,0
10083,4884,7527,2789,267,209,57,3,0,2,0
17636,17204,0,0,75,75,0,1,0,1,0
49754,31652,0,0,126,126,0,1,0,1,0
8017,25718,0,0,157,157,0,1,0,1,0
27099,27473,0,0,130,130,0,1,0,1,0
28888,28696,0,0,117,117,0,1,0,1,0
3579,48116,0,0,144,144,0,1,0,1,0
43808,13554,0,0,150,150,0,1,0,1,0
10873,25282,0,0,141,141,0,1,0,1,0
53601,60687,0,0,106,106,0,1,0,1,0
17499,3389,17499,3389,293,223,70,4,1,3,1
13677,16846,0,0,144,144,0,1,0,1,0
38758,3389,38758,3389,293,223,70,4,0,3,1
52752,6111,0,0,145,145,0,1,0,1,0
21280,31830,0,0,83,83,0,1,0,1,0
14431,23062,0,0,111,111,0,1,0,1,0
15259,61248,0,0,145,145,0,1,0,1,0
51884,31963,0,0,62,62,0,1,0,1,0
35482,3389,35482,3389,293,223,70,4,1,3,1
39902,6047,0,0,146,146,0,1,0,1,0
52111,32637,0,0,62,62,0,1,0,1,0
18980,1678,6240,1677,176,141,34,2,0,1,0
19750,28989,0,0,111,111,0,1,0,1,0
50242,31652,0,0,107,107,0,1,0,1,0
9345,25773,0,0,151,151,0,1,0,1,0
29028,24577,0,0,147,147,0,1,0,1,0
28292,26363,0,0,141,141,0,1,0,1,0
49160,33916,0,0,146,146,0,1,0,1,0
49816,32107,0,0,129,129,0,1,0,1,0
60723,59019,0,0,138,138,0,1,0,1,0
12870,22011,0,0,141,141,0,1,0,1,0
12130,61248,0,0,139,139,0,1,0,1,0
51387,30852,0,0,74,74,0,1,0,1,0
15729,61248,0,0,145,145,0,1,0,1,0
14659,11627,0,0,146,146,0,1,0,1,0
49450,27001,0,0,142,142,0,1,0,1,0
17085,3389,17085,3389,293,223,70,4,0,3,1
28506,34021,0,0,62,62,0,1,0,1,0
53272,19809,0,0,105,105,0,1,0,1,0
15610,3389,15610,3389,293,223,70,4,0,3,1
57486,5134,13889,735,177,161,15,1,0,1,0
52040,32428,0,0,62,62,0,1,0,1,0
9658,3389,9658,3389,293,223,70,4,1,3,1
21932,28479,0,0,116,116,0,1,0,1,0
28629,3389,28629,3389,293,223,70,4,1,3,1
3342,47958,0,0,144,144,0,1,0,1,0
63999,35032,0,0,71,71,0,1,0,1,0
27559,32368,0,0,78,78,0,1,0,1,0
27060,34021,0,0,62,62,0,1,0,1,0
20058,29561,0,0,105,105,0,1,0,1,0
49289,31652,0,0,141,141,0,1,0,1,0
29117,34021,0,0,62,62,0,1,0,1,0
51768,31652,0,0,71,71,0,1,0,1,0
49092,30098,0,0,148,148,0,1,0,1,0
16374,3389,16374,3389,293,223,70,4,0,3,1
13463,10264,1711,634,175,162,13,1,0,1,0
59862,31652,0,0,87,87,0,1,0,1,0
37398,3389,37398,3389,293,223,70,4,0,3,1
20388,27706,0,0,124,124,0,1,0,1,0
19083,31284,0,0,87,87,0,1,0,1,0
5550,51088,0,0,142,142,0,1,0,1,0
20141,3389,20141,3389,293,223,70,4,0,3,1
14790,12406,0,0,140,140,0,1,0,1,0
51540,31652,0,0,66,66,0,1,0,1,0
48912,25985,0,0,156,156,0,1,0,1,0
12115,3389,12115,3389,293,223,70,4,0,3,1
10193,61248,0,0,139,139,0,1,0,1,0
37354,3389,37354,3389,293,223,70,4,1,3,1
9870,3389,9870,3389,293,223,70,4,0,3,1
26917,25773,0,0,147,147,0,1,0,1,0
14585,48230,0,0,102,102,0,1,0,1,0
9265,61248,0,0,139,139,0,1,0,1,0
3028,32699,0,0,143,143,0,1,0,1,0
47815,44102,0,0,113,113,0,1,0,1,0
50006,28029,0,0,120,120,0,1,0,1,0
5011,48103,0,0,147,147,0,1,0,1,0
17936,61248,0,0,152,152,0,1,0,1,0
41744,5618,0,0,145,145,0,1,0,1,0
28454,26519,0,0,140,140,0,1,0,1,0
18097,23195,0,0,115,115,0,1,0,1,0
26722,548,0,0,70,70,0,1,0,1,0
9859,3389,9859,3389,293,223,70,4,1,3,1
49131,30998,0,0,147,147,0,1,0,1,0
21423,61248,0,0,158,158,0,1,0,1,0
11015,61248,0,0,142,142,0,1,0,1,0
36696,8823,0,0,145,145,0,1,0,1,0
57774,61030,0,0,130,130,0,1,0,1,0
11422,25773,0,0,152,152,0,1,0,1,0
21975,35319,0,0,65,65,0,1,0,1,0
21751,32703,0,0,74,74,0,1,0,1,0
16987,3389,16987,3389,293,223,70,4,0,3,1
38271,9300,0,0,146,146,0,1,0,1,0
12145,3389,12145,3389,293,223,70,4,1,3,1
13503,26762,0,0,129,129,0,1,0,1,0
15136,61248,0,0,148,148,0,1,0,1,0
55320,7727,0,0,139,139,0,1,0,1,0
16147,27783,0,0,120,120,0,1,0,1,0
30465,60819,0,0,124,124,0,1,0,1,0
18170,3389,18170,3389,293,223,70,4,1,3,1
11203,3389,11203,3389,293,223,70,4,1,3,1
14863,3389,14863,3389,293,223,70,4,0,3,1
16519,25773,0,0,145,145,0,1,0,1,0
20726,30801,0,0,93,93,0,1,0,1,0
61600,31652,0,0,62,62,0,1,0,1,0
12322,3389,12322,3389,293,223,70,4,0,3,1
51950,32161,0,0,62,62,0,1,0,1,0
21481,61248,0,0,158,158,0,1,0,1,0
54827,10633,0,0,130,130,0,1,0,1,0
31704,3389,31704,3389,293,223,70,4,0,3,1
12447,3389,12447,3389,293,223,70,4,1,3,1
2528,22377,0,0,154,154,0,1,0,1,0
14788,55610,0,0,153,153,0,1,0,1,0
27544,60969,0,0,136,136,0,1,0,1,0
7115,23974,0,0,147,147,0,1,0,1,0
49426,33720,0,0,136,136,0,1,0,1,0
2715,46813,0,0,144,144,0,1,0,1,0
49050,30501,0,0,150,150,0,1,0,1,0
15676,61248,0,0,150,150,0,1,0,1,0
20897,20224,0,0,84,84,0,1,0,1,0
21748,3389,21748,3389,293,223,70,4,0,3,1
48443,37513,0,0,128,128,0,1,0,1,0
12391,8556,3557,1318,204,177,27,2,0,1,0
49150,5618,0,0,145,145,0,1,0,1,0
23670,34021,0,0,62,62,0,1,0,1,0
25509,34021,0,0,62,62,0,1,0,1,0
18893,3389,18893,3389,293,223,70,4,0,3,1
37700,7626,0,0,146,146,0,1,0,1,0
15156,25773,0,0,147,147,0,1,0,1,0
6674,23820,0,0,147,147,0,1,0,1,0
58168,3389,58168,3389,293,223,70,4,0,3,1
23011,33243,0,0,70,70,0,1,0,1,0
53338,19418,0,0,106,106,0,1,0,1,0
9807,3389,9807,3389,293,223,70,4,0,3,1
33408,6921,0,0,126,126,0,1,0,1,0
11204,3389,11204,3389,293,223,70,4,1,3,1
15317,3389,15317,3389,293,223,70,4,0,3,1
3777,50796,0,0,143,143,0,1,0,1,0
49009,28211,0,0,152,152,0,1,0,1,0
25390,23589,0,0,123,123,0,1,0,1,0
18406,3389,18406,3389,293,223,70,4,0,3,1
19691,41432,0,0,82,82,0,1,0,1,0
28667,34021,0,0,62,62,0,1,0,1,0
49666,33562,0,0,129,129,0,1,0,1,0
28138,33856,0,0,63,63,0,1,0,1,0
17228,3389,17228,3389,293,223,70,4,0,3,1
28589,27200,0,0,133,133,0,1,0,1,0
23689,22315,0,0,108,108,0,1,0,1,0
25214,34021,0,0,62,62,0,1,0,1,0
19313,61248,0,0,154,154,0,1,0,1,0
31021,21282,0,0,147,147,0,1,0,1,0
50802,32172,0,0,88,88,0,1,0,1,0
20286,59832,0,0,157,157,0,1,0,1,0
11476,61248,0,0,143,143,0,1,0,1,0
3613,25773,0,0,143,143,0,1,0,1,0
52416,60590,0,0,99,99,0,1,0,1,0
10916,61248,0,0,139,139,0,1,0,1,0
6948,25127,0,0,157,157,0,1,0,1,0
32649,60707,0,0,115,115,0,1,0,1,0
51423,31652,0,0,68,68,0,1,0,1,0
40375,5707,0,0,146,146,0,1,0,1,0
11339,25773,0,0,152,152,0,1,0,1,0
9182,3389,9182,3389,293,223,70,4,1,3,1
49312,31757,0,0,142,142,0,1,0,1,0
12550,25435,0,0,135,135,0,1,0,1,0
8802,57057,0,0,143,143,0,1,0,1,0
51627,31652,0,0,66,66,0,1,0,1,0
51201,31494,0,0,74,74,0,1,0,1,0
23696,3389,23696,3389,293,223,70,4,0,3,1
53031,43384,0,0,145,145,0,1,0,1,0
52467,33694,0,0,62,62,0,1,0,1,0
49946,31652,0,0,120,120,0,1,0,1,0
52671,34709,0,0,70,70,0,1,0,1,0
11219,3389,11219,3389,293,223,70,4,1,3,1
27237,33289,0,0,69,69,0,1,0,1,0
52503,33887,0,0,62,62,0,1,0,1,0
27630,3389,27630,3389,293,223,70,4,0,3,1
11621,61248,0,0,141,141,0,1,0,1,0
14308,23217,0,0,112,112,0,1,0,1,0
51942,27656,0,0,83,83,0,1,0,1,0
18365,3389,18365,3389,293,223,70,4,0,3,1
11317,6847,5405,2003,233,192,41,2,0,2,0
45263,3389,45263,3389,293,223,70,4,0,3,1
27921,2276,0,0,83,83,0,1,0,1,0
12748,3389,12748,3389,293,223,70,4,0,3,1
22401,760,2826,760,113,98,15,1,0,1,0
9034,23701,0,0,150,150,0,1,0,1,0
16467,3389,16467,3389,293,223,70,4,0,3,1
18055,61248,0,0,152,152,0,1,0,1,0
11614,3389,11614,3389,293,223,70,4,1,3,1
25456,29793,0,0,106,106,0,1,0,1,0
61094,32323,0,0,62,62,0,1,0,1,0
15461,3389,15461,3389,293,223,70,4,0,3,1
9772,3389,9772,3389,293,223,70,4,1,3,1
11199,3389,11199,3389,293,223,70,4,1,3,1
15279,3389,15279,3389,293,223,70,4,0,3,1
10144,61248,0,0,141,141,0,1,0,1,0
16533,25773,0,0,143,143,0,1,0,1,0
10358,61248,0,0,143,143,0,1,0,1,0
21029,61248,0,0,157,157,0,1,0,1,0
51847,31855,0,0,62,62,0,1,0,1,0
38372,3389,38372,3389,293,223,70,4,1,3,1
30432,4402,0,0,103,103,0,1,0,1,0
7850,61248,0,0,139,139,0,1,0,1,0
49718,33516,0,0,128,128,0,1,0,1,0
28180,31833,0,0,84,84,0,1,0,1,0
51355,3389,51355,3389,293,223,70,4,0,3,1
28516,34021,0,0,62,62,0,1,0,1,0
12964,3389,12964,3389,293,223,70,4,0,3,1
9229,57768,0,0,143,143,0,1,0,1,0
49709,3389,49709,3389,293,223,70,4,0,3,1
18485,3389,18485,3389,293,223,70,4,0,3,1
26234,24222,0,0,130,130,0,1,0,1,0
20174,19682,0,0,78,78,0,1,0,1,0
62343,31652,0,0,63,63,0,1,0,1,0
61994,3389,61994,3389,293,223,70,4,0,3,1
6016,23591,0,0,149,149,0,1,0,1,0
50492,32575,0,0,113,113,0,1,0,1,0
24594,14896,0,0,92,92,0,1,0,1,0
9075,25773,0,0,155,155,0,1,0,1,0
49823,3389,49823,3389,293,223,70,4,0,3,1
28899,24444,0,0,147,147,0,1,0,1,0
9665,3389,9665,3389,293,223,70,4,0,3,1
27799,32533,0,0,76,76,0,1,0,1,0
27772,34021,0,0,62,62,0,1,0,1,0
19684,31771,0,0,83,83,0,1,0,1,0
21692,36076,0,0,67,67,0,1,0,1,0
49987,27989,0,0,121,121,0,1,0,1,0
13728,16520,0,0,144,144,0,1,0,1,0
32928,18131,0,0,147,147,0,1,0,1,0
30751,21728,0,0,147,147,0,1,0,1,0
53486,31652,0,0,70,70,0,1,0,1,0
5675,33885,0,0,152,152,0,1,0,1,0
36851,8235,0,0,146,146,0,1,0,1,0
19097,3389,19097,3389,293,223,70,4,0,3,1
23124,33084,0,0,71,71,0,1,0,1,0
7696,61248,0,0,139,139,0,1,0,1,0
27338,60980,0,0,137,137,0,1,0,1,0
51735,32501,0,0,68,68,0,1,0,1,0
21475,61248,0,0,158,158,0,1,0,1,0
48514,3389,48514,3389,293,223,70,4,0,3,1
23717,34021,0,0,62,62,0,1,0,1,0
17398,16803,0,0,81,81,0,1,0,1,0
33151,60681,0,0,113,113,0,1,0,1,0
48906,25871,0,0,156,156,0,1,0,1,0
1137,21916,0,0,157,157,0,1,0,1,0
29859,33561,0,0,66,66,0,1,0,1,0
12786,61248,0,0,145,145,0,1,0,1,0
22145,3389,22145,3389,293,223,70,4,0,3,1
52723,23050,0,0,96,96,0,1,0,1,0
14881,3389,14881,3389,293,223,70,4,0,3,1
5685,25773,0,0,149,149,0,1,0,1,0
60445,31652,0,0,84,84,0,1,0,1,0
20101,3389,20101,3389,293,223,70,4,0,3,1
24998,34021,0,0,62,62,0,1,0,1,0
52313,33238,0,0,62,62,0,1,0,1,0
50620,33794,0,0,137,137,0,1,0,1,0
6018,25773,0,0,150,150,0,1,0,1,0
12139,25773,0,0,151,151,0,1,0,1,0
20682,3389,20682,3389,293,223,70,4,0,3,1
51939,32869,0,0,66,66,0,1,0,1,0
17781,3389,17781,3389,293,223,70,4,0,3,1
35821,8973,0,0,145,145,0,1,0,1,0
11919,61248,0,0,140,140,0,1,0,1,0
49910,33342,0,0,121,121,0,1,0,1,0
53942,45586,0,0,145,145,0,1,0,1,0
58953,31652,0,0,62,62,0,1,0,1,0
12989,61248,0,0,140,140,0,1,0,1,0
17223,25773,0,0,144,144,0,1,0,1,0
48944,27096,0,0,155,155,0,1,0,1,0
29848,34021,0,0,62,62,0,1,0,1,0
24163,255,822,254,79,74,5,1,0,1,0
16734,3389,16734,3389,293,223,70,4,0,3,1
49129,33040,0,0,147,147,0,1,0,1,0
20405,61248,0,0,156,156,0,1,0,1,0
14208,3389,14208,3389,293,223,70,4,1,3,1
5314,25773,0,0,148,148,0,1,0,1,0
57500,51250,0,0,116,116,0,1,0,1,0
52930,43139,0,0,145,145,0,1,0,1,0
49980,28455,0,0,118,118,0,1,0,1,0
50011,31652,0,0,141,141,0,1,0,1,0
51265,31653,0,0,71,71,0,1,0,1,0
18203,19793,0,0,78,78,0,1,0,1,0
22796,34021,0,0,62,62,0,1,0,1,0
52713,33993,0,0,62,62,0,1,0,1,0
33698,3389,33698,3389,293,223,70,4,0,3,1
8704,23125,0,0,114,114,0,1,0,1,0
2522,22682,0,0,157,157,0,1,0,1,0
50652,29349,0,0,99,99,0,1,0,1,0
49767,31652,0,0,126,126,0,1,0,1,0
17227,3389,17227,3389,293,223,70,4,0,3,1
47361,47505,0,0,102,102,0,1,0,1,0
51221,34021,0,0,95,95,0,1,0,1,0
7704,54338,0,0,141,141,0,1,0,1,0
22516,31097,0,0,89,89,0,1,0,1,0
11572,25525,0,0,140,140,0,1,0,1,0
11977,3389,11977,3389,293,223,70,4,0,3,1
15908,61248,0,0,150,150,0,1,0,1,0
14649,3389,14649,3389,293,223,70,4,0,3,1
11096,3389,11096,3389,293,223,70,4,0,3,1
51185,32188,0,0,81,81,0,1,0,1,0
15036,3389,15036,3389,293,223,70,4,0,3,1
8792,25773,0,0,156,156,0,1,0,1,0
13150,20219,0,0,142,142,0,1,0,1,0
55483,44111,0,0,92,92,0,1,0,1,0
50922,5618,0,0,145,145,0,1,0,1,0
37237,3389,37237,3389,293,223,70,4,1,3,1
60526,60457,0,0,142,142,0,1,0,1,0
25982,14164,0,0,98,98,0,1,0,1,0
51496,31907,0,0,71,71,0,1,0,1,0
47840,43912,0,0,114,114,0,1,0,1,0
52459,33668,0,0,62,62,0,1,0,1,0
20462,3389,20462,3389,293,223,70,4,0,3,1
36312,3389,36312,3389,293,223,70,4,0,3,1
26197,3389,26197,3389,293,223,70,4,0,3,1
7276,25773,0,0,143,143,0,1,0,1,0
50102,28225,0,0,117,117,0,1,0,1,0
22608,2888,0,0,82,82,0,1,0,1,0
32113,5825,0,0,116,116,0,1,0,1,0
51292,31652,0,0,77,77,0,1,0,1,0
1781,23039,0,0,152,152,0,1,0,1,0
14104,61248,0,0,148,148,0,1,0,1,0
28035,26153,0,0,144,144,0,1,0,1,0
49160,31745,0,0,146,146,0,1,0,1,0
48077,34021,0,0,141,141,0,1,0,1,0
1376,22405,0,0,155,155,0,1,0,1,0
15582,25773,0,0,146,146,0,1,0,1,0
29848,34021,0,0,62,62,0,1,0,1,0
22240,3389,22240,3389,293,223,70,4,0,3,1
9092,56432,0,0,140,140,0,1,0,1,0
51522,33289,0,0,87,87,0,1,0,1,0
12266,61248,0,0,139,139,0,1,0,1,0
51671,31652,0,0,64,64,0,1,0,1,0
52059,16382,0,0,151,151,0,1,0,1,0
26031,3389,26031,3389,293,223,70,4,0,3,1
50793,34021,0,0,105,105,0,1,0,1,0
48645,34021,0,0,143,143,0,1,0,1,0
50189,32862,0,0,109,109,0,1,0,1,0
62727,44343,0,0,97,97,0,1,0,1,0
11566,61248,0,0,141,141,0,1,0,1,0
12827,3389,12827,3389,293,223,70,4,0,3,1
3480,26448,0,0,143,143,0,1,0,1,0
57945,61044,0,0,131,131,0,1,0,1,0
10878,3389,10878,3389,293,223,70,4,1,3,1
49160,32158,0,0,146,146,0,1,0,1,0
14060,25773,0,0,140,140,0,1,0,1,0
21716,3389,21716,3389,293,223,70,4,0,3,1
28408,26291,0,0,142,142,0,1,0,1,0
30864,11588,0,0,122,122,0,1,0,1,0
17294,3389,17294,3389,293,223,70,4,0,3,1
52066,32504,0,0,62,62,0,1,0,1,0
25629,23768,0,0,125,125,0,1,0,1,0
12307,61187,0,0,138,138,0,1,0,1,0
27862,3389,27862,3389,293,223,70,4,0,3,1
38158,3389,38158,3389,293,223,70,4,0,3,1
15447,3389,15447,3389,293,223,70,4,0,3,1
40296,5764,0,0,146,146,0,1,0,1,0
12651,3389,12651,3389,293,223,70,4,0,3,1
3389,27705,0,0,143,143,0,1,0,1,0
44601,15456,0,0,151,151,0,1,0,1,0
16672,15578,0,0,97,97,0,1,0,1,0
62413,31652,0,0,73,73,0,1,0,1,0
9224,15746,0,0,151,151,0,1,0,1,0
21378,3389,21378,3389,293,223,70,4,0,3,1
51017,32939,0,0,100,100,0,1,0,1,0
46864,7106,0,0,145,145,0,1,0,1,0
10562,3389,10562,3389,293,223,70,4,0,3,1
12829,3389,12829,3389,293,223,70,4,0,3,1
33736,16796,0,0,147,147,0,1,0,1,0
36261,3389,36261,3389,293,223,70,4,0,3,1
51684,31652,0,0,63,63,0,1,0,1,0
25935,29117,0,0,113,113,0,1,0,1,0
63906,31762,0,0,62,62,0,1,0,1,0
12496,25503,0,0,136,136,0,1,0,1,0
30717,60806,0,0,123,123,0,1,0,1,0
14342,11662,200,74,151,149,1,1,0,1,0
11835,61248,0,0,139,139,0,1,0,1,0
52633,33483,0,0,126,126,0,1,0,1,0
14056,3389,14056,3389,293,223,70,4,0,3,1
14479,3389,14479,3389,293,223,70,4,0,3,1
9843,3389,9843,3389,293,223,70,4,1,3,1
9751,24557,0,0,141,141,0,1,0,1,0
27424,27016,0,0,135,135,0,1,0,1,0
22342,33801,0,0,64,64,0,1,0,1,0
54144,14663,0,0,119,119,0,1,0,1,0
14412,55554,0,0,122,122,0,1,0,1,0
11374,61248,0,0,139,139,0,1,0,1,0
8528,16264,0,0,151,151,0,1,0,1,0
27810,34021,0,0,62,62,0,1,0,1,0
52536,33991,0,0,63,63,0,1,0,1,0
49114,32554,0,0,147,147,0,1,0,1,0
49819,33424,0,0,124,124,0,1,0,1,0
51397,38480,0,0,62,62,0,1,0,1,0
11445,3389,11445,3389,293,223,70,4,1,3,1
60113,32518,0,0,62,62,0,1,0,1,0
29375,34021,0,0,62,62,0,1,0,1,0
8386,25773,0,0,143,143,0,1,0,1,0
18885,26373,0,0,137,137,0,1,0,1,0
18041,24995,0,0,134,134,0,1,0,1,0
4018,51496,0,0,142,142,0,1,0,1,0
23909,1457,0,0,72,72,0,1,0,1,0
9605,3389,9605,3389,293,223,70,4,1,3,1
21959,33089,0,0,71,71,0,1,0,1,0
37880,7497,0,0,146,146,0,1,0,1,0
3896,48882,0,0,144,144,0,1,0,1,0
32209,3389,32209,3389,293,223,70,4,0,3,1
10817,3389,10817,3389,293,223,70,4,0,3,1
52168,32806,0,0,62,62,0,1,0,1,0
14182,61248,0,0,148,148,0,1,0,1,0
11088,25773,0,0,143,143,0,1,0,1,0
12243,61248,0,0,139,139,0,1,0,1,0
50834,30108,0,0,107,107,0,1,0,1,0
8707,61248,0,0,140,140,0,1,0,1,0
28194,31156,0,0,91,91,0,1,0,1,0
22410,28809,0,0,113,113,0,1,0,1,0
50483,32532,0,0,99,99,0,1,0,1,0
12155,61248,0,0,139,139,0,1,0,1,0
7235,54447,0,0,143,143,0,1,0,1,0
8484,25773,0,0,155,155,0,1,0,1,0
13248,61248,0,0,145,145,0,1,0,1,0
18921,3389,18921,3389,293,223,70,4,0,3,1
18152,21433,0,0,96,96,0,1,0,1,0
10100,25773,0,0,148,148,0,1,0,1,0
4205,23612,0,0,157,157,0,1,0,1,0
30479,3389,30479,3389,293,223,70,4,1,3,1
12769,7756,5304,1639,218,184,33,2,0,1,0
52523,33859,0,0,62,62,0,1,0,1,0
18966,3389,18966,3389,293,223,70,4,0,3,1
50481,29000,0,0,104,104,0,1,0,1,0
59694,4544,30842,1632,216,182,33,2,0,1,0
51774,31652,0,0,62,62,0,1,0,1,0
9979,25773,0,0,148,148,0,1,0,1,0
28703,27770,0,0,127,127,0,1,0,1,0
53932,60715,0,0,108,108,0,1,0,1,0
48916,26078,0,0,156,156,0,1,0,1,0
43212,5618,0,0,145,145,0,1,0,1,0
51782,32586,0,0,68,68,0,1,0,1,0
21738,32680,0,0,75,75,0,1,0,1,0
3600,25773,0,0,143,143,0,1,0,1,0
58225,3389,58225,3389,293,223,70,4,0,3,1
52079,41079,0,0,145,145,0,1,0,1,0
4718,25773,0,0,146,146,0,1,0,1,0
49039,26113,0,0,152,152,0,1,0,1,0
20442,3389,20442,3389,293,223,70,4,0,3,1
11135,3389,11135,3389,293,223,70,4,0,3,1
16368,20618,0,0,86,86,0,1,0,1,0
57715,31652,0,0,99,99,0,1,0,1,0
49097,26170,0,0,150,150,0,1,0,1,0
51374,31652,0,0,69,69,0,1,0,1,0
1464,22097,0,0,157,157,0,1,0,1,0
49677,31652,0,0,127,127,0,1,0,1,0
10035,3389,10035,3389,293,223,70,4,0,3,1
49160,33249,0,0,146,146,0,1,0,1,0
21056,60423,0,0,158,158,0,1,0,1,0
51600,31287,0,0,67,67,0,1,0,1,0
5886,56928,0,0,140,140,0,1,0,1,0
11835,25617,0,0,139,139,0,1,0,1,0
49575,31652,0,0,132,132,0,1,0,1,0
14026,3389,14026,3389,293,223,70,4,0,3,1
51469,32021,0,0,70,70,0,1,0,1,0
63438,31855,0,0,62,62,0,1,0,1,0
18042,3389,18042,3389,293,223,70,4,0,3,1
49985,33092,0,0,116,116,0,1,0,1,0
27707,25773,0,0,147,147,0,1,0,1,0
10006,61248,0,0,139,139,0,1,0,1,0
29276,30641,0,0,97,97,0,1,0,1,0
36038,8818,0,0,146,146,0,1,0,1,0
14998,25773,0,0,147,147,0,1,0,1,0
50052,3389,50052,3389,293,223,70,4,0,3,1
21699,16423,0,0,78,78,0,1,0,1,0
10759,3389,10759,3389,293,223,70,4,1,3,1
7023,25773,0,0,153,153,0,1,0,1,0
39687,6200,0,0,146,146,0,1,0,1,0
52510,42122,0,0,145,145,0,1,0,1,0
19613,3389,19613,3389,293,223,70,4,0,3,1
20847,3389,20847,3389,293,223,70,4,0,3,1
15115,3389,15115,3389,293,223,70,4,0,3,1
29383,34021,0,0,62,62,0,1,0,1,0
18992,61248,0,0,152,152,0,1,0,1,0
7578,23365,0,0,151,151,0,1,0,1,0
17888,25773,0,0,142,142,0,1,0,1,0
50827,30093,0,0,107,107,0,1,0,1,0
16070,3389,16070,3389,293,223,70,4,0,3,1
10923,25773,0,0,139,139,0,1,0,1,0
48983,28351,0,0,153,153,0,1,0,1,0
28737,34021,0,0,62,62,0,1,0,1,0
15320,3389,15320,3389,293,223,70,4,0,3,1
5063,24086,0,0,157,157,0,1,0,1,0
51684,34021,0,0,83,83,0,1,0,1,0
10957,61248,0,0,139,139,0,1,0,1,0
14676,25773,0,0,147,147,0,1,0,1,0
17428,16854,0,0,80,80,0,1,0,1,0
10844,3389,10844,3389,293,223,70,4,1,3,1
54527,41065,0,0,88,88,0,1,0,1,0
52510,33974,0,0,63,63,0,1,0,1,0
11125,3389,11125,3389,293,223,70,4,0,3,1
50522,31652,0,0,98,98,0,1,0,1,0
52302,33524,0,0,64,64,0,1,0,1,0
10731,3389,10731,3389,293,223,70,4,1,3,1
21122,31537,0,0,86,86,0,1,0,1,0
40540,5618,0,0,145,145,0,1,0,1,0
1895,23216,0,0,152,152,0,1,0,1,0
55477,6215,0,0,145,145,0,1,0,1,0
49144,34021,0,0,145,145,0,1,0,1,0
28865,34021,0,0,62,62,0,1,0,1,0
11758,61248,0,0,141,141,0,1,0,1,0
52037,33046,0,0,66,66,0,1,0,1,0
51242,31652,0,0,79,79,0,1,0,1,0
20818,61248,0,0,157,157,0,1,0,1,0
57563,32719,0,0,99,99,0,1,0,1,0
4557,25773,0,0,146,146,0,1,0,1,0
18897,3389,18897,3389,293,223,70,4,0,3,1
51142,30798,0,0,99,99,0,1,0,1,0
13238,24567,0,0,126,126,0,1,0,1,0
47033,3389,47033,3389,293,223,70,4,0,3,1
28548,26994,0,0,135,135,0,1,0,1,0
48344,3389,48344,3389,293,223,70,4,0,3,1
18168,18347,0,0,63,63,0,1,0,1,0
26626,24515,0,0,133,133,0,1,0,1,0
19374,26879,0,0,132,132,0,1,0,1,0
13627,9833,2612,807,182,165,16,1,0,1,0
25892,34021,0,0,62,62,0,1,0,1,0
24612,148,477,147,72,69,3,1,0,1,0
36996,3389,36996,3389,293,223,70,4,0,3,1
30923,3389,30923,3389,293,223,70,4,0,3,1
33198,17685,0,0,147,147,0,1,0,1,0
18130,22127,0,0,103,103,0,1,0,1,0
16603,15463,0,0,99,99,0,1,0,1,0
20251,17187,0,0,71,71,0,1,0,1,0
5341,25773,0,0,148,148,0,1,0,1,0
2173,44519,0,0,144,144,0,1,0,1,0
9938,61248,0,0,139,139,0,1,0,1,0
12426,8613,3496,1295,203,176,26,2,0,1,0
5072,24091,0,0,157,157,0,1,0,1,0
1600,22172,0,0,157,157,0,1,0,1,0
9736,3389,9736,3389,293,223,70,4,1,3,1
49822,27652,0,0,126,126,0,1,0,1,0
17638,25685,0,0,143,143,0,1,0,1,0
16298,61248,0,0,151,151,0,1,0,1,0
50489,32525,0,0,99,99,0,1,0,1,0
12178,3389,12178,3389,293,223,70,4,1,3,1
51136,31331,0,0,76,76,0,1,0,1,0
24461,30227,0,0,99,99,0,1,0,1,0
11109,6516,5763,2136,239,195,44,2,0,2,0
33428,3389,33428,3389,293,223,70,4,0,3,1
49160,32114,0,0,146,146,0,1,0,1,0
9382,3389,9382,3389,293,223,70,4,1,3,1
16413,3389,16413,3389,293,223,70,4,0,3,1
9051,61248,0,0,140,140,0,1,0,1,0
19078,3389,19078,3389,293,223,70,4,0,3,1
26077,31344,0,0,88,88,0,1,0,1,0
16361,61248,0,0,151,151,0,1,0,1,0
13445,18333,0,0,143,143,0,1,0,1,0
11735,5251,8552,2642,261,206,54,3,0,2,0
12006,3389,12006,3389,293,223,70,4,0,3,1
28413,26315,0,0,142,142,0,1,0,1,0
11310,3389,11310,3389,293,223,70,4,1,3,1
19516,1534,5705,1534,166,134,31,2,0,1,0
46710,3389,46710,3389,293,223,70,4,0,3,1
15211,3389,15211,3389,293,223,70,4,0,3,1
33129,60683,0,0,113,113,0,1,0,1,0
52139,32720,0,0,62,62,0,1,0,1,0
28289,25795,0,0,147,147,0,1,0,1,0
36642,3389,36642,3389,293,223,70,4,0,3,1
22236,3389,22236,3389,293,223,70,4,0,3,1
49008,28180,0,0,152,152,0,1,0,1,0
47826,44019,0,0,113,113,0,1,0,1,0
46087,56782,0,0,71,71,0,1,0,1,0
51896,5618,0,0,145,145,0,1,0,1,0
12599,3389,12599,3389,293,223,70,4,1,3,1
38023,3389,38023,3389,293,223,70,4,1,3,1
34607,3449,0,0,113,113,0,1,0,1,0
28749,3389,28749,3389,293,223,70,4,0,3,1
17889,3389,17889,3389,293,223,70,4,0,3,1
24719,123,395,122,70,67,2,1,0,1,0
21606,25773,0,0,144,144,0,1,0,1,0
19779,3389,19779,3389,293,223,70,4,0,3,1
3151,47640,0,0,144,144,0,1,0,1,0
5533,55900,0,0,141,141,0,1,0,1,0
27740,26570,0,0,139,139,0,1,0,1,0
29186,30189,0,0,101,101,0,1,0,1,0
49276,26537,0,0,144,144,0,1,0,1,0
3391,22678,0,0,153,153,0,1,0,1,0
9966,3389,9966,3389,293,223,70,4,1,3,1
58914,32757,0,0,62,62,0,1,0,1,0
17790,18823,0,0,67,67,0,1,0,1,0
49310,26606,0,0,143,143,0,1,0,1,0
20318,39255,0,0,77,77,0,1,0,1,0
6707,52835,0,0,142,142,0,1,0,1,0
10818,25773,0,0,145,145,0,1,0,1,0
3965,47300,0,0,146,146,0,1,0,1,0
49896,5618,0,0,145,145,0,1,0,1,0
50601,32716,0,0,99,99,0,1,0,1,0
48998,28852,0,0,152,152,0,1,0,1,0
13189,22003,0,0,109,109,0,1,0,1,0
29171,3389,29171,3389,293,223,70,4,1,3,1
21102,3389,21102,3389,293,223,70,4,0,3,1
16097,20959,0,0,89,89,0,1,0,1,0
4963,54245,0,0,141,141,0,1,0,1,0
50372,32924,0,0,107,107,0,1,0,1,0
21954,3389,21954,3389,293,223,70,4,0,3,1
50742,31652,0,0,90,90,0,1,0,1,0
39931,60333,0,0,85,85,0,1,0,1,0
14044,10843,1302,402,165,156,8,1,0,1,0
31481,18678,0,0,147,147,0,1,0,1,0
38585,6991,0,0,146,146,0,1,0,1,0
15884,14250,0,0,115,115,0,1,0,1,0
26802,1329,0,0,74,74,0,1,0,1,0
12630,25333,0,0,134,134,0,1,0,1,0
29730,32916,0,0,73,73,0,1,0,1,0
14785,3389,14785,3389,293,223,70,4,0,3,1
8125,16564,0,0,152,152,0,1,0,1,0
17679,61248,0,0,149,149,0,1,0,1,0
51307,31729,0,0,71,71,0,1,0,1,0
42865,11291,0,0,149,149,0,1,0,1,0
26851,32974,0,0,72,72,0,1,0,1,0
49594,27186,0,0,134,134,0,1,0,1,0
14122,3389,14122,3389,293,223,70,4,0,3,1
55432,5618,0,0,145,145,0,1,0,1,0
49020,26013,0,0,153,153,0,1,0,1,0
16168,2153,6968,2153,208,164,44,2,0,2,0
15286,3389,15286,3389,293,223,70,4,0,3,1
21907,61248,0,0,158,158,0,1,0,1,0
9438,61248,0,0,141,141,0,1,0,1,0
5138,25773,0,0,142,142,0,1,0,1,0
21773,61248,0,0,158,158,0,1,0,1,0
52710,31652,0,0,70,70,0,1,0,1,0
50853,30150,0,0,106,106,0,1,0,1,0
50336,42488,0,0,62,62,0,1,0,1,0
61382,31652,0,0,78,78,0,1,0,1,0
13947,25773,0,0,140,140,0,1,0,1,0
63284,40264,0,0,86,86,0,1,0,1,0
54745,5618,0,0,145,145,0,1,0,1,0
52054,5618,0,0,145,145,0,1,0,1,0
31355,3389,31355,3389,293,223,70,4,0,3,1
19098,18875,0,0,69,69,0,1,0,1,0
12934,3389,12934,3389,293,223,70,4,0,3,1
50481,41940,0,0,62,62,0,1,0,1,0
3846,22836,0,0,152,152,0,1,0,1,0
13952,49374,0,0,105,105,0,1,0,1,0
26279,25773,0,0,147,147,0,1,0,1,0
56894,60958,0,0,125,125,0,1,0,1,0
51440,31652,0,0,68,68,0,1,0,1,0
9280,56715,0,0,140,140,0,1,0,1,0
33360,3389,33360,3389,293,223,70,4,0,3,1
9730,3389,9730,3389,293,223,70,4,0,3,1
15642,3389,15642,3389,293,223,70,4,0,3,1
35399,3389,35399,3389,293,223,70,4,0,3,1
55675,31652,0,0,62,62,0,1,0,1,0
13749,16387,0,0,145,145,0,1,0,1,0
33152,3389,33152,3389,293,223,70,4,0,3,1
37905,3389,37905,3389,293,223,70,4,1,3,1
16777,20922,0,0,144,144,0,1,0,1,0
59150,58179,0,0,145,145,0,1,0,1,0
48553,60273,0,0,78,78,0,1,0,1,0
51513,32099,0,0,70,70,0,1,0,1,0
16501,3389,16501,3389,293,223,70,4,0,3,1
50183,32361,0,0,120,120,0,1,0,1,0
4091,39152,0,0,149,149,0,1,0,1,0
2373,23964,0,0,149,149,0,1,0,1,0
11380,3389,11380,3389,293,223,70,4,0,3,1
50017,34021,0,0,124,124,0,1,0,1,0
9868,3389,9868,3389,293,223,70,4,0,3,1
51489,33266,0,0,88,88,0,1,0,1,0
3521,22723,0,0,153,153,0,1,0,1,0
55945,45925,0,0,102,102,0,1,0,1,0
28165,32522,0,0,77,77,0,1,0,1,0
40129,8243,0,0,145,145,0,1,0,1,0
51910,32521,0,0,79,79,0,1,0,1,0
14511,3389,14511,3389,293,223,70,4,0,3,1
10952,6267,6032,2235,243,197,46,2,0,2,0
10638,3389,10638,3389,293,223,70,4,1,3,1
7776,16824,0,0,152,152,0,1,0,1,0
2223,23731,0,0,150,150,0,1,0,1,0
14886,12567,0,0,138,138,0,1,0,1,0
16392,61248,0,0,151,151,0,1,0,1,0
62707,44488,0,0,98,98,0,1,0,1,0
11605,25773,0,0,139,139,0,1,0,1,0
19922,29308,0,0,108,108,0,1,0,1,0
32813,3389,32813,3389,293,223,70,4,0,3,1
42683,3389,42683,3389,293,223,70,4,0,3,1
15574,3389,15574,3389,293,223,70,4,0,3,1
43386,60156,0,0,71,71,0,1,0,1,0
8381,61248,0,0,140,140,0,1,0,1,0
23753,34021,0,0,62,62,0,1,0,1,0
49165,34014,0,0,145,145,0,1,0,1,0
29206,23760,0,0,147,147,0,1,0,1,0
22755,25773,0,0,145,145,0,1,0,1,0
20063,39877,0,0,79,79,0,1,0,1,0
20239,1340,4983,1340,153,125,27,2,0,1,0
37330,7891,0,0,146,146,0,1,0,1,0
21267,25773,0,0,144,144,0,1,0,1,0
3017,24972,0,0,145,145,0,1,0,1,0
51246,31606,0,0,72,72,0,1,0,1,0
14068,3389,14068,3389,293,223,70,4,0,3,1
20370,3389,20370,3389,293,223,70,4,0,3,1
61009,56927,0,0,132,132,0,1,0,1,0
12471,8684,3419,1267,202,176,26,2,0,1,0
17735,25773,0,0,142,142,0,1,0,1,0
10039,3389,10039,3389,293,223,70,4,0,3,1
17428,2094,7789,2094,204,161,43,2,0,2,0
23804,340,1098,339,85,78,7,1,0,1,0
49700,27563,0,0,136,136,0,1,0,1,0
11801,61248,0,0,140,140,0,1,0,1,0
47065,48785,0,0,95,95,0,1,0,1,0
49166,31652,0,0,145,145,0,1,0,1,0
51534,31652,0,0,66,66,0,1,0,1,0
15555,3389,15555,3389,293,223,70,4,0,3,1
13534,61248,0,0,141,141,0,1,0,1,0
26695,33271,0,0,68,68,0,1,0,1,0
17082,3389,17082,3389,293,223,70,4,0,3,1
10417,3389,10417,3389,293,223,70,4,1,3,1
10008,4764,7656,2837,269,210,58,3,0,2,0
19006,3389,19006,3389,293,223,70,4,0,3,1
14866,22513,0,0,105,105,0,1,0,1,0
42710,3389,42710,3389,293,223,70,4,0,3,1
17650,61248,0,0,149,149,0,1,0,1,0
6660,52763,0,0,142,142,0,1,0,1,0
54598,8828,0,0,146,146,0,1,0,1,0
33750,7211,0,0,129,129,0,1,0,1,0
57011,60968,0,0,125,125,0,1,0,1,0
10209,25773,0,0,139,139,0,1,0,1,0
19528,3389,19528,3389,293,223,70,4,0,3,1
31638,60759,0,0,119,119,0,1,0,1,0
49048,30446,0,0,150,150,0,1,0,1,0
17978,17780,0,0,68,68,0,1,0,1,0
8462,56491,0,0,143,143,0,1,0,1,0
51168,31760,0,0,75,75,0,1,0,1,0
11582,3389,11582,3389,293,223,70,4,0,3,1
31101,3389,31101,3389,293,223,70,4,0,3,1
28135,34007,0,0,62,62,0,1,0,1,0
18432,18377,0,0,63,63,0,1,0,1,0
14822,3389,14822,3389,293,223,70,4,0,3,1
5450,55660,0,0,141,141,0,1,0,1,0
11881,61248,0,0,143,143,0,1,0,1,0
35621,3389,35621,3389,293,223,70,4,0,3,1
11586,3389,11586,3389,293,223,70,4,1,3,1
33742,7204,0,0,129,129,0,1,0,1,0
51415,31981,0,0,73,73,0,1,0,1,0
28862,34021,0,0,62,62,0,1,0,1,0
9525,23814,0,0,149,149,0,1,0,1,0
50671,30173,0,0,93,93,0,1,0,1,0
9936,3389,9936,3389,293,223,70,4,1,3,1
12340,3389,12340,3389,293,223,70,4,1,3,1
14187,3389,14187,3389,293,223,70,4,0,3,1
15116,3389,15116,3389,293,223,70,4,0,3,1
11966,25773,0,0,139,139,0,1,0,1,0
3320,47726,0,0,144,144,0,1,0,1,0
15211,3389,15211,3389,293,223,70,4,0,3,1
49615,31652,0,0,129,129,0,1,0,1,0
3775,25773,0,0,142,142,0,1,0,1,0
18733,61248,0,0,152,152,0,1,0,1,0
10627,3389,10627,3389,293,223,70,4,1,3,1
35292,9252,0,0,143,143,0,1,0,1,0
16234,3389,16234,3389,293,223,70,4,0,3,1
9877,24464,0,0,140,140,0,1,0,1,0
5911,57001,0,0,140,140,0,1,0,1,0
3810,19778,0,0,155,155,0,1,0,1,0
10984,3389,10984,3389,293,223,70,4,1,3,1
2993,22539,0,0,153,153,0,1,0,1,0
16377,25773,0,0,143,143,0,1,0,1,0
49472,34021,0,0,138,138,0,1,0,1,0
25611,34021,0,0,62,62,0,1,0,1,0
17473,3389,17473,3389,293,223,70,4,0,3,1
3385,25548,0,0,143,143,0,1,0,1,0
28239,28929,0,0,115,115,0,1,0,1,0
15310,3389,15310,3389,293,223,70,4,0,3,1
15720,3389,15720,3389,293,223,70,4,0,3,1
12557,3389,12557,3389,293,223,70,4,1,3,1
38091,7346,0,0,146,146,0,1,0,1,0
59704,61189,0,0,140,140,0,1,0,1,0
59639,3389,59639,3389,293,223,70,4,0,3,1
1103,21978,0,0,156,156,0,1,0,1,0
13135,3389,13135,3389,293,223,70,4,0,3,1
15040,20628,0,0,92,92,0,1,0,1,0
18227,19013,0,0,70,70,0,1,0,1,0
17176,19599,0,0,75,75,0,1,0,1,0
20102,3389,20102,3389,293,223,70,4,0,3,1
49094,30163,0,0,148,148,0,1,0,1,0
16337,3389,16337,3389,293,223,70,4,0,3,1
9605,25773,0,0,154,154,0,1,0,1,0
10713,3389,10713,3389,293,223,70,4,0,3,1
12089,3389,12089,3389,293,223,70,4,0,3,1
16775,3389,16775,3389,293,223,70,4,0,3,1
17539,2065,7679,2064,202,160,42,2,0,2,0
26173,28781,0,0,116,116,0,1,0,1,0
18400,18353,0,0,63,63,0,1,0,1,0
52282,33144,0,0,62,62,0,1,0,1,0
51545,31704,0,0,88,88,0,1,0,1,0
18210,19579,0,0,76,76,0,1,0,1,0
36094,3389,36094,3389,293,223,70,4,1,3,1
10255,3389,10255,3389,293,223,70,4,1,3,1
4018,49085,0,0,144,144,0,1,0,1,0
11881,25773,0,0,140,140,0,1,0,1,0
21592,3389,21592,3389,293,223,70,4,0,3,1
26840,1360,0,0,74,74,0,1,0,1,0
27104,27466,0,0,130,130,0,1,0,1,0
10112,3389,10112,3389,293,223,70,4,1,3,1
5821,52089,0,0,144,144,0,1,0,1,0
49086,31651,0,0,149,149,0,1,0,1,0
19756,27191,0,0,129,129,0,1,0,1,0
47047,3389,47047,3389,293,223,70,4,0,3,1
48374,60258,0,0,77,77,0,1,0,1,0
23873,32028,0,0,82,82,0,1,0,1,0
11043,6412,5876,2177,241,196,44,2,0,2,0
12607,22435,0,0,114,114,0,1,0,1,0
52555,34021,0,0,62,62,0,1,0,1,0
12387,13390,0,0,149,149,0,1,0,1,0
18741,3389,18741,3389,293,223,70,4,0,3,1
34430,3389,34430,3389,293,223,70,4,0,3,1
49160,33584,0,0,146,146,0,1,0,1,0
52439,27240,0,0,76,76,0,1,0,1,0
16564,20087,0,0,145,145,0,1,0,1,0
44383,7525,0,0,145,145,0,1,0,1,0
18654,44205,0,0,90,90,0,1,0,1,0
15918,14308,0,0,114,114,0,1,0,1,0
28569,33065,0,0,71,71,0,1,0,1,0
14949,12675,0,0,136,136,0,1,0,1,0
50088,33180,0,0,116,116,0,1,0,1,0
17172,22468,0,0,144,144,0,1,0,1,0
9925,3389,9925,3389,293,223,70,4,1,3,1
29759,34021,0,0,62,62,0,1,0,1,0
7547,25773,0,0,143,143,0,1,0,1,0
12921,22202,0,0,111,111,0,1,0,1,0
51810,31745,0,0,62,62,0,1,0,1,0
50156,34021,0,0,121,121,0,1,0,1,0
49436,27099,0,0,137,137,0,1,0,1,0
35683,8848,0,0,144,144,0,1,0,1,0
48913,26014,0,0,156,156,0,1,0,1,0
17477,16936,0,0,79,79,0,1,0,1,0
49246,31652,0,0,142,142,0,1,0,1,0
3311,23117,0,0,157,157,0,1,0,1,0
36344,4088,0,0,123,123,0,1,0,1,0
37391,3389,37391,3389,293,223,70,4,1,3,1
49153,31506,0,0,146,146,0,1,0,1,0
54925,10640,0,0,128,128,0,1,0,1,0
9381,3767,8735,3237,286,219,66,3,0,2,0
57637,31652,0,0,67,67,0,1,0,1,0
18113,22671,0,0,109,109,0,1,0,1,0
19377,3389,19377,3389,293,223,70,4,0,3,1
9580,25773,0,0,150,150,0,1,0,1,0
8726,25773,0,0,154,154,0,1,0,1,0
3676,25773,0,0,142,142,0,1,0,1,0
10301,59555,0,0,143,143,0,1,0,1,0
23826,34021,0,0,62,62,0,1,0,1,0
51338,34021,0,0,92,92,0,1,0,1,0
49160,33456,0,0,146,146,0,1,0,1,0
36145,34021,0,0,89,89,0,1,0,1,0
21883,3389,21883,3389,293,223,70,4,0,3,1
13005,24861,0,0,129,129,0,1,0,1,0
48891,25744,0,0,156,156,0,1,0,1,0
11517,3389,11517,3389,293,223,70,4,1,3,1
12384,3389,12384,3389,293,223,70,4,1,3,1
10316,25773,0,0,139,139,0,1,0,1,0
19144,3389,19144,3389,293,223,70,4,0,3,1
13123,3389,13123,3389,293,223,70,4,0,3,1
23239,3389,23239,3389,293,223,70,4,1,3,1
24599,698,0,0,67,67,0,1,0,1,0
8076,25905,0,0,156,156,0,1,0,1,0
19605,3389,19605,3389,293,223,70,4,0,3,1
7610,24146,0,0,146,146,0,1,0,1,0
11977,3389,11977,3389,293,223,70,4,1,3,1
8729,25773,0,0,140,140,0,1,0,1,0
48950,26869,0,0,154,154,0,1,0,1,0
23740,34021,0,0,62,62,0,1,0,1,0
14394,3389,14394,3389,293,223,70,4,0,3,1
48988,28504,0,0,153,153,0,1,0,1,0
12145,25725,0,0,139,139,0,1,0,1,0
21743,3389,21743,3389,293,223,70,4,0,3,1
51778,31652,0,0,62,62,0,1,0,1,0
13964,61248,0,0,147,147,0,1,0,1,0
35390,8599,0,0,142,142,0,1,0,1,0
12251,3389,12251,3389,293,223,70,4,0,3,1
6300,23690,0,0,148,148,0,1,0,1,0
7529,24118,0,0,146,146,0,1,0,1,0
40266,5785,0,0,146,146,0,1,0,1,0
51343,18513,0,0,152,152,0,1,0,1,0
21692,3389,21692,3389,293,223,70,4,0,3,1
52530,33879,0,0,62,62,0,1,0,1,0
12799,22465,0,0,141,141,0,1,0,1,0
2406,24016,0,0,149,149,0,1,0,1,0
31651,3389,31651,3389,293,223,70,4,0,3,1
17362,18697,0,0,66,66,0,1,0,1,0
60872,3389,60872,3389,293,223,70,4,0,3,1
39472,6355,0,0,146,146,0,1,0,1,0
21878,3389,21878,3389,293,223,70,4,0,3,1
50523,31652,0,0,102,102,0,1,0,1,0
48942,26669,0,0,155,155,0,1,0,1,0
13202,8804,3945,1219,200,174,25,2,0,1,0
16299,3389,16299,3389,293,223,70,4,0,3,1
25539,29675,0,0,107,107,0,1,0,1,0
4456,25773,0,0,142,142,0,1,0,1,0
41719,8542,0,0,147,147,0,1,0,1,0
51989,33613,0,0,76,76,0,1,0,1,0
8634,25773,0,0,154,154,0,1,0,1,0
49039,30150,0,0,151,151,0,1,0,1,0
20996,3389,20996,3389,293,223,70,4,1,3,1
51737,31652,0,0,62,62,0,1,0,1,0
21221,3389,21221,3389,293,223,70,4,0,3,1
13711,10036,2349,725,179,164,14,1,0,1,0
51908,32036,0,0,62,62,0,1,0,1,0
36412,3389,36412,3389,293,223,70,4,0,3,1
52850,14028,0,0,150,150,0,1,0,1,0
51651,31652,0,0,66,66,0,1,0,1,0
3842,19755,0,0,155,155,0,1,0,1,0
12665,25773,0,0,139,139,0,1,0,1,0
45697,7303,0,0,145,145,0,1,0,1,0
54069,10402,0,0,147,147,0,1,0,1,0
51670,31652,0,0,71,71,0,1,0,1,0
28814,34021,0,0,62,62,0,1,0,1,0
49349,31783,0,0,141,141,0,1,0,1,0
35289,3700,0,0,117,117,0,1,0,1,0
19629,3389,19629,3389,293,223,70,4,0,3,1
11770,61248,0,0,141,141,0,1,0,1,0
60301,31652,0,0,84,84,0,1,0,1,0
10116,3389,10116,3389,293,223,70,4,1,3,1
7086,25773,0,0,153,153,0,1,0,1,0
47467,7004,0,0,145,145,0,1,0,1,0
15032,25773,0,0,147,147,0,1,0,1,0
11992,3389,11992,3389,293,223,70,4,1,3,1
2176,23657,0,0,150,150,0,1,0,1,0
28728,27896,0,0,125,125,0,1,0,1,0
9448,61248,0,0,141,141,0,1,0,1,0
19154,25773,0,0,143,143,0,1,0,1,0
12811,25773,0,0,150,150,0,1,0,1,0
45817,7283,0,0,145,145,0,1,0,1,0
11553,3389,11553,3389,293,223,70,4,1,3,1
15058,25090,0,0,145,145,0,1,0,1,0
28253,28266,0,0,122,122,0,1,0,1,0
37025,3389,37025,3389,293,223,70,4,0,3,1
28177,34021,0,0,62,62,0,1,0,1,0
38802,6836,0,0,146,146,0,1,0,1,0
24966,14699,0,0,94,94,0,1,0,1,0
51479,32038,0,0,70,70,0,1,0,1,0
11403,3389,11403,3389,293,223,70,4,1,3,1
49280,33911,0,0,142,142,0,1,0,1,0
22144,3389,22144,3389,293,223,70,4,1,3,1
9933,4645,7786,2885,271,211,59,3,0,2,0
21019,3389,21019,3389,293,223,70,4,0,3,1
56421,47367,0,0,102,102,0,1,0,1,0
6706,25773,0,0,152,152,0,1,0,1,0
13409,25773,0,0,139,139,0,1,0,1,0
50998,32358,0,0,87,87,0,1,0,1,0
50238,28503,0,0,112,112,0,1,0,1,0
18702,29113,0,0,107,107,0,1,0,1,0
14952,54109,0,0,118,118,0,1,0,1,0
49160,31920,0,0,146,146,0,1,0,1,0
24836,25773,0,0,146,146,0,1,0,1,0
48915,26176,0,0,156,156,0,1,0,1,0
18287,3389,18287,3389,293,223,70,4,0,3,1
5885,24567,0,0,130,130,0,1,0,1,0
28764,34021,0,0,62,62,0,1,0,1,0
15100,11142,0,0,142,142,0,1,0,1,0
12007,3389,12007,3389,293,223,70,4,1,3,1
12427,25590,0,0,137,137,0,1,0,1,0
18005,18424,0,0,64,64,0,1,0,1,0
38280,3389,38280,3389,293,223,70,4,1,3,1
19143,3389,19143,3389,293,223,70,4,0,3,1
14474,2556,8271,2555,236,183,52,3,0,2,0
46535,56842,0,0,62,62,0,1,0,1,0
49160,32806,0,0,146,146,0,1,0,1,0
51373,31652,0,0,69,69,0,1,0,1,0
8953,58395,0,0,130,130,0,1,0,1,0
13283,24511,0,0,126,126,0,1,0,1,0
24451,34021,0,0,62,62,0,1,0,1,0
5871,56883,0,0,140,140,0,1,0,1,0
49807,3389,49807,3389,293,223,70,4,0,3,1
47479,5618,0,0,145,145,0,1,0,1,0
15571,52453,0,0,114,114,0,1,0,1,0
40339,3389,40339,3389,293,223,70,4,0,3,1
51677,31652,0,0,63,63,0,1,0,1,0
11424,25773,0,0,142,142,0,1,0,1,0
11570,3389,11570,3389,293,223,70,4,1,3,1
49457,27153,0,0,137,137,0,1,0,1,0
20224,3389,20224,3389,293,223,70,4,0,3,1
29133,34021,0,0,62,62,0,1,0,1,0
49157,31599,0,0,146,146,0,1,0,1,0
52504,33801,0,0,62,62,0,1,0,1,0
47688,43688,0,0,110,110,0,1,0,1,0
38029,3389,38029,3389,293,223,70,4,1,3,1
17762,61248,0,0,150,150,0,1,0,1,0
15467,3389,15467,3389,293,223,70,4,0,3,1
51246,31032,0,0,96,96,0,1,0,1,0
22940,34021,0,0,62,62,0,1,0,1,0
13915,25773,0,0,140,140,0,1,0,1,0
29022,29366,0,0,110,110,0,1,0,1,0
35058,9376,0,0,142,142,0,1,0,1,0
12601,25773,0,0,139,139,0,1,0,1,0
49160,32982,0,0,146,146,0,1,0,1,0
16682,3389,16682,3389,293,223,70,4,0,3,1
14699,3389,14699,3389,293,223,70,4,0,3,1
10880,3389,10880,3389,293,223,70,4,1,3,1
15365,3389,15365,3389,293,223,70,4,0,3,1
7331,25339,0,0,157,157,0,1,0,1,0
49137,31130,0,0,146,146,0,1,0,1,0
22755,25773,0,0,145,145,0,1,0,1,0
11226,61096,0,0,143,143,0,1,0,1,0
16504,20447,0,0,84,84,0,1,0,1,0
15091,2721,10121,2721,247,191,56,3,0,2,0
17890,1970,7328,1970,196,155,40,2,0,2,0
24563,31053,0,0,92,92,0,1,0,1,0
11799,3389,11799,3389,293,223,70,4,0,3,1
2694,20609,0,0,155,155,0,1,0,1,0
51168,60488,0,0,92,92,0,1,0,1,0
30603,4547,0,0,104,104,0,1,0,1,0
14475,48430,0,0,102,102,0,1,0,1,0
10715,24089,0,0,149,149,0,1,0,1,0
15691,3389,15691,3389,293,223,70,4,0,3,1
58065,31652,0,0,66,66,0,1,0,1,0
28866,28588,0,0,118,118,0,1,0,1,0
33343,34021,0,0,76,76,0,1,0,1,0
49160,32459,0,0,146,146,0,1,0,1,0
11143,23523,0,0,128,128,0,1,0,1,0
12783,57665,0,0,132,132,0,1,0,1,0
49942,28106,0,0,130,130,0,1,0,1,0
11979,61248,0,0,145,145,0,1,0,1,0
56811,3389,56811,3389,293,223,70,4,0,3,1
33183,3389,33183,3389,293,223,70,4,0,3,1
14049,25773,0,0,148,148,0,1,0,1,0
27118,27448,0,0,130,130,0,1,0,1,0
14154,23411,0,0,114,114,0,1,0,1,0
12550,25435,0,0,135,135,0,1,0,1,0
53559,60684,0,0,106,106,0,1,0,1,0
56691,5347,7782,412,162,154,8,1,0,1,0
12758,22731,0,0,140,140,0,1,0,1,0
26166,24171,0,0,129,129,0,1,0,1,0
28145,33499,0,0,67,67,0,1,0,1,0
23972,34021,0,0,62,62,0,1,0,1,0
12033,61248,0,0,140,140,0,1,0,1,0
14327,3389,14327,3389,293,223,70,4,0,3,1
30877,20026,0,0,147,147,0,1,0,1,0
4281,38520,0,0,149,149,0,1,0,1,0
15177,3389,15177,3389,293,223,70,4,0,3,1
49492,31652,0,0,134,134,0,1,0,1,0
60077,61219,0,0,143,143,0,1,0,1,0
2487,24144,0,0,148,148,0,1,0,1,0
50568,29917,0,0,97,97,0,1,0,1,0
60568,4310,37556,1988,231,190,41,2,0,2,0
29359,34021,0,0,62,62,0,1,0,1,0
39565,3389,39565,3389,293,223,70,4,0,3,1
22340,33923,0,0,62,62,0,1,0,1,0
34122,3389,34122,3389,293,223,70,4,1,3,1
22561,31121,0,0,89,89,0,1,0,1,0
11154,3389,11154,3389,293,223,70,4,0,3,1
51871,36687,0,0,62,62,0,1,0,1,0
12960,3293,12248,3293,286,218,68,3,0,2,0
16772,3389,16772,3389,293,223,70,4,0,3,1
49023,29626,0,0,151,151,0,1,0,1,0
51859,33602,0,0,131,131,0,1,0,1,0
27477,34021,0,0,62,62,0,1,0,1,0
20493,25773,0,0,144,144,0,1,0,1,0
37309,8719,0,0,145,145,0,1,0,1,0
52648,3389,52648,3389,293,223,70,4,0,3,1
15188,11046,0,0,142,142,0,1,0,1,0
11077,25773,0,0,144,144,0,1,0,1,0
2799,47053,0,0,144,144,0,1,0,1,0
51979,32247,0,0,62,62,0,1,0,1,0
58033,55480,0,0,145,145,0,1,0,1,0
28962,33337,0,0,68,68,0,1,0,1,0
53807,5618,0,0,145,145,0,1,0,1,0
25578,34021,0,0,62,62,0,1,0,1,0
9678,58516,0,0,143,143,0,1,0,1,0
7963,61248,0,0,139,139,0,1,0,1,0
21920,61248,0,0,158,158,0,1,0,1,0
11763,3389,11763,3389,293,223,70,4,1,3,1
24964,297,0,0,64,64,0,1,0,1,0
37667,3389,37667,3389,293,223,70,4,1,3,1
14670,12205,0,0,143,143,0,1,0,1,0
45879,3389,45879,3389,293,223,70,4,0,3,1
34452,3393,0,0,112,112,0,1,0,1,0
25511,34021,0,0,62,62,0,1,0,1,0
60654,3389,60654,3389,293,223,70,4,0,3,1
11440,3389,11440,3389,293,223,70,4,1,3,1
7742,61248,0,0,139,139,0,1,0,1,0
41989,5618,0,0,145,145,0,1,0,1,0
3442,49822,0,0,143,143,0,1,0,1,0
11869,61248,0,0,140,140,0,1,0,1,0
54128,3389,54128,3389,293,223,70,4,0,3,1
34730,3495,0,0,114,114,0,1,0,1,0
62719,3735,54076,2862,270,210,59,3,0,2,0
16599,3389,16599,3389,293,223,70,4,0,3,1
14756,3389,14756,3389,293,223,70,4,0,3,1
36847,8238,0,0,146,146,0,1,0,1,0
24180,34021,0,0,62,62,0,1,0,1,0
26315,916,0,0,70,70,0,1,0,1,0
46077,58575,0,0,62,62,0,1,0,1,0
22066,3389,22066,3389,293,223,70,4,0,3,1
61224,31652,0,0,79,79,0,1,0,1,0
43206,12109,0,0,149,149,0,1,0,1,0
34214,3389,34214,3389,293,223,70,4,0,3,1
38904,3389,38904,3389,293,223,70,4,0,3,1
18677,3389,18677,3389,293,223,70,4,0,3,1
2947,33808,0,0,143,143,0,1,0,1,0
36966,8153,0,0,146,146,0,1,0,1,0
35539,9122,0,0,144,144,0,1,0,1,0
10503,25153,0,0,141,141,0,1,0,1,0
44798,3389,44798,3389,293,223,70,4,0,3,1
14402,25773,0,0,143,143,0,1,0,1,0
25627,29552,0,0,108,108,0,1,0,1,0
13739,21594,0,0,104,104,0,1,0,1,0
32469,2663,0,0,101,101,0,1,0,1,0
10576,3389,10576,3389,293,223,70,4,1,3,1
35230,10303,0,0,146,146,0,1,0,1,0
14197,12042,0,0,148,148,0,1,0,1,0
21443,3389,21443,3389,293,223,70,4,0,3,1
12291,25780,0,0,138,138,0,1,0,1,0
24291,34021,0,0,62,62,0,1,0,1,0
51410,31914,0,0,70,70,0,1,0,1,0
10232,3389,10232,3389,293,223,70,4,1,3,1
49085,26183,0,0,152,152,0,1,0,1,0
9360,25773,0,0,155,155,0,1,0,1,0
40196,5835,0,0,146,146,0,1,0,1,0
63041,42044,0,0,91,91,0,1,0,1,0
25084,23360,0,0,120,120,0,1,0,1,0
22171,34795,0,0,64,64,0,1,0,1,0
21137,3389,21137,3389,293,223,70,4,0,3,1
40384,5575,0,0,145,145,0,1,0,1,0
26461,24392,0,0,132,132,0,1,0,1,0
38216,3389,38216,3389,293,223,70,4,1,3,1
11731,25580,0,0,139,139,0,1,0,1,0
4958,50195,0,0,143,143,0,1,0,1,0
28287,26598,0,0,139,139,0,1,0,1,0
16737,2018,6531,2018,199,157,41,2,0,2,0
49620,3389,49620,3389,293,223,70,4,0,3,1
18208,19620,0,0,76,76,0,1,0,1,0
11150,61248,0,0,142,142,0,1,0,1,0
61525,53147,0,0,122,122,0,1,0,1,0
52509,33867,0,0,63,63,0,1,0,1,0
15052,3389,15052,3389,293,223,70,4,0,3,1
17680,18534,0,0,65,65,0,1,0,1,0
21043,3389,21043,3389,293,223,70,4,0,3,1
20443,3389,20443,3389,293,223,70,4,0,3,1
6983,25773,0,0,141,141,0,1,0,1,0
28831,34021,0,0,62,62,0,1,0,1,0
16190,3389,16190,3389,293,223,70,4,0,3,1
9294,24732,0,0,143,143,0,1,0,1,0
10214,3389,10214,3389,293,223,70,4,1,3,1
13197,25773,0,0,139,139,0,1,0,1,0
10239,25773,0,0,147,147,0,1,0,1,0
51057,31652,0,0,85,85,0,1,0,1,0
11910,61248,0,0,140,140,0,1,0,1,0
5367,50813,0,0,143,143,0,1,0,1,0
48081,34021,0,0,141,141,0,1,0,1,0
12453,25773,0,0,139,139,0,1,0,1,0
48197,3389,48197,3389,293,223,70,4,0,3,1
60086,60444,0,0,145,145,0,1,0,1,0
11393,23338,0,0,126,126,0,1,0,1,0
12146,3389,12146,3389,293,223,70,4,1,3,1
49299,34021,0,0,142,142,0,1,0,1,0
28247,28582,0,0,118,118,0,1,0,1,0
50318,28950,0,0,120,120,0,1,0,1,0
33880,3389,33880,3389,293,223,70,4,0,3,1
16867,3389,16867,3389,293,223,70,4,0,3,1
47419,7012,0,0,145,145,0,1,0,1,0
13443,10231,1747,647,175,162,13,1,0,1,0
13829,61248,0,0,142,142,0,1,0,1,0
50320,28669,0,0,110,110,0,1,0,1,0
49073,26197,0,0,150,150,0,1,0,1,0
60725,4268,38760,2052,234,192,42,2,0,2,0
30682,34021,0,0,65,65,0,1,0,1,0
49007,29121,0,0,152,152,0,1,0,1,0
18147,3389,18147,3389,293,223,70,4,0,3,1
18030,3389,18030,3389,293,223,70,4,0,3,1
18091,61248,0,0,150,150,0,1,0,1,0
5326,25773,0,0,142,142,0,1,0,1,0
29995,34021,0,0,62,62,0,1,0,1,0
8469,16309,0,0,152,152,0,1,0,1,0
49160,32745,0,0,146,146,0,1,0,1,0
19442,1376,4452,1375,155,127,28,2,0,1,0
10642,25773,0,0,146,146,0,1,0,1,0
28338,34021,0,0,62,62,0,1,0,1,0
51335,31652,0,0,70,70,0,1,0,1,0
19002,3389,19002,3389,293,223,70,4,0,3,1
52305,33213,0,0,62,62,0,1,0,1,0
20075,3389,20075,3389,293,223,70,4,0,3,1
28745,34021,0,0,62,62,0,1,0,1,0
17112,3389,17112,3389,293,223,70,4,0,3,1
48941,26996,0,0,155,155,0,1,0,1,0
16756,61248,0,0,151,151,0,1,0,1,0
51602,33345,0,0,85,85,0,1,0,1,0
27457,60974,0,0,137,137,0,1,0,1,0
1159,22066,0,0,156,156,0,1,0,1,0
8132,54984,0,0,141,141,0,1,0,1,0
12221,3389,12221,3389,293,223,70,4,1,3,1
11662,61248,0,0,139,139,0,1,0,1,0
48961,27108,0,0,154,154,0,1,0,1,0
19443,61248,0,0,155,155,0,1,0,1,0
14523,12099,0,0,147,147,0,1,0,1,0
10828,25773,0,0,145,145,0,1,0,1,0
18149,21514,0,0,97,97,0,1,0,1,0
15331,3389,15331,3389,293,223,70,4,0,3,1
17049,28252,0,0,115,115,0,1,0,1,0
51279,31652,0,0,71,71,0,1,0,1,0
13564,3131,11645,3131,275,210,64,3,0,2,0
25361,47,0,0,62,62,0,1,0,1,0
51715,31652,0,0,63,63,0,1,0,1,0
49160,33359,0,0,146,146,0,1,0,1,0
34537,3389,34537,3389,293,223,70,4,0,3,1
52086,32564,0,0,62,62,0,1,0,1,0
16981,3389,16981,3389,293,223,70,4,0,3,1
35222,3676,0,0,116,116,0,1,0,1,0
50933,31652,0,0,83,83,0,1,0,1,0
5755,24468,0,0,157,157,0,1,0,1,0
1643,22822,0,0,153,153,0,1,0,1,0
14450,11900,0,0,147,147,0,1,0,1,0
17487,25773,0,0,143,143,0,1,0,1,0
11389,3389,11389,3389,293,223,70,4,0,3,1
15398,3389,15398,3389,293,223,70,4,0,3,1
51172,32200,0,0,81,81,0,1,0,1,0
18505,3389,18505,3389,293,223,70,4,0,3,1
28927,28891,0,0,115,115,0,1,0,1,0
12399,61248,0,0,144,144,0,1,0,1,0
20066,3389,20066,3389,293,223,70,4,0,3,1
25349,31750,0,0,84,84,0,1,0,1,0
55976,31652,0,0,108,108,0,1,0,1,0
51582,31652,0,0,65,65,0,1,0,1,0
22622,33793,0,0,64,64,0,1,0,1,0
28402,34021,0,0,62,62,0,1,0,1,0
11322,14183,0,0,150,150,0,1,0,1,0
6124,51955,0,0,142,142,0,1,0,1,0
8999,25773,0,0,140,140,0,1,0,1,0
23546,22208,0,0,107,107,0,1,0,1,0
19978,3389,19978,3389,293,223,70,4,0,3,1
22039,3389,22039,3389,293,223,70,4,0,3,1
12018,25773,0,0,140,140,0,1,0,1,0
14843,20774,0,0,93,93,0,1,0,1,0
49160,32438,0,0,146,146,0,1,0,1,0
49160,31682,0,0,146,146,0,1,0,1,0
13453,24296,0,0,123,123,0,1,0,1,0
18425,43880,0,0,91,91,0,1,0,1,0
15837,3389,15837,3389,293,223,70,4,0,3,1
59860,3389,59860,3389,293,223,70,4,0,3,1
44257,7546,0,0,145,145,0,1,0,1,0
15387,3389,15387,3389,293,223,70,4,0,3,1
53250,19939,0,0,104,104,0,1,0,1,0
55474,6816,0,0,141,141,0,1,0,1,0
12317,3389,12317,3389,293,223,70,4,0,3,1
53857,5618,0,0,145,145,0,1,0,1,0
48980,5618,0,0,145,145,0,1,0,1,0
49782,27571,0,0,127,127,0,1,0,1,0
6298,58127,0,0,140,140,0,1,0,1,0
48021,34021,0,0,141,141,0,1,0,1,0
10288,3389,10288,3389,293,223,70,4,0,3,1
20606,30579,0,0,95,95,0,1,0,1,0
38172,3389,38172,3389,293,223,70,4,1,3,1
49338,31652,0,0,139,139,0,1,0,1,0
49242,26534,0,0,148,148,0,1,0,1,0
38989,6701,0,0,146,146,0,1,0,1,0
9159,3389,9159,3389,293,223,70,4,0,3,1
22362,34199,0,0,62,62,0,1,0,1,0
11976,25666,0,0,139,139,0,1,0,1,0
49010,28221,0,0,152,152,0,1,0,1,0
51318,31652,0,0,70,70,0,1,0,1,0
25847,34021,0,0,62,62,0,1,0,1,0
38641,34021,0,0,100,100,0,1,0,1,0
59784,61195,0,0,141,141,0,1,0,1,0
24208,1128,0,0,70,70,0,1,0,1,0
52625,14699,0,0,150,150,0,1,0,1,0
20466,39357,0,0,77,77,0,1,0,1,0
21425,36791,0,0,69,69,0,1,0,1,0
17970,25590,0,0,143,143,0,1,0,1,0
3621,23289,0,0,157,157,0,1,0,1,0
29400,31261,0,0,90,90,0,1,0,1,0
26959,34021,0,0,62,62,0,1,0,1,0
50003,32236,0,0,125,125,0,1,0,1,0
19815,3389,19815,3389,293,223,70,4,0,3,1
34188,34021,0,0,80,80,0,1,0,1,0
28120,25634,0,0,146,146,0,1,0,1,0
21027,3389,21027,3389,293,223,70,4,0,3,1
11799,61248,0,0,141,141,0,1,0,1,0
51565,32193,0,0,69,69,0,1,0,1,0
12509,7125,6123,1892,228,189,39,2,0,2,0
14471,2887,10739,2887,258,199,59,3,0,2,0
55164,9047,0,0,134,134,0,1,0,1,0
20176,29780,0,0,103,103,0,1,0,1,0
17021,3389,17021,3389,293,223,70,4,0,3,1
52309,33225,0,0,62,62,0,1,0,1,0
18695,3389,18695,3389,293,223,70,4,0,3,1
29339,3389,29339,3389,293,223,70,4,0,3,1
22162,730,2360,729,111,96,15,1,0,1,0
52799,33457,0,0,126,126,0,1,0,1,0
49178,31652,0,0,145,145,0,1,0,1,0
49148,31398,0,0,146,146,0,1,0,1,0
7835,61248,0,0,139,139,0,1,0,1,0
13496,25773,0,0,149,149,0,1,0,1,0
12252,61248,0,0,139,139,0,1,0,1,0
51378,31652,0,0,69,69,0,1,0,1,0
11270,61170,0,0,143,143,0,1,0,1,0
6480,25773,0,0,141,141,0,1,0,1,0
49943,3389,49943,3389,293,223,70,4,0,3,1
49095,30176,0,0,148,148,0,1,0,1,0
24632,23021,0,0,116,116,0,1,0,1,0
50227,33055,0,0,111,111,0,1,0,1,0
13094,25773,0,0,139,139,0,1,0,1,0
18136,21937,0,0,101,101,0,1,0,1,0
22408,33923,0,0,62,62,0,1,0,1,0
12617,25773,0,0,139,139,0,1,0,1,0
29069,1412,0,0,83,83,0,1,0,1,0
12938,25773,0,0,150,150,0,1,0,1,0
49160,33948,0,0,146,146,0,1,0,1,0
49683,33547,0,0,129,129,0,1,0,1,0
49160,33481,0,0,146,146,0,1,0,1,0
14810,3389,14810,3389,293,223,70,4,0,3,1
50575,34021,0,0,111,111,0,1,0,1,0
11243,3389,11243,3389,293,223,70,4,1,3,1
6572,24216,0,0,126,126,0,1,0,1,0
8503,61248,0,0,139,139,0,1,0,1,0
7702,27146,0,0,156,156,0,1,0,1,0
37884,3389,37884,3389,293,223,70,4,1,3,1
11410,3389,11410,3389,293,223,70,4,1,3,1
16534,19518,0,0,78,78,0,1,0,1,0
29175,30135,0,0,102,102,0,1,0,1,0
12411,25610,0,0,137,137,0,1,0,1,0
9318,25773,0,0,140,140,0,1,0,1,0
35228,60575,0,0,105,105,0,1,0,1,0
51824,33498,0,0,80,80,0,1,0,1,0
60989,57068,0,0,133,133,0,1,0,1,0
10371,25773,0,0,153,153,0,1,0,1,0
16416,3389,16416,3389,293,223,70,4,0,3,1
27149,705,0,0,72,72,0,1,0,1,0
21102,3389,21102,3389,293,223,70,4,0,3,1
50446,32543,0,0,114,114,0,1,0,1,0
28521,26855,0,0,136,136,0,1,0,1,0
19028,27649,0,0,124,124,0,1,0,1,0
11879,3389,11879,3389,293,223,70,4,1,3,1
20743,3389,20743,3389,293,223,70,4,0,3,1
17907,3389,17907,3389,293,223,70,4,0,3,1
45896,34021,0,0,131,131,0,1,0,1,0
27300,25020,0,0,139,139,0,1,0,1,0
16693,3389,16693,3389,293,223,70,4,0,3,1
50094,31652,0,0,113,113,0,1,0,1,0
17222,3389,17222,3389,293,223,70,4,0,3,1
19760,1469,5462,1468,162,131,30,2,0,1,0
13278,8989,3706,1145,197,173,23,2,0,1,0
22065,61248,0,0,158,158,0,1,0,1,0
10222,61248,0,0,141,141,0,1,0,1,0
11569,61248,0,0,139,139,0,1,0,1,0
33919,3389,33919,3389,293,223,70,4,0,3,1
12751,57744,0,0,132,132,0,1,0,1,0
42501,5618,0,0,145,145,0,1,0,1,0
50247,32797,0,0,107,107,0,1,0,1,0
51737,31652,0,0,62,62,0,1,0,1,0
13695,55437,0,0,125,125,0,1,0,1,0
51559,31652,0,0,69,69,0,1,0,1,0
7708,61248,0,0,139,139,0,1,0,1,0
27971,60948,0,0,134,134,0,1,0,1,0
26616,31716,0,0,84,84,0,1,0,1,0
13913,3389,13913,3389,293,223,70,4,0,3,1
4939,54173,0,0,141,141,0,1,0,1,0
8695,61248,0,0,139,139,0,1,0,1,0
4897,54053,0,0,141,141,0,1,0,1,0
11387,3389,11387,3389,293,223,70,4,0,3,1
11193,61248,0,0,144,144,0,1,0,1,0
5375,25773,0,0,148,148,0,1,0,1,0
9572,57276,0,0,127,127,0,1,0,1,0
6959,25773,0,0,153,153,0,1,0,1,0
27911,33838,0,0,63,63,0,1,0,1,0
11478,61248,0,0,142,142,0,1,0,1,0
16599,15456,0,0,99,99,0,1,0,1,0
17325,16679,0,0,83,83,0,1,0,1,0
14337,61248,0,0,143,143,0,1,0,1,0
26712,3389,26712,3389,293,223,70,4,0,3,1
17854,3389,17854,3389,293,223,70,4,0,3,1
17104,3389,17104,3389,293,223,70,4,0,3,1
46099,5618,0,0,145,145,0,1,0,1,0
51340,31787,0,0,71,71,0,1,0,1,0
55587,31652,0,0,68,68,0,1,0,1,0
5963,51712,0,0,142,142,0,1,0,1,0
55447,3389,55447,3389,293,223,70,4,0,3,1
2058,23472,0,0,151,151,0,1,0,1,0
6274,58056,0,0,140,140,0,1,0,1,0
11105,3389,11105,3389,293,223,70,4,1,3,1
29657,3389,29657,3389,293,223,70,4,0,3,1
32034,17443,0,0,147,147,0,1,0,1,0
14956,20690,0,0,92,92,0,1,0,1,0
7269,54503,0,0,143,143,0,1,0,1,0
22617,33800,0,0,64,64,0,1,0,1,0
17641,8349,0,0,122,122,0,1,0,1,0
61027,56795,0,0,132,132,0,1,0,1,0
57020,31652,0,0,67,67,0,1,0,1,0
10972,3389,10972,3389,293,223,70,4,0,3,1
12854,9295,2759,1022,191,170,21,1,0,1,0
31261,3389,31261,3389,293,223,70,4,0,3,1
16416,15147,0,0,103,103,0,1,0,1,0
20697,25773,0,0,144,144,0,1,0,1,0
17012,3389,17012,3389,293,223,70,4,0,3,1
61537,3389,61537,3389,293,223,70,4,0,3,1
17645,3389,17645,3389,293,223,70,4,0,3,1
50561,32443,0,0,96,96,0,1,0,1,0
21219,3389,21219,3389,293,223,70,4,1,3,1
63871,3426,62923,3331,290,221,68,3,0,2,0
26238,3389,26238,3389,293,223,70,4,1,3,1
49914,31652,0,0,119,119,0,1,0,1,0
48981,27562,0,0,153,153,0,1,0,1,0
20369,61248,0,0,155,155,0,1,0,1,0
31424,3389,31424,3389,293,223,70,4,0,3,1
39041,8427,0,0,145,145,0,1,0,1,0
50438,33823,0,0,138,138,0,1,0,1,0
49393,26993,0,0,139,139,0,1,0,1,0
52486,34076,0,0,68,68,0,1,0,1,0
18888,18718,0,0,67,67,0,1,0,1,0
10303,3389,10303,3389,293,223,70,4,1,3,1
15427,61248,0,0,149,149,0,1,0,1,0
18794,26406,0,0,136,136,0,1,0,1,0
28045,34021,0,0,62,62,0,1,0,1,0
50281,32429,0,0,118,118,0,1,0,1,0
18283,1865,6936,1865,189,150,38,2,0,2,0
16855,44136,0,0,90,90,0,1,0,1,0
5880,23544,0,0,149,149,0,1,0,1,0
20438,3389,20438,3389,293,223,70,4,0,3,1
53714,11459,0,0,148,148,0,1,0,1,0
51766,31625,0,0,62,62,0,1,0,1,0
15911,25773,0,0,143,143,0,1,0,1,0
50468,32548,0,0,100,100,0,1,0,1,0
52538,33902,0,0,62,62,0,1,0,1,0
49191,31652,0,0,144,144,0,1,0,1,0
26981,60998,0,0,139,139,0,1,0,1,0
11544,61248,0,0,142,142,0,1,0,1,0
34040,16293,0,0,147,147,0,1,0,1,0
49058,30756,0,0,150,150,0,1,0,1,0
10704,25223,0,0,141,141,0,1,0,1,0
56945,49349,0,0,111,111,0,1,0,1,0
26851,34021,0,0,62,62,0,1,0,1,0
49634,3389,49634,3389,293,223,70,4,0,3,1
27840,34021,0,0,62,62,0,1,0,1,0
55868,32982,0,0,109,109,0,1,0,1,0
19277,3389,19277,3389,293,223,70,4,0,3,1
8103,25773,0,0,156,156,0,1,0,1,0
51607,31652,0,0,65,65,0,1,0,1,0
51962,32640,0,0,77,77,0,1,0,1,0
49825,27843,0,0,133,133,0,1,0,1,0
11929,60711,0,0,139,139,0,1,0,1,0
11848,61248,0,0,140,140,0,1,0,1,0
32205,3389,32205,3389,293,223,70,4,0,3,1
15083,3389,15083,3389,293,223,70,4,0,3,1
52547,14930,0,0,150,150,0,1,0,1,0
21057,16761,0,0,75,75,0,1,0,1,0
6938,53183,0,0,142,142,0,1,0,1,0
53545,19858,0,0,99,99,0,1,0,1,0
20407,27425,0,0,126,126,0,1,0,1,0
13310,25773,0,0,139,139,0,1,0,1,0
38475,3389,38475,3389,293,223,70,4,1,3,1
52433,33591,0,0,62,62,0,1,0,1,0
53454,3389,53454,3389,293,223,70,4,0,3,1
28280,26977,0,0,135,135,0,1,0,1,0
49880,60382,0,0,85,85,0,1,0,1,0
51637,31652,0,0,64,64,0,1,0,1,0
18667,61248,0,0,151,151,0,1,0,1,0
13586,9734,2739,846,184,166,17,1,0,1,0
29938,3389,29938,3389,293,223,70,4,0,3,1
30675,11688,0,0,121,121,0,1,0,1,0
15943,3389,15943,3389,293,223,70,4,0,3,1
18269,58283,0,0,156,156,0,1,0,1,0
34570,3389,34570,3389,293,223,70,4,0,3,1
18098,25924,0,0,141,141,0,1,0,1,0
10203,61248,0,0,141,141,0,1,0,1,0
49600,31652,0,0,130,130,0,1,0,1,0
57149,32784,0,0,102,102,0,1,0,1,0
50662,31652,0,0,97,97,0,1,0,1,0
31940,3389,31940,3389,293,223,70,4,0,3,1
12037,25773,0,0,151,151,0,1,0,1,0
15047,3389,15047,3389,293,223,70,4,0,3,1
16962,3389,16962,3389,293,223,70,4,0,3,1
51476,31652,0,0,67,67,0,1,0,1,0
19026,3389,19026,3389,293,223,70,4,0,3,1
21697,35399,0,0,65,65,0,1,0,1,0
51737,31652,0,0,71,71,0,1,0,1,0
28180,31834,0,0,84,84,0,1,0,1,0
31043,2138,0,0,93,93,0,1,0,1,0
22143,3389,22143,3389,293,223,70,4,0,3,1
19663,25773,0,0,143,143,0,1,0,1,0
25159,25773,0,0,146,146,0,1,0,1,0
15520,3389,15520,3389,293,223,70,4,0,3,1
13762,12366,0,0,148,148,0,1,0,1,0
8746,56964,0,0,143,143,0,1,0,1,0
49054,30642,0,0,150,150,0,1,0,1,0
20313,61248,0,0,156,156,0,1,0,1,0
20396,3389,20396,3389,293,223,70,4,0,3,1
19601,3389,19601,3389,293,223,70,4,1,3,1
35071,3389,35071,3389,293,223,70,4,0,3,1
16324,27876,0,0,119,119,0,1,0,1,0
21332,61248,0,0,157,157,0,1,0,1,0
50941,30349,0,0,104,104,0,1,0,1,0
55454,6936,0,0,141,141,0,1,0,1,0
21785,20889,0,0,92,92,0,1,0,1,0
49181,31652,0,0,145,145,0,1,0,1,0
49013,28305,0,0,152,152,0,1,0,1,0
17306,3389,17306,3389,293,223,70,4,0,3,1
18029,25379,0,0,138,138,0,1,0,1,0
51131,31802,0,0,76,76,0,1,0,1,0
19240,28043,0,0,120,120,0,1,0,1,0
10877,25773,0,0,145,145,0,1,0,1,0
59811,59139,0,0,138,138,0,1,0,1,0
22582,33850,0,0,63,63,0,1,0,1,0
50284,5618,0,0,145,145,0,1,0,1,0
24671,134,432,133,71,68,2,1,0,1,0
25346,29947,0,0,104,104,0,1,0,1,0
16940,3389,16940,3389,293,223,70,4,0,3,1
8605,25773,0,0,140,140,0,1,0,1,0
18454,26075,0,0,140,140,0,1,0,1,0
4320,52373,0,0,142,142,0,1,0,1,0
49165,34033,0,0,145,145,0,1,0,1,0
36888,3389,36888,3389,293,223,70,4,0,3,1
19682,25773,0,0,143,143,0,1,0,1,0
21186,61248,0,0,157,157,0,1,0,1,0
44208,34021,0,0,124,124,0,1,0,1,0
9272,3389,9272,3389,293,223,70,4,0,3,1
12068,3389,12068,3389,293,223,70,4,1,3,1
5067,35907,0,0,150,150,0,1,0,1,0
14968,3389,14968,3389,293,223,70,4,0,3,1
40243,6042,0,0,146,146,0,1,0,1,0
37101,34021,0,0,93,93,0,1,0,1,0
30092,3389,30092,3389,293,223,70,4,0,3,1
5153,54797,0,0,141,141,0,1,0,1,0
35949,3389,35949,3389,293,223,70,4,0,3,1
18229,18960,0,0,69,69,0,1,0,1,0
2812,22476,0,0,154,154,0,1,0,1,0
56973,3389,56973,3389,293,223,70,4,0,3,1
18915,3389,18915,3389,293,223,70,4,0,3,1
35234,3389,35234,3389,293,223,70,4,1,3,1
13215,25773,0,0,139,139,0,1,0,1,0
12103,25773,0,0,139,139,0,1,0,1,0
10850,25773,0,0,139,139,0,1,0,1,0
4203,38779,0,0,149,149,0,1,0,1,0
46494,60104,0,0,66,66,0,1,0,1,0
49902,28260,0,0,121,121,0,1,0,1,0
49658,34021,0,0,133,133,0,1,0,1,0
9530,61248,0,0,139,139,0,1,0,1,0
51790,33474,0,0,81,81,0,1,0,1,0
54973,5618,0,0,145,145,0,1,0,1,0
17150,19060,0,0,72,72,0,1,0,1,0
50734,31652,0,0,95,95,0,1,0,1,0
30516,3389,30516,3389,293,223,70,4,0,3,1
12147,3389,12147,3389,293,223,70,4,1,3,1
16363,3389,16363,3389,293,223,70,4,0,3,1
11492,25773,0,0,142,142,0,1,0,1,0
49875,27760,0,0,124,124,0,1,0,1,0
49160,31773,0,0,146,146,0,1,0,1,0
37908,3389,37908,3389,293,223,70,4,0,3,1
27456,3389,27456,3389,293,223,70,4,0,3,1
38288,3389,38288,3389,293,223,70,4,1,3,1
19025,3389,19025,3389,293,223,70,4,0,3,1
6644,25773,0,0,152,152,0,1,0,1,0
5677,56320,0,0,140,140,0,1,0,1,0
12277,8375,3753,1391,207,178,28,2,0,1,0
50784,29995,0,0,108,108,0,1,0,1,0
23296,34021,0,0,62,62,0,1,0,1,0
14175,23384,0,0,114,114,0,1,0,1,0
56958,31652,0,0,67,67,0,1,0,1,0
15738,3389,15738,3389,293,223,70,4,0,3,1
8121,25768,0,0,156,156,0,1,0,1,0
23885,362,1345,361,86,79,7,1,0,1,0
49282,31652,0,0,142,142,0,1,0,1,0
49061,30875,0,0,150,150,0,1,0,1,0
24033,3389,24033,3389,293,223,70,4,0,3,1
7805,25773,0,0,141,141,0,1,0,1,0
21153,61248,0,0,157,157,0,1,0,1,0
50600,41491,0,0,62,62,0,1,0,1,0
51771,31659,0,0,62,62,0,1,0,1,0
16838,3389,16838,3389,293,223,70,4,0,3,1
22320,34275,0,0,62,62,0,1,0,1,0
25490,3389,25490,3389,293,223,70,4,1,3,1
52090,33140,0,0,65,65,0,1,0,1,0
9771,3389,9771,3389,293,223,70,4,1,3,1
22066,3389,22066,3389,293,223,70,4,0,3,1
19609,3389,19609,3389,293,223,70,4,0,3,1
12021,61248,0,0,140,140,0,1,0,1,0
54560,33184,0,0,116,116,0,1,0,1,0
42907,11392,0,0,149,149,0,1,0,1,0
35484,9151,0,0,144,144,0,1,0,1,0
55272,6824,0,0,145,145,0,1,0,1,0
23632,22272,0,0,108,108,0,1,0,1,0
22065,33700,0,0,64,64,0,1,0,1,0
7502,25773,0,0,155,155,0,1,0,1,0
23159,3389,23159,3389,293,223,70,4,0,3,1
18794,26406,0,0,136,136,0,1,0,1,0
28724,2956,0,0,89,89,0,1,0,1,0
14147,61248,0,0,148,148,0,1,0,1,0
22189,3389,22189,3389,293,223,70,4,0,3,1
48813,36616,0,0,137,137,0,1,0,1,0
34020,60637,0,0,110,110,0,1,0,1,0
42996,7759,0,0,145,145,0,1,0,1,0
44122,14306,0,0,150,150,0,1,0,1,0
14148,3389,14148,3389,293,223,70,4,0,3,1
13015,3389,13015,3389,293,223,70,4,0,3,1
4790,53740,0,0,141,141,0,1,0,1,0
51470,31652,0,0,67,67,0,1,0,1,0
11017,6370,5920,2194,241,196,45,2,0,2,0
37353,3389,37353,3389,293,223,70,4,1,3,1
18401,43939,0,0,91,91,0,1,0,1,0
51334,31652,0,0,70,70,0,1,0,1,0
15147,3389,15147,3389,293,223,70,4,0,3,1
48966,25929,0,0,154,154,0,1,0,1,0
14659,25773,0,0,140,140,0,1,0,1,0
32742,6357,0,0,121,121,0,1,0,1,0
13614,61248,0,0,141,141,0,1,0,1,0
12872,25773,0,0,150,150,0,1,0,1,0
5667,51833,0,0,144,144,0,1,0,1,0
18639,25773,0,0,143,143,0,1,0,1,0
17595,19070,0,0,70,70,0,1,0,1,0
14368,26858,0,0,128,128,0,1,0,1,0
52013,31652,0,0,62,62,0,1,0,1,0
13313,3389,13313,3389,293,223,70,4,0,3,1
52430,33583,0,0,62,62,0,1,0,1,0
49878,33212,0,0,120,120,0,1,0,1,0
10059,4845,7569,2805,268,210,57,3,0,2,0
16959,61248,0,0,148,148,0,1,0,1,0
28188,31401,0,0,89,89,0,1,0,1,0
10138,3389,10138,3389,293,223,70,4,1,3,1
20803,3389,20803,3389,293,223,70,4,0,3,1
20323,3389,20323,3389,293,223,70,4,0,3,1
19533,3389,19533,3389,293,223,70,4,0,3,1
63923,31652,0,0,62,62,0,1,0,1,0
23995,3389,23995,3389,293,223,70,4,0,3,1
61905,31652,0,0,76,76,0,1,0,1,0
51228,31652,0,0,79,79,0,1,0,1,0
51673,31652,0,0,64,64,0,1,0,1,0
15369,3389,15369,3389,293,223,70,4,0,3,1
49160,32737,0,0,146,146,0,1,0,1,0
36029,3389,36029,3389,293,223,70,4,0,3,1
16873,3389,16873,3389,293,223,70,4,0,3,1
1491,22585,0,0,154,154,0,1,0,1,0
49160,31855,0,0,146,146,0,1,0,1,0
36551,3389,36551,3389,293,223,70,4,0,3,1
16663,61248,0,0,150,150,0,1,0,1,0
14414,11777,76,28,149,148,0,1,0,1,0
13787,3389,13787,3389,293,223,70,4,0,3,1
60326,31652,0,0,84,84,0,1,0,1,0
49018,28422,0,0,152,152,0,1,0,1,0
17550,3389,17550,3389,293,223,70,4,0,3,1
15883,27646,0,0,121,121,0,1,0,1,0
21491,3389,21491,3389,293,223,70,4,0,3,1
52555,26469,0,0,78,78,0,1,0,1,0
4724,37047,0,0,150,150,0,1,0,1,0
14526,12113,0,0,147,147,0,1,0,1,0
30892,3389,30892,3389,293,223,70,4,0,3,1
35348,34021,0,0,85,85,0,1,0,1,0
43415,5618,0,0,145,145,0,1,0,1,0
29300,30763,0,0,95,95,0,1,0,1,0
11433,61248,0,0,143,143,0,1,0,1,0
12060,3389,12060,3389,293,223,70,4,0,3,1
16823,19303,0,0,75,75,0,1,0,1,0
20882,60289,0,0,158,158,0,1,0,1,0
51078,34021,0,0,98,98,0,1,0,1,0
49542,33590,0,0,132,132,0,1,0,1,0
47942,6924,0,0,145,145,0,1,0,1,0
15018,3389,15018,3389,293,223,70,4,0,3,1
50108,31652,0,0,112,112,0,1,0,1,0
12961,3389,12961,3389,293,223,70,4,0,3,1
13928,25773,0,0,140,140,0,1,0,1,0
14165,3389,14165,3389,293,223,70,4,0,3,1
50085,33183,0,0,116,116,0,1,0,1,0
22356,29310,0,0,108,108,0,1,0,1,0
21267,3389,21267,3389,293,223,70,4,0,3,1
24471,61127,0,0,149,149,0,1,0,1,0
18145,21666,0,0,98,98,0,1,0,1,0
23564,32464,0,0,78,78,0,1,0,1,0
22136,3389,22136,3389,293,223,70,4,0,3,1
4359,23697,0,0,157,157,0,1,0,1,0
45945,5618,0,0,145,145,0,1,0,1,0
29158,34021,0,0,62,62,0,1,0,1,0
50768,31652,0,0,94,94,0,1,0,1,0
12156,3389,12156,3389,293,223,70,4,1,3,1
18512,43667,0,0,90,90,0,1,0,1,0
18341,3389,18341,3389,293,223,70,4,0,3,1
48059,6904,0,0,145,145,0,1,0,1,0
12110,3389,12110,3389,293,223,70,4,0,3,1
22157,28634,0,0,114,114,0,1,0,1,0
9803,24518,0,0,141,141,0,1,0,1,0
46788,51798,0,0,88,88,0,1,0,1,0
11447,61248,0,0,139,139,0,1,0,1,0
51353,30783,0,0,76,76,0,1,0,1,0
63322,39984,0,0,85,85,0,1,0,1,0
20029,29507,0,0,106,106,0,1,0,1,0
1697,22906,0,0,153,153,0,1,0,1,0
51857,40545,0,0,145,145,0,1,0,1,0
26998,3389,26998,3389,293,223,70,4,0,3,1
20401,61248,0,0,155,155,0,1,0,1,0
22626,34021,0,0,62,62,0,1,0,1,0
12618,3389,12618,3389,293,223,70,4,0,3,1
12795,3389,12795,3389,293,223,70,4,0,3,1
18340,3389,18340,3389,293,223,70,4,0,3,1
60888,31652,0,0,64,64,0,1,0,1,0
5167,25773,0,0,148,148,0,1,0,1,0
50827,30562,0,0,87,87,0,1,0,1,0
51072,31868,0,0,78,78,0,1,0,1,0
14224,3389,14224,3389,293,223,70,4,0,3,1
50659,30145,0,0,93,93,0,1,0,1,0
49117,34339,0,0,144,144,0,1,0,1,0
51607,31652,0,0,65,65,0,1,0,1,0
51862,31899,0,0,62,62,0,1,0,1,0
8582,61248,0,0,140,140,0,1,0,1,0
7871,61248,0,0,139,139,0,1,0,1,0
49565,31652,0,0,131,131,0,1,0,1,0
12941,8173,4764,1472,210,180,30,2,0,1,0
29129,60888,0,0,130,130,0,1,0,1,0
33673,60655,0,0,111,111,0,1,0,1,0
16176,3389,16176,3389,293,223,70,4,0,3,1
18734,25773,0,0,143,143,0,1,0,1,0
49291,60333,0,0,82,82,0,1,0,1,0
63460,31652,0,0,62,62,0,1,0,1,0
44550,15333,0,0,151,151,0,1,0,1,0
17173,2163,8044,2162,209,164,44,2,0,2,0
8447,24438,0,0,145,145,0,1,0,1,0
51469,31652,0,0,68,68,0,1,0,1,0
18159,3389,18159,3389,293,223,70,4,1,3,1
13913,3389,13913,3389,293,223,70,4,0,3,1
49160,33421,0,0,146,146,0,1,0,1,0
5935,24567,0,0,157,157,0,1,0,1,0
24902,30574,0,0,97,97,0,1,0,1,0
18211,19530,0,0,75,75,0,1,0,1,0
49160,31862,0,0,146,146,0,1,0,1,0
18588,26834,0,0,132,132,0,1,0,1,0
16649,3389,16649,3389,293,223,70,4,0,3,1
4712,53513,0,0,142,142,0,1,0,1,0
7091,49700,0,0,148,148,0,1,0,1,0
12791,3389,12791,3389,293,223,70,4,0,3,1
11221,3389,11221,3389,293,223,70,4,1,3,1
17701,25773,0,0,143,143,0,1,0,1,0
48927,25833,0,0,156,156,0,1,0,1,0
58400,32590,0,0,95,95,0,1,0,1,0
51368,31838,0,0,71,71,0,1,0,1,0
46789,51791,0,0,88,88,0,1,0,1,0
56648,3389,56648,3389,293,223,70,4,0,3,1
49807,32100,0,0,130,130,0,1,0,1,0
61449,32252,0,0,62,62,0,1,0,1,0
50954,60470,0,0,91,91,0,1,0,1,0
21133,20400,0,0,86,86,0,1,0,1,0
13163,8710,4067,1256,201,175,25,2,0,1,0
58877,3389,58877,3389,293,223,70,4,0,3,1
17372,25773,0,0,143,143,0,1,0,1,0
6445,23741,0,0,148,148,0,1,0,1,0
27015,27593,0,0,129,129,0,1,0,1,0
3813,25773,0,0,143,143,0,1,0,1,0
36545,4162,0,0,124,124,0,1,0,1,0
20824,3389,20824,3389,293,223,70,4,0,3,1
19706,61248,0,0,155,155,0,1,0,1,0
51650,5618,0,0,145,145,0,1,0,1,0
50006,33889,0,0,141,141,0,1,0,1,0
20832,3389,20832,3389,293,223,70,4,0,3,1
26297,34021,0,0,62,62,0,1,0,1,0
18288,26277,0,0,138,138,0,1,0,1,0
46137,58347,0,0,62,62,0,1,0,1,0
55815,33375,0,0,62,62,0,1,0,1,0
5626,25773,0,0,142,142,0,1,0,1,0
8892,61248,0,0,139,139,0,1,0,1,0
52372,33649,0,0,63,63,0,1,0,1,0
18648,26945,0,0,131,131,0,1,0,1,0
4603,53197,0,0,142,142,0,1,0,1,0
28590,27203,0,0,133,133,0,1,0,1,0
9553,57128,0,0,140,140,0,1,0,1,0
12115,3389,12115,3389,293,223,70,4,1,3,1
11009,25773,0,0,139,139,0,1,0,1,0
7511,27783,0,0,155,155,0,1,0,1,0
16073,3389,16073,3389,293,223,70,4,0,3,1
12946,61248,0,0,146,146,0,1,0,1,0
28283,26810,0,0,137,137,0,1,0,1,0
52358,33368,0,0,62,62,0,1,0,1,0
52419,3389,52419,3389,293,223,70,4,0,3,1
46456,60100,0,0,66,66,0,1,0,1,0
11339,23378,0,0,126,126,0,1,0,1,0
3670,25773,0,0,142,142,0,1,0,1,0
12251,25773,0,0,139,139,0,1,0,1,0
64035,34770,0,0,70,70,0,1,0,1,0
29467,31599,0,0,87,87,0,1,0,1,0
43944,3389,43944,3389,293,223,70,4,0,3,1
51881,32458,0,0,80,80,0,1,0,1,0
3064,25046,0,0,145,145,0,1,0,1,0
22648,25773,0,0,145,145,0,1,0,1,0
48988,27719,0,0,153,153,0,1,0,1,0
13995,10724,1456,449,167,157,9,1,0,1,0
50704,31652,0,0,91,91,0,1,0,1,0
63174,3389,63174,3389,293,223,70,4,0,3,1
12383,61248,0,0,139,139,0,1,0,1,0
6913,25773,0,0,153,153,0,1,0,1,0
11385,3389,11385,3389,293,223,70,4,1,3,1
48263,3389,48263,3389,293,223,70,4,0,3,1
17366,3389,17366,3389,293,223,70,4,0,3,1
14240,25773,0,0,148,148,0,1,0,1,0
49160,32215,0,0,146,146,0,1,0,1,0
9192,57963,0,0,129,129,0,1,0,1,0
49405,33798,0,0,138,138,0,1,0,1,0
23497,34021,0,0,62,62,0,1,0,1,0
14033,10816,1337,413,165,157,8,1,0,1,0
29524,34021,0,0,62,62,0,1,0,1,0
13787,3389,13787,3389,293,223,70,4,0,3,1
34263,3323,0,0,111,111,0,1,0,1,0
12218,61248,0,0,139,139,0,1,0,1,0
28723,27868,0,0,126,126,0,1,0,1,0
51226,31695,0,0,73,73,0,1,0,1,0
40757,5618,0,0,145,145,0,1,0,1,0
7944,61248,0,0,139,139,0,1,0,1,0
13431,3389,13431,3389,293,223,70,4,0,3,1
52209,6203,0,0,145,145,0,1,0,1,0
49247,31652,0,0,142,142,0,1,0,1,0
7219,25277,0,0,157,157,0,1,0,1,0
10069,25002,0,0,142,142,0,1,0,1,0
27233,33286,0,0,69,69,0,1,0,1,0
32256,2584,0,0,100,100,0,1,0,1,0
29127,3297,0,0,92,92,0,1,0,1,0
16267,3389,16267,3389,293,223,70,4,0,3,1
24453,34021,0,0,62,62,0,1,0,1,0
51650,60527,0,0,95,95,0,1,0,1,0
11596,3389,11596,3389,293,223,70,4,1,3,1
53143,60650,0,0,103,103,0,1,0,1,0
38421,34021,0,0,99,99,0,1,0,1,0
49091,31818,0,0,148,148,0,1,0,1,0
51173,39326,0,0,62,62,0,1,0,1,0
51741,31652,0,0,62,62,0,1,0,1,0
6179,52686,0,0,144,144,0,1,0,1,0
8657,56815,0,0,143,143,0,1,0,1,0
21960,3389,21960,3389,293,223,70,4,0,3,1
27153,32087,0,0,80,80,0,1,0,1,0
12056,3389,12056,3389,293,223,70,4,1,3,1
51198,3389,51198,3389,293,223,70,4,0,3,1
50331,32702,0,0,104,104,0,1,0,1,0
38353,3389,38353,3389,293,223,70,4,1,3,1
55422,33453,0,0,62,62,0,1,0,1,0
51340,32048,0,0,76,76,0,1,0,1,0
17291,3389,17291,3389,293,223,70,4,0,3,1
17827,18557,0,0,65,65,0,1,0,1,0
50443,34021,0,0,114,114,0,1,0,1,0
13420,3389,13420,3389,293,223,70,4,0,3,1
60274,61236,0,0,144,144,0,1,0,1,0
11968,25773,0,0,151,151,0,1,0,1,0
10549,3389,10549,3389,293,223,70,4,0,3,1
51859,31889,0,0,62,62,0,1,0,1,0
13843,3389,13843,3389,293,223,70,4,0,3,1
12082,3389,12082,3389,293,223,70,4,0,3,1
20748,3389,20748,3389,293,223,70,4,0,3,1
26838,3389,26838,3389,293,223,70,4,0,3,1
1213,21920,0,0,156,156,0,1,0,1,0
28687,3389,28687,3389,293,223,70,4,0,3,1
11599,61248,0,0,139,139,0,1,0,1,0
21792,3389,21792,3389,293,223,70,4,0,3,1
52199,60572,0,0,98,98,0,1,0,1,0
11840,3389,11840,3389,293,223,70,4,0,3,1
10670,60170,0,0,143,143,0,1,0,1,0
15112,25773,0,0,140,140,0,1,0,1,0
25370,116,0,0,63,63,0,1,0,1,0
51325,3389,51325,3389,293,223,70,4,0,3,1
21420,3389,21420,3389,293,223,70,4,0,3,1
53796,3389,53796,3389,293,223,70,4,0,3,1
21570,3389,21570,3389,293,223,70,4,0,3,1
24235,31516,0,0,88,88,0,1,0,1,0
11626,4987,8894,2748,265,208,56,3,0,2,0
52115,32983,0,0,73,73,0,1,0,1,0
14962,54083,0,0,118,118,0,1,0,1,0
17686,3389,17686,3389,293,223,70,4,0,3,1
19626,3389,19626,3389,293,223,70,4,0,3,1
18625,18521,0,0,65,65,0,1,0,1,0
49080,31455,0,0,149,149,0,1,0,1,0
26458,34021,0,0,62,62,0,1,0,1,0
49824,33419,0,0,124,124,0,1,0,1,0
22639,34021,0,0,62,62,0,1,0,1,0
25770,32093,0,0,80,80,0,1,0,1,0
5775,25773,0,0,141,141,0,1,0,1,0
51380,39391,0,0,145,145,0,1,0,1,0
49160,33151,0,0,146,146,0,1,0,1,0
15758,3389,15758,3389,293,223,70,4,0,3,1
57403,5156,13251,701,175,161,14,1,0,1,0
49334,26846,0,0,141,141,0,1,0,1,0
12083,3389,12083,3389,293,223,70,4,1,3,1
18018,25713,0,0,142,142,0,1,0,1,0
4327,49244,0,0,143,143,0,1,0,1,0
20113,29664,0,0,104,104,0,1,0,1,0
34115,3389,34115,3389,293,223,70,4,0,3,1
38512,34021,0,0,99,99,0,1,0,1,0
21294,3389,21294,3389,293,223,70,4,0,3,1
16422,19533,0,0,145,145,0,1,0,1,0
48094,42007,0,0,120,120,0,1,0,1,0
48968,27273,0,0,154,154,0,1,0,1,0
11933,25773,0,0,140,140,0,1,0,1,0
15562,3389,15562,3389,293,223,70,4,0,3,1
4767,50333,0,0,144,144,0,1,0,1,0
31523,5325,0,0,111,111,0,1,0,1,0
57472,54123,0,0,145,145,0,1,0,1,0
21605,30623,0,0,93,93,0,1,0,1,0
10771,3389,10771,3389,293,223,70,4,1,3,1
21424,3389,21424,3389,293,223,70,4,0,3,1
52206,33763,0,0,71,71,0,1,0,1,0
11423,3389,11423,3389,293,223,70,4,1,3,1
16290,3389,16290,3389,293,223,70,4,0,3,1
38405,3389,38405,3389,293,223,70,4,1,3,1
51246,33098,0,0,94,94,0,1,0,1,0
17363,3389,17363,3389,293,223,70,4,0,3,1
28844,34021,0,0,62,62,0,1,0,1,0
11334,61248,0,0,142,142,0,1,0,1,0
51894,31652,0,0,71,71,0,1,0,1,0
11920,61248,0,0,140,140,0,1,0,1,0
32634,16102,0,0,146,146,0,1,0,1,0
59020,32736,0,0,62,62,0,1,0,1,0
14557,12013,0,0,145,145,0,1,0,1,0
49742,32055,0,0,131,131,0,1,0,1,0
24499,3389,24499,3389,293,223,70,4,0,3,1
37786,34021,0,0,96,96,0,1,0,1,0
21916,3389,21916,3389,293,223,70,4,0,3,1
8367,55338,0,0,141,141,0,1,0,1,0
15505,25193,0,0,145,145,0,1,0,1,0
49654,31994,0,0,133,133,0,1,0,1,0
18890,61248,0,0,154,154,0,1,0,1,0
2320,23882,0,0,149,149,0,1,0,1,0
15603,3389,15603,3389,293,223,70,4,0,3,1
12279,25773,0,0,139,139,0,1,0,1,0
29219,30356,0,0,100,100,0,1,0,1,0
29052,34021,0,0,62,62,0,1,0,1,0
58732,31652,0,0,62,62,0,1,0,1,0
29138,29949,0,0,104,104,0,1,0,1,0
11895,3389,11895,3389,293,223,70,4,0,3,1
50071,31652,0,0,116,116,0,1,0,1,0
12056,3389,12056,3389,293,223,70,4,1,3,1
9717,61248,0,0,141,141,0,1,0,1,0
28325,34021,0,0,62,62,0,1,0,1,0
32779,3389,32779,3389,293,223,70,4,0,3,1
28568,34021,0,0,62,62,0,1,0,1,0
36425,12352,0,0,146,146,0,1,0,1,0
2908,22895,0,0,157,157,0,1,0,1,0
51720,31705,0,0,63,63,0,1,0,1,0
9513,3389,9513,3389,293,223,70,4,0,3,1
46989,50293,0,0,93,93,0,1,0,1,0
16773,61248,0,0,148,148,0,1,0,1,0
49089,30044,0,0,149,149,0,1,0,1,0
52038,33647,0,0,75,75,0,1,0,1,0
49953,22647,0,0,155,155,0,1,0,1,0
21573,4026,0,0,91,91,0,1,0,1,0
17710,61248,0,0,153,153,0,1,0,1,0
12613,7376,5796,1791,224,187,36,2,0,2,0
14173,3389,14173,3389,293,223,70,4,0,3,1
27096,34021,0,0,62,62,0,1,0,1,0
51333,34021,0,0,92,92,0,1,0,1,0
51305,34021,0,0,93,93,0,1,0,1,0
41113,3389,41113,3389,293,223,70,4,0,3,1
26987,646,0,0,71,71,0,1,0,1,0
18878,27371,0,0,127,127,0,1,0,1,0
18088,23494,0,0,118,118,0,1,0,1,0
43845,5618,0,0,145,145,0,1,0,1,0
54806,42023,0,0,91,91,0,1,0,1,0
48492,39023,0,0,129,129,0,1,0,1,0
47495,46497,0,0,105,105,0,1,0,1,0
2937,24847,0,0,146,146,0,1,0,1,0
22841,61211,0,0,156,156,0,1,0,1,0
55398,60835,0,0,116,116,0,1,0,1,0
57886,52454,0,0,118,118,0,1,0,1,0
45985,18775,0,0,153,153,0,1,0,1,0
55867,45442,0,0,96,96,0,1,0,1,0
14023,3389,14023,3389,293,223,70,4,0,3,1
28182,3389,28182,3389,293,223,70,4,0,3,1
49784,31652,0,0,124,124,0,1,0,1,0
19169,3389,19169,3389,293,223,70,4,0,3,1
13710,3389,13710,3389,293,223,70,4,0,3,1
51426,30700,0,0,74,74,0,1,0,1,0
34094,3389,34094,3389,293,223,70,4,0,3,1
10600,60053,0,0,143,143,0,1,0,1,0
51814,32306,0,0,81,81,0,1,0,1,0
15703,13945,0,0,119,119,0,1,0,1,0
1499,22598,0,0,154,154,0,1,0,1,0
51598,32254,0,0,69,69,0,1,0,1,0
15910,3389,15910,3389,293,223,70,4,0,3,1
1760,23006,0,0,152,152,0,1,0,1,0
55471,5618,0,0,145,145,0,1,0,1,0
15401,3389,15401,3389,293,223,70,4,0,3,1
19734,3389,19734,3389,293,223,70,4,0,3,1
4987,24044,0,0,157,157,0,1,0,1,0
46304,57715,0,0,62,62,0,1,0,1,0
11492,60051,0,0,139,139,0,1,0,1,0
51077,6394,0,0,145,145,0,1,0,1,0
20570,61248,0,0,156,156,0,1,0,1,0
11778,61248,0,0,139,139,0,1,0,1,0
6155,25773,0,0,141,141,0,1,0,1,0
3045,42628,0,0,146,146,0,1,0,1,0
32955,2842,0,0,104,104,0,1,0,1,0
26269,3389,26269,3389,293,223,70,4,0,3,1
12977,8258,4654,1438,209,179,29,2,0,1,0
2460,24102,0,0,148,148,0,1,0,1,0
3491,46936,0,0,145,145,0,1,0,1,0
13239,25773,0,0,139,139,0,1,0,1,0
18006,3389,18006,3389,293,223,70,4,0,3,1
48975,28102,0,0,153,153,0,1,0,1,0
49692,33539,0,0,128,128,0,1,0,1,0
20107,25773,0,0,144,144,0,1,0,1,0
49086,29971,0,0,149,149,0,1,0,1,0
55195,5699,0,0,145,145,0,1,0,1,0
49415,31652,0,0,144,144,0,1,0,1,0
32358,3389,32358,3389,293,223,70,4,0,3,1
11603,53612,0,0,117,117,0,1,0,1,0
29235,30437,0,0,99,99,0,1,0,1,0
50567,29175,0,0,102,102,0,1,0,1,0
17111,61248,0,0,148,148,0,1,0,1,0
50572,41596,0,0,62,62,0,1,0,1,0
17208,57468,0,0,155,155,0,1,0,1,0
29483,34021,0,0,62,62,0,1,0,1,0
28155,33030,0,0,72,72,0,1,0,1,0
18792,3389,18792,3389,293,223,70,4,0,3,1
20389,3389,20389,3389,293,223,70,4,0,3,1
24669,31196,0,0,89,89,0,1,0,1,0
16990,3389,16990,3389,293,223,70,4,0,3,1
50916,31652,0,0,84,84,0,1,0,1,0
13716,3389,13716,3389,293,223,70,4,0,3,1
27541,25773,0,0,147,147,0,1,0,1,0
17083,3389,17083,3389,293,223,70,4,0,3,1
31766,3389,31766,3389,293,223,70,4,0,3,1
58640,31652,0,0,93,93,0,1,0,1,0
17638,17207,0,0,75,75,0,1,0,1,0
3681,23322,0,0,157,157,0,1,0,1,0
16373,25773,0,0,145,145,0,1,0,1,0
38910,8449,0,0,145,145,0,1,0,1,0
6274,24755,0,0,157,157,0,1,0,1,0
21292,31852,0,0,83,83,0,1,0,1,0
26202,28739,0,0,117,117,0,1,0,1,0
10540,61248,0,0,143,143,0,1,0,1,0
3857,48536,0,0,143,143,0,1,0,1,0
50499,31652,0,0,103,103,0,1,0,1,0
5188,25773,0,0,142,142,0,1,0,1,0
28363,34021,0,0,62,62,0,1,0,1,0
39075,6640,0,0,146,146,0,1,0,1,0
55996,33339,0,0,62,62,0,1,0,1,0
49117,30689,0,0,147,147,0,1,0,1,0
18722,3389,18722,3389,293,223,70,4,0,3,1
15802,2240,7250,2240,214,168,46,2,0,2,0
18249,18316,0,0,62,62,0,1,0,1,0
21039,3389,21039,3389,293,223,70,4,0,3,1
51720,31704,0,0,63,63,0,1,0,1,0
39628,6243,0,0,146,146,0,1,0,1,0
3061,32232,0,0,143,143,0,1,0,1,0
47583,52884,0,0,62,62,0,1,0,1,0
36680,11929,0,0,146,146,0,1,0,1,0
17467,3389,17467,3389,293,223,70,4,0,3,1
2834,35376,0,0,143,143,0,1,0,1,0
28999,3389,28999,3389,293,223,70,4,0,3,1
37855,4644,0,0,131,131,0,1,0,1,0
21240,61248,0,0,157,157,0,1,0,1,0
3172,30708,0,0,143,143,0,1,0,1,0
12741,3389,12741,3389,293,223,70,4,0,3,1
4384,25773,0,0,142,142,0,1,0,1,0
15708,20132,0,0,85,85,0,1,0,1,0
16657,15554,0,0,98,98,0,1,0,1,0
55556,44363,0,0,93,93,0,1,0,1,0
50024,33048,0,0,115,115,0,1,0,1,0
4145,47438,0,0,146,146,0,1,0,1,0
41164,5618,0,0,145,145,0,1,0,1,0
49480,31652,0,0,135,135,0,1,0,1,0
49533,27187,0,0,140,140,0,1,0,1,0
14429,12038,0,0,147,147,0,1,0,1,0
19699,3389,19699,3389,293,223,70,4,0,3,1
11933,61248,0,0,140,140,0,1,0,1,0
38174,3389,38174,3389,293,223,70,4,1,3,1
9227,61248,0,0,139,139,0,1,0,1,0
48877,36137,0,0,139,139,0,1,0,1,0
49814,31652,0,0,125,125,0,1,0,1,0
9516,61248,0,0,139,139,0,1,0,1,0
13946,11032,881,326,161,155,6,1,0,1,0
51527,31652,0,0,71,71,0,1,0,1,0
16258,3389,16258,3389,293,223,70,4,0,3,1
50307,32982,0,0,109,109,0,1,0,1,0
14579,12051,0,0,145,145,0,1,0,1,0
52482,34021,0,0,64,64,0,1,0,1,0
21756,3389,21756,3389,293,223,70,4,0,3,1
2174,46013,0,0,144,144,0,1,0,1,0
19083,43059,0,0,87,87,0,1,0,1,0
3074,32062,0,0,143,143,0,1,0,1,0
6130,24675,0,0,157,157,0,1,0,1,0
10356,25773,0,0,143,143,0,1,0,1,0
23430,32652,0,0,76,76,0,1,0,1,0
55241,6916,0,0,145,145,0,1,0,1,0
52259,33446,0,0,64,64,0,1,0,1,0
10421,25773,0,0,153,153,0,1,0,1,0
51548,31652,0,0,69,69,0,1,0,1,0
52094,29548,0,0,68,68,0,1,0,1,0
5272,24201,0,0,157,157,0,1,0,1,0
29117,34021,0,0,62,62,0,1,0,1,0
51681,31453,0,0,65,65,0,1,0,1,0
8561,25773,0,0,140,140,0,1,0,1,0
51512,33282,0,0,88,88,0,1,0,1,0
49791,27766,0,0,134,134,0,1,0,1,0
2102,23541,0,0,150,150,0,1,0,1,0
7614,61248,0,0,139,139,0,1,0,1,0
13427,25773,0,0,139,139,0,1,0,1,0
6827,59664,0,0,139,139,0,1,0,1,0
11832,7668,4518,1674,219,185,34,2,0,1,0
48188,39598,0,0,122,122,0,1,0,1,0
15901,3389,15901,3389,293,223,70,4,0,3,1
6101,25773,0,0,150,150,0,1,0,1,0
51312,31652,0,0,71,71,0,1,0,1,0
28152,33153,0,0,71,71,0,1,0,1,0
49608,31652,0,0,131,131,0,1,0,1,0
50662,29721,0,0,111,111,0,1,0,1,0
32210,2567,0,0,100,100,0,1,0,1,0
49089,31770,0,0,149,149,0,1,0,1,0
6843,53792,0,0,143,143,0,1,0,1,0
50131,28530,0,0,125,125,0,1,0,1,0
28508,1205,0,0,80,80,0,1,0,1,0
43570,7662,0,0,145,145,0,1,0,1,0
8208,25773,0,0,156,156,0,1,0,1,0
47154,49060,0,0,97,97,0,1,0,1,0
13693,25773,0,0,139,139,0,1,0,1,0
17850,25773,0,0,142,142,0,1,0,1,0
49207,31652,0,0,144,144,0,1,0,1,0
37809,3389,37809,3389,293,223,70,4,1,3,1
50409,29522,0,0,102,102,0,1,0,1,0
12169,6301,7190,2221,243,197,45,2,0,2,0
29858,33557,0,0,66,66,0,1,0,1,0
48768,34855,0,0,136,136,0,1,0,1,0
45912,58367,0,0,67,67,0,1,0,1,0
6820,25773,0,0,153,153,0,1,0,1,0
30641,1990,0,0,91,91,0,1,0,1,0
11433,23307,0,0,125,125,0,1,0,1,0
37963,3389,37963,3389,293,223,70,4,1,3,1
11231,3389,11231,3389,293,223,70,4,1,3,1
23307,34021,0,0,62,62,0,1,0,1,0
29661,32569,0,0,77,77,0,1,0,1,0
51850,33516,0,0,79,79,0,1,0,1,0
11619,60244,0,0,139,139,0,1,0,1,0
29272,3389,29272,3389,293,223,70,4,1,3,1
21637,3389,21637,3389,293,223,70,4,0,3,1
10278,25773,0,0,153,153,0,1,0,1,0
50513,32497,0,0,98,98,0,1,0,1,0
19155,61248,0,0,154,154,0,1,0,1,0
47446,22280,0,0,155,155,0,1,0,1,0
12681,25773,0,0,150,150,0,1,0,1,0
8864,57160,0,0,143,143,0,1,0,1,0
51278,32105,0,0,78,78,0,1,0,1,0
10144,58019,0,0,140,140,0,1,0,1,0
38134,3389,38134,3389,293,223,70,4,1,3,1
10805,3389,10805,3389,293,223,70,4,1,3,1
52024,32378,0,0,62,62,0,1,0,1,0
9089,25773,0,0,140,140,0,1,0,1,0
50599,29241,0,0,100,100,0,1,0,1,0
29296,34021,0,0,62,62,0,1,0,1,0
28306,2602,0,0,86,86,0,1,0,1,0
52350,33611,0,0,63,63,0,1,0,1,0
29329,23485,0,0,147,147,0,1,0,1,0
37891,3389,37891,3389,293,223,70,4,1,3,1
42416,5618,0,0,145,145,0,1,0,1,0
29332,34021,0,0,62,62,0,1,0,1,0
18078,23799,0,0,121,121,0,1,0,1,0
31658,18283,0,0,147,147,0,1,0,1,0
50968,29995,0,0,88,88,0,1,0,1,0
7340,53789,0,0,141,141,0,1,0,1,0
6882,25773,0,0,153,153,0,1,0,1,0
27265,34021,0,0,62,62,0,1,0,1,0
10111,25017,0,0,142,142,0,1,0,1,0
39928,5407,0,0,142,142,0,1,0,1,0
44370,7527,0,0,145,145,0,1,0,1,0
20242,19733,0,0,79,79,0,1,0,1,0
14320,23202,0,0,112,112,0,1,0,1,0
63554,3389,63554,3389,293,223,70,4,0,3,1
27220,25773,0,0,147,147,0,1,0,1,0
28115,34021,0,0,62,62,0,1,0,1,0
16167,3389,16167,3389,293,223,70,4,0,3,1
2540,47198,0,0,144,144,0,1,0,1,0
20235,29891,0,0,102,102,0,1,0,1,0
16879,3389,16879,3389,293,223,70,4,0,3,1
51229,31691,0,0,73,73,0,1,0,1,0
9878,3389,9878,3389,293,223,70,4,1,3,1
30889,3389,30889,3389,293,223,70,4,0,3,1
16836,61248,0,0,151,151,0,1,0,1,0
1290,21915,0,0,156,156,0,1,0,1,0
1814,23090,0,0,152,152,0,1,0,1,0
12202,61248,0,0,139,139,0,1,0,1,0
50059,34021,0,0,123,123,0,1,0,1,0
37328,3389,37328,3389,293,223,70,4,1,3,1
39370,60362,0,0,88,88,0,1,0,1,0
16611,3389,16611,3389,293,223,70,4,0,3,1
38734,6884,0,0,146,146,0,1,0,1,0
51693,31729,0,0,64,64,0,1,0,1,0
17740,25773,0,0,143,143,0,1,0,1,0
6177,32216,0,0,153,153,0,1,0,1,0
27865,25443,0,0,144,144,0,1,0,1,0
50630,30071,0,0,94,94,0,1,0,1,0
38273,3389,38273,3389,293,223,70,4,1,3,1
49160,33819,0,0,146,146,0,1,0,1,0
34043,16288,0,0,147,147,0,1,0,1,0
50404,29141,0,0,118,118,0,1,0,1,0
28822,34021,0,0,62,62,0,1,0,1,0
56540,31652,0,0,68,68,0,1,0,1,0
16222,3389,16222,3389,293,223,70,4,0,3,1
49114,30620,0,0,147,147,0,1,0,1,0
3591,25773,0,0,142,142,0,1,0,1,0
28408,3389,28408,3389,293,223,70,4,0,3,1
51271,32111,0,0,78,78,0,1,0,1,0
10849,3389,10849,3389,293,223,70,4,1,3,1
29591,32219,0,0,80,80,0,1,0,1,0
18855,3389,18855,3389,293,223,70,4,0,3,1
27754,928,0,0,75,75,0,1,0,1,0
12456,58464,0,0,134,134,0,1,0,1,0
11328,3389,11328,3389,293,223,70,4,0,3,1
10376,24093,0,0,135,135,0,1,0,1,0
14703,3389,14703,3389,293,223,70,4,0,3,1
19935,3389,19935,3389,293,223,70,4,0,3,1
9246,57865,0,0,129,129,0,1,0,1,0
35871,8938,0,0,146,146,0,1,0,1,0
50709,31652,0,0,91,91,0,1,0,1,0
49028,28652,0,0,151,151,0,1,0,1,0
8399,25773,0,0,143,143,0,1,0,1,0
10886,25773,0,0,145,145,0,1,0,1,0
55297,5618,0,0,145,145,0,1,0,1,0
12072,3389,12072,3389,293,223,70,4,0,3,1
17154,25773,0,0,142,142,0,1,0,1,0
27066,33149,0,0,70,70,0,1,0,1,0
22048,30854,0,0,91,91,0,1,0,1,0
30373,1891,0,0,90,90,0,1,0,1,0
52405,34021,0,0,66,66,0,1,0,1,0
49090,31788,0,0,148,148,0,1,0,1,0
18184,45462,0,0,94,94,0,1,0,1,0
2146,46050,0,0,144,144,0,1,0,1,0
18293,28900,0,0,109,109,0,1,0,1,0
3167,30772,0,0,143,143,0,1,0,1,0
15164,13037,0,0,132,132,0,1,0,1,0
10028,25773,0,0,148,148,0,1,0,1,0
56223,31652,0,0,62,62,0,1,0,1,0
11462,61248,0,0,142,142,0,1,0,1,0
14236,25773,0,0,148,148,0,1,0,1,0
14858,13412,0,0,147,147,0,1,0,1,0
16306,19687,0,0,80,80,0,1,0,1,0
22005,61248,0,0,158,158,0,1,0,1,0
21944,25773,0,0,144,144,0,1,0,1,0
52573,34006,0,0,62,62,0,1,0,1,0
27813,26467,0,0,140,140,0,1,0,1,0
18210,19568,0,0,76,76,0,1,0,1,0
10179,3389,10179,3389,293,223,70,4,1,3,1
39081,5096,0,0,138,138,0,1,0,1,0
24585,31021,0,0,93,93,0,1,0,1,0
60972,4202,40657,2152,238,194,44,2,0,2,0
29579,34021,0,0,62,62,0,1,0,1,0
33205,34021,0,0,76,76,0,1,0,1,0
61056,32330,0,0,62,62,0,1,0,1,0
10270,3389,10270,3389,293,223,70,4,0,3,1
11009,25773,0,0,152,152,0,1,0,1,0
50213,28714,0,0,123,123,0,1,0,1,0
19259,28079,0,0,120,120,0,1,0,1,0
13860,3389,13860,3389,293,223,70,4,0,3,1
7395,25374,0,0,157,157,0,1,0,1,0
62587,3770,53058,2809,267,209,58,3,0,2,0
22170,3389,22170,3389,293,223,70,4,0,3,1
29789,33212,0,0,70,70,0,1,0,1,0
28925,34021,0,0,62,62,0,1,0,1,0
13251,9925,2077,770,180,165,15,1,0,1,0
17525,17017,0,0,78,78,0,1,0,1,0
12216,22726,0,0,118,118,0,1,0,1,0
9475,3389,9475,3389,293,223,70,4,1,3,1
20599,30566,0,0,95,95,0,1,0,1,0
37271,3389,37271,3389,293,223,70,4,1,3,1
34631,7956,0,0,136,136,0,1,0,1,0
26867,34021,0,0,62,62,0,1,0,1,0
20161,3389,20161,3389,293,223,70,4,0,3,1
3297,28972,0,0,143,143,0,1,0,1,0
54052,15209,0,0,118,118,0,1,0,1,0
13086,20629,0,0,142,142,0,1,0,1,0
51255,33104,0,0,94,94,0,1,0,1,0
35838,8962,0,0,146,146,0,1,0,1,0
36119,12857,0,0,146,146,0,1,0,1,0
62822,43651,0,0,95,95,0,1,0,1,0
27606,25773,0,0,147,147,0,1,0,1,0
18212,19514,0,0,75,75,0,1,0,1,0
28229,29443,0,0,109,109,0,1,0,1,0
10666,3389,10666,3389,293,223,70,4,0,3,1
50888,29831,0,0,91,91,0,1,0,1,0
10864,3389,10864,3389,293,223,70,4,0,3,1
32615,2716,0,0,102,102,0,1,0,1,0
49160,33837,0,0,146,146,0,1,0,1,0
20052,3389,20052,3389,293,223,70,4,0,3,1
22783,34021,0,0,62,62,0,1,0,1,0
46517,60105,0,0,66,66,0,1,0,1,0
11687,61248,0,0,141,141,0,1,0,1,0
22639,21528,0,0,99,99,0,1,0,1,0
9953,61248,0,0,141,141,0,1,0,1,0
19317,3389,19317,3389,293,223,70,4,0,3,1
52001,32312,0,0,62,62,0,1,0,1,0
11811,3389,11811,3389,293,223,70,4,1,3,1
15490,28371,0,0,114,114,0,1,0,1,0
10876,3389,10876,3389,293,223,70,4,0,3,1
37867,9968,0,0,146,146,0,1,0,1,0
11608,60535,0,0,140,140,0,1,0,1,0
47540,5618,0,0,145,145,0,1,0,1,0
33779,3389,33779,3389,293,223,70,4,0,3,1
19133,3389,19133,3389,293,223,70,4,0,3,1
49160,33287,0,0,146,146,0,1,0,1,0
24495,61126,0,0,149,149,0,1,0,1,0
31093,3389,31093,3389,293,223,70,4,0,3,1
6524,24893,0,0,157,157,0,1,0,1,0
23813,25773,0,0,145,145,0,1,0,1,0
49457,27018,0,0,142,142,0,1,0,1,0
29276,1488,0,0,84,84,0,1,0,1,0
46816,60130,0,0,68,68,0,1,0,1,0
32090,3389,32090,3389,293,223,70,4,0,3,1
28920,3389,28920,3389,293,223,70,4,0,3,1
3970,51354,0,0,142,142,0,1,0,1,0
28212,30264,0,0,101,101,0,1,0,1,0
10041,61248,0,0,141,141,0,1,0,1,0
53073,23007,0,0,89,89,0,1,0,1,0
12542,3389,12542,3389,293,223,70,4,0,3,1
15553,3389,15553,3389,293,223,70,4,0,3,1
21660,3389,21660,3389,293,223,70,4,0,3,1
64333,32587,0,0,64,64,0,1,0,1,0
4216,22965,0,0,151,151,0,1,0,1,0
51967,32211,0,0,62,62,0,1,0,1,0
11839,60576,0,0,139,139,0,1,0,1,0
18458,18396,0,0,63,63,0,1,0,1,0
53264,60660,0,0,104,104,0,1,0,1,0
11407,61025,0,0,142,142,0,1,0,1,0
28226,2534,0,0,85,85,0,1,0,1,0
49056,30710,0,0,150,150,0,1,0,1,0
6145,32325,0,0,153,153,0,1,0,1,0
29054,34021,0,0,62,62,0,1,0,1,0
54198,14344,0,0,120,120,0,1,0,1,0
12710,25773,0,0,139,139,0,1,0,1,0
50149,28570,0,0,124,124,0,1,0,1,0
13758,54820,0,0,153,153,0,1,0,1,0
28240,28879,0,0,115,115,0,1,0,1,0
20349,3389,20349,3389,293,223,70,4,0,3,1
15800,3389,15800,3389,293,223,70,4,0,3,1
9247,3389,9247,3389,293,223,70,4,1,3,1
16936,16023,0,0,91,91,0,1,0,1,0
52020,5618,0,0,145,145,0,1,0,1,0
32954,60692,0,0,114,114,0,1,0,1,0
24978,23281,0,0,119,119,0,1,0,1,0
40757,3389,40757,3389,293,223,70,4,0,3,1
10704,5872,6459,2394,250,200,49,3,0,2,0
9553,3389,9553,3389,293,223,70,4,1,3,1
37061,3389,37061,3389,293,223,70,4,0,3,1
49155,33872,0,0,146,146,0,1,0,1,0
50230,32393,0,0,119,119,0,1,0,1,0
11175,3894,10311,3186,284,218,65,3,0,2,0
26201,34021,0,0,62,62,0,1,0,1,0
19153,3389,19153,3389,293,223,70,4,0,3,1
7512,24112,0,0,146,146,0,1,0,1,0
58952,32504,0,0,92,92,0,1,0,1,0
50172,34021,0,0,121,121,0,1,0,1,0
15997,3389,15997,3389,293,223,70,4,0,3,1
20452,3389,20452,3389,293,223,70,4,0,3,1
11590,25773,0,0,152,152,0,1,0,1,0
57325,31652,0,0,62,62,0,1,0,1,0
17745,3389,17745,3389,293,223,70,4,0,3,1
51636,31780,0,0,66,66,0,1,0,1,0
10465,5491,6871,2546,256,204,52,3,0,2,0
26062,305,0,0,66,66,0,1,0,1,0
14092,11265,630,233,157,153,4,1,0,1,0
50101,32961,0,0,112,112,0,1,0,1,0
45533,60046,0,0,62,62,0,1,0,1,0
2891,43141,0,0,146,146,0,1,0,1,0
12458,3389,12458,3389,293,223,70,4,1,3,1
29027,34021,0,0,62,62,0,1,0,1,0
8193,61248,0,0,139,139,0,1,0,1,0
23711,25773,0,0,145,145,0,1,0,1,0
43894,3389,43894,3389,293,223,70,4,0,3,1
25702,34021,0,0,62,62,0,1,0,1,0
45979,58943,0,0,62,62,0,1,0,1,0
17351,2115,7866,2115,206,162,43,2,0,2,0
22360,3389,22360,3389,293,223,70,4,0,3,1
51500,31652,0,0,67,67,0,1,0,1,0
10693,3389,10693,3389,293,223,70,4,0,3,1
9901,3389,9901,3389,293,223,70,4,0,3,1
17507,18622,0,0,66,66,0,1,0,1,0
27390,25087,0,0,140,140,0,1,0,1,0
37108,3389,37108,3389,293,223,70,4,0,3,1
8681,56855,0,0,143,143,0,1,0,1,0
13026,3389,13026,3389,293,223,70,4,0,3,1
55149,9148,0,0,133,133,0,1,0,1,0
29197,34021,0,0,62,62,0,1,0,1,0
33699,3389,33699,3389,293,223,70,4,1,3,1
14916,61248,0,0,148,148,0,1,0,1,0
16385,25773,0,0,141,141,0,1,0,1,0
28238,3389,28238,3389,293,223,70,4,0,3,1
14215,25773,0,0,148,148,0,1,0,1,0
1559,22040,0,0,156,156,0,1,0,1,0
19465,28462,0,0,116,116,0,1,0,1,0
37444,60461,0,0,95,95,0,1,0,1,0
50592,29226,0,0,101,101,0,1,0,1,0
49651,31652,0,0,130,130,0,1,0,1,0
18932,3389,18932,3389,293,223,70,4,0,3,1
41567,34021,0,0,112,112,0,1,0,1,0
38125,9542,0,0,146,146,0,1,0,1,0
46459,60101,0,0,66,66,0,1,0,1,0
34037,3240,0,0,110,110,0,1,0,1,0
18245,3389,18245,3389,293,223,70,4,0,3,1
11408,53015,0,0,151,151,0,1,0,1,0
49160,32860,0,0,146,146,0,1,0,1,0
50619,34021,0,0,110,110,0,1,0,1,0
9390,3389,9390,3389,293,223,70,4,1,3,1
10839,3389,10839,3389,293,223,70,4,1,3,1
50889,30717,0,0,85,85,0,1,0,1,0
15086,25773,0,0,147,147,0,1,0,1,0
2967,22927,0,0,157,157,0,1,0,1,0
52656,25790,0,0,80,80,0,1,0,1,0
14760,3389,14760,3389,293,223,70,4,0,3,1
16135,18407,0,0,145,145,0,1,0,1,0
11361,3389,11361,3389,293,223,70,4,0,3,1
3323,49476,0,0,143,143,0,1,0,1,0
21964,28501,0,0,116,116,0,1,0,1,0
50185,31652,0,0,109,109,0,1,0,1,0
51200,30929,0,0,97,97,0,1,0,1,0
15139,3389,15139,3389,293,223,70,4,0,3,1
8371,61248,0,0,140,140,0,1,0,1,0
27212,25773,0,0,147,147,0,1,0,1,0
8185,61248,0,0,139,139,0,1,0,1,0
5744,56515,0,0,140,140,0,1,0,1,0
35839,8961,0,0,146,146,0,1,0,1,0
9168,24688,0,0,143,143,0,1,0,1,0
50198,34021,0,0,120,120,0,1,0,1,0
49754,32063,0,0,131,131,0,1,0,1,0
7516,25773,0,0,155,155,0,1,0,1,0
57712,51850,0,0,116,116,0,1,0,1,0
49061,29388,0,0,150,150,0,1,0,1,0
14930,61248,0,0,148,148,0,1,0,1,0
20410,1294,4813,1294,150,123,26,2,0,1,0
1387,22423,0,0,154,154,0,1,0,1,0
12027,7977,4183,1550,214,182,32,2,0,1,0
11456,61248,0,0,139,139,0,1,0,1,0
25740,34021,0,0,62,62,0,1,0,1,0
14359,3389,14359,3389,293,223,70,4,0,3,1
13114,3252,12094,3252,283,216,67,3,0,2,0
9261,3389,9261,3389,293,223,70,4,0,3,1
31521,2314,0,0,96,96,0,1,0,1,0
49690,23430,0,0,155,155,0,1,0,1,0
20271,61248,0,0,156,156,0,1,0,1,0
24396,921,0,0,68,68,0,1,0,1,0
16093,14603,0,0,110,110,0,1,0,1,0
29103,29775,0,0,106,106,0,1,0,1,0
31688,20180,0,0,147,147,0,1,0,1,0
50612,31652,0,0,94,94,0,1,0,1,0
37588,3389,37588,3389,293,223,70,4,1,3,1
50064,34021,0,0,123,123,0,1,0,1,0
19349,28245,0,0,118,118,0,1,0,1,0
17692,24503,0,0,143,143,0,1,0,1,0
22284,3389,22284,3389,293,223,70,4,0,3,1
13045,3389,13045,3389,293,223,70,4,0,3,1
6119,25773,0,0,150,150,0,1,0,1,0
57819,52221,0,0,117,117,0,1,0,1,0
52455,33800,0,0,62,62,0,1,0,1,0
28675,27630,0,0,128,128,0,1,0,1,0
23944,25773,0,0,145,145,0,1,0,1,0
57791,3389,57791,3389,293,223,70,4,0,3,1
49077,31384,0,0,149,149,0,1,0,1,0
13875,3389,13875,3389,293,223,70,4,0,3,1
49643,33477,0,0,129,129,0,1,0,1,0
3741,50691,0,0,143,143,0,1,0,1,0
10190,25773,0,0,154,154,0,1,0,1,0
30635,4573,0,0,104,104,0,1,0,1,0
29148,34021,0,0,62,62,0,1,0,1,0
27502,25773,0,0,147,147,0,1,0,1,0
18897,3389,18897,3389,293,223,70,4,0,3,1
28596,60915,0,0,132,132,0,1,0,1,0
12403,3389,12403,3389,293,223,70,4,0,3,1
43990,7591,0,0,145,145,0,1,0,1,0
18158,3389,18158,3389,293,223,70,4,0,3,1
16883,25773,0,0,144,144,0,1,0,1,0
14522,3389,14522,3389,293,223,70,4,0,3,1
31744,3389,31744,3389,293,223,70,4,0,3,1
17962,3389,17962,3389,293,223,70,4,0,3,1
47432,60181,0,0,71,71,0,1,0,1,0
12053,25773,0,0,151,151,0,1,0,1,0
17952,3389,17952,3389,293,223,70,4,0,3,1
51815,31761,0,0,62,62,0,1,0,1,0
12032,3389,12032,3389,293,223,70,4,1,3,1
22695,3389,22695,3389,293,223,70,4,1,3,1
19204,27977,0,0,121,121,0,1,0,1,0
28264,27752,0,0,127,127,0,1,0,1,0
20686,38356,0,0,74,74,0,1,0,1,0
17632,19024,0,0,69,69,0,1,0,1,0
12372,6794,6551,2024,234,192,41,2,0,2,0
52091,26773,0,0,85,85,0,1,0,1,0
9841,4499,7943,2944,273,213,60,3,0,2,0
3500,26166,0,0,143,143,0,1,0,1,0
11990,61248,0,0,145,145,0,1,0,1,0
49160,33949,0,0,146,146,0,1,0,1,0
3431,47893,0,0,144,144,0,1,0,1,0
49067,29536,0,0,149,149,0,1,0,1,0
8294,25773,0,0,156,156,0,1,0,1,0
14223,13356,0,0,147,147,0,1,0,1,0
49417,34021,0,0,139,139,0,1,0,1,0
55971,3389,55971,3389,293,223,70,4,0,3,1
6503,53225,0,0,144,144,0,1,0,1,0
13886,3389,13886,3389,293,223,70,4,0,3,1
62018,3922,48693,2577,257,204,53,3,0,2,0
6619,25773,0,0,152,152,0,1,0,1,0
60024,32536,0,0,62,62,0,1,0,1,0
28181,31747,0,0,85,85,0,1,0,1,0
16007,3389,16007,3389,293,223,70,4,0,3,1
49680,33550,0,0,129,129,0,1,0,1,0
18080,23732,0,0,121,121,0,1,0,1,0
7049,25773,0,0,141,141,0,1,0,1,0
21498,32235,0,0,79,79,0,1,0,1,0
10055,25773,0,0,148,148,0,1,0,1,0
20029,3389,20029,3389,293,223,70,4,0,3,1
11442,3389,11442,3389,293,223,70,4,0,3,1
56155,31652,0,0,107,107,0,1,0,1,0
13209,3389,13209,3389,293,223,70,4,0,3,1
51687,6291,0,0,145,145,0,1,0,1,0
12869,7996,4993,1543,214,182,31,2,0,1,0
50205,29014,0,0,110,110,0,1,0,1,0
51272,31652,0,0,71,71,0,1,0,1,0
20017,3389,20017,3389,293,223,70,4,0,3,1
48920,26170,0,0,156,156,0,1,0,1,0
11977,60784,0,0,139,139,0,1,0,1,0
10051,24334,0,0,138,138,0,1,0,1,0
21338,3389,21338,3389,293,223,70,4,0,3,1
44912,5618,0,0,145,145,0,1,0,1,0
7552,25773,0,0,141,141,0,1,0,1,0
49160,33704,0,0,146,146,0,1,0,1,0
16828,28138,0,0,116,116,0,1,0,1,0
5457,55680,0,0,141,141,0,1,0,1,0
28848,28495,0,0,119,119,0,1,0,1,0
49162,34018,0,0,145,145,0,1,0,1,0
8044,25773,0,0,156,156,0,1,0,1,0
46494,56998,0,0,62,62,0,1,0,1,0
43848,13649,0,0,150,150,0,1,0,1,0
20494,30370,0,0,97,97,0,1,0,1,0
15019,2426,7852,2426,227,177,50,3,0,2,0
9148,3396,9135,3385,292,222,69,3,0,2,0
38009,9733,0,0,146,146,0,1,0,1,0
3348,49547,0,0,143,143,0,1,0,1,0
14427,3389,14427,3389,293,223,70,4,0,3,1
48966,27228,0,0,154,154,0,1,0,1,0
11302,6824,5429,2012,234,192,41,2,0,2,0
2979,24913,0,0,146,146,0,1,0,1,0
46723,56132,0,0,62,62,0,1,0,1,0
9054,61248,0,0,139,139,0,1,0,1,0
50396,29491,0,0,103,103,0,1,0,1,0
24132,34021,0,0,62,62,0,1,0,1,0
24029,34021,0,0,62,62,0,1,0,1,0
5785,52030,0,0,144,144,0,1,0,1,0
19244,26773,0,0,133,133,0,1,0,1,0
50515,32794,0,0,102,102,0,1,0,1,0
3840,25773,0,0,142,142,0,1,0,1,0
9215,25773,0,0,155,155,0,1,0,1,0
16158,2435,9057,2435,227,177,50,3,0,2,0
17061,29645,0,0,102,102,0,1,0,1,0
51166,31652,0,0,75,75,0,1,0,1,0
53037,21192,0,0,101,101,0,1,0,1,0
38661,3389,38661,3389,293,223,70,4,0,3,1
64440,31656,0,0,62,62,0,1,0,1,0
1060,21874,0,0,157,157,0,1,0,1,0
16969,25531,0,0,143,143,0,1,0,1,0
37921,7468,0,0,146,146,0,1,0,1,0
10963,3389,10963,3389,293,223,70,4,1,3,1
19255,3389,19255,3389,293,223,70,4,0,3,1
49321,24527,0,0,156,156,0,1,0,1,0
17373,3389,17373,3389,293,223,70,4,0,3,1
12026,61248,0,0,140,140,0,1,0,1,0
28385,34021,0,0,62,62,0,1,0,1,0
29445,23888,0,0,147,147,0,1,0,1,0
36155,3389,36155,3389,293,223,70,4,0,3,1
7014,25773,0,0,141,141,0,1,0,1,0
3388,48035,0,0,144,144,0,1,0,1,0
39760,6148,0,0,146,146,0,1,0,1,0
54812,8193,0,0,146,146,0,1,0,1,0
51886,33542,0,0,78,78,0,1,0,1,0
50856,34021,0,0,104,104,0,1,0,1,0
13511,10340,1630,604,173,161,12,1,0,1,0
27780,34021,0,0,62,62,0,1,0,1,0
51885,31968,0,0,62,62,0,1,0,1,0
21168,61248,0,0,157,157,0,1,0,1,0
58410,31652,0,0,95,95,0,1,0,1,0
12998,2906,9405,2906,260,200,60,3,0,2,0
11304,23403,0,0,127,127,0,1,0,1,0
26013,660,0,0,68,68,0,1,0,1,0
61854,32055,0,0,76,76,0,1,0,1,0
16210,61248,0,0,146,146,0,1,0,1,0
50202,32374,0,0,120,120,0,1,0,1,0
16783,3389,16783,3389,293,223,70,4,0,3,1
55092,43003,0,0,93,93,0,1,0,1,0
10842,61248,0,0,142,142,0,1,0,1,0
31444,5259,0,0,111,111,0,1,0,1,0
47521,46307,0,0,106,106,0,1,0,1,0
20506,61248,0,0,156,156,0,1,0,1,0
17132,25773,0,0,144,144,0,1,0,1,0
50118,33153,0,0,115,115,0,1,0,1,0
23808,3389,23808,3389,293,223,70,4,0,3,1
50322,28958,0,0,120,120,0,1,0,1,0
13141,3389,13141,3389,293,223,70,4,0,3,1
58147,61061,0,0,132,132,0,1,0,1,0
49105,32287,0,0,148,148,0,1,0,1,0
47484,53261,0,0,62,62,0,1,0,1,0
3637,50386,0,0,143,143,0,1,0,1,0
19512,28548,0,0,115,115,0,1,0,1,0
49649,31652,0,0,130,130,0,1,0,1,0
6940,17447,0,0,153,153,0,1,0,1,0
8363,55332,0,0,141,141,0,1,0,1,0
14077,55064,0,0,153,153,0,1,0,1,0
50019,28055,0,0,120,120,0,1,0,1,0
14267,25773,0,0,140,140,0,1,0,1,0
10540,5611,6742,2498,254,203,51,3,0,2,0
62445,31652,0,0,62,62,0,1,0,1,0
21232,3389,21232,3389,293,223,70,4,0,3,1
24826,25773,0,0,146,146,0,1,0,1,0
49160,33564,0,0,146,146,0,1,0,1,0
20546,39142,0,0,76,76,0,1,0,1,0
49803,33438,0,0,125,125,0,1,0,1,0
50675,31652,0,0,92,92,0,1,0,1,0
20283,27339,0,0,127,127,0,1,0,1,0
28328,25892,0,0,146,146,0,1,0,1,0
24178,34021,0,0,62,62,0,1,0,1,0
42762,34021,0,0,118,118,0,1,0,1,0
55675,3389,55675,3389,293,223,70,4,0,3,1
18528,3389,18528,3389,293,223,70,4,0,3,1
11669,3389,11669,3389,293,223,70,4,0,3,1
45932,58217,0,0,67,67,0,1,0,1,0
49291,34000,0,0,145,145,0,1,0,1,0
9376,61248,0,0,141,141,0,1,0,1,0
21920,34995,0,0,64,64,0,1,0,1,0
17687,61248,0,0,152,152,0,1,0,1,0
19575,28665,0,0,114,114,0,1,0,1,0
11452,3273,10593,3273,285,217,67,3,0,2,0
49537,33679,0,0,133,133,0,1,0,1,0
28253,28250,0,0,122,122,0,1,0,1,0
11892,3389,11892,3389,293,223,70,4,0,3,1
12037,25773,0,0,140,140,0,1,0,1,0
51607,31842,0,0,87,87,0,1,0,1,0
50898,60465,0,0,91,91,0,1,0,1,0
5532,51061,0,0,142,142,0,1,0,1,0
11245,25773,0,0,143,143,0,1,0,1,0
25654,357,0,0,65,65,0,1,0,1,0
28153,34021,0,0,62,62,0,1,0,1,0
3935,23462,0,0,157,157,0,1,0,1,0
48942,26666,0,0,155,155,0,1,0,1,0
51820,32321,0,0,81,81,0,1,0,1,0
33408,6921,0,0,126,126,0,1,0,1,0
42484,3389,42484,3389,293,223,70,4,0,3,1
48675,48760,0,0,62,62,0,1,0,1,0
11214,61248,0,0,139,139,0,1,0,1,0
49599,33623,0,0,131,131,0,1,0,1,0
14847,52622,0,0,117,117,0,1,0,1,0
9809,25773,0,0,149,149,0,1,0,1,0
27778,33730,0,0,64,64,0,1,0,1,0
49630,33491,0,0,129,129,0,1,0,1,0
19279,28116,0,0,119,119,0,1,0,1,0
12673,3389,12673,3389,293,223,70,4,0,3,1
50877,32467,0,0,90,90,0,1,0,1,0
12269,61248,0,0,139,139,0,1,0,1,0
55532,5618,0,0,145,145,0,1,0,1,0
23407,25773,0,0,145,145,0,1,0,1,0
12758,26158,0,0,135,135,0,1,0,1,0
28577,34021,0,0,62,62,0,1,0,1,0
27238,60985,0,0,137,137,0,1,0,1,0
12117,25773,0,0,151,151,0,1,0,1,0
17669,3389,17669,3389,293,223,70,4,0,3,1
34502,7847,0,0,135,135,0,1,0,1,0
21061,31423,0,0,87,87,0,1,0,1,0
50629,29647,0,0,112,112,0,1,0,1,0
28989,34021,0,0,62,62,0,1,0,1,0
6233,57938,0,0,140,140,0,1,0,1,0
28313,34021,0,0,62,62,0,1,0,1,0
49160,33067,0,0,146,146,0,1,0,1,0
49074,29689,0,0,149,149,0,1,0,1,0
19766,1299,4202,1298,150,123,26,2,0,1,0
45909,18592,0,0,153,153,0,1,0,1,0
49206,33979,0,0,144,144,0,1,0,1,0
12739,3389,12739,3389,293,223,70,4,0,3,1
15528,13650,0,0,123,123,0,1,0,1,0
58243,32891,0,0,62,62,0,1,0,1,0
51735,32500,0,0,68,68,0,1,0,1,0
26114,34021,0,0,62,62,0,1,0,1,0
5767,33582,0,0,152,152,0,1,0,1,0
21340,3389,21340,3389,293,223,70,4,0,3,1
20883,3389,20883,3389,293,223,70,4,0,3,1
22171,3389,22171,3389,293,223,70,4,0,3,1
6555,25773,0,0,152,152,0,1,0,1,0
53279,5618,0,0,145,145,0,1,0,1,0
32229,3389,32229,3389,293,223,70,4,0,3,1
49160,33805,0,0,146,146,0,1,0,1,0
51578,31833,0,0,68,68,0,1,0,1,0
41907,60232,0,0,77,77,0,1,0,1,0
39398,60361,0,0,87,87,0,1,0,1,0
8549,55612,0,0,141,141,0,1,0,1,0
23595,34021,0,0,62,62,0,1,0,1,0
2726,22446,0,0,154,154,0,1,0,1,0
10548,5623,6728,2493,254,203,51,3,0,2,0
28235,34021,0,0,62,62,0,1,0,1,0
13228,9889,2117,784,181,165,16,1,0,1,0
18645,26938,0,0,131,131,0,1,0,1,0
23274,34021,0,0,62,62,0,1,0,1,0
51673,31652,0,0,64,64,0,1,0,1,0
11045,61248,0,0,142,142,0,1,0,1,0
18085,61248,0,0,153,153,0,1,0,1,0
21298,31862,0,0,83,83,0,1,0,1,0
29367,1521,0,0,84,84,0,1,0,1,0
19665,40850,0,0,82,82,0,1,0,1,0
49157,33940,0,0,146,146,0,1,0,1,0
15798,20065,0,0,84,84,0,1,0,1,0
15018,25773,0,0,143,143,0,1,0,1,0
7658,25773,0,0,155,155,0,1,0,1,0
49160,33933,0,0,146,146,0,1,0,1,0
17261,3389,17261,3389,293,223,70,4,0,3,1
59169,3389,59169,3389,293,223,70,4,0,3,1
51853,32714,0,0,67,67,0,1,0,1,0
18412,26507,0,0,135,135,0,1,0,1,0
19449,29502,0,0,104,104,0,1,0,1,0
1167,22078,0,0,156,156,0,1,0,1,0
21823,3389,21823,3389,293,223,70,4,0,3,1
5289,55191,0,0,141,141,0,1,0,1,0
30095,3389,30095,3389,293,223,70,4,0,3,1
11467,61248,0,0,142,142,0,1,0,1,0
50671,29388,0,0,98,98,0,1,0,1,0
11140,60954,0,0,143,143,0,1,0,1,0
3633,22762,0,0,152,152,0,1,0,1,0
12747,3389,12747,3389,293,223,70,4,0,3,1
14485,3389,14485,3389,293,223,70,4,0,3,1
55138,42913,0,0,89,89,0,1,0,1,0
18637,3389,18637,3389,293,223,70,4,0,3,1
2422,46853,0,0,144,144,0,1,0,1,0
49214,34021,0,0,144,144,0,1,0,1,0
52208,41392,0,0,145,145,0,1,0,1,0
27141,34021,0,0,62,62,0,1,0,1,0
13889,3389,13889,3389,293,223,70,4,0,3,1
31838,3389,31838,3389,293,223,70,4,0,3,1
63272,3389,63272,3389,293,223,70,4,0,3,1
28878,12635,0,0,112,112,0,1,0,1,0
21217,3389,21217,3389,293,223,70,4,0,3,1
9976,61248,0,0,141,141,0,1,0,1,0
6936,17450,0,0,153,153,0,1,0,1,0
51722,31652,0,0,131,131,0,1,0,1,0
16810,15811,0,0,94,94,0,1,0,1,0
15201,3389,15201,3389,293,223,70,4,0,3,1
49160,32413,0,0,146,146,0,1,0,1,0
37149,3389,37149,3389,293,223,70,4,1,3,1
39167,7820,0,0,146,146,0,1,0,1,0
44971,3389,44971,3389,293,223,70,4,0,3,1
60790,31652,0,0,62,62,0,1,0,1,0
29900,33768,0,0,64,64,0,1,0,1,0
49099,32087,0,0,148,148,0,1,0,1,0
13657,61248,0,0,141,141,0,1,0,1,0
18168,61248,0,0,153,153,0,1,0,1,0
56441,5413,5864,310,158,152,6,1,0,1,0
33771,16738,0,0,147,147,0,1,0,1,0
9668,3389,9668,3389,293,223,70,4,1,3,1
27980,3389,27980,3389,293,223,70,4,0,3,1
16238,19271,0,0,73,73,0,1,0,1,0
50811,32162,0,0,87,87,0,1,0,1,0
38150,4753,0,0,133,133,0,1,0,1,0
20589,3389,20589,3389,293,223,70,4,0,3,1
5846,25773,0,0,150,150,0,1,0,1,0
1280,22255,0,0,155,155,0,1,0,1,0
16827,3389,16827,3389,293,223,70,4,0,3,1
1611,22772,0,0,153,153,0,1,0,1,0
37903,3389,37903,3389,293,223,70,4,1,3,1
8432,24432,0,0,145,145,0,1,0,1,0
9401,3798,8701,3224,285,219,66,3,0,2,0
24285,34021,0,0,62,62,0,1,0,1,0
19457,41360,0,0,83,83,0,1,0,1,0
32284,3389,32284,3389,293,223,70,4,0,3,1
12179,61248,0,0,139,139,0,1,0,1,0
16709,9374,0,0,130,130,0,1,0,1,0
52457,33803,0,0,62,62,0,1,0,1,0
18658,3389,18658,3389,293,223,70,4,0,3,1
19737,25773,0,0,143,143,0,1,0,1,0
16366,19643,0,0,79,79,0,1,0,1,0
17308,43317,0,0,88,88,0,1,0,1,0
12353,25773,0,0,139,139,0,1,0,1,0
18560,61248,0,0,153,153,0,1,0,1,0
36822,8256,0,0,146,146,0,1,0,1,0
38700,60396,0,0,90,90,0,1,0,1,0
29673,32631,0,0,76,76,0,1,0,1,0
19926,19496,0,0,76,76,0,1,0,1,0
26001,3389,26001,3389,293,223,70,4,0,3,1
51718,33425,0,0,83,83,0,1,0,1,0
13707,3389,13707,3389,293,223,70,4,0,3,1
49355,34021,0,0,141,141,0,1,0,1,0
52542,33940,0,0,62,62,0,1,0,1,0
25629,14350,0,0,97,97,0,1,0,1,0
16997,3389,16997,3389,293,223,70,4,0,3,1
3799,25634,0,0,141,141,0,1,0,1,0
2598,24317,0,0,148,148,0,1,0,1,0
13671,12434,0,0,148,148,0,1,0,1,0
14331,27432,0,0,123,123,0,1,0,1,0
48066,42220,0,0,119,119,0,1,0,1,0
31589,5381,0,0,112,112,0,1,0,1,0
55412,31652,0,0,68,68,0,1,0,1,0
5500,25773,0,0,142,142,0,1,0,1,0
61629,52385,0,0,120,120,0,1,0,1,0
22056,34750,0,0,64,64,0,1,0,1,0
1958,22370,0,0,157,157,0,1,0,1,0
12059,61248,0,0,139,139,0,1,0,1,0
17885,3389,17885,3389,293,223,70,4,1,3,1
26217,34021,0,0,62,62,0,1,0,1,0
51248,31652,0,0,72,72,0,1,0,1,0
21122,3389,21122,3389,293,223,70,4,0,3,1
50145,28865,0,0,112,112,0,1,0,1,0
50402,32513,0,0,115,115,0,1,0,1,0
28135,34001,0,0,62,62,0,1,0,1,0
23828,3389,23828,3389,293,223,70,4,0,3,1
14619,61248,0,0,147,147,0,1,0,1,0
51355,31652,0,0,75,75,0,1,0,1,0
21144,3389,21144,3389,293,223,70,4,0,3,1
18276,26255,0,0,138,138,0,1,0,1,0
25780,34021,0,0,62,62,0,1,0,1,0
10332,3389,10332,3389,293,223,70,4,1,3,1
3852,22506,0,0,154,154,0,1,0,1,0
10802,25773,0,0,145,145,0,1,0,1,0
51654,32354,0,0,69,69,0,1,0,1,0
28359,1150,0,0,79,79,0,1,0,1,0
11115,23544,0,0,128,128,0,1,0,1,0
1665,22857,0,0,153,153,0,1,0,1,0
49465,26923,0,0,138,138,0,1,0,1,0
51122,19171,0,0,153,153,0,1,0,1,0
42757,11032,0,0,148,148,0,1,0,1,0
4706,53496,0,0,142,142,0,1,0,1,0
48942,27030,0,0,155,155,0,1,0,1,0
15486,13580,0,0,124,124,0,1,0,1,0
55352,60831,0,0,116,116,0,1,0,1,0
32708,60704,0,0,115,115,0,1,0,1,0
38070,3389,38070,3389,293,223,70,4,1,3,1
17436,61248,0,0,149,149,0,1,0,1,0
57993,61048,0,0,131,131,0,1,0,1,0
27553,34021,0,0,62,62,0,1,0,1,0
9833,61248,0,0,139,139,0,1,0,1,0
11396,3389,11396,3389,293,223,70,4,0,3,1
2292,46476,0,0,144,144,0,1,0,1,0
15607,3389,15607,3389,293,223,70,4,0,3,1
15088,14313,0,0,147,147,0,1,0,1,0
18227,19032,0,0,70,70,0,1,0,1,0
17464,3389,17464,3389,293,223,70,4,0,3,1
12057,61248,0,0,139,139,0,1,0,1,0
63467,38928,0,0,82,82,0,1,0,1,0
14918,22447,0,0,104,104,0,1,0,1,0
18435,1824,6784,1824,186,148,37,2,0,2,0
17464,25773,0,0,143,143,0,1,0,1,0
9607,4127,8345,3093,280,216,63,3,0,2,0
37449,3389,37449,3389,293,223,70,4,0,3,1
51351,38653,0,0,62,62,0,1,0,1,0
52285,34021,0,0,69,69,0,1,0,1,0
26528,24442,0,0,132,132,0,1,0,1,0
1900,23225,0,0,152,152,0,1,0,1,0
3091,42478,0,0,147,147,0,1,0,1,0
51582,32225,0,0,69,69,0,1,0,1,0
50675,60447,0,0,90,90,0,1,0,1,0
55413,33455,0,0,62,62,0,1,0,1,0
10536,25773,0,0,139,139,0,1,0,1,0
21261,3389,21261,3389,293,223,70,4,0,3,1
15039,53877,0,0,118,118,0,1,0,1,0
37752,7589,0,0,146,146,0,1,0,1,0
46425,54021,0,0,79,79,0,1,0,1,0
22687,34021,0,0,62,62,0,1,0,1,0
7589,54165,0,0,141,141,0,1,0,1,0
21402,3389,21402,3389,293,223,70,4,0,3,1
51585,31652,0,0,65,65,0,1,0,1,0
29264,34021,0,0,62,62,0,1,0,1,0
11865,3389,11865,3389,293,223,70,4,0,3,1
53815,16606,0,0,114,114,0,1,0,1,0
17185,3389,17185,3389,293,223,70,4,0,3,1
12305,3389,12305,3389,293,223,70,4,1,3,1
5099,48170,0,0,147,147,0,1,0,1,0
28182,31739,0,0,85,85,0,1,0,1,0
51444,31476,0,0,91,91,0,1,0,1,0
52470,33826,0,0,62,62,0,1,0,1,0
34844,3389,34844,3389,293,223,70,4,1,3,1
7923,25773,0,0,156,156,0,1,0,1,0
23821,61161,0,0,152,152,0,1,0,1,0
25545,264,0,0,64,64,0,1,0,1,0
49124,30833,0,0,147,147,0,1,0,1,0
8457,25773,0,0,155,155,0,1,0,1,0
30449,20982,0,0,147,147,0,1,0,1,0
14324,3389,14324,3389,293,223,70,4,0,3,1
10316,61248,0,0,141,141,0,1,0,1,0
38175,3389,38175,3389,293,223,70,4,1,3,1
1850,23147,0,0,152,152,0,1,0,1,0
18997,61248,0,0,154,154,0,1,0,1,0
1364,22386,0,0,155,155,0,1,0,1,0
21372,3389,21372,3389,293,223,70,4,0,3,1
4104,25773,0,0,142,142,0,1,0,1,0
14862,25773,0,0,147,147,0,1,0,1,0
43581,5618,0,0,145,145,0,1,0,1,0
59621,4563,30279,1603,215,181,33,2,0,1,0
13470,10275,1700,630,174,161,13,1,0,1,0
1653,22201,0,0,157,157,0,1,0,1,0
1523,22635,0,0,154,154,0,1,0,1,0
42608,5618,0,0,145,145,0,1,0,1,0
15726,61248,0,0,149,149,0,1,0,1,0
23743,34021,0,0,62,62,0,1,0,1,0
49555,27237,0,0,140,140,0,1,0,1,0
28898,34021,0,0,62,62,0,1,0,1,0
21070,61248,0,0,157,157,0,1,0,1,0
13229,25773,0,0,143,143,0,1,0,1,0
3917,51202,0,0,142,142,0,1,0,1,0
17790,3389,17790,3389,293,223,70,4,0,3,1
37258,3389,37258,3389,293,223,70,4,1,3,1
59270,32686,0,0,62,62,0,1,0,1,0
36511,3389,36511,3389,293,223,70,4,1,3,1
17495,3389,17495,3389,293,223,70,4,0,3,1
19765,3389,19765,3389,293,223,70,4,0,3,1
53430,33851,0,0,62,62,0,1,0,1,0
24546,31077,0,0,92,92,0,1,0,1,0
57631,61019,0,0,129,129,0,1,0,1,0
4660,37260,0,0,150,150,0,1,0,1,0
12326,3389,12326,3389,293,223,70,4,1,3,1
51454,30534,0,0,75,75,0,1,0,1,0
49158,31615,0,0,146,146,0,1,0,1,0
6277,52849,0,0,144,144,0,1,0,1,0
4959,25041,0,0,135,135,0,1,0,1,0
39036,34021,0,0,101,101,0,1,0,1,0
11507,3389,11507,3389,293,223,70,4,1,3,1
25659,25773,0,0,146,146,0,1,0,1,0
9921,3389,9921,3389,293,223,70,4,1,3,1
12608,24525,0,0,147,147,0,1,0,1,0
20899,3389,20899,3389,293,223,70,4,0,3,1
49931,33323,0,0,121,121,0,1,0,1,0
12617,8916,3168,1174,198,173,24,2,0,1,0
14929,3389,14929,3389,293,223,70,4,0,3,1
14813,13233,0,0,147,147,0,1,0,1,0
11285,61248,0,0,142,142,0,1,0,1,0
58471,31652,0,0,66,66,0,1,0,1,0
21452,3389,21452,3389,293,223,70,4,0,3,1
8153,16543,0,0,152,152,0,1,0,1,0
50153,28579,0,0,124,124,0,1,0,1,0
8956,25148,0,0,149,149,0,1,0,1,0
52000,32307,0,0,62,62,0,1,0,1,0
12310,3389,12310,3389,293,223,70,4,1,3,1
12303,6627,6768,2091,237,194,43,2,0,2,0
54967,3389,54967,3389,293,223,70,4,0,3,1
49076,29749,0,0,149,149,0,1,0,1,0
28156,32980,0,0,72,72,0,1,0,1,0
39461,3389,39461,3389,293,223,70,4,0,3,1
10050,3389,10050,3389,293,223,70,4,1,3,1
20592,27552,0,0,125,125,0,1,0,1,0
35275,10203,0,0,146,146,0,1,0,1,0
36571,3389,36571,3389,293,223,70,4,0,3,1
10977,25318,0,0,141,141,0,1,0,1,0
12509,24321,0,0,139,139,0,1,0,1,0
14333,25773,0,0,140,140,0,1,0,1,0
11727,61248,0,0,143,143,0,1,0,1,0
49854,27907,0,0,132,132,0,1,0,1,0
23120,34021,0,0,62,62,0,1,0,1,0
14342,25773,0,0,140,140,0,1,0,1,0
50908,31652,0,0,84,84,0,1,0,1,0
16794,3389,16794,3389,293,223,70,4,0,3,1
53754,5618,0,0,145,145,0,1,0,1,0
22084,61212,0,0,158,158,0,1,0,1,0
48938,26595,0,0,155,155,0,1,0,1,0
12200,61248,0,0,139,139,0,1,0,1,0
14509,22963,0,0,110,110,0,1,0,1,0
11313,3389,11313,3389,293,223,70,4,1,3,1
13178,3389,13178,3389,293,223,70,4,0,3,1
15493,2314,7487,2313,219,171,47,3,0,2,0
22239,3389,22239,3389,293,223,70,4,0,3,1
37334,3389,37334,3389,293,223,70,4,1,3,1
51093,31845,0,0,78,78,0,1,0,1,0
51630,31347,0,0,66,66,0,1,0,1,0
6127,32382,0,0,153,153,0,1,0,1,0
56090,60892,0,0,120,120,0,1,0,1,0
12503,3389,12503,3389,293,223,70,4,0,3,1
18617,3389,18617,3389,293,223,70,4,0,3,1
51547,31861,0,0,69,69,0,1,0,1,0
50636,29316,0,0,99,99,0,1,0,1,0
49142,31256,0,0,146,146,0,1,0,1,0
19060,58891,0,0,156,156,0,1,0,1,0
16450,25411,0,0,144,144,0,1,0,1,0
2604,38553,0,0,144,144,0,1,0,1,0
14673,3389,14673,3389,293,223,70,4,0,3,1
29401,3529,0,0,95,95,0,1,0,1,0
46871,5618,0,0,145,145,0,1,0,1,0
11037,25339,0,0,140,140,0,1,0,1,0
44854,5618,0,0,145,145,0,1,0,1,0
20852,3389,20852,3389,293,223,70,4,0,3,1
6124,25773,0,0,150,150,0,1,0,1,0
13678,26903,0,0,128,128,0,1,0,1,0
51297,31652,0,0,71,71,0,1,0,1,0
22680,25773,0,0,145,145,0,1,0,1,0
51119,31815,0,0,77,77,0,1,0,1,0
16650,3389,16650,3389,293,223,70,4,0,3,1
16658,15556,0,0,98,98,0,1,0,1,0
6162,23642,0,0,148,148,0,1,0,1,0
50426,29565,0,0,102,102,0,1,0,1,0
19172,18931,0,0,69,69,0,1,0,1,0
49104,30390,0,0,148,148,0,1,0,1,0
9575,25773,0,0,150,150,0,1,0,1,0
52089,5618,0,0,145,145,0,1,0,1,0
50131,28831,0,0,112,112,0,1,0,1,0
4702,53485,0,0,142,142,0,1,0,1,0
50214,34021,0,0,120,120,0,1,0,1,0
7922,25773,0,0,140,140,0,1,0,1,0
49050,30493,0,0,150,150,0,1,0,1,0
12620,8921,3163,1172,198,173,24,2,0,1,0
49403,34021,0,0,140,140,0,1,0,1,0
33063,2881,0,0,105,105,0,1,0,1,0
49423,33724,0,0,136,136,0,1,0,1,0
35052,8313,0,0,139,139,0,1,0,1,0
50235,3389,50235,3389,293,223,70,4,0,3,1
34686,3478,0,0,114,114,0,1,0,1,0
49748,34021,0,0,131,131,0,1,0,1,0
9696,61248,0,0,141,141,0,1,0,1,0
11942,25773,0,0,140,140,0,1,0,1,0
49146,33575,0,0,146,146,0,1,0,1,0
63136,3623,57277,3032,277,214,62,3,0,2,0
26962,33065,0,0,71,71,0,1,0,1,0
18053,3389,18053,3389,293,223,70,4,0,3,1
31684,2374,0,0,97,97,0,1,0,1,0
49576,33644,0,0,132,132,0,1,0,1,0
3697,25773,0,0,142,142,0,1,0,1,0
20474,3389,20474,3389,293,223,70,4,0,3,1
17462,16911,0,0,79,79,0,1,0,1,0
25614,29569,0,0,108,108,0,1,0,1,0
18812,18661,0,0,66,66,0,1,0,1,0
29437,3389,29437,3389,293,223,70,4,0,3,1
29185,34021,0,0,62,62,0,1,0,1,0
41278,7485,0,0,147,147,0,1,0,1,0
51750,32528,0,0,68,68,0,1,0,1,0
61803,3980,47039,2490,253,202,51,3,0,2,0
51350,31805,0,0,71,71,0,1,0,1,0
50492,32520,0,0,99,99,0,1,0,1,0
6114,25773,0,0,150,150,0,1,0,1,0
16979,61248,0,0,148,148,0,1,0,1,0
19195,17744,0,0,66,66,0,1,0,1,0
63237,3596,58053,3073,279,215,63,3,0,2,0
2366,41848,0,0,144,144,0,1,0,1,0
39165,7823,0,0,146,146,0,1,0,1,0
37244,3389,37244,3389,293,223,70,4,1,3,1
47368,46309,0,0,102,102,0,1,0,1,0
50359,31652,0,0,103,103,0,1,0,1,0
18013,3389,18013,3389,293,223,70,4,0,3,1
51643,31652,0,0,64,64,0,1,0,1,0
20672,61248,0,0,157,157,0,1,0,1,0
15473,3389,15473,3389,293,223,70,4,0,3,1
38449,9007,0,0,146,146,0,1,0,1,0
10093,3389,10093,3389,293,223,70,4,1,3,1
38928,6745,0,0,146,146,0,1,0,1,0
27745,26562,0,0,139,139,0,1,0,1,0
29411,34021,0,0,62,62,0,1,0,1,0
50089,31652,0,0,113,113,0,1,0,1,0
20406,19856,0,0,80,80,0,1,0,1,0
11151,3389,11151,3389,293,223,70,4,1,3,1
28250,25732,0,0,147,147,0,1,0,1,0
53527,5618,0,0,145,145,0,1,0,1,0
8170,61248,0,0,139,139,0,1,0,1,0
14041,25773,0,0,140,140,0,1,0,1,0
19142,3389,19142,3389,293,223,70,4,0,3,1
51565,31844,0,0,68,68,0,1,0,1,0
13764,16291,0,0,145,145,0,1,0,1,0
50988,31652,0,0,87,87,0,1,0,1,0
28190,31330,0,0,90,90,0,1,0,1,0
20498,30378,0,0,97,97,0,1,0,1,0
9854,3389,9854,3389,293,223,70,4,0,3,1
29451,3389,29451,3389,293,223,70,4,0,3,1
37103,3389,37103,3389,293,223,70,4,1,3,1
2220,23726,0,0,150,150,0,1,0,1,0
3755,23363,0,0,157,157,0,1,0,1,0
50900,29856,0,0,91,91,0,1,0,1,0
12927,25773,0,0,139,139,0,1,0,1,0
21406,3389,21406,3389,293,223,70,4,0,3,1
28243,28746,0,0,116,116,0,1,0,1,0
6397,25773,0,0,151,151,0,1,0,1,0
12337,6708,6662,2058,236,193,42,2,0,2,0
23513,3389,23513,3389,293,223,70,4,0,3,1
15939,17640,0,0,145,145,0,1,0,1,0
50471,32544,0,0,99,99,0,1,0,1,0
22887,630,2341,629,104,91,13,1,0,1,0
30823,2057,0,0,92,92,0,1,0,1,0
1248,22204,0,0,155,155,0,1,0,1,0
28855,34021,0,0,62,62,0,1,0,1,0
50653,29701,0,0,111,111,0,1,0,1,0
14183,3389,14183,3389,293,223,70,4,0,3,1
28690,34021,0,0,62,62,0,1,0,1,0
17299,61248,0,0,151,151,0,1,0,1,0
8089,61248,0,0,139,139,0,1,0,1,0
9815,3389,9815,3389,293,223,70,4,1,3,1
49334,31652,0,0,140,140,0,1,0,1,0
26876,3389,26876,3389,293,223,70,4,0,3,1
15221,3389,15221,3389,293,223,70,4,0,3,1
12187,61248,0,0,139,139,0,1,0,1,0
27982,26228,0,0,143,143,0,1,0,1,0
20869,61248,0,0,157,157,0,1,0,1,0
9584,25773,0,0,154,154,0,1,0,1,0
17006,3389,17006,3389,293,223,70,4,0,3,1
42261,60214,0,0,76,76,0,1,0,1,0
27871,2233,0,0,82,82,0,1,0,1,0
17033,18865,0,0,68,68,0,1,0,1,0
52292,33173,0,0,62,62,0,1,0,1,0
19743,61248,0,0,155,155,0,1,0,1,0
7119,25222,0,0,157,157,0,1,0,1,0
60381,31652,0,0,65,65,0,1,0,1,0
46657,56384,0,0,62,62,0,1,0,1,0
14838,12487,0,0,139,139,0,1,0,1,0
45051,5618,0,0,145,145,0,1,0,1,0
9213,3389,9213,3389,293,223,70,4,1,3,1
57322,3389,57322,3389,293,223,70,4,0,3,1
11802,3190,10324,3190,279,213,65,3,0,2,0
15786,14085,0,0,117,117,0,1,0,1,0
49160,33926,0,0,146,146,0,1,0,1,0
20920,32772,0,0,73,73,0,1,0,1,0
22227,714,2310,714,110,95,14,1,0,1,0
7583,61248,0,0,139,139,0,1,0,1,0
4084,51688,0,0,142,142,0,1,0,1,0
48063,40618,0,0,119,119,0,1,0,1,0
50346,31652,0,0,107,107,0,1,0,1,0
51369,31652,0,0,69,69,0,1,0,1,0
9927,61248,0,0,141,141,0,1,0,1,0
24405,34021,0,0,62,62,0,1,0,1,0
21525,3389,21525,3389,293,223,70,4,0,3,1
40238,34021,0,0,106,106,0,1,0,1,0
46302,3389,46302,3389,293,223,70,4,0,3,1
16894,15953,0,0,92,92,0,1,0,1,0
7985,25773,0,0,156,156,0,1,0,1,0
27333,25045,0,0,139,139,0,1,0,1,0
14169,25773,0,0,140,140,0,1,0,1,0
4689,23879,0,0,157,157,0,1,0,1,0
21954,61248,0,0,158,158,0,1,0,1,0
49036,28827,0,0,151,151,0,1,0,1,0
11929,25773,0,0,151,151,0,1,0,1,0
33288,3389,33288,3389,293,223,70,4,0,3,1
51138,31794,0,0,76,76,0,1,0,1,0
51387,30850,0,0,74,74,0,1,0,1,0
7869,25636,0,0,157,157,0,1,0,1,0
37507,7764,0,0,146,146,0,1,0,1,0
20961,3389,20961,3389,293,223,70,4,0,3,1
16553,3389,16553,3389,293,223,70,4,0,3,1
13998,3389,13998,3389,293,223,70,4,0,3,1
45841,58797,0,0,65,65,0,1,0,1,0
28770,34021,0,0,62,62,0,1,0,1,0
13181,61248,0,0,146,146,0,1,0,1,0
10144,58019,0,0,140,140,0,1,0,1,0
13368,3389,13368,3389,293,223,70,4,0,3,1
58081,3389,58081,3389,293,223,70,4,0,3,1
17167,61248,0,0,151,151,0,1,0,1,0
10851,61248,0,0,139,139,0,1,0,1,0
13780,3389,13780,3389,293,223,70,4,0,3,1
17376,3389,17376,3389,293,223,70,4,0,3,1
51526,33292,0,0,87,87,0,1,0,1,0
50207,5618,0,0,145,145,0,1,0,1,0
56879,60957,0,0,125,125,0,1,0,1,0
11584,4884,9027,2789,267,209,57,3,0,2,0
4544,25253,0,0,137,137,0,1,0,1,0
9981,25773,0,0,148,148,0,1,0,1,0
51449,31652,0,0,72,72,0,1,0,1,0
10826,61248,0,0,142,142,0,1,0,1,0
18922,27454,0,0,126,126,0,1,0,1,0
53885,5618,0,0,145,145,0,1,0,1,0
49782,33320,0,0,124,124,0,1,0,1,0
11413,61248,0,0,142,142,0,1,0,1,0
37937,3389,37937,3389,293,223,70,4,0,3,1
49824,33273,0,0,122,122,0,1,0,1,0
28871,28611,0,0,118,118,0,1,0,1,0
16821,15831,0,0,94,94,0,1,0,1,0
11035,25773,0,0,144,144,0,1,0,1,0
8788,61248,0,0,139,139,0,1,0,1,0
18145,21660,0,0,98,98,0,1,0,1,0
12654,23396,0,0,140,140,0,1,0,1,0
26664,3389,26664,3389,293,223,70,4,0,3,1
17142,22348,0,0,144,144,0,1,0,1,0
11044,60794,0,0,143,143,0,1,0,1,0
53342,37009,0,0,77,77,0,1,0,1,0
16242,14853,0,0,107,107,0,1,0,1,0
19003,3389,19003,3389,293,223,70,4,0,3,1
13448,3389,13448,3389,293,223,70,4,0,3,1
10058,61248,0,0,141,141,0,1,0,1,0
28175,32044,0,0,82,82,0,1,0,1,0
8055,25975,0,0,156,156,0,1,0,1,0
25773,29345,0,0,110,110,0,1,0,1,0
51080,30659,0,0,100,100,0,1,0,1,0
20609,30585,0,0,95,95,0,1,0,1,0
47561,3389,47561,3389,293,223,70,4,0,3,1
13967,3389,13967,3389,293,223,70,4,0,3,1
4641,25773,0,0,146,146,0,1,0,1,0
10949,3389,10949,3389,293,223,70,4,1,3,1
40577,5618,0,0,145,145,0,1,0,1,0
52048,5618,0,0,145,145,0,1,0,1,0
19567,19227,0,0,73,73,0,1,0,1,0
37759,3389,37759,3389,293,223,70,4,1,3,1
9571,3389,9571,3389,293,223,70,4,1,3,1
18148,21569,0,0,97,97,0,1,0,1,0
59321,31652,0,0,65,65,0,1,0,1,0
13187,3389,13187,3389,293,223,70,4,0,3,1
10385,3389,10385,3389,293,223,70,4,1,3,1
21144,31577,0,0,86,86,0,1,0,1,0
52461,33759,0,0,65,65,0,1,0,1,0
21093,3389,21093,3389,293,223,70,4,0,3,1
61934,3945,48044,2543,256,203,52,3,0,2,0
14345,26846,0,0,128,128,0,1,0,1,0
2629,24366,0,0,148,148,0,1,0,1,0
22207,3389,22207,3389,293,223,70,4,0,3,1
13812,25773,0,0,140,140,0,1,0,1,0
49110,32431,0,0,148,148,0,1,0,1,0
11191,25392,0,0,140,140,0,1,0,1,0
20427,30246,0,0,99,99,0,1,0,1,0
9667,3389,9667,3389,293,223,70,4,0,3,1
19537,19205,0,0,73,73,0,1,0,1,0
51789,28555,0,0,80,80,0,1,0,1,0
28994,34021,0,0,62,62,0,1,0,1,0
18640,26929,0,0,131,131,0,1,0,1,0
55595,6105,0,0,143,143,0,1,0,1,0
22317,25773,0,0,145,145,0,1,0,1,0
8574,61248,0,0,139,139,0,1,0,1,0
13400,25773,0,0,139,139,0,1,0,1,0
2738,22801,0,0,157,157,0,1,0,1,0
15126,14462,0,0,147,147,0,1,0,1,0
49141,31218,0,0,146,146,0,1,0,1,0
48645,3389,48645,3389,293,223,70,4,0,3,1
17978,17781,0,0,68,68,0,1,0,1,0
49160,31679,0,0,146,146,0,1,0,1,0
10717,3389,10717,3389,293,223,70,4,0,3,1
17895,25745,0,0,143,143,0,1,0,1,0
23153,34021,0,0,62,62,0,1,0,1,0
50454,34021,0,0,114,114,0,1,0,1,0
8447,25773,0,0,156,156,0,1,0,1,0
19156,3389,19156,3389,293,223,70,4,0,3,1
51682,32404,0,0,68,68,0,1,0,1,0
28274,27233,0,0,132,132,0,1,0,1,0
55107,42802,0,0,88,88,0,1,0,1,0
51542,32151,0,0,69,69,0,1,0,1,0
51985,32359,0,0,63,63,0,1,0,1,0
20686,61248,0,0,157,157,0,1,0,1,0
17183,61248,0,0,152,152,0,1,0,1,0
52497,34021,0,0,63,63,0,1,0,1,0
21600,3389,21600,3389,293,223,70,4,0,3,1
31151,19415,0,0,147,147,0,1,0,1,0
22704,34021,0,0,62,62,0,1,0,1,0
49858,32136,0,0,128,128,0,1,0,1,0
49625,27395,0,0,138,138,0,1,0,1,0
13197,25773,0,0,143,143,0,1,0,1,0
52306,33530,0,0,64,64,0,1,0,1,0
35675,34021,0,0,87,87,0,1,0,1,0
19878,61248,0,0,154,154,0,1,0,1,0
35838,8962,0,0,146,146,0,1,0,1,0
46532,5618,0,0,145,145,0,1,0,1,0
35467,8664,0,0,143,143,0,1,0,1,0
16634,15515,0,0,98,98,0,1,0,1,0
49283,31652,0,0,145,145,0,1,0,1,0
49160,33420,0,0,146,146,0,1,0,1,0
26259,24240,0,0,130,130,0,1,0,1,0
9328,3389,9328,3389,293,223,70,4,1,3,1
60378,61244,0,0,144,144,0,1,0,1,0
17618,25773,0,0,142,142,0,1,0,1,0
51724,31652,0,0,63,63,0,1,0,1,0
51630,31348,0,0,66,66,0,1,0,1,0
58157,31652,0,0,62,62,0,1,0,1,0
13450,25773,0,0,139,139,0,1,0,1,0
15620,3389,15620,3389,293,223,70,4,0,3,1
21972,3389,21972,3389,293,223,70,4,0,3,1
42666,5618,0,0,145,145,0,1,0,1,0
18232,25949,0,0,141,141,0,1,0,1,0
38218,3389,38218,3389,293,223,70,4,1,3,1
11277,3389,11277,3389,293,223,70,4,1,3,1
9352,61248,0,0,139,139,0,1,0,1,0
24264,22746,0,0,113,113,0,1,0,1,0
15406,28304,0,0,115,115,0,1,0,1,0
3112,31528,0,0,143,143,0,1,0,1,0
20321,3389,20321,3389,293,223,70,4,0,3,1
44498,5618,0,0,145,145,0,1,0,1,0
63733,3389,63733,3389,293,223,70,4,0,3,1
12232,3389,12232,3389,293,223,70,4,1,3,1
29345,3389,29345,3389,293,223,70,4,0,3,1
7231,25773,0,0,154,154,0,1,0,1,0
62252,3389,62252,3389,293,223,70,4,0,3,1
26847,24680,0,0,135,135,0,1,0,1,0
45871,5618,0,0,145,145,0,1,0,1,0
18761,3389,18761,3389,293,223,70,4,0,3,1
16874,29493,0,0,104,104,0,1,0,1,0
24685,604,0,0,66,66,0,1,0,1,0
19736,19354,0,0,74,74,0,1,0,1,0
52562,33993,0,0,62,62,0,1,0,1,0
21190,61248,0,0,157,157,0,1,0,1,0
49588,27479,0,0,132,132,0,1,0,1,0
50326,31652,0,0,108,108,0,1,0,1,0
34642,9595,0,0,140,140,0,1,0,1,0
36775,3389,36775,3389,293,223,70,4,1,3,1
49835,34021,0,0,129,129,0,1,0,1,0
59848,59292,0,0,139,139,0,1,0,1,0
9555,57130,0,0,140,140,0,1,0,1,0
2738,36709,0,0,144,144,0,1,0,1,0
17565,19108,0,0,70,70,0,1,0,1,0
39409,6400,0,0,146,146,0,1,0,1,0
50698,34021,0,0,108,108,0,1,0,1,0
57874,52413,0,0,118,118,0,1,0,1,0
54987,31652,0,0,114,114,0,1,0,1,0
26262,34021,0,0,62,62,0,1,0,1,0
27189,33250,0,0,69,69,0,1,0,1,0
21410,3389,21410,3389,293,223,70,4,0,3,1
40411,8196,0,0,145,145,0,1,0,1,0
18740,3389,18740,3389,293,223,70,4,0,3,1
28543,34021,0,0,62,62,0,1,0,1,0
4753,50310,0,0,144,144,0,1,0,1,0
51023,30107,0,0,86,86,0,1,0,1,0
13600,3389,13600,3389,293,223,70,4,0,3,1
51068,31873,0,0,78,78,0,1,0,1,0
10130,25773,0,0,139,139,0,1,0,1,0
9707,25773,0,0,154,154,0,1,0,1,0
10151,3389,10151,3389,293,223,70,4,1,3,1
52178,33124,0,0,72,72,0,1,0,1,0
51377,30831,0,0,75,75,0,1,0,1,0
11567,61248,0,0,141,141,0,1,0,1,0
11672,61248,0,0,141,141,0,1,0,1,0
1373,22400,0,0,155,155,0,1,0,1,0
17104,16308,0,0,88,88,0,1,0,1,0
58213,53589,0,0,121,121,0,1,0,1,0
52425,33915,0,0,65,65,0,1,0,1,0
9584,3389,9584,3389,293,223,70,4,0,3,1
27827,60955,0,0,135,135,0,1,0,1,0
51685,31652,0,0,63,63,0,1,0,1,0
5790,56649,0,0,140,140,0,1,0,1,0
25979,29054,0,0,113,113,0,1,0,1,0
51843,33511,0,0,80,80,0,1,0,1,0
50941,30847,0,0,83,83,0,1,0,1,0
50937,19720,0,0,153,153,0,1,0,1,0
5035,25773,0,0,147,147,0,1,0,1,0
21642,25773,0,0,144,144,0,1,0,1,0
27657,25287,0,0,142,142,0,1,0,1,0
37108,8051,0,0,146,146,0,1,0,1,0
12301,3389,12301,3389,293,223,70,4,1,3,1
47211,5618,0,0,145,145,0,1,0,1,0
16190,18626,0,0,145,145,0,1,0,1,0
49089,30030,0,0,149,149,0,1,0,1,0
51655,17583,0,0,152,152,0,1,0,1,0
3907,22857,0,0,152,152,0,1,0,1,0
51858,31887,0,0,62,62,0,1,0,1,0
9641,3389,9641,3389,293,223,70,4,1,3,1
28258,28009,0,0,124,124,0,1,0,1,0
11057,6434,5852,2168,240,196,44,2,0,2,0
17801,3389,17801,3389,293,223,70,4,0,3,1
16047,19880,0,0,82,82,0,1,0,1,0
10450,3389,10450,3389,293,223,70,4,1,3,1
49066,29517,0,0,149,149,0,1,0,1,0
15510,3389,15510,3389,293,223,70,4,0,3,1
51238,31652,0,0,72,72,0,1,0,1,0
17985,3389,17985,3389,293,223,70,4,0,3,1
49077,3389,49077,3389,293,223,70,4,0,3,1
21365,3389,21365,3389,293,223,70,4,0,3,1
22084,3389,22084,3389,293,223,70,4,0,3,1
21076,31451,0,0,87,87,0,1,0,1,0
20716,3389,20716,3389,293,223,70,4,0,3,1
11095,3389,11095,3389,293,223,70,4,1,3,1
15820,3389,15820,3389,293,223,70,4,0,3,1
47762,5618,0,0,145,145,0,1,0,1,0
29340,30960,0,0,93,93,0,1,0,1,0
60642,32413,0,0,62,62,0,1,0,1,0
51366,31652,0,0,70,70,0,1,0,1,0
50467,32549,0,0,100,100,0,1,0,1,0
48909,25926,0,0,156,156,0,1,0,1,0
52231,32994,0,0,62,62,0,1,0,1,0
14617,55008,0,0,121,121,0,1,0,1,0
27593,33579,0,0,66,66,0,1,0,1,0
2715,24499,0,0,147,147,0,1,0,1,0
63203,40860,0,0,87,87,0,1,0,1,0
17068,16246,0,0,88,88,0,1,0,1,0
1734,22965,0,0,153,153,0,1,0,1,0
3213,47744,0,0,144,144,0,1,0,1,0
2356,23938,0,0,149,149,0,1,0,1,0
51993,32289,0,0,62,62,0,1,0,1,0
30619,3389,30619,3389,293,223,70,4,0,3,1
51330,31770,0,0,71,71,0,1,0,1,0
13024,3389,13024,3389,293,223,70,4,0,3,1
12735,22878,0,0,140,140,0,1,0,1,0
4253,49132,0,0,143,143,0,1,0,1,0
18151,21463,0,0,96,96,0,1,0,1,0
27871,26385,0,0,141,141,0,1,0,1,0
61117,4163,41770,2211,241,195,45,2,0,2,0
54682,8578,0,0,146,146,0,1,0,1,0
51367,31303,0,0,93,93,0,1,0,1,0
51690,31732,0,0,64,64,0,1,0,1,0
36409,60514,0,0,100,100,0,1,0,1,0
40279,5775,0,0,146,146,0,1,0,1,0
20471,3389,20471,3389,293,223,70,4,0,3,1
13285,3389,13285,3389,293,223,70,4,0,3,1
4109,51760,0,0,142,142,0,1,0,1,0
62030,32028,0,0,75,75,0,1,0,1,0
2841,24696,0,0,146,146,0,1,0,1,0
21769,3389,21769,3389,293,223,70,4,0,3,1
8703,25773,0,0,156,156,0,1,0,1,0
52267,33460,0,0,64,64,0,1,0,1,0
17595,3389,17595,3389,293,223,70,4,0,3,1
27562,3389,27562,3389,293,223,70,4,0,3,1
50699,30244,0,0,92,92,0,1,0,1,0
10776,61248,0,0,139,139,0,1,0,1,0
53842,5618,0,0,145,145,0,1,0,1,0
28298,26087,0,0,144,144,0,1,0,1,0
12194,61248,0,0,139,139,0,1,0,1,0
50932,19735,0,0,153,153,0,1,0,1,0
50775,30433,0,0,89,89,0,1,0,1,0
56197,51039,0,0,145,145,0,1,0,1,0
49037,28845,0,0,151,151,0,1,0,1,0
49667,31652,0,0,128,128,0,1,0,1,0
20918,3389,20918,3389,293,223,70,4,0,3,1
22896,25773,0,0,145,145,0,1,0,1,0
2812,35679,0,0,143,143,0,1,0,1,0
17288,19457,0,0,74,74,0,1,0,1,0
21339,3389,21339,3389,293,223,70,4,0,3,1
38323,3389,38323,3389,293,223,70,4,0,3,1
8164,61248,0,0,139,139,0,1,0,1,0
20370,27399,0,0,127,127,0,1,0,1,0
11017,25773,0,0,144,144,0,1,0,1,0
17999,3389,17999,3389,293,223,70,4,0,3,1
45650,7311,0,0,145,145,0,1,0,1,0
20257,61248,0,0,156,156,0,1,0,1,0
2564,46585,0,0,144,144,0,1,0,1,0
49566,27261,0,0,139,139,0,1,0,1,0
8033,24293,0,0,145,145,0,1,0,1,0
16333,3389,16333,3389,293,223,70,4,0,3,1
50121,31652,0,0,115,115,0,1,0,1,0
40301,5760,0,0,146,146,0,1,0,1,0
11084,3389,11084,3389,293,223,70,4,0,3,1
34594,3389,34594,3389,293,223,70,4,0,3,1
16040,14514,0,0,112,112,0,1,0,1,0
29564,34021,0,0,62,62,0,1,0,1,0
13142,25773,0,0,149,149,0,1,0,1,0
28801,28262,0,0,122,122,0,1,0,1,0
6092,57528,0,0,140,140,0,1,0,1,0
7938,61248,0,0,139,139,0,1,0,1,0
25604,3389,25604,3389,293,223,70,4,0,3,1
49755,27686,0,0,134,134,0,1,0,1,0
8266,61248,0,0,139,139,0,1,0,1,0
9543,3389,9543,3389,293,223,70,4,1,3,1
11665,3389,11665,3389,293,223,70,4,1,3,1
28175,32047,0,0,82,82,0,1,0,1,0
2912,47109,0,0,144,144,0,1,0,1,0
49757,6617,0,0,145,145,0,1,0,1,0
49973,33105,0,0,117,117,0,1,0,1,0
50694,29434,0,0,97,97,0,1,0,1,0
12376,3389,12376,3389,293,223,70,4,1,3,1
6103,25773,0,0,150,150,0,1,0,1,0
19613,3389,19613,3389,293,223,70,4,0,3,1
18099,61248,0,0,153,153,0,1,0,1,0
16913,25773,0,0,142,142,0,1,0,1,0
38968,60383,0,0,89,89,0,1,0,1,0
7635,61248,0,0,139,139,0,1,0,1,0
49381,33771,0,0,138,138,0,1,0,1,0
25292,34021,0,0,62,62,0,1,0,1,0
29769,22501,0,0,147,147,0,1,0,1,0
12679,3389,12679,3389,293,223,70,4,0,3,1
51460,31652,0,0,68,68,0,1,0,1,0
8822,57091,0,0,143,143,0,1,0,1,0
8503,25773,0,0,140,140,0,1,0,1,0
51266,33111,0,0,94,94,0,1,0,1,0
52365,41771,0,0,145,145,0,1,0,1,0
12332,25773,0,0,139,139,0,1,0,1,0
51894,31994,0,0,62,62,0,1,0,1,0
26125,34021,0,0,62,62,0,1,0,1,0
10218,61248,0,0,139,139,0,1,0,1,0
20903,3389,20903,3389,293,223,70,4,0,3,1
29622,3716,0,0,96,96,0,1,0,1,0
15558,2298,7437,2298,218,171,47,3,0,2,0
10925,3389,10925,3389,293,223,70,4,1,3,1
57453,31652,0,0,100,100,0,1,0,1,0
15226,25773,0,0,146,146,0,1,0,1,0
32709,6329,0,0,121,121,0,1,0,1,0
49889,34021,0,0,128,128,0,1,0,1,0
26527,34021,0,0,62,62,0,1,0,1,0
18179,20564,0,0,86,86,0,1,0,1,0
60212,32309,0,0,85,85,0,1,0,1,0
5411,34765,0,0,151,151,0,1,0,1,0
15367,25773,0,0,146,146,0,1,0,1,0
5823,25773,0,0,141,141,0,1,0,1,0
17578,8418,0,0,123,123,0,1,0,1,0
7633,60776,0,0,137,137,0,1,0,1,0
52683,25610,0,0,81,81,0,1,0,1,0
11404,3389,11404,3389,293,223,70,4,0,3,1
7543,61248,0,0,139,139,0,1,0,1,0
51223,6370,0,0,145,145,0,1,0,1,0
37563,3389,37563,3389,293,223,70,4,1,3,1
17662,3389,17662,3389,293,223,70,4,0,3,1
31734,3389,31734,3389,293,223,70,4,0,3,1
31616,3389,31616,3389,293,223,70,4,0,3,1
19977,3389,19977,3389,293,223,70,4,0,3,1
13032,20976,0,0,142,142,0,1,0,1,0
21645,3389,21645,3389,293,223,70,4,0,3,1
13181,3389,13181,3389,293,223,70,4,0,3,1
53175,3389,53175,3389,293,223,70,4,0,3,1
2719,43713,0,0,146,146,0,1,0,1,0
8536,24468,0,0,144,144,0,1,0,1,0
49124,31942,0,0,145,145,0,1,0,1,0
13647,25773,0,0,139,139,0,1,0,1,0
18484,61248,0,0,154,154,0,1,0,1,0
12883,3389,12883,3389,293,223,70,4,0,3,1
56633,3389,56633,3389,293,223,70,4,0,3,1
8909,61248,0,0,139,139,0,1,0,1,0
22890,34021,0,0,62,62,0,1,0,1,0
26467,24396,0,0,132,132,0,1,0,1,0
17969,25773,0,0,142,142,0,1,0,1,0
10078,24315,0,0,138,138,0,1,0,1,0
12619,25773,0,0,143,143,0,1,0,1,0
40105,5900,0,0,146,146,0,1,0,1,0
22429,3389,22429,3389,293,223,70,4,0,3,1
51933,32109,0,0,62,62,0,1,0,1,0
19560,3389,19560,3389,293,223,70,4,0,3,1
62261,3857,50555,2676,261,206,55,3,0,2,0
7155,60619,0,0,139,139,0,1,0,1,0
7219,25773,0,0,154,154,0,1,0,1,0
14786,54555,0,0,120,120,0,1,0,1,0
49160,32126,0,0,146,146,0,1,0,1,0
50022,31652,0,0,115,115,0,1,0,1,0
8581,23188,0,0,115,115,0,1,0,1,0
11598,25773,0,0,143,143,0,1,0,1,0
49144,33511,0,0,146,146,0,1,0,1,0
27196,1662,0,0,77,77,0,1,0,1,0
12191,6355,7120,2200,242,196,45,2,0,2,0
49059,29348,0,0,150,150,0,1,0,1,0
27199,3389,27199,3389,293,223,70,4,0,3,1
19521,3389,19521,3389,293,223,70,4,0,3,1
16160,14716,0,0,109,109,0,1,0,1,0
17123,48301,0,0,102,102,0,1,0,1,0
15693,61248,0,0,145,145,0,1,0,1,0
17586,25773,0,0,142,142,0,1,0,1,0
13551,21734,0,0,106,106,0,1,0,1,0
11623,3389,11623,3389,293,223,70,4,0,3,1
18632,3389,18632,3389,293,223,70,4,0,3,1
51140,33024,0,0,97,97,0,1,0,1,0
13562,10421,1542,571,172,160,11,1,0,1,0
53567,3389,53567,3389,293,223,70,4,0,3,1
56695,31652,0,0,67,67,0,1,0,1,0
16308,3389,16308,3389,293,223,70,4,0,3,1
6634,17675,0,0,153,153,0,1,0,1,0
41932,9053,0,0,147,147,0,1,0,1,0
34863,11123,0,0,146,146,0,1,0,1,0
54860,3389,54860,3389,293,223,70,4,0,3,1
9399,61248,0,0,141,141,0,1,0,1,0
15533,3389,15533,3389,293,223,70,4,0,3,1
18052,61248,0,0,152,152,0,1,0,1,0
29235,30437,0,0,99,99,0,1,0,1,0
12877,25022,0,0,131,131,0,1,0,1,0
26425,34021,0,0,62,62,0,1,0,1,0
48997,27934,0,0,152,152,0,1,0,1,0
45928,58090,0,0,67,67,0,1,0,1,0
13750,21586,0,0,104,104,0,1,0,1,0
28276,27150,0,0,133,133,0,1,0,1,0
60455,31652,0,0,62,62,0,1,0,1,0
48907,25783,0,0,156,156,0,1,0,1,0
10877,25773,0,0,145,145,0,1,0,1,0
51028,30118,0,0,86,86,0,1,0,1,0
10449,3389,10449,3389,293,223,70,4,0,3,1
28136,34021,0,0,62,62,0,1,0,1,0
51912,60549,0,0,97,97,0,1,0,1,0
18518,18101,0,0,63,63,0,1,0,1,0
17314,16661,0,0,83,83,0,1,0,1,0
10338,61248,0,0,139,139,0,1,0,1,0
3608,23282,0,0,157,157,0,1,0,1,0
39916,6036,0,0,146,146,0,1,0,1,0
27293,3389,27293,3389,293,223,70,4,0,3,1
13219,3389,13219,3389,293,223,70,4,0,3,1
38156,3389,38156,3389,293,223,70,4,1,3,1
29461,31565,0,0,87,87,0,1,0,1,0
33396,6911,0,0,126,126,0,1,0,1,0
7645,24158,0,0,146,146,0,1,0,1,0
51337,38708,0,0,62,62,0,1,0,1,0
54045,16516,0,0,110,110,0,1,0,1,0
10567,61248,0,0,139,139,0,1,0,1,0
49117,30673,0,0,147,147,0,1,0,1,0
9453,61248,0,0,141,141,0,1,0,1,0
52651,60609,0,0,101,101,0,1,0,1,0
12926,61248,0,0,145,145,0,1,0,1,0
20092,1380,5130,1379,156,127,28,2,0,1,0
16660,3389,16660,3389,293,223,70,4,0,3,1
14959,3389,14959,3389,293,223,70,4,0,3,1
62386,32065,0,0,62,62,0,1,0,1,0
16122,3389,16122,3389,293,223,70,4,0,3,1
9514,3389,9514,3389,293,223,70,4,1,3,1
12712,3389,12712,3389,293,223,70,4,0,3,1
17397,3389,17397,3389,293,223,70,4,0,3,1
52005,32988,0,0,66,66,0,1,0,1,0
28201,30812,0,0,95,95,0,1,0,1,0
52322,33261,0,0,62,62,0,1,0,1,0
55782,5589,805,42,146,145,0,1,0,1,0
23465,3389,23465,3389,293,223,70,4,0,3,1
20249,3389,20249,3389,293,223,70,4,0,3,1
13783,3389,13783,3389,293,223,70,4,0,3,1
20516,61248,0,0,156,156,0,1,0,1,0
15153,2705,10059,2704,246,190,55,3,0,2,0
15695,3389,15695,3389,293,223,70,4,0,3,1
57238,50203,0,0,111,111,0,1,0,1,0
28940,34021,0,0,62,62,0,1,0,1,0
51786,33472,0,0,81,81,0,1,0,1,0
22989,61203,0,0,155,155,0,1,0,1,0
51894,31995,0,0,62,62,0,1,0,1,0
43533,7668,0,0,145,145,0,1,0,1,0
30993,4877,0,0,107,107,0,1,0,1,0
23360,445,1440,445,92,83,9,1,0,1,0
7794,25773,0,0,156,156,0,1,0,1,0
46524,60106,0,0,66,66,0,1,0,1,0
19721,25773,0,0,143,143,0,1,0,1,0
20387,3389,20387,3389,293,223,70,4,0,3,1
29313,30824,0,0,95,95,0,1,0,1,0
11705,61248,0,0,141,141,0,1,0,1,0
27894,26352,0,0,141,141,0,1,0,1,0
49601,27510,0,0,131,131,0,1,0,1,0
50084,32980,0,0,113,113,0,1,0,1,0
2858,48122,0,0,144,144,0,1,0,1,0
28263,34021,0,0,62,62,0,1,0,1,0
27079,34021,0,0,62,62,0,1,0,1,0
13615,24757,0,0,146,146,0,1,0,1,0
20844,3389,20844,3389,293,223,70,4,0,3,1
13367,3389,13367,3389,293,223,70,4,0,3,1
11248,3389,11248,3389,293,223,70,4,1,3,1
55125,60813,0,0,115,115,0,1,0,1,0
28193,31159,0,0,91,91,0,1,0,1,0
20692,3389,20692,3389,293,223,70,4,0,3,1
37203,3389,37203,3389,293,223,70,4,1,3,1
29834,33437,0,0,68,68,0,1,0,1,0
2283,42999,0,0,144,144,0,1,0,1,0
1219,22160,0,0,155,155,0,1,0,1,0
12241,25773,0,0,139,139,0,1,0,1,0
10186,3389,10186,3389,293,223,70,4,1,3,1
9991,57788,0,0,140,140,0,1,0,1,0
14356,3389,14356,3389,293,223,70,4,0,3,1
52734,14373,0,0,150,150,0,1,0,1,0
51759,3389,51759,3389,293,223,70,4,0,3,1
51644,34021,0,0,84,84,0,1,0,1,0
49924,27860,0,0,123,123,0,1,0,1,0
9657,57284,0,0,140,140,0,1,0,1,0
9739,61248,0,0,141,141,0,1,0,1,0
28727,34021,0,0,62,62,0,1,0,1,0
8366,61248,0,0,140,140,0,1,0,1,0
9757,58648,0,0,143,143,0,1,0,1,0
12825,25088,0,0,131,131,0,1,0,1,0
20152,27513,0,0,125,125,0,1,0,1,0
42900,5618,0,0,145,145,0,1,0,1,0
32446,34021,0,0,72,72,0,1,0,1,0
24960,301,0,0,64,64,0,1,0,1,0
28466,1190,0,0,79,79,0,1,0,1,0
6319,58187,0,0,140,140,0,1,0,1,0
7291,61013,0,0,139,139,0,1,0,1,0
49576,31652,0,0,131,131,0,1,0,1,0
5173,54854,0,0,141,141,0,1,0,1,0
29669,34021,0,0,62,62,0,1,0,1,0
15692,28536,0,0,113,113,0,1,0,1,0
16703,20632,0,0,144,144,0,1,0,1,0
54452,5618,0,0,145,145,0,1,0,1,0
20801,3389,20801,3389,293,223,70,4,0,3,1
11536,61248,0,0,142,142,0,1,0,1,0
9977,59016,0,0,143,143,0,1,0,1,0
19276,3389,19276,3389,293,223,70,4,0,3,1
3591,40815,0,0,148,148,0,1,0,1,0
23433,34021,0,0,62,62,0,1,0,1,0
12593,7329,5858,1810,225,188,37,2,0,2,0
12710,3389,12710,3389,293,223,70,4,0,3,1
55649,3389,55649,3389,293,223,70,4,0,3,1
50851,31652,0,0,86,86,0,1,0,1,0
29347,34021,0,0,62,62,0,1,0,1,0
56988,49496,0,0,112,112,0,1,0,1,0
29884,33686,0,0,65,65,0,1,0,1,0
3494,26251,0,0,143,143,0,1,0,1,0
37520,3389,37520,3389,293,223,70,4,0,3,1
18216,19382,0,0,74,74,0,1,0,1,0
15775,10400,0,0,137,137,0,1,0,1,0
26217,25773,0,0,146,146,0,1,0,1,0
15918,3389,15918,3389,293,223,70,4,0,3,1
55021,60804,0,0,114,114,0,1,0,1,0
37386,7851,0,0,146,146,0,1,0,1,0
18542,3389,18542,3389,293,223,70,4,0,3,1
24024,3389,24024,3389,293,223,70,4,0,3,1
51756,31672,0,0,62,62,0,1,0,1,0
11961,61248,0,0,139,139,0,1,0,1,0
8670,25773,0,0,154,154,0,1,0,1,0
45431,3389,45431,3389,293,223,70,4,0,3,1
17187,25773,0,0,142,142,0,1,0,1,0
49079,31431,0,0,149,149,0,1,0,1,0
13156,3389,13156,3389,293,223,70,4,0,3,1
34953,3389,34953,3389,293,223,70,4,0,3,1
41240,5618,0,0,145,145,0,1,0,1,0
7625,61248,0,0,139,139,0,1,0,1,0
9967,25773,0,0,149,149,0,1,0,1,0
13820,3389,13820,3389,293,223,70,4,0,3,1
12321,3389,12321,3389,293,223,70,4,1,3,1
22114,3389,22114,3389,293,223,70,4,0,3,1
62287,47563,0,0,106,106,0,1,0,1,0
9341,3703,8804,3263,287,220,67,3,0,2,0
49946,28371,0,0,119,119,0,1,0,1,0
28165,32547,0,0,77,77,0,1,0,1,0
51117,33008,0,0,97,97,0,1,0,1,0
27265,34021,0,0,62,62,0,1,0,1,0
18177,18116,0,0,63,63,0,1,0,1,0
47861,6937,0,0,145,145,0,1,0,1,0
10686,25217,0,0,141,141,0,1,0,1,0
9827,25773,0,0,149,149,0,1,0,1,0
15166,61248,0,0,144,144,0,1,0,1,0
51516,60516,0,0,94,94,0,1,0,1,0
24462,208,770,207,76,71,4,1,0,1,0
29061,29565,0,0,108,108,0,1,0,1,0
18227,3389,18227,3389,293,223,70,4,0,3,1
22407,61233,0,0,157,157,0,1,0,1,0
21519,61248,0,0,158,158,0,1,0,1,0
15604,20209,0,0,86,86,0,1,0,1,0
16473,3389,16473,3389,293,223,70,4,0,3,1
52493,33868,0,0,62,62,0,1,0,1,0
50273,5618,0,0,145,145,0,1,0,1,0
4304,23667,0,0,157,157,0,1,0,1,0
51095,60482,0,0,92,92,0,1,0,1,0
51764,31652,0,0,62,62,0,1,0,1,0
47416,5618,0,0,145,145,0,1,0,1,0
1205,22138,0,0,155,155,0,1,0,1,0
18504,3389,18504,3389,293,223,70,4,0,3,1
38210,7260,0,0,146,146,0,1,0,1,0
37788,3389,37788,3389,293,223,70,4,1,3,1
33363,14475,0,0,146,146,0,1,0,1,0
29246,60882,0,0,129,129,0,1,0,1,0
49160,32176,0,0,146,146,0,1,0,1,0
24497,34021,0,0,62,62,0,1,0,1,0
52092,33145,0,0,65,65,0,1,0,1,0
10672,23873,0,0,133,133,0,1,0,1,0
9576,3389,9576,3389,293,223,70,4,1,3,1
18204,19761,0,0,78,78,0,1,0,1,0
15824,61248,0,0,150,150,0,1,0,1,0
22706,2779,0,0,82,82,0,1,0,1,0
45719,59813,0,0,62,62,0,1,0,1,0
50343,28717,0,0,109,109,0,1,0,1,0
13343,3389,13343,3389,293,223,70,4,0,3,1
49070,31160,0,0,149,149,0,1,0,1,0
49510,60351,0,0,83,83,0,1,0,1,0
51893,32785,0,0,67,67,0,1,0,1,0
19828,29134,0,0,109,109,0,1,0,1,0
17445,18841,0,0,69,69,0,1,0,1,0
32765,10585,0,0,131,131,0,1,0,1,0
10886,3389,10886,3389,293,223,70,4,0,3,1
4539,53011,0,0,142,142,0,1,0,1,0
28206,2517,0,0,85,85,0,1,0,1,0
37518,3389,37518,3389,293,223,70,4,1,3,1
51367,32024,0,0,75,75,0,1,0,1,0
50540,31652,0,0,97,97,0,1,0,1,0
28272,27369,0,0,131,131,0,1,0,1,0
12897,13011,0,0,149,149,0,1,0,1,0
51866,34021,0,0,79,79,0,1,0,1,0
11727,61248,0,0,141,141,0,1,0,1,0
2457,22353,0,0,154,154,0,1,0,1,0
55583,5618,0,0,145,145,0,1,0,1,0
50206,31652,0,0,112,112,0,1,0,1,0
18214,3389,18214,3389,293,223,70,4,0,3,1
49376,31652,0,0,138,138,0,1,0,1,0
34136,3389,34136,3389,293,223,70,4,0,3,1
8041,25773,0,0,140,140,0,1,0,1,0
13395,18655,0,0,143,143,0,1,0,1,0
8282,25773,0,0,140,140,0,1,0,1,0
35294,3389,35294,3389,293,223,70,4,0,3,1
11209,3976,10205,3153,282,217,65,3,0,2,0
9152,3389,9152,3389,293,223,70,4,1,3,1
7130,25773,0,0,153,153,0,1,0,1,0
13372,3389,13372,3389,293,223,70,4,0,3,1
13342,9143,3506,1083,194,171,22,1,0,1,0
19324,3389,19324,3389,293,223,70,4,0,3,1
19046,3389,19046,3389,293,223,70,4,0,3,1
57283,60990,0,0,127,127,0,1,0,1,0
8365,61248,0,0,140,140,0,1,0,1,0
49553,34021,0,0,136,136,0,1,0,1,0
49098,32038,0,0,148,148,0,1,0,1,0
4028,51526,0,0,142,142,0,1,0,1,0
14192,23364,0,0,114,114,0,1,0,1,0
51680,31652,0,0,65,65,0,1,0,1,0
40646,60297,0,0,82,82,0,1,0,1,0
50289,29225,0,0,107,107,0,1,0,1,0
8219,61248,0,0,139,139,0,1,0,1,0
61972,3934,48339,2559,256,203,52,3,0,2,0
17358,3389,17358,3389,293,223,70,4,0,3,1
33211,3389,33211,3389,293,223,70,4,0,3,1
51911,40674,0,0,145,145,0,1,0,1,0
28459,26549,0,0,139,139,0,1,0,1,0
37269,3389,37269,3389,293,223,70,4,1,3,1
12469,3389,12469,3389,293,223,70,4,1,3,1
21702,3389,21702,3389,293,223,70,4,0,3,1
18433,3389,18433,3389,293,223,70,4,0,3,1
3453,49853,0,0,143,143,0,1,0,1,0
28918,3120,0,0,91,91,0,1,0,1,0
27326,25773,0,0,147,147,0,1,0,1,0
50172,28932,0,0,111,111,0,1,0,1,0
48994,28696,0,0,153,153,0,1,0,1,0
9047,58225,0,0,130,130,0,1,0,1,0
62084,31652,0,0,63,63,0,1,0,1,0
11674,61248,0,0,141,141,0,1,0,1,0
11035,3389,11035,3389,293,223,70,4,0,3,1
33059,60686,0,0,114,114,0,1,0,1,0
51033,38552,0,0,145,145,0,1,0,1,0
51540,31163,0,0,69,69,0,1,0,1,0
54554,3389,54554,3389,293,223,70,4,0,3,1
3239,29777,0,0,143,143,0,1,0,1,0
7052,29308,0,0,154,154,0,1,0,1,0
28195,31063,0,0,92,92,0,1,0,1,0
44898,7438,0,0,145,145,0,1,0,1,0
21899,28456,0,0,116,116,0,1,0,1,0
53655,11635,0,0,148,148,0,1,0,1,0
26912,34021,0,0,62,62,0,1,0,1,0
12931,20963,0,0,91,91,0,1,0,1,0
26352,28528,0,0,119,119,0,1,0,1,0
14711,25773,0,0,140,140,0,1,0,1,0
20747,61248,0,0,156,156,0,1,0,1,0
12352,6744,6616,2044,235,193,42,2,0,2,0
13815,3389,13815,3389,293,223,70,4,0,3,1
25648,34021,0,0,62,62,0,1,0,1,0
23122,29301,0,0,108,108,0,1,0,1,0
17119,16333,0,0,87,87,0,1,0,1,0
18517,3389,18517,3389,293,223,70,4,0,3,1
40101,8248,0,0,145,145,0,1,0,1,0
7663,61248,0,0,139,139,0,1,0,1,0
7956,25684,0,0,157,157,0,1,0,1,0
49011,29257,0,0,152,152,0,1,0,1,0
49020,29543,0,0,151,151,0,1,0,1,0
63024,42167,0,0,91,91,0,1,0,1,0
49501,34021,0,0,137,137,0,1,0,1,0
51286,31652,0,0,77,77,0,1,0,1,0
51563,31212,0,0,69,69,0,1,0,1,0
58809,3389,58809,3389,293,223,70,4,0,3,1
10675,3389,10675,3389,293,223,70,4,1,3,1
17101,3389,17101,3389,293,223,70,4,0,3,1
47700,22889,0,0,155,155,0,1,0,1,0
22066,61248,0,0,158,158,0,1,0,1,0
26118,34021,0,0,62,62,0,1,0,1,0
5237,55041,0,0,141,141,0,1,0,1,0
23885,30556,0,0,96,96,0,1,0,1,0
50723,31652,0,0,91,91,0,1,0,1,0
55947,45929,0,0,102,102,0,1,0,1,0
36147,8740,0,0,146,146,0,1,0,1,0
6307,25773,0,0,143,143,0,1,0,1,0
52499,5618,0,0,145,145,0,1,0,1,0
17600,3389,17600,3389,293,223,70,4,0,3,1
39414,8364,0,0,145,145,0,1,0,1,0
35840,3903,0,0,120,120,0,1,0,1,0
16137,3389,16137,3389,293,223,70,4,0,3,1
32692,10623,0,0,131,131,0,1,0,1,0
24611,14886,0,0,92,92,0,1,0,1,0
33371,2994,0,0,106,106,0,1,0,1,0
36575,8843,0,0,145,145,0,1,0,1,0
16163,2155,6972,2154,208,164,44,2,0,2,0
37788,3389,37788,3389,293,223,70,4,1,3,1
31419,60770,0,0,120,120,0,1,0,1,0
10801,3389,10801,3389,293,223,70,4,0,3,1
21340,3389,21340,3389,293,223,70,4,0,3,1
8188,25719,0,0,156,156,0,1,0,1,0
19086,3389,19086,3389,293,223,70,4,0,3,1
6478,17791,0,0,153,153,0,1,0,1,0
49164,31652,0,0,145,145,0,1,0,1,0
47136,48202,0,0,97,97,0,1,0,1,0
29498,3389,29498,3389,293,223,70,4,0,3,1
10412,3389,10412,3389,293,223,70,4,1,3,1
42526,34021,0,0,116,116,0,1,0,1,0
52281,33815,0,0,69,69,0,1,0,1,0
21590,3389,21590,3389,293,223,70,4,0,3,1
5368,24254,0,0,157,157,0,1,0,1,0
49198,33985,0,0,144,144,0,1,0,1,0
28187,31485,0,0,88,88,0,1,0,1,0
47263,3389,47263,3389,293,223,70,4,0,3,1
22545,28902,0,0,112,112,0,1,0,1,0
14542,3389,14542,3389,293,223,70,4,0,3,1
12446,24724,0,0,139,139,0,1,0,1,0
15748,3389,15748,3389,293,223,70,4,0,3,1
16950,25773,0,0,142,142,0,1,0,1,0
16349,25773,0,0,145,145,0,1,0,1,0
49787,33453,0,0,125,125,0,1,0,1,0
24336,34021,0,0,62,62,0,1,0,1,0
49803,31652,0,0,125,125,0,1,0,1,0
49600,33622,0,0,131,131,0,1,0,1,0
51097,32994,0,0,98,98,0,1,0,1,0
10975,3389,10975,3389,293,223,70,4,1,3,1
7667,61248,0,0,139,139,0,1,0,1,0
10159,61248,0,0,139,139,0,1,0,1,0
15248,20473,0,0,90,90,0,1,0,1,0
3005,22311,0,0,155,155,0,1,0,1,0
52285,31652,0,0,71,71,0,1,0,1,0
11101,61248,0,0,142,142,0,1,0,1,0
10061,3389,10061,3389,293,223,70,4,0,3,1
62591,31941,0,0,72,72,0,1,0,1,0
38094,3389,38094,3389,293,223,70,4,1,3,1
52976,13656,0,0,149,149,0,1,0,1,0
24147,31640,0,0,86,86,0,1,0,1,0
15358,25773,0,0,143,143,0,1,0,1,0
13036,9584,2446,906,186,168,18,1,0,1,0
51040,30570,0,0,101,101,0,1,0,1,0
22665,34021,0,0,62,62,0,1,0,1,0
7389,61248,0,0,139,139,0,1,0,1,0
19539,3389,19539,3389,293,223,70,4,0,3,1
56286,51254,0,0,145,145,0,1,0,1,0
55432,60838,0,0,116,116,0,1,0,1,0
13546,3389,13546,3389,293,223,70,4,0,3,1
6763,53659,0,0,143,143,0,1,0,1,0
38259,3389,38259,3389,293,223,70,4,1,3,1
49071,29619,0,0,149,149,0,1,0,1,0
49121,32778,0,0,147,147,0,1,0,1,0
25721,34021,0,0,62,62,0,1,0,1,0
19992,29784,0,0,101,101,0,1,0,1,0
8621,61248,0,0,139,139,0,1,0,1,0
7019,60221,0,0,139,139,0,1,0,1,0
12221,3389,12221,3389,293,223,70,4,1,3,1
8852,61248,0,0,140,140,0,1,0,1,0
43914,60129,0,0,69,69,0,1,0,1,0
50883,3389,50883,3389,293,223,70,4,0,3,1
51834,32679,0,0,67,67,0,1,0,1,0
50141,31652,0,0,111,111,0,1,0,1,0
27929,3389,27929,3389,293,223,70,4,0,3,1
10887,3389,10887,3389,293,223,70,4,1,3,1
1648,22831,0,0,153,153,0,1,0,1,0
12739,61248,0,0,139,139,0,1,0,1,0
21874,3389,21874,3389,293,223,70,4,0,3,1
50172,28933,0,0,111,111,0,1,0,1,0
10256,24182,0,0,136,136,0,1,0,1,0
5674,33888,0,0,152,152,0,1,0,1,0
56068,31652,0,0,108,108,0,1,0,1,0
14799,3389,14799,3389,293,223,70,4,0,3,1
10601,25773,0,0,139,139,0,1,0,1,0
22509,21431,0,0,98,98,0,1,0,1,0
28299,25773,0,0,147,147,0,1,0,1,0
38142,3389,38142,3389,293,223,70,4,0,3,1
11374,3389,11374,3389,293,223,70,4,0,3,1
1911,21192,0,0,156,156,0,1,0,1,0
13763,16300,0,0,145,145,0,1,0,1,0
10716,25773,0,0,139,139,0,1,0,1,0
19528,6274,0,0,107,107,0,1,0,1,0
21584,3389,21584,3389,293,223,70,4,0,3,1
12138,3389,12138,3389,293,223,70,4,1,3,1
17834,3389,17834,3389,293,223,70,4,0,3,1
6396,58411,0,0,140,140,0,1,0,1,0
12340,22634,0,0,117,117,0,1,0,1,0
30789,21666,0,0,147,147,0,1,0,1,0
13412,25773,0,0,139,139,0,1,0,1,0
7182,54358,0,0,143,143,0,1,0,1,0
50517,32793,0,0,102,102,0,1,0,1,0
59050,56495,0,0,130,130,0,1,0,1,0
15478,3389,15478,3389,293,223,70,4,0,3,1
31393,3389,31393,3389,293,223,70,4,0,3,1
52382,33669,0,0,63,63,0,1,0,1,0
49525,31652,0,0,134,134,0,1,0,1,0
24313,1013,0,0,69,69,0,1,0,1,0
7571,61248,0,0,139,139,0,1,0,1,0
35784,8932,0,0,145,145,0,1,0,1,0
8288,23529,0,0,151,151,0,1,0,1,0
1287,22265,0,0,155,155,0,1,0,1,0
28833,60903,0,0,131,131,0,1,0,1,0
18063,24279,0,0,126,126,0,1,0,1,0
51374,30825,0,0,75,75,0,1,0,1,0
47040,21305,0,0,154,154,0,1,0,1,0
36423,8542,0,0,146,146,0,1,0,1,0
29112,34021,0,0,62,62,0,1,0,1,0
19852,3389,19852,3389,293,223,70,4,0,3,1
11248,3389,11248,3389,293,223,70,4,0,3,1
12144,22780,0,0,119,119,0,1,0,1,0
27837,26432,0,0,141,141,0,1,0,1,0
13890,3389,13890,3389,293,223,70,4,0,3,1
49420,31652,0,0,137,137,0,1,0,1,0
24309,34021,0,0,62,62,0,1,0,1,0
13984,3389,13984,3389,293,223,70,4,0,3,1
2148,22475,0,0,157,157,0,1,0,1,0
18058,24457,0,0,128,128,0,1,0,1,0
56220,32927,0,0,107,107,0,1,0,1,0
51369,31309,0,0,93,93,0,1,0,1,0
51667,17548,0,0,152,152,0,1,0,1,0
44121,7569,0,0,145,145,0,1,0,1,0
21844,20933,0,0,92,92,0,1,0,1,0
16455,61248,0,0,150,150,0,1,0,1,0
52925,60632,0,0,102,102,0,1,0,1,0
49160,33988,0,0,146,146,0,1,0,1,0
28206,30546,0,0,98,98,0,1,0,1,0
17349,23161,0,0,143,143,0,1,0,1,0
11549,53123,0,0,151,151,0,1,0,1,0
4247,22976,0,0,151,151,0,1,0,1,0
50412,34021,0,0,115,115,0,1,0,1,0
11748,3389,11748,3389,293,223,70,4,1,3,1
23261,34021,0,0,62,62,0,1,0,1,0
19680,28860,0,0,112,112,0,1,0,1,0
48970,27314,0,0,154,154,0,1,0,1,0
45854,5618,0,0,145,145,0,1,0,1,0
6055,23014,0,0,152,152,0,1,0,1,0
33019,3389,33019,3389,293,223,70,4,0,3,1
27722,34021,0,0,62,62,0,1,0,1,0
5387,25773,0,0,148,148,0,1,0,1,0
12422,3389,12422,3389,293,223,70,4,0,3,1
17070,3389,17070,3389,293,223,70,4,0,3,1
26452,28386,0,0,120,120,0,1,0,1,0
19035,3389,19035,3389,293,223,70,4,0,3,1
51496,5618,0,0,145,145,0,1,0,1,0
19428,61248,0,0,155,155,0,1,0,1,0
48988,28532,0,0,153,153,0,1,0,1,0
2959,24882,0,0,146,146,0,1,0,1,0
50624,30056,0,0,95,95,0,1,0,1,0
11286,25773,0,0,143,143,0,1,0,1,0
9200,25773,0,0,152,152,0,1,0,1,0
17593,3389,17593,3389,293,223,70,4,0,3,1
28477,26638,0,0,138,138,0,1,0,1,0
49160,32567,0,0,146,146,0,1,0,1,0
47525,60188,0,0,72,72,0,1,0,1,0
5896,25773,0,0,150,150,0,1,0,1,0
50073,31652,0,0,116,116,0,1,0,1,0
49423,33724,0,0,136,136,0,1,0,1,0
6695,25773,0,0,152,152,0,1,0,1,0
18683,25773,0,0,143,143,0,1,0,1,0
27805,25398,0,0,143,143,0,1,0,1,0
31792,2414,0,0,98,98,0,1,0,1,0
19872,3389,19872,3389,293,223,70,4,0,3,1
28203,34021,0,0,62,62,0,1,0,1,0
23161,15652,0,0,85,85,0,1,0,1,0
21720,835,2701,834,118,101,17,1,0,1,0
22296,34460,0,0,63,63,0,1,0,1,0
50588,31652,0,0,95,95,0,1,0,1,0
50749,5618,0,0,145,145,0,1,0,1,0
27095,1577,0,0,76,76,0,1,0,1,0
28814,28327,0,0,121,121,0,1,0,1,0
12243,8322,3811,1412,208,179,29,2,0,1,0
21557,874,2826,873,121,103,18,1,0,1,0
10162,25034,0,0,142,142,0,1,0,1,0
29429,23261,0,0,147,147,0,1,0,1,0
19230,1426,4614,1426,159,129,29,2,0,1,0
12458,25773,0,0,150,150,0,1,0,1,0
49502,31652,0,0,135,135,0,1,0,1,0
52154,32766,0,0,62,62,0,1,0,1,0
50760,32219,0,0,89,89,0,1,0,1,0
29238,30451,0,0,99,99,0,1,0,1,0
51330,31652,0,0,70,70,0,1,0,1,0
1762,23010,0,0,152,152,0,1,0,1,0
13292,3389,13292,3389,293,223,70,4,0,3,1
9247,25773,0,0,143,143,0,1,0,1,0
9807,25773,0,0,140,140,0,1,0,1,0
51645,31652,0,0,64,64,0,1,0,1,0
13038,8408,4459,1378,206,178,28,2,0,1,0
1831,23116,0,0,152,152,0,1,0,1,0
10473,61248,0,0,143,143,0,1,0,1,0
19348,31498,0,0,85,85,0,1,0,1,0
13505,24230,0,0,123,123,0,1,0,1,0
9039,61248,0,0,140,140,0,1,0,1,0
50844,32819,0,0,104,104,0,1,0,1,0
37963,7437,0,0,146,146,0,1,0,1,0
52520,33917,0,0,62,62,0,1,0,1,0
9140,25773,0,0,155,155,0,1,0,1,0
10765,61248,0,0,139,139,0,1,0,1,0
4658,23119,0,0,151,151,0,1,0,1,0
17698,61248,0,0,152,152,0,1,0,1,0
1434,22496,0,0,154,154,0,1,0,1,0
51652,31652,0,0,64,64,0,1,0,1,0
7087,25773,0,0,141,141,0,1,0,1,0
49544,31652,0,0,132,132,0,1,0,1,0
17221,1903,6158,1903,191,152,39,2,0,2,0
23829,34021,0,0,62,62,0,1,0,1,0
2440,40817,0,0,144,144,0,1,0,1,0
20978,27819,0,0,122,122,0,1,0,1,0
49160,33725,0,0,146,146,0,1,0,1,0
16242,18826,0,0,145,145,0,1,0,1,0
42395,3389,42395,3389,293,223,70,4,0,3,1
28195,25928,0,0,146,146,0,1,0,1,0
8571,61248,0,0,140,140,0,1,0,1,0
5812,24499,0,0,157,157,0,1,0,1,0
29621,34021,0,0,62,62,0,1,0,1,0
14114,11299,592,219,157,152,4,1,0,1,0
19428,19123,0,0,72,72,0,1,0,1,0
51616,33354,0,0,85,85,0,1,0,1,0
12884,61248,0,0,145,145,0,1,0,1,0
49594,33531,0,0,130,130,0,1,0,1,0
62857,31652,0,0,63,63,0,1,0,1,0
20824,3389,20824,3389,293,223,70,4,0,3,1
11695,61248,0,0,141,141,0,1,0,1,0
9690,61248,0,0,141,141,0,1,0,1,0
19029,3389,19029,3389,293,223,70,4,0,3,1
9069,24654,0,0,144,144,0,1,0,1,0
15850,19470,0,0,75,75,0,1,0,1,0
9688,24604,0,0,142,142,0,1,0,1,0
15239,3389,15239,3389,293,223,70,4,0,3,1
16401,3389,16401,3389,293,223,70,4,0,3,1
29782,3389,29782,3389,293,223,70,4,0,3,1
18624,26900,0,0,131,131,0,1,0,1,0
11282,3389,11282,3389,293,223,70,4,1,3,1
11411,25773,0,0,152,152,0,1,0,1,0
19995,3389,19995,3389,293,223,70,4,0,3,1
11915,59785,0,0,138,138,0,1,0,1,0
17501,30001,0,0,99,99,0,1,0,1,0
2245,22528,0,0,157,157,0,1,0,1,0
23288,61188,0,0,154,154,0,1,0,1,0
38026,34021,0,0,97,97,0,1,0,1,0
3154,48984,0,0,143,143,0,1,0,1,0
19353,3389,19353,3389,293,223,70,4,0,3,1
1147,22046,0,0,156,156,0,1,0,1,0
25486,3389,25486,3389,293,223,70,4,0,3,1
21800,3389,21800,3389,293,223,70,4,0,3,1
13494,3389,13494,3389,293,223,70,4,1,3,1
51582,31652,0,0,65,65,0,1,0,1,0
12881,21942,0,0,141,141,0,1,0,1,0
14557,3389,14557,3389,293,223,70,4,0,3,1
22104,3389,22104,3389,293,223,70,4,0,3,1
54390,60752,0,0,111,111,0,1,0,1,0
31630,60760,0,0,119,119,0,1,0,1,0
29762,22518,0,0,147,147,0,1,0,1,0
16674,49503,0,0,105,105,0,1,0,1,0
51721,31652,0,0,63,63,0,1,0,1,0
63669,3389,63669,3389,293,223,70,4,0,3,1
10038,61248,0,0,139,139,0,1,0,1,0
27373,27087,0,0,134,134,0,1,0,1,0
26505,34021,0,0,62,62,0,1,0,1,0
63511,31652,0,0,62,62,0,1,0,1,0
29298,34021,0,0,62,62,0,1,0,1,0
26064,32332,0,0,78,78,0,1,0,1,0
13409,10177,1805,669,176,162,13,1,0,1,0
28195,31101,0,0,92,92,0,1,0,1,0
7387,25370,0,0,157,157,0,1,0,1,0
11947,5763,7887,2437,252,201,50,3,0,2,0
17536,47196,0,0,99,99,0,1,0,1,0
51923,32552,0,0,78,78,0,1,0,1,0
48989,28542,0,0,153,153,0,1,0,1,0
2928,34075,0,0,143,143,0,1,0,1,0
29292,30719,0,0,96,96,0,1,0,1,0
49416,26822,0,0,140,140,0,1,0,1,0
28994,29227,0,0,111,111,0,1,0,1,0
4614,19179,0,0,154,154,0,1,0,1,0
50863,38140,0,0,145,145,0,1,0,1,0
43408,12594,0,0,149,149,0,1,0,1,0
3936,25773,0,0,144,144,0,1,0,1,0
4246,25773,0,0,145,145,0,1,0,1,0
51744,3389,51744,3389,293,223,70,4,0,3,1
51926,32845,0,0,66,66,0,1,0,1,0
16735,20759,0,0,144,144,0,1,0,1,0
10020,61248,0,0,141,141,0,1,0,1,0
13151,25773,0,0,149,149,0,1,0,1,0
39847,34021,0,0,105,105,0,1,0,1,0
28522,26865,0,0,136,136,0,1,0,1,0
7858,23558,0,0,119,119,0,1,0,1,0
33568,3389,33568,3389,293,223,70,4,1,3,1
50736,31652,0,0,95,95,0,1,0,1,0
14832,12478,0,0,139,139,0,1,0,1,0
18046,24833,0,0,132,132,0,1,0,1,0
24796,3389,24796,3389,293,223,70,4,0,3,1
38530,3389,38530,3389,293,223,70,4,1,3,1
26700,1242,0,0,73,73,0,1,0,1,0
11120,3389,11120,3389,293,223,70,4,0,3,1
20563,3389,20563,3389,293,223,70,4,0,3,1
9330,3389,9330,3389,293,223,70,4,1,3,1
20873,3389,20873,3389,293,223,70,4,0,3,1
7672,61248,0,0,139,139,0,1,0,1,0
14184,3389,14184,3389,293,223,70,4,0,3,1
9530,4003,8479,3142,282,217,64,3,0,2,0
50692,37726,0,0,145,145,0,1,0,1,0
18029,25783,0,0,142,142,0,1,0,1,0
9250,25773,0,0,152,152,0,1,0,1,0
49834,27863,0,0,132,132,0,1,0,1,0
46950,3389,46950,3389,293,223,70,4,0,3,1
31194,19319,0,0,147,147,0,1,0,1,0
12337,3389,12337,3389,293,223,70,4,0,3,1
38892,3389,38892,3389,293,223,70,4,0,3,1
15825,61248,0,0,149,149,0,1,0,1,0
49534,33682,0,0,134,134,0,1,0,1,0
13445,24306,0,0,124,124,0,1,0,1,0
15036,12821,0,0,134,134,0,1,0,1,0
10638,3389,10638,3389,293,223,70,4,1,3,1
57293,50395,0,0,111,111,0,1,0,1,0
49108,26233,0,0,151,151,0,1,0,1,0
51742,31652,0,0,62,62,0,1,0,1,0
55291,60826,0,0,116,116,0,1,0,1,0
15214,61248,0,0,148,148,0,1,0,1,0
11070,25773,0,0,139,139,0,1,0,1,0
20223,3389,20223,3389,293,223,70,4,0,3,1
36009,3389,36009,3389,293,223,70,4,0,3,1
23021,25773,0,0,145,145,0,1,0,1,0
22803,33537,0,0,67,67,0,1,0,1,0
18462,3389,18462,3389,293,223,70,4,0,3,1
19306,3389,19306,3389,293,223,70,4,0,3,1
38905,60386,0,0,89,89,0,1,0,1,0
6954,25773,0,0,153,153,0,1,0,1,0
15659,3389,15659,3389,293,223,70,4,0,3,1
14090,61248,0,0,148,148,0,1,0,1,0
15450,3389,15450,3389,293,223,70,4,0,3,1
2078,45831,0,0,144,144,0,1,0,1,0
4357,25773,0,0,142,142,0,1,0,1,0
27828,3389,27828,3389,293,223,70,4,0,3,1
11452,25773,0,0,139,139,0,1,0,1,0
54484,12661,0,0,125,125,0,1,0,1,0
29214,34021,0,0,62,62,0,1,0,1,0
15110,61248,0,0,148,148,0,1,0,1,0
47186,54385,0,0,62,62,0,1,0,1,0
45724,59782,0,0,62,62,0,1,0,1,0
14851,54381,0,0,119,119,0,1,0,1,0
51034,30130,0,0,86,86,0,1,0,1,0
17176,1914,6194,1914,192,152,39,2,0,2,0
49781,33321,0,0,124,124,0,1,0,1,0
60052,32530,0,0,62,62,0,1,0,1,0
19118,1641,6103,1641,173,139,33,2,0,1,0
18016,3389,18016,3389,293,223,70,4,0,3,1
51130,31652,0,0,82,82,0,1,0,1,0
50526,32599,0,0,112,112,0,1,0,1,0
16649,9439,0,0,130,130,0,1,0,1,0
24335,241,896,241,78,73,4,1,0,1,0
51563,31743,0,0,88,88,0,1,0,1,0
12756,13115,0,0,149,149,0,1,0,1,0
49160,33360,0,0,146,146,0,1,0,1,0
21038,3389,21038,3389,293,223,70,4,0,3,1
18979,3389,18979,3389,293,223,70,4,0,3,1
13513,3389,13513,3389,293,223,70,4,0,3,1
55721,5606,335,17,145,145,0,1,0,1,0
20498,30378,0,0,97,97,0,1,0,1,0
18073,23955,0,0,123,123,0,1,0,1,0
10864,6126,6184,2292,246,198,47,3,0,2,0
18152,3389,18152,3389,293,223,70,4,0,3,1
19999,3389,19999,3389,293,223,70,4,0,3,1
18069,24077,0,0,124,124,0,1,0,1,0
15811,17139,0,0,146,146,0,1,0,1,0
50216,31652,0,0,112,112,0,1,0,1,0
12248,25760,0,0,139,139,0,1,0,1,0
1639,22817,0,0,153,153,0,1,0,1,0
10850,61248,0,0,139,139,0,1,0,1,0
21205,3389,21205,3389,293,223,70,4,0,3,1
51676,31652,0,0,64,64,0,1,0,1,0
51690,31652,0,0,63,63,0,1,0,1,0
50995,30051,0,0,87,87,0,1,0,1,0
49068,31080,0,0,149,149,0,1,0,1,0
20804,3389,20804,3389,293,223,70,4,0,3,1
10303,3389,10303,3389,293,223,70,4,1,3,1
18043,24933,0,0,133,133,0,1,0,1,0
55325,7698,0,0,139,139,0,1,0,1,0
42854,5618,0,0,145,145,0,1,0,1,0
51759,40308,0,0,145,145,0,1,0,1,0
15172,47172,0,0,99,99,0,1,0,1,0
37151,3389,37151,3389,293,223,70,4,1,3,1
28195,31070,0,0,92,92,0,1,0,1,0
4498,25773,0,0,145,145,0,1,0,1,0
17408,25773,0,0,142,142,0,1,0,1,0
10137,61248,0,0,139,139,0,1,0,1,0
18016,3389,18016,3389,293,223,70,4,0,3,1
31045,3389,31045,3389,293,223,70,4,0,3,1
12381,3389,12381,3389,293,223,70,4,1,3,1
19480,6326,0,0,107,107,0,1,0,1,0
12224,3389,12224,3389,293,223,70,4,1,3,1
5322,24855,0,0,133,133,0,1,0,1,0
27278,1731,0,0,78,78,0,1,0,1,0
26410,3389,26410,3389,293,223,70,4,0,3,1
54752,11797,0,0,125,125,0,1,0,1,0
50535,31652,0,0,97,97,0,1,0,1,0
10906,24133,0,0,148,148,0,1,0,1,0
25997,25773,0,0,146,146,0,1,0,1,0
12868,26077,0,0,136,136,0,1,0,1,0
7507,61248,0,0,139,139,0,1,0,1,0
10784,25773,0,0,145,145,0,1,0,1,0
37397,3389,37397,3389,293,223,70,4,1,3,1
12752,61248,0,0,139,139,0,1,0,1,0
49732,27838,0,0,127,127,0,1,0,1,0
49043,28991,0,0,150,150,0,1,0,1,0
26974,34021,0,0,62,62,0,1,0,1,0
20547,3389,20547,3389,293,223,70,4,0,3,1
28185,31589,0,0,87,87,0,1,0,1,0
8959,61248,0,0,139,139,0,1,0,1,0
19371,1573,5850,1573,169,136,32,2,0,1,0
52305,33832,0,0,68,68,0,1,0,1,0
49921,32179,0,0,127,127,0,1,0,1,0
49479,27208,0,0,136,136,0,1,0,1,0
18080,3389,18080,3389,293,223,70,4,0,3,1
18192,3389,18192,3389,293,223,70,4,0,3,1
47360,46373,0,0,102,102,0,1,0,1,0
2127,45148,0,0,144,144,0,1,0,1,0
50669,32321,0,0,92,92,0,1,0,1,0
22599,61223,0,0,157,157,0,1,0,1,0
20399,3389,20399,3389,293,223,70,4,0,3,1
51900,33551,0,0,78,78,0,1,0,1,0
29834,33437,0,0,68,68,0,1,0,1,0
12145,6244,7264,2244,244,197,46,2,0,2,0
13746,3389,13746,3389,293,223,70,4,0,3,1
17371,3389,17371,3389,293,223,70,4,0,3,1
25972,24025,0,0,128,128,0,1,0,1,0
36572,3389,36572,3389,293,223,70,4,0,3,1
21333,3389,21333,3389,293,223,70,4,0,3,1
58527,61092,0,0,134,134,0,1,0,1,0
33120,2902,0,0,105,105,0,1,0,1,0
9763,24896,0,0,143,143,0,1,0,1,0
52069,33103,0,0,65,65,0,1,0,1,0
21322,61248,0,0,157,157,0,1,0,1,0
15781,21358,0,0,93,93,0,1,0,1,0
49160,32669,0,0,146,146,0,1,0,1,0
52683,25615,0,0,81,81,0,1,0,1,0
2805,47969,0,0,144,144,0,1,0,1,0
47498,53208,0,0,62,62,0,1,0,1,0
20750,61248,0,0,156,156,0,1,0,1,0
28181,31763,0,0,85,85,0,1,0,1,0
9965,3389,9965,3389,293,223,70,4,1,3,1
21468,3389,21468,3389,293,223,70,4,0,3,1
25654,3389,25654,3389,293,223,70,4,0,3,1
50479,32827,0,0,103,103,0,1,0,1,0
51986,32267,0,0,62,62,0,1,0,1,0
18454,3389,18454,3389,293,223,70,4,0,3,1
8544,55605,0,0,141,141,0,1,0,1,0
11181,25773,0,0,152,152,0,1,0,1,0
10093,3389,10093,3389,293,223,70,4,1,3,1
30458,3389,30458,3389,293,223,70,4,0,3,1
29447,31497,0,0,88,88,0,1,0,1,0
48988,27719,0,0,153,153,0,1,0,1,0
49746,33490,0,0,127,127,0,1,0,1,0
14378,3389,14378,3389,293,223,70,4,0,3,1
16149,3389,16149,3389,293,223,70,4,0,3,1
8238,61248,0,0,139,139,0,1,0,1,0
3626,25773,0,0,142,142,0,1,0,1,0
52059,32482,0,0,62,62,0,1,0,1,0
54578,33182,0,0,116,116,0,1,0,1,0
3561,25773,0,0,143,143,0,1,0,1,0
51091,31652,0,0,78,78,0,1,0,1,0
14777,3389,14777,3389,293,223,70,4,0,3,1
7044,25773,0,0,141,141,0,1,0,1,0
19901,3389,19901,3389,293,223,70,4,0,3,1
5112,23277,0,0,150,150,0,1,0,1,0
19523,28568,0,0,115,115,0,1,0,1,0
19947,3389,19947,3389,293,223,70,4,0,3,1
11412,3389,11412,3389,293,223,70,4,1,3,1
7369,25773,0,0,154,154,0,1,0,1,0
58896,4757,24718,1308,202,175,27,2,0,1,0
54696,31652,0,0,69,69,0,1,0,1,0
2906,24798,0,0,146,146,0,1,0,1,0
27386,34021,0,0,62,62,0,1,0,1,0
39897,60335,0,0,85,85,0,1,0,1,0
17889,3389,17889,3389,293,223,70,4,0,3,1
16080,3389,16080,3389,293,223,70,4,0,3,1
49037,28840,0,0,151,151,0,1,0,1,0
12669,3389,12669,3389,293,223,70,4,0,3,1
6236,32020,0,0,153,153,0,1,0,1,0
37371,3389,37371,3389,293,223,70,4,1,3,1
28356,3389,28356,3389,293,223,70,4,0,3,1
11820,3389,11820,3389,293,223,70,4,1,3,1
10298,58252,0,0,140,140,0,1,0,1,0
29826,34021,0,0,62,62,0,1,0,1,0
1196,22124,0,0,156,156,0,1,0,1,0
14502,25773,0,0,140,140,0,1,0,1,0
17134,25773,0,0,142,142,0,1,0,1,0
11937,22933,0,0,121,121,0,1,0,1,0
18679,3389,18679,3389,293,223,70,4,0,3,1
21034,3389,21034,3389,293,223,70,4,0,3,1
50936,32021,0,0,83,83,0,1,0,1,0
17420,23438,0,0,143,143,0,1,0,1,0
20830,25773,0,0,144,144,0,1,0,1,0
15097,12924,0,0,133,133,0,1,0,1,0
51746,31652,0,0,62,62,0,1,0,1,0
43642,5618,0,0,145,145,0,1,0,1,0
3991,25773,0,0,142,142,0,1,0,1,0
33944,34021,0,0,79,79,0,1,0,1,0
24792,3389,24792,3389,293,223,70,4,0,3,1
49329,31652,0,0,140,140,0,1,0,1,0
9584,25773,0,0,150,150,0,1,0,1,0
49345,26875,0,0,141,141,0,1,0,1,0
12030,7983,4177,1548,214,182,31,2,0,1,0
17798,24918,0,0,143,143,0,1,0,1,0
55959,60881,0,0,119,119,0,1,0,1,0
18341,61248,0,0,153,153,0,1,0,1,0
49160,33539,0,0,146,146,0,1,0,1,0
21126,61248,0,0,157,157,0,1,0,1,0
8093,25773,0,0,156,156,0,1,0,1,0
9369,3389,9369,3389,293,223,70,4,1,3,1
43429,3389,43429,3389,293,223,70,4,0,3,1
62830,3705,54923,2907,271,211,60,3,0,2,0
37692,10258,0,0,146,146,0,1,0,1,0
18980,3389,18980,3389,293,223,70,4,0,3,1
18203,3389,18203,3389,293,223,70,4,0,3,1
22604,3389,22604,3389,293,223,70,4,0,3,1
13467,3389,13467,3389,293,223,70,4,0,3,1
49914,33171,0,0,119,119,0,1,0,1,0
50554,3389,50554,3389,293,223,70,4,0,3,1
21760,3389,21760,3389,293,223,70,4,0,3,1
37135,3389,37135,3389,293,223,70,4,0,3,1
24915,34021,0,0,62,62,0,1,0,1,0
51365,31652,0,0,75,75,0,1,0,1,0
49132,33136,0,0,147,147,0,1,0,1,0
51309,34021,0,0,93,93,0,1,0,1,0
8973,23687,0,0,150,150,0,1,0,1,0
59143,3389,59143,3389,293,223,70,4,0,3,1
54693,8545,0,0,146,146,0,1,0,1,0
61059,4178,41328,2188,240,195,45,2,0,2,0
51445,31652,0,0,72,72,0,1,0,1,0
1319,22316,0,0,155,155,0,1,0,1,0
18086,23532,0,0,118,118,0,1,0,1,0
16463,19692,0,0,145,145,0,1,0,1,0
42627,34021,0,0,117,117,0,1,0,1,0
49297,33999,0,0,145,145,0,1,0,1,0
17301,22972,0,0,144,144,0,1,0,1,0
30805,4717,0,0,106,106,0,1,0,1,0
34766,3508,0,0,114,114,0,1,0,1,0
60606,32420,0,0,62,62,0,1,0,1,0
49032,29945,0,0,151,151,0,1,0,1,0
3983,39512,0,0,148,148,0,1,0,1,0
54436,5827,0,0,145,145,0,1,0,1,0
48942,27052,0,0,155,155,0,1,0,1,0
17375,16764,0,0,81,81,0,1,0,1,0
37499,3389,37499,3389,293,223,70,4,1,3,1
8163,25773,0,0,143,143,0,1,0,1,0
12091,8079,4073,1509,212,181,31,2,0,1,0
51612,33351,0,0,85,85,0,1,0,1,0
13652,9895,2531,782,181,165,16,1,0,1,0
11904,21488,0,0,96,96,0,1,0,1,0
34617,34021,0,0,82,82,0,1,0,1,0
55118,60812,0,0,115,115,0,1,0,1,0
2550,47226,0,0,144,144,0,1,0,1,0
1654,22839,0,0,153,153,0,1,0,1,0
8676,25356,0,0,151,151,0,1,0,1,0
49126,30888,0,0,147,147,0,1,0,1,0
61603,52574,0,0,120,120,0,1,0,1,0
9123,24673,0,0,144,144,0,1,0,1,0
26154,14073,0,0,99,99,0,1,0,1,0
12339,25414,0,0,139,139,0,1,0,1,0
13536,10379,1586,588,173,161,12,1,0,1,0
32707,3389,32707,3389,293,223,70,4,0,3,1
42723,10951,0,0,148,148,0,1,0,1,0
29175,34021,0,0,62,62,0,1,0,1,0
51694,31652,0,0,63,63,0,1,0,1,0
18130,25983,0,0,140,140,0,1,0,1,0
54079,5618,0,0,145,145,0,1,0,1,0
52120,6218,0,0,145,145,0,1,0,1,0
17975,61248,0,0,152,152,0,1,0,1,0
63022,31652,0,0,63,63,0,1,0,1,0
28251,28380,0,0,120,120,0,1,0,1,0
59236,31652,0,0,90,90,0,1,0,1,0
12862,7979,5014,1549,214,182,32,2,0,1,0
15486,61248,0,0,149,149,0,1,0,1,0
3042,25012,0,0,145,145,0,1,0,1,0
41493,5618,0,0,145,145,0,1,0,1,0
17204,25773,0,0,142,142,0,1,0,1,0
11869,3389,11869,3389,293,223,70,4,0,3,1
21773,25773,0,0,144,144,0,1,0,1,0
53875,38526,0,0,75,75,0,1,0,1,0
18063,25773,0,0,143,143,0,1,0,1,0
29290,33564,0,0,66,66,0,1,0,1,0
13607,3389,13607,3389,293,223,70,4,0,3,1
29934,34021,0,0,62,62,0,1,0,1,0
49643,34021,0,0,134,134,0,1,0,1,0
59173,58235,0,0,145,145,0,1,0,1,0
51662,31652,0,0,64,64,0,1,0,1,0
32460,3389,32460,3389,293,223,70,4,1,3,1
9438,61248,0,0,141,141,0,1,0,1,0
7510,25773,0,0,141,141,0,1,0,1,0
51532,31652,0,0,66,66,0,1,0,1,0
50663,32660,0,0,97,97,0,1,0,1,0
28218,29967,0,0,104,104,0,1,0,1,0
61965,31652,0,0,62,62,0,1,0,1,0
19798,61248,0,0,155,155,0,1,0,1,0
22061,3389,22061,3389,293,223,70,4,0,3,1
59568,58295,0,0,136,136,0,1,0,1,0
3180,30586,0,0,143,143,0,1,0,1,0
18967,31189,0,0,88,88,0,1,0,1,0
20980,1010,3269,1010,130,109,20,1,0,1,0
9605,4123,8350,3094,280,216,63,3,0,2,0
28207,30508,0,0,98,98,0,1,0,1,0
52331,6183,0,0,145,145,0,1,0,1,0
4774,23159,0,0,151,151,0,1,0,1,0
9331,57939,0,0,143,143,0,1,0,1,0
26160,28800,0,0,116,116,0,1,0,1,0
20384,3389,20384,3389,293,223,70,4,0,3,1
7025,17384,0,0,152,152,0,1,0,1,0
52553,33976,0,0,62,62,0,1,0,1,0
50553,29146,0,0,102,102,0,1,0,1,0
38372,7144,0,0,146,146,0,1,0,1,0
19439,3389,19439,3389,293,223,70,4,0,3,1
56898,60958,0,0,125,125,0,1,0,1,0
48922,25812,0,0,156,156,0,1,0,1,0
55878,5564,1542,81,148,146,1,1,0,1,0
12101,24408,0,0,147,147,0,1,0,1,0
13788,61248,0,0,142,142,0,1,0,1,0
28001,26201,0,0,143,143,0,1,0,1,0
9551,3389,9551,3389,293,223,70,4,1,3,1
28928,28898,0,0,115,115,0,1,0,1,0
50789,32547,0,0,93,93,0,1,0,1,0
14283,61248,0,0,147,147,0,1,0,1,0
51542,3389,51542,3389,293,223,70,4,0,3,1
45370,60054,0,0,63,63,0,1,0,1,0
33538,17123,0,0,147,147,0,1,0,1,0
52152,32759,0,0,62,62,0,1,0,1,0
21898,25773,0,0,144,144,0,1,0,1,0
50659,31652,0,0,97,97,0,1,0,1,0
56882,52695,0,0,145,145,0,1,0,1,0
43870,5618,0,0,145,145,0,1,0,1,0
4675,25773,0,0,146,146,0,1,0,1,0
3920,25572,0,0,140,140,0,1,0,1,0
29859,34021,0,0,62,62,0,1,0,1,0
18052,24640,0,0,130,130,0,1,0,1,0
9165,3389,9165,3389,293,223,70,4,1,3,1
18231,18891,0,0,68,68,0,1,0,1,0
11067,3389,11067,3389,293,223,70,4,0,3,1
39360,6435,0,0,146,146,0,1,0,1,0
13447,3389,13447,3389,293,223,70,4,0,3,1
9226,61248,0,0,139,139,0,1,0,1,0
18079,7866,0,0,119,119,0,1,0,1,0
13048,9602,2427,899,186,167,18,1,0,1,0
4362,23015,0,0,151,151,0,1,0,1,0
10988,59292,0,0,139,139,0,1,0,1,0
32758,34021,0,0,74,74,0,1,0,1,0
47804,3389,47804,3389,293,223,70,4,0,3,1
11607,4941,8954,2767,266,209,57,3,0,2,0
18198,19947,0,0,80,80,0,1,0,1,0
17286,3389,17286,3389,293,223,70,4,0,3,1
49768,31652,0,0,126,126,0,1,0,1,0
15722,3389,15722,3389,293,223,70,4,1,3,1
18132,22062,0,0,103,103,0,1,0,1,0
51444,34021,0,0,89,89,0,1,0,1,0
30421,3389,30421,3389,293,223,70,4,0,3,1
9911,61248,0,0,139,139,0,1,0,1,0
49206,26394,0,0,146,146,0,1,0,1,0
51462,31652,0,0,68,68,0,1,0,1,0
49056,29284,0,0,150,150,0,1,0,1,0
22583,34021,0,0,62,62,0,1,0,1,0
11962,3389,11962,3389,293,223,70,4,1,3,1
42879,11324,0,0,149,149,0,1,0,1,0
46932,50724,0,0,92,92,0,1,0,1,0
28149,33333,0,0,69,69,0,1,0,1,0
49482,33729,0,0,135,135,0,1,0,1,0
40328,8210,0,0,145,145,0,1,0,1,0
24659,30364,0,0,97,97,0,1,0,1,0
49456,33753,0,0,136,136,0,1,0,1,0
49833,31652,0,0,124,124,0,1,0,1,0
4153,22943,0,0,151,151,0,1,0,1,0
5799,23516,0,0,149,149,0,1,0,1,0
17059,18852,0,0,68,68,0,1,0,1,0
29659,32560,0,0,77,77,0,1,0,1,0
49152,26393,0,0,148,148,0,1,0,1,0
22215,3389,22215,3389,293,223,70,4,0,3,1
37473,3389,37473,3389,293,223,70,4,1,3,1
52510,33502,0,0,127,127,0,1,0,1,0
3920,22862,0,0,152,152,0,1,0,1,0
20864,3389,20864,3389,293,223,70,4,0,3,1
9793,3389,9793,3389,293,223,70,4,1,3,1
9955,3389,9955,3389,293,223,70,4,1,3,1
49976,33281,0,0,119,119,0,1,0,1,0
21116,61248,0,0,156,156,0,1,0,1,0
38428,3389,38428,3389,293,223,70,4,1,3,1
22215,29195,0,0,109,109,0,1,0,1,0
17062,3389,17062,3389,293,223,70,4,0,3,1
31452,3389,31452,3389,293,223,70,4,0,3,1
7567,54131,0,0,141,141,0,1,0,1,0
50427,32874,0,0,105,105,0,1,0,1,0
50021,34021,0,0,124,124,0,1,0,1,0
11151,54428,0,0,119,119,0,1,0,1,0
48927,26334,0,0,155,155,0,1,0,1,0
10165,24250,0,0,137,137,0,1,0,1,0
12407,25874,0,0,138,138,0,1,0,1,0
52172,32818,0,0,62,62,0,1,0,1,0
6781,59529,0,0,139,139,0,1,0,1,0
54331,60747,0,0,110,110,0,1,0,1,0
17865,3389,17865,3389,293,223,70,4,0,3,1
3288,25397,0,0,144,144,0,1,0,1,0
14830,3389,14830,3389,293,223,70,4,0,3,1
61398,32126,0,0,78,78,0,1,0,1,0
50894,32854,0,0,103,103,0,1,0,1,0
33372,6891,0,0,126,126,0,1,0,1,0
49120,32768,0,0,147,147,0,1,0,1,0
49015,29368,0,0,152,152,0,1,0,1,0
50254,34021,0,0,119,119,0,1,0,1,0
17839,3389,17839,3389,293,223,70,4,0,3,1
35252,3389,35252,3389,293,223,70,4,0,3,1
48728,60287,0,0,79,79,0,1,0,1,0
9566,25773,0,0,150,150,0,1,0,1,0
52520,26703,0,0,77,77,0,1,0,1,0
17696,25773,0,0,143,143,0,1,0,1,0
16541,25773,0,0,145,145,0,1,0,1,0
11402,61248,0,0,142,142,0,1,0,1,0
2885,43162,0,0,146,146,0,1,0,1,0
11822,3389,11822,3389,293,223,70,4,0,3,1
51526,31880,0,0,70,70,0,1,0,1,0
8312,56241,0,0,143,143,0,1,0,1,0
8239,25773,0,0,156,156,0,1,0,1,0
45767,59400,0,0,63,63,0,1,0,1,0
49362,31652,0,0,139,139,0,1,0,1,0
29674,60860,0,0,127,127,0,1,0,1,0
49968,32212,0,0,126,126,0,1,0,1,0
18108,22849,0,0,111,111,0,1,0,1,0
24644,30938,0,0,94,94,0,1,0,1,0
14066,61248,0,0,142,142,0,1,0,1,0
17876,17608,0,0,70,70,0,1,0,1,0
11483,3389,11483,3389,293,223,70,4,1,3,1
18099,25926,0,0,141,141,0,1,0,1,0
59169,56910,0,0,131,131,0,1,0,1,0
11137,61248,0,0,142,142,0,1,0,1,0
33010,3389,33010,3389,293,223,70,4,0,3,1
1337,21926,0,0,156,156,0,1,0,1,0
52126,32681,0,0,62,62,0,1,0,1,0
1150,22051,0,0,156,156,0,1,0,1,0
12687,3389,12687,3389,293,223,70,4,0,3,1
36895,8789,0,0,145,145,0,1,0,1,0
53423,5618,0,0,145,145,0,1,0,1,0
29144,23898,0,0,147,147,0,1,0,1,0
29282,12422,0,0,114,114,0,1,0,1,0
26817,24658,0,0,135,135,0,1,0,1,0
12057,3389,12057,3389,293,223,70,4,1,3,1
7054,54144,0,0,143,143,0,1,0,1,0
7611,25773,0,0,155,155,0,1,0,1,0
17130,3389,17130,3389,293,223,70,4,0,3,1
23396,61182,0,0,153,153,0,1,0,1,0
1535,21473,0,0,156,156,0,1,0,1,0
17694,3389,17694,3389,293,223,70,4,0,3,1
32334,19113,0,0,147,147,0,1,0,1,0
18596,3389,18596,3389,293,223,70,4,0,3,1
1025,21855,0,0,156,156,0,1,0,1,0
49630,34021,0,0,134,134,0,1,0,1,0
20839,3389,20839,3389,293,223,70,4,0,3,1
51106,30719,0,0,100,100,0,1,0,1,0
49290,31742,0,0,142,142,0,1,0,1,0
9643,24637,0,0,142,142,0,1,0,1,0
28534,26925,0,0,135,135,0,1,0,1,0
11125,61248,0,0,139,139,0,1,0,1,0
21218,3389,21218,3389,293,223,70,4,0,3,1
51505,31899,0,0,70,70,0,1,0,1,0
32440,3389,32440,3389,293,223,70,4,0,3,1
29860,3917,0,0,98,98,0,1,0,1,0
23856,34021,0,0,62,62,0,1,0,1,0
29141,60887,0,0,130,130,0,1,0,1,0
37085,8067,0,0,146,146,0,1,0,1,0
4385,23024,0,0,151,151,0,1,0,1,0
39743,6160,0,0,146,146,0,1,0,1,0
49313,24552,0,0,156,156,0,1,0,1,0
52455,33800,0,0,62,62,0,1,0,1,0
13617,25773,0,0,139,139,0,1,0,1,0
36989,8136,0,0,146,146,0,1,0,1,0
51614,31800,0,0,67,67,0,1,0,1,0
21035,31376,0,0,87,87,0,1,0,1,0
19649,3389,19649,3389,293,223,70,4,0,3,1
11479,61248,0,0,142,142,0,1,0,1,0
11523,3389,11523,3389,293,223,70,4,1,3,1
2389,22608,0,0,157,157,0,1,0,1,0
46161,56504,0,0,73,73,0,1,0,1,0
8640,23158,0,0,114,114,0,1,0,1,0
31186,19336,0,0,147,147,0,1,0,1,0
29223,30375,0,0,100,100,0,1,0,1,0
16215,3389,16215,3389,293,223,70,4,0,3,1
3031,47440,0,0,144,144,0,1,0,1,0
18595,3389,18595,3389,293,223,70,4,0,3,1
27919,3389,27919,3389,293,223,70,4,0,3,1
29553,3389,29553,3389,293,223,70,4,0,3,1
1047,21891,0,0,156,156,0,1,0,1,0
24890,34021,0,0,62,62,0,1,0,1,0
56270,33284,0,0,62,62,0,1,0,1,0
49715,32037,0,0,132,132,0,1,0,1,0
16672,25773,0,0,144,144,0,1,0,1,0
15614,3389,15614,3389,293,223,70,4,0,3,1
11900,61248,0,0,140,140,0,1,0,1,0
18409,3389,18409,3389,293,223,70,4,0,3,1
49180,31652,0,0,145,145,0,1,0,1,0
12575,8849,3241,1201,199,174,24,2,0,1,0
22899,34021,0,0,62,62,0,1,0,1,0
8275,61248,0,0,139,139,0,1,0,1,0
51764,31622,0,0,62,62,0,1,0,1,0
9987,61248,0,0,141,141,0,1,0,1,0
21037,3389,21037,3389,293,223,70,4,0,3,1
52051,31652,0,0,130,130,0,1,0,1,0
29597,34021,0,0,62,62,0,1,0,1,0
27587,33574,0,0,66,66,0,1,0,1,0
22072,3389,22072,3389,293,223,70,4,0,3,1
27032,24819,0,0,137,137,0,1,0,1,0
48677,48753,0,0,62,62,0,1,0,1,0
4870,53973,0,0,141,141,0,1,0,1,0
28193,34021,0,0,62,62,0,1,0,1,0
18940,61248,0,0,152,152,0,1,0,1,0
4070,49171,0,0,144,144,0,1,0,1,0
19418,3389,19418,3389,293,223,70,4,0,3,1
5769,25773,0,0,149,149,0,1,0,1,0
50450,32546,0,0,114,114,0,1,0,1,0
47897,43484,0,0,115,115,0,1,0,1,0
10868,3389,10868,3389,293,223,70,4,0,3,1
14494,11907,0,0,147,147,0,1,0,1,0
19635,40923,0,0,82,82,0,1,0,1,0
29657,33817,0,0,63,63,0,1,0,1,0
48032,34021,0,0,141,141,0,1,0,1,0
19529,3389,19529,3389,293,223,70,4,0,3,1
49103,30368,0,0,148,148,0,1,0,1,0
13192,25773,0,0,139,139,0,1,0,1,0
41472,3389,41472,3389,293,223,70,4,0,3,1
18214,19456,0,0,75,75,0,1,0,1,0
51178,31652,0,0,75,75,0,1,0,1,0
12221,61248,0,0,139,139,0,1,0,1,0
10038,56435,0,0,125,125,0,1,0,1,0
11169,14298,0,0,150,150,0,1,0,1,0
59652,3389,59652,3389,293,223,70,4,0,3,1
51505,34021,0,0,88,88,0,1,0,1,0
24373,31321,0,0,90,90,0,1,0,1,0
58487,31652,0,0,66,66,0,1,0,1,0
23941,31838,0,0,82,82,0,1,0,1,0
25400,34021,0,0,62,62,0,1,0,1,0
26079,716,0,0,68,68,0,1,0,1,0
13867,15631,0,0,145,145,0,1,0,1,0
18184,20397,0,0,85,85,0,1,0,1,0
52441,33775,0,0,63,63,0,1,0,1,0
14586,12062,0,0,145,145,0,1,0,1,0
13666,3389,13666,3389,293,223,70,4,0,3,1
13806,25773,0,0,140,140,0,1,0,1,0
6684,59248,0,0,139,139,0,1,0,1,0
63939,31756,0,0,62,62,0,1,0,1,0
9479,61248,0,0,141,141,0,1,0,1,0
24385,3389,24385,3389,293,223,70,4,0,3,1
6351,58279,0,0,140,140,0,1,0,1,0
40780,8133,0,0,145,145,0,1,0,1,0
18124,3389,18124,3389,293,223,70,4,0,3,1
52104,32618,0,0,62,62,0,1,0,1,0
8545,61248,0,0,140,140,0,1,0,1,0
54813,10719,0,0,130,130,0,1,0,1,0
12502,3389,12502,3389,293,223,70,4,0,3,1
34258,34021,0,0,80,80,0,1,0,1,0
21373,3389,21373,3389,293,223,70,4,0,3,1
9822,61248,0,0,139,139,0,1,0,1,0
12133,25773,0,0,139,139,0,1,0,1,0
9948,3389,9948,3389,293,223,70,4,0,3,1
12065,61248,0,0,139,139,0,1,0,1,0
23652,3389,23652,3389,293,223,70,4,0,3,1
11830,3389,11830,3389,293,223,70,4,1,3,1
15697,61248,0,0,145,145,0,1,0,1,0
48994,27868,0,0,153,153,0,1,0,1,0
51598,31652,0,0,67,67,0,1,0,1,0
19357,1396,4517,1395,157,128,28,2,0,1,0
21112,25773,0,0,144,144,0,1,0,1,0
54799,33147,0,0,115,115,0,1,0,1,0
20694,60145,0,0,157,157,0,1,0,1,0
24914,23233,0,0,118,118,0,1,0,1,0
40488,3389,40488,3389,293,223,70,4,0,3,1
11933,3389,11933,3389,293,223,70,4,0,3,1
52329,31652,0,0,62,62,0,1,0,1,0
4671,53396,0,0,142,142,0,1,0,1,0
8752,61248,0,0,139,139,0,1,0,1,0
25375,34021,0,0,62,62,0,1,0,1,0
4236,25773,0,0,145,145,0,1,0,1,0
19580,1343,4345,1342,153,125,27,2,0,1,0
6768,59492,0,0,139,139,0,1,0,1,0
40876,5618,0,0,145,145,0,1,0,1,0
21280,20510,0,0,87,87,0,1,0,1,0
30579,11738,0,0,120,120,0,1,0,1,0
4819,53823,0,0,141,141,0,1,0,1,0
37036,3389,37036,3389,293,223,70,4,0,3,1
52390,33683,0,0,63,63,0,1,0,1,0
56655,5356,7509,397,162,154,8,1,0,1,0
52221,33377,0,0,64,64,0,1,0,1,0
47521,45053,0,0,106,106,0,1,0,1,0
13160,56743,0,0,129,129,0,1,0,1,0
38057,7370,0,0,146,146,0,1,0,1,0
32306,2603,0,0,100,100,0,1,0,1,0
52103,26705,0,0,85,85,0,1,0,1,0
48901,5618,0,0,145,145,0,1,0,1,0
11070,61248,0,0,142,142,0,1,0,1,0
38800,6837,0,0,146,146,0,1,0,1,0
49196,26504,0,0,146,146,0,1,0,1,0
59011,61132,0,0,137,137,0,1,0,1,0
21661,3389,21661,3389,293,223,70,4,0,3,1
8286,61248,0,0,139,139,0,1,0,1,0
50073,32993,0,0,113,113,0,1,0,1,0
42111,3389,42111,3389,293,223,70,4,0,3,1
26910,1420,0,0,75,75,0,1,0,1,0
14704,22717,0,0,107,107,0,1,0,1,0
48975,25921,0,0,154,154,0,1,0,1,0
9513,3389,9513,3389,293,223,70,4,1,3,1
40904,5618,0,0,145,145,0,1,0,1,0
6682,23823,0,0,147,147,0,1,0,1,0
19799,3389,19799,3389,293,223,70,4,0,3,1
18248,18369,0,0,63,63,0,1,0,1,0
40645,8156,0,0,145,145,0,1,0,1,0
64206,33518,0,0,67,67,0,1,0,1,0
6361,25773,0,0,151,151,0,1,0,1,0
41472,34021,0,0,112,112,0,1,0,1,0
11077,6466,5816,2155,240,195,44,2,0,2,0
14133,23437,0,0,115,115,0,1,0,1,0
12385,25773,0,0,139,139,0,1,0,1,0
14672,3389,14672,3389,293,223,70,4,0,3,1
38877,6781,0,0,146,146,0,1,0,1,0
50292,28612,0,0,111,111,0,1,0,1,0
15992,14432,0,0,113,113,0,1,0,1,0
16675,15584,0,0,97,97,0,1,0,1,0
5552,55957,0,0,141,141,0,1,0,1,0
33664,60655,0,0,111,111,0,1,0,1,0
24716,31234,0,0,89,89,0,1,0,1,0
13082,26421,0,0,132,132,0,1,0,1,0
1293,22003,0,0,157,157,0,1,0,1,0
24900,3389,24900,3389,293,223,70,4,0,3,1
8714,61248,0,0,140,140,0,1,0,1,0
37857,3389,37857,3389,293,223,70,4,1,3,1
49015,29380,0,0,152,152,0,1,0,1,0
18953,61248,0,0,152,152,0,1,0,1,0
53400,20822,0,0,96,96,0,1,0,1,0
3249,47804,0,0,144,144,0,1,0,1,0
21890,25773,0,0,144,144,0,1,0,1,0
37934,3389,37934,3389,293,223,70,4,1,3,1
25415,34021,0,0,62,62,0,1,0,1,0
11283,61248,0,0,139,139,0,1,0,1,0
50890,32073,0,0,85,85,0,1,0,1,0
13487,24252,0,0,123,123,0,1,0,1,0
57162,60980,0,0,126,126,0,1,0,1,0
7388,53862,0,0,141,141,0,1,0,1,0
46271,55278,0,0,76,76,0,1,0,1,0
23068,34021,0,0,62,62,0,1,0,1,0
9919,58919,0,0,143,143,0,1,0,1,0
37264,3389,37264,3389,293,223,70,4,1,3,1
51295,31652,0,0,71,71,0,1,0,1,0
17148,25773,0,0,144,144,0,1,0,1,0
14852,3389,14852,3389,293,223,70,4,0,3,1
29602,32273,0,0,80,80,0,1,0,1,0
26307,28592,0,0,118,118,0,1,0,1,0
26348,24306,0,0,131,131,0,1,0,1,0
9363,25773,0,0,155,155,0,1,0,1,0
55995,60884,0,0,120,120,0,1,0,1,0
21195,3389,21195,3389,293,223,70,4,0,3,1
5068,35903,0,0,150,150,0,1,0,1,0
21807,61248,0,0,158,158,0,1,0,1,0
52122,32669,0,0,62,62,0,1,0,1,0
51573,6311,0,0,145,145,0,1,0,1,0
28266,27646,0,0,128,128,0,1,0,1,0
29180,3389,29180,3389,293,223,70,4,0,3,1
63534,38439,0,0,81,81,0,1,0,1,0
51091,31219,0,0,78,78,0,1,0,1,0
29009,34021,0,0,62,62,0,1,0,1,0
17656,3389,17656,3389,293,223,70,4,0,3,1
10473,22220,0,0,104,104,0,1,0,1,0
14172,2968,11039,2968,264,203,61,3,0,2,0
48712,37372,0,0,135,135,0,1,0,1,0
18145,3389,18145,3389,293,223,70,4,0,3,1
38004,9742,0,0,146,146,0,1,0,1,0
33686,3389,33686,3389,293,223,70,4,0,3,1
7805,61248,0,0,139,139,0,1,0,1,0
13048,3389,13048,3389,293,223,70,4,0,3,1
20453,19891,0,0,80,80,0,1,0,1,0
10798,23779,0,0,131,131,0,1,0,1,0
10739,60285,0,0,143,143,0,1,0,1,0
25267,31683,0,0,84,84,0,1,0,1,0
18447,3389,18447,3389,293,223,70,4,0,3,1
28541,26955,0,0,135,135,0,1,0,1,0
48926,33563,0,0,140,140,0,1,0,1,0
13377,61248,0,0,147,147,0,1,0,1,0
45932,58055,0,0,67,67,0,1,0,1,0
10230,3389,10230,3389,293,223,70,4,0,3,1
5976,25773,0,0,141,141,0,1,0,1,0
57599,32714,0,0,99,99,0,1,0,1,0
29176,34021,0,0,62,62,0,1,0,1,0
51064,32298,0,0,84,84,0,1,0,1,0
15268,3389,15268,3389,293,223,70,4,0,3,1
27636,884,0,0,75,75,0,1,0,1,0
48929,26389,0,0,155,155,0,1,0,1,0
1952,22367,0,0,157,157,0,1,0,1,0
47657,43944,0,0,109,109,0,1,0,1,0
60443,4343,36592,1937,229,189,40,2,0,2,0
2855,48114,0,0,144,144,0,1,0,1,0
3127,47434,0,0,144,144,0,1,0,1,0
58135,55727,0,0,145,145,0,1,0,1,0
54148,15833,0,0,112,112,0,1,0,1,0
29296,34021,0,0,62,62,0,1,0,1,0
49466,34021,0,0,138,138,0,1,0,1,0
48961,27112,0,0,154,154,0,1,0,1,0
19583,3389,19583,3389,293,223,70,4,0,3,1
11584,61248,0,0,144,144,0,1,0,1,0
49781,33321,0,0,124,124,0,1,0,1,0
43403,5618,0,0,145,145,0,1,0,1,0
2339,23911,0,0,149,149,0,1,0,1,0
18513,3389,18513,3389,293,223,70,4,0,3,1
48723,37297,0,0,135,135,0,1,0,1,0
37306,8720,0,0,145,145,0,1,0,1,0
15013,2428,7856,2427,227,177,50,3,0,2,0
61713,4004,46344,2453,252,201,50,3,0,2,0
49195,31652,0,0,144,144,0,1,0,1,0
33171,3389,33171,3389,293,223,70,4,0,3,1
22866,34021,0,0,62,62,0,1,0,1,0
14560,25773,0,0,140,140,0,1,0,1,0
23654,3389,23654,3389,293,223,70,4,0,3,1
10728,3389,10728,3389,293,223,70,4,1,3,1
40558,8171,0,0,145,145,0,1,0,1,0
49772,27724,0,0,134,134,0,1,0,1,0
7752,54411,0,0,141,141,0,1,0,1,0
31594,5386,0,0,112,112,0,1,0,1,0
16249,3389,16249,3389,293,223,70,4,0,3,1
10392,25773,0,0,147,147,0,1,0,1,0
24864,3389,24864,3389,293,223,70,4,0,3,1
16882,3389,16882,3389,293,223,70,4,0,3,1
11431,4513,9508,2938,273,213,60,3,0,2,0
47463,53337,0,0,62,62,0,1,0,1,0
50553,32760,0,0,101,101,0,1,0,1,0
35099,14543,0,0,146,146,0,1,0,1,0
10358,61248,0,0,139,139,0,1,0,1,0
33386,34021,0,0,77,77,0,1,0,1,0
51040,32320,0,0,85,85,0,1,0,1,0
27381,27076,0,0,134,134,0,1,0,1,0
60609,59855,0,0,141,141,0,1,0,1,0
24769,25773,0,0,146,146,0,1,0,1,0
17740,3389,17740,3389,293,223,70,4,0,3,1
51377,30990,0,0,73,73,0,1,0,1,0
51224,33083,0,0,95,95,0,1,0,1,0
11564,25773,0,0,139,139,0,1,0,1,0
28299,26026,0,0,145,145,0,1,0,1,0
49160,33498,0,0,146,146,0,1,0,1,0
51808,33487,0,0,80,80,0,1,0,1,0
15326,61248,0,0,148,148,0,1,0,1,0
17206,3389,17206,3389,293,223,70,4,1,3,1
19882,19463,0,0,75,75,0,1,0,1,0
29593,32230,0,0,80,80,0,1,0,1,0
4810,23946,0,0,157,157,0,1,0,1,0
10994,3389,10994,3389,293,223,70,4,1,3,1
21257,61248,0,0,157,157,0,1,0,1,0
40437,5663,0,0,146,146,0,1,0,1,0
8014,24287,0,0,145,145,0,1,0,1,0
16008,28791,0,0,110,110,0,1,0,1,0
28062,26114,0,0,144,144,0,1,0,1,0
14722,61248,0,0,143,143,0,1,0,1,0
18463,26600,0,0,134,134,0,1,0,1,0
14335,25773,0,0,148,148,0,1,0,1,0
62774,3720,54493,2884,270,211,59,3,0,2,0
21625,3389,21625,3389,293,223,70,4,0,3,1
15532,61248,0,0,145,145,0,1,0,1,0
4655,25773,0,0,146,146,0,1,0,1,0
6408,52383,0,0,142,142,0,1,0,1,0
6628,30719,0,0,154,154,0,1,0,1,0
54229,39757,0,0,79,79,0,1,0,1,0
41027,8092,0,0,145,145,0,1,0,1,0
51925,34021,0,0,78,78,0,1,0,1,0
23017,33235,0,0,70,70,0,1,0,1,0
11571,61248,0,0,141,141,0,1,0,1,0
13427,20709,0,0,88,88,0,1,0,1,0
18216,3389,18216,3389,293,223,70,4,0,3,1
10178,61248,0,0,139,139,0,1,0,1,0
4905,54075,0,0,141,141,0,1,0,1,0
47056,48860,0,0,95,95,0,1,0,1,0
36856,8796,0,0,145,145,0,1,0,1,0
18194,58226,0,0,156,156,0,1,0,1,0
12098,25708,0,0,139,139,0,1,0,1,0
29402,33641,0,0,65,65,0,1,0,1,0
50464,34021,0,0,113,113,0,1,0,1,0
9330,3389,9330,3389,293,223,70,4,0,3,1
11511,61248,0,0,142,142,0,1,0,1,0
17582,3389,17582,3389,293,223,70,4,0,3,1
11948,3389,11948,3389,293,223,70,4,1,3,1
14119,20355,0,0,84,84,0,1,0,1,0
18787,3389,18787,3389,293,223,70,4,0,3,1
28819,34021,0,0,62,62,0,1,0,1,0
29408,23948,0,0,147,147,0,1,0,1,0
3245,25329,0,0,144,144,0,1,0,1,0
13502,17966,0,0,144,144,0,1,0,1,0
7285,60997,0,0,139,139,0,1,0,1,0
2939,42983,0,0,146,146,0,1,0,1,0
49984,28464,0,0,118,118,0,1,0,1,0
28261,27893,0,0,125,125,0,1,0,1,0
5655,23466,0,0,149,149,0,1,0,1,0
6176,25773,0,0,141,141,0,1,0,1,0
52198,32895,0,0,62,62,0,1,0,1,0
50659,20546,0,0,153,153,0,1,0,1,0
42523,10471,0,0,148,148,0,1,0,1,0
17028,19785,0,0,77,77,0,1,0,1,0
57464,3389,57464,3389,293,223,70,4,0,3,1
11868,3389,11868,3389,293,223,70,4,0,3,1
63764,31652,0,0,62,62,0,1,0,1,0
19765,29018,0,0,111,111,0,1,0,1,0
9580,3389,9580,3389,293,223,70,4,1,3,1
13856,55044,0,0,124,124,0,1,0,1,0
28164,32607,0,0,76,76,0,1,0,1,0
20233,5498,0,0,101,101,0,1,0,1,0
23454,34021,0,0,62,62,0,1,0,1,0
47962,41450,0,0,117,117,0,1,0,1,0
18120,22446,0,0,107,107,0,1,0,1,0
8769,61248,0,0,139,139,0,1,0,1,0
13428,9352,3235,999,190,170,20,1,0,1,0
20483,17064,0,0,72,72,0,1,0,1,0
15388,3389,15388,3389,293,223,70,4,0,3,1
49005,28121,0,0,152,152,0,1,0,1,0
17175,16427,0,0,86,86,0,1,0,1,0
9555,3389,9555,3389,293,223,70,4,1,3,1
51601,31830,0,0,87,87,0,1,0,1,0
1419,22472,0,0,154,154,0,1,0,1,0
63936,31652,0,0,62,62,0,1,0,1,0
10994,25773,0,0,144,144,0,1,0,1,0
52324,33270,0,0,62,62,0,1,0,1,0
22604,3389,22604,3389,293,223,70,4,0,3,1
25064,34021,0,0,62,62,0,1,0,1,0
53117,22716,0,0,90,90,0,1,0,1,0
14485,61248,0,0,147,147,0,1,0,1,0
50766,30410,0,0,89,89,0,1,0,1,0
49728,31652,0,0,127,127,0,1,0,1,0
47647,45361,0,0,109,109,0,1,0,1,0
51661,32367,0,0,68,68,0,1,0,1,0
13176,20053,0,0,142,142,0,1,0,1,0
51460,34021,0,0,89,89,0,1,0,1,0
7694,61248,0,0,139,139,0,1,0,1,0
5312,24223,0,0,157,157,0,1,0,1,0
25978,14165,0,0,98,98,0,1,0,1,0
17460,16907,0,0,79,79,0,1,0,1,0
47421,53498,0,0,62,62,0,1,0,1,0
48979,27517,0,0,153,153,0,1,0,1,0
55226,60821,0,0,115,115,0,1,0,1,0
49055,29266,0,0,150,150,0,1,0,1,0
40306,5937,0,0,146,146,0,1,0,1,0
41278,8049,0,0,145,145,0,1,0,1,0
29473,34021,0,0,62,62,0,1,0,1,0
11779,61248,0,0,141,141,0,1,0,1,0
24090,25773,0,0,145,145,0,1,0,1,0
49338,31652,0,0,139,139,0,1,0,1,0
8600,61248,0,0,140,140,0,1,0,1,0
28217,30039,0,0,103,103,0,1,0,1,0
17822,3389,17822,3389,293,223,70,4,0,3,1
7824,25773,0,0,156,156,0,1,0,1,0
28272,1118,0,0,78,78,0,1,0,1,0
2657,24410,0,0,147,147,0,1,0,1,0
12352,3389,12352,3389,293,223,70,4,1,3,1
49571,27274,0,0,139,139,0,1,0,1,0
21976,33628,0,0,65,65,0,1,0,1,0
50477,32828,0,0,103,103,0,1,0,1,0
15300,3389,15300,3389,293,223,70,4,0,3,1
50885,31652,0,0,85,85,0,1,0,1,0
16438,2360,8777,2360,222,174,48,3,0,2,0
47057,48849,0,0,95,95,0,1,0,1,0
35646,3389,35646,3389,293,223,70,4,0,3,1
36445,60512,0,0,100,100,0,1,0,1,0
20306,3389,20306,3389,293,223,70,4,0,3,1
48255,24221,0,0,156,156,0,1,0,1,0
17780,3389,17780,3389,293,223,70,4,0,3,1
49933,33150,0,0,118,118,0,1,0,1,0
14934,25773,0,0,140,140,0,1,0,1,0
2362,46681,0,0,144,144,0,1,0,1,0
14229,3389,14229,3389,293,223,70,4,0,3,1
17256,22797,0,0,144,144,0,1,0,1,0
3734,19835,0,0,155,155,0,1,0,1,0
11960,3389,11960,3389,293,223,70,4,1,3,1
23126,3389,23126,3389,293,223,70,4,1,3,1
49259,31652,0,0,142,142,0,1,0,1,0
17516,25773,0,0,142,142,0,1,0,1,0
12254,3389,12254,3389,293,223,70,4,0,3,1
52447,27187,0,0,76,76,0,1,0,1,0
36292,3389,36292,3389,293,223,70,4,0,3,1
17960,17750,0,0,68,68,0,1,0,1,0
2902,22507,0,0,153,153,0,1,0,1,0
49942,33313,0,0,120,120,0,1,0,1,0
14426,3389,14426,3389,293,223,70,4,0,3,1
11159,3389,11159,3389,293,223,70,4,1,3,1
49088,30022,0,0,149,149,0,1,0,1,0
22166,29155,0,0,109,109,0,1,0,1,0
12374,22608,0,0,117,117,0,1,0,1,0
8659,25368,0,0,151,151,0,1,0,1,0
29389,3389,29389,3389,293,223,70,4,1,3,1
38481,3389,38481,3389,293,223,70,4,0,3,1
13535,2778,8992,2778,251,194,57,3,0,2,0
13999,61248,0,0,142,142,0,1,0,1,0
3961,22876,0,0,152,152,0,1,0,1,0
11762,3389,11762,3389,293,223,70,4,0,3,1
48948,25865,0,0,155,155,0,1,0,1,0
28748,27997,0,0,124,124,0,1,0,1,0
57274,5191,12257,648,173,159,13,1,0,1,0
34885,3389,34885,3389,293,223,70,4,0,3,1
51311,31652,0,0,71,71,0,1,0,1,0
25333,37,0,0,62,62,0,1,0,1,0
34191,7584,0,0,133,133,0,1,0,1,0
45310,17155,0,0,152,152,0,1,0,1,0
9605,3389,9605,3389,293,223,70,4,1,3,1
21177,31639,0,0,85,85,0,1,0,1,0
11218,3389,11218,3389,293,223,70,4,1,3,1
37428,4487,0,0,129,129,0,1,0,1,0
45888,58546,0,0,66,66,0,1,0,1,0
31246,5090,0,0,109,109,0,1,0,1,0
28233,25873,0,0,146,146,0,1,0,1,0
23149,495,1602,495,95,85,10,1,0,1,0
20628,1094,3540,1093,136,113,22,1,0,1,0
23381,32722,0,0,75,75,0,1,0,1,0
17147,3389,17147,3389,293,223,70,4,0,3,1
22274,33674,0,0,65,65,0,1,0,1,0
4885,25773,0,0,147,147,0,1,0,1,0
3528,25772,0,0,143,143,0,1,0,1,0
16429,25406,0,0,144,144,0,1,0,1,0
22167,61246,0,0,158,158,0,1,0,1,0
18017,25747,0,0,142,142,0,1,0,1,0
28593,34021,0,0,62,62,0,1,0,1,0
14696,22728,0,0,107,107,0,1,0,1,0
49664,27329,0,0,131,131,0,1,0,1,0
13978,3389,13978,3389,293,223,70,4,0,3,1
16915,19927,0,0,79,79,0,1,0,1,0
28280,26963,0,0,135,135,0,1,0,1,0
13107,24733,0,0,128,128,0,1,0,1,0
16335,3389,16335,3389,293,223,70,4,0,3,1
5506,25773,0,0,143,143,0,1,0,1,0
12614,3389,12614,3389,293,223,70,4,0,3,1
11948,3389,11948,3389,293,223,70,4,0,3,1
49289,31652,0,0,141,141,0,1,0,1,0
12863,22058,0,0,141,141,0,1,0,1,0
10974,3389,10974,3389,293,223,70,4,1,3,1
49482,34021,0,0,138,138,0,1,0,1,0
52011,32450,0,0,64,64,0,1,0,1,0
14606,3389,14606,3389,293,223,70,4,0,3,1
26485,28340,0,0,121,121,0,1,0,1,0
3157,25192,0,0,145,145,0,1,0,1,0
1744,21317,0,0,156,156,0,1,0,1,0
47983,60226,0,0,74,74,0,1,0,1,0
14421,3389,14421,3389,293,223,70,4,0,3,1
27891,2250,0,0,83,83,0,1,0,1,0
24334,30139,0,0,100,100,0,1,0,1,0
4571,53104,0,0,142,142,0,1,0,1,0
28258,28036,0,0,124,124,0,1,0,1,0
52355,33866,0,0,67,67,0,1,0,1,0
13729,61248,0,0,147,147,0,1,0,1,0
59340,4638,28125,1489,210,179,30,2,0,1,0
35674,3389,35674,3389,293,223,70,4,0,3,1
38734,6884,0,0,146,146,0,1,0,1,0
12234,25773,0,0,151,151,0,1,0,1,0
9447,25773,0,0,155,155,0,1,0,1,0
27678,25304,0,0,142,142,0,1,0,1,0
28249,28450,0,0,120,120,0,1,0,1,0
9991,3389,9991,3389,293,223,70,4,1,3,1
49449,33759,0,0,136,136,0,1,0,1,0
10172,61248,0,0,141,141,0,1,0,1,0
26665,24545,0,0,133,133,0,1,0,1,0
17846,3389,17846,3389,293,223,70,4,0,3,1
12840,9272,2784,1032,192,170,21,1,0,1,0
16898,15959,0,0,92,92,0,1,0,1,0
50214,31652,0,0,108,108,0,1,0,1,0
23283,34021,0,0,62,62,0,1,0,1,0
26168,3389,26168,3389,293,223,70,4,0,3,1
13242,2848,9217,2848,256,197,58,3,0,2,0
64083,31652,0,0,62,62,0,1,0,1,0
43248,34021,0,0,120,120,0,1,0,1,0
50345,31652,0,0,104,104,0,1,0,1,0
15645,25773,0,0,141,141,0,1,0,1,0
38815,8465,0,0,145,145,0,1,0,1,0
37340,10839,0,0,146,146,0,1,0,1,0
19195,3389,19195,3389,293,223,70,4,0,3,1
20955,3389,20955,3389,293,223,70,4,0,3,1
14389,3389,14389,3389,293,223,70,4,0,3,1
49025,29703,0,0,151,151,0,1,0,1,0
53364,12500,0,0,149,149,0,1,0,1,0
32677,3389,32677,3389,293,223,70,4,0,3,1
12245,61248,0,0,139,139,0,1,0,1,0
11714,61248,0,0,141,141,0,1,0,1,0
12304,3071,9938,3071,271,207,63,3,0,2,0
32538,16317,0,0,146,146,0,1,0,1,0
52411,33526,0,0,62,62,0,1,0,1,0
50737,30339,0,0,90,90,0,1,0,1,0
18656,61248,0,0,154,154,0,1,0,1,0
49562,31931,0,0,136,136,0,1,0,1,0
49190,26488,0,0,146,146,0,1,0,1,0
49752,27888,0,0,126,126,0,1,0,1,0
52499,33878,0,0,62,62,0,1,0,1,0
23491,32565,0,0,77,77,0,1,0,1,0
5956,25773,0,0,150,150,0,1,0,1,0
18900,3389,18900,3389,293,223,70,4,0,3,1
14551,25773,0,0,140,140,0,1,0,1,0
7574,61248,0,0,139,139,0,1,0,1,0
61677,52036,0,0,119,119,0,1,0,1,0
34561,9637,0,0,139,139,0,1,0,1,0
1715,22935,0,0,153,153,0,1,0,1,0
50253,36665,0,0,145,145,0,1,0,1,0
14103,25773,0,0,148,148,0,1,0,1,0
4534,25773,0,0,142,142,0,1,0,1,0
28358,26039,0,0,145,145,0,1,0,1,0
51144,30354,0,0,82,82,0,1,0,1,0
39949,34021,0,0,105,105,0,1,0,1,0
12153,3389,12153,3389,293,223,70,4,1,3,1
27857,966,0,0,76,76,0,1,0,1,0
5157,50983,0,0,144,144,0,1,0,1,0
54687,11463,0,0,128,128,0,1,0,1,0
11462,23286,0,0,125,125,0,1,0,1,0
20171,61248,0,0,156,156,0,1,0,1,0
11992,3389,11992,3389,293,223,70,4,1,3,1
13190,8775,3983,1230,200,175,25,2,0,1,0
51244,31652,0,0,72,72,0,1,0,1,0
25929,32873,0,0,72,72,0,1,0,1,0
30593,60813,0,0,124,124,0,1,0,1,0
29906,33799,0,0,64,64,0,1,0,1,0
12064,3389,12064,3389,293,223,70,4,1,3,1
12861,3389,12861,3389,293,223,70,4,0,3,1
55625,33020,0,0,110,110,0,1,0,1,0
13746,3389,13746,3389,293,223,70,4,0,3,1
16617,3389,16617,3389,293,223,70,4,0,3,1
37171,60475,0,0,97,97,0,1,0,1,0
20722,3389,20722,3389,293,223,70,4,0,3,1
11094,3389,11094,3389,293,223,70,4,0,3,1
44442,15073,0,0,151,151,0,1,0,1,0
11896,25773,0,0,151,151,0,1,0,1,0
3223,49184,0,0,143,143,0,1,0,1,0
25099,3389,25099,3389,293,223,70,4,0,3,1
50219,28726,0,0,122,122,0,1,0,1,0
48607,5618,0,0,145,145,0,1,0,1,0
27648,26700,0,0,138,138,0,1,0,1,0
11955,61248,0,0,143,143,0,1,0,1,0
3314,41735,0,0,147,147,0,1,0,1,0
3897,22854,0,0,152,152,0,1,0,1,0
6947,25773,0,0,153,153,0,1,0,1,0
51550,34021,0,0,87,87,0,1,0,1,0
10903,14495,0,0,150,150,0,1,0,1,0
50643,31652,0,0,137,137,0,1,0,1,0
11837,3389,11837,3389,293,223,70,4,0,3,1
8511,61248,0,0,140,140,0,1,0,1,0
36840,8243,0,0,146,146,0,1,0,1,0
51392,31882,0,0,71,71,0,1,0,1,0
59449,3389,59449,3389,293,223,70,4,0,3,1
11105,3389,11105,3389,293,223,70,4,1,3,1
46923,60139,0,0,68,68,0,1,0,1,0
52465,27070,0,0,76,76,0,1,0,1,0
4306,49212,0,0,143,143,0,1,0,1,0
48064,5618,0,0,145,145,0,1,0,1,0
18706,3389,18706,3389,293,223,70,4,0,3,1
11040,3389,11040,3389,293,223,70,4,1,3,1
38926,3389,38926,3389,293,223,70,4,0,3,1
31493,2304,0,0,96,96,0,1,0,1,0
29078,29649,0,0,107,107,0,1,0,1,0
27341,25051,0,0,139,139,0,1,0,1,0
22642,34021,0,0,62,62,0,1,0,1,0
19570,1520,5651,1519,165,134,31,2,0,1,0
19261,3389,19261,3389,293,223,70,4,0,3,1
34708,3389,34708,3389,293,223,70,4,0,3,1
48818,36581,0,0,137,137,0,1,0,1,0
9560,3389,9560,3389,293,223,70,4,1,3,1
17166,19611,0,0,76,76,0,1,0,1,0
12883,59646,0,0,134,134,0,1,0,1,0
19038,3389,19038,3389,293,223,70,4,0,3,1
50633,30081,0,0,94,94,0,1,0,1,0
21764,61248,0,0,158,158,0,1,0,1,0
51668,31751,0,0,65,65,0,1,0,1,0
13392,3389,13392,3389,293,223,70,4,0,3,1
22146,21159,0,0,95,95,0,1,0,1,0
18470,3389,18470,3389,293,223,70,4,0,3,1
15746,3389,15746,3389,293,223,70,4,0,3,1
16396,3389,16396,3389,293,223,70,4,0,3,1
50062,28659,0,0,115,115,0,1,0,1,0
49058,30751,0,0,150,150,0,1,0,1,0
20196,3389,20196,3389,293,223,70,4,0,3,1
37088,34021,0,0,93,93,0,1,0,1,0
37485,7780,0,0,146,146,0,1,0,1,0
54060,16418,0,0,110,110,0,1,0,1,0
9873,25773,0,0,149,149,0,1,0,1,0
16024,25773,0,0,141,141,0,1,0,1,0
28622,27363,0,0,131,131,0,1,0,1,0
62412,46649,0,0,104,104,0,1,0,1,0
49048,29109,0,0,150,150,0,1,0,1,0
20163,29757,0,0,103,103,0,1,0,1,0
9992,3389,9992,3389,293,223,70,4,1,3,1
29349,1515,0,0,84,84,0,1,0,1,0
18457,3389,18457,3389,293,223,70,4,0,3,1
22304,25773,0,0,145,145,0,1,0,1,0
60373,32466,0,0,62,62,0,1,0,1,0
37682,3389,37682,3389,293,223,70,4,1,3,1
57754,52120,0,0,119,119,0,1,0,1,0
51473,31652,0,0,67,67,0,1,0,1,0
9780,22575,0,0,108,108,0,1,0,1,0
15652,61248,0,0,149,149,0,1,0,1,0
55646,5801,0,0,144,144,0,1,0,1,0
23699,22323,0,0,108,108,0,1,0,1,0
58885,32763,0,0,62,62,0,1,0,1,0
24979,34021,0,0,62,62,0,1,0,1,0
17151,61248,0,0,151,151,0,1,0,1,0
19061,3389,19061,3389,293,223,70,4,0,3,1
18053,24610,0,0,130,130,0,1,0,1,0
52332,27956,0,0,73,73,0,1,0,1,0
8149,24334,0,0,145,145,0,1,0,1,0
6541,58834,0,0,139,139,0,1,0,1,0
13147,61248,0,0,145,145,0,1,0,1,0
12459,25864,0,0,138,138,0,1,0,1,0
20412,3389,20412,3389,293,223,70,4,0,3,1
12468,7025,6252,1932,230,190,39,2,0,2,0
58552,31652,0,0,94,94,0,1,0,1,0
11643,61248,0,0,139,139,0,1,0,1,0
13932,23692,0,0,117,117,0,1,0,1,0
29253,3389,29253,3389,293,223,70,4,0,3,1
50759,29939,0,0,109,109,0,1,0,1,0
14250,23290,0,0,113,113,0,1,0,1,0
51666,31652,0,0,65,65,0,1,0,1,0
38511,4886,0,0,135,135,0,1,0,1,0
11570,61248,0,0,141,141,0,1,0,1,0
3336,25472,0,0,144,144,0,1,0,1,0
9597,24838,0,0,143,143,0,1,0,1,0
23233,537,1996,536,98,87,11,1,0,1,0
14123,24874,0,0,146,146,0,1,0,1,0
27229,27291,0,0,132,132,0,1,0,1,0
33491,34021,0,0,77,77,0,1,0,1,0
13771,61248,0,0,146,146,0,1,0,1,0
58290,3389,58290,3389,293,223,70,4,0,3,1
6309,25773,0,0,141,141,0,1,0,1,0
17474,3389,17474,3389,293,223,70,4,0,3,1
52131,32698,0,0,62,62,0,1,0,1,0
34620,11667,0,0,146,146,0,1,0,1,0
18274,3389,18274,3389,293,223,70,4,0,3,1
28267,27609,0,0,128,128,0,1,0,1,0
11968,3389,11968,3389,293,223,70,4,1,3,1
19182,61248,0,0,153,153,0,1,0,1,0
11891,5628,8063,2491,254,203,51,3,0,2,0
12193,61248,0,0,139,139,0,1,0,1,0
21529,20697,0,0,90,90,0,1,0,1,0
50432,34021,0,0,114,114,0,1,0,1,0
14145,61248,0,0,142,142,0,1,0,1,0
50389,29108,0,0,118,118,0,1,0,1,0
17750,3389,17750,3389,293,223,70,4,0,3,1
58779,55554,0,0,127,127,0,1,0,1,0
46814,5618,0,0,145,145,0,1,0,1,0
51400,34021,0,0,90,90,0,1,0,1,0
50989,31652,0,0,81,81,0,1,0,1,0
12529,61248,0,0,144,144,0,1,0,1,0
33162,34021,0,0,76,76,0,1,0,1,0
50326,31652,0,0,108,108,0,1,0,1,0
10814,3389,10814,3389,293,223,70,4,1,3,1
16187,20847,0,0,88,88,0,1,0,1,0
19930,61248,0,0,156,156,0,1,0,1,0
12157,3389,12157,3389,293,223,70,4,1,3,1
52393,33893,0,0,66,66,0,1,0,1,0
27452,34021,0,0,62,62,0,1,0,1,0
6534,52573,0,0,142,142,0,1,0,1,0
37400,3389,37400,3389,293,223,70,4,1,3,1
35962,8947,0,0,145,145,0,1,0,1,0
11977,61248,0,0,140,140,0,1,0,1,0
11804,3389,11804,3389,293,223,70,4,1,3,1
12003,3389,12003,3389,293,223,70,4,1,3,1
12029,3389,12029,3389,293,223,70,4,1,3,1
25455,34021,0,0,62,62,0,1,0,1,0
19326,59094,0,0,157,157,0,1,0,1,0
19167,26710,0,0,133,133,0,1,0,1,0
49106,32299,0,0,148,148,0,1,0,1,0
11508,61248,0,0,142,142,0,1,0,1,0
17975,1948,7243,1947,194,154,40,2,0,2,0
16285,3389,16285,3389,293,223,70,4,0,3,1
18163,18353,0,0,63,63,0,1,0,1,0
52337,34021,0,0,67,67,0,1,0,1,0
15131,25773,0,0,140,140,0,1,0,1,0
15328,2658,9885,2657,243,188,54,3,0,2,0
54338,60748,0,0,110,110,0,1,0,1,0
14434,3389,14434,3389,293,223,70,4,0,3,1
23324,3389,23324,3389,293,223,70,4,1,3,1
15318,28233,0,0,116,116,0,1,0,1,0
19557,3389,19557,3389,293,223,70,4,0,3,1
29074,29631,0,0,107,107,0,1,0,1,0
49557,33661,0,0,133,133,0,1,0,1,0
49883,31652,0,0,122,122,0,1,0,1,0
51715,32464,0,0,68,68,0,1,0,1,0
9607,3389,9607,3389,293,223,70,4,1,3,1
48950,27285,0,0,154,154,0,1,0,1,0
13846,10873,1053,390,164,156,8,1,0,1,0
34030,3389,34030,3389,293,223,70,4,0,3,1
10726,61248,0,0,142,142,0,1,0,1,0
12831,26058,0,0,136,136,0,1,0,1,0
37847,3389,37847,3389,293,223,70,4,1,3,1
24269,34021,0,0,62,62,0,1,0,1,0
50529,29821,0,0,98,98,0,1,0,1,0
19708,3389,19708,3389,293,223,70,4,0,3,1
17100,3389,17100,3389,293,223,70,4,0,3,1
54881,33561,0,0,62,62,0,1,0,1,0
16724,3389,16724,3389,293,223,70,4,0,3,1
10964,3389,10964,3389,293,223,70,4,1,3,1
50948,30865,0,0,83,83,0,1,0,1,0
9543,25773,0,0,150,150,0,1,0,1,0
49733,33375,0,0,125,125,0,1,0,1,0
51141,31790,0,0,76,76,0,1,0,1,0
44978,34021,0,0,127,127,0,1,0,1,0
36063,3389,36063,3389,293,223,70,4,1,3,1
42174,60218,0,0,76,76,0,1,0,1,0
19480,28489,0,0,116,116,0,1,0,1,0
17681,17279,0,0,74,74,0,1,0,1,0
1261,21936,0,0,156,156,0,1,0,1,0
11639,61248,0,0,141,141,0,1,0,1,0
50318,34021,0,0,117,117,0,1,0,1,0
5106,25773,0,0,142,142,0,1,0,1,0
10645,61248,0,0,142,142,0,1,0,1,0
51375,30827,0,0,75,75,0,1,0,1,0
58592,4838,22377,1184,196,172,24,2,0,1,0
54851,60790,0,0,113,113,0,1,0,1,0
29450,34021,0,0,62,62,0,1,0,1,0
16400,25773,0,0,143,143,0,1,0,1,0
58031,3389,58031,3389,293,223,70,4,0,3,1
17561,25773,0,0,143,143,0,1,0,1,0
17587,19080,0,0,70,70,0,1,0,1,0
16818,47807,0,0,103,103,0,1,0,1,0
14314,3389,14314,3389,293,223,70,4,0,3,1
12179,3389,12179,3389,293,223,70,4,1,3,1
14319,21164,0,0,98,98,0,1,0,1,0
9174,56555,0,0,140,140,0,1,0,1,0
15295,2361,7639,2360,222,174,48,3,0,2,0
12274,8370,3759,1393,207,178,28,2,0,1,0
3710,48314,0,0,144,144,0,1,0,1,0
49160,31864,0,0,146,146,0,1,0,1,0
27541,34021,0,0,62,62,0,1,0,1,0
46386,34021,0,0,133,133,0,1,0,1,0
13699,3389,13699,3389,293,223,70,4,0,3,1
8215,55109,0,0,141,141,0,1,0,1,0
50727,32602,0,0,95,95,0,1,0,1,0
15469,3389,15469,3389,293,223,70,4,0,3,1
12920,3389,12920,3389,293,223,70,4,0,3,1
60266,60720,0,0,143,143,0,1,0,1,0
49014,29362,0,0,152,152,0,1,0,1,0
49796,27599,0,0,127,127,0,1,0,1,0
14936,3389,14936,3389,293,223,70,4,0,3,1
63023,31652,0,0,69,69,0,1,0,1,0
49513,31896,0,0,137,137,0,1,0,1,0
20906,3389,20906,3389,293,223,70,4,0,3,1
14725,2496,8077,2496,232,180,51,3,0,2,0
17958,3389,17958,3389,293,223,70,4,0,3,1
49060,29371,0,0,150,150,0,1,0,1,0
7191,25262,0,0,157,157,0,1,0,1,0
4700,25773,0,0,142,142,0,1,0,1,0
11533,3389,11533,3389,293,223,70,4,1,3,1
46142,56642,0,0,72,72,0,1,0,1,0
13159,3389,13159,3389,293,223,70,4,0,3,1
13458,3389,13458,3389,293,223,70,4,0,3,1
2470,46505,0,0,144,144,0,1,0,1,0
36009,13039,0,0,146,146,0,1,0,1,0
19457,3389,19457,3389,293,223,70,4,0,3,1
12963,61248,0,0,145,145,0,1,0,1,0
8665,25773,0,0,154,154,0,1,0,1,0
25233,34021,0,0,62,62,0,1,0,1,0
50609,30021,0,0,95,95,0,1,0,1,0
10056,3389,10056,3389,293,223,70,4,1,3,1
38150,3389,38150,3389,293,223,70,4,1,3,1
37021,11366,0,0,146,146,0,1,0,1,0
49693,31652,0,0,127,127,0,1,0,1,0
49160,33256,0,0,146,146,0,1,0,1,0
1482,22571,0,0,154,154,0,1,0,1,0
16272,14905,0,0,106,106,0,1,0,1,0
10073,61248,0,0,141,141,0,1,0,1,0
58806,4781,24023,1271,200,174,26,2,0,1,0
25074,34021,0,0,62,62,0,1,0,1,0
11103,3389,11103,3389,293,223,70,4,1,3,1
63403,39393,0,0,83,83,0,1,0,1,0
17389,3389,17389,3389,293,223,70,4,0,3,1
18523,3389,18523,3389,293,223,70,4,0,3,1
49160,33144,0,0,146,146,0,1,0,1,0
11401,25773,0,0,139,139,0,1,0,1,0
9165,3389,9165,3389,293,223,70,4,0,3,1
11169,3389,11169,3389,293,223,70,4,1,3,1
50955,32896,0,0,101,101,0,1,0,1,0
49295,31652,0,0,141,141,0,1,0,1,0
28532,26912,0,0,136,136,0,1,0,1,0
20417,30227,0,0,99,99,0,1,0,1,0
36816,4262,0,0,125,125,0,1,0,1,0
17954,61248,0,0,150,150,0,1,0,1,0
52231,25951,0,0,87,87,0,1,0,1,0
28964,34021,0,0,62,62,0,1,0,1,0
49878,31652,0,0,122,122,0,1,0,1,0
24063,34021,0,0,62,62,0,1,0,1,0
50420,32525,0,0,115,115,0,1,0,1,0
27605,13307,0,0,106,106,0,1,0,1,0
28655,12753,0,0,111,111,0,1,0,1,0
50193,28668,0,0,123,123,0,1,0,1,0
34875,11097,0,0,146,146,0,1,0,1,0
12550,3389,12550,3389,293,223,70,4,1,3,1
19934,1422,5288,1421,158,129,29,2,0,1,0
49306,33888,0,0,141,141,0,1,0,1,0
26462,13910,0,0,101,101,0,1,0,1,0
19212,3389,19212,3389,293,223,70,4,0,3,1
14283,23249,0,0,113,113,0,1,0,1,0
27414,34021,0,0,62,62,0,1,0,1,0
15860,61248,0,0,146,146,0,1,0,1,0
2598,24317,0,0,148,148,0,1,0,1,0
13483,3389,13483,3389,293,223,70,4,0,3,1
13679,9959,2447,756,180,164,15,1,0,1,0
53137,20602,0,0,102,102,0,1,0,1,0
50528,32481,0,0,97,97,0,1,0,1,0
13156,24671,0,0,127,127,0,1,0,1,0
18072,23980,0,0,123,123,0,1,0,1,0
42452,5618,0,0,145,145,0,1,0,1,0
17764,61248,0,0,152,152,0,1,0,1,0
18385,18341,0,0,63,63,0,1,0,1,0
51381,31652,0,0,69,69,0,1,0,1,0
48961,27109,0,0,154,154,0,1,0,1,0
18250,3389,18250,3389,293,223,70,4,0,3,1
25280,31694,0,0,84,84,0,1,0,1,0
17565,18752,0,0,68,68,0,1,0,1,0
51948,32155,0,0,62,62,0,1,0,1,0
16014,10137,0,0,135,135,0,1,0,1,0
19098,3389,19098,3389,293,223,70,4,0,3,1
11601,7300,4915,1821,225,188,37,2,0,2,0
37833,3389,37833,3389,293,223,70,4,1,3,1
50581,31652,0,0,100,100,0,1,0,1,0
49160,32806,0,0,146,146,0,1,0,1,0
30941,4832,0,0,107,107,0,1,0,1,0
50219,33062,0,0,112,112,0,1,0,1,0
11166,3389,11166,3389,293,223,70,4,1,3,1
51973,33601,0,0,76,76,0,1,0,1,0
19595,6200,0,0,107,107,0,1,0,1,0
7050,29314,0,0,154,154,0,1,0,1,0
4099,49220,0,0,144,144,0,1,0,1,0
52241,41472,0,0,145,145,0,1,0,1,0
16585,61248,0,0,151,151,0,1,0,1,0
12550,3389,12550,3389,293,223,70,4,1,3,1
49778,31652,0,0,124,124,0,1,0,1,0
51681,31452,0,0,65,65,0,1,0,1,0
52533,5618,0,0,145,145,0,1,0,1,0
18431,3389,18431,3389,293,223,70,4,0,3,1
37643,3389,37643,3389,293,223,70,4,1,3,1
28270,27446,0,0,130,130,0,1,0,1,0
28138,33870,0,0,63,63,0,1,0,1,0
11800,25773,0,0,141,141,0,1,0,1,0
2172,22488,0,0,157,157,0,1,0,1,0
58069,61054,0,0,131,131,0,1,0,1,0
19262,3389,19262,3389,293,223,70,4,0,3,1
16495,3389,16495,3389,293,223,70,4,0,3,1
50449,31652,0,0,100,100,0,1,0,1,0
21642,20781,0,0,91,91,0,1,0,1,0
49269,31727,0,0,143,143,0,1,0,1,0
22826,34021,0,0,62,62,0,1,0,1,0
7046,29327,0,0,154,154,0,1,0,1,0
28208,30448,0,0,99,99,0,1,0,1,0
51753,5618,0,0,145,145,0,1,0,1,0
26753,34021,0,0,62,62,0,1,0,1,0
8114,25773,0,0,156,156,0,1,0,1,0
54556,12236,0,0,126,126,0,1,0,1,0
15413,3389,15413,3389,293,223,70,4,0,3,1
50975,34021,0,0,101,101,0,1,0,1,0
6548,25773,0,0,152,152,0,1,0,1,0
7209,25272,0,0,157,157,0,1,0,1,0
12019,61248,0,0,140,140,0,1,0,1,0
6934,25120,0,0,157,157,0,1,0,1,0
24275,34021,0,0,62,62,0,1,0,1,0
12644,61248,0,0,146,146,0,1,0,1,0
50659,32332,0,0,93,93,0,1,0,1,0
50407,34021,0,0,115,115,0,1,0,1,0
20095,61248,0,0,156,156,0,1,0,1,0
45513,17643,0,0,152,152,0,1,0,1,0
22459,34018,0,0,62,62,0,1,0,1,0
16098,3389,16098,3389,293,223,70,4,0,3,1
51992,32964,0,0,66,66,0,1,0,1,0
25231,30111,0,0,102,102,0,1,0,1,0
7676,61248,0,0,139,139,0,1,0,1,0
54659,12418,0,0,123,123,0,1,0,1,0
22696,34021,0,0,62,62,0,1,0,1,0
14411,3389,14411,3389,293,223,70,4,0,3,1
3186,47698,0,0,144,144,0,1,0,1,0
20478,61248,0,0,156,156,0,1,0,1,0
18761,29143,0,0,107,107,0,1,0,1,0
36195,3389,36195,3389,293,223,70,4,0,3,1
28235,29157,0,0,112,112,0,1,0,1,0
51811,31763,0,0,62,62,0,1,0,1,0
52497,33781,0,0,62,62,0,1,0,1,0
7570,25471,0,0,157,157,0,1,0,1,0
24412,221,819,220,77,72,4,1,0,1,0
1078,21884,0,0,157,157,0,1,0,1,0
35960,60537,0,0,102,102,0,1,0,1,0
13701,3389,13701,3389,293,223,70,4,0,3,1
26432,33134,0,0,70,70,0,1,0,1,0
27077,3389,27077,3389,293,223,70,4,0,3,1
11520,3389,11520,3389,293,223,70,4,1,3,1
37144,3389,37144,3389,293,223,70,4,1,3,1
52154,33070,0,0,72,72,0,1,0,1,0
52129,32690,0,0,62,62,0,1,0,1,0
5212,25773,0,0,148,148,0,1,0,1,0
21725,25773,0,0,144,144,0,1,0,1,0
10513,25773,0,0,139,139,0,1,0,1,0
15763,20090,0,0,85,85,0,1,0,1,0
13614,24757,0,0,146,146,0,1,0,1,0
15670,61248,0,0,145,145,0,1,0,1,0
50959,29977,0,0,89,89,0,1,0,1,0
13795,12342,0,0,148,148,0,1,0,1,0
50931,38304,0,0,145,145,0,1,0,1,0
22076,34715,0,0,63,63,0,1,0,1,0
41855,7952,0,0,145,145,0,1,0,1,0
48344,5618,0,0,145,145,0,1,0,1,0
52365,60586,0,0,99,99,0,1,0,1,0
52613,14733,0,0,150,150,0,1,0,1,0
13437,3389,13437,3389,293,223,70,4,0,3,1
22368,61235,0,0,158,158,0,1,0,1,0
22096,3389,22096,3389,293,223,70,4,0,3,1
47406,5618,0,0,145,145,0,1,0,1,0
9141,25773,0,0,152,152,0,1,0,1,0
50060,31652,0,0,117,117,0,1,0,1,0
7575,61248,0,0,139,139,0,1,0,1,0
3764,25773,0,0,142,142,0,1,0,1,0
53751,11349,0,0,148,148,0,1,0,1,0
17075,25773,0,0,144,144,0,1,0,1,0
37194,3389,37194,3389,293,223,70,4,1,3,1
12209,25773,0,0,139,139,0,1,0,1,0
15979,10176,0,0,135,135,0,1,0,1,0
50998,34021,0,0,100,100,0,1,0,1,0
61025,3389,61025,3389,293,223,70,4,0,3,1
13865,3389,13865,3389,293,223,70,4,0,3,1
49116,32634,0,0,147,147,0,1,0,1,0
50323,32711,0,0,105,105,0,1,0,1,0
12053,61248,0,0,139,139,0,1,0,1,0
11930,3389,11930,3389,293,223,70,4,0,3,1
28877,33278,0,0,69,69,0,1,0,1,0
51846,32701,0,0,67,67,0,1,0,1,0
10171,61248,0,0,139,139,0,1,0,1,0
15529,3389,15529,3389,293,223,70,4,0,3,1
64299,32835,0,0,65,65,0,1,0,1,0
41479,8015,0,0,145,145,0,1,0,1,0
20343,61248,0,0,155,155,0,1,0,1,0
18099,23119,0,0,114,114,0,1,0,1,0
17980,61248,0,0,150,150,0,1,0,1,0
28952,34021,0,0,62,62,0,1,0,1,0
49059,26092,0,0,151,151,0,1,0,1,0
2465,46498,0,0,144,144,0,1,0,1,0
4385,52564,0,0,142,142,0,1,0,1,0
26211,3389,26211,3389,293,223,70,4,0,3,1
51821,32656,0,0,67,67,0,1,0,1,0
14028,3389,14028,3389,293,223,70,4,0,3,1
14602,3389,14602,3389,293,223,70,4,0,3,1
24511,31127,0,0,92,92,0,1,0,1,0
40351,5724,0,0,146,146,0,1,0,1,0
22101,25773,0,0,144,144,0,1,0,1,0
21870,3389,21870,3389,293,223,70,4,0,3,1
50686,5618,0,0,145,145,0,1,0,1,0
10643,3389,10643,3389,293,223,70,4,1,3,1
28150,33283,0,0,69,69,0,1,0,1,0
52117,32655,0,0,62,62,0,1,0,1,0
52574,34021,0,0,62,62,0,1,0,1,0
15838,61248,0,0,149,149,0,1,0,1,0
16117,14643,0,0,110,110,0,1,0,1,0
60823,3389,60823,3389,293,223,70,4,0,3,1
17220,3389,17220,3389,293,223,70,4,0,3,1
52476,31652,0,0,127,127,0,1,0,1,0
25470,25773,0,0,146,146,0,1,0,1,0
10450,25773,0,0,146,146,0,1,0,1,0
9512,3389,9512,3389,293,223,70,4,1,3,1
21715,3389,21715,3389,293,223,70,4,0,3,1
24663,61117,0,0,148,148,0,1,0,1,0
11725,61248,0,0,141,141,0,1,0,1,0
10927,3389,10927,3389,293,223,70,4,1,3,1
18212,19522,0,0,75,75,0,1,0,1,0
17489,3389,17489,3389,293,223,70,4,0,3,1
11543,3389,11543,3389,293,223,70,4,1,3,1
5288,18677,0,0,154,154,0,1,0,1,0
39723,6900,0,0,146,146,0,1,0,1,0
51069,32975,0,0,99,99,0,1,0,1,0
10156,5000,7402,2743,265,208,56,3,0,2,0
37251,3389,37251,3389,293,223,70,4,0,3,1
18067,24147,0,0,125,125,0,1,0,1,0
57493,51225,0,0,116,116,0,1,0,1,0
18880,18712,0,0,67,67,0,1,0,1,0
22556,2945,0,0,83,83,0,1,0,1,0
29532,31922,0,0,83,83,0,1,0,1,0
17610,19051,0,0,70,70,0,1,0,1,0
21617,32454,0,0,77,77,0,1,0,1,0
15372,25773,0,0,141,141,0,1,0,1,0
49160,33078,0,0,146,146,0,1,0,1,0
12452,25773,0,0,139,139,0,1,0,1,0
28317,34021,0,0,62,62,0,1,0,1,0
21838,28888,0,0,112,112,0,1,0,1,0
16464,25773,0,0,141,141,0,1,0,1,0
47094,21435,0,0,154,154,0,1,0,1,0
26940,34021,0,0,62,62,0,1,0,1,0
18642,1566,5066,1565,168,136,32,2,0,1,0
8100,55887,0,0,143,143,0,1,0,1,0
3924,51222,0,0,142,142,0,1,0,1,0
13855,3389,13855,3389,293,223,70,4,0,3,1
50166,31652,0,0,140,140,0,1,0,1,0
33655,3389,33655,3389,293,223,70,4,0,3,1
13405,3389,13405,3389,293,223,70,4,0,3,1
9182,25773,0,0,152,152,0,1,0,1,0
19200,26590,0,0,134,134,0,1,0,1,0
46615,52462,0,0,84,84,0,1,0,1,0
29203,3389,29203,3389,293,223,70,4,0,3,1
15496,3389,15496,3389,293,223,70,4,0,3,1
18676,18018,0,0,64,64,0,1,0,1,0
51622,31331,0,0,67,67,0,1,0,1,0
18397,61248,0,0,151,151,0,1,0,1,0
53880,16221,0,0,115,115,0,1,0,1,0
2985,48492,0,0,143,143,0,1,0,1,0
49143,33481,0,0,146,146,0,1,0,1,0
21661,61248,0,0,158,158,0,1,0,1,0
20086,3389,20086,3389,293,223,70,4,0,3,1
5771,24477,0,0,157,157,0,1,0,1,0
19082,3389,19082,3389,293,223,70,4,0,3,1
16378,19634,0,0,79,79,0,1,0,1,0
5404,23378,0,0,149,149,0,1,0,1,0
17570,25669,0,0,143,143,0,1,0,1,0
51039,31652,0,0,135,135,0,1,0,1,0
15153,47206,0,0,99,99,0,1,0,1,0
20480,3389,20480,3389,293,223,70,4,0,3,1
21090,985,3185,984,129,108,20,1,0,1,0
19957,3389,19957,3389,293,223,70,4,0,3,1
5929,51661,0,0,142,142,0,1,0,1,0
19985,3389,19985,3389,293,223,70,4,0,3,1
9383,3389,9383,3389,293,223,70,4,0,3,1
52571,3389,52571,3389,293,223,70,4,0,3,1
33899,3389,33899,3389,293,223,70,4,0,3,1
18238,18258,0,0,62,62,0,1,0,1,0
60408,61212,0,0,144,144,0,1,0,1,0
49641,31985,0,0,134,134,0,1,0,1,0
12651,3389,12651,3389,293,223,70,4,0,3,1
21689,951,3536,950,126,107,19,1,0,1,0
51699,32436,0,0,68,68,0,1,0,1,0
17184,61248,0,0,152,152,0,1,0,1,0
13457,25773,0,0,139,139,0,1,0,1,0
53839,3389,53839,3389,293,223,70,4,0,3,1
6213,24400,0,0,128,128,0,1,0,1,0
45137,60066,0,0,64,64,0,1,0,1,0
49566,33653,0,0,132,132,0,1,0,1,0
50638,30092,0,0,94,94,0,1,0,1,0
26039,32930,0,0,72,72,0,1,0,1,0
49597,31652,0,0,131,131,0,1,0,1,0
12107,61248,0,0,145,145,0,1,0,1,0
2546,24235,0,0,148,148,0,1,0,1,0
13061,3389,13061,3389,293,223,70,4,0,3,1
37349,3389,37349,3389,293,223,70,4,1,3,1
31531,3389,31531,3389,293,223,70,4,0,3,1
51416,38408,0,0,62,62,0,1,0,1,0
19382,19089,0,0,71,71,0,1,0,1,0
29492,3606,0,0,95,95,0,1,0,1,0
26869,27798,0,0,126,126,0,1,0,1,0
27529,3389,27529,3389,293,223,70,4,0,3,1
50347,42444,0,0,62,62,0,1,0,1,0
16317,3389,16317,3389,293,223,70,4,0,3,1
9339,3389,9339,3389,293,223,70,4,1,3,1
38148,3389,38148,3389,293,223,70,4,1,3,1
12541,7203,6021,1860,227,189,38,2,0,2,0
52537,33947,0,0,62,62,0,1,0,1,0
44673,34021,0,0,126,126,0,1,0,1,0
24973,25773,0,0,146,146,0,1,0,1,0
6603,25773,0,0,141,141,0,1,0,1,0
3456,23198,0,0,157,157,0,1,0,1,0
12937,8162,4778,1476,211,180,30,2,0,1,0
9640,24853,0,0,143,143,0,1,0,1,0
31371,5197,0,0,110,110,0,1,0,1,0
50874,30679,0,0,86,86,0,1,0,1,0
34757,3389,34757,3389,293,223,70,4,0,3,1
45443,5618,0,0,145,145,0,1,0,1,0
12939,61248,0,0,146,146,0,1,0,1,0
11269,3389,11269,3389,293,223,70,4,0,3,1
17062,16236,0,0,88,88,0,1,0,1,0
13685,25773,0,0,139,139,0,1,0,1,0
15664,3389,15664,3389,293,223,70,4,0,3,1
13465,18206,0,0,143,143,0,1,0,1,0
5550,25773,0,0,142,142,0,1,0,1,0
35302,3389,35302,3389,293,223,70,4,0,3,1
7691,25773,0,0,141,141,0,1,0,1,0
22165,3389,22165,3389,293,223,70,4,0,3,1
25581,3389,25581,3389,293,223,70,4,0,3,1
52558,33961,0,0,62,62,0,1,0,1,0
14610,27659,0,0,121,121,0,1,0,1,0
21145,31579,0,0,85,85,0,1,0,1,0
51977,32241,0,0,62,62,0,1,0,1,0
15280,3389,15280,3389,293,223,70,4,0,3,1
50167,32887,0,0,110,110,0,1,0,1,0
19977,3389,19977,3389,293,223,70,4,0,3,1
1659,22847,0,0,153,153,0,1,0,1,0
35616,13688,0,0,146,146,0,1,0,1,0
8146,16549,0,0,152,152,0,1,0,1,0
51558,33314,0,0,87,87,0,1,0,1,0
4360,19368,0,0,154,154,0,1,0,1,0
2756,24564,0,0,147,147,0,1,0,1,0
51908,16832,0,0,151,151,0,1,0,1,0
5863,56859,0,0,140,140,0,1,0,1,0
58121,31652,0,0,62,62,0,1,0,1,0
28434,34021,0,0,62,62,0,1,0,1,0
10624,61248,0,0,142,142,0,1,0,1,0
19442,17613,0,0,67,67,0,1,0,1,0
1478,22565,0,0,154,154,0,1,0,1,0
47176,54424,0,0,62,62,0,1,0,1,0
26623,28145,0,0,123,123,0,1,0,1,0
18877,3389,18877,3389,293,223,70,4,0,3,1
10121,3389,10121,3389,293,223,70,4,1,3,1
22388,3389,22388,3389,293,223,70,4,1,3,1
51122,33012,0,0,97,97,0,1,0,1,0
4050,51588,0,0,142,142,0,1,0,1,0
14314,11497,454,140,154,151,2,1,0,1,0
16282,3389,16282,3389,293,223,70,4,0,3,1
10963,3389,10963,3389,293,223,70,4,1,3,1
34681,7999,0,0,136,136,0,1,0,1,0
13994,27160,0,0,126,126,0,1,0,1,0
4095,25773,0,0,144,144,0,1,0,1,0
10491,3389,10491,3389,293,223,70,4,1,3,1
9397,3389,9397,3389,293,223,70,4,1,3,1
3163,30826,0,0,143,143,0,1,0,1,0
54563,13059,0,0,121,121,0,1,0,1,0
51623,32298,0,0,69,69,0,1,0,1,0
28310,25798,0,0,147,147,0,1,0,1,0
8364,25773,0,0,155,155,0,1,0,1,0
23731,61165,0,0,152,152,0,1,0,1,0
14428,3389,14428,3389,293,223,70,4,0,3,1
45551,3389,45551,3389,293,223,70,4,0,3,1
12435,13354,0,0,149,149,0,1,0,1,0
15905,61248,0,0,149,149,0,1,0,1,0
18316,3389,18316,3389,293,223,70,4,0,3,1
49753,27512,0,0,128,128,0,1,0,1,0
25029,31489,0,0,86,86,0,1,0,1,0
8784,23643,0,0,150,150,0,1,0,1,0
48987,27698,0,0,153,153,0,1,0,1,0
49195,31652,0,0,144,144,0,1,0,1,0
2185,23671,0,0,150,150,0,1,0,1,0
1696,22906,0,0,153,153,0,1,0,1,0
49639,27278,0,0,132,132,0,1,0,1,0
9557,24702,0,0,143,143,0,1,0,1,0
2305,23859,0,0,149,149,0,1,0,1,0
51307,31652,0,0,77,77,0,1,0,1,0
20071,3389,20071,3389,293,223,70,4,0,3,1
18391,3389,18391,3389,293,223,70,4,0,3,1
14105,3389,14105,3389,293,223,70,4,0,3,1
51289,31696,0,0,71,71,0,1,0,1,0
23566,31643,0,0,84,84,0,1,0,1,0
32304,2602,0,0,100,100,0,1,0,1,0
4509,25773,0,0,142,142,0,1,0,1,0
48776,6783,0,0,145,145,0,1,0,1,0
56823,31652,0,0,62,62,0,1,0,1,0
42129,3389,42129,3389,293,223,70,4,0,3,1
16259,3389,16259,3389,293,223,70,4,0,3,1
11814,61248,0,0,140,140,0,1,0,1,0
17228,25773,0,0,142,142,0,1,0,1,0
7518,25773,0,0,155,155,0,1,0,1,0
7725,25773,0,0,155,155,0,1,0,1,0
11117,25773,0,0,144,144,0,1,0,1,0
58059,32643,0,0,97,97,0,1,0,1,0
48693,3389,48693,3389,293,223,70,4,0,3,1
4666,25773,0,0,146,146,0,1,0,1,0
11635,3389,11635,3389,293,223,70,4,1,3,1
18038,18400,0,0,63,63,0,1,0,1,0
49160,31792,0,0,146,146,0,1,0,1,0
51204,31652,0,0,74,74,0,1,0,1,0
13231,24575,0,0,126,126,0,1,0,1,0
28215,12986,0,0,109,109,0,1,0,1,0
16336,20658,0,0,86,86,0,1,0,1,0
4605,25773,0,0,143,143,0,1,0,1,0
25719,32051,0,0,81,81,0,1,0,1,0
14174,3389,14174,3389,293,223,70,4,0,3,1
21725,61248,0,0,158,158,0,1,0,1,0
15856,61248,0,0,150,150,0,1,0,1,0
20217,3389,20217,3389,293,223,70,4,0,3,1
49265,33901,0,0,142,142,0,1,0,1,0
49398,33752,0,0,137,137,0,1,0,1,0
17921,25773,0,0,143,143,0,1,0,1,0
19980,19536,0,0,76,76,0,1,0,1,0
17162,3389,17162,3389,293,223,70,4,0,3,1
28272,27347,0,0,131,131,0,1,0,1,0
54128,33711,0,0,62,62,0,1,0,1,0
11242,3389,11242,3389,293,223,70,4,1,3,1
21991,3389,21991,3389,293,223,70,4,0,3,1
3527,25794,0,0,143,143,0,1,0,1,0
4988,25773,0,0,147,147,0,1,0,1,0
2297,46181,0,0,144,144,0,1,0,1,0
55489,6879,0,0,140,140,0,1,0,1,0
31002,3389,31002,3389,293,223,70,4,0,3,1
59445,32651,0,0,62,62,0,1,0,1,0
17157,16397,0,0,86,86,0,1,0,1,0
26542,34021,0,0,62,62,0,1,0,1,0
50765,31652,0,0,94,94,0,1,0,1,0
27049,25773,0,0,147,147,0,1,0,1,0
7584,61248,0,0,139,139,0,1,0,1,0
18941,3389,18941,3389,293,223,70,4,0,3,1
29614,32336,0,0,79,79,0,1,0,1,0
13456,20694,0,0,88,88,0,1,0,1,0
50581,32420,0,0,96,96,0,1,0,1,0
39698,3389,39698,3389,293,223,70,4,0,3,1
12687,25773,0,0,139,139,0,1,0,1,0
49424,60344,0,0,83,83,0,1,0,1,0
50213,32835,0,0,108,108,0,1,0,1,0
21699,20824,0,0,91,91,0,1,0,1,0
41127,3389,41127,3389,293,223,70,4,0,3,1
49169,26370,0,0,150,150,0,1,0,1,0
38101,7339,0,0,146,146,0,1,0,1,0
52414,33536,0,0,62,62,0,1,0,1,0
37390,7849,0,0,146,146,0,1,0,1,0
20073,3389,20073,3389,293,223,70,4,0,3,1
3868,23425,0,0,157,157,0,1,0,1,0
29889,1714,0,0,87,87,0,1,0,1,0
33302,60674,0,0,113,113,0,1,0,1,0
49189,33994,0,0,145,145,0,1,0,1,0
29603,34021,0,0,62,62,0,1,0,1,0
9583,61248,0,0,139,139,0,1,0,1,0
28216,30058,0,0,103,103,0,1,0,1,0
50803,32791,0,0,105,105,0,1,0,1,0
12226,6440,7010,2166,240,195,44,2,0,2,0
49816,28046,0,0,124,124,0,1,0,1,0
49856,32134,0,0,128,128,0,1,0,1,0
47598,44423,0,0,108,108,0,1,0,1,0
28211,1096,0,0,78,78,0,1,0,1,0
18083,61248,0,0,153,153,0,1,0,1,0
43821,5618,0,0,145,145,0,1,0,1,0
45791,18309,0,0,152,152,0,1,0,1,0
38869,6787,0,0,146,146,0,1,0,1,0
45586,3389,45586,3389,293,223,70,4,0,3,1
49001,28944,0,0,152,152,0,1,0,1,0
20708,3389,20708,3389,293,223,70,4,0,3,1
2873,47177,0,0,144,144,0,1,0,1,0
21717,32640,0,0,75,75,0,1,0,1,0
18118,3389,18118,3389,293,223,70,4,0,3,1
20021,25773,0,0,143,143,0,1,0,1,0
50009,28255,0,0,128,128,0,1,0,1,0
11682,61248,0,0,143,143,0,1,0,1,0
27057,25773,0,0,147,147,0,1,0,1,0
37968,9801,0,0,146,146,0,1,0,1,0
6042,57382,0,0,140,140,0,1,0,1,0
37239,3389,37239,3389,293,223,70,4,0,3,1
51635,31652,0,0,64,64,0,1,0,1,0
1061,21874,0,0,157,157,0,1,0,1,0
50526,31652,0,0,138,138,0,1,0,1,0
50273,28573,0,0,111,111,0,1,0,1,0
11324,54116,0,0,118,118,0,1,0,1,0
16308,20693,0,0,87,87,0,1,0,1,0
27971,3389,27971,3389,293,223,70,4,0,3,1
51760,32545,0,0,68,68,0,1,0,1,0
57967,31652,0,0,62,62,0,1,0,1,0
49953,33128,0,0,118,118,0,1,0,1,0
54221,40019,0,0,85,85,0,1,0,1,0
15603,25216,0,0,144,144,0,1,0,1,0
26028,28986,0,0,114,114,0,1,0,1,0
14570,61248,0,0,147,147,0,1,0,1,0
21423,3389,21423,3389,293,223,70,4,0,3,1
1333,21623,0,0,156,156,0,1,0,1,0
63082,3638,56862,3010,276,214,62,3,0,2,0
17617,3389,17617,3389,293,223,70,4,0,3,1
16480,3389,16480,3389,293,223,70,4,0,3,1
10580,3389,10580,3389,293,223,70,4,1,3,1
19082,27750,0,0,123,123,0,1,0,1,0
62833,3704,54945,2908,272,211,60,3,0,2,0
18509,3389,18509,3389,293,223,70,4,0,3,1
58722,32540,0,0,93,93,0,1,0,1,0
25901,246,0,0,65,65,0,1,0,1,0
11701,3389,11701,3389,293,223,70,4,0,3,1
11472,60022,0,0,139,139,0,1,0,1,0
51015,32342,0,0,86,86,0,1,0,1,0
2202,23698,0,0,150,150,0,1,0,1,0
19675,25773,0,0,143,143,0,1,0,1,0
16401,15122,0,0,103,103,0,1,0,1,0
4317,23674,0,0,157,157,0,1,0,1,0
12234,3389,12234,3389,293,223,70,4,0,3,1
23708,61166,0,0,152,152,0,1,0,1,0
28250,28418,0,0,120,120,0,1,0,1,0
18439,18382,0,0,63,63,0,1,0,1,0
9802,61248,0,0,139,139,0,1,0,1,0
10295,61248,0,0,139,139,0,1,0,1,0
52091,32577,0,0,62,62,0,1,0,1,0
20254,29925,0,0,102,102,0,1,0,1,0
51527,31652,0,0,66,66,0,1,0,1,0
18156,44538,0,0,93,93,0,1,0,1,0
18915,3389,18915,3389,293,223,70,4,0,3,1
22495,25773,0,0,145,145,0,1,0,1,0
50459,28955,0,0,105,105,0,1,0,1,0
54561,8938,0,0,146,146,0,1,0,1,0
49890,27791,0,0,124,124,0,1,0,1,0
18447,61248,0,0,154,154,0,1,0,1,0
29854,34021,0,0,62,62,0,1,0,1,0
10309,25773,0,0,153,153,0,1,0,1,0
14981,3389,14981,3389,293,223,70,4,0,3,1
19673,3389,19673,3389,293,223,70,4,0,3,1
61217,55400,0,0,128,128,0,1,0,1,0
3235,23075,0,0,157,157,0,1,0,1,0
51768,31652,0,0,62,62,0,1,0,1,0
51054,31652,0,0,79,79,0,1,0,1,0
13657,16978,0,0,144,144,0,1,0,1,0
15639,13837,0,0,121,121,0,1,0,1,0
13545,24741,0,0,146,146,0,1,0,1,0
51429,31949,0,0,70,70,0,1,0,1,0
4694,50211,0,0,144,144,0,1,0,1,0
24665,31192,0,0,89,89,0,1,0,1,0
10406,25773,0,0,147,147,0,1,0,1,0
10760,25243,0,0,141,141,0,1,0,1,0
27772,25773,0,0,147,147,0,1,0,1,0
45016,34021,0,0,127,127,0,1,0,1,0
19137,3389,19137,3389,293,223,70,4,0,3,1
52804,5618,0,0,145,145,0,1,0,1,0
40185,6137,0,0,146,146,0,1,0,1,0
28295,26229,0,0,143,143,0,1,0,1,0
51306,33140,0,0,93,93,0,1,0,1,0
27722,32480,0,0,77,77,0,1,0,1,0
13912,10978,940,348,162,155,7,1,0,1,0
22655,3389,22655,3389,293,223,70,4,0,3,1
15895,17469,0,0,145,145,0,1,0,1,0
14066,61248,0,0,142,142,0,1,0,1,0
25504,61074,0,0,145,145,0,1,0,1,0
26194,14052,0,0,99,99,0,1,0,1,0
34530,15484,0,0,146,146,0,1,0,1,0
28537,34021,0,0,62,62,0,1,0,1,0
49337,31652,0,0,139,139,0,1,0,1,0
15549,21651,0,0,96,96,0,1,0,1,0
12138,61248,0,0,139,139,0,1,0,1,0
21165,3389,21165,3389,293,223,70,4,0,3,1
31132,11447,0,0,123,123,0,1,0,1,0
17592,3389,17592,3389,293,223,70,4,0,3,1
50847,32121,0,0,86,86,0,1,0,1,0
16479,15253,0,0,102,102,0,1,0,1,0
18074,23923,0,0,123,123,0,1,0,1,0
19548,3389,19548,3389,293,223,70,4,0,3,1
40856,6472,0,0,146,146,0,1,0,1,0
21053,993,3213,993,129,109,20,1,0,1,0
48900,35965,0,0,139,139,0,1,0,1,0
17170,48177,0,0,102,102,0,1,0,1,0
8493,23576,0,0,150,150,0,1,0,1,0
24152,34021,0,0,62,62,0,1,0,1,0
10390,58389,0,0,140,140,0,1,0,1,0
41974,9154,0,0,147,147,0,1,0,1,0
17502,3389,17502,3389,293,223,70,4,0,3,1
24533,31095,0,0,92,92,0,1,0,1,0
49118,30705,0,0,147,147,0,1,0,1,0
1776,23030,0,0,152,152,0,1,0,1,0
50104,28763,0,0,113,113,0,1,0,1,0
12417,24481,0,0,147,147,0,1,0,1,0
2936,24846,0,0,146,146,0,1,0,1,0
17607,61248,0,0,149,149,0,1,0,1,0
28299,26036,0,0,145,145,0,1,0,1,0
50180,3389,50180,3389,293,223,70,4,0,3,1
19470,3389,19470,3389,293,223,70,4,0,3,1
38439,3389,38439,3389,293,223,70,4,0,3,1
53099,22833,0,0,90,90,0,1,0,1,0
16829,1996,6460,1996,198,156,41,2,0,2,0
52229,32986,0,0,62,62,0,1,0,1,0
48968,27280,0,0,154,154,0,1,0,1,0
51983,32259,0,0,62,62,0,1,0,1,0
28017,26179,0,0,143,143,0,1,0,1,0
33653,3389,33653,3389,293,223,70,4,0,3,1
51775,31652,0,0,62,62,0,1,0,1,0
19594,3389,19594,3389,293,223,70,4,0,3,1
53506,18430,0,0,109,109,0,1,0,1,0
11230,61248,0,0,142,142,0,1,0,1,0
42336,3389,42336,3389,293,223,70,4,0,3,1
29352,33607,0,0,66,66,0,1,0,1,0
10746,3389,10746,3389,293,223,70,4,1,3,1
11843,3389,11843,3389,293,223,70,4,0,3,1
50753,32756,0,0,106,106,0,1,0,1,0
10422,25773,0,0,147,147,0,1,0,1,0
33721,3389,33721,3389,293,223,70,4,0,3,1
19971,61248,0,0,154,154,0,1,0,1,0
24261,22743,0,0,113,113,0,1,0,1,0
11967,61248,0,0,140,140,0,1,0,1,0
19132,61248,0,0,154,154,0,1,0,1,0
26823,25773,0,0,147,147,0,1,0,1,0
54130,60731,0,0,109,109,0,1,0,1,0
34014,3389,34014,3389,293,223,70,4,0,3,1
9414,22762,0,0,110,110,0,1,0,1,0
11700,61248,0,0,144,144,0,1,0,1,0
21018,3389,21018,3389,293,223,70,4,0,3,1
15135,53621,0,0,117,117,0,1,0,1,0
18198,19946,0,0,80,80,0,1,0,1,0
19367,3389,19367,3389,293,223,70,4,0,3,1
21166,3389,21166,3389,293,223,70,4,0,3,1
12168,3389,12168,3389,293,223,70,4,1,3,1
49794,33446,0,0,125,125,0,1,0,1,0
62680,3389,62680,3389,293,223,70,4,0,3,1
9554,25773,0,0,150,150,0,1,0,1,0
9240,3389,9240,3389,293,223,70,4,0,3,1
23248,34021,0,0,62,62,0,1,0,1,0
14517,25773,0,0,147,147,0,1,0,1,0
33487,6988,0,0,127,127,0,1,0,1,0
29903,34021,0,0,62,62,0,1,0,1,0
15620,2579,9593,2579,237,184,53,3,0,2,0
38335,3389,38335,3389,293,223,70,4,1,3,1
14576,3389,14576,3389,293,223,70,4,0,3,1
8727,56932,0,0,143,143,0,1,0,1,0
15570,61248,0,0,145,145,0,1,0,1,0
20678,61248,0,0,156,156,0,1,0,1,0
16506,25773,0,0,143,143,0,1,0,1,0
5356,55387,0,0,141,141,0,1,0,1,0
14394,25773,0,0,140,140,0,1,0,1,0
51054,31652,0,0,79,79,0,1,0,1,0
49780,27741,0,0,134,134,0,1,0,1,0
18062,24313,0,0,127,127,0,1,0,1,0
49797,27780,0,0,133,133,0,1,0,1,0
5339,35003,0,0,151,151,0,1,0,1,0
64136,34028,0,0,68,68,0,1,0,1,0
18240,3389,18240,3389,293,223,70,4,0,3,1
51740,31652,0,0,62,62,0,1,0,1,0
10125,24280,0,0,138,138,0,1,0,1,0
38198,3389,38198,3389,293,223,70,4,0,3,1
55079,42707,0,0,88,88,0,1,0,1,0
13296,3389,13296,3389,293,223,70,4,0,3,1
27663,25773,0,0,147,147,0,1,0,1,0
18746,61248,0,0,154,154,0,1,0,1,0
46877,50326,0,0,90,90,0,1,0,1,0
49411,33737,0,0,137,137,0,1,0,1,0
21034,4618,0,0,95,95,0,1,0,1,0
11591,61248,0,0,141,141,0,1,0,1,0
48973,47633,0,0,62,62,0,1,0,1,0
23693,3389,23693,3389,293,223,70,4,0,3,1
37943,60435,0,0,93,93,0,1,0,1,0
49160,31683,0,0,146,146,0,1,0,1,0
18550,3389,18550,3389,293,223,70,4,0,3,1
5394,34819,0,0,151,151,0,1,0,1,0
29045,29481,0,0,109,109,0,1,0,1,0
18017,18416,0,0,64,64,0,1,0,1,0
46590,52672,0,0,83,83,0,1,0,1,0
6000,32806,0,0,152,152,0,1,0,1,0
51735,33437,0,0,82,82,0,1,0,1,0
15688,3389,15688,3389,293,223,70,4,0,3,1
17212,19014,0,0,71,71,0,1,0,1,0
64194,31652,0,0,62,62,0,1,0,1,0
10221,61248,0,0,139,139,0,1,0,1,0
5982,52358,0,0,144,144,0,1,0,1,0
12744,61248,0,0,146,146,0,1,0,1,0
38441,3389,38441,3389,293,223,70,4,1,3,1
12614,7380,5792,1789,224,187,36,2,0,2,0
17061,47212,0,0,101,101,0,1,0,1,0
27672,3389,27672,3389,293,223,70,4,1,3,1
18030,25339,0,0,138,138,0,1,0,1,0
18775,29151,0,0,107,107,0,1,0,1,0
51485,31568,0,0,90,90,0,1,0,1,0
51623,31652,0,0,65,65,0,1,0,1,0
50013,28536,0,0,117,117,0,1,0,1,0
51521,34021,0,0,87,87,0,1,0,1,0
19500,26982,0,0,131,131,0,1,0,1,0
19988,3389,19988,3389,293,223,70,4,0,3,1
50089,32975,0,0,113,113,0,1,0,1,0
49968,33289,0,0,120,120,0,1,0,1,0
12255,6509,6921,2138,239,195,44,2,0,2,0
26646,34021,0,0,62,62,0,1,0,1,0
2888,24771,0,0,146,146,0,1,0,1,0
21439,61248,0,0,157,157,0,1,0,1,0
22067,3389,22067,3389,293,223,70,4,0,3,1
49675,33554,0,0,129,129,0,1,0,1,0
34464,3389,34464,3389,293,223,70,4,0,3,1
15118,3389,15118,3389,293,223,70,4,0,3,1
9717,22607,0,0,108,108,0,1,0,1,0
23736,34021,0,0,62,62,0,1,0,1,0
23614,34021,0,0,62,62,0,1,0,1,0
49605,31652,0,0,131,131,0,1,0,1,0
22260,3389,22260,3389,293,223,70,4,0,3,1
8557,25773,0,0,155,155,0,1,0,1,0
16056,3389,16056,3389,293,223,70,4,0,3,1
6644,24959,0,0,157,157,0,1,0,1,0
52196,32889,0,0,62,62,0,1,0,1,0
14749,3389,14749,3389,293,223,70,4,0,3,1
53763,18399,0,0,104,104,0,1,0,1,0
10251,25773,0,0,147,147,0,1,0,1,0
29684,32687,0,0,75,75,0,1,0,1,0
5550,25773,0,0,149,149,0,1,0,1,0
18744,7136,0,0,113,113,0,1,0,1,0
13054,8446,4410,1362,206,178,28,2,0,1,0
38146,3389,38146,3389,293,223,70,4,1,3,1
3200,49116,0,0,143,143,0,1,0,1,0
49114,30620,0,0,147,147,0,1,0,1,0
51486,31652,0,0,71,71,0,1,0,1,0
59228,61150,0,0,138,138,0,1,0,1,0
37959,3389,37959,3389,293,223,70,4,1,3,1
18042,24949,0,0,134,134,0,1,0,1,0
14298,11459,504,155,154,151,3,1,0,1,0
51718,31652,0,0,63,63,0,1,0,1,0
4012,51477,0,0,142,142,0,1,0,1,0
18374,3389,18374,3389,293,223,70,4,0,3,1
3608,48401,0,0,144,144,0,1,0,1,0
16180,3389,16180,3389,293,223,70,4,0,3,1
31390,3389,31390,3389,293,223,70,4,0,3,1
49093,31877,0,0,148,148,0,1,0,1,0
18455,3389,18455,3389,293,223,70,4,0,3,1
49638,27422,0,0,137,137,0,1,0,1,0
14935,22425,0,0,104,104,0,1,0,1,0
49960,22627,0,0,155,155,0,1,0,1,0
30048,1772,0,0,88,88,0,1,0,1,0
37476,3389,37476,3389,293,223,70,4,1,3,1
26652,34021,0,0,62,62,0,1,0,1,0
25353,29938,0,0,104,104,0,1,0,1,0
8334,61248,0,0,139,139,0,1,0,1,0
49160,33311,0,0,146,146,0,1,0,1,0
29011,34021,0,0,62,62,0,1,0,1,0
10742,61248,0,0,139,139,0,1,0,1,0
56733,3389,56733,3389,293,223,70,4,0,3,1
11414,59935,0,0,139,139,0,1,0,1,0
11545,3389,11545,3389,293,223,70,4,1,3,1
8841,58595,0,0,131,131,0,1,0,1,0
18089,23439,0,0,117,117,0,1,0,1,0
16212,3389,16212,3389,293,223,70,4,0,3,1
11454,61248,0,0,142,142,0,1,0,1,0
4374,38211,0,0,149,149,0,1,0,1,0
63741,31652,0,0,62,62,0,1,0,1,0
3381,47818,0,0,144,144,0,1,0,1,0
16126,20923,0,0,89,89,0,1,0,1,0
18104,3389,18104,3389,293,223,70,4,0,3,1
10307,61248,0,0,141,141,0,1,0,1,0
49110,30525,0,0,148,148,0,1,0,1,0
56199,60901,0,0,121,121,0,1,0,1,0
46125,3389,46125,3389,293,223,70,4,0,3,1
40119,5477,0,0,143,143,0,1,0,1,0
50494,29343,0,0,115,115,0,1,0,1,0
49823,28063,0,0,123,123,0,1,0,1,0
27846,33871,0,0,63,63,0,1,0,1,0
4786,49937,0,0,143,143,0,1,0,1,0
13994,3389,13994,3389,293,223,70,4,0,3,1
49160,32034,0,0,146,146,0,1,0,1,0
16740,25773,0,0,142,142,0,1,0,1,0
9342,57957,0,0,143,143,0,1,0,1,0
7088,29190,0,0,154,154,0,1,0,1,0
1399,22440,0,0,154,154,0,1,0,1,0
16158,3389,16158,3389,293,223,70,4,0,3,1
59598,31652,0,0,88,88,0,1,0,1,0
2109,45400,0,0,144,144,0,1,0,1,0
9897,61248,0,0,141,141,0,1,0,1,0
4773,53690,0,0,141,141,0,1,0,1,0
14115,3389,14115,3389,293,223,70,4,0,3,1
10044,61248,0,0,139,139,0,1,0,1,0
10118,59251,0,0,143,143,0,1,0,1,0
10401,3389,10401,3389,293,223,70,4,1,3,1
49160,33859,0,0,146,146,0,1,0,1,0
48278,38859,0,0,124,124,0,1,0,1,0
53921,3389,53921,3389,293,223,70,4,0,3,1
15634,61248,0,0,145,145,0,1,0,1,0
52042,5618,0,0,145,145,0,1,0,1,0
11625,25773,0,0,141,141,0,1,0,1,0
39074,8421,0,0,145,145,0,1,0,1,0
11501,61248,0,0,142,142,0,1,0,1,0
52141,41232,0,0,145,145,0,1,0,1,0
9083,61248,0,0,140,140,0,1,0,1,0
29259,34021,0,0,62,62,0,1,0,1,0
4585,25773,0,0,146,146,0,1,0,1,0
23902,31818,0,0,82,82,0,1,0,1,0
54948,7787,0,0,146,146,0,1,0,1,0
43549,60147,0,0,70,70,0,1,0,1,0
18869,27354,0,0,127,127,0,1,0,1,0
10616,25773,0,0,139,139,0,1,0,1,0
50661,29366,0,0,98,98,0,1,0,1,0
38310,3389,38310,3389,293,223,70,4,0,3,1
26118,3389,26118,3389,293,223,70,4,0,3,1
12013,61248,0,0,140,140,0,1,0,1,0
48958,27041,0,0,154,154,0,1,0,1,0
28430,34021,0,0,62,62,0,1,0,1,0
9143,61248,0,0,140,140,0,1,0,1,0
5987,57222,0,0,140,140,0,1,0,1,0
59820,31652,0,0,65,65,0,1,0,1,0
8639,61248,0,0,140,140,0,1,0,1,0
16819,19306,0,0,75,75,0,1,0,1,0
51076,31183,0,0,78,78,0,1,0,1,0
24555,34021,0,0,62,62,0,1,0,1,0
8443,56460,0,0,143,143,0,1,0,1,0
29642,34021,0,0,62,62,0,1,0,1,0
49323,33873,0,0,140,140,0,1,0,1,0
52150,32752,0,0,62,62,0,1,0,1,0
10276,3389,10276,3389,293,223,70,4,1,3,1
26727,24591,0,0,134,134,0,1,0,1,0
17307,25773,0,0,144,144,0,1,0,1,0
13483,61248,0,0,141,141,0,1,0,1,0
14905,13594,0,0,147,147,0,1,0,1,0
60075,4442,33772,1787,223,186,36,2,0,2,0
39596,3389,39596,3389,293,223,70,4,0,3,1
62151,31652,0,0,74,74,0,1,0,1,0
15628,25773,0,0,146,146,0,1,0,1,0
19520,61248,0,0,155,155,0,1,0,1,0
49034,28783,0,0,151,151,0,1,0,1,0
50911,31652,0,0,89,89,0,1,0,1,0
9092,61248,0,0,139,139,0,1,0,1,0
4826,49997,0,0,143,143,0,1,0,1,0
10102,4914,7494,2777,266,209,57,3,0,2,0
25986,24036,0,0,128,128,0,1,0,1,0
14710,61248,0,0,148,148,0,1,0,1,0
50863,29781,0,0,92,92,0,1,0,1,0
51209,30487,0,0,80,80,0,1,0,1,0
8584,25773,0,0,154,154,0,1,0,1,0
50362,31652,0,0,107,107,0,1,0,1,0
19650,1498,5572,1498,164,133,30,2,0,1,0
4294,38476,0,0,149,149,0,1,0,1,0
52298,34021,0,0,68,68,0,1,0,1,0
12456,25773,0,0,139,139,0,1,0,1,0
20343,17138,0,0,71,71,0,1,0,1,0
15080,12895,0,0,133,133,0,1,0,1,0
49353,6685,0,0,145,145,0,1,0,1,0
16554,61248,0,0,147,147,0,1,0,1,0
35805,34021,0,0,87,87,0,1,0,1,0
1905,21197,0,0,156,156,0,1,0,1,0
19655,59347,0,0,157,157,0,1,0,1,0
17043,25773,0,0,144,144,0,1,0,1,0
14533,25773,0,0,140,140,0,1,0,1,0
6298,25773,0,0,141,141,0,1,0,1,0
49835,44380,0,0,62,62,0,1,0,1,0
12895,2931,9484,2931,261,201,60,3,0,2,0
49949,33132,0,0,118,118,0,1,0,1,0
24108,31695,0,0,86,86,0,1,0,1,0
8146,25773,0,0,156,156,0,1,0,1,0
13516,9564,2960,914,187,168,18,1,0,1,0
12570,3389,12570,3389,293,223,70,4,1,3,1
48612,3389,48612,3389,293,223,70,4,0,3,1
48721,5618,0,0,145,145,0,1,0,1,0
12914,3389,12914,3389,293,223,70,4,0,3,1
10844,6096,6217,2304,246,198,47,3,0,2,0
27233,24970,0,0,138,138,0,1,0,1,0
8373,24412,0,0,145,145,0,1,0,1,0
49160,33930,0,0,146,146,0,1,0,1,0
50762,32217,0,0,89,89,0,1,0,1,0
9835,4488,7955,2948,274,213,60,3,0,2,0
9074,25773,0,0,140,140,0,1,0,1,0
52079,33122,0,0,65,65,0,1,0,1,0
29250,34021,0,0,62,62,0,1,0,1,0
14114,2641,8547,2641,242,187,54,3,0,2,0
60417,61243,0,0,145,145,0,1,0,1,0
55410,5618,0,0,145,145,0,1,0,1,0
21692,3389,21692,3389,293,223,70,4,0,3,1
51595,31652,0,0,65,65,0,1,0,1,0
49828,5618,0,0,145,145,0,1,0,1,0
10407,61248,0,0,142,142,0,1,0,1,0
36015,3967,0,0,121,121,0,1,0,1,0
15693,3389,15693,3389,293,223,70,4,0,3,1
41208,5618,0,0,145,145,0,1,0,1,0
14780,25773,0,0,147,147,0,1,0,1,0
63512,3389,63512,3389,293,223,70,4,0,3,1
52026,5618,0,0,145,145,0,1,0,1,0
50770,32768,0,0,106,106,0,1,0,1,0
51935,32116,0,0,62,62,0,1,0,1,0
23048,34021,0,0,62,62,0,1,0,1,0
18467,3389,18467,3389,293,223,70,4,0,3,1
48170,3389,48170,3389,293,223,70,4,0,3,1
15919,3389,15919,3389,293,223,70,4,0,3,1
8726,61248,0,0,140,140,0,1,0,1,0
10567,61248,0,0,142,142,0,1,0,1,0
52431,33919,0,0,65,65,0,1,0,1,0
19698,3389,19698,3389,293,223,70,4,0,3,1
26309,25773,0,0,147,147,0,1,0,1,0
5916,57016,0,0,140,140,0,1,0,1,0
2737,47770,0,0,144,144,0,1,0,1,0
51220,31652,0,0,79,79,0,1,0,1,0
18868,3389,18868,3389,293,223,70,4,0,3,1
51992,32965,0,0,66,66,0,1,0,1,0
53414,5618,0,0,145,145,0,1,0,1,0
17111,61248,0,0,148,148,0,1,0,1,0
49715,31652,0,0,126,126,0,1,0,1,0
4411,52638,0,0,142,142,0,1,0,1,0
9889,4575,7861,2913,272,212,60,3,0,2,0
14094,10964,1145,353,163,155,7,1,0,1,0
10414,3389,10414,3389,293,223,70,4,1,3,1
50095,31652,0,0,113,113,0,1,0,1,0
8547,59126,0,0,133,133,0,1,0,1,0
48860,48063,0,0,62,62,0,1,0,1,0
3838,23409,0,0,157,157,0,1,0,1,0
49154,33843,0,0,146,146,0,1,0,1,0
50447,5618,0,0,145,145,0,1,0,1,0
16804,21029,0,0,144,144,0,1,0,1,0
28269,27509,0,0,129,129,0,1,0,1,0
49160,31657,0,0,146,146,0,1,0,1,0
49160,31739,0,0,146,146,0,1,0,1,0
15027,3389,15027,3389,293,223,70,4,0,3,1
17357,23191,0,0,143,143,0,1,0,1,0
12348,3389,12348,3389,293,223,70,4,1,3,1
10719,61248,0,0,142,142,0,1,0,1,0
14585,20965,0,0,96,96,0,1,0,1,0
50904,32442,0,0,90,90,0,1,0,1,0
11307,61248,0,0,142,142,0,1,0,1,0
51024,31652,0,0,80,80,0,1,0,1,0
28217,29994,0,0,103,103,0,1,0,1,0
9798,61248,0,0,141,141,0,1,0,1,0
49653,27306,0,0,132,132,0,1,0,1,0
32381,19036,0,0,147,147,0,1,0,1,0
26608,28167,0,0,123,123,0,1,0,1,0
19422,28382,0,0,117,117,0,1,0,1,0
32902,3389,32902,3389,293,223,70,4,0,3,1
7560,54987,0,0,143,143,0,1,0,1,0
30455,4421,0,0,103,103,0,1,0,1,0
6305,52896,0,0,144,144,0,1,0,1,0
51419,30742,0,0,74,74,0,1,0,1,0
35704,9246,0,0,146,146,0,1,0,1,0
46530,5618,0,0,145,145,0,1,0,1,0
14529,26941,0,0,128,128,0,1,0,1,0
10790,3389,10790,3389,293,223,70,4,1,3,1
27636,3389,27636,3389,293,223,70,4,0,3,1
14826,12466,0,0,139,139,0,1,0,1,0
7732,61248,0,0,139,139,0,1,0,1,0
50589,29970,0,0,96,96,0,1,0,1,0
28609,27297,0,0,132,132,0,1,0,1,0
5639,25773,0,0,149,149,0,1,0,1,0
51376,31652,0,0,69,69,0,1,0,1,0
9987,3389,9987,3389,293,223,70,4,1,3,1
25542,29671,0,0,107,107,0,1,0,1,0
28163,32620,0,0,76,76,0,1,0,1,0
11089,3686,10580,3269,287,220,67,3,0,2,0
50073,31652,0,0,116,116,0,1,0,1,0
18232,3389,18232,3389,293,223,70,4,0,3,1
9401,3389,9401,3389,293,223,70,4,1,3,1
51056,32305,0,0,85,85,0,1,0,1,0
17729,18901,0,0,68,68,0,1,0,1,0
11889,3389,11889,3389,293,223,70,4,1,3,1
27818,25408,0,0,143,143,0,1,0,1,0
25188,32487,0,0,76,76,0,1,0,1,0
23041,21830,0,0,102,102,0,1,0,1,0
8783,61248,0,0,140,140,0,1,0,1,0
51507,34021,0,0,88,88,0,1,0,1,0
18055,3389,18055,3389,293,223,70,4,0,3,1
2245,43520,0,0,144,144,0,1,0,1,0
28888,28697,0,0,117,117,0,1,0,1,0
60900,32361,0,0,62,62,0,1,0,1,0
17564,25773,0,0,143,143,0,1,0,1,0
16031,2469,9183,2469,230,179,51,3,0,2,0
10836,25773,0,0,153,153,0,1,0,1,0
12445,3389,12445,3389,293,223,70,4,1,3,1
51257,31652,0,0,72,72,0,1,0,1,0
34656,7978,0,0,136,136,0,1,0,1,0
49216,33956,0,0,143,143,0,1,0,1,0
31149,3389,31149,3389,293,223,70,4,0,3,1
20274,3389,20274,3389,293,223,70,4,0,3,1
58265,31652,0,0,66,66,0,1,0,1,0
21807,35617,0,0,66,66,0,1,0,1,0
13721,3389,13721,3389,293,223,70,4,0,3,1
14906,3389,14906,3389,293,223,70,4,0,3,1
50908,30763,0,0,84,84,0,1,0,1,0
26739,24600,0,0,134,134,0,1,0,1,0
12605,3389,12605,3389,293,223,70,4,0,3,1
6350,49131,0,0,147,147,0,1,0,1,0
15976,14406,0,0,113,113,0,1,0,1,0
14878,61248,0,0,144,144,0,1,0,1,0
15939,14343,0,0,114,114,0,1,0,1,0
13588,3389,13588,3389,293,223,70,4,0,3,1
20355,3389,20355,3389,293,223,70,4,0,3,1
54820,31652,0,0,62,62,0,1,0,1,0
21053,61248,0,0,157,157,0,1,0,1,0
38427,9043,0,0,146,146,0,1,0,1,0
2786,47914,0,0,144,144,0,1,0,1,0
58415,3389,58415,3389,293,223,70,4,0,3,1
54008,10583,0,0,147,147,0,1,0,1,0
21245,61248,0,0,157,157,0,1,0,1,0
4237,52132,0,0,142,142,0,1,0,1,0
11988,61248,0,0,140,140,0,1,0,1,0
8834,25773,0,0,143,143,0,1,0,1,0
12068,6056,7508,2320,247,199,47,3,0,2,0
17084,16274,0,0,88,88,0,1,0,1,0
55834,31652,0,0,68,68,0,1,0,1,0
17143,61248,0,0,152,152,0,1,0,1,0
51094,30690,0,0,100,100,0,1,0,1,0
55563,5637,0,0,145,145,0,1,0,1,0
16106,25773,0,0,145,145,0,1,0,1,0
51460,31652,0,0,68,68,0,1,0,1,0
12382,8543,3572,1323,204,177,27,2,0,1,0
16009,25773,0,0,145,145,0,1,0,1,0
12492,3389,12492,3389,293,223,70,4,1,3,1
21281,25773,0,0,144,144,0,1,0,1,0
63147,3389,63147,3389,293,223,70,4,0,3,1
16662,3389,16662,3389,293,223,70,4,0,3,1
57795,5051,16264,861,182,164,17,1,0,1,0
21107,61248,0,0,156,156,0,1,0,1,0
17652,42697,0,0,86,86,0,1,0,1,0
9447,3389,9447,3389,293,223,70,4,1,3,1
63258,31652,0,0,62,62,0,1,0,1,0
39735,8310,0,0,145,145,0,1,0,1,0
15625,3389,15625,3389,293,223,70,4,0,3,1
8126,55930,0,0,143,143,0,1,0,1,0
51480,31652,0,0,67,67,0,1,0,1,0
17574,61248,0,0,152,152,0,1,0,1,0
15111,19848,0,0,79,79,0,1,0,1,0
27057,32021,0,0,81,81,0,1,0,1,0
33705,34021,0,0,78,78,0,1,0,1,0
10341,25773,0,0,139,139,0,1,0,1,0
54230,33691,0,0,62,62,0,1,0,1,0
18197,20003,0,0,80,80,0,1,0,1,0
16016,61248,0,0,146,146,0,1,0,1,0
22257,3389,22257,3389,293,223,70,4,0,3,1
3052,25026,0,0,145,145,0,1,0,1,0
17960,3389,17960,3389,293,223,70,4,0,3,1
28881,34021,0,0,62,62,0,1,0,1,0
50377,29082,0,0,118,118,0,1,0,1,0
15192,3389,15192,3389,293,223,70,4,0,3,1
28423,1174,0,0,79,79,0,1,0,1,0
56059,46314,0,0,103,103,0,1,0,1,0
46335,7195,0,0,145,145,0,1,0,1,0
49984,31652,0,0,117,117,0,1,0,1,0
16107,61248,0,0,146,146,0,1,0,1,0
14814,52702,0,0,117,117,0,1,0,1,0
9603,3389,9603,3389,293,223,70,4,1,3,1
21113,3389,21113,3389,293,223,70,4,0,3,1
46960,21114,0,0,154,154,0,1,0,1,0
50030,5618,0,0,145,145,0,1,0,1,0
4022,25520,0,0,140,140,0,1,0,1,0
31478,3389,31478,3389,293,223,70,4,0,3,1
49601,5618,0,0,145,145,0,1,0,1,0
13797,12340,0,0,148,148,0,1,0,1,0
51763,60536,0,0,96,96,0,1,0,1,0
28312,34021,0,0,62,62,0,1,0,1,0
20994,3389,20994,3389,293,223,70,4,0,3,1
21827,33507,0,0,66,66,0,1,0,1,0
49144,31290,0,0,146,146,0,1,0,1,0
36362,8586,0,0,146,146,0,1,0,1,0
25831,34021,0,0,62,62,0,1,0,1,0
51564,32193,0,0,69,69,0,1,0,1,0
10289,3389,10289,3389,293,223,70,4,1,3,1
50946,6416,0,0,145,145,0,1,0,1,0
22995,601,2234,600,102,90,12,1,0,1,0
43978,60125,0,0,69,69,0,1,0,1,0
29604,32284,0,0,80,80,0,1,0,1,0
11239,61248,0,0,142,142,0,1,0,1,0
50723,32735,0,0,107,107,0,1,0,1,0
13321,9092,3572,1104,195,172,22,1,0,1,0
13933,11011,904,335,162,155,6,1,0,1,0
52213,32941,0,0,62,62,0,1,0,1,0
20730,3389,20730,3389,293,223,70,4,0,3,1
10142,61248,0,0,141,141,0,1,0,1,0
17995,45967,0,0,95,95,0,1,0,1,0
19429,3389,19429,3389,293,223,70,4,0,3,1
22220,30943,0,0,90,90,0,1,0,1,0
10366,59664,0,0,143,143,0,1,0,1,0
11492,4661,9317,2879,271,211,59,3,0,2,0
51275,31652,0,0,71,71,0,1,0,1,0
18091,23400,0,0,117,117,0,1,0,1,0
15751,25773,0,0,141,141,0,1,0,1,0
23888,30559,0,0,95,95,0,1,0,1,0
51968,40813,0,0,145,145,0,1,0,1,0
14099,3389,14099,3389,293,223,70,4,1,3,1
28228,29488,0,0,109,109,0,1,0,1,0
48945,25879,0,0,155,155,0,1,0,1,0
29377,31145,0,0,91,91,0,1,0,1,0
50291,29227,0,0,107,107,0,1,0,1,0
52201,33341,0,0,64,64,0,1,0,1,0
49462,24109,0,0,156,156,0,1,0,1,0
46362,5618,0,0,145,145,0,1,0,1,0
18045,24861,0,0,133,133,0,1,0,1,0
19508,6296,0,0,107,107,0,1,0,1,0
29998,4034,0,0,99,99,0,1,0,1,0
13393,58281,0,0,130,130,0,1,0,1,0
26399,28462,0,0,119,119,0,1,0,1,0
52540,33954,0,0,62,62,0,1,0,1,0
60270,32487,0,0,62,62,0,1,0,1,0
23909,34021,0,0,62,62,0,1,0,1,0
51996,31652,0,0,130,130,0,1,0,1,0
51991,32704,0,0,77,77,0,1,0,1,0
33831,16639,0,0,147,147,0,1,0,1,0
16622,19452,0,0,77,77,0,1,0,1,0
18197,61248,0,0,153,153,0,1,0,1,0
14501,25773,0,0,140,140,0,1,0,1,0
5566,25773,0,0,149,149,0,1,0,1,0
21596,36334,0,0,68,68,0,1,0,1,0
3551,22733,0,0,152,152,0,1,0,1,0
56113,5501,3346,177,152,149,3,1,0,1,0
32761,2770,0,0,103,103,0,1,0,1,0
12109,61248,0,0,139,139,0,1,0,1,0
9069,61248,0,0,140,140,0,1,0,1,0
37757,7585,0,0,146,146,0,1,0,1,0
50578,32424,0,0,96,96,0,1,0,1,0
46519,3389,46519,3389,293,223,70,4,0,3,1
33186,3389,33186,3389,293,223,70,4,0,3,1
48922,33591,0,0,140,140,0,1,0,1,0
28535,34021,0,0,62,62,0,1,0,1,0
49160,33426,0,0,146,146,0,1,0,1,0
20247,61248,0,0,156,156,0,1,0,1,0
15381,61248,0,0,149,149,0,1,0,1,0
52406,33711,0,0,63,63,0,1,0,1,0
17638,19016,0,0,69,69,0,1,0,1,0
49614,33509,0,0,130,130,0,1,0,1,0
7584,25479,0,0,157,157,0,1,0,1,0
46058,58646,0,0,62,62,0,1,0,1,0
3082,25075,0,0,145,145,0,1,0,1,0
9886,25773,0,0,154,154,0,1,0,1,0
45455,7344,0,0,145,145,0,1,0,1,0
11600,61248,0,0,141,141,0,1,0,1,0
11347,4310,9771,3019,277,214,62,3,0,2,0
1605,22175,0,0,157,157,0,1,0,1,0
27967,3389,27967,3389,293,223,70,4,0,3,1
19843,31900,0,0,81,81,0,1,0,1,0
54466,12765,0,0,124,124,0,1,0,1,0
36992,3389,36992,3389,293,223,70,4,0,3,1
51525,31134,0,0,70,70,0,1,0,1,0
54987,42641,0,0,92,92,0,1,0,1,0
48959,27595,0,0,154,154,0,1,0,1,0
23904,3389,23904,3389,293,223,70,4,0,3,1
29285,3389,29285,3389,293,223,70,4,0,3,1
10769,25246,0,0,141,141,0,1,0,1,0
1816,23093,0,0,152,152,0,1,0,1,0
12989,21253,0,0,141,141,0,1,0,1,0
15489,2314,7490,2314,219,171,47,3,0,2,0
33431,60667,0,0,112,112,0,1,0,1,0
51314,31652,0,0,71,71,0,1,0,1,0
52273,33118,0,0,62,62,0,1,0,1,0
15843,17264,0,0,146,146,0,1,0,1,0
19098,3389,19098,3389,293,223,70,4,0,3,1
9555,3389,9555,3389,293,223,70,4,1,3,1
36875,8793,0,0,145,145,0,1,0,1,0
10990,3446,10892,3365,292,222,69,3,0,2,0
11748,3389,11748,3389,293,223,70,4,0,3,1
38906,60386,0,0,89,89,0,1,0,1,0
15824,25773,0,0,141,141,0,1,0,1,0
61523,31652,0,0,78,78,0,1,0,1,0
55022,42762,0,0,93,93,0,1,0,1,0
22141,29135,0,0,109,109,0,1,0,1,0
52451,31652,0,0,127,127,0,1,0,1,0
50357,31652,0,0,103,103,0,1,0,1,0
35354,8569,0,0,142,142,0,1,0,1,0
15005,25773,0,0,140,140,0,1,0,1,0
50222,28469,0,0,113,113,0,1,0,1,0
9665,3389,9665,3389,293,223,70,4,0,3,1
37275,3389,37275,3389,293,223,70,4,1,3,1
51269,32112,0,0,78,78,0,1,0,1,0
22265,3389,22265,3389,293,223,70,4,0,3,1
57221,5205,11850,627,172,159,12,1,0,1,0
50600,34021,0,0,110,110,0,1,0,1,0
9489,25773,0,0,151,151,0,1,0,1,0
11005,60728,0,0,143,143,0,1,0,1,0
49160,33163,0,0,146,146,0,1,0,1,0
27009,27600,0,0,128,128,0,1,0,1,0
15095,3389,15095,3389,293,223,70,4,0,3,1
49312,33849,0,0,140,140,0,1,0,1,0
52521,31652,0,0,62,62,0,1,0,1,0
7808,25773,0,0,156,156,0,1,0,1,0
60961,4205,40571,2147,238,194,44,2,0,2,0
7438,25773,0,0,141,141,0,1,0,1,0
27091,25773,0,0,147,147,0,1,0,1,0
8172,25773,0,0,140,140,0,1,0,1,0
3037,32575,0,0,143,143,0,1,0,1,0
13894,3389,13894,3389,293,223,70,4,0,3,1
17913,61248,0,0,152,152,0,1,0,1,0
19717,61248,0,0,154,154,0,1,0,1,0
33316,3389,33316,3389,293,223,70,4,0,3,1
17130,29701,0,0,102,102,0,1,0,1,0
16360,3389,16360,3389,293,223,70,4,0,3,1
51578,31652,0,0,68,68,0,1,0,1,0
51675,31652,0,0,64,64,0,1,0,1,0
9305,23763,0,0,150,150,0,1,0,1,0
18364,3389,18364,3389,293,223,70,4,0,3,1
13977,25773,0,0,148,148,0,1,0,1,0
18964,3389,18964,3389,293,223,70,4,0,3,1
12209,8268,3869,1434,209,179,29,2,0,1,0
16008,2191,7091,2191,211,166,45,2,0,2,0
38437,3389,38437,3389,293,223,70,4,1,3,1
39598,34021,0,0,104,104,0,1,0,1,0
52672,31652,0,0,70,70,0,1,0,1,0
50434,32868,0,0,105,105,0,1,0,1,0
26428,3389,26428,3389,293,223,70,4,0,3,1
17285,25773,0,0,144,144,0,1,0,1,0
48936,47774,0,0,62,62,0,1,0,1,0
18064,61248,0,0,152,152,0,1,0,1,0
11357,61248,0,0,142,142,0,1,0,1,0
14452,2893,10759,2893,259,199,59,3,0,2,0
51236,33091,0,0,94,94,0,1,0,1,0
15296,3389,15296,3389,293,223,70,4,0,3,1
3961,48990,0,0,144,144,0,1,0,1,0
20811,30960,0,0,92,92,0,1,0,1,0
54905,5618,0,0,145,145,0,1,0,1,0
15639,13838,0,0,121,121,0,1,0,1,0
14645,3389,14645,3389,293,223,70,4,0,3,1
11718,3389,11718,3389,293,223,70,4,0,3,1
13734,12387,0,0,148,148,0,1,0,1,0
10637,61248,0,0,142,142,0,1,0,1,0
21263,36181,0,0,68,68,0,1,0,1,0
11632,61248,0,0,141,141,0,1,0,1,0
12398,3389,12398,3389,293,223,70,4,1,3,1
3920,25773,0,0,142,142,0,1,0,1,0
9546,25773,0,0,143,143,0,1,0,1,0
64046,31652,0,0,64,64,0,1,0,1,0
18160,21163,0,0,93,93,0,1,0,1,0
14113,11011,1084,335,162,155,6,1,0,1,0
16300,3389,16300,3389,293,223,70,4,0,3,1
44414,3389,44414,3389,293,223,70,4,0,3,1
59838,59259,0,0,139,139,0,1,0,1,0
5466,55707,0,0,141,141,0,1,0,1,0
4775,47921,0,0,146,146,0,1,0,1,0
18788,7088,0,0,113,113,0,1,0,1,0
10018,61248,0,0,142,142,0,1,0,1,0
4541,23797,0,0,157,157,0,1,0,1,0
37393,3389,37393,3389,293,223,70,4,1,3,1
50613,29612,0,0,112,112,0,1,0,1,0
8513,25477,0,0,153,153,0,1,0,1,0
54473,5821,0,0,145,145,0,1,0,1,0
52037,34021,0,0,75,75,0,1,0,1,0
23205,32970,0,0,72,72,0,1,0,1,0
17119,19670,0,0,76,76,0,1,0,1,0
49803,33296,0,0,123,123,0,1,0,1,0
23947,25773,0,0,145,145,0,1,0,1,0
49023,29630,0,0,151,151,0,1,0,1,0
14415,23082,0,0,111,111,0,1,0,1,0
28172,34021,0,0,62,62,0,1,0,1,0
10736,3389,10736,3389,293,223,70,4,1,3,1
4723,23898,0,0,157,157,0,1,0,1,0
7604,61248,0,0,139,139,0,1,0,1,0
9891,25773,0,0,149,149,0,1,0,1,0
20925,3389,20925,3389,293,223,70,4,0,3,1
20848,3389,20848,3389,293,223,70,4,0,3,1
18044,3389,18044,3389,293,223,70,4,0,3,1
13919,27098,0,0,126,126,0,1,0,1,0
50717,30288,0,0,91,91,0,1,0,1,0
24167,3389,24167,3389,293,223,70,4,0,3,1
54917,10102,0,0,132,132,0,1,0,1,0
36219,8688,0,0,146,146,0,1,0,1,0
51326,31652,0,0,70,70,0,1,0,1,0
15609,25773,0,0,141,141,0,1,0,1,0
7456,17063,0,0,152,152,0,1,0,1,0
12186,61248,0,0,139,139,0,1,0,1,0
38124,3389,38124,3389,293,223,70,4,1,3,1
12149,61248,0,0,139,139,0,1,0,1,0
11386,3389,11386,3389,293,223,70,4,1,3,1
19177,3389,19177,3389,293,223,70,4,0,3,1
50340,31652,0,0,104,104,0,1,0,1,0
52635,6131,0,0,145,145,0,1,0,1,0
26867,34021,0,0,62,62,0,1,0,1,0
49160,31715,0,0,146,146,0,1,0,1,0
24101,34021,0,0,62,62,0,1,0,1,0
1486,22578,0,0,154,154,0,1,0,1,0
60675,31652,0,0,82,82,0,1,0,1,0
10240,61248,0,0,142,142,0,1,0,1,0
12030,61248,0,0,140,140,0,1,0,1,0
50209,31652,0,0,112,112,0,1,0,1,0
5954,23570,0,0,149,149,0,1,0,1,0
29317,34021,0,0,62,62,0,1,0,1,0
51288,34021,0,0,93,93,0,1,0,1,0
18589,3389,18589,3389,293,223,70,4,0,3,1
15716,2554,9498,2553,236,183,52,3,0,2,0
38352,3389,38352,3389,293,223,70,4,1,3,1
18631,61248,0,0,153,153,0,1,0,1,0
1033,21859,0,0,157,157,0,1,0,1,0
49143,46994,0,0,62,62,0,1,0,1,0
60996,4195,40845,2162,239,194,44,2,0,2,0
51673,60529,0,0,95,95,0,1,0,1,0
21971,3389,21971,3389,293,223,70,4,0,3,1
10218,3389,10218,3389,293,223,70,4,1,3,1
34920,8201,0,0,138,138,0,1,0,1,0
9643,61248,0,0,141,141,0,1,0,1,0
13308,3389,13308,3389,293,223,70,4,0,3,1
57677,61022,0,0,129,129,0,1,0,1,0
49479,33732,0,0,135,135,0,1,0,1,0
23808,22404,0,0,109,109,0,1,0,1,0
18066,24175,0,0,125,125,0,1,0,1,0
28252,28317,0,0,121,121,0,1,0,1,0
5623,56162,0,0,140,140,0,1,0,1,0
10717,25228,0,0,141,141,0,1,0,1,0
46963,21120,0,0,154,154,0,1,0,1,0
49539,33594,0,0,132,132,0,1,0,1,0
16573,20359,0,0,83,83,0,1,0,1,0
16346,3389,16346,3389,293,223,70,4,0,3,1
52047,33064,0,0,66,66,0,1,0,1,0
12410,3389,12410,3389,293,223,70,4,1,3,1
41041,5618,0,0,145,145,0,1,0,1,0
15209,3389,15209,3389,293,223,70,4,0,3,1
20080,61248,0,0,155,155,0,1,0,1,0
11417,61248,0,0,142,142,0,1,0,1,0
50517,5618,0,0,145,145,0,1,0,1,0
2939,24850,0,0,146,146,0,1,0,1,0
43877,5618,0,0,145,145,0,1,0,1,0
3251,49265,0,0,143,143,0,1,0,1,0
29703,3389,29703,3389,293,223,70,4,0,3,1
16669,20500,0,0,144,144,0,1,0,1,0
52136,33224,0,0,65,65,0,1,0,1,0
11954,61248,0,0,140,140,0,1,0,1,0
32619,3389,32619,3389,293,223,70,4,0,3,1
51461,31652,0,0,68,68,0,1,0,1,0
19566,3389,19566,3389,293,223,70,4,0,3,1
9941,25773,0,0,149,149,0,1,0,1,0
19137,3389,19137,3389,293,223,70,4,0,3,1
2567,22707,0,0,157,157,0,1,0,1,0
22049,61248,0,0,158,158,0,1,0,1,0
15794,46050,0,0,96,96,0,1,0,1,0
29015,34021,0,0,62,62,0,1,0,1,0
13420,3389,13420,3389,293,223,70,4,0,3,1
3723,25773,0,0,142,142,0,1,0,1,0
62165,3389,62165,3389,293,223,70,4,0,3,1
59488,61171,0,0,139,139,0,1,0,1,0
9384,25773,0,0,151,151,0,1,0,1,0
13759,3389,13759,3389,293,223,70,4,0,3,1
23995,25773,0,0,145,145,0,1,0,1,0
24245,31997,0,0,80,80,0,1,0,1,0
48335,24411,0,0,156,156,0,1,0,1,0
53126,5618,0,0,145,145,0,1,0,1,0
49969,33288,0,0,120,120,0,1,0,1,0
4963,54244,0,0,141,141,0,1,0,1,0
49160,31763,0,0,146,146,0,1,0,1,0
19855,5915,0,0,104,104,0,1,0,1,0
11173,59571,0,0,139,139,0,1,0,1,0
39445,3389,39445,3389,293,223,70,4,0,3,1
15344,3389,15344,3389,293,223,70,4,0,3,1
20919,31159,0,0,90,90,0,1,0,1,0
49518,31900,0,0,137,137,0,1,0,1,0
49512,33702,0,0,134,134,0,1,0,1,0
13188,3389,13188,3389,293,223,70,4,0,3,1
49655,33462,0,0,128,128,0,1,0,1,0
52429,33581,0,0,62,62,0,1,0,1,0
35546,60558,0,0,103,103,0,1,0,1,0
20259,19745,0,0,79,79,0,1,0,1,0
51470,32021,0,0,70,70,0,1,0,1,0
4455,25773,0,0,145,145,0,1,0,1,0
12633,25773,0,0,150,150,0,1,0,1,0
50465,29662,0,0,100,100,0,1,0,1,0
45814,3389,45814,3389,293,223,70,4,0,3,1
18393,3389,18393,3389,293,223,70,4,0,3,1
12366,25236,0,0,139,139,0,1,0,1,0
22334,3389,22334,3389,293,223,70,4,0,3,1
14352,21138,0,0,98,98,0,1,0,1,0
52154,34021,0,0,72,72,0,1,0,1,0
13029,3389,13029,3389,293,223,70,4,0,3,1
50378,32649,0,0,103,103,0,1,0,1,0
24427,25773,0,0,146,146,0,1,0,1,0
51348,31652,0,0,70,70,0,1,0,1,0
49129,33035,0,0,147,147,0,1,0,1,0
29313,34021,0,0,62,62,0,1,0,1,0
44549,7497,0,0,145,145,0,1,0,1,0
59566,61177,0,0,140,140,0,1,0,1,0
4057,48837,0,0,143,143,0,1,0,1,0
40865,8119,0,0,145,145,0,1,0,1,0
59248,58416,0,0,145,145,0,1,0,1,0
46859,55621,0,0,62,62,0,1,0,1,0
16512,3389,16512,3389,293,223,70,4,0,3,1
6901,25101,0,0,157,157,0,1,0,1,0
49160,31877,0,0,146,146,0,1,0,1,0
21558,3389,21558,3389,293,223,70,4,0,3,1
49209,33964,0,0,144,144,0,1,0,1,0
22439,31057,0,0,89,89,0,1,0,1,0
4990,25773,0,0,142,142,0,1,0,1,0
38303,3389,38303,3389,293,223,70,4,1,3,1
9302,3389,9302,3389,293,223,70,4,1,3,1
28360,26052,0,0,145,145,0,1,0,1,0
10429,61248,0,0,139,139,0,1,0,1,0
47260,47193,0,0,100,100,0,1,0,1,0
9995,3389,9995,3389,293,223,70,4,1,3,1
22219,25773,0,0,145,145,0,1,0,1,0
28177,31969,0,0,83,83,0,1,0,1,0
16691,3389,16691,3389,293,223,70,4,0,3,1
21893,61248,0,0,158,158,0,1,0,1,0
51590,31652,0,0,65,65,0,1,0,1,0
15340,3389,15340,3389,293,223,70,4,0,3,1
50488,31652,0,0,103,103,0,1,0,1,0
9785,3389,9785,3389,293,223,70,4,1,3,1
21453,20640,0,0,89,89,0,1,0,1,0
7392,61248,0,0,139,139,0,1,0,1,0
34714,11456,0,0,146,146,0,1,0,1,0
28225,25773,0,0,147,147,0,1,0,1,0
9339,3389,9339,3389,293,223,70,4,1,3,1
51660,31652,0,0,65,65,0,1,0,1,0
2663,37737,0,0,144,144,0,1,0,1,0
7403,25773,0,0,154,154,0,1,0,1,0
19496,19174,0,0,72,72,0,1,0,1,0
16248,20769,0,0,87,87,0,1,0,1,0
10076,3389,10076,3389,293,223,70,4,1,3,1
11332,61248,0,0,142,142,0,1,0,1,0
3776,23374,0,0,157,157,0,1,0,1,0
3510,23228,0,0,157,157,0,1,0,1,0
48906,25849,0,0,156,156,0,1,0,1,0
57116,49936,0,0,113,113,0,1,0,1,0
51709,32071,0,0,84,84,0,1,0,1,0
17245,61248,0,0,151,151,0,1,0,1,0
21885,3389,21885,3389,293,223,70,4,0,3,1
21773,61248,0,0,158,158,0,1,0,1,0
12714,7621,5479,1693,220,185,34,2,0,1,0
39313,7579,0,0,146,146,0,1,0,1,0
32387,19025,0,0,147,147,0,1,0,1,0
28042,25773,0,0,147,147,0,1,0,1,0
5360,34933,0,0,151,151,0,1,0,1,0
49160,32084,0,0,146,146,0,1,0,1,0
28272,27335,0,0,131,131,0,1,0,1,0
4103,49226,0,0,144,144,0,1,0,1,0
7047,60304,0,0,139,139,0,1,0,1,0
7157,23916,0,0,123,123,0,1,0,1,0
14812,3389,14812,3389,293,223,70,4,0,3,1
11173,3389,11173,3389,293,223,70,4,0,3,1
10467,3389,10467,3389,293,223,70,4,0,3,1
28295,26254,0,0,142,142,0,1,0,1,0
17694,17301,0,0,74,74,0,1,0,1,0
49090,30053,0,0,148,148,0,1,0,1,0
48334,5618,0,0,145,145,0,1,0,1,0
14926,61248,0,0,148,148,0,1,0,1,0
13759,61248,0,0,141,141,0,1,0,1,0
33801,3389,33801,3389,293,223,70,4,0,3,1
19781,59444,0,0,157,157,0,1,0,1,0
19409,3389,19409,3389,293,223,70,4,0,3,1
55045,33109,0,0,113,113,0,1,0,1,0
12207,3389,12207,3389,293,223,70,4,1,3,1
9483,25773,0,0,151,151,0,1,0,1,0
48192,24069,0,0,156,156,0,1,0,1,0
23350,25773,0,0,145,145,0,1,0,1,0
11764,60462,0,0,139,139,0,1,0,1,0
50305,3389,50305,3389,293,223,70,4,0,3,1
18204,18277,0,0,62,62,0,1,0,1,0
49160,33134,0,0,146,146,0,1,0,1,0
58424,3389,58424,3389,293,223,70,4,0,3,1
62258,31652,0,0,62,62,0,1,0,1,0
18220,19262,0,0,72,72,0,1,0,1,0
2855,22866,0,0,157,157,0,1,0,1,0
60910,31652,0,0,81,81,0,1,0,1,0
18793,3389,18793,3389,293,223,70,4,0,3,1
9330,3389,9330,3389,293,223,70,4,0,3,1
16682,20222,0,0,82,82,0,1,0,1,0
15127,22184,0,0,102,102,0,1,0,1,0
55489,44361,0,0,97,97,0,1,0,1,0
51608,31303,0,0,67,67,0,1,0,1,0
49160,31656,0,0,146,146,0,1,0,1,0
51627,32306,0,0,69,69,0,1,0,1,0
48440,39413,0,0,128,128,0,1,0,1,0
20847,31026,0,0,91,91,0,1,0,1,0
4814,25773,0,0,146,146,0,1,0,1,0
14727,3389,14727,3389,293,223,70,4,0,3,1
50535,29109,0,0,103,103,0,1,0,1,0
20495,30372,0,0,97,97,0,1,0,1,0
59270,31652,0,0,62,62,0,1,0,1,0
28813,34021,0,0,62,62,0,1,0,1,0
15768,3389,15768,3389,293,223,70,4,0,3,1
38172,7288,0,0,146,146,0,1,0,1,0
13695,16732,0,0,144,144,0,1,0,1,0
2475,24124,0,0,148,148,0,1,0,1,0
28228,29463,0,0,109,109,0,1,0,1,0
15854,3389,15854,3389,293,223,70,4,0,3,1
14606,26981,0,0,127,127,0,1,0,1,0
21230,3389,21230,3389,293,223,70,4,0,3,1
28748,34021,0,0,62,62,0,1,0,1,0
11926,61248,0,0,140,140,0,1,0,1,0
10324,24132,0,0,136,136,0,1,0,1,0
15986,28774,0,0,110,110,0,1,0,1,0
12363,61248,0,0,145,145,0,1,0,1,0
12307,3389,12307,3389,293,223,70,4,1,3,1
23898,34021,0,0,62,62,0,1,0,1,0
9607,3389,9607,3389,293,223,70,4,1,3,1
22335,29293,0,0,108,108,0,1,0,1,0
50564,32750,0,0,100,100,0,1,0,1,0
12037,5981,7605,2350,248,200,48,3,0,2,0
49160,32232,0,0,146,146,0,1,0,1,0
10022,61248,0,0,139,139,0,1,0,1,0
5505,24330,0,0,157,157,0,1,0,1,0
49950,28124,0,0,129,129,0,1,0,1,0
16946,3389,16946,3389,293,223,70,4,0,3,1
12495,3389,12495,3389,293,223,70,4,1,3,1
16582,3389,16582,3389,293,223,70,4,0,3,1
11466,3389,11466,3389,293,223,70,4,1,3,1
11773,3389,11773,3389,293,223,70,4,1,3,1
21397,61248,0,0,157,157,0,1,0,1,0
14064,3389,14064,3389,293,223,70,4,0,3,1
9756,3389,9756,3389,293,223,70,4,0,3,1
10446,59798,0,0,143,143,0,1,0,1,0
10312,5249,7132,2643,261,206,54,3,0,2,0
37521,3389,37521,3389,293,223,70,4,1,3,1
52547,33966,0,0,62,62,0,1,0,1,0
49880,33369,0,0,122,122,0,1,0,1,0
49647,27295,0,0,132,132,0,1,0,1,0
22853,33466,0,0,67,67,0,1,0,1,0
32232,3389,32232,3389,293,223,70,4,1,3,1
28994,24632,0,0,147,147,0,1,0,1,0
6235,57942,0,0,140,140,0,1,0,1,0
39465,34021,0,0,103,103,0,1,0,1,0
28554,27020,0,0,134,134,0,1,0,1,0
13854,27046,0,0,127,127,0,1,0,1,0
57645,51747,0,0,118,118,0,1,0,1,0
28914,24411,0,0,147,147,0,1,0,1,0
16435,2361,8780,2360,222,174,48,3,0,2,0
38459,3389,38459,3389,293,223,70,4,1,3,1
18062,24319,0,0,127,127,0,1,0,1,0
18028,3389,18028,3389,293,223,70,4,0,3,1
18104,3389,18104,3389,293,223,70,4,0,3,1
23506,34021,0,0,62,62,0,1,0,1,0
15361,3389,15361,3389,293,223,70,4,0,3,1
59990,31652,0,0,62,62,0,1,0,1,0
48934,26771,0,0,155,155,0,1,0,1,0
10922,61248,0,0,142,142,0,1,0,1,0
20577,19984,0,0,81,81,0,1,0,1,0
50825,29703,0,0,93,93,0,1,0,1,0
2244,43539,0,0,144,144,0,1,0,1,0
16842,3389,16842,3389,293,223,70,4,0,3,1
29366,31093,0,0,92,92,0,1,0,1,0
19871,61248,0,0,155,155,0,1,0,1,0
49600,27338,0,0,138,138,0,1,0,1,0
13393,18663,0,0,143,143,0,1,0,1,0
2046,23453,0,0,151,151,0,1,0,1,0
14685,27023,0,0,127,127,0,1,0,1,0
3260,25353,0,0,144,144,0,1,0,1,0
26928,27715,0,0,127,127,0,1,0,1,0
50573,29523,0,0,113,113,0,1,0,1,0
3095,47546,0,0,144,144,0,1,0,1,0
14480,2885,10731,2885,258,199,59,3,0,2,0
14067,3389,14067,3389,293,223,70,4,0,3,1
50260,29151,0,0,108,108,0,1,0,1,0
28568,12799,0,0,111,111,0,1,0,1,0
25062,34021,0,0,62,62,0,1,0,1,0
17929,25773,0,0,142,142,0,1,0,1,0
20763,3389,20763,3389,293,223,70,4,0,3,1
38411,3389,38411,3389,293,223,70,4,1,3,1
9479,25773,0,0,151,151,0,1,0,1,0
12298,25773,0,0,139,139,0,1,0,1,0
55914,31652,0,0,68,68,0,1,0,1,0
47218,5618,0,0,145,145,0,1,0,1,0
50347,29368,0,0,105,105,0,1,0,1,0
47162,47992,0,0,97,97,0,1,0,1,0
15729,19532,0,0,75,75,0,1,0,1,0
52301,33201,0,0,62,62,0,1,0,1,0
42982,5618,0,0,145,145,0,1,0,1,0
10236,25773,0,0,147,147,0,1,0,1,0
49837,33408,0,0,124,124,0,1,0,1,0
13445,3389,13445,3389,293,223,70,4,0,3,1
51679,31741,0,0,65,65,0,1,0,1,0
12729,3389,12729,3389,293,223,70,4,0,3,1
7797,60479,0,0,136,136,0,1,0,1,0
5742,25773,0,0,149,149,0,1,0,1,0
49907,22783,0,0,155,155,0,1,0,1,0
7455,23337,0,0,151,151,0,1,0,1,0
11254,6748,5512,2043,235,193,42,2,0,2,0
52254,33063,0,0,62,62,0,1,0,1,0
33311,6839,0,0,126,126,0,1,0,1,0
9701,61248,0,0,141,141,0,1,0,1,0
25401,29870,0,0,105,105,0,1,0,1,0
51350,31805,0,0,71,71,0,1,0,1,0
4817,25113,0,0,135,135,0,1,0,1,0
28282,26847,0,0,136,136,0,1,0,1,0
21992,61142,0,0,158,158,0,1,0,1,0
37001,3389,37001,3389,293,223,70,4,0,3,1
37511,4518,0,0,129,129,0,1,0,1,0
49058,30776,0,0,150,150,0,1,0,1,0
28321,25856,0,0,147,147,0,1,0,1,0
51512,31652,0,0,67,67,0,1,0,1,0
29455,34021,0,0,62,62,0,1,0,1,0
10759,3389,10759,3389,293,223,70,4,1,3,1
18113,22688,0,0,109,109,0,1,0,1,0
12108,6154,7381,2281,245,198,47,3,0,2,0
51709,60532,0,0,95,95,0,1,0,1,0
22470,25773,0,0,145,145,0,1,0,1,0
13437,9373,3207,991,190,169,20,1,0,1,0
48978,28204,0,0,153,153,0,1,0,1,0
10080,3389,10080,3389,293,223,70,4,0,3,1
27397,25773,0,0,147,147,0,1,0,1,0
5518,34407,0,0,151,151,0,1,0,1,0
4764,23155,0,0,151,151,0,1,0,1,0
29552,32024,0,0,82,82,0,1,0,1,0
23531,32509,0,0,77,77,0,1,0,1,0
52622,26018,0,0,79,79,0,1,0,1,0
62410,31652,0,0,63,63,0,1,0,1,0
3882,22849,0,0,152,152,0,1,0,1,0
13621,61248,0,0,141,141,0,1,0,1,0
56268,31652,0,0,62,62,0,1,0,1,0
51929,34021,0,0,77,77,0,1,0,1,0
59910,59505,0,0,140,140,0,1,0,1,0
22232,3301,0,0,85,85,0,1,0,1,0
16174,3389,16174,3389,293,223,70,4,0,3,1
50845,31652,0,0,91,91,0,1,0,1,0
20676,3389,20676,3389,293,223,70,4,0,3,1
27761,3389,27761,3389,293,223,70,4,1,3,1
50309,3389,50309,3389,293,223,70,4,0,3,1
2646,24391,0,0,147,147,0,1,0,1,0
28130,60939,0,0,134,134,0,1,0,1,0
16190,18622,0,0,145,145,0,1,0,1,0
12084,6095,7458,2304,246,199,47,3,0,2,0
60455,31652,0,0,65,65,0,1,0,1,0
49160,33773,0,0,146,146,0,1,0,1,0
46172,19223,0,0,153,153,0,1,0,1,0
2343,22583,0,0,157,157,0,1,0,1,0
5711,25773,0,0,142,142,0,1,0,1,0
29402,34021,0,0,62,62,0,1,0,1,0
51683,31652,0,0,63,63,0,1,0,1,0
15494,25773,0,0,143,143,0,1,0,1,0
57273,33084,0,0,62,62,0,1,0,1,0
29269,34021,0,0,62,62,0,1,0,1,0
35608,9085,0,0,144,144,0,1,0,1,0
49337,31652,0,0,145,145,0,1,0,1,0
14602,20953,0,0,96,96,0,1,0,1,0
11163,3389,11163,3389,293,223,70,4,0,3,1
50972,31652,0,0,87,87,0,1,0,1,0
10381,5358,7014,2599,259,205,53,3,0,2,0
20195,3389,20195,3389,293,223,70,4,0,3,1
11016,3510,10810,3340,290,221,68,3,0,2,0
19862,25773,0,0,143,143,0,1,0,1,0
17230,16520,0,0,85,85,0,1,0,1,0
37492,3389,37492,3389,293,223,70,4,1,3,1
8224,61248,0,0,139,139,0,1,0,1,0
9876,61248,0,0,139,139,0,1,0,1,0
35199,3389,35199,3389,293,223,70,4,1,3,1
26213,32454,0,0,77,77,0,1,0,1,0
28209,30417,0,0,99,99,0,1,0,1,0
20375,27402,0,0,126,126,0,1,0,1,0
61874,31652,0,0,76,76,0,1,0,1,0
18150,21479,0,0,96,96,0,1,0,1,0
50062,34021,0,0,123,123,0,1,0,1,0
20072,3389,20072,3389,293,223,70,4,0,3,1
32536,3389,32536,3389,293,223,70,4,1,3,1
26167,24171,0,0,129,129,0,1,0,1,0
15908,25773,0,0,141,141,0,1,0,1,0
28234,29176,0,0,112,112,0,1,0,1,0
19581,3389,19581,3389,293,223,70,4,0,3,1
52312,33836,0,0,68,68,0,1,0,1,0
49160,31764,0,0,146,146,0,1,0,1,0
16975,16089,0,0,90,90,0,1,0,1,0
21416,4198,0,0,92,92,0,1,0,1,0
54523,12431,0,0,125,125,0,1,0,1,0
28907,3389,28907,3389,293,223,70,4,0,3,1
40731,5618,0,0,145,145,0,1,0,1,0
16012,3389,16012,3389,293,223,70,4,0,3,1
5374,25773,0,0,148,148,0,1,0,1,0
15162,25773,0,0,147,147,0,1,0,1,0
21466,3389,21466,3389,293,223,70,4,0,3,1
11390,4414,9637,2978,275,213,61,3,0,2,0
50821,30548,0,0,87,87,0,1,0,1,0
38032,7388,0,0,146,146,0,1,0,1,0
21284,61248,0,0,157,157,0,1,0,1,0
51659,34021,0,0,84,84,0,1,0,1,0
8315,25624,0,0,155,155,0,1,0,1,0
46358,54567,0,0,78,78,0,1,0,1,0
4481,23057,0,0,151,151,0,1,0,1,0
14916,2451,7930,2450,229,178,50,3,0,2,0
11957,61248,0,0,139,139,0,1,0,1,0
25528,34021,0,0,62,62,0,1,0,1,0
4257,23641,0,0,157,157,0,1,0,1,0
20320,39251,0,0,77,77,0,1,0,1,0
25506,29722,0,0,106,106,0,1,0,1,0
51218,34021,0,0,95,95,0,1,0,1,0
15626,3389,15626,3389,293,223,70,4,0,3,1
6762,49448,0,0,148,148,0,1,0,1,0
55215,5618,0,0,145,145,0,1,0,1,0
31212,5062,0,0,109,109,0,1,0,1,0
27405,27042,0,0,134,134,0,1,0,1,0
12971,54215,0,0,152,152,0,1,0,1,0
54082,10364,0,0,147,147,0,1,0,1,0
50311,31652,0,0,109,109,0,1,0,1,0
16955,19877,0,0,78,78,0,1,0,1,0
19898,3389,19898,3389,293,223,70,4,0,3,1
13314,3389,13314,3389,293,223,70,4,0,3,1
13317,3389,13317,3389,293,223,70,4,1,3,1
50706,34021,0,0,107,107,0,1,0,1,0
22756,33604,0,0,66,66,0,1,0,1,0
63396,3554,59270,3137,282,217,64,3,0,2,0
21189,32990,0,0,71,71,0,1,0,1,0
38202,7266,0,0,146,146,0,1,0,1,0
9925,61248,0,0,141,141,0,1,0,1,0
50365,32664,0,0,103,103,0,1,0,1,0
55417,3389,55417,3389,293,223,70,4,0,3,1
22739,34021,0,0,62,62,0,1,0,1,0
60766,31652,0,0,64,64,0,1,0,1,0
24401,22848,0,0,114,114,0,1,0,1,0
17907,3389,17907,3389,293,223,70,4,0,3,1
23147,61195,0,0,154,154,0,1,0,1,0
28091,26074,0,0,144,144,0,1,0,1,0
24620,3389,24620,3389,293,223,70,4,0,3,1
28702,27765,0,0,127,127,0,1,0,1,0
7258,24023,0,0,147,147,0,1,0,1,0
51061,31880,0,0,79,79,0,1,0,1,0
18357,26050,0,0,140,140,0,1,0,1,0
15961,3389,15961,3389,293,223,70,4,0,3,1
28256,34021,0,0,62,62,0,1,0,1,0
28176,32005,0,0,83,83,0,1,0,1,0
55029,33112,0,0,113,113,0,1,0,1,0
14488,21038,0,0,97,97,0,1,0,1,0
48523,36857,0,0,130,130,0,1,0,1,0
52155,33071,0,0,72,72,0,1,0,1,0
3384,22675,0,0,153,153,0,1,0,1,0
15343,53064,0,0,115,115,0,1,0,1,0
52305,33214,0,0,62,62,0,1,0,1,0
49976,27967,0,0,121,121,0,1,0,1,0
56624,3389,56624,3389,293,223,70,4,0,3,1
11372,3389,11372,3389,293,223,70,4,0,3,1
52278,33133,0,0,62,62,0,1,0,1,0
34445,3389,34445,3389,293,223,70,4,1,3,1
49632,34021,0,0,134,134,0,1,0,1,0
10260,3389,10260,3389,293,223,70,4,1,3,1
23540,1862,0,0,75,75,0,1,0,1,0
28619,2867,0,0,88,88,0,1,0,1,0
9246,3389,9246,3389,293,223,70,4,0,3,1
14579,11715,0,0,147,147,0,1,0,1,0
26460,34021,0,0,62,62,0,1,0,1,0
5903,56978,0,0,140,140,0,1,0,1,0
22736,3389,22736,3389,293,223,70,4,1,3,1
35367,60568,0,0,104,104,0,1,0,1,0
49889,32157,0,0,128,128,0,1,0,1,0
11630,61248,0,0,139,139,0,1,0,1,0
4854,23187,0,0,150,150,0,1,0,1,0
19545,3389,19545,3389,293,223,70,4,0,3,1
8834,61248,0,0,139,139,0,1,0,1,0
49139,31177,0,0,146,146,0,1,0,1,0
27757,2137,0,0,82,82,0,1,0,1,0
51872,32437,0,0,80,80,0,1,0,1,0
28205,30610,0,0,97,97,0,1,0,1,0
19002,3389,19002,3389,293,223,70,4,0,3,1
33883,3389,33883,3389,293,223,70,4,1,3,1
26754,3389,26754,3389,293,223,70,4,0,3,1
2222,22516,0,0,157,157,0,1,0,1,0
41145,3389,41145,3389,293,223,70,4,0,3,1
19759,25773,0,0,143,143,0,1,0,1,0
51533,31652,0,0,66,66,0,1,0,1,0
61611,4031,45564,2412,250,200,49,3,0,2,0
53020,13525,0,0,149,149,0,1,0,1,0
20694,20071,0,0,82,82,0,1,0,1,0
49468,33673,0,0,135,135,0,1,0,1,0
10979,3389,10979,3389,293,223,70,4,1,3,1
10338,25773,0,0,147,147,0,1,0,1,0
52285,33386,0,0,66,66,0,1,0,1,0
15971,25773,0,0,145,145,0,1,0,1,0
48292,38750,0,0,124,124,0,1,0,1,0
50324,42532,0,0,62,62,0,1,0,1,0
16556,3389,16556,3389,293,223,70,4,1,3,1
49938,31652,0,0,118,118,0,1,0,1,0
28785,34021,0,0,62,62,0,1,0,1,0
51673,31652,0,0,64,64,0,1,0,1,0
40569,8169,0,0,145,145,0,1,0,1,0
49160,32456,0,0,146,146,0,1,0,1,0
11296,4187,9931,3068,279,215,63,3,0,2,0
16087,20972,0,0,89,89,0,1,0,1,0
14172,11153,900,278,159,154,5,1,0,1,0
18342,3389,18342,3389,293,223,70,4,0,3,1
52006,32989,0,0,66,66,0,1,0,1,0
63538,31652,0,0,67,67,0,1,0,1,0
22781,34021,0,0,62,62,0,1,0,1,0
11635,53555,0,0,117,117,0,1,0,1,0
52364,3389,52364,3389,293,223,70,4,0,3,1
37661,3389,37661,3389,293,223,70,4,1,3,1
55790,45392,0,0,100,100,0,1,0,1,0
10436,61248,0,0,142,142,0,1,0,1,0
54683,5785,0,0,145,145,0,1,0,1,0
8839,61248,0,0,139,139,0,1,0,1,0
35666,9330,0,0,146,146,0,1,0,1,0
18555,3389,18555,3389,293,223,70,4,0,3,1
12140,22782,0,0,119,119,0,1,0,1,0
5465,55702,0,0,141,141,0,1,0,1,0
2340,22312,0,0,154,154,0,1,0,1,0
60130,3389,60130,3389,293,223,70,4,0,3,1
18025,25489,0,0,139,139,0,1,0,1,0
22158,3389,22158,3389,293,223,70,4,0,3,1
47917,41814,0,0,115,115,0,1,0,1,0
51179,31652,0,0,81,81,0,1,0,1,0
38685,6920,0,0,146,146,0,1,0,1,0
32328,2611,0,0,101,101,0,1,0,1,0
10050,3389,10050,3389,293,223,70,4,1,3,1
15887,3389,15887,3389,293,223,70,4,0,3,1
44464,3389,44464,3389,293,223,70,4,0,3,1
21117,20388,0,0,86,86,0,1,0,1,0
17361,3389,17361,3389,293,223,70,4,0,3,1
49160,32511,0,0,146,146,0,1,0,1,0
17396,3389,17396,3389,293,223,70,4,0,3,1
55048,5618,0,0,145,145,0,1,0,1,0
29866,1705,0,0,87,87,0,1,0,1,0
14624,12126,0,0,144,144,0,1,0,1,0
49160,32897,0,0,146,146,0,1,0,1,0
11101,3389,11101,3389,293,223,70,4,1,3,1
26188,808,0,0,69,69,0,1,0,1,0
30517,3389,30517,3389,293,223,70,4,0,3,1
28199,30867,0,0,94,94,0,1,0,1,0
12318,3389,12318,3389,293,223,70,4,0,3,1
50033,31652,0,0,117,117,0,1,0,1,0
48752,37075,0,0,136,136,0,1,0,1,0
17464,25773,0,0,143,143,0,1,0,1,0
16330,61248,0,0,150,150,0,1,0,1,0
55003,5618,0,0,145,145,0,1,0,1,0
18173,25773,0,0,143,143,0,1,0,1,0
33128,3389,33128,3389,293,223,70,4,0,3,1
18392,3389,18392,3389,293,223,70,4,0,3,1
37112,3389,37112,3389,293,223,70,4,0,3,1
17987,18438,0,0,64,64,0,1,0,1,0
51524,60517,0,0,94,94,0,1,0,1,0
6703,53560,0,0,143,143,0,1,0,1,0
15260,3389,15260,3389,293,223,70,4,0,3,1
10409,3389,10409,3389,293,223,70,4,0,3,1
51206,31652,0,0,74,74,0,1,0,1,0
28276,27170,0,0,133,133,0,1,0,1,0
16108,2448,9106,2448,228,178,50,3,0,2,0
11841,5507,8219,2540,256,204,52,3,0,2,0
37939,7455,0,0,146,146,0,1,0,1,0
61381,3389,61381,3389,293,223,70,4,0,3,1
29149,1441,0,0,83,83,0,1,0,1,0
26074,310,0,0,66,66,0,1,0,1,0
55473,44307,0,0,97,97,0,1,0,1,0
36038,8934,0,0,145,145,0,1,0,1,0
18015,17843,0,0,67,67,0,1,0,1,0
52399,33490,0,0,62,62,0,1,0,1,0
28395,26228,0,0,143,143,0,1,0,1,0
25160,34021,0,0,62,62,0,1,0,1,0
14077,3389,14077,3389,293,223,70,4,0,3,1
53424,18912,0,0,107,107,0,1,0,1,0
14304,61248,0,0,147,147,0,1,0,1,0
14430,12032,0,0,147,147,0,1,0,1,0
5219,18729,0,0,154,154,0,1,0,1,0
15178,25773,0,0,147,147,0,1,0,1,0
46282,57798,0,0,62,62,0,1,0,1,0
22700,34021,0,0,62,62,0,1,0,1,0
50324,28678,0,0,110,110,0,1,0,1,0
48903,25777,0,0,156,156,0,1,0,1,0
37271,3389,37271,3389,293,223,70,4,1,3,1
24574,31037,0,0,93,93,0,1,0,1,0
39387,8368,0,0,145,145,0,1,0,1,0
15193,22100,0,0,101,101,0,1,0,1,0
9323,25773,0,0,151,151,0,1,0,1,0
11743,3389,11743,3389,293,223,70,4,1,3,1
28190,31317,0,0,90,90,0,1,0,1,0
50649,29342,0,0,99,99,0,1,0,1,0
50958,31996,0,0,82,82,0,1,0,1,0
51770,31652,0,0,62,62,0,1,0,1,0
18839,31085,0,0,89,89,0,1,0,1,0
13252,3389,13252,3389,293,223,70,4,0,3,1
49032,28733,0,0,151,151,0,1,0,1,0
51895,32788,0,0,67,67,0,1,0,1,0
10544,3389,10544,3389,293,223,70,4,1,3,1
1873,23182,0,0,152,152,0,1,0,1,0
12006,3389,12006,3389,293,223,70,4,0,3,1
10621,61248,0,0,139,139,0,1,0,1,0
17757,18609,0,0,66,66,0,1,0,1,0
15343,13338,0,0,127,127,0,1,0,1,0
41659,7985,0,0,145,145,0,1,0,1,0
17636,61248,0,0,149,149,0,1,0,1,0
12744,22817,0,0,140,140,0,1,0,1,0
1946,22363,0,0,157,157,0,1,0,1,0
50732,32251,0,0,90,90,0,1,0,1,0
27167,1637,0,0,77,77,0,1,0,1,0
27184,34021,0,0,62,62,0,1,0,1,0
29125,34021,0,0,62,62,0,1,0,1,0
29425,31389,0,0,89,89,0,1,0,1,0
50780,31652,0,0,94,94,0,1,0,1,0
49039,28892,0,0,151,151,0,1,0,1,0
64300,31652,0,0,62,62,0,1,0,1,0
15682,3389,15682,3389,293,223,70,4,0,3,1
17756,17406,0,0,73,73,0,1,0,1,0
2388,41545,0,0,144,144,0,1,0,1,0
8148,61248,0,0,140,140,0,1,0,1,0
22750,590,1908,589,102,90,12,1,0,1,0
17677,3389,17677,3389,293,223,70,4,0,3,1
11152,25773,0,0,139,139,0,1,0,1,0
55810,45246,0,0,96,96,0,1,0,1,0
20297,19773,0,0,79,79,0,1,0,1,0
49074,3389,49074,3389,293,223,70,4,0,3,1
28730,27904,0,0,125,125,0,1,0,1,0
6845,25070,0,0,157,157,0,1,0,1,0
38534,3389,38534,3389,293,223,70,4,1,3,1
11689,5138,8699,2688,263,207,55,3,0,2,0
52486,33855,0,0,62,62,0,1,0,1,0
4847,53905,0,0,141,141,0,1,0,1,0
24075,3389,24075,3389,293,223,70,4,0,3,1
33857,3389,33857,3389,293,223,70,4,0,3,1
2909,34340,0,0,143,143,0,1,0,1,0
18035,25178,0,0,136,136,0,1,0,1,0
45766,59410,0,0,63,63,0,1,0,1,0
12739,25773,0,0,139,139,0,1,0,1,0
17344,19386,0,0,73,73,0,1,0,1,0
3472,22706,0,0,153,153,0,1,0,1,0
13604,9778,2682,828,183,166,17,1,0,1,0
12822,3389,12822,3389,293,223,70,4,0,3,1
26190,34021,0,0,62,62,0,1,0,1,0
23460,476,1770,475,94,84,9,1,0,1,0
53751,11348,0,0,148,148,0,1,0,1,0
49239,31652,0,0,143,143,0,1,0,1,0
15644,25773,0,0,143,143,0,1,0,1,0
52541,33913,0,0,62,62,0,1,0,1,0
20175,25773,0,0,144,144,0,1,0,1,0
24376,31318,0,0,90,90,0,1,0,1,0
12972,25773,0,0,139,139,0,1,0,1,0
16515,20432,0,0,84,84,0,1,0,1,0
25827,29269,0,0,111,111,0,1,0,1,0
1784,23044,0,0,152,152,0,1,0,1,0
52382,33440,0,0,62,62,0,1,0,1,0
49042,28958,0,0,151,151,0,1,0,1,0
14805,25773,0,0,140,140,0,1,0,1,0
8395,23553,0,0,150,150,0,1,0,1,0
9244,3389,9244,3389,293,223,70,4,0,3,1
50912,30775,0,0,84,84,0,1,0,1,0
24256,31486,0,0,88,88,0,1,0,1,0
34838,11179,0,0,146,146,0,1,0,1,0
48060,60232,0,0,75,75,0,1,0,1,0
24180,31594,0,0,87,87,0,1,0,1,0
17608,42777,0,0,86,86,0,1,0,1,0
15844,21278,0,0,93,93,0,1,0,1,0
27070,1555,0,0,76,76,0,1,0,1,0
12082,3389,12082,3389,293,223,70,4,1,3,1
22773,34021,0,0,62,62,0,1,0,1,0
26263,31472,0,0,87,87,0,1,0,1,0
13638,24062,0,0,121,121,0,1,0,1,0
55411,43859,0,0,91,91,0,1,0,1,0
14934,3389,14934,3389,293,223,70,4,0,3,1
21541,3389,21541,3389,293,223,70,4,0,3,1
50070,28392,0,0,126,126,0,1,0,1,0
14701,20879,0,0,95,95,0,1,0,1,0
19272,3389,19272,3389,293,223,70,4,0,3,1
8307,23328,0,0,116,116,0,1,0,1,0
37439,7813,0,0,146,146,0,1,0,1,0
49809,34021,0,0,130,130,0,1,0,1,0
14419,3389,14419,3389,293,223,70,4,0,3,1
15826,10343,0,0,137,137,0,1,0,1,0
51164,30848,0,0,98,98,0,1,0,1,0
27743,33817,0,0,63,63,0,1,0,1,0
58992,3389,58992,3389,293,223,70,4,0,3,1
17960,3389,17960,3389,293,223,70,4,0,3,1
29389,31207,0,0,91,91,0,1,0,1,0
26178,24180,0,0,129,129,0,1,0,1,0
52096,32593,0,0,62,62,0,1,0,1,0
52206,33763,0,0,71,71,0,1,0,1,0
14292,3389,14292,3389,293,223,70,4,0,3,1
49160,32253,0,0,146,146,0,1,0,1,0
4138,25461,0,0,139,139,0,1,0,1,0
28257,28055,0,0,124,124,0,1,0,1,0
24162,31954,0,0,81,81,0,1,0,1,0
50988,31652,0,0,81,81,0,1,0,1,0
23003,15735,0,0,84,84,0,1,0,1,0
31259,3389,31259,3389,293,223,70,4,0,3,1
28493,26719,0,0,138,138,0,1,0,1,0
12111,3389,12111,3389,293,223,70,4,1,3,1
27541,25773,0,0,147,147,0,1,0,1,0
50115,6557,0,0,145,145,0,1,0,1,0
3170,30730,0,0,143,143,0,1,0,1,0
51584,31652,0,0,68,68,0,1,0,1,0
18171,3389,18171,3389,293,223,70,4,0,3,1
28446,2720,0,0,87,87,0,1,0,1,0
12360,3389,12360,3389,293,223,70,4,0,3,1
41571,34021,0,0,112,112,0,1,0,1,0
42346,5618,0,0,145,145,0,1,0,1,0
13895,3389,13895,3389,293,223,70,4,0,3,1
4107,49233,0,0,144,144,0,1,0,1,0
50365,29412,0,0,104,104,0,1,0,1,0
19396,25773,0,0,143,143,0,1,0,1,0
19804,3389,19804,3389,293,223,70,4,0,3,1
22567,716,2661,715,110,95,14,1,0,1,0
16031,14498,0,0,112,112,0,1,0,1,0
50696,31652,0,0,92,92,0,1,0,1,0
34477,3389,34477,3389,293,223,70,4,0,3,1
19267,3389,19267,3389,293,223,70,4,0,3,1
14744,12329,0,0,141,141,0,1,0,1,0
21285,3389,21285,3389,293,223,70,4,0,3,1
30674,20480,0,0,147,147,0,1,0,1,0
52541,33914,0,0,62,62,0,1,0,1,0
29631,3389,29631,3389,293,223,70,4,0,3,1
5807,25773,0,0,149,149,0,1,0,1,0
10924,3389,10924,3389,293,223,70,4,1,3,1
50704,29815,0,0,110,110,0,1,0,1,0
50361,31652,0,0,107,107,0,1,0,1,0
12465,24607,0,0,139,139,0,1,0,1,0
15574,25773,0,0,141,141,0,1,0,1,0
59047,31652,0,0,66,66,0,1,0,1,0
29342,34021,0,0,62,62,0,1,0,1,0
11702,3389,11702,3389,293,223,70,4,0,3,1
31976,19704,0,0,147,147,0,1,0,1,0
5972,57177,0,0,140,140,0,1,0,1,0
11326,61248,0,0,142,142,0,1,0,1,0
2640,20650,0,0,155,155,0,1,0,1,0
60355,32287,0,0,84,84,0,1,0,1,0
51513,31652,0,0,67,67,0,1,0,1,0
59669,4550,30651,1622,215,182,33,2,0,1,0
10393,25773,0,0,143,143,0,1,0,1,0
15125,22186,0,0,102,102,0,1,0,1,0
13643,3389,13643,3389,293,223,70,4,0,3,1
37738,3389,37738,3389,293,223,70,4,1,3,1
11163,6603,5669,2101,237,194,43,2,0,2,0
50462,28959,0,0,105,105,0,1,0,1,0
21759,3389,21759,3389,293,223,70,4,0,3,1
39195,6553,0,0,146,146,0,1,0,1,0
16566,3389,16566,3389,293,223,70,4,0,3,1
28203,30712,0,0,96,96,0,1,0,1,0
8768,24549,0,0,144,144,0,1,0,1,0
28603,27270,0,0,132,132,0,1,0,1,0
44060,5618,0,0,145,145,0,1,0,1,0
30662,1998,0,0,91,91,0,1,0,1,0
17705,1788,5786,1788,183,146,36,2,0,2,0
6239,57953,0,0,140,140,0,1,0,1,0
18019,25682,0,0,142,142,0,1,0,1,0
15859,3389,15859,3389,293,223,70,4,0,3,1
14740,47952,0,0,101,101,0,1,0,1,0
10497,3389,10497,3389,293,223,70,4,1,3,1
3245,29688,0,0,143,143,0,1,0,1,0
10242,59456,0,0,143,143,0,1,0,1,0
64381,31652,0,0,62,62,0,1,0,1,0
52226,33386,0,0,64,64,0,1,0,1,0
37840,3389,37840,3389,293,223,70,4,1,3,1
12504,7113,6138,1896,229,189,39,2,0,2,0
7882,26549,0,0,156,156,0,1,0,1,0
50113,32948,0,0,112,112,0,1,0,1,0
14120,11028,1062,328,162,155,6,1,0,1,0
18503,3389,18503,3389,293,223,70,4,0,3,1
20443,19883,0,0,80,80,0,1,0,1,0
9874,24466,0,0,140,140,0,1,0,1,0
20598,61248,0,0,155,155,0,1,0,1,0
50430,32871,0,0,105,105,0,1,0,1,0
58085,32923,0,0,62,62,0,1,0,1,0
54598,11988,0,0,127,127,0,1,0,1,0
28643,1255,0,0,80,80,0,1,0,1,0
13142,3389,13142,3389,293,223,70,4,0,3,1
16691,3389,16691,3389,293,223,70,4,0,3,1
11556,3389,11556,3389,293,223,70,4,0,3,1
3457,48151,0,0,144,144,0,1,0,1,0
2241,20946,0,0,156,156,0,1,0,1,0
54587,40997,0,0,83,83,0,1,0,1,0
3472,23206,0,0,157,157,0,1,0,1,0
25096,34021,0,0,62,62,0,1,0,1,0
23723,34021,0,0,62,62,0,1,0,1,0
11824,25613,0,0,139,139,0,1,0,1,0
15276,3389,15276,3389,293,223,70,4,0,3,1
35389,3389,35389,3389,293,223,70,4,0,3,1
49957,28397,0,0,119,119,0,1,0,1,0
49538,45499,0,0,62,62,0,1,0,1,0
50001,31652,0,0,119,119,0,1,0,1,0
11420,3389,11420,3389,293,223,70,4,1,3,1
11875,7736,4444,1647,218,184,34,2,0,1,0
16276,3389,16276,3389,293,223,70,4,0,3,1
50368,29062,0,0,119,119,0,1,0,1,0
9283,3389,9283,3389,293,223,70,4,1,3,1
17903,17653,0,0,69,69,0,1,0,1,0
48992,25507,0,0,156,156,0,1,0,1,0
20717,38687,0,0,75,75,0,1,0,1,0
15582,25773,0,0,141,141,0,1,0,1,0
53002,21399,0,0,100,100,0,1,0,1,0
22816,34021,0,0,62,62,0,1,0,1,0
21361,61248,0,0,157,157,0,1,0,1,0
8458,23251,0,0,115,115,0,1,0,1,0
50545,29130,0,0,102,102,0,1,0,1,0
18266,44269,0,0,92,92,0,1,0,1,0
3668,25773,0,0,142,142,0,1,0,1,0
10045,3389,10045,3389,293,223,70,4,1,3,1
53560,11915,0,0,148,148,0,1,0,1,0
40390,5696,0,0,146,146,0,1,0,1,0
16248,27836,0,0,119,119,0,1,0,1,0
6499,24879,0,0,157,157,0,1,0,1,0
21261,3389,21261,3389,293,223,70,4,0,3,1
17385,3389,17385,3389,293,223,70,4,0,3,1
57734,51927,0,0,116,116,0,1,0,1,0
49135,31080,0,0,147,147,0,1,0,1,0
32666,16031,0,0,146,146,0,1,0,1,0
53774,18325,0,0,104,104,0,1,0,1,0
14551,12004,0,0,145,145,0,1,0,1,0
9315,3389,9315,3389,293,223,70,4,1,3,1
51879,33536,0,0,79,79,0,1,0,1,0
27544,33713,0,0,64,64,0,1,0,1,0
49782,33457,0,0,126,126,0,1,0,1,0
12871,3389,12871,3389,293,223,70,4,0,3,1
3734,50669,0,0,143,143,0,1,0,1,0
50485,32822,0,0,103,103,0,1,0,1,0
20603,61248,0,0,155,155,0,1,0,1,0
9706,3389,9706,3389,293,223,70,4,0,3,1
16369,25773,0,0,143,143,0,1,0,1,0
14601,2525,8172,2525,234,181,52,3,0,2,0
9918,61248,0,0,139,139,0,1,0,1,0
18286,30638,0,0,93,93,0,1,0,1,0
21327,61248,0,0,157,157,0,1,0,1,0
30848,60800,0,0,123,123,0,1,0,1,0
13002,57130,0,0,130,130,0,1,0,1,0
29139,29953,0,0,104,104,0,1,0,1,0
9783,3389,9783,3389,293,223,70,4,1,3,1
19566,28649,0,0,114,114,0,1,0,1,0
49118,32701,0,0,147,147,0,1,0,1,0
52963,5618,0,0,145,145,0,1,0,1,0
18175,3389,18175,3389,293,223,70,4,0,3,1
26336,3389,26336,3389,293,223,70,4,0,3,1
17112,61248,0,0,152,152,0,1,0,1,0
31389,60772,0,0,120,120,0,1,0,1,0
3563,23257,0,0,157,157,0,1,0,1,0
14994,3389,14994,3389,293,223,70,4,0,3,1
27763,931,0,0,75,75,0,1,0,1,0
48959,27075,0,0,154,154,0,1,0,1,0
52226,33777,0,0,70,70,0,1,0,1,0
33811,3389,33811,3389,293,223,70,4,0,3,1
49069,29583,0,0,149,149,0,1,0,1,0
25400,34021,0,0,62,62,0,1,0,1,0
35259,14279,0,0,146,146,0,1,0,1,0
10944,3389,10944,3389,293,223,70,4,1,3,1
54501,31652,0,0,116,116,0,1,0,1,0
7958,61248,0,0,139,139,0,1,0,1,0
57654,32705,0,0,99,99,0,1,0,1,0
19527,25773,0,0,143,143,0,1,0,1,0
21056,3389,21056,3389,293,223,70,4,0,3,1
24212,25773,0,0,146,146,0,1,0,1,0
26413,24355,0,0,131,131,0,1,0,1,0
49107,32347,0,0,148,148,0,1,0,1,0
18368,3389,18368,3389,293,223,70,4,0,3,1
32345,10806,0,0,129,129,0,1,0,1,0
48052,5618,0,0,145,145,0,1,0,1,0
16782,25488,0,0,144,144,0,1,0,1,0
10862,24123,0,0,148,148,0,1,0,1,0
21757,3389,21757,3389,293,223,70,4,0,3,1
51261,31642,0,0,72,72,0,1,0,1,0
2386,20839,0,0,156,156,0,1,0,1,0
9582,3389,9582,3389,293,223,70,4,1,3,1
37390,4474,0,0,128,128,0,1,0,1,0
28145,33520,0,0,67,67,0,1,0,1,0
14027,61248,0,0,142,142,0,1,0,1,0
18451,3389,18451,3389,293,223,70,4,0,3,1
51561,31848,0,0,68,68,0,1,0,1,0
49790,33450,0,0,125,125,0,1,0,1,0
18019,25688,0,0,142,142,0,1,0,1,0
17239,3389,17239,3389,293,223,70,4,0,3,1
25658,34021,0,0,62,62,0,1,0,1,0
51107,31652,0,0,77,77,0,1,0,1,0
11805,25773,0,0,141,141,0,1,0,1,0
50616,32381,0,0,94,94,0,1,0,1,0
19362,3389,19362,3389,293,223,70,4,0,3,1
21059,3389,21059,3389,293,223,70,4,0,3,1
51553,31652,0,0,66,66,0,1,0,1,0
54298,14828,0,0,115,115,0,1,0,1,0
11789,7599,4592,1702,220,185,35,2,0,2,0
49130,30971,0,0,147,147,0,1,0,1,0
11913,25773,0,0,140,140,0,1,0,1,0
17376,16766,0,0,81,81,0,1,0,1,0
49160,32959,0,0,146,146,0,1,0,1,0
10837,59065,0,0,139,139,0,1,0,1,0
17994,3389,17994,3389,293,223,70,4,0,3,1
50869,38155,0,0,145,145,0,1,0,1,0
3532,25771,0,0,142,142,0,1,0,1,0
58011,61050,0,0,131,131,0,1,0,1,0
14484,3389,14484,3389,293,223,70,4,0,3,1
51169,31652,0,0,81,81,0,1,0,1,0
16775,3389,16775,3389,293,223,70,4,0,3,1
19605,3389,19605,3389,293,223,70,4,0,3,1
13742,23931,0,0,120,120,0,1,0,1,0
52213,34021,0,0,70,70,0,1,0,1,0
52627,14692,0,0,150,150,0,1,0,1,0
38544,7021,0,0,146,146,0,1,0,1,0
30022,1763,0,0,88,88,0,1,0,1,0
20191,29809,0,0,103,103,0,1,0,1,0
20002,32028,0,0,80,80,0,1,0,1,0
9540,3389,9540,3389,293,223,70,4,0,3,1
13043,61248,0,0,146,146,0,1,0,1,0
52526,60599,0,0,100,100,0,1,0,1,0
20926,61248,0,0,156,156,0,1,0,1,0
28162,32679,0,0,75,75,0,1,0,1,0
49160,31770,0,0,146,146,0,1,0,1,0
19915,3389,19915,3389,293,223,70,4,0,3,1
51342,31652,0,0,70,70,0,1,0,1,0
10652,61248,0,0,142,142,0,1,0,1,0
8046,23462,0,0,118,118,0,1,0,1,0
12052,25773,0,0,151,151,0,1,0,1,0
4373,19359,0,0,154,154,0,1,0,1,0
23641,32355,0,0,79,79,0,1,0,1,0
36077,3389,36077,3389,293,223,70,4,0,3,1
50711,31652,0,0,91,91,0,1,0,1,0
16924,3389,16924,3389,293,223,70,4,0,3,1
32550,60712,0,0,116,116,0,1,0,1,0
5607,24386,0,0,157,157,0,1,0,1,0
17272,57518,0,0,155,155,0,1,0,1,0
10397,3389,10397,3389,293,223,70,4,1,3,1
9727,4317,8140,3017,277,214,62,3,0,2,0
12037,3389,12037,3389,293,223,70,4,0,3,1
45855,7276,0,0,145,145,0,1,0,1,0
53406,3389,53406,3389,293,223,70,4,0,3,1
29260,34021,0,0,62,62,0,1,0,1,0
2439,24068,0,0,149,149,0,1,0,1,0
60213,4405,34825,1843,225,187,38,2,0,2,0
7369,49913,0,0,148,148,0,1,0,1,0
53985,16916,0,0,108,108,0,1,0,1,0
12983,25773,0,0,139,139,0,1,0,1,0
9189,25773,0,0,140,140,0,1,0,1,0
62792,43867,0,0,96,96,0,1,0,1,0
27124,1601,0,0,76,76,0,1,0,1,0
60149,60312,0,0,142,142,0,1,0,1,0
51939,3389,51939,3389,293,223,70,4,0,3,1
15824,3389,15824,3389,293,223,70,4,0,3,1
50009,31652,0,0,118,118,0,1,0,1,0
49441,33703,0,0,136,136,0,1,0,1,0
60358,61038,0,0,144,144,0,1,0,1,0
3180,30586,0,0,143,143,0,1,0,1,0
59869,61202,0,0,141,141,0,1,0,1,0
64288,32915,0,0,65,65,0,1,0,1,0
18043,24935,0,0,133,133,0,1,0,1,0
10342,25773,0,0,139,139,0,1,0,1,0
8839,61248,0,0,140,140,0,1,0,1,0
51772,31657,0,0,62,62,0,1,0,1,0
1695,22905,0,0,153,153,0,1,0,1,0
17712,25773,0,0,143,143,0,1,0,1,0
10918,60583,0,0,143,143,0,1,0,1,0
50901,32061,0,0,84,84,0,1,0,1,0
13164,8713,4064,1255,201,175,25,2,0,1,0
44593,7489,0,0,145,145,0,1,0,1,0
18076,18462,0,0,64,64,0,1,0,1,0
16601,3389,16601,3389,293,223,70,4,0,3,1
48983,28355,0,0,153,153,0,1,0,1,0
11157,3389,11157,3389,293,223,70,4,0,3,1
2546,24236,0,0,148,148,0,1,0,1,0
3487,26340,0,0,143,143,0,1,0,1,0
11907,61248,0,0,140,140,0,1,0,1,0
9537,61248,0,0,141,141,0,1,0,1,0
17356,19372,0,0,73,73,0,1,0,1,0
26018,29000,0,0,114,114,0,1,0,1,0
11686,61248,0,0,141,141,0,1,0,1,0
23143,34021,0,0,62,62,0,1,0,1,0
12114,22802,0,0,119,119,0,1,0,1,0
11052,61248,0,0,142,142,0,1,0,1,0
19732,28956,0,0,111,111,0,1,0,1,0
51025,33732,0,0,135,135,0,1,0,1,0
29111,34021,0,0,62,62,0,1,0,1,0
28278,27070,0,0,134,134,0,1,0,1,0
13558,17612,0,0,144,144,0,1,0,1,0
11953,61248,0,0,140,140,0,1,0,1,0
38197,3389,38197,3389,293,223,70,4,1,3,1
38431,3389,38431,3389,293,223,70,4,1,3,1
22200,3389,22200,3389,293,223,70,4,0,3,1
13915,3389,13915,3389,293,223,70,4,0,3,1
17752,18613,0,0,66,66,0,1,0,1,0
4187,49034,0,0,143,143,0,1,0,1,0
52585,34046,0,0,62,62,0,1,0,1,0
42660,60193,0,0,74,74,0,1,0,1,0
24157,3389,24157,3389,293,223,70,4,0,3,1
49441,31652,0,0,136,136,0,1,0,1,0
54502,12554,0,0,125,125,0,1,0,1,0
15439,3389,15439,3389,293,223,70,4,0,3,1
2127,45145,0,0,144,144,0,1,0,1,0
52061,26952,0,0,85,85,0,1,0,1,0
10324,3389,10324,3389,293,223,70,4,1,3,1
34853,60594,0,0,106,106,0,1,0,1,0
18439,3389,18439,3389,293,223,70,4,0,3,1
52149,33247,0,0,65,65,0,1,0,1,0
28161,3389,28161,3389,293,223,70,4,0,3,1
18919,3389,18919,3389,293,223,70,4,0,3,1
3069,25053,0,0,145,145,0,1,0,1,0
37134,3389,37134,3389,293,223,70,4,1,3,1
11680,7425,4780,1771,223,187,36,2,0,2,0
33356,3389,33356,3389,293,223,70,4,0,3,1
51415,30765,0,0,74,74,0,1,0,1,0
50901,32060,0,0,84,84,0,1,0,1,0
11466,3389,11466,3389,293,223,70,4,1,3,1
29515,34021,0,0,62,62,0,1,0,1,0
56393,31652,0,0,106,106,0,1,0,1,0
16084,61248,0,0,150,150,0,1,0,1,0
16691,25773,0,0,144,144,0,1,0,1,0
7106,23971,0,0,147,147,0,1,0,1,0
18664,3389,18664,3389,293,223,70,4,0,3,1
18498,25773,0,0,143,143,0,1,0,1,0
29592,32226,0,0,80,80,0,1,0,1,0
14563,3389,14563,3389,293,223,70,4,0,3,1
12284,3389,12284,3389,293,223,70,4,0,3,1
16798,2004,6484,2003,198,157,41,2,0,2,0
39297,6480,0,0,146,146,0,1,0,1,0
56090,46421,0,0,103,103,0,1,0,1,0
13376,3389,13376,3389,293,223,70,4,0,3,1
50694,32715,0,0,108,108,0,1,0,1,0
11529,60729,0,0,141,141,0,1,0,1,0
29081,1416,0,0,83,83,0,1,0,1,0
20168,29765,0,0,103,103,0,1,0,1,0
25371,51,0,0,62,62,0,1,0,1,0
6036,48890,0,0,147,147,0,1,0,1,0
4818,23950,0,0,157,157,0,1,0,1,0
15004,12767,0,0,135,135,0,1,0,1,0
52041,32430,0,0,62,62,0,1,0,1,0
50976,30933,0,0,82,82,0,1,0,1,0
61404,3389,61404,3389,293,223,70,4,0,3,1
51404,31652,0,0,69,69,0,1,0,1,0
10909,3389,10909,3389,293,223,70,4,1,3,1
49463,24105,0,0,156,156,0,1,0,1,0
27365,25773,0,0,147,147,0,1,0,1,0
12838,3389,12838,3389,293,223,70,4,0,3,1
26730,27994,0,0,124,124,0,1,0,1,0
3118,31453,0,0,143,143,0,1,0,1,0
35760,3874,0,0,119,119,0,1,0,1,0
29928,34021,0,0,62,62,0,1,0,1,0
48957,27530,0,0,154,154,0,1,0,1,0
18973,3389,18973,3389,293,223,70,4,0,3,1
34507,3413,0,0,113,113,0,1,0,1,0
29356,34021,0,0,62,62,0,1,0,1,0
18255,3389,18255,3389,293,223,70,4,1,3,1
5844,18263,0,0,153,153,0,1,0,1,0
13872,10426,1843,569,172,160,11,1,0,1,0
14101,3389,14101,3389,293,223,70,4,0,3,1
49160,32362,0,0,146,146,0,1,0,1,0
4842,25773,0,0,147,147,0,1,0,1,0
49130,26237,0,0,149,149,0,1,0,1,0
16359,61248,0,0,147,147,0,1,0,1,0
34519,7861,0,0,135,135,0,1,0,1,0
6675,24977,0,0,157,157,0,1,0,1,0
49750,33356,0,0,125,125,0,1,0,1,0
10658,60150,0,0,143,143,0,1,0,1,0
15582,21610,0,0,96,96,0,1,0,1,0
38235,3389,38235,3389,293,223,70,4,1,3,1
11939,25773,0,0,139,139,0,1,0,1,0
29392,3389,29392,3389,293,223,70,4,0,3,1
49132,31022,0,0,147,147,0,1,0,1,0
51728,31548,0,0,63,63,0,1,0,1,0
6273,58054,0,0,140,140,0,1,0,1,0
13816,3389,13816,3389,293,223,70,4,0,3,1
50161,33114,0,0,113,113,0,1,0,1,0
35213,9294,0,0,143,143,0,1,0,1,0
3060,42579,0,0,146,146,0,1,0,1,0
51081,30225,0,0,85,85,0,1,0,1,0
2899,24788,0,0,146,146,0,1,0,1,0
11323,61248,0,0,139,139,0,1,0,1,0
8265,56162,0,0,143,143,0,1,0,1,0
19393,3389,19393,3389,293,223,70,4,0,3,1
51760,31613,0,0,62,62,0,1,0,1,0
46975,49520,0,0,93,93,0,1,0,1,0
18350,3389,18350,3389,293,223,70,4,0,3,1
37043,3389,37043,3389,293,223,70,4,0,3,1
3962,25773,0,0,144,144,0,1,0,1,0
14248,11337,661,204,156,152,4,1,0,1,0
26797,27901,0,0,125,125,0,1,0,1,0
8347,55308,0,0,141,141,0,1,0,1,0
8573,61248,0,0,140,140,0,1,0,1,0
3672,25773,0,0,143,143,0,1,0,1,0
37210,3389,37210,3389,293,223,70,4,1,3,1
48413,39617,0,0,127,127,0,1,0,1,0
60104,31652,0,0,85,85,0,1,0,1,0
15246,2680,9966,2679,244,189,55,3,0,2,0
35001,3389,35001,3389,293,223,70,4,0,3,1
1391,21938,0,0,156,156,0,1,0,1,0
44135,14337,0,0,150,150,0,1,0,1,0
25725,61063,0,0,144,144,0,1,0,1,0
2872,34846,0,0,143,143,0,1,0,1,0
2531,22378,0,0,154,154,0,1,0,1,0
10850,24120,0,0,148,148,0,1,0,1,0
17404,25773,0,0,142,142,0,1,0,1,0
13807,49635,0,0,106,106,0,1,0,1,0
10708,5879,6451,2391,250,200,49,3,0,2,0
31447,60769,0,0,120,120,0,1,0,1,0
28136,33926,0,0,62,62,0,1,0,1,0
49857,31652,0,0,123,123,0,1,0,1,0
18530,61248,0,0,154,154,0,1,0,1,0
10756,3389,10756,3389,293,223,70,4,1,3,1
49119,30718,0,0,147,147,0,1,0,1,0
18441,3389,18441,3389,293,223,70,4,0,3,1
49160,32889,0,0,146,146,0,1,0,1,0
20509,61248,0,0,155,155,0,1,0,1,0
52071,29701,0,0,68,68,0,1,0,1,0
43003,11623,0,0,149,149,0,1,0,1,0
63758,31652,0,0,62,62,0,1,0,1,0
26087,25773,0,0,146,146,0,1,0,1,0
13043,8420,4444,1373,206,178,28,2,0,1,0
6573,58924,0,0,139,139,0,1,0,1,0
50501,34021,0,0,113,113,0,1,0,1,0
10112,3389,10112,3389,293,223,70,4,1,3,1
3891,25773,0,0,142,142,0,1,0,1,0
25958,34021,0,0,62,62,0,1,0,1,0
12214,3389,12214,3389,293,223,70,4,1,3,1
22839,33486,0,0,67,67,0,1,0,1,0
49865,27933,0,0,132,132,0,1,0,1,0
53278,36787,0,0,76,76,0,1,0,1,0
31622,18363,0,0,147,147,0,1,0,1,0
11866,61248,0,0,140,140,0,1,0,1,0
26882,607,0,0,71,71,0,1,0,1,0
1184,22105,0,0,156,156,0,1,0,1,0
10622,5741,6600,2446,252,202,50,3,0,2,0
17358,25773,0,0,143,143,0,1,0,1,0
28814,34021,0,0,62,62,0,1,0,1,0
5819,24504,0,0,157,157,0,1,0,1,0
28141,33704,0,0,65,65,0,1,0,1,0
18105,22929,0,0,112,112,0,1,0,1,0
51200,18937,0,0,152,152,0,1,0,1,0
36534,12172,0,0,146,146,0,1,0,1,0
16562,49801,0,0,106,106,0,1,0,1,0
11773,3389,11773,3389,293,223,70,4,1,3,1
7882,61248,0,0,139,139,0,1,0,1,0
33878,9998,0,0,136,136,0,1,0,1,0
6458,24857,0,0,157,157,0,1,0,1,0
46700,51768,0,0,86,86,0,1,0,1,0
19228,25773,0,0,143,143,0,1,0,1,0
64080,31652,0,0,62,62,0,1,0,1,0
12174,3389,12174,3389,293,223,70,4,1,3,1
51084,30668,0,0,100,100,0,1,0,1,0
56497,5398,6289,332,159,152,6,1,0,1,0
20085,61248,0,0,154,154,0,1,0,1,0
24395,3389,24395,3389,293,223,70,4,0,3,1
50754,32578,0,0,94,94,0,1,0,1,0
29943,34021,0,0,62,62,0,1,0,1,0
60894,32363,0,0,62,62,0,1,0,1,0
8888,23667,0,0,150,150,0,1,0,1,0
20853,20190,0,0,84,84,0,1,0,1,0
18473,3389,18473,3389,293,223,70,4,0,3,1
51557,31199,0,0,69,69,0,1,0,1,0
11727,61248,0,0,141,141,0,1,0,1,0
7919,61248,0,0,139,139,0,1,0,1,0
48966,25903,0,0,154,154,0,1,0,1,0
50497,5618,0,0,145,145,0,1,0,1,0
15637,16460,0,0,146,146,0,1,0,1,0
4359,49654,0,0,144,144,0,1,0,1,0
15694,25773,0,0,146,146,0,1,0,1,0
9238,3539,8981,3328,290,221,68,3,0,2,0
49624,27392,0,0,138,138,0,1,0,1,0
12234,61248,0,0,139,139,0,1,0,1,0
26433,31590,0,0,85,85,0,1,0,1,0
51732,33435,0,0,82,82,0,1,0,1,0
13576,25773,0,0,139,139,0,1,0,1,0
12049,3389,12049,3389,293,223,70,4,1,3,1
21865,61248,0,0,158,158,0,1,0,1,0
50872,30674,0,0,86,86,0,1,0,1,0
50538,31652,0,0,97,97,0,1,0,1,0
16279,3389,16279,3389,293,223,70,4,0,3,1
50367,34021,0,0,116,116,0,1,0,1,0
12755,3389,12755,3389,293,223,70,4,0,3,1
23256,34021,0,0,62,62,0,1,0,1,0
17207,3389,17207,3389,293,223,70,4,0,3,1
49160,32788,0,0,146,146,0,1,0,1,0
11140,25375,0,0,140,140,0,1,0,1,0
17452,25773,0,0,142,142,0,1,0,1,0
7549,27655,0,0,155,155,0,1,0,1,0
13573,9702,2781,859,184,167,17,1,0,1,0
22776,34021,0,0,62,62,0,1,0,1,0
52123,29353,0,0,69,69,0,1,0,1,0
50865,30177,0,0,106,106,0,1,0,1,0
7232,23878,0,0,122,122,0,1,0,1,0
28296,2593,0,0,86,86,0,1,0,1,0
49963,33293,0,0,120,120,0,1,0,1,0
26189,3389,26189,3389,293,223,70,4,0,3,1
52369,33876,0,0,67,67,0,1,0,1,0
25535,3389,25535,3389,293,223,70,4,0,3,1
3851,51010,0,0,142,142,0,1,0,1,0
29382,31172,0,0,91,91,0,1,0,1,0
22122,28610,0,0,115,115,0,1,0,1,0
33952,7382,0,0,131,131,0,1,0,1,0
49005,28107,0,0,152,152,0,1,0,1,0
18879,3389,18879,3389,293,223,70,4,0,3,1
51344,6349,0,0,145,145,0,1,0,1,0
54388,3389,54388,3389,293,223,70,4,0,3,1
12144,25724,0,0,139,139,0,1,0,1,0
16812,15814,0,0,94,94,0,1,0,1,0
5465,23399,0,0,149,149,0,1,0,1,0
58230,32894,0,0,62,62,0,1,0,1,0
14094,61248,0,0,142,142,0,1,0,1,0
31584,3389,31584,3389,293,223,70,4,0,3,1
2397,24003,0,0,149,149,0,1,0,1,0
38439,3389,38439,3389,293,223,70,4,1,3,1
54557,31652,0,0,69,69,0,1,0,1,0
25767,29353,0,0,110,110,0,1,0,1,0
23328,61186,0,0,154,154,0,1,0,1,0
50049,31652,0,0,114,114,0,1,0,1,0
29442,3389,29442,3389,293,223,70,4,0,3,1
17582,3389,17582,3389,293,223,70,4,0,3,1
51510,31652,0,0,67,67,0,1,0,1,0
10992,25773,0,0,152,152,0,1,0,1,0
34129,3273,0,0,110,110,0,1,0,1,0
21191,3389,21191,3389,293,223,70,4,0,3,1
28973,29120,0,0,113,113,0,1,0,1,0
51254,31652,0,0,72,72,0,1,0,1,0
51958,32184,0,0,62,62,0,1,0,1,0
17719,61248,0,0,150,150,0,1,0,1,0
18909,31142,0,0,88,88,0,1,0,1,0
20630,30623,0,0,95,95,0,1,0,1,0
10203,3389,10203,3389,293,223,70,4,1,3,1
11538,61248,0,0,142,142,0,1,0,1,0
14516,22955,0,0,110,110,0,1,0,1,0
8510,24459,0,0,145,145,0,1,0,1,0
50178,32358,0,0,120,120,0,1,0,1,0
59476,58018,0,0,135,135,0,1,0,1,0
52246,25861,0,0,88,88,0,1,0,1,0
2418,41131,0,0,144,144,0,1,0,1,0
18799,3389,18799,3389,293,223,70,4,0,3,1
51793,31695,0,0,62,62,0,1,0,1,0
52041,33052,0,0,66,66,0,1,0,1,0
19908,19483,0,0,76,76,0,1,0,1,0
47454,45603,0,0,104,104,0,1,0,1,0
29014,34021,0,0,62,62,0,1,0,1,0
32871,34021,0,0,74,74,0,1,0,1,0
24056,34021,0,0,62,62,0,1,0,1,0
29644,34021,0,0,62,62,0,1,0,1,0
62356,3832,51282,2714,263,207,56,3,0,2,0
12262,25773,0,0,139,139,0,1,0,1,0
18411,3389,18411,3389,293,223,70,4,0,3,1
16665,25773,0,0,142,142,0,1,0,1,0
11761,3389,11761,3389,293,223,70,4,1,3,1
19593,3389,19593,3389,293,223,70,4,1,3,1
11327,3389,11327,3389,293,223,70,4,1,3,1
7919,61248,0,0,139,139,0,1,0,1,0
8456,61248,0,0,139,139,0,1,0,1,0
12358,25773,0,0,143,143,0,1,0,1,0
50870,31652,0,0,85,85,0,1,0,1,0
14313,3389,14313,3389,293,223,70,4,0,3,1
7785,25773,0,0,155,155,0,1,0,1,0
18156,21298,0,0,94,94,0,1,0,1,0
49570,34021,0,0,135,135,0,1,0,1,0
11403,61248,0,0,142,142,0,1,0,1,0
6747,25773,0,0,141,141,0,1,0,1,0
8510,55554,0,0,141,141,0,1,0,1,0
50141,28552,0,0,124,124,0,1,0,1,0
35932,13166,0,0,146,146,0,1,0,1,0
13091,8535,4294,1327,204,177,27,2,0,1,0
43564,12967,0,0,150,150,0,1,0,1,0
8637,25385,0,0,152,152,0,1,0,1,0
60993,4196,40821,2161,239,194,44,2,0,2,0
2958,24880,0,0,146,146,0,1,0,1,0
14434,3389,14434,3389,293,223,70,4,0,3,1
51345,31255,0,0,93,93,0,1,0,1,0
50730,32253,0,0,90,90,0,1,0,1,0
49069,31107,0,0,149,149,0,1,0,1,0
26839,27842,0,0,126,126,0,1,0,1,0
6452,23743,0,0,148,148,0,1,0,1,0
52340,34919,0,0,62,62,0,1,0,1,0
63240,3595,58071,3074,279,215,63,3,0,2,0
50338,31652,0,0,104,104,0,1,0,1,0
14282,61248,0,0,147,147,0,1,0,1,0
10819,3389,10819,3389,293,223,70,4,1,3,1
16810,2001,6475,2001,198,157,41,2,0,2,0
28193,31178,0,0,91,91,0,1,0,1,0
20498,3389,20498,3389,293,223,70,4,0,3,1
17350,25773,0,0,142,142,0,1,0,1,0
12122,3389,12122,3389,293,223,70,4,0,3,1
18632,26915,0,0,131,131,0,1,0,1,0
50864,32103,0,0,86,86,0,1,0,1,0
29347,34021,0,0,62,62,0,1,0,1,0
17117,3389,17117,3389,293,223,70,4,0,3,1
8860,61248,0,0,139,139,0,1,0,1,0
47293,7033,0,0,145,145,0,1,0,1,0
10144,25773,0,0,148,148,0,1,0,1,0
14594,12076,0,0,144,144,0,1,0,1,0
49160,32320,0,0,146,146,0,1,0,1,0
22870,29729,0,0,104,104,0,1,0,1,0
25655,29512,0,0,109,109,0,1,0,1,0
14683,25773,0,0,140,140,0,1,0,1,0
55832,3389,55832,3389,293,223,70,4,0,3,1
26075,28919,0,0,115,115,0,1,0,1,0
37150,8021,0,0,146,146,0,1,0,1,0
9978,61248,0,0,139,139,0,1,0,1,0
52212,6203,0,0,145,145,0,1,0,1,0
9563,23823,0,0,149,149,0,1,0,1,0
12811,3333,12396,3333,289,220,68,3,0,2,0
11392,3389,11392,3389,293,223,70,4,1,3,1
23342,34021,0,0,62,62,0,1,0,1,0
28498,34021,0,0,62,62,0,1,0,1,0
1721,22239,0,0,157,157,0,1,0,1,0
47943,60223,0,0,74,74,0,1,0,1,0
13050,57012,0,0,130,130,0,1,0,1,0
21185,61248,0,0,157,157,0,1,0,1,0
39519,60354,0,0,87,87,0,1,0,1,0
14461,3389,14461,3389,293,223,70,4,0,3,1
12056,3389,12056,3389,293,223,70,4,1,3,1
7585,61248,0,0,139,139,0,1,0,1,0
32543,3389,32543,3389,293,223,70,4,0,3,1
62829,43598,0,0,95,95,0,1,0,1,0
10925,3389,10925,3389,293,223,70,4,1,3,1
28628,34021,0,0,62,62,0,1,0,1,0
51017,31035,0,0,80,80,0,1,0,1,0
10560,3389,10560,3389,293,223,70,4,1,3,1
14912,52463,0,0,116,116,0,1,0,1,0
16078,61248,0,0,150,150,0,1,0,1,0
14253,3389,14253,3389,293,223,70,4,0,3,1
13573,24144,0,0,122,122,0,1,0,1,0
15859,21260,0,0,92,92,0,1,0,1,0
19771,3389,19771,3389,293,223,70,4,0,3,1
39113,34021,0,0,102,102,0,1,0,1,0
52251,34021,0,0,70,70,0,1,0,1,0
13254,24547,0,0,126,126,0,1,0,1,0
3179,23045,0,0,157,157,0,1,0,1,0
25692,32030,0,0,81,81,0,1,0,1,0
15902,61248,0,0,150,150,0,1,0,1,0
51330,31652,0,0,70,70,0,1,0,1,0
13655,24041,0,0,121,121,0,1,0,1,0
16398,3389,16398,3389,293,223,70,4,0,3,1
59599,61180,0,0,140,140,0,1,0,1,0
14751,3389,14751,3389,293,223,70,4,0,3,1
63262,3589,58243,3083,279,215,63,3,0,2,0
12410,6885,6434,1988,233,192,41,2,0,2,0
40081,34021,0,0,106,106,0,1,0,1,0
25784,34021,0,0,62,62,0,1,0,1,0
19975,3389,19975,3389,293,223,70,4,0,3,1
16996,3389,16996,3389,293,223,70,4,0,3,1
53032,21227,0,0,101,101,0,1,0,1,0
50445,32858,0,0,104,104,0,1,0,1,0
8450,61248,0,0,140,140,0,1,0,1,0
47502,3389,47502,3389,293,223,70,4,0,3,1
50543,31652,0,0,97,97,0,1,0,1,0
8902,25773,0,0,155,155,0,1,0,1,0
50434,28902,0,0,106,106,0,1,0,1,0
15318,25773,0,0,141,141,0,1,0,1,0
57553,31652,0,0,67,67,0,1,0,1,0
17621,3389,17621,3389,293,223,70,4,0,3,1
12456,60789,0,0,137,137,0,1,0,1,0
51708,31507,0,0,64,64,0,1,0,1,0
23065,29262,0,0,108,108,0,1,0,1,0
57000,49537,0,0,112,112,0,1,0,1,0
10762,5964,6360,2357,248,200,48,3,0,2,0
46467,57101,0,0,62,62,0,1,0,1,0
11512,61248,0,0,142,142,0,1,0,1,0
26718,3389,26718,3389,293,223,70,4,0,3,1
12971,59411,0,0,133,133,0,1,0,1,0
38370,3389,38370,3389,293,223,70,4,1,3,1
12698,3389,12698,3389,293,223,70,4,0,3,1
47446,45671,0,0,104,104,0,1,0,1,0
55223,8298,0,0,137,137,0,1,0,1,0
10996,25325,0,0,141,141,0,1,0,1,0
47720,43426,0,0,111,111,0,1,0,1,0
55676,5628,0,0,144,144,0,1,0,1,0
49160,33395,0,0,146,146,0,1,0,1,0
15263,3389,15263,3389,293,223,70,4,0,3,1
14359,25773,0,0,148,148,0,1,0,1,0
10228,3389,10228,3389,293,223,70,4,0,3,1
28704,34021,0,0,62,62,0,1,0,1,0
18248,18244,0,0,62,62,0,1,0,1,0
19074,26634,0,0,134,134,0,1,0,1,0
50976,32911,0,0,101,101,0,1,0,1,0
13585,3389,13585,3389,293,223,70,4,0,3,1
36080,3389,36080,3389,293,223,70,4,0,3,1
28583,34021,0,0,62,62,0,1,0,1,0
46724,52284,0,0,87,87,0,1,0,1,0
49160,32865,0,0,146,146,0,1,0,1,0
51578,31652,0,0,68,68,0,1,0,1,0
16604,3389,16604,3389,293,223,70,4,0,3,1
29931,33925,0,0,62,62,0,1,0,1,0
8564,25773,0,0,155,155,0,1,0,1,0
12811,22284,0,0,112,112,0,1,0,1,0
17884,25742,0,0,143,143,0,1,0,1,0
49068,31093,0,0,149,149,0,1,0,1,0
28680,27653,0,0,128,128,0,1,0,1,0
6252,25773,0,0,143,143,0,1,0,1,0
12394,6847,6483,2003,233,192,41,2,0,2,0
28252,28323,0,0,121,121,0,1,0,1,0
28204,30644,0,0,97,97,0,1,0,1,0
21960,21020,0,0,93,93,0,1,0,1,0
10180,3389,10180,3389,293,223,70,4,1,3,1
29226,30389,0,0,99,99,0,1,0,1,0
17036,3389,17036,3389,293,223,70,4,0,3,1
1831,23117,0,0,152,152,0,1,0,1,0
50736,29521,0,0,96,96,0,1,0,1,0
37792,7560,0,0,146,146,0,1,0,1,0
10269,3389,10269,3389,293,223,70,4,1,3,1
18478,3389,18478,3389,293,223,70,4,0,3,1
18557,3389,18557,3389,293,223,70,4,0,3,1
62517,45883,0,0,101,101,0,1,0,1,0
19685,3389,19685,3389,293,223,70,4,0,3,1
12785,3389,12785,3389,293,223,70,4,0,3,1
15654,21518,0,0,95,95,0,1,0,1,0
29607,34021,0,0,62,62,0,1,0,1,0
26609,507,0,0,69,69,0,1,0,1,0
43448,3389,43448,3389,293,223,70,4,0,3,1
49373,60340,0,0,82,82,0,1,0,1,0
50194,28671,0,0,123,123,0,1,0,1,0
46661,3389,46661,3389,293,223,70,4,0,3,1
2297,23846,0,0,149,149,0,1,0,1,0
54943,3389,54943,3389,293,223,70,4,0,3,1
48992,28656,0,0,153,153,0,1,0,1,0
12044,8005,4153,1539,213,182,31,2,0,1,0
63028,42138,0,0,91,91,0,1,0,1,0
58026,61051,0,0,131,131,0,1,0,1,0
18008,3389,18008,3389,293,223,70,4,0,3,1
13418,18509,0,0,143,143,0,1,0,1,0
27707,13253,0,0,107,107,0,1,0,1,0
25514,29711,0,0,106,106,0,1,0,1,0
29508,3389,29508,3389,293,223,70,4,0,3,1
14653,3389,14653,3389,293,223,70,4,0,3,1
32559,16269,0,0,146,146,0,1,0,1,0
22883,21711,0,0,101,101,0,1,0,1,0
37584,3389,37584,3389,293,223,70,4,1,3,1
12099,3389,12099,3389,293,223,70,4,0,3,1
20106,3389,20106,3389,293,223,70,4,0,3,1
50380,36973,0,0,145,145,0,1,0,1,0
9816,3389,9816,3389,293,223,70,4,1,3,1
38149,3389,38149,3389,293,223,70,4,1,3,1
50966,31652,0,0,88,88,0,1,0,1,0
1545,22669,0,0,154,154,0,1,0,1,0
49823,27838,0,0,133,133,0,1,0,1,0
25692,34021,0,0,62,62,0,1,0,1,0
27286,1738,0,0,78,78,0,1,0,1,0
12523,58300,0,0,134,134,0,1,0,1,0
29850,1699,0,0,87,87,0,1,0,1,0
13352,24424,0,0,125,125,0,1,0,1,0
9900,3389,9900,3389,293,223,70,4,1,3,1
11526,7180,5045,1869,228,189,38,2,0,2,0
31035,3389,31035,3389,293,223,70,4,0,3,1
4115,49246,0,0,144,144,0,1,0,1,0
10136,3389,10136,3389,293,223,70,4,1,3,1
28716,34021,0,0,62,62,0,1,0,1,0
58611,31652,0,0,66,66,0,1,0,1,0
52257,33071,0,0,62,62,0,1,0,1,0
52456,60593,0,0,100,100,0,1,0,1,0
51624,31652,0,0,65,65,0,1,0,1,0
28712,34021,0,0,62,62,0,1,0,1,0
19575,3389,19575,3389,293,223,70,4,0,3,1
2199,45442,0,0,145,145,0,1,0,1,0
5178,25773,0,0,148,148,0,1,0,1,0
35011,34021,0,0,84,84,0,1,0,1,0
19449,28431,0,0,116,116,0,1,0,1,0
10822,61248,0,0,142,142,0,1,0,1,0
6717,23166,0,0,152,152,0,1,0,1,0
19245,18985,0,0,70,70,0,1,0,1,0
53888,45456,0,0,145,145,0,1,0,1,0
35509,3781,0,0,118,118,0,1,0,1,0
33157,17753,0,0,147,147,0,1,0,1,0
35501,3389,35501,3389,293,223,70,4,1,3,1
2305,42691,0,0,144,144,0,1,0,1,0
63669,3389,63669,3389,293,223,70,4,0,3,1
11998,61248,0,0,140,140,0,1,0,1,0
40326,3389,40326,3389,293,223,70,4,0,3,1
34598,11715,0,0,146,146,0,1,0,1,0
49712,33399,0,0,126,126,0,1,0,1,0
3394,27634,0,0,143,143,0,1,0,1,0
9621,61248,0,0,139,139,0,1,0,1,0
4087,39167,0,0,148,148,0,1,0,1,0
1777,22270,0,0,157,157,0,1,0,1,0
4024,39376,0,0,148,148,0,1,0,1,0
28111,25627,0,0,146,146,0,1,0,1,0
14459,61248,0,0,147,147,0,1,0,1,0
6423,25773,0,0,141,141,0,1,0,1,0
18809,61248,0,0,154,154,0,1,0,1,0
52438,34021,0,0,65,65,0,1,0,1,0
49017,29460,0,0,152,152,0,1,0,1,0
52446,33724,0,0,65,65,0,1,0,1,0
15477,3389,15477,3389,293,223,70,4,0,3,1
47209,3389,47209,3389,293,223,70,4,0,3,1
7557,50058,0,0,148,148,0,1,0,1,0
30041,1769,0,0,88,88,0,1,0,1,0
9656,3389,9656,3389,293,223,70,4,1,3,1
19182,29363,0,0,105,105,0,1,0,1,0
4112,39084,0,0,149,149,0,1,0,1,0
10079,3389,10079,3389,293,223,70,4,1,3,1
63066,41861,0,0,90,90,0,1,0,1,0
29102,3389,29102,3389,293,223,70,4,0,3,1
19847,29170,0,0,109,109,0,1,0,1,0
22399,25773,0,0,145,145,0,1,0,1,0
57166,60980,0,0,126,126,0,1,0,1,0
49513,33701,0,0,134,134,0,1,0,1,0
47594,3389,47594,3389,293,223,70,4,0,3,1
42344,3389,42344,3389,293,223,70,4,0,3,1
16385,61248,0,0,151,151,0,1,0,1,0
11844,3389,11844,3389,293,223,70,4,0,3,1
22703,25773,0,0,145,145,0,1,0,1,0
8760,61248,0,0,140,140,0,1,0,1,0
49372,33781,0,0,138,138,0,1,0,1,0
49557,27241,0,0,140,140,0,1,0,1,0
24236,61139,0,0,150,150,0,1,0,1,0
18248,18368,0,0,63,63,0,1,0,1,0
35707,9239,0,0,146,146,0,1,0,1,0
49021,26014,0,0,153,153,0,1,0,1,0
16610,3389,16610,3389,293,223,70,4,0,3,1
20770,61248,0,0,156,156,0,1,0,1,0
9951,3389,9951,3389,293,223,70,4,0,3,1
12270,3389,12270,3389,293,223,70,4,0,3,1
2950,33775,0,0,143,143,0,1,0,1,0
58994,4731,25466,1348,203,176,27,2,0,1,0
14345,11572,357,110,152,150,2,1,0,1,0
10559,61248,0,0,142,142,0,1,0,1,0
10862,61248,0,0,142,142,0,1,0,1,0
13528,25773,0,0,143,143,0,1,0,1,0
7737,24190,0,0,146,146,0,1,0,1,0
26628,34021,0,0,62,62,0,1,0,1,0
22174,34786,0,0,64,64,0,1,0,1,0
52129,33710,0,0,73,73,0,1,0,1,0
49616,5618,0,0,145,145,0,1,0,1,0
14774,61248,0,0,148,148,0,1,0,1,0
23060,584,2169,583,101,89,12,1,0,1,0
1434,22496,0,0,154,154,0,1,0,1,0
17259,47938,0,0,101,101,0,1,0,1,0
9588,61248,0,0,141,141,0,1,0,1,0
33309,17501,0,0,147,147,0,1,0,1,0
49491,31652,0,0,134,134,0,1,0,1,0
58176,32624,0,0,96,96,0,1,0,1,0
7989,25703,0,0,157,157,0,1,0,1,0
26750,25773,0,0,147,147,0,1,0,1,0
37820,7540,0,0,146,146,0,1,0,1,0
17475,3389,17475,3389,293,223,70,4,0,3,1
11051,61248,0,0,142,142,0,1,0,1,0
14555,61248,0,0,143,143,0,1,0,1,0
38279,3389,38279,3389,293,223,70,4,1,3,1
6789,59553,0,0,139,139,0,1,0,1,0
33517,60663,0,0,112,112,0,1,0,1,0
18965,3389,18965,3389,293,223,70,4,0,3,1
5492,25773,0,0,148,148,0,1,0,1,0
49690,27732,0,0,128,128,0,1,0,1,0
36139,12825,0,0,146,146,0,1,0,1,0
17468,25773,0,0,143,143,0,1,0,1,0
54434,13921,0,0,118,118,0,1,0,1,0
50695,30235,0,0,92,92,0,1,0,1,0
22329,21296,0,0,96,96,0,1,0,1,0
13721,61248,0,0,141,141,0,1,0,1,0
11385,61248,0,0,142,142,0,1,0,1,0
21311,3389,21311,3389,293,223,70,4,0,3,1
15171,3389,15171,3389,293,223,70,4,0,3,1
27747,25773,0,0,147,147,0,1,0,1,0
50536,29439,0,0,114,114,0,1,0,1,0
16171,18550,0,0,145,145,0,1,0,1,0
28297,26128,0,0,144,144,0,1,0,1,0
49093,30121,0,0,148,148,0,1,0,1,0
27497,833,0,0,74,74,0,1,0,1,0
37377,8708,0,0,145,145,0,1,0,1,0
21890,35414,0,0,66,66,0,1,0,1,0
18070,24067,0,0,124,124,0,1,0,1,0
50471,28979,0,0,105,105,0,1,0,1,0
2129,45677,0,0,145,145,0,1,0,1,0
46683,7136,0,0,145,145,0,1,0,1,0
8785,61248,0,0,139,139,0,1,0,1,0
6779,25773,0,0,152,152,0,1,0,1,0
9306,25773,0,0,151,151,0,1,0,1,0
18326,3389,18326,3389,293,223,70,4,0,3,1
11024,6381,5908,2190,241,196,45,2,0,2,0
37824,3389,37824,3389,293,223,70,4,1,3,1
11737,61248,0,0,139,139,0,1,0,1,0
8163,55031,0,0,141,141,0,1,0,1,0
18031,3389,18031,3389,293,223,70,4,0,3,1
16998,3389,16998,3389,293,223,70,4,0,3,1
49815,31652,0,0,124,124,0,1,0,1,0
51122,32245,0,0,83,83,0,1,0,1,0
16126,19821,0,0,81,81,0,1,0,1,0
49345,31652,0,0,140,140,0,1,0,1,0
49160,33827,0,0,146,146,0,1,0,1,0
8649,23612,0,0,150,150,0,1,0,1,0
26700,24571,0,0,134,134,0,1,0,1,0
13733,25773,0,0,149,149,0,1,0,1,0
58691,32545,0,0,93,93,0,1,0,1,0
13952,26641,0,0,130,130,0,1,0,1,0
13331,2827,9149,2827,254,196,58,3,0,2,0
40334,5736,0,0,146,146,0,1,0,1,0
52120,32993,0,0,73,73,0,1,0,1,0
45536,60045,0,0,62,62,0,1,0,1,0
30907,3389,30907,3389,293,223,70,4,0,3,1
4316,23000,0,0,151,151,0,1,0,1,0
18378,3389,18378,3389,293,223,70,4,0,3,1
56977,60965,0,0,125,125,0,1,0,1,0
48741,37162,0,0,135,135,0,1,0,1,0
2412,22621,0,0,157,157,0,1,0,1,0
2215,23718,0,0,150,150,0,1,0,1,0
26342,3389,26342,3389,293,223,70,4,0,3,1
36238,34021,0,0,89,89,0,1,0,1,0
17155,3389,17155,3389,293,223,70,4,0,3,1
52081,33124,0,0,65,65,0,1,0,1,0
48983,34021,0,0,145,145,0,1,0,1,0
20782,3389,20782,3389,293,223,70,4,0,3,1
6351,52298,0,0,142,142,0,1,0,1,0
16483,3389,16483,3389,293,223,70,4,0,3,1
38055,3389,38055,3389,293,223,70,4,1,3,1
18072,24000,0,0,123,123,0,1,0,1,0
49155,33887,0,0,146,146,0,1,0,1,0
51490,31652,0,0,67,67,0,1,0,1,0
11695,61248,0,0,139,139,0,1,0,1,0
38509,4885,0,0,135,135,0,1,0,1,0
57187,32778,0,0,101,101,0,1,0,1,0
54539,41108,0,0,88,88,0,1,0,1,0
3332,28491,0,0,143,143,0,1,0,1,0
4016,23507,0,0,157,157,0,1,0,1,0
30118,21722,0,0,147,147,0,1,0,1,0
26538,34021,0,0,62,62,0,1,0,1,0
10295,3389,10295,3389,293,223,70,4,0,3,1
6570,25773,0,0,152,152,0,1,0,1,0
4108,23558,0,0,157,157,0,1,0,1,0
10638,25773,0,0,146,146,0,1,0,1,0
38807,34021,0,0,100,100,0,1,0,1,0
33690,3112,0,0,108,108,0,1,0,1,0
50849,30618,0,0,86,86,0,1,0,1,0
49938,31652,0,0,118,118,0,1,0,1,0
28437,34021,0,0,62,62,0,1,0,1,0
18827,25773,0,0,143,143,0,1,0,1,0
10656,23885,0,0,133,133,0,1,0,1,0
20595,30558,0,0,96,96,0,1,0,1,0
33991,9939,0,0,137,137,0,1,0,1,0
46504,3389,46504,3389,293,223,70,4,0,3,1
14303,2596,8402,2596,238,185,53,3,0,2,0
17556,3389,17556,3389,293,223,70,4,0,3,1
15067,61248,0,0,149,149,0,1,0,1,0
59590,59245,0,0,145,145,0,1,0,1,0
7732,61248,0,0,139,139,0,1,0,1,0
9465,3389,9465,3389,293,223,70,4,1,3,1
13167,3389,13167,3389,293,223,70,4,0,3,1
17159,25773,0,0,144,144,0,1,0,1,0
16886,3389,16886,3389,293,223,70,4,0,3,1
11611,3389,11611,3389,293,223,70,4,0,3,1
29476,34021,0,0,62,62,0,1,0,1,0
7611,61248,0,0,139,139,0,1,0,1,0
27074,34021,0,0,62,62,0,1,0,1,0
53144,3389,53144,3389,293,223,70,4,0,3,1
52048,3389,52048,3389,293,223,70,4,0,3,1
12432,3389,12432,3389,293,223,70,4,1,3,1
37808,3389,37808,3389,293,223,70,4,1,3,1
13181,3389,13181,3389,293,223,70,4,0,3,1
13846,10364,1922,594,173,161,12,1,0,1,0
12080,60939,0,0,139,139,0,1,0,1,0
45950,58083,0,0,68,68,0,1,0,1,0
14778,27795,0,0,120,120,0,1,0,1,0
20268,39376,0,0,77,77,0,1,0,1,0
10305,61248,0,0,142,142,0,1,0,1,0
49125,30854,0,0,147,147,0,1,0,1,0
15267,22008,0,0,100,100,0,1,0,1,0
48943,27066,0,0,155,155,0,1,0,1,0
51026,32945,0,0,100,100,0,1,0,1,0
10937,25773,0,0,143,143,0,1,0,1,0
37171,3389,37171,3389,293,223,70,4,0,3,1
18124,22320,0,0,105,105,0,1,0,1,0
21279,3389,21279,3389,293,223,70,4,0,3,1
15858,3389,15858,3389,293,223,70,4,0,3,1
28235,25720,0,0,147,147,0,1,0,1,0
25528,34021,0,0,62,62,0,1,0,1,0
16480,3389,16480,3389,293,223,70,4,0,3,1
50116,60401,0,0,86,86,0,1,0,1,0
37151,8020,0,0,146,146,0,1,0,1,0
26641,3389,26641,3389,293,223,70,4,0,3,1
29023,34021,0,0,62,62,0,1,0,1,0
28186,31516,0,0,88,88,0,1,0,1,0
2607,24331,0,0,148,148,0,1,0,1,0
25666,160,0,0,64,64,0,1,0,1,0
47074,48711,0,0,95,95,0,1,0,1,0
50411,32888,0,0,105,105,0,1,0,1,0
15504,25773,0,0,141,141,0,1,0,1,0
57628,54500,0,0,145,145,0,1,0,1,0
49507,34021,0,0,137,137,0,1,0,1,0
12278,3389,12278,3389,293,223,70,4,1,3,1
5658,56265,0,0,140,140,0,1,0,1,0
28238,3389,28238,3389,293,223,70,4,0,3,1
10308,25773,0,0,147,147,0,1,0,1,0
11490,4657,9322,2880,271,211,59,3,0,2,0
16253,18869,0,0,145,145,0,1,0,1,0
45854,58801,0,0,65,65,0,1,0,1,0
18886,3389,18886,3389,293,223,70,4,0,3,1
49071,31189,0,0,149,149,0,1,0,1,0
50242,28512,0,0,112,112,0,1,0,1,0
3344,22389,0,0,155,155,0,1,0,1,0
54924,42426,0,0,92,92,0,1,0,1,0
49134,33214,0,0,147,147,0,1,0,1,0
40970,3389,40970,3389,293,223,70,4,0,3,1
6532,25773,0,0,152,152,0,1,0,1,0
18867,3389,18867,3389,293,223,70,4,0,3,1
45254,5618,0,0,145,145,0,1,0,1,0
50622,31652,0,0,99,99,0,1,0,1,0
18443,3389,18443,3389,293,223,70,4,0,3,1
1591,22741,0,0,153,153,0,1,0,1,0
61426,3389,61426,3389,293,223,70,4,0,3,1
17046,3389,17046,3389,293,223,70,4,0,3,1
48913,26102,0,0,156,156,0,1,0,1,0
47743,43239,0,0,111,111,0,1,0,1,0
45144,5618,0,0,145,145,0,1,0,1,0
9240,25773,0,0,140,140,0,1,0,1,0
15457,3389,15457,3389,293,223,70,4,0,3,1
36051,8809,0,0,146,146,0,1,0,1,0
37864,3389,37864,3389,293,223,70,4,1,3,1
17595,61248,0,0,152,152,0,1,0,1,0
24927,23242,0,0,119,119,0,1,0,1,0
17836,61248,0,0,150,150,0,1,0,1,0
10779,14588,0,0,150,150,0,1,0,1,0
14872,61248,0,0,148,148,0,1,0,1,0
4412,23726,0,0,157,157,0,1,0,1,0
62806,3711,54739,2898,271,211,59,3,0,2,0
55359,31652,0,0,68,68,0,1,0,1,0
50472,32543,0,0,99,99,0,1,0,1,0
48051,6905,0,0,145,145,0,1,0,1,0
32071,3389,32071,3389,293,223,70,4,0,3,1
49160,33811,0,0,146,146,0,1,0,1,0
52220,15904,0,0,151,151,0,1,0,1,0
16413,15142,0,0,103,103,0,1,0,1,0
39117,6609,0,0,146,146,0,1,0,1,0
60207,3389,60207,3389,293,223,70,4,0,3,1
32636,6268,0,0,120,120,0,1,0,1,0
53102,33916,0,0,62,62,0,1,0,1,0
3265,49304,0,0,143,143,0,1,0,1,0
39200,60371,0,0,88,88,0,1,0,1,0
51597,34021,0,0,86,86,0,1,0,1,0
24524,30270,0,0,98,98,0,1,0,1,0
16913,15984,0,0,92,92,0,1,0,1,0
3305,49423,0,0,143,143,0,1,0,1,0
29938,33960,0,0,62,62,0,1,0,1,0
27216,34021,0,0,62,62,0,1,0,1,0
18321,26337,0,0,137,137,0,1,0,1,0
28231,29349,0,0,110,110,0,1,0,1,0
24353,3389,24353,3389,293,223,70,4,0,3,1
17518,25773,0,0,143,143,0,1,0,1,0
26781,34021,0,0,62,62,0,1,0,1,0
9583,24833,0,0,143,143,0,1,0,1,0
21368,3389,21368,3389,293,223,70,4,0,3,1
53121,3389,53121,3389,293,223,70,4,0,3,1
10891,3389,10891,3389,293,223,70,4,1,3,1
9690,61248,0,0,139,139,0,1,0,1,0
20391,3389,20391,3389,293,223,70,4,0,3,1
35690,3389,35690,3389,293,223,70,4,0,3,1
5055,25773,0,0,142,142,0,1,0,1,0
9496,25773,0,0,143,143,0,1,0,1,0
27524,34021,0,0,62,62,0,1,0,1,0
6803,25773,0,0,141,141,0,1,0,1,0
51915,32056,0,0,62,62,0,1,0,1,0
4134,22936,0,0,152,152,0,1,0,1,0
49569,31652,0,0,132,132,0,1,0,1,0
53528,31652,0,0,122,122,0,1,0,1,0
15717,25773,0,0,141,141,0,1,0,1,0
9993,4740,7682,2847,269,211,58,3,0,2,0
12062,8033,4123,1528,213,181,31,2,0,1,0
27173,27370,0,0,131,131,0,1,0,1,0
37839,3389,37839,3389,293,223,70,4,1,3,1
29323,3389,29323,3389,293,223,70,4,1,3,1
20193,3389,20193,3389,293,223,70,4,0,3,1
13328,10048,1944,720,178,163,14,1,0,1,0
47572,3389,47572,3389,293,223,70,4,0,3,1
48969,27916,0,0,154,154,0,1,0,1,0
7719,23629,0,0,119,119,0,1,0,1,0
7066,53376,0,0,142,142,0,1,0,1,0
27166,27379,0,0,131,131,0,1,0,1,0
12691,3389,12691,3389,293,223,70,4,0,3,1
45487,17581,0,0,152,152,0,1,0,1,0
15208,13111,0,0,131,131,0,1,0,1,0
29559,34021,0,0,62,62,0,1,0,1,0
3583,22444,0,0,154,154,0,1,0,1,0
11145,3389,11145,3389,293,223,70,4,0,3,1
8907,25773,0,0,153,153,0,1,0,1,0
56097,33319,0,0,62,62,0,1,0,1,0
56801,52499,0,0,145,145,0,1,0,1,0
20471,30328,0,0,98,98,0,1,0,1,0
14094,3389,14094,3389,293,223,70,4,0,3,1
25932,32875,0,0,72,72,0,1,0,1,0
51074,31178,0,0,78,78,0,1,0,1,0
7350,53804,0,0,141,141,0,1,0,1,0
17508,3389,17508,3389,293,223,70,4,0,3,1
17233,61248,0,0,152,152,0,1,0,1,0
49853,31652,0,0,142,142,0,1,0,1,0
22047,30853,0,0,91,91,0,1,0,1,0
25838,29254,0,0,111,111,0,1,0,1,0
12616,25352,0,0,134,134,0,1,0,1,0
29922,33876,0,0,63,63,0,1,0,1,0
15399,3389,15399,3389,293,223,70,4,0,3,1
60539,31652,0,0,83,83,0,1,0,1,0
6291,25773,0,0,141,141,0,1,0,1,0
40192,34021,0,0,106,106,0,1,0,1,0
2848,43283,0,0,146,146,0,1,0,1,0
31280,60778,0,0,121,121,0,1,0,1,0
26257,34021,0,0,62,62,0,1,0,1,0
36969,8150,0,0,146,146,0,1,0,1,0
51020,31927,0,0,80,80,0,1,0,1,0
8533,25773,0,0,155,155,0,1,0,1,0
49160,32780,0,0,146,146,0,1,0,1,0
13565,24154,0,0,122,122,0,1,0,1,0
4654,53346,0,0,142,142,0,1,0,1,0
9757,3389,9757,3389,293,223,70,4,1,3,1
64455,31652,0,0,62,62,0,1,0,1,0
16315,3389,16315,3389,293,223,70,4,0,3,1
16882,19969,0,0,79,79,0,1,0,1,0
50492,32575,0,0,113,113,0,1,0,1,0
27415,3389,27415,3389,293,223,70,4,0,3,1
21193,61248,0,0,157,157,0,1,0,1,0
49160,33064,0,0,146,146,0,1,0,1,0
16155,61248,0,0,150,150,0,1,0,1,0
13246,61248,0,0,145,145,0,1,0,1,0
14621,3389,14621,3389,293,223,70,4,0,3,1
18130,22150,0,0,104,104,0,1,0,1,0
12611,22433,0,0,114,114,0,1,0,1,0
7889,61248,0,0,139,139,0,1,0,1,0
11758,3389,11758,3389,293,223,70,4,1,3,1
16306,19236,0,0,72,72,0,1,0,1,0
49412,31652,0,0,144,144,0,1,0,1,0
50441,28918,0,0,106,106,0,1,0,1,0
21632,61248,0,0,158,158,0,1,0,1,0
14058,3389,14058,3389,293,223,70,4,0,3,1
9918,3389,9918,3389,293,223,70,4,1,3,1
49496,26986,0,0,137,137,0,1,0,1,0
28584,34021,0,0,62,62,0,1,0,1,0
41300,5618,0,0,145,145,0,1,0,1,0
11455,3389,11455,3389,293,223,70,4,0,3,1
59710,61189,0,0,141,141,0,1,0,1,0
3856,22839,0,0,152,152,0,1,0,1,0
10264,24176,0,0,136,136,0,1,0,1,0
50823,3389,50823,3389,293,223,70,4,0,3,1
43452,3389,43452,3389,293,223,70,4,0,3,1
12050,3389,12050,3389,293,223,70,4,1,3,1
53702,18807,0,0,102,102,0,1,0,1,0
13634,55585,0,0,126,126,0,1,0,1,0
49754,27891,0,0,126,126,0,1,0,1,0
5538,24745,0,0,131,131,0,1,0,1,0
22818,2656,0,0,81,81,0,1,0,1,0
9348,25773,0,0,155,155,0,1,0,1,0
21740,3389,21740,3389,293,223,70,4,0,3,1
29217,30346,0,0,100,100,0,1,0,1,0
2801,24634,0,0,147,147,0,1,0,1,0
4094,39144,0,0,149,149,0,1,0,1,0
49035,30011,0,0,151,151,0,1,0,1,0
12279,6567,6845,2115,238,194,43,2,0,2,0
11288,3389,11288,3389,293,223,70,4,0,3,1
50470,29291,0,0,116,116,0,1,0,1,0
10094,59210,0,0,143,143,0,1,0,1,0
31090,2155,0,0,94,94,0,1,0,1,0
49365,3389,49365,3389,293,223,70,4,0,3,1
18247,18370,0,0,63,63,0,1,0,1,0
11329,59807,0,0,139,139,0,1,0,1,0
16391,3389,16391,3389,293,223,70,4,0,3,1
24058,31765,0,0,85,85,0,1,0,1,0
12555,3389,12555,3389,293,223,70,4,1,3,1
50677,34021,0,0,108,108,0,1,0,1,0
17619,17175,0,0,76,76,0,1,0,1,0
19100,40084,0,0,79,79,0,1,0,1,0
12225,3389,12225,3389,293,223,70,4,1,3,1
28996,34021,0,0,62,62,0,1,0,1,0
51624,33359,0,0,85,85,0,1,0,1,0
57312,50460,0,0,112,112,0,1,0,1,0
26622,33233,0,0,69,69,0,1,0,1,0
52378,33430,0,0,62,62,0,1,0,1,0
24271,34021,0,0,62,62,0,1,0,1,0
52477,33723,0,0,62,62,0,1,0,1,0
51403,31652,0,0,69,69,0,1,0,1,0
2003,23385,0,0,151,151,0,1,0,1,0
12383,3389,12383,3389,293,223,70,4,0,3,1
19472,28473,0,0,116,116,0,1,0,1,0
10357,58341,0,0,140,140,0,1,0,1,0
48731,60287,0,0,79,79,0,1,0,1,0
3874,25773,0,0,144,144,0,1,0,1,0
12901,3389,12901,3389,293,223,70,4,0,3,1
54393,31652,0,0,62,62,0,1,0,1,0
3564,40903,0,0,147,147,0,1,0,1,0
24884,34021,0,0,62,62,0,1,0,1,0
4457,25773,0,0,142,142,0,1,0,1,0
34013,3389,34013,3389,293,223,70,4,0,3,1
50929,32420,0,0,89,89,0,1,0,1,0
54385,5836,0,0,145,145,0,1,0,1,0
49514,31897,0,0,137,137,0,1,0,1,0
51391,31880,0,0,71,71,0,1,0,1,0
27702,25773,0,0,147,147,0,1,0,1,0
51347,30768,0,0,76,76,0,1,0,1,0
20050,3389,20050,3389,293,223,70,4,0,3,1
10614,25773,0,0,153,153,0,1,0,1,0
8584,55666,0,0,141,141,0,1,0,1,0
18971,3389,18971,3389,293,223,70,4,0,3,1
58707,55386,0,0,128,128,0,1,0,1,0
7682,60687,0,0,137,137,0,1,0,1,0
20914,3389,20914,3389,293,223,70,4,0,3,1
1136,22029,0,0,156,156,0,1,0,1,0
49546,31920,0,0,136,136,0,1,0,1,0
21020,3389,21020,3389,293,223,70,4,0,3,1
16368,3389,16368,3389,293,223,70,4,0,3,1
10988,3389,10988,3389,293,223,70,4,1,3,1
9580,25773,0,0,150,150,0,1,0,1,0
28953,34021,0,0,62,62,0,1,0,1,0
9749,3389,9749,3389,293,223,70,4,1,3,1
15368,3389,15368,3389,293,223,70,4,0,3,1
20614,3389,20614,3389,293,223,70,4,0,3,1
28782,34021,0,0,62,62,0,1,0,1,0
33131,3389,33131,3389,293,223,70,4,0,3,1
17790,18584,0,0,66,66,0,1,0,1,0
12585,3389,12585,3389,293,223,70,4,0,3,1
20369,3389,20369,3389,293,223,70,4,0,3,1
12120,6182,7344,2269,245,198,46,3,0,2,0
40108,5473,0,0,143,143,0,1,0,1,0
18967,3389,18967,3389,293,223,70,4,0,3,1
49160,33991,0,0,146,146,0,1,0,1,0
6204,23048,0,0,152,152,0,1,0,1,0
11496,25773,0,0,142,142,0,1,0,1,0
2177,22255,0,0,155,155,0,1,0,1,0
51436,31961,0,0,70,70,0,1,0,1,0
14825,47799,0,0,100,100,0,1,0,1,0
9853,3389,9853,3389,293,223,70,4,1,3,1
49019,28428,0,0,152,152,0,1,0,1,0
26629,34021,0,0,62,62,0,1,0,1,0
13855,27047,0,0,127,127,0,1,0,1,0
11998,61248,0,0,140,140,0,1,0,1,0
11003,3389,11003,3389,293,223,70,4,0,3,1
22717,15886,0,0,83,83,0,1,0,1,0
19193,6642,0,0,110,110,0,1,0,1,0
22387,33883,0,0,63,63,0,1,0,1,0
20801,38460,0,0,74,74,0,1,0,1,0
7251,60898,0,0,139,139,0,1,0,1,0
7569,61248,0,0,139,139,0,1,0,1,0
11836,3389,11836,3389,293,223,70,4,0,3,1
61722,32075,0,0,77,77,0,1,0,1,0
2715,47706,0,0,144,144,0,1,0,1,0
20979,3389,20979,3389,293,223,70,4,0,3,1
55308,8084,0,0,137,137,0,1,0,1,0
18504,18431,0,0,64,64,0,1,0,1,0
8997,61248,0,0,139,139,0,1,0,1,0
50100,34021,0,0,122,122,0,1,0,1,0
25644,32725,0,0,74,74,0,1,0,1,0
16963,61248,0,0,151,151,0,1,0,1,0
8519,25773,0,0,155,155,0,1,0,1,0
4095,25773,0,0,144,144,0,1,0,1,0
49055,29253,0,0,150,150,0,1,0,1,0
21004,3389,21004,3389,293,223,70,4,0,3,1
25652,31996,0,0,81,81,0,1,0,1,0
20729,3389,20729,3389,293,223,70,4,0,3,1
6318,52248,0,0,142,142,0,1,0,1,0
51473,31652,0,0,67,67,0,1,0,1,0
29702,34021,0,0,62,62,0,1,0,1,0
50472,28980,0,0,105,105,0,1,0,1,0
25780,3389,25780,3389,293,223,70,4,0,3,1
63636,3490,61111,3235,286,219,66,3,0,2,0
55318,5678,0,0,145,145,0,1,0,1,0
10328,3389,10328,3389,293,223,70,4,1,3,1
21446,3389,21446,3389,293,223,70,4,0,3,1
9335,3389,9335,3389,293,223,70,4,1,3,1
16275,3389,16275,3389,293,223,70,4,0,3,1
20943,37727,0,0,73,73,0,1,0,1,0
49160,33913,0,0,146,146,0,1,0,1,0
15184,25773,0,0,141,141,0,1,0,1,0
49937,28094,0,0,130,130,0,1,0,1,0
15655,16529,0,0,146,146,0,1,0,1,0
8025,61248,0,0,139,139,0,1,0,1,0
35296,3389,35296,3389,293,223,70,4,0,3,1
11812,60038,0,0,139,139,0,1,0,1,0
19013,3389,19013,3389,293,223,70,4,0,3,1
28240,25864,0,0,147,147,0,1,0,1,0
8731,56939,0,0,143,143,0,1,0,1,0
10582,25773,0,0,146,146,0,1,0,1,0
16472,3389,16472,3389,293,223,70,4,0,3,1
7760,60547,0,0,137,137,0,1,0,1,0
1813,23089,0,0,152,152,0,1,0,1,0
49417,34643,0,0,145,145,0,1,0,1,0
18187,20314,0,0,84,84,0,1,0,1,0
18149,21542,0,0,97,97,0,1,0,1,0
3988,49034,0,0,144,144,0,1,0,1,0
37649,3389,37649,3389,293,223,70,4,1,3,1
12491,3389,12491,3389,293,223,70,4,0,3,1
13150,61248,0,0,145,145,0,1,0,1,0
17533,25773,0,0,143,143,0,1,0,1,0
6645,23810,0,0,148,148,0,1,0,1,0
14319,20253,0,0,83,83,0,1,0,1,0
9501,15539,0,0,151,151,0,1,0,1,0
18755,3389,18755,3389,293,223,70,4,0,3,1
18732,3389,18732,3389,293,223,70,4,0,3,1
34520,3417,0,0,113,113,0,1,0,1,0
22984,33281,0,0,69,69,0,1,0,1,0
56558,33227,0,0,62,62,0,1,0,1,0
36475,4137,0,0,123,123,0,1,0,1,0
18916,3389,18916,3389,293,223,70,4,0,3,1
7078,49690,0,0,148,148,0,1,0,1,0
2345,22314,0,0,154,154,0,1,0,1,0
25685,34021,0,0,62,62,0,1,0,1,0
47411,22194,0,0,155,155,0,1,0,1,0
30319,3389,30319,3389,293,223,70,4,0,3,1
45380,60053,0,0,63,63,0,1,0,1,0
51515,32103,0,0,70,70,0,1,0,1,0
51356,31652,0,0,70,70,0,1,0,1,0
45712,59870,0,0,62,62,0,1,0,1,0
12560,3389,12560,3389,293,223,70,4,1,3,1
61218,55395,0,0,128,128,0,1,0,1,0
15210,22079,0,0,101,101,0,1,0,1,0
28204,30632,0,0,97,97,0,1,0,1,0
13784,24796,0,0,146,146,0,1,0,1,0
10011,3389,10011,3389,293,223,70,4,1,3,1
11465,25773,0,0,142,142,0,1,0,1,0
9253,25773,0,0,143,143,0,1,0,1,0
29481,34021,0,0,62,62,0,1,0,1,0
51329,39266,0,0,145,145,0,1,0,1,0
53803,60704,0,0,107,107,0,1,0,1,0
8486,61248,0,0,139,139,0,1,0,1,0
5762,25773,0,0,149,149,0,1,0,1,0
38241,3389,38241,3389,293,223,70,4,1,3,1
49987,33089,0,0,116,116,0,1,0,1,0
10928,61248,0,0,142,142,0,1,0,1,0
54386,5618,0,0,145,145,0,1,0,1,0
18804,3389,18804,3389,293,223,70,4,0,3,1
9905,24945,0,0,142,142,0,1,0,1,0
9311,3655,8856,3282,288,220,67,3,0,2,0
9433,3849,8646,3204,285,218,66,3,0,2,0
13695,2740,8869,2740,248,192,56,3,0,2,0
50531,5618,0,0,145,145,0,1,0,1,0
26296,392,0,0,67,67,0,1,0,1,0
18123,22352,0,0,106,106,0,1,0,1,0
27077,1561,0,0,76,76,0,1,0,1,0
14050,56522,0,0,125,125,0,1,0,1,0
20680,3389,20680,3389,293,223,70,4,0,3,1
48911,25961,0,0,156,156,0,1,0,1,0
58558,31652,0,0,62,62,0,1,0,1,0
9559,4050,8429,3124,281,217,64,3,0,2,0
49160,31691,0,0,146,146,0,1,0,1,0
15461,25773,0,0,146,146,0,1,0,1,0
9367,61248,0,0,139,139,0,1,0,1,0
12106,60978,0,0,139,139,0,1,0,1,0
52471,33946,0,0,64,64,0,1,0,1,0
12832,59784,0,0,134,134,0,1,0,1,0
16467,20494,0,0,85,85,0,1,0,1,0
3245,29695,0,0,143,143,0,1,0,1,0
22312,34288,0,0,62,62,0,1,0,1,0
23652,61169,0,0,152,152,0,1,0,1,0
18061,24355,0,0,127,127,0,1,0,1,0
19625,27083,0,0,130,130,0,1,0,1,0
50644,29332,0,0,99,99,0,1,0,1,0
35332,3389,35332,3389,293,223,70,4,0,3,1
10534,5601,6752,2502,255,203,51,3,0,2,0
21733,28341,0,0,117,117,0,1,0,1,0
21072,25773,0,0,144,144,0,1,0,1,0
48947,26786,0,0,155,155,0,1,0,1,0
2997,46557,0,0,145,145,0,1,0,1,0
36338,3389,36338,3389,293,223,70,4,0,3,1
49317,46336,0,0,62,62,0,1,0,1,0
59134,4693,26539,1405,206,177,29,2,0,1,0
18206,45405,0,0,94,94,0,1,0,1,0
18120,22466,0,0,107,107,0,1,0,1,0
49736,27476,0,0,129,129,0,1,0,1,0
60507,3389,60507,3389,293,223,70,4,0,3,1
40588,8166,0,0,145,145,0,1,0,1,0
27816,25773,0,0,147,147,0,1,0,1,0
52442,34021,0,0,65,65,0,1,0,1,0
10912,3389,10912,3389,293,223,70,4,1,3,1
18237,18217,0,0,62,62,0,1,0,1,0
46062,5618,0,0,145,145,0,1,0,1,0
29005,29285,0,0,111,111,0,1,0,1,0
28301,25919,0,0,146,146,0,1,0,1,0
19025,1475,4772,1474,162,132,30,2,0,1,0
9460,61248,0,0,141,141,0,1,0,1,0
21030,3389,21030,3389,293,223,70,4,0,3,1
49644,60362,0,0,84,84,0,1,0,1,0
57472,32733,0,0,100,100,0,1,0,1,0
58119,61059,0,0,132,132,0,1,0,1,0
48974,25918,0,0,154,154,0,1,0,1,0
12371,52226,0,0,113,113,0,1,0,1,0
16635,61248,0,0,147,147,0,1,0,1,0
15847,61248,0,0,146,146,0,1,0,1,0
15694,3389,15694,3389,293,223,70,4,0,3,1
28164,32613,0,0,76,76,0,1,0,1,0
10830,3389,10830,3389,293,223,70,4,1,3,1
20082,3389,20082,3389,293,223,70,4,0,3,1
40541,5618,0,0,145,145,0,1,0,1,0
3577,47001,0,0,146,146,0,1,0,1,0
51557,33313,0,0,87,87,0,1,0,1,0
56305,60910,0,0,121,121,0,1,0,1,0
3285,25391,0,0,144,144,0,1,0,1,0
10958,25773,0,0,139,139,0,1,0,1,0
10691,25773,0,0,145,145,0,1,0,1,0
14333,11543,395,122,153,150,2,1,0,1,0
23701,32270,0,0,80,80,0,1,0,1,0
16008,21072,0,0,90,90,0,1,0,1,0
12210,25773,0,0,151,151,0,1,0,1,0
3782,23378,0,0,157,157,0,1,0,1,0
34919,3389,34919,3389,293,223,70,4,0,3,1
58508,54615,0,0,124,124,0,1,0,1,0
12236,3389,12236,3389,293,223,70,4,1,3,1
28803,28272,0,0,121,121,0,1,0,1,0
21392,3389,21392,3389,293,223,70,4,0,3,1
3177,30631,0,0,143,143,0,1,0,1,0
11383,59887,0,0,139,139,0,1,0,1,0
13784,23878,0,0,119,119,0,1,0,1,0
54175,3389,54175,3389,293,223,70,4,0,3,1
28219,29924,0,0,104,104,0,1,0,1,0
56072,3389,56072,3389,293,223,70,4,0,3,1
18034,25225,0,0,137,137,0,1,0,1,0
11433,7032,5205,1929,230,190,39,2,0,2,0
31311,5146,0,0,110,110,0,1,0,1,0
49032,34977,0,0,142,142,0,1,0,1,0
59704,31652,0,0,88,88,0,1,0,1,0
23509,32541,0,0,77,77,0,1,0,1,0
48349,5618,0,0,145,145,0,1,0,1,0
18048,3389,18048,3389,293,223,70,4,0,3,1
14821,12459,0,0,139,139,0,1,0,1,0
15016,61248,0,0,148,148,0,1,0,1,0
12966,61248,0,0,140,140,0,1,0,1,0
17321,3389,17321,3389,293,223,70,4,0,3,1
16304,9819,0,0,133,133,0,1,0,1,0
11814,61248,0,0,140,140,0,1,0,1,0
9481,3389,9481,3389,293,223,70,4,0,3,1
16503,3389,16503,3389,293,223,70,4,0,3,1
18219,3389,18219,3389,293,223,70,4,0,3,1
49451,26895,0,0,138,138,0,1,0,1,0
56629,48266,0,0,108,108,0,1,0,1,0
17330,3389,17330,3389,293,223,70,4,0,3,1
29691,32719,0,0,75,75,0,1,0,1,0
12106,3118,10091,3118,274,210,64,3,0,2,0
26161,34021,0,0,62,62,0,1,0,1,0
26157,28803,0,0,116,116,0,1,0,1,0
56021,31652,0,0,62,62,0,1,0,1,0
13892,3389,13892,3389,293,223,70,4,0,3,1
6600,25773,0,0,143,143,0,1,0,1,0
36576,4174,0,0,124,124,0,1,0,1,0
51137,33022,0,0,97,97,0,1,0,1,0
8359,25773,0,0,155,155,0,1,0,1,0
10450,3389,10450,3389,293,223,70,4,1,3,1
52033,29953,0,0,67,67,0,1,0,1,0
28244,28703,0,0,117,117,0,1,0,1,0
62086,3389,62086,3389,293,223,70,4,0,3,1
13015,25773,0,0,150,150,0,1,0,1,0
18736,7145,0,0,113,113,0,1,0,1,0
10219,61248,0,0,141,141,0,1,0,1,0
9876,3389,9876,3389,293,223,70,4,0,3,1
11452,60917,0,0,142,142,0,1,0,1,0
17851,25126,0,0,143,143,0,1,0,1,0
40331,5895,0,0,146,146,0,1,0,1,0
41924,3389,41924,3389,293,223,70,4,0,3,1
29472,31621,0,0,87,87,0,1,0,1,0
29001,34021,0,0,62,62,0,1,0,1,0
21880,3389,21880,3389,293,223,70,4,0,3,1
8100,25773,0,0,143,143,0,1,0,1,0
17147,3389,17147,3389,293,223,70,4,0,3,1
45813,60048,0,0,62,62,0,1,0,1,0
28800,34021,0,0,62,62,0,1,0,1,0
16433,27932,0,0,118,118,0,1,0,1,0
26505,31639,0,0,85,85,0,1,0,1,0
16718,3389,16718,3389,293,223,70,4,0,3,1
51212,34021,0,0,95,95,0,1,0,1,0
9949,61248,0,0,141,141,0,1,0,1,0
4532,25773,0,0,146,146,0,1,0,1,0
42813,3389,42813,3389,293,223,70,4,0,3,1
28181,31774,0,0,85,85,0,1,0,1,0
52065,34021,0,0,74,74,0,1,0,1,0
22846,34021,0,0,62,62,0,1,0,1,0
11932,61248,0,0,140,140,0,1,0,1,0
51070,32292,0,0,84,84,0,1,0,1,0
15697,13935,0,0,119,119,0,1,0,1,0
51440,31652,0,0,68,68,0,1,0,1,0
49164,34016,0,0,145,145,0,1,0,1,0
49846,33248,0,0,121,121,0,1,0,1,0
20559,3389,20559,3389,293,223,70,4,0,3,1
4010,51472,0,0,142,142,0,1,0,1,0
47256,3389,47256,3389,293,223,70,4,0,3,1
49160,32358,0,0,146,146,0,1,0,1,0
49122,32812,0,0,147,147,0,1,0,1,0
51813,33490,0,0,80,80,0,1,0,1,0
11936,61248,0,0,140,140,0,1,0,1,0
37326,4450,0,0,128,128,0,1,0,1,0
32332,19117,0,0,147,147,0,1,0,1,0
19593,3389,19593,3389,293,223,70,4,0,3,1
30740,4662,0,0,105,105,0,1,0,1,0
10398,61248,0,0,142,142,0,1,0,1,0
61215,31652,0,0,62,62,0,1,0,1,0
16169,3389,16169,3389,293,223,70,4,0,3,1
10677,3389,10677,3389,293,223,70,4,0,3,1
12441,61248,0,0,139,139,0,1,0,1,0
50369,31652,0,0,103,103,0,1,0,1,0
13132,3389,13132,3389,293,223,70,4,0,3,1
16017,3389,16017,3389,293,223,70,4,0,3,1
58140,53334,0,0,120,120,0,1,0,1,0
51467,31652,0,0,68,68,0,1,0,1,0
51803,31725,0,0,62,62,0,1,0,1,0
14442,25773,0,0,140,140,0,1,0,1,0
6014,24611,0,0,157,157,0,1,0,1,0
21351,3389,21351,3389,293,223,70,4,0,3,1
51290,31652,0,0,71,71,0,1,0,1,0
38868,6788,0,0,146,146,0,1,0,1,0
59297,31652,0,0,65,65,0,1,0,1,0
51680,32401,0,0,68,68,0,1,0,1,0
13258,24675,0,0,146,146,0,1,0,1,0
28598,3389,28598,3389,293,223,70,4,0,3,1
36981,8142,0,0,146,146,0,1,0,1,0
17849,3389,17849,3389,293,223,70,4,0,3,1
12962,3389,12962,3389,293,223,70,4,0,3,1
29400,31261,0,0,90,90,0,1,0,1,0
4231,38688,0,0,149,149,0,1,0,1,0
29281,30668,0,0,96,96,0,1,0,1,0
50673,31652,0,0,97,97,0,1,0,1,0
37475,3389,37475,3389,293,223,70,4,1,3,1
7900,61248,0,0,139,139,0,1,0,1,0
61138,31652,0,0,80,80,0,1,0,1,0
17368,3389,17368,3389,293,223,70,4,0,3,1
18230,3389,18230,3389,293,223,70,4,0,3,1
18502,3389,18502,3389,293,223,70,4,0,3,1
43566,5618,0,0,145,145,0,1,0,1,0
18478,3389,18478,3389,293,223,70,4,0,3,1
11811,61248,0,0,140,140,0,1,0,1,0
52420,33736,0,0,63,63,0,1,0,1,0
17336,61248,0,0,151,151,0,1,0,1,0
49131,33117,0,0,147,147,0,1,0,1,0
14220,3389,14220,3389,293,223,70,4,0,3,1
7021,25773,0,0,153,153,0,1,0,1,0
19110,61248,0,0,154,154,0,1,0,1,0
3025,22315,0,0,155,155,0,1,0,1,0
27232,3389,27232,3389,293,223,70,4,0,3,1
27448,3389,27448,3389,293,223,70,4,0,3,1
1367,22392,0,0,155,155,0,1,0,1,0
5165,54830,0,0,141,141,0,1,0,1,0
49160,32581,0,0,146,146,0,1,0,1,0
9634,25773,0,0,154,154,0,1,0,1,0
24393,3389,24393,3389,293,223,70,4,0,3,1
51409,31652,0,0,69,69,0,1,0,1,0
13678,9956,2451,757,180,164,15,1,0,1,0
15394,3389,15394,3389,293,223,70,4,0,3,1
49358,31652,0,0,139,139,0,1,0,1,0
13300,9040,3639,1124,196,172,23,1,0,1,0
63469,31805,0,0,67,67,0,1,0,1,0
23943,3389,23943,3389,293,223,70,4,0,3,1
11492,3389,11492,3389,293,223,70,4,1,3,1
48904,25813,0,0,156,156,0,1,0,1,0
49160,33750,0,0,146,146,0,1,0,1,0
18694,3389,18694,3389,293,223,70,4,0,3,1
7701,25773,0,0,141,141,0,1,0,1,0
10912,6203,6101,2261,244,198,46,3,0,2,0
62645,31652,0,0,63,63,0,1,0,1,0
13636,3389,13636,3389,293,223,70,4,1,3,1
51781,32584,0,0,68,68,0,1,0,1,0
25024,34021,0,0,62,62,0,1,0,1,0
27795,34021,0,0,62,62,0,1,0,1,0
11777,25773,0,0,139,139,0,1,0,1,0
25210,34021,0,0,62,62,0,1,0,1,0
49196,31652,0,0,144,144,0,1,0,1,0
18077,23836,0,0,122,122,0,1,0,1,0
36489,12245,0,0,146,146,0,1,0,1,0
24103,3389,24103,3389,293,223,70,4,0,3,1
11830,3389,11830,3389,293,223,70,4,1,3,1
58103,31652,0,0,96,96,0,1,0,1,0
31860,5611,0,0,114,114,0,1,0,1,0
24766,3389,24766,3389,293,223,70,4,1,3,1
28424,34021,0,0,62,62,0,1,0,1,0
58527,54767,0,0,126,126,0,1,0,1,0
21493,4113,0,0,91,91,0,1,0,1,0
57619,54479,0,0,145,145,0,1,0,1,0
10886,23714,0,0,131,131,0,1,0,1,0
47133,5618,0,0,145,145,0,1,0,1,0
23367,32741,0,0,75,75,0,1,0,1,0
38660,6937,0,0,146,146,0,1,0,1,0
4462,23753,0,0,157,157,0,1,0,1,0
18943,3389,18943,3389,293,223,70,4,0,3,1
25744,3389,25744,3389,293,223,70,4,1,3,1
51801,32279,0,0,82,82,0,1,0,1,0
33773,3389,33773,3389,293,223,70,4,0,3,1
9764,61248,0,0,139,139,0,1,0,1,0
50544,29858,0,0,97,97,0,1,0,1,0
37706,3389,37706,3389,293,223,70,4,0,3,1
37784,3389,37784,3389,293,223,70,4,1,3,1
24574,3389,24574,3389,293,223,70,4,0,3,1
58518,61091,0,0,134,134,0,1,0,1,0
51340,31652,0,0,70,70,0,1,0,1,0
28150,33249,0,0,70,70,0,1,0,1,0
14978,3389,14978,3389,293,223,70,4,0,3,1
2344,23920,0,0,149,149,0,1,0,1,0
14315,61248,0,0,147,147,0,1,0,1,0
5446,24297,0,0,157,157,0,1,0,1,0
13750,61248,0,0,141,141,0,1,0,1,0
10924,61248,0,0,142,142,0,1,0,1,0
13712,10039,2344,724,178,164,14,1,0,1,0
17500,25773,0,0,142,142,0,1,0,1,0
21397,20598,0,0,88,88,0,1,0,1,0
17581,47077,0,0,98,98,0,1,0,1,0
51650,32347,0,0,69,69,0,1,0,1,0
28759,28052,0,0,124,124,0,1,0,1,0
49153,33819,0,0,146,146,0,1,0,1,0
35180,3389,35180,3389,293,223,70,4,0,3,1
16867,25773,0,0,142,142,0,1,0,1,0
21010,3389,21010,3389,293,223,70,4,0,3,1
37613,7689,0,0,146,146,0,1,0,1,0
20604,61248,0,0,156,156,0,1,0,1,0
19940,3389,19940,3389,293,223,70,4,0,3,1
18285,25958,0,0,141,141,0,1,0,1,0
7476,17048,0,0,152,152,0,1,0,1,0
37825,8632,0,0,145,145,0,1,0,1,0
11323,3389,11323,3389,293,223,70,4,0,3,1
20003,3389,20003,3389,293,223,70,4,0,3,1
19340,61248,0,0,154,154,0,1,0,1,0
35359,14113,0,0,146,146,0,1,0,1,0
27440,3389,27440,3389,293,223,70,4,0,3,1
27495,3389,27495,3389,293,223,70,4,0,3,1
28367,26087,0,0,144,144,0,1,0,1,0
10889,61248,0,0,142,142,0,1,0,1,0
16293,25773,0,0,143,143,0,1,0,1,0
49280,33912,0,0,142,142,0,1,0,1,0
17722,17349,0,0,74,74,0,1,0,1,0
9760,61248,0,0,142,142,0,1,0,1,0
3554,48311,0,0,144,144,0,1,0,1,0
11610,61248,0,0,141,141,0,1,0,1,0
51850,32387,0,0,80,80,0,1,0,1,0
11461,3389,11461,3389,293,223,70,4,1,3,1
10492,3389,10492,3389,293,223,70,4,0,3,1
39539,7205,0,0,146,146,0,1,0,1,0
39145,60374,0,0,88,88,0,1,0,1,0
49030,29870,0,0,151,151,0,1,0,1,0
46366,3389,46366,3389,293,223,70,4,0,3,1
16119,25773,0,0,145,145,0,1,0,1,0
49139,31173,0,0,146,146,0,1,0,1,0
54635,5618,0,0,145,145,0,1,0,1,0
17209,3389,17209,3389,293,223,70,4,0,3,1
51131,31802,0,0,76,76,0,1,0,1,0
50418,3389,50418,3389,293,223,70,4,0,3,1
19233,3389,19233,3389,293,223,70,4,0,3,1
13743,25773,0,0,143,143,0,1,0,1,0
62380,46885,0,0,104,104,0,1,0,1,0
18317,3389,18317,3389,293,223,70,4,0,3,1
9978,4716,7708,2857,270,211,59,3,0,2,0
6468,24862,0,0,157,157,0,1,0,1,0
20483,30351,0,0,98,98,0,1,0,1,0
49370,33830,0,0,139,139,0,1,0,1,0
50983,19583,0,0,153,153,0,1,0,1,0
47720,43425,0,0,111,111,0,1,0,1,0
13920,3389,13920,3389,293,223,70,4,0,3,1
10473,5505,6856,2541,256,204,52,3,0,2,0
49490,33648,0,0,134,134,0,1,0,1,0
49131,26285,0,0,151,151,0,1,0,1,0
51298,30669,0,0,77,77,0,1,0,1,0
51697,31652,0,0,63,63,0,1,0,1,0
10278,3389,10278,3389,293,223,70,4,1,3,1
9513,3977,8508,3153,282,217,65,3,0,2,0
53867,17704,0,0,106,106,0,1,0,1,0
11713,61248,0,0,141,141,0,1,0,1,0
51844,34021,0,0,80,80,0,1,0,1,0
16304,3389,16304,3389,293,223,70,4,0,3,1
20282,19762,0,0,79,79,0,1,0,1,0
52382,3389,52382,3389,293,223,70,4,0,3,1
28272,27370,0,0,131,131,0,1,0,1,0
49761,33927,0,0,142,142,0,1,0,1,0
28232,2539,0,0,85,85,0,1,0,1,0
17441,47452,0,0,99,99,0,1,0,1,0
16673,25773,0,0,142,142,0,1,0,1,0
52855,5618,0,0,145,145,0,1,0,1,0
4493,23771,0,0,157,157,0,1,0,1,0
49950,28380,0,0,119,119,0,1,0,1,0
10225,3389,10225,3389,293,223,70,4,0,3,1
60320,31652,0,0,62,62,0,1,0,1,0
11111,25773,0,0,144,144,0,1,0,1,0
3566,25773,0,0,142,142,0,1,0,1,0
17970,25773,0,0,143,143,0,1,0,1,0
56912,49073,0,0,107,107,0,1,0,1,0
23320,34021,0,0,62,62,0,1,0,1,0
34939,10953,0,0,146,146,0,1,0,1,0
49029,28676,0,0,151,151,0,1,0,1,0
10564,5649,6699,2483,254,202,51,3,0,2,0
14483,3389,14483,3389,293,223,70,4,0,3,1
3635,23296,0,0,157,157,0,1,0,1,0
12502,3389,12502,3389,293,223,70,4,1,3,1
13184,3389,13184,3389,293,223,70,4,0,3,1
2201,44134,0,0,144,144,0,1,0,1,0
50778,30440,0,0,89,89,0,1,0,1,0
9756,3389,9756,3389,293,223,70,4,1,3,1
11860,60607,0,0,139,139,0,1,0,1,0
13593,24119,0,0,122,122,0,1,0,1,0
19030,61248,0,0,152,152,0,1,0,1,0
5526,24341,0,0,157,157,0,1,0,1,0
17703,3389,17703,3389,293,223,70,4,0,3,1
52406,33511,0,0,62,62,0,1,0,1,0
32830,3389,32830,3389,293,223,70,4,0,3,1
15882,2509,9332,2509,233,181,51,3,0,2,0
12060,8030,4126,1529,213,181,31,2,0,1,0
9296,3389,9296,3389,293,223,70,4,0,3,1
2307,46026,0,0,145,145,0,1,0,1,0
28237,29061,0,0,113,113,0,1,0,1,0
50611,6473,0,0,145,145,0,1,0,1,0
52221,32963,0,0,62,62,0,1,0,1,0
9533,61248,0,0,139,139,0,1,0,1,0
53506,37569,0,0,78,78,0,1,0,1,0
30411,4384,0,0,103,103,0,1,0,1,0
11347,4309,9773,3020,277,214,62,3,0,2,0
13143,20265,0,0,142,142,0,1,0,1,0
51652,31652,0,0,64,64,0,1,0,1,0
35683,3389,35683,3389,293,223,70,4,0,3,1
48346,5618,0,0,145,145,0,1,0,1,0
19568,28653,0,0,114,114,0,1,0,1,0
37269,3389,37269,3389,293,223,70,4,0,3,1
52270,33110,0,0,62,62,0,1,0,1,0
21732,940,3494,939,126,106,19,1,0,1,0
6103,25773,0,0,143,143,0,1,0,1,0
33757,7216,0,0,129,129,0,1,0,1,0
57618,3389,57618,3389,293,223,70,4,0,3,1
50811,30523,0,0,88,88,0,1,0,1,0
9026,25096,0,0,148,148,0,1,0,1,0
54905,7914,0,0,146,146,0,1,0,1,0
28147,33417,0,0,68,68,0,1,0,1,0
48777,36889,0,0,136,136,0,1,0,1,0
49082,31521,0,0,149,149,0,1,0,1,0
21831,20923,0,0,92,92,0,1,0,1,0
26331,34021,0,0,62,62,0,1,0,1,0
8658,61248,0,0,139,139,0,1,0,1,0
7938,25773,0,0,156,156,0,1,0,1,0
50402,28837,0,0,107,107,0,1,0,1,0
51400,31652,0,0,74,74,0,1,0,1,0
9845,3389,9845,3389,293,223,70,4,1,3,1
49769,33469,0,0,126,126,0,1,0,1,0
28150,33271,0,0,69,69,0,1,0,1,0
12625,25773,0,0,139,139,0,1,0,1,0
10516,61248,0,0,142,142,0,1,0,1,0
16908,15976,0,0,92,92,0,1,0,1,0
26351,33093,0,0,70,70,0,1,0,1,0
14173,23387,0,0,114,114,0,1,0,1,0
50768,29960,0,0,108,108,0,1,0,1,0
21380,3389,21380,3389,293,223,70,4,0,3,1
8562,25773,0,0,155,155,0,1,0,1,0
10196,61248,0,0,139,139,0,1,0,1,0
63307,31652,0,0,68,68,0,1,0,1,0
14860,22521,0,0,105,105,0,1,0,1,0
21689,3389,21689,3389,293,223,70,4,0,3,1
33669,34021,0,0,78,78,0,1,0,1,0
52014,16517,0,0,151,151,0,1,0,1,0
11800,3389,11800,3389,293,223,70,4,1,3,1
61378,4093,43776,2317,246,198,47,3,0,2,0
8910,61248,0,0,140,140,0,1,0,1,0
20811,25773,0,0,144,144,0,1,0,1,0
1270,22240,0,0,155,155,0,1,0,1,0
29653,34021,0,0,62,62,0,1,0,1,0
18078,23808,0,0,121,121,0,1,0,1,0
16177,20859,0,0,88,88,0,1,0,1,0
21188,61248,0,0,157,157,0,1,0,1,0
11551,3389,11551,3389,293,223,70,4,1,3,1
4653,22691,0,0,154,154,0,1,0,1,0
8440,25773,0,0,140,140,0,1,0,1,0
55887,5562,1605,84,148,146,1,1,0,1,0
15469,28355,0,0,114,114,0,1,0,1,0
18178,20610,0,0,87,87,0,1,0,1,0
2495,46547,0,0,144,144,0,1,0,1,0
23047,25773,0,0,145,145,0,1,0,1,0
49534,27064,0,0,136,136,0,1,0,1,0
51254,31624,0,0,72,72,0,1,0,1,0
18134,3389,18134,3389,293,223,70,4,0,3,1
21733,28341,0,0,117,117,0,1,0,1,0
11490,3389,11490,3389,293,223,70,4,1,3,1
25322,75,0,0,62,62,0,1,0,1,0
18777,3389,18777,3389,293,223,70,4,0,3,1
6379,25773,0,0,151,151,0,1,0,1,0
18077,23832,0,0,122,122,0,1,0,1,0
59392,58766,0,0,145,145,0,1,0,1,0
36421,8544,0,0,146,146,0,1,0,1,0
34817,8114,0,0,137,137,0,1,0,1,0
17022,3389,17022,3389,293,223,70,4,0,3,1
64016,31720,0,0,64,64,0,1,0,1,0
17925,18653,0,0,66,66,0,1,0,1,0
28686,34021,0,0,62,62,0,1,0,1,0
51313,31652,0,0,76,76,0,1,0,1,0
13132,3389,13132,3389,293,223,70,4,0,3,1
43103,60170,0,0,72,72,0,1,0,1,0
41073,34021,0,0,110,110,0,1,0,1,0
50668,30168,0,0,93,93,0,1,0,1,0
7389,25773,0,0,141,141,0,1,0,1,0
2056,23468,0,0,151,151,0,1,0,1,0
15447,61248,0,0,149,149,0,1,0,1,0
13405,10171,1811,671,176,162,13,1,0,1,0
1069,21925,0,0,156,156,0,1,0,1,0
18488,3389,18488,3389,293,223,70,4,0,3,1
11562,7237,4983,1847,227,188,38,2,0,2,0
40069,5927,0,0,146,146,0,1,0,1,0
13361,3389,13361,3389,293,223,70,4,0,3,1
51699,31652,0,0,63,63,0,1,0,1,0
25323,3389,25323,3389,293,223,70,4,0,3,1
31906,3389,31906,3389,293,223,70,4,0,3,1
14954,3389,14954,3389,293,223,70,4,0,3,1
48751,34996,0,0,136,136,0,1,0,1,0
25799,29308,0,0,111,111,0,1,0,1,0
43887,13743,0,0,150,150,0,1,0,1,0
20664,1226,4560,1226,145,120,25,2,0,1,0
47906,43418,0,0,115,115,0,1,0,1,0
9738,25773,0,0,149,149,0,1,0,1,0
13074,9645,2381,882,185,167,18,1,0,1,0
9948,3389,9948,3389,293,223,70,4,1,3,1
15395,21845,0,0,98,98,0,1,0,1,0
40893,8114,0,0,145,145,0,1,0,1,0
49396,34021,0,0,140,140,0,1,0,1,0
6636,25773,0,0,152,152,0,1,0,1,0
54946,42245,0,0,87,87,0,1,0,1,0
49804,31652,0,0,123,123,0,1,0,1,0
12201,8254,3884,1439,209,179,29,2,0,1,0
51476,31652,0,0,71,71,0,1,0,1,0
10452,5471,6893,2554,257,204,52,3,0,2,0
7250,25773,0,0,141,141,0,1,0,1,0
9673,24616,0,0,142,142,0,1,0,1,0
18314,26324,0,0,137,137,0,1,0,1,0
38311,3389,38311,3389,293,223,70,4,1,3,1
60266,60878,0,0,145,145,0,1,0,1,0
26996,1493,0,0,75,75,0,1,0,1,0
14915,3389,14915,3389,293,223,70,4,0,3,1
52411,24889,0,0,90,90,0,1,0,1,0
1611,22058,0,0,156,156,0,1,0,1,0
51629,31652,0,0,64,64,0,1,0,1,0
18516,3389,18516,3389,293,223,70,4,0,3,1
49522,33613,0,0,133,133,0,1,0,1,0
51758,32543,0,0,68,68,0,1,0,1,0
50822,32516,0,0,92,92,0,1,0,1,0
52448,24671,0,0,91,91,0,1,0,1,0
50225,28477,0,0,113,113,0,1,0,1,0
48171,5618,0,0,145,145,0,1,0,1,0
11384,3389,11384,3389,293,223,70,4,1,3,1
13172,8731,4040,1248,201,175,25,2,0,1,0
19630,28767,0,0,113,113,0,1,0,1,0
47877,3389,47877,3389,293,223,70,4,0,3,1
4955,50192,0,0,143,143,0,1,0,1,0
38463,7078,0,0,146,146,0,1,0,1,0
2607,47392,0,0,144,144,0,1,0,1,0
17339,16703,0,0,82,82,0,1,0,1,0
31339,5170,0,0,110,110,0,1,0,1,0
5793,56656,0,0,140,140,0,1,0,1,0
19108,3389,19108,3389,293,223,70,4,0,3,1
51359,31093,0,0,73,73,0,1,0,1,0
12112,61248,0,0,139,139,0,1,0,1,0
49259,31652,0,0,142,142,0,1,0,1,0
51887,36628,0,0,62,62,0,1,0,1,0
11886,25634,0,0,139,139,0,1,0,1,0
46506,5618,0,0,145,145,0,1,0,1,0
51337,31652,0,0,70,70,0,1,0,1,0
9045,25773,0,0,140,140,0,1,0,1,0
12337,3389,12337,3389,293,223,70,4,1,3,1
51272,31652,0,0,71,71,0,1,0,1,0
41214,5618,0,0,145,145,0,1,0,1,0
8432,61248,0,0,140,140,0,1,0,1,0
2838,43318,0,0,146,146,0,1,0,1,0
39102,6620,0,0,146,146,0,1,0,1,0
49898,33353,0,0,122,122,0,1,0,1,0
13971,3389,13971,3389,293,223,70,4,0,3,1
20151,32149,0,0,79,79,0,1,0,1,0
20775,61248,0,0,156,156,0,1,0,1,0
48993,28678,0,0,153,153,0,1,0,1,0
59791,3389,59791,3389,293,223,70,4,0,3,1
21759,3389,21759,3389,293,223,70,4,0,3,1
51814,33491,0,0,80,80,0,1,0,1,0
50417,32883,0,0,105,105,0,1,0,1,0
50004,28515,0,0,117,117,0,1,0,1,0
52217,32951,0,0,62,62,0,1,0,1,0
62462,46282,0,0,103,103,0,1,0,1,0
27133,34021,0,0,62,62,0,1,0,1,0
11835,60570,0,0,139,139,0,1,0,1,0
3309,28803,0,0,143,143,0,1,0,1,0
29420,31360,0,0,89,89,0,1,0,1,0
13710,21616,0,0,104,104,0,1,0,1,0
26265,34021,0,0,62,62,0,1,0,1,0
2606,38530,0,0,144,144,0,1,0,1,0
14588,3389,14588,3389,293,223,70,4,0,3,1
15187,28127,0,0,117,117,0,1,0,1,0
14893,61248,0,0,149,149,0,1,0,1,0
20667,30691,0,0,94,94,0,1,0,1,0
35700,3389,35700,3389,293,223,70,4,0,3,1
3536,48052,0,0,144,144,0,1,0,1,0
14064,3389,14064,3389,293,223,70,4,0,3,1
20259,61248,0,0,156,156,0,1,0,1,0
51608,31652,0,0,65,65,0,1,0,1,0
50521,34021,0,0,112,112,0,1,0,1,0
50789,60456,0,0,90,90,0,1,0,1,0
23325,3389,23325,3389,293,223,70,4,0,3,1
28198,30927,0,0,94,94,0,1,0,1,0
14824,3389,14824,3389,293,223,70,4,0,3,1
21523,32281,0,0,79,79,0,1,0,1,0
23702,3389,23702,3389,293,223,70,4,0,3,1
37338,3389,37338,3389,293,223,70,4,1,3,1
4673,25773,0,0,146,146,0,1,0,1,0
50647,37618,0,0,145,145,0,1,0,1,0
38319,3389,38319,3389,293,223,70,4,1,3,1
47711,43502,0,0,110,110,0,1,0,1,0
51849,31860,0,0,62,62,0,1,0,1,0
15975,3389,15975,3389,293,223,70,4,0,3,1
13250,56522,0,0,128,128,0,1,0,1,0
37104,3389,37104,3389,293,223,70,4,1,3,1
14878,3389,14878,3389,293,223,70,4,0,3,1
26406,3389,26406,3389,293,223,70,4,0,3,1
52313,33236,0,0,62,62,0,1,0,1,0
50832,32508,0,0,92,92,0,1,0,1,0
16862,3389,16862,3389,293,223,70,4,0,3,1
5042,22780,0,0,153,153,0,1,0,1,0
9759,3389,9759,3389,293,223,70,4,1,3,1
9735,24886,0,0,143,143,0,1,0,1,0
19695,61248,0,0,154,154,0,1,0,1,0
15785,17038,0,0,146,146,0,1,0,1,0
12497,61248,0,0,144,144,0,1,0,1,0
3109,42415,0,0,147,147,0,1,0,1,0
3744,25773,0,0,142,142,0,1,0,1,0
8690,61248,0,0,139,139,0,1,0,1,0
12682,9020,3056,1132,196,173,23,2,0,1,0
51690,31652,0,0,63,63,0,1,0,1,0
59934,60076,0,0,145,145,0,1,0,1,0
27994,26211,0,0,143,143,0,1,0,1,0
9972,61248,0,0,141,141,0,1,0,1,0
29854,33537,0,0,67,67,0,1,0,1,0
51189,33058,0,0,96,96,0,1,0,1,0
16787,9288,0,0,129,129,0,1,0,1,0
51259,33107,0,0,94,94,0,1,0,1,0
49515,27296,0,0,134,134,0,1,0,1,0
25245,31665,0,0,85,85,0,1,0,1,0
43469,12740,0,0,149,149,0,1,0,1,0
25486,34021,0,0,62,62,0,1,0,1,0
11792,61248,0,0,141,141,0,1,0,1,0
49144,31295,0,0,146,146,0,1,0,1,0
52527,34021,0,0,63,63,0,1,0,1,0
48938,26590,0,0,155,155,0,1,0,1,0
51814,31756,0,0,62,62,0,1,0,1,0
21548,3389,21548,3389,293,223,70,4,0,3,1
29268,3389,29268,3389,293,223,70,4,0,3,1
3362,25512,0,0,143,143,0,1,0,1,0
9138,61248,0,0,140,140,0,1,0,1,0
62613,3763,53257,2819,268,209,58,3,0,2,0
9141,25773,0,0,155,155,0,1,0,1,0
38275,3389,38275,3389,293,223,70,4,1,3,1
13745,10120,2239,692,177,163,14,1,0,1,0
9320,3389,9320,3389,293,223,70,4,1,3,1
19399,3389,19399,3389,293,223,70,4,0,3,1
21902,3389,21902,3389,293,223,70,4,0,3,1
37610,3389,37610,3389,293,223,70,4,1,3,1
52314,33239,0,0,62,62,0,1,0,1,0
12003,25773,0,0,143,143,0,1,0,1,0
10970,3389,10970,3389,293,223,70,4,0,3,1
11370,3389,11370,3389,293,223,70,4,1,3,1
49130,33084,0,0,147,147,0,1,0,1,0
21330,1048,3895,1047,133,111,21,1,0,1,0
1134,21771,0,0,156,156,0,1,0,1,0
58092,31652,0,0,96,96,0,1,0,1,0
15144,61248,0,0,148,148,0,1,0,1,0
51429,30938,0,0,73,73,0,1,0,1,0
24917,3389,24917,3389,293,223,70,4,0,3,1
12788,61248,0,0,140,140,0,1,0,1,0
49057,30733,0,0,150,150,0,1,0,1,0
25791,473,0,0,66,66,0,1,0,1,0
12122,61003,0,0,139,139,0,1,0,1,0
7476,61248,0,0,139,139,0,1,0,1,0
11103,61248,0,0,142,142,0,1,0,1,0
51421,31652,0,0,68,68,0,1,0,1,0
49160,32631,0,0,146,146,0,1,0,1,0
50022,28559,0,0,116,116,0,1,0,1,0
29535,34021,0,0,62,62,0,1,0,1,0
50658,31652,0,0,93,93,0,1,0,1,0
5028,18871,0,0,154,154,0,1,0,1,0
15078,3389,15078,3389,293,223,70,4,0,3,1
46827,55740,0,0,62,62,0,1,0,1,0
12562,25773,0,0,150,150,0,1,0,1,0
50085,33183,0,0,116,116,0,1,0,1,0
21901,61248,0,0,158,158,0,1,0,1,0
51265,18744,0,0,152,152,0,1,0,1,0
6435,25773,0,0,143,143,0,1,0,1,0
18820,3389,18820,3389,293,223,70,4,0,3,1
16064,3389,16064,3389,293,223,70,4,0,3,1
9112,57574,0,0,143,143,0,1,0,1,0
35201,14375,0,0,146,146,0,1,0,1,0
23347,34021,0,0,62,62,0,1,0,1,0
51750,32528,0,0,68,68,0,1,0,1,0
49511,27288,0,0,135,135,0,1,0,1,0
9397,25773,0,0,151,151,0,1,0,1,0
17439,19266,0,0,72,72,0,1,0,1,0
34699,34021,0,0,82,82,0,1,0,1,0
17809,17495,0,0,72,72,0,1,0,1,0
19435,3389,19435,3389,293,223,70,4,0,3,1
51414,38416,0,0,62,62,0,1,0,1,0
50310,31652,0,0,109,109,0,1,0,1,0
50707,31652,0,0,91,91,0,1,0,1,0
10727,3389,10727,3389,293,223,70,4,1,3,1
12726,25773,0,0,139,139,0,1,0,1,0
51930,32099,0,0,62,62,0,1,0,1,0
31017,2128,0,0,93,93,0,1,0,1,0
23558,34021,0,0,62,62,0,1,0,1,0
9639,3389,9639,3389,293,223,70,4,0,3,1
15130,3389,15130,3389,293,223,70,4,0,3,1
47736,6959,0,0,145,145,0,1,0,1,0
25444,25773,0,0,146,146,0,1,0,1,0
16080,3389,16080,3389,293,223,70,4,0,3,1
51562,32188,0,0,69,69,0,1,0,1,0
46270,19459,0,0,153,153,0,1,0,1,0
2440,46905,0,0,144,144,0,1,0,1,0
51724,28941,0,0,79,79,0,1,0,1,0
49270,33896,0,0,142,142,0,1,0,1,0
38528,60405,0,0,91,91,0,1,0,1,0
32709,3389,32709,3389,293,223,70,4,0,3,1
11223,3389,11223,3389,293,223,70,4,0,3,1
56627,52079,0,0,145,145,0,1,0,1,0
28794,34021,0,0,62,62,0,1,0,1,0
61292,4116,43118,2282,244,197,47,3,0,2,0
15833,61248,0,0,149,149,0,1,0,1,0
50190,32365,0,0,120,120,0,1,0,1,0
10304,3389,10304,3389,293,223,70,4,0,3,1
19894,31940,0,0,81,81,0,1,0,1,0
28304,25813,0,0,147,147,0,1,0,1,0
2556,46648,0,0,144,144,0,1,0,1,0
51167,31408,0,0,75,75,0,1,0,1,0
53774,3389,53774,3389,293,223,70,4,0,3,1
44420,34021,0,0,125,125,0,1,0,1,0
49069,29584,0,0,149,149,0,1,0,1,0
25285,3389,25285,3389,293,223,70,4,0,3,1
14252,25773,0,0,148,148,0,1,0,1,0
18184,26084,0,0,139,139,0,1,0,1,0
55246,8166,0,0,137,137,0,1,0,1,0
43165,3389,43165,3389,293,223,70,4,0,3,1
19883,61248,0,0,155,155,0,1,0,1,0
24759,3389,24759,3389,293,223,70,4,0,3,1
14883,3389,14883,3389,293,223,70,4,0,3,1
49056,34797,0,0,143,143,0,1,0,1,0
10148,59300,0,0,143,143,0,1,0,1,0
10911,25773,0,0,153,153,0,1,0,1,0
29881,33673,0,0,65,65,0,1,0,1,0
47514,3389,47514,3389,293,223,70,4,0,3,1
13962,3389,13962,3389,293,223,70,4,0,3,1
60601,31652,0,0,62,62,0,1,0,1,0
50346,31652,0,0,104,104,0,1,0,1,0
28237,29053,0,0,113,113,0,1,0,1,0
19313,28179,0,0,119,119,0,1,0,1,0
4167,51929,0,0,142,142,0,1,0,1,0
7714,24182,0,0,146,146,0,1,0,1,0
56611,3389,56611,3389,293,223,70,4,0,3,1
11971,3389,11971,3389,293,223,70,4,1,3,1
40417,5676,0,0,146,146,0,1,0,1,0
14035,14558,0,0,146,146,0,1,0,1,0
61385,31652,0,0,64,64,0,1,0,1,0
19499,3389,19499,3389,293,223,70,4,0,3,1
7589,25773,0,0,141,141,0,1,0,1,0
33966,7394,0,0,131,131,0,1,0,1,0
4460,23752,0,0,157,157,0,1,0,1,0
19951,3389,19951,3389,293,223,70,4,0,3,1
16469,3389,16469,3389,293,223,70,4,0,3,1
31085,4955,0,0,108,108,0,1,0,1,0
51344,31652,0,0,70,70,0,1,0,1,0
38711,3389,38711,3389,293,223,70,4,0,3,1
16370,20615,0,0,86,86,0,1,0,1,0
36457,8518,0,0,146,146,0,1,0,1,0
14628,3389,14628,3389,293,223,70,4,0,3,1
23168,3389,23168,3389,293,223,70,4,0,3,1
43150,5618,0,0,145,145,0,1,0,1,0
15933,3389,15933,3389,293,223,70,4,0,3,1
12034,61248,0,0,140,140,0,1,0,1,0
42879,3389,42879,3389,293,223,70,4,0,3,1
16187,25773,0,0,141,141,0,1,0,1,0
13898,15437,0,0,145,145,0,1,0,1,0
20050,3389,20050,3389,293,223,70,4,0,3,1
32696,34021,0,0,74,74,0,1,0,1,0
6182,25773,0,0,151,151,0,1,0,1,0
12444,25773,0,0,139,139,0,1,0,1,0
2134,22240,0,0,155,155,0,1,0,1,0
51327,6352,0,0,145,145,0,1,0,1,0
38438,3389,38438,3389,293,223,70,4,1,3,1
9742,3389,9742,3389,293,223,70,4,1,3,1
40637,3389,40637,3389,293,223,70,4,0,3,1
61349,32272,0,0,62,62,0,1,0,1,0
10860,3389,10860,3389,293,223,70,4,1,3,1
3638,48452,0,0,144,144,0,1,0,1,0
52111,33179,0,0,65,65,0,1,0,1,0
12237,3389,12237,3389,293,223,70,4,1,3,1
6198,25773,0,0,151,151,0,1,0,1,0
7651,61248,0,0,139,139,0,1,0,1,0
29915,34021,0,0,62,62,0,1,0,1,0
26954,61000,0,0,139,139,0,1,0,1,0
14920,3389,14920,3389,293,223,70,4,0,3,1
25980,61050,0,0,143,143,0,1,0,1,0
15331,3389,15331,3389,293,223,70,4,0,3,1
54330,60747,0,0,110,110,0,1,0,1,0
3601,48150,0,0,144,144,0,1,0,1,0
51297,60498,0,0,93,93,0,1,0,1,0
25507,34021,0,0,62,62,0,1,0,1,0
11193,6651,5617,2081,237,194,43,2,0,2,0
25893,25773,0,0,146,146,0,1,0,1,0
18410,3389,18410,3389,293,223,70,4,0,3,1
18235,3389,18235,3389,293,223,70,4,0,3,1
17438,23510,0,0,143,143,0,1,0,1,0
28275,27183,0,0,133,133,0,1,0,1,0
6347,52292,0,0,142,142,0,1,0,1,0
21072,3389,21072,3389,293,223,70,4,0,3,1
31735,60754,0,0,119,119,0,1,0,1,0
19033,3389,19033,3389,293,223,70,4,0,3,1
28488,33009,0,0,71,71,0,1,0,1,0
7427,61248,0,0,139,139,0,1,0,1,0
54711,5618,0,0,145,145,0,1,0,1,0
8130,54981,0,0,141,141,0,1,0,1,0
15476,61248,0,0,145,145,0,1,0,1,0
54792,5618,0,0,145,145,0,1,0,1,0
10762,3389,10762,3389,293,223,70,4,1,3,1
50178,32357,0,0,120,120,0,1,0,1,0
11936,61248,0,0,140,140,0,1,0,1,0
51968,31652,0,0,130,130,0,1,0,1,0
3936,48949,0,0,144,144,0,1,0,1,0
58303,61074,0,0,133,133,0,1,0,1,0
10124,3389,10124,3389,293,223,70,4,1,3,1
28209,30420,0,0,99,99,0,1,0,1,0
19508,3389,19508,3389,293,223,70,4,0,3,1
47733,5618,0,0,145,145,0,1,0,1,0
12252,3389,12252,3389,293,223,70,4,0,3,1
20128,3389,20128,3389,293,223,70,4,0,3,1
18137,21906,0,0,101,101,0,1,0,1,0
48934,26780,0,0,155,155,0,1,0,1,0
38007,7406,0,0,146,146,0,1,0,1,0
17790,3389,17790,3389,293,223,70,4,0,3,1
16281,14919,0,0,106,106,0,1,0,1,0
14445,11825,23,8,148,148,0,1,0,1,0
50118,31652,0,0,112,112,0,1,0,1,0
15821,3389,15821,3389,293,223,70,4,0,3,1
29110,34021,0,0,62,62,0,1,0,1,0
63565,3389,63565,3389,293,223,70,4,0,3,1
14904,3389,14904,3389,293,223,70,4,0,3,1
37074,3389,37074,3389,293,223,70,4,0,3,1
30940,19887,0,0,147,147,0,1,0,1,0
6359,58304,0,0,140,140,0,1,0,1,0
13356,10093,1896,702,178,163,14,1,0,1,0
49159,31648,0,0,146,146,0,1,0,1,0
50290,32749,0,0,106,106,0,1,0,1,0
49148,31378,0,0,146,146,0,1,0,1,0
49787,33453,0,0,125,125,0,1,0,1,0
14447,61248,0,0,143,143,0,1,0,1,0
45867,58703,0,0,66,66,0,1,0,1,0
11730,61248,0,0,141,141,0,1,0,1,0
10117,61248,0,0,141,141,0,1,0,1,0
7525,25773,0,0,155,155,0,1,0,1,0
10528,61248,0,0,139,139,0,1,0,1,0
14316,61248,0,0,148,148,0,1,0,1,0
52131,60567,0,0,98,98,0,1,0,1,0
13523,9581,2938,908,186,168,18,1,0,1,0
49550,27226,0,0,140,140,0,1,0,1,0
23902,34021,0,0,62,62,0,1,0,1,0
51815,31759,0,0,62,62,0,1,0,1,0
9940,25773,0,0,143,143,0,1,0,1,0
12117,61248,0,0,139,139,0,1,0,1,0
52282,3389,52282,3389,293,223,70,4,0,3,1
14536,3389,14536,3389,293,223,70,4,0,3,1
15811,3389,15811,3389,293,223,70,4,0,3,1
38040,3389,38040,3389,293,223,70,4,1,3,1
16505,61248,0,0,147,147,0,1,0,1,0
10604,25773,0,0,146,146,0,1,0,1,0
59065,4712,26010,1377,205,176,28,2,0,1,0
2191,22499,0,0,157,157,0,1,0,1,0
51835,32354,0,0,81,81,0,1,0,1,0
49648,27445,0,0,137,137,0,1,0,1,0
54815,3389,54815,3389,293,223,70,4,0,3,1
14746,3389,14746,3389,293,223,70,4,0,3,1
29198,1459,0,0,83,83,0,1,0,1,0
49160,32863,0,0,146,146,0,1,0,1,0
15254,13188,0,0,129,129,0,1,0,1,0
6851,53806,0,0,143,143,0,1,0,1,0
25511,25773,0,0,146,146,0,1,0,1,0
54764,31652,0,0,115,115,0,1,0,1,0
20482,30039,0,0,99,99,0,1,0,1,0
4310,47565,0,0,146,146,0,1,0,1,0
50689,31652,0,0,92,92,0,1,0,1,0
39954,8273,0,0,145,145,0,1,0,1,0
49331,31652,0,0,139,139,0,1,0,1,0
12090,8077,4075,1510,212,181,31,2,0,1,0
17615,17169,0,0,76,76,0,1,0,1,0
9920,25773,0,0,149,149,0,1,0,1,0
13807,27008,0,0,127,127,0,1,0,1,0
24840,34021,0,0,62,62,0,1,0,1,0
11594,61248,0,0,141,141,0,1,0,1,0
8395,61248,0,0,140,140,0,1,0,1,0
49160,32273,0,0,146,146,0,1,0,1,0
28765,3389,28765,3389,293,223,70,4,0,3,1
18464,25773,0,0,143,143,0,1,0,1,0
51783,60538,0,0,96,96,0,1,0,1,0
50406,29148,0,0,118,118,0,1,0,1,0
49282,33883,0,0,141,141,0,1,0,1,0
35354,3724,0,0,117,117,0,1,0,1,0
52508,33895,0,0,62,62,0,1,0,1,0
52011,32340,0,0,62,62,0,1,0,1,0
16149,61248,0,0,146,146,0,1,0,1,0
12327,3389,12327,3389,293,223,70,4,1,3,1
12572,3389,12572,3389,293,223,70,4,1,3,1
20667,25773,0,0,144,144,0,1,0,1,0
4606,23833,0,0,157,157,0,1,0,1,0
14484,11947,0,0,147,147,0,1,0,1,0
7923,61248,0,0,139,139,0,1,0,1,0
8320,25773,0,0,140,140,0,1,0,1,0
60597,59937,0,0,141,141,0,1,0,1,0
12674,61248,0,0,145,145,0,1,0,1,0
19112,3389,19112,3389,293,223,70,4,0,3,1
18631,1772,6589,1771,182,146,36,2,0,2,0
14088,11258,636,236,158,153,4,1,0,1,0
21881,61248,0,0,158,158,0,1,0,1,0
50283,6528,0,0,145,145,0,1,0,1,0
9624,4153,8317,3082,279,216,63,3,0,2,0
29560,32063,0,0,82,82,0,1,0,1,0
12266,8358,3772,1398,207,178,28,2,0,1,0
28220,34021,0,0,62,62,0,1,0,1,0
10264,5172,7216,2674,262,207,55,3,0,2,0
60595,3389,60595,3389,293,223,70,4,0,3,1
26704,31777,0,0,84,84,0,1,0,1,0
50534,32777,0,0,101,101,0,1,0,1,0
20796,3389,20796,3389,293,223,70,4,0,3,1
15481,13570,0,0,124,124,0,1,0,1,0
5331,25773,0,0,148,148,0,1,0,1,0
51718,31652,0,0,63,63,0,1,0,1,0
3248,47802,0,0,144,144,0,1,0,1,0
13506,25773,0,0,139,139,0,1,0,1,0
10269,3389,10269,3389,293,223,70,4,1,3,1
13903,25773,0,0,140,140,0,1,0,1,0
47815,34021,0,0,140,140,0,1,0,1,0
51450,31652,0,0,68,68,0,1,0,1,0
55040,42570,0,0,88,88,0,1,0,1,0
51371,32020,0,0,75,75,0,1,0,1,0
9632,61248,0,0,139,139,0,1,0,1,0
48696,37496,0,0,134,134,0,1,0,1,0
19183,42790,0,0,86,86,0,1,0,1,0
7122,25773,0,0,141,141,0,1,0,1,0
14717,3389,14717,3389,293,223,70,4,0,3,1
53394,20866,0,0,96,96,0,1,0,1,0
33529,17138,0,0,147,147,0,1,0,1,0
18939,3389,18939,3389,293,223,70,4,0,3,1
18589,3389,18589,3389,293,223,70,4,0,3,1
50889,32850,0,0,103,103,0,1,0,1,0
26047,3389,26047,3389,293,223,70,4,0,3,1
18165,21015,0,0,91,91,0,1,0,1,0
27510,33696,0,0,65,65,0,1,0,1,0
10438,3389,10438,3389,293,223,70,4,1,3,1
19561,3389,19561,3389,293,223,70,4,0,3,1
52358,31652,0,0,62,62,0,1,0,1,0
13790,16126,0,0,145,145,0,1,0,1,0
17749,3389,17749,3389,293,223,70,4,0,3,1
13364,21873,0,0,107,107,0,1,0,1,0
12862,22246,0,0,112,112,0,1,0,1,0
3899,39791,0,0,148,148,0,1,0,1,0
15790,3389,15790,3389,293,223,70,4,0,3,1
8634,61248,0,0,139,139,0,1,0,1,0
9058,25773,0,0,152,152,0,1,0,1,0
49225,33946,0,0,143,143,0,1,0,1,0
8620,56754,0,0,143,143,0,1,0,1,0
18742,40729,0,0,80,80,0,1,0,1,0
50086,33182,0,0,116,116,0,1,0,1,0
51587,31652,0,0,65,65,0,1,0,1,0
19352,3389,19352,3389,293,223,70,4,0,3,1
53493,20205,0,0,98,98,0,1,0,1,0
51531,60517,0,0,94,94,0,1,0,1,0
49160,32256,0,0,146,146,0,1,0,1,0
51793,32605,0,0,67,67,0,1,0,1,0
14226,25773,0,0,148,148,0,1,0,1,0
52013,33002,0,0,66,66,0,1,0,1,0
47657,3389,47657,3389,293,223,70,4,0,3,1
46544,3389,46544,3389,293,223,70,4,0,3,1
49160,32048,0,0,146,146,0,1,0,1,0
59976,3389,59976,3389,293,223,70,4,0,3,1
50272,32768,0,0,106,106,0,1,0,1,0
13242,19632,0,0,142,142,0,1,0,1,0
12071,61248,0,0,139,139,0,1,0,1,0
21158,31603,0,0,85,85,0,1,0,1,0
18402,3389,18402,3389,293,223,70,4,0,3,1
12257,61206,0,0,139,139,0,1,0,1,0
15157,3389,15157,3389,293,223,70,4,0,3,1
4880,25773,0,0,142,142,0,1,0,1,0
51827,60542,0,0,96,96,0,1,0,1,0
14718,20867,0,0,95,95,0,1,0,1,0
51585,31794,0,0,87,87,0,1,0,1,0
12051,3389,12051,3389,293,223,70,4,1,3,1
28149,33316,0,0,69,69,0,1,0,1,0
25965,3389,25965,3389,293,223,70,4,0,3,1
5901,25773,0,0,141,141,0,1,0,1,0
14193,3389,14193,3389,293,223,70,4,0,3,1
13186,24633,0,0,127,127,0,1,0,1,0
9053,25773,0,0,152,152,0,1,0,1,0
52692,25550,0,0,81,81,0,1,0,1,0
18058,24448,0,0,128,128,0,1,0,1,0
11348,61248,0,0,142,142,0,1,0,1,0
31170,3389,31170,3389,293,223,70,4,0,3,1
48205,6879,0,0,145,145,0,1,0,1,0
41918,9020,0,0,147,147,0,1,0,1,0
18726,3389,18726,3389,293,223,70,4,0,3,1
2362,46681,0,0,144,144,0,1,0,1,0
13389,18695,0,0,143,143,0,1,0,1,0
47188,47779,0,0,98,98,0,1,0,1,0
49268,26682,0,0,143,143,0,1,0,1,0
17164,3389,17164,3389,293,223,70,4,0,3,1
12390,25773,0,0,143,143,0,1,0,1,0
63532,31652,0,0,62,62,0,1,0,1,0
4487,25773,0,0,143,143,0,1,0,1,0
28566,27084,0,0,134,134,0,1,0,1,0
49608,33615,0,0,131,131,0,1,0,1,0
50838,32131,0,0,86,86,0,1,0,1,0
26111,25773,0,0,146,146,0,1,0,1,0
55996,33339,0,0,62,62,0,1,0,1,0
2021,23414,0,0,151,151,0,1,0,1,0
18265,3389,18265,3389,293,223,70,4,0,3,1
58290,4919,20059,1062,191,169,21,1,0,1,0
48914,26136,0,0,156,156,0,1,0,1,0
2649,24397,0,0,147,147,0,1,0,1,0
51303,31720,0,0,71,71,0,1,0,1,0
51781,3389,51781,3389,293,223,70,4,0,3,1
13621,25773,0,0,139,139,0,1,0,1,0
43330,34021,0,0,120,120,0,1,0,1,0
10474,3389,10474,3389,293,223,70,4,1,3,1
2060,22426,0,0,157,157,0,1,0,1,0
59254,4661,27467,1454,208,178,30,2,0,1,0
15851,25773,0,0,141,141,0,1,0,1,0
8569,56670,0,0,143,143,0,1,0,1,0
19782,61248,0,0,155,155,0,1,0,1,0
9399,58051,0,0,143,143,0,1,0,1,0
57802,61033,0,0,130,130,0,1,0,1,0
6268,25773,0,0,141,141,0,1,0,1,0
49642,33584,0,0,130,130,0,1,0,1,0
54459,5823,0,0,145,145,0,1,0,1,0
61011,3389,61011,3389,293,223,70,4,0,3,1
31878,19867,0,0,147,147,0,1,0,1,0
13568,3389,13568,3389,293,223,70,4,0,3,1
48913,26017,0,0,156,156,0,1,0,1,0
49068,29548,0,0,149,149,0,1,0,1,0
30021,3389,30021,3389,293,223,70,4,1,3,1
12338,3389,12338,3389,293,223,70,4,1,3,1
19712,28920,0,0,112,112,0,1,0,1,0
46092,58517,0,0,62,62,0,1,0,1,0
28228,29467,0,0,109,109,0,1,0,1,0
21560,61248,0,0,158,158,0,1,0,1,0
25155,61092,0,0,146,146,0,1,0,1,0
28437,32974,0,0,72,72,0,1,0,1,0
52250,33794,0,0,70,70,0,1,0,1,0
24658,3389,24658,3389,293,223,70,4,0,3,1
13369,18822,0,0,143,143,0,1,0,1,0
51680,31652,0,0,63,63,0,1,0,1,0
23076,579,2153,578,101,89,11,1,0,1,0
12387,8551,3563,1320,204,177,27,2,0,1,0
32720,2755,0,0,103,103,0,1,0,1,0
10778,3389,10778,3389,293,223,70,4,1,3,1
15959,3389,15959,3389,293,223,70,4,0,3,1
52423,33741,0,0,63,63,0,1,0,1,0
49035,30026,0,0,151,151,0,1,0,1,0
28921,3122,0,0,91,91,0,1,0,1,0
18251,3389,18251,3389,293,223,70,4,0,3,1
18675,7212,0,0,114,114,0,1,0,1,0
49160,33103,0,0,146,146,0,1,0,1,0
49160,32849,0,0,146,146,0,1,0,1,0
22248,34539,0,0,63,63,0,1,0,1,0
49360,33795,0,0,138,138,0,1,0,1,0
38399,3389,38399,3389,293,223,70,4,0,3,1
31073,3389,31073,3389,293,223,70,4,0,3,1
2198,22502,0,0,157,157,0,1,0,1,0
44639,5618,0,0,145,145,0,1,0,1,0
16790,25773,0,0,142,142,0,1,0,1,0
27806,3389,27806,3389,293,223,70,4,0,3,1
1044,21861,0,0,156,156,0,1,0,1,0
27229,32140,0,0,80,80,0,1,0,1,0
20901,31126,0,0,90,90,0,1,0,1,0
51139,30345,0,0,83,83,0,1,0,1,0
10042,3389,10042,3389,293,223,70,4,1,3,1
51884,16903,0,0,151,151,0,1,0,1,0
10347,61248,0,0,139,139,0,1,0,1,0
10220,3389,10220,3389,293,223,70,4,1,3,1
50685,30209,0,0,92,92,0,1,0,1,0
29318,30853,0,0,95,95,0,1,0,1,0
47044,49883,0,0,94,94,0,1,0,1,0
17461,23598,0,0,143,143,0,1,0,1,0
16578,3389,16578,3389,293,223,70,4,0,3,1
6933,25773,0,0,141,141,0,1,0,1,0
23620,34021,0,0,62,62,0,1,0,1,0
18351,3389,18351,3389,293,223,70,4,0,3,1
33981,3389,33981,3389,293,223,70,4,0,3,1
51209,34021,0,0,95,95,0,1,0,1,0
48730,37243,0,0,135,135,0,1,0,1,0
51136,34021,0,0,97,97,0,1,0,1,0
40754,60291,0,0,82,82,0,1,0,1,0
50380,31652,0,0,106,106,0,1,0,1,0
5304,18666,0,0,154,154,0,1,0,1,0
53188,33899,0,0,62,62,0,1,0,1,0
19109,3389,19109,3389,293,223,70,4,0,3,1
19127,18898,0,0,69,69,0,1,0,1,0
51231,31569,0,0,73,73,0,1,0,1,0
25251,30082,0,0,103,103,0,1,0,1,0
7985,61248,0,0,139,139,0,1,0,1,0
14354,23159,0,0,112,112,0,1,0,1,0
49160,32152,0,0,146,146,0,1,0,1,0
23634,32365,0,0,79,79,0,1,0,1,0
15185,22110,0,0,101,101,0,1,0,1,0
18956,3389,18956,3389,293,223,70,4,0,3,1
16024,17976,0,0,145,145,0,1,0,1,0
43421,12625,0,0,149,149,0,1,0,1,0
16349,19655,0,0,79,79,0,1,0,1,0
18976,3389,18976,3389,293,223,70,4,0,3,1
5705,56402,0,0,140,140,0,1,0,1,0
23950,22510,0,0,110,110,0,1,0,1,0
51712,32459,0,0,68,68,0,1,0,1,0
18079,3389,18079,3389,293,223,70,4,0,3,1
15185,53487,0,0,117,117,0,1,0,1,0
37511,3389,37511,3389,293,223,70,4,1,3,1
23133,564,2095,563,100,88,11,1,0,1,0
11537,3389,11537,3389,293,223,70,4,1,3,1
14243,2949,10967,2948,263,202,60,3,0,2,0
60328,31652,0,0,84,84,0,1,0,1,0
46192,56271,0,0,74,74,0,1,0,1,0
9297,15691,0,0,151,151,0,1,0,1,0
29765,33089,0,0,71,71,0,1,0,1,0
62474,31652,0,0,62,62,0,1,0,1,0
2310,23867,0,0,149,149,0,1,0,1,0
14203,25773,0,0,143,143,0,1,0,1,0
17911,46192,0,0,96,96,0,1,0,1,0
14850,54383,0,0,119,119,0,1,0,1,0
22636,25773,0,0,145,145,0,1,0,1,0
37767,60444,0,0,94,94,0,1,0,1,0
15067,14228,0,0,147,147,0,1,0,1,0
10505,22204,0,0,104,104,0,1,0,1,0
28152,33148,0,0,71,71,0,1,0,1,0
16180,25773,0,0,143,143,0,1,0,1,0
9329,57936,0,0,143,143,0,1,0,1,0
12812,3389,12812,3389,293,223,70,4,0,3,1
14886,20742,0,0,93,93,0,1,0,1,0
8067,61248,0,0,139,139,0,1,0,1,0
26704,25773,0,0,147,147,0,1,0,1,0
25086,30315,0,0,100,100,0,1,0,1,0
18127,22228,0,0,104,104,0,1,0,1,0
25339,3389,25339,3389,293,223,70,4,0,3,1
14265,23271,0,0,113,113,0,1,0,1,0
50179,33099,0,0,113,113,0,1,0,1,0
4557,53062,0,0,142,142,0,1,0,1,0
24295,34021,0,0,62,62,0,1,0,1,0
20288,29989,0,0,101,101,0,1,0,1,0
51412,30902,0,0,74,74,0,1,0,1,0
16061,18121,0,0,145,145,0,1,0,1,0
22407,25773,0,0,145,145,0,1,0,1,0
21978,21033,0,0,93,93,0,1,0,1,0
26736,24598,0,0,134,134,0,1,0,1,0
24219,31538,0,0,87,87,0,1,0,1,0
44060,3389,44060,3389,293,223,70,4,0,3,1
47878,3389,47878,3389,293,223,70,4,0,3,1
9985,25773,0,0,148,148,0,1,0,1,0
3613,48167,0,0,144,144,0,1,0,1,0
12828,3389,12828,3389,293,223,70,4,0,3,1
9173,25773,0,0,143,143,0,1,0,1,0
45219,3389,45219,3389,293,223,70,4,0,3,1
10234,61248,0,0,139,139,0,1,0,1,0
23333,2091,0,0,77,77,0,1,0,1,0
44841,60081,0,0,65,65,0,1,0,1,0
25879,34021,0,0,62,62,0,1,0,1,0
50879,31652,0,0,90,90,0,1,0,1,0
55685,60859,0,0,118,118,0,1,0,1,0
18040,3389,18040,3389,293,223,70,4,0,3,1
51196,31728,0,0,74,74,0,1,0,1,0
49127,32965,0,0,147,147,0,1,0,1,0
35464,60563,0,0,104,104,0,1,0,1,0
49410,31652,0,0,144,144,0,1,0,1,0
13701,3389,13701,3389,293,223,70,4,0,3,1
51362,33178,0,0,91,91,0,1,0,1,0
50229,32816,0,0,108,108,0,1,0,1,0
47717,6962,0,0,145,145,0,1,0,1,0
13272,3389,13272,3389,293,223,70,4,0,3,1
9949,3389,9949,3389,293,223,70,4,1,3,1
21839,61248,0,0,158,158,0,1,0,1,0
11194,3389,11194,3389,293,223,70,4,1,3,1
13629,3389,13629,3389,293,223,70,4,0,3,1
13846,20495,0,0,86,86,0,1,0,1,0
16090,25773,0,0,143,143,0,1,0,1,0
18665,58587,0,0,156,156,0,1,0,1,0
52186,60571,0,0,98,98,0,1,0,1,0
54589,41007,0,0,83,83,0,1,0,1,0
28316,34021,0,0,62,62,0,1,0,1,0
21475,32191,0,0,79,79,0,1,0,1,0
2306,22562,0,0,157,157,0,1,0,1,0
12027,3389,12027,3389,293,223,70,4,0,3,1
5285,23337,0,0,150,150,0,1,0,1,0
53860,31652,0,0,62,62,0,1,0,1,0
50867,32476,0,0,91,91,0,1,0,1,0
50871,29796,0,0,91,91,0,1,0,1,0
39172,3389,39172,3389,293,223,70,4,0,3,1
17644,3389,17644,3389,293,223,70,4,0,3,1
12886,3389,12886,3389,293,223,70,4,0,3,1
11792,61248,0,0,141,141,0,1,0,1,0
51789,5618,0,0,145,145,0,1,0,1,0
61159,32310,0,0,62,62,0,1,0,1,0
17455,3389,17455,3389,293,223,70,4,0,3,1
50580,29202,0,0,101,101,0,1,0,1,0
41748,7970,0,0,145,145,0,1,0,1,0
15863,3389,15863,3389,293,223,70,4,0,3,1
52008,34021,0,0,76,76,0,1,0,1,0
36005,8842,0,0,146,146,0,1,0,1,0
19367,26706,0,0,133,133,0,1,0,1,0
20578,3389,20578,3389,293,223,70,4,0,3,1
21234,950,3074,950,126,107,19,1,0,1,0
33189,3389,33189,3389,293,223,70,4,0,3,1
13806,3389,13806,3389,293,223,70,4,0,3,1
11508,4701,9265,2863,270,211,59,3,0,2,0
2609,24334,0,0,148,148,0,1,0,1,0
21770,3389,21770,3389,293,223,70,4,0,3,1
10778,23794,0,0,132,132,0,1,0,1,0
7456,54815,0,0,143,143,0,1,0,1,0
51567,31652,0,0,66,66,0,1,0,1,0
10879,23719,0,0,131,131,0,1,0,1,0
46676,3389,46676,3389,293,223,70,4,0,3,1
21306,61248,0,0,157,157,0,1,0,1,0
11117,61248,0,0,144,144,0,1,0,1,0
26986,1484,0,0,75,75,0,1,0,1,0
1591,22167,0,0,157,157,0,1,0,1,0
10765,3389,10765,3389,293,223,70,4,0,3,1
58842,4771,24303,1286,201,174,26,2,0,1,0
9431,3389,9431,3389,293,223,70,4,0,3,1
49122,30790,0,0,147,147,0,1,0,1,0
46269,57847,0,0,62,62,0,1,0,1,0
49424,34021,0,0,139,139,0,1,0,1,0
10510,25773,0,0,146,146,0,1,0,1,0
21276,28025,0,0,120,120,0,1,0,1,0
50246,32405,0,0,119,119,0,1,0,1,0
57331,5175,12695,672,174,160,13,1,0,1,0
60403,4354,36290,1921,228,189,39,2,0,2,0
56541,3389,56541,3389,293,223,70,4,0,3,1
38576,6997,0,0,146,146,0,1,0,1,0
51795,31700,0,0,62,62,0,1,0,1,0
34538,11849,0,0,146,146,0,1,0,1,0
49089,32225,0,0,144,144,0,1,0,1,0
34444,15625,0,0,146,146,0,1,0,1,0
55922,3389,55922,3389,293,223,70,4,0,3,1
14406,25773,0,0,140,140,0,1,0,1,0
20492,3389,20492,3389,293,223,70,4,0,3,1
23847,3389,23847,3389,293,223,70,4,0,3,1
35095,3389,35095,3389,293,223,70,4,0,3,1
4289,38494,0,0,149,149,0,1,0,1,0
12601,3389,12601,3389,293,223,70,4,1,3,1
13039,25773,0,0,150,150,0,1,0,1,0
11070,3389,11070,3389,293,223,70,4,0,3,1
10957,3389,10957,3389,293,223,70,4,0,3,1
51374,33186,0,0,91,91,0,1,0,1,0
28244,28701,0,0,117,117,0,1,0,1,0
49314,31652,0,0,141,141,0,1,0,1,0
19066,3389,19066,3389,293,223,70,4,0,3,1
59570,3389,59570,3389,293,223,70,4,0,3,1
11233,3389,11233,3389,293,223,70,4,1,3,1
51342,31652,0,0,70,70,0,1,0,1,0
49160,31898,0,0,146,146,0,1,0,1,0
9307,25773,0,0,151,151,0,1,0,1,0
2525,44359,0,0,145,145,0,1,0,1,0
13867,15635,0,0,145,145,0,1,0,1,0
50891,31652,0,0,90,90,0,1,0,1,0
19437,28408,0,0,117,117,0,1,0,1,0
22264,21247,0,0,96,96,0,1,0,1,0
11257,3389,11257,3389,293,223,70,4,1,3,1
11792,61248,0,0,141,141,0,1,0,1,0
37598,3389,37598,3389,293,223,70,4,1,3,1
49686,34021,0,0,133,133,0,1,0,1,0
51153,31777,0,0,75,75,0,1,0,1,0
50846,30609,0,0,87,87,0,1,0,1,0
51936,34021,0,0,77,77,0,1,0,1,0
23232,34021,0,0,62,62,0,1,0,1,0
7932,25671,0,0,157,157,0,1,0,1,0
16772,25773,0,0,142,142,0,1,0,1,0
18065,61248,0,0,150,150,0,1,0,1,0
12167,25773,0,0,139,139,0,1,0,1,0
4296,49548,0,0,144,144,0,1,0,1,0
24506,3389,24506,3389,293,223,70,4,0,3,1
62332,47235,0,0,105,105,0,1,0,1,0
24356,25773,0,0,146,146,0,1,0,1,0
50616,29276,0,0,100,100,0,1,0,1,0
21506,3389,21506,3389,293,223,70,4,0,3,1
27957,26263,0,0,142,142,0,1,0,1,0
17760,25773,0,0,142,142,0,1,0,1,0
12323,25515,0,0,139,139,0,1,0,1,0
10898,25291,0,0,141,141,0,1,0,1,0
34533,3389,34533,3389,293,223,70,4,1,3,1
36557,3389,36557,3389,293,223,70,4,0,3,1
5121,25773,0,0,147,147,0,1,0,1,0
23033,21823,0,0,102,102,0,1,0,1,0
48972,35423,0,0,141,141,0,1,0,1,0
49034,28771,0,0,151,151,0,1,0,1,0
49122,32822,0,0,147,147,0,1,0,1,0
50347,31652,0,0,104,104,0,1,0,1,0
59528,4588,29569,1565,213,181,32,2,0,1,0
64448,31746,0,0,62,62,0,1,0,1,0
4654,37282,0,0,150,150,0,1,0,1,0
49174,26328,0,0,148,148,0,1,0,1,0
36679,3389,36679,3389,293,223,70,4,0,3,1
51352,32037,0,0,75,75,0,1,0,1,0
37401,3389,37401,3389,293,223,70,4,0,3,1
49059,29357,0,0,150,150,0,1,0,1,0
49708,33403,0,0,126,126,0,1,0,1,0
33937,34021,0,0,79,79,0,1,0,1,0
16378,3389,16378,3389,293,223,70,4,0,3,1
49410,31825,0,0,139,139,0,1,0,1,0
11927,3389,11927,3389,293,223,70,4,1,3,1
19972,3389,19972,3389,293,223,70,4,0,3,1
50436,32536,0,0,114,114,0,1,0,1,0
30526,4481,0,0,103,103,0,1,0,1,0
24701,3389,24701,3389,293,223,70,4,0,3,1
18795,58687,0,0,156,156,0,1,0,1,0
25771,198,0,0,64,64,0,1,0,1,0
51655,31652,0,0,64,64,0,1,0,1,0
46664,52732,0,0,85,85,0,1,0,1,0
57023,3389,57023,3389,293,223,70,4,0,3,1
47768,23051,0,0,155,155,0,1,0,1,0
4440,52722,0,0,142,142,0,1,0,1,0
50051,31652,0,0,117,117,0,1,0,1,0
52325,41674,0,0,145,145,0,1,0,1,0
58244,61069,0,0,132,132,0,1,0,1,0
18005,18552,0,0,65,65,0,1,0,1,0
45789,59289,0,0,64,64,0,1,0,1,0
22078,25773,0,0,144,144,0,1,0,1,0
12382,8543,3572,1323,204,177,27,2,0,1,0
7469,25773,0,0,155,155,0,1,0,1,0
37118,8044,0,0,146,146,0,1,0,1,0
19992,3389,19992,3389,293,223,70,4,0,3,1
40118,60324,0,0,84,84,0,1,0,1,0
28245,28680,0,0,117,117,0,1,0,1,0
52211,33548,0,0,129,129,0,1,0,1,0
11595,25773,0,0,141,141,0,1,0,1,0
28385,26177,0,0,143,143,0,1,0,1,0
49160,32803,0,0,146,146,0,1,0,1,0
50564,29169,0,0,102,102,0,1,0,1,0
49770,27932,0,0,125,125,0,1,0,1,0
4318,25773,0,0,142,142,0,1,0,1,0
49671,27496,0,0,137,137,0,1,0,1,0
51356,30787,0,0,75,75,0,1,0,1,0
51555,33312,0,0,87,87,0,1,0,1,0
11755,61248,0,0,141,141,0,1,0,1,0
20844,3389,20844,3389,293,223,70,4,0,3,1
21909,25773,0,0,144,144,0,1,0,1,0
52422,33560,0,0,62,62,0,1,0,1,0
14896,22475,0,0,105,105,0,1,0,1,0
15713,3389,15713,3389,293,223,70,4,0,3,1
51434,31957,0,0,70,70,0,1,0,1,0
7334,25773,0,0,154,154,0,1,0,1,0
49080,29841,0,0,149,149,0,1,0,1,0
12086,3389,12086,3389,293,223,70,4,1,3,1
56308,51308,0,0,145,145,0,1,0,1,0
20653,3389,20653,3389,293,223,70,4,0,3,1
39511,3389,39511,3389,293,223,70,4,0,3,1
28210,30369,0,0,100,100,0,1,0,1,0
50046,33023,0,0,114,114,0,1,0,1,0
26919,3389,26919,3389,293,223,70,4,0,3,1
14175,23384,0,0,114,114,0,1,0,1,0
49834,27863,0,0,132,132,0,1,0,1,0
2490,22664,0,0,157,157,0,1,0,1,0
9522,3389,9522,3389,293,223,70,4,1,3,1
58197,31652,0,0,96,96,0,1,0,1,0
13983,54992,0,0,153,153,0,1,0,1,0
28210,60935,0,0,133,133,0,1,0,1,0
13439,61248,0,0,147,147,0,1,0,1,0
58638,61101,0,0,134,134,0,1,0,1,0
12257,3389,12257,3389,293,223,70,4,0,3,1
17445,47441,0,0,99,99,0,1,0,1,0
34855,3389,34855,3389,293,223,70,4,0,3,1
9608,3389,9608,3389,293,223,70,4,1,3,1
20014,3389,20014,3389,293,223,70,4,0,3,1
32111,5823,0,0,116,116,0,1,0,1,0
28235,29166,0,0,112,112,0,1,0,1,0
49754,27512,0,0,128,128,0,1,0,1,0
26805,25773,0,0,147,147,0,1,0,1,0
49145,33547,0,0,146,146,0,1,0,1,0
8432,25773,0,0,140,140,0,1,0,1,0
19380,3389,19380,3389,293,223,70,4,0,3,1
49160,33752,0,0,146,146,0,1,0,1,0
37936,3389,37936,3389,293,223,70,4,1,3,1
14563,3389,14563,3389,293,223,70,4,0,3,1
2898,48238,0,0,144,144,0,1,0,1,0
55733,31652,0,0,62,62,0,1,0,1,0
51920,32072,0,0,62,62,0,1,0,1,0
29847,33949,0,0,62,62,0,1,0,1,0
48892,60301,0,0,80,80,0,1,0,1,0
42367,10096,0,0,148,148,0,1,0,1,0
33662,3389,33662,3389,293,223,70,4,1,3,1
16191,18626,0,0,145,145,0,1,0,1,0
15465,3389,15465,3389,293,223,70,4,0,3,1
51517,31652,0,0,67,67,0,1,0,1,0
51661,31758,0,0,65,65,0,1,0,1,0
52230,32991,0,0,62,62,0,1,0,1,0
37089,3389,37089,3389,293,223,70,4,1,3,1
3089,48793,0,0,143,143,0,1,0,1,0
12887,3389,12887,3389,293,223,70,4,0,3,1
10376,3389,10376,3389,293,223,70,4,1,3,1
41774,5618,0,0,145,145,0,1,0,1,0
9758,25773,0,0,140,140,0,1,0,1,0
31938,3389,31938,3389,293,223,70,4,0,3,1
56909,32821,0,0,103,103,0,1,0,1,0
22193,61244,0,0,158,158,0,1,0,1,0
16738,3389,16738,3389,293,223,70,4,0,3,1
4772,36887,0,0,150,150,0,1,0,1,0
49220,26562,0,0,145,145,0,1,0,1,0
17086,25773,0,0,142,142,0,1,0,1,0
60291,3389,60291,3389,293,223,70,4,0,3,1
51692,31652,0,0,63,63,0,1,0,1,0
5978,24591,0,0,157,157,0,1,0,1,0
50213,28452,0,0,113,113,0,1,0,1,0
21963,3389,21963,3389,293,223,70,4,0,3,1
4473,25773,0,0,142,142,0,1,0,1,0
51768,31652,0,0,62,62,0,1,0,1,0
17787,18828,0,0,67,67,0,1,0,1,0
6959,23920,0,0,147,147,0,1,0,1,0
54098,14936,0,0,118,118,0,1,0,1,0
21664,61248,0,0,158,158,0,1,0,1,0
11362,4346,9725,3005,276,214,62,3,0,2,0
8435,25535,0,0,154,154,0,1,0,1,0
10510,25773,0,0,146,146,0,1,0,1,0
19234,3389,19234,3389,293,223,70,4,0,3,1
6905,25773,0,0,143,143,0,1,0,1,0
24015,3389,24015,3389,293,223,70,4,1,3,1
23476,34021,0,0,62,62,0,1,0,1,0
55267,31652,0,0,62,62,0,1,0,1,0
22563,33876,0,0,63,63,0,1,0,1,0
4661,53366,0,0,142,142,0,1,0,1,0
61591,31652,0,0,77,77,0,1,0,1,0
54817,3389,54817,3389,293,223,70,4,0,3,1
30278,3389,30278,3389,293,223,70,4,0,3,1
14467,55408,0,0,122,122,0,1,0,1,0
49115,30641,0,0,147,147,0,1,0,1,0
48931,26415,0,0,155,155,0,1,0,1,0
9658,3389,9658,3389,293,223,70,4,0,3,1
15702,21458,0,0,94,94,0,1,0,1,0
9168,3389,9168,3389,293,223,70,4,1,3,1
13171,58877,0,0,132,132,0,1,0,1,0
49819,27829,0,0,133,133,0,1,0,1,0
18208,26127,0,0,139,139,0,1,0,1,0
26970,24773,0,0,136,136,0,1,0,1,0
9868,3389,9868,3389,293,223,70,4,1,3,1
6925,17458,0,0,153,153,0,1,0,1,0
63694,31652,0,0,62,62,0,1,0,1,0
19047,61248,0,0,154,154,0,1,0,1,0
53543,5618,0,0,145,145,0,1,0,1,0
11469,3389,11469,3389,293,223,70,4,1,3,1
11649,3389,11649,3389,293,223,70,4,0,3,1
20474,19907,0,0,81,81,0,1,0,1,0
7776,25585,0,0,157,157,0,1,0,1,0
50766,32765,0,0,106,106,0,1,0,1,0
12060,3389,12060,3389,293,223,70,4,1,3,1
7276,25773,0,0,154,154,0,1,0,1,0
12225,61248,0,0,139,139,0,1,0,1,0
20706,30765,0,0,93,93,0,1,0,1,0
19369,3389,19369,3389,293,223,70,4,0,3,1
29709,34021,0,0,62,62,0,1,0,1,0
55068,31652,0,0,62,62,0,1,0,1,0
2302,23854,0,0,149,149,0,1,0,1,0
23078,31390,0,0,86,86,0,1,0,1,0
19827,3389,19827,3389,293,223,70,4,0,3,1
51099,31652,0,0,77,77,0,1,0,1,0
2821,48015,0,0,144,144,0,1,0,1,0
17990,3389,17990,3389,293,223,70,4,0,3,1
24318,61135,0,0,149,149,0,1,0,1,0
19865,3389,19865,3389,293,223,70,4,0,3,1
53750,45121,0,0,145,145,0,1,0,1,0
6134,25773,0,0,141,141,0,1,0,1,0
18570,3389,18570,3389,293,223,70,4,0,3,1
32257,3389,32257,3389,293,223,70,4,0,3,1
50857,29768,0,0,92,92,0,1,0,1,0
59557,31652,0,0,62,62,0,1,0,1,0
5429,25773,0,0,148,148,0,1,0,1,0
11511,3389,11511,3389,293,223,70,4,1,3,1
23324,32801,0,0,74,74,0,1,0,1,0
5126,54718,0,0,141,141,0,1,0,1,0
11738,3389,11738,3389,293,223,70,4,0,3,1
29818,34021,0,0,62,62,0,1,0,1,0
37808,3389,37808,3389,293,223,70,4,1,3,1
38457,34021,0,0,99,99,0,1,0,1,0
2832,48048,0,0,144,144,0,1,0,1,0
2131,45941,0,0,144,144,0,1,0,1,0
50492,60432,0,0,89,89,0,1,0,1,0
17977,3389,17977,3389,293,223,70,4,0,3,1
55100,43030,0,0,93,93,0,1,0,1,0
9659,61248,0,0,141,141,0,1,0,1,0
46606,56576,0,0,62,62,0,1,0,1,0
24291,3389,24291,3389,293,223,70,4,0,3,1
18519,3389,18519,3389,293,223,70,4,0,3,1
10278,5195,7191,2665,262,206,55,3,0,2,0
52252,33055,0,0,62,62,0,1,0,1,0
37135,11179,0,0,146,146,0,1,0,1,0
20152,61248,0,0,156,156,0,1,0,1,0
9661,25773,0,0,150,150,0,1,0,1,0
53329,36630,0,0,69,69,0,1,0,1,0
10578,3389,10578,3389,293,223,70,4,0,3,1
12762,57717,0,0,132,132,0,1,0,1,0
19076,3389,19076,3389,293,223,70,4,0,3,1
63223,3389,63223,3389,293,223,70,4,0,3,1
20918,31157,0,0,90,90,0,1,0,1,0
17206,3389,17206,3389,293,223,70,4,0,3,1
13144,25773,0,0,149,149,0,1,0,1,0
17135,8905,0,0,126,126,0,1,0,1,0
52509,33866,0,0,63,63,0,1,0,1,0
7079,25773,0,0,141,141,0,1,0,1,0
47834,23209,0,0,155,155,0,1,0,1,0
44502,7505,0,0,145,145,0,1,0,1,0
11340,25773,0,0,143,143,0,1,0,1,0
8381,61248,0,0,140,140,0,1,0,1,0
18640,29080,0,0,108,108,0,1,0,1,0
39596,5285,0,0,141,141,0,1,0,1,0
22687,21564,0,0,99,99,0,1,0,1,0
5992,24599,0,0,157,157,0,1,0,1,0
47930,23439,0,0,155,155,0,1,0,1,0
7212,17244,0,0,152,152,0,1,0,1,0
21474,61248,0,0,158,158,0,1,0,1,0
21339,3389,21339,3389,293,223,70,4,0,3,1
37957,3389,37957,3389,293,223,70,4,1,3,1
57889,32669,0,0,98,98,0,1,0,1,0
25078,32430,0,0,76,76,0,1,0,1,0
49160,32284,0,0,146,146,0,1,0,1,0
6866,25773,0,0,153,153,0,1,0,1,0
3374,49624,0,0,143,143,0,1,0,1,0
12127,61248,0,0,139,139,0,1,0,1,0
28278,27069,0,0,134,134,0,1,0,1,0
3557,25773,0,0,143,143,0,1,0,1,0
22577,3389,22577,3389,293,223,70,4,0,3,1
20830,38384,0,0,74,74,0,1,0,1,0
21102,25773,0,0,144,144,0,1,0,1,0
55429,7085,0,0,140,140,0,1,0,1,0
12801,61248,0,0,145,145,0,1,0,1,0
49238,26606,0,0,144,144,0,1,0,1,0
37996,7413,0,0,146,146,0,1,0,1,0
51837,31652,0,0,62,62,0,1,0,1,0
11358,3389,11358,3389,293,223,70,4,1,3,1
15887,14256,0,0,115,115,0,1,0,1,0
49092,30105,0,0,148,148,0,1,0,1,0
51930,32851,0,0,66,66,0,1,0,1,0
43129,11923,0,0,149,149,0,1,0,1,0
54539,3389,54539,3389,293,223,70,4,0,3,1
11270,61248,0,0,142,142,0,1,0,1,0
53897,31652,0,0,70,70,0,1,0,1,0
13008,3389,13008,3389,293,223,70,4,0,3,1
4811,25773,0,0,146,146,0,1,0,1,0
17311,57547,0,0,155,155,0,1,0,1,0
15739,20108,0,0,85,85,0,1,0,1,0
50797,31652,0,0,93,93,0,1,0,1,0
50095,31652,0,0,113,113,0,1,0,1,0
39844,6088,0,0,146,146,0,1,0,1,0
29260,23638,0,0,147,147,0,1,0,1,0
51488,31914,0,0,71,71,0,1,0,1,0
13916,23711,0,0,117,117,0,1,0,1,0
18382,18339,0,0,63,63,0,1,0,1,0
48108,60236,0,0,75,75,0,1,0,1,0
49419,26829,0,0,139,139,0,1,0,1,0
14770,3389,14770,3389,293,223,70,4,0,3,1
15104,61248,0,0,144,144,0,1,0,1,0
22028,35076,0,0,65,65,0,1,0,1,0
12598,22442,0,0,114,114,0,1,0,1,0
12876,21976,0,0,141,141,0,1,0,1,0
18154,21378,0,0,95,95,0,1,0,1,0
10397,61248,0,0,139,139,0,1,0,1,0
20265,61248,0,0,155,155,0,1,0,1,0
18122,22388,0,0,106,106,0,1,0,1,0
15187,3389,15187,3389,293,223,70,4,0,3,1
14909,27901,0,0,119,119,0,1,0,1,0
5877,25773,0,0,143,143,0,1,0,1,0
44326,5618,0,0,145,145,0,1,0,1,0
7588,24139,0,0,146,146,0,1,0,1,0
17231,3389,17231,3389,293,223,70,4,0,3,1
51260,30591,0,0,79,79,0,1,0,1,0
11062,25773,0,0,144,144,0,1,0,1,0
8329,59520,0,0,134,134,0,1,0,1,0
20199,32188,0,0,79,79,0,1,0,1,0
14463,11855,0,0,147,147,0,1,0,1,0
40332,3389,40332,3389,293,223,70,4,0,3,1
51160,30838,0,0,98,98,0,1,0,1,0
39205,6546,0,0,146,146,0,1,0,1,0
53628,60690,0,0,106,106,0,1,0,1,0
50797,29644,0,0,94,94,0,1,0,1,0
35688,3389,35688,3389,293,223,70,4,0,3,1
16921,19920,0,0,79,79,0,1,0,1,0
17372,3389,17372,3389,293,223,70,4,0,3,1
18726,3389,18726,3389,293,223,70,4,0,3,1
36482,3389,36482,3389,293,223,70,4,0,3,1
24332,31379,0,0,89,89,0,1,0,1,0
11400,4438,9606,2968,275,213,61,3,0,2,0
2331,20880,0,0,156,156,0,1,0,1,0
30608,34021,0,0,64,64,0,1,0,1,0
10481,3389,10481,3389,293,223,70,4,0,3,1
19782,3389,19782,3389,293,223,70,4,0,3,1
10366,22275,0,0,105,105,0,1,0,1,0
48910,25944,0,0,156,156,0,1,0,1,0
15245,3389,15245,3389,293,223,70,4,0,3,1
17981,61248,0,0,150,150,0,1,0,1,0
49108,32374,0,0,148,148,0,1,0,1,0
28280,26985,0,0,135,135,0,1,0,1,0
50812,30525,0,0,88,88,0,1,0,1,0
4343,25773,0,0,142,142,0,1,0,1,0
7003,25773,0,0,153,153,0,1,0,1,0
37346,3389,37346,3389,293,223,70,4,1,3,1
16970,19194,0,0,74,74,0,1,0,1,0
31120,19483,0,0,147,147,0,1,0,1,0
2861,22869,0,0,157,157,0,1,0,1,0
20146,3389,20146,3389,293,223,70,4,0,3,1
32397,3389,32397,3389,293,223,70,4,0,3,1
29179,34021,0,0,62,62,0,1,0,1,0
17097,16296,0,0,88,88,0,1,0,1,0
49284,33907,0,0,141,141,0,1,0,1,0
28507,34021,0,0,62,62,0,1,0,1,0
55684,3389,55684,3389,293,223,70,4,0,3,1
1510,22615,0,0,154,154,0,1,0,1,0
62288,3389,62288,3389,293,223,70,4,0,3,1
20473,3389,20473,3389,293,223,70,4,0,3,1
11070,61248,0,0,142,142,0,1,0,1,0
56899,49028,0,0,107,107,0,1,0,1,0
15232,14875,0,0,146,146,0,1,0,1,0
19705,3389,19705,3389,293,223,70,4,0,3,1
16254,3389,16254,3389,293,223,70,4,0,3,1
17283,3389,17283,3389,293,223,70,4,0,3,1
40190,5839,0,0,146,146,0,1,0,1,0
49699,27560,0,0,136,136,0,1,0,1,0
16234,25773,0,0,141,141,0,1,0,1,0
18172,20789,0,0,89,89,0,1,0,1,0
16547,3389,16547,3389,293,223,70,4,0,3,1
16940,25773,0,0,144,144,0,1,0,1,0
4320,25773,0,0,142,142,0,1,0,1,0
14894,61248,0,0,144,144,0,1,0,1,0
28876,28638,0,0,118,118,0,1,0,1,0
46600,52585,0,0,84,84,0,1,0,1,0
27070,27514,0,0,129,129,0,1,0,1,0
49106,60318,0,0,81,81,0,1,0,1,0
49217,34021,0,0,144,144,0,1,0,1,0
53143,43655,0,0,145,145,0,1,0,1,0
41010,3389,41010,3389,293,223,70,4,0,3,1
27130,24893,0,0,137,137,0,1,0,1,0
13848,3389,13848,3389,293,223,70,4,0,3,1
23077,579,2151,578,101,89,11,1,0,1,0
18245,3389,18245,3389,293,223,70,4,0,3,1
22630,21521,0,0,99,99,0,1,0,1,0
6617,30754,0,0,154,154,0,1,0,1,0
47652,43984,0,0,109,109,0,1,0,1,0
30656,3389,30656,3389,293,223,70,4,0,3,1
52153,33255,0,0,65,65,0,1,0,1,0
49160,32959,0,0,146,146,0,1,0,1,0
38500,60407,0,0,91,91,0,1,0,1,0
57192,33101,0,0,62,62,0,1,0,1,0
12658,3389,12658,3389,293,223,70,4,0,3,1
7986,25773,0,0,156,156,0,1,0,1,0
12705,23068,0,0,140,140,0,1,0,1,0
29072,34021,0,0,62,62,0,1,0,1,0
18123,22365,0,0,106,106,0,1,0,1,0
62236,31652,0,0,74,74,0,1,0,1,0
17890,61248,0,0,150,150,0,1,0,1,0
15682,3389,15682,3389,293,223,70,4,0,3,1
51193,31731,0,0,74,74,0,1,0,1,0
28347,1146,0,0,79,79,0,1,0,1,0
23092,3389,23092,3389,293,223,70,4,0,3,1
2697,24472,0,0,147,147,0,1,0,1,0
57983,52905,0,0,121,121,0,1,0,1,0
18694,27030,0,0,130,130,0,1,0,1,0
49974,27962,0,0,121,121,0,1,0,1,0
30053,1774,0,0,88,88,0,1,0,1,0
49990,28213,0,0,128,128,0,1,0,1,0
12652,23405,0,0,140,140,0,1,0,1,0
38518,3389,38518,3389,293,223,70,4,0,3,1
20263,3389,20263,3389,293,223,70,4,0,3,1
16889,3389,16889,3389,293,223,70,4,0,3,1
51381,30840,0,0,75,75,0,1,0,1,0
51537,31870,0,0,69,69,0,1,0,1,0
49015,29388,0,0,152,152,0,1,0,1,0
50032,28082,0,0,119,119,0,1,0,1,0
29876,34021,0,0,62,62,0,1,0,1,0
14886,61248,0,0,144,144,0,1,0,1,0
5031,22778,0,0,153,153,0,1,0,1,0
13984,61248,0,0,142,142,0,1,0,1,0
22565,34021,0,0,62,62,0,1,0,1,0
2932,24839,0,0,146,146,0,1,0,1,0
28295,26254,0,0,142,142,0,1,0,1,0
52521,26691,0,0,77,77,0,1,0,1,0
51099,31240,0,0,77,77,0,1,0,1,0
3792,48437,0,0,143,143,0,1,0,1,0
41988,3389,41988,3389,293,223,70,4,0,3,1
17593,3389,17593,3389,293,223,70,4,0,3,1
12087,8073,4080,1512,212,181,31,2,0,1,0
11388,61248,0,0,142,142,0,1,0,1,0
50407,32616,0,0,102,102,0,1,0,1,0
13995,23612,0,0,116,116,0,1,0,1,0
43539,7667,0,0,145,145,0,1,0,1,0
10420,14856,0,0,150,150,0,1,0,1,0
2477,24127,0,0,148,148,0,1,0,1,0
46620,52429,0,0,84,84,0,1,0,1,0
18203,3389,18203,3389,293,223,70,4,0,3,1
51759,32543,0,0,68,68,0,1,0,1,0
12364,3389,12364,3389,293,223,70,4,1,3,1
17595,2050,7623,2049,201,159,42,2,0,2,0
51331,31222,0,0,94,94,0,1,0,1,0
18014,17841,0,0,67,67,0,1,0,1,0
11526,3389,11526,3389,293,223,70,4,1,3,1
15916,3389,15916,3389,293,223,70,4,0,3,1
14286,3389,14286,3389,293,223,70,4,0,3,1
8375,23549,0,0,150,150,0,1,0,1,0
57573,31652,0,0,67,67,0,1,0,1,0
11272,3389,11272,3389,293,223,70,4,1,3,1
60689,59271,0,0,139,139,0,1,0,1,0
19548,6252,0,0,107,107,0,1,0,1,0
14041,25773,0,0,140,140,0,1,0,1,0
8998,61248,0,0,140,140,0,1,0,1,0
46056,57292,0,0,70,70,0,1,0,1,0
23538,29588,0,0,105,105,0,1,0,1,0
13889,61248,0,0,147,147,0,1,0,1,0
21892,20968,0,0,93,93,0,1,0,1,0
25804,3389,25804,3389,293,223,70,4,0,3,1
49284,26723,0,0,143,143,0,1,0,1,0
16538,25773,0,0,145,145,0,1,0,1,0
13520,10354,1614,598,173,161,12,1,0,1,0
4069,23536,0,0,157,157,0,1,0,1,0
24342,15028,0,0,91,91,0,1,0,1,0
13633,61248,0,0,141,141,0,1,0,1,0
45825,59024,0,0,65,65,0,1,0,1,0
16088,61248,0,0,146,146,0,1,0,1,0
49808,27624,0,0,127,127,0,1,0,1,0
53623,33812,0,0,62,62,0,1,0,1,0
15736,3389,15736,3389,293,223,70,4,0,3,1
15716,25773,0,0,143,143,0,1,0,1,0
12981,61248,0,0,145,145,0,1,0,1,0
64227,33358,0,0,66,66,0,1,0,1,0
8509,25773,0,0,156,156,0,1,0,1,0
6351,25773,0,0,151,151,0,1,0,1,0
9799,25773,0,0,140,140,0,1,0,1,0
15952,14365,0,0,114,114,0,1,0,1,0
50861,32482,0,0,91,91,0,1,0,1,0
11111,3740,10511,3248,286,219,67,3,0,2,0
23861,34021,0,0,62,62,0,1,0,1,0
57281,60990,0,0,127,127,0,1,0,1,0
8009,54798,0,0,141,141,0,1,0,1,0
49094,30150,0,0,148,148,0,1,0,1,0
17180,61248,0,0,148,148,0,1,0,1,0
49160,33252,0,0,146,146,0,1,0,1,0
14783,22618,0,0,106,106,0,1,0,1,0
19000,3389,19000,3389,293,223,70,4,0,3,1
57248,33089,0,0,62,62,0,1,0,1,0
51284,31652,0,0,71,71,0,1,0,1,0
18354,3389,18354,3389,293,223,70,4,0,3,1
18441,43841,0,0,91,91,0,1,0,1,0
11977,3389,11977,3389,293,223,70,4,1,3,1
51216,31530,0,0,73,73,0,1,0,1,0
28736,34021,0,0,62,62,0,1,0,1,0
23166,3389,23166,3389,293,223,70,4,0,3,1
53749,60700,0,0,107,107,0,1,0,1,0
12980,3389,12980,3389,293,223,70,4,0,3,1
3152,23030,0,0,157,157,0,1,0,1,0
48235,34021,0,0,141,141,0,1,0,1,0
22900,555,1794,554,99,88,11,1,0,1,0
9236,25773,0,0,152,152,0,1,0,1,0
45938,60058,0,0,63,63,0,1,0,1,0
35131,60580,0,0,105,105,0,1,0,1,0
47455,3389,47455,3389,293,223,70,4,0,3,1
14200,3389,14200,3389,293,223,70,4,0,3,1
62037,32027,0,0,75,75,0,1,0,1,0
38640,3389,38640,3389,293,223,70,4,0,3,1
46408,19788,0,0,153,153,0,1,0,1,0
20393,3389,20393,3389,293,223,70,4,0,3,1
50315,32453,0,0,117,117,0,1,0,1,0
22254,3389,22254,3389,293,223,70,4,0,3,1
23381,2037,0,0,76,76,0,1,0,1,0
20555,27527,0,0,125,125,0,1,0,1,0
48931,26434,0,0,155,155,0,1,0,1,0
2843,48077,0,0,144,144,0,1,0,1,0
3368,27986,0,0,143,143,0,1,0,1,0
14378,61248,0,0,143,143,0,1,0,1,0
3312,28772,0,0,143,143,0,1,0,1,0
49160,32484,0,0,146,146,0,1,0,1,0
4120,25773,0,0,144,144,0,1,0,1,0
12052,3389,12052,3389,293,223,70,4,1,3,1
16076,14575,0,0,111,111,0,1,0,1,0
49107,32333,0,0,148,148,0,1,0,1,0
49008,29156,0,0,152,152,0,1,0,1,0
12257,61248,0,0,139,139,0,1,0,1,0
15956,21137,0,0,91,91,0,1,0,1,0
28813,33234,0,0,69,69,0,1,0,1,0
56645,33210,0,0,62,62,0,1,0,1,0
50982,34021,0,0,101,101,0,1,0,1,0
18154,21381,0,0,95,95,0,1,0,1,0
15161,11075,0,0,142,142,0,1,0,1,0
63582,3389,63582,3389,293,223,70,4,0,3,1
11316,61247,0,0,143,143,0,1,0,1,0
20953,31222,0,0,89,89,0,1,0,1,0
52576,34017,0,0,62,62,0,1,0,1,0
51097,30258,0,0,84,84,0,1,0,1,0
19193,61248,0,0,153,153,0,1,0,1,0
23788,344,1110,343,85,78,7,1,0,1,0
48974,35410,0,0,141,141,0,1,0,1,0
17998,3389,17998,3389,293,223,70,4,0,3,1
15312,25773,0,0,146,146,0,1,0,1,0
52335,33475,0,0,68,68,0,1,0,1,0
22646,34021,0,0,62,62,0,1,0,1,0
18127,22218,0,0,104,104,0,1,0,1,0
6368,25773,0,0,151,151,0,1,0,1,0
21476,3389,21476,3389,293,223,70,4,0,3,1
9435,25773,0,0,140,140,0,1,0,1,0
33683,34021,0,0,78,78,0,1,0,1,0
20306,3389,20306,3389,293,223,70,4,0,3,1
45545,5618,0,0,145,145,0,1,0,1,0
37919,4668,0,0,131,131,0,1,0,1,0
37287,7922,0,0,146,146,0,1,0,1,0
19335,25773,0,0,143,143,0,1,0,1,0
13288,3389,13288,3389,293,223,70,4,0,3,1
12448,6977,6314,1951,231,191,40,2,0,2,0
49160,32372,0,0,146,146,0,1,0,1,0
54814,11386,0,0,126,126,0,1,0,1,0
34424,34021,0,0,81,81,0,1,0,1,0
38797,3389,38797,3389,293,223,70,4,0,3,1
21415,35907,0,0,67,67,0,1,0,1,0
15970,19409,0,0,74,74,0,1,0,1,0
46396,54740,0,0,79,79,0,1,0,1,0
25165,34021,0,0,62,62,0,1,0,1,0
15512,20277,0,0,87,87,0,1,0,1,0
13459,61248,0,0,141,141,0,1,0,1,0
28018,3389,28018,3389,293,223,70,4,0,3,1
11532,3389,11532,3389,293,223,70,4,1,3,1
20372,19830,0,0,80,80,0,1,0,1,0
12570,3389,12570,3389,293,223,70,4,1,3,1
6605,30794,0,0,153,153,0,1,0,1,0
18036,7914,0,0,119,119,0,1,0,1,0
9222,57757,0,0,143,143,0,1,0,1,0
11598,3389,11598,3389,293,223,70,4,0,3,1
32621,3389,32621,3389,293,223,70,4,0,3,1
3198,23055,0,0,157,157,0,1,0,1,0
50758,34021,0,0,106,106,0,1,0,1,0
43041,7751,0,0,145,145,0,1,0,1,0
48930,26649,0,0,155,155,0,1,0,1,0
50450,31652,0,0,100,100,0,1,0,1,0
50433,32587,0,0,101,101,0,1,0,1,0
10124,3389,10124,3389,293,223,70,4,1,3,1
21461,20646,0,0,89,89,0,1,0,1,0
51939,32127,0,0,62,62,0,1,0,1,0
48487,3389,48487,3389,293,223,70,4,0,3,1
17179,3389,17179,3389,293,223,70,4,0,3,1
26359,954,0,0,70,70,0,1,0,1,0
13991,3389,13991,3389,293,223,70,4,0,3,1
64151,31652,0,0,62,62,0,1,0,1,0
17967,3389,17967,3389,293,223,70,4,0,3,1
58232,53759,0,0,123,123,0,1,0,1,0
62798,3389,62798,3389,293,223,70,4,0,3,1
2328,42373,0,0,144,144,0,1,0,1,0
23312,516,1917,515,97,86,10,1,0,1,0
50102,31652,0,0,112,112,0,1,0,1,0
62437,46471,0,0,103,103,0,1,0,1,0
3924,51222,0,0,142,142,0,1,0,1,0
9911,3389,9911,3389,293,223,70,4,1,3,1
20071,5677,0,0,103,103,0,1,0,1,0
8121,61248,0,0,140,140,0,1,0,1,0
28758,28047,0,0,124,124,0,1,0,1,0
18119,3389,18119,3389,293,223,70,4,0,3,1
42363,3389,42363,3389,293,223,70,4,0,3,1
32665,34021,0,0,73,73,0,1,0,1,0
51536,3389,51536,3389,293,223,70,4,0,3,1
14662,25773,0,0,140,140,0,1,0,1,0
15040,3389,15040,3389,293,223,70,4,0,3,1
6288,23686,0,0,148,148,0,1,0,1,0
20069,19603,0,0,77,77,0,1,0,1,0
28637,34021,0,0,62,62,0,1,0,1,0
17096,3389,17096,3389,293,223,70,4,0,3,1
8508,61248,0,0,140,140,0,1,0,1,0
49637,27275,0,0,132,132,0,1,0,1,0
52379,33661,0,0,63,63,0,1,0,1,0
50390,28814,0,0,107,107,0,1,0,1,0
6416,53081,0,0,144,144,0,1,0,1,0
11273,25773,0,0,143,143,0,1,0,1,0
37770,3389,37770,3389,293,223,70,4,1,3,1
26870,31891,0,0,82,82,0,1,0,1,0
35405,8612,0,0,142,142,0,1,0,1,0
22395,34196,0,0,62,62,0,1,0,1,0
52148,32746,0,0,62,62,0,1,0,1,0
50526,34021,0,0,112,112,0,1,0,1,0
54464,40851,0,0,87,87,0,1,0,1,0
12978,25773,0,0,139,139,0,1,0,1,0
27824,25773,0,0,147,147,0,1,0,1,0
11512,3389,11512,3389,293,223,70,4,0,3,1
10138,61248,0,0,139,139,0,1,0,1,0
13963,3389,13963,3389,293,223,70,4,0,3,1
22035,25773,0,0,144,144,0,1,0,1,0
12513,61248,0,0,144,144,0,1,0,1,0
40459,5647,0,0,146,146,0,1,0,1,0
13930,21452,0,0,102,102,0,1,0,1,0
55625,5774,0,0,145,145,0,1,0,1,0
51680,31652,0,0,63,63,0,1,0,1,0
31751,20077,0,0,147,147,0,1,0,1,0
15053,12850,0,0,134,134,0,1,0,1,0
9988,59034,0,0,143,143,0,1,0,1,0
52389,33461,0,0,62,62,0,1,0,1,0
53078,33921,0,0,62,62,0,1,0,1,0
36621,8401,0,0,146,146,0,1,0,1,0
17259,3389,17259,3389,293,223,70,4,0,3,1
6137,25773,0,0,150,150,0,1,0,1,0
59101,4702,26288,1391,205,177,28,2,0,1,0
51234,31575,0,0,73,73,0,1,0,1,0
25587,34021,0,0,62,62,0,1,0,1,0
30308,3389,30308,3389,293,223,70,4,0,3,1
52462,33679,0,0,62,62,0,1,0,1,0
3253,49272,0,0,143,143,0,1,0,1,0
18715,61248,0,0,152,152,0,1,0,1,0
39633,5299,0,0,141,141,0,1,0,1,0
31917,3389,31917,3389,293,223,70,4,0,3,1
11218,3389,11218,3389,293,223,70,4,1,3,1
21057,61248,0,0,156,156,0,1,0,1,0
14116,3389,14116,3389,293,223,70,4,0,3,1
26168,34021,0,0,62,62,0,1,0,1,0
49160,32016,0,0,146,146,0,1,0,1,0
19465,3389,19465,3389,293,223,70,4,0,3,1
20300,61248,0,0,155,155,0,1,0,1,0
12446,13346,0,0,149,149,0,1,0,1,0
5379,55455,0,0,141,141,0,1,0,1,0
16312,19682,0,0,80,80,0,1,0,1,0
52088,33137,0,0,65,65,0,1,0,1,0
19414,3389,19414,3389,293,223,70,4,0,3,1
62326,47277,0,0,105,105,0,1,0,1,0
20569,3389,20569,3389,293,223,70,4,0,3,1
11079,61248,0,0,142,142,0,1,0,1,0
19526,3389,19526,3389,293,223,70,4,0,3,1
7078,25199,0,0,157,157,0,1,0,1,0
16225,3389,16225,3389,293,223,70,4,0,3,1
21782,32760,0,0,74,74,0,1,0,1,0
54740,41798,0,0,90,90,0,1,0,1,0
12961,3389,12961,3389,293,223,70,4,0,3,1
24596,25773,0,0,146,146,0,1,0,1,0
8068,55835,0,0,143,143,0,1,0,1,0
10642,23895,0,0,133,133,0,1,0,1,0
63010,3389,63010,3389,293,223,70,4,0,3,1
15403,3389,15403,3389,293,223,70,4,0,3,1
12168,25773,0,0,139,139,0,1,0,1,0
28993,29222,0,0,112,112,0,1,0,1,0
8455,61248,0,0,140,140,0,1,0,1,0
51902,32075,0,0,63,63,0,1,0,1,0
26293,25773,0,0,147,147,0,1,0,1,0
12045,22853,0,0,120,120,0,1,0,1,0
43453,7682,0,0,145,145,0,1,0,1,0
48981,28294,0,0,153,153,0,1,0,1,0
10076,3389,10076,3389,293,223,70,4,1,3,1
19517,28558,0,0,115,115,0,1,0,1,0
54942,42489,0,0,92,92,0,1,0,1,0
18164,21036,0,0,92,92,0,1,0,1,0
29478,3389,29478,3389,293,223,70,4,0,3,1
39262,6505,0,0,146,146,0,1,0,1,0
17954,18617,0,0,65,65,0,1,0,1,0
11476,3389,11476,3389,293,223,70,4,0,3,1
26052,31326,0,0,88,88,0,1,0,1,0
25118,30270,0,0,101,101,0,1,0,1,0
53702,38239,0,0,80,80,0,1,0,1,0
54769,11683,0,0,125,125,0,1,0,1,0
14460,61248,0,0,143,143,0,1,0,1,0
28940,24353,0,0,147,147,0,1,0,1,0
43751,13416,0,0,150,150,0,1,0,1,0
17588,3389,17588,3389,293,223,70,4,0,3,1
52331,33289,0,0,62,62,0,1,0,1,0
28803,34021,0,0,62,62,0,1,0,1,0
19446,3389,19446,3389,293,223,70,4,0,3,1
19781,29048,0,0,110,110,0,1,0,1,0
37942,4676,0,0,131,131,0,1,0,1,0
48903,25778,0,0,156,156,0,1,0,1,0
16493,3389,16493,3389,293,223,70,4,0,3,1
2505,24171,0,0,148,148,0,1,0,1,0
46034,57220,0,0,70,70,0,1,0,1,0
50020,31652,0,0,115,115,0,1,0,1,0
16534,3389,16534,3389,293,223,70,4,0,3,1
49798,34021,0,0,130,130,0,1,0,1,0
53530,5618,0,0,145,145,0,1,0,1,0
1184,22105,0,0,156,156,0,1,0,1,0
2032,23431,0,0,151,151,0,1,0,1,0
30985,3389,30985,3389,293,223,70,4,0,3,1
12757,22324,0,0,113,113,0,1,0,1,0
27958,2307,0,0,83,83,0,1,0,1,0
28549,26997,0,0,135,135,0,1,0,1,0
9720,61248,0,0,139,139,0,1,0,1,0
28349,32914,0,0,72,72,0,1,0,1,0
56947,3389,56947,3389,293,223,70,4,0,3,1
56867,32827,0,0,103,103,0,1,0,1,0
60167,3389,60167,3389,293,223,70,4,0,3,1
39848,3389,39848,3389,293,223,70,4,0,3,1
15876,20007,0,0,84,84,0,1,0,1,0
13517,61248,0,0,146,146,0,1,0,1,0
18375,26438,0,0,136,136,0,1,0,1,0
10805,61248,0,0,143,143,0,1,0,1,0
17571,18747,0,0,68,68,0,1,0,1,0
50401,32897,0,0,106,106,0,1,0,1,0
25023,34021,0,0,62,62,0,1,0,1,0
14328,3389,14328,3389,293,223,70,4,0,3,1
14670,61248,0,0,147,147,0,1,0,1,0
51385,31652,0,0,69,69,0,1,0,1,0
20401,30198,0,0,99,99,0,1,0,1,0
23207,21954,0,0,104,104,0,1,0,1,0
25890,3389,25890,3389,293,223,70,4,0,3,1
7231,25773,0,0,154,154,0,1,0,1,0
51285,31652,0,0,71,71,0,1,0,1,0
59933,61208,0,0,142,142,0,1,0,1,0
11320,6853,5398,2000,233,192,41,2,0,2,0
24088,30722,0,0,94,94,0,1,0,1,0
50366,34021,0,0,116,116,0,1,0,1,0
9470,3389,9470,3389,293,223,70,4,1,3,1
35843,8959,0,0,146,146,0,1,0,1,0
14533,27596,0,0,121,121,0,1,0,1,0
28142,3389,28142,3389,293,223,70,4,0,3,1
18050,25773,0,0,143,143,0,1,0,1,0
27133,33500,0,0,66,66,0,1,0,1,0
13176,61248,0,0,146,146,0,1,0,1,0
32250,2582,0,0,100,100,0,1,0,1,0
20521,3389,20521,3389,293,223,70,4,0,3,1
10991,23636,0,0,130,130,0,1,0,1,0
18378,18175,0,0,62,62,0,1,0,1,0
11372,61248,0,0,142,142,0,1,0,1,0
31965,17598,0,0,147,147,0,1,0,1,0
49864,27929,0,0,132,132,0,1,0,1,0
9376,3389,9376,3389,293,223,70,4,1,3,1
48966,27234,0,0,154,154,0,1,0,1,0
18152,21430,0,0,96,96,0,1,0,1,0
16327,14998,0,0,105,105,0,1,0,1,0
10205,25049,0,0,142,142,0,1,0,1,0
38308,7190,0,0,146,146,0,1,0,1,0
16448,3389,16448,3389,293,223,70,4,0,3,1
8765,56996,0,0,143,143,0,1,0,1,0
44522,5618,0,0,145,145,0,1,0,1,0
49487,27085,0,0,141,141,0,1,0,1,0
11927,3389,11927,3389,293,223,70,4,1,3,1
2659,47544,0,0,144,144,0,1,0,1,0
63338,31652,0,0,62,62,0,1,0,1,0
56215,32928,0,0,107,107,0,1,0,1,0
22176,3389,22176,3389,293,223,70,4,0,3,1
50184,28391,0,0,114,114,0,1,0,1,0
32771,18391,0,0,147,147,0,1,0,1,0
52129,33212,0,0,65,65,0,1,0,1,0
50861,34021,0,0,104,104,0,1,0,1,0
22461,3389,22461,3389,293,223,70,4,0,3,1
10623,25773,0,0,146,146,0,1,0,1,0
28847,28493,0,0,119,119,0,1,0,1,0
30339,1879,0,0,90,90,0,1,0,1,0
16576,19098,0,0,71,71,0,1,0,1,0
18143,21705,0,0,99,99,0,1,0,1,0
12880,8023,4958,1532,213,181,31,2,0,1,0
20517,61248,0,0,156,156,0,1,0,1,0
51243,33096,0,0,94,94,0,1,0,1,0
9321,3389,9321,3389,293,223,70,4,1,3,1
13261,3389,13261,3389,293,223,70,4,0,3,1
19476,3389,19476,3389,293,223,70,4,0,3,1
54929,7843,0,0,146,146,0,1,0,1,0
18015,3389,18015,3389,293,223,70,4,0,3,1
14338,21149,0,0,98,98,0,1,0,1,0
49118,30708,0,0,147,147,0,1,0,1,0
46181,56350,0,0,73,73,0,1,0,1,0
52015,32353,0,0,62,62,0,1,0,1,0
6742,17595,0,0,153,153,0,1,0,1,0
27130,3389,27130,3389,293,223,70,4,0,3,1
24682,23059,0,0,117,117,0,1,0,1,0
7592,55040,0,0,143,143,0,1,0,1,0
49160,32637,0,0,146,146,0,1,0,1,0
23359,25773,0,0,145,145,0,1,0,1,0
11545,61248,0,0,142,142,0,1,0,1,0
28663,34021,0,0,62,62,0,1,0,1,0
7860,54574,0,0,141,141,0,1,0,1,0
50199,28682,0,0,123,123,0,1,0,1,0
3328,25459,0,0,144,144,0,1,0,1,0
5829,33374,0,0,152,152,0,1,0,1,0
40110,3389,40110,3389,293,223,70,4,0,3,1
54952,9900,0,0,132,132,0,1,0,1,0
1376,22048,0,0,157,157,0,1,0,1,0
2539,22691,0,0,157,157,0,1,0,1,0
19492,3389,19492,3389,293,223,70,4,0,3,1
11874,60628,0,0,139,139,0,1,0,1,0
49291,31742,0,0,142,142,0,1,0,1,0
39420,5220,0,0,140,140,0,1,0,1,0
3878,25773,0,0,144,144,0,1,0,1,0
3738,25773,0,0,143,143,0,1,0,1,0
12729,3389,12729,3389,293,223,70,4,0,3,1
49341,33816,0,0,139,139,0,1,0,1,0
24882,34021,0,0,62,62,0,1,0,1,0
32882,10523,0,0,131,131,0,1,0,1,0
12357,3389,12357,3389,293,223,70,4,1,3,1
23498,25773,0,0,145,145,0,1,0,1,0
50910,32865,0,0,102,102,0,1,0,1,0
47437,45738,0,0,104,104,0,1,0,1,0
12639,3389,12639,3389,293,223,70,4,0,3,1
17596,61248,0,0,152,152,0,1,0,1,0
13402,10167,1817,673,176,162,13,1,0,1,0
18428,3389,18428,3389,293,223,70,4,0,3,1
43097,60171,0,0,72,72,0,1,0,1,0
21402,3389,21402,3389,293,223,70,4,0,3,1
29723,34021,0,0,62,62,0,1,0,1,0
18241,18586,0,0,65,65,0,1,0,1,0
14284,3389,14284,3389,293,223,70,4,0,3,1
27077,34021,0,0,62,62,0,1,0,1,0
49804,27616,0,0,127,127,0,1,0,1,0
13695,3389,13695,3389,293,223,70,4,0,3,1
11174,25773,0,0,143,143,0,1,0,1,0
47649,45345,0,0,109,109,0,1,0,1,0
52506,33807,0,0,62,62,0,1,0,1,0
25335,38,0,0,62,62,0,1,0,1,0
49237,5618,0,0,145,145,0,1,0,1,0
49022,29595,0,0,151,151,0,1,0,1,0
50105,31652,0,0,115,115,0,1,0,1,0
9621,61248,0,0,139,139,0,1,0,1,0
10858,25773,0,0,153,153,0,1,0,1,0
35971,8866,0,0,146,146,0,1,0,1,0
52093,32584,0,0,62,62,0,1,0,1,0
49127,6724,0,0,145,145,0,1,0,1,0
19571,1345,4352,1345,153,125,27,2,0,1,0
13441,3389,13441,3389,293,223,70,4,0,3,1
17044,1945,6295,1945,194,154,40,2,0,2,0
61853,31652,0,0,76,76,0,1,0,1,0
49122,32804,0,0,147,147,0,1,0,1,0
34874,3389,34874,3389,293,223,70,4,0,3,1
11970,61248,0,0,140,140,0,1,0,1,0
62708,32001,0,0,62,62,0,1,0,1,0
49777,33326,0,0,124,124,0,1,0,1,0
25835,29259,0,0,111,111,0,1,0,1,0
20338,3389,20338,3389,293,223,70,4,0,3,1
14713,3389,14713,3389,293,223,70,4,0,3,1
20836,38367,0,0,74,74,0,1,0,1,0
15072,22253,0,0,103,103,0,1,0,1,0
50050,33018,0,0,114,114,0,1,0,1,0
9322,15673,0,0,151,151,0,1,0,1,0
21297,33078,0,0,70,70,0,1,0,1,0
51328,31652,0,0,76,76,0,1,0,1,0
6442,25773,0,0,141,141,0,1,0,1,0
13670,3389,13670,3389,293,223,70,4,0,3,1
35088,3626,0,0,116,116,0,1,0,1,0
49402,34021,0,0,140,140,0,1,0,1,0
49767,31652,0,0,126,126,0,1,0,1,0
61127,32168,0,0,80,80,0,1,0,1,0
50361,32668,0,0,103,103,0,1,0,1,0
49667,32003,0,0,133,133,0,1,0,1,0
10632,58755,0,0,139,139,0,1,0,1,0
27689,33657,0,0,65,65,0,1,0,1,0
11155,3389,11155,3389,293,223,70,4,1,3,1
49996,28227,0,0,128,128,0,1,0,1,0
22190,3389,22190,3389,293,223,70,4,0,3,1
16377,20606,0,0,86,86,0,1,0,1,0
24665,34021,0,0,62,62,0,1,0,1,0
16818,18975,0,0,69,69,0,1,0,1,0
16822,47796,0,0,102,102,0,1,0,1,0
28247,28547,0,0,119,119,0,1,0,1,0
18673,3389,18673,3389,293,223,70,4,0,3,1
29373,3389,29373,3389,293,223,70,4,0,3,1
49440,31652,0,0,136,136,0,1,0,1,0
13627,25773,0,0,139,139,0,1,0,1,0
2754,36485,0,0,144,144,0,1,0,1,0
15128,14466,0,0,147,147,0,1,0,1,0
51537,31158,0,0,69,69,0,1,0,1,0
51174,31753,0,0,75,75,0,1,0,1,0
35175,34021,0,0,84,84,0,1,0,1,0
7228,54434,0,0,143,143,0,1,0,1,0
10788,6006,6315,2340,248,199,48,3,0,2,0
21306,3389,21306,3389,293,223,70,4,0,3,1
38289,9271,0,0,146,146,0,1,0,1,0
16101,3389,16101,3389,293,223,70,4,0,3,1
12723,57811,0,0,132,132,0,1,0,1,0
19659,40865,0,0,82,82,0,1,0,1,0
23453,478,1777,477,94,84,9,1,0,1,0
13848,10876,1050,389,164,156,8,1,0,1,0
8541,24470,0,0,144,144,0,1,0,1,0
12555,53895,0,0,152,152,0,1,0,1,0
4423,49760,0,0,144,144,0,1,0,1,0
23919,353,1311,352,86,78,7,1,0,1,0
10534,61248,0,0,142,142,0,1,0,1,0
16232,18790,0,0,145,145,0,1,0,1,0
28381,34021,0,0,62,62,0,1,0,1,0
11330,3389,11330,3389,293,223,70,4,0,3,1
18324,3389,18324,3389,293,223,70,4,0,3,1
